team,n,rank,w,d,l,gf,ga,gd,pts
Crusaders,0,1,20,6,4,59,27,32,66
Cliftonville,0,2,17,5,8,62,44,18,56
Linfield,0,3,15,10,5,62,30,32,55
Coleraine,0,4,13,9,8,45,38,7,48
Ballymena,0,5,12,6,12,54,64,-10,42
Glenavon,0,6,10,8,12,41,46,-5,38
Ards,0,7,9,6,15,37,47,-10,33
Glentoran,0,8,7,10,13,32,45,-13,31
Portadown,0,9,9,4,17,29,50,-21,31
Dungannon,0,10,7,8,15,47,50,-3,29
Ballinamalla,0,11,7,6,17,28,55,-27,27
Crusaders,1,1,18,7,5,60,32,28,61
Cliftonville,1,2,16,6,8,50,35,15,54
Ballymena,1,3,14,6,10,58,55,3,48
Coleraine,1,4,13,8,9,47,40,7,47
Linfield,1,5,11,12,7,52,34,18,45
Dungannon,1,6,10,12,8,49,42,7,42
Glenavon,1,7,10,9,11,43,44,-1,39
Ballinamalla,1,8,9,6,15,30,45,-15,33
Glentoran,1,9,8,8,14,27,40,-13,32
Ards,1,10,7,7,16,32,54,-22,28
Portadown,1,11,6,5,19,22,49,-27,23
Crusaders,2,1,16,9,5,57,38,19,57
Cliftonville,2,2,16,4,10,53,38,15,52
Linfield,2,3,14,9,7,63,31,32,51
Ballymena,2,4,14,7,9,59,60,-1,49
Dungannon,2,5,10,11,9,49,43,6,41
Coleraine,2,6,11,7,12,42,37,5,40
Ards,2,7,10,9,11,41,46,-5,39
Glentoran,2,8,8,9,13,32,46,-14,33
Glenavon,2,9,7,10,13,37,56,-19,31
Portadown,2,10,8,6,16,28,46,-18,30
Ballinamalla,2,11,7,7,16,30,50,-20,28
Cliftonville,3,1,15,7,8,57,41,16,52
Coleraine,3,2,13,9,8,46,37,9,48
Crusaders,3,3,13,9,8,47,41,6,48
Linfield,3,4,12,10,8,54,38,16,46
Ballymena,3,5,13,6,11,54,62,-8,45
Glenavon,3,6,10,11,9,43,50,-7,41
Dungannon,3,7,9,10,11,46,42,4,37
Ards,3,8,10,7,13,41,43,-2,37
Glentoran,3,9,9,7,14,36,44,-8,34
Ballinamalla,3,10,10,3,17,35,46,-11,33
Portadown,3,11,9,5,16,35,50,-15,32
Linfield,4,1,20,7,3,66,29,37,67
Ballymena,4,2,15,5,10,55,58,-3,50
Crusaders,4,3,14,7,9,60,43,17,49
Coleraine,4,4,12,10,8,48,36,12,46
Dungannon,4,5,13,6,11,61,42,19,45
Cliftonville,4,6,12,7,11,46,40,6,43
Glenavon,4,7,8,13,9,48,51,-3,37
Ards,4,8,11,4,15,34,47,-13,37
Glentoran,4,9,9,7,14,27,41,-14,34
Portadown,4,10,7,4,19,23,49,-26,25
Ballinamalla,4,11,6,6,18,25,57,-32,24
Crusaders,5,1,17,8,5,60,38,22,59
Linfield,5,2,17,7,6,69,35,34,58
Glenavon,5,3,12,11,7,46,41,5,47
Ballymena,5,4,14,4,12,61,61,0,46
Cliftonville,5,5,13,6,11,52,46,6,45
Dungannon,5,6,11,8,11,47,44,3,41
Coleraine,5,7,10,10,10,43,41,2,40
Glentoran,5,8,9,8,13,28,41,-13,35
Ards,5,9,10,3,17,36,51,-15,33
Portadown,5,10,8,5,17,25,43,-18,29
Ballinamalla,5,11,7,4,19,25,51,-26,25
Linfield,6,1,16,8,6,54,28,26,56
Crusaders,6,2,17,5,8,54,38,16,56
Ballymena,6,3,17,5,8,63,53,10,56
Cliftonville,6,4,16,7,7,53,36,17,55
Glenavon,6,5,11,8,11,46,45,1,41
Coleraine,6,6,10,10,10,34,39,-5,40
Dungannon,6,7,9,10,11,53,45,8,37
Ards,6,8,10,4,16,37,43,-6,34
Portadown,6,9,8,5,17,29,47,-18,29
Glentoran,6,10,7,8,15,27,48,-21,29
Ballinamalla,6,11,6,6,18,23,51,-28,24
Crusaders,7,1,15,11,4,49,30,19,56
Linfield,7,2,14,11,5,61,26,35,53
Cliftonville,7,3,13,7,10,50,48,2,46
Ballymena,7,4,13,6,11,56,61,-5,45
Glenavon,7,5,10,11,9,43,47,-4,41
Coleraine,7,6,9,13,8,39,42,-3,40
Portadown,7,7,12,4,14,36,41,-5,40
Glentoran,7,8,9,8,13,34,41,-7,35
Dungannon,7,9,7,11,12,52,49,3,32
Ards,7,10,8,7,15,36,48,-12,31
Ballinamalla,7,11,9,3,18,28,51,-23,30
Crusaders,8,1,15,9,6,53,33,20,54
Cliftonville,8,2,16,5,9,54,40,14,53
Linfield,8,3,13,11,6,52,28,24,50
Dungannon,8,4,14,7,9,49,37,12,49
Ballymena,8,5,12,8,10,56,57,-1,44
Glenavon,8,6,11,10,9,46,42,4,43
Coleraine,8,7,10,11,9,45,44,1,41
Glentoran,8,8,9,9,12,35,41,-6,36
Ards,8,9,10,4,16,37,52,-15,34
Ballinamalla,8,10,8,3,19,31,57,-26,27
Portadown,8,11,5,7,18,21,48,-27,22
Linfield,9,1,14,9,7,58,36,22,51
Crusaders,9,2,14,8,8,50,36,14,50
Ballymena,9,3,15,4,11,54,53,1,49
Glenavon,9,4,12,10,8,60,48,12,46
Cliftonville,9,5,13,7,10,46,35,11,46
Coleraine,9,6,12,9,9,43,40,3,45
Glentoran,9,7,10,10,10,32,34,-2,40
Dungannon,9,8,9,10,11,47,44,3,37
Ballinamalla,9,9,9,5,16,29,51,-22,32
Ards,9,10,8,5,17,38,57,-19,29
Portadown,9,11,7,7,16,26,49,-23,28
Crusaders,10,1,17,7,6,55,36,19,58
Linfield,10,2,15,9,6,62,30,32,54
Coleraine,10,3,14,10,6,48,36,12,52
Cliftonville,10,4,15,4,11,57,40,17,49
Ballymena,10,5,13,6,11,55,61,-6,45
Glenavon,10,6,10,12,8,52,50,2,42
Dungannon,10,7,10,9,11,48,45,3,39
Glentoran,10,8,8,8,14,33,50,-17,32
Ards,10,9,8,6,16,38,54,-16,30
Portadown,10,10,8,6,16,28,48,-20,30
Ballinamalla,10,11,7,3,20,32,58,-26,24
Crusaders,11,1,15,8,7,58,37,21,53
Coleraine,11,2,14,10,6,45,36,9,52
Cliftonville,11,3,16,3,11,48,36,12,51
Linfield,11,4,13,9,8,53,37,16,48
Ballymena,11,5,14,5,11,62,56,6,47
Glenavon,11,6,12,9,9,53,48,5,45
Dungannon,11,7,10,11,9,48,43,5,41
Portadown,11,8,11,2,17,33,49,-16,35
Ballinamalla,11,9,8,7,15,37,51,-14,31
Ards,11,10,8,5,17,31,49,-18,29
Glentoran,11,11,6,7,17,26,52,-26,25
Crusaders,12,1,16,8,6,60,41,19,56
Cliftonville,12,2,15,5,10,50,39,11,50
Ballymena,12,3,14,6,10,59,60,-1,48
Linfield,12,4,12,9,9,57,40,17,45
Ards,12,5,12,5,13,41,42,-1,41
Glentoran,12,6,10,10,10,32,40,-8,40
Ballinamalla,12,7,12,3,15,37,46,-9,39
Glenavon,12,8,9,10,11,42,50,-8,37
Coleraine,12,9,9,9,12,36,39,-3,36
Dungannon,12,10,7,10,13,46,48,-2,31
Portadown,12,11,8,7,15,25,40,-15,31
Linfield,13,1,18,7,5,62,27,35,61
Cliftonville,13,2,15,7,8,56,38,18,52
Coleraine,13,3,13,11,6,48,41,7,50
Crusaders,13,4,14,7,9,48,38,10,49
Glenavon,13,5,12,10,8,47,42,5,46
Ballymena,13,6,10,9,11,49,59,-10,39
Dungannon,13,7,8,14,8,52,44,8,38
Portadown,13,8,9,5,16,31,41,-10,32
Glentoran,13,9,8,7,15,28,44,-16,31
Ards,13,10,8,6,16,40,56,-16,30
Ballinamalla,13,11,7,3,20,23,54,-31,24
Crusaders,14,1,18,6,6,61,32,29,60
Linfield,14,2,17,8,5,60,25,35,59
Cliftonville,14,3,16,5,9,53,37,16,53
Ballymena,14,4,13,6,11,50,49,1,45
Glenavon,14,5,10,10,10,53,50,3,40
Dungannon,14,6,11,7,12,42,40,2,40
Coleraine,14,7,11,7,12,39,44,-5,40
Ards,14,8,12,2,16,45,56,-11,38
Glentoran,14,9,9,7,14,30,47,-17,34
Ballinamalla,14,10,8,4,18,32,58,-26,28
Portadown,14,11,6,6,18,21,48,-27,24
Ballymena,15,1,17,5,8,65,56,9,56
Crusaders,15,2,14,10,6,50,32,18,52
Cliftonville,15,3,15,4,11,50,36,14,49
Glenavon,15,4,13,10,7,46,39,7,49
Dungannon,15,5,12,10,8,57,46,11,46
Linfield,15,6,13,6,11,58,34,24,45
Coleraine,15,7,9,10,11,38,45,-7,37
Glentoran,15,8,10,6,14,33,46,-13,36
Ballinamalla,15,9,9,5,16,31,53,-22,32
Ards,15,10,8,5,17,37,51,-14,29
Portadown,15,11,6,7,17,27,54,-27,25
Crusaders,16,1,20,6,4,59,30,29,66
Cliftonville,16,2,17,4,9,48,33,15,55
Linfield,16,3,15,7,8,61,33,28,52
Glenavon,16,4,12,13,5,46,39,7,49
Coleraine,16,5,12,11,7,45,33,12,47
Ballymena,16,6,10,7,13,52,63,-11,37
Dungannon,16,7,9,8,13,50,45,5,35
Ards,16,8,10,4,16,36,46,-10,34
Glentoran,16,9,8,5,17,28,54,-26,29
Ballinamalla,16,10,7,7,16,30,50,-20,28
Portadown,16,11,6,6,18,23,52,-29,24
Crusaders,17,1,16,9,5,54,33,21,57
Ballymena,17,2,16,5,9,56,56,0,53
Linfield,17,3,13,11,6,64,34,30,50
Cliftonville,17,4,15,5,10,52,38,14,50
Coleraine,17,5,12,11,7,43,41,2,47
Dungannon,17,6,11,11,8,48,37,11,44
Glenavon,17,7,10,12,8,46,39,7,42
Ards,17,8,10,6,14,40,49,-9,36
Glentoran,17,9,8,6,16,32,47,-15,30
Portadown,17,10,8,3,19,23,51,-28,27
Ballinamalla,17,11,5,3,22,27,60,-33,18
Ballymena,18,1,19,5,6,75,55,20,62
Crusaders,18,2,18,6,6,60,32,28,60
Linfield,18,3,14,9,7,56,29,27,51
Cliftonville,18,4,14,5,11,51,45,6,47
Glenavon,18,5,12,8,10,47,41,6,44
Dungannon,18,6,11,8,11,50,45,5,41
Ards,18,7,10,5,15,40,51,-11,35
Coleraine,18,8,8,10,12,39,47,-8,34
Glentoran,18,9,8,7,15,28,51,-23,31
Ballinamalla,18,10,8,4,18,28,52,-24,28
Portadown,18,11,7,5,18,23,49,-26,26
Cliftonville,19,1,16,5,9,59,42,17,53
Crusaders,19,2,15,7,8,51,38,13,52
Linfield,19,3,14,7,9,55,37,18,49
Ballymena,19,4,14,7,9,58,54,4,49
Coleraine,19,5,11,10,9,38,35,3,43
Glenavon,19,6,10,10,10,43,44,-1,40
Ards,19,7,11,5,14,37,42,-5,38
Glentoran,19,8,10,8,12,37,48,-11,38
Dungannon,19,9,9,8,13,52,48,4,35
Ballinamalla,19,10,9,3,18,29,53,-24,30
Portadown,19,11,7,8,15,26,44,-18,29
Cliftonville,20,1,18,5,7,63,34,29,59
Crusaders,20,2,18,5,7,48,28,20,59
Linfield,20,3,15,7,8,54,34,20,52
Ballymena,20,4,15,6,9,55,54,1,51
Coleraine,20,5,12,10,8,45,40,5,46
Dungannon,20,6,12,8,10,45,40,5,44
Glenavon,20,7,9,9,12,49,51,-2,36
Ards,20,8,10,3,17,39,51,-12,33
Glentoran,20,9,7,7,16,30,50,-20,28
Portadown,20,10,7,5,18,29,47,-18,26
Ballinamalla,20,11,7,5,18,27,55,-28,26
Linfield,21,1,15,9,6,57,29,28,54
Crusaders,21,2,16,6,8,50,33,17,54
Cliftonville,21,3,15,5,10,49,39,10,50
Ballymena,21,4,14,5,11,57,61,-4,47
Coleraine,21,5,12,9,9,39,37,2,45
Dungannon,21,6,10,9,11,51,46,5,39
Ballinamalla,21,7,12,3,15,36,44,-8,39
Glenavon,21,8,10,8,12,43,49,-6,38
Portadown,21,9,8,8,14,30,47,-17,32
Ards,21,10,9,4,17,38,49,-11,31
Glentoran,21,11,7,8,15,28,44,-16,29
Crusaders,22,1,17,6,7,63,37,26,57
Cliftonville,22,2,15,6,9,56,37,19,51
Linfield,22,3,13,10,7,62,42,20,49
Glenavon,22,4,12,13,5,41,37,4,49
Coleraine,22,5,12,7,11,43,41,2,43
Ards,22,6,13,4,13,41,47,-6,43
Dungannon,22,7,11,8,11,56,51,5,41
Ballymena,22,8,10,9,11,55,62,-7,39
Glentoran,22,9,8,7,15,26,42,-16,31
Portadown,22,10,8,6,16,29,48,-19,30
Ballinamalla,22,11,6,4,20,27,55,-28,22
Linfield,23,1,14,8,8,61,33,28,50
Crusaders,23,2,13,9,8,50,35,15,48
Ballymena,23,3,14,6,10,56,60,-4,48
Coleraine,23,4,13,8,9,41,35,6,47
Cliftonville,23,5,13,5,12,51,50,1,44
Ards,23,6,12,4,14,41,45,-4,40
Glentoran,23,7,10,8,12,38,45,-7,38
Dungannon,23,8,9,10,11,50,44,6,37
Glenavon,23,9,8,13,9,39,43,-4,37
Ballinamalla,23,10,8,9,13,27,45,-18,33
Portadown,23,11,7,8,15,29,48,-19,29
Cliftonville,24,1,15,7,8,48,37,11,52
Coleraine,24,2,13,10,7,46,33,13,49
Linfield,24,3,11,13,6,57,33,24,46
Crusaders,24,4,13,7,10,49,42,7,46
Ballymena,24,5,12,9,9,61,63,-2,45
Glenavon,24,6,11,10,9,48,48,0,43
Dungannon,24,7,10,10,10,47,40,7,40
Ballinamalla,24,8,12,3,15,40,50,-10,39
Glentoran,24,9,8,8,14,35,47,-12,32
Portadown,24,10,8,5,17,25,49,-24,29
Ards,24,11,6,10,14,35,49,-14,28
Ballymena,25,1,16,7,7,57,47,10,55
Crusaders,25,2,15,8,7,59,38,21,53
Linfield,25,3,14,8,8,59,43,16,50
Cliftonville,25,4,15,4,11,49,42,7,49
Coleraine,25,5,13,8,9,44,35,9,47
Dungannon,25,6,12,10,8,58,41,17,46
Glenavon,25,7,7,12,11,42,50,-8,33
Ards,25,8,8,7,15,36,51,-15,31
Ballinamalla,25,9,8,7,15,23,45,-22,31
Glentoran,25,10,7,9,14,28,37,-9,30
Portadown,25,11,8,4,18,32,58,-26,28
Crusaders,26,1,18,5,7,60,35,25,59
Linfield,26,2,16,7,7,57,30,27,55
Dungannon,26,3,14,7,9,54,32,22,49
Cliftonville,26,4,14,7,9,52,42,10,49
Coleraine,26,5,13,9,8,44,35,9,48
Glenavon,26,6,11,11,8,50,50,0,44
Ballymena,26,7,12,8,10,55,61,-6,44
Ards,26,8,9,6,15,42,54,-12,33
Portadown,26,9,7,7,16,24,43,-19,28
Glentoran,26,10,7,7,16,28,48,-20,28
Ballinamalla,26,11,5,4,21,24,60,-36,19
Crusaders,27,1,16,8,6,51,32,19,56
Linfield,27,2,15,8,7,56,28,28,53
Cliftonville,27,3,15,5,10,51,38,13,50
Ballymena,27,4,14,7,9,49,50,-1,49
Dungannon,27,5,12,10,8,46,35,11,46
Coleraine,27,6,10,11,9,41,41,0,41
Glenavon,27,7,11,7,12,44,42,2,40
Ballinamalla,27,8,9,4,17,28,43,-15,31
Ards,27,9,8,7,15,27,43,-16,31
Glentoran,27,10,8,7,15,27,48,-21,31
Portadown,27,11,7,6,17,25,45,-20,27
Crusaders,28,1,18,7,5,52,27,25,61
Cliftonville,28,2,16,6,8,59,39,20,54
Ballymena,28,3,15,5,10,61,58,3,50
Linfield,28,4,13,10,7,55,32,23,49
Coleraine,28,5,12,10,8,48,37,11,46
Glenavon,28,6,11,11,8,50,43,7,44
Dungannon,28,7,11,8,11,53,48,5,41
Portadown,28,8,9,5,16,28,45,-17,32
Glentoran,28,9,7,7,16,20,44,-24,28
Ballinamalla,28,10,7,5,18,35,63,-28,26
Ards,28,11,7,4,19,33,58,-25,25
Linfield,29,1,16,9,5,62,28,34,57
Crusaders,29,2,15,6,9,45,36,9,51
Ballymena,29,3,14,8,8,61,62,-1,50
Coleraine,29,4,12,10,8,52,39,13,46
Glenavon,29,5,12,10,8,44,36,8,46
Cliftonville,29,6,11,7,12,45,43,2,40
Dungannon,29,7,9,11,10,46,42,4,38
Ards,29,8,11,3,16,38,47,-9,36
Glentoran,29,9,9,6,15,31,45,-14,33
Ballinamalla,29,10,9,4,17,29,49,-20,31
Portadown,29,11,7,6,17,22,48,-26,27
Cliftonville,30,1,16,7,7,55,33,22,55
Crusaders,30,2,14,7,9,52,36,16,49
Coleraine,30,3,12,11,7,44,37,7,47
Linfield,30,4,12,9,9,56,41,15,45
Glenavon,30,5,10,15,5,49,39,10,45
Dungannon,30,6,9,13,8,54,43,11,40
Ballymena,30,7,11,5,14,53,64,-11,38
Glentoran,30,8,10,7,13,34,48,-14,37
Ards,30,9,9,6,15,39,49,-10,33
Portadown,30,10,9,6,15,25,47,-22,33
Ballinamalla,30,11,8,4,18,31,55,-24,28
Linfield,31,1,17,11,2,62,25,37,62
Crusaders,31,2,15,9,6,52,27,25,54
Coleraine,31,3,13,10,7,47,37,10,49
Ballymena,31,4,14,6,10,57,56,1,48
Cliftonville,31,5,14,5,11,50,41,9,47
Glenavon,31,6,11,9,10,45,52,-7,42
Dungannon,31,7,10,6,14,45,43,2,36
Glentoran,31,8,8,8,14,29,42,-13,32
Ballinamalla,31,9,8,6,16,28,52,-24,30
Portadown,31,10,8,4,18,28,46,-18,28
Ards,31,11,8,4,18,32,54,-22,28
Crusaders,32,1,15,9,6,58,36,22,54
Linfield,32,2,13,9,8,53,35,18,48
Cliftonville,32,3,13,8,9,44,39,5,47
Glenavon,32,4,12,10,8,48,40,8,46
Ballymena,32,5,13,4,13,50,51,-1,43
Dungannon,32,6,10,10,10,47,41,6,40
Coleraine,32,7,10,10,10,41,35,6,40
Glentoran,32,8,10,9,11,35,45,-10,39
Portadown,32,9,10,6,14,24,40,-16,36
Ards,32,10,7,8,15,37,50,-13,29
Ballinamalla,32,11,8,5,17,30,55,-25,29
Cliftonville,33,1,19,4,7,57,34,23,61
Linfield,33,2,16,6,8,61,34,27,54
Crusaders,33,3,15,8,7,59,41,18,53
Ballymena,33,4,15,6,9,66,59,7,51
Glenavon,33,5,11,11,8,43,45,-2,44
Coleraine,33,6,9,12,9,44,39,5,39
Ards,33,7,12,3,15,45,53,-8,39
Dungannon,33,8,7,12,11,47,48,-1,33
Glentoran,33,9,8,8,14,29,44,-15,32
Ballinamalla,33,10,7,5,18,28,56,-28,26
Portadown,33,11,7,3,20,27,53,-26,24
Crusaders,34,1,15,7,8,50,34,16,52
Cliftonville,34,2,16,4,10,54,40,14,52
Ballymena,34,3,14,8,8,62,49,13,50
Coleraine,34,4,12,12,6,45,36,9,48
Linfield,34,5,13,8,9,55,37,18,47
Glenavon,34,6,10,12,8,40,48,-8,42
Dungannon,34,7,8,10,12,48,47,1,34
Ballinamalla,34,8,10,4,16,38,57,-19,34
Glentoran,34,9,9,6,15,28,44,-16,33
Portadown,34,10,8,7,15,29,46,-17,31
Ards,34,11,8,6,16,40,51,-11,30
Linfield,35,1,16,10,4,60,23,37,58
Crusaders,35,2,15,10,5,51,28,23,55
Ballymena,35,3,15,7,8,69,63,6,52
Cliftonville,35,4,13,10,7,51,41,10,49
Glenavon,35,5,11,11,8,49,41,8,44
Dungannon,35,6,10,11,9,51,48,3,41
Coleraine,35,7,8,12,10,39,40,-1,36
Ards,35,8,8,7,15,39,53,-14,31
Portadown,35,9,7,6,17,20,43,-23,27
Glentoran,35,10,5,11,14,23,48,-25,26
Ballinamalla,35,11,5,9,16,29,53,-24,24
Crusaders,36,1,19,6,5,58,31,27,63
Linfield,36,2,15,9,6,56,32,24,54
Ballymena,36,3,17,3,10,64,59,5,54
Cliftonville,36,4,14,6,10,51,44,7,48
Dungannon,36,5,11,10,9,54,44,10,43
Coleraine,36,6,11,8,11,44,37,7,41
Glenavon,36,7,9,12,9,45,47,-2,39
Glentoran,36,8,9,5,16,32,52,-20,32
Ards,36,9,8,6,16,34,47,-13,30
Portadown,36,10,7,7,16,25,42,-17,28
Ballinamalla,36,11,7,4,19,28,56,-28,25
Crusaders,37,1,16,9,5,53,32,21,57
Linfield,37,2,13,11,6,53,28,25,50
Cliftonville,37,3,15,4,11,50,38,12,49
Ballymena,37,4,14,7,9,51,55,-4,49
Glenavon,37,5,12,10,8,47,39,8,46
Coleraine,37,6,12,9,9,42,35,7,45
Dungannon,37,7,10,10,10,50,38,12,40
Glentoran,37,8,9,8,13,33,46,-13,35
Portadown,37,9,7,7,16,27,46,-19,28
Ballinamalla,37,10,7,7,16,31,56,-25,28
Ards,37,11,7,4,19,34,58,-24,25
Linfield,38,1,16,9,5,66,38,28,57
Cliftonville,38,2,17,5,8,59,37,22,56
Crusaders,38,3,15,6,9,53,37,16,51
Ballymena,38,4,15,6,9,64,52,12,51
Coleraine,38,5,13,10,7,44,32,12,49
Dungannon,38,6,8,14,8,48,45,3,38
Ards,38,7,11,5,14,40,47,-7,38
Glenavon,38,8,8,13,9,47,52,-5,37
Ballinamalla,38,9,9,3,18,32,54,-22,30
Glentoran,38,10,5,8,17,24,54,-30,23
Portadown,38,11,5,7,18,20,49,-29,22
Crusaders,39,1,16,6,8,54,31,23,54
Cliftonville,39,2,17,3,10,55,39,16,54
Glenavon,39,3,14,8,8,57,50,7,50
Linfield,39,4,12,12,6,51,31,20,48
Ballymena,39,5,13,7,10,55,58,-3,46
Coleraine,39,6,11,9,10,46,43,3,42
Dungannon,39,7,9,11,10,50,46,4,38
Ballinamalla,39,8,11,3,16,35,52,-17,36
Glentoran,39,9,7,10,13,29,44,-15,31
Ards,39,10,8,5,17,40,58,-18,29
Portadown,39,11,6,8,16,18,38,-20,26
Crusaders,40,1,17,7,6,61,37,24,58
Cliftonville,40,2,16,2,12,49,44,5,50
Coleraine,40,3,12,13,5,43,29,14,49
Ballymena,40,4,14,6,10,56,55,1,48
Linfield,40,5,12,9,9,53,36,17,45
Dungannon,40,6,12,8,10,54,43,11,44
Portadown,40,7,13,4,13,30,38,-8,43
Glenavon,40,8,8,14,8,42,43,-1,38
Ballinamalla,40,9,9,4,17,33,54,-21,31
Glentoran,40,10,6,8,16,23,47,-24,26
Ards,40,11,7,3,20,34,52,-18,24
Ballymena,41,1,18,5,7,61,50,11,59
Crusaders,41,2,17,6,7,55,37,18,57
Cliftonville,41,3,16,3,11,57,42,15,51
Linfield,41,4,13,9,8,59,39,20,48
Coleraine,41,5,11,9,10,41,37,4,42
Glentoran,41,6,12,6,12,34,44,-10,42
Glenavon,41,7,10,9,11,44,49,-5,39
Dungannon,41,8,10,8,12,44,39,5,38
Ballinamalla,41,9,11,2,17,28,46,-18,35
Ards,41,10,10,3,17,39,51,-12,33
Portadown,41,11,5,4,21,20,48,-28,19
Cliftonville,42,1,16,5,9,62,40,22,53
Linfield,42,2,14,9,7,54,29,25,51
Ballymena,42,3,15,6,9,65,64,1,51
Crusaders,42,4,14,8,8,57,36,21,50
Coleraine,42,5,11,8,11,36,37,-1,41
Dungannon,42,6,9,11,10,51,51,0,38
Glenavon,42,7,9,11,10,48,50,-2,38
Portadown,42,8,11,5,14,37,47,-10,38
Glentoran,42,9,10,6,14,35,49,-14,36
Ballinamalla,42,10,9,4,17,32,57,-25,31
Ards,42,11,9,3,18,32,49,-17,30
Linfield,43,1,17,8,5,65,32,33,59
Crusaders,43,2,15,9,6,52,32,20,54
Cliftonville,43,3,15,8,7,54,34,20,53
Ballymena,43,4,11,10,9,64,62,2,43
Dungannon,43,5,11,8,11,53,48,5,41
Glenavon,43,6,9,12,9,48,50,-2,39
Glentoran,43,7,11,5,14,33,45,-12,38
Ards,43,8,10,4,16,37,47,-10,34
Coleraine,43,9,6,13,11,37,46,-9,31
Ballinamalla,43,10,8,7,15,35,51,-16,31
Portadown,43,11,7,6,17,26,57,-31,27
Crusaders,44,1,18,7,5,58,32,26,61
Ballymena,44,2,16,6,8,62,60,2,54
Linfield,44,3,15,8,7,60,30,30,53
Cliftonville,44,4,12,8,10,47,41,6,44
Coleraine,44,5,10,12,8,46,41,5,42
Dungannon,44,6,10,9,11,55,51,4,39
Glenavon,44,7,8,12,10,47,53,-6,36
Glentoran,44,8,9,9,12,34,48,-14,36
Ards,44,9,9,6,15,46,55,-9,33
Portadown,44,10,6,9,15,24,42,-18,27
Ballinamalla,44,11,8,2,20,29,55,-26,26
Linfield,45,1,18,7,5,56,21,35,61
Ballymena,45,2,15,5,10,59,57,2,50
Cliftonville,45,3,15,4,11,49,41,8,49
Crusaders,45,4,13,9,8,47,39,8,48
Glenavon,45,5,12,12,6,43,38,5,48
Coleraine,45,6,12,10,8,45,36,9,46
Dungannon,45,7,9,13,8,51,39,12,40
Ballinamalla,45,8,9,5,16,29,47,-18,32
Glentoran,45,9,8,7,15,31,44,-13,31
Ards,45,10,8,4,18,30,52,-22,28
Portadown,45,11,6,4,20,18,44,-26,22
Linfield,46,1,16,8,6,59,39,20,56
Crusaders,46,2,15,7,8,53,36,17,52
Cliftonville,46,3,16,4,10,55,40,15,52
Ballymena,46,4,14,6,10,57,58,-1,48
Dungannon,46,5,12,10,8,63,41,22,46
Coleraine,46,6,9,12,9,34,35,-1,39
Glenavon,46,7,8,15,7,41,51,-10,39
Glentoran,46,8,10,8,12,36,37,-1,38
Ards,46,9,7,9,14,37,50,-13,30
Portadown,46,10,6,7,17,34,56,-22,25
Ballinamalla,46,11,7,4,19,28,54,-26,25
Crusaders,47,1,17,6,7,67,40,27,57
Linfield,47,2,14,10,6,60,33,27,52
Cliftonville,47,3,14,8,8,55,39,16,50
Coleraine,47,4,12,8,10,46,47,-1,44
Glenavon,47,5,11,9,10,44,46,-2,42
Dungannon,47,6,11,7,12,49,42,7,40
Ballymena,47,7,11,7,12,56,66,-10,40
Ards,47,8,10,6,14,38,47,-9,36
Ballinamalla,47,9,10,4,16,36,51,-15,34
Glentoran,47,10,9,6,15,26,42,-16,33
Portadown,47,11,8,5,17,22,46,-24,29
Ballymena,48,1,19,3,8,60,52,8,60
Crusaders,48,2,17,7,6,56,35,21,58
Cliftonville,48,3,17,3,10,59,38,21,54
Linfield,48,4,13,10,7,52,27,25,49
Ards,48,5,11,6,13,42,43,-1,39
Dungannon,48,6,9,11,10,47,42,5,38
Glenavon,48,7,8,14,8,49,48,1,38
Coleraine,48,8,9,10,11,41,47,-6,37
Portadown,48,9,9,4,17,25,46,-21,31
Glentoran,48,10,7,7,16,26,49,-23,28
Ballinamalla,48,11,5,7,18,28,58,-30,22
Crusaders,49,1,18,6,6,61,33,28,60
Linfield,49,2,16,8,6,59,31,28,56
Glenavon,49,3,12,10,8,51,45,6,46
Cliftonville,49,4,13,6,11,53,44,9,45
Ballymena,49,5,13,6,11,55,62,-7,45
Coleraine,49,6,10,10,10,46,41,5,40
Dungannon,49,7,7,14,9,41,40,1,35
Glentoran,49,8,9,8,13,33,42,-9,35
Ballinamalla,49,9,9,5,16,29,46,-17,32
Ards,49,10,9,5,16,30,50,-20,32
Portadown,49,11,7,6,17,19,43,-24,27
Crusaders,50,1,16,7,7,56,40,16,55
Linfield,50,2,14,9,7,58,32,26,51
Cliftonville,50,3,15,5,10,50,41,9,50
Coleraine,50,4,12,13,5,48,32,16,49
Glenavon,50,5,13,10,7,53,42,11,49
Glentoran,50,6,13,8,9,43,37,6,47
Ballymena,50,7,10,6,14,45,61,-16,36
Ards,50,8,8,9,13,34,43,-9,33
Dungannon,50,9,6,10,14,44,48,-4,28
Ballinamalla,50,10,7,7,16,33,58,-25,28
Portadown,50,11,7,4,19,20,50,-30,25
Linfield,51,1,16,8,6,61,29,32,56
Crusaders,51,2,16,8,6,60,35,25,56
Cliftonville,51,3,15,7,8,52,37,15,52
Ballymena,51,4,13,9,8,58,61,-3,48
Glenavon,51,5,11,11,8,47,46,1,44
Dungannon,51,6,11,8,11,49,41,8,41
Coleraine,51,7,11,8,11,44,44,0,41
Glentoran,51,8,11,6,13,39,50,-11,39
Ards,51,9,8,6,16,39,51,-12,30
Ballinamalla,51,10,8,1,21,25,54,-29,25
Portadown,51,11,5,8,17,30,56,-26,23
Linfield,52,1,16,11,3,61,27,34,59
Crusaders,52,2,15,10,5,50,27,23,55
Cliftonville,52,3,13,7,10,46,36,10,46
Ballymena,52,4,12,9,9,54,54,0,45
Dungannon,52,5,12,8,10,55,43,12,44
Glenavon,52,6,10,14,6,47,41,6,44
Coleraine,52,7,9,10,11,37,46,-9,37
Ards,52,8,10,4,16,40,50,-10,34
Portadown,52,9,9,5,16,26,46,-20,32
Glentoran,52,10,7,9,14,29,46,-17,30
Ballinamalla,52,11,8,1,21,25,54,-29,25
Linfield,53,1,15,9,6,59,28,31,54
Crusaders,53,2,15,9,6,55,38,17,54
Cliftonville,53,3,15,6,9,50,42,8,51
Ballymena,53,4,13,8,9,59,60,-1,47
Coleraine,53,5,11,10,9,53,46,7,43
Dungannon,53,6,10,9,11,53,41,12,39
Glenavon,53,7,10,8,12,43,51,-8,38
Glentoran,53,8,9,7,14,32,47,-15,34
Ballinamalla,53,9,10,4,16,31,48,-17,34
Ards,53,10,9,6,15,40,53,-13,33
Portadown,53,11,8,4,18,24,45,-21,28
Crusaders,54,1,17,6,7,57,36,21,57
Cliftonville,54,2,17,5,8,62,39,23,56
Coleraine,54,3,16,8,6,48,37,11,56
Linfield,54,4,14,9,7,52,31,21,51
Ballymena,54,5,15,4,11,57,56,1,49
Dungannon,54,6,12,10,8,53,39,14,46
Glenavon,54,7,10,7,13,47,56,-9,37
Ballinamalla,54,8,10,1,19,36,60,-24,31
Portadown,54,9,8,6,16,32,48,-16,30
Ards,54,10,7,4,19,36,57,-21,25
Glentoran,54,11,7,4,19,32,53,-21,25
Cliftonville,55,1,18,2,10,55,37,18,56
Coleraine,55,2,15,9,6,49,31,18,54
Linfield,55,3,15,7,8,55,37,18,52
Crusaders,55,4,14,9,7,50,32,18,51
Glentoran,55,5,12,7,11,31,39,-8,43
Ballymena,55,6,12,6,12,53,59,-6,42
Dungannon,55,7,11,7,12,47,38,9,40
Glenavon,55,8,10,9,11,42,49,-7,39
Ards,55,9,8,6,16,36,49,-13,30
Portadown,55,10,7,6,17,26,47,-21,27
Ballinamalla,55,11,7,4,19,29,55,-26,25
Crusaders,56,1,19,7,4,57,27,30,64
Cliftonville,56,2,20,3,7,63,31,32,63
Linfield,56,3,14,9,7,56,33,23,51
Ballymena,56,4,13,5,12,53,52,1,44
Coleraine,56,5,11,10,9,43,40,3,43
Glentoran,56,6,11,7,12,27,39,-12,40
Dungannon,56,7,10,7,13,47,45,2,37
Glenavon,56,8,8,10,12,43,51,-8,34
Ballinamalla,56,9,10,2,18,27,47,-20,32
Ards,56,10,8,3,19,32,56,-24,27
Portadown,56,11,7,5,18,25,52,-27,26
Cliftonville,57,1,17,4,9,52,34,18,55
Crusaders,57,2,15,9,6,53,42,11,54
Ballymena,57,3,15,9,6,61,55,6,54
Linfield,57,4,14,10,6,58,34,24,52
Dungannon,57,5,11,10,9,53,39,14,43
Coleraine,57,6,11,10,9,43,40,3,43
Glentoran,57,7,8,11,11,33,43,-10,35
Ballinamalla,57,8,9,6,15,28,43,-15,33
Glenavon,57,9,7,8,15,40,53,-13,29
Portadown,57,10,7,6,17,27,49,-22,27
Ards,57,11,6,7,17,35,51,-16,25
Crusaders,58,1,16,8,6,55,30,25,56
Ballymena,58,2,16,6,8,60,60,0,54
Linfield,58,3,12,11,7,66,42,24,47
Cliftonville,58,4,13,8,9,49,41,8,47
Glenavon,58,5,11,10,9,46,50,-4,43
Glentoran,58,6,11,6,13,34,40,-6,39
Dungannon,58,7,10,7,13,46,54,-8,37
Coleraine,58,8,8,12,10,39,41,-2,36
Portadown,58,9,10,4,16,36,47,-11,34
Ballinamalla,58,10,11,1,18,33,47,-14,34
Ards,58,11,8,5,17,41,53,-12,29
Linfield,59,1,16,11,3,60,29,31,59
Cliftonville,59,2,17,6,7,62,39,23,57
Crusaders,59,3,15,7,8,57,39,18,52
Coleraine,59,4,12,10,8,44,39,5,46
Ballymena,59,5,11,10,9,58,57,1,43
Glenavon,59,6,10,12,8,43,45,-2,42
Dungannon,59,7,8,11,11,44,43,1,35
Ards,59,8,10,5,15,40,49,-9,35
Glentoran,59,9,8,10,12,31,47,-16,34
Ballinamalla,59,10,7,4,19,29,50,-21,25
Portadown,59,11,5,6,19,21,52,-31,21
Crusaders,60,1,20,7,3,59,28,31,67
Linfield,60,2,13,11,6,54,30,24,50
Cliftonville,60,3,15,3,12,53,44,9,48
Coleraine,60,4,11,14,5,43,35,8,47
Dungannon,60,5,9,13,8,51,40,11,40
Ballymena,60,6,10,10,10,50,58,-8,40
Glenavon,60,7,8,10,12,40,51,-11,34
Glentoran,60,8,8,10,12,31,42,-11,34
Ards,60,9,9,5,16,40,50,-10,32
Ballinamalla,60,10,7,7,16,28,52,-24,28
Portadown,60,11,7,6,17,22,41,-19,27
Crusaders,61,1,17,9,4,60,33,27,60
Linfield,61,2,14,7,9,61,35,26,49
Cliftonville,61,3,15,3,12,58,52,6,48
Ballymena,61,4,13,6,11,59,59,0,45
Glenavon,61,5,11,11,8,43,39,4,44
Coleraine,61,6,11,10,9,44,37,7,43
Glentoran,61,7,12,6,12,36,42,-6,42
Dungannon,61,8,9,11,10,44,46,-2,38
Portadown,61,9,10,5,15,29,45,-16,35
Ards,61,10,8,4,18,34,59,-25,28
Ballinamalla,61,11,6,6,18,29,50,-21,24
Crusaders,62,1,20,5,5,61,31,30,65
Linfield,62,2,16,7,7,58,31,27,55
Cliftonville,62,3,17,4,9,56,38,18,55
Ballymena,62,4,13,9,8,59,54,5,48
Glenavon,62,5,10,13,7,53,47,6,43
Coleraine,62,6,11,10,9,38,43,-5,43
Dungannon,62,7,10,8,12,57,50,7,38
Glentoran,62,8,9,7,14,32,47,-15,34
Portadown,62,9,7,5,18,22,47,-25,26
Ballinamalla,62,10,8,2,20,26,54,-28,26
Ards,62,11,6,6,18,31,51,-20,24
Linfield,63,1,18,8,4,65,28,37,62
Crusaders,63,2,18,8,4,62,30,32,62
Glenavon,63,3,14,8,8,54,48,6,50
Cliftonville,63,4,14,6,10,50,39,11,48
Ballymena,63,5,15,3,12,53,63,-10,48
Ballinamalla,63,6,12,3,15,37,47,-10,39
Coleraine,63,7,8,9,13,37,45,-8,33
Glentoran,63,8,8,9,13,35,48,-13,33
Portadown,63,9,8,5,17,25,51,-26,29
Dungannon,63,10,6,9,15,44,50,-6,27
Ards,63,11,7,6,17,36,49,-13,27
Glenavon,64,1,14,10,6,49,37,12,52
Crusaders,64,2,15,6,9,50,33,17,51
Coleraine,64,3,14,8,8,46,39,7,50
Cliftonville,64,4,14,6,10,47,39,8,48
Ballymena,64,5,12,9,9,56,62,-6,45
Linfield,64,6,11,8,11,50,39,11,41
Ards,64,7,12,3,15,39,44,-5,39
Dungannon,64,8,9,9,12,48,44,4,36
Glentoran,64,9,9,8,13,33,44,-11,35
Portadown,64,10,8,7,15,25,42,-17,31
Ballinamalla,64,11,9,2,19,32,52,-20,29
Crusaders,65,1,17,9,4,55,31,24,60
Cliftonville,65,2,15,6,9,52,43,9,51
Glenavon,65,3,13,10,7,58,42,16,49
Linfield,65,4,12,10,8,54,36,18,46
Coleraine,65,5,10,14,6,44,36,8,44
Glentoran,65,6,10,9,11,36,44,-8,39
Ballymena,65,7,10,8,12,51,59,-8,38
Dungannon,65,8,8,11,11,49,49,0,35
Portadown,65,9,9,7,14,33,43,-10,34
Ards,65,10,7,6,17,40,60,-20,27
Ballinamalla,65,11,5,8,17,30,59,-29,23
Linfield,66,1,14,8,8,54,33,21,50
Dungannon,66,2,14,8,8,60,43,17,50
Ballymena,66,3,14,7,9,49,49,0,49
Crusaders,66,4,13,8,9,54,45,9,47
Glenavon,66,5,12,10,8,48,44,4,46
Coleraine,66,6,12,8,10,44,40,4,44
Cliftonville,66,7,13,4,13,54,43,11,43
Glentoran,66,8,10,7,13,34,44,-10,37
Portadown,66,9,9,5,16,29,47,-18,32
Ards,66,10,9,4,17,36,52,-16,31
Ballinamalla,66,11,9,3,18,33,55,-22,30
Crusaders,67,1,19,7,4,61,32,29,64
Linfield,67,2,15,9,6,63,32,31,54
Glenavon,67,3,15,7,8,53,43,10,52
Ballymena,67,4,15,4,11,62,58,4,49
Cliftonville,67,5,13,5,12,46,42,4,44
Coleraine,67,6,9,12,9,39,44,-5,39
Dungannon,67,7,8,10,12,51,44,7,34
Ballinamalla,67,8,10,4,16,35,53,-18,34
Ards,67,9,8,7,15,30,49,-19,31
Glentoran,67,10,5,11,14,33,50,-17,26
Portadown,67,11,6,8,16,24,50,-26,26
Ballymena,68,1,17,5,8,56,49,7,56
Linfield,68,2,13,12,5,58,36,22,51
Glenavon,68,3,14,9,7,54,40,14,51
Crusaders,68,4,13,12,5,49,36,13,51
Cliftonville,68,5,15,5,10,55,42,13,50
Coleraine,68,6,11,9,10,47,39,8,42
Glentoran,68,7,9,9,12,33,40,-7,36
Dungannon,68,8,6,13,11,42,45,-3,31
Ards,68,9,7,7,16,33,48,-15,28
Ballinamalla,68,10,8,4,18,27,55,-28,28
Portadown,68,11,5,9,16,18,42,-24,24
Crusaders,69,1,16,7,7,54,38,16,55
Cliftonville,69,2,15,4,11,50,42,8,49
Linfield,69,3,13,9,8,53,33,20,48
Ballymena,69,4,14,5,11,57,60,-3,47
Coleraine,69,5,11,10,9,46,38,8,43
Dungannon,69,6,12,7,11,53,46,7,43
Glenavon,69,7,10,12,8,43,48,-5,42
Portadown,69,8,10,4,16,33,45,-12,34
Glentoran,69,9,8,9,13,35,45,-10,33
Ards,69,10,8,8,14,38,47,-9,32
Ballinamalla,69,11,7,7,16,30,50,-20,28
Crusaders,70,1,18,7,5,63,33,30,61
Cliftonville,70,2,18,4,8,67,34,33,58
Ballymena,70,3,15,5,10,53,58,-5,50
Linfield,70,4,13,8,9,51,33,18,47
Glenavon,70,5,11,11,8,45,46,-1,44
Dungannon,70,6,11,8,11,51,47,4,41
Coleraine,70,7,9,10,11,36,44,-8,37
Glentoran,70,8,7,11,12,31,45,-14,32
Ballinamalla,70,9,8,6,16,35,54,-19,30
Portadown,70,10,8,5,17,26,46,-20,29
Ards,70,11,7,5,18,35,53,-18,26
Linfield,71,1,16,10,4,59,24,35,58
Ballymena,71,2,16,6,8,67,51,16,54
Coleraine,71,3,15,9,6,48,33,15,54
Crusaders,71,4,15,6,9,52,42,10,51
Cliftonville,71,5,13,6,11,53,44,9,45
Dungannon,71,6,9,9,12,52,49,3,36
Glenavon,71,7,9,9,12,44,46,-2,36
Ards,71,8,9,6,15,37,46,-9,33
Glentoran,71,9,8,9,13,29,46,-17,33
Portadown,71,10,9,4,17,30,63,-33,31
Ballinamalla,71,11,7,4,19,28,55,-27,25
Crusaders,72,1,17,9,4,61,32,29,60
Ballymena,72,2,17,5,8,66,56,10,56
Coleraine,72,3,13,9,8,44,39,5,48
Linfield,72,4,12,10,8,56,36,20,46
Cliftonville,72,5,13,4,13,46,38,8,43
Glenavon,72,6,11,10,9,48,45,3,43
Glentoran,72,7,11,8,11,35,44,-9,41
Dungannon,72,8,8,10,12,45,46,-1,34
Ards,72,9,8,6,16,38,55,-17,30
Ballinamalla,72,10,6,8,16,26,48,-22,26
Portadown,72,11,7,5,18,30,56,-26,26
Crusaders,73,1,18,7,5,63,35,28,61
Cliftonville,73,2,16,4,10,59,41,18,52
Linfield,73,3,13,12,5,60,30,30,51
Ballymena,73,4,14,7,9,59,58,1,49
Coleraine,73,5,11,11,8,47,43,4,44
Dungannon,73,6,10,8,12,48,47,1,38
Glenavon,73,7,8,12,10,50,56,-6,36
Glentoran,73,8,9,8,13,35,50,-15,35
Ards,73,9,8,8,14,34,47,-13,32
Portadown,73,10,9,3,18,25,44,-19,30
Ballinamalla,73,11,8,2,20,33,62,-29,26
Crusaders,74,1,15,10,5,54,29,25,55
Ballymena,74,2,16,7,7,72,54,18,55
Linfield,74,3,14,9,7,61,37,24,51
Cliftonville,74,4,16,3,11,54,43,11,51
Glenavon,74,5,11,14,5,46,36,10,47
Coleraine,74,6,11,11,8,47,44,3,44
Dungannon,74,7,9,11,10,47,44,3,38
Glentoran,74,8,8,6,16,29,49,-20,30
Ards,74,9,7,7,16,39,54,-15,28
Portadown,74,10,5,11,14,28,54,-26,26
Ballinamalla,74,11,5,7,18,29,62,-33,22
Linfield,75,1,14,11,5,58,26,32,53
Crusaders,75,2,15,8,7,52,34,18,53
Coleraine,75,3,14,11,5,52,36,16,53
Cliftonville,75,4,15,4,11,51,38,13,49
Glenavon,75,5,13,10,7,51,46,5,49
Ballymena,75,6,12,5,13,54,60,-6,41
Dungannon,75,7,9,12,9,53,46,7,39
Ards,75,8,11,3,16,42,55,-13,36
Glentoran,75,9,9,8,13,35,49,-14,35
Portadown,75,10,7,4,19,19,45,-26,25
Ballinamalla,75,11,6,4,20,30,62,-32,22
Crusaders,76,1,18,7,5,55,32,23,61
Cliftonville,76,2,15,7,8,53,36,17,52
Glenavon,76,3,14,8,8,52,42,10,50
Linfield,76,4,13,10,7,51,34,17,49
Coleraine,76,5,12,10,8,43,40,3,46
Ballymena,76,6,13,7,10,59,60,-1,46
Dungannon,76,7,10,9,11,50,44,6,39
Ards,76,8,11,3,16,40,52,-12,36
Glentoran,76,9,9,8,13,32,41,-9,35
Ballinamalla,76,10,7,2,21,27,52,-25,23
Portadown,76,11,5,5,20,26,55,-29,20
Linfield,77,1,15,10,5,60,30,30,55
Cliftonville,77,2,16,6,8,53,34,19,54
Crusaders,77,3,14,9,7,55,41,14,51
Coleraine,77,4,13,11,6,43,31,12,50
Glenavon,77,5,11,13,6,50,46,4,46
Glentoran,77,6,12,5,13,36,41,-5,41
Ballymena,77,7,10,9,11,49,55,-6,39
Ards,77,8,10,5,15,41,54,-13,35
Dungannon,77,9,8,7,15,43,45,-2,31
Portadown,77,10,8,7,15,21,40,-19,31
Ballinamalla,77,11,6,2,22,31,65,-34,20
Glenavon,78,1,15,9,6,55,43,12,54
Ballymena,78,2,15,6,9,59,53,6,51
Linfield,78,3,14,8,8,56,41,15,50
Crusaders,78,4,14,8,8,52,40,12,50
Cliftonville,78,5,12,7,11,49,43,6,43
Coleraine,78,6,11,9,10,48,42,6,42
Glentoran,78,7,11,8,11,34,41,-7,41
Dungannon,78,8,9,13,8,49,37,12,40
Ballinamalla,78,9,8,7,15,28,48,-20,31
Ards,78,10,7,5,18,35,56,-21,26
Portadown,78,11,6,6,18,25,46,-21,24
Linfield,79,1,16,8,6,64,32,32,56
Ballymena,79,2,17,5,8,60,52,8,56
Crusaders,79,3,15,9,6,56,34,22,54
Cliftonville,79,4,14,4,12,56,45,11,46
Coleraine,79,5,12,10,8,42,36,6,46
Ards,79,6,11,5,14,40,49,-9,38
Dungannon,79,7,9,9,12,45,51,-6,36
Glenavon,79,8,7,14,9,46,46,0,35
Glentoran,79,9,9,7,14,29,41,-12,34
Portadown,79,10,9,3,18,20,45,-25,30
Ballinamalla,79,11,7,4,19,28,55,-27,25
Crusaders,80,1,15,8,7,54,35,19,53
Linfield,80,2,14,10,6,65,37,28,52
Coleraine,80,3,14,8,8,41,34,7,50
Cliftonville,80,4,15,3,12,48,45,3,48
Glenavon,80,5,12,10,8,51,49,2,46
Dungannon,80,6,11,9,10,57,45,12,42
Ballymena,80,7,11,5,14,53,65,-12,38
Portadown,80,8,9,6,15,25,41,-16,33
Ards,80,9,8,8,14,37,48,-11,32
Glentoran,80,10,9,5,16,34,47,-13,32
Ballinamalla,80,11,9,4,17,33,52,-19,31
Cliftonville,81,1,15,7,8,54,33,21,52
Ballymena,81,2,15,7,8,59,55,4,52
Linfield,81,3,13,9,8,58,35,23,48
Crusaders,81,4,13,8,9,48,42,6,47
Glenavon,81,5,11,12,7,50,43,7,45
Coleraine,81,6,9,14,7,43,39,4,41
Dungannon,81,7,9,9,12,46,48,-2,36
Glentoran,81,8,9,8,13,25,40,-15,35
Portadown,81,9,9,5,16,33,49,-16,32
Ballinamalla,81,10,8,7,15,31,51,-20,31
Ards,81,11,8,6,16,38,50,-12,30
Crusaders,82,1,17,10,3,60,32,28,61
Linfield,82,2,14,10,6,59,36,23,52
Glenavon,82,3,13,11,6,55,40,15,50
Ballymena,82,4,14,6,10,50,53,-3,48
Coleraine,82,5,12,9,9,44,42,2,45
Dungannon,82,6,10,10,10,56,43,13,40
Cliftonville,82,7,12,4,14,48,45,3,40
Glentoran,82,8,10,7,13,36,48,-12,37
Ards,82,9,9,6,15,33,50,-17,33
Portadown,82,10,9,4,17,35,50,-15,31
Ballinamalla,82,11,4,5,21,25,62,-37,17
Crusaders,83,1,16,8,6,57,38,19,56
Linfield,83,2,15,7,8,61,34,27,52
Cliftonville,83,3,15,6,9,52,39,13,51
Glenavon,83,4,13,10,7,54,45,9,49
Coleraine,83,5,11,11,8,44,45,-1,44
Ballymena,83,6,12,7,11,57,62,-5,43
Dungannon,83,7,11,9,10,55,47,8,42
Glentoran,83,8,10,8,12,35,45,-10,38
Ards,83,9,9,8,13,38,46,-8,35
Portadown,83,10,5,7,18,24,50,-26,22
Ballinamalla,83,11,5,5,20,24,50,-26,20
Crusaders,84,1,17,7,6,61,35,26,58
Ballymena,84,2,14,8,8,63,56,7,50
Linfield,84,3,13,8,9,53,33,20,47
Coleraine,84,4,12,10,8,41,46,-5,46
Cliftonville,84,5,12,8,10,43,35,8,44
Glenavon,84,6,9,14,7,45,44,1,41
Glentoran,84,7,10,9,11,30,40,-10,39
Ards,84,8,9,7,14,33,42,-9,34
Ballinamalla,84,9,8,7,15,38,52,-14,31
Dungannon,84,10,6,10,14,43,48,-5,28
Portadown,84,11,6,10,14,22,41,-19,28
Crusaders,85,1,17,7,6,60,33,27,58
Ballymena,85,2,17,7,6,64,52,12,58
Linfield,85,3,14,9,7,55,29,26,51
Cliftonville,85,4,14,7,9,49,39,10,49
Ards,85,5,12,5,13,41,44,-3,41
Coleraine,85,6,9,11,10,37,42,-5,38
Glenavon,85,7,8,13,9,53,52,1,37
Glentoran,85,8,8,7,15,31,50,-19,31
Portadown,85,9,8,7,15,29,48,-19,31
Dungannon,85,10,7,9,14,47,49,-2,30
Ballinamalla,85,11,7,6,17,31,59,-28,27
Crusaders,86,1,17,4,9,54,43,11,55
Coleraine,86,2,14,10,6,49,34,15,52
Cliftonville,86,3,14,6,10,50,38,12,48
Ballymena,86,4,14,6,10,58,56,2,48
Glenavon,86,5,13,8,9,44,43,1,47
Linfield,86,6,10,12,8,53,35,18,42
Dungannon,86,7,9,10,11,54,47,7,37
Glentoran,86,8,9,8,13,33,46,-13,35
Ballinamalla,86,9,10,4,16,32,52,-20,34
Ards,86,10,8,8,14,37,46,-9,32
Portadown,86,11,5,8,17,25,49,-24,23
Cliftonville,87,1,20,2,8,65,35,30,62
Linfield,87,2,16,9,5,61,31,30,57
Crusaders,87,3,15,6,9,48,31,17,51
Glenavon,87,4,13,11,6,46,34,12,50
Coleraine,87,5,12,10,8,40,38,2,46
Ballymena,87,6,11,9,10,53,60,-7,42
Ards,87,7,10,4,16,38,52,-14,34
Dungannon,87,8,8,9,13,48,51,-3,33
Glentoran,87,9,9,5,16,26,46,-20,32
Ballinamalla,87,10,9,2,19,31,53,-22,29
Portadown,87,11,6,5,19,28,53,-25,23
Crusaders,88,1,18,8,4,61,32,29,62
Cliftonville,88,2,17,4,9,62,38,24,55
Ballymena,88,3,16,4,10,63,61,2,52
Glenavon,88,4,13,9,8,50,43,7,48
Linfield,88,5,12,9,9,49,33,16,45
Dungannon,88,6,10,10,10,52,44,8,40
Coleraine,88,7,10,10,10,41,39,2,40
Glentoran,88,8,9,11,10,33,42,-9,38
Ards,88,9,8,4,18,30,49,-19,28
Ballinamalla,88,10,8,3,19,27,54,-27,27
Portadown,88,11,5,6,19,19,52,-33,21
Cliftonville,89,1,17,5,8,51,35,16,56
Linfield,89,2,14,9,7,60,37,23,51
Crusaders,89,3,14,9,7,52,34,18,51
Glenavon,89,4,12,10,8,49,51,-2,46
Coleraine,89,5,11,11,8,46,45,1,44
Ballymena,89,6,11,7,12,60,64,-4,40
Ballinamalla,89,7,9,7,14,42,49,-7,34
Ards,89,8,10,4,16,42,55,-13,34
Glentoran,89,9,8,9,13,35,45,-10,33
Portadown,89,10,9,6,15,31,47,-16,33
Dungannon,89,11,7,9,14,47,53,-6,30
Crusaders,90,1,20,6,4,69,35,34,66
Glenavon,90,2,12,11,7,54,45,9,47
Cliftonville,90,3,13,8,9,49,42,7,47
Ballymena,90,4,13,8,9,60,62,-2,47
Coleraine,90,5,12,10,8,49,37,12,46
Linfield,90,6,10,13,7,51,33,18,43
Ards,90,7,10,7,13,41,48,-7,37
Glentoran,90,8,10,7,13,31,43,-12,37
Dungannon,90,9,8,9,13,51,56,-5,33
Portadown,90,10,6,9,15,21,43,-22,27
Ballinamalla,90,11,5,4,21,27,59,-32,19
Crusaders,91,1,16,7,7,49,31,18,55
Cliftonville,91,2,16,4,10,49,38,11,52
Linfield,91,3,11,12,7,54,35,19,45
Dungannon,91,4,12,9,9,56,44,12,45
Ballymena,91,5,13,6,11,54,57,-3,45
Coleraine,91,6,11,11,8,47,39,8,44
Glenavon,91,7,9,11,10,49,54,-5,38
Glentoran,91,8,9,10,11,35,43,-8,37
Ballinamalla,91,9,10,4,16,30,46,-16,34
Ards,91,10,9,6,15,37,53,-16,33
Portadown,91,11,6,6,18,28,48,-20,24
Linfield,92,1,15,9,6,63,34,29,54
Crusaders,92,2,15,7,8,52,37,15,52
Cliftonville,92,3,12,9,9,52,42,10,45
Coleraine,92,4,12,8,10,43,34,9,44
Glenavon,92,5,11,11,8,47,45,2,44
Glentoran,92,6,12,8,10,39,39,0,44
Ballymena,92,7,13,5,12,52,57,-5,44
Dungannon,92,8,11,8,11,46,43,3,41
Ballinamalla,92,9,9,7,14,31,48,-17,34
Portadown,92,10,8,5,17,28,52,-24,29
Ards,92,11,6,5,19,32,54,-22,23
Linfield,93,1,16,10,4,60,30,30,58
Crusaders,93,2,16,8,6,56,39,17,56
Cliftonville,93,3,15,6,9,54,39,15,51
Glenavon,93,4,12,12,6,55,48,7,48
Coleraine,93,5,11,10,9,47,45,2,43
Ballymena,93,6,12,6,12,53,61,-8,42
Ards,93,7,10,7,13,43,48,-5,37
Dungannon,93,8,7,11,12,49,47,2,32
Glentoran,93,9,7,8,15,33,50,-17,29
Portadown,93,10,6,9,15,26,45,-19,27
Ballinamalla,93,11,7,5,18,35,59,-24,26
Cliftonville,94,1,18,3,9,61,37,24,57
Crusaders,94,2,17,5,8,58,39,19,56
Linfield,94,3,15,10,5,52,25,27,55
Glenavon,94,4,12,11,7,43,38,5,47
Glentoran,94,5,12,8,10,35,38,-3,44
Ballymena,94,6,13,5,12,49,58,-9,44
Coleraine,94,7,9,11,10,38,40,-2,38
Ards,94,8,9,7,14,44,49,-5,34
Dungannon,94,9,8,9,13,50,51,-1,33
Ballinamalla,94,10,6,6,18,30,61,-31,24
Portadown,94,11,4,9,17,18,42,-24,21
Cliftonville,95,1,19,5,6,61,32,29,62
Crusaders,95,2,18,7,5,60,34,26,61
Linfield,95,3,15,8,7,54,29,25,53
Ballymena,95,4,14,7,9,62,57,5,49
Glenavon,95,5,10,9,11,42,50,-8,39
Dungannon,95,6,10,7,13,49,43,6,37
Coleraine,95,7,9,10,11,37,42,-5,37
Portadown,95,8,10,4,16,28,49,-21,34
Ards,95,9,9,4,17,36,48,-12,31
Glentoran,95,10,7,8,15,31,52,-21,29
Ballinamalla,95,11,7,5,18,27,51,-24,26
Crusaders,96,1,17,8,5,59,34,25,59
Linfield,96,2,16,9,5,62,29,33,57
Ballymena,96,3,16,5,9,66,65,1,53
Glenavon,96,4,13,8,9,44,42,2,47
Cliftonville,96,5,14,4,12,54,46,8,46
Coleraine,96,6,11,10,9,50,53,-3,43
Dungannon,96,7,9,10,11,50,44,6,37
Ards,96,8,10,4,16,30,43,-13,34
Ballinamalla,96,9,9,5,16,33,48,-15,32
Glentoran,96,10,7,7,16,30,49,-19,28
Portadown,96,11,6,4,20,23,48,-25,22
Linfield,97,1,17,7,6,59,26,33,58
Crusaders,97,2,15,7,8,51,33,18,52
Ballymena,97,3,14,7,9,57,53,4,49
Cliftonville,97,4,14,6,10,46,35,11,48
Glenavon,97,5,11,11,8,47,41,6,44
Dungannon,97,6,10,11,9,43,39,4,41
Coleraine,97,7,10,9,11,34,39,-5,39
Ards,97,8,11,4,15,40,48,-8,37
Glentoran,97,9,7,9,14,27,45,-18,30
Ballinamalla,97,10,8,5,17,28,46,-18,29
Portadown,97,11,6,8,16,22,49,-27,26
Cliftonville,98,1,17,5,8,57,37,20,56
Crusaders,98,2,17,5,8,50,37,13,56
Linfield,98,3,15,9,6,62,28,34,54
Glenavon,98,4,13,12,5,52,41,11,51
Coleraine,98,5,11,12,7,46,38,8,45
Ballymena,98,6,12,8,10,58,60,-2,44
Dungannon,98,7,11,6,13,50,51,-1,39
Glentoran,98,8,10,7,13,36,46,-10,37
Portadown,98,9,7,4,19,28,52,-24,25
Ballinamalla,98,10,7,4,19,28,54,-26,25
Ards,98,11,6,6,18,33,56,-23,24
Crusaders,99,1,18,8,4,55,29,26,62
Linfield,99,2,17,7,6,65,35,30,58
Ballymena,99,3,17,5,8,68,59,9,56
Coleraine,99,4,13,10,7,45,36,9,49
Cliftonville,99,5,14,5,11,53,42,11,47
Dungannon,99,6,11,10,9,51,39,12,43
Glenavon,99,7,9,8,13,41,54,-13,35
Glentoran,99,8,9,5,16,28,55,-27,32
Ballinamalla,99,9,9,4,17,35,48,-13,31
Ards,99,10,7,4,19,36,54,-18,25
Portadown,99,11,6,4,20,27,53,-26,22
Crusaders,100,1,19,6,5,68,41,27,63
Cliftonville,100,2,15,6,9,49,37,12,51
Linfield,100,3,14,8,8,58,37,21,50
Coleraine,100,4,12,9,9,44,35,9,45
Ballymena,100,5,13,6,11,67,66,1,45
Glenavon,100,6,10,12,8,48,49,-1,42
Dungannon,100,7,11,8,11,49,43,6,41
Ards,100,8,10,8,12,34,41,-7,38
Ballinamalla,100,9,8,4,18,31,49,-18,28
Glentoran,100,10,7,7,16,30,53,-23,28
Portadown,100,11,6,6,18,21,48,-27,24
Linfield,101,1,18,6,6,66,32,34,60
Cliftonville,101,2,19,3,8,53,32,21,60
Crusaders,101,3,18,5,7,58,32,26,59
Coleraine,101,4,13,10,7,46,37,9,49
Glenavon,101,5,12,8,10,47,45,2,44
Ballymena,101,6,11,10,9,50,60,-10,43
Dungannon,101,7,8,10,12,43,46,-3,34
Ards,101,8,9,4,17,37,50,-13,31
Portadown,101,9,8,5,17,27,46,-19,29
Glentoran,101,10,6,8,16,28,50,-22,26
Ballinamalla,101,11,7,3,20,24,49,-25,24
Linfield,102,1,14,13,3,56,28,28,55
Crusaders,102,2,13,9,8,52,37,15,48
Cliftonville,102,3,14,6,10,54,45,9,48
Glenavon,102,4,11,13,6,51,44,7,46
Coleraine,102,5,11,11,8,41,39,2,44
Dungannon,102,6,11,9,10,47,42,5,42
Ballymena,102,7,11,9,10,51,51,0,42
Glentoran,102,8,10,7,13,34,42,-8,37
Portadown,102,9,9,5,16,26,42,-16,32
Ards,102,10,9,2,19,36,50,-14,29
Ballinamalla,102,11,7,6,17,24,52,-28,27
Linfield,103,1,15,9,6,62,29,33,54
Glenavon,103,2,14,8,8,52,41,11,50
Cliftonville,103,3,14,7,9,49,37,12,49
Ballymena,103,4,14,7,9,58,59,-1,49
Dungannon,103,5,12,8,10,58,46,12,44
Coleraine,103,6,11,10,9,42,37,5,43
Glentoran,103,7,12,6,12,36,42,-6,42
Crusaders,103,8,11,8,11,50,49,1,41
Ballinamalla,103,9,11,3,16,33,49,-16,36
Ards,103,10,8,4,18,34,52,-18,28
Portadown,103,11,6,4,20,18,51,-33,22
Linfield,104,1,18,8,4,72,34,38,62
Crusaders,104,2,18,6,6,52,32,20,60
Cliftonville,104,3,15,5,10,54,45,9,50
Coleraine,104,4,12,10,8,43,37,6,46
Glenavon,104,5,12,10,8,53,49,4,46
Ballymena,104,6,12,6,12,59,67,-8,42
Dungannon,104,7,11,7,12,55,51,4,40
Glentoran,104,8,9,8,13,31,44,-13,35
Ards,104,9,9,5,16,41,48,-7,32
Portadown,104,10,7,5,18,23,47,-24,26
Ballinamalla,104,11,6,2,22,33,62,-29,20
Linfield,105,1,18,8,4,64,32,32,62
Crusaders,105,2,18,6,6,61,32,29,60
Cliftonville,105,3,14,8,8,47,37,10,50
Glenavon,105,4,11,13,6,46,37,9,46
Dungannon,105,5,11,8,11,51,40,11,41
Ballymena,105,6,11,8,11,55,60,-5,41
Glentoran,105,7,11,6,13,33,42,-9,39
Coleraine,105,8,9,10,11,35,38,-3,37
Ards,105,9,9,6,15,39,51,-12,33
Ballinamalla,105,10,7,3,20,30,58,-28,24
Portadown,105,11,5,6,19,18,52,-34,21
Cliftonville,106,1,16,7,7,46,32,14,55
Crusaders,106,2,15,6,9,53,31,22,51
Ballymena,106,3,13,9,8,56,52,4,48
Linfield,106,4,12,10,8,55,35,20,46
Coleraine,106,5,11,12,7,48,43,5,45
Dungannon,106,6,11,10,9,46,37,9,43
Glenavon,106,7,11,10,9,53,47,6,43
Ballinamalla,106,8,11,2,17,34,52,-18,35
Portadown,106,9,8,6,16,24,43,-19,30
Ards,106,10,7,8,15,39,54,-15,29
Glentoran,106,11,6,8,16,27,55,-28,26
Cliftonville,107,1,18,4,8,56,39,17,58
Coleraine,107,2,14,9,7,45,33,12,51
Crusaders,107,3,15,5,10,55,41,14,50
Dungannon,107,4,13,9,8,52,38,14,48
Ballymena,107,5,14,4,12,53,58,-5,46
Linfield,107,6,12,8,10,55,40,15,44
Glenavon,107,7,9,10,11,51,45,6,37
Ards,107,8,10,6,14,36,42,-6,36
Ballinamalla,107,9,9,4,17,29,49,-20,31
Glentoran,107,10,8,7,15,24,46,-22,31
Portadown,107,11,7,6,17,24,49,-25,27
Cliftonville,108,1,18,4,8,63,37,26,58
Crusaders,108,2,17,7,6,59,40,19,58
Linfield,108,3,14,10,6,56,36,20,52
Coleraine,108,4,12,9,9,44,43,1,45
Ballymena,108,5,12,8,10,62,67,-5,44
Dungannon,108,6,12,6,12,54,44,10,42
Glenavon,108,7,9,12,9,48,48,0,39
Glentoran,108,8,9,7,14,40,45,-5,34
Ards,108,9,9,5,16,39,53,-14,32
Ballinamalla,108,10,7,6,17,33,55,-22,27
Portadown,108,11,5,8,17,20,50,-30,23
Crusaders,109,1,18,6,6,57,35,22,60
Linfield,109,2,16,8,6,59,29,30,56
Coleraine,109,3,13,9,8,48,39,9,48
Cliftonville,109,4,14,5,11,53,44,9,47
Ballymena,109,5,12,8,10,54,56,-2,44
Dungannon,109,6,9,12,9,45,38,7,39
Ards,109,7,11,4,15,44,48,-4,37
Glenavon,109,8,8,11,11,40,44,-4,35
Glentoran,109,9,7,9,14,31,50,-19,30
Ballinamalla,109,10,7,8,15,27,47,-20,29
Portadown,109,11,8,4,18,24,52,-28,28
Crusaders,110,1,18,7,5,55,30,25,61
Cliftonville,110,2,17,3,10,54,36,18,54
Linfield,110,3,13,12,5,56,31,25,51
Coleraine,110,4,12,10,8,45,40,5,46
Glenavon,110,5,10,11,9,46,50,-4,41
Ballymena,110,6,11,7,12,50,63,-13,40
Dungannon,110,7,9,10,11,54,46,8,37
Glentoran,110,8,10,6,14,30,40,-10,36
Ballinamalla,110,9,10,4,16,36,52,-16,34
Ards,110,10,9,3,18,41,53,-12,30
Portadown,110,11,7,5,18,23,49,-26,26
Dungannon,111,1,14,9,7,56,37,19,51
Crusaders,111,2,14,8,8,47,36,11,50
Glenavon,111,3,14,8,8,54,46,8,50
Cliftonville,111,4,15,4,11,56,42,14,49
Linfield,111,5,13,9,8,54,36,18,48
Coleraine,111,6,12,10,8,47,43,4,46
Ballymena,111,7,12,5,13,56,60,-4,41
Glentoran,111,8,10,8,12,31,38,-7,38
Ards,111,9,9,6,15,36,46,-10,33
Portadown,111,10,8,6,16,26,45,-19,30
Ballinamalla,111,11,5,5,20,27,61,-34,20
Crusaders,112,1,15,9,6,56,35,21,54
Cliftonville,112,2,16,4,10,55,41,14,52
Linfield,112,3,14,9,7,56,31,25,51
Ballymena,112,4,12,6,12,50,56,-6,42
Ards,112,5,12,5,13,42,42,0,41
Glenavon,112,6,10,11,9,48,51,-3,41
Dungannon,112,7,9,11,10,54,47,7,38
Coleraine,112,8,9,11,10,33,38,-5,38
Glentoran,112,9,10,8,12,31,43,-12,38
Portadown,112,10,8,5,17,29,48,-19,29
Ballinamalla,112,11,8,5,17,37,59,-22,29
Cliftonville,113,1,19,3,8,61,39,22,60
Glenavon,113,2,15,10,5,55,40,15,55
Ballymena,113,3,13,9,8,58,54,4,48
Linfield,113,4,11,14,5,55,30,25,47
Crusaders,113,5,13,7,10,51,43,8,46
Dungannon,113,6,11,8,11,54,42,12,41
Ards,113,7,11,4,15,35,47,-12,37
Coleraine,113,8,8,12,10,38,41,-3,36
Portadown,113,9,8,7,15,26,45,-19,31
Ballinamalla,113,10,8,4,18,34,60,-26,28
Glentoran,113,11,6,6,18,28,54,-26,24
Linfield,114,1,19,6,5,64,28,36,63
Crusaders,114,2,16,6,8,64,41,23,54
Cliftonville,114,3,15,5,10,47,42,5,50
Dungannon,114,4,12,10,8,57,42,15,46
Coleraine,114,5,12,9,9,47,43,4,45
Ballymena,114,6,13,5,12,55,64,-9,44
Glenavon,114,7,11,9,10,45,47,-2,42
Glentoran,114,8,10,9,11,34,42,-8,39
Ards,114,9,9,2,19,35,53,-18,29
Ballinamalla,114,10,7,5,18,29,51,-22,26
Portadown,114,11,7,2,21,23,47,-24,23
Linfield,115,1,15,9,6,60,26,34,54
Crusaders,115,2,15,9,6,57,33,24,54
Cliftonville,115,3,17,3,10,52,35,17,54
Coleraine,115,4,15,8,7,45,33,12,53
Glenavon,115,5,10,12,8,38,38,0,42
Glentoran,115,6,11,7,12,36,38,-2,40
Dungannon,115,7,10,9,11,40,38,2,39
Ballymena,115,8,11,6,13,47,64,-17,39
Ards,115,9,8,8,14,34,52,-18,32
Portadown,115,10,7,7,16,26,42,-16,28
Ballinamalla,115,11,4,6,20,24,60,-36,18
Linfield,116,1,16,11,3,70,28,42,59
Cliftonville,116,2,17,5,8,60,40,20,56
Crusaders,116,3,17,5,8,53,38,15,56
Ballymena,116,4,14,6,10,57,56,1,48
Coleraine,116,5,11,10,9,46,41,5,43
Glenavon,116,6,11,9,10,42,45,-3,42
Ballinamalla,116,7,11,3,16,34,53,-19,36
Dungannon,116,8,8,11,11,51,48,3,35
Glentoran,116,9,8,7,15,33,47,-14,31
Ards,116,10,8,5,17,35,55,-20,29
Portadown,116,11,4,8,18,19,49,-30,20
Ballymena,117,1,16,7,7,60,55,5,55
Cliftonville,117,2,16,5,9,51,37,14,53
Crusaders,117,3,14,8,8,50,35,15,50
Linfield,117,4,12,11,7,51,29,22,47
Glenavon,117,5,11,10,9,47,43,4,43
Coleraine,117,6,10,12,8,40,38,2,42
Glentoran,117,7,12,6,12,38,46,-8,42
Dungannon,117,8,10,8,12,49,46,3,38
Portadown,117,9,8,6,16,28,44,-16,30
Ards,117,10,6,8,16,35,49,-14,26
Ballinamalla,117,11,7,5,18,29,56,-27,26
Linfield,118,1,14,11,5,58,33,25,53
Cliftonville,118,2,16,5,9,54,40,14,53
Crusaders,118,3,14,7,9,49,38,11,49
Coleraine,118,4,12,10,8,40,31,9,46
Ballymena,118,5,11,10,9,54,58,-4,43
Dungannon,118,6,10,10,10,50,46,4,40
Glenavon,118,7,10,10,10,46,48,-2,40
Portadown,118,8,8,10,12,29,38,-9,34
Glentoran,118,9,8,10,12,25,36,-11,34
Ards,118,10,10,4,16,44,57,-13,34
Ballinamalla,118,11,7,3,20,33,57,-24,24
Crusaders,119,1,16,8,6,53,33,20,56
Ballymena,119,2,17,5,8,67,55,12,56
Cliftonville,119,3,16,7,7,60,40,20,55
Linfield,119,4,13,9,8,67,44,23,48
Glenavon,119,5,11,10,9,43,48,-5,43
Glentoran,119,6,11,6,13,40,48,-8,39
Coleraine,119,7,9,11,10,34,37,-3,38
Dungannon,119,8,8,8,14,45,53,-8,32
Portadown,119,9,8,8,14,33,47,-14,32
Ballinamalla,119,10,8,6,16,32,51,-19,30
Ards,119,11,7,4,19,32,50,-18,25
Linfield,120,1,18,7,5,63,26,37,61
Crusaders,120,2,15,10,5,51,32,19,55
Cliftonville,120,3,15,5,10,47,37,10,50
Ballymena,120,4,13,7,10,66,62,4,46
Coleraine,120,5,11,10,9,49,46,3,43
Glenavon,120,6,11,9,10,42,44,-2,42
Portadown,120,7,11,5,14,30,44,-14,38
Ards,120,8,10,4,16,37,45,-8,34
Glentoran,120,9,8,9,13,36,55,-19,33
Dungannon,120,10,7,9,14,44,50,-6,30
Ballinamalla,120,11,8,1,21,30,54,-24,25
Crusaders,121,1,17,6,7,57,41,16,57
Linfield,121,2,15,9,6,57,34,23,54
Coleraine,121,3,15,9,6,52,37,15,54
Cliftonville,121,4,16,5,9,59,44,15,53
Ballymena,121,5,16,5,9,68,57,11,53
Glenavon,121,6,14,9,7,57,45,12,51
Dungannon,121,7,10,9,11,48,41,7,39
Glentoran,121,8,8,8,14,31,48,-17,32
Ards,121,9,7,3,20,36,61,-25,24
Portadown,121,10,6,5,19,23,46,-23,23
Ballinamalla,121,11,3,8,19,22,56,-34,17
Crusaders,122,1,18,8,4,58,31,27,62
Linfield,122,2,15,9,6,62,34,28,54
Ballymena,122,3,15,4,11,53,54,-1,49
Cliftonville,122,4,14,5,11,47,32,15,47
Coleraine,122,5,11,11,8,39,38,1,44
Ards,122,6,12,6,12,42,44,-2,42
Dungannon,122,7,10,10,10,48,43,5,40
Glenavon,122,8,7,15,8,43,44,-1,36
Glentoran,122,9,6,8,16,28,50,-22,26
Portadown,122,10,6,7,17,26,49,-23,25
Ballinamalla,122,11,6,7,17,24,51,-27,25
Crusaders,123,1,17,5,8,54,39,15,56
Cliftonville,123,2,15,4,11,54,43,11,49
Glenavon,123,3,13,8,9,58,47,11,47
Ballymena,123,4,13,8,9,61,58,3,47
Linfield,123,5,12,10,8,54,34,20,46
Coleraine,123,6,12,10,8,46,42,4,46
Dungannon,123,7,11,7,12,55,53,2,40
Ards,123,8,11,5,14,39,47,-8,38
Ballinamalla,123,9,11,4,15,36,53,-17,37
Glentoran,123,10,8,6,16,28,45,-17,30
Portadown,123,11,4,9,17,25,49,-24,21
Ballymena,124,1,16,4,10,63,55,8,52
Crusaders,124,2,14,9,7,57,41,16,51
Cliftonville,124,3,16,3,11,51,37,14,51
Linfield,124,4,12,10,8,59,41,18,46
Glenavon,124,5,10,12,8,51,49,2,42
Glentoran,124,6,11,9,10,29,36,-7,42
Coleraine,124,7,9,13,8,42,39,3,40
Dungannon,124,8,9,9,12,49,51,-2,36
Portadown,124,9,10,5,15,32,42,-10,35
Ballinamalla,124,10,8,5,17,38,58,-20,29
Ards,124,11,8,5,17,35,57,-22,29
Crusaders,125,1,19,7,4,63,32,31,64
Linfield,125,2,14,12,4,58,28,30,54
Cliftonville,125,3,15,5,10,57,40,17,50
Coleraine,125,4,12,12,6,45,35,10,48
Glenavon,125,5,13,7,10,50,45,5,46
Ballymena,125,6,11,8,11,58,62,-4,41
Dungannon,125,7,9,8,13,45,45,0,35
Ballinamalla,125,8,10,3,17,28,47,-19,33
Ards,125,9,9,4,17,28,55,-27,31
Glentoran,125,10,7,8,15,34,53,-19,29
Portadown,125,11,6,6,18,18,42,-24,24
Linfield,126,1,16,6,8,51,24,27,54
Crusaders,126,2,15,9,6,57,35,22,54
Glenavon,126,3,12,10,8,52,48,4,46
Ballymena,126,4,13,7,10,49,49,0,46
Cliftonville,126,5,13,5,12,47,42,5,44
Dungannon,126,6,11,9,10,51,46,5,42
Coleraine,126,7,10,11,9,38,39,-1,41
Ards,126,8,11,5,14,35,42,-7,38
Portadown,126,9,9,5,16,28,42,-14,32
Glentoran,126,10,7,9,14,26,41,-15,30
Ballinamalla,126,11,8,4,18,29,55,-26,28
Crusaders,127,1,16,10,4,57,33,24,58
Cliftonville,127,2,16,2,12,52,36,16,50
Coleraine,127,3,13,10,7,46,36,10,49
Ballymena,127,4,13,7,10,59,61,-2,46
Glenavon,127,5,12,9,9,57,40,17,45
Linfield,127,6,11,9,10,56,41,15,42
Glentoran,127,7,12,6,12,34,47,-13,42
Dungannon,127,8,11,8,11,50,44,6,41
Ards,127,9,9,3,18,38,52,-14,30
Ballinamalla,127,10,8,5,17,27,60,-33,29
Portadown,127,11,7,5,18,25,51,-26,26
Crusaders,128,1,19,6,5,63,30,33,63
Cliftonville,128,2,17,5,8,53,42,11,56
Linfield,128,3,14,10,6,58,35,23,52
Glentoran,128,4,12,7,11,33,36,-3,43
Coleraine,128,5,10,11,9,41,40,1,41
Ballymena,128,6,12,5,13,63,64,-1,41
Glenavon,128,7,9,10,11,44,50,-6,37
Dungannon,128,8,8,11,11,46,46,0,35
Ards,128,9,9,5,16,39,50,-11,32
Portadown,128,10,8,5,17,27,47,-20,29
Ballinamalla,128,11,8,3,19,27,54,-27,27
Crusaders,129,1,18,6,6,61,34,27,60
Ballymena,129,2,16,8,6,62,50,12,56
Cliftonville,129,3,15,5,10,49,41,8,50
Linfield,129,4,14,6,10,53,33,20,48
Dungannon,129,5,12,7,11,48,41,7,43
Coleraine,129,6,11,9,10,42,43,-1,42
Glenavon,129,7,9,9,12,45,48,-3,36
Ballinamalla,129,8,11,3,16,36,54,-18,36
Glentoran,129,9,8,10,12,32,46,-14,34
Ards,129,10,9,3,18,36,49,-13,30
Portadown,129,11,7,4,19,21,46,-25,25
Linfield,130,1,16,10,4,65,29,36,58
Crusaders,130,2,15,7,8,48,37,11,52
Cliftonville,130,3,13,7,10,49,42,7,46
Glentoran,130,4,13,6,11,37,40,-3,45
Dungannon,130,5,12,8,10,53,45,8,44
Glenavon,130,6,11,11,8,48,44,4,44
Coleraine,130,7,11,10,9,45,37,8,43
Ballymena,130,8,11,5,14,44,56,-12,38
Ards,130,9,9,5,16,35,49,-14,32
Portadown,130,10,8,4,18,27,48,-21,28
Ballinamalla,130,11,6,7,17,25,49,-24,25
Crusaders,131,1,16,8,6,56,38,18,56
Cliftonville,131,2,16,4,10,57,42,15,52
Ballymena,131,3,15,7,8,61,55,6,52
Linfield,131,4,14,7,9,55,36,19,49
Glenavon,131,5,13,10,7,60,51,9,49
Dungannon,131,6,12,8,10,59,49,10,44
Coleraine,131,7,10,10,10,42,35,7,40
Glentoran,131,8,10,8,12,29,40,-11,38
Ards,131,9,9,4,17,34,55,-21,31
Ballinamalla,131,10,6,6,18,32,59,-27,24
Portadown,131,11,6,4,20,27,52,-25,22
Ballymena,132,1,15,8,7,51,49,2,53
Cliftonville,132,2,16,4,10,53,39,14,52
Crusaders,132,3,13,10,7,55,39,16,49
Coleraine,132,4,12,11,7,39,35,4,47
Linfield,132,5,11,12,7,55,32,23,45
Glenavon,132,6,10,10,10,40,40,0,40
Dungannon,132,7,9,11,10,48,42,6,38
Ballinamalla,132,8,10,4,16,32,48,-16,34
Glentoran,132,9,7,12,11,30,43,-13,33
Ards,132,10,9,4,17,36,51,-15,31
Portadown,132,11,7,6,17,21,42,-21,27
Crusaders,133,1,21,5,4,60,29,31,68
Cliftonville,133,2,17,4,9,61,41,20,55
Coleraine,133,3,13,10,7,47,33,14,49
Ballymena,133,4,14,6,10,55,59,-4,48
Linfield,133,5,11,11,8,56,35,21,44
Glenavon,133,6,9,14,7,44,44,0,41
Dungannon,133,7,9,10,11,50,45,5,37
Ards,133,8,9,7,14,31,44,-13,34
Glentoran,133,9,8,9,13,32,45,-13,33
Portadown,133,10,5,7,18,21,50,-29,22
Ballinamalla,133,11,7,1,22,26,58,-32,22
Linfield,134,1,14,11,5,52,24,28,53
Dungannon,134,2,14,9,7,62,38,24,51
Crusaders,134,3,14,9,7,52,36,16,51
Coleraine,134,4,13,10,7,43,32,11,49
Cliftonville,134,5,12,9,9,44,40,4,45
Ballymena,134,6,13,6,11,51,59,-8,45
Glenavon,134,7,7,16,7,44,47,-3,37
Glentoran,134,8,9,8,13,24,36,-12,35
Ballinamalla,134,9,8,7,15,29,51,-22,31
Ards,134,10,8,5,17,37,54,-17,29
Portadown,134,11,5,6,19,25,46,-21,21
Crusaders,135,1,21,6,3,62,28,34,69
Cliftonville,135,2,17,7,6,59,31,28,58
Linfield,135,3,12,12,6,56,33,23,48
Glenavon,135,4,13,8,9,55,53,2,47
Ballymena,135,5,13,7,10,56,57,-1,46
Coleraine,135,6,9,10,11,36,39,-3,37
Dungannon,135,7,9,9,12,44,48,-4,36
Portadown,135,8,11,3,16,26,44,-18,36
Ards,135,9,8,5,17,38,54,-16,29
Glentoran,135,10,7,7,16,24,44,-20,28
Ballinamalla,135,11,5,6,19,33,58,-25,21
Crusaders,136,1,18,7,5,59,33,26,61
Linfield,136,2,16,9,5,69,34,35,57
Cliftonville,136,3,17,3,10,64,41,23,54
Ballymena,136,4,14,6,10,61,61,0,48
Glenavon,136,5,11,8,11,46,47,-1,41
Coleraine,136,6,10,10,10,39,41,-2,40
Glentoran,136,7,10,6,14,31,48,-17,36
Dungannon,136,8,8,9,13,45,47,-2,33
Portadown,136,9,8,7,15,25,43,-18,31
Ballinamalla,136,10,9,3,18,31,58,-27,30
Ards,136,11,9,2,19,35,52,-17,29
Crusaders,137,1,16,9,5,65,43,22,57
Ballymena,137,2,16,6,8,73,59,14,54
Linfield,137,3,13,10,7,63,40,23,49
Cliftonville,137,4,14,7,9,47,38,9,49
Coleraine,137,5,10,13,7,41,32,9,43
Glenavon,137,6,9,15,6,48,44,4,42
Ards,137,7,10,8,12,42,43,-1,38
Dungannon,137,8,8,11,11,48,48,0,35
Ballinamalla,137,9,8,5,17,23,50,-27,29
Glentoran,137,10,7,6,17,28,58,-30,27
Portadown,137,11,4,10,16,26,49,-23,22
Crusaders,138,1,19,6,5,57,34,23,63
Cliftonville,138,2,19,3,8,60,32,28,60
Linfield,138,3,16,8,6,58,25,33,56
Ballymena,138,4,15,5,10,54,53,1,50
Glenavon,138,5,12,10,8,49,43,6,46
Glentoran,138,6,11,7,12,36,42,-6,40
Coleraine,138,7,8,12,10,40,46,-6,36
Dungannon,138,8,8,9,13,45,50,-5,33
Ards,138,9,9,6,15,37,49,-12,33
Ballinamalla,138,10,6,4,20,24,54,-30,22
Portadown,138,11,4,6,20,20,52,-32,18
Linfield,139,1,17,9,4,70,29,41,60
Crusaders,139,2,16,8,6,51,29,22,56
Cliftonville,139,3,17,2,11,48,44,4,53
Ballymena,139,4,13,7,10,57,54,3,46
Dungannon,139,5,13,6,11,51,41,10,45
Coleraine,139,6,12,8,10,44,38,6,44
Glenavon,139,7,11,11,8,53,51,2,44
Ards,139,8,8,6,16,40,55,-15,30
Glentoran,139,9,8,6,16,29,52,-23,30
Portadown,139,10,7,6,17,33,52,-19,27
Ballinamalla,139,11,6,5,19,27,58,-31,23
Cliftonville,140,1,17,4,9,53,38,15,55
Glenavon,140,2,13,12,5,55,44,11,51
Crusaders,140,3,14,8,8,53,42,11,50
Coleraine,140,4,12,8,10,49,43,6,44
Linfield,140,5,11,9,10,55,39,16,42
Ards,140,6,12,4,14,43,48,-5,40
Ballymena,140,7,12,4,14,56,62,-6,40
Glentoran,140,8,11,7,12,30,42,-12,40
Dungannon,140,9,8,12,10,52,46,6,36
Ballinamalla,140,10,8,5,17,32,52,-20,29
Portadown,140,11,7,7,16,27,49,-22,28
Linfield,141,1,19,6,5,68,31,37,63
Crusaders,141,2,14,7,9,47,38,9,49
Ballymena,141,3,14,6,10,59,54,5,48
Glenavon,141,4,13,9,8,46,41,5,48
Dungannon,141,5,13,8,9,50,37,13,47
Cliftonville,141,6,14,5,11,44,37,7,47
Coleraine,141,7,12,9,9,49,46,3,45
Ballinamalla,141,8,9,5,16,29,55,-26,32
Ards,141,9,8,5,17,33,44,-11,29
Glentoran,141,10,5,10,15,27,44,-17,25
Portadown,141,11,7,4,19,26,51,-25,25
Linfield,142,1,17,9,4,67,25,42,60
Crusaders,142,2,15,7,8,50,38,12,52
Cliftonville,142,3,14,7,9,54,41,13,49
Ballymena,142,4,13,7,10,69,63,6,46
Glenavon,142,5,10,15,5,45,41,4,45
Dungannon,142,6,10,10,10,51,41,10,40
Coleraine,142,7,9,11,10,36,43,-7,38
Glentoran,142,8,7,11,12,32,46,-14,32
Ballinamalla,142,9,9,5,16,35,54,-19,32
Portadown,142,10,7,7,16,25,49,-24,28
Ards,142,11,6,7,17,27,50,-23,25
Cliftonville,143,1,17,4,9,53,35,18,55
Linfield,143,2,12,12,6,59,27,32,48
Dungannon,143,3,13,9,8,55,43,12,48
Glenavon,143,4,11,13,6,57,43,14,46
Coleraine,143,5,12,10,8,43,43,0,46
Crusaders,143,6,11,10,9,47,44,3,43
Ballymena,143,7,12,5,13,50,62,-12,41
Ards,143,8,9,6,15,43,53,-10,33
Ballinamalla,143,9,8,8,14,37,49,-12,32
Glentoran,143,10,8,8,14,28,46,-18,32
Portadown,143,11,7,5,18,23,50,-27,26
Linfield,144,1,16,8,6,59,33,26,56
Crusaders,144,2,16,8,6,55,34,21,56
Cliftonville,144,3,14,6,10,52,32,20,48
Ballymena,144,4,13,6,11,51,52,-1,45
Coleraine,144,5,10,13,7,38,32,6,43
Glenavon,144,6,10,10,10,45,55,-10,40
Dungannon,144,7,10,9,11,48,41,7,39
Glentoran,144,8,11,6,13,37,44,-7,39
Portadown,144,9,10,4,16,29,50,-21,34
Ards,144,10,8,5,17,36,52,-16,29
Ballinamalla,144,11,7,5,18,26,51,-25,26
Cliftonville,145,1,18,5,7,56,32,24,59
Ballymena,145,2,16,4,10,58,51,7,52
Glenavon,145,3,12,11,7,58,48,10,47
Linfield,145,4,13,7,10,52,31,21,46
Crusaders,145,5,13,7,10,54,43,11,46
Glentoran,145,6,13,6,11,38,38,0,45
Coleraine,145,7,10,9,11,38,46,-8,39
Dungannon,145,8,8,10,12,44,48,-4,34
Ballinamalla,145,9,10,3,17,33,53,-20,33
Ards,145,10,8,6,16,39,55,-16,30
Portadown,145,11,6,8,16,20,45,-25,26
Crusaders,146,1,17,7,6,60,36,24,58
Cliftonville,146,2,17,5,8,60,36,24,56
Linfield,146,3,13,9,8,53,34,19,48
Glenavon,146,4,13,9,8,47,49,-2,48
Ballymena,146,5,13,6,11,54,59,-5,45
Coleraine,146,6,11,11,8,48,38,10,44
Glentoran,146,7,10,6,14,31,45,-14,36
Dungannon,146,8,8,9,13,49,53,-4,33
Ards,146,9,9,6,15,43,49,-6,33
Ballinamalla,146,10,8,6,16,35,50,-15,30
Portadown,146,11,6,6,18,23,54,-31,24
Crusaders,147,1,19,6,5,65,34,31,63
Coleraine,147,2,13,11,6,49,37,12,50
Linfield,147,3,14,8,8,52,42,10,50
Cliftonville,147,4,14,5,11,50,41,9,47
Ballymena,147,5,13,8,9,52,52,0,47
Glenavon,147,6,10,9,11,40,48,-8,39
Glentoran,147,7,10,8,12,33,43,-10,38
Ards,147,8,10,7,13,44,44,0,37
Dungannon,147,9,8,7,15,45,48,-3,31
Portadown,147,10,8,7,15,27,40,-13,31
Ballinamalla,147,11,5,6,19,24,52,-28,21
Crusaders,148,1,18,9,3,64,27,37,63
Linfield,148,2,15,8,7,68,37,31,53
Dungannon,148,3,14,9,7,56,42,14,51
Cliftonville,148,4,15,6,9,50,45,5,51
Coleraine,148,5,12,13,5,45,30,15,49
Ballymena,148,6,13,6,11,69,65,4,45
Glenavon,148,7,9,12,9,42,46,-4,39
Ards,148,8,9,4,17,35,49,-14,31
Glentoran,148,9,6,9,15,27,52,-25,27
Ballinamalla,148,10,7,4,19,26,57,-31,25
Portadown,148,11,6,2,22,25,57,-32,20
Crusaders,149,1,17,8,5,59,30,29,59
Linfield,149,2,15,10,5,60,30,30,55
Ballymena,149,3,15,6,9,58,57,1,51
Cliftonville,149,4,14,6,10,47,42,5,48
Coleraine,149,5,12,10,8,47,38,9,46
Ballinamalla,149,6,12,5,13,38,45,-7,41
Glenavon,149,7,8,12,10,36,49,-13,36
Ards,149,8,9,8,13,46,48,-2,35
Dungannon,149,9,8,8,14,54,54,0,32
Glentoran,149,10,8,7,15,32,53,-21,31
Portadown,149,11,4,6,20,24,55,-31,18
Crusaders,150,1,16,10,4,64,37,27,58
Linfield,150,2,15,9,6,63,32,31,54
Cliftonville,150,3,16,5,9,58,42,16,53
Ballymena,150,4,15,5,10,58,59,-1,50
Coleraine,150,5,13,8,9,44,40,4,47
Glenavon,150,6,12,9,9,49,42,7,45
Dungannon,150,7,9,10,11,47,46,1,37
Ards,150,8,11,4,15,40,48,-8,37
Glentoran,150,9,7,9,14,32,48,-16,30
Ballinamalla,150,10,8,3,19,30,57,-27,27
Portadown,150,11,3,8,19,24,58,-34,17
Crusaders,151,1,17,7,6,58,33,25,58
Cliftonville,151,2,16,5,9,62,42,20,53
Glenavon,151,3,14,10,6,54,43,11,52
Linfield,151,4,13,9,8,53,34,19,48
Ballymena,151,5,14,5,11,55,51,4,47
Dungannon,151,6,11,9,10,49,41,8,42
Coleraine,151,7,11,9,10,43,41,2,42
Glentoran,151,8,10,9,11,35,42,-7,39
Portadown,151,9,8,4,18,22,50,-28,28
Ballinamalla,151,10,7,4,19,36,63,-27,25
Ards,151,11,5,7,18,28,55,-27,22
Ballymena,152,1,17,7,6,65,59,6,58
Crusaders,152,2,14,8,8,49,33,16,50
Coleraine,152,3,13,9,8,47,39,8,48
Linfield,152,4,12,10,8,52,34,18,46
Cliftonville,152,5,14,4,12,52,44,8,46
Glentoran,152,6,12,8,10,37,36,1,44
Glenavon,152,7,10,10,10,44,44,0,40
Dungannon,152,8,8,10,12,49,48,1,34
Ards,152,9,9,4,17,36,51,-15,31
Portadown,152,10,9,4,17,31,50,-19,31
Ballinamalla,152,11,6,8,16,23,47,-24,26
Crusaders,153,1,16,9,5,54,30,24,57
Cliftonville,153,2,16,5,9,54,36,18,53
Linfield,153,3,13,10,7,56,27,29,49
Ballymena,153,4,14,7,9,54,51,3,49
Coleraine,153,5,11,8,11,43,44,-1,41
Portadown,153,6,11,6,13,30,44,-14,39
Ards,153,7,11,5,14,41,47,-6,38
Glenavon,153,8,8,10,12,41,46,-5,34
Ballinamalla,153,9,9,7,14,28,46,-18,34
Dungannon,153,10,7,11,12,47,50,-3,32
Glentoran,153,11,5,10,15,22,49,-27,25
Crusaders,154,1,16,9,5,59,33,26,57
Linfield,154,2,15,10,5,60,28,32,55
Cliftonville,154,3,14,7,9,51,39,12,49
Coleraine,154,4,13,10,7,44,38,6,49
Dungannon,154,5,10,11,9,54,44,10,41
Glenavon,154,6,9,12,9,40,50,-10,39
Ballymena,154,7,10,8,12,47,58,-11,38
Glentoran,154,8,10,7,13,29,40,-11,37
Ards,154,9,11,3,16,46,53,-7,36
Ballinamalla,154,10,5,9,16,26,52,-26,24
Portadown,154,11,5,8,17,23,44,-21,23
Crusaders,155,1,16,9,5,55,42,13,57
Cliftonville,155,2,16,5,9,54,37,17,53
Linfield,155,3,13,12,5,57,30,27,51
Ballymena,155,4,15,5,10,61,64,-3,50
Glenavon,155,5,11,10,9,43,35,8,43
Dungannon,155,6,9,12,9,48,38,10,39
Ards,155,7,11,5,14,44,49,-5,38
Coleraine,155,8,8,12,10,43,42,1,36
Ballinamalla,155,9,8,5,17,28,50,-22,29
Portadown,155,10,7,7,16,25,48,-23,28
Glentoran,155,11,7,6,17,25,48,-23,27
Crusaders,156,1,20,5,5,63,27,36,65
Linfield,156,2,15,8,7,54,30,24,53
Coleraine,156,3,14,9,7,50,34,16,51
Ballymena,156,4,15,5,10,59,56,3,50
Cliftonville,156,5,13,8,9,48,42,6,47
Dungannon,156,6,11,9,10,50,46,4,42
Ards,156,7,10,6,14,41,48,-7,36
Glentoran,156,8,9,8,13,31,41,-10,35
Glenavon,156,9,7,8,15,43,64,-21,29
Ballinamalla,156,10,6,6,18,24,48,-24,24
Portadown,156,11,6,6,18,29,56,-27,24
Crusaders,157,1,18,6,6,59,30,29,60
Cliftonville,157,2,17,5,8,51,40,11,56
Linfield,157,3,14,12,4,63,33,30,54
Coleraine,157,4,12,11,7,59,45,14,47
Ballymena,157,5,13,7,10,61,61,0,46
Glenavon,157,6,11,9,10,50,48,2,42
Ballinamalla,157,7,12,4,14,35,49,-14,40
Dungannon,157,8,10,8,12,56,50,6,38
Ards,157,9,7,6,17,39,56,-17,27
Glentoran,157,10,5,9,16,27,54,-27,24
Portadown,157,11,4,7,19,23,57,-34,19
Glenavon,158,1,15,10,5,57,37,20,55
Linfield,158,2,15,8,7,60,33,27,53
Coleraine,158,3,15,8,7,48,37,11,53
Cliftonville,158,4,16,3,11,58,50,8,51
Ballymena,158,5,15,6,9,60,60,0,51
Crusaders,158,6,14,5,11,51,43,8,47
Glentoran,158,7,9,8,13,33,46,-13,35
Dungannon,158,8,9,6,15,51,54,-3,33
Ballinamalla,158,9,8,6,16,35,49,-14,30
Ards,158,10,8,3,19,33,53,-20,27
Portadown,158,11,7,5,18,35,59,-24,26
Crusaders,159,1,18,7,5,60,33,27,61
Ballymena,159,2,16,8,6,61,54,7,56
Linfield,159,3,14,8,8,56,36,20,50
Coleraine,159,4,12,9,9,48,32,16,45
Cliftonville,159,5,12,5,13,47,46,1,41
Glenavon,159,6,8,14,8,42,45,-3,38
Glentoran,159,7,9,9,12,30,41,-11,36
Dungannon,159,8,8,10,12,44,45,-1,34
Ards,159,9,9,7,14,36,47,-11,34
Ballinamalla,159,10,8,6,16,31,52,-21,30
Portadown,159,11,5,9,16,20,44,-24,24
Linfield,160,1,17,10,3,71,28,43,61
Crusaders,160,2,17,6,7,61,38,23,57
Cliftonville,160,3,15,4,11,46,40,6,49
Ballymena,160,4,13,8,9,59,59,0,47
Dungannon,160,5,11,11,8,55,41,14,44
Glenavon,160,6,11,11,8,50,46,4,44
Coleraine,160,7,11,11,8,39,38,1,44
Glentoran,160,8,8,5,17,29,49,-20,29
Ballinamalla,160,9,7,6,17,25,52,-27,27
Ards,160,10,6,8,16,33,54,-21,26
Portadown,160,11,7,4,19,21,44,-23,25
Linfield,161,1,16,6,8,60,37,23,54
Crusaders,161,2,15,8,7,57,36,21,53
Coleraine,161,3,13,12,5,47,34,13,51
Cliftonville,161,4,15,5,10,56,43,13,50
Glenavon,161,5,10,12,8,47,45,2,42
Dungannon,161,6,10,10,10,53,45,8,40
Ballymena,161,7,11,5,14,54,62,-8,38
Ards,161,8,11,5,14,41,57,-16,38
Glentoran,161,9,9,7,14,32,46,-14,34
Ballinamalla,161,10,8,4,18,33,51,-18,28
Portadown,161,11,7,6,17,32,56,-24,27
Crusaders,162,1,16,7,7,55,35,20,55
Linfield,162,2,14,11,5,51,28,23,53
Cliftonville,162,3,16,5,9,49,34,15,53
Coleraine,162,4,14,8,8,47,36,11,50
Glenavon,162,5,13,10,7,48,44,4,49
Ballymena,162,6,14,5,11,55,57,-2,47
Ards,162,7,9,6,15,48,48,0,33
Dungannon,162,8,8,9,13,45,49,-4,33
Glentoran,162,9,8,7,15,28,45,-17,31
Ballinamalla,162,10,9,2,19,26,57,-31,29
Portadown,162,11,6,6,18,28,47,-19,24
Crusaders,163,1,17,6,7,58,37,21,57
Cliftonville,163,2,15,7,8,57,42,15,52
Linfield,163,3,13,11,6,53,29,24,50
Dungannon,163,4,13,11,6,58,38,20,50
Glenavon,163,5,12,12,6,49,41,8,48
Coleraine,163,6,11,11,8,45,43,2,44
Ballymena,163,7,12,6,12,60,66,-6,42
Ards,163,8,9,9,12,34,40,-6,36
Ballinamalla,163,9,6,6,18,25,51,-26,24
Portadown,163,10,5,8,17,19,46,-27,23
Glentoran,163,11,5,7,18,21,46,-25,22
Crusaders,164,1,15,9,6,53,34,19,54
Linfield,164,2,14,8,8,58,34,24,50
Cliftonville,164,3,15,5,10,53,38,15,50
Glenavon,164,4,11,12,7,45,41,4,45
Ballymena,164,5,13,6,11,61,61,0,45
Ards,164,6,12,5,13,38,46,-8,41
Coleraine,164,7,10,9,11,40,42,-2,39
Glentoran,164,8,9,9,12,34,41,-7,36
Portadown,164,9,10,5,15,27,46,-19,35
Dungannon,164,10,7,9,14,52,56,-4,30
Ballinamalla,164,11,9,3,18,26,48,-22,30
Crusaders,165,1,16,8,6,51,30,21,56
Cliftonville,165,2,16,5,9,55,40,15,53
Glenavon,165,3,14,8,8,42,36,6,50
Linfield,165,4,13,10,7,59,35,24,49
Ballymena,165,5,12,6,12,52,58,-6,42
Coleraine,165,6,10,10,10,42,37,5,40
Ards,165,7,11,5,14,44,45,-1,38
Dungannon,165,8,9,10,11,46,41,5,37
Ballinamalla,165,9,9,7,14,30,43,-13,34
Glentoran,165,10,8,6,16,25,51,-26,30
Portadown,165,11,7,5,18,21,51,-30,26
Crusaders,166,1,15,11,4,60,31,29,56
Linfield,166,2,14,10,6,57,35,22,52
Cliftonville,166,3,14,5,11,48,38,10,47
Ards,166,4,13,6,11,50,45,5,45
Glenavon,166,5,10,14,6,44,45,-1,44
Coleraine,166,6,11,10,9,44,38,6,43
Ballymena,166,7,12,4,14,50,58,-8,40
Dungannon,166,8,10,8,12,44,46,-2,38
Portadown,166,9,8,7,15,26,47,-21,31
Glentoran,166,10,6,10,14,26,42,-16,28
Ballinamalla,166,11,6,7,17,28,52,-24,25
Crusaders,167,1,16,7,7,55,35,20,55
Linfield,167,2,15,9,6,58,30,28,54
Coleraine,167,3,15,9,6,42,28,14,54
Ballymena,167,4,15,6,9,64,56,8,51
Cliftonville,167,5,13,4,13,53,44,9,43
Dungannon,167,6,11,10,9,48,43,5,43
Glenavon,167,7,10,10,10,38,42,-4,40
Ards,167,8,11,4,15,43,46,-3,37
Ballinamalla,167,9,10,5,15,28,48,-20,35
Glentoran,167,10,4,11,15,20,45,-25,23
Portadown,167,11,5,5,20,19,51,-32,20
Crusaders,168,1,18,6,6,57,36,21,60
Cliftonville,168,2,15,6,9,51,36,15,51
Linfield,168,3,13,11,6,58,35,23,50
Glenavon,168,4,12,11,7,56,42,14,47
Ballymena,168,5,13,8,9,53,53,0,47
Dungannon,168,6,10,10,10,47,43,4,40
Coleraine,168,7,10,9,11,37,43,-6,39
Ards,168,8,9,7,14,41,44,-3,34
Glentoran,168,9,8,9,13,34,48,-14,33
Portadown,168,10,6,9,15,23,45,-22,27
Ballinamalla,168,11,5,6,19,26,58,-32,21
Crusaders,169,1,17,6,7,51,37,14,57
Ballymena,169,2,16,4,10,59,56,3,52
Glenavon,169,3,14,9,7,56,44,12,51
Linfield,169,4,13,10,7,56,34,22,49
Cliftonville,169,5,13,6,11,50,41,9,45
Glentoran,169,6,11,6,13,36,38,-2,39
Ards,169,7,12,3,15,44,52,-8,39
Dungannon,169,8,8,12,10,50,49,1,36
Coleraine,169,9,9,9,12,41,45,-4,36
Portadown,169,10,8,6,16,21,41,-20,30
Ballinamalla,169,11,8,1,21,33,60,-27,25
Crusaders,170,1,14,8,8,53,39,14,50
Linfield,170,2,13,9,8,52,32,20,48
Glenavon,170,3,12,11,7,50,45,5,47
Cliftonville,170,4,14,4,12,57,48,9,46
Coleraine,170,5,12,9,9,47,38,9,45
Ballymena,170,6,13,5,12,55,55,0,44
Dungannon,170,7,12,7,11,51,42,9,43
Ards,170,8,11,5,14,42,49,-7,38
Portadown,170,9,11,5,14,30,40,-10,38
Glentoran,170,10,9,7,14,26,44,-18,34
Ballinamalla,170,11,7,4,19,26,57,-31,25
Cliftonville,171,1,18,4,8,54,37,17,58
Crusaders,171,2,16,6,8,52,37,15,54
Coleraine,171,3,14,8,8,46,34,12,50
Linfield,171,4,12,11,7,55,31,24,47
Ballymena,171,5,13,7,10,56,56,0,46
Glenavon,171,6,9,9,12,45,54,-9,36
Dungannon,171,7,8,11,11,41,44,-3,35
Glentoran,171,8,9,7,14,41,41,0,34
Ards,171,9,8,8,14,36,54,-18,32
Ballinamalla,171,10,10,2,18,32,54,-22,32
Portadown,171,11,8,7,15,31,47,-16,31
Linfield,172,1,15,9,6,65,35,30,54
Crusaders,172,2,14,6,10,57,45,12,48
Glenavon,172,3,12,12,6,49,41,8,48
Coleraine,172,4,12,11,7,41,41,0,47
Ballymena,172,5,11,10,9,55,55,0,43
Dungannon,172,6,11,9,10,52,43,9,42
Cliftonville,172,7,12,4,14,51,53,-2,40
Portadown,172,8,10,7,13,34,43,-9,37
Ards,172,9,8,7,15,37,44,-7,31
Glentoran,172,10,7,10,13,25,40,-15,31
Ballinamalla,172,11,9,3,18,27,53,-26,30
Crusaders,173,1,19,7,4,61,31,30,64
Linfield,173,2,15,9,6,53,29,24,54
Cliftonville,173,3,16,5,9,52,36,16,53
Glenavon,173,4,13,8,9,54,47,7,47
Ballymena,173,5,13,6,11,67,59,8,45
Coleraine,173,6,10,10,10,41,42,-1,40
Glentoran,173,7,10,7,13,32,46,-14,37
Dungannon,173,8,9,9,12,50,52,-2,36
Ards,173,9,10,5,15,43,50,-7,35
Ballinamalla,173,10,6,6,18,33,58,-25,24
Portadown,173,11,6,4,20,20,56,-36,22
Cliftonville,174,1,18,3,9,55,33,22,57
Crusaders,174,2,16,7,7,54,31,23,55
Ballymena,174,3,15,9,6,55,45,10,54
Dungannon,174,4,10,13,7,48,38,10,43
Glenavon,174,5,10,12,8,47,50,-3,42
Linfield,174,6,9,14,7,54,41,13,41
Glentoran,174,7,10,8,12,27,42,-15,38
Coleraine,174,8,9,10,11,36,40,-4,37
Ards,174,9,7,8,15,36,47,-11,29
Ballinamalla,174,10,6,7,17,27,50,-23,25
Portadown,174,11,5,9,16,21,43,-22,24
Crusaders,175,1,19,6,5,60,32,28,63
Linfield,175,2,14,10,6,60,29,31,52
Coleraine,175,3,13,11,6,48,41,7,50
Cliftonville,175,4,13,6,11,56,47,9,45
Ballymena,175,5,12,8,10,56,68,-12,44
Glenavon,175,6,11,10,9,52,48,4,43
Ards,175,7,10,8,12,43,43,0,38
Dungannon,175,8,8,10,12,41,47,-6,34
Glentoran,175,9,7,12,11,28,37,-9,33
Ballinamalla,175,10,6,6,18,24,51,-27,24
Portadown,175,11,6,5,19,24,49,-25,23
Crusaders,176,1,19,5,6,64,34,30,62
Ballymena,176,2,15,9,6,57,47,10,54
Linfield,176,3,13,9,8,60,40,20,48
Glenavon,176,4,12,10,8,47,48,-1,46
Cliftonville,176,5,13,3,14,44,49,-5,42
Coleraine,176,6,10,11,9,41,40,1,41
Dungannon,176,7,9,10,11,49,46,3,37
Ards,176,8,11,4,15,47,56,-9,37
Portadown,176,9,9,6,15,28,40,-12,33
Ballinamalla,176,10,8,4,18,38,55,-17,28
Glentoran,176,11,7,7,16,31,51,-20,28
Crusaders,177,1,16,11,3,61,29,32,59
Cliftonville,177,2,14,8,8,54,35,19,50
Glenavon,177,3,12,13,5,49,42,7,49
Linfield,177,4,12,10,8,58,37,21,46
Coleraine,177,5,11,12,7,46,39,7,45
Ballymena,177,6,13,5,12,52,58,-6,44
Ards,177,7,11,7,12,42,48,-6,40
Dungannon,177,8,7,11,12,41,45,-4,32
Ballinamalla,177,9,8,5,17,25,46,-21,29
Glentoran,177,10,6,10,14,28,47,-19,28
Portadown,177,11,5,8,17,22,52,-30,23
Crusaders,178,1,16,8,6,52,30,22,56
Linfield,178,2,14,10,6,55,32,23,52
Cliftonville,178,3,15,5,10,54,39,15,50
Glenavon,178,4,12,10,8,45,39,6,46
Ballymena,178,5,14,4,12,54,59,-5,46
Dungannon,178,6,11,8,11,51,38,13,41
Coleraine,178,7,10,11,9,37,38,-1,41
Ards,178,8,9,6,15,33,46,-13,33
Glentoran,178,9,8,8,14,28,42,-14,32
Ballinamalla,178,10,9,3,18,26,47,-21,30
Portadown,178,11,8,5,17,26,51,-25,29
Linfield,179,1,16,9,5,59,29,30,57
Crusaders,179,2,15,9,6,58,42,16,54
Cliftonville,179,3,16,4,10,56,42,14,52
Coleraine,179,4,13,8,9,43,37,6,47
Ballymena,179,5,12,7,11,55,58,-3,43
Glenavon,179,6,10,12,8,41,43,-2,42
Dungannon,179,7,8,12,10,51,47,4,36
Glentoran,179,8,8,8,14,33,44,-11,32
Ards,179,9,7,10,13,39,49,-10,31
Ballinamalla,179,10,8,5,17,32,50,-18,29
Portadown,179,11,6,8,16,27,53,-26,26
Linfield,180,1,16,7,7,64,34,30,55
Crusaders,180,2,16,6,8,51,43,8,54
Ballymena,180,3,14,6,10,55,58,-3,48
Cliftonville,180,4,13,6,11,50,41,9,45
Dungannon,180,5,12,8,10,53,41,12,44
Glenavon,180,6,11,10,9,46,43,3,43
Coleraine,180,7,10,12,8,41,36,5,42
Portadown,180,8,11,4,15,32,41,-9,37
Ards,180,9,11,2,17,42,51,-9,35
Ballinamalla,180,10,7,7,16,25,47,-22,28
Glentoran,180,11,8,4,18,28,52,-24,28
Cliftonville,181,1,17,6,7,65,35,30,57
Linfield,181,2,16,9,5,60,30,30,57
Crusaders,181,3,16,6,8,55,38,17,54
Coleraine,181,4,13,9,8,38,31,7,48
Glenavon,181,5,12,11,7,47,40,7,47
Glentoran,181,6,13,5,12,38,47,-9,44
Ballymena,181,7,12,6,12,51,59,-8,42
Dungannon,181,8,9,6,15,42,45,-3,33
Portadown,181,9,6,8,16,20,41,-21,26
Ballinamalla,181,10,8,2,20,26,58,-32,26
Ards,181,11,7,4,19,30,48,-18,25
Cliftonville,182,1,18,6,6,56,29,27,60
Crusaders,182,2,17,6,7,58,33,25,57
Glenavon,182,3,14,8,8,45,40,5,50
Linfield,182,4,13,8,9,52,30,22,47
Ballymena,182,5,12,7,11,56,59,-3,43
Dungannon,182,6,10,7,13,48,48,0,37
Coleraine,182,7,9,10,11,33,38,-5,37
Ballinamalla,182,8,11,4,15,31,44,-13,37
Ards,182,9,9,6,15,37,48,-11,33
Portadown,182,10,8,5,17,22,44,-22,29
Glentoran,182,11,7,7,16,29,54,-25,28
Crusaders,183,1,17,6,7,53,31,22,57
Linfield,183,2,15,9,6,65,32,33,54
Ballymena,183,3,14,7,9,63,56,7,49
Cliftonville,183,4,14,4,12,54,46,8,46
Glenavon,183,5,11,10,9,49,46,3,43
Coleraine,183,6,11,10,9,41,46,-5,43
Ards,183,7,10,8,12,41,44,-3,38
Glentoran,183,8,8,9,13,30,47,-17,33
Portadown,183,9,9,5,16,32,54,-22,32
Ballinamalla,183,10,9,4,17,33,54,-21,31
Dungannon,183,11,7,8,15,41,46,-5,29
Crusaders,184,1,15,10,5,53,33,20,55
Coleraine,184,2,15,9,6,54,34,20,54
Linfield,184,3,13,13,4,70,34,36,52
Dungannon,184,4,12,8,10,54,47,7,44
Cliftonville,184,5,14,2,14,49,49,0,44
Ballymena,184,6,12,5,13,56,71,-15,41
Ards,184,7,12,3,15,41,48,-7,39
Glentoran,184,8,10,8,12,32,45,-13,38
Glenavon,184,9,8,12,10,45,50,-5,36
Ballinamalla,184,10,9,3,18,34,52,-18,30
Portadown,184,11,5,7,18,29,54,-25,22
Cliftonville,185,1,17,5,8,60,35,25,56
Linfield,185,2,14,9,7,62,35,27,51
Crusaders,185,3,14,7,9,53,40,13,49
Ballymena,185,4,15,3,12,61,66,-5,48
Coleraine,185,5,12,11,7,39,32,7,47
Glenavon,185,6,11,12,7,52,44,8,45
Dungannon,185,7,10,9,11,57,50,7,39
Ards,185,8,9,6,15,42,52,-10,33
Portadown,185,9,9,5,16,29,51,-22,32
Ballinamalla,185,10,9,2,19,38,58,-20,29
Glentoran,185,11,8,5,17,26,56,-30,29
Crusaders,186,1,19,7,4,51,27,24,64
Linfield,186,2,14,6,10,51,34,17,48
Cliftonville,186,3,14,6,10,45,39,6,48
Ballymena,186,4,13,9,8,52,53,-1,48
Glenavon,186,5,12,9,9,46,43,3,45
Dungannon,186,6,12,8,10,57,40,17,44
Glentoran,186,7,12,6,12,38,39,-1,42
Coleraine,186,8,9,11,10,44,44,0,38
Ards,186,9,9,4,17,40,56,-16,31
Ballinamalla,186,10,7,7,16,28,48,-20,28
Portadown,186,11,5,5,20,24,53,-29,20
Linfield,187,1,15,9,6,60,30,30,54
Crusaders,187,2,16,5,9,58,35,23,53
Cliftonville,187,3,15,5,10,52,38,14,50
Ballymena,187,4,14,7,9,54,51,3,49
Coleraine,187,5,11,14,5,39,30,9,47
Glenavon,187,6,11,11,8,43,45,-2,44
Dungannon,187,7,11,9,10,45,44,1,42
Ards,187,8,9,6,15,34,50,-16,33
Glentoran,187,9,8,5,17,27,46,-19,29
Ballinamalla,187,10,9,2,19,29,52,-23,29
Portadown,187,11,7,5,18,26,46,-20,26
Crusaders,188,1,18,9,3,62,30,32,63
Linfield,188,2,15,8,7,56,28,28,53
Ballymena,188,3,13,9,8,57,60,-3,48
Glenavon,188,4,11,11,8,50,44,6,44
Cliftonville,188,5,12,8,10,45,39,6,44
Dungannon,188,6,11,8,11,47,39,8,41
Glentoran,188,7,11,6,13,35,45,-10,39
Coleraine,188,8,9,7,14,34,43,-9,34
Portadown,188,9,9,7,14,26,40,-14,34
Ballinamalla,188,10,9,4,17,29,52,-23,31
Ards,188,11,5,7,18,30,51,-21,22
Crusaders,189,1,20,5,5,64,34,30,65
Cliftonville,189,2,15,4,11,58,46,12,49
Ballymena,189,3,14,7,9,60,67,-7,49
Linfield,189,4,13,9,8,60,33,27,48
Coleraine,189,5,9,13,8,44,44,0,40
Dungannon,189,6,9,12,9,56,47,9,39
Glenavon,189,7,10,9,11,47,55,-8,39
Portadown,189,8,11,2,17,33,43,-10,35
Glentoran,189,9,9,6,15,31,47,-16,33
Ards,189,10,10,3,17,37,55,-18,33
Ballinamalla,189,11,7,6,17,32,51,-19,27
Crusaders,190,1,20,6,4,59,29,30,66
Cliftonville,190,2,15,5,10,54,38,16,50
Coleraine,190,3,13,9,8,42,38,4,48
Ballymena,190,4,14,6,10,56,57,-1,48
Linfield,190,5,12,10,8,51,31,20,46
Glenavon,190,6,11,11,8,49,49,0,44
Glentoran,190,7,9,7,14,31,44,-13,34
Dungannon,190,8,8,9,13,49,53,-4,33
Ards,190,9,9,5,16,32,44,-12,32
Portadown,190,10,8,6,16,25,41,-16,30
Ballinamalla,190,11,7,4,19,26,50,-24,25
Linfield,191,1,16,8,6,64,34,30,56
Cliftonville,191,2,16,3,11,55,38,17,51
Glenavon,191,3,13,10,7,56,42,14,49
Coleraine,191,4,12,12,6,46,38,8,48
Crusaders,191,5,13,8,9,46,37,9,47
Dungannon,191,6,13,7,10,52,43,9,46
Ballymena,191,7,12,7,11,53,60,-7,43
Ards,191,8,11,6,13,41,43,-2,39
Glentoran,191,9,6,9,15,27,50,-23,27
Ballinamalla,191,10,6,6,18,27,54,-27,24
Portadown,191,11,6,6,18,23,51,-28,24
Linfield,192,1,19,7,4,68,32,36,64
Cliftonville,192,2,15,6,9,55,37,18,51
Crusaders,192,3,15,6,9,55,40,15,51
Coleraine,192,4,14,8,8,50,42,8,50
Glenavon,192,5,12,11,7,53,47,6,47
Ballymena,192,6,13,7,10,54,55,-1,46
Ards,192,7,12,2,16,38,50,-12,38
Dungannon,192,8,7,12,11,51,49,2,33
Glentoran,192,9,8,8,14,28,44,-16,32
Ballinamalla,192,10,7,5,18,27,53,-26,26
Portadown,192,11,5,4,21,22,52,-30,19
Crusaders,193,1,17,5,8,65,41,24,56
Glenavon,193,2,14,11,5,58,48,10,53
Coleraine,193,3,13,11,6,44,34,10,50
Linfield,193,4,13,8,9,52,37,15,47
Glentoran,193,5,14,5,11,36,40,-4,47
Cliftonville,193,6,14,4,12,44,39,5,46
Ballymena,193,7,13,6,11,55,59,-4,45
Dungannon,193,8,9,9,12,49,47,2,36
Ards,193,9,9,4,17,35,49,-14,31
Portadown,193,10,9,4,17,30,46,-16,31
Ballinamalla,193,11,5,3,22,26,54,-28,18
Linfield,194,1,16,8,6,58,30,28,56
Crusaders,194,2,14,9,7,46,34,12,51
Ballymena,194,3,15,6,9,60,58,2,51
Glenavon,194,4,12,12,6,51,38,13,48
Cliftonville,194,5,13,6,11,46,39,7,45
Dungannon,194,6,10,12,8,49,39,10,42
Coleraine,194,7,8,14,8,32,33,-1,38
Ballinamalla,194,8,10,5,15,34,47,-13,35
Ards,194,9,9,7,14,38,43,-5,34
Glentoran,194,10,7,8,15,28,49,-21,29
Portadown,194,11,4,7,19,20,52,-32,19
Crusaders,195,1,15,8,7,55,39,16,53
Ballymena,195,2,14,9,7,67,60,7,51
Cliftonville,195,3,13,9,8,53,39,14,48
Linfield,195,4,12,10,8,62,44,18,46
Dungannon,195,5,11,10,9,52,42,10,43
Glenavon,195,6,10,11,9,51,47,4,41
Coleraine,195,7,8,14,8,39,41,-2,38
Portadown,195,8,9,8,13,32,49,-17,35
Glentoran,195,9,8,7,15,32,50,-18,31
Ballinamalla,195,10,8,6,16,34,52,-18,30
Ards,195,11,7,8,15,36,50,-14,29
Crusaders,196,1,17,6,7,55,36,19,57
Linfield,196,2,15,10,5,58,29,29,55
Coleraine,196,3,15,9,6,47,37,10,54
Ballymena,196,4,13,9,8,49,48,1,48
Cliftonville,196,5,14,4,12,51,40,11,46
Glentoran,196,6,11,7,12,36,36,0,40
Dungannon,196,7,9,9,12,48,43,5,36
Glenavon,196,8,9,9,12,39,46,-7,36
Ballinamalla,196,9,8,6,16,31,55,-24,30
Portadown,196,10,7,6,17,26,46,-20,27
Ards,196,11,7,5,18,34,58,-24,26
Crusaders,197,1,17,7,6,60,32,28,58
Cliftonville,197,2,17,7,6,60,36,24,58
Linfield,197,3,15,12,3,62,28,34,57
Coleraine,197,4,13,9,8,40,32,8,48
Ballymena,197,5,14,6,10,58,53,5,48
Glenavon,197,6,11,8,11,50,57,-7,41
Ards,197,7,10,6,14,41,52,-11,36
Dungannon,197,8,8,8,14,49,58,-9,32
Glentoran,197,9,8,6,16,33,50,-17,30
Portadown,197,10,8,4,18,21,47,-26,28
Ballinamalla,197,11,6,3,21,30,59,-29,21
Linfield,198,1,14,12,4,63,30,33,54
Crusaders,198,2,16,6,8,53,39,14,54
Cliftonville,198,3,14,5,11,50,43,7,47
Dungannon,198,4,11,12,7,56,36,20,45
Ballymena,198,5,11,9,10,58,62,-4,42
Coleraine,198,6,9,14,7,37,35,2,41
Portadown,198,7,12,4,14,28,40,-12,40
Glenavon,198,8,10,9,11,45,46,-1,39
Ards,198,9,8,8,14,32,45,-13,32
Glentoran,198,10,7,9,14,26,49,-23,30
Ballinamalla,198,11,7,4,19,27,50,-23,25
Linfield,199,1,15,9,6,61,29,32,54
Crusaders,199,2,14,10,6,55,43,12,52
Cliftonville,199,3,15,4,11,54,41,13,49
Ballymena,199,4,14,6,10,63,66,-3,48
Glenavon,199,5,11,11,8,51,42,9,44
Glentoran,199,6,10,10,10,35,41,-6,40
Dungannon,199,7,10,9,11,48,46,2,39
Ards,199,8,10,7,13,36,45,-9,37
Coleraine,199,9,8,11,11,37,44,-7,35
Ballinamalla,199,10,7,6,17,31,52,-21,27
Portadown,199,11,8,3,19,27,49,-22,27
Cliftonville,200,1,17,7,6,52,31,21,58
Crusaders,200,2,16,6,8,51,34,17,54
Ballymena,200,3,15,6,9,68,66,2,51
Linfield,200,4,13,9,8,59,37,22,48
Glenavon,200,5,11,11,8,49,43,6,44
Dungannon,200,6,10,10,10,46,42,4,40
Coleraine,200,7,9,12,9,38,36,2,39
Ards,200,8,10,4,16,41,50,-9,34
Glentoran,200,9,8,9,13,29,43,-14,33
Portadown,200,10,7,8,15,28,48,-20,29
Ballinamalla,200,11,6,4,20,27,58,-31,22
Crusaders,201,1,16,9,5,53,32,21,57
Ballymena,201,2,16,4,10,54,59,-5,52
Linfield,201,3,13,10,7,61,38,23,49
Glenavon,201,4,12,12,6,49,40,9,48
Coleraine,201,5,11,12,7,41,32,9,45
Glentoran,201,6,11,8,11,32,38,-6,41
Cliftonville,201,7,11,6,13,44,44,0,39
Dungannon,201,8,7,12,11,46,45,1,33
Ballinamalla,201,9,9,5,16,34,51,-17,32
Ards,201,10,6,9,15,35,46,-11,27
Portadown,201,11,6,7,17,19,43,-24,25
Cliftonville,202,1,17,5,8,62,37,25,56
Crusaders,202,2,15,9,6,59,36,23,54
Coleraine,202,3,12,12,6,46,35,11,48
Glenavon,202,4,13,9,8,48,39,9,48
Linfield,202,5,13,8,9,51,39,12,47
Ballymena,202,6,12,9,9,60,62,-2,45
Dungannon,202,7,11,10,9,49,40,9,43
Ards,202,8,10,5,15,42,50,-8,35
Glentoran,202,9,7,8,15,28,46,-18,29
Ballinamalla,202,10,9,1,20,34,66,-32,28
Portadown,202,11,5,6,19,20,49,-29,21
Crusaders,203,1,19,7,4,55,24,31,64
Cliftonville,203,2,17,3,10,58,37,21,54
Linfield,203,3,13,10,7,57,37,20,49
Ballymena,203,4,14,7,9,53,54,-1,49
Dungannon,203,5,12,8,10,55,42,13,44
Glenavon,203,6,10,9,11,45,51,-6,39
Coleraine,203,7,9,10,11,38,39,-1,37
Portadown,203,8,10,6,14,31,46,-15,36
Glentoran,203,9,5,12,13,23,38,-15,27
Ards,203,10,7,6,17,30,53,-23,27
Ballinamalla,203,11,7,6,17,27,51,-24,27
Ballymena,204,1,18,4,8,69,53,16,58
Cliftonville,204,2,15,7,8,54,35,19,52
Glenavon,204,3,14,10,6,48,37,11,52
Crusaders,204,4,13,10,7,52,40,12,49
Linfield,204,5,12,10,8,53,34,19,46
Coleraine,204,6,12,8,10,44,46,-2,44
Dungannon,204,7,9,12,9,47,40,7,39
Portadown,204,8,8,6,16,23,42,-19,30
Ards,204,9,8,5,17,35,50,-15,29
Glentoran,204,10,5,12,13,28,49,-21,27
Ballinamalla,204,11,5,8,17,24,51,-27,23
Crusaders,205,1,17,8,5,51,30,21,59
Cliftonville,205,2,14,6,10,48,39,9,48
Dungannon,205,3,13,8,9,57,41,16,47
Coleraine,205,4,12,11,7,39,31,8,47
Linfield,205,5,11,12,7,49,33,16,45
Glenavon,205,6,11,10,9,48,44,4,43
Ballymena,205,7,12,6,12,53,61,-8,42
Ards,205,8,11,6,13,50,45,5,39
Portadown,205,9,10,5,15,33,47,-14,35
Glentoran,205,10,5,10,15,23,52,-29,25
Ballinamalla,205,11,6,4,20,24,52,-28,22
Cliftonville,206,1,18,3,9,68,38,30,57
Crusaders,206,2,17,6,7,60,37,23,57
Ballymena,206,3,16,5,9,52,52,0,53
Coleraine,206,4,14,10,6,40,32,8,52
Linfield,206,5,14,7,9,57,38,19,49
Glenavon,206,6,11,9,10,39,42,-3,42
Dungannon,206,7,9,7,14,49,52,-3,34
Glentoran,206,8,9,7,14,32,48,-16,34
Ards,206,9,9,6,15,40,47,-7,33
Portadown,206,10,8,7,15,31,46,-15,31
Ballinamalla,206,11,5,3,22,24,60,-36,18
Crusaders,207,1,17,9,4,47,24,23,60
Coleraine,207,2,13,11,6,47,32,15,50
Cliftonville,207,3,14,6,10,51,43,8,48
Glentoran,207,4,14,6,10,39,38,1,48
Linfield,207,5,12,11,7,57,38,19,47
Glenavon,207,6,12,9,9,45,49,-4,45
Dungannon,207,7,9,12,9,56,43,13,39
Ballymena,207,8,9,8,13,49,65,-16,35
Ards,207,9,8,6,16,40,49,-9,30
Portadown,207,10,6,9,15,28,45,-17,27
Ballinamalla,207,11,6,3,21,29,62,-33,21
Linfield,208,1,17,9,4,55,21,34,60
Cliftonville,208,2,16,5,9,49,35,14,53
Crusaders,208,3,15,7,8,57,41,16,52
Ballymena,208,4,16,4,10,60,58,2,52
Glenavon,208,5,12,10,8,56,54,2,46
Coleraine,208,6,11,9,10,43,33,10,42
Dungannon,208,7,11,9,10,53,49,4,42
Ards,208,8,10,6,14,40,51,-11,36
Glentoran,208,9,7,7,16,25,45,-20,28
Portadown,208,10,7,3,20,25,52,-27,24
Ballinamalla,208,11,6,5,19,29,53,-24,23
Linfield,209,1,15,9,6,59,31,28,54
Crusaders,209,2,14,11,5,54,37,17,53
Ballymena,209,3,14,8,8,53,53,0,50
Cliftonville,209,4,15,4,11,57,41,16,49
Dungannon,209,5,10,11,9,52,38,14,41
Coleraine,209,6,9,12,9,36,34,2,39
Glenavon,209,7,8,11,11,46,54,-8,35
Ards,209,8,9,7,14,34,45,-11,34
Glentoran,209,9,9,7,14,33,47,-14,34
Portadown,209,10,8,6,16,29,48,-19,30
Ballinamalla,209,11,8,6,16,32,57,-25,30
Cliftonville,210,1,17,7,6,57,36,21,58
Linfield,210,2,14,11,5,66,33,33,53
Crusaders,210,3,15,8,7,55,37,18,53
Ballymena,210,4,14,5,11,63,68,-5,47
Ards,210,5,12,5,13,48,49,-1,41
Coleraine,210,6,9,12,9,44,44,0,39
Glenavon,210,7,9,12,9,44,46,-2,39
Dungannon,210,8,9,9,12,48,51,-3,36
Glentoran,210,9,9,5,16,29,50,-21,32
Portadown,210,10,9,2,19,26,47,-21,29
Ballinamalla,210,11,8,4,18,36,55,-19,28
Crusaders,211,1,17,6,7,47,30,17,57
Linfield,211,2,15,9,6,61,26,35,54
Coleraine,211,3,14,9,7,43,40,3,51
Dungannon,211,4,14,7,9,58,38,20,49
Cliftonville,211,5,14,3,13,49,41,8,45
Glenavon,211,6,11,12,7,46,42,4,45
Ballymena,211,7,12,4,14,53,62,-9,40
Ards,211,8,11,5,14,43,48,-5,38
Glentoran,211,9,10,7,13,31,40,-9,37
Ballinamalla,211,10,6,5,19,23,55,-32,23
Portadown,211,11,5,5,20,19,51,-32,20
Linfield,212,1,19,8,3,66,22,44,65
Coleraine,212,2,14,11,5,51,38,13,53
Crusaders,212,3,14,10,6,58,39,19,52
Ballymena,212,4,13,6,11,55,60,-5,45
Glenavon,212,5,11,10,9,46,42,4,43
Cliftonville,212,6,11,9,10,47,46,1,42
Dungannon,212,7,9,9,12,52,51,1,36
Portadown,212,8,10,4,16,33,40,-7,34
Ballinamalla,212,9,10,3,17,34,52,-18,33
Ards,212,10,9,3,18,41,57,-16,30
Glentoran,212,11,5,7,18,22,58,-36,22
Crusaders,213,1,16,10,4,52,29,23,58
Cliftonville,213,2,15,7,8,56,35,21,52
Linfield,213,3,12,12,6,53,34,19,48
Ballymena,213,4,13,8,9,57,57,0,47
Glenavon,213,5,11,11,8,47,45,2,44
Dungannon,213,6,12,7,11,51,38,13,43
Coleraine,213,7,11,10,9,45,42,3,43
Glentoran,213,8,7,10,13,28,46,-18,31
Portadown,213,9,9,3,18,31,51,-20,30
Ards,213,10,8,5,17,38,55,-17,29
Ballinamalla,213,11,7,5,18,26,52,-26,26
Linfield,214,1,15,10,5,57,27,30,55
Ballymena,214,2,14,7,9,62,57,5,49
Crusaders,214,3,13,9,8,55,47,8,48
Cliftonville,214,4,13,8,9,46,36,10,47
Coleraine,214,5,11,12,7,43,39,4,45
Glenavon,214,6,11,11,8,54,47,7,44
Dungannon,214,7,10,10,10,52,43,9,40
Portadown,214,8,9,5,16,26,45,-19,32
Ballinamalla,214,9,8,7,15,29,49,-20,31
Ards,214,10,8,6,16,35,46,-11,30
Glentoran,214,11,6,9,15,27,50,-23,27
Crusaders,215,1,19,8,3,64,26,38,65
Ballymena,215,2,15,6,9,62,55,7,51
Cliftonville,215,3,15,4,11,54,44,10,49
Linfield,215,4,13,9,8,57,37,20,48
Coleraine,215,5,12,10,8,44,38,6,46
Glentoran,215,6,14,4,12,33,40,-7,46
Dungannon,215,7,9,8,13,47,50,-3,35
Glenavon,215,8,7,12,11,41,52,-11,33
Ards,215,9,9,6,15,35,48,-13,33
Portadown,215,10,8,5,17,25,43,-18,29
Ballinamalla,215,11,7,2,21,27,56,-29,23
Crusaders,216,1,17,9,4,55,31,24,60
Ballymena,216,2,17,5,8,60,54,6,56
Coleraine,216,3,13,9,8,49,42,7,48
Linfield,216,4,13,7,10,55,33,22,46
Cliftonville,216,5,14,4,12,52,44,8,46
Glenavon,216,6,10,9,11,47,45,2,39
Dungannon,216,7,8,11,11,48,49,-1,35
Portadown,216,8,10,5,15,26,42,-16,35
Glentoran,216,9,8,8,14,29,41,-12,32
Ballinamalla,216,10,8,6,16,26,48,-22,30
Ards,216,11,8,5,17,34,52,-18,29
Linfield,217,1,16,10,4,58,23,35,58
Cliftonville,217,2,15,5,10,55,37,18,50
Glenavon,217,3,13,10,7,43,37,6,49
Ballymena,217,4,14,6,10,58,56,2,48
Dungannon,217,5,12,7,11,51,41,10,43
Crusaders,217,6,12,7,11,41,42,-1,43
Coleraine,217,7,8,14,8,33,34,-1,38
Portadown,217,8,10,6,14,26,39,-13,36
Glentoran,217,9,9,8,13,24,38,-14,35
Ards,217,10,9,5,16,32,44,-12,32
Ballinamalla,217,11,6,4,20,24,54,-30,22
Crusaders,218,1,17,9,4,63,32,31,60
Linfield,218,2,13,10,7,62,37,25,49
Cliftonville,218,3,14,5,11,51,45,6,47
Glenavon,218,4,11,12,7,54,51,3,45
Dungannon,218,5,12,8,10,57,44,13,44
Ballymena,218,6,13,5,12,59,66,-7,44
Ards,218,7,11,6,13,45,49,-4,39
Coleraine,218,8,9,11,10,44,43,1,38
Portadown,218,9,8,6,16,32,50,-18,30
Glentoran,218,10,7,9,14,31,55,-24,30
Ballinamalla,218,11,6,7,17,34,60,-26,25
Crusaders,219,1,16,8,6,52,30,22,56
Glenavon,219,2,15,9,6,57,38,19,54
Cliftonville,219,3,15,6,9,50,35,15,51
Ballymena,219,4,13,7,10,55,59,-4,46
Linfield,219,5,12,9,9,52,37,15,45
Coleraine,219,6,10,11,9,45,41,4,41
Glentoran,219,7,11,8,11,31,38,-7,41
Dungannon,219,8,9,9,12,44,44,0,36
Ballinamalla,219,9,8,6,16,26,47,-21,30
Portadown,219,10,8,4,18,23,49,-26,28
Ards,219,11,6,7,17,36,53,-17,25
Crusaders,220,1,17,8,5,53,26,27,59
Cliftonville,220,2,17,4,9,58,44,14,55
Ballymena,220,3,14,7,9,57,56,1,49
Coleraine,220,4,13,9,8,42,32,10,48
Linfield,220,5,12,9,9,53,40,13,45
Glenavon,220,6,9,13,8,49,42,7,40
Dungannon,220,7,10,7,13,51,54,-3,37
Ards,220,8,10,5,15,38,45,-7,35
Glentoran,220,9,8,9,13,34,50,-16,33
Portadown,220,10,8,4,18,30,48,-18,28
Ballinamalla,220,11,7,5,18,33,61,-28,26
Linfield,221,1,15,11,4,63,32,31,56
Cliftonville,221,2,17,4,9,63,44,19,55
Crusaders,221,3,16,6,8,63,44,19,54
Glenavon,221,4,11,10,9,58,49,9,43
Dungannon,221,5,11,8,11,52,45,7,41
Ballymena,221,6,11,7,12,55,63,-8,40
Coleraine,221,7,9,12,9,47,46,1,39
Ards,221,8,10,4,16,34,53,-19,34
Ballinamalla,221,9,8,7,15,29,49,-20,31
Glentoran,221,10,7,9,14,28,45,-17,30
Portadown,221,11,6,10,14,28,50,-22,28
Linfield,222,1,18,7,5,60,22,38,61
Crusaders,222,2,18,5,7,54,38,16,59
Glenavon,222,3,14,9,7,47,40,7,51
Cliftonville,222,4,15,4,11,55,40,15,49
Coleraine,222,5,11,11,8,47,38,9,44
Glentoran,222,6,12,5,13,33,41,-8,41
Ballymena,222,7,12,4,14,53,55,-2,40
Dungannon,222,8,10,7,13,52,51,1,37
Ards,222,9,9,3,18,39,59,-20,30
Portadown,222,10,8,5,17,23,46,-23,29
Ballinamalla,222,11,7,2,21,31,64,-33,23
Crusaders,223,1,16,7,7,54,45,9,55
Linfield,223,2,13,13,4,66,35,31,52
Cliftonville,223,3,15,3,12,55,41,14,48
Ballymena,223,4,13,7,10,58,66,-8,46
Coleraine,223,5,12,9,9,49,41,8,45
Glenavon,223,6,10,12,8,49,48,1,42
Dungannon,223,7,10,8,12,48,42,6,38
Ards,223,8,9,7,14,38,49,-11,34
Portadown,223,9,10,4,16,30,46,-16,34
Glentoran,223,10,7,9,14,32,49,-17,30
Ballinamalla,223,11,7,7,16,33,50,-17,28
Cliftonville,224,1,18,7,5,61,31,30,61
Linfield,224,2,16,8,6,63,32,31,56
Crusaders,224,3,15,7,8,49,37,12,52
Ballymena,224,4,16,4,10,60,60,0,52
Glenavon,224,5,13,10,7,52,45,7,49
Coleraine,224,6,12,9,9,48,39,9,45
Glentoran,224,7,12,4,14,39,48,-9,40
Dungannon,224,8,10,7,13,49,44,5,37
Ards,224,9,6,6,18,33,55,-22,24
Ballinamalla,224,10,6,5,19,30,61,-31,23
Portadown,224,11,6,3,21,23,55,-32,21
Crusaders,225,1,15,11,4,54,34,20,56
Cliftonville,225,2,17,4,9,51,33,18,55
Ballymena,225,3,16,6,8,65,56,9,54
Glenavon,225,4,12,10,8,47,44,3,46
Linfield,225,5,11,11,8,52,39,13,44
Coleraine,225,6,11,11,8,41,34,7,44
Dungannon,225,7,11,10,9,54,44,10,43
Glentoran,225,8,11,6,13,37,47,-10,39
Ards,225,9,9,4,17,39,50,-11,31
Portadown,225,10,6,3,21,20,47,-27,21
Ballinamalla,225,11,4,8,18,24,56,-32,20
Glenavon,226,1,14,11,5,52,38,14,53
Linfield,226,2,14,8,8,49,29,20,50
Crusaders,226,3,14,7,9,52,36,16,49
Cliftonville,226,4,14,6,10,57,43,14,48
Coleraine,226,5,12,12,6,49,38,11,48
Ballymena,226,6,14,6,10,57,61,-4,48
Dungannon,226,7,11,10,9,52,44,8,43
Glentoran,226,8,9,9,12,31,42,-11,36
Ards,226,9,11,3,16,40,52,-12,36
Ballinamalla,226,10,6,4,20,30,59,-29,22
Portadown,226,11,5,6,19,20,47,-27,21
Crusaders,227,1,16,8,6,56,36,20,56
Linfield,227,2,14,10,6,55,24,31,52
Cliftonville,227,3,15,7,8,53,36,17,52
Glenavon,227,4,11,12,7,42,41,1,45
Ballymena,227,5,12,7,11,48,56,-8,43
Coleraine,227,6,10,11,9,41,40,1,41
Glentoran,227,7,11,6,13,37,43,-6,39
Ards,227,8,10,6,14,36,47,-11,36
Dungannon,227,9,8,10,12,50,46,4,34
Portadown,227,10,8,4,18,25,49,-24,28
Ballinamalla,227,11,6,7,17,24,49,-25,25
Coleraine,228,1,15,9,6,43,29,14,54
Linfield,228,2,14,10,6,59,37,22,52
Crusaders,228,3,14,9,7,55,38,17,51
Ballymena,228,4,14,6,10,55,56,-1,48
Cliftonville,228,5,14,5,11,49,44,5,47
Glenavon,228,6,11,9,10,45,44,1,42
Glentoran,228,7,10,7,13,40,44,-4,37
Ards,228,8,10,4,16,41,51,-10,34
Portadown,228,9,9,6,15,28,38,-10,33
Ballinamalla,228,10,8,6,16,25,48,-23,30
Dungannon,228,11,6,9,15,40,51,-11,27
Crusaders,229,1,18,8,4,62,33,29,62
Cliftonville,229,2,17,5,8,48,28,20,56
Ballymena,229,3,16,8,6,59,48,11,56
Linfield,229,4,12,10,8,55,30,25,46
Coleraine,229,5,11,11,8,44,39,5,44
Ards,229,6,10,7,13,37,45,-8,37
Dungannon,229,7,7,12,11,49,47,2,33
Glenavon,229,8,7,12,11,34,46,-12,33
Portadown,229,9,10,3,17,27,49,-22,33
Glentoran,229,10,6,8,16,23,48,-25,26
Ballinamalla,229,11,7,4,19,29,54,-25,25
Linfield,230,1,14,8,8,52,31,21,50
Crusaders,230,2,14,7,9,52,48,4,49
Ballymena,230,3,15,4,11,60,61,-1,49
Coleraine,230,4,12,12,6,46,35,11,48
Glenavon,230,5,11,13,6,45,36,9,46
Glentoran,230,6,13,5,12,36,39,-3,44
Cliftonville,230,7,12,6,12,52,46,6,42
Dungannon,230,8,8,11,11,46,44,2,35
Ards,230,9,9,5,16,36,47,-11,32
Ballinamalla,230,10,9,5,16,33,51,-18,32
Portadown,230,11,6,8,16,25,45,-20,26
Crusaders,231,1,17,8,5,57,31,26,59
Linfield,231,2,15,8,7,61,30,31,53
Glenavon,231,3,12,12,6,51,45,6,48
Ballymena,231,4,13,8,9,55,56,-1,47
Cliftonville,231,5,13,4,13,54,50,4,43
Coleraine,231,6,10,11,9,52,52,0,41
Dungannon,231,7,10,10,10,50,39,11,40
Glentoran,231,8,10,8,12,31,41,-10,38
Portadown,231,9,8,5,17,26,50,-24,29
Ards,231,10,7,7,16,32,50,-18,28
Ballinamalla,231,11,7,5,18,26,51,-25,26
Crusaders,232,1,16,10,4,54,29,25,58
Cliftonville,232,2,16,6,8,48,34,14,54
Linfield,232,3,12,11,7,51,34,17,47
Glenavon,232,4,11,13,6,49,43,6,46
Ballymena,232,5,12,5,13,56,59,-3,41
Ards,232,6,11,7,12,51,47,4,40
Coleraine,232,7,9,12,9,40,40,0,39
Glentoran,232,8,10,7,13,34,40,-6,37
Ballinamalla,232,9,9,5,16,23,47,-24,32
Portadown,232,10,7,8,15,25,48,-23,29
Dungannon,232,11,4,12,14,37,47,-10,24
Crusaders,233,1,19,7,4,58,32,26,64
Ballymena,233,2,15,7,8,66,56,10,52
Linfield,233,3,13,9,8,55,37,18,48
Coleraine,233,4,11,13,6,45,37,8,46
Cliftonville,233,5,13,4,13,52,46,6,43
Glenavon,233,6,9,14,7,43,41,2,41
Dungannon,233,7,10,10,10,46,38,8,40
Ards,233,8,11,4,15,43,44,-1,37
Glentoran,233,9,7,9,14,35,53,-18,30
Portadown,233,10,8,5,17,28,54,-26,29
Ballinamalla,233,11,6,4,20,23,56,-33,22
Crusaders,234,1,18,7,5,53,30,23,61
Cliftonville,234,2,16,5,9,58,42,16,53
Ballymena,234,3,15,7,8,64,60,4,52
Linfield,234,4,13,10,7,58,32,26,49
Coleraine,234,5,11,10,9,44,38,6,43
Glenavon,234,6,10,11,9,49,46,3,41
Dungannon,234,7,9,11,10,45,38,7,38
Ballinamalla,234,8,11,4,15,30,44,-14,37
Ards,234,9,8,7,15,36,50,-14,31
Glentoran,234,10,7,4,19,25,57,-32,25
Portadown,234,11,6,6,18,23,48,-25,24
Crusaders,235,1,17,9,4,56,24,32,60
Cliftonville,235,2,17,4,9,55,45,10,55
Linfield,235,3,12,10,8,53,33,20,46
Ballymena,235,4,12,6,12,56,58,-2,42
Coleraine,235,5,10,11,9,40,44,-4,41
Ards,235,6,11,7,12,40,42,-2,40
Dungannon,235,7,10,9,11,48,43,5,39
Glenavon,235,8,9,12,9,42,45,-3,39
Glentoran,235,9,9,6,15,26,44,-18,33
Portadown,235,10,9,5,16,29,43,-14,32
Ballinamalla,235,11,7,5,18,21,45,-24,26
Cliftonville,236,1,17,5,8,53,34,19,56
Linfield,236,2,15,7,8,62,35,27,52
Crusaders,236,3,15,7,8,53,41,12,52
Ballymena,236,4,14,8,8,54,52,2,50
Glenavon,236,5,12,13,5,51,43,8,49
Dungannon,236,6,11,11,8,50,39,11,44
Coleraine,236,7,10,9,11,42,43,-1,39
Glentoran,236,8,9,7,14,26,41,-15,34
Ards,236,9,10,4,16,40,56,-16,34
Ballinamalla,236,10,7,4,19,33,55,-22,25
Portadown,236,11,4,7,19,21,46,-25,19
Crusaders,237,1,17,8,5,55,30,25,59
Ballymena,237,2,15,6,9,60,52,8,51
Linfield,237,3,14,8,8,52,32,20,50
Dungannon,237,4,13,7,10,53,43,10,46
Coleraine,237,5,12,9,9,39,38,1,45
Glenavon,237,6,12,8,10,48,50,-2,44
Cliftonville,237,7,13,4,13,44,42,2,43
Glentoran,237,8,10,9,11,37,44,-7,39
Ballinamalla,237,9,10,5,15,34,44,-10,35
Ards,237,10,9,2,19,35,52,-17,29
Portadown,237,11,4,6,20,18,48,-30,18
Crusaders,238,1,18,6,6,61,36,25,60
Linfield,238,2,16,10,4,66,30,36,58
Coleraine,238,3,13,11,6,39,29,10,50
Glenavon,238,4,13,10,7,49,42,7,49
Ballymena,238,5,12,11,7,52,51,1,47
Cliftonville,238,6,11,6,13,40,47,-7,39
Ballinamalla,238,7,9,5,16,34,45,-11,32
Dungannon,238,8,7,10,13,39,44,-5,31
Glentoran,238,9,7,10,13,24,43,-19,31
Portadown,238,10,7,6,17,23,43,-20,27
Ards,238,11,6,7,17,34,51,-17,25
Crusaders,239,1,16,10,4,52,24,28,58
Linfield,239,2,16,9,5,59,26,33,57
Cliftonville,239,3,15,4,11,56,46,10,49
Glenavon,239,4,11,11,8,52,49,3,44
Ballymena,239,5,12,7,11,58,63,-5,43
Dungannon,239,6,11,8,11,52,50,2,41
Coleraine,239,7,10,10,10,34,38,-4,40
Glentoran,239,8,9,7,14,38,49,-11,34
Ards,239,9,9,6,15,39,46,-7,33
Ballinamalla,239,10,8,4,18,32,57,-25,28
Portadown,239,11,6,8,16,27,51,-24,26
Linfield,240,1,16,9,5,58,26,32,57
Cliftonville,240,2,17,4,9,55,39,16,55
Ballymena,240,3,14,6,10,58,54,4,48
Coleraine,240,4,12,11,7,45,41,4,47
Dungannon,240,5,12,9,9,62,47,15,45
Crusaders,240,6,13,5,12,48,44,4,44
Glenavon,240,7,8,14,8,39,42,-3,38
Ballinamalla,240,8,8,7,15,26,43,-17,31
Glentoran,240,9,8,7,15,28,50,-22,31
Ards,240,10,8,5,17,39,53,-14,29
Portadown,240,11,7,7,16,24,43,-19,28
Linfield,241,1,15,10,5,59,27,32,55
Crusaders,241,2,15,6,9,56,36,20,51
Cliftonville,241,3,15,4,11,57,45,12,49
Dungannon,241,4,11,10,9,44,38,6,43
Glentoran,241,5,11,9,10,38,39,-1,42
Glenavon,241,6,11,9,10,44,47,-3,42
Ballymena,241,7,11,8,11,57,64,-7,41
Coleraine,241,8,9,12,9,38,40,-2,39
Ards,241,9,11,4,15,38,52,-14,37
Ballinamalla,241,10,8,4,18,33,52,-19,28
Portadown,241,11,7,6,17,27,51,-24,27
Linfield,242,1,15,11,4,65,32,33,56
Crusaders,242,2,14,10,6,51,34,17,52
Cliftonville,242,3,16,3,11,54,40,14,51
Glentoran,242,4,14,8,8,44,42,2,50
Ballymena,242,5,13,9,8,60,61,-1,48
Coleraine,242,6,9,16,5,41,36,5,43
Glenavon,242,7,9,14,7,56,47,9,41
Dungannon,242,8,9,10,11,49,47,2,37
Portadown,242,9,6,6,18,22,45,-23,24
Ards,242,10,6,5,19,30,56,-26,23
Ballinamalla,242,11,6,4,20,25,57,-32,22
Cliftonville,243,1,18,4,8,58,33,25,58
Glenavon,243,2,15,9,6,56,41,15,54
Crusaders,243,3,15,7,8,59,41,18,52
Ballymena,243,4,13,7,10,56,59,-3,46
Linfield,243,5,11,8,11,55,38,17,41
Ards,243,6,13,2,15,42,46,-4,41
Dungannon,243,7,10,9,11,50,46,4,39
Glentoran,243,8,11,4,15,36,45,-9,37
Coleraine,243,9,8,10,12,38,52,-14,34
Ballinamalla,243,10,9,5,16,33,57,-24,32
Portadown,243,11,7,5,18,20,45,-25,26
Crusaders,244,1,19,6,5,52,23,29,63
Glenavon,244,2,13,10,7,54,44,10,49
Dungannon,244,3,14,7,9,51,45,6,49
Linfield,244,4,12,12,6,52,29,23,48
Coleraine,244,5,13,9,8,47,38,9,48
Cliftonville,244,6,13,6,11,49,38,11,45
Ballymena,244,7,13,6,11,61,61,0,45
Glentoran,244,8,9,7,14,27,42,-15,34
Ards,244,9,9,3,18,38,52,-14,30
Ballinamalla,244,10,8,3,19,31,55,-24,27
Portadown,244,11,5,5,20,26,61,-35,20
Crusaders,245,1,16,10,4,62,30,32,58
Ballymena,245,2,14,10,6,57,48,9,52
Linfield,245,3,12,11,7,53,37,16,47
Cliftonville,245,4,13,7,10,45,43,2,46
Glenavon,245,5,9,13,8,46,49,-3,40
Ards,245,6,11,6,13,40,43,-3,39
Dungannon,245,7,8,11,11,54,55,-1,35
Coleraine,245,8,8,11,11,34,46,-12,35
Portadown,245,9,9,6,15,30,40,-10,33
Glentoran,245,10,8,7,15,27,41,-14,31
Ballinamalla,245,11,9,4,17,31,47,-16,31
Linfield,246,1,15,7,8,58,35,23,52
Crusaders,246,2,15,7,8,51,38,13,52
Cliftonville,246,3,15,5,10,50,46,4,50
Coleraine,246,4,12,12,6,49,40,9,48
Ballymena,246,5,14,6,10,49,50,-1,48
Glenavon,246,6,12,10,8,50,46,4,46
Dungannon,246,7,10,10,10,56,43,13,40
Ards,246,8,8,9,13,36,44,-8,33
Ballinamalla,246,9,8,6,16,38,55,-17,30
Portadown,246,10,9,2,19,25,46,-21,29
Glentoran,246,11,6,8,16,26,45,-19,26
Crusaders,247,1,17,6,7,56,34,22,57
Linfield,247,2,15,8,7,59,35,24,53
Coleraine,247,3,13,10,7,46,37,9,49
Ballymena,247,4,14,6,10,59,58,1,48
Dungannon,247,5,12,9,9,50,42,8,45
Cliftonville,247,6,13,5,12,47,42,5,44
Glenavon,247,7,10,12,8,50,45,5,42
Ballinamalla,247,8,9,5,16,31,54,-23,32
Portadown,247,9,9,3,18,20,40,-20,30
Ards,247,10,7,8,15,40,54,-14,29
Glentoran,247,11,7,6,17,29,46,-17,27
Linfield,248,1,15,10,5,55,26,29,55
Crusaders,248,2,16,7,7,54,32,22,55
Glenavon,248,3,13,11,6,51,39,12,50
Cliftonville,248,4,14,6,10,50,41,9,48
Coleraine,248,5,12,11,7,48,35,13,47
Ballymena,248,6,11,8,11,51,60,-9,41
Dungannon,248,7,9,11,10,46,42,4,38
Ards,248,8,9,4,17,35,53,-18,31
Portadown,248,9,7,9,14,27,42,-15,30
Ballinamalla,248,10,8,6,16,25,46,-21,30
Glentoran,248,11,7,5,18,26,52,-26,26
Crusaders,249,1,19,5,6,58,30,28,62
Linfield,249,2,16,9,5,58,25,33,57
Ballymena,249,3,13,6,11,48,51,-3,45
Glenavon,249,4,12,9,9,44,51,-7,45
Cliftonville,249,5,13,5,12,46,37,9,44
Coleraine,249,6,11,9,10,38,37,1,42
Dungannon,249,7,11,8,11,51,41,10,41
Glentoran,249,8,10,8,12,32,37,-5,38
Ards,249,9,8,7,15,32,48,-16,31
Portadown,249,10,6,8,16,20,42,-22,26
Ballinamalla,249,11,6,6,18,24,52,-28,24
Glenavon,250,1,14,12,4,52,40,12,54
Crusaders,250,2,14,10,6,52,30,22,52
Cliftonville,250,3,14,6,10,50,40,10,48
Coleraine,250,4,11,11,8,39,36,3,44
Ballymena,250,5,13,5,12,51,54,-3,44
Linfield,250,6,11,10,9,51,34,17,43
Glentoran,250,7,10,9,11,31,40,-9,39
Dungannon,250,8,10,8,12,54,52,2,38
Ards,250,9,8,9,13,34,44,-10,33
Portadown,250,10,6,8,16,29,44,-15,26
Ballinamalla,250,11,6,8,16,27,56,-29,26
Crusaders,251,1,19,7,4,65,35,30,64
Ballymena,251,2,17,5,8,63,49,14,56
Cliftonville,251,3,14,6,10,55,39,16,48
Glenavon,251,4,13,8,9,58,55,3,47
Linfield,251,5,12,10,8,53,33,20,46
Coleraine,251,6,10,12,8,47,42,5,42
Ards,251,7,12,5,13,42,44,-2,41
Dungannon,251,8,8,10,12,49,52,-3,34
Glentoran,251,9,7,7,16,30,57,-27,28
Portadown,251,10,8,4,18,29,56,-27,28
Ballinamalla,251,11,6,4,20,27,56,-29,22
Crusaders,252,1,18,6,6,53,33,20,60
Linfield,252,2,17,8,5,66,29,37,59
Cliftonville,252,3,16,4,10,50,41,9,52
Ballymena,252,4,13,7,10,60,58,2,46
Glenavon,252,5,11,11,8,52,44,8,44
Coleraine,252,6,11,10,9,44,45,-1,43
Dungannon,252,7,11,9,10,48,43,5,42
Glentoran,252,8,8,9,13,32,45,-13,33
Ards,252,9,8,5,17,33,49,-16,29
Ballinamalla,252,10,6,7,17,23,46,-23,25
Portadown,252,11,5,6,19,24,52,-28,21
Crusaders,253,1,19,6,5,60,32,28,63
Linfield,253,2,15,9,6,69,41,28,54
Coleraine,253,3,13,11,6,48,36,12,50
Cliftonville,253,4,14,7,9,51,38,13,49
Ballymena,253,5,14,5,11,53,58,-5,47
Glenavon,253,6,12,9,9,56,52,4,45
Dungannon,253,7,9,10,11,48,50,-2,37
Ards,253,8,11,4,15,34,43,-9,37
Glentoran,253,9,8,9,13,36,49,-13,33
Ballinamalla,253,10,6,3,21,30,55,-25,21
Portadown,253,11,5,5,20,19,50,-31,20
Crusaders,254,1,16,10,4,58,32,26,58
Linfield,254,2,14,9,7,58,34,24,51
Ballymena,254,3,14,7,9,62,54,8,49
Cliftonville,254,4,14,6,10,49,37,12,48
Glenavon,254,5,13,9,8,49,41,8,48
Coleraine,254,6,9,12,9,39,44,-5,39
Dungannon,254,7,9,11,10,51,44,7,38
Glentoran,254,8,9,8,13,29,46,-17,35
Ards,254,9,7,7,16,31,49,-18,28
Ballinamalla,254,10,7,6,17,28,51,-23,27
Portadown,254,11,5,11,14,22,44,-22,26
Crusaders,255,1,16,9,5,59,37,22,57
Cliftonville,255,2,13,9,8,53,39,14,48
Ballymena,255,3,13,8,9,55,57,-2,47
Linfield,255,4,12,10,8,58,39,19,46
Glenavon,255,5,11,12,7,46,42,4,45
Coleraine,255,6,10,12,8,43,37,6,42
Dungannon,255,7,10,9,11,51,40,11,39
Glentoran,255,8,10,7,13,32,43,-11,37
Ards,255,9,8,7,15,37,54,-17,31
Ballinamalla,255,10,9,4,17,26,51,-25,31
Portadown,255,11,7,5,18,24,45,-21,26
Cliftonville,256,1,18,3,9,59,33,26,57
Crusaders,256,2,16,9,5,56,33,23,57
Linfield,256,3,15,8,7,54,33,21,53
Ballymena,256,4,15,8,7,56,53,3,53
Glenavon,256,5,10,13,7,42,43,-1,43
Dungannon,256,6,10,12,8,53,37,16,42
Coleraine,256,7,8,12,10,42,42,0,36
Ballinamalla,256,8,9,3,18,31,56,-25,30
Glentoran,256,9,7,8,15,32,50,-18,29
Ards,256,10,8,4,18,35,52,-17,28
Portadown,256,11,6,6,18,21,49,-28,24
Crusaders,257,1,16,7,7,61,40,21,55
Linfield,257,2,14,9,7,54,28,26,51
Glenavon,257,3,14,8,8,48,43,5,50
Cliftonville,257,4,14,5,11,53,41,12,47
Ballymena,257,5,14,5,11,63,57,6,47
Coleraine,257,6,13,8,9,45,39,6,47
Ballinamalla,257,7,12,4,14,34,46,-12,40
Dungannon,257,8,10,9,11,45,43,2,39
Glentoran,257,9,7,9,14,30,47,-17,30
Ards,257,10,7,9,14,30,49,-19,30
Portadown,257,11,6,3,21,22,52,-30,21
Linfield,258,1,16,8,6,59,29,30,56
Ballymena,258,2,17,5,8,61,57,4,56
Crusaders,258,3,15,6,9,51,32,19,51
Cliftonville,258,4,15,3,12,53,43,10,48
Glenavon,258,5,12,9,9,44,42,2,45
Coleraine,258,6,11,11,8,40,35,5,44
Dungannon,258,7,9,9,12,45,46,-1,36
Glentoran,258,8,9,7,14,33,44,-11,34
Ballinamalla,258,9,10,3,17,30,51,-21,33
Ards,258,10,8,5,17,31,48,-17,29
Portadown,258,11,8,4,18,25,45,-20,28
Linfield,259,1,17,8,5,51,25,26,59
Crusaders,259,2,14,11,5,58,36,22,53
Cliftonville,259,3,16,5,9,49,36,13,53
Coleraine,259,4,13,12,5,48,35,13,51
Ballymena,259,5,15,6,9,56,52,4,51
Glenavon,259,6,10,11,9,41,42,-1,41
Glentoran,259,7,8,8,14,35,50,-15,32
Dungannon,259,8,6,13,11,41,42,-1,31
Ballinamalla,259,9,9,3,18,34,53,-19,30
Ards,259,10,7,7,16,37,51,-14,28
Portadown,259,11,6,4,20,29,57,-28,22
Linfield,260,1,16,7,7,57,29,28,55
Crusaders,260,2,16,7,7,59,43,16,55
Ballymena,260,3,17,3,10,63,54,9,54
Dungannon,260,4,15,7,8,56,39,17,52
Cliftonville,260,5,15,4,11,51,39,12,49
Coleraine,260,6,10,10,10,42,45,-3,40
Glenavon,260,7,9,10,11,39,45,-6,37
Glentoran,260,8,9,8,13,36,52,-16,35
Ballinamalla,260,9,8,7,15,34,48,-14,31
Ards,260,10,7,5,18,37,53,-16,26
Portadown,260,11,7,4,19,23,50,-27,25
Linfield,261,1,15,10,5,56,26,30,55
Glenavon,261,2,13,11,6,61,46,15,50
Cliftonville,261,3,14,8,8,58,44,14,50
Crusaders,261,4,14,6,10,50,35,15,48
Ballymena,261,5,13,9,8,56,56,0,48
Dungannon,261,6,11,9,10,51,46,5,42
Coleraine,261,7,9,10,11,41,47,-6,37
Glentoran,261,8,9,8,13,31,47,-16,35
Ards,261,9,8,8,14,33,46,-13,32
Portadown,261,10,6,9,15,28,45,-17,27
Ballinamalla,261,11,6,6,18,26,53,-27,24
Linfield,262,1,16,10,4,59,30,29,58
Crusaders,262,2,16,9,5,63,34,29,57
Cliftonville,262,3,15,6,9,56,39,17,51
Glenavon,262,4,13,9,8,48,44,4,48
Coleraine,262,5,11,11,8,44,38,6,44
Ballymena,262,6,11,7,12,58,62,-4,40
Dungannon,262,7,10,8,12,49,44,5,38
Glentoran,262,8,9,5,16,34,59,-25,32
Ballinamalla,262,9,9,4,17,30,52,-22,31
Portadown,262,10,8,6,16,27,49,-22,30
Ards,262,11,7,5,18,37,54,-17,26
Crusaders,263,1,16,7,7,55,35,20,55
Ballymena,263,2,14,7,9,60,56,4,49
Linfield,263,3,13,9,8,51,35,16,48
Glenavon,263,4,13,8,9,50,47,3,47
Cliftonville,263,5,13,6,11,49,42,7,45
Coleraine,263,6,10,12,8,38,34,4,42
Glentoran,263,7,9,11,10,34,43,-9,38
Dungannon,263,8,9,9,12,44,46,-2,36
Ards,263,9,8,7,15,39,51,-12,31
Ballinamalla,263,10,8,7,15,36,51,-15,31
Portadown,263,11,7,7,16,24,40,-16,28
Ballymena,264,1,17,5,8,57,49,8,56
Linfield,264,2,15,7,8,61,34,27,52
Crusaders,264,3,15,6,9,46,36,10,51
Cliftonville,264,4,15,3,12,46,38,8,48
Glenavon,264,5,11,10,9,48,46,2,43
Dungannon,264,6,10,11,9,51,43,8,41
Coleraine,264,7,10,11,9,38,37,1,41
Glentoran,264,8,9,10,11,29,42,-13,37
Ards,264,9,8,6,16,31,44,-13,30
Portadown,264,10,8,5,17,30,47,-17,29
Ballinamalla,264,11,6,8,16,32,53,-21,26
Linfield,265,1,16,9,5,60,30,30,57
Crusaders,265,2,15,8,7,52,32,20,53
Ballymena,265,3,14,6,10,67,64,3,48
Coleraine,265,4,11,12,7,47,34,13,45
Glenavon,265,5,11,12,7,41,38,3,45
Cliftonville,265,6,12,8,10,49,41,8,44
Dungannon,265,7,12,8,10,53,46,7,44
Glentoran,265,8,9,9,12,31,41,-10,36
Portadown,265,9,9,2,19,21,52,-31,29
Ards,265,10,8,4,18,36,55,-19,28
Ballinamalla,265,11,7,4,19,24,48,-24,25
Linfield,266,1,15,8,7,58,31,27,53
Cliftonville,266,2,15,5,10,54,41,13,50
Coleraine,266,3,12,11,7,47,40,7,47
Ballymena,266,4,14,5,11,61,66,-5,47
Glenavon,266,5,12,10,8,48,43,5,46
Crusaders,266,6,13,6,11,49,44,5,45
Glentoran,266,7,13,5,12,39,43,-4,44
Ballinamalla,266,8,11,3,16,36,49,-13,36
Dungannon,266,9,9,8,13,50,44,6,35
Ards,266,10,9,5,16,41,53,-12,32
Portadown,266,11,7,4,19,22,51,-29,25
Linfield,267,1,20,7,3,78,33,45,67
Crusaders,267,2,15,8,7,48,32,16,53
Cliftonville,267,3,16,4,10,54,40,14,52
Glenavon,267,4,14,8,8,53,40,13,50
Ballymena,267,5,14,8,8,60,55,5,50
Dungannon,267,6,11,10,9,52,42,10,43
Coleraine,267,7,9,12,9,39,41,-2,39
Glentoran,267,8,9,7,14,32,46,-14,34
Ards,267,9,7,4,19,34,59,-25,25
Ballinamalla,267,10,6,5,19,26,54,-28,23
Portadown,267,11,4,7,19,16,50,-34,19
Crusaders,268,1,16,10,4,53,32,21,58
Cliftonville,268,2,15,5,10,53,39,14,50
Coleraine,268,3,14,7,9,48,39,9,49
Ballymena,268,4,13,9,8,59,54,5,48
Glenavon,268,5,13,9,8,53,48,5,48
Linfield,268,6,12,9,9,54,33,21,45
Glentoran,268,7,12,7,11,36,39,-3,43
Dungannon,268,8,9,9,12,45,46,-1,36
Ballinamalla,268,9,7,6,17,27,54,-27,27
Ards,268,10,6,7,17,28,44,-16,25
Portadown,268,11,7,4,19,23,51,-28,25
Crusaders,269,1,18,5,7,56,33,23,59
Linfield,269,2,15,9,6,61,25,36,54
Cliftonville,269,3,16,4,10,52,38,14,52
Glenavon,269,4,14,9,7,53,42,11,51
Ballymena,269,5,16,3,11,55,56,-1,51
Coleraine,269,6,10,8,12,43,40,3,38
Dungannon,269,7,10,8,12,43,44,-1,38
Ards,269,8,11,4,15,37,47,-10,37
Ballinamalla,269,9,10,2,18,29,51,-22,32
Glentoran,269,10,8,6,16,26,45,-19,30
Portadown,269,11,6,4,20,23,57,-34,22
Crusaders,270,1,17,7,6,61,39,22,58
Linfield,270,2,15,9,6,57,29,28,54
Ballymena,270,3,15,6,9,69,57,12,51
Cliftonville,270,4,13,11,6,55,39,16,50
Glenavon,270,5,12,11,7,47,41,6,47
Coleraine,270,6,12,9,9,47,40,7,45
Dungannon,270,7,8,11,11,48,50,-2,35
Ballinamalla,270,8,9,6,15,34,51,-17,33
Glentoran,270,9,7,9,14,34,53,-19,30
Ards,270,10,6,8,16,34,54,-20,26
Portadown,270,11,6,3,21,28,61,-33,21
Crusaders,271,1,16,7,7,52,37,15,55
Cliftonville,271,2,15,5,10,56,47,9,50
Linfield,271,3,13,10,7,58,35,23,49
Coleraine,271,4,13,9,8,45,33,12,48
Glenavon,271,5,12,11,7,51,43,8,47
Dungannon,271,6,12,10,8,56,46,10,46
Ballymena,271,7,13,7,10,55,58,-3,46
Glentoran,271,8,9,7,14,31,43,-12,34
Ards,271,9,9,4,17,38,51,-13,31
Ballinamalla,271,10,7,4,19,26,53,-27,25
Portadown,271,11,5,8,17,25,47,-22,23
Crusaders,272,1,17,8,5,58,31,27,59
Linfield,272,2,16,8,6,63,34,29,56
Cliftonville,272,3,14,5,11,49,36,13,47
Ballymena,272,4,13,8,9,59,62,-3,47
Coleraine,272,5,11,10,9,40,37,3,43
Dungannon,272,6,11,9,10,55,44,11,42
Glenavon,272,7,10,11,9,48,48,0,41
Ards,272,8,10,6,14,39,47,-8,36
Glentoran,272,9,7,9,14,28,49,-21,30
Portadown,272,10,7,7,16,26,43,-17,28
Ballinamalla,272,11,6,5,19,20,54,-34,23
Coleraine,273,1,14,10,6,48,33,15,52
Linfield,273,2,13,11,6,55,32,23,50
Crusaders,273,3,14,8,8,54,39,15,50
Ballymena,273,4,15,5,10,74,60,14,50
Cliftonville,273,5,14,6,10,47,37,10,48
Glenavon,273,6,10,12,8,45,43,2,42
Dungannon,273,7,9,12,9,44,40,4,39
Glentoran,273,8,9,7,14,27,47,-20,34
Portadown,273,9,8,7,15,30,50,-20,31
Ballinamalla,273,10,7,6,17,29,46,-17,27
Ards,273,11,7,6,17,35,61,-26,27
Crusaders,274,1,15,8,7,51,35,16,53
Ballymena,274,2,16,5,9,67,56,11,53
Linfield,274,3,13,10,7,58,32,26,49
Cliftonville,274,4,15,4,11,51,41,10,49
Glenavon,274,5,13,8,9,52,49,3,47
Coleraine,274,6,12,10,8,44,40,4,46
Dungannon,274,7,11,7,12,45,38,7,40
Glentoran,274,8,9,7,14,29,44,-15,34
Ballinamalla,274,9,10,2,18,31,54,-23,32
Portadown,274,10,8,6,16,31,47,-16,30
Ards,274,11,6,7,17,30,53,-23,25
Crusaders,275,1,18,7,5,61,31,30,61
Linfield,275,2,14,8,8,54,31,23,50
Coleraine,275,3,11,13,6,41,32,9,46
Ballymena,275,4,11,8,11,54,59,-5,41
Cliftonville,275,5,11,7,12,48,46,2,40
Glenavon,275,6,10,10,10,48,48,0,40
Dungannon,275,7,9,12,9,49,40,9,39
Glentoran,275,8,9,10,11,27,42,-15,37
Portadown,275,9,10,5,15,34,52,-18,35
Ards,275,10,9,7,14,41,49,-8,34
Ballinamalla,275,11,7,5,18,34,61,-27,26
Linfield,276,1,15,9,6,61,33,28,54
Crusaders,276,2,15,8,7,51,33,18,53
Cliftonville,276,3,16,4,10,52,43,9,52
Ballymena,276,4,15,5,10,59,54,5,50
Glenavon,276,5,10,13,7,40,39,1,43
Coleraine,276,6,11,10,9,37,36,1,43
Glentoran,276,7,12,7,11,34,35,-1,43
Dungannon,276,8,9,8,13,47,45,2,35
Ards,276,9,8,9,13,39,46,-7,33
Ballinamalla,276,10,5,8,17,23,51,-28,23
Portadown,276,11,4,9,17,22,50,-28,21
Crusaders,277,1,16,8,6,52,30,22,56
Glenavon,277,2,12,11,7,53,46,7,47
Cliftonville,277,3,14,5,11,53,49,4,47
Linfield,277,4,11,13,6,52,34,18,46
Ballymena,277,5,13,7,10,54,56,-2,46
Coleraine,277,6,11,10,9,42,38,4,43
Ards,277,7,12,6,12,40,42,-2,42
Glentoran,277,8,10,7,13,32,42,-10,37
Dungannon,277,9,8,12,10,46,47,-1,36
Portadown,277,10,8,7,15,33,44,-11,31
Ballinamalla,277,11,6,2,22,22,51,-29,20
Cliftonville,278,1,15,6,9,56,38,18,51
Ballymena,278,2,14,7,9,63,64,-1,49
Coleraine,278,3,13,9,8,45,37,8,48
Linfield,278,4,12,11,7,58,36,22,47
Crusaders,278,5,13,7,10,52,44,8,46
Glentoran,278,6,11,7,12,34,41,-7,40
Glenavon,278,7,10,9,11,49,53,-4,39
Dungannon,278,8,9,9,12,49,49,0,36
Portadown,278,9,10,6,14,30,42,-12,36
Ards,278,10,10,5,15,41,51,-10,35
Ballinamalla,278,11,9,2,19,32,54,-22,29
Cliftonville,279,1,16,6,8,53,38,15,54
Crusaders,279,2,14,8,8,53,41,12,50
Linfield,279,3,14,7,9,62,37,25,49
Ballymena,279,4,11,11,8,55,59,-4,44
Coleraine,279,5,11,9,10,50,43,7,42
Glenavon,279,6,10,12,8,42,44,-2,42
Dungannon,279,7,10,11,9,58,43,15,41
Glentoran,279,8,10,9,11,31,39,-8,39
Portadown,279,9,7,9,14,33,49,-16,30
Ballinamalla,279,10,7,9,14,28,50,-22,30
Ards,279,11,6,7,17,37,59,-22,25
Crusaders,280,1,17,9,4,61,32,29,60
Cliftonville,280,2,17,4,9,61,40,21,55
Linfield,280,3,15,8,7,57,33,24,53
Glenavon,280,4,15,8,7,56,44,12,53
Coleraine,280,5,10,12,8,40,38,2,42
Ballymena,280,6,10,11,9,51,58,-7,41
Dungannon,280,7,9,9,12,47,43,4,36
Ards,280,8,8,7,15,42,55,-13,31
Glentoran,280,9,8,7,15,25,41,-16,31
Ballinamalla,280,10,8,3,19,30,60,-30,27
Portadown,280,11,7,4,19,20,46,-26,25
Crusaders,281,1,20,4,6,52,28,24,64
Linfield,281,2,13,10,7,63,45,18,49
Glenavon,281,3,13,10,7,49,38,11,49
Coleraine,281,4,13,9,8,43,33,10,48
Cliftonville,281,5,14,4,12,59,49,10,46
Ballymena,281,6,10,7,13,48,58,-10,37
Dungannon,281,7,9,8,13,54,48,6,35
Portadown,281,8,9,8,13,37,44,-7,35
Glentoran,281,9,9,8,13,30,48,-18,35
Ballinamalla,281,10,9,4,17,29,53,-24,31
Ards,281,11,7,6,17,33,53,-20,27
Crusaders,282,1,17,7,6,56,35,21,58
Linfield,282,2,15,10,5,55,26,29,55
Cliftonville,282,3,14,6,10,46,35,11,48
Coleraine,282,4,13,8,9,48,42,6,47
Ballymena,282,5,13,8,9,57,55,2,47
Dungannon,282,6,13,6,11,53,40,13,45
Glenavon,282,7,9,10,11,41,49,-8,37
Ards,282,8,10,5,15,36,54,-18,35
Portadown,282,9,8,6,16,23,38,-15,30
Glentoran,282,10,6,9,15,27,46,-19,27
Ballinamalla,282,11,7,5,18,27,49,-22,26
Ballymena,283,1,14,7,9,62,54,8,49
Crusaders,283,2,14,6,10,56,44,12,48
Cliftonville,283,3,13,9,8,48,37,11,48
Coleraine,283,4,12,12,6,46,40,6,48
Glenavon,283,5,12,11,7,52,44,8,47
Linfield,283,6,11,12,7,55,32,23,45
Dungannon,283,7,12,9,9,55,46,9,45
Portadown,283,8,9,5,16,30,53,-23,32
Ballinamalla,283,9,8,6,16,27,45,-18,30
Glentoran,283,10,7,9,14,24,42,-18,30
Ards,283,11,6,8,16,32,50,-18,26
Crusaders,284,1,17,5,8,65,42,23,56
Cliftonville,284,2,15,5,10,55,38,17,50
Glenavon,284,3,13,10,7,48,40,8,49
Coleraine,284,4,12,12,6,40,34,6,48
Linfield,284,5,12,9,9,52,34,18,45
Ballymena,284,6,12,9,9,55,62,-7,45
Dungannon,284,7,12,8,10,52,41,11,44
Ards,284,8,10,5,15,44,49,-5,35
Ballinamalla,284,9,9,7,14,31,48,-17,34
Glentoran,284,10,7,6,17,25,50,-25,27
Portadown,284,11,6,4,20,21,50,-29,22
Crusaders,285,1,18,7,5,62,33,29,61
Ballymena,285,2,16,7,7,62,50,12,55
Linfield,285,3,14,8,8,57,35,22,50
Cliftonville,285,4,15,4,11,52,43,9,49
Dungannon,285,5,9,14,7,58,47,11,41
Coleraine,285,6,9,13,8,43,36,7,40
Ards,285,7,11,4,15,39,47,-8,37
Glenavon,285,8,8,10,12,43,55,-12,34
Glentoran,285,9,8,8,14,21,41,-20,32
Portadown,285,10,8,6,16,22,42,-20,30
Ballinamalla,285,11,6,5,19,23,53,-30,23
Crusaders,286,1,16,10,4,58,34,24,58
Cliftonville,286,2,16,7,7,52,37,15,55
Linfield,286,3,13,11,6,60,34,26,50
Glenavon,286,4,12,12,6,49,37,12,48
Ballymena,286,5,13,6,11,53,60,-7,45
Coleraine,286,6,9,11,10,37,37,0,38
Glentoran,286,7,9,10,11,27,33,-6,37
Dungannon,286,8,8,9,13,41,42,-1,33
Ballinamalla,286,9,8,9,13,34,51,-17,33
Ards,286,10,8,7,15,37,49,-12,31
Portadown,286,11,4,6,20,23,57,-34,18
Crusaders,287,1,17,9,4,59,30,29,60
Linfield,287,2,16,8,6,62,32,30,56
Glenavon,287,3,13,10,7,56,49,7,49
Cliftonville,287,4,14,6,10,49,37,12,48
Ballymena,287,5,13,6,11,51,55,-4,45
Coleraine,287,6,10,10,10,40,42,-2,40
Glentoran,287,7,10,7,13,32,44,-12,37
Dungannon,287,8,9,8,13,45,43,2,35
Ards,287,9,8,6,16,36,53,-17,30
Portadown,287,10,7,7,16,26,45,-19,28
Ballinamalla,287,11,8,3,19,30,56,-26,27
Crusaders,288,1,19,8,3,56,25,31,65
Coleraine,288,2,12,12,6,46,36,10,48
Cliftonville,288,3,13,8,9,52,45,7,47
Dungannon,288,4,12,10,8,56,43,13,46
Linfield,288,5,10,13,7,49,37,12,43
Ballymena,288,6,12,6,12,56,58,-2,42
Glenavon,288,7,10,10,10,45,49,-4,40
Ards,288,8,10,6,14,43,50,-7,36
Glentoran,288,9,8,8,14,28,44,-16,32
Ballinamalla,288,10,7,5,18,29,50,-21,26
Portadown,288,11,7,4,19,26,49,-23,25
Crusaders,289,1,17,8,5,53,29,24,59
Cliftonville,289,2,18,3,9,60,41,19,57
Linfield,289,3,16,8,6,67,31,36,56
Coleraine,289,4,13,13,4,54,35,19,52
Glenavon,289,5,12,9,9,51,43,8,45
Ballymena,289,6,12,4,14,55,69,-14,40
Dungannon,289,7,9,9,12,44,47,-3,36
Glentoran,289,8,7,9,14,24,42,-18,30
Ards,289,9,8,5,17,32,50,-18,29
Ballinamalla,289,10,6,7,17,32,57,-25,25
Portadown,289,11,6,7,17,23,51,-28,25
Crusaders,290,1,17,8,5,58,39,19,59
Linfield,290,2,15,9,6,57,27,30,54
Glenavon,290,3,15,9,6,53,39,14,54
Cliftonville,290,4,16,3,11,56,43,13,51
Ballymena,290,5,15,4,11,63,59,4,49
Dungannon,290,6,10,11,9,48,40,8,41
Coleraine,290,7,9,11,10,36,46,-10,38
Ards,290,8,10,6,14,39,45,-6,36
Glentoran,290,9,6,10,14,23,40,-17,28
Ballinamalla,290,10,5,8,17,24,48,-24,23
Portadown,290,11,5,5,20,22,53,-31,20
Crusaders,291,1,16,7,7,53,33,20,55
Linfield,291,2,15,8,7,59,30,29,53
Cliftonville,291,3,15,5,10,52,40,12,50
Coleraine,291,4,11,12,7,44,34,10,45
Glenavon,291,5,11,11,8,49,49,0,44
Ballymena,291,6,10,11,9,58,66,-8,41
Ballinamalla,291,7,10,7,13,38,52,-14,37
Glentoran,291,8,9,8,13,36,46,-10,35
Ards,291,9,8,9,13,41,49,-8,33
Dungannon,291,10,7,9,14,48,52,-4,30
Portadown,291,11,7,5,18,28,55,-27,26
Linfield,292,1,17,9,4,59,31,28,60
Cliftonville,292,2,15,6,9,49,38,11,51
Crusaders,292,3,14,6,10,50,41,9,48
Glenavon,292,4,13,9,8,44,42,2,48
Glentoran,292,5,14,4,12,40,37,3,46
Coleraine,292,6,10,11,9,41,41,0,41
Ballymena,292,7,11,8,11,56,60,-4,41
Ards,292,8,11,5,14,46,48,-2,38
Dungannon,292,9,10,7,13,48,45,3,37
Ballinamalla,292,10,6,6,18,28,53,-25,24
Portadown,292,11,6,5,19,22,47,-25,23
Crusaders,293,1,16,7,7,53,34,19,55
Cliftonville,293,2,15,8,7,50,30,20,53
Ballymena,293,3,16,5,9,57,52,5,53
Dungannon,293,4,12,9,9,54,39,15,45
Glenavon,293,5,11,12,7,45,49,-4,45
Coleraine,293,6,10,12,8,43,40,3,42
Linfield,293,7,11,8,11,50,33,17,41
Glentoran,293,8,11,8,11,33,39,-6,41
Ards,293,9,7,7,16,37,53,-16,28
Portadown,293,10,6,9,15,24,46,-22,27
Ballinamalla,293,11,5,5,20,26,57,-31,20
Crusaders,294,1,18,11,1,57,26,31,65
Linfield,294,2,14,11,5,56,28,28,53
Ballymena,294,3,14,9,7,53,48,5,51
Cliftonville,294,4,14,6,10,55,42,13,48
Coleraine,294,5,13,8,9,48,40,8,47
Glentoran,294,6,9,9,12,30,46,-16,36
Dungannon,294,7,8,11,11,53,50,3,35
Glenavon,294,8,7,13,10,37,44,-7,34
Ards,294,9,8,5,17,32,49,-17,29
Portadown,294,10,8,5,17,25,43,-18,29
Ballinamalla,294,11,5,6,19,26,56,-30,21
Crusaders,295,1,16,12,2,59,35,24,60
Ballymena,295,2,17,4,9,66,57,9,55
Cliftonville,295,3,15,4,11,59,50,9,49
Coleraine,295,4,13,9,8,44,35,9,48
Linfield,295,5,12,11,7,58,38,20,47
Glenavon,295,6,11,11,8,51,48,3,44
Ards,295,7,9,8,13,39,48,-9,35
Glentoran,295,8,8,8,14,31,48,-17,32
Ballinamalla,295,9,7,8,15,31,48,-17,29
Dungannon,295,10,5,10,15,44,54,-10,25
Portadown,295,11,6,7,17,28,49,-21,25
Crusaders,296,1,15,7,8,53,39,14,52
Coleraine,296,2,13,12,5,45,29,16,51
Glenavon,296,3,13,12,5,52,40,12,51
Ballymena,296,4,14,7,9,58,58,0,49
Linfield,296,5,13,9,8,56,32,24,48
Cliftonville,296,6,14,3,13,47,44,3,45
Dungannon,296,7,9,10,11,50,47,3,37
Portadown,296,8,9,5,16,33,44,-11,32
Glentoran,296,9,7,10,13,26,42,-16,31
Ballinamalla,296,10,8,5,17,24,47,-23,29
Ards,296,11,7,6,17,35,57,-22,27
Cliftonville,297,1,17,5,8,63,38,25,56
Crusaders,297,2,14,10,6,51,34,17,52
Linfield,297,3,13,10,7,59,32,27,49
Ballymena,297,4,12,11,7,54,55,-1,47
Glentoran,297,5,12,9,9,32,38,-6,45
Glenavon,297,6,10,14,6,52,45,7,44
Dungannon,297,7,11,9,10,48,39,9,42
Coleraine,297,8,11,9,10,45,45,0,42
Ards,297,9,10,4,16,37,48,-11,34
Portadown,297,10,6,3,21,20,58,-38,21
Ballinamalla,297,11,5,4,21,21,50,-29,19
Crusaders,298,1,16,8,6,53,38,15,56
Cliftonville,298,2,15,7,8,64,39,25,52
Linfield,298,3,14,10,6,59,36,23,52
Glenavon,298,4,13,11,6,50,37,13,50
Ballymena,298,5,13,7,10,56,63,-7,46
Dungannon,298,6,11,11,8,53,39,14,44
Coleraine,298,7,10,9,11,40,42,-2,39
Glentoran,298,8,9,8,13,31,43,-12,35
Ards,298,9,8,6,16,36,51,-15,30
Ballinamalla,298,10,8,2,20,27,55,-28,26
Portadown,298,11,6,5,19,25,51,-26,23
Crusaders,299,1,18,7,5,61,33,28,61
Ballymena,299,2,14,7,9,61,59,2,49
Glenavon,299,3,13,9,8,48,43,5,48
Cliftonville,299,4,14,5,11,52,44,8,47
Coleraine,299,5,11,11,8,48,38,10,44
Linfield,299,6,11,10,9,59,43,16,43
Dungannon,299,7,9,8,13,49,50,-1,35
Glentoran,299,8,9,7,14,31,43,-12,34
Ards,299,9,8,8,14,36,53,-17,32
Portadown,299,10,8,7,15,27,40,-13,31
Ballinamalla,299,11,8,5,17,29,55,-26,29
Crusaders,300,1,16,9,5,51,30,21,57
Ballymena,300,2,15,6,9,62,56,6,51
Linfield,300,3,13,9,8,53,31,22,48
Coleraine,300,4,12,11,7,43,32,11,47
Cliftonville,300,5,14,5,11,49,42,7,47
Dungannon,300,6,11,9,10,48,43,5,42
Ards,300,7,11,6,13,39,43,-4,39
Glenavon,300,8,9,10,11,49,54,-5,37
Glentoran,300,9,8,7,15,28,50,-22,31
Portadown,300,10,9,2,19,29,51,-22,29
Ballinamalla,300,11,7,6,17,31,50,-19,27
Crusaders,301,1,18,8,4,67,36,31,62
Linfield,301,2,14,9,7,59,32,27,51
Ballymena,301,3,14,7,9,60,57,3,49
Cliftonville,301,4,12,8,10,49,45,4,44
Glenavon,301,5,10,13,7,49,44,5,43
Coleraine,301,6,11,8,11,40,42,-2,41
Dungannon,301,7,9,10,11,57,55,2,37
Ards,301,8,10,5,15,37,48,-11,35
Portadown,301,9,9,5,16,29,48,-19,32
Glentoran,301,10,7,9,14,32,47,-15,30
Ballinamalla,301,11,7,6,17,30,55,-25,27
Crusaders,302,1,16,7,7,58,40,18,55
Cliftonville,302,2,16,3,11,63,47,16,51
Ballymena,302,3,14,9,7,59,53,6,51
Linfield,302,4,13,11,6,58,31,27,50
Coleraine,302,5,13,9,8,44,36,8,48
Glenavon,302,6,10,12,8,54,51,3,42
Dungannon,302,7,9,10,11,56,52,4,37
Glentoran,302,8,8,8,14,35,51,-16,32
Portadown,302,9,7,9,14,31,54,-23,30
Ards,302,10,7,7,16,34,55,-21,28
Ballinamalla,302,11,7,5,18,35,57,-22,26
Cliftonville,303,1,16,5,9,54,42,12,53
Ballymena,303,2,16,5,9,58,55,3,53
Linfield,303,3,15,7,8,57,39,18,52
Crusaders,303,4,15,7,8,48,37,11,52
Dungannon,303,5,13,8,9,60,32,28,47
Glenavon,303,6,12,8,10,49,39,10,44
Glentoran,303,7,12,8,10,37,36,1,44
Coleraine,303,8,11,9,10,43,43,0,42
Ards,303,9,10,2,18,41,56,-15,32
Portadown,303,10,6,5,19,21,53,-32,23
Ballinamalla,303,11,6,2,22,25,61,-36,20
Linfield,304,1,18,7,5,61,25,36,61
Cliftonville,304,2,18,3,9,57,38,19,57
Glenavon,304,3,14,9,7,55,40,15,51
Ballymena,304,4,15,6,9,64,54,10,51
Crusaders,304,5,13,10,7,50,40,10,49
Dungannon,304,6,13,7,10,52,40,12,46
Coleraine,304,7,11,12,7,44,42,2,45
Glentoran,304,8,10,7,13,24,34,-10,37
Ballinamalla,304,9,6,4,20,26,60,-34,22
Ards,304,10,4,7,19,30,59,-29,19
Portadown,304,11,4,6,20,22,53,-31,18
Crusaders,305,1,18,5,7,54,31,23,59
Ballymena,305,2,18,4,8,64,56,8,58
Cliftonville,305,3,14,7,9,51,37,14,49
Coleraine,305,4,13,9,8,43,38,5,48
Glenavon,305,5,12,10,8,49,38,11,46
Linfield,305,6,12,9,9,56,36,20,45
Dungannon,305,7,8,10,12,46,49,-3,34
Ards,305,8,10,3,17,38,50,-12,33
Glentoran,305,9,9,5,16,31,48,-17,32
Portadown,305,10,7,9,14,30,48,-18,30
Ballinamalla,305,11,8,1,21,31,62,-31,25
Crusaders,306,1,16,6,8,65,45,20,54
Linfield,306,2,13,10,7,52,30,22,49
Cliftonville,306,3,15,4,11,61,52,9,49
Ballymena,306,4,14,7,9,59,57,2,49
Glenavon,306,5,11,10,9,50,50,0,43
Ards,306,6,13,3,14,41,49,-8,42
Coleraine,306,7,10,11,9,46,44,2,41
Dungannon,306,8,8,10,12,46,52,-6,34
Glentoran,306,9,8,9,13,30,40,-10,33
Ballinamalla,306,10,9,5,16,33,48,-15,32
Portadown,306,11,7,7,16,29,45,-16,28
Crusaders,307,1,18,4,8,58,37,21,58
Linfield,307,2,15,8,7,60,31,29,53
Cliftonville,307,3,16,4,10,56,45,11,52
Ballymena,307,4,13,8,9,62,56,6,47
Glenavon,307,5,11,13,6,49,44,5,46
Glentoran,307,6,10,10,10,33,38,-5,40
Coleraine,307,7,9,11,10,43,43,0,38
Dungannon,307,8,9,8,13,52,49,3,35
Ballinamalla,307,9,10,2,18,35,54,-19,32
Ards,307,10,7,8,15,38,54,-16,29
Portadown,307,11,6,6,18,20,55,-35,24
Cliftonville,308,1,16,3,11,49,35,14,51
Crusaders,308,2,14,9,7,48,36,12,51
Linfield,308,3,14,7,9,52,27,25,49
Dungannon,308,4,13,10,7,56,40,16,49
Glenavon,308,5,14,7,9,48,46,2,49
Ballymena,308,6,13,8,9,62,60,2,47
Coleraine,308,7,12,8,10,43,38,5,44
Ards,308,8,9,5,16,38,51,-13,32
Glentoran,308,9,8,7,15,30,45,-15,31
Portadown,308,10,8,6,16,26,47,-21,30
Ballinamalla,308,11,5,8,17,26,53,-27,23
Cliftonville,309,1,18,3,9,57,45,12,57
Crusaders,309,2,16,8,6,55,29,26,56
Linfield,309,3,15,9,6,60,29,31,54
Ballymena,309,4,15,8,7,57,54,3,53
Coleraine,309,5,11,12,7,38,28,10,45
Dungannon,309,6,7,14,9,51,51,0,35
Ards,309,7,9,6,15,44,52,-8,33
Ballinamalla,309,8,9,4,17,30,51,-21,31
Glenavon,309,9,5,14,11,36,47,-11,29
Glentoran,309,10,6,10,14,25,48,-23,28
Portadown,309,11,7,6,17,27,46,-19,27
Linfield,310,1,17,9,4,65,30,35,60
Cliftonville,310,2,17,4,9,56,35,21,55
Crusaders,310,3,14,8,8,50,35,15,50
Ballymena,310,4,14,8,8,58,56,2,50
Coleraine,310,5,13,9,8,47,38,9,48
Glenavon,310,6,11,12,7,51,51,0,45
Glentoran,310,7,11,6,13,33,44,-11,39
Dungannon,310,8,8,9,13,42,45,-3,33
Ards,310,9,9,4,17,42,56,-14,31
Ballinamalla,310,10,6,5,19,26,53,-27,23
Portadown,310,11,5,6,19,23,50,-27,21
Cliftonville,311,1,17,5,8,60,35,25,56
Crusaders,311,2,16,6,8,49,33,16,54
Linfield,311,3,14,8,8,51,31,20,50
Ballymena,311,4,14,6,10,60,57,3,48
Glenavon,311,5,11,14,5,47,42,5,47
Coleraine,311,6,10,9,11,39,45,-6,39
Dungannon,311,7,9,9,12,44,42,2,36
Ards,311,8,9,6,15,39,50,-11,33
Ballinamalla,311,9,9,5,16,30,47,-17,32
Glentoran,311,10,8,8,14,23,40,-17,32
Portadown,311,11,7,6,17,28,48,-20,27
Linfield,312,1,17,7,6,57,26,31,58
Cliftonville,312,2,16,6,8,58,38,20,54
Crusaders,312,3,15,9,6,55,43,12,54
Coleraine,312,4,12,11,7,38,31,7,47
Dungannon,312,5,12,6,12,52,38,14,42
Ballymena,312,6,12,6,12,49,54,-5,42
Glentoran,312,7,11,6,13,35,39,-4,39
Glenavon,312,8,8,11,11,42,52,-10,35
Ards,312,9,9,4,17,37,52,-15,31
Portadown,312,10,9,4,17,24,47,-23,31
Ballinamalla,312,11,6,6,18,26,53,-27,24
Cliftonville,313,1,19,4,7,58,34,24,61
Crusaders,313,2,17,6,7,58,36,22,57
Linfield,313,3,12,12,6,53,30,23,48
Coleraine,313,4,11,12,7,46,35,11,45
Dungannon,313,5,11,11,8,53,43,10,44
Ballymena,313,6,11,8,11,49,60,-11,41
Glenavon,313,7,7,13,10,38,46,-8,34
Portadown,313,8,8,8,14,29,43,-14,32
Ards,313,9,8,7,15,33,45,-12,31
Glentoran,313,10,7,9,14,24,42,-18,30
Ballinamalla,313,11,6,6,18,23,50,-27,24
Crusaders,314,1,16,10,4,57,30,27,58
Linfield,314,2,13,11,6,49,23,26,50
Cliftonville,314,3,14,8,8,55,38,17,50
Ballymena,314,4,15,4,11,49,55,-6,49
Glenavon,314,5,11,11,8,41,41,0,44
Dungannon,314,6,10,12,8,49,39,10,42
Coleraine,314,7,10,10,10,40,43,-3,40
Glentoran,314,8,10,6,14,31,43,-12,36
Ards,314,9,8,6,16,36,48,-12,30
Portadown,314,10,7,7,16,25,45,-20,28
Ballinamalla,314,11,6,5,19,32,59,-27,23
Crusaders,315,1,19,6,5,61,29,32,63
Linfield,315,2,15,10,5,62,34,28,55
Cliftonville,315,3,17,3,10,58,45,13,54
Ballymena,315,4,14,6,10,62,58,4,48
Dungannon,315,5,10,10,10,50,42,8,40
Glenavon,315,6,9,11,10,41,46,-5,38
Glentoran,315,7,10,7,13,29,41,-12,37
Coleraine,315,8,9,9,12,40,47,-7,36
Ballinamalla,315,9,9,5,16,32,50,-18,32
Ards,315,10,7,7,16,39,54,-15,28
Portadown,315,11,6,6,18,21,49,-28,24
Crusaders,316,1,18,6,6,58,32,26,60
Ballymena,316,2,16,7,7,62,55,7,55
Linfield,316,3,14,11,5,60,32,28,53
Cliftonville,316,4,13,6,11,55,41,14,45
Coleraine,316,5,10,13,7,41,35,6,43
Dungannon,316,6,10,11,9,49,42,7,41
Glenavon,316,7,9,13,8,53,54,-1,40
Ards,316,8,9,8,13,42,49,-7,35
Glentoran,316,9,6,9,15,32,50,-18,27
Portadown,316,10,7,6,17,21,48,-27,27
Ballinamalla,316,11,6,4,20,25,60,-35,22
Crusaders,317,1,15,10,5,57,35,22,55
Cliftonville,317,2,15,7,8,48,37,11,52
Ballymena,317,3,13,8,9,58,58,0,47
Glenavon,317,4,10,15,5,53,44,9,45
Coleraine,317,5,12,9,9,44,42,2,45
Dungannon,317,6,10,11,9,54,43,11,41
Glentoran,317,7,11,6,13,39,47,-8,39
Linfield,317,8,9,11,10,53,47,6,38
Ards,317,9,10,5,15,45,53,-8,35
Portadown,317,10,8,5,17,30,46,-16,29
Ballinamalla,317,11,6,5,19,28,57,-29,23
Crusaders,318,1,16,8,6,57,40,17,56
Cliftonville,318,2,17,4,9,56,32,24,55
Linfield,318,3,13,9,8,59,38,21,48
Ballymena,318,4,12,9,9,54,55,-1,45
Coleraine,318,5,11,11,8,39,33,6,44
Dungannon,318,6,10,10,10,55,48,7,40
Ards,318,7,9,7,14,41,49,-8,34
Portadown,318,8,9,6,15,28,39,-11,33
Glentoran,318,9,8,9,13,24,41,-17,33
Glenavon,318,10,7,10,13,37,55,-18,31
Ballinamalla,318,11,8,7,15,27,47,-20,31
Linfield,319,1,16,10,4,62,35,27,58
Ballymena,319,2,17,6,7,71,59,12,57
Crusaders,319,3,12,11,7,55,40,15,47
Cliftonville,319,4,12,7,11,45,37,8,43
Glenavon,319,5,10,12,8,46,43,3,42
Ballinamalla,319,6,11,5,14,41,51,-10,38
Dungannon,319,7,9,9,12,51,50,1,36
Coleraine,319,8,9,9,12,41,45,-4,36
Glentoran,319,9,9,9,12,25,38,-13,36
Portadown,319,10,9,6,15,29,46,-17,33
Ards,319,11,7,4,19,34,56,-22,25
Crusaders,320,1,18,7,5,55,36,19,61
Cliftonville,320,2,16,4,10,61,43,18,52
Linfield,320,3,14,9,7,60,37,23,51
Ballymena,320,4,12,8,10,58,59,-1,44
Coleraine,320,5,9,12,9,40,41,-1,39
Dungannon,320,6,9,10,11,51,46,5,37
Glenavon,320,7,8,12,10,38,44,-6,36
Glentoran,320,8,9,8,13,30,42,-12,35
Portadown,320,9,9,7,14,33,45,-12,34
Ards,320,10,9,6,15,40,54,-14,33
Ballinamalla,320,11,7,7,16,28,47,-19,28
Crusaders,321,1,15,10,5,54,36,18,55
Linfield,321,2,15,9,6,56,31,25,54
Ballymena,321,3,14,6,10,51,55,-4,48
Coleraine,321,4,12,11,7,43,32,11,47
Cliftonville,321,5,13,7,10,45,37,8,46
Glenavon,321,6,11,10,9,46,44,2,43
Dungannon,321,7,9,10,11,49,43,6,37
Portadown,321,8,9,7,14,27,40,-13,34
Glentoran,321,9,8,9,13,32,43,-11,33
Ards,321,10,8,6,16,34,48,-14,30
Ballinamalla,321,11,5,7,18,24,52,-28,22
Crusaders,322,1,18,6,6,59,35,24,60
Cliftonville,322,2,16,3,11,56,42,14,51
Linfield,322,3,11,14,5,50,31,19,47
Ballymena,322,4,13,8,9,52,54,-2,47
Glentoran,322,5,12,8,10,33,35,-2,44
Coleraine,322,6,10,11,9,44,39,5,41
Glenavon,322,7,10,9,11,46,50,-4,39
Dungannon,322,8,9,8,13,48,48,0,35
Ards,322,9,9,7,14,38,50,-12,34
Portadown,322,10,8,6,16,25,42,-17,30
Ballinamalla,322,11,7,4,19,26,51,-25,25
Crusaders,323,1,16,10,4,64,36,28,58
Cliftonville,323,2,16,6,8,54,36,18,54
Linfield,323,3,13,9,8,60,32,28,48
Dungannon,323,4,12,10,8,54,38,16,46
Glenavon,323,5,12,10,8,46,44,2,46
Ards,323,6,11,5,14,42,47,-5,38
Ballymena,323,7,10,6,14,47,63,-16,36
Glentoran,323,8,9,8,13,33,46,-13,35
Coleraine,323,9,8,10,12,43,51,-8,34
Portadown,323,10,8,5,17,28,54,-26,29
Ballinamalla,323,11,7,7,16,29,53,-24,28
Crusaders,324,1,18,8,4,61,33,28,62
Cliftonville,324,2,17,2,11,51,37,14,53
Glenavon,324,3,14,10,6,48,43,5,52
Linfield,324,4,15,6,9,62,38,24,51
Ballymena,324,5,14,6,10,62,54,8,48
Ards,324,6,12,4,14,49,55,-6,40
Dungannon,324,7,7,14,9,50,48,2,35
Coleraine,324,8,9,8,13,36,46,-10,35
Glentoran,324,9,9,8,13,35,46,-11,35
Portadown,324,10,7,6,17,21,45,-24,27
Ballinamalla,324,11,4,6,20,27,57,-30,18
Crusaders,325,1,15,12,3,60,35,25,57
Cliftonville,325,2,16,7,7,57,35,22,55
Linfield,325,3,15,8,7,62,37,25,53
Dungannon,325,4,15,7,8,56,38,18,52
Ballymena,325,5,12,10,8,62,58,4,46
Glenavon,325,6,8,12,10,44,49,-5,36
Coleraine,325,7,8,11,11,39,45,-6,35
Glentoran,325,8,8,7,15,28,50,-22,31
Ards,325,9,8,6,16,34,51,-17,30
Ballinamalla,325,10,8,4,18,31,53,-22,28
Portadown,325,11,6,8,16,22,44,-22,26
Linfield,326,1,17,7,6,57,26,31,58
Glenavon,326,2,14,10,6,47,38,9,52
Crusaders,326,3,15,6,9,51,38,13,51
Ballymena,326,4,15,5,10,53,57,-4,50
Coleraine,326,5,13,10,7,46,33,13,49
Cliftonville,326,6,14,5,11,52,40,12,47
Dungannon,326,7,10,7,13,51,52,-1,37
Glentoran,326,8,9,8,13,27,41,-14,35
Ards,326,9,8,6,16,37,49,-12,30
Portadown,326,10,8,4,18,26,43,-17,28
Ballinamalla,326,11,7,2,21,26,56,-30,23
Coleraine,327,1,17,8,5,52,31,21,59
Linfield,327,2,14,12,4,63,37,26,54
Crusaders,327,3,16,6,8,55,40,15,54
Cliftonville,327,4,16,4,10,56,42,14,52
Ballymena,327,5,13,5,12,55,64,-9,44
Dungannon,327,6,10,9,11,50,41,9,39
Ards,327,7,11,5,14,46,45,1,38
Glenavon,327,8,8,12,10,37,40,-3,36
Glentoran,327,9,7,7,16,28,49,-21,28
Ballinamalla,327,10,8,3,19,29,57,-28,27
Portadown,327,11,7,5,18,28,53,-25,26
Crusaders,328,1,15,8,7,50,32,18,53
Ballymena,328,2,16,5,9,53,49,4,53
Coleraine,328,3,12,12,6,47,32,15,48
Dungannon,328,4,12,10,8,48,41,7,46
Linfield,328,5,11,11,8,54,32,22,44
Cliftonville,328,6,13,4,13,52,49,3,43
Glenavon,328,7,9,13,8,43,45,-2,40
Glentoran,328,8,9,9,12,30,43,-13,36
Ballinamalla,328,9,10,4,16,33,48,-15,34
Portadown,328,10,7,7,16,20,42,-22,28
Ards,328,11,7,5,18,32,49,-17,26
Linfield,329,1,19,8,3,63,21,42,65
Crusaders,329,2,17,7,6,58,34,24,58
Cliftonville,329,3,16,3,11,53,37,16,51
Ballymena,329,4,13,6,11,52,62,-10,45
Coleraine,329,5,11,11,8,41,37,4,44
Glenavon,329,6,11,10,9,50,48,2,43
Dungannon,329,7,8,12,10,46,47,-1,36
Glentoran,329,8,9,7,14,31,44,-13,34
Ards,329,9,9,5,16,31,49,-18,32
Portadown,329,10,6,6,18,25,45,-20,24
Ballinamalla,329,11,6,5,19,25,51,-26,23
Crusaders,330,1,15,8,7,49,30,19,53
Cliftonville,330,2,16,3,11,58,40,18,51
Glenavon,330,3,13,9,8,53,46,7,48
Linfield,330,4,13,7,10,54,32,22,46
Glentoran,330,5,12,8,10,36,38,-2,44
Ballymena,330,6,12,5,13,46,61,-15,41
Coleraine,330,7,9,13,8,43,41,2,40
Dungannon,330,8,9,10,11,46,44,2,37
Ards,330,9,11,4,15,40,57,-17,37
Portadown,330,10,9,6,15,31,40,-9,33
Ballinamalla,330,11,6,7,17,28,55,-27,25
Ballymena,331,1,16,7,7,66,60,6,55
Crusaders,331,2,15,9,6,56,38,18,54
Linfield,331,3,14,9,7,61,28,33,51
Cliftonville,331,4,15,3,12,49,37,12,48
Glenavon,331,5,12,10,8,48,52,-4,46
Coleraine,331,6,10,10,10,36,38,-2,40
Dungannon,331,7,10,9,11,47,45,2,39
Portadown,331,8,10,6,14,32,40,-8,36
Ballinamalla,331,9,9,6,15,31,50,-19,33
Glentoran,331,10,7,6,17,32,51,-19,27
Ards,331,11,6,7,17,37,56,-19,25
Crusaders,332,1,16,9,5,57,34,23,57
Coleraine,332,2,13,14,3,47,33,14,53
Cliftonville,332,3,14,5,11,54,42,12,47
Linfield,332,4,12,9,9,54,36,18,45
Glentoran,332,5,12,9,9,38,40,-2,45
Ballymena,332,6,12,7,11,62,68,-6,43
Glenavon,332,7,11,9,10,46,48,-2,42
Portadown,332,8,11,3,16,31,45,-14,36
Dungannon,332,9,8,9,13,43,43,0,33
Ards,332,10,8,6,16,34,48,-14,30
Ballinamalla,332,11,5,6,19,26,55,-29,21
Cliftonville,333,1,18,4,8,68,41,27,58
Crusaders,333,2,16,7,7,52,33,19,55
Ballymena,333,3,15,7,8,58,54,4,52
Coleraine,333,4,14,8,8,48,32,16,50
Linfield,333,5,13,10,7,56,36,20,49
Glenavon,333,6,10,7,13,45,54,-9,37
Dungannon,333,7,9,9,12,45,42,3,36
Glentoran,333,8,9,6,15,27,46,-19,33
Ballinamalla,333,9,9,4,17,38,55,-17,31
Portadown,333,10,8,5,17,31,52,-21,29
Ards,333,11,8,5,17,30,53,-23,29
Crusaders,334,1,17,7,6,55,31,24,58
Linfield,334,2,16,9,5,58,26,32,57
Ballymena,334,3,16,6,8,67,55,12,54
Cliftonville,334,4,15,4,11,49,41,8,49
Coleraine,334,5,12,9,9,36,34,2,45
Glenavon,334,6,9,14,7,42,41,1,41
Dungannon,334,7,9,10,11,43,42,1,37
Ards,334,8,9,6,15,39,48,-9,33
Glentoran,334,9,8,6,16,27,51,-24,30
Ballinamalla,334,10,6,7,17,32,50,-18,25
Portadown,334,11,6,6,18,19,48,-29,24
Crusaders,335,1,16,7,7,63,40,23,55
Linfield,335,2,13,14,3,56,27,29,53
Cliftonville,335,3,16,5,9,52,38,14,53
Coleraine,335,4,14,10,6,44,34,10,52
Ballymena,335,5,13,8,9,54,57,-3,47
Glenavon,335,6,10,12,8,44,43,1,42
Dungannon,335,7,8,9,13,43,48,-5,33
Ards,335,8,8,7,15,37,48,-11,31
Glentoran,335,9,7,9,14,39,54,-15,30
Portadown,335,10,7,7,16,24,47,-23,28
Ballinamalla,335,11,6,6,18,30,50,-20,24
Cliftonville,336,1,18,6,6,60,36,24,60
Coleraine,336,2,15,9,6,46,34,12,54
Crusaders,336,3,14,11,5,52,34,18,53
Linfield,336,4,12,11,7,58,36,22,47
Ballymena,336,5,12,6,12,58,62,-4,42
Dungannon,336,6,10,8,12,48,41,7,38
Glenavon,336,7,9,11,10,43,43,0,38
Ballinamalla,336,8,9,5,16,32,52,-20,32
Ards,336,9,8,6,16,37,49,-12,30
Glentoran,336,10,6,11,13,25,49,-24,29
Portadown,336,11,6,8,16,21,44,-23,26
Glenavon,337,1,18,8,4,61,32,29,62
Linfield,337,2,15,9,6,62,39,23,54
Cliftonville,337,3,16,5,9,53,34,19,53
Crusaders,337,4,14,9,7,58,49,9,51
Ballymena,337,5,13,6,11,62,67,-5,45
Coleraine,337,6,10,10,10,40,44,-4,40
Dungannon,337,7,9,10,11,49,48,1,37
Glentoran,337,8,10,6,14,37,48,-11,36
Ards,337,9,10,5,15,41,48,-7,35
Ballinamalla,337,10,7,3,20,29,55,-26,24
Portadown,337,11,5,5,20,22,50,-28,20
Linfield,338,1,16,9,5,59,25,34,57
Crusaders,338,2,15,10,5,57,36,21,55
Dungannon,338,3,12,11,7,59,41,18,47
Cliftonville,338,4,14,5,11,59,45,14,47
Coleraine,338,5,13,8,9,49,49,0,47
Ballymena,338,6,12,7,11,60,58,2,43
Glenavon,338,7,11,9,10,45,50,-5,42
Portadown,338,8,9,5,16,29,47,-18,32
Glentoran,338,9,8,8,14,31,50,-19,32
Ards,338,10,8,6,16,39,52,-13,30
Ballinamalla,338,11,6,4,20,22,56,-34,22
Linfield,339,1,17,8,5,61,22,39,59
Crusaders,339,2,17,6,7,55,43,12,57
Ballymena,339,3,15,5,10,58,52,6,50
Glenavon,339,4,13,10,7,50,39,11,49
Cliftonville,339,5,15,3,12,47,45,2,48
Coleraine,339,6,12,8,10,45,40,5,44
Dungannon,339,7,11,6,13,54,51,3,39
Ballinamalla,339,8,9,5,16,32,48,-16,32
Ards,339,9,8,6,16,37,50,-13,30
Glentoran,339,10,7,7,16,30,54,-24,28
Portadown,339,11,6,6,18,22,47,-25,24
Crusaders,340,1,17,9,4,57,33,24,60
Ballymena,340,2,17,7,6,60,48,12,58
Cliftonville,340,3,14,7,9,45,32,13,49
Linfield,340,4,12,12,6,52,28,24,48
Coleraine,340,5,11,11,8,50,41,9,44
Glenavon,340,6,10,11,9,47,51,-4,41
Portadown,340,7,9,5,16,28,46,-18,32
Glentoran,340,8,7,10,13,32,48,-16,31
Dungannon,340,9,6,11,13,41,46,-5,29
Ballinamalla,340,10,7,8,15,28,46,-18,29
Ards,340,11,7,5,18,36,57,-21,26
Linfield,341,1,16,10,4,59,24,35,58
Cliftonville,341,2,16,4,10,50,34,16,52
Coleraine,341,3,13,11,6,49,41,8,50
Glenavon,341,4,13,10,7,52,45,7,49
Crusaders,341,5,12,9,9,46,35,11,45
Ballymena,341,6,12,6,12,51,63,-12,42
Ards,341,7,10,6,14,38,49,-11,36
Dungannon,341,8,9,8,13,49,48,1,35
Glentoran,341,9,8,8,14,30,44,-14,32
Ballinamalla,341,10,8,6,16,28,48,-20,30
Portadown,341,11,5,8,17,27,48,-21,23
Crusaders,342,1,17,8,5,50,30,20,59
Cliftonville,342,2,18,4,8,55,36,19,58
Linfield,342,3,16,7,7,57,26,31,55
Ballymena,342,4,15,6,9,55,51,4,51
Coleraine,342,5,11,11,8,43,37,6,44
Glenavon,342,6,9,10,11,43,49,-6,37
Dungannon,342,7,9,8,13,44,44,0,35
Ards,342,8,10,4,16,39,49,-10,34
Glentoran,342,9,9,7,14,26,38,-12,34
Ballinamalla,342,10,9,4,17,31,52,-21,31
Portadown,342,11,6,3,21,19,50,-31,21
Crusaders,343,1,15,10,5,53,32,21,55
Ballymena,343,2,16,5,9,58,58,0,53
Coleraine,343,3,11,15,4,42,29,13,48
Cliftonville,343,4,13,8,9,51,40,11,47
Linfield,343,5,12,10,8,53,37,16,46
Glenavon,343,6,11,13,6,42,37,5,46
Dungannon,343,7,10,8,12,52,50,2,38
Glentoran,343,8,8,11,11,30,40,-10,35
Ards,343,9,7,7,16,39,51,-12,28
Portadown,343,10,6,8,16,24,50,-26,26
Ballinamalla,343,11,6,5,19,29,49,-20,23
Crusaders,344,1,16,8,6,52,33,19,56
Linfield,344,2,15,8,7,62,34,28,53
Ballymena,344,3,14,8,8,59,51,8,50
Cliftonville,344,4,13,9,8,46,37,9,48
Glenavon,344,5,12,11,7,49,44,5,47
Dungannon,344,6,12,10,8,57,41,16,46
Coleraine,344,7,10,13,7,47,44,3,43
Glentoran,344,8,9,7,14,35,49,-14,34
Ards,344,9,7,4,19,35,55,-20,25
Portadown,344,10,6,7,17,23,51,-28,25
Ballinamalla,344,11,6,5,19,29,55,-26,23
Glenavon,345,1,16,10,4,62,40,22,58
Crusaders,345,2,15,7,8,58,47,11,52
Linfield,345,3,13,10,7,57,36,21,49
Cliftonville,345,4,15,4,11,54,45,9,49
Coleraine,345,5,12,9,9,41,37,4,45
Ballymena,345,6,12,8,10,62,57,5,44
Dungannon,345,7,9,13,8,52,38,14,40
Glentoran,345,8,10,6,14,28,46,-18,36
Ards,345,9,9,4,17,40,51,-11,31
Ballinamalla,345,10,8,4,18,27,54,-27,28
Portadown,345,11,5,7,18,24,54,-30,22
Crusaders,346,1,17,9,4,53,25,28,60
Linfield,346,2,15,12,3,67,32,35,57
Cliftonville,346,3,16,5,9,55,38,17,53
Glenavon,346,4,13,10,7,51,41,10,49
Coleraine,346,5,11,9,10,43,45,-2,42
Ballinamalla,346,6,11,4,15,32,45,-13,37
Ballymena,346,7,10,6,14,48,69,-21,36
Glentoran,346,8,8,9,13,29,47,-18,33
Dungannon,346,9,7,9,14,48,52,-4,30
Ards,346,10,9,3,18,35,42,-7,30
Portadown,346,11,7,6,17,22,47,-25,27
Crusaders,347,1,17,7,6,54,30,24,58
Cliftonville,347,2,14,8,8,51,36,15,50
Linfield,347,3,13,9,8,61,41,20,48
Coleraine,347,4,11,13,6,45,37,8,46
Ballymena,347,5,11,9,10,59,59,0,42
Dungannon,347,6,10,10,10,51,46,5,40
Glentoran,347,7,10,10,10,37,40,-3,40
Ards,347,8,11,4,15,39,50,-11,37
Glenavon,347,9,8,11,11,43,54,-11,35
Portadown,347,10,8,6,16,28,44,-16,30
Ballinamalla,347,11,5,7,18,22,53,-31,22
Crusaders,348,1,16,8,6,58,40,18,56
Ballymena,348,2,17,3,10,68,58,10,54
Linfield,348,3,14,10,6,56,27,29,52
Cliftonville,348,4,14,8,8,53,41,12,50
Coleraine,348,5,10,12,8,45,50,-5,42
Glenavon,348,6,10,11,9,51,48,3,41
Dungannon,348,7,10,10,10,50,42,8,40
Glentoran,348,8,9,6,15,29,45,-16,33
Portadown,348,9,8,8,14,30,47,-17,32
Ards,348,10,8,4,18,37,53,-16,28
Ballinamalla,348,11,7,4,19,27,53,-26,25
Crusaders,349,1,16,8,6,53,35,18,56
Linfield,349,2,15,8,7,62,33,29,53
Coleraine,349,3,14,10,6,53,32,21,52
Cliftonville,349,4,15,7,8,47,33,14,52
Glenavon,349,5,10,13,7,38,39,-1,43
Dungannon,349,6,10,9,11,46,41,5,39
Ballymena,349,7,11,5,14,52,64,-12,38
Ballinamalla,349,8,11,3,16,35,51,-16,36
Glentoran,349,9,7,10,13,24,40,-16,31
Portadown,349,10,5,10,15,27,49,-22,25
Ards,349,11,5,9,16,34,54,-20,24
Cliftonville,350,1,17,5,8,55,40,15,56
Crusaders,350,2,15,8,7,52,29,23,53
Linfield,350,3,12,11,7,61,40,21,47
Glenavon,350,4,12,11,7,49,37,12,47
Ballymena,350,5,12,9,9,53,52,1,45
Coleraine,350,6,10,14,6,45,39,6,44
Dungannon,350,7,10,10,10,47,37,10,40
Ards,350,8,11,5,14,46,51,-5,38
Glentoran,350,9,6,11,13,26,46,-20,29
Portadown,350,10,5,9,16,24,50,-26,24
Ballinamalla,350,11,5,7,18,31,68,-37,22
Linfield,351,1,17,7,6,65,35,30,58
Cliftonville,351,2,15,6,9,54,43,11,51
Crusaders,351,3,14,8,8,49,41,8,50
Ballymena,351,4,14,6,10,59,59,0,48
Coleraine,351,5,13,7,10,44,36,8,46
Dungannon,351,6,12,7,11,55,43,12,43
Glenavon,351,7,9,10,11,38,43,-5,37
Glentoran,351,8,10,7,13,37,47,-10,37
Ards,351,9,10,4,16,43,50,-7,34
Ballinamalla,351,10,7,7,16,27,53,-26,28
Portadown,351,11,6,7,17,23,44,-21,25
Coleraine,352,1,15,8,7,52,39,13,53
Cliftonville,352,2,16,4,10,55,40,15,52
Crusaders,352,3,14,8,8,54,42,12,50
Glenavon,352,4,11,12,7,49,46,3,45
Linfield,352,5,11,10,9,59,40,19,43
Ballymena,352,6,11,9,10,52,58,-6,42
Glentoran,352,7,10,8,12,36,42,-6,38
Dungannon,352,8,7,14,9,45,44,1,35
Portadown,352,9,10,5,15,29,42,-13,35
Ards,352,10,10,3,17,35,50,-15,33
Ballinamalla,352,11,7,5,18,30,53,-23,26
Cliftonville,353,1,17,4,9,58,46,12,55
Ballymena,353,2,15,6,9,56,54,2,51
Glenavon,353,3,12,11,7,46,41,5,47
Crusaders,353,4,14,4,12,56,42,14,46
Dungannon,353,5,12,8,10,55,43,12,44
Coleraine,353,6,11,11,8,49,43,6,44
Linfield,353,7,10,10,10,50,37,13,40
Ards,353,8,11,5,14,42,45,-3,38
Glentoran,353,9,8,8,14,32,49,-17,32
Portadown,353,10,9,5,16,22,42,-20,32
Ballinamalla,353,11,8,4,18,33,57,-24,28
Crusaders,354,1,17,8,5,54,34,20,59
Linfield,354,2,17,7,6,64,29,35,58
Cliftonville,354,3,15,3,12,50,38,12,48
Glenavon,354,4,12,8,10,47,45,2,44
Ballymena,354,5,13,5,12,58,62,-4,44
Coleraine,354,6,10,12,8,41,36,5,42
Ards,354,7,12,5,13,42,48,-6,41
Dungannon,354,8,11,7,12,50,54,-4,40
Glentoran,354,9,10,4,16,34,46,-12,34
Portadown,354,10,7,6,17,30,52,-22,27
Ballinamalla,354,11,7,3,20,31,57,-26,24
Crusaders,355,1,18,7,5,60,31,29,61
Linfield,355,2,17,8,5,52,27,25,59
Glenavon,355,3,13,10,7,49,42,7,49
Cliftonville,355,4,14,6,10,53,47,6,48
Ballymena,355,5,13,8,9,53,50,3,47
Coleraine,355,6,11,11,8,46,34,12,44
Ards,355,7,11,5,14,48,50,-2,38
Dungannon,355,8,9,7,14,49,52,-3,34
Ballinamalla,355,9,10,2,18,28,46,-18,32
Portadown,355,10,6,6,18,24,52,-28,24
Glentoran,355,11,6,4,20,25,56,-31,22
Crusaders,356,1,16,8,6,59,37,22,56
Linfield,356,2,14,10,6,59,33,26,52
Coleraine,356,3,14,8,8,49,35,14,50
Cliftonville,356,4,15,5,10,50,40,10,50
Glenavon,356,5,12,11,7,45,38,7,47
Glentoran,356,6,12,7,11,39,41,-2,43
Ballymena,356,7,9,8,13,52,65,-13,35
Dungannon,356,8,7,12,11,47,40,7,33
Ballinamalla,356,9,9,4,17,29,47,-18,31
Ards,356,10,7,7,16,33,57,-24,28
Portadown,356,11,8,4,18,31,60,-29,28
Crusaders,357,1,17,7,6,52,33,19,58
Cliftonville,357,2,16,5,9,52,38,14,53
Ballymena,357,3,16,5,9,58,52,6,53
Linfield,357,4,13,8,9,57,41,16,47
Glenavon,357,5,10,13,7,49,43,6,43
Coleraine,357,6,10,13,7,43,40,3,43
Glentoran,357,7,10,7,13,32,36,-4,37
Ards,357,8,11,3,16,40,50,-10,36
Dungannon,357,9,8,11,11,47,47,0,35
Ballinamalla,357,10,6,6,18,24,48,-24,24
Portadown,357,11,6,6,18,23,49,-26,24
Cliftonville,358,1,17,4,9,63,45,18,55
Ballymena,358,2,15,6,9,61,53,8,51
Linfield,358,3,14,8,8,57,38,19,50
Crusaders,358,4,14,7,9,49,36,13,49
Coleraine,358,5,12,11,7,45,41,4,47
Glenavon,358,6,12,9,9,45,44,1,45
Glentoran,358,7,11,6,13,34,39,-5,39
Ballinamalla,358,8,11,4,15,36,45,-9,37
Dungannon,358,9,7,11,12,41,45,-4,32
Portadown,358,10,7,6,17,24,50,-26,27
Ards,358,11,7,4,19,40,59,-19,25
Crusaders,359,1,17,6,7,52,29,23,57
Linfield,359,2,14,8,8,59,37,22,50
Ballymena,359,3,14,7,9,58,50,8,49
Cliftonville,359,4,14,5,11,48,40,8,47
Glenavon,359,5,11,10,9,47,44,3,43
Ards,359,6,12,5,13,44,47,-3,41
Coleraine,359,7,10,9,11,42,46,-4,39
Dungannon,359,8,9,11,10,48,44,4,38
Portadown,359,9,8,8,14,25,41,-16,32
Glentoran,359,10,8,6,16,27,47,-20,30
Ballinamalla,359,11,8,5,17,31,56,-25,29
Cliftonville,360,1,17,6,7,53,38,15,57
Crusaders,360,2,15,10,5,60,34,26,55
Linfield,360,3,13,12,5,49,29,20,51
Glenavon,360,4,10,13,7,43,38,5,43
Coleraine,360,5,11,10,9,40,36,4,43
Portadown,360,6,12,4,14,31,37,-6,40
Ballymena,360,7,11,7,12,53,62,-9,40
Dungannon,360,8,8,9,13,41,42,-1,33
Ards,360,9,8,7,15,40,47,-7,31
Glentoran,360,10,7,10,13,29,48,-19,31
Ballinamalla,360,11,7,4,19,26,54,-28,25
Crusaders,361,1,17,8,5,57,32,25,59
Linfield,361,2,15,8,7,56,35,21,53
Cliftonville,361,3,16,4,10,51,42,9,52
Glenavon,361,4,13,11,6,45,37,8,50
Dungannon,361,5,11,9,10,52,41,11,42
Ballymena,361,6,12,6,12,54,64,-10,42
Coleraine,361,7,9,10,11,46,47,-1,37
Glentoran,361,8,8,9,13,35,46,-11,33
Ards,361,9,8,7,15,38,50,-12,31
Portadown,361,10,8,4,18,26,49,-23,28
Ballinamalla,361,11,7,6,17,27,44,-17,27
Linfield,362,1,18,7,5,75,30,45,61
Crusaders,362,2,16,9,5,54,33,21,57
Ballymena,362,3,16,4,10,60,57,3,52
Cliftonville,362,4,15,5,10,56,43,13,50
Glenavon,362,5,12,11,7,46,41,5,47
Coleraine,362,6,10,9,11,34,40,-6,39
Dungannon,362,7,9,8,13,51,43,8,35
Ards,362,8,9,4,17,37,56,-19,31
Glentoran,362,9,8,6,16,38,59,-21,30
Portadown,362,10,9,3,18,31,52,-21,30
Ballinamalla,362,11,8,4,18,30,58,-28,28
Cliftonville,363,1,16,6,8,55,36,19,54
Crusaders,363,2,15,8,7,52,35,17,53
Linfield,363,3,13,10,7,54,33,21,49
Glenavon,363,4,12,11,7,54,49,5,47
Ballymena,363,5,11,8,11,57,59,-2,41
Dungannon,363,6,8,13,9,46,43,3,37
Coleraine,363,7,9,9,12,36,36,0,36
Glentoran,363,8,9,9,12,29,45,-16,36
Ards,363,9,8,10,12,39,49,-10,34
Portadown,363,10,8,7,15,24,38,-14,31
Ballinamalla,363,11,7,7,16,27,50,-23,28
Crusaders,364,1,16,9,5,62,39,23,57
Linfield,364,2,15,7,8,62,38,24,52
Glenavon,364,3,13,12,5,50,40,10,51
Cliftonville,364,4,14,7,9,59,43,16,49
Coleraine,364,5,12,10,8,39,35,4,46
Glentoran,364,6,10,7,13,29,39,-10,37
Dungannon,364,7,9,9,12,42,43,-1,36
Ards,364,8,10,6,14,42,44,-2,36
Ballymena,364,9,10,6,14,46,64,-18,36
Portadown,364,10,8,5,17,24,46,-22,29
Ballinamalla,364,11,7,4,19,27,51,-24,25
Linfield,365,1,16,8,6,66,32,34,56
Ballymena,365,2,15,6,9,60,52,8,51
Coleraine,365,3,13,11,6,53,40,13,50
Crusaders,365,4,13,10,7,49,34,15,49
Cliftonville,365,5,14,6,10,51,41,10,48
Glenavon,365,6,12,10,8,55,50,5,46
Dungannon,365,7,11,9,10,46,43,3,42
Glentoran,365,8,8,7,15,28,48,-20,31
Ards,365,9,8,5,17,38,55,-17,29
Portadown,365,10,7,7,16,29,45,-16,28
Ballinamalla,365,11,7,3,20,22,57,-35,24
Crusaders,366,1,17,8,5,61,36,25,59
Coleraine,366,2,15,9,6,47,34,13,54
Linfield,366,3,13,9,8,54,36,18,48
Cliftonville,366,4,14,5,11,50,38,12,47
Dungannon,366,5,12,8,10,49,41,8,44
Ballymena,366,6,12,7,11,63,61,2,43
Glenavon,366,7,10,9,11,47,52,-5,39
Ards,366,8,11,5,14,42,45,-3,38
Portadown,366,9,8,6,16,29,48,-19,30
Glentoran,366,10,6,10,14,30,52,-22,28
Ballinamalla,366,11,7,4,19,29,58,-29,25
Crusaders,367,1,18,7,5,59,35,24,61
Ballymena,367,2,16,5,9,58,58,0,53
Cliftonville,367,3,16,4,10,62,45,17,52
Linfield,367,4,13,7,10,47,25,22,46
Glenavon,367,5,12,10,8,51,45,6,46
Coleraine,367,6,12,8,10,43,38,5,44
Dungannon,367,7,9,10,11,55,54,1,37
Ards,367,8,11,4,15,39,46,-7,37
Portadown,367,9,8,6,16,26,47,-21,30
Ballinamalla,367,10,8,4,18,27,50,-23,28
Glentoran,367,11,7,5,18,27,51,-24,26
Ballymena,368,1,17,4,9,62,53,9,55
Linfield,368,2,14,9,7,57,36,21,51
Cliftonville,368,3,14,6,10,53,42,11,48
Crusaders,368,4,11,13,6,49,34,15,46
Coleraine,368,5,11,12,7,43,38,5,45
Dungannon,368,6,11,10,9,53,44,9,43
Glenavon,368,7,8,15,7,39,41,-2,39
Ards,368,8,10,4,16,39,51,-12,34
Ballinamalla,368,9,7,9,14,33,50,-17,30
Glentoran,368,10,7,8,15,32,50,-18,29
Portadown,368,11,8,4,18,24,45,-21,28
Linfield,369,1,18,6,6,63,32,31,60
Glenavon,369,2,16,9,5,52,36,16,57
Coleraine,369,3,15,8,7,49,34,15,53
Ballymena,369,4,14,5,11,59,61,-2,47
Cliftonville,369,5,14,4,12,57,43,14,46
Crusaders,369,6,13,7,10,44,41,3,46
Dungannon,369,7,9,7,14,49,50,-1,34
Glentoran,369,8,8,9,13,33,43,-10,33
Ards,369,9,9,4,17,39,56,-17,31
Portadown,369,10,9,4,17,32,50,-18,31
Ballinamalla,369,11,5,7,18,23,54,-31,22
Crusaders,370,1,16,7,7,53,34,19,55
Linfield,370,2,15,7,8,57,37,20,52
Cliftonville,370,3,14,7,9,58,47,11,49
Glenavon,370,4,12,9,9,49,43,6,45
Coleraine,370,5,10,13,7,43,37,6,43
Ballymena,370,6,12,7,11,60,63,-3,43
Dungannon,370,7,11,8,11,49,40,9,41
Glentoran,370,8,9,8,13,30,42,-12,35
Ards,370,9,9,6,15,47,56,-9,33
Portadown,370,10,10,2,18,30,51,-21,32
Ballinamalla,370,11,8,4,18,23,49,-26,28
Crusaders,371,1,16,8,6,60,39,21,56
Ballymena,371,2,17,4,9,58,52,6,55
Coleraine,371,3,13,12,5,44,32,12,51
Dungannon,371,4,11,11,8,52,36,16,44
Linfield,371,5,10,12,8,47,35,12,42
Cliftonville,371,6,12,6,12,50,45,5,42
Glentoran,371,7,11,9,10,37,38,-1,42
Glenavon,371,8,9,10,11,42,46,-4,37
Ballinamalla,371,9,11,2,17,33,49,-16,35
Ards,371,10,6,8,16,33,54,-21,26
Portadown,371,11,6,4,20,22,52,-30,22
Linfield,372,1,17,7,6,68,33,35,58
Crusaders,372,2,16,9,5,58,41,17,57
Cliftonville,372,3,17,3,10,55,39,16,54
Ballymena,372,4,16,6,8,64,58,6,54
Coleraine,372,5,12,8,10,49,45,4,44
Glenavon,372,6,11,10,9,44,43,1,43
Dungannon,372,7,10,10,10,56,48,8,40
Glentoran,372,8,8,6,16,29,48,-19,30
Ballinamalla,372,9,7,7,16,34,51,-17,28
Ards,372,10,7,4,19,32,56,-24,25
Portadown,372,11,7,4,19,27,54,-27,25
Crusaders,373,1,17,9,4,49,26,23,60
Glenavon,373,2,13,11,6,49,40,9,50
Ballymena,373,3,14,7,9,53,55,-2,49
Cliftonville,373,4,14,5,11,51,44,7,47
Linfield,373,5,12,10,8,53,34,19,46
Coleraine,373,6,12,9,9,39,32,7,45
Dungannon,373,7,10,10,10,54,43,11,40
Ballinamalla,373,8,8,9,13,33,46,-13,33
Glentoran,373,9,8,8,14,23,38,-15,32
Ards,373,10,7,4,19,34,57,-23,25
Portadown,373,11,7,4,19,22,45,-23,25
Cliftonville,374,1,19,5,6,63,35,28,62
Crusaders,374,2,18,5,7,59,32,27,59
Linfield,374,3,15,9,6,62,39,23,54
Glenavon,374,4,11,11,8,47,46,1,44
Coleraine,374,5,11,11,8,45,44,1,44
Dungannon,374,6,11,10,9,51,42,9,43
Ballymena,374,7,11,7,12,55,62,-7,40
Glentoran,374,8,6,11,13,29,46,-17,29
Ards,374,9,8,4,18,33,48,-15,28
Portadown,374,10,7,7,16,28,46,-18,28
Ballinamalla,374,11,6,4,20,23,55,-32,22
Linfield,375,1,19,7,4,67,23,44,64
Cliftonville,375,2,19,3,8,61,37,24,60
Crusaders,375,3,14,7,9,58,44,14,49
Ballymena,375,4,14,4,12,59,58,1,46
Dungannon,375,5,10,12,8,45,41,4,42
Coleraine,375,6,10,11,9,42,46,-4,41
Glenavon,375,7,9,12,9,45,47,-2,39
Glentoran,375,8,9,7,14,36,53,-17,34
Ards,375,9,9,5,16,40,50,-10,32
Ballinamalla,375,10,9,3,18,28,52,-24,30
Portadown,375,11,6,3,21,25,55,-30,21
Linfield,376,1,17,9,4,67,30,37,60
Crusaders,376,2,18,6,6,60,38,22,60
Ballymena,376,3,13,8,9,56,57,-1,47
Glenavon,376,4,12,7,11,45,51,-6,43
Cliftonville,376,5,12,6,12,44,45,-1,42
Coleraine,376,6,10,9,11,40,43,-3,39
Ards,376,7,10,8,12,37,45,-8,38
Dungannon,376,8,10,7,13,55,45,10,37
Glentoran,376,9,8,10,12,32,42,-10,34
Portadown,376,10,7,6,17,28,47,-19,27
Ballinamalla,376,11,7,6,17,35,56,-21,27
Linfield,377,1,15,10,5,60,31,29,55
Crusaders,377,2,15,9,6,56,35,21,54
Cliftonville,377,3,15,8,7,48,32,16,53
Ballymena,377,4,14,5,11,59,56,3,47
Glenavon,377,5,11,10,9,53,49,4,43
Coleraine,377,6,10,10,10,40,41,-1,40
Dungannon,377,7,9,10,11,42,43,-1,37
Ballinamalla,377,8,9,10,11,36,43,-7,37
Ards,377,9,8,6,16,40,52,-12,30
Portadown,377,10,8,5,17,22,46,-24,29
Glentoran,377,11,5,9,16,26,54,-28,24
Crusaders,378,1,17,6,7,57,36,21,57
Cliftonville,378,2,17,4,9,61,37,24,55
Glenavon,378,3,14,8,8,49,41,8,50
Linfield,378,4,13,10,7,51,32,19,49
Ballymena,378,5,14,6,10,58,53,5,48
Coleraine,378,6,10,11,9,44,47,-3,41
Glentoran,378,7,10,9,11,33,38,-5,39
Dungannon,378,8,8,11,11,45,46,-1,35
Ards,378,9,10,4,16,39,52,-13,34
Ballinamalla,378,10,6,6,18,23,52,-29,24
Portadown,378,11,5,7,18,24,50,-26,22
Crusaders,379,1,19,5,6,64,39,25,62
Linfield,379,2,15,8,7,65,34,31,53
Cliftonville,379,3,15,5,10,58,41,17,50
Coleraine,379,4,13,9,8,44,34,10,48
Glenavon,379,5,12,10,8,51,49,2,46
Ballymena,379,6,12,7,11,65,64,1,43
Dungannon,379,7,11,7,12,47,46,1,40
Glentoran,379,8,10,6,14,32,50,-18,36
Portadown,379,9,9,6,15,22,44,-22,33
Ards,379,10,8,4,18,37,57,-20,28
Ballinamalla,379,11,5,5,20,27,54,-27,20
Crusaders,380,1,16,10,4,64,34,30,58
Cliftonville,380,2,17,5,8,56,37,19,56
Linfield,380,3,15,9,6,57,26,31,54
Glenavon,380,4,12,11,7,52,47,5,47
Coleraine,380,5,11,12,7,45,40,5,45
Dungannon,380,6,10,11,9,55,45,10,41
Ballymena,380,7,11,6,13,50,63,-13,39
Ards,380,8,9,7,14,38,48,-10,34
Ballinamalla,380,9,8,7,15,32,48,-16,31
Glentoran,380,10,7,7,16,30,56,-26,28
Portadown,380,11,3,7,20,20,55,-35,16
Crusaders,381,1,16,9,5,53,30,23,57
Linfield,381,2,14,8,8,52,26,26,50
Coleraine,381,3,11,11,8,42,33,9,44
Cliftonville,381,4,13,4,13,48,46,2,43
Glenavon,381,5,11,10,9,46,47,-1,43
Ards,381,6,13,4,13,41,46,-5,43
Ballymena,381,7,12,6,12,54,60,-6,42
Dungannon,381,8,10,9,11,53,44,9,39
Glentoran,381,9,11,5,14,34,41,-7,38
Portadown,381,10,7,8,15,25,48,-23,29
Ballinamalla,381,11,8,4,18,29,56,-27,28
Linfield,382,1,14,12,4,63,39,24,54
Ballymena,382,2,16,4,10,61,56,5,52
Dungannon,382,3,14,8,8,65,42,23,50
Crusaders,382,4,12,11,7,55,39,16,47
Cliftonville,382,5,14,5,11,53,51,2,47
Glenavon,382,6,12,11,7,43,42,1,47
Ards,382,7,12,4,14,49,51,-2,40
Coleraine,382,8,7,12,11,44,50,-6,33
Glentoran,382,9,7,10,13,32,48,-16,31
Portadown,382,10,7,5,18,26,48,-22,26
Ballinamalla,382,11,6,6,18,33,58,-25,24
Crusaders,383,1,16,6,8,63,42,21,54
Cliftonville,383,2,16,4,10,54,40,14,52
Linfield,383,3,13,9,8,52,33,19,48
Ballymena,383,4,14,6,10,55,56,-1,48
Dungannon,383,5,12,10,8,59,37,22,46
Coleraine,383,6,11,10,9,49,42,7,43
Ards,383,7,13,3,14,40,49,-9,42
Glenavon,383,8,9,13,8,44,44,0,40
Glentoran,383,9,10,7,13,24,37,-13,37
Ballinamalla,383,10,7,4,19,29,59,-30,25
Portadown,383,11,6,4,20,26,56,-30,22
Cliftonville,384,1,17,4,9,56,36,20,55
Crusaders,384,2,15,9,6,56,36,20,54
Glenavon,384,3,14,10,6,55,43,12,52
Ballymena,384,4,14,5,11,60,63,-3,47
Linfield,384,5,11,12,7,52,34,18,45
Dungannon,384,6,12,9,9,51,40,11,45
Coleraine,384,7,12,9,9,45,43,2,45
Ards,384,8,9,6,15,38,51,-13,33
Glentoran,384,9,7,9,14,28,47,-19,30
Ballinamalla,384,10,8,2,20,28,51,-23,26
Portadown,384,11,6,5,19,24,49,-25,23
Coleraine,385,1,15,10,5,51,33,18,55
Crusaders,385,2,15,8,7,49,30,19,53
Cliftonville,385,3,14,7,9,50,41,9,49
Linfield,385,4,13,9,8,59,36,23,48
Ballymena,385,5,13,6,11,52,57,-5,45
Portadown,385,6,12,6,12,33,41,-8,42
Dungannon,385,7,9,11,10,43,38,5,38
Glenavon,385,8,8,12,10,45,50,-5,36
Ballinamalla,385,9,9,3,18,32,52,-20,30
Ards,385,10,8,5,17,38,55,-17,29
Glentoran,385,11,8,5,17,33,52,-19,29
Crusaders,386,1,20,6,4,65,35,30,66
Cliftonville,386,2,17,4,9,61,41,20,55
Linfield,386,3,16,6,8,64,31,33,54
Coleraine,386,4,13,9,8,46,39,7,48
Ballymena,386,5,12,9,9,54,56,-2,45
Dungannon,386,6,11,8,11,48,38,10,41
Glenavon,386,7,11,7,12,48,53,-5,40
Glentoran,386,8,9,8,13,31,43,-12,35
Portadown,386,9,7,6,17,22,52,-30,27
Ballinamalla,386,10,6,6,18,23,51,-28,24
Ards,386,11,6,5,19,36,59,-23,23
Crusaders,387,1,17,7,6,56,35,21,58
Cliftonville,387,2,15,6,9,57,41,16,51
Linfield,387,3,13,10,7,59,35,24,49
Glenavon,387,4,12,11,7,47,43,4,47
Ballymena,387,5,13,8,9,55,60,-5,47
Portadown,387,6,11,7,12,28,36,-8,40
Coleraine,387,7,9,10,11,42,40,2,37
Glentoran,387,8,10,7,13,35,46,-11,37
Dungannon,387,9,8,10,12,51,50,1,34
Ards,387,10,8,7,15,36,47,-11,31
Ballinamalla,387,11,5,5,20,30,63,-33,20
Crusaders,388,1,18,5,7,62,35,27,59
Cliftonville,388,2,17,4,9,55,41,14,55
Linfield,388,3,14,9,7,57,34,23,51
Ballymena,388,4,15,5,10,54,55,-1,50
Dungannon,388,5,11,8,11,51,44,7,41
Ards,388,6,12,5,13,44,44,0,41
Glenavon,388,7,10,11,9,41,44,-3,41
Coleraine,388,8,9,11,10,40,36,4,38
Ballinamalla,388,9,10,2,18,34,55,-21,32
Glentoran,388,10,6,7,17,27,50,-23,25
Portadown,388,11,6,7,17,22,49,-27,25
Linfield,389,1,15,7,8,59,40,19,52
Crusaders,389,2,14,10,6,56,40,16,52
Coleraine,389,3,11,13,6,40,31,9,46
Cliftonville,389,4,12,9,9,52,43,9,45
Ballymena,389,5,13,5,12,62,63,-1,44
Glenavon,389,6,10,13,7,42,39,3,43
Glentoran,389,7,11,7,12,38,42,-4,40
Ards,389,8,10,6,14,37,47,-10,36
Dungannon,389,9,8,9,13,47,46,1,33
Portadown,389,10,7,8,15,28,46,-18,29
Ballinamalla,389,11,8,5,17,34,58,-24,29
Linfield,390,1,17,7,6,61,29,32,58
Crusaders,390,2,16,7,7,54,38,16,55
Ballymena,390,3,15,4,11,60,58,2,49
Cliftonville,390,4,13,8,9,52,41,11,47
Glenavon,390,5,11,10,9,46,45,1,43
Ballinamalla,390,6,13,2,15,36,48,-12,41
Coleraine,390,7,9,11,10,38,40,-2,38
Dungannon,390,8,9,8,13,51,51,0,35
Glentoran,390,9,9,7,14,32,45,-13,34
Portadown,390,10,9,5,16,35,55,-20,32
Ards,390,11,7,5,18,31,46,-15,26
Crusaders,391,1,18,6,6,56,30,26,60
Linfield,391,2,13,11,6,59,31,28,50
Coleraine,391,3,13,8,9,50,37,13,47
Glenavon,391,4,12,9,9,40,40,0,45
Ballymena,391,5,11,11,8,49,52,-3,44
Cliftonville,391,6,12,6,12,47,46,1,42
Dungannon,391,7,9,9,12,45,44,1,36
Glentoran,391,8,9,9,12,28,44,-16,36
Ards,391,9,10,5,15,43,54,-11,35
Ballinamalla,391,10,9,3,18,31,53,-22,30
Portadown,391,11,7,7,16,30,47,-17,28
Crusaders,392,1,18,6,6,60,33,27,60
Cliftonville,392,2,16,6,8,52,39,13,54
Linfield,392,3,15,7,8,64,34,30,52
Glenavon,392,4,13,8,9,52,47,5,47
Coleraine,392,5,11,10,9,41,38,3,43
Ballymena,392,6,11,9,10,58,58,0,42
Portadown,392,7,9,7,14,28,39,-11,34
Ballinamalla,392,8,10,4,16,33,48,-15,34
Dungannon,392,9,8,8,14,44,49,-5,32
Glentoran,392,10,9,4,17,32,60,-28,31
Ards,392,11,8,5,17,41,60,-19,29
Glenavon,393,1,15,11,4,54,41,13,56
Linfield,393,2,14,12,4,55,28,27,54
Ballymena,393,3,15,6,9,59,54,5,51
Cliftonville,393,4,14,8,8,50,34,16,50
Crusaders,393,5,13,9,8,56,39,17,48
Coleraine,393,6,11,8,11,35,32,3,41
Portadown,393,7,8,7,15,33,46,-13,31
Dungannon,393,8,6,12,12,41,46,-5,30
Ballinamalla,393,9,7,8,15,32,52,-20,29
Ards,393,10,7,7,16,34,54,-20,28
Glentoran,393,11,6,10,14,32,55,-23,28
Linfield,394,1,14,11,5,64,33,31,53
Crusaders,394,2,14,8,8,53,38,15,50
Ballymena,394,3,13,9,8,60,60,0,48
Cliftonville,394,4,14,5,11,49,46,3,47
Glenavon,394,5,10,10,10,48,49,-1,40
Coleraine,394,6,10,10,10,39,47,-8,40
Dungannon,394,7,9,12,9,53,51,2,39
Glentoran,394,8,10,8,12,42,41,1,38
Ards,394,9,10,6,14,36,43,-7,36
Portadown,394,10,9,5,16,34,49,-15,32
Ballinamalla,394,11,7,6,17,31,52,-21,27
Crusaders,395,1,18,8,4,61,28,33,62
Linfield,395,2,15,8,7,55,31,24,53
Coleraine,395,3,13,11,6,61,40,21,50
Glenavon,395,4,13,9,8,50,46,4,48
Ballymena,395,5,14,4,12,61,72,-11,46
Cliftonville,395,6,13,6,11,55,43,12,45
Glentoran,395,7,11,5,14,36,50,-14,38
Dungannon,395,8,9,7,14,45,54,-9,34
Ards,395,9,9,5,16,42,55,-13,32
Ballinamalla,395,10,6,7,17,30,56,-26,25
Portadown,395,11,5,8,17,26,47,-21,23
Crusaders,396,1,18,7,5,63,36,27,61
Cliftonville,396,2,18,3,9,59,41,18,57
Ballymena,396,3,17,5,8,65,52,13,56
Linfield,396,4,13,11,6,63,37,26,50
Glentoran,396,5,12,6,12,37,48,-11,42
Glenavon,396,6,11,8,11,46,45,1,41
Coleraine,396,7,9,12,9,45,43,2,39
Ards,396,8,8,7,15,40,56,-16,31
Ballinamalla,396,9,8,4,18,27,50,-23,28
Dungannon,396,10,6,9,15,37,44,-7,27
Portadown,396,11,6,6,18,22,52,-30,24
Cliftonville,397,1,16,6,8,57,36,21,54
Crusaders,397,2,15,8,7,56,35,21,53
Linfield,397,3,14,8,8,60,33,27,50
Glenavon,397,4,12,10,8,49,47,2,46
Ballymena,397,5,14,4,12,56,62,-6,46
Dungannon,397,6,10,10,10,51,41,10,40
Coleraine,397,7,9,11,10,39,43,-4,38
Ards,397,8,11,3,16,36,52,-16,36
Portadown,397,9,9,7,14,29,43,-14,34
Glentoran,397,10,9,5,16,26,44,-18,32
Ballinamalla,397,11,9,2,19,24,47,-23,29
Crusaders,398,1,17,7,6,54,33,21,58
Coleraine,398,2,13,10,7,45,38,7,49
Linfield,398,3,13,9,8,53,34,19,48
Ballymena,398,4,13,9,8,57,56,1,48
Cliftonville,398,5,13,8,9,55,41,14,47
Glenavon,398,6,11,11,8,48,44,4,44
Dungannon,398,7,9,11,10,47,42,5,38
Ards,398,8,6,12,12,34,47,-13,30
Ballinamalla,398,9,7,7,16,35,53,-18,28
Glentoran,398,10,6,9,15,28,50,-22,27
Portadown,398,11,5,11,14,26,44,-18,26
Linfield,399,1,17,10,3,62,28,34,61
Crusaders,399,2,16,8,6,58,37,21,56
Cliftonville,399,3,14,7,9,50,42,8,49
Dungannon,399,4,13,7,10,56,44,12,46
Glenavon,399,5,12,8,10,42,43,-1,44
Ards,399,6,12,3,15,40,50,-10,39
Coleraine,399,7,9,10,11,41,39,2,37
Ballymena,399,8,10,7,13,52,61,-9,37
Glentoran,399,9,9,10,11,27,40,-13,37
Ballinamalla,399,10,9,3,18,35,53,-18,30
Portadown,399,11,5,5,20,28,54,-26,20
Crusaders,400,1,19,7,4,59,27,32,64
Linfield,400,2,14,10,6,57,33,24,52
Ballymena,400,3,15,5,10,66,59,7,50
Cliftonville,400,4,15,4,11,57,45,12,49
Glenavon,400,5,10,13,7,43,42,1,43
Ards,400,6,11,6,13,40,45,-5,39
Glentoran,400,7,11,6,13,36,41,-5,39
Coleraine,400,8,9,9,12,37,39,-2,36
Dungannon,400,9,7,10,13,42,51,-9,31
Ballinamalla,400,10,9,1,20,29,57,-28,28
Portadown,400,11,7,5,18,32,59,-27,26
Crusaders,401,1,17,8,5,63,36,27,59
Linfield,401,2,13,10,7,66,35,31,49
Cliftonville,401,3,13,9,8,47,41,6,48
Glenavon,401,4,11,11,8,44,45,-1,44
Ards,401,5,12,7,11,37,39,-2,43
Ballymena,401,6,12,6,12,52,59,-7,42
Coleraine,401,7,8,11,11,39,45,-6,35
Glentoran,401,8,9,7,14,28,39,-11,34
Dungannon,401,9,8,9,13,49,54,-5,33
Ballinamalla,401,10,9,6,15,37,53,-16,33
Portadown,401,11,8,6,16,28,44,-16,30
Linfield,402,1,17,8,5,60,30,30,59
Crusaders,402,2,17,6,7,58,35,23,57
Cliftonville,402,3,16,3,11,49,36,13,51
Ballymena,402,4,13,9,8,61,55,6,48
Glenavon,402,5,12,11,7,52,45,7,47
Coleraine,402,6,11,10,9,41,34,7,43
Dungannon,402,7,10,10,10,50,46,4,40
Glentoran,402,8,8,8,14,25,42,-17,32
Ballinamalla,402,9,8,4,18,28,53,-25,28
Portadown,402,10,7,5,18,23,51,-28,26
Ards,402,11,7,4,19,35,55,-20,25
Cliftonville,403,1,19,3,8,63,34,29,60
Crusaders,403,2,15,9,6,58,41,17,54
Glenavon,403,3,15,8,7,51,39,12,53
Linfield,403,4,13,11,6,63,37,26,50
Ballymena,403,5,14,6,10,66,61,5,48
Coleraine,403,6,11,9,10,42,44,-2,42
Dungannon,403,7,9,9,12,48,53,-5,36
Glentoran,403,8,8,11,11,33,42,-9,35
Ards,403,9,7,6,17,33,53,-20,27
Portadown,403,10,7,5,18,26,54,-28,26
Ballinamalla,403,11,6,5,19,32,57,-25,23
Cliftonville,404,1,17,4,9,58,40,18,55
Linfield,404,2,15,9,6,65,35,30,54
Crusaders,404,3,14,7,9,51,41,10,49
Ballymena,404,4,13,8,9,58,55,3,47
Dungannon,404,5,12,9,9,51,42,9,45
Coleraine,404,6,10,10,10,40,45,-5,40
Glenavon,404,7,9,12,9,44,45,-1,39
Glentoran,404,8,10,6,14,33,48,-15,36
Portadown,404,9,8,7,15,24,37,-13,31
Ards,404,10,7,8,15,39,50,-11,29
Ballinamalla,404,11,7,6,17,29,54,-25,27
Crusaders,405,1,17,8,5,52,31,21,59
Linfield,405,2,16,7,7,57,32,25,55
Ballymena,405,3,16,6,8,63,53,10,54
Cliftonville,405,4,14,6,10,57,43,14,48
Glenavon,405,5,12,10,8,49,43,6,46
Coleraine,405,6,10,11,9,40,40,0,41
Dungannon,405,7,8,11,11,45,40,5,35
Glentoran,405,8,8,8,14,25,39,-14,32
Ballinamalla,405,9,9,2,19,29,53,-24,29
Ards,405,10,7,7,16,33,51,-18,28
Portadown,405,11,7,6,17,22,47,-25,27
Linfield,406,1,15,9,6,60,36,24,54
Crusaders,406,2,14,9,7,55,39,16,51
Cliftonville,406,3,13,8,9,56,42,14,47
Ballymena,406,4,13,8,9,60,57,3,47
Coleraine,406,5,11,12,7,40,33,7,45
Glentoran,406,6,10,11,9,28,33,-5,41
Glenavon,406,7,9,10,11,47,57,-10,37
Ards,406,8,11,4,15,43,56,-13,37
Dungannon,406,9,8,10,12,56,48,8,34
Ballinamalla,406,10,6,10,14,28,50,-22,28
Portadown,406,11,6,7,17,23,45,-22,25
Ballymena,407,1,17,6,7,60,50,10,57
Crusaders,407,2,15,9,6,51,37,14,54
Linfield,407,3,15,8,7,52,29,23,53
Cliftonville,407,4,16,5,9,59,40,19,53
Dungannon,407,5,12,8,10,55,42,13,44
Glenavon,407,6,11,9,10,48,48,0,42
Coleraine,407,7,9,11,10,38,40,-2,38
Glentoran,407,8,9,10,11,29,39,-10,37
Ards,407,9,10,3,17,37,48,-11,33
Ballinamalla,407,10,6,7,17,29,52,-23,25
Portadown,407,11,5,4,21,19,52,-33,19
Ballymena,408,1,17,6,7,65,52,13,57
Crusaders,408,2,16,8,6,60,39,21,56
Cliftonville,408,3,16,3,11,54,47,7,51
Glenavon,408,4,13,10,7,51,41,10,49
Linfield,408,5,11,11,8,55,40,15,44
Coleraine,408,6,11,8,11,39,40,-1,41
Dungannon,408,7,8,11,11,53,45,8,35
Ards,408,8,9,7,14,38,45,-7,34
Glentoran,408,9,9,7,14,30,45,-15,34
Ballinamalla,408,10,7,6,17,27,48,-21,27
Portadown,408,11,6,7,17,25,55,-30,25
Cliftonville,409,1,18,2,10,64,42,22,56
Crusaders,409,2,16,7,7,57,38,19,55
Coleraine,409,3,15,9,6,51,37,14,54
Linfield,409,4,13,10,7,66,41,25,49
Ballymena,409,5,14,7,9,60,61,-1,49
Glenavon,409,6,9,13,8,42,42,0,40
Dungannon,409,7,9,11,10,46,38,8,38
Ballinamalla,409,8,9,3,18,26,47,-21,30
Glentoran,409,9,8,6,16,27,54,-27,30
Ards,409,10,7,7,16,37,52,-15,28
Portadown,409,11,7,5,18,23,47,-24,26
Crusaders,410,1,17,9,4,57,30,27,60
Cliftonville,410,2,16,4,10,54,38,16,52
Ballymena,410,3,14,7,9,58,63,-5,49
Linfield,410,4,13,9,8,60,37,23,48
Glenavon,410,5,12,11,7,47,43,4,47
Glentoran,410,6,11,8,11,35,42,-7,41
Coleraine,410,7,11,7,12,36,42,-6,40
Ballinamalla,410,8,9,7,14,38,50,-12,34
Dungannon,410,9,8,9,13,47,51,-4,33
Portadown,410,10,7,5,18,30,45,-15,26
Ards,410,11,6,6,18,31,52,-21,24
Crusaders,411,1,20,6,4,64,28,36,66
Linfield,411,2,13,10,7,54,33,21,49
Dungannon,411,3,13,7,10,51,41,10,46
Cliftonville,411,4,13,7,10,56,47,9,46
Ballymena,411,5,12,9,9,62,63,-1,45
Coleraine,411,6,10,11,9,49,44,5,41
Glenavon,411,7,10,9,11,45,50,-5,39
Ards,411,8,9,7,14,41,48,-7,34
Glentoran,411,9,8,7,15,25,46,-21,31
Ballinamalla,411,10,9,3,18,31,51,-20,30
Portadown,411,11,7,6,17,22,49,-27,27
Crusaders,412,1,18,6,6,66,37,29,60
Linfield,412,2,14,10,6,59,38,21,52
Cliftonville,412,3,15,6,9,50,39,11,51
Ballymena,412,4,11,10,9,56,62,-6,43
Dungannon,412,5,11,9,10,49,40,9,42
Glenavon,412,6,9,12,9,41,43,-2,39
Coleraine,412,7,9,12,9,36,39,-3,39
Glentoran,412,8,10,8,12,35,40,-5,38
Ards,412,9,8,8,14,36,48,-12,32
Portadown,412,10,7,8,15,30,47,-17,29
Ballinamalla,412,11,7,3,20,35,60,-25,24
Linfield,413,1,17,8,5,60,27,33,59
Crusaders,413,2,17,8,5,61,34,27,59
Cliftonville,413,3,16,6,8,57,38,19,54
Ballymena,413,4,16,5,9,62,53,9,53
Coleraine,413,5,13,9,8,52,40,12,48
Glenavon,413,6,10,8,12,46,46,0,38
Glentoran,413,7,9,7,14,30,50,-20,34
Ards,413,8,7,9,14,36,50,-14,30
Portadown,413,9,9,3,18,30,53,-23,30
Dungannon,413,10,6,10,14,45,57,-12,28
Ballinamalla,413,11,7,3,20,30,61,-31,24
Crusaders,414,1,20,7,3,62,30,32,67
Cliftonville,414,2,17,6,7,53,33,20,57
Linfield,414,3,13,10,7,57,31,26,49
Coleraine,414,4,12,11,7,45,32,13,47
Ballymena,414,5,13,6,11,53,62,-9,45
Glenavon,414,6,10,12,8,54,52,2,42
Portadown,414,7,11,3,16,31,46,-15,36
Dungannon,414,8,7,9,14,46,51,-5,30
Glentoran,414,9,8,6,16,30,49,-19,30
Ballinamalla,414,10,8,3,19,30,56,-26,27
Ards,414,11,7,5,18,34,53,-19,26
Crusaders,415,1,16,9,5,54,33,21,57
Linfield,415,2,15,10,5,56,27,29,55
Glenavon,415,3,11,14,5,48,39,9,47
Cliftonville,415,4,12,9,9,53,40,13,45
Ballymena,415,5,12,6,12,56,59,-3,42
Coleraine,415,6,8,14,8,42,46,-4,38
Ballinamalla,415,7,12,2,16,36,54,-18,38
Dungannon,415,8,8,11,11,44,44,0,35
Glentoran,415,9,8,7,15,32,46,-14,31
Portadown,415,10,8,7,15,31,46,-15,31
Ards,415,11,8,5,17,38,56,-18,29
Crusaders,416,1,16,8,6,54,34,20,56
Coleraine,416,2,14,11,5,48,29,19,53
Linfield,416,3,14,10,6,60,34,26,52
Cliftonville,416,4,15,6,9,50,38,12,51
Ballymena,416,5,13,6,11,53,61,-8,45
Glenavon,416,6,10,10,10,47,48,-1,40
Glentoran,416,7,9,9,12,36,44,-8,36
Dungannon,416,8,7,13,10,44,45,-1,34
Ards,416,9,9,6,15,31,47,-16,33
Ballinamalla,416,10,7,6,17,33,48,-15,27
Portadown,416,11,6,5,19,22,50,-28,23
Linfield,417,1,16,7,7,60,29,31,55
Crusaders,417,2,14,10,6,51,35,16,52
Cliftonville,417,3,15,7,8,53,40,13,52
Coleraine,417,4,13,12,5,51,37,14,51
Ballymena,417,5,13,6,11,54,57,-3,45
Glentoran,417,6,13,4,13,34,42,-8,43
Glenavon,417,7,10,12,8,47,43,4,42
Dungannon,417,8,9,8,13,49,54,-5,35
Ards,417,9,8,3,19,29,43,-14,27
Ballinamalla,417,10,7,5,18,30,51,-21,26
Portadown,417,11,6,8,16,26,53,-27,26
Crusaders,418,1,17,6,7,57,34,23,57
Linfield,418,2,16,8,6,58,31,27,56
Cliftonville,418,3,16,6,8,58,37,21,54
Glenavon,418,4,11,11,8,47,43,4,44
Coleraine,418,5,11,9,10,44,45,-1,42
Ballymena,418,6,12,5,13,55,67,-12,41
Dungannon,418,7,10,8,12,50,50,0,38
Ards,418,8,11,4,15,36,46,-10,37
Glentoran,418,9,8,11,11,31,40,-9,35
Ballinamalla,418,10,8,3,19,30,49,-19,27
Portadown,418,11,6,7,17,25,49,-24,25
Crusaders,419,1,19,7,4,57,32,25,64
Ballymena,419,2,16,5,9,61,61,0,53
Linfield,419,3,13,10,7,55,34,21,49
Cliftonville,419,4,13,7,10,57,45,12,46
Glenavon,419,5,11,11,8,51,44,7,44
Dungannon,419,6,11,9,10,57,48,9,42
Glentoran,419,7,11,7,12,29,37,-8,40
Coleraine,419,8,8,12,10,36,38,-2,36
Portadown,419,9,9,6,15,30,45,-15,33
Ards,419,10,8,4,18,40,59,-19,28
Ballinamalla,419,11,4,6,20,27,57,-30,18
Crusaders,420,1,16,6,8,51,34,17,54
Cliftonville,420,2,16,4,10,57,37,20,52
Glenavon,420,3,14,10,6,49,38,11,52
Coleraine,420,4,14,8,8,48,41,7,50
Linfield,420,5,13,10,7,54,33,21,49
Ballymena,420,6,12,10,8,57,58,-1,46
Dungannon,420,7,11,8,11,57,47,10,41
Glentoran,420,8,9,6,15,29,44,-15,33
Ballinamalla,420,9,8,5,17,30,49,-19,29
Ards,420,10,8,5,17,36,56,-20,29
Portadown,420,11,5,6,19,24,55,-31,21
Cliftonville,421,1,17,4,9,59,31,28,55
Crusaders,421,2,16,6,8,53,32,21,54
Linfield,421,3,14,11,5,58,27,31,53
Ballymena,421,4,14,6,10,59,56,3,48
Glenavon,421,5,11,11,8,51,42,9,44
Coleraine,421,6,11,11,8,38,39,-1,44
Dungannon,421,7,10,9,11,52,50,2,39
Glentoran,421,8,11,5,14,23,42,-19,38
Ards,421,9,7,9,14,34,49,-15,30
Portadown,421,10,7,7,16,22,50,-28,28
Ballinamalla,421,11,5,5,20,20,51,-31,20
Linfield,422,1,16,9,5,58,33,25,57
Crusaders,422,2,16,8,6,55,32,23,56
Cliftonville,422,3,16,4,10,58,40,18,52
Coleraine,422,4,13,12,5,46,31,15,51
Dungannon,422,5,11,10,9,47,48,-1,43
Ballymena,422,6,12,7,11,56,58,-2,43
Glenavon,422,7,9,12,9,45,53,-8,39
Ards,422,8,9,6,15,45,46,-1,33
Glentoran,422,9,8,8,14,28,46,-18,32
Portadown,422,10,6,7,17,23,42,-19,25
Ballinamalla,422,11,4,7,19,27,59,-32,19
Crusaders,423,1,19,5,6,55,32,23,62
Cliftonville,423,2,18,4,8,58,37,21,58
Coleraine,423,3,13,9,8,48,41,7,48
Ballymena,423,4,12,7,11,48,51,-3,43
Linfield,423,5,11,9,10,53,34,19,42
Glenavon,423,6,9,11,10,48,48,0,38
Glentoran,423,7,10,8,12,28,40,-12,38
Ballinamalla,423,8,11,4,15,32,45,-13,37
Dungannon,423,9,9,7,14,44,48,-4,34
Portadown,423,10,9,4,17,26,46,-20,31
Ards,423,11,7,6,17,32,50,-18,27
Crusaders,424,1,20,7,3,60,28,32,67
Cliftonville,424,2,18,6,6,59,33,26,60
Linfield,424,3,14,9,7,57,35,22,51
Coleraine,424,4,12,10,8,51,41,10,46
Dungannon,424,5,11,8,11,52,44,8,41
Glenavon,424,6,10,11,9,45,47,-2,41
Glentoran,424,7,10,7,13,31,43,-12,37
Ballymena,424,8,9,7,14,49,62,-13,34
Ards,424,9,8,4,18,36,58,-22,28
Portadown,424,10,8,4,18,27,52,-25,28
Ballinamalla,424,11,8,1,21,30,54,-24,25
Cliftonville,425,1,18,5,7,56,33,23,59
Linfield,425,2,16,10,4,67,29,38,58
Ballymena,425,3,16,6,8,60,57,3,54
Crusaders,425,4,14,6,10,53,47,6,48
Coleraine,425,5,12,8,10,47,37,10,44
Glentoran,425,6,10,9,11,39,44,-5,39
Glenavon,425,7,9,10,11,45,57,-12,37
Dungannon,425,8,8,9,13,43,46,-3,33
Ards,425,9,9,4,17,36,55,-19,31
Portadown,425,10,8,4,18,25,44,-19,28
Ballinamalla,425,11,7,5,18,34,56,-22,26
Ballymena,426,1,15,8,7,58,49,9,53
Linfield,426,2,14,9,7,62,38,24,51
Cliftonville,426,3,14,6,10,53,45,8,48
Crusaders,426,4,13,8,9,51,42,9,47
Coleraine,426,5,11,11,8,46,40,6,44
Glenavon,426,6,11,10,9,45,44,1,43
Ards,426,7,11,6,13,44,46,-2,39
Dungannon,426,8,10,8,12,46,47,-1,38
Glentoran,426,9,9,6,15,33,50,-17,33
Portadown,426,10,8,6,16,28,43,-15,30
Ballinamalla,426,11,6,8,16,32,54,-22,26
Crusaders,427,1,18,9,3,57,28,29,63
Cliftonville,427,2,16,5,9,53,38,15,53
Linfield,427,3,14,9,7,53,31,22,51
Ballymena,427,4,13,9,8,59,53,6,48
Dungannon,427,5,9,10,11,43,44,-1,37
Ards,427,6,10,7,13,42,47,-5,37
Glenavon,427,7,8,12,10,45,50,-5,36
Coleraine,427,8,8,11,11,38,43,-5,35
Glentoran,427,9,9,7,14,30,45,-15,34
Ballinamalla,427,10,8,5,17,35,56,-21,29
Portadown,427,11,8,4,18,27,47,-20,28
Cliftonville,428,1,18,6,6,67,36,31,60
Glenavon,428,2,17,8,5,55,36,19,59
Crusaders,428,3,15,5,10,57,44,13,50
Ballymena,428,4,14,6,10,60,68,-8,48
Linfield,428,5,13,8,9,58,40,18,47
Dungannon,428,6,12,8,10,54,43,11,44
Coleraine,428,7,11,10,9,37,35,2,43
Ards,428,8,8,7,15,33,46,-13,31
Glentoran,428,9,7,9,14,31,44,-13,30
Ballinamalla,428,10,8,5,17,26,51,-25,29
Portadown,428,11,5,2,23,21,56,-35,17
Crusaders,429,1,16,8,6,59,37,22,56
Ballymena,429,2,17,3,10,67,59,8,54
Cliftonville,429,3,14,6,10,50,40,10,48
Dungannon,429,4,13,8,9,54,38,16,47
Linfield,429,5,12,10,8,56,39,17,46
Glenavon,429,6,12,9,9,57,52,5,45
Coleraine,429,7,10,10,10,39,39,0,40
Glentoran,429,8,9,7,14,35,49,-14,34
Ards,429,9,8,7,15,44,53,-9,31
Ballinamalla,429,10,7,6,17,30,54,-24,27
Portadown,429,11,7,6,17,26,57,-31,27
Crusaders,430,1,18,7,5,71,34,37,61
Linfield,430,2,13,11,6,54,35,19,50
Glenavon,430,3,12,13,5,47,43,4,49
Dungannon,430,4,13,8,9,57,40,17,47
Cliftonville,430,5,13,7,10,52,45,7,46
Coleraine,430,6,10,11,9,42,40,2,41
Ballymena,430,7,9,8,13,52,66,-14,35
Portadown,430,8,10,4,16,37,48,-11,34
Glentoran,430,9,7,9,14,29,52,-23,30
Ards,430,10,7,8,15,30,45,-15,29
Ballinamalla,430,11,6,8,16,26,49,-23,26
Cliftonville,431,1,16,7,7,56,34,22,55
Ballymena,431,2,14,9,7,59,52,7,51
Coleraine,431,3,14,9,7,37,31,6,51
Linfield,431,4,13,8,9,55,36,19,47
Glentoran,431,5,13,7,10,40,42,-2,46
Crusaders,431,6,13,6,11,53,40,13,45
Glenavon,431,7,12,9,9,46,38,8,45
Dungannon,431,8,8,8,14,43,47,-4,32
Ballinamalla,431,9,8,5,17,29,52,-23,29
Ards,431,10,7,6,17,36,57,-21,27
Portadown,431,11,7,6,17,26,51,-25,27
Linfield,432,1,16,9,5,62,33,29,57
Crusaders,432,2,16,9,5,56,32,24,57
Cliftonville,432,3,14,6,10,53,44,9,48
Glenavon,432,4,12,11,7,53,47,6,47
Dungannon,432,5,13,6,11,58,50,8,45
Ballymena,432,6,13,5,12,62,59,3,44
Coleraine,432,7,10,9,11,45,45,0,39
Ballinamalla,432,8,9,4,17,37,61,-24,31
Portadown,432,9,8,6,16,31,48,-17,30
Glentoran,432,10,7,9,14,32,52,-20,30
Ards,432,11,8,4,18,42,60,-18,28
Crusaders,433,1,18,7,5,66,36,30,61
Linfield,433,2,17,9,4,64,29,35,60
Ballymena,433,3,16,4,10,59,57,2,52
Cliftonville,433,4,15,4,11,54,43,11,49
Glenavon,433,5,9,10,11,43,45,-2,37
Coleraine,433,6,8,13,9,34,36,-2,37
Ards,433,7,9,7,14,33,46,-13,34
Portadown,433,8,10,4,16,29,42,-13,34
Dungannon,433,9,8,8,14,43,46,-3,32
Ballinamalla,433,10,9,5,16,29,50,-21,32
Glentoran,433,11,8,5,17,27,51,-24,29
Crusaders,434,1,17,6,7,52,35,17,57
Cliftonville,434,2,15,5,10,49,34,15,50
Ballymena,434,3,14,6,10,56,57,-1,48
Linfield,434,4,12,11,7,53,35,18,47
Coleraine,434,5,12,11,7,47,36,11,47
Glenavon,434,6,12,11,7,53,49,4,47
Glentoran,434,7,10,8,12,32,44,-12,38
Dungannon,434,8,9,8,13,48,42,6,35
Ards,434,9,10,4,16,42,49,-7,34
Portadown,434,10,7,7,16,27,45,-18,28
Ballinamalla,434,11,7,3,20,29,62,-33,24
Crusaders,435,1,15,10,5,58,35,23,55
Linfield,435,2,14,9,7,58,35,23,51
Ballymena,435,3,15,6,9,63,52,11,51
Cliftonville,435,4,14,7,9,51,40,11,49
Coleraine,435,5,11,12,7,44,31,13,45
Dungannon,435,6,10,9,11,49,47,2,39
Glenavon,435,7,8,11,11,39,50,-11,35
Glentoran,435,8,8,10,12,28,45,-17,34
Ballinamalla,435,9,8,7,15,35,51,-16,31
Ards,435,10,8,7,15,30,47,-17,31
Portadown,435,11,7,6,17,25,47,-22,27
Crusaders,436,1,16,4,10,56,40,16,52
Glenavon,436,2,14,10,6,51,38,13,52
Cliftonville,436,3,15,5,10,51,40,11,50
Coleraine,436,4,12,9,9,42,34,8,45
Linfield,436,5,11,11,8,51,34,17,44
Ballymena,436,6,12,7,11,49,58,-9,43
Ballinamalla,436,7,11,5,14,36,45,-9,38
Dungannon,436,8,8,10,12,46,45,1,34
Portadown,436,9,10,4,16,27,41,-14,34
Glentoran,436,10,8,9,13,26,41,-15,33
Ards,436,11,7,8,15,31,50,-19,29
Glenavon,437,1,16,9,5,52,35,17,57
Linfield,437,2,15,9,6,52,28,24,54
Crusaders,437,3,15,7,8,59,39,20,52
Ballymena,437,4,15,4,11,56,56,0,49
Cliftonville,437,5,14,4,12,51,41,10,46
Coleraine,437,6,12,10,8,42,38,4,46
Ards,437,7,11,4,15,39,49,-10,37
Portadown,437,8,9,4,17,24,42,-18,31
Dungannon,437,9,7,8,15,47,52,-5,29
Glentoran,437,10,6,11,13,30,48,-18,29
Ballinamalla,437,11,7,6,17,28,52,-24,27
Crusaders,438,1,17,7,6,53,35,18,58
Cliftonville,438,2,16,4,10,55,40,15,52
Ballymena,438,3,14,7,9,54,52,2,49
Linfield,438,4,13,9,8,57,32,25,48
Glenavon,438,5,12,11,7,50,43,7,47
Coleraine,438,6,11,11,8,44,38,6,44
Dungannon,438,7,10,11,9,57,44,13,41
Glentoran,438,8,7,11,12,23,42,-19,32
Ards,438,9,9,4,17,38,56,-18,31
Ballinamalla,438,10,7,5,18,32,54,-22,26
Portadown,438,11,6,6,18,23,50,-27,24
Crusaders,439,1,19,6,5,65,30,35,63
Linfield,439,2,14,11,5,58,35,23,53
Cliftonville,439,3,15,8,7,57,40,17,53
Ballymena,439,4,13,5,12,57,62,-5,44
Coleraine,439,5,10,12,8,43,40,3,42
Glenavon,439,6,10,11,9,38,43,-5,41
Dungannon,439,7,9,8,13,47,46,1,35
Ballinamalla,439,8,9,6,15,36,50,-14,33
Ards,439,9,9,5,16,40,54,-14,32
Glentoran,439,10,7,7,16,35,55,-20,28
Portadown,439,11,6,9,15,23,44,-21,27
Cliftonville,440,1,19,4,7,65,36,29,61
Glenavon,440,2,15,9,6,58,48,10,54
Linfield,440,3,13,11,6,61,36,25,50
Coleraine,440,4,12,10,8,48,42,6,46
Dungannon,440,5,12,9,9,55,40,15,45
Ballymena,440,6,12,5,13,53,67,-14,41
Crusaders,440,7,11,7,12,51,45,6,40
Glentoran,440,8,10,7,13,36,52,-16,37
Ards,440,9,10,3,17,38,51,-13,33
Ballinamalla,440,10,9,2,19,33,57,-24,29
Portadown,440,11,6,5,19,28,52,-24,23
Linfield,441,1,16,8,6,64,27,37,56
Glenavon,441,2,16,7,7,51,45,6,55
Crusaders,441,3,15,9,6,62,44,18,54
Ballymena,441,4,15,6,9,60,53,7,51
Coleraine,441,5,12,11,7,42,31,11,47
Dungannon,441,6,12,9,9,55,41,14,45
Cliftonville,441,7,13,5,12,44,48,-4,44
Ballinamalla,441,8,8,5,17,45,57,-12,29
Ards,441,9,7,5,18,35,55,-20,26
Glentoran,441,10,6,8,16,30,56,-26,26
Portadown,441,11,7,3,20,25,56,-31,24
Linfield,442,1,15,9,6,59,29,30,54
Crusaders,442,2,15,7,8,52,36,16,52
Dungannon,442,3,13,9,8,56,40,16,48
Coleraine,442,4,12,11,7,39,30,9,47
Cliftonville,442,5,13,7,10,47,38,9,46
Ballymena,442,6,9,13,8,48,54,-6,40
Glenavon,442,7,10,9,11,42,47,-5,39
Glentoran,442,8,9,8,13,32,45,-13,35
Ards,442,9,8,7,15,37,52,-15,31
Ballinamalla,442,10,8,6,16,35,56,-21,30
Portadown,442,11,5,10,15,24,44,-20,25
Crusaders,443,1,20,5,5,62,30,32,65
Cliftonville,443,2,15,6,9,54,36,18,51
Coleraine,443,3,12,10,8,43,43,0,46
Linfield,443,4,11,11,8,54,38,16,44
Ballymena,443,5,12,6,12,51,60,-9,42
Ards,443,6,12,3,15,46,49,-3,39
Glenavon,443,7,10,8,12,41,48,-7,38
Dungannon,443,8,8,12,10,45,42,3,36
Portadown,443,9,10,6,14,25,34,-9,36
Ballinamalla,443,10,11,3,16,30,46,-16,36
Glentoran,443,11,5,8,17,29,54,-25,23
Crusaders,444,1,19,6,5,61,32,29,63
Linfield,444,2,16,7,7,61,31,30,55
Cliftonville,444,3,17,3,10,54,40,14,54
Coleraine,444,4,12,11,7,44,38,6,47
Glentoran,444,5,13,8,9,38,40,-2,47
Ballymena,444,6,12,10,8,56,58,-2,46
Glenavon,444,7,12,9,9,47,50,-3,45
Dungannon,444,8,7,12,11,45,47,-2,33
Ards,444,9,9,5,16,41,47,-6,32
Portadown,444,10,5,6,19,22,47,-25,21
Ballinamalla,444,11,4,1,25,28,67,-39,13
Linfield,445,1,17,9,4,65,29,36,60
Crusaders,445,2,16,7,7,53,32,21,55
Cliftonville,445,3,14,5,11,55,40,15,47
Coleraine,445,4,12,10,8,41,39,2,46
Ballymena,445,5,12,8,10,50,56,-6,44
Glenavon,445,6,10,12,8,47,46,1,42
Dungannon,445,7,9,11,10,48,42,6,38
Ballinamalla,445,8,10,5,15,29,46,-17,35
Ards,445,9,10,4,16,35,47,-12,34
Glentoran,445,10,6,9,15,23,45,-22,27
Portadown,445,11,6,6,18,23,47,-24,24
Crusaders,446,1,18,9,3,62,31,31,63
Linfield,446,2,15,8,7,56,28,28,53
Cliftonville,446,3,16,4,10,61,47,14,52
Dungannon,446,4,14,8,8,59,38,21,50
Ballymena,446,5,13,8,9,51,53,-2,47
Coleraine,446,6,12,10,8,46,37,9,46
Ards,446,7,9,7,14,37,45,-8,34
Glentoran,446,8,9,7,14,27,43,-16,34
Glenavon,446,9,8,8,14,41,58,-17,32
Ballinamalla,446,10,7,3,20,29,58,-29,24
Portadown,446,11,7,2,21,23,54,-31,23
Crusaders,447,1,16,10,4,53,27,26,58
Linfield,447,2,16,8,6,68,41,27,56
Cliftonville,447,3,15,7,8,56,41,15,52
Glenavon,447,4,14,8,8,57,44,13,50
Ballymena,447,5,13,7,10,59,58,1,46
Coleraine,447,6,10,11,9,42,44,-2,41
Glentoran,447,7,9,10,11,30,42,-12,37
Dungannon,447,8,7,12,11,46,49,-3,33
Ards,447,9,8,6,16,37,52,-15,30
Ballinamalla,447,10,8,4,18,29,47,-18,28
Portadown,447,11,6,3,21,23,55,-32,21
Crusaders,448,1,18,7,5,56,29,27,61
Linfield,448,2,15,8,7,56,35,21,53
Cliftonville,448,3,15,5,10,53,43,10,50
Glenavon,448,4,13,9,8,52,46,6,48
Ballymena,448,5,13,6,11,58,58,0,45
Ards,448,6,13,4,13,53,46,7,43
Coleraine,448,7,12,7,11,43,38,5,43
Portadown,448,8,9,4,17,27,47,-20,31
Dungannon,448,9,6,11,13,43,55,-12,29
Glentoran,448,10,7,7,16,31,46,-15,28
Ballinamalla,448,11,7,6,17,23,52,-29,27
Cliftonville,449,1,16,5,9,51,38,13,53
Ballymena,449,2,15,7,8,61,56,5,52
Linfield,449,3,14,9,7,54,32,22,51
Crusaders,449,4,14,9,7,54,39,15,51
Glenavon,449,5,10,12,8,47,41,6,42
Coleraine,449,6,9,13,8,43,42,1,40
Dungannon,449,7,9,11,10,46,38,8,38
Glentoran,449,8,9,8,13,35,51,-16,35
Ballinamalla,449,9,10,2,18,36,51,-15,32
Ards,449,10,8,5,17,34,48,-14,29
Portadown,449,11,7,7,16,30,55,-25,28
Crusaders,450,1,18,9,3,64,31,33,63
Linfield,450,2,14,11,5,56,31,25,53
Cliftonville,450,3,16,3,11,56,46,10,51
Coleraine,450,4,13,11,6,51,36,15,50
Ballymena,450,5,14,7,9,61,57,4,49
Glenavon,450,6,11,9,10,47,47,0,42
Dungannon,450,7,10,8,12,46,46,0,38
Ards,450,8,8,6,16,35,52,-17,30
Portadown,450,9,8,6,16,32,50,-18,30
Ballinamalla,450,10,8,3,19,30,54,-24,27
Glentoran,450,11,5,7,18,24,52,-28,22
Crusaders,451,1,17,7,6,55,37,18,58
Linfield,451,2,16,9,5,62,28,34,57
Cliftonville,451,3,15,5,10,53,38,15,50
Coleraine,451,4,13,8,9,43,39,4,47
Ballymena,451,5,12,5,13,54,64,-10,41
Dungannon,451,6,10,10,10,53,43,10,40
Portadown,451,7,11,6,13,37,44,-7,39
Glentoran,451,8,10,6,14,31,44,-13,36
Glenavon,451,9,7,14,9,42,50,-8,35
Ballinamalla,451,10,8,3,19,27,51,-24,27
Ards,451,11,7,5,18,33,52,-19,26
Linfield,452,1,17,7,6,64,31,33,58
Crusaders,452,2,17,7,6,57,33,24,58
Ballymena,452,3,17,6,7,59,51,8,57
Cliftonville,452,4,13,8,9,54,41,13,47
Glenavon,452,5,11,9,10,45,45,0,42
Dungannon,452,6,10,9,11,52,47,5,39
Coleraine,452,7,8,10,12,43,44,-1,34
Portadown,452,8,9,7,14,29,45,-16,34
Ards,452,9,9,4,17,37,55,-18,31
Glentoran,452,10,7,8,15,25,51,-26,29
Ballinamalla,452,11,8,3,19,31,53,-22,27
Crusaders,453,1,16,6,8,61,41,20,54
Cliftonville,453,2,15,4,11,55,47,8,49
Ballymena,453,3,13,8,9,51,49,2,47
Linfield,453,4,11,12,7,51,33,18,45
Coleraine,453,5,11,12,7,43,34,9,45
Glenavon,453,6,11,10,9,47,50,-3,43
Dungannon,453,7,10,9,11,48,44,4,39
Ards,453,8,10,4,16,34,45,-11,34
Glentoran,453,9,9,7,14,30,47,-17,34
Portadown,453,10,9,5,16,33,44,-11,32
Ballinamalla,453,11,9,5,16,34,53,-19,32
Crusaders,454,1,19,7,4,58,33,25,64
Ballymena,454,2,14,7,9,53,53,0,49
Linfield,454,3,13,9,8,55,30,25,48
Cliftonville,454,4,14,5,11,48,40,8,47
Coleraine,454,5,11,11,8,42,40,2,44
Dungannon,454,6,11,9,10,47,40,7,42
Glenavon,454,7,8,12,10,39,46,-7,36
Glentoran,454,8,10,6,14,38,47,-9,36
Portadown,454,9,10,4,16,25,37,-12,34
Ballinamalla,454,10,8,5,17,29,49,-20,29
Ards,454,11,7,5,18,35,54,-19,26
Linfield,455,1,15,11,4,61,29,32,56
Ballymena,455,2,15,5,10,55,54,1,50
Coleraine,455,3,13,10,7,50,39,11,49
Glenavon,455,4,11,14,5,49,39,10,47
Crusaders,455,5,13,7,10,54,40,14,46
Cliftonville,455,6,13,5,12,46,42,4,44
Dungannon,455,7,9,11,10,54,51,3,38
Glentoran,455,8,8,9,13,29,46,-17,33
Portadown,455,9,9,5,16,30,46,-16,32
Ards,455,10,7,8,15,32,46,-14,29
Ballinamalla,455,11,7,5,18,27,55,-28,26
Linfield,456,1,14,11,5,61,30,31,53
Cliftonville,456,2,16,5,9,58,45,13,53
Glenavon,456,3,15,8,7,51,42,9,53
Ballymena,456,4,14,6,10,57,57,0,48
Crusaders,456,5,13,8,9,53,38,15,47
Ards,456,6,12,4,14,39,43,-4,40
Glentoran,456,7,10,8,12,34,43,-9,38
Dungannon,456,8,9,9,12,49,51,-2,36
Coleraine,456,9,9,9,12,34,38,-4,36
Ballinamalla,456,10,9,3,18,27,49,-22,30
Portadown,456,11,6,5,19,22,49,-27,23
Linfield,457,1,17,8,5,62,28,34,59
Cliftonville,457,2,17,4,9,55,36,19,55
Crusaders,457,3,15,8,7,51,34,17,53
Coleraine,457,4,11,10,9,52,52,0,43
Ballymena,457,5,12,7,11,55,62,-7,43
Glentoran,457,6,12,6,12,43,44,-1,42
Glenavon,457,7,9,10,11,51,54,-3,37
Dungannon,457,8,9,8,13,47,41,6,35
Ballinamalla,457,9,11,2,17,33,53,-20,35
Portadown,457,10,10,2,18,27,49,-22,32
Ards,457,11,8,3,19,31,54,-23,27
Linfield,458,1,17,9,4,59,28,31,60
Coleraine,458,2,13,12,5,43,32,11,51
Ballymena,458,3,15,5,10,53,54,-1,50
Crusaders,458,4,13,9,8,53,40,13,48
Glenavon,458,5,11,12,7,52,48,4,45
Glentoran,458,6,11,10,9,44,44,0,43
Cliftonville,458,7,12,6,12,45,38,7,42
Dungannon,458,8,11,8,11,47,46,1,41
Ards,458,9,8,5,17,36,52,-16,29
Ballinamalla,458,10,7,4,19,29,50,-21,25
Portadown,458,11,4,6,20,23,52,-29,18
Crusaders,459,1,15,7,8,53,45,8,52
Cliftonville,459,2,15,6,9,52,38,14,51
Glenavon,459,3,12,9,9,43,40,3,45
Dungannon,459,4,12,8,10,56,43,13,44
Glentoran,459,5,12,8,10,31,39,-8,44
Linfield,459,6,11,9,10,53,35,18,42
Ballymena,459,7,11,8,11,52,56,-4,41
Ards,459,8,12,3,15,44,50,-6,39
Coleraine,459,9,8,12,10,44,44,0,36
Portadown,459,10,10,3,17,33,50,-17,33
Ballinamalla,459,11,8,5,17,36,57,-21,29
Crusaders,460,1,18,7,5,55,32,23,61
Linfield,460,2,15,10,5,59,28,31,55
Cliftonville,460,3,15,5,10,59,44,15,50
Dungannon,460,4,12,9,9,51,37,14,45
Glenavon,460,5,10,12,8,47,42,5,42
Ards,460,6,11,8,11,40,37,3,41
Coleraine,460,7,10,11,9,40,46,-6,41
Ballymena,460,8,11,6,13,55,63,-8,39
Glentoran,460,9,7,9,14,23,41,-18,30
Portadown,460,10,6,7,17,19,51,-32,25
Ballinamalla,460,11,6,4,20,26,53,-27,22
Linfield,461,1,16,9,5,63,31,32,57
Crusaders,461,2,16,9,5,66,40,26,57
Ballymena,461,3,16,4,10,56,52,4,52
Cliftonville,461,4,14,7,9,58,45,13,49
Dungannon,461,5,10,12,8,53,42,11,42
Coleraine,461,6,10,12,8,47,42,5,42
Glenavon,461,7,10,12,8,50,51,-1,42
Ards,461,8,10,6,14,41,48,-7,36
Glentoran,461,9,6,10,14,32,50,-18,28
Ballinamalla,461,10,6,5,19,28,58,-30,23
Portadown,461,11,5,6,19,19,54,-35,21
Crusaders,462,1,16,5,9,50,33,17,53
Linfield,462,2,14,10,6,62,30,32,52
Ballymena,462,3,14,8,8,56,52,4,50
Glenavon,462,4,13,9,8,43,41,2,48
Cliftonville,462,5,13,6,11,46,36,10,45
Coleraine,462,6,11,10,9,37,34,3,43
Ards,462,7,11,6,13,40,48,-8,39
Portadown,462,8,11,6,13,29,38,-9,39
Dungannon,462,9,8,12,10,42,41,1,36
Ballinamalla,462,10,7,4,19,24,48,-24,25
Glentoran,462,11,7,4,19,30,58,-28,25
Linfield,463,1,17,7,6,66,28,38,58
Crusaders,463,2,15,7,8,56,45,11,52
Cliftonville,463,3,15,3,12,53,42,11,48
Glenavon,463,4,12,12,6,48,43,5,48
Dungannon,463,5,12,10,8,58,42,16,46
Coleraine,463,6,12,10,8,49,38,11,46
Ballymena,463,7,13,7,10,51,54,-3,46
Ards,463,8,8,7,15,35,53,-18,31
Glentoran,463,9,7,9,14,28,42,-14,30
Ballinamalla,463,10,7,5,18,27,54,-27,26
Portadown,463,11,5,7,18,19,49,-30,22
Crusaders,464,1,19,4,7,61,35,26,61
Linfield,464,2,16,7,7,63,31,32,55
Cliftonville,464,3,15,5,10,53,41,12,50
Ballymena,464,4,12,8,10,56,65,-9,44
Glenavon,464,5,11,8,11,47,47,0,41
Coleraine,464,6,10,10,10,46,47,-1,40
Ards,464,7,10,8,12,48,50,-2,38
Dungannon,464,8,9,9,12,45,48,-3,36
Glentoran,464,9,8,9,13,30,46,-16,33
Ballinamalla,464,10,8,5,17,31,49,-18,29
Portadown,464,11,7,7,16,28,49,-21,28
Ballymena,465,1,16,5,9,62,51,11,53
Crusaders,465,2,13,11,6,54,40,14,50
Cliftonville,465,3,14,7,9,46,33,13,49
Dungannon,465,4,13,9,8,57,39,18,48
Linfield,465,5,13,8,9,53,34,19,47
Coleraine,465,6,12,10,8,43,33,10,46
Glenavon,465,7,10,11,9,46,47,-1,41
Ards,465,8,11,4,15,35,44,-9,37
Glentoran,465,9,6,11,13,29,49,-20,29
Ballinamalla,465,10,8,4,18,32,57,-25,28
Portadown,465,11,6,6,18,23,53,-30,24
Crusaders,466,1,16,10,4,53,31,22,58
Cliftonville,466,2,16,7,7,60,36,24,55
Ballymena,466,3,13,8,9,57,55,2,47
Glenavon,466,4,11,12,7,50,50,0,45
Linfield,466,5,10,12,8,47,32,15,42
Glentoran,466,6,11,8,11,38,41,-3,41
Coleraine,466,7,10,10,10,39,41,-2,40
Dungannon,466,8,10,9,11,44,43,1,39
Ards,466,9,9,5,16,33,51,-18,32
Portadown,466,10,7,7,16,30,45,-15,28
Ballinamalla,466,11,5,6,19,29,55,-26,21
Cliftonville,467,1,19,4,7,56,35,21,61
Crusaders,467,2,14,7,9,59,43,16,49
Linfield,467,3,12,12,6,66,38,28,48
Dungannon,467,4,11,9,10,50,42,8,42
Glenavon,467,5,10,11,9,51,54,-3,41
Glentoran,467,6,11,8,11,37,43,-6,41
Ballymena,467,7,11,7,12,57,68,-11,40
Coleraine,467,8,9,10,11,36,44,-8,37
Ards,467,9,9,7,14,39,47,-8,34
Portadown,467,10,7,9,14,29,41,-12,30
Ballinamalla,467,11,6,8,16,30,55,-25,26
Crusaders,468,1,18,6,6,60,37,23,60
Linfield,468,2,14,9,7,60,34,26,51
Ballymena,468,3,15,6,9,53,50,3,51
Cliftonville,468,4,14,4,12,50,39,11,46
Coleraine,468,5,11,11,8,43,36,7,44
Glenavon,468,6,10,13,7,45,43,2,43
Dungannon,468,7,9,10,11,45,42,3,37
Glentoran,468,8,9,9,12,35,46,-11,36
Portadown,468,9,9,6,15,32,50,-18,33
Ards,468,10,6,8,16,34,56,-22,26
Ballinamalla,468,11,6,6,18,27,51,-24,24
Crusaders,469,1,18,5,7,54,28,26,59
Ballymena,469,2,15,7,8,57,52,5,52
Linfield,469,3,13,10,7,51,36,15,49
Cliftonville,469,4,14,5,11,51,43,8,47
Glenavon,469,5,10,12,8,47,44,3,42
Coleraine,469,6,10,11,9,42,41,1,41
Dungannon,469,7,10,9,11,47,40,7,39
Glentoran,469,8,10,5,15,33,44,-11,35
Ards,469,9,9,7,14,40,49,-9,34
Ballinamalla,469,10,9,3,18,31,53,-22,30
Portadown,469,11,5,10,15,27,50,-23,25
Crusaders,470,1,18,9,3,58,27,31,63
Ballymena,470,2,15,6,9,58,53,5,51
Cliftonville,470,3,14,6,10,57,44,13,48
Linfield,470,4,12,11,7,52,29,23,47
Coleraine,470,5,13,7,10,48,46,2,46
Glenavon,470,6,11,11,8,47,45,2,44
Portadown,470,7,9,7,14,28,43,-15,34
Glentoran,470,8,8,9,13,31,48,-17,33
Dungannon,470,9,6,11,13,37,44,-7,29
Ards,470,10,7,7,16,34,47,-13,28
Ballinamalla,470,11,8,4,18,29,53,-24,28
Crusaders,471,1,18,9,3,54,26,28,63
Linfield,471,2,18,7,5,65,26,39,61
Cliftonville,471,3,16,6,8,46,31,15,54
Ballymena,471,4,12,7,11,53,58,-5,43
Coleraine,471,5,10,11,9,35,39,-4,41
Glenavon,471,6,9,11,10,45,49,-4,38
Ards,471,7,11,5,14,37,42,-5,38
Dungannon,471,8,8,9,13,51,55,-4,33
Glentoran,471,9,7,11,12,34,47,-13,32
Portadown,471,10,7,7,16,30,49,-19,28
Ballinamalla,471,11,5,5,20,21,49,-28,20
Crusaders,472,1,20,7,3,57,27,30,67
Linfield,472,2,14,10,6,59,32,27,52
Cliftonville,472,3,15,5,10,55,42,13,50
Coleraine,472,4,10,11,9,46,42,4,41
Ballymena,472,5,10,9,11,52,61,-9,39
Glenavon,472,6,8,13,9,43,45,-2,37
Dungannon,472,7,8,11,11,49,50,-1,35
Glentoran,472,8,8,10,12,26,39,-13,34
Ards,472,9,10,3,17,35,48,-13,33
Portadown,472,10,8,7,15,31,48,-17,31
Ballinamalla,472,11,8,6,16,28,47,-19,30
Ballymena,473,1,17,7,6,64,49,15,58
Crusaders,473,2,15,8,7,60,43,17,53
Cliftonville,473,3,14,6,10,50,39,11,48
Linfield,473,4,12,9,9,57,40,17,45
Coleraine,473,5,12,9,9,45,44,1,45
Ards,473,6,13,4,13,42,42,0,43
Glenavon,473,7,10,11,9,46,50,-4,41
Dungannon,473,8,10,9,11,52,44,8,39
Portadown,473,9,10,4,16,23,36,-13,34
Glentoran,473,10,6,7,17,26,51,-25,25
Ballinamalla,473,11,5,8,17,27,54,-27,23
Crusaders,474,1,15,6,9,53,41,12,51
Ballymena,474,2,14,9,7,63,55,8,51
Cliftonville,474,3,13,10,7,55,38,17,49
Coleraine,474,4,12,10,8,39,31,8,46
Linfield,474,5,11,12,7,54,38,16,45
Glenavon,474,6,11,9,10,48,48,0,42
Ards,474,7,10,7,13,39,45,-6,37
Dungannon,474,8,8,10,12,52,48,4,34
Glentoran,474,9,8,9,13,33,49,-16,33
Ballinamalla,474,10,8,6,16,30,50,-20,30
Portadown,474,11,7,8,15,26,49,-23,29
Crusaders,475,1,20,6,4,76,39,37,66
Cliftonville,475,2,16,5,9,54,40,14,53
Ballymena,475,3,13,8,9,59,59,0,47
Coleraine,475,4,11,11,8,41,36,5,44
Dungannon,475,5,11,10,9,57,46,11,43
Linfield,475,6,11,9,10,55,38,17,42
Glenavon,475,7,10,10,10,42,43,-1,40
Glentoran,475,8,10,5,15,30,48,-18,35
Portadown,475,9,10,4,16,21,44,-23,34
Ards,475,10,8,5,17,34,50,-16,29
Ballinamalla,475,11,6,5,19,34,60,-26,23
Cliftonville,476,1,20,3,7,52,29,23,63
Crusaders,476,2,16,8,6,56,36,20,56
Linfield,476,3,15,7,8,61,40,21,52
Ballymena,476,4,13,7,10,51,55,-4,46
Glentoran,476,5,12,7,11,41,38,3,43
Coleraine,476,6,11,9,10,42,39,3,42
Glenavon,476,7,10,10,10,50,46,4,40
Ballinamalla,476,8,12,2,16,33,53,-20,38
Dungannon,476,9,7,9,14,48,49,-1,30
Ards,476,10,9,3,18,37,50,-13,30
Portadown,476,11,5,5,20,19,55,-36,20
Crusaders,477,1,12,12,6,55,36,19,48
Coleraine,477,2,12,12,6,45,37,8,48
Cliftonville,477,3,15,3,12,51,46,5,48
Glenavon,477,4,11,12,7,43,38,5,45
Linfield,477,5,11,11,8,58,39,19,44
Ballymena,477,6,13,5,12,59,62,-3,44
Dungannon,477,7,9,12,9,46,40,6,39
Glentoran,477,8,10,9,11,36,47,-11,39
Portadown,477,9,11,4,15,34,47,-13,37
Ards,477,10,11,3,16,45,50,-5,36
Ballinamalla,477,11,5,7,18,26,56,-30,22
Crusaders,478,1,18,5,7,54,30,24,59
Ballymena,478,2,16,7,7,68,54,14,55
Linfield,478,3,15,8,7,55,32,23,53
Coleraine,478,4,14,10,6,44,31,13,52
Cliftonville,478,5,13,7,10,49,35,14,46
Dungannon,478,6,11,9,10,60,45,15,42
Glenavon,478,7,9,14,7,44,48,-4,41
Ards,478,8,8,7,15,40,52,-12,31
Portadown,478,9,5,10,15,23,52,-29,25
Ballinamalla,478,10,7,3,20,29,60,-31,24
Glentoran,478,11,4,10,16,26,53,-27,22
Cliftonville,479,1,17,5,8,51,33,18,56
Linfield,479,2,14,11,5,55,28,27,53
Crusaders,479,3,14,11,5,49,31,18,53
Coleraine,479,4,12,12,6,43,38,5,48
Glenavon,479,5,11,11,8,48,39,9,44
Ballymena,479,6,11,9,10,56,59,-3,42
Glentoran,479,7,9,12,9,34,43,-9,39
Dungannon,479,8,8,14,8,44,38,6,38
Ards,479,9,9,5,16,37,43,-6,32
Portadown,479,10,4,8,18,16,46,-30,20
Ballinamalla,479,11,4,6,20,20,55,-35,18
Cliftonville,480,1,16,7,7,65,36,29,55
Crusaders,480,2,16,6,8,54,39,15,54
Linfield,480,3,14,10,6,56,33,23,52
Coleraine,480,4,13,11,6,44,30,14,50
Ballymena,480,5,14,5,11,55,57,-2,47
Glenavon,480,6,11,12,7,46,43,3,45
Dungannon,480,7,12,6,12,47,39,8,42
Glentoran,480,8,9,5,16,32,44,-12,32
Ards,480,9,9,5,16,34,51,-17,32
Ballinamalla,480,10,8,2,20,28,59,-31,26
Portadown,480,11,5,7,18,22,52,-30,22
Crusaders,481,1,16,8,6,53,27,26,56
Linfield,481,2,12,11,7,57,34,23,47
Glenavon,481,3,12,11,7,40,38,2,47
Cliftonville,481,4,13,6,11,47,40,7,45
Coleraine,481,5,11,11,8,39,35,4,44
Ballymena,481,6,11,9,10,51,57,-6,42
Dungannon,481,7,9,14,7,46,38,8,41
Glentoran,481,8,10,8,12,39,47,-8,38
Ards,481,9,9,7,14,36,45,-9,34
Ballinamalla,481,10,5,11,14,27,48,-21,26
Portadown,481,11,5,8,17,21,47,-26,23
Cliftonville,482,1,16,5,9,55,41,14,53
Glenavon,482,2,13,11,6,54,40,14,50
Glentoran,482,3,14,8,8,38,38,0,50
Linfield,482,4,13,10,7,58,31,27,49
Crusaders,482,5,12,9,9,54,42,12,45
Ballymena,482,6,12,8,10,51,53,-2,44
Coleraine,482,7,10,12,8,45,47,-2,42
Dungannon,482,8,8,10,12,50,48,2,34
Ards,482,9,8,7,15,41,51,-10,31
Portadown,482,10,6,7,17,25,49,-24,25
Ballinamalla,482,11,6,7,17,25,56,-31,25
Crusaders,483,1,16,8,6,53,33,20,56
Ballymena,483,2,15,8,7,59,50,9,53
Cliftonville,483,3,15,3,12,45,41,4,48
Linfield,483,4,13,7,10,59,36,23,46
Glenavon,483,5,12,9,9,43,47,-4,45
Coleraine,483,6,10,11,9,42,38,4,41
Glentoran,483,7,11,7,12,36,42,-6,40
Dungannon,483,8,10,9,11,46,40,6,39
Portadown,483,9,10,7,13,29,37,-8,37
Ards,483,10,10,5,15,35,48,-13,35
Ballinamalla,483,11,5,2,23,23,58,-35,17
Crusaders,484,1,17,8,5,53,30,23,59
Linfield,484,2,16,10,4,59,27,32,58
Ballymena,484,3,14,5,11,64,58,6,47
Cliftonville,484,4,14,5,11,48,42,6,47
Glenavon,484,5,11,11,8,47,47,0,44
Coleraine,484,6,11,10,9,44,41,3,43
Ards,484,7,11,4,15,37,43,-6,37
Ballinamalla,484,8,10,5,15,29,43,-14,35
Glentoran,484,9,8,7,15,25,45,-20,31
Dungannon,484,10,6,12,12,38,40,-2,30
Portadown,484,11,6,5,19,23,51,-28,23
Crusaders,485,1,16,8,6,52,35,17,56
Ballymena,485,2,16,6,8,60,51,9,54
Linfield,485,3,13,13,4,56,29,27,52
Cliftonville,485,4,16,4,10,54,39,15,52
Coleraine,485,5,11,12,7,38,32,6,45
Glenavon,485,6,11,10,9,46,44,2,43
Dungannon,485,7,11,8,11,49,44,5,41
Ballinamalla,485,8,8,7,15,32,47,-15,31
Ards,485,9,7,5,18,35,50,-15,26
Portadown,485,10,7,5,18,21,46,-25,26
Glentoran,485,11,6,8,16,22,48,-26,26
Cliftonville,486,1,17,3,10,55,39,16,54
Crusaders,486,2,14,9,7,48,31,17,51
Linfield,486,3,14,8,8,56,31,25,50
Glentoran,486,4,13,6,11,43,45,-2,45
Glenavon,486,5,10,14,6,52,46,6,44
Coleraine,486,6,11,11,8,36,36,0,44
Ballymena,486,7,13,5,12,54,64,-10,44
Dungannon,486,8,8,9,13,47,47,0,33
Ballinamalla,486,9,9,5,16,34,50,-16,32
Portadown,486,10,8,5,17,24,44,-20,29
Ards,486,11,6,9,15,37,53,-16,27
Linfield,487,1,17,7,6,58,28,30,58
Cliftonville,487,2,18,4,8,53,32,21,58
Crusaders,487,3,16,6,8,52,36,16,54
Ballymena,487,4,14,8,8,57,55,2,50
Glenavon,487,5,11,11,8,39,37,2,44
Coleraine,487,6,10,13,7,35,33,2,43
Glentoran,487,7,9,7,14,30,43,-13,34
Dungannon,487,8,7,11,12,46,46,0,32
Ards,487,9,8,5,17,38,50,-12,29
Ballinamalla,487,10,7,6,17,26,50,-24,27
Portadown,487,11,5,8,17,22,46,-24,23
Crusaders,488,1,19,6,5,55,34,21,63
Linfield,488,2,15,8,7,57,27,30,53
Cliftonville,488,3,16,5,9,58,45,13,53
Ballymena,488,4,15,4,11,57,50,7,49
Coleraine,488,5,12,12,6,40,30,10,48
Glenavon,488,6,11,12,7,50,44,6,45
Dungannon,488,7,7,11,12,41,42,-1,32
Ards,488,8,8,7,15,38,56,-18,31
Glentoran,488,9,7,7,16,25,43,-18,28
Ballinamalla,488,10,7,7,16,34,55,-21,28
Portadown,488,11,6,5,19,25,54,-29,23
Crusaders,489,1,17,7,6,50,30,20,58
Cliftonville,489,2,18,4,8,58,39,19,58
Linfield,489,3,15,10,5,61,31,30,55
Glenavon,489,4,11,11,8,52,43,9,44
Dungannon,489,5,12,7,11,51,45,6,43
Ballymena,489,6,12,7,11,52,57,-5,43
Coleraine,489,7,9,14,7,39,37,2,41
Ballinamalla,489,8,10,5,15,29,44,-15,35
Ards,489,9,8,6,16,37,51,-14,30
Glentoran,489,10,6,8,16,26,47,-21,26
Portadown,489,11,5,5,20,20,51,-31,20
Linfield,490,1,13,12,5,62,35,27,51
Ballymena,490,2,14,6,10,56,49,7,48
Crusaders,490,3,12,10,8,50,37,13,46
Cliftonville,490,4,14,4,12,49,42,7,46
Dungannon,490,5,11,10,9,50,43,7,43
Coleraine,490,6,10,13,7,40,34,6,43
Ards,490,7,11,6,13,34,40,-6,39
Portadown,490,8,12,3,15,32,39,-7,39
Glentoran,490,9,8,10,12,28,44,-16,34
Glenavon,490,10,6,12,12,35,52,-17,30
Ballinamalla,490,11,8,6,16,30,51,-21,30
Crusaders,491,1,19,7,4,57,26,31,64
Cliftonville,491,2,17,6,7,54,31,23,57
Coleraine,491,3,14,8,8,48,34,14,50
Linfield,491,4,13,9,8,55,31,24,48
Ballymena,491,5,13,6,11,54,59,-5,45
Glenavon,491,6,10,9,11,38,44,-6,39
Dungannon,491,7,10,8,12,48,46,2,38
Glentoran,491,8,9,9,12,29,42,-13,36
Ards,491,9,8,5,17,33,55,-22,29
Portadown,491,10,8,3,19,23,51,-28,27
Ballinamalla,491,11,7,4,19,29,49,-20,25
Crusaders,492,1,16,7,7,57,34,23,55
Cliftonville,492,2,16,5,9,50,35,15,53
Linfield,492,3,14,10,6,56,30,26,52
Glenavon,492,4,13,12,5,54,39,15,51
Ballymena,492,5,14,8,8,56,53,3,50
Coleraine,492,6,11,9,10,40,40,0,42
Dungannon,492,7,7,12,11,47,47,0,33
Ballinamalla,492,8,9,5,16,33,56,-23,32
Ards,492,9,8,7,15,34,46,-12,31
Glentoran,492,10,6,8,16,23,46,-23,26
Portadown,492,11,6,7,17,22,46,-24,25
Crusaders,493,1,20,7,3,60,26,34,67
Coleraine,493,2,14,10,6,45,32,13,52
Linfield,493,3,13,10,7,56,32,24,49
Ballymena,493,4,14,6,10,61,56,5,48
Glenavon,493,5,9,15,6,52,50,2,42
Cliftonville,493,6,10,11,9,51,46,5,41
Glentoran,493,7,9,8,13,30,47,-17,35
Ards,493,8,7,8,15,37,54,-17,29
Ballinamalla,493,9,8,5,17,30,51,-21,29
Portadown,493,10,7,7,16,32,51,-19,28
Dungannon,493,11,5,11,14,39,48,-9,26
Crusaders,494,1,17,5,8,57,39,18,56
Cliftonville,494,2,15,6,9,50,37,13,51
Linfield,494,3,13,11,6,50,31,19,50
Dungannon,494,4,12,10,8,48,34,14,46
Glenavon,494,5,11,11,8,47,45,2,44
Ballymena,494,6,11,9,10,54,60,-6,42
Coleraine,494,7,10,10,10,42,38,4,40
Ards,494,8,11,5,14,42,44,-2,38
Portadown,494,9,7,9,14,22,40,-18,30
Glentoran,494,10,6,9,15,29,47,-18,27
Ballinamalla,494,11,7,5,18,29,55,-26,26
Crusaders,495,1,15,9,6,52,37,15,54
Linfield,495,2,14,10,6,60,37,23,52
Dungannon,495,3,11,9,10,62,45,17,42
Coleraine,495,4,10,12,8,44,43,1,42
Ballymena,495,5,11,9,10,53,57,-4,42
Glenavon,495,6,9,14,7,41,42,-1,41
Cliftonville,495,7,11,7,12,45,41,4,40
Ards,495,8,11,6,13,39,39,0,39
Glentoran,495,9,9,10,11,34,39,-5,37
Portadown,495,10,10,5,15,24,41,-17,35
Ballinamalla,495,11,6,5,19,23,56,-33,23
Linfield,496,1,15,8,7,58,30,28,53
Crusaders,496,2,14,9,7,53,39,14,51
Ballymena,496,3,15,6,9,59,56,3,51
Glenavon,496,4,13,10,7,50,43,7,49
Cliftonville,496,5,14,5,11,50,35,15,47
Coleraine,496,6,12,10,8,44,36,8,46
Glentoran,496,7,9,9,12,28,45,-17,36
Dungannon,496,8,8,10,12,42,45,-3,34
Ballinamalla,496,9,9,5,16,31,50,-19,32
Ards,496,10,9,3,18,37,54,-17,30
Portadown,496,11,6,7,17,22,41,-19,25
Linfield,497,1,16,11,3,63,24,39,59
Crusaders,497,2,16,10,4,54,30,24,58
Cliftonville,497,3,15,5,10,53,40,13,50
Ballymena,497,4,15,4,11,57,61,-4,49
Dungannon,497,5,13,8,9,57,46,11,47
Glenavon,497,6,11,10,9,47,42,5,43
Coleraine,497,7,9,10,11,37,45,-8,37
Glentoran,497,8,9,10,11,26,38,-12,37
Ards,497,9,8,6,16,35,47,-12,30
Ballinamalla,497,10,6,5,19,28,58,-30,23
Portadown,497,11,5,5,20,26,52,-26,20
Crusaders,498,1,18,7,5,53,27,26,61
Ballymena,498,2,15,4,11,56,59,-3,49
Linfield,498,3,13,9,8,57,36,21,48
Glenavon,498,4,12,11,7,46,43,3,47
Cliftonville,498,5,14,2,14,40,43,-3,44
Coleraine,498,6,10,13,7,50,40,10,43
Glentoran,498,7,9,10,11,28,40,-12,37
Dungannon,498,8,9,9,12,45,43,2,36
Portadown,498,9,8,7,15,26,39,-13,31
Ards,498,10,7,8,15,38,48,-10,29
Ballinamalla,498,11,8,4,18,34,55,-21,28
Cliftonville,499,1,17,5,8,59,38,21,56
Linfield,499,2,13,11,6,61,35,26,50
Glenavon,499,3,12,14,4,57,43,14,50
Crusaders,499,4,15,4,11,56,55,1,49
Ballymena,499,5,10,10,10,51,60,-9,40
Ballinamalla,499,6,11,6,13,39,44,-5,39
Coleraine,499,7,8,14,8,41,40,1,38
Dungannon,499,8,9,10,11,42,38,4,37
Ards,499,9,9,7,14,43,55,-12,34
Portadown,499,10,7,7,16,27,50,-23,28
Glentoran,499,11,5,10,15,32,50,-18,25
Linfield,500,1,17,7,6,59,32,27,58
Cliftonville,500,2,16,5,9,46,30,16,53
Glenavon,500,3,14,11,5,55,40,15,53
Ballymena,500,4,16,5,9,62,56,6,53
Crusaders,500,5,15,7,8,55,38,17,52
Coleraine,500,6,12,8,10,39,45,-6,44
Dungannon,500,7,10,11,9,55,41,14,41
Glentoran,500,8,9,7,14,26,39,-13,34
Ballinamalla,500,9,8,2,20,23,54,-31,26
Ards,500,10,7,4,19,33,49,-16,25
Portadown,500,11,6,3,21,24,53,-29,21
Crusaders,501,1,16,10,4,62,36,26,58
Linfield,501,2,14,11,5,60,33,27,53
Glenavon,501,3,14,10,6,52,39,13,52
Cliftonville,501,4,15,6,9,55,44,11,51
Coleraine,501,5,11,9,10,41,38,3,42
Dungannon,501,6,10,10,10,50,46,4,40
Ballymena,501,7,11,7,12,57,67,-10,40
Glentoran,501,8,10,8,12,31,41,-10,38
Ballinamalla,501,9,9,5,16,34,49,-15,32
Ards,501,10,7,4,19,32,52,-20,25
Portadown,501,11,5,6,19,21,50,-29,21
Crusaders,502,1,18,5,7,56,36,20,59
Linfield,502,2,15,8,7,59,30,29,53
Cliftonville,502,3,13,8,9,57,43,14,47
Coleraine,502,4,10,12,8,47,42,5,42
Glenavon,502,5,10,11,9,46,46,0,41
Dungannon,502,6,10,10,10,60,52,8,40
Glentoran,502,7,10,9,11,32,36,-4,39
Ards,502,8,11,5,14,44,50,-6,38
Ballymena,502,9,8,8,14,48,68,-20,32
Portadown,502,10,7,9,14,26,50,-24,30
Ballinamalla,502,11,7,7,16,26,48,-22,28
Linfield,503,1,15,11,4,62,35,27,56
Crusaders,503,2,15,9,6,52,32,20,54
Cliftonville,503,3,16,4,10,53,40,13,52
Dungannon,503,4,13,8,9,58,42,16,47
Ballymena,503,5,13,5,12,59,60,-1,44
Coleraine,503,6,9,13,8,38,38,0,40
Glenavon,503,7,9,12,9,51,53,-2,39
Ards,503,8,9,8,13,38,43,-5,35
Portadown,503,9,8,6,16,30,46,-16,30
Glentoran,503,10,8,6,16,23,44,-21,30
Ballinamalla,503,11,7,4,19,27,58,-31,25
Linfield,504,1,17,9,4,68,26,42,60
Ballymena,504,2,16,7,7,57,53,4,55
Crusaders,504,3,16,6,8,51,39,12,54
Cliftonville,504,4,16,2,12,56,44,12,50
Dungannon,504,5,14,6,10,61,43,18,48
Coleraine,504,6,12,8,10,39,36,3,44
Glenavon,504,7,10,10,10,42,44,-2,40
Glentoran,504,8,9,6,15,29,48,-19,33
Portadown,504,9,9,4,17,27,49,-22,31
Ards,504,10,8,5,17,28,46,-18,29
Ballinamalla,504,11,5,3,22,22,52,-30,18
Crusaders,505,1,15,11,4,57,33,24,56
Linfield,505,2,16,7,7,61,34,27,55
Cliftonville,505,3,14,5,11,48,36,12,47
Glenavon,505,4,12,10,8,53,46,7,46
Ballymena,505,5,12,8,10,50,55,-5,44
Coleraine,505,6,10,11,9,39,37,2,41
Dungannon,505,7,9,10,11,44,44,0,37
Portadown,505,8,9,8,13,28,38,-10,35
Ards,505,9,9,4,17,33,48,-15,31
Ballinamalla,505,10,8,6,16,28,49,-21,30
Glentoran,505,11,6,10,14,23,44,-21,28
Crusaders,506,1,18,8,4,61,28,33,62
Linfield,506,2,15,7,8,56,33,23,52
Ballymena,506,3,16,3,11,62,58,4,51
Cliftonville,506,4,15,4,11,54,41,13,49
Dungannon,506,5,12,9,9,52,44,8,45
Coleraine,506,6,11,10,9,43,42,1,43
Glenavon,506,7,9,12,9,47,48,-1,39
Glentoran,506,8,9,9,12,31,39,-8,36
Ards,506,9,8,7,15,41,53,-12,31
Ballinamalla,506,10,7,6,17,31,55,-24,27
Portadown,506,11,5,5,20,24,61,-37,20
Linfield,507,1,16,10,4,61,24,37,58
Crusaders,507,2,16,7,7,55,31,24,55
Cliftonville,507,3,16,4,10,59,49,10,52
Ballymena,507,4,15,5,10,63,59,4,50
Glenavon,507,5,10,12,8,50,44,6,42
Coleraine,507,6,10,11,9,50,49,1,41
Ards,507,7,12,3,15,41,51,-10,39
Dungannon,507,8,10,8,12,48,48,0,38
Portadown,507,9,8,6,16,33,53,-20,30
Ballinamalla,507,10,8,3,19,30,56,-26,27
Glentoran,507,11,6,7,17,27,53,-26,25
Linfield,508,1,17,10,3,61,25,36,61
Crusaders,508,2,17,9,4,54,34,20,60
Cliftonville,508,3,17,5,8,52,38,14,56
Coleraine,508,4,14,9,7,50,39,11,51
Ballymena,508,5,13,8,9,53,52,1,47
Glentoran,508,6,9,7,14,32,45,-13,34
Portadown,508,7,10,4,16,25,40,-15,34
Dungannon,508,8,7,10,13,51,50,1,31
Glenavon,508,9,6,10,14,42,52,-10,28
Ards,508,10,7,7,16,32,49,-17,28
Ballinamalla,508,11,6,5,19,25,53,-28,23
Linfield,509,1,14,9,7,59,36,23,51
Crusaders,509,2,14,6,10,49,39,10,48
Ballymena,509,3,14,6,10,61,59,2,48
Ards,509,4,14,5,11,47,41,6,47
Cliftonville,509,5,14,3,13,44,39,5,45
Coleraine,509,6,10,11,9,37,40,-3,41
Dungannon,509,7,10,9,11,51,44,7,39
Glenavon,509,8,9,11,10,46,51,-5,38
Portadown,509,9,10,6,14,30,41,-11,36
Glentoran,509,10,9,6,15,37,53,-16,33
Ballinamalla,509,11,8,6,16,35,53,-18,30
Crusaders,510,1,17,6,7,67,51,16,57
Linfield,510,2,13,12,5,62,38,24,51
Cliftonville,510,3,16,3,11,63,43,20,51
Glenavon,510,4,13,10,7,50,45,5,49
Ballymena,510,5,12,9,9,58,58,0,45
Coleraine,510,6,10,11,9,39,42,-3,41
Ards,510,7,10,6,14,43,46,-3,36
Dungannon,510,8,9,8,13,50,55,-5,35
Ballinamalla,510,9,9,6,15,38,53,-15,33
Portadown,510,10,8,5,17,32,49,-17,29
Glentoran,510,11,5,10,15,28,50,-22,25
Cliftonville,511,1,21,3,6,54,28,26,66
Crusaders,511,2,17,7,6,52,30,22,58
Linfield,511,3,13,10,7,60,33,27,49
Ballymena,511,4,14,6,10,57,57,0,48
Glenavon,511,5,12,10,8,53,39,14,46
Coleraine,511,6,10,9,11,39,41,-2,39
Dungannon,511,7,8,9,13,47,48,-1,33
Glentoran,511,8,8,9,13,28,42,-14,33
Ballinamalla,511,9,10,3,17,32,54,-22,33
Ards,511,10,9,2,19,38,54,-16,29
Portadown,511,11,7,4,19,20,54,-34,25
Crusaders,512,1,18,6,6,53,34,19,60
Linfield,512,2,13,10,7,57,33,24,49
Ballymena,512,3,14,7,9,62,55,7,49
Cliftonville,512,4,14,6,10,51,37,14,48
Glenavon,512,5,11,11,8,48,45,3,44
Coleraine,512,6,11,9,10,38,42,-4,42
Glentoran,512,7,9,9,12,27,42,-15,36
Dungannon,512,8,9,8,13,51,50,1,35
Ards,512,9,8,8,14,31,45,-14,32
Ballinamalla,512,10,8,5,17,34,49,-15,29
Portadown,512,11,7,7,16,27,47,-20,28
Linfield,513,1,17,9,4,67,32,35,60
Crusaders,513,2,15,7,8,55,40,15,52
Coleraine,513,3,13,11,6,51,35,16,50
Dungannon,513,4,12,9,9,51,41,10,45
Cliftonville,513,5,14,3,13,47,43,4,45
Ballymena,513,6,11,9,10,51,58,-7,42
Portadown,513,7,12,5,13,30,40,-10,41
Glenavon,513,8,7,13,10,43,50,-7,34
Ards,513,9,10,3,17,35,49,-14,33
Glentoran,513,10,6,11,13,35,48,-13,29
Ballinamalla,513,11,5,6,19,27,56,-29,21
Crusaders,514,1,17,6,7,58,31,27,57
Linfield,514,2,15,9,6,65,34,31,54
Coleraine,514,3,13,11,6,52,40,12,50
Cliftonville,514,4,14,6,10,52,45,7,48
Glenavon,514,5,12,11,7,52,44,8,47
Dungannon,514,6,10,10,10,51,42,9,40
Ballymena,514,7,9,10,11,52,65,-13,37
Glentoran,514,8,9,8,13,31,47,-16,35
Ards,514,9,9,7,14,36,45,-9,34
Portadown,514,10,7,5,18,23,47,-24,26
Ballinamalla,514,11,7,3,20,25,57,-32,24
Crusaders,515,1,16,6,8,55,37,18,54
Ballymena,515,2,15,5,10,62,61,1,50
Linfield,515,3,14,6,10,59,37,22,48
Cliftonville,515,4,15,3,12,57,45,12,48
Glenavon,515,5,13,9,8,50,44,6,48
Coleraine,515,6,12,8,10,46,38,8,44
Dungannon,515,7,9,10,11,50,50,0,37
Portadown,515,8,10,5,15,32,39,-7,35
Ballinamalla,515,9,9,8,13,33,46,-13,35
Glentoran,515,10,8,7,15,32,60,-28,31
Ards,515,11,7,7,16,32,51,-19,28
Crusaders,516,1,16,6,8,53,29,24,54
Cliftonville,516,2,17,3,10,52,38,14,54
Linfield,516,3,14,8,8,58,32,26,50
Coleraine,516,4,12,12,6,46,31,15,48
Dungannon,516,5,12,9,9,50,39,11,45
Ballymena,516,6,11,8,11,53,61,-8,41
Glenavon,516,7,8,12,10,36,43,-7,36
Ballinamalla,516,8,11,3,16,31,46,-15,36
Glentoran,516,9,10,6,14,30,47,-17,36
Ards,516,10,10,4,16,39,50,-11,34
Portadown,516,11,6,5,19,21,53,-32,23
Crusaders,517,1,17,7,6,67,36,31,58
Linfield,517,2,16,8,6,59,33,26,56
Ballymena,517,3,14,8,8,56,55,1,50
Glenavon,517,4,13,10,7,55,45,10,49
Cliftonville,517,5,12,8,10,49,43,6,44
Coleraine,517,6,9,14,7,46,42,4,41
Dungannon,517,7,9,10,11,43,40,3,37
Ards,517,8,8,6,16,38,52,-14,30
Glentoran,517,9,7,8,15,35,55,-20,29
Portadown,517,10,7,8,15,21,44,-23,29
Ballinamalla,517,11,7,5,18,31,55,-24,26
Crusaders,518,1,15,9,6,50,34,16,54
Cliftonville,518,2,16,5,9,55,37,18,53
Linfield,518,3,14,10,6,56,39,17,52
Glenavon,518,4,13,12,5,53,40,13,51
Dungannon,518,5,10,11,9,56,44,12,41
Ballymena,518,6,11,7,12,55,64,-9,40
Glentoran,518,7,9,11,10,35,38,-3,38
Coleraine,518,8,10,8,12,34,40,-6,38
Ballinamalla,518,9,7,8,15,31,49,-18,29
Portadown,518,10,6,9,15,22,42,-20,27
Ards,518,11,6,6,18,30,50,-20,24
Crusaders,519,1,15,10,5,53,35,18,55
Linfield,519,2,16,6,8,53,28,25,54
Dungannon,519,3,15,8,7,60,39,21,53
Cliftonville,519,4,16,5,9,64,44,20,53
Glenavon,519,5,12,12,6,48,38,10,48
Coleraine,519,6,10,10,10,48,48,0,40
Ballymena,519,7,10,8,12,52,63,-11,38
Glentoran,519,8,9,8,13,30,45,-15,35
Ards,519,9,7,7,16,40,53,-13,28
Portadown,519,10,8,4,18,23,46,-23,28
Ballinamalla,519,11,5,6,19,28,60,-32,21
Crusaders,520,1,17,7,6,61,36,25,58
Ballymena,520,2,17,5,8,58,52,6,56
Cliftonville,520,3,16,2,12,51,43,8,50
Linfield,520,4,13,8,9,51,34,17,47
Coleraine,520,5,13,7,10,40,40,0,46
Glenavon,520,6,12,9,9,46,39,7,45
Dungannon,520,7,10,11,9,51,40,11,41
Portadown,520,8,11,3,16,30,43,-13,36
Ballinamalla,520,9,8,4,18,34,50,-16,28
Glentoran,520,10,6,10,14,31,49,-18,28
Ards,520,11,6,6,18,32,59,-27,24
Crusaders,521,1,16,6,8,53,37,16,54
Cliftonville,521,2,16,4,10,57,37,20,52
Coleraine,521,3,13,10,7,46,35,11,49
Ballymena,521,4,13,8,9,58,52,6,47
Linfield,521,5,11,12,7,52,37,15,45
Glenavon,521,6,11,10,9,45,49,-4,43
Glentoran,521,7,10,8,12,34,44,-10,38
Dungannon,521,8,9,9,12,51,45,6,36
Ards,521,9,9,4,17,38,50,-12,31
Portadown,521,10,8,7,15,24,43,-19,31
Ballinamalla,521,11,9,2,19,30,59,-29,29
Cliftonville,522,1,19,3,8,64,39,25,60
Crusaders,522,2,15,8,7,50,41,9,53
Ballymena,522,3,15,5,10,62,60,2,50
Coleraine,522,4,13,8,9,48,37,11,47
Linfield,522,5,12,9,9,53,34,19,45
Glenavon,522,6,12,9,9,47,42,5,45
Dungannon,522,7,10,8,12,48,43,5,38
Glentoran,522,8,10,8,12,36,50,-14,38
Ballinamalla,522,9,10,3,17,33,50,-17,33
Ards,522,10,9,4,17,40,57,-17,31
Portadown,522,11,5,5,20,26,54,-28,20
Crusaders,523,1,18,7,5,62,32,30,61
Ballymena,523,2,15,10,5,54,43,11,55
Linfield,523,3,14,10,6,52,26,26,52
Cliftonville,523,4,13,7,10,50,45,5,46
Glenavon,523,5,12,9,9,48,42,6,45
Coleraine,523,6,11,11,8,43,37,6,44
Dungannon,523,7,9,11,10,46,48,-2,38
Portadown,523,8,10,6,14,33,38,-5,36
Glentoran,523,9,8,8,14,27,50,-23,32
Ards,523,10,5,6,19,30,57,-27,21
Ballinamalla,523,11,5,5,20,21,48,-27,20
Linfield,524,1,15,10,5,61,35,26,55
Coleraine,524,2,15,10,5,44,29,15,55
Crusaders,524,3,14,10,6,50,35,15,52
Cliftonville,524,4,13,9,8,47,33,14,48
Ballymena,524,5,13,6,11,58,60,-2,45
Glenavon,524,6,9,13,8,41,40,1,40
Dungannon,524,7,10,9,11,52,44,8,39
Glentoran,524,8,8,7,15,27,40,-13,31
Ards,524,9,9,4,17,33,50,-17,31
Portadown,524,10,7,8,15,23,42,-19,29
Ballinamalla,524,11,6,6,18,25,53,-28,24
Linfield,525,1,16,8,6,61,31,30,56
Crusaders,525,2,14,9,7,51,33,18,51
Glenavon,525,3,13,10,7,45,40,5,49
Ballymena,525,4,14,6,10,53,60,-7,48
Cliftonville,525,5,13,5,12,56,46,10,44
Ards,525,6,12,5,13,44,51,-7,41
Dungannon,525,7,10,9,11,53,46,7,39
Coleraine,525,8,8,14,8,38,35,3,38
Glentoran,525,9,8,8,14,30,50,-20,32
Portadown,525,10,7,7,16,27,48,-21,28
Ballinamalla,525,11,8,3,19,31,49,-18,27
Crusaders,526,1,15,10,5,57,32,25,55
Glenavon,526,2,14,10,6,51,44,7,52
Cliftonville,526,3,15,6,9,53,41,12,51
Ballymena,526,4,14,7,9,60,53,7,49
Linfield,526,5,10,13,7,53,41,12,43
Coleraine,526,6,11,10,9,37,33,4,43
Glentoran,526,7,10,10,10,33,37,-4,40
Dungannon,526,8,10,7,13,46,45,1,37
Ballinamalla,526,9,7,7,16,27,49,-22,28
Ards,526,10,6,9,15,31,45,-14,27
Portadown,526,11,5,7,18,23,51,-28,22
Crusaders,527,1,16,11,3,57,34,23,59
Linfield,527,2,16,10,4,57,26,31,58
Cliftonville,527,3,16,4,10,55,40,15,52
Ballymena,527,4,14,5,11,62,59,3,47
Glenavon,527,5,12,9,9,47,48,-1,45
Portadown,527,6,11,4,15,34,43,-9,37
Coleraine,527,7,9,9,12,43,48,-5,36
Ballinamalla,527,8,11,2,17,34,53,-19,35
Glentoran,527,9,9,7,14,31,41,-10,34
Dungannon,527,10,6,9,15,44,53,-9,27
Ards,527,11,7,6,17,33,52,-19,27
Crusaders,528,1,21,6,3,65,29,36,69
Ballymena,528,2,15,5,10,58,54,4,50
Coleraine,528,3,13,8,9,45,36,9,47
Cliftonville,528,4,14,5,11,48,46,2,47
Dungannon,528,5,12,7,11,47,40,7,43
Glenavon,528,6,11,8,11,41,44,-3,41
Linfield,528,7,10,9,11,49,41,8,39
Ards,528,8,10,4,16,35,46,-11,34
Ballinamalla,528,9,10,3,17,28,48,-20,33
Glentoran,528,10,8,8,14,33,46,-13,32
Portadown,528,11,6,7,17,25,44,-19,25
Cliftonville,529,1,18,3,9,57,36,21,57
Linfield,529,2,16,6,8,56,28,28,54
Crusaders,529,3,16,4,10,48,38,10,52
Coleraine,529,4,13,11,6,44,35,9,50
Ballymena,529,5,14,6,10,50,55,-5,48
Dungannon,529,6,11,10,9,54,41,13,43
Ards,529,7,11,4,15,40,54,-14,37
Glenavon,529,8,8,12,10,43,47,-4,36
Portadown,529,9,8,6,16,29,42,-13,30
Ballinamalla,529,10,9,3,18,33,55,-22,30
Glentoran,529,11,5,7,18,26,49,-23,22
Cliftonville,530,1,16,5,9,55,40,15,53
Dungannon,530,2,14,9,7,57,38,19,51
Ballymena,530,3,15,6,9,63,57,6,51
Glentoran,530,4,15,5,10,40,35,5,50
Crusaders,530,5,12,9,9,52,41,11,45
Linfield,530,6,12,9,9,49,39,10,45
Glenavon,530,7,11,12,7,45,42,3,45
Coleraine,530,8,9,13,8,39,37,2,40
Ards,530,9,7,5,18,30,50,-20,26
Ballinamalla,530,10,6,6,18,33,57,-24,24
Portadown,530,11,5,7,18,24,51,-27,22
Crusaders,531,1,18,7,5,57,27,30,61
Linfield,531,2,15,10,5,60,30,30,55
Coleraine,531,3,15,9,6,50,33,17,54
Cliftonville,531,4,15,4,11,53,40,13,49
Ballymena,531,5,11,8,11,54,61,-7,41
Glenavon,531,6,10,10,10,47,52,-5,40
Dungannon,531,7,8,11,11,47,49,-2,35
Ards,531,8,10,4,16,42,55,-13,34
Glentoran,531,9,9,6,15,36,51,-15,33
Portadown,531,10,8,6,16,30,47,-17,30
Ballinamalla,531,11,5,7,18,24,55,-31,22
Crusaders,532,1,16,7,7,52,35,17,55
Cliftonville,532,2,16,6,8,51,31,20,54
Ballymena,532,3,15,7,8,65,60,5,52
Glenavon,532,4,13,11,6,46,32,14,50
Linfield,532,5,13,6,11,54,46,8,45
Coleraine,532,6,10,11,9,39,37,2,41
Dungannon,532,7,8,12,10,49,46,3,36
Ballinamalla,532,8,10,5,15,34,47,-13,35
Glentoran,532,9,8,7,15,26,42,-16,31
Ards,532,10,8,5,17,38,55,-17,29
Portadown,532,11,6,7,17,25,48,-23,25
Crusaders,533,1,20,6,4,53,27,26,66
Cliftonville,533,2,16,4,10,51,38,13,52
Linfield,533,3,14,8,8,58,36,22,50
Ballymena,533,4,13,7,10,56,52,4,46
Coleraine,533,5,10,12,8,40,37,3,42
Glenavon,533,6,10,10,10,47,49,-2,40
Portadown,533,7,10,5,15,33,43,-10,35
Dungannon,533,8,8,10,12,48,44,4,34
Glentoran,533,9,8,9,13,27,42,-15,33
Ballinamalla,533,10,9,4,17,25,53,-28,31
Ards,533,11,6,7,17,36,53,-17,25
Cliftonville,534,1,19,3,8,62,40,22,60
Linfield,534,2,16,7,7,70,37,33,55
Crusaders,534,3,16,7,7,49,29,20,55
Coleraine,534,4,14,8,8,42,38,4,50
Dungannon,534,5,10,10,10,45,38,7,40
Ballymena,534,6,11,7,12,53,61,-8,40
Glentoran,534,7,11,6,13,35,45,-10,39
Glenavon,534,8,8,12,10,42,48,-6,36
Portadown,534,9,8,7,15,22,44,-22,31
Ards,534,10,8,5,17,37,50,-13,29
Ballinamalla,534,11,5,6,19,25,52,-27,21
Crusaders,535,1,17,7,6,59,34,25,58
Linfield,535,2,15,8,7,56,32,24,53
Cliftonville,535,3,14,8,8,49,35,14,50
Coleraine,535,4,13,10,7,50,39,11,49
Ballymena,535,5,12,9,9,51,56,-5,45
Glentoran,535,6,12,7,11,41,41,0,43
Dungannon,535,7,11,9,10,53,47,6,42
Glenavon,535,8,11,9,10,48,50,-2,42
Ballinamalla,535,9,8,5,17,29,54,-25,29
Ards,535,10,7,4,19,35,56,-21,25
Portadown,535,11,4,6,20,23,50,-27,18
Crusaders,536,1,20,5,5,60,30,30,65
Cliftonville,536,2,16,7,7,57,34,23,55
Linfield,536,3,13,11,6,60,34,26,50
Ballymena,536,4,15,5,10,58,54,4,50
Coleraine,536,5,10,9,11,36,42,-6,39
Glenavon,536,6,8,13,9,47,51,-4,37
Dungannon,536,7,9,9,12,47,48,-1,36
Ballinamalla,536,8,10,3,17,35,57,-22,33
Ards,536,9,9,5,16,39,53,-14,32
Glentoran,536,10,8,6,16,30,48,-18,30
Portadown,536,11,9,3,18,21,39,-18,30
Cliftonville,537,1,16,6,8,55,39,16,54
Crusaders,537,2,15,7,8,53,36,17,52
Linfield,537,3,13,10,7,53,30,23,49
Glenavon,537,4,11,11,8,48,46,2,44
Coleraine,537,5,10,12,8,46,46,0,42
Ballymena,537,6,12,5,13,51,57,-6,41
Dungannon,537,7,11,7,12,47,46,1,40
Ballinamalla,537,8,10,6,14,36,45,-9,36
Ards,537,9,9,7,14,40,48,-8,34
Portadown,537,10,9,4,17,26,44,-18,31
Glentoran,537,11,6,11,13,28,46,-18,29
Crusaders,538,1,18,6,6,63,34,29,60
Cliftonville,538,2,18,3,9,57,36,21,57
Linfield,538,3,15,8,7,62,33,29,53
Coleraine,538,4,12,8,10,38,40,-2,44
Ballymena,538,5,12,6,12,56,60,-4,42
Glenavon,538,6,10,11,9,45,44,1,41
Ballinamalla,538,7,10,6,14,31,43,-12,36
Glentoran,538,8,10,6,14,35,49,-14,36
Dungannon,538,9,7,11,12,42,47,-5,32
Ards,538,10,7,8,15,37,51,-14,29
Portadown,538,11,7,5,18,21,50,-29,26
Linfield,539,1,16,9,5,66,33,33,57
Cliftonville,539,2,16,5,9,47,29,18,53
Ballymena,539,3,16,5,9,61,54,7,53
Crusaders,539,4,14,8,8,48,36,12,50
Coleraine,539,5,13,10,7,43,36,7,49
Glenavon,539,6,10,12,8,44,43,1,42
Ards,539,7,9,6,15,38,47,-9,33
Dungannon,539,8,7,10,13,54,57,-3,31
Portadown,539,9,8,6,16,29,48,-19,30
Ballinamalla,539,10,7,6,17,35,62,-27,27
Glentoran,539,11,5,11,14,25,45,-20,26
Crusaders,540,1,18,5,7,57,30,27,59
Linfield,540,2,15,10,5,51,23,28,55
Cliftonville,540,3,14,7,9,49,36,13,49
Glenavon,540,4,12,11,7,47,40,7,47
Coleraine,540,5,11,13,6,40,35,5,46
Dungannon,540,6,12,8,10,54,45,9,44
Ballymena,540,7,13,5,12,55,56,-1,44
Ards,540,8,13,3,14,40,40,0,42
Glentoran,540,9,7,7,16,27,51,-24,28
Portadown,540,10,6,4,20,23,51,-28,22
Ballinamalla,540,11,6,3,21,25,61,-36,21
Crusaders,541,1,18,6,6,57,32,25,60
Dungannon,541,2,15,8,7,63,38,25,53
Linfield,541,3,14,10,6,60,38,22,52
Cliftonville,541,4,14,3,13,50,45,5,45
Ballymena,541,5,13,5,12,54,60,-6,44
Glenavon,541,6,9,13,8,50,47,3,40
Ards,541,7,11,4,15,36,44,-8,37
Glentoran,541,8,8,9,13,32,50,-18,33
Coleraine,541,9,8,8,14,33,44,-11,32
Portadown,541,10,7,9,14,32,50,-18,30
Ballinamalla,541,11,8,5,17,36,55,-19,29
Linfield,542,1,17,10,3,64,24,40,61
Crusaders,542,2,17,6,7,55,39,16,57
Cliftonville,542,3,17,2,11,58,42,16,53
Ballymena,542,4,14,6,10,51,53,-2,48
Coleraine,542,5,12,8,10,50,50,0,44
Glenavon,542,6,10,12,8,55,49,6,42
Portadown,542,7,10,4,16,29,41,-12,34
Dungannon,542,8,6,13,11,45,46,-1,31
Ballinamalla,542,9,9,4,17,29,53,-24,31
Glentoran,542,10,7,9,14,30,49,-19,30
Ards,542,11,8,2,20,35,55,-20,26
Crusaders,543,1,17,8,5,54,33,21,59
Linfield,543,2,15,9,6,61,29,32,54
Cliftonville,543,3,15,4,11,53,46,7,49
Ballymena,543,4,13,5,12,58,61,-3,44
Coleraine,543,5,10,12,8,37,34,3,42
Dungannon,543,6,9,11,10,50,47,3,38
Glenavon,543,7,9,11,10,44,45,-1,38
Ballinamalla,543,8,10,7,13,34,40,-6,37
Ards,543,9,9,5,16,34,56,-22,32
Portadown,543,10,9,4,17,27,46,-19,31
Glentoran,543,11,5,12,13,25,40,-15,27
Cliftonville,544,1,19,2,9,59,34,25,59
Glenavon,544,2,14,10,6,51,35,16,52
Crusaders,544,3,15,6,9,52,38,14,51
Coleraine,544,4,12,10,8,46,44,2,46
Ballymena,544,5,14,4,12,55,59,-4,46
Linfield,544,6,12,8,10,60,41,19,44
Glentoran,544,7,12,6,12,39,55,-16,42
Dungannon,544,8,9,10,11,50,44,6,37
Ards,544,9,8,6,16,33,45,-12,30
Ballinamalla,544,10,8,3,19,29,54,-25,27
Portadown,544,11,7,5,18,26,51,-25,26
Cliftonville,545,1,16,5,9,51,37,14,53
Ballymena,545,2,15,7,8,58,50,8,52
Crusaders,545,3,13,8,9,50,38,12,47
Ards,545,4,13,4,13,44,42,2,43
Linfield,545,5,10,11,9,52,38,14,41
Dungannon,545,6,11,8,11,51,43,8,41
Coleraine,545,7,8,13,9,37,39,-2,37
Glenavon,545,8,9,10,11,38,49,-11,37
Portadown,545,9,10,6,14,33,45,-12,36
Glentoran,545,10,9,7,14,31,42,-11,34
Ballinamalla,545,11,8,7,15,30,52,-22,31
Crusaders,546,1,17,5,8,51,33,18,56
Linfield,546,2,14,11,5,60,28,32,53
Glenavon,546,3,11,14,5,44,35,9,47
Dungannon,546,4,12,8,10,53,43,10,44
Coleraine,546,5,10,12,8,42,38,4,42
Cliftonville,546,6,12,6,12,48,49,-1,42
Ards,546,7,12,2,16,37,48,-11,38
Ballymena,546,8,10,7,13,57,64,-7,37
Portadown,546,9,10,7,13,30,42,-12,37
Glentoran,546,10,9,7,14,35,45,-10,34
Ballinamalla,546,11,7,3,20,26,58,-32,24
Crusaders,547,1,16,8,6,53,29,24,56
Linfield,547,2,13,11,6,61,37,24,50
Dungannon,547,3,13,9,8,54,39,15,48
Cliftonville,547,4,14,6,10,51,37,14,48
Ballymena,547,5,14,5,11,61,64,-3,47
Glenavon,547,6,10,12,8,44,41,3,42
Coleraine,547,7,9,12,9,37,38,-1,39
Ards,547,8,11,6,13,45,49,-4,39
Ballinamalla,547,9,9,4,17,24,47,-23,31
Portadown,547,10,7,6,17,22,48,-26,27
Glentoran,547,11,5,9,16,32,55,-23,24
Linfield,548,1,17,8,5,59,24,35,59
Crusaders,548,2,15,9,6,57,38,19,54
Ballymena,548,3,16,5,9,62,57,5,53
Cliftonville,548,4,14,6,10,52,37,15,48
Coleraine,548,5,11,9,10,42,40,2,42
Dungannon,548,6,10,11,9,47,44,3,41
Glenavon,548,7,9,11,10,42,47,-5,38
Glentoran,548,8,8,10,12,30,43,-13,34
Ards,548,9,8,6,16,35,47,-12,30
Portadown,548,10,7,6,17,21,43,-22,27
Ballinamalla,548,11,7,5,18,28,55,-27,26
Coleraine,549,1,15,9,6,50,35,15,54
Crusaders,549,2,15,7,8,56,33,23,52
Glenavon,549,3,13,11,6,51,41,10,50
Linfield,549,4,12,13,5,58,35,23,49
Cliftonville,549,5,14,7,9,52,38,14,49
Ballymena,549,6,12,8,10,53,54,-1,44
Dungannon,549,7,8,10,12,41,48,-7,34
Ballinamalla,549,8,9,7,14,34,46,-12,34
Portadown,549,9,9,6,15,29,45,-16,33
Glentoran,549,10,6,12,12,28,47,-19,30
Ards,549,11,5,4,21,25,55,-30,19
Linfield,550,1,18,7,5,61,26,35,61
Cliftonville,550,2,16,4,10,55,35,20,52
Glenavon,550,3,14,10,6,51,37,14,52
Crusaders,550,4,15,6,9,55,40,15,51
Coleraine,550,5,11,10,9,47,43,4,43
Ballymena,550,6,13,4,13,53,63,-10,43
Dungannon,550,7,11,7,12,47,42,5,40
Ards,550,8,10,6,14,40,50,-10,36
Ballinamalla,550,9,10,3,17,30,45,-15,33
Glentoran,550,10,9,5,16,27,44,-17,32
Portadown,550,11,5,4,21,23,64,-41,19
Linfield,551,1,15,8,7,59,32,27,53
Crusaders,551,2,15,8,7,55,36,19,53
Ballymena,551,3,14,6,10,56,57,-1,48
Cliftonville,551,4,14,5,11,51,41,10,47
Glenavon,551,5,11,9,10,49,48,1,42
Dungannon,551,6,11,8,11,45,40,5,41
Ards,551,7,12,4,14,35,41,-6,40
Glentoran,551,8,10,10,10,28,36,-8,40
Coleraine,551,9,8,11,11,36,38,-2,35
Ballinamalla,551,10,10,4,16,28,48,-20,34
Portadown,551,11,5,7,18,19,44,-25,22
Linfield,552,1,14,8,8,53,32,21,50
Crusaders,552,2,14,8,8,49,37,12,50
Glenavon,552,3,13,10,7,51,36,15,49
Cliftonville,552,4,14,6,10,53,41,12,48
Dungannon,552,5,13,7,10,47,38,9,46
Ballymena,552,6,12,7,11,52,52,0,43
Glentoran,552,7,12,7,11,28,39,-11,43
Coleraine,552,8,9,11,10,36,47,-11,38
Ards,552,9,10,5,15,43,48,-5,35
Portadown,552,10,6,8,16,27,47,-20,26
Ballinamalla,552,11,6,7,17,30,52,-22,25
Linfield,553,1,16,7,7,67,31,36,55
Crusaders,553,2,16,6,8,53,38,15,54
Glenavon,553,3,13,11,6,53,42,11,50
Coleraine,553,4,13,10,7,41,34,7,49
Dungannon,553,5,12,10,8,60,41,19,46
Cliftonville,553,6,13,6,11,52,50,2,45
Ballymena,553,7,12,8,10,52,59,-7,44
Glentoran,553,8,10,6,14,34,46,-12,36
Ards,553,9,10,3,17,33,48,-15,33
Portadown,553,10,5,8,17,20,45,-25,23
Ballinamalla,553,11,5,5,20,22,53,-31,20
Crusaders,554,1,16,8,6,55,30,25,56
Cliftonville,554,2,16,8,6,60,39,21,56
Linfield,554,3,15,9,6,55,28,27,54
Ballymena,554,4,15,6,9,61,60,1,51
Glenavon,554,5,12,9,9,50,50,0,45
Dungannon,554,6,10,10,10,54,44,10,40
Coleraine,554,7,8,11,11,39,43,-4,35
Ards,554,8,7,10,13,32,44,-12,31
Glentoran,554,9,8,7,15,30,52,-22,31
Ballinamalla,554,10,7,6,17,29,51,-22,27
Portadown,554,11,6,6,18,19,43,-24,24
Crusaders,555,1,14,8,8,50,37,13,50
Cliftonville,555,2,14,6,10,55,47,8,48
Coleraine,555,3,13,9,8,41,37,4,48
Ballymena,555,4,14,6,10,63,61,2,48
Linfield,555,5,13,7,10,59,40,19,46
Dungannon,555,6,10,10,10,50,46,4,40
Glentoran,555,7,10,9,11,34,39,-5,39
Glenavon,555,8,9,10,11,52,57,-5,37
Ards,555,9,8,8,14,40,47,-7,32
Ballinamalla,555,10,8,8,14,35,49,-14,32
Portadown,555,11,8,7,15,27,46,-19,31
Crusaders,556,1,18,6,6,69,41,28,60
Cliftonville,556,2,14,7,9,51,38,13,49
Ballymena,556,3,13,9,8,61,55,6,48
Linfield,556,4,12,9,9,55,37,18,45
Dungannon,556,5,11,10,9,50,37,13,43
Glentoran,556,6,11,9,10,38,41,-3,42
Coleraine,556,7,9,11,10,41,45,-4,38
Glenavon,556,8,7,16,7,47,49,-2,37
Ards,556,9,8,6,16,37,54,-17,30
Portadown,556,10,7,8,15,20,44,-24,29
Ballinamalla,556,11,6,7,17,31,59,-28,25
Linfield,557,1,16,9,5,65,33,32,57
Crusaders,557,2,14,7,9,51,35,16,49
Cliftonville,557,3,14,6,10,53,42,11,48
Glenavon,557,4,12,12,6,46,41,5,48
Coleraine,557,5,13,9,8,48,44,4,48
Ards,557,6,14,3,13,48,47,1,45
Ballymena,557,7,12,7,11,55,58,-3,43
Glentoran,557,8,10,8,12,39,47,-8,38
Dungannon,557,9,9,9,12,57,50,7,36
Portadown,557,10,7,4,19,26,53,-27,25
Ballinamalla,557,11,6,2,22,26,64,-38,20
Linfield,558,1,16,8,6,58,33,25,56
Ballymena,558,2,17,4,9,63,53,10,55
Crusaders,558,3,13,11,6,54,34,20,50
Cliftonville,558,4,15,5,10,52,42,10,50
Glenavon,558,5,12,10,8,48,39,9,46
Coleraine,558,6,10,11,9,41,37,4,41
Dungannon,558,7,10,8,12,51,50,1,38
Glentoran,558,8,10,8,12,29,40,-11,38
Portadown,558,9,8,6,16,25,45,-20,30
Ards,558,10,7,5,18,36,55,-19,26
Ballinamalla,558,11,7,4,19,30,59,-29,25
Crusaders,559,1,17,6,7,60,33,27,57
Linfield,559,2,15,9,6,57,33,24,54
Cliftonville,559,3,14,5,11,53,46,7,47
Dungannon,559,4,12,10,8,52,40,12,46
Ballymena,559,5,13,7,10,57,54,3,46
Glentoran,559,6,10,8,12,29,41,-12,38
Coleraine,559,7,9,10,11,38,42,-4,37
Glenavon,559,8,9,10,11,37,42,-5,37
Ards,559,9,9,6,15,40,52,-12,33
Ballinamalla,559,10,8,7,15,28,48,-20,31
Portadown,559,11,6,8,16,24,44,-20,26
Crusaders,560,1,19,8,3,58,28,30,65
Cliftonville,560,2,18,2,10,60,39,21,56
Linfield,560,3,15,8,7,62,34,28,53
Glenavon,560,4,11,11,8,54,44,10,44
Coleraine,560,5,11,9,10,43,40,3,42
Ballymena,560,6,12,6,12,51,65,-14,42
Ards,560,7,11,4,15,39,46,-7,37
Glentoran,560,8,10,7,13,30,43,-13,37
Dungannon,560,9,7,9,14,44,50,-6,30
Portadown,560,10,8,4,18,30,59,-29,28
Ballinamalla,560,11,7,4,19,27,50,-23,25
Ballymena,561,1,18,4,8,54,47,7,58
Cliftonville,561,2,15,7,8,50,36,14,52
Glenavon,561,3,12,13,5,46,38,8,49
Dungannon,561,4,12,9,9,54,36,18,45
Linfield,561,5,11,11,8,50,31,19,44
Coleraine,561,6,10,11,9,37,37,0,41
Glentoran,561,7,11,7,12,35,40,-5,40
Crusaders,561,8,10,7,13,42,45,-3,37
Ards,561,9,9,6,15,30,40,-10,33
Ballinamalla,561,10,9,4,17,34,57,-23,31
Portadown,561,11,5,7,18,18,43,-25,22
Cliftonville,562,1,16,8,6,56,33,23,56
Linfield,562,2,14,8,8,60,33,27,50
Crusaders,562,3,12,12,6,54,39,15,48
Ballymena,562,4,13,7,10,57,57,0,46
Coleraine,562,5,11,12,7,43,39,4,45
Glenavon,562,6,11,12,7,45,43,2,45
Ards,562,7,11,7,12,44,45,-1,40
Dungannon,562,8,10,8,12,49,46,3,38
Portadown,562,9,9,4,17,24,44,-20,31
Glentoran,562,10,6,9,15,32,55,-23,27
Ballinamalla,562,11,6,5,19,31,61,-30,23
Linfield,563,1,18,6,6,63,31,32,60
Crusaders,563,2,18,4,8,60,40,20,58
Cliftonville,563,3,15,3,12,63,45,18,48
Coleraine,563,4,13,8,9,46,43,3,47
Ballymena,563,5,13,8,9,62,64,-2,47
Dungannon,563,6,13,6,11,50,45,5,45
Glenavon,563,7,11,9,10,44,45,-1,42
Glentoran,563,8,9,6,15,36,48,-12,33
Ballinamalla,563,9,10,2,18,33,49,-16,32
Ards,563,10,8,3,19,37,56,-19,27
Portadown,563,11,8,3,19,23,51,-28,27
Linfield,564,1,15,9,6,71,38,33,54
Crusaders,564,2,14,7,9,48,41,7,49
Glenavon,564,3,12,12,6,45,33,12,48
Ballymena,564,4,13,9,8,55,53,2,48
Cliftonville,564,5,14,4,12,45,41,4,46
Coleraine,564,6,9,12,9,36,37,-1,39
Dungannon,564,7,9,10,11,50,45,5,37
Glentoran,564,8,9,10,11,29,36,-7,37
Ards,564,9,8,9,13,37,51,-14,33
Ballinamalla,564,10,9,3,18,25,48,-23,30
Portadown,564,11,7,7,16,28,46,-18,28
Linfield,565,1,19,7,4,70,26,44,64
Crusaders,565,2,18,7,5,60,33,27,61
Cliftonville,565,3,14,5,11,49,44,5,47
Ballymena,565,4,14,5,11,54,61,-7,47
Coleraine,565,5,11,10,9,45,39,6,43
Ards,565,6,12,5,13,38,45,-7,41
Glenavon,565,7,10,10,10,45,42,3,40
Dungannon,565,8,10,8,12,43,44,-1,38
Portadown,565,9,8,7,15,24,39,-15,31
Ballinamalla,565,10,7,3,20,30,57,-27,24
Glentoran,565,11,4,9,17,24,52,-28,21
Crusaders,566,1,18,4,8,54,33,21,58
Coleraine,566,2,15,10,5,44,31,13,55
Linfield,566,3,15,7,8,61,35,26,52
Cliftonville,566,4,15,4,11,53,41,12,49
Ballymena,566,5,14,4,12,58,64,-6,46
Dungannon,566,6,12,7,11,55,44,11,43
Glenavon,566,7,11,10,9,50,46,4,43
Ards,566,8,10,4,16,40,52,-12,34
Glentoran,566,9,8,8,14,34,49,-15,32
Ballinamalla,566,10,7,5,18,29,53,-24,26
Portadown,566,11,6,5,19,24,54,-30,23
Cliftonville,567,1,17,6,7,61,33,28,57
Linfield,567,2,13,9,8,56,37,19,48
Ballymena,567,3,14,6,10,56,62,-6,48
Crusaders,567,4,13,6,11,52,49,3,45
Dungannon,567,5,11,10,9,49,44,5,43
Glenavon,567,6,11,10,9,49,47,2,43
Coleraine,567,7,8,14,8,38,35,3,38
Ards,567,8,10,6,14,43,49,-6,36
Ballinamalla,567,9,10,4,16,40,55,-15,34
Glentoran,567,10,7,11,12,28,42,-14,32
Portadown,567,11,8,4,18,29,48,-19,28
Ballymena,568,1,16,6,8,62,56,6,54
Crusaders,568,2,15,8,7,56,37,19,53
Linfield,568,3,15,7,8,66,39,27,52
Cliftonville,568,4,13,7,10,51,40,11,46
Coleraine,568,5,11,9,10,44,45,-1,42
Ards,568,6,12,4,14,44,46,-2,40
Glenavon,568,7,9,11,10,49,51,-2,38
Dungannon,568,8,9,10,11,47,45,2,37
Glentoran,568,9,10,6,14,33,51,-18,36
Portadown,568,10,7,8,15,24,41,-17,29
Ballinamalla,568,11,7,6,17,25,50,-25,27
Linfield,569,1,17,9,4,59,23,36,60
Crusaders,569,2,14,9,7,51,36,15,51
Cliftonville,569,3,15,5,10,52,38,14,50
Ballymena,569,4,13,7,10,55,61,-6,46
Dungannon,569,5,11,10,9,54,44,10,43
Glenavon,569,6,10,11,9,42,39,3,41
Coleraine,569,7,10,11,9,36,34,2,41
Ards,569,8,11,3,16,41,52,-11,36
Portadown,569,9,9,7,14,26,44,-18,34
Glentoran,569,10,8,7,15,31,43,-12,31
Ballinamalla,569,11,5,5,20,19,52,-33,20
Ballymena,570,1,17,5,8,66,55,11,56
Glenavon,570,2,13,12,5,47,37,10,51
Cliftonville,570,3,15,5,10,51,36,15,50
Coleraine,570,4,13,11,6,44,34,10,50
Crusaders,570,5,13,7,10,54,49,5,46
Linfield,570,6,12,8,10,54,44,10,44
Glentoran,570,7,13,5,12,40,42,-2,44
Dungannon,570,8,11,9,10,52,44,8,42
Ards,570,9,8,6,16,33,46,-13,30
Portadown,570,10,6,6,18,27,49,-22,24
Ballinamalla,570,11,5,4,21,26,58,-32,19
Crusaders,571,1,16,8,6,49,32,17,56
Cliftonville,571,2,17,2,11,50,36,14,53
Linfield,571,3,13,9,8,58,37,21,48
Ballymena,571,4,14,6,10,63,59,4,48
Coleraine,571,5,12,11,7,42,33,9,47
Dungannon,571,6,10,10,10,49,41,8,40
Glenavon,571,7,9,11,10,41,46,-5,38
Glentoran,571,8,9,9,12,34,42,-8,36
Ards,571,9,11,3,16,40,49,-9,36
Portadown,571,10,9,2,19,28,54,-26,29
Ballinamalla,571,11,7,5,18,31,56,-25,26
Crusaders,572,1,17,8,5,57,34,23,59
Ballymena,572,2,15,6,9,57,52,5,51
Cliftonville,572,3,14,5,11,50,33,17,47
Dungannon,572,4,13,8,9,54,44,10,47
Glenavon,572,5,11,13,6,35,34,1,46
Linfield,572,6,12,8,10,55,40,15,44
Coleraine,572,7,11,9,10,35,36,-1,42
Glentoran,572,8,9,10,11,37,39,-2,37
Ards,572,9,11,3,16,37,48,-11,36
Ballinamalla,572,10,5,7,18,28,56,-28,22
Portadown,572,11,5,7,18,24,53,-29,22
Crusaders,573,1,18,8,4,61,33,28,62
Cliftonville,573,2,15,4,11,53,44,9,49
Linfield,573,3,13,9,8,59,37,22,48
Coleraine,573,4,12,9,9,45,42,3,45
Ballymena,573,5,12,7,11,54,59,-5,43
Dungannon,573,6,11,9,10,53,46,7,42
Ards,573,7,10,7,13,41,46,-5,37
Glenavon,573,8,9,10,11,42,48,-6,37
Ballinamalla,573,9,9,6,15,30,45,-15,33
Glentoran,573,10,8,6,16,30,49,-19,30
Portadown,573,11,8,5,17,28,47,-19,29
Crusaders,574,1,18,9,3,62,34,28,63
Cliftonville,574,2,18,3,9,61,40,21,57
Linfield,574,3,15,8,7,54,31,23,53
Ballymena,574,4,15,6,9,53,50,3,51
Coleraine,574,5,10,14,6,44,40,4,44
Ards,574,6,13,3,14,49,43,6,42
Glenavon,574,7,8,12,10,46,50,-4,36
Glentoran,574,8,8,7,15,28,48,-20,31
Dungannon,574,9,6,11,13,41,46,-5,29
Portadown,574,10,7,4,19,21,47,-26,25
Ballinamalla,574,11,6,5,19,30,60,-30,23
Crusaders,575,1,17,8,5,57,32,25,59
Linfield,575,2,13,11,6,69,37,32,50
Cliftonville,575,3,14,4,12,51,40,11,46
Ballymena,575,4,13,7,10,59,59,0,46
Glentoran,575,5,12,7,11,35,48,-13,43
Coleraine,575,6,11,9,10,38,41,-3,42
Dungannon,575,7,10,11,9,50,42,8,41
Ards,575,8,12,4,14,43,52,-9,40
Glenavon,575,9,9,9,12,42,48,-6,36
Portadown,575,10,8,5,17,27,46,-19,29
Ballinamalla,575,11,7,3,20,27,53,-26,24
Linfield,576,1,16,8,6,62,30,32,56
Crusaders,576,2,15,7,8,59,39,20,52
Cliftonville,576,3,15,4,11,58,49,9,49
Coleraine,576,4,12,11,7,45,44,1,47
Ballymena,576,5,12,8,10,51,56,-5,44
Glentoran,576,6,12,6,12,36,45,-9,42
Dungannon,576,7,11,7,12,55,45,10,40
Glenavon,576,8,9,13,8,54,53,1,40
Portadown,576,9,8,8,14,35,51,-16,32
Ballinamalla,576,10,6,7,17,28,49,-21,25
Ards,576,11,6,7,17,32,54,-22,25
Linfield,577,1,15,9,6,57,30,27,54
Crusaders,577,2,15,8,7,54,32,22,53
Cliftonville,577,3,15,4,11,54,40,14,49
Glenavon,577,4,13,10,7,60,47,13,49
Coleraine,577,5,13,9,8,46,41,5,48
Ballymena,577,6,14,5,11,53,57,-4,47
Glentoran,577,7,9,7,14,29,46,-17,34
Dungannon,577,8,7,11,12,45,47,-2,32
Ballinamalla,577,9,9,5,16,24,41,-17,32
Ards,577,10,8,7,15,31,44,-13,31
Portadown,577,11,7,5,18,25,53,-28,26
Crusaders,578,1,19,6,5,59,38,21,63
Cliftonville,578,2,17,4,9,58,40,18,55
Coleraine,578,3,12,12,6,42,30,12,48
Linfield,578,4,11,14,5,52,27,25,47
Dungannon,578,5,10,9,11,48,47,1,39
Ballymena,578,6,10,8,12,50,63,-13,38
Ards,578,7,10,6,14,40,51,-11,36
Glenavon,578,8,8,11,11,49,51,-2,35
Glentoran,578,9,7,9,14,32,48,-16,30
Portadown,578,10,8,6,16,26,45,-19,30
Ballinamalla,578,11,8,5,17,38,54,-16,29
Crusaders,579,1,18,7,5,61,33,28,61
Linfield,579,2,15,10,5,59,32,27,55
Ballymena,579,3,16,6,8,59,55,4,54
Cliftonville,579,4,15,5,10,48,36,12,50
Glenavon,579,5,12,11,7,41,33,8,47
Coleraine,579,6,10,10,10,35,34,1,40
Ards,579,7,10,5,15,38,47,-9,35
Glentoran,579,8,8,11,11,31,43,-12,35
Dungannon,579,9,7,9,14,42,46,-4,30
Ballinamalla,579,10,8,4,18,30,53,-23,28
Portadown,579,11,5,4,21,18,50,-32,19
Crusaders,580,1,16,10,4,54,33,21,58
Glenavon,580,2,13,11,6,52,37,15,50
Cliftonville,580,3,14,7,9,50,34,16,49
Linfield,580,4,13,8,9,49,31,18,47
Ballymena,580,5,12,8,10,49,52,-3,44
Dungannon,580,6,12,7,11,54,39,15,43
Coleraine,580,7,9,11,10,42,43,-1,38
Portadown,580,8,10,4,16,32,49,-17,34
Glentoran,580,9,8,9,13,27,48,-21,33
Ards,580,10,8,5,17,36,54,-18,29
Ballinamalla,580,11,7,6,17,31,56,-25,27
Linfield,581,1,15,10,5,61,36,25,55
Cliftonville,581,2,16,7,7,55,37,18,55
Crusaders,581,3,14,7,9,53,42,11,49
Glenavon,581,4,13,10,7,49,42,7,49
Ballymena,581,5,13,6,11,59,61,-2,45
Coleraine,581,6,10,12,8,42,40,2,42
Dungannon,581,7,9,9,12,46,42,4,36
Glentoran,581,8,9,6,15,35,49,-14,33
Portadown,581,9,9,6,15,30,47,-17,33
Ards,581,10,7,8,15,38,50,-12,29
Ballinamalla,581,11,7,5,18,31,53,-22,26
Crusaders,582,1,18,6,6,64,37,27,60
Linfield,582,2,14,11,5,61,28,33,53
Cliftonville,582,3,16,4,10,59,46,13,52
Dungannon,582,4,11,10,9,55,40,15,43
Ballymena,582,5,11,10,9,52,57,-5,43
Coleraine,582,6,10,12,8,40,41,-1,42
Glenavon,582,7,10,11,9,47,49,-2,41
Ards,582,8,9,6,15,38,51,-13,33
Glentoran,582,9,7,9,14,26,48,-22,30
Portadown,582,10,7,6,17,23,47,-24,27
Ballinamalla,582,11,7,5,18,35,56,-21,26
Crusaders,583,1,15,8,7,45,30,15,53
Cliftonville,583,2,16,4,10,51,34,17,52
Coleraine,583,3,14,9,7,43,33,10,51
Linfield,583,4,14,8,8,62,39,23,50
Glenavon,583,5,12,9,9,45,39,6,45
Ballymena,583,6,13,6,11,66,67,-1,45
Dungannon,583,7,10,9,11,48,44,4,39
Glentoran,583,8,9,8,13,37,40,-3,35
Ards,583,9,10,4,16,38,51,-13,34
Portadown,583,10,9,3,18,25,51,-26,30
Ballinamalla,583,11,6,6,18,25,57,-32,24
Crusaders,584,1,19,7,4,59,26,33,64
Linfield,584,2,16,8,6,66,35,31,56
Cliftonville,584,3,15,6,9,51,36,15,51
Coleraine,584,4,14,9,7,44,34,10,51
Ballymena,584,5,13,5,12,57,61,-4,44
Dungannon,584,6,10,10,10,50,43,7,40
Glenavon,584,7,7,12,11,36,45,-9,33
Glentoran,584,8,9,6,15,29,43,-14,33
Ballinamalla,584,9,10,3,17,32,52,-20,33
Ards,584,10,8,3,19,36,60,-24,27
Portadown,584,11,7,5,18,26,51,-25,26
Crusaders,585,1,19,5,6,55,31,24,62
Cliftonville,585,2,15,5,10,56,42,14,50
Linfield,585,3,13,9,8,53,30,23,48
Ballymena,585,4,13,6,11,54,61,-7,45
Glenavon,585,5,11,10,9,53,48,5,43
Coleraine,585,6,11,10,9,37,37,0,43
Dungannon,585,7,11,7,12,53,45,8,40
Ards,585,8,9,9,12,31,40,-9,36
Glentoran,585,9,8,11,11,27,36,-9,35
Ballinamalla,585,10,8,6,16,30,49,-19,30
Portadown,585,11,6,4,20,26,56,-30,22
Crusaders,586,1,18,8,4,61,33,28,62
Cliftonville,586,2,16,5,9,53,39,14,53
Linfield,586,3,14,10,6,52,32,20,52
Ballymena,586,4,15,6,9,64,55,9,51
Dungannon,586,5,11,9,10,48,37,11,42
Glenavon,586,6,11,9,10,46,52,-6,42
Ballinamalla,586,7,11,5,14,37,47,-10,38
Coleraine,586,8,9,9,12,40,43,-3,36
Glentoran,586,9,9,7,14,30,42,-12,34
Ards,586,10,7,5,18,33,56,-23,26
Portadown,586,11,5,5,20,19,47,-28,20
Crusaders,587,1,18,8,4,57,34,23,62
Linfield,587,2,16,8,6,64,32,32,56
Glenavon,587,3,12,12,6,56,43,13,48
Cliftonville,587,4,14,4,12,54,50,4,46
Ballymena,587,5,13,6,11,58,61,-3,45
Coleraine,587,6,11,9,10,41,42,-1,42
Glentoran,587,7,9,10,11,26,42,-16,37
Dungannon,587,8,9,9,12,53,49,4,36
Ards,587,9,8,7,15,34,44,-10,31
Portadown,587,10,7,5,18,23,45,-22,26
Ballinamalla,587,11,7,4,19,30,54,-24,25
Cliftonville,588,1,17,6,7,52,34,18,57
Crusaders,588,2,16,7,7,49,28,21,55
Linfield,588,3,13,9,8,63,29,34,48
Ballymena,588,4,12,9,9,57,57,0,45
Glenavon,588,5,10,12,8,45,48,-3,42
Coleraine,588,6,8,11,11,32,40,-8,35
Portadown,588,7,9,8,13,33,44,-11,35
Ards,588,8,9,7,14,36,46,-10,34
Ballinamalla,588,9,8,8,14,34,54,-20,32
Dungannon,588,10,7,10,13,44,50,-6,31
Glentoran,588,11,6,13,11,30,45,-15,31
Crusaders,589,1,18,6,6,57,29,28,60
Cliftonville,589,2,16,6,8,51,36,15,54
Ballymena,589,3,16,5,9,66,63,3,53
Linfield,589,4,13,11,6,61,38,23,50
Glenavon,589,5,13,9,8,49,42,7,48
Coleraine,589,6,10,13,7,44,39,5,43
Dungannon,589,7,9,9,12,52,55,-3,36
Ards,589,8,8,7,15,38,50,-12,31
Portadown,589,9,6,9,15,26,45,-19,27
Glentoran,589,10,6,8,16,23,45,-22,26
Ballinamalla,589,11,6,5,19,28,53,-25,23
Crusaders,590,1,17,9,4,58,33,25,60
Linfield,590,2,17,8,5,61,27,34,59
Cliftonville,590,3,16,5,9,61,39,22,53
Glenavon,590,4,14,9,7,48,37,11,51
Coleraine,590,5,12,8,10,39,43,-4,44
Ballymena,590,6,11,6,13,54,69,-15,39
Dungannon,590,7,9,11,10,51,46,5,38
Ballinamalla,590,8,8,7,15,31,49,-18,31
Glentoran,590,9,7,8,15,26,47,-21,29
Ards,590,10,7,6,17,38,51,-13,27
Portadown,590,11,6,5,19,20,46,-26,23
Crusaders,591,1,19,7,4,65,36,29,64
Cliftonville,591,2,15,4,11,55,42,13,49
Linfield,591,3,12,11,7,52,33,19,47
Dungannon,591,4,12,10,8,51,40,11,46
Glenavon,591,5,11,13,6,49,39,10,46
Ballymena,591,6,12,7,11,48,61,-13,43
Coleraine,591,7,10,11,9,37,36,1,41
Ards,591,8,12,3,15,40,48,-8,39
Glentoran,591,9,8,6,16,26,41,-15,30
Ballinamalla,591,10,7,6,17,32,53,-21,27
Portadown,591,11,6,4,20,22,48,-26,22
Cliftonville,592,1,15,7,8,48,37,11,52
Crusaders,592,2,13,10,7,46,30,16,49
Linfield,592,3,12,12,6,58,35,23,48
Glenavon,592,4,12,10,8,55,45,10,46
Ballymena,592,5,13,6,11,60,63,-3,45
Coleraine,592,6,11,10,9,43,37,6,43
Glentoran,592,7,11,5,14,28,47,-19,38
Portadown,592,8,11,3,16,34,49,-15,36
Dungannon,592,9,8,10,12,47,42,5,34
Ards,592,10,9,5,16,36,54,-18,32
Ballinamalla,592,11,9,4,17,33,49,-16,31
Ballymena,593,1,16,7,7,65,57,8,55
Linfield,593,2,14,9,7,63,37,26,51
Glenavon,593,3,13,11,6,59,43,16,50
Cliftonville,593,4,15,4,11,54,43,11,49
Crusaders,593,5,14,7,9,52,42,10,49
Coleraine,593,6,13,10,7,46,38,8,49
Dungannon,593,7,10,7,13,47,48,-1,37
Ards,593,8,8,6,16,33,51,-18,30
Ballinamalla,593,9,7,9,14,32,52,-20,30
Glentoran,593,10,8,5,17,26,44,-18,29
Portadown,593,11,6,7,17,23,45,-22,25
Crusaders,594,1,16,6,8,50,36,14,54
Ballymena,594,2,16,5,9,65,53,12,53
Glenavon,594,3,12,14,4,51,39,12,50
Cliftonville,594,4,15,5,10,57,46,11,50
Linfield,594,5,12,11,7,58,35,23,47
Coleraine,594,6,12,10,8,46,40,6,46
Ards,594,7,10,7,13,38,43,-5,37
Ballinamalla,594,8,10,6,14,38,55,-17,36
Portadown,594,9,7,8,15,21,44,-23,29
Dungannon,594,10,6,9,15,44,53,-9,27
Glentoran,594,11,4,9,17,24,48,-24,21
Crusaders,595,1,16,8,6,62,37,25,56
Ballymena,595,2,16,5,9,58,53,5,53
Linfield,595,3,14,10,6,54,33,21,52
Cliftonville,595,4,14,6,10,54,40,14,48
Coleraine,595,5,11,11,8,38,37,1,44
Glenavon,595,6,11,10,9,49,54,-5,43
Dungannon,595,7,11,9,10,51,43,8,42
Glentoran,595,8,10,6,14,36,44,-8,36
Ards,595,9,10,3,17,37,46,-9,33
Portadown,595,10,9,4,17,24,43,-19,31
Ballinamalla,595,11,4,6,20,21,54,-33,18
Cliftonville,596,1,18,4,8,58,37,21,58
Crusaders,596,2,17,7,6,54,33,21,58
Linfield,596,3,16,8,6,61,29,32,56
Glenavon,596,4,10,10,10,48,46,2,40
Ballymena,596,5,11,6,13,51,63,-12,39
Coleraine,596,6,8,14,8,42,39,3,38
Dungannon,596,7,8,11,11,41,43,-2,35
Ards,596,8,10,4,16,39,49,-10,34
Portadown,596,9,10,3,17,24,43,-19,33
Glentoran,596,10,8,8,14,37,52,-15,32
Ballinamalla,596,11,8,7,15,30,51,-21,31
Crusaders,597,1,19,6,5,61,29,32,63
Linfield,597,2,14,9,7,56,30,26,51
Cliftonville,597,3,15,3,12,51,46,5,48
Glenavon,597,4,11,10,9,48,50,-2,43
Ballymena,597,5,12,7,11,52,58,-6,43
Dungannon,597,6,11,6,13,48,44,4,39
Coleraine,597,7,10,9,11,44,44,0,39
Ballinamalla,597,8,12,2,16,41,52,-11,38
Glentoran,597,9,10,6,14,34,43,-9,36
Ards,597,10,9,5,16,35,53,-18,32
Portadown,597,11,8,5,17,26,47,-21,29
Crusaders,598,1,18,7,5,62,34,28,61
Linfield,598,2,15,7,8,56,34,22,52
Coleraine,598,3,14,9,7,47,39,8,51
Ballymena,598,4,14,7,9,54,50,4,49
Cliftonville,598,5,14,5,11,50,40,10,47
Glenavon,598,6,12,10,8,51,43,8,46
Ards,598,7,11,3,16,39,46,-7,36
Ballinamalla,598,8,10,4,16,31,49,-18,34
Glentoran,598,9,8,8,14,27,44,-17,32
Dungannon,598,10,7,9,14,47,53,-6,30
Portadown,598,11,5,5,20,21,53,-32,20
Crusaders,599,1,17,8,5,60,38,22,59
Linfield,599,2,14,10,6,56,33,23,52
Cliftonville,599,3,16,3,11,55,40,15,51
Ballymena,599,4,14,6,10,52,53,-1,48
Coleraine,599,5,12,10,8,37,29,8,46
Dungannon,599,6,10,10,10,51,44,7,40
Glenavon,599,7,8,12,10,40,51,-11,36
Glentoran,599,8,8,9,13,35,50,-15,33
Portadown,599,9,8,7,15,24,37,-13,31
Ards,599,10,9,4,17,38,53,-15,31
Ballinamalla,599,11,8,3,19,34,54,-20,27
Crusaders,600,1,19,8,3,54,26,28,65
Cliftonville,600,2,17,7,6,60,38,22,58
Linfield,600,3,13,10,7,55,34,21,49
Ballymena,600,4,13,6,11,56,63,-7,45
Glenavon,600,5,11,10,9,43,48,-5,43
Coleraine,600,6,10,9,11,41,37,4,39
Dungannon,600,7,8,11,11,48,46,2,35
Glentoran,600,8,9,8,13,35,45,-10,35
Ards,600,9,8,9,13,42,46,-4,33
Ballinamalla,600,10,8,4,18,28,51,-23,28
Portadown,600,11,5,6,19,27,55,-28,21
Linfield,601,1,14,9,7,62,35,27,51
Crusaders,601,2,14,9,7,55,40,15,51
Glenavon,601,3,12,11,7,48,43,5,47
Coleraine,601,4,12,10,8,47,38,9,46
Ballymena,601,5,12,8,10,53,59,-6,44
Cliftonville,601,6,11,8,11,51,45,6,41
Glentoran,601,7,10,8,12,38,47,-9,38
Ards,601,8,8,10,12,38,48,-10,34
Ballinamalla,601,9,9,6,15,35,50,-15,33
Dungannon,601,10,7,11,12,53,53,0,32
Portadown,601,11,8,6,16,27,49,-22,30
Cliftonville,602,1,18,6,6,61,32,29,60
Crusaders,602,2,16,10,4,59,35,24,58
Linfield,602,3,13,12,5,61,31,30,51
Coleraine,602,4,10,11,9,41,43,-2,41
Glentoran,602,5,12,5,13,36,48,-12,41
Dungannon,602,6,8,14,8,56,47,9,38
Ballymena,602,7,11,5,14,56,73,-17,38
Ballinamalla,602,8,10,6,14,43,53,-10,36
Glenavon,602,9,8,11,11,39,46,-7,35
Portadown,602,10,6,7,17,28,49,-21,25
Ards,602,11,6,7,17,30,53,-23,25
Crusaders,603,1,16,9,5,54,30,24,57
Cliftonville,603,2,16,4,10,55,42,13,52
Ballymena,603,3,16,4,10,56,53,3,52
Linfield,603,4,13,11,6,58,35,23,50
Glenavon,603,5,12,12,6,45,39,6,48
Coleraine,603,6,10,13,7,47,43,4,43
Glentoran,603,7,9,8,13,34,45,-11,35
Ards,603,8,8,6,16,31,48,-17,30
Portadown,603,9,7,8,15,31,50,-19,29
Dungannon,603,10,6,9,15,52,56,-4,27
Ballinamalla,603,11,7,6,17,31,53,-22,27
Crusaders,604,1,17,6,7,59,35,24,57
Linfield,604,2,16,6,8,60,38,22,54
Coleraine,604,3,14,9,7,43,35,8,51
Cliftonville,604,4,16,2,12,51,40,11,50
Ballymena,604,5,14,8,8,55,52,3,50
Glenavon,604,6,11,9,10,43,40,3,42
Dungannon,604,7,10,10,10,57,44,13,40
Ards,604,8,11,3,16,36,46,-10,36
Glentoran,604,9,7,8,15,33,52,-19,29
Portadown,604,10,8,3,19,26,46,-20,27
Ballinamalla,604,11,7,4,19,27,62,-35,25
Crusaders,605,1,16,6,8,55,36,19,54
Linfield,605,2,15,8,7,65,33,32,53
Cliftonville,605,3,13,7,10,48,40,8,46
Coleraine,605,4,12,9,9,48,41,7,45
Ballymena,605,5,13,6,11,61,69,-8,45
Glenavon,605,6,11,11,8,48,42,6,44
Glentoran,605,7,12,7,11,40,48,-8,43
Ards,605,8,10,4,16,32,48,-16,34
Dungannon,605,9,8,9,13,47,47,0,33
Ballinamalla,605,10,9,4,17,32,51,-19,31
Portadown,605,11,8,5,17,20,41,-21,29
Crusaders,606,1,20,6,4,60,28,32,66
Cliftonville,606,2,17,6,7,63,37,26,57
Linfield,606,3,15,6,9,56,35,21,51
Coleraine,606,4,12,10,8,52,42,10,46
Ballymena,606,5,12,5,13,59,71,-12,41
Ards,606,6,12,3,15,42,58,-16,39
Glenavon,606,7,9,10,11,51,58,-7,37
Glentoran,606,8,10,7,13,39,49,-10,37
Dungannon,606,9,9,8,13,58,53,5,35
Ballinamalla,606,10,7,6,17,34,59,-25,27
Portadown,606,11,6,5,19,24,48,-24,23
Crusaders,607,1,20,5,5,62,28,34,65
Linfield,607,2,13,12,5,55,28,27,51
Cliftonville,607,3,14,6,10,53,38,15,48
Ballymena,607,4,14,6,10,60,60,0,48
Dungannon,607,5,13,8,9,57,45,12,47
Coleraine,607,6,11,9,10,37,36,1,42
Glenavon,607,7,10,10,10,46,48,-2,40
Ballinamalla,607,8,10,3,17,33,48,-15,33
Ards,607,9,8,7,15,33,50,-17,31
Glentoran,607,10,7,9,14,31,52,-21,30
Portadown,607,11,6,3,21,26,60,-34,21
Crusaders,608,1,18,6,6,54,32,22,60
Cliftonville,608,2,17,4,9,58,41,17,55
Ballymena,608,3,15,6,9,59,50,9,51
Linfield,608,4,13,9,8,52,35,17,48
Coleraine,608,5,13,9,8,41,34,7,48
Glenavon,608,6,10,10,10,44,44,0,40
Glentoran,608,7,10,6,14,36,42,-6,36
Ards,608,8,10,6,14,35,44,-9,36
Portadown,608,9,8,5,17,29,44,-15,29
Dungannon,608,10,7,7,16,47,62,-15,28
Ballinamalla,608,11,8,4,18,27,54,-27,28
Crusaders,609,1,19,7,4,60,31,29,64
Cliftonville,609,2,15,6,9,56,40,16,51
Glenavon,609,3,13,9,8,46,43,3,48
Ballymena,609,4,14,6,10,64,63,1,48
Linfield,609,5,13,8,9,49,36,13,47
Coleraine,609,6,12,9,9,41,33,8,45
Dungannon,609,7,10,10,10,51,50,1,40
Ards,609,8,10,5,15,41,50,-9,35
Glentoran,609,9,8,6,16,26,47,-21,30
Portadown,609,10,5,9,16,26,44,-18,24
Ballinamalla,609,11,6,5,19,25,48,-23,23
Linfield,610,1,16,9,5,58,27,31,57
Ballymena,610,2,17,6,7,61,44,17,57
Crusaders,610,3,14,8,8,48,32,16,50
Cliftonville,610,4,14,6,10,42,31,11,48
Coleraine,610,5,12,11,7,39,35,4,47
Glentoran,610,6,10,7,13,31,39,-8,37
Dungannon,610,7,9,8,13,38,39,-1,35
Glenavon,610,8,9,8,13,36,44,-8,35
Ballinamalla,610,9,10,3,17,32,53,-21,33
Ards,610,10,8,8,14,31,45,-14,32
Portadown,610,11,7,4,19,18,45,-27,25
Linfield,611,1,14,11,5,66,33,33,53
Cliftonville,611,2,15,7,8,54,35,19,52
Ballymena,611,3,15,7,8,64,55,9,52
Crusaders,611,4,14,8,8,50,46,4,50
Glenavon,611,5,12,8,10,45,44,1,44
Coleraine,611,6,11,8,11,43,39,4,41
Dungannon,611,7,10,9,11,49,43,6,39
Glentoran,611,8,8,10,12,30,40,-10,34
Ballinamalla,611,9,9,4,17,30,49,-19,31
Portadown,611,10,9,3,18,23,50,-27,30
Ards,611,11,7,7,16,32,52,-20,28
Linfield,612,1,16,9,5,59,29,30,57
Crusaders,612,2,15,11,4,51,27,24,56
Cliftonville,612,3,15,7,8,52,41,11,52
Ballymena,612,4,13,7,10,53,52,1,46
Glenavon,612,5,10,11,9,43,44,-1,41
Ards,612,6,11,7,12,40,43,-3,40
Coleraine,612,7,8,12,10,38,40,-2,36
Dungannon,612,8,8,10,12,40,42,-2,34
Ballinamalla,612,9,10,4,16,34,49,-15,34
Glentoran,612,10,5,11,14,26,43,-17,26
Portadown,612,11,7,5,18,21,47,-26,26
Linfield,613,1,17,8,5,61,28,33,59
Crusaders,613,2,16,8,6,60,37,23,56
Cliftonville,613,3,15,5,10,50,37,13,50
Ballymena,613,4,15,5,10,65,58,7,50
Glenavon,613,5,11,12,7,52,47,5,45
Glentoran,613,6,12,7,11,33,36,-3,43
Coleraine,613,7,10,9,11,38,43,-5,39
Dungannon,613,8,9,10,11,50,49,1,37
Ballinamalla,613,9,9,5,16,30,49,-19,32
Ards,613,10,6,4,20,32,53,-21,22
Portadown,613,11,5,7,18,18,52,-34,22
Linfield,614,1,16,8,6,62,31,31,56
Cliftonville,614,2,16,3,11,53,39,14,51
Coleraine,614,3,14,9,7,55,42,13,51
Dungannon,614,4,13,9,8,56,34,22,48
Crusaders,614,5,13,8,9,44,32,12,47
Ballymena,614,6,12,4,14,50,55,-5,40
Glenavon,614,7,9,10,11,38,53,-15,37
Ards,614,8,11,2,17,38,50,-12,35
Portadown,614,9,10,5,15,29,41,-12,35
Ballinamalla,614,10,9,4,17,29,58,-29,31
Glentoran,614,11,8,6,16,27,46,-19,30
Crusaders,615,1,18,9,3,60,33,27,63
Linfield,615,2,16,7,7,65,33,32,55
Cliftonville,615,3,15,5,10,52,45,7,50
Glenavon,615,4,12,12,6,53,43,10,48
Ballymena,615,5,13,8,9,56,59,-3,47
Coleraine,615,6,12,10,8,52,39,13,46
Dungannon,615,7,10,9,11,53,45,8,39
Ballinamalla,615,8,11,2,17,34,44,-10,35
Glentoran,615,9,7,7,16,28,57,-29,28
Ards,615,10,5,8,17,34,55,-21,23
Portadown,615,11,6,3,21,20,54,-34,21
Linfield,616,1,17,9,4,67,28,39,60
Crusaders,616,2,15,7,8,50,38,12,52
Coleraine,616,3,13,10,7,46,32,14,49
Cliftonville,616,4,14,6,10,54,41,13,48
Ballymena,616,5,14,4,12,62,66,-4,46
Dungannon,616,6,11,11,8,50,38,12,44
Glenavon,616,7,9,11,10,41,45,-4,38
Ards,616,8,10,3,17,39,54,-15,33
Glentoran,616,9,8,6,16,26,50,-24,30
Portadown,616,10,8,5,17,27,50,-23,29
Ballinamalla,616,11,7,6,17,27,47,-20,27
Linfield,617,1,17,9,4,63,29,34,60
Crusaders,617,2,15,8,7,51,37,14,53
Dungannon,617,3,13,9,8,59,45,14,48
Coleraine,617,4,11,12,7,42,35,7,45
Cliftonville,617,5,13,4,13,49,38,11,43
Glenavon,617,6,9,12,9,43,43,0,39
Ards,617,7,11,5,14,45,49,-4,38
Ballymena,617,8,10,8,12,45,61,-16,38
Portadown,617,9,8,6,16,27,42,-15,30
Glentoran,617,10,7,9,14,26,45,-19,30
Ballinamalla,617,11,7,6,17,25,51,-26,27
Linfield,618,1,17,7,6,60,29,31,58
Cliftonville,618,2,15,7,8,49,34,15,52
Ballymena,618,3,16,4,10,61,54,7,52
Crusaders,618,4,15,6,9,53,38,15,51
Dungannon,618,5,13,9,8,55,42,13,48
Ballinamalla,618,6,12,2,16,31,46,-15,38
Glentoran,618,7,10,6,14,35,45,-10,36
Glenavon,618,8,9,9,12,43,54,-11,36
Coleraine,618,9,7,13,10,35,40,-5,34
Portadown,618,10,8,4,18,24,46,-22,28
Ards,618,11,6,7,17,32,50,-18,25
Crusaders,619,1,16,9,5,52,30,22,57
Linfield,619,2,16,8,6,58,27,31,56
Cliftonville,619,3,14,6,10,52,42,10,48
Coleraine,619,4,12,10,8,46,40,6,46
Ballymena,619,5,13,7,10,59,60,-1,46
Glenavon,619,6,10,11,9,48,51,-3,41
Dungannon,619,7,9,9,12,51,46,5,36
Glentoran,619,8,9,9,12,32,42,-10,36
Ards,619,9,9,4,17,36,51,-15,31
Ballinamalla,619,10,9,4,17,33,55,-22,31
Portadown,619,11,5,9,16,18,41,-23,24
Glenavon,620,1,15,11,4,58,38,20,56
Crusaders,620,2,14,8,8,54,39,15,50
Linfield,620,3,12,11,7,55,31,24,47
Cliftonville,620,4,13,8,9,55,44,11,47
Coleraine,620,5,10,14,6,44,40,4,44
Ballymena,620,6,12,7,11,53,62,-9,43
Dungannon,620,7,10,9,11,46,41,5,39
Glentoran,620,8,7,12,11,31,40,-9,33
Ards,620,9,9,5,16,35,51,-16,32
Portadown,620,10,6,9,15,27,47,-20,27
Ballinamalla,620,11,6,8,16,28,53,-25,26
Linfield,621,1,16,10,4,60,34,26,58
Ballymena,621,2,16,6,8,59,51,8,54
Coleraine,621,3,14,10,6,42,30,12,52
Crusaders,621,4,15,6,9,52,39,13,51
Cliftonville,621,5,15,5,10,52,34,18,50
Dungannon,621,6,9,12,9,55,41,14,39
Ards,621,7,10,7,13,34,44,-10,37
Glentoran,621,8,9,5,16,31,49,-18,32
Ballinamalla,621,9,8,6,16,30,52,-22,30
Glenavon,621,10,6,9,15,46,61,-15,27
Portadown,621,11,6,6,18,27,53,-26,24
Cliftonville,622,1,15,7,8,47,33,14,52
Crusaders,622,2,15,7,8,57,44,13,52
Ballymena,622,3,15,7,8,50,46,4,52
Linfield,622,4,11,11,8,51,32,19,44
Coleraine,622,5,10,13,7,42,38,4,43
Glentoran,622,6,11,7,12,32,42,-10,40
Dungannon,622,7,8,12,10,45,40,5,36
Glenavon,622,8,8,11,11,39,43,-4,35
Ards,622,9,10,3,17,35,45,-10,33
Ballinamalla,622,10,9,5,16,37,52,-15,32
Portadown,622,11,8,7,15,27,47,-20,31
Linfield,623,1,15,10,5,67,30,37,55
Cliftonville,623,2,16,7,7,50,32,18,55
Crusaders,623,3,13,11,6,44,30,14,50
Ballymena,623,4,14,8,8,60,57,3,50
Glenavon,623,5,13,9,8,44,39,5,48
Coleraine,623,6,12,10,8,43,35,8,46
Glentoran,623,7,10,6,14,29,43,-14,36
Dungannon,623,8,8,7,15,46,49,-3,31
Ballinamalla,623,9,9,3,18,25,52,-27,30
Ards,623,10,7,7,16,36,52,-16,28
Portadown,623,11,6,6,18,18,43,-25,24
Crusaders,624,1,15,8,7,52,43,9,53
Glenavon,624,2,14,10,6,50,36,14,52
Ballymena,624,3,13,10,7,59,58,1,49
Linfield,624,4,13,8,9,54,37,17,47
Cliftonville,624,5,13,7,10,48,37,11,46
Coleraine,624,6,8,14,8,34,34,0,38
Dungannon,624,7,9,10,11,45,42,3,37
Ards,624,8,9,7,14,39,45,-6,34
Glentoran,624,9,8,9,13,37,52,-15,33
Ballinamalla,624,10,9,4,17,32,48,-16,31
Portadown,624,11,8,5,17,27,45,-18,29
Coleraine,625,1,15,9,6,46,29,17,54
Crusaders,625,2,15,8,7,49,33,16,53
Ballymena,625,3,15,7,8,55,53,2,52
Linfield,625,4,13,7,10,58,38,20,46
Cliftonville,625,5,12,6,12,47,41,6,42
Glenavon,625,6,10,12,8,46,45,1,42
Glentoran,625,7,10,6,14,31,40,-9,36
Ballinamalla,625,8,10,4,16,30,46,-16,34
Portadown,625,9,10,4,16,30,52,-22,34
Dungannon,625,10,6,13,11,45,44,1,31
Ards,625,11,8,6,16,33,49,-16,30
Glenavon,626,1,16,7,7,43,35,8,55
Ballymena,626,2,16,6,8,53,49,4,54
Linfield,626,3,15,8,7,50,24,26,53
Coleraine,626,4,12,12,6,47,37,10,48
Cliftonville,626,5,14,5,11,53,41,12,47
Crusaders,626,6,12,10,8,51,39,12,46
Glentoran,626,7,11,6,13,33,41,-8,39
Dungannon,626,8,8,8,14,41,41,0,32
Ards,626,9,7,8,15,35,51,-16,29
Ballinamalla,626,10,7,6,17,25,45,-20,27
Portadown,626,11,6,6,18,16,44,-28,24
Crusaders,627,1,18,7,5,53,30,23,61
Cliftonville,627,2,16,6,8,55,37,18,54
Linfield,627,3,12,13,5,57,30,27,49
Coleraine,627,4,11,13,6,40,33,7,46
Ballymena,627,5,13,5,12,49,58,-9,44
Glenavon,627,6,8,15,7,42,44,-2,39
Glentoran,627,7,9,8,13,31,45,-14,35
Dungannon,627,8,8,9,13,45,48,-3,33
Portadown,627,9,8,7,15,23,41,-18,31
Ards,627,10,7,8,15,38,50,-12,29
Ballinamalla,627,11,8,3,19,38,55,-17,27
Ballymena,628,1,16,6,8,63,60,3,54
Crusaders,628,2,14,11,5,55,33,22,53
Cliftonville,628,3,15,5,10,51,36,15,50
Glenavon,628,4,13,11,6,53,43,10,50
Linfield,628,5,13,8,9,59,37,22,47
Coleraine,628,6,11,11,8,42,41,1,44
Dungannon,628,7,11,8,11,50,43,7,41
Glentoran,628,8,8,7,15,31,46,-15,31
Ards,628,9,8,6,16,32,48,-16,30
Portadown,628,10,8,5,17,24,47,-23,29
Ballinamalla,628,11,7,4,19,29,55,-26,25
Cliftonville,629,1,17,6,7,59,37,22,57
Crusaders,629,2,15,7,8,47,34,13,52
Linfield,629,3,13,9,8,58,34,24,48
Glenavon,629,4,11,10,9,41,38,3,43
Ards,629,5,11,6,13,41,46,-5,39
Glentoran,629,6,11,6,13,31,45,-14,39
Dungannon,629,7,10,8,12,50,50,0,38
Coleraine,629,8,9,11,10,38,42,-4,38
Ballymena,629,9,11,5,14,50,60,-10,38
Portadown,629,10,9,5,16,30,41,-11,32
Ballinamalla,629,11,9,5,16,37,55,-18,32
Linfield,630,1,18,8,4,64,30,34,62
Crusaders,630,2,18,4,8,61,34,27,58
Cliftonville,630,3,17,3,10,55,40,15,54
Ballymena,630,4,13,7,10,59,55,4,46
Glenavon,630,5,12,10,8,49,49,0,46
Coleraine,630,6,10,12,8,38,34,4,42
Dungannon,630,7,9,12,9,51,46,5,39
Ards,630,8,9,5,16,40,52,-12,32
Glentoran,630,9,8,8,14,32,46,-14,32
Ballinamalla,630,10,5,8,17,29,55,-26,23
Portadown,630,11,5,5,20,23,60,-37,20
Cliftonville,631,1,17,5,8,57,39,18,56
Linfield,631,2,15,8,7,63,37,26,53
Crusaders,631,3,15,7,8,52,41,11,52
Ballymena,631,4,14,6,10,61,60,1,48
Glenavon,631,5,11,12,7,47,45,2,45
Coleraine,631,6,11,11,8,52,39,13,44
Dungannon,631,7,10,9,11,45,41,4,39
Ards,631,8,10,7,13,37,48,-11,37
Glentoran,631,9,7,8,15,27,46,-19,29
Ballinamalla,631,10,7,7,16,28,46,-18,28
Portadown,631,11,4,8,18,21,48,-27,20
Crusaders,632,1,15,8,7,50,31,19,53
Linfield,632,2,14,9,7,56,35,21,51
Dungannon,632,3,12,10,8,58,42,16,46
Cliftonville,632,4,13,5,12,49,46,3,44
Ballymena,632,5,12,8,10,64,64,0,44
Glenavon,632,6,10,13,7,43,47,-4,43
Coleraine,632,7,11,9,10,35,31,4,42
Ards,632,8,11,4,15,45,48,-3,37
Glentoran,632,9,10,7,13,30,45,-15,37
Ballinamalla,632,10,8,6,16,34,51,-17,30
Portadown,632,11,7,5,18,27,51,-24,26
Linfield,633,1,16,10,4,62,27,35,58
Crusaders,633,2,17,4,9,60,38,22,55
Cliftonville,633,3,16,5,9,58,36,22,53
Ballymena,633,4,15,7,8,59,53,6,52
Coleraine,633,5,11,11,8,37,36,1,44
Ards,633,6,12,4,14,42,47,-5,40
Glenavon,633,7,9,11,10,45,48,-3,38
Glentoran,633,8,9,5,16,29,48,-19,32
Dungannon,633,9,8,7,15,53,63,-10,31
Portadown,633,10,9,4,17,27,48,-21,31
Ballinamalla,633,11,6,6,18,25,53,-28,24
Cliftonville,634,1,19,3,8,59,32,27,60
Crusaders,634,2,17,9,4,53,26,27,60
Ballymena,634,3,16,7,7,58,56,2,55
Linfield,634,4,13,8,9,52,34,18,47
Glenavon,634,5,11,11,8,47,50,-3,44
Coleraine,634,6,9,11,10,36,36,0,38
Dungannon,634,7,8,12,10,48,44,4,36
Glentoran,634,8,9,5,16,31,44,-13,32
Portadown,634,9,7,6,17,23,48,-25,27
Ballinamalla,634,10,8,3,19,22,47,-25,27
Ards,634,11,5,11,14,34,46,-12,26
Linfield,635,1,16,8,6,60,31,29,56
Ballymena,635,2,16,7,7,59,53,6,55
Cliftonville,635,3,15,5,10,51,36,15,50
Crusaders,635,4,14,7,9,51,41,10,49
Coleraine,635,5,9,13,8,41,41,0,40
Dungannon,635,6,9,12,9,48,41,7,39
Glentoran,635,7,9,8,13,36,46,-10,35
Portadown,635,8,10,5,15,29,43,-14,35
Glenavon,635,9,8,10,12,48,54,-6,34
Ards,635,10,8,6,16,41,59,-18,30
Ballinamalla,635,11,6,9,15,28,47,-19,27
Crusaders,636,1,15,6,9,47,39,8,51
Ballymena,636,2,13,10,7,54,54,0,49
Linfield,636,3,12,12,6,57,35,22,48
Coleraine,636,4,11,13,6,41,30,11,46
Glenavon,636,5,12,10,8,43,37,6,46
Dungannon,636,6,12,8,10,55,51,4,44
Cliftonville,636,7,12,5,13,46,46,0,41
Ards,636,8,9,6,15,34,46,-12,33
Ballinamalla,636,9,10,3,17,31,43,-12,33
Glentoran,636,10,7,10,13,34,46,-12,31
Portadown,636,11,8,5,17,37,52,-15,29
Crusaders,637,1,18,10,2,60,31,29,64
Linfield,637,2,15,11,4,62,29,33,56
Glenavon,637,3,13,8,9,46,44,2,47
Coleraine,637,4,11,12,7,42,39,3,45
Dungannon,637,5,11,11,8,57,42,15,44
Cliftonville,637,6,13,5,12,46,39,7,44
Ballymena,637,7,12,5,13,53,61,-8,41
Glentoran,637,8,7,11,12,28,43,-15,32
Ards,637,9,6,10,14,36,49,-13,28
Ballinamalla,637,10,6,7,17,29,53,-24,25
Portadown,637,11,5,6,19,28,57,-29,21
Crusaders,638,1,18,8,4,70,36,34,62
Coleraine,638,2,16,9,5,49,31,18,57
Linfield,638,3,16,6,8,56,31,25,54
Glenavon,638,4,12,10,8,44,45,-1,46
Ballymena,638,5,14,4,12,58,60,-2,46
Cliftonville,638,6,13,6,11,49,43,6,45
Glentoran,638,7,10,8,12,31,38,-7,38
Dungannon,638,8,7,10,13,45,50,-5,31
Ards,638,9,8,5,17,36,51,-15,29
Portadown,638,10,7,5,18,27,49,-22,26
Ballinamalla,638,11,6,5,19,31,62,-31,23
Linfield,639,1,16,9,5,56,28,28,57
Ballymena,639,2,17,5,8,70,58,12,56
Crusaders,639,3,15,10,5,65,38,27,55
Coleraine,639,4,13,10,7,50,39,11,49
Cliftonville,639,5,13,5,12,53,41,12,44
Dungannon,639,6,11,9,10,49,44,5,42
Glenavon,639,7,10,11,9,47,50,-3,41
Glentoran,639,8,10,5,15,29,45,-16,35
Portadown,639,9,6,8,16,26,50,-24,26
Ballinamalla,639,10,7,5,18,25,56,-31,26
Ards,639,11,6,5,19,29,50,-21,23
Linfield,640,1,15,8,7,63,36,27,53
Crusaders,640,2,15,7,8,55,45,10,52
Cliftonville,640,3,14,7,9,49,40,9,49
Coleraine,640,4,12,11,7,50,40,10,47
Ballymena,640,5,14,5,11,53,57,-4,47
Glenavon,640,6,12,10,8,55,43,12,46
Dungannon,640,7,10,9,11,55,48,7,39
Glentoran,640,8,9,8,13,34,48,-14,35
Ards,640,9,7,8,15,35,52,-17,29
Ballinamalla,640,10,8,5,17,35,53,-18,29
Portadown,640,11,8,4,18,25,47,-22,28
Crusaders,641,1,16,9,5,62,38,24,57
Cliftonville,641,2,17,4,9,47,35,12,55
Linfield,641,3,13,11,6,51,24,27,50
Ballymena,641,4,14,7,9,54,58,-4,49
Glenavon,641,5,10,14,6,41,41,0,44
Coleraine,641,6,10,13,7,41,33,8,43
Glentoran,641,7,11,9,10,38,43,-5,42
Ards,641,8,11,5,14,44,45,-1,38
Dungannon,641,9,6,12,12,42,42,0,30
Portadown,641,10,8,5,17,20,42,-22,29
Ballinamalla,641,11,4,1,25,24,63,-39,13
Crusaders,642,1,17,5,8,56,34,22,56
Linfield,642,2,14,9,7,65,34,31,51
Ballymena,642,3,13,9,8,59,58,1,48
Coleraine,642,4,12,10,8,45,37,8,46
Glenavon,642,5,11,11,8,48,47,1,44
Cliftonville,642,6,11,5,14,48,50,-2,38
Portadown,642,7,10,6,14,33,45,-12,36
Glentoran,642,8,10,6,14,33,48,-15,36
Ballinamalla,642,9,10,5,15,27,45,-18,35
Ards,642,10,8,9,13,38,46,-8,33
Dungannon,642,11,7,9,14,42,50,-8,30
Linfield,643,1,16,10,4,64,27,37,58
Cliftonville,643,2,15,8,7,52,40,12,53
Ballymena,643,3,15,5,10,67,59,8,50
Crusaders,643,4,15,4,11,53,41,12,49
Coleraine,643,5,13,8,9,49,42,7,47
Glenavon,643,6,10,10,10,45,51,-6,40
Dungannon,643,7,9,9,12,49,47,2,36
Ballinamalla,643,8,10,5,15,34,48,-14,35
Ards,643,9,8,9,13,34,45,-11,33
Glentoran,643,10,7,8,15,26,50,-24,29
Portadown,643,11,7,4,19,28,51,-23,25
Crusaders,644,1,19,8,3,61,30,31,65
Linfield,644,2,17,8,5,71,32,39,59
Cliftonville,644,3,16,5,9,51,33,18,53
Coleraine,644,4,11,13,6,44,35,9,46
Ballymena,644,5,13,7,10,60,58,2,46
Glenavon,644,6,11,11,8,48,47,1,44
Ards,644,7,10,4,16,34,53,-19,34
Dungannon,644,8,8,8,14,49,52,-3,32
Glentoran,644,9,8,6,16,26,48,-22,30
Portadown,644,10,7,3,20,26,55,-29,24
Ballinamalla,644,11,5,7,18,23,50,-27,22
Linfield,645,1,16,9,5,59,27,32,57
Cliftonville,645,2,16,7,7,56,37,19,55
Crusaders,645,3,15,9,6,60,34,26,54
Ballymena,645,4,13,8,9,63,58,5,47
Coleraine,645,5,11,12,7,43,34,9,45
Glenavon,645,6,8,12,10,45,53,-8,36
Dungannon,645,7,7,11,12,40,44,-4,32
Glentoran,645,8,7,10,13,25,49,-24,31
Ards,645,9,8,6,16,34,49,-15,30
Portadown,645,10,8,6,16,27,46,-19,30
Ballinamalla,645,11,7,8,15,30,51,-21,29
Linfield,646,1,17,9,4,63,32,31,60
Cliftonville,646,2,14,9,7,51,34,17,51
Crusaders,646,3,13,10,7,49,30,19,49
Ballymena,646,4,13,8,9,60,57,3,47
Coleraine,646,5,10,12,8,43,40,3,42
Dungannon,646,6,11,7,12,48,48,0,40
Ards,646,7,10,6,14,42,47,-5,36
Glenavon,646,8,8,11,11,40,52,-12,35
Glentoran,646,9,8,9,13,27,38,-11,33
Portadown,646,10,7,7,16,27,48,-21,28
Ballinamalla,646,11,6,8,16,29,53,-24,26
Crusaders,647,1,18,7,5,65,38,27,61
Cliftonville,647,2,16,6,8,59,42,17,54
Linfield,647,3,15,8,7,58,32,26,53
Coleraine,647,4,13,9,8,44,41,3,48
Ballymena,647,5,14,4,12,66,70,-4,46
Dungannon,647,6,11,8,11,53,45,8,41
Glenavon,647,7,9,10,11,46,54,-8,37
Ards,647,8,11,3,16,41,50,-9,36
Glentoran,647,9,9,5,16,36,53,-17,32
Ballinamalla,647,10,9,4,17,39,57,-18,31
Portadown,647,11,6,4,20,26,51,-25,22
Linfield,648,1,13,9,8,60,38,22,48
Cliftonville,648,2,14,6,10,52,39,13,48
Crusaders,648,3,12,11,7,50,37,13,47
Glenavon,648,4,12,10,8,47,43,4,46
Ballymena,648,5,13,5,12,50,54,-4,44
Coleraine,648,6,11,9,10,40,38,2,42
Glentoran,648,7,11,5,14,38,50,-12,38
Ballinamalla,648,8,11,5,14,32,44,-12,38
Dungannon,648,9,9,9,12,45,52,-7,36
Ards,648,10,8,8,14,41,47,-6,32
Portadown,648,11,7,11,12,31,44,-13,32
Crusaders,649,1,17,6,7,57,33,24,57
Linfield,649,2,15,8,7,62,29,33,53
Cliftonville,649,3,14,9,7,56,38,18,51
Coleraine,649,4,13,12,5,52,35,17,51
Ballymena,649,5,12,6,12,53,62,-9,42
Glenavon,649,6,9,13,8,45,49,-4,40
Dungannon,649,7,10,8,12,48,44,4,38
Glentoran,649,8,9,6,15,34,51,-17,33
Ballinamalla,649,9,9,4,17,32,53,-21,31
Ards,649,10,7,8,15,30,48,-18,29
Portadown,649,11,8,4,18,24,51,-27,28
Crusaders,650,1,20,7,3,58,29,29,67
Ballymena,650,2,14,7,9,60,58,2,49
Cliftonville,650,3,14,4,12,56,52,4,46
Linfield,650,4,12,9,9,52,38,14,45
Coleraine,650,5,11,10,9,41,36,5,43
Glenavon,650,6,10,11,9,47,48,-1,41
Glentoran,650,7,11,4,15,28,40,-12,37
Dungannon,650,8,9,9,12,49,43,6,36
Ards,650,9,10,5,15,40,47,-7,35
Portadown,650,10,9,6,15,30,47,-17,33
Ballinamalla,650,11,6,6,18,27,50,-23,24
Crusaders,651,1,17,5,8,54,38,16,56
Cliftonville,651,2,17,4,9,59,34,25,55
Linfield,651,3,13,11,6,57,33,24,50
Dungannon,651,4,13,8,9,63,44,19,47
Coleraine,651,5,12,9,9,47,44,3,45
Glenavon,651,6,11,10,9,53,45,8,43
Ballymena,651,7,13,4,13,51,63,-12,43
Glentoran,651,8,8,7,15,28,47,-19,31
Ards,651,9,7,9,14,38,52,-14,30
Ballinamalla,651,10,7,7,16,24,50,-26,28
Portadown,651,11,6,8,16,27,51,-24,26
Cliftonville,652,1,17,4,9,54,35,19,55
Linfield,652,2,14,11,5,53,28,25,53
Crusaders,652,3,12,11,7,52,39,13,47
Ballymena,652,4,13,7,10,53,55,-2,46
Coleraine,652,5,12,9,9,40,38,2,45
Dungannon,652,6,11,8,11,45,40,5,41
Glenavon,652,7,10,9,11,45,48,-3,39
Glentoran,652,8,10,8,12,25,37,-12,38
Portadown,652,9,11,4,15,28,41,-13,37
Ards,652,10,7,7,16,34,46,-12,28
Ballinamalla,652,11,7,4,19,29,51,-22,25
Crusaders,653,1,16,9,5,59,32,27,57
Linfield,653,2,15,10,5,61,33,28,55
Ballymena,653,3,14,6,10,54,54,0,48
Cliftonville,653,4,13,6,11,48,44,4,45
Coleraine,653,5,11,11,8,43,44,-1,44
Glenavon,653,6,11,9,10,49,47,2,42
Portadown,653,7,11,4,15,37,49,-12,37
Dungannon,653,8,8,12,10,51,46,5,36
Ards,653,9,9,5,16,38,52,-14,32
Ballinamalla,653,10,8,6,16,31,48,-17,30
Glentoran,653,11,6,8,16,30,52,-22,26
Linfield,654,1,19,9,2,65,23,42,66
Crusaders,654,2,16,6,8,54,31,23,54
Ballymena,654,3,14,7,9,52,52,0,49
Cliftonville,654,4,13,7,10,50,36,14,46
Dungannon,654,5,12,8,10,48,44,4,44
Glenavon,654,6,9,11,10,43,49,-6,38
Coleraine,654,7,8,12,10,32,34,-2,36
Ards,654,8,10,3,17,37,46,-9,33
Portadown,654,9,9,6,15,24,41,-17,33
Ballinamalla,654,10,8,5,17,28,56,-28,29
Glentoran,654,11,7,6,17,24,45,-21,27
Linfield,655,1,16,9,5,66,33,33,57
Crusaders,655,2,16,8,6,53,35,18,56
Cliftonville,655,3,17,3,10,58,40,18,54
Coleraine,655,4,11,11,8,49,44,5,44
Dungannon,655,5,11,8,11,54,53,1,41
Glenavon,655,6,8,15,7,40,41,-1,39
Ballinamalla,655,7,10,6,14,26,39,-13,36
Ards,655,8,9,7,14,40,48,-8,34
Ballymena,655,9,9,7,14,46,62,-16,34
Glentoran,655,10,9,5,16,28,42,-14,32
Portadown,655,11,5,9,16,31,54,-23,24
Crusaders,656,1,19,6,5,62,37,25,63
Linfield,656,2,17,8,5,59,25,34,59
Cliftonville,656,3,15,4,11,52,39,13,49
Glenavon,656,4,11,12,7,46,45,1,45
Coleraine,656,5,10,12,8,43,35,8,42
Ards,656,6,12,4,14,41,48,-7,40
Dungannon,656,7,9,11,10,52,45,7,38
Ballymena,656,8,9,7,14,47,63,-16,34
Glentoran,656,9,8,7,15,24,40,-16,31
Ballinamalla,656,10,7,6,17,27,49,-22,27
Portadown,656,11,7,5,18,22,49,-27,26
Crusaders,657,1,18,7,5,61,40,21,61
Cliftonville,657,2,15,5,10,57,39,18,50
Glenavon,657,3,13,11,6,54,42,12,50
Linfield,657,4,13,8,9,54,34,20,47
Coleraine,657,5,12,11,7,48,41,7,47
Ballymena,657,6,11,6,13,53,67,-14,39
Dungannon,657,7,9,9,12,46,41,5,36
Glentoran,657,8,8,10,12,33,47,-14,34
Portadown,657,9,8,6,16,28,46,-18,30
Ards,657,10,7,8,15,35,52,-17,29
Ballinamalla,657,11,8,5,17,30,50,-20,29
Crusaders,658,1,16,9,5,51,32,19,57
Glenavon,658,2,14,10,6,52,40,12,52
Linfield,658,3,13,11,6,60,34,26,50
Ballymena,658,4,13,10,7,57,57,0,49
Cliftonville,658,5,13,7,10,49,43,6,46
Coleraine,658,6,10,11,9,43,38,5,41
Dungannon,658,7,10,8,12,43,43,0,38
Portadown,658,8,10,6,14,33,40,-7,36
Glentoran,658,9,7,10,13,27,47,-20,31
Ballinamalla,658,10,9,3,18,28,47,-19,30
Ards,658,11,6,3,21,27,49,-22,21
Crusaders,659,1,17,8,5,56,29,27,59
Cliftonville,659,2,18,3,9,57,42,15,57
Linfield,659,3,15,8,7,59,34,25,53
Ballymena,659,4,15,5,10,58,57,1,50
Coleraine,659,5,13,9,8,48,41,7,48
Glenavon,659,6,11,9,10,48,49,-1,42
Glentoran,659,7,9,8,13,30,43,-13,35
Dungannon,659,8,8,10,12,47,49,-2,34
Portadown,659,9,9,4,17,32,46,-14,31
Ards,659,10,6,8,16,35,51,-16,26
Ballinamalla,659,11,6,4,20,30,59,-29,22
Crusaders,660,1,16,8,6,57,38,19,56
Ballymena,660,2,14,8,8,59,48,11,50
Glenavon,660,3,12,12,6,51,43,8,48
Cliftonville,660,4,12,7,11,45,42,3,43
Coleraine,660,5,10,11,9,46,36,10,41
Dungannon,660,6,9,12,9,49,42,7,39
Linfield,660,7,10,8,12,50,39,11,38
Portadown,660,8,10,6,14,30,46,-16,36
Ards,660,9,9,8,13,38,50,-12,35
Ballinamalla,660,10,10,2,18,29,51,-22,32
Glentoran,660,11,7,10,13,28,47,-19,31
Linfield,661,1,16,8,6,65,29,36,56
Cliftonville,661,2,16,3,11,50,38,12,51
Crusaders,661,3,14,8,8,49,35,14,50
Coleraine,661,4,13,10,7,48,37,11,49
Glenavon,661,5,12,9,9,49,46,3,45
Ballymena,661,6,12,4,14,51,64,-13,40
Glentoran,661,7,10,7,13,28,49,-21,37
Dungannon,661,8,8,10,12,44,42,2,34
Ballinamalla,661,9,10,4,16,35,44,-9,34
Ards,661,10,9,6,15,35,49,-14,33
Portadown,661,11,8,5,17,29,50,-21,29
Crusaders,662,1,18,6,6,56,30,26,60
Linfield,662,2,17,7,6,66,30,36,58
Coleraine,662,3,12,9,9,42,40,2,45
Cliftonville,662,4,13,5,12,48,42,6,44
Glenavon,662,5,11,11,8,46,46,0,44
Dungannon,662,6,11,9,10,56,41,15,42
Ballymena,662,7,10,10,10,50,58,-8,40
Glentoran,662,8,9,6,15,31,48,-17,33
Ards,662,9,8,7,15,36,51,-15,31
Portadown,662,10,7,8,15,31,52,-21,29
Ballinamalla,662,11,7,6,17,27,51,-24,27
Crusaders,663,1,18,7,5,58,33,25,61
Cliftonville,663,2,18,5,7,61,37,24,59
Ballymena,663,3,17,6,7,57,49,8,57
Glenavon,663,4,14,9,7,46,39,7,51
Linfield,663,5,11,10,9,51,36,15,43
Coleraine,663,6,10,9,11,42,41,1,39
Glentoran,663,7,9,9,12,31,42,-11,36
Ards,663,8,8,9,13,38,51,-13,33
Dungannon,663,9,7,8,15,43,50,-7,29
Portadown,663,10,7,5,18,29,49,-20,26
Ballinamalla,663,11,5,5,20,28,57,-29,20
Crusaders,664,1,18,7,5,58,31,27,61
Linfield,664,2,16,9,5,63,31,32,57
Cliftonville,664,3,17,3,10,53,38,15,54
Ballymena,664,4,14,9,7,65,49,16,51
Coleraine,664,5,10,9,11,40,44,-4,39
Ards,664,6,10,7,13,41,49,-8,37
Glenavon,664,7,9,9,12,42,61,-19,36
Ballinamalla,664,8,9,6,15,31,50,-19,33
Glentoran,664,9,7,10,13,32,46,-14,31
Dungannon,664,10,7,8,15,44,49,-5,29
Portadown,664,11,6,7,17,25,46,-21,25
Cliftonville,665,1,19,4,7,59,35,24,61
Crusaders,665,2,17,6,7,57,38,19,57
Linfield,665,3,15,10,5,62,34,28,55
Coleraine,665,4,13,9,8,50,36,14,48
Dungannon,665,5,14,6,10,49,41,8,48
Glenavon,665,6,11,10,9,49,47,2,43
Ballymena,665,7,12,7,11,50,56,-6,43
Glentoran,665,8,9,5,16,29,44,-15,32
Portadown,665,9,6,8,16,24,45,-21,26
Ards,665,10,6,5,19,31,50,-19,23
Ballinamalla,665,11,7,2,21,29,63,-34,23
Linfield,666,1,17,8,5,64,29,35,59
Crusaders,666,2,16,6,8,56,39,17,54
Cliftonville,666,3,15,4,11,54,42,12,49
Ballymena,666,4,14,5,11,51,55,-4,47
Glenavon,666,5,11,11,8,47,43,4,44
Dungannon,666,6,11,10,9,51,36,15,43
Coleraine,666,7,11,9,10,48,45,3,42
Glentoran,666,8,10,5,15,34,51,-17,35
Ards,666,9,9,3,18,35,52,-17,30
Portadown,666,10,7,7,16,26,48,-22,28
Ballinamalla,666,11,8,4,18,29,55,-26,28
Crusaders,667,1,17,7,6,53,31,22,58
Cliftonville,667,2,16,7,7,65,43,22,55
Ballymena,667,3,16,5,9,65,54,11,53
Coleraine,667,4,12,11,7,47,39,8,47
Glenavon,667,5,10,12,8,46,46,0,42
Linfield,667,6,10,8,12,53,41,12,38
Dungannon,667,7,9,11,10,51,50,1,38
Ards,667,8,10,5,15,36,48,-12,35
Ballinamalla,667,9,9,6,15,29,44,-15,33
Glentoran,667,10,7,7,16,27,52,-25,28
Portadown,667,11,7,5,18,28,52,-24,26
Crusaders,668,1,20,4,6,59,35,24,64
Linfield,668,2,16,8,6,65,31,34,56
Glenavon,668,3,14,8,8,47,37,10,50
Cliftonville,668,4,14,5,11,52,45,7,47
Dungannon,668,5,12,8,10,50,39,11,44
Coleraine,668,6,11,9,10,42,41,1,42
Ballymena,668,7,11,9,10,49,55,-6,42
Ards,668,8,9,4,17,41,56,-15,31
Glentoran,668,9,7,9,14,24,41,-17,30
Portadown,668,10,7,7,16,23,45,-22,28
Ballinamalla,668,11,7,3,20,25,52,-27,24
Linfield,669,1,16,8,6,61,27,34,56
Coleraine,669,2,13,12,5,46,37,9,51
Crusaders,669,3,13,9,8,49,40,9,48
Cliftonville,669,4,14,5,11,55,42,13,47
Glenavon,669,5,11,10,9,49,42,7,43
Ballymena,669,6,11,10,9,54,57,-3,43
Ballinamalla,669,7,12,6,12,37,43,-6,42
Dungannon,669,8,10,10,10,45,40,5,40
Glentoran,669,9,7,10,13,25,40,-15,31
Ards,669,10,6,8,16,29,54,-25,26
Portadown,669,11,6,4,20,23,51,-28,22
Crusaders,670,1,15,11,4,55,29,26,56
Linfield,670,2,15,9,6,59,32,27,54
Ballymena,670,3,15,6,9,60,51,9,51
Cliftonville,670,4,15,5,10,50,41,9,50
Glentoran,670,5,11,9,10,30,36,-6,42
Ards,670,6,12,5,13,42,46,-4,41
Glenavon,670,7,10,10,10,50,47,3,40
Dungannon,670,8,9,11,10,43,45,-2,38
Coleraine,670,9,9,11,10,44,49,-5,38
Portadown,670,10,5,8,17,22,41,-19,23
Ballinamalla,670,11,4,5,21,19,57,-38,17
Crusaders,671,1,18,7,5,56,34,22,61
Linfield,671,2,16,9,5,62,31,31,57
Cliftonville,671,3,15,6,9,55,38,17,51
Dungannon,671,4,14,8,8,54,36,18,50
Glenavon,671,5,12,11,7,45,42,3,47
Ballymena,671,6,12,5,13,51,59,-8,41
Coleraine,671,7,7,12,11,37,47,-10,33
Ards,671,8,9,4,17,35,50,-15,31
Glentoran,671,9,8,6,16,28,49,-21,30
Ballinamalla,671,10,7,8,15,39,54,-15,29
Portadown,671,11,6,6,18,23,45,-22,24
Cliftonville,672,1,19,4,7,58,34,24,61
Crusaders,672,2,17,7,6,59,39,20,58
Linfield,672,3,15,8,7,58,34,24,53
Ballymena,672,4,13,6,11,55,53,2,45
Coleraine,672,5,11,8,11,42,41,1,41
Ballinamalla,672,6,12,3,15,36,47,-11,39
Glenavon,672,7,9,11,10,47,52,-5,38
Glentoran,672,8,10,7,13,28,40,-12,37
Dungannon,672,9,9,8,13,48,47,1,35
Ards,672,10,9,3,18,37,53,-16,30
Portadown,672,11,6,5,19,25,53,-28,23
Crusaders,673,1,17,8,5,57,30,27,59
Linfield,673,2,13,13,4,58,31,27,52
Ballymena,673,3,14,8,8,53,49,4,50
Cliftonville,673,4,14,7,9,59,44,15,49
Glenavon,673,5,13,10,7,47,37,10,49
Coleraine,673,6,12,11,7,41,31,10,47
Dungannon,673,7,9,11,10,45,42,3,38
Ards,673,8,9,5,16,39,53,-14,32
Portadown,673,9,8,5,17,27,52,-25,29
Glentoran,673,10,6,7,17,25,50,-25,25
Ballinamalla,673,11,5,5,20,27,59,-32,20
Cliftonville,674,1,18,6,6,60,35,25,60
Linfield,674,2,15,10,5,59,29,30,55
Crusaders,674,3,15,7,8,52,37,15,52
Ballymena,674,4,14,5,11,58,58,0,47
Glenavon,674,5,12,7,11,47,51,-4,43
Coleraine,674,6,11,9,10,42,39,3,42
Glentoran,674,7,11,7,12,30,36,-6,40
Dungannon,674,8,8,11,11,50,46,4,35
Portadown,674,9,9,5,16,34,46,-12,32
Ballinamalla,674,10,9,1,20,22,52,-30,28
Ards,674,11,6,6,18,29,54,-25,24
Crusaders,675,1,16,11,3,57,33,24,59
Glenavon,675,2,14,11,5,54,39,15,53
Cliftonville,675,3,16,4,10,59,41,18,52
Coleraine,675,4,12,9,9,40,33,7,45
Linfield,675,5,12,8,10,52,35,17,44
Ballymena,675,6,13,5,12,54,59,-5,44
Dungannon,675,7,11,9,10,54,47,7,42
Glentoran,675,8,8,9,13,30,44,-14,33
Ards,675,9,8,7,15,32,46,-14,31
Ballinamalla,675,10,8,4,18,26,49,-23,28
Portadown,675,11,6,5,19,20,52,-32,23
Crusaders,676,1,16,8,6,56,33,23,56
Linfield,676,2,15,10,5,64,29,35,55
Cliftonville,676,3,14,3,13,50,47,3,45
Coleraine,676,4,12,9,9,48,46,2,45
Ballymena,676,5,12,9,9,50,52,-2,45
Glenavon,676,6,11,11,8,49,44,5,44
Ards,676,7,12,4,14,39,45,-6,40
Glentoran,676,8,9,9,12,34,44,-10,36
Portadown,676,9,9,5,16,29,48,-19,32
Dungannon,676,10,7,10,13,51,50,1,31
Ballinamalla,676,11,8,2,20,27,59,-32,26
Ballymena,677,1,16,7,7,60,55,5,55
Crusaders,677,2,15,8,7,60,38,22,53
Cliftonville,677,3,15,5,10,56,43,13,50
Linfield,677,4,13,10,7,55,35,20,49
Glenavon,677,5,12,10,8,47,38,9,46
Dungannon,677,6,10,9,11,46,39,7,39
Coleraine,677,7,10,8,12,41,40,1,38
Ballinamalla,677,8,11,3,16,33,51,-18,36
Ards,677,9,10,4,16,41,53,-12,34
Portadown,677,10,7,8,15,29,48,-19,29
Glentoran,677,11,6,8,16,25,53,-28,26
Crusaders,678,1,17,6,7,57,36,21,57
Coleraine,678,2,15,11,4,43,25,18,56
Ballymena,678,3,15,4,11,58,60,-2,49
Glenavon,678,4,13,9,8,50,43,7,48
Linfield,678,5,12,10,8,53,30,23,46
Dungannon,678,6,11,10,9,54,38,16,43
Cliftonville,678,7,13,4,13,46,42,4,43
Portadown,678,8,10,4,16,25,46,-21,34
Glentoran,678,9,7,7,16,26,54,-28,28
Ards,678,10,7,6,17,37,54,-17,27
Ballinamalla,678,11,8,3,19,36,57,-21,27
Linfield,679,1,21,6,3,74,30,44,69
Crusaders,679,2,18,5,7,61,30,31,59
Glenavon,679,3,13,10,7,52,45,7,49
Cliftonville,679,4,13,5,12,46,44,2,44
Coleraine,679,5,11,10,9,49,39,10,43
Ballymena,679,6,12,6,12,54,62,-8,42
Ards,679,7,12,4,14,43,52,-9,40
Glentoran,679,8,8,7,15,25,45,-20,31
Dungannon,679,9,7,9,14,44,51,-7,30
Portadown,679,10,8,5,17,29,49,-20,29
Ballinamalla,679,11,6,5,19,23,53,-30,23
Coleraine,680,1,16,9,5,52,33,19,57
Crusaders,680,2,16,8,6,54,37,17,56
Cliftonville,680,3,15,5,10,53,38,15,50
Linfield,680,4,11,12,7,58,38,20,45
Ballymena,680,5,13,6,11,62,65,-3,45
Glenavon,680,6,10,12,8,46,51,-5,42
Dungannon,680,7,10,8,12,52,43,9,38
Ards,680,8,9,7,14,35,46,-11,34
Portadown,680,9,9,5,16,33,47,-14,32
Glentoran,680,10,5,11,14,25,45,-20,26
Ballinamalla,680,11,5,9,16,24,51,-27,24
Crusaders,681,1,15,8,7,53,41,12,53
Linfield,681,2,14,10,6,56,33,23,52
Cliftonville,681,3,15,6,9,59,38,21,51
Glenavon,681,4,13,10,7,55,44,11,49
Ballymena,681,5,14,6,10,58,57,1,48
Dungannon,681,6,11,8,11,53,42,11,41
Coleraine,681,7,9,11,10,35,37,-2,38
Ards,681,8,11,5,14,32,39,-7,38
Glentoran,681,9,10,8,12,29,36,-7,38
Ballinamalla,681,10,6,6,18,26,52,-26,24
Portadown,681,11,6,4,20,24,61,-37,22
Crusaders,682,1,18,6,6,59,33,26,60
Cliftonville,682,2,17,4,9,56,37,19,55
Glenavon,682,3,12,10,8,48,39,9,46
Linfield,682,4,12,9,9,60,39,21,45
Coleraine,682,5,11,9,10,44,45,-1,42
Ballymena,682,6,12,5,13,55,65,-10,41
Dungannon,682,7,9,10,11,44,45,-1,37
Glentoran,682,8,9,7,14,30,43,-13,34
Portadown,682,9,8,8,14,28,48,-20,32
Ards,682,10,8,7,15,34,47,-13,31
Ballinamalla,682,11,7,9,14,26,43,-17,30
Crusaders,683,1,18,6,6,54,29,25,60
Linfield,683,2,15,8,7,59,33,26,53
Cliftonville,683,3,15,7,8,53,40,13,52
Glenavon,683,4,11,13,6,53,44,9,46
Coleraine,683,5,10,12,8,49,41,8,42
Ballymena,683,6,12,6,12,50,60,-10,42
Dungannon,683,7,9,12,9,52,45,7,39
Glentoran,683,8,8,9,13,26,37,-11,33
Ballinamalla,683,9,10,3,17,25,44,-19,33
Ards,683,10,7,7,16,33,48,-15,28
Portadown,683,11,6,5,19,23,56,-33,23
Crusaders,684,1,17,8,5,62,36,26,59
Linfield,684,2,16,8,6,62,33,29,56
Ballymena,684,3,15,5,10,59,53,6,50
Coleraine,684,4,12,10,8,44,39,5,46
Glenavon,684,5,11,11,8,56,52,4,44
Dungannon,684,6,11,9,10,44,42,2,42
Cliftonville,684,7,11,5,14,47,52,-5,38
Glentoran,684,8,8,8,14,28,45,-17,32
Ards,684,9,9,3,18,37,51,-14,30
Portadown,684,10,8,6,16,29,44,-15,30
Ballinamalla,684,11,7,7,16,31,52,-21,28
Cliftonville,685,1,16,6,8,49,34,15,54
Linfield,685,2,14,7,9,59,39,20,49
Coleraine,685,3,11,14,5,46,35,11,47
Crusaders,685,4,12,10,8,45,37,8,46
Glenavon,685,5,10,13,7,50,47,3,43
Ballymena,685,6,11,10,9,55,62,-7,43
Ards,685,7,10,6,14,37,43,-6,36
Portadown,685,8,10,5,15,33,44,-11,35
Glentoran,685,9,7,13,10,28,35,-7,34
Dungannon,685,10,8,9,13,46,51,-5,33
Ballinamalla,685,11,6,7,17,26,47,-21,25
Crusaders,686,1,16,8,6,57,42,15,56
Linfield,686,2,16,7,7,70,37,33,55
Cliftonville,686,3,16,5,9,52,38,14,53
Glenavon,686,4,12,13,5,48,38,10,49
Ballymena,686,5,14,7,9,63,60,3,49
Coleraine,686,6,9,13,8,39,38,1,40
Dungannon,686,7,9,8,13,47,42,5,35
Portadown,686,8,8,7,15,26,43,-17,31
Glentoran,686,9,6,11,13,29,48,-19,29
Ards,686,10,6,9,15,36,55,-19,27
Ballinamalla,686,11,7,4,19,30,56,-26,25
Crusaders,687,1,15,8,7,52,36,16,53
Glenavon,687,2,14,9,7,47,41,6,51
Linfield,687,3,13,9,8,54,32,22,48
Cliftonville,687,4,14,6,10,53,35,18,48
Ballymena,687,5,14,6,10,50,51,-1,48
Coleraine,687,6,11,11,8,39,39,0,44
Dungannon,687,7,10,8,12,46,39,7,38
Glentoran,687,8,9,8,13,29,40,-11,35
Ards,687,9,9,5,16,30,45,-15,32
Portadown,687,10,7,8,15,21,38,-17,29
Ballinamalla,687,11,8,4,18,31,56,-25,28
Crusaders,688,1,17,7,6,58,29,29,58
Cliftonville,688,2,14,7,9,47,38,9,49
Coleraine,688,3,12,12,6,48,39,9,48
Ballymena,688,4,13,9,8,54,47,7,48
Glenavon,688,5,10,12,8,43,43,0,42
Linfield,688,6,10,10,10,51,39,12,40
Ards,688,7,11,4,15,41,47,-6,37
Glentoran,688,8,10,7,13,24,39,-15,37
Dungannon,688,9,8,11,11,47,45,2,35
Ballinamalla,688,10,9,6,15,27,48,-21,33
Portadown,688,11,5,7,18,22,48,-26,22
Crusaders,689,1,19,6,5,58,34,24,63
Cliftonville,689,2,15,6,9,58,42,16,51
Ballymena,689,3,15,6,9,61,56,5,51
Linfield,689,4,14,8,8,59,39,20,50
Glenavon,689,5,11,10,9,54,51,3,43
Dungannon,689,6,11,8,11,58,51,7,41
Glentoran,689,7,11,8,11,39,42,-3,41
Ards,689,8,9,6,15,43,53,-10,33
Coleraine,689,9,8,8,14,35,49,-14,32
Portadown,689,10,9,5,16,30,47,-17,32
Ballinamalla,689,11,5,5,20,30,61,-31,20
Crusaders,690,1,21,5,4,61,26,35,68
Linfield,690,2,13,11,6,61,32,29,50
Cliftonville,690,3,14,7,9,51,39,12,49
Dungannon,690,4,11,11,8,57,46,11,44
Ballymena,690,5,12,8,10,58,60,-2,44
Glenavon,690,6,11,11,8,46,49,-3,44
Coleraine,690,7,10,12,8,44,39,5,42
Ards,690,8,7,8,15,34,49,-15,29
Glentoran,690,9,7,8,15,27,45,-18,29
Portadown,690,10,6,7,17,20,46,-26,25
Ballinamalla,690,11,7,4,19,29,57,-28,25
Crusaders,691,1,17,8,5,54,33,21,59
Cliftonville,691,2,15,6,9,56,46,10,51
Ballymena,691,3,15,6,9,64,56,8,51
Linfield,691,4,13,9,8,58,37,21,48
Glenavon,691,5,12,12,6,55,42,13,48
Dungannon,691,6,10,11,9,45,43,2,41
Coleraine,691,7,9,11,10,47,45,2,38
Portadown,691,8,9,7,14,23,40,-17,34
Glentoran,691,9,8,6,16,36,51,-15,30
Ards,691,10,7,9,14,32,47,-15,30
Ballinamalla,691,11,4,7,19,30,60,-30,19
Linfield,692,1,16,10,4,64,33,31,58
Crusaders,692,2,16,7,7,54,37,17,55
Cliftonville,692,3,15,5,10,59,44,15,50
Glenavon,692,4,11,11,8,50,45,5,44
Ballymena,692,5,12,5,13,57,71,-14,41
Coleraine,692,6,9,12,9,45,44,1,39
Dungannon,692,7,8,14,8,52,46,6,38
Ards,692,8,10,7,13,43,47,-4,37
Ballinamalla,692,9,9,7,14,33,48,-15,34
Glentoran,692,10,8,7,15,34,49,-15,31
Portadown,692,11,5,7,18,23,50,-27,22
Crusaders,693,1,20,6,4,61,28,33,66
Linfield,693,2,15,10,5,58,31,27,55
Cliftonville,693,3,15,4,11,52,41,11,49
Glenavon,693,4,13,10,7,52,42,10,49
Coleraine,693,5,10,12,8,40,35,5,42
Dungannon,693,6,11,8,11,49,46,3,41
Ballymena,693,7,11,8,11,53,61,-8,41
Portadown,693,8,10,4,16,28,42,-14,34
Ballinamalla,693,9,8,5,17,28,52,-24,29
Glentoran,693,10,6,8,16,28,51,-23,26
Ards,693,11,5,7,18,34,54,-20,22
Linfield,694,1,18,7,5,68,27,41,61
Crusaders,694,2,16,8,6,55,37,18,56
Cliftonville,694,3,16,6,8,55,36,19,54
Ballymena,694,4,10,11,9,54,58,-4,41
Glenavon,694,5,10,10,10,44,44,0,40
Coleraine,694,6,9,12,9,35,41,-6,39
Glentoran,694,7,10,8,12,30,42,-12,38
Portadown,694,8,9,5,16,27,46,-19,32
Ballinamalla,694,9,9,4,17,35,48,-13,31
Dungannon,694,10,7,9,14,49,54,-5,30
Ards,694,11,8,6,16,31,50,-19,30
Crusaders,695,1,16,7,7,47,33,14,55
Linfield,695,2,13,12,5,52,33,19,51
Glentoran,695,3,15,6,9,39,35,4,51
Cliftonville,695,4,14,6,10,50,37,13,48
Coleraine,695,5,13,9,8,46,35,11,48
Ballymena,695,6,14,6,10,58,53,5,48
Glenavon,695,7,11,11,8,50,46,4,44
Dungannon,695,8,11,6,13,53,53,0,39
Ards,695,9,7,6,17,31,49,-18,27
Portadown,695,10,6,5,19,28,52,-24,23
Ballinamalla,695,11,6,4,20,26,54,-28,22
Crusaders,696,1,17,8,5,56,30,26,59
Cliftonville,696,2,15,7,8,47,33,14,52
Ballymena,696,3,15,5,10,59,54,5,50
Linfield,696,4,11,13,6,58,37,21,46
Coleraine,696,5,10,11,9,39,39,0,41
Glenavon,696,6,10,10,10,46,46,0,40
Dungannon,696,7,10,9,11,46,40,6,39
Glentoran,696,8,9,9,12,34,44,-10,36
Portadown,696,9,9,6,15,26,45,-19,33
Ards,696,10,8,5,17,35,51,-16,29
Ballinamalla,696,11,7,5,18,31,58,-27,26
Linfield,697,1,16,10,4,67,25,42,58
Ballymena,697,2,15,7,8,68,63,5,52
Glenavon,697,3,14,9,7,52,42,10,51
Coleraine,697,4,13,7,10,42,43,-1,46
Cliftonville,697,5,13,5,12,55,46,9,44
Crusaders,697,6,10,8,12,47,45,2,38
Dungannon,697,7,9,10,11,45,40,5,37
Glentoran,697,8,10,7,13,31,46,-15,37
Ards,697,9,9,8,13,38,45,-7,35
Ballinamalla,697,10,9,3,18,26,53,-27,30
Portadown,697,11,7,6,17,27,50,-23,27
Cliftonville,698,1,17,5,8,54,38,16,56
Glenavon,698,2,15,7,8,54,43,11,52
Crusaders,698,3,15,5,10,56,38,18,50
Linfield,698,4,13,8,9,61,39,22,47
Coleraine,698,5,12,10,8,45,40,5,46
Ballymena,698,6,13,7,10,57,56,1,46
Dungannon,698,7,11,8,11,51,48,3,41
Ards,698,8,11,6,13,45,48,-3,39
Glentoran,698,9,9,9,12,30,39,-9,36
Ballinamalla,698,10,7,4,19,26,57,-31,25
Portadown,698,11,5,5,20,20,53,-33,20
Crusaders,699,1,18,8,4,53,23,30,62
Cliftonville,699,2,15,5,10,55,43,12,50
Coleraine,699,3,12,12,6,47,38,9,48
Linfield,699,4,11,12,7,54,37,17,45
Ballymena,699,5,12,8,10,56,56,0,44
Ards,699,6,10,7,13,37,42,-5,37
Dungannon,699,7,8,12,10,45,44,1,36
Glenavon,699,8,9,9,12,48,54,-6,36
Glentoran,699,9,7,11,12,31,47,-16,32
Ballinamalla,699,10,8,6,16,35,52,-17,30
Portadown,699,11,6,8,16,24,49,-25,26
Crusaders,700,1,15,11,4,56,35,21,56
Cliftonville,700,2,14,9,7,49,38,11,51
Dungannon,700,3,14,7,9,57,43,14,49
Linfield,700,4,12,9,9,59,40,19,45
Coleraine,700,5,10,11,9,40,39,1,41
Glenavon,700,6,11,7,12,54,52,2,40
Ards,700,7,9,9,12,40,46,-6,36
Glentoran,700,8,8,11,11,31,44,-13,35
Ballymena,700,9,9,7,14,48,64,-16,34
Portadown,700,10,8,7,15,29,44,-15,31
Ballinamalla,700,11,8,6,16,31,49,-18,30
Crusaders,701,1,19,5,6,66,40,26,62
Linfield,701,2,15,8,7,58,28,30,53
Cliftonville,701,3,14,8,8,48,37,11,50
Ballymena,701,4,14,5,11,61,65,-4,47
Glenavon,701,5,11,12,7,47,39,8,45
Coleraine,701,6,11,9,10,42,41,1,42
Dungannon,701,7,9,9,12,51,48,3,36
Ards,701,8,11,2,17,38,50,-12,35
Glentoran,701,9,8,8,14,30,48,-18,32
Ballinamalla,701,10,9,3,18,30,52,-22,30
Portadown,701,11,7,5,18,26,49,-23,26
Linfield,702,1,15,9,6,65,40,25,54
Crusaders,702,2,15,8,7,56,35,21,53
Ballymena,702,3,14,8,8,53,50,3,50
Glenavon,702,4,11,12,7,48,41,7,45
Dungannon,702,5,10,12,8,55,44,11,42
Cliftonville,702,6,11,7,12,40,42,-2,40
Coleraine,702,7,9,10,11,41,41,0,37
Ards,702,8,10,7,13,36,43,-7,37
Portadown,702,9,7,10,13,26,44,-18,31
Glentoran,702,10,7,9,14,23,41,-18,30
Ballinamalla,702,11,7,6,17,25,47,-22,27
Ballymena,703,1,17,4,9,62,53,9,55
Linfield,703,2,14,10,6,56,28,28,52
Glenavon,703,3,13,11,6,49,39,10,50
Cliftonville,703,4,14,7,9,51,39,12,49
Crusaders,703,5,14,6,10,55,51,4,48
Coleraine,703,6,11,12,7,45,37,8,45
Dungannon,703,7,9,8,13,52,48,4,35
Portadown,703,8,10,5,15,29,43,-14,35
Ballinamalla,703,9,9,4,17,41,53,-12,31
Glentoran,703,10,7,9,14,24,45,-21,30
Ards,703,11,7,4,19,28,56,-28,25
Crusaders,704,1,19,6,5,69,33,36,63
Coleraine,704,2,15,8,7,49,32,17,53
Cliftonville,704,3,15,7,8,53,37,16,52
Linfield,704,4,14,9,7,57,34,23,51
Dungannon,704,5,12,8,10,52,44,8,44
Ballymena,704,6,12,8,10,52,65,-13,44
Glenavon,704,7,9,10,11,43,49,-6,37
Ards,704,8,10,4,16,34,42,-8,34
Glentoran,704,9,6,9,15,24,49,-25,27
Ballinamalla,704,10,8,3,19,27,56,-29,27
Portadown,704,11,7,4,19,28,47,-19,25
Linfield,705,1,16,10,4,62,24,38,58
Crusaders,705,2,14,7,9,47,39,8,49
Ballymena,705,3,13,9,8,55,56,-1,48
Cliftonville,705,4,12,9,9,46,36,10,45
Coleraine,705,5,10,14,6,40,36,4,44
Dungannon,705,6,11,10,9,61,45,16,43
Glenavon,705,7,10,10,10,53,52,1,40
Glentoran,705,8,9,8,13,30,50,-20,35
Portadown,705,9,8,8,14,30,43,-13,32
Ards,705,10,8,7,15,30,43,-13,31
Ballinamalla,705,11,6,4,20,21,51,-30,22
Linfield,706,1,16,10,4,65,31,34,58
Cliftonville,706,2,16,6,8,59,36,23,54
Crusaders,706,3,15,7,8,54,39,15,52
Glenavon,706,4,13,12,5,56,45,11,51
Coleraine,706,5,10,11,9,40,41,-1,41
Dungannon,706,6,10,10,10,48,42,6,40
Ballymena,706,7,11,7,12,49,60,-11,40
Glentoran,706,8,10,6,14,36,44,-8,36
Ballinamalla,706,9,9,4,17,35,52,-17,31
Portadown,706,10,6,7,17,22,49,-27,25
Ards,706,11,6,6,18,29,54,-25,24
Linfield,707,1,16,8,6,58,26,32,56
Crusaders,707,2,15,9,6,56,37,19,54
Glenavon,707,3,12,10,8,48,47,1,46
Cliftonville,707,4,13,6,11,51,45,6,45
Ballymena,707,5,13,6,11,66,65,1,45
Coleraine,707,6,10,13,7,43,39,4,43
Glentoran,707,7,9,9,12,29,40,-11,36
Dungannon,707,8,7,11,12,40,40,0,32
Ballinamalla,707,9,8,8,14,28,48,-20,32
Portadown,707,10,9,5,16,27,47,-20,32
Ards,707,11,6,9,15,31,43,-12,27
Crusaders,708,1,17,9,4,56,31,25,60
Cliftonville,708,2,18,4,8,64,38,26,58
Linfield,708,3,16,9,5,66,29,37,57
Ballymena,708,4,14,4,12,64,65,-1,46
Coleraine,708,5,10,10,10,42,41,1,40
Glentoran,708,6,10,8,12,32,41,-9,38
Glenavon,708,7,9,8,13,37,53,-16,35
Ballinamalla,708,8,10,5,15,35,54,-19,35
Dungannon,708,9,8,8,14,42,48,-6,32
Ards,708,10,9,3,18,39,54,-15,30
Portadown,708,11,9,2,19,31,54,-23,29
Cliftonville,709,1,19,4,7,57,38,19,61
Crusaders,709,2,14,12,4,52,31,21,54
Linfield,709,3,14,11,5,58,33,25,53
Ballymena,709,4,13,8,9,61,56,5,47
Coleraine,709,5,12,10,8,43,31,12,46
Dungannon,709,6,11,9,10,52,45,7,42
Glenavon,709,7,9,13,8,49,48,1,40
Ards,709,8,10,6,14,39,46,-7,36
Glentoran,709,9,6,10,14,33,55,-22,28
Portadown,709,10,6,5,19,26,48,-22,23
Ballinamalla,709,11,4,6,20,26,65,-39,18
Crusaders,710,1,16,6,8,59,38,21,54
Ballymena,710,2,15,5,10,56,56,0,50
Linfield,710,3,13,10,7,57,36,21,49
Glenavon,710,4,12,12,6,52,41,11,48
Cliftonville,710,5,13,7,10,51,41,10,46
Dungannon,710,6,12,9,9,51,38,13,45
Coleraine,710,7,11,12,7,40,41,-1,45
Ballinamalla,710,8,9,4,17,34,50,-16,31
Ards,710,9,8,5,17,32,48,-16,29
Portadown,710,10,8,5,17,19,43,-24,29
Glentoran,710,11,6,9,15,24,43,-19,27
Glenavon,711,1,16,9,5,53,33,20,57
Cliftonville,711,2,17,5,8,53,36,17,56
Crusaders,711,3,14,8,8,52,32,20,50
Coleraine,711,4,13,10,7,53,43,10,49
Linfield,711,5,12,12,6,56,34,22,48
Ballymena,711,6,12,8,10,59,61,-2,44
Glentoran,711,7,9,11,10,34,43,-9,38
Dungannon,711,8,9,10,11,47,49,-2,37
Ards,711,9,11,3,16,42,56,-14,36
Ballinamalla,711,10,6,4,20,38,66,-28,22
Portadown,711,11,5,2,23,19,53,-34,17
Crusaders,712,1,17,6,7,59,37,22,57
Linfield,712,2,15,7,8,55,30,25,52
Glenavon,712,3,14,10,6,52,39,13,52
Cliftonville,712,4,15,5,10,50,40,10,50
Dungannon,712,5,13,7,10,65,39,26,46
Ballymena,712,6,12,9,9,58,62,-4,45
Glentoran,712,7,11,7,12,30,44,-14,40
Coleraine,712,8,8,10,12,33,39,-6,34
Ards,712,9,8,8,14,34,45,-11,32
Portadown,712,10,7,4,19,21,49,-28,25
Ballinamalla,712,11,5,7,18,24,57,-33,22
Crusaders,713,1,18,7,5,59,38,21,61
Coleraine,713,2,11,14,5,44,32,12,47
Linfield,713,3,13,7,10,50,38,12,46
Ards,713,4,13,5,12,47,45,2,44
Ballymena,713,5,12,8,10,56,58,-2,44
Glenavon,713,6,11,10,9,47,43,4,43
Cliftonville,713,7,11,5,14,46,49,-3,38
Glentoran,713,8,10,7,13,33,42,-9,37
Portadown,713,9,11,3,16,27,44,-17,36
Dungannon,713,10,7,11,12,48,45,3,32
Ballinamalla,713,11,6,7,17,28,51,-23,25
Crusaders,714,1,21,7,2,66,32,34,70
Linfield,714,2,14,8,8,61,32,29,50
Glenavon,714,3,11,13,6,48,44,4,46
Cliftonville,714,4,13,6,11,55,46,9,45
Ballymena,714,5,12,7,11,54,61,-7,43
Coleraine,714,6,9,14,7,45,45,0,41
Ards,714,7,11,5,14,43,49,-6,38
Dungannon,714,8,8,11,11,48,53,-5,35
Portadown,714,9,10,5,15,34,45,-11,35
Glentoran,714,10,6,8,16,28,51,-23,26
Ballinamalla,714,11,7,2,21,26,50,-24,23
Crusaders,715,1,19,7,4,63,30,33,64
Linfield,715,2,17,6,7,65,39,26,57
Cliftonville,715,3,17,4,9,60,43,17,55
Ballymena,715,4,13,7,10,59,58,1,46
Coleraine,715,5,11,10,9,49,43,6,43
Glenavon,715,6,11,9,10,45,47,-2,42
Glentoran,715,7,10,7,13,35,46,-11,37
Dungannon,715,8,8,10,12,48,54,-6,34
Ards,715,9,8,7,15,34,48,-14,31
Ballinamalla,715,10,7,4,19,29,53,-24,25
Portadown,715,11,4,9,17,29,55,-26,21
Crusaders,716,1,16,9,5,55,29,26,57
Cliftonville,716,2,17,6,7,60,37,23,57
Linfield,716,3,13,9,8,62,43,19,48
Ballymena,716,4,13,6,11,56,55,1,45
Glenavon,716,5,12,7,11,47,47,0,43
Coleraine,716,6,10,12,8,43,43,0,42
Glentoran,716,7,11,7,12,40,43,-3,40
Dungannon,716,8,8,11,11,46,46,0,35
Ards,716,9,7,8,15,35,50,-15,29
Portadown,716,10,8,5,17,25,51,-26,29
Ballinamalla,716,11,7,6,17,27,52,-25,27
Crusaders,717,1,16,10,4,60,37,23,58
Linfield,717,2,15,7,8,61,42,19,52
Dungannon,717,3,13,9,8,58,39,19,48
Cliftonville,717,4,14,6,10,58,47,11,48
Ballymena,717,5,13,7,10,55,53,2,46
Glenavon,717,6,10,11,9,48,44,4,41
Portadown,717,7,12,4,14,36,43,-7,40
Coleraine,717,8,10,9,11,41,50,-9,39
Glentoran,717,9,10,6,14,38,43,-5,36
Ards,717,10,8,2,20,33,62,-29,26
Ballinamalla,717,11,6,5,19,27,55,-28,23
Crusaders,718,1,19,7,4,67,31,36,64
Cliftonville,718,2,18,3,9,58,39,19,57
Ballymena,718,3,15,4,11,51,55,-4,49
Coleraine,718,4,12,10,8,40,37,3,46
Linfield,718,5,12,8,10,57,40,17,44
Portadown,718,6,12,4,14,32,41,-9,40
Dungannon,718,7,9,11,10,53,43,10,38
Glenavon,718,8,8,12,10,42,52,-10,36
Ards,718,9,8,7,15,37,48,-11,31
Glentoran,718,10,7,6,17,28,52,-24,27
Ballinamalla,718,11,6,6,18,25,52,-27,24
Cliftonville,719,1,17,4,9,60,38,22,55
Crusaders,719,2,16,7,7,52,33,19,55
Glenavon,719,3,14,12,4,51,36,15,54
Linfield,719,4,15,6,9,59,35,24,51
Ballymena,719,5,16,3,11,63,59,4,51
Coleraine,719,6,11,11,8,39,36,3,44
Dungannon,719,7,9,8,13,43,45,-2,35
Ballinamalla,719,8,8,6,16,29,50,-21,30
Ards,719,9,8,5,17,38,52,-14,29
Glentoran,719,10,8,5,17,27,54,-27,29
Portadown,719,11,8,3,19,29,52,-23,27
Crusaders,720,1,17,9,4,56,33,23,60
Cliftonville,720,2,17,5,8,55,36,19,56
Linfield,720,3,15,10,5,63,32,31,55
Ballymena,720,4,15,4,11,63,58,5,49
Coleraine,720,5,11,10,9,42,35,7,43
Glenavon,720,6,12,7,11,43,44,-1,43
Glentoran,720,7,11,5,14,30,47,-17,38
Dungannon,720,8,7,10,13,46,49,-3,31
Ards,720,9,7,8,15,30,45,-15,29
Ballinamalla,720,10,7,6,17,28,52,-24,27
Portadown,720,11,5,8,17,24,49,-25,23
Crusaders,721,1,16,8,6,51,27,24,56
Glenavon,721,2,12,13,5,58,42,16,49
Linfield,721,3,13,7,10,53,38,15,46
Cliftonville,721,4,14,4,12,52,45,7,46
Ballymena,721,5,13,5,12,55,54,1,44
Glentoran,721,6,13,4,13,32,38,-6,43
Dungannon,721,7,10,10,10,48,43,5,40
Coleraine,721,8,10,9,11,43,45,-2,39
Ards,721,9,11,6,13,41,51,-10,39
Portadown,721,10,9,5,16,26,43,-17,32
Ballinamalla,721,11,7,3,20,25,58,-33,24
Cliftonville,722,1,16,4,10,46,36,10,52
Linfield,722,2,14,9,7,63,33,30,51
Crusaders,722,3,14,8,8,54,40,14,50
Glenavon,722,4,13,10,7,50,42,8,49
Dungannon,722,5,13,9,8,55,41,14,48
Coleraine,722,6,13,9,8,45,40,5,48
Ards,722,7,10,5,15,40,48,-8,35
Ballymena,722,8,8,10,12,56,72,-16,34
Glentoran,722,9,7,11,12,36,50,-14,32
Portadown,722,10,8,5,17,21,44,-23,29
Ballinamalla,722,11,6,6,18,28,48,-20,24
Coleraine,723,1,15,10,5,52,34,18,55
Ballymena,723,2,16,7,7,59,52,7,55
Crusaders,723,3,15,9,6,58,40,18,54
Linfield,723,4,15,8,7,57,35,22,53
Glenavon,723,5,14,10,6,48,37,11,52
Cliftonville,723,6,14,5,11,47,39,8,47
Dungannon,723,7,8,13,9,49,44,5,37
Glentoran,723,8,7,8,15,30,45,-15,29
Ards,723,9,6,7,17,30,54,-24,25
Ballinamalla,723,10,5,7,18,28,55,-27,22
Portadown,723,11,5,6,19,25,48,-23,21
Ballymena,724,1,19,4,7,60,45,15,61
Crusaders,724,2,17,9,4,60,32,28,60
Linfield,724,3,14,10,6,55,31,24,52
Coleraine,724,4,13,10,7,44,31,13,49
Cliftonville,724,5,14,7,9,46,37,9,49
Glenavon,724,6,10,11,9,47,50,-3,41
Dungannon,724,7,9,10,11,54,47,7,37
Glentoran,724,8,8,9,13,31,45,-14,33
Ards,724,9,8,4,18,31,51,-20,28
Portadown,724,10,6,4,20,23,53,-30,22
Ballinamalla,724,11,4,8,18,27,56,-29,20
Crusaders,725,1,16,6,8,53,31,22,54
Linfield,725,2,15,8,7,57,30,27,53
Coleraine,725,3,14,8,8,43,32,11,50
Ballymena,725,4,15,5,10,63,58,5,50
Cliftonville,725,5,14,5,11,47,44,3,47
Glenavon,725,6,11,10,9,43,37,6,43
Glentoran,725,7,10,7,13,28,39,-11,37
Ballinamalla,725,8,10,4,16,36,49,-13,34
Ards,725,9,10,4,16,37,55,-18,34
Dungannon,725,10,7,12,11,44,47,-3,33
Portadown,725,11,6,5,19,21,50,-29,23
Linfield,726,1,14,9,7,57,33,24,51
Coleraine,726,2,14,8,8,46,36,10,50
Ballymena,726,3,15,5,10,54,54,0,50
Crusaders,726,4,14,7,9,44,36,8,49
Cliftonville,726,5,14,5,11,47,38,9,47
Glenavon,726,6,11,12,7,48,45,3,45
Ards,726,7,12,4,14,44,43,1,40
Dungannon,726,8,9,8,13,42,41,1,35
Ballinamalla,726,9,11,2,17,38,46,-8,35
Glentoran,726,10,8,6,16,25,46,-21,30
Portadown,726,11,7,6,17,25,52,-27,27
Linfield,727,1,18,8,4,65,27,38,62
Cliftonville,727,2,14,7,9,52,41,11,49
Ballymena,727,3,14,7,9,62,58,4,49
Coleraine,727,4,12,11,7,41,37,4,47
Crusaders,727,5,13,8,9,50,48,2,47
Dungannon,727,6,10,9,11,46,47,-1,39
Glentoran,727,7,9,10,11,35,40,-5,37
Glenavon,727,8,9,8,13,50,53,-3,35
Ards,727,9,10,5,15,44,53,-9,35
Portadown,727,10,8,5,17,31,47,-16,29
Ballinamalla,727,11,7,4,19,24,49,-25,25
Crusaders,728,1,17,5,8,64,47,17,56
Linfield,728,2,15,10,5,55,25,30,55
Cliftonville,728,3,16,4,10,56,36,20,52
Glenavon,728,4,12,11,7,51,41,10,47
Ballymena,728,5,13,5,12,58,64,-6,44
Dungannon,728,6,11,9,10,59,48,11,42
Coleraine,728,7,9,11,10,36,37,-1,38
Glentoran,728,8,10,6,14,29,48,-19,36
Portadown,728,9,11,2,17,28,49,-21,35
Ballinamalla,728,10,9,5,16,30,48,-18,32
Ards,728,11,5,6,19,30,53,-23,21
Linfield,729,1,19,6,5,66,29,37,63
Cliftonville,729,2,18,5,7,52,32,20,59
Crusaders,729,3,15,8,7,57,34,23,53
Ballymena,729,4,15,5,10,57,54,3,50
Glenavon,729,5,12,12,6,54,49,5,48
Dungannon,729,6,9,10,11,51,51,0,37
Coleraine,729,7,8,12,10,32,38,-6,36
Ards,729,8,9,7,14,40,48,-8,34
Glentoran,729,9,8,8,14,36,50,-14,32
Portadown,729,10,7,5,18,27,47,-20,26
Ballinamalla,729,11,4,4,22,30,70,-40,16
Crusaders,730,1,17,7,6,59,34,25,58
Linfield,730,2,15,10,5,62,32,30,55
Coleraine,730,3,15,8,7,53,34,19,53
Cliftonville,730,4,16,5,9,56,39,17,53
Ballymena,730,5,13,7,10,57,58,-1,46
Dungannon,730,6,11,11,8,50,41,9,44
Glentoran,730,7,8,10,12,28,46,-18,34
Glenavon,730,8,8,9,13,42,54,-12,33
Ballinamalla,730,9,9,5,16,30,51,-21,32
Portadown,730,10,7,4,19,24,50,-26,25
Ards,730,11,5,6,19,31,53,-22,21
Crusaders,731,1,17,8,5,50,28,22,59
Linfield,731,2,14,12,4,59,25,34,54
Glenavon,731,3,15,8,7,57,45,12,53
Cliftonville,731,4,14,7,9,52,42,10,49
Ballymena,731,5,14,7,9,55,54,1,49
Coleraine,731,6,11,10,9,44,40,4,43
Dungannon,731,7,10,10,10,50,44,6,40
Ards,731,8,9,4,17,36,54,-18,31
Glentoran,731,9,7,8,15,28,50,-22,29
Ballinamalla,731,10,7,4,19,24,48,-24,25
Portadown,731,11,6,4,20,18,43,-25,22
Cliftonville,732,1,17,5,8,52,33,19,56
Crusaders,732,2,15,8,7,56,35,21,53
Linfield,732,3,13,9,8,51,34,17,48
Ballymena,732,4,12,8,10,56,57,-1,44
Dungannon,732,5,11,10,9,56,41,15,43
Glentoran,732,6,11,10,9,35,33,2,43
Coleraine,732,7,11,9,10,39,37,2,42
Glenavon,732,8,9,9,12,43,50,-7,36
Ards,732,9,9,7,14,38,51,-13,34
Portadown,732,10,8,7,15,29,48,-19,31
Ballinamalla,732,11,6,4,20,25,61,-36,22
Linfield,733,1,15,8,7,53,28,25,53
Ballymena,733,2,14,7,9,62,57,5,49
Cliftonville,733,3,15,3,12,54,44,10,48
Crusaders,733,4,13,8,9,53,42,11,47
Glenavon,733,5,12,10,8,46,47,-1,46
Coleraine,733,6,12,8,10,39,37,2,44
Dungannon,733,7,10,9,11,45,45,0,39
Glentoran,733,8,9,10,11,32,40,-8,37
Portadown,733,9,11,4,15,32,41,-9,37
Ballinamalla,733,10,7,8,15,29,48,-19,29
Ards,733,11,8,3,19,37,53,-16,27
Crusaders,734,1,17,8,5,54,32,22,59
Linfield,734,2,13,9,8,53,36,17,48
Coleraine,734,3,12,11,7,44,37,7,47
Ballymena,734,4,12,9,9,57,58,-1,45
Cliftonville,734,5,13,4,13,55,44,11,43
Glenavon,734,6,10,13,7,52,44,8,43
Dungannon,734,7,8,11,11,49,50,-1,35
Glentoran,734,8,8,10,12,33,45,-12,34
Portadown,734,9,8,8,14,28,44,-16,32
Ballinamalla,734,10,8,7,15,30,51,-21,31
Ards,734,11,8,6,16,35,49,-14,30
Crusaders,735,1,17,7,6,56,34,22,58
Cliftonville,735,2,14,5,11,52,47,5,47
Linfield,735,3,12,10,8,58,41,17,46
Coleraine,735,4,12,10,8,43,35,8,46
Ballymena,735,5,13,5,12,60,60,0,44
Ards,735,6,12,5,13,44,43,1,41
Glenavon,735,7,10,10,10,45,46,-1,40
Dungannon,735,8,10,8,12,44,47,-3,38
Glentoran,735,9,9,9,12,38,44,-6,36
Ballinamalla,735,10,8,5,17,31,50,-19,29
Portadown,735,11,7,8,15,31,55,-24,29
Cliftonville,736,1,19,5,6,52,30,22,62
Crusaders,736,2,15,9,6,54,38,16,54
Linfield,736,3,14,9,7,58,30,28,51
Glenavon,736,4,11,13,6,49,38,11,46
Dungannon,736,5,10,11,9,49,45,4,41
Ballymena,736,6,12,5,13,50,58,-8,41
Coleraine,736,7,10,10,10,41,41,0,40
Glentoran,736,8,11,6,13,33,36,-3,39
Ards,736,9,10,3,17,38,51,-13,33
Ballinamalla,736,10,8,4,18,32,53,-21,28
Portadown,736,11,5,5,20,19,55,-36,20
Crusaders,737,1,19,7,4,61,32,29,64
Linfield,737,2,14,12,4,61,33,28,54
Glenavon,737,3,14,9,7,52,39,13,51
Coleraine,737,4,11,13,6,37,30,7,46
Ballymena,737,5,12,9,9,48,51,-3,45
Dungannon,737,6,11,11,8,48,37,11,44
Cliftonville,737,7,12,7,11,49,44,5,43
Glentoran,737,8,8,7,15,33,49,-16,31
Ards,737,9,7,7,16,37,55,-18,28
Portadown,737,10,5,7,18,21,46,-25,22
Ballinamalla,737,11,6,3,21,27,58,-31,21
Crusaders,738,1,16,9,5,59,41,18,57
Linfield,738,2,14,9,7,56,32,24,51
Coleraine,738,3,13,11,6,46,36,10,50
Ballymena,738,4,14,6,10,62,60,2,48
Cliftonville,738,5,12,9,9,52,42,10,45
Glenavon,738,6,10,10,10,50,51,-1,40
Dungannon,738,7,7,13,10,48,45,3,34
Portadown,738,8,8,9,13,30,41,-11,33
Ards,738,9,8,7,15,43,51,-8,31
Glentoran,738,10,8,7,15,32,54,-22,31
Ballinamalla,738,11,7,6,17,28,53,-25,27
Crusaders,739,1,14,9,7,46,33,13,51
Linfield,739,2,14,7,9,66,38,28,49
Cliftonville,739,3,13,9,8,53,40,13,48
Coleraine,739,4,12,10,8,41,41,0,46
Ballymena,739,5,13,7,10,62,63,-1,46
Dungannon,739,6,10,9,11,47,45,2,39
Ards,739,7,11,6,13,38,43,-5,39
Glenavon,739,8,9,10,11,39,44,-5,37
Glentoran,739,9,9,8,13,31,41,-10,35
Ballinamalla,739,10,9,5,16,34,47,-13,32
Portadown,739,11,7,8,15,27,49,-22,29
Linfield,740,1,16,7,7,65,31,34,55
Cliftonville,740,2,15,6,9,55,42,13,51
Crusaders,740,3,14,8,8,47,32,15,50
Ballymena,740,4,14,6,10,52,54,-2,48
Dungannon,740,5,12,10,8,50,39,11,46
Coleraine,740,6,12,9,9,38,36,2,45
Glentoran,740,7,10,7,13,30,41,-11,37
Glenavon,740,8,7,15,8,41,44,-3,36
Ards,740,9,10,4,16,39,50,-11,34
Portadown,740,10,8,7,15,28,45,-17,31
Ballinamalla,740,11,4,7,19,25,56,-31,19
Crusaders,741,1,16,7,7,60,40,20,55
Cliftonville,741,2,16,7,7,58,42,16,55
Linfield,741,3,14,8,8,55,36,19,50
Ballymena,741,4,13,9,8,60,58,2,48
Glenavon,741,5,11,13,6,47,41,6,46
Coleraine,741,6,12,8,10,45,36,9,44
Dungannon,741,7,10,10,10,54,44,10,40
Glentoran,741,8,9,7,14,29,50,-21,34
Portadown,741,9,8,6,16,30,48,-18,30
Ards,741,10,8,3,19,36,52,-16,27
Ballinamalla,741,11,8,2,20,32,59,-27,26
Crusaders,742,1,16,7,7,56,39,17,55
Linfield,742,2,15,9,6,61,34,27,54
Ballymena,742,3,16,4,10,62,57,5,52
Glenavon,742,4,13,9,8,56,43,13,48
Coleraine,742,5,13,8,9,44,35,9,47
Dungannon,742,6,12,8,10,51,38,13,44
Cliftonville,742,7,12,4,14,49,49,0,40
Glentoran,742,8,10,5,15,35,54,-19,35
Ards,742,9,9,4,17,41,56,-15,31
Ballinamalla,742,10,8,5,17,32,58,-26,29
Portadown,742,11,7,5,18,23,47,-24,26
Crusaders,743,1,16,6,8,52,32,20,54
Cliftonville,743,2,15,8,7,51,37,14,53
Linfield,743,3,15,7,8,57,35,22,52
Dungannon,743,4,12,8,10,53,34,19,44
Ballymena,743,5,11,10,9,52,56,-4,43
Glenavon,743,6,10,11,9,52,50,2,41
Coleraine,743,7,10,10,10,36,39,-3,40
Glentoran,743,8,11,7,12,38,43,-5,40
Ballinamalla,743,9,10,4,16,30,45,-15,34
Ards,743,10,9,4,17,33,52,-19,31
Portadown,743,11,6,5,19,22,53,-31,23
Linfield,744,1,15,9,6,59,34,25,54
Crusaders,744,2,15,7,8,54,36,18,52
Cliftonville,744,3,16,4,10,54,37,17,52
Ballymena,744,4,14,6,10,55,56,-1,48
Coleraine,744,5,11,9,10,43,43,0,42
Glenavon,744,6,10,12,8,44,47,-3,42
Dungannon,744,7,11,8,11,51,45,6,41
Ards,744,8,9,9,12,42,50,-8,36
Glentoran,744,9,8,8,14,28,42,-14,32
Portadown,744,10,7,7,16,26,43,-17,28
Ballinamalla,744,11,8,3,19,35,58,-23,27
Linfield,745,1,16,9,5,65,29,36,57
Crusaders,745,2,16,8,6,55,33,22,56
Cliftonville,745,3,16,6,8,47,30,17,54
Coleraine,745,4,10,12,8,38,36,2,42
Ballymena,745,5,12,6,12,62,65,-3,42
Glentoran,745,6,10,8,12,32,44,-12,38
Dungannon,745,7,9,8,13,49,50,-1,35
Ards,745,8,9,7,14,44,53,-9,34
Glenavon,745,9,8,9,13,39,54,-15,33
Portadown,745,10,9,5,16,29,48,-19,32
Ballinamalla,745,11,9,4,17,32,50,-18,31
Cliftonville,746,1,17,5,8,55,39,16,56
Crusaders,746,2,15,10,5,49,28,21,55
Linfield,746,3,14,9,7,58,29,29,51
Ballymena,746,4,15,4,11,61,62,-1,49
Coleraine,746,5,12,8,10,45,41,4,44
Dungannon,746,6,11,8,11,47,37,10,41
Glenavon,746,7,9,11,10,45,47,-2,38
Portadown,746,8,9,7,14,22,37,-15,34
Ballinamalla,746,9,9,5,16,26,47,-21,32
Glentoran,746,10,7,8,15,25,46,-21,29
Ards,746,11,8,3,19,31,51,-20,27
Linfield,747,1,15,10,5,59,31,28,55
Crusaders,747,2,15,9,6,50,34,16,54
Ballymena,747,3,16,3,11,63,54,9,51
Cliftonville,747,4,13,8,9,53,40,13,47
Glenavon,747,5,11,11,8,50,48,2,44
Coleraine,747,6,10,12,8,43,42,1,42
Dungannon,747,7,8,14,8,49,44,5,38
Ards,747,8,10,4,16,38,53,-15,34
Portadown,747,9,9,6,15,31,46,-15,33
Glentoran,747,10,7,8,15,28,47,-19,29
Ballinamalla,747,11,6,5,19,24,49,-25,23
Crusaders,748,1,20,6,4,61,37,24,66
Linfield,748,2,16,8,6,64,29,35,56
Coleraine,748,3,15,9,6,56,32,24,54
Cliftonville,748,4,16,3,11,51,42,9,51
Glenavon,748,5,12,9,9,51,49,2,45
Ballymena,748,6,13,5,12,58,58,0,44
Dungannon,748,7,10,8,12,51,46,5,38
Glentoran,748,8,9,8,13,37,50,-13,35
Ballinamalla,748,9,8,5,17,29,56,-27,29
Ards,748,10,6,5,19,29,56,-27,23
Portadown,748,11,4,6,20,23,55,-32,18
Linfield,749,1,15,10,5,69,31,38,55
Glenavon,749,2,14,12,4,48,33,15,54
Ballymena,749,3,15,7,8,53,50,3,52
Cliftonville,749,4,14,6,10,44,36,8,48
Crusaders,749,5,12,8,10,47,39,8,44
Coleraine,749,6,10,9,11,42,38,4,39
Dungannon,749,7,10,9,11,43,40,3,39
Glentoran,749,8,8,9,13,32,48,-16,33
Ards,749,9,9,6,15,34,51,-17,33
Ballinamalla,749,10,7,6,17,27,51,-24,27
Portadown,749,11,6,8,16,23,45,-22,26
Crusaders,750,1,17,9,4,54,26,28,60
Cliftonville,750,2,18,5,7,56,35,21,59
Linfield,750,3,13,11,6,59,34,25,50
Ballymena,750,4,12,10,8,65,62,3,46
Dungannon,750,5,11,9,10,53,41,12,42
Coleraine,750,6,9,14,7,44,36,8,41
Ards,750,7,10,4,16,41,52,-11,34
Glenavon,750,8,7,13,10,41,55,-14,34
Ballinamalla,750,9,9,3,18,27,49,-22,30
Glentoran,750,10,7,8,15,27,50,-23,29
Portadown,750,11,4,10,16,23,50,-27,22
Linfield,751,1,17,8,5,57,28,29,59
Ballymena,751,2,16,5,9,62,53,9,53
Coleraine,751,3,13,11,6,43,32,11,50
Dungannon,751,4,13,7,10,53,42,11,46
Cliftonville,751,5,13,7,10,49,42,7,46
Crusaders,751,6,13,6,11,49,39,10,45
Glenavon,751,7,8,12,10,40,49,-9,36
Ards,751,8,10,5,15,44,52,-8,35
Glentoran,751,9,8,8,14,39,52,-13,32
Portadown,751,10,8,4,18,28,48,-20,28
Ballinamalla,751,11,8,3,19,30,57,-27,27
Crusaders,752,1,17,7,6,62,41,21,58
Cliftonville,752,2,15,6,9,56,35,21,51
Linfield,752,3,13,10,7,60,36,24,49
Ballymena,752,4,14,7,9,59,55,4,49
Dungannon,752,5,12,10,8,55,41,14,46
Glenavon,752,6,9,12,9,52,51,1,39
Coleraine,752,7,8,12,10,35,38,-3,36
Glentoran,752,8,8,11,11,33,43,-10,35
Ards,752,9,10,5,15,35,49,-14,35
Portadown,752,10,10,4,16,31,50,-19,34
Ballinamalla,752,11,5,4,21,21,60,-39,19
Linfield,753,1,17,8,5,60,30,30,59
Crusaders,753,2,13,10,7,54,38,16,49
Cliftonville,753,3,15,4,11,50,44,6,49
Coleraine,753,4,13,9,8,45,36,9,48
Ballymena,753,5,15,3,12,57,60,-3,48
Glenavon,753,6,10,12,8,54,47,7,42
Dungannon,753,7,9,9,12,39,42,-3,36
Ards,753,8,10,4,16,43,53,-10,34
Glentoran,753,9,8,8,14,26,41,-15,32
Ballinamalla,753,10,8,7,15,32,52,-20,31
Portadown,753,11,7,6,17,30,47,-17,27
Crusaders,754,1,16,8,6,64,42,22,56
Linfield,754,2,15,9,6,57,33,24,54
Cliftonville,754,3,17,3,10,58,48,10,54
Ballymena,754,4,14,6,10,64,60,4,48
Coleraine,754,5,12,10,8,46,41,5,46
Dungannon,754,6,11,7,12,54,47,7,40
Glenavon,754,7,9,12,9,51,54,-3,39
Ballinamalla,754,8,10,7,13,32,42,-10,37
Glentoran,754,9,6,10,14,24,43,-19,28
Portadown,754,10,7,5,18,24,48,-24,26
Ards,754,11,6,7,17,39,55,-16,25
Cliftonville,755,1,19,4,7,60,33,27,61
Linfield,755,2,16,10,4,56,23,33,58
Crusaders,755,3,17,7,6,52,30,22,58
Ballymena,755,4,15,7,8,58,49,9,52
Coleraine,755,5,12,11,7,36,35,1,47
Glenavon,755,6,9,10,11,43,46,-3,37
Dungannon,755,7,8,10,12,46,48,-2,34
Ards,755,8,7,10,13,40,48,-8,31
Ballinamalla,755,9,8,6,16,25,46,-21,30
Glentoran,755,10,7,7,16,29,51,-22,28
Portadown,755,11,3,6,21,19,55,-36,15
Linfield,756,1,16,8,6,65,34,31,56
Crusaders,756,2,15,11,4,47,28,19,56
Coleraine,756,3,14,9,7,49,36,13,51
Cliftonville,756,4,12,8,10,52,44,8,44
Glenavon,756,5,10,14,6,40,38,2,44
Ballymena,756,6,12,6,12,51,60,-9,42
Dungannon,756,7,8,10,12,47,50,-3,34
Glentoran,756,8,10,4,16,29,43,-14,34
Ballinamalla,756,9,10,3,17,37,53,-16,33
Portadown,756,10,8,6,16,30,45,-15,30
Ards,756,11,9,3,18,34,50,-16,30
Crusaders,757,1,17,8,5,61,34,27,59
Cliftonville,757,2,17,3,10,57,45,12,54
Linfield,757,3,14,10,6,62,33,29,52
Dungannon,757,4,14,8,8,61,43,18,50
Ballymena,757,5,15,5,10,58,64,-6,50
Coleraine,757,6,12,9,9,49,44,5,45
Glentoran,757,7,9,8,13,36,45,-9,35
Glenavon,757,8,8,9,13,43,58,-15,33
Ballinamalla,757,9,8,4,18,30,49,-19,28
Ards,757,10,7,5,18,36,52,-16,26
Portadown,757,11,7,5,18,27,53,-26,26
Crusaders,758,1,17,9,4,59,32,27,60
Cliftonville,758,2,17,5,8,62,36,26,56
Ballymena,758,3,14,9,7,54,50,4,51
Glenavon,758,4,12,11,7,44,39,5,47
Linfield,758,5,12,9,9,56,40,16,45
Coleraine,758,6,12,9,9,43,35,8,45
Dungannon,758,7,9,10,11,46,41,5,37
Glentoran,758,8,9,8,13,30,48,-18,35
Ballinamalla,758,9,9,3,18,34,56,-22,30
Portadown,758,10,5,9,16,28,55,-27,24
Ards,758,11,5,6,19,33,57,-24,21
Ballymena,759,1,20,5,5,61,48,13,65
Crusaders,759,2,19,6,5,61,34,27,63
Cliftonville,759,3,13,8,9,48,36,12,47
Glenavon,759,4,11,10,9,47,44,3,43
Linfield,759,5,10,12,8,49,33,16,42
Coleraine,759,6,10,12,8,47,35,12,42
Glentoran,759,7,10,7,13,33,46,-13,37
Dungannon,759,8,8,10,12,48,51,-3,34
Ards,759,9,9,4,17,36,47,-11,31
Portadown,759,10,8,3,19,28,52,-24,27
Ballinamalla,759,11,5,7,18,30,62,-32,22
Crusaders,760,1,17,7,6,60,35,25,58
Cliftonville,760,2,15,4,11,58,41,17,49
Dungannon,760,3,14,7,9,54,40,14,49
Glenavon,760,4,12,13,5,47,38,9,49
Linfield,760,5,13,9,8,60,40,20,48
Coleraine,760,6,10,13,7,40,34,6,43
Ballymena,760,7,12,6,12,56,66,-10,42
Ards,760,8,11,5,14,48,48,0,38
Glentoran,760,9,10,5,15,35,55,-20,35
Portadown,760,10,8,4,18,27,49,-22,28
Ballinamalla,760,11,5,3,22,25,64,-39,18
Cliftonville,761,1,17,6,7,64,35,29,57
Crusaders,761,2,16,8,6,58,39,19,56
Ballymena,761,3,16,7,7,68,57,11,55
Glenavon,761,4,14,9,7,53,49,4,51
Linfield,761,5,11,12,7,59,44,15,45
Glentoran,761,6,8,11,11,35,45,-10,35
Coleraine,761,7,7,13,10,37,42,-5,34
Portadown,761,8,8,7,15,27,41,-14,31
Ards,761,9,7,9,14,38,52,-14,30
Dungannon,761,10,6,11,13,50,60,-10,29
Ballinamalla,761,11,6,5,19,33,58,-25,23
Crusaders,762,1,17,5,8,55,29,26,56
Linfield,762,2,16,8,6,65,40,25,56
Cliftonville,762,3,17,5,8,60,40,20,56
Glenavon,762,4,13,12,5,57,41,16,51
Glentoran,762,5,12,8,10,35,38,-3,44
Ards,762,6,9,8,13,36,46,-10,35
Ballymena,762,7,10,5,15,42,65,-23,35
Coleraine,762,8,8,9,13,37,46,-9,33
Dungannon,762,9,7,11,12,48,48,0,32
Ballinamalla,762,10,8,6,16,29,48,-19,30
Portadown,762,11,7,5,18,29,52,-23,26
Crusaders,763,1,15,8,7,58,39,19,53
Linfield,763,2,14,10,6,55,31,24,52
Glenavon,763,3,14,10,6,56,42,14,52
Cliftonville,763,4,16,3,11,64,47,17,51
Coleraine,763,5,13,8,9,47,39,8,47
Ballymena,763,6,12,7,11,63,60,3,43
Dungannon,763,7,10,11,9,55,49,6,41
Ards,763,8,10,5,15,38,50,-12,35
Glentoran,763,9,9,7,14,33,57,-24,34
Ballinamalla,763,10,7,4,19,27,53,-26,25
Portadown,763,11,5,7,18,25,54,-29,22
Linfield,764,1,16,11,3,60,23,37,59
Crusaders,764,2,17,7,6,58,33,25,58
Cliftonville,764,3,15,6,9,51,35,16,51
Coleraine,764,4,14,9,7,46,33,13,51
Ballymena,764,5,15,6,9,51,52,-1,51
Dungannon,764,6,9,10,11,50,47,3,37
Glentoran,764,7,10,6,14,29,47,-18,36
Portadown,764,8,9,5,16,27,47,-20,32
Glenavon,764,9,8,7,15,41,53,-12,31
Ards,764,10,8,4,18,35,57,-22,28
Ballinamalla,764,11,6,5,19,34,55,-21,23
Crusaders,765,1,15,9,6,60,38,22,54
Cliftonville,765,2,16,5,9,56,34,22,53
Linfield,765,3,14,10,6,57,29,28,52
Ballymena,765,4,12,9,9,57,56,1,45
Dungannon,765,5,11,10,9,55,46,9,43
Coleraine,765,6,11,10,9,36,36,0,43
Glentoran,765,7,8,12,10,30,39,-9,36
Ballinamalla,765,8,10,6,14,29,46,-17,36
Glenavon,765,9,8,10,12,43,52,-9,34
Ards,765,10,7,6,17,36,59,-23,27
Portadown,765,11,6,7,17,28,52,-24,25
Linfield,766,1,17,8,5,57,25,32,59
Crusaders,766,2,17,7,6,61,35,26,58
Cliftonville,766,3,17,3,10,55,40,15,54
Ballymena,766,4,14,5,11,58,57,1,47
Glenavon,766,5,10,12,8,46,49,-3,42
Ards,766,6,11,7,12,44,44,0,40
Coleraine,766,7,9,11,10,42,44,-2,38
Glentoran,766,8,8,11,11,34,48,-14,35
Dungannon,766,9,8,10,12,45,47,-2,34
Ballinamalla,766,10,6,7,17,37,59,-22,25
Portadown,766,11,5,5,20,18,49,-31,20
Linfield,767,1,17,8,5,59,24,35,59
Ballymena,767,2,18,3,9,60,55,5,57
Crusaders,767,3,15,8,7,56,41,15,53
Dungannon,767,4,13,7,10,56,45,11,46
Cliftonville,767,5,13,6,11,53,41,12,45
Coleraine,767,6,10,10,10,44,43,1,40
Glenavon,767,7,10,9,11,47,53,-6,39
Glentoran,767,8,10,7,13,35,42,-7,37
Ards,767,9,8,7,15,38,52,-14,31
Ballinamalla,767,10,8,4,18,35,60,-25,28
Portadown,767,11,6,5,19,20,47,-27,23
Crusaders,768,1,16,8,6,61,41,20,56
Cliftonville,768,2,17,4,9,54,33,21,55
Ballymena,768,3,16,4,10,61,53,8,52
Linfield,768,4,13,8,9,51,35,16,47
Glenavon,768,5,12,11,7,50,45,5,47
Coleraine,768,6,9,9,12,35,42,-7,36
Ards,768,7,10,5,15,40,44,-4,35
Dungannon,768,8,9,7,14,47,49,-2,34
Ballinamalla,768,9,10,4,16,34,53,-19,34
Glentoran,768,10,8,8,14,29,51,-22,32
Portadown,768,11,7,8,15,28,44,-16,29
Crusaders,769,1,16,10,4,57,35,22,58
Glenavon,769,2,13,11,6,50,40,10,50
Cliftonville,769,3,14,6,10,54,46,8,48
Ballymena,769,4,13,8,9,61,57,4,47
Linfield,769,5,13,7,10,57,33,24,46
Coleraine,769,6,12,8,10,37,37,0,44
Dungannon,769,7,9,10,11,53,40,13,37
Ballinamalla,769,8,11,4,15,31,53,-22,37
Glentoran,769,9,7,9,14,30,49,-19,30
Ards,769,10,8,5,17,39,53,-14,29
Portadown,769,11,8,4,18,21,47,-26,28
Linfield,770,1,15,9,6,56,31,25,54
Crusaders,770,2,15,9,6,54,36,18,54
Cliftonville,770,3,14,7,9,48,37,11,49
Ballymena,770,4,14,6,10,55,52,3,48
Coleraine,770,5,12,11,7,43,33,10,47
Glenavon,770,6,11,11,8,45,39,6,44
Dungannon,770,7,9,10,11,47,46,1,37
Glentoran,770,8,9,10,11,36,45,-9,37
Ards,770,9,9,5,16,41,50,-9,32
Ballinamalla,770,10,8,3,19,30,57,-27,27
Portadown,770,11,4,9,17,16,45,-29,21
Linfield,771,1,17,8,5,68,32,36,59
Coleraine,771,2,14,9,7,47,37,10,51
Crusaders,771,3,14,7,9,51,34,17,49
Cliftonville,771,4,14,4,12,49,41,8,46
Ballymena,771,5,13,6,11,57,60,-3,45
Dungannon,771,6,12,8,10,50,39,11,44
Glentoran,771,7,12,6,12,37,45,-8,42
Glenavon,771,8,10,9,11,39,41,-2,39
Portadown,771,9,10,3,17,25,45,-20,33
Ards,771,10,8,4,18,31,55,-24,28
Ballinamalla,771,11,8,2,20,31,56,-25,26
Crusaders,772,1,18,7,5,61,30,31,61
Linfield,772,2,16,11,3,61,28,33,59
Coleraine,772,3,13,10,7,47,38,9,49
Cliftonville,772,4,13,7,10,53,46,7,46
Ballymena,772,5,11,10,9,55,58,-3,43
Glenavon,772,6,9,12,9,41,47,-6,39
Dungannon,772,7,8,10,12,50,49,1,34
Glentoran,772,8,9,7,14,31,43,-12,34
Ards,772,9,9,5,16,34,51,-17,32
Ballinamalla,772,10,7,6,17,33,53,-20,27
Portadown,772,11,5,9,16,21,44,-23,24
Crusaders,773,1,17,8,5,66,33,33,59
Ballymena,773,2,18,4,8,65,59,6,58
Glenavon,773,3,13,9,8,49,42,7,48
Linfield,773,4,12,11,7,58,40,18,47
Cliftonville,773,5,13,5,12,54,47,7,44
Coleraine,773,6,10,10,10,44,48,-4,40
Ards,773,7,9,9,12,40,46,-6,36
Dungannon,773,8,8,10,12,43,43,0,34
Portadown,773,9,8,7,15,35,49,-14,31
Glentoran,773,10,7,10,13,27,47,-20,31
Ballinamalla,773,11,5,7,18,28,55,-27,22
Crusaders,774,1,17,7,6,53,29,24,58
Coleraine,774,2,15,11,4,50,32,18,56
Dungannon,774,3,13,8,9,51,43,8,47
Ballymena,774,4,13,8,9,57,55,2,47
Cliftonville,774,5,12,9,9,54,43,11,45
Linfield,774,6,12,7,11,52,35,17,43
Glenavon,774,7,9,11,10,42,42,0,38
Portadown,774,8,10,6,14,34,43,-9,36
Glentoran,774,9,8,6,16,28,48,-20,30
Ards,774,10,8,5,17,35,60,-25,29
Ballinamalla,774,11,7,4,19,29,55,-26,25
Ballymena,775,1,19,3,8,66,55,11,60
Crusaders,775,2,17,6,7,57,40,17,57
Coleraine,775,3,14,7,9,53,37,16,49
Linfield,775,4,12,10,8,52,35,17,46
Cliftonville,775,5,13,5,12,48,42,6,44
Glenavon,775,6,10,9,11,50,53,-3,39
Ballinamalla,775,7,11,4,15,36,49,-13,37
Dungannon,775,8,9,8,13,50,51,-1,35
Ards,775,9,9,7,14,40,51,-11,34
Glentoran,775,10,8,9,13,31,45,-14,33
Portadown,775,11,6,6,18,24,49,-25,24
Linfield,776,1,14,11,5,53,27,26,53
Crusaders,776,2,14,9,7,55,41,14,51
Glenavon,776,3,13,11,6,53,44,9,50
Ballymena,776,4,15,5,10,60,61,-1,50
Cliftonville,776,5,14,7,9,47,30,17,49
Coleraine,776,6,13,10,7,50,40,10,49
Ballinamalla,776,7,10,6,14,32,48,-16,36
Ards,776,8,10,4,16,34,47,-13,34
Dungannon,776,9,6,11,13,41,44,-3,29
Portadown,776,10,8,5,17,28,44,-16,29
Glentoran,776,11,5,7,18,28,55,-27,22
Crusaders,777,1,16,8,6,50,29,21,56
Cliftonville,777,2,16,7,7,54,38,16,55
Ballymena,777,3,15,7,8,70,58,12,52
Coleraine,777,4,13,11,6,52,44,8,50
Linfield,777,5,11,12,7,50,31,19,45
Glenavon,777,6,12,8,10,44,48,-4,44
Dungannon,777,7,9,10,11,46,44,2,37
Ards,777,8,10,6,14,36,46,-10,36
Portadown,777,9,8,6,16,22,41,-19,30
Glentoran,777,10,6,6,18,32,54,-22,24
Ballinamalla,777,11,5,7,18,26,49,-23,22
Crusaders,778,1,15,6,9,52,37,15,51
Coleraine,778,2,14,9,7,46,38,8,51
Ballymena,778,3,14,9,7,56,50,6,51
Linfield,778,4,13,10,7,56,39,17,49
Glenavon,778,5,13,7,10,52,45,7,46
Cliftonville,778,6,12,6,12,44,44,0,42
Ards,778,7,10,8,12,52,50,2,38
Dungannon,778,8,9,10,11,49,44,5,37
Glentoran,778,9,8,9,13,30,43,-13,33
Ballinamalla,778,10,9,5,16,32,52,-20,32
Portadown,778,11,7,3,20,23,50,-27,24
Ballymena,779,1,16,7,7,64,53,11,55
Linfield,779,2,14,9,7,63,32,31,51
Glenavon,779,3,13,9,8,50,43,7,48
Cliftonville,779,4,14,6,10,50,44,6,48
Coleraine,779,5,12,10,8,42,35,7,46
Crusaders,779,6,13,5,12,45,35,10,44
Dungannon,779,7,9,11,10,43,43,0,38
Glentoran,779,8,10,8,12,32,38,-6,38
Ballinamalla,779,9,9,6,15,29,47,-18,33
Portadown,779,10,8,5,17,22,45,-23,29
Ards,779,11,6,6,18,33,58,-25,24
Cliftonville,780,1,17,3,10,64,43,21,54
Crusaders,780,2,15,9,6,51,35,16,54
Linfield,780,3,11,11,8,53,36,17,44
Coleraine,780,4,11,10,9,45,41,4,43
Glenavon,780,5,10,10,10,49,52,-3,40
Glentoran,780,6,11,7,12,38,41,-3,40
Ballymena,780,7,11,6,13,53,69,-16,39
Ballinamalla,780,8,12,3,15,32,48,-16,39
Dungannon,780,9,9,10,11,54,48,6,37
Portadown,780,10,11,3,16,35,46,-11,36
Ards,780,11,9,4,17,38,53,-15,31
Crusaders,781,1,16,10,4,62,39,23,58
Linfield,781,2,15,9,6,56,32,24,54
Ballymena,781,3,17,3,10,61,53,8,54
Glenavon,781,4,13,11,6,49,40,9,50
Coleraine,781,5,12,11,7,44,34,10,47
Cliftonville,781,6,14,4,12,53,40,13,46
Dungannon,781,7,11,9,10,48,36,12,42
Glentoran,781,8,10,6,14,28,46,-18,36
Ards,781,9,7,5,18,30,50,-20,26
Ballinamalla,781,10,7,4,19,32,59,-27,25
Portadown,781,11,3,8,19,19,53,-34,17
Linfield,782,1,15,9,6,65,38,27,54
Cliftonville,782,2,16,5,9,51,40,11,53
Dungannon,782,3,14,8,8,54,36,18,50
Coleraine,782,4,12,11,7,43,35,8,47
Crusaders,782,5,14,5,11,52,45,7,47
Ballymena,782,6,12,8,10,49,54,-5,44
Glenavon,782,7,11,10,9,50,47,3,43
Ards,782,8,10,6,14,46,45,1,36
Glentoran,782,9,7,10,13,24,40,-16,31
Portadown,782,10,7,7,16,28,44,-16,28
Ballinamalla,782,11,6,3,21,24,62,-38,21
Crusaders,783,1,18,6,6,59,32,27,60
Linfield,783,2,16,8,6,60,31,29,56
Cliftonville,783,3,15,5,10,54,46,8,50
Glenavon,783,4,13,8,9,56,48,8,47
Coleraine,783,5,10,11,9,41,44,-3,41
Ballymena,783,6,11,6,13,52,61,-9,39
Dungannon,783,7,10,7,13,48,48,0,37
Glentoran,783,8,10,7,13,29,40,-11,37
Ards,783,9,9,5,16,39,50,-11,32
Portadown,783,10,8,6,16,22,43,-21,30
Ballinamalla,783,11,7,7,16,27,44,-17,28
Cliftonville,784,1,19,3,8,57,31,26,60
Crusaders,784,2,15,7,8,61,39,22,52
Coleraine,784,3,14,9,7,48,44,4,51
Linfield,784,4,14,7,9,62,39,23,49
Ballymena,784,5,14,5,11,59,56,3,47
Glenavon,784,6,12,8,10,49,45,4,44
Dungannon,784,7,10,8,12,50,51,-1,38
Ards,784,8,11,4,15,37,47,-10,37
Glentoran,784,9,9,8,13,38,47,-9,35
Ballinamalla,784,10,10,1,19,31,55,-24,31
Portadown,784,11,5,4,21,19,57,-38,19
Linfield,785,1,18,6,6,59,27,32,60
Glenavon,785,2,13,13,4,56,42,14,52
Cliftonville,785,3,15,5,10,52,39,13,50
Glentoran,785,4,13,7,10,40,42,-2,46
Crusaders,785,5,13,6,11,43,38,5,45
Coleraine,785,6,11,10,9,45,43,2,43
Ballymena,785,7,12,7,11,56,60,-4,43
Dungannon,785,8,10,9,11,46,40,6,39
Portadown,785,9,7,7,16,25,50,-25,28
Ards,785,10,7,6,17,36,48,-12,27
Ballinamalla,785,11,6,4,20,29,58,-29,22
Crusaders,786,1,19,6,5,59,27,32,63
Linfield,786,2,13,11,6,56,34,22,50
Cliftonville,786,3,14,8,8,57,38,19,50
Coleraine,786,4,12,11,7,47,34,13,47
Glenavon,786,5,11,10,9,47,49,-2,43
Glentoran,786,6,10,11,9,34,38,-4,41
Ballymena,786,7,10,9,11,52,61,-9,39
Dungannon,786,8,9,9,12,47,47,0,36
Portadown,786,9,10,5,15,33,47,-14,35
Ards,786,10,6,6,18,38,59,-21,24
Ballinamalla,786,11,6,4,20,30,66,-36,22
Cliftonville,787,1,18,2,10,58,39,19,56
Crusaders,787,2,15,8,7,60,40,20,53
Linfield,787,3,13,11,6,54,30,24,50
Ballymena,787,4,13,7,10,57,57,0,46
Dungannon,787,5,12,8,10,54,44,10,44
Glenavon,787,6,9,12,9,46,49,-3,39
Coleraine,787,7,10,9,11,43,48,-5,39
Ards,787,8,11,4,15,39,46,-7,37
Glentoran,787,9,9,6,15,39,49,-10,33
Portadown,787,10,8,8,14,26,45,-19,32
Ballinamalla,787,11,8,3,19,32,61,-29,27
Crusaders,788,1,17,6,7,54,33,21,57
Coleraine,788,2,14,11,5,52,37,15,53
Linfield,788,3,14,10,6,58,39,19,52
Ballymena,788,4,16,4,10,66,54,12,52
Cliftonville,788,5,15,4,11,51,40,11,49
Dungannon,788,6,10,11,9,53,45,8,41
Glenavon,788,7,9,11,10,46,50,-4,38
Glentoran,788,8,8,10,12,37,48,-11,34
Ards,788,9,8,9,13,43,52,-9,33
Ballinamalla,788,10,6,7,17,30,54,-24,25
Portadown,788,11,5,3,22,23,61,-38,18
Crusaders,789,1,16,6,8,57,41,16,54
Linfield,789,2,13,11,6,60,31,29,50
Ballymena,789,3,14,7,9,54,49,5,49
Coleraine,789,4,12,11,7,43,35,8,47
Glenavon,789,5,13,8,9,46,41,5,47
Cliftonville,789,6,12,4,14,45,44,1,40
Glentoran,789,7,10,10,10,37,44,-7,40
Dungannon,789,8,10,8,12,50,46,4,38
Ards,789,9,9,7,14,38,54,-16,34
Ballinamalla,789,10,8,7,15,30,47,-17,31
Portadown,789,11,6,5,19,22,50,-28,23
Crusaders,790,1,17,7,6,53,26,27,58
Linfield,790,2,15,12,3,56,26,30,57
Glenavon,790,3,14,10,6,50,40,10,52
Cliftonville,790,4,14,7,9,54,37,17,49
Ballymena,790,5,14,7,9,57,59,-2,49
Dungannon,790,6,11,10,9,54,44,10,43
Coleraine,790,7,10,9,11,43,41,2,39
Glentoran,790,8,8,7,15,33,54,-21,31
Ards,790,9,7,7,16,31,50,-19,28
Portadown,790,10,6,7,17,24,47,-23,25
Ballinamalla,790,11,5,5,20,28,59,-31,20
Crusaders,791,1,17,7,6,57,34,23,58
Linfield,791,2,15,9,6,62,36,26,54
Coleraine,791,3,14,10,6,46,29,17,52
Cliftonville,791,4,14,7,9,45,34,11,49
Dungannon,791,5,11,10,9,50,42,8,43
Portadown,791,6,11,6,13,37,36,1,39
Ballymena,791,7,11,5,14,46,59,-13,38
Glenavon,791,8,9,10,11,46,54,-8,37
Ballinamalla,791,9,9,3,18,29,49,-20,30
Glentoran,791,10,7,8,15,28,55,-27,29
Ards,791,11,7,5,18,30,48,-18,26
Cliftonville,792,1,19,2,9,55,32,23,59
Crusaders,792,2,15,10,5,53,28,25,55
Linfield,792,3,15,8,7,62,34,28,53
Ballymena,792,4,14,5,11,57,68,-11,47
Dungannon,792,5,10,11,9,47,39,8,41
Coleraine,792,6,10,11,9,38,34,4,41
Glenavon,792,7,8,13,9,39,41,-2,37
Ards,792,8,9,5,16,39,46,-7,32
Glentoran,792,9,8,8,14,32,50,-18,32
Portadown,792,10,8,6,16,26,48,-22,30
Ballinamalla,792,11,6,7,17,25,53,-28,25
Cliftonville,793,1,18,4,8,51,41,10,58
Linfield,793,2,15,8,7,56,33,23,53
Crusaders,793,3,15,6,9,51,36,15,51
Ballymena,793,4,15,5,10,54,52,2,50
Glenavon,793,5,11,9,10,51,50,1,42
Coleraine,793,6,10,8,12,40,40,0,38
Ards,793,7,10,6,14,38,42,-4,36
Ballinamalla,793,8,11,3,16,31,53,-22,36
Dungannon,793,9,8,10,12,45,39,6,34
Glentoran,793,10,9,7,14,30,43,-13,34
Portadown,793,11,7,6,17,22,40,-18,27
Crusaders,794,1,18,8,4,55,25,30,62
Cliftonville,794,2,16,6,8,51,38,13,54
Linfield,794,3,15,8,7,54,33,21,53
Ballymena,794,4,15,6,9,60,53,7,51
Glenavon,794,5,11,10,9,46,43,3,43
Coleraine,794,6,10,10,10,37,40,-3,40
Dungannon,794,7,9,7,14,47,45,2,34
Glentoran,794,8,9,7,14,35,48,-13,34
Ards,794,9,8,6,16,34,49,-15,30
Portadown,794,10,9,3,18,28,48,-20,30
Ballinamalla,794,11,6,7,17,26,51,-25,25
Cliftonville,795,1,16,6,8,54,34,20,54
Crusaders,795,2,15,8,7,51,31,20,53
Linfield,795,3,12,11,7,49,28,21,47
Glenavon,795,4,12,11,7,49,48,1,47
Ballymena,795,5,14,5,11,53,56,-3,47
Coleraine,795,6,11,10,9,37,35,2,43
Dungannon,795,7,11,6,13,49,46,3,39
Ballinamalla,795,8,10,5,15,34,48,-14,35
Portadown,795,9,9,7,14,27,41,-14,34
Ards,795,10,9,4,17,32,46,-14,31
Glentoran,795,11,7,5,18,27,49,-22,26
Crusaders,796,1,19,6,5,62,36,26,63
Ballymena,796,2,15,7,8,66,57,9,52
Linfield,796,3,13,12,5,57,32,25,51
Cliftonville,796,4,14,7,9,51,42,9,49
Coleraine,796,5,13,10,7,48,39,9,49
Glenavon,796,6,11,11,8,45,46,-1,44
Ards,796,7,10,6,14,41,48,-7,36
Dungannon,796,8,8,11,11,57,54,3,35
Glentoran,796,9,7,10,13,32,47,-15,31
Ballinamalla,796,10,5,5,20,27,57,-30,20
Portadown,796,11,4,7,19,19,47,-28,19
Crusaders,797,1,17,6,7,63,38,25,57
Cliftonville,797,2,14,6,10,51,40,11,48
Linfield,797,3,13,8,9,58,37,21,47
Glenavon,797,4,12,9,9,48,44,4,45
Coleraine,797,5,11,12,7,41,37,4,45
Ballymena,797,6,12,8,10,53,57,-4,44
Glentoran,797,7,11,9,10,37,38,-1,42
Ards,797,8,10,7,13,37,47,-10,37
Dungannon,797,9,9,6,15,46,51,-5,33
Portadown,797,10,9,6,15,26,43,-17,33
Ballinamalla,797,11,8,1,21,32,60,-28,25
Crusaders,798,1,18,4,8,62,42,20,58
Linfield,798,2,14,11,5,53,27,26,53
Cliftonville,798,3,16,4,10,50,42,8,52
Ballymena,798,4,13,7,10,54,61,-7,46
Glenavon,798,5,11,12,7,47,40,7,45
Coleraine,798,6,10,12,8,45,40,5,42
Ards,798,7,11,5,14,45,46,-1,38
Dungannon,798,8,8,11,11,45,42,3,35
Glentoran,798,9,9,5,16,26,45,-19,32
Portadown,798,10,7,6,17,31,46,-15,27
Ballinamalla,798,11,7,5,18,29,56,-27,26
Glenavon,799,1,14,9,7,60,47,13,51
Cliftonville,799,2,14,8,8,54,36,18,50
Ballymena,799,3,14,8,8,59,54,5,50
Crusaders,799,4,14,7,9,55,42,13,49
Linfield,799,5,13,8,9,58,41,17,47
Dungannon,799,6,11,8,11,60,47,13,41
Coleraine,799,7,10,10,10,37,39,-2,40
Glentoran,799,8,9,8,13,30,45,-15,35
Ballinamalla,799,9,8,8,14,32,51,-19,32
Ards,799,10,9,4,17,36,54,-18,31
Portadown,799,11,6,8,16,28,53,-25,26
Crusaders,800,1,18,7,5,61,37,24,61
Cliftonville,800,2,17,5,8,49,30,19,56
Glenavon,800,3,13,12,5,46,37,9,51
Linfield,800,4,11,10,9,50,35,15,43
Coleraine,800,5,10,12,8,41,40,1,42
Ballymena,800,6,12,5,13,54,59,-5,41
Dungannon,800,7,9,11,10,46,40,6,38
Glentoran,800,8,10,8,12,39,48,-9,38
Ballinamalla,800,9,9,6,15,32,49,-17,33
Ards,800,10,6,9,15,35,50,-15,27
Portadown,800,11,6,3,21,20,48,-28,21
Crusaders,801,1,16,6,8,52,36,16,54
Glenavon,801,2,14,10,6,55,40,15,52
Linfield,801,3,12,12,6,54,35,19,48
Cliftonville,801,4,14,6,10,51,38,13,48
Coleraine,801,5,11,12,7,43,37,6,45
Ballymena,801,6,12,9,9,64,61,3,45
Glentoran,801,7,12,5,13,39,41,-2,41
Dungannon,801,8,8,7,15,38,46,-8,31
Ballinamalla,801,9,9,4,17,26,48,-22,31
Portadown,801,10,7,9,14,24,44,-20,30
Ards,801,11,7,6,17,33,53,-20,27
Crusaders,802,1,16,10,4,54,30,24,58
Linfield,802,2,14,10,6,50,27,23,52
Cliftonville,802,3,15,4,11,57,40,17,49
Dungannon,802,4,11,10,9,48,42,6,43
Coleraine,802,5,11,10,9,45,45,0,43
Glenavon,802,6,10,12,8,47,40,7,42
Ballymena,802,7,10,10,10,51,56,-5,40
Ards,802,8,10,5,15,38,49,-11,35
Glentoran,802,9,8,8,14,19,40,-21,32
Portadown,802,10,8,5,17,25,47,-22,29
Ballinamalla,802,11,7,6,17,28,46,-18,27
Crusaders,803,1,16,9,5,53,30,23,57
Cliftonville,803,2,14,8,8,52,39,13,50
Dungannon,803,3,13,8,9,56,42,14,47
Ballymena,803,4,13,8,9,56,61,-5,47
Linfield,803,5,12,10,8,51,27,24,46
Coleraine,803,6,12,9,9,43,33,10,45
Glenavon,803,7,8,13,9,47,51,-4,37
Ards,803,8,10,6,14,38,48,-10,36
Glentoran,803,9,9,8,13,31,41,-10,35
Portadown,803,10,7,5,18,25,52,-27,26
Ballinamalla,803,11,6,6,18,28,56,-28,24
Linfield,804,1,16,9,5,61,31,30,57
Crusaders,804,2,16,6,8,55,35,20,54
Cliftonville,804,3,16,4,10,53,39,14,52
Ballymena,804,4,14,6,10,55,51,4,48
Coleraine,804,5,11,9,10,49,43,6,42
Ards,804,6,11,5,14,42,47,-5,38
Portadown,804,7,11,4,15,30,45,-15,37
Glenavon,804,8,8,10,12,42,47,-5,34
Ballinamalla,804,9,10,3,17,30,52,-22,33
Glentoran,804,10,8,9,13,28,50,-22,33
Dungannon,804,11,7,9,14,44,49,-5,30
Crusaders,805,1,17,10,3,60,31,29,61
Linfield,805,2,14,10,6,62,34,28,52
Glenavon,805,3,11,13,6,48,42,6,46
Coleraine,805,4,12,10,8,45,39,6,46
Ballymena,805,5,13,7,10,62,66,-4,46
Cliftonville,805,6,13,6,11,55,42,13,45
Dungannon,805,7,9,10,11,45,47,-2,37
Ards,805,8,9,6,15,40,53,-13,33
Portadown,805,9,9,5,16,24,43,-19,32
Glentoran,805,10,6,10,14,30,49,-19,28
Ballinamalla,805,11,6,5,19,23,48,-25,23
Crusaders,806,1,16,8,6,59,40,19,56
Linfield,806,2,15,10,5,65,36,29,55
Ballymena,806,3,16,5,9,61,58,3,53
Cliftonville,806,4,15,2,13,47,42,5,47
Coleraine,806,5,11,11,8,45,36,9,44
Glenavon,806,6,11,9,10,52,44,8,42
Ballinamalla,806,7,11,4,15,30,41,-11,37
Glentoran,806,8,9,7,14,30,41,-11,34
Portadown,806,9,10,3,17,28,49,-21,33
Dungannon,806,10,7,10,13,41,47,-6,31
Ards,806,11,7,5,18,31,55,-24,26
Linfield,807,1,17,8,5,55,24,31,59
Coleraine,807,2,13,10,7,45,35,10,49
Cliftonville,807,3,15,4,11,48,41,7,49
Crusaders,807,4,14,6,10,47,39,8,48
Ballymena,807,5,14,5,11,53,56,-3,47
Glenavon,807,6,11,11,8,50,46,4,44
Dungannon,807,7,12,7,11,53,41,12,43
Glentoran,807,8,11,9,10,35,38,-3,42
Ballinamalla,807,9,9,4,17,31,50,-19,31
Ards,807,10,7,4,19,35,59,-24,25
Portadown,807,11,6,4,20,27,50,-23,22
Crusaders,808,1,18,6,6,52,31,21,60
Cliftonville,808,2,15,6,9,51,34,17,51
Linfield,808,3,13,11,6,56,29,27,50
Ballymena,808,4,13,8,9,56,57,-1,47
Dungannon,808,5,12,10,8,51,40,11,46
Glenavon,808,6,9,12,9,48,49,-1,39
Ards,808,7,12,3,15,37,40,-3,39
Glentoran,808,8,9,7,14,28,42,-14,34
Coleraine,808,9,8,9,13,34,49,-15,33
Ballinamalla,808,10,9,4,17,30,50,-20,31
Portadown,808,11,5,8,17,20,42,-22,23
Crusaders,809,1,18,8,4,57,29,28,62
Cliftonville,809,2,14,5,11,47,39,8,47
Linfield,809,3,12,10,8,55,34,21,46
Coleraine,809,4,13,7,10,43,41,2,46
Ballymena,809,5,12,7,11,55,59,-4,43
Glentoran,809,6,12,6,12,31,39,-8,42
Glenavon,809,7,10,10,10,46,42,4,40
Ards,809,8,10,5,15,38,46,-8,35
Dungannon,809,9,7,12,11,43,41,2,33
Portadown,809,10,9,5,16,27,48,-21,32
Ballinamalla,809,11,8,5,17,27,51,-24,29
Crusaders,810,1,17,4,9,52,32,20,55
Cliftonville,810,2,16,7,7,62,44,18,55
Glenavon,810,3,15,9,6,50,36,14,54
Linfield,810,4,12,10,8,58,39,19,46
Coleraine,810,5,11,11,8,46,37,9,44
Ballymena,810,6,12,5,13,50,59,-9,41
Glentoran,810,7,11,6,13,34,46,-12,39
Ards,810,8,10,6,14,38,46,-8,36
Dungannon,810,9,8,8,14,41,48,-7,32
Ballinamalla,810,10,8,5,17,29,50,-21,29
Portadown,810,11,7,5,18,25,48,-23,26
Cliftonville,811,1,17,7,6,61,35,26,58
Crusaders,811,2,17,6,7,55,34,21,57
Linfield,811,3,16,8,6,64,32,32,56
Ballymena,811,4,14,4,12,59,57,2,46
Glenavon,811,5,10,12,8,44,44,0,42
Ards,811,6,12,6,12,38,43,-5,42
Coleraine,811,7,10,9,11,39,44,-5,39
Glentoran,811,8,9,6,15,32,46,-14,33
Dungannon,811,9,7,8,15,44,51,-7,29
Ballinamalla,811,10,8,4,18,31,53,-22,28
Portadown,811,11,6,8,16,25,53,-28,26
Linfield,812,1,15,11,4,63,29,34,56
Crusaders,812,2,14,9,7,52,36,16,51
Glenavon,812,3,11,12,7,49,43,6,45
Coleraine,812,4,10,14,6,42,36,6,44
Cliftonville,812,5,14,2,14,50,48,2,44
Dungannon,812,6,11,8,11,50,42,8,41
Ballymena,812,7,10,9,11,52,61,-9,39
Ards,812,8,10,7,13,44,50,-6,37
Glentoran,812,9,9,9,12,36,42,-6,36
Ballinamalla,812,10,9,4,17,34,56,-22,31
Portadown,812,11,6,7,17,25,54,-29,25
Crusaders,813,1,18,6,6,50,28,22,60
Coleraine,813,2,15,9,6,45,31,14,54
Linfield,813,3,14,8,8,61,36,25,50
Ballymena,813,4,15,4,11,59,55,4,49
Glenavon,813,5,13,7,10,47,43,4,46
Cliftonville,813,6,12,6,12,46,42,4,42
Dungannon,813,7,11,7,12,52,48,4,40
Ballinamalla,813,8,10,4,16,32,48,-16,34
Portadown,813,9,9,4,17,25,49,-24,31
Glentoran,813,10,7,7,16,30,50,-20,28
Ards,813,11,7,6,17,42,59,-17,27
Crusaders,814,1,15,9,6,58,34,24,54
Linfield,814,2,13,12,5,59,34,25,51
Ballymena,814,3,15,6,9,65,58,7,51
Cliftonville,814,4,13,5,12,46,40,6,44
Coleraine,814,5,11,10,9,46,45,1,43
Glenavon,814,6,11,9,10,50,52,-2,42
Glentoran,814,7,11,7,12,32,41,-9,40
Ards,814,8,10,4,16,41,53,-12,34
Dungannon,814,9,6,14,10,46,45,1,32
Portadown,814,10,9,4,17,30,48,-18,31
Ballinamalla,814,11,8,6,16,30,53,-23,30
Crusaders,815,1,16,8,6,55,34,21,56
Ballymena,815,2,15,7,8,57,51,6,52
Cliftonville,815,3,14,7,9,56,40,16,49
Linfield,815,4,13,9,8,55,32,23,48
Coleraine,815,5,10,12,8,42,39,3,42
Glenavon,815,6,10,9,11,43,47,-4,39
Glentoran,815,7,11,6,13,28,43,-15,39
Dungannon,815,8,7,12,11,47,47,0,33
Ards,815,9,9,6,15,36,46,-10,33
Ballinamalla,815,10,9,5,16,33,49,-16,32
Portadown,815,11,8,5,17,30,54,-24,29
Crusaders,816,1,18,7,5,52,23,29,61
Cliftonville,816,2,17,2,11,56,39,17,53
Linfield,816,3,14,9,7,56,30,26,51
Glenavon,816,4,13,10,7,53,45,8,49
Coleraine,816,5,12,8,10,37,40,-3,44
Ballymena,816,6,12,6,12,47,55,-8,42
Glentoran,816,7,9,9,12,29,40,-11,36
Portadown,816,8,10,5,15,30,45,-15,35
Dungannon,816,9,9,7,14,43,42,1,34
Ards,816,10,7,6,17,35,49,-14,27
Ballinamalla,816,11,6,7,17,20,50,-30,25
Cliftonville,817,1,17,7,6,53,33,20,58
Linfield,817,2,14,11,5,59,31,28,53
Crusaders,817,3,15,7,8,51,35,16,52
Dungannon,817,4,14,8,8,54,40,14,50
Coleraine,817,5,12,9,9,45,42,3,45
Glenavon,817,6,10,12,8,48,49,-1,42
Ballymena,817,7,12,4,14,52,61,-9,40
Ards,817,8,9,10,11,43,48,-5,37
Ballinamalla,817,9,8,5,17,38,53,-15,29
Glentoran,817,10,6,6,18,23,46,-23,24
Portadown,817,11,7,3,20,31,59,-28,24
Linfield,818,1,15,9,6,62,31,31,54
Crusaders,818,2,16,6,8,57,39,18,54
Ballymena,818,3,15,7,8,54,50,4,52
Cliftonville,818,4,15,5,10,52,40,12,50
Glenavon,818,5,11,11,8,49,51,-2,44
Coleraine,818,6,10,10,10,36,34,2,40
Glentoran,818,7,9,11,10,38,48,-10,38
Ards,818,8,9,6,15,41,48,-7,33
Dungannon,818,9,7,9,14,46,47,-1,30
Ballinamalla,818,10,8,6,16,28,48,-20,30
Portadown,818,11,6,8,16,25,52,-27,26
Crusaders,819,1,18,8,4,53,32,21,62
Cliftonville,819,2,15,5,10,52,39,13,50
Linfield,819,3,12,13,5,53,28,25,49
Coleraine,819,4,13,9,8,45,38,7,48
Glentoran,819,5,12,9,9,31,34,-3,45
Ballymena,819,6,13,4,13,56,60,-4,43
Glenavon,819,7,9,11,10,52,53,-1,38
Portadown,819,8,11,3,16,31,47,-16,36
Dungannon,819,9,9,8,13,50,43,7,35
Ballinamalla,819,10,7,7,16,23,47,-24,28
Ards,819,11,6,3,21,32,57,-25,21
Linfield,820,1,14,11,5,63,30,33,53
Ballymena,820,2,14,7,9,64,55,9,49
Crusaders,820,3,14,6,10,48,40,8,48
Glenavon,820,4,12,10,8,57,49,8,46
Cliftonville,820,5,14,4,12,45,42,3,46
Coleraine,820,6,12,9,9,52,41,11,45
Dungannon,820,7,10,8,12,48,47,1,38
Ballinamalla,820,8,10,6,14,36,49,-13,36
Glentoran,820,9,9,7,14,36,49,-13,34
Ards,820,10,9,6,15,36,53,-17,33
Portadown,820,11,7,6,17,21,51,-30,27
Linfield,821,1,15,9,6,57,27,30,54
Cliftonville,821,2,16,6,8,54,39,15,54
Ballymena,821,3,16,6,8,64,53,11,54
Crusaders,821,4,13,12,5,56,37,19,51
Glenavon,821,5,10,12,8,45,42,3,42
Dungannon,821,6,9,9,12,50,52,-2,36
Coleraine,821,7,9,8,13,36,41,-5,35
Ards,821,8,8,8,14,37,49,-12,32
Glentoran,821,9,8,8,14,28,46,-18,32
Ballinamalla,821,10,9,5,16,33,53,-20,32
Portadown,821,11,7,7,16,28,49,-21,28
Linfield,822,1,17,8,5,68,28,40,59
Crusaders,822,2,17,5,8,53,34,19,56
Cliftonville,822,3,16,3,11,53,44,9,51
Ballymena,822,4,14,5,11,58,54,4,47
Glenavon,822,5,11,10,9,47,47,0,43
Coleraine,822,6,10,10,10,38,38,0,40
Ards,822,7,11,6,13,40,42,-2,39
Ballinamalla,822,8,12,1,17,28,43,-15,37
Glentoran,822,9,10,6,14,27,45,-18,36
Dungannon,822,10,5,13,12,37,45,-8,28
Portadown,822,11,7,3,20,19,48,-29,24
Crusaders,823,1,18,8,4,64,28,36,62
Linfield,823,2,14,9,7,60,36,24,51
Ballymena,823,3,15,6,9,65,59,6,51
Coleraine,823,4,13,9,8,44,37,7,48
Cliftonville,823,5,12,7,11,47,45,2,43
Dungannon,823,6,9,11,10,45,39,6,38
Ards,823,7,10,8,12,37,41,-4,38
Glenavon,823,8,9,10,11,44,51,-7,37
Glentoran,823,9,8,8,14,30,47,-17,32
Portadown,823,10,7,6,17,23,49,-26,27
Ballinamalla,823,11,5,8,17,27,54,-27,23
Cliftonville,824,1,17,4,9,62,43,19,55
Crusaders,824,2,16,7,7,58,41,17,55
Linfield,824,3,15,8,7,60,33,27,53
Glenavon,824,4,13,10,7,48,42,6,49
Coleraine,824,5,11,10,9,41,39,2,43
Glentoran,824,6,12,5,13,33,40,-7,41
Dungannon,824,7,9,13,8,49,41,8,40
Ballymena,824,8,10,6,14,52,65,-13,36
Ards,824,9,10,4,16,40,50,-10,34
Portadown,824,10,8,4,18,25,45,-20,28
Ballinamalla,824,11,6,5,19,26,55,-29,23
Crusaders,825,1,18,6,6,59,33,26,60
Linfield,825,2,15,10,5,64,29,35,55
Ballymena,825,3,17,3,10,60,57,3,54
Cliftonville,825,4,14,3,13,51,39,12,45
Dungannon,825,5,11,9,10,53,40,13,42
Coleraine,825,6,11,9,10,38,43,-5,42
Glenavon,825,7,10,10,10,48,52,-4,40
Glentoran,825,8,10,7,13,27,41,-14,37
Portadown,825,9,8,8,14,29,41,-12,32
Ards,825,10,6,7,17,33,57,-24,25
Ballinamalla,825,11,7,4,19,33,63,-30,25
Cliftonville,826,1,16,6,8,59,39,20,54
Crusaders,826,2,14,9,7,54,40,14,51
Linfield,826,3,14,8,8,53,34,19,50
Glenavon,826,4,12,10,8,51,40,11,46
Dungannon,826,5,12,10,8,47,40,7,46
Ballymena,826,6,13,6,11,56,63,-7,45
Coleraine,826,7,11,9,10,42,43,-1,42
Ards,826,8,10,3,17,39,49,-10,33
Ballinamalla,826,9,9,5,16,35,49,-14,32
Glentoran,826,10,7,9,14,34,48,-14,30
Portadown,826,11,7,5,18,21,46,-25,26
Crusaders,827,1,16,6,8,51,37,14,54
Linfield,827,2,14,11,5,57,29,28,53
Ballymena,827,3,15,5,10,53,51,2,50
Coleraine,827,4,11,15,4,45,32,13,48
Cliftonville,827,5,13,9,8,46,34,12,48
Dungannon,827,6,11,9,10,54,41,13,42
Glentoran,827,7,10,7,13,37,43,-6,37
Ballinamalla,827,8,10,5,15,29,48,-19,35
Ards,827,9,9,5,16,33,49,-16,32
Glenavon,827,10,6,11,13,34,49,-15,29
Portadown,827,11,6,5,19,21,47,-26,23
Cliftonville,828,1,18,2,10,58,39,19,56
Crusaders,828,2,15,7,8,52,41,11,52
Ballymena,828,3,15,6,9,59,52,7,51
Glenavon,828,4,12,11,7,50,46,4,47
Dungannon,828,5,13,7,10,52,41,11,46
Coleraine,828,6,11,11,8,43,39,4,44
Linfield,828,7,11,9,10,51,34,17,42
Ards,828,8,10,5,15,34,50,-16,35
Glentoran,828,9,9,5,16,31,47,-16,32
Portadown,828,10,8,6,16,29,43,-14,30
Ballinamalla,828,11,7,3,20,30,57,-27,24
Cliftonville,829,1,19,4,7,62,40,22,61
Crusaders,829,2,17,8,5,53,27,26,59
Linfield,829,3,15,9,6,57,31,26,54
Ballymena,829,4,13,8,9,57,50,7,47
Coleraine,829,5,11,10,9,48,44,4,43
Glenavon,829,6,9,14,7,45,42,3,41
Ballinamalla,829,7,10,4,16,36,51,-15,34
Dungannon,829,8,8,9,13,51,55,-4,33
Ards,829,9,8,6,16,36,50,-14,30
Glentoran,829,10,5,11,14,30,53,-23,26
Portadown,829,11,6,5,19,25,57,-32,23
Glenavon,830,1,16,8,6,58,40,18,56
Linfield,830,2,15,8,7,60,41,19,53
Cliftonville,830,3,16,4,10,50,37,13,52
Crusaders,830,4,15,6,9,52,34,18,51
Dungannon,830,5,12,7,11,46,45,1,43
Ballymena,830,6,12,6,12,54,58,-4,42
Coleraine,830,7,10,10,10,39,41,-2,40
Ballinamalla,830,8,11,2,17,32,47,-15,35
Glentoran,830,9,9,7,14,36,44,-8,34
Ards,830,10,7,7,16,35,51,-16,28
Portadown,830,11,7,5,18,25,49,-24,26
Crusaders,831,1,19,6,5,70,44,26,63
Linfield,831,2,15,9,6,54,28,26,54
Cliftonville,831,3,16,6,8,60,36,24,54
Glenavon,831,4,11,14,5,47,38,9,47
Ballymena,831,5,13,7,10,55,55,0,46
Dungannon,831,6,12,8,10,49,45,4,44
Coleraine,831,7,11,10,9,48,45,3,43
Glentoran,831,8,7,8,15,25,43,-18,29
Ards,831,9,6,8,16,39,52,-13,26
Portadown,831,10,6,6,18,21,49,-28,24
Ballinamalla,831,11,5,6,19,23,56,-33,21
Cliftonville,832,1,20,3,7,62,38,24,63
Linfield,832,2,18,8,4,71,31,40,62
Crusaders,832,3,15,7,8,56,37,19,52
Coleraine,832,4,12,8,10,44,40,4,44
Ballymena,832,5,13,4,13,58,65,-7,43
Glenavon,832,6,10,11,9,45,48,-3,41
Glentoran,832,7,10,9,11,41,46,-5,39
Dungannon,832,8,8,9,13,51,51,0,33
Ballinamalla,832,9,8,6,16,35,54,-19,30
Ards,832,10,6,7,17,38,57,-19,25
Portadown,832,11,6,6,18,20,54,-34,24
Crusaders,833,1,15,8,7,58,38,20,53
Glenavon,833,2,14,9,7,53,46,7,51
Ballymena,833,3,14,7,9,55,52,3,49
Dungannon,833,4,13,8,9,56,40,16,47
Linfield,833,5,12,9,9,57,39,18,45
Coleraine,833,6,11,9,10,44,39,5,42
Cliftonville,833,7,12,5,13,45,42,3,41
Glentoran,833,8,11,8,11,33,44,-11,41
Portadown,833,9,11,4,15,25,36,-11,37
Ballinamalla,833,10,7,6,17,32,60,-28,27
Ards,833,11,6,5,19,36,58,-22,23
Linfield,834,1,14,11,5,60,31,29,53
Coleraine,834,2,13,12,5,49,39,10,51
Ballymena,834,3,15,4,11,60,59,1,49
Crusaders,834,4,13,9,8,54,41,13,48
Cliftonville,834,5,14,6,10,50,40,10,48
Portadown,834,6,13,3,14,31,40,-9,42
Glenavon,834,7,9,12,9,47,50,-3,39
Ards,834,8,9,7,14,39,47,-8,34
Glentoran,834,9,8,9,13,35,44,-9,33
Dungannon,834,10,7,11,12,45,49,-4,32
Ballinamalla,834,11,6,4,20,33,63,-30,22
Linfield,835,1,19,7,4,66,27,39,64
Crusaders,835,2,18,6,6,59,29,30,60
Cliftonville,835,3,17,4,9,48,31,17,55
Glenavon,835,4,13,7,10,43,50,-7,46
Ballymena,835,5,13,6,11,55,60,-5,45
Coleraine,835,6,11,8,11,41,41,0,41
Dungannon,835,7,9,7,14,44,38,6,34
Glentoran,835,8,9,7,14,30,43,-13,34
Ards,835,9,9,6,15,37,48,-11,33
Portadown,835,10,8,4,18,31,56,-25,28
Ballinamalla,835,11,7,2,21,25,56,-31,23
Crusaders,836,1,19,7,4,59,27,32,64
Cliftonville,836,2,15,6,9,59,43,16,51
Ballymena,836,3,13,9,8,62,57,5,48
Linfield,836,4,11,12,7,62,46,16,45
Glenavon,836,5,10,11,9,44,49,-5,41
Coleraine,836,6,10,9,11,44,41,3,39
Ards,836,7,10,7,13,41,50,-9,37
Ballinamalla,836,8,10,6,14,36,48,-12,36
Dungannon,836,9,9,8,13,44,45,-1,35
Glentoran,836,10,8,6,16,31,54,-23,30
Portadown,836,11,7,5,18,27,49,-22,26
Linfield,837,1,15,9,6,56,33,23,54
Dungannon,837,2,15,8,7,51,34,17,53
Cliftonville,837,3,15,5,10,59,41,18,50
Crusaders,837,4,13,10,7,53,40,13,49
Ballymena,837,5,14,6,10,54,57,-3,48
Glenavon,837,6,11,11,8,49,42,7,44
Coleraine,837,7,9,9,12,42,45,-3,36
Glentoran,837,8,9,8,13,36,49,-13,35
Ards,837,9,8,7,15,37,49,-12,31
Portadown,837,10,8,5,17,25,46,-21,29
Ballinamalla,837,11,6,6,18,31,57,-26,24
Linfield,838,1,15,11,4,60,31,29,56
Cliftonville,838,2,17,4,9,56,35,21,55
Coleraine,838,3,14,9,7,46,31,15,51
Crusaders,838,4,13,8,9,55,44,11,47
Ballymena,838,5,13,4,13,56,59,-3,43
Dungannon,838,6,11,9,10,57,43,14,42
Glenavon,838,7,9,11,10,41,50,-9,38
Ards,838,8,9,5,16,41,55,-14,32
Portadown,838,9,9,4,17,27,49,-22,31
Ballinamalla,838,10,9,4,17,30,55,-25,31
Glentoran,838,11,7,9,14,25,42,-17,30
Crusaders,839,1,15,7,8,53,35,18,52
Ballymena,839,2,15,5,10,61,56,5,50
Glenavon,839,3,13,11,6,46,42,4,50
Linfield,839,4,13,9,8,58,42,16,48
Dungannon,839,5,13,8,9,54,38,16,47
Cliftonville,839,6,14,5,11,51,41,10,47
Coleraine,839,7,12,11,7,49,45,4,47
Ards,839,8,8,6,16,40,53,-13,30
Glentoran,839,9,8,6,16,29,45,-16,30
Portadown,839,10,8,4,18,31,52,-21,28
Ballinamalla,839,11,8,4,18,24,47,-23,28
Crusaders,840,1,22,6,2,62,27,35,72
Cliftonville,840,2,16,5,9,54,34,20,53
Linfield,840,3,14,9,7,63,41,22,51
Ballymena,840,4,14,5,11,56,59,-3,47
Glenavon,840,5,11,11,8,47,44,3,44
Coleraine,840,6,10,11,9,40,36,4,41
Dungannon,840,7,10,7,13,41,39,2,37
Glentoran,840,8,10,7,13,28,41,-13,37
Ards,840,9,9,5,16,36,48,-12,32
Portadown,840,10,5,8,17,19,48,-29,23
Ballinamalla,840,11,5,4,21,27,56,-29,19
Crusaders,841,1,19,5,6,59,33,26,62
Cliftonville,841,2,16,6,8,52,35,17,54
Linfield,841,3,14,11,5,57,31,26,53
Ballymena,841,4,14,10,6,61,52,9,52
Coleraine,841,5,12,11,7,41,36,5,47
Dungannon,841,6,11,9,10,55,46,9,42
Glenavon,841,7,10,9,11,48,57,-9,39
Portadown,841,8,8,5,17,30,50,-20,29
Ards,841,9,8,4,18,39,50,-11,28
Glentoran,841,10,6,8,16,29,50,-21,26
Ballinamalla,841,11,6,4,20,30,61,-31,22
Coleraine,842,1,15,8,7,48,35,13,53
Cliftonville,842,2,15,7,8,59,39,20,52
Linfield,842,3,13,10,7,51,30,21,49
Crusaders,842,4,14,7,9,47,33,14,49
Ballymena,842,5,14,7,9,56,57,-1,49
Dungannon,842,6,10,11,9,45,35,10,41
Glenavon,842,7,10,9,11,42,43,-1,39
Ballinamalla,842,8,10,4,16,33,55,-22,34
Glentoran,842,9,8,9,13,29,42,-13,33
Portadown,842,10,9,2,19,24,49,-25,29
Ards,842,11,8,4,18,35,51,-16,28
Crusaders,843,1,18,6,6,61,41,20,60
Ballymena,843,2,15,6,9,52,48,4,51
Cliftonville,843,3,14,7,9,50,40,10,49
Linfield,843,4,13,8,9,54,31,23,47
Coleraine,843,5,12,10,8,42,39,3,46
Dungannon,843,6,12,8,10,64,45,19,44
Glenavon,843,7,8,11,11,38,46,-8,35
Glentoran,843,8,9,7,14,24,38,-14,34
Ballinamalla,843,9,10,4,16,31,48,-17,34
Ards,843,10,10,2,18,35,50,-15,32
Portadown,843,11,6,7,17,29,54,-25,25
Crusaders,844,1,18,5,7,62,39,23,59
Linfield,844,2,14,11,5,56,31,25,53
Ballymena,844,3,15,4,11,62,58,4,49
Coleraine,844,4,11,11,8,48,41,7,44
Dungannon,844,5,11,9,10,52,46,6,42
Glenavon,844,6,10,12,8,52,47,5,42
Cliftonville,844,7,12,4,14,47,45,2,40
Ards,844,8,10,6,14,38,45,-7,36
Glentoran,844,9,8,10,12,32,44,-12,34
Portadown,844,10,8,4,18,24,53,-29,28
Ballinamalla,844,11,7,6,17,28,52,-24,27
Linfield,845,1,14,10,6,62,37,25,52
Coleraine,845,2,13,12,5,45,32,13,51
Cliftonville,845,3,14,8,8,55,42,13,50
Crusaders,845,4,13,10,7,53,36,17,49
Ballymena,845,5,13,8,9,65,63,2,47
Glenavon,845,6,10,11,9,45,47,-2,41
Dungannon,845,7,9,11,10,46,42,4,38
Glentoran,845,8,9,9,12,34,49,-15,36
Ards,845,9,7,7,16,42,52,-10,28
Portadown,845,10,7,6,17,28,49,-21,27
Ballinamalla,845,11,7,6,17,25,51,-26,27
Cliftonville,846,1,17,4,9,51,32,19,55
Crusaders,846,2,15,8,7,50,39,11,53
Glenavon,846,3,13,11,6,47,39,8,50
Dungannon,846,4,12,11,7,47,34,13,47
Linfield,846,5,12,10,8,54,34,20,46
Ballymena,846,6,11,9,10,56,60,-4,42
Glentoran,846,7,11,5,14,35,47,-12,38
Coleraine,846,8,9,10,11,39,39,0,37
Ards,846,9,10,4,16,40,50,-10,34
Portadown,846,10,7,5,18,24,44,-20,26
Ballinamalla,846,11,7,5,18,27,52,-25,26
Linfield,847,1,15,10,5,58,25,33,55
Ballymena,847,2,17,3,10,61,62,-1,54
Crusaders,847,3,14,10,6,49,31,18,52
Cliftonville,847,4,16,4,10,59,43,16,52
Glenavon,847,5,14,9,7,49,38,11,51
Coleraine,847,6,11,11,8,46,40,6,44
Ards,847,7,12,5,13,41,48,-7,41
Dungannon,847,8,9,7,14,42,47,-5,34
Glentoran,847,9,8,7,15,26,40,-14,31
Ballinamalla,847,10,7,2,21,26,51,-25,23
Portadown,847,11,6,4,20,22,54,-32,22
Crusaders,848,1,18,6,6,54,35,19,60
Linfield,848,2,15,8,7,57,31,26,53
Coleraine,848,3,14,11,5,50,33,17,53
Ballymena,848,4,14,6,10,64,59,5,48
Cliftonville,848,5,13,8,9,48,37,11,47
Glenavon,848,6,9,13,8,43,48,-5,40
Ards,848,7,9,6,15,38,48,-10,33
Ballinamalla,848,8,8,9,13,29,48,-19,33
Dungannon,848,9,7,9,14,45,47,-2,30
Glentoran,848,10,6,10,14,26,44,-18,28
Portadown,848,11,5,8,17,26,50,-24,23
Cliftonville,849,1,17,6,7,55,32,23,57
Linfield,849,2,15,7,8,54,35,19,52
Crusaders,849,3,15,6,9,58,42,16,51
Glentoran,849,4,14,6,10,39,38,1,48
Ballymena,849,5,13,7,10,57,58,-1,46
Glenavon,849,6,11,12,7,50,46,4,45
Ards,849,7,11,4,15,42,49,-7,37
Coleraine,849,8,9,9,12,44,51,-7,36
Dungannon,849,9,6,14,10,47,47,0,32
Ballinamalla,849,10,7,7,16,29,53,-24,28
Portadown,849,11,6,4,20,23,47,-24,22
Linfield,850,1,19,7,4,70,26,44,64
Crusaders,850,2,16,6,8,53,38,15,54
Glenavon,850,3,13,8,9,59,49,10,47
Cliftonville,850,4,14,5,11,50,40,10,47
Ballymena,850,5,14,5,11,53,60,-7,47
Dungannon,850,6,12,9,9,56,41,15,45
Coleraine,850,7,10,12,8,34,37,-3,42
Portadown,850,8,10,4,16,22,40,-18,34
Ards,850,9,9,6,15,32,46,-14,33
Glentoran,850,10,7,4,19,27,50,-23,25
Ballinamalla,850,11,7,2,21,28,57,-29,23
Crusaders,851,1,16,7,7,59,41,18,55
Linfield,851,2,15,7,8,62,34,28,52
Dungannon,851,3,13,6,11,67,50,17,45
Cliftonville,851,4,14,3,13,57,53,4,45
Glenavon,851,5,12,9,9,50,48,2,45
Coleraine,851,6,12,8,10,45,43,2,44
Glentoran,851,7,11,8,11,35,39,-4,41
Ballymena,851,8,11,7,12,49,56,-7,40
Ballinamalla,851,9,10,5,15,35,50,-15,35
Ards,851,10,10,4,16,40,56,-16,34
Portadown,851,11,7,4,19,19,48,-29,25
Linfield,852,1,17,9,4,57,20,37,60
Cliftonville,852,2,18,4,8,57,37,20,58
Crusaders,852,3,16,7,7,57,39,18,55
Ballymena,852,4,15,5,10,61,58,3,50
Dungannon,852,5,12,8,10,61,53,8,44
Coleraine,852,6,10,11,9,42,36,6,41
Glentoran,852,7,10,7,13,37,47,-10,37
Glenavon,852,8,8,10,12,35,53,-18,34
Portadown,852,9,8,4,18,24,43,-19,28
Ballinamalla,852,10,9,1,20,31,57,-26,28
Ards,852,11,6,6,18,30,49,-19,24
Crusaders,853,1,16,6,8,50,35,15,54
Linfield,853,2,15,8,7,62,35,27,53
Cliftonville,853,3,16,3,11,49,39,10,51
Ballymena,853,4,15,4,11,58,60,-2,49
Dungannon,853,5,11,11,8,50,41,9,44
Coleraine,853,6,11,10,9,39,37,2,43
Glenavon,853,7,9,14,7,43,43,0,41
Ards,853,8,10,6,14,37,49,-12,36
Portadown,853,9,10,2,18,25,39,-14,32
Ballinamalla,853,10,8,5,17,35,51,-16,29
Glentoran,853,11,6,7,17,26,45,-19,25
Crusaders,854,1,16,8,6,60,42,18,56
Linfield,854,2,14,12,4,64,31,33,54
Cliftonville,854,3,15,8,7,49,32,17,53
Ballymena,854,4,15,6,9,54,51,3,51
Glenavon,854,5,11,12,7,49,42,7,45
Coleraine,854,6,8,13,9,39,43,-4,37
Ballinamalla,854,7,10,3,17,36,56,-20,33
Ards,854,8,9,5,16,38,48,-10,32
Dungannon,854,9,7,10,13,50,49,1,31
Glentoran,854,10,6,11,13,29,50,-21,29
Portadown,854,11,7,6,17,25,49,-24,27
Linfield,855,1,16,10,4,63,25,38,58
Cliftonville,855,2,15,7,8,51,37,14,52
Ballymena,855,3,15,5,10,62,57,5,50
Crusaders,855,4,14,6,10,52,41,11,48
Coleraine,855,5,12,9,9,44,38,6,45
Glenavon,855,6,9,13,8,40,41,-1,40
Ballinamalla,855,7,10,6,14,38,48,-10,36
Dungannon,855,8,8,10,12,46,45,1,34
Portadown,855,9,9,6,15,22,41,-19,33
Ards,855,10,9,5,16,35,52,-17,32
Glentoran,855,11,7,5,18,26,54,-28,26
Ballymena,856,1,16,6,8,63,58,5,54
Crusaders,856,2,13,12,5,50,33,17,51
Linfield,856,3,13,10,7,57,36,21,49
Cliftonville,856,4,14,7,9,52,38,14,49
Coleraine,856,5,10,12,8,40,34,6,42
Glenavon,856,6,10,11,9,46,50,-4,41
Dungannon,856,7,9,13,8,50,40,10,40
Ballinamalla,856,8,11,4,15,34,46,-12,37
Glentoran,856,9,8,9,13,30,48,-18,33
Portadown,856,10,9,5,16,30,47,-17,32
Ards,856,11,5,5,20,28,50,-22,20
Crusaders,857,1,18,5,7,67,38,29,59
Coleraine,857,2,12,12,6,45,34,11,48
Ballymena,857,3,13,9,8,59,56,3,48
Linfield,857,4,12,11,7,53,33,20,47
Cliftonville,857,5,14,5,11,46,45,1,47
Dungannon,857,6,9,12,9,53,46,7,39
Glentoran,857,7,9,9,12,32,44,-12,36
Glenavon,857,8,9,8,13,43,51,-8,35
Ards,857,9,9,7,14,42,46,-4,34
Portadown,857,10,9,6,15,35,54,-19,33
Ballinamalla,857,11,5,8,17,26,54,-28,23
Crusaders,858,1,16,9,5,60,39,21,57
Coleraine,858,2,16,8,6,50,36,14,56
Linfield,858,3,15,9,6,63,31,32,54
Cliftonville,858,4,15,4,11,54,40,14,49
Glenavon,858,5,10,14,6,47,41,6,44
Ballymena,858,6,12,7,11,56,61,-5,43
Dungannon,858,7,10,10,10,51,47,4,40
Glentoran,858,8,9,6,15,34,51,-17,33
Portadown,858,9,8,4,18,22,47,-25,28
Ards,858,10,6,7,17,34,55,-21,25
Ballinamalla,858,11,6,6,18,36,59,-23,24
Linfield,859,1,16,10,4,58,29,29,58
Crusaders,859,2,16,9,5,57,31,26,57
Glenavon,859,3,12,11,7,46,41,5,47
Coleraine,859,4,13,8,9,48,45,3,47
Dungannon,859,5,12,10,8,56,42,14,46
Ballymena,859,6,13,5,12,54,55,-1,44
Cliftonville,859,7,13,4,13,45,47,-2,43
Glentoran,859,8,9,9,12,36,43,-7,36
Ballinamalla,859,9,11,3,16,30,44,-14,36
Ards,859,10,7,4,19,36,58,-22,25
Portadown,859,11,3,7,20,20,51,-31,16
Crusaders,860,1,17,5,8,47,29,18,56
Cliftonville,860,2,16,5,9,55,33,22,53
Linfield,860,3,12,12,6,59,34,25,48
Ballymena,860,4,14,5,11,60,66,-6,47
Coleraine,860,5,12,9,9,42,37,5,45
Dungannon,860,6,11,9,10,55,47,8,42
Glenavon,860,7,10,10,10,50,47,3,40
Glentoran,860,8,9,9,12,32,47,-15,36
Portadown,860,9,10,5,15,28,45,-17,35
Ards,860,10,7,6,17,35,50,-15,27
Ballinamalla,860,11,6,7,17,25,53,-28,25
Crusaders,861,1,20,6,4,60,29,31,66
Linfield,861,2,15,9,6,64,38,26,54
Coleraine,861,3,12,10,8,44,33,11,46
Ballymena,861,4,12,9,9,54,50,4,45
Cliftonville,861,5,13,4,13,44,44,0,43
Dungannon,861,6,9,11,10,55,48,7,38
Glenavon,861,7,8,12,10,49,58,-9,36
Glentoran,861,8,9,7,14,32,42,-10,34
Ards,861,9,9,7,14,34,46,-12,34
Portadown,861,10,9,7,14,34,48,-14,34
Ballinamalla,861,11,7,2,21,23,57,-34,23
Linfield,862,1,18,7,5,62,32,30,61
Crusaders,862,2,17,7,6,57,30,27,58
Ballymena,862,3,16,6,8,67,54,13,54
Cliftonville,862,4,13,6,11,46,41,5,45
Dungannon,862,5,11,9,10,51,50,1,42
Glenavon,862,6,10,10,10,50,52,-2,40
Coleraine,862,7,9,11,10,38,41,-3,38
Ards,862,8,9,6,15,35,44,-9,33
Glentoran,862,9,9,4,17,29,48,-19,31
Ballinamalla,862,10,7,6,17,27,48,-21,27
Portadown,862,11,7,6,17,21,43,-22,27
Crusaders,863,1,19,6,5,61,30,31,63
Coleraine,863,2,13,12,5,45,32,13,51
Linfield,863,3,12,10,8,55,35,20,46
Cliftonville,863,4,14,4,12,53,44,9,46
Ballymena,863,5,11,11,8,56,58,-2,44
Glentoran,863,6,11,9,10,39,39,0,42
Dungannon,863,7,9,13,8,47,39,8,40
Glenavon,863,8,8,12,10,40,45,-5,36
Ards,863,9,8,6,16,38,57,-19,30
Portadown,863,10,7,4,19,20,53,-33,25
Ballinamalla,863,11,5,9,16,27,49,-22,24
Crusaders,864,1,18,6,6,60,33,27,60
Cliftonville,864,2,18,3,9,52,30,22,57
Coleraine,864,3,13,10,7,45,30,15,49
Ballymena,864,4,13,6,11,59,58,1,45
Linfield,864,5,12,8,10,55,39,16,44
Glentoran,864,6,12,7,11,29,35,-6,43
Dungannon,864,7,10,9,11,56,51,5,39
Glenavon,864,8,9,10,11,38,46,-8,37
Ballinamalla,864,9,10,2,18,32,58,-26,32
Ards,864,10,9,2,19,35,52,-17,29
Portadown,864,11,7,5,18,26,55,-29,26
Crusaders,865,1,16,9,5,51,28,23,57
Ballymena,865,2,15,7,8,59,54,5,52
Linfield,865,3,12,10,8,54,36,18,46
Coleraine,865,4,12,10,8,43,42,1,46
Cliftonville,865,5,13,5,12,52,43,9,44
Glenavon,865,6,11,11,8,44,38,6,44
Dungannon,865,7,9,10,11,45,45,0,37
Portadown,865,8,9,7,14,24,38,-14,34
Glentoran,865,9,8,8,14,27,40,-13,32
Ards,865,10,7,9,14,39,52,-13,30
Ballinamalla,865,11,7,6,17,23,45,-22,27
Crusaders,866,1,15,10,5,51,27,24,55
Cliftonville,866,2,16,6,8,53,36,17,54
Linfield,866,3,15,8,7,67,38,29,53
Ballymena,866,4,15,8,7,56,51,5,53
Glenavon,866,5,11,14,5,49,40,9,47
Coleraine,866,6,12,7,11,39,40,-1,43
Dungannon,866,7,8,13,9,48,44,4,37
Ards,866,8,9,4,17,36,48,-12,31
Ballinamalla,866,9,8,6,16,30,52,-22,30
Glentoran,866,10,7,7,16,26,46,-20,28
Portadown,866,11,5,5,20,20,53,-33,20
Crusaders,867,1,20,6,4,63,35,28,66
Cliftonville,867,2,14,6,10,51,40,11,48
Ballymena,867,3,14,4,12,59,61,-2,46
Linfield,867,4,12,9,9,56,42,14,45
Dungannon,867,5,12,8,10,54,42,12,44
Coleraine,867,6,11,10,9,41,39,2,43
Glenavon,867,7,11,9,10,48,47,1,42
Ards,867,8,12,4,14,45,49,-4,40
Glentoran,867,9,9,7,14,31,43,-12,34
Portadown,867,10,8,4,18,24,44,-20,28
Ballinamalla,867,11,6,5,19,29,59,-30,23
Crusaders,868,1,17,8,5,58,39,19,59
Linfield,868,2,13,8,9,54,36,18,47
Ballymena,868,3,14,5,11,52,53,-1,47
Coleraine,868,4,11,9,10,43,36,7,42
Glenavon,868,5,10,12,8,45,41,4,42
Dungannon,868,6,11,8,11,52,44,8,41
Cliftonville,868,7,10,8,12,42,46,-4,38
Ards,868,8,11,5,14,39,43,-4,38
Glentoran,868,9,9,10,11,35,42,-7,37
Ballinamalla,868,10,9,7,14,31,48,-17,34
Portadown,868,11,7,6,17,23,46,-23,27
Cliftonville,869,1,17,5,8,53,39,14,56
Coleraine,869,2,13,11,6,55,31,24,50
Linfield,869,3,13,10,7,64,40,24,49
Crusaders,869,4,13,9,8,50,35,15,48
Glenavon,869,5,12,11,7,52,48,4,47
Ballymena,869,6,12,5,13,52,67,-15,41
Ards,869,7,11,5,14,39,46,-7,38
Glentoran,869,8,11,5,14,30,45,-15,38
Dungannon,869,9,9,9,12,50,46,4,36
Ballinamalla,869,10,7,7,16,31,51,-20,28
Portadown,869,11,7,3,20,25,53,-28,24
Crusaders,870,1,16,8,6,53,34,19,56
Coleraine,870,2,15,9,6,51,33,18,54
Ballymena,870,3,14,8,8,60,52,8,50
Cliftonville,870,4,12,10,8,54,42,12,46
Linfield,870,5,10,12,8,45,33,12,42
Dungannon,870,6,11,9,10,49,40,9,42
Glenavon,870,7,7,14,9,44,51,-7,35
Ballinamalla,870,8,10,5,15,31,47,-16,35
Ards,870,9,8,8,14,36,48,-12,32
Glentoran,870,10,7,8,15,28,47,-19,29
Portadown,870,11,6,7,17,25,49,-24,25
Crusaders,871,1,17,7,6,57,31,26,58
Cliftonville,871,2,17,3,10,57,37,20,54
Linfield,871,3,13,8,9,55,33,22,47
Glenavon,871,4,12,10,8,53,39,14,46
Glentoran,871,5,13,6,11,35,41,-6,45
Coleraine,871,6,10,11,9,39,41,-2,41
Ballymena,871,7,9,10,11,49,63,-14,37
Portadown,871,8,10,5,15,27,44,-17,35
Ards,871,9,10,4,16,33,48,-15,34
Dungannon,871,10,8,7,15,50,55,-5,31
Ballinamalla,871,11,8,5,17,31,54,-23,29
Linfield,872,1,17,9,4,60,27,33,60
Ballymena,872,2,16,7,7,58,49,9,55
Crusaders,872,3,15,7,8,56,40,16,52
Cliftonville,872,4,14,7,9,48,40,8,49
Coleraine,872,5,12,8,10,40,42,-2,44
Glenavon,872,6,9,11,10,43,45,-2,38
Ards,872,7,9,8,13,43,47,-4,35
Dungannon,872,8,8,8,14,43,47,-4,32
Glentoran,872,9,8,8,14,31,47,-16,32
Portadown,872,10,6,11,13,27,42,-15,29
Ballinamalla,872,11,7,4,19,35,58,-23,25
Linfield,873,1,16,7,7,61,33,28,55
Cliftonville,873,2,15,5,10,57,40,17,50
Dungannon,873,3,14,8,8,55,40,15,50
Crusaders,873,4,14,7,9,47,34,13,49
Ballymena,873,5,14,7,9,69,60,9,49
Coleraine,873,6,11,12,7,44,39,5,45
Glenavon,873,7,9,11,10,45,47,-2,38
Ballinamalla,873,8,11,4,15,34,48,-14,37
Glentoran,873,9,8,9,13,23,40,-17,33
Portadown,873,10,7,6,17,29,55,-26,27
Ards,873,11,6,4,20,33,61,-28,22
Cliftonville,874,1,15,7,8,54,37,17,52
Crusaders,874,2,15,6,9,55,43,12,51
Glenavon,874,3,13,11,6,56,41,15,50
Linfield,874,4,14,7,9,61,39,22,49
Coleraine,874,5,12,9,9,53,41,12,45
Ballymena,874,6,12,8,10,53,55,-2,44
Ballinamalla,874,7,12,2,16,36,45,-9,38
Glentoran,874,8,10,7,13,30,54,-24,37
Dungannon,874,9,9,7,14,44,50,-6,34
Ards,874,10,10,4,16,39,55,-16,34
Portadown,874,11,6,6,18,27,48,-21,24
Crusaders,875,1,19,6,5,63,33,30,63
Glenavon,875,2,14,10,6,53,38,15,52
Ballymena,875,3,16,4,10,62,56,6,52
Linfield,875,4,14,9,7,56,30,26,51
Cliftonville,875,5,14,4,12,52,39,13,46
Coleraine,875,6,11,10,9,45,41,4,43
Dungannon,875,7,11,7,12,48,49,-1,40
Ards,875,8,10,5,15,38,54,-16,35
Glentoran,875,9,7,7,16,26,53,-27,28
Portadown,875,10,8,3,19,23,48,-25,27
Ballinamalla,875,11,7,3,20,29,54,-25,24
Linfield,876,1,16,8,6,59,30,29,56
Crusaders,876,2,16,7,7,52,31,21,55
Glenavon,876,3,12,12,6,52,45,7,48
Ballymena,876,4,13,8,9,55,54,1,47
Cliftonville,876,5,13,6,11,47,36,11,45
Ards,876,6,13,2,15,40,43,-3,41
Coleraine,876,7,9,12,9,35,35,0,39
Dungannon,876,8,9,8,13,50,52,-2,35
Glentoran,876,9,9,7,14,32,51,-19,34
Portadown,876,10,8,7,15,27,45,-18,31
Ballinamalla,876,11,7,3,20,25,52,-27,24
Crusaders,877,1,18,8,4,57,26,31,62
Linfield,877,2,14,8,8,62,33,29,50
Ballymena,877,3,13,9,8,53,52,1,48
Coleraine,877,4,11,13,6,43,38,5,46
Cliftonville,877,5,12,9,9,60,48,12,45
Glentoran,877,6,11,8,11,38,38,0,41
Glenavon,877,7,9,12,9,42,45,-3,39
Portadown,877,8,10,6,14,34,49,-15,36
Ards,877,9,9,5,16,32,48,-16,32
Dungannon,877,10,6,10,14,39,50,-11,28
Ballinamalla,877,11,6,4,20,25,58,-33,22
Ballymena,878,1,17,5,8,69,59,10,56
Crusaders,878,2,16,7,7,51,35,16,55
Linfield,878,3,13,9,8,59,36,23,48
Glenavon,878,4,13,8,9,48,45,3,47
Coleraine,878,5,12,9,9,45,42,3,45
Cliftonville,878,6,11,7,12,54,51,3,40
Dungannon,878,7,10,9,11,48,42,6,39
Ards,878,8,9,5,16,34,48,-14,32
Portadown,878,9,9,5,16,26,45,-19,32
Ballinamalla,878,10,8,7,15,35,48,-13,31
Glentoran,878,11,7,9,14,28,46,-18,30
Crusaders,879,1,17,6,7,51,29,22,57
Linfield,879,2,14,10,6,57,35,22,52
Cliftonville,879,3,15,5,10,50,35,15,50
Ballymena,879,4,14,6,10,60,55,5,48
Coleraine,879,5,12,10,8,43,37,6,46
Glenavon,879,6,12,10,8,49,44,5,46
Dungannon,879,7,11,9,10,51,41,10,42
Ards,879,8,11,5,14,36,42,-6,38
Glentoran,879,9,8,6,16,27,49,-22,30
Portadown,879,10,7,4,19,22,47,-25,25
Ballinamalla,879,11,6,5,19,24,56,-32,23
Crusaders,880,1,16,8,6,53,34,19,56
Linfield,880,2,15,10,5,57,26,31,55
Cliftonville,880,3,16,4,10,53,36,17,52
Dungannon,880,4,13,8,9,53,39,14,47
Ballymena,880,5,14,5,11,55,57,-2,47
Coleraine,880,6,12,8,10,40,39,1,44
Glenavon,880,7,10,10,10,49,47,2,40
Ards,880,8,12,3,15,42,49,-7,39
Glentoran,880,9,6,9,15,26,50,-24,27
Ballinamalla,880,10,8,3,19,26,53,-27,27
Portadown,880,11,6,6,18,25,49,-24,24
Ballymena,881,1,17,7,6,64,49,15,58
Crusaders,881,2,17,6,7,53,35,18,57
Linfield,881,3,15,9,6,60,34,26,54
Dungannon,881,4,12,9,9,53,42,11,45
Coleraine,881,5,12,9,9,41,36,5,45
Cliftonville,881,6,13,4,13,47,45,2,43
Ards,881,7,12,3,15,38,42,-4,39
Glenavon,881,8,9,9,12,40,49,-9,36
Ballinamalla,881,9,9,4,17,31,49,-18,31
Glentoran,881,10,6,10,14,26,43,-17,28
Portadown,881,11,5,6,19,21,50,-29,21
Cliftonville,882,1,19,5,6,59,35,24,62
Linfield,882,2,15,10,5,60,34,26,55
Crusaders,882,3,16,7,7,48,28,20,55
Coleraine,882,4,12,11,7,39,27,12,47
Glentoran,882,5,12,6,12,36,42,-6,42
Ballymena,882,6,12,5,13,54,62,-8,41
Dungannon,882,7,11,7,12,51,45,6,40
Glenavon,882,8,8,12,10,45,50,-5,36
Ballinamalla,882,9,7,7,16,25,50,-25,28
Ards,882,10,6,7,17,31,48,-17,25
Portadown,882,11,7,3,20,22,49,-27,24
Crusaders,883,1,19,7,4,66,29,37,64
Ballymena,883,2,16,8,6,66,54,12,56
Glenavon,883,3,13,10,7,50,51,-1,49
Linfield,883,4,10,11,9,50,37,13,41
Coleraine,883,5,10,10,10,38,39,-1,40
Cliftonville,883,6,11,6,13,41,41,0,39
Ards,883,7,10,7,13,40,49,-9,37
Glentoran,883,8,10,7,13,29,41,-12,37
Ballinamalla,883,9,9,5,16,37,50,-13,32
Dungannon,883,10,6,12,12,42,46,-4,30
Portadown,883,11,6,7,17,21,43,-22,25
Crusaders,884,1,17,7,6,57,38,19,58
Linfield,884,2,14,9,7,58,31,27,51
Ballymena,884,3,14,6,10,61,56,5,48
Glenavon,884,4,12,8,10,51,48,3,44
Cliftonville,884,5,11,9,10,52,42,10,42
Coleraine,884,6,10,12,8,45,41,4,42
Dungannon,884,7,7,14,9,54,50,4,35
Ards,884,8,9,7,14,35,47,-12,34
Ballinamalla,884,9,9,5,16,33,55,-22,32
Portadown,884,10,7,10,13,30,47,-17,31
Glentoran,884,11,6,11,13,32,53,-21,29
Crusaders,885,1,16,9,5,55,30,25,57
Linfield,885,2,15,10,5,66,37,29,55
Cliftonville,885,3,16,7,7,63,41,22,55
Coleraine,885,4,10,12,8,44,40,4,42
Ballymena,885,5,11,7,12,47,58,-11,40
Glenavon,885,6,8,14,8,36,39,-3,38
Glentoran,885,7,9,11,10,33,39,-6,38
Portadown,885,8,10,6,14,29,41,-12,36
Dungannon,885,9,8,11,11,46,47,-1,35
Ballinamalla,885,10,8,3,19,29,57,-28,27
Ards,885,11,6,6,18,32,51,-19,24
Crusaders,886,1,17,6,7,62,37,25,57
Coleraine,886,2,14,12,4,46,29,17,54
Cliftonville,886,3,14,6,10,52,41,11,48
Ballymena,886,4,13,8,9,53,55,-2,47
Linfield,886,5,11,11,8,57,36,21,44
Dungannon,886,6,11,9,10,49,41,8,42
Glenavon,886,7,9,14,7,51,50,1,41
Ards,886,8,8,10,12,35,40,-5,34
Glentoran,886,9,8,9,13,27,48,-21,33
Ballinamalla,886,10,8,5,17,36,56,-20,29
Portadown,886,11,3,8,19,16,51,-35,17
Crusaders,887,1,18,8,4,58,33,25,62
Ballymena,887,2,16,6,8,58,51,7,54
Linfield,887,3,13,11,6,57,28,29,50
Cliftonville,887,4,14,4,12,54,44,10,46
Glenavon,887,5,11,11,8,46,46,0,44
Dungannon,887,6,11,8,11,56,45,11,41
Glentoran,887,7,11,6,13,31,39,-8,39
Coleraine,887,8,10,7,13,39,45,-6,37
Ards,887,9,9,4,17,33,50,-17,31
Portadown,887,10,9,4,17,29,53,-24,31
Ballinamalla,887,11,7,3,20,31,58,-27,24
Linfield,888,1,15,10,5,58,32,26,55
Crusaders,888,2,16,6,8,52,36,16,54
Ballymena,888,3,13,8,9,58,57,1,47
Cliftonville,888,4,14,3,13,51,38,13,45
Glenavon,888,5,11,12,7,47,44,3,45
Coleraine,888,6,11,10,9,41,40,1,43
Glentoran,888,7,10,8,12,37,45,-8,38
Dungannon,888,8,8,11,11,45,43,2,35
Ards,888,9,9,7,14,35,48,-13,34
Portadown,888,10,8,8,14,26,42,-16,32
Ballinamalla,888,11,5,7,18,30,55,-25,22
Linfield,889,1,17,9,4,65,30,35,60
Crusaders,889,2,15,7,8,59,43,16,52
Cliftonville,889,3,14,6,10,55,42,13,48
Glenavon,889,4,10,14,6,48,41,7,44
Ballymena,889,5,13,5,12,62,60,2,44
Coleraine,889,6,11,9,10,37,37,0,42
Dungannon,889,7,10,9,11,51,45,6,39
Portadown,889,8,10,8,12,29,43,-14,38
Glentoran,889,9,7,9,14,33,55,-22,30
Ards,889,10,7,7,16,34,52,-18,28
Ballinamalla,889,11,7,5,18,29,54,-25,26
Ballymena,890,1,16,6,8,62,48,14,54
Cliftonville,890,2,17,2,11,50,38,12,53
Linfield,890,3,13,9,8,60,37,23,48
Crusaders,890,4,13,8,9,50,40,10,47
Dungannon,890,5,12,9,9,53,42,11,45
Glenavon,890,6,11,12,7,55,49,6,45
Coleraine,890,7,11,11,8,40,39,1,44
Ards,890,8,7,9,14,34,46,-12,30
Glentoran,890,9,8,6,16,29,50,-21,30
Portadown,890,10,8,6,16,27,52,-25,30
Ballinamalla,890,11,8,4,18,28,47,-19,28
Linfield,891,1,14,11,5,60,26,34,53
Cliftonville,891,2,16,5,9,53,41,12,53
Coleraine,891,3,14,7,9,43,35,8,49
Crusaders,891,4,13,8,9,48,41,7,47
Glenavon,891,5,11,11,8,53,50,3,44
Glentoran,891,6,12,6,12,31,40,-9,42
Ards,891,7,10,7,13,36,48,-12,37
Dungannon,891,8,9,8,13,48,46,2,35
Ballymena,891,9,8,9,13,53,63,-10,33
Ballinamalla,891,10,8,6,16,35,52,-17,30
Portadown,891,11,8,6,16,25,43,-18,30
Crusaders,892,1,16,9,5,57,30,27,57
Linfield,892,2,14,9,7,59,32,27,51
Cliftonville,892,3,14,7,9,48,38,10,49
Ballymena,892,4,13,5,12,61,66,-5,44
Dungannon,892,5,11,10,9,56,42,14,43
Coleraine,892,6,10,13,7,42,35,7,43
Ards,892,7,10,6,14,37,50,-13,36
Portadown,892,8,10,5,15,29,41,-12,35
Ballinamalla,892,9,9,7,14,28,49,-21,34
Glenavon,892,10,8,9,13,38,50,-12,33
Glentoran,892,11,6,8,16,30,52,-22,26
Cliftonville,893,1,16,7,7,58,35,23,55
Crusaders,893,2,15,9,6,48,30,18,54
Ballymena,893,3,15,9,6,62,52,10,54
Linfield,893,4,14,10,6,59,34,25,52
Coleraine,893,5,12,10,8,41,38,3,46
Dungannon,893,6,11,11,8,61,48,13,44
Glenavon,893,7,11,10,9,42,46,-4,43
Glentoran,893,8,8,10,12,25,38,-13,34
Ards,893,9,10,3,17,42,53,-11,33
Ballinamalla,893,10,4,6,20,25,57,-32,18
Portadown,893,11,3,7,20,26,58,-32,16
Ballymena,894,1,18,3,9,65,60,5,57
Cliftonville,894,2,16,4,10,55,39,16,52
Crusaders,894,3,14,10,6,55,40,15,52
Linfield,894,4,14,8,8,54,31,23,50
Glenavon,894,5,13,11,6,63,48,15,50
Coleraine,894,6,11,8,11,48,40,8,41
Dungannon,894,7,11,7,12,52,52,0,40
Glentoran,894,8,9,7,14,33,49,-16,34
Ballinamalla,894,9,10,3,17,30,48,-18,33
Ards,894,10,8,3,19,31,50,-19,27
Portadown,894,11,7,4,19,31,60,-29,25
Crusaders,895,1,16,8,6,58,32,26,56
Glenavon,895,2,14,9,7,56,42,14,51
Ballymena,895,3,14,8,8,56,54,2,50
Cliftonville,895,4,14,7,9,57,40,17,49
Linfield,895,5,13,9,8,50,35,15,48
Dungannon,895,6,12,8,10,56,45,11,44
Coleraine,895,7,12,8,10,36,44,-8,44
Ballinamalla,895,8,10,2,18,32,53,-21,32
Glentoran,895,9,8,7,15,32,49,-17,31
Portadown,895,10,7,9,14,29,44,-15,30
Ards,895,11,6,3,21,31,55,-24,21
Crusaders,896,1,18,7,5,59,32,27,61
Linfield,896,2,15,8,7,58,35,23,53
Ballymena,896,3,13,10,7,61,60,1,49
Glenavon,896,4,13,9,8,54,44,10,48
Cliftonville,896,5,12,8,10,41,37,4,44
Coleraine,896,6,11,10,9,45,41,4,43
Dungannon,896,7,9,9,12,48,48,0,36
Ballinamalla,896,8,9,5,16,34,50,-16,32
Glentoran,896,9,8,8,14,30,46,-16,32
Portadown,896,10,8,5,17,29,46,-17,29
Ards,896,11,6,7,17,39,59,-20,25
Crusaders,897,1,16,9,5,51,32,19,57
Cliftonville,897,2,17,5,8,56,33,23,56
Linfield,897,3,15,9,6,62,31,31,54
Ballymena,897,4,16,4,10,63,57,6,52
Glenavon,897,5,12,10,8,48,44,4,46
Coleraine,897,6,12,9,9,43,40,3,45
Dungannon,897,7,11,8,11,45,38,7,41
Ballinamalla,897,8,8,5,17,24,44,-20,29
Glentoran,897,9,6,8,16,32,53,-21,26
Ards,897,10,6,8,16,34,56,-22,26
Portadown,897,11,6,5,19,24,54,-30,23
Cliftonville,898,1,18,5,7,58,32,26,59
Glenavon,898,2,15,8,7,50,44,6,53
Linfield,898,3,14,9,7,56,34,22,51
Ballymena,898,4,15,5,10,55,55,0,50
Crusaders,898,5,14,6,10,50,40,10,48
Ards,898,6,11,5,14,36,45,-9,38
Dungannon,898,7,9,10,11,43,40,3,37
Coleraine,898,8,8,10,12,36,40,-4,34
Ballinamalla,898,9,9,4,17,33,53,-20,31
Portadown,898,10,8,5,17,28,45,-17,29
Glentoran,898,11,6,9,15,35,52,-17,27
Crusaders,899,1,20,5,5,56,27,29,65
Linfield,899,2,17,7,6,63,28,35,58
Cliftonville,899,3,18,3,9,52,39,13,57
Glenavon,899,4,11,12,7,47,43,4,45
Ballymena,899,5,13,5,12,50,57,-7,44
Dungannon,899,6,11,9,10,65,51,14,42
Coleraine,899,7,10,10,10,39,40,-1,40
Ards,899,8,9,6,15,41,51,-10,33
Portadown,899,9,8,6,16,24,41,-17,30
Glentoran,899,10,8,4,18,27,46,-19,28
Ballinamalla,899,11,5,3,22,20,61,-41,18
Crusaders,900,1,16,8,6,59,35,24,56
Linfield,900,2,15,9,6,58,38,20,54
Cliftonville,900,3,17,3,10,55,36,19,54
Coleraine,900,4,15,8,7,45,31,14,53
Glenavon,900,5,14,10,6,50,39,11,52
Ballymena,900,6,12,7,11,61,62,-1,43
Dungannon,900,7,9,10,11,53,49,4,37
Glentoran,900,8,8,9,13,31,47,-16,33
Portadown,900,9,6,7,17,24,46,-22,25
Ards,900,10,7,4,19,34,59,-25,25
Ballinamalla,900,11,6,5,19,29,57,-28,23
Cliftonville,901,1,17,5,8,54,33,21,56
Crusaders,901,2,15,9,6,47,29,18,54
Linfield,901,3,15,7,8,65,35,30,52
Ballymena,901,4,15,5,10,52,54,-2,50
Glenavon,901,5,10,12,8,51,49,2,42
Coleraine,901,6,11,9,10,42,42,0,42
Dungannon,901,7,8,14,8,45,40,5,38
Portadown,901,8,8,7,15,31,47,-16,31
Glentoran,901,9,7,9,14,24,42,-18,30
Ards,901,10,8,5,17,35,54,-19,29
Ballinamalla,901,11,8,4,18,32,53,-21,28
Crusaders,902,1,19,6,5,63,30,33,63
Cliftonville,902,2,16,6,8,52,37,15,54
Ballymena,902,3,15,3,12,60,55,5,48
Glenavon,902,4,13,8,9,51,45,6,47
Linfield,902,5,13,7,10,47,32,15,46
Ards,902,6,12,5,13,44,48,-4,41
Coleraine,902,7,9,11,10,39,46,-7,38
Portadown,902,8,10,5,15,33,44,-11,35
Glentoran,902,9,10,5,15,30,45,-15,35
Dungannon,902,10,6,9,15,47,58,-11,27
Ballinamalla,902,11,8,3,19,28,54,-26,27
Linfield,903,1,19,8,3,70,29,41,65
Cliftonville,903,2,17,6,7,64,40,24,57
Crusaders,903,3,14,7,9,51,42,9,49
Glenavon,903,4,12,11,7,52,43,9,47
Ballymena,903,5,11,8,11,51,62,-11,41
Coleraine,903,6,9,12,9,37,39,-2,39
Ards,903,7,10,6,14,39,47,-8,36
Dungannon,903,8,8,9,13,50,48,2,33
Ballinamalla,903,9,9,4,17,34,52,-18,31
Portadown,903,10,9,4,17,28,51,-23,31
Glentoran,903,11,6,7,17,26,49,-23,25
Linfield,904,1,19,8,3,64,23,41,65
Ballymena,904,2,16,6,8,68,62,6,54
Crusaders,904,3,15,6,9,53,37,16,51
Cliftonville,904,4,14,6,10,54,41,13,48
Glenavon,904,5,10,13,7,46,44,2,43
Coleraine,904,6,10,12,8,46,42,4,42
Dungannon,904,7,9,11,10,44,42,2,38
Glentoran,904,8,7,9,14,26,41,-15,30
Portadown,904,9,7,7,16,22,44,-22,28
Ards,904,10,7,5,18,35,54,-19,26
Ballinamalla,904,11,4,11,15,26,54,-28,23
Ballymena,905,1,15,9,6,58,49,9,54
Glenavon,905,2,14,10,6,51,41,10,52
Crusaders,905,3,13,9,8,49,31,18,48
Cliftonville,905,4,13,6,11,51,43,8,45
Dungannon,905,5,11,9,10,52,40,12,42
Ards,905,6,11,7,12,41,44,-3,40
Coleraine,905,7,9,12,9,42,41,1,39
Linfield,905,8,9,10,11,43,34,9,37
Glentoran,905,9,8,9,13,38,54,-16,33
Ballinamalla,905,10,9,6,15,31,48,-17,33
Portadown,905,11,6,7,17,20,51,-31,25
Crusaders,906,1,15,8,7,50,31,19,53
Linfield,906,2,13,12,5,62,35,27,51
Cliftonville,906,3,15,5,10,52,43,9,50
Dungannon,906,4,13,8,9,52,40,12,47
Ballymena,906,5,13,7,10,65,63,2,46
Glenavon,906,6,11,10,9,47,45,2,43
Coleraine,906,7,11,10,9,39,39,0,43
Glentoran,906,8,9,7,14,29,46,-17,34
Portadown,906,9,8,7,15,29,47,-18,31
Ards,906,10,7,8,15,41,49,-8,29
Ballinamalla,906,11,7,4,19,24,52,-28,25
Linfield,907,1,18,8,4,58,27,31,62
Glenavon,907,2,14,10,6,51,36,15,52
Cliftonville,907,3,15,7,8,49,34,15,52
Crusaders,907,4,14,8,8,48,30,18,50
Coleraine,907,5,13,8,9,46,35,11,47
Ballymena,907,6,13,6,11,52,56,-4,45
Dungannon,907,7,9,6,15,46,54,-8,33
Glentoran,907,8,9,6,15,32,48,-16,33
Ballinamalla,907,9,9,4,17,33,55,-22,31
Portadown,907,10,9,3,18,25,48,-23,30
Ards,907,11,6,6,18,33,50,-17,24
Linfield,908,1,15,10,5,61,33,28,55
Crusaders,908,2,15,9,6,53,37,16,54
Cliftonville,908,3,15,9,6,48,36,12,54
Glenavon,908,4,13,8,9,51,42,9,47
Coleraine,908,5,11,10,9,39,37,2,43
Ballymena,908,6,12,6,12,50,56,-6,42
Dungannon,908,7,9,10,11,49,49,0,37
Glentoran,908,8,10,5,15,31,44,-13,35
Ards,908,9,9,6,15,38,49,-11,33
Ballinamalla,908,10,7,7,16,28,47,-19,28
Portadown,908,11,6,6,18,25,43,-18,24
Linfield,909,1,14,10,6,57,29,28,52
Crusaders,909,2,14,8,8,53,36,17,50
Cliftonville,909,3,15,4,11,53,47,6,49
Coleraine,909,4,12,12,6,37,30,7,48
Glenavon,909,5,12,11,7,51,45,6,47
Dungannon,909,6,12,9,9,56,43,13,45
Ballymena,909,7,13,5,12,59,61,-2,44
Ards,909,8,7,9,14,34,48,-14,30
Ballinamalla,909,9,8,6,16,30,47,-17,30
Portadown,909,10,8,5,17,32,52,-20,29
Glentoran,909,11,7,7,16,25,49,-24,28
Crusaders,910,1,16,8,6,54,34,20,56
Cliftonville,910,2,15,9,6,51,35,16,54
Linfield,910,3,14,10,6,59,30,29,52
Ballymena,910,4,11,13,6,52,51,1,46
Glenavon,910,5,9,13,8,47,43,4,40
Coleraine,910,6,8,14,8,37,35,2,38
Ards,910,7,11,5,14,41,49,-8,38
Dungannon,910,8,8,9,13,49,49,0,33
Glentoran,910,9,9,6,15,33,50,-17,33
Ballinamalla,910,10,9,4,17,32,57,-25,31
Portadown,910,11,7,5,18,21,43,-22,26
Crusaders,911,1,17,7,6,53,33,20,58
Linfield,911,2,15,7,8,59,37,22,52
Cliftonville,911,3,15,5,10,55,37,18,50
Glenavon,911,4,13,9,8,52,41,11,48
Ballymena,911,5,12,8,10,51,57,-6,44
Coleraine,911,6,10,10,10,39,44,-5,40
Dungannon,911,7,10,8,12,52,45,7,38
Glentoran,911,8,9,11,10,33,40,-7,38
Ballinamalla,911,9,8,8,14,29,50,-21,32
Ards,911,10,8,6,16,35,51,-16,30
Portadown,911,11,6,5,19,30,53,-23,23
Linfield,912,1,15,9,6,57,32,25,54
Glenavon,912,2,14,11,5,58,47,11,53
Crusaders,912,3,13,9,8,51,37,14,48
Cliftonville,912,4,12,7,11,49,42,7,43
Coleraine,912,5,11,10,9,43,42,1,43
Dungannon,912,6,11,7,12,49,48,1,40
Ballymena,912,7,11,7,12,55,63,-8,40
Ards,912,8,10,7,13,47,51,-4,37
Glentoran,912,9,9,7,14,31,47,-16,34
Portadown,912,10,7,9,14,28,43,-15,30
Ballinamalla,912,11,7,7,16,31,47,-16,28
Linfield,913,1,17,8,5,66,32,34,59
Ballymena,913,2,17,3,10,58,51,7,54
Cliftonville,913,3,15,4,11,54,41,13,49
Crusaders,913,4,14,7,9,50,39,11,49
Coleraine,913,5,12,9,9,39,35,4,45
Glenavon,913,6,10,11,9,43,42,1,41
Dungannon,913,7,10,10,10,47,43,4,40
Glentoran,913,8,10,7,13,30,43,-13,37
Ards,913,9,8,7,15,33,46,-13,31
Portadown,913,10,9,3,18,22,47,-25,30
Ballinamalla,913,11,6,5,19,30,53,-23,23
Linfield,914,1,18,7,5,67,30,37,61
Glenavon,914,2,15,9,6,56,45,11,54
Crusaders,914,3,15,8,7,57,42,15,53
Coleraine,914,4,14,8,8,38,32,6,50
Cliftonville,914,5,14,5,11,44,37,7,47
Ballymena,914,6,13,6,11,54,53,1,45
Dungannon,914,7,9,9,12,48,47,1,36
Ards,914,8,10,3,17,33,44,-11,33
Portadown,914,9,8,6,16,32,44,-12,30
Glentoran,914,10,6,8,16,22,52,-30,26
Ballinamalla,914,11,7,3,20,28,53,-25,24
Linfield,915,1,16,10,4,63,29,34,58
Glenavon,915,2,14,11,5,57,42,15,53
Cliftonville,915,3,15,7,8,56,39,17,52
Crusaders,915,4,15,6,9,59,37,22,51
Dungannon,915,5,13,7,10,51,37,14,46
Coleraine,915,6,10,12,8,40,45,-5,42
Ballymena,915,7,12,5,13,56,55,1,41
Portadown,915,8,8,6,16,25,44,-19,30
Ards,915,9,8,4,18,33,57,-24,28
Glentoran,915,10,7,7,16,28,52,-24,28
Ballinamalla,915,11,7,5,18,26,57,-31,26
Linfield,916,1,15,10,5,63,34,29,55
Crusaders,916,2,16,5,9,47,36,11,53
Ballymena,916,3,16,5,9,57,53,4,53
Cliftonville,916,4,14,5,11,54,40,14,47
Dungannon,916,5,11,10,9,53,41,12,43
Coleraine,916,6,10,12,8,37,34,3,42
Glenavon,916,7,11,9,10,43,46,-3,42
Glentoran,916,8,11,6,13,33,41,-8,39
Ards,916,9,10,5,15,40,50,-10,35
Ballinamalla,916,10,8,4,18,28,49,-21,28
Portadown,916,11,6,3,21,23,54,-31,21
Cliftonville,917,1,17,6,7,59,42,17,57
Crusaders,917,2,14,9,7,53,36,17,51
Linfield,917,3,14,8,8,64,38,26,50
Glenavon,917,4,13,10,7,59,49,10,49
Ballymena,917,5,13,7,10,62,56,6,46
Coleraine,917,6,12,9,9,41,38,3,45
Dungannon,917,7,11,11,8,55,43,12,44
Glentoran,917,8,8,10,12,32,47,-15,34
Ards,917,9,7,6,17,29,50,-21,27
Portadown,917,10,5,10,15,27,52,-25,25
Ballinamalla,917,11,4,8,18,24,54,-30,20
Linfield,918,1,16,12,2,62,27,35,60
Crusaders,918,2,17,8,5,58,37,21,59
Ballymena,918,3,15,8,7,67,50,17,53
Coleraine,918,4,11,10,9,40,37,3,43
Cliftonville,918,5,12,6,12,42,37,5,42
Glenavon,918,6,9,11,10,47,49,-2,38
Ballinamalla,918,7,11,3,16,35,50,-15,36
Ards,918,8,10,3,17,39,56,-17,33
Dungannon,918,9,7,10,13,49,48,1,31
Glentoran,918,10,8,7,15,36,58,-22,31
Portadown,918,11,8,4,18,30,56,-26,28
Crusaders,919,1,17,8,5,59,33,26,59
Linfield,919,2,16,10,4,60,28,32,58
Cliftonville,919,3,16,6,8,52,37,15,54
Glenavon,919,4,13,10,7,48,38,10,49
Coleraine,919,5,13,7,10,45,36,9,46
Ballymena,919,6,11,6,13,46,52,-6,39
Dungannon,919,7,8,11,11,44,43,1,35
Ards,919,8,10,5,15,38,49,-11,35
Glentoran,919,9,8,10,12,34,47,-13,34
Portadown,919,10,6,5,19,22,52,-30,23
Ballinamalla,919,11,5,6,19,23,56,-33,21
Linfield,920,1,18,8,4,72,28,44,62
Crusaders,920,2,15,9,6,51,35,16,54
Cliftonville,920,3,16,3,11,48,36,12,51
Glenavon,920,4,13,10,7,42,42,0,49
Coleraine,920,5,13,9,8,47,34,13,48
Ballymena,920,6,12,7,11,53,59,-6,43
Dungannon,920,7,9,9,12,52,45,7,36
Ballinamalla,920,8,10,2,18,26,49,-23,32
Ards,920,9,8,5,17,35,51,-16,29
Portadown,920,10,8,4,18,23,48,-25,28
Glentoran,920,11,7,6,17,26,48,-22,27
Crusaders,921,1,17,7,6,60,36,24,58
Linfield,921,2,15,10,5,51,26,25,55
Cliftonville,921,3,16,6,8,54,34,20,54
Glenavon,921,4,9,15,6,44,40,4,42
Ballymena,921,5,10,8,12,51,61,-10,38
Glentoran,921,6,10,7,13,34,42,-8,37
Dungannon,921,7,8,12,10,48,48,0,36
Coleraine,921,8,8,12,10,36,40,-4,36
Ballinamalla,921,9,11,3,16,34,50,-16,36
Ards,921,10,7,8,15,35,48,-13,29
Portadown,921,11,7,6,17,24,46,-22,27
Crusaders,922,1,20,4,6,68,41,27,64
Ballymena,922,2,16,5,9,61,55,6,53
Coleraine,922,3,11,11,8,43,33,10,44
Cliftonville,922,4,12,7,11,47,45,2,43
Linfield,922,5,11,9,10,53,43,10,42
Ards,922,6,12,5,13,47,46,1,41
Glenavon,922,7,10,11,9,42,45,-3,41
Ballinamalla,922,8,11,4,15,34,46,-12,37
Glentoran,922,9,9,8,13,34,44,-10,35
Dungannon,922,10,8,8,14,46,47,-1,32
Portadown,922,11,5,8,17,24,54,-30,23
Crusaders,923,1,14,9,7,53,35,18,51
Linfield,923,2,13,8,9,58,34,24,47
Glenavon,923,3,12,11,7,50,44,6,47
Coleraine,923,4,12,8,10,43,44,-1,44
Dungannon,923,5,11,10,9,55,48,7,43
Ballymena,923,6,13,4,13,62,64,-2,43
Cliftonville,923,7,12,6,12,46,43,3,42
Glentoran,923,8,12,6,12,38,44,-6,42
Ballinamalla,923,9,9,6,15,33,52,-19,33
Ards,923,10,8,7,15,35,48,-13,31
Portadown,923,11,8,7,15,28,45,-17,31
Crusaders,924,1,19,5,6,55,30,25,62
Cliftonville,924,2,16,5,9,51,37,14,53
Linfield,924,3,13,10,7,62,34,28,49
Ballymena,924,4,12,9,9,48,56,-8,45
Dungannon,924,5,12,7,11,49,37,12,43
Coleraine,924,6,11,10,9,37,35,2,43
Glenavon,924,7,8,13,9,44,43,1,37
Glentoran,924,8,9,7,14,31,43,-12,34
Portadown,924,9,9,5,16,22,44,-22,32
Ards,924,10,8,5,17,33,52,-19,29
Ballinamalla,924,11,8,4,18,27,48,-21,28
Crusaders,925,1,17,8,5,66,41,25,59
Linfield,925,2,17,7,6,60,32,28,58
Glenavon,925,3,15,7,8,55,50,5,52
Coleraine,925,4,13,8,9,47,36,11,47
Cliftonville,925,5,13,6,11,58,46,12,45
Ballymena,925,6,12,8,10,54,58,-4,44
Dungannon,925,7,11,9,10,53,41,12,42
Glentoran,925,8,10,5,15,34,49,-15,35
Ballinamalla,925,9,9,4,17,31,47,-16,31
Ards,925,10,8,5,17,31,52,-21,29
Portadown,925,11,4,5,21,21,58,-37,17
Cliftonville,926,1,20,2,8,58,36,22,62
Crusaders,926,2,17,6,7,60,40,20,57
Ballymena,926,3,16,6,8,61,54,7,54
Linfield,926,4,13,9,8,56,34,22,48
Coleraine,926,5,10,11,9,42,36,6,41
Glenavon,926,6,9,14,7,49,48,1,41
Dungannon,926,7,10,7,13,51,51,0,37
Glentoran,926,8,9,6,15,31,46,-15,33
Ards,926,9,8,6,16,32,49,-17,30
Portadown,926,10,8,6,16,26,47,-21,30
Ballinamalla,926,11,6,5,19,31,56,-25,23
Crusaders,927,1,14,10,6,45,33,12,52
Linfield,927,2,14,9,7,58,36,22,51
Glenavon,927,3,11,12,7,44,41,3,45
Coleraine,927,4,12,9,9,43,41,2,45
Cliftonville,927,5,12,8,10,47,39,8,44
Ballymena,927,6,11,8,11,51,53,-2,41
Ards,927,7,11,6,13,42,43,-1,39
Glentoran,927,8,10,7,13,30,41,-11,37
Dungannon,927,9,9,9,12,49,41,8,36
Portadown,927,10,10,3,17,25,44,-19,33
Ballinamalla,927,11,7,7,16,25,47,-22,28
Cliftonville,928,1,18,3,9,61,41,20,57
Ballymena,928,2,16,4,10,63,59,4,52
Coleraine,928,3,14,9,7,53,38,15,51
Glenavon,928,4,14,9,7,55,41,14,51
Crusaders,928,5,14,8,8,52,38,14,50
Linfield,928,6,13,9,8,57,35,22,48
Dungannon,928,7,9,9,12,47,46,1,36
Ards,928,8,9,6,15,36,49,-13,33
Glentoran,928,9,7,8,15,28,48,-20,29
Portadown,928,10,8,3,19,33,58,-25,27
Ballinamalla,928,11,7,4,19,25,57,-32,25
Crusaders,929,1,15,9,6,52,31,21,54
Linfield,929,2,13,11,6,52,30,22,50
Glenavon,929,3,14,7,9,50,41,9,49
Cliftonville,929,4,13,7,10,50,39,11,46
Ballymena,929,5,14,4,12,57,57,0,46
Coleraine,929,6,10,9,11,36,38,-2,39
Glentoran,929,7,10,9,11,31,41,-10,39
Dungannon,929,8,9,10,11,49,43,6,37
Ards,929,9,9,8,13,35,45,-10,35
Portadown,929,10,10,5,15,26,44,-18,35
Ballinamalla,929,11,6,5,19,24,53,-29,23
Crusaders,930,1,17,6,7,57,30,27,57
Cliftonville,930,2,15,5,10,49,39,10,50
Glenavon,930,2,13,11,6,49,39,10,50
Coleraine,930,4,12,11,7,42,32,10,47
Linfield,930,5,12,10,8,57,33,24,46
Ballymena,930,6,13,7,10,55,58,-3,46
Glentoran,930,7,9,10,11,31,42,-11,37
Dungannon,930,8,6,12,12,37,44,-7,30
Ballinamalla,930,9,8,5,17,25,50,-25,29
Ards,930,10,7,7,16,31,47,-16,28
Portadown,930,11,5,12,13,23,42,-19,27
Crusaders,931,1,17,9,4,65,37,28,60
Ballymena,931,2,16,6,8,56,52,4,54
Cliftonville,931,3,14,6,10,55,39,16,48
Linfield,931,4,12,11,7,55,35,20,47
Glenavon,931,5,11,9,10,49,46,3,42
Coleraine,931,6,11,9,10,40,40,0,42
Dungannon,931,7,10,11,9,49,42,7,41
Ards,931,8,9,6,15,35,45,-10,33
Glentoran,931,9,6,11,13,22,40,-18,29
Portadown,931,10,8,5,17,25,51,-26,29
Ballinamalla,931,11,7,5,18,28,52,-24,26
Crusaders,932,1,17,8,5,57,32,25,59
Linfield,932,2,14,11,5,56,30,26,53
Glenavon,932,3,12,12,6,55,45,10,48
Coleraine,932,4,11,13,6,50,45,5,46
Ballymena,932,5,13,6,11,54,56,-2,45
Cliftonville,932,6,12,4,14,42,43,-1,40
Dungannon,932,7,10,6,14,48,49,-1,36
Ards,932,8,9,8,13,38,46,-8,35
Portadown,932,9,9,7,14,25,39,-14,34
Glentoran,932,10,8,7,15,35,50,-15,31
Ballinamalla,932,11,8,2,20,34,59,-25,26
Crusaders,933,1,19,6,5,57,30,27,63
Linfield,933,2,17,10,3,64,29,35,61
Cliftonville,933,3,15,4,11,53,41,12,49
Ballymena,933,4,12,9,9,58,58,0,45
Dungannon,933,5,11,6,13,52,48,4,39
Coleraine,933,6,9,11,10,51,49,2,38
Glenavon,933,7,8,12,10,44,52,-8,36
Ards,933,8,10,5,15,40,48,-8,35
Ballinamalla,933,9,10,5,15,27,44,-17,35
Glentoran,933,10,8,5,17,28,51,-23,29
Portadown,933,11,7,5,18,25,49,-24,26
Cliftonville,934,1,15,6,9,50,35,15,51
Crusaders,934,2,15,5,10,52,40,12,50
Ballymena,934,3,14,7,9,57,54,3,49
Glentoran,934,4,14,4,12,37,42,-5,46
Glenavon,934,5,12,9,9,46,42,4,45
Linfield,934,6,11,9,10,48,34,14,42
Dungannon,934,7,10,9,11,44,42,2,39
Ards,934,8,10,7,13,41,44,-3,37
Coleraine,934,9,8,13,9,36,39,-3,37
Ballinamalla,934,10,9,4,17,26,48,-22,31
Portadown,934,11,8,5,17,30,47,-17,29
Cliftonville,935,1,17,5,8,68,43,25,56
Crusaders,935,2,15,7,8,57,38,19,52
Coleraine,935,3,14,10,6,52,38,14,52
Glenavon,935,4,13,9,8,49,43,6,48
Linfield,935,5,12,9,9,55,40,15,45
Glentoran,935,6,12,7,11,35,42,-7,43
Ballymena,935,7,12,5,13,58,62,-4,41
Dungannon,935,8,9,11,10,45,40,5,38
Ards,935,9,10,4,16,41,52,-11,34
Ballinamalla,935,10,7,4,19,29,56,-27,25
Portadown,935,11,5,7,18,19,54,-35,22
Ballymena,936,1,17,6,7,71,58,13,57
Crusaders,936,2,15,8,7,51,32,19,53
Linfield,936,3,14,9,7,60,29,31,51
Cliftonville,936,4,15,3,12,48,42,6,48
Coleraine,936,5,12,9,9,44,46,-2,45
Glenavon,936,6,10,9,11,50,52,-2,39
Glentoran,936,7,8,13,9,30,36,-6,37
Dungannon,936,8,9,7,14,42,44,-2,34
Portadown,936,9,8,7,15,24,43,-19,31
Ballinamalla,936,10,8,6,16,33,54,-21,30
Ards,936,11,8,5,17,37,54,-17,29
Linfield,937,1,18,7,5,69,30,39,61
Crusaders,937,2,16,9,5,57,32,25,57
Glenavon,937,3,13,11,6,47,38,9,50
Coleraine,937,4,12,10,8,44,36,8,46
Ballymena,937,5,12,10,8,59,62,-3,46
Cliftonville,937,6,13,5,12,45,37,8,44
Dungannon,937,7,9,11,10,47,44,3,38
Glentoran,937,8,8,9,13,30,50,-20,33
Ards,937,9,8,4,18,37,53,-16,28
Ballinamalla,937,10,8,3,19,26,50,-24,27
Portadown,937,11,5,7,18,19,48,-29,22
Crusaders,938,1,17,8,5,56,33,23,59
Cliftonville,938,2,16,8,6,54,35,19,56
Ballymena,938,3,14,8,8,55,50,5,50
Linfield,938,4,13,9,8,64,37,27,48
Ards,938,5,13,5,12,44,45,-1,44
Coleraine,938,6,11,8,11,43,43,0,41
Glenavon,938,7,10,11,9,44,47,-3,41
Dungannon,938,8,8,9,13,44,45,-1,33
Glentoran,938,9,8,9,13,33,43,-10,33
Ballinamalla,938,10,9,3,18,30,53,-23,30
Portadown,938,11,4,6,20,22,58,-36,18
Ballymena,939,1,17,5,8,68,57,11,56
Cliftonville,939,2,16,4,10,49,34,15,52
Crusaders,939,3,14,7,9,50,34,16,49
Glenavon,939,4,13,8,9,53,40,13,47
Linfield,939,5,11,10,9,48,30,18,43
Dungannon,939,6,11,10,9,49,44,5,43
Coleraine,939,7,10,9,11,47,47,0,39
Ards,939,8,10,8,12,36,43,-7,38
Glentoran,939,9,10,8,12,32,46,-14,38
Portadown,939,10,7,7,16,23,46,-23,28
Ballinamalla,939,11,6,4,20,19,53,-34,22
Cliftonville,940,1,17,4,9,53,40,13,55
Crusaders,940,2,14,9,7,51,39,12,51
Coleraine,940,3,14,7,9,51,37,14,49
Linfield,940,4,12,12,6,52,31,21,48
Ballymena,940,5,12,10,8,57,58,-1,46
Dungannon,940,6,10,10,10,53,46,7,40
Glenavon,940,7,9,13,8,47,46,1,40
Glentoran,940,8,10,8,12,35,44,-9,38
Ards,940,9,9,5,16,41,51,-10,32
Portadown,940,10,6,8,16,25,50,-25,26
Ballinamalla,940,11,6,6,18,34,57,-23,24
Crusaders,941,1,14,12,4,55,35,20,54
Linfield,941,2,14,10,6,56,32,24,52
Ballymena,941,3,15,6,9,57,57,0,51
Cliftonville,941,4,14,8,8,54,43,11,50
Dungannon,941,5,12,9,9,54,40,14,45
Coleraine,941,6,10,9,11,40,42,-2,39
Glenavon,941,7,9,11,10,45,51,-6,38
Ards,941,8,9,6,15,43,48,-5,33
Glentoran,941,9,7,10,13,33,47,-14,31
Portadown,941,10,7,8,15,33,47,-14,29
Ballinamalla,941,11,7,5,18,24,52,-28,26
Crusaders,942,1,17,7,6,64,39,25,58
Cliftonville,942,2,15,6,9,54,36,18,51
Ballymena,942,3,15,6,9,71,56,15,51
Coleraine,942,4,13,12,5,49,35,14,51
Linfield,942,5,13,11,6,55,32,23,50
Glenavon,942,6,12,9,9,47,47,0,45
Dungannon,942,7,11,9,10,57,45,12,42
Glentoran,942,8,9,8,13,33,48,-15,35
Ards,942,9,7,3,20,29,57,-28,24
Portadown,942,10,6,6,18,25,54,-29,24
Ballinamalla,942,11,6,5,19,25,60,-35,23
Crusaders,943,1,17,7,6,62,32,30,58
Cliftonville,943,2,14,6,10,49,41,8,48
Linfield,943,3,13,8,9,53,37,16,47
Dungannon,943,4,13,7,10,59,47,12,46
Coleraine,943,5,11,11,8,44,41,3,44
Portadown,943,6,12,5,13,34,42,-8,41
Ballymena,943,7,10,7,13,53,66,-13,37
Glenavon,943,8,8,11,11,48,54,-6,35
Glentoran,943,9,9,8,13,30,41,-11,35
Ballinamalla,943,10,10,4,16,31,51,-20,34
Ards,943,11,10,2,18,38,49,-11,32
Linfield,944,1,18,9,3,59,21,38,63
Crusaders,944,2,17,9,4,50,27,23,60
Cliftonville,944,3,16,5,9,51,34,17,53
Ballymena,944,4,15,7,8,55,50,5,52
Glenavon,944,5,11,10,9,46,47,-1,43
Coleraine,944,6,9,11,10,38,38,0,38
Dungannon,944,7,10,7,13,47,46,1,37
Ards,944,8,8,5,17,30,51,-21,29
Glentoran,944,9,6,10,14,27,45,-18,28
Portadown,944,10,7,5,18,26,45,-19,26
Ballinamalla,944,11,6,6,18,28,53,-25,24
Linfield,945,1,16,6,8,65,36,29,54
Crusaders,945,2,16,6,8,53,34,19,54
Cliftonville,945,3,15,6,9,54,39,15,51
Ballymena,945,4,15,5,10,59,61,-2,50
Coleraine,945,5,12,9,9,47,40,7,45
Glenavon,945,6,12,9,9,47,48,-1,45
Dungannon,945,7,10,10,10,46,39,7,40
Ards,945,8,11,4,15,45,50,-5,37
Portadown,945,9,9,6,15,31,46,-15,33
Ballinamalla,945,10,9,2,19,28,57,-29,29
Glentoran,945,11,6,5,19,25,50,-25,23
Linfield,946,1,16,10,4,56,24,32,58
Cliftonville,946,2,14,6,10,53,41,12,48
Crusaders,946,3,14,6,10,44,39,5,48
Glenavon,946,4,12,9,9,47,45,2,45
Ballymena,946,5,13,6,11,48,52,-4,45
Coleraine,946,6,11,8,11,42,35,7,41
Dungannon,946,7,9,9,12,46,46,0,36
Ards,946,8,10,6,14,34,42,-8,36
Ballinamalla,946,9,10,4,16,27,47,-20,34
Portadown,946,10,9,6,15,28,39,-11,33
Glentoran,946,11,8,8,14,28,43,-15,32
Crusaders,947,1,15,12,3,62,31,31,57
Linfield,947,2,15,8,7,65,40,25,53
Coleraine,947,3,15,8,7,45,34,11,53
Cliftonville,947,4,15,5,10,49,38,11,50
Ballymena,947,5,14,5,11,64,57,7,47
Glenavon,947,6,9,13,8,45,48,-3,40
Glentoran,947,7,9,8,13,28,45,-17,35
Dungannon,947,8,8,10,12,41,45,-4,34
Portadown,947,9,8,7,15,31,51,-20,31
Ballinamalla,947,10,6,8,16,30,52,-22,26
Ards,947,11,6,6,18,32,51,-19,24
Coleraine,948,1,14,12,4,54,36,18,54
Crusaders,948,2,14,9,7,57,38,19,51
Linfield,948,3,13,9,8,57,39,18,48
Glenavon,948,4,10,15,5,52,43,9,45
Cliftonville,948,5,13,6,11,49,44,5,45
Ballymena,948,6,13,6,11,61,58,3,45
Dungannon,948,7,9,11,10,48,45,3,38
Glentoran,948,8,10,8,12,32,43,-11,38
Ballinamalla,948,9,8,6,16,33,50,-17,30
Ards,948,10,7,6,17,37,58,-21,27
Portadown,948,11,7,6,17,26,52,-26,27
Linfield,949,1,18,6,6,66,31,35,60
Cliftonville,949,2,18,5,7,59,36,23,59
Crusaders,949,3,14,7,9,50,36,14,49
Ballymena,949,4,12,9,9,58,59,-1,45
Coleraine,949,5,10,11,9,38,38,0,41
Glenavon,949,6,9,12,9,43,50,-7,39
Dungannon,949,7,8,10,12,52,58,-6,34
Ards,949,8,10,4,16,41,49,-8,34
Portadown,949,9,9,5,16,37,46,-9,32
Glentoran,949,10,7,11,12,30,46,-16,32
Ballinamalla,949,11,6,8,16,32,57,-25,26
Crusaders,950,1,14,13,3,54,31,23,55
Ballymena,950,2,16,6,8,58,47,11,54
Linfield,950,3,14,9,7,64,32,32,51
Cliftonville,950,4,14,6,10,56,44,12,48
Glentoran,950,5,11,8,11,33,41,-8,41
Glenavon,950,6,10,10,10,50,52,-2,40
Coleraine,950,7,10,9,11,37,45,-8,39
Ards,950,8,10,6,14,38,53,-15,36
Ballinamalla,950,9,10,3,17,32,47,-15,33
Dungannon,950,10,6,11,13,43,46,-3,29
Portadown,950,11,7,5,18,25,52,-27,26
Crusaders,951,1,19,4,7,50,30,20,61
Glenavon,951,2,15,8,7,51,40,11,53
Linfield,951,3,13,10,7,58,35,23,49
Cliftonville,951,4,14,7,9,46,38,8,49
Ballymena,951,5,14,5,11,63,55,8,47
Coleraine,951,6,10,11,9,42,41,1,41
Dungannon,951,7,10,9,11,46,45,1,39
Ards,951,8,9,6,15,32,48,-16,33
Portadown,951,9,9,3,18,26,44,-18,30
Ballinamalla,951,10,8,5,17,36,54,-18,29
Glentoran,951,11,7,6,17,30,50,-20,27
Crusaders,952,1,18,5,7,56,40,16,59
Glenavon,952,2,14,11,5,56,43,13,53
Linfield,952,3,13,7,10,50,36,14,46
Cliftonville,952,4,13,7,10,61,48,13,46
Dungannon,952,5,12,8,10,63,48,15,44
Coleraine,952,6,11,11,8,44,36,8,44
Ballymena,952,7,12,7,11,51,60,-9,43
Glentoran,952,8,10,7,13,26,40,-14,37
Ards,952,9,9,5,16,34,48,-14,32
Portadown,952,10,6,9,15,26,43,-17,27
Ballinamalla,952,11,8,1,21,36,61,-25,25
Linfield,953,1,15,9,6,54,25,29,54
Crusaders,953,2,15,8,7,50,37,13,53
Coleraine,953,3,14,9,7,42,36,6,51
Ballymena,953,4,13,7,10,60,63,-3,46
Dungannon,953,5,10,10,10,52,42,10,40
Glenavon,953,6,10,9,11,44,45,-1,39
Cliftonville,953,7,11,6,13,44,48,-4,39
Portadown,953,8,10,6,14,29,42,-13,36
Glentoran,953,9,9,9,12,27,42,-15,36
Ards,953,10,8,7,15,36,43,-7,31
Ballinamalla,953,11,8,4,18,35,50,-15,28
Crusaders,954,1,17,10,3,60,33,27,61
Cliftonville,954,2,16,7,7,53,31,22,55
Linfield,954,3,15,9,6,55,29,26,54
Ballymena,954,4,14,8,8,61,54,7,50
Glenavon,954,5,11,11,8,50,47,3,44
Coleraine,954,6,9,12,9,41,43,-2,39
Ards,954,7,12,3,15,41,51,-10,39
Dungannon,954,8,8,13,9,45,37,8,37
Glentoran,954,9,6,7,17,25,48,-23,25
Ballinamalla,954,10,5,8,17,31,58,-27,23
Portadown,954,11,6,4,20,29,60,-31,22
Linfield,955,1,13,14,3,61,29,32,53
Coleraine,955,2,15,7,8,44,31,13,52
Crusaders,955,3,14,8,8,46,35,11,50
Cliftonville,955,4,14,5,11,51,44,7,47
Ballymena,955,5,14,5,11,59,59,0,47
Glenavon,955,6,12,9,9,47,48,-1,45
Dungannon,955,7,11,6,13,57,51,6,39
Portadown,955,8,10,6,14,34,46,-12,36
Glentoran,955,9,8,8,14,32,45,-13,32
Ballinamalla,955,10,8,6,16,32,51,-19,30
Ards,955,11,6,6,18,36,60,-24,24
Linfield,956,1,16,10,4,60,30,30,58
Crusaders,956,2,15,9,6,63,38,25,54
Cliftonville,956,3,16,4,10,57,51,6,52
Coleraine,956,4,11,10,9,40,35,5,43
Ballymena,956,5,13,4,13,56,64,-8,43
Ards,956,6,13,3,14,44,47,-3,42
Glenavon,956,7,9,11,10,45,48,-3,38
Dungannon,956,8,10,7,13,51,48,3,37
Glentoran,956,9,9,9,12,34,40,-6,36
Portadown,956,10,8,6,16,26,47,-21,30
Ballinamalla,956,11,6,5,19,31,59,-28,23
Linfield,957,1,15,9,6,60,31,29,54
Crusaders,957,2,14,11,5,54,37,17,53
Cliftonville,957,3,15,6,9,47,36,11,51
Dungannon,957,4,13,8,9,55,40,15,47
Coleraine,957,5,11,10,9,43,35,8,43
Ballymena,957,6,12,4,14,58,64,-6,40
Glenavon,957,7,8,14,8,45,49,-4,38
Glentoran,957,8,9,8,13,32,44,-12,35
Ards,957,9,8,10,12,35,44,-9,34
Ballinamalla,957,10,8,6,16,32,58,-26,30
Portadown,957,11,7,4,19,29,52,-23,25
Crusaders,958,1,16,8,6,50,26,24,56
Ballymena,958,2,15,6,9,56,56,0,51
Linfield,958,3,13,10,7,50,29,21,49
Cliftonville,958,4,15,4,11,57,44,13,49
Coleraine,958,5,13,8,9,45,38,7,47
Dungannon,958,6,11,9,10,50,41,9,42
Glenavon,958,7,10,10,10,43,47,-4,40
Ards,958,8,9,6,15,34,44,-10,33
Glentoran,958,9,8,8,14,30,43,-13,32
Portadown,958,10,8,7,15,28,51,-23,31
Ballinamalla,958,11,7,4,19,33,57,-24,25
Crusaders,959,1,16,9,5,52,30,22,57
Glenavon,959,2,14,11,5,49,39,10,53
Linfield,959,3,11,13,6,55,35,20,46
Cliftonville,959,4,13,5,12,48,42,6,44
Ballymena,959,5,12,8,10,57,57,0,44
Glentoran,959,6,10,11,9,36,37,-1,41
Dungannon,959,7,9,10,11,52,51,1,37
Coleraine,959,8,9,10,11,39,41,-2,37
Ballinamalla,959,9,11,3,16,28,44,-16,36
Ards,959,10,9,5,16,33,45,-12,32
Portadown,959,11,6,5,19,22,50,-28,23
Crusaders,960,1,15,11,4,52,33,19,56
Glenavon,960,2,14,10,6,57,38,19,52
Ballymena,960,3,15,7,8,64,60,4,52
Coleraine,960,4,13,11,6,49,39,10,50
Linfield,960,5,13,9,8,54,37,17,48
Cliftonville,960,6,13,6,11,52,43,9,45
Glentoran,960,7,9,7,14,35,47,-12,34
Dungannon,960,8,7,12,11,42,43,-1,33
Portadown,960,9,7,7,16,25,44,-19,28
Ards,960,10,7,6,17,31,52,-21,27
Ballinamalla,960,11,6,6,18,32,57,-25,24
Ballymena,961,1,17,6,7,65,59,6,57
Crusaders,961,2,16,8,6,54,33,21,56
Linfield,961,3,13,11,6,61,37,24,50
Cliftonville,961,4,15,4,11,55,40,15,49
Coleraine,961,5,9,13,8,39,34,5,40
Glenavon,961,6,9,13,8,43,39,4,40
Dungannon,961,7,9,9,12,46,41,5,36
Portadown,961,8,9,6,15,26,46,-20,33
Glentoran,961,9,8,8,14,26,47,-21,32
Ards,961,10,7,8,15,35,49,-14,29
Ballinamalla,961,11,9,2,19,29,54,-25,29
Crusaders,962,1,18,5,7,60,28,32,59
Linfield,962,2,15,11,4,63,28,35,56
Cliftonville,962,3,15,5,10,56,44,12,50
Ballymena,962,4,13,8,9,58,63,-5,47
Glenavon,962,5,12,10,8,51,44,7,46
Dungannon,962,6,10,9,11,48,45,3,39
Glentoran,962,7,10,6,14,31,41,-10,36
Coleraine,962,8,8,11,11,41,48,-7,35
Ards,962,9,10,5,15,37,47,-10,35
Portadown,962,10,8,5,17,26,48,-22,29
Ballinamalla,962,11,6,5,19,24,59,-35,23
Crusaders,963,1,18,9,3,64,34,30,63
Linfield,963,2,15,8,7,61,31,30,53
Cliftonville,963,3,14,6,10,55,41,14,48
Coleraine,963,4,12,11,7,42,35,7,47
Glenavon,963,5,10,14,6,48,39,9,44
Dungannon,963,6,9,10,11,49,49,0,37
Glentoran,963,7,10,7,13,31,44,-13,37
Ballymena,963,8,10,7,13,45,63,-18,37
Ards,963,9,8,6,16,40,47,-7,30
Ballinamalla,963,10,7,7,16,29,51,-22,28
Portadown,963,11,8,3,19,22,52,-30,27
Crusaders,964,1,19,5,6,54,32,22,62
Cliftonville,964,2,16,6,8,55,46,9,54
Ballymena,964,3,15,8,7,54,51,3,53
Linfield,964,4,12,9,9,62,37,25,45
Glenavon,964,5,11,12,7,45,34,11,45
Dungannon,964,6,10,9,11,49,41,8,39
Coleraine,964,7,9,10,11,34,38,-4,37
Ards,964,8,10,7,13,40,47,-7,37
Portadown,964,9,9,4,17,26,49,-23,31
Glentoran,964,10,7,9,14,32,45,-13,30
Ballinamalla,964,11,6,3,21,24,55,-31,21
Crusaders,965,1,17,7,6,62,44,18,58
Ballymena,965,2,15,7,8,61,52,9,52
Linfield,965,3,13,9,8,50,32,18,48
Glenavon,965,4,12,11,7,53,42,11,47
Dungannon,965,5,12,9,9,53,42,11,45
Coleraine,965,6,12,9,9,48,42,6,45
Cliftonville,965,7,11,8,11,43,39,4,41
Glentoran,965,8,8,9,13,29,46,-17,33
Ards,965,9,9,4,17,36,52,-16,31
Portadown,965,10,8,7,15,26,43,-17,31
Ballinamalla,965,11,7,2,21,29,56,-27,23
Crusaders,966,1,17,10,3,57,28,29,61
Glenavon,966,2,13,12,5,48,33,15,51
Cliftonville,966,3,15,5,10,49,38,11,50
Linfield,966,4,13,10,7,56,30,26,49
Ballymena,966,5,12,9,9,59,57,2,45
Coleraine,966,6,12,8,10,34,34,0,44
Dungannon,966,7,9,8,13,42,48,-6,35
Glentoran,966,8,7,12,11,33,47,-14,33
Ballinamalla,966,9,9,3,18,24,47,-23,30
Ards,966,10,8,4,18,37,53,-16,28
Portadown,966,11,6,7,17,28,52,-24,25
Cliftonville,967,1,18,5,7,61,31,30,59
Glenavon,967,2,15,9,6,55,43,12,54
Crusaders,967,3,14,10,6,55,37,18,52
Linfield,967,4,14,9,7,60,32,28,51
Ballymena,967,5,14,4,12,54,59,-5,46
Glentoran,967,6,10,8,12,34,41,-7,38
Coleraine,967,7,10,8,12,32,43,-11,38
Dungannon,967,8,8,12,10,42,44,-2,36
Ards,967,9,9,7,14,37,42,-5,34
Ballinamalla,967,10,7,3,20,26,61,-35,24
Portadown,967,11,5,7,18,22,45,-23,22
Crusaders,968,1,15,12,3,54,31,23,57
Linfield,968,2,15,11,4,60,29,31,56
Cliftonville,968,3,17,4,9,52,39,13,55
Glenavon,968,4,12,12,6,52,42,10,48
Coleraine,968,5,11,10,9,42,42,0,43
Dungannon,968,6,11,9,10,54,43,11,42
Ballymena,968,7,11,7,12,53,61,-8,40
Glentoran,968,8,9,10,11,35,46,-11,37
Ards,968,9,7,6,17,38,54,-16,27
Portadown,968,10,6,7,17,29,49,-20,25
Ballinamalla,968,11,4,6,20,19,52,-33,18
Ballymena,969,1,18,4,8,61,54,7,58
Cliftonville,969,2,18,3,9,55,31,24,57
Crusaders,969,3,16,6,8,54,39,15,54
Linfield,969,4,12,11,7,52,27,25,47
Ards,969,5,12,5,13,38,44,-6,41
Glenavon,969,6,10,10,10,41,42,-1,40
Glentoran,969,7,11,6,13,31,39,-8,39
Coleraine,969,8,9,9,12,34,41,-7,36
Dungannon,969,9,9,8,13,45,43,2,35
Ballinamalla,969,10,10,3,17,25,44,-19,33
Portadown,969,11,6,3,21,21,53,-32,21
Crusaders,970,1,15,8,7,57,39,18,53
Cliftonville,970,2,15,6,9,56,41,15,51
Ballymena,970,3,15,6,9,56,54,2,51
Linfield,970,4,12,12,6,54,33,21,48
Coleraine,970,5,11,11,8,42,36,6,44
Glenavon,970,6,12,8,10,46,46,0,44
Dungannon,970,7,10,9,11,53,50,3,39
Glentoran,970,8,10,8,12,37,41,-4,38
Ards,970,9,8,7,15,32,44,-12,31
Portadown,970,10,8,5,17,26,48,-22,29
Ballinamalla,970,11,7,4,19,27,54,-27,25
Linfield,971,1,15,8,7,56,33,23,53
Crusaders,971,2,14,9,7,47,36,11,51
Cliftonville,971,3,13,8,9,48,40,8,47
Ballymena,971,4,14,4,12,56,58,-2,46
Coleraine,971,5,12,9,9,41,36,5,45
Glenavon,971,6,10,12,8,44,49,-5,42
Dungannon,971,7,10,10,10,53,38,15,40
Ards,971,8,10,6,14,37,47,-10,36
Glentoran,971,9,8,9,13,32,44,-12,33
Ballinamalla,971,10,9,4,17,30,43,-13,31
Portadown,971,11,7,7,16,21,41,-20,28
Crusaders,972,1,18,7,5,53,29,24,61
Ballymena,972,2,14,10,6,56,54,2,52
Linfield,972,3,14,9,7,60,37,23,51
Cliftonville,972,4,14,6,10,46,38,8,48
Coleraine,972,5,12,10,8,44,36,8,46
Glenavon,972,6,10,11,9,45,44,1,41
Glentoran,972,7,8,9,13,30,42,-12,33
Dungannon,972,8,7,11,12,48,49,-1,32
Ards,972,9,9,5,16,37,47,-10,32
Ballinamalla,972,10,7,8,15,33,52,-19,29
Portadown,972,11,6,6,18,23,47,-24,24
Crusaders,973,1,19,4,7,56,36,20,61
Linfield,973,2,15,6,9,58,41,17,51
Glenavon,973,3,13,10,7,49,42,7,49
Ballymena,973,4,14,6,10,62,58,4,48
Cliftonville,973,5,14,5,11,51,44,7,47
Coleraine,973,6,11,10,9,45,40,5,43
Dungannon,973,7,10,7,13,50,45,5,37
Glentoran,973,8,9,8,13,27,37,-10,35
Portadown,973,9,10,5,15,29,42,-13,35
Ards,973,10,9,5,16,35,51,-16,32
Ballinamalla,973,11,7,2,21,23,49,-26,23
Crusaders,974,1,15,9,6,52,34,18,54
Coleraine,974,2,13,11,6,48,36,12,50
Linfield,974,3,13,10,7,50,27,23,49
Cliftonville,974,4,15,4,11,52,38,14,49
Dungannon,974,5,12,10,8,51,36,15,46
Ballymena,974,6,13,7,10,55,60,-5,46
Glenavon,974,7,11,10,9,46,49,-3,43
Ards,974,8,10,6,14,39,44,-5,36
Glentoran,974,9,9,7,14,28,40,-12,34
Portadown,974,10,7,5,18,24,49,-25,26
Ballinamalla,974,11,5,5,20,29,61,-32,20
Linfield,975,1,17,9,4,60,27,33,60
Crusaders,975,2,14,11,5,54,34,20,53
Cliftonville,975,3,13,7,10,50,39,11,46
Ballymena,975,4,13,6,11,59,60,-1,45
Coleraine,975,5,10,11,9,35,39,-4,41
Glenavon,975,6,10,10,10,48,51,-3,40
Ards,975,7,11,7,12,44,49,-5,40
Glentoran,975,8,9,10,11,36,43,-7,37
Dungannon,975,9,8,10,12,49,46,3,34
Ballinamalla,975,10,8,6,16,32,50,-18,30
Portadown,975,11,6,5,19,24,53,-29,23
Crusaders,976,1,19,7,4,51,23,28,64
Coleraine,976,2,14,11,5,57,41,16,53
Linfield,976,3,14,10,6,59,32,27,52
Cliftonville,976,4,14,6,10,54,45,9,48
Ballymena,976,5,11,7,12,54,72,-18,40
Ballinamalla,976,6,12,2,16,38,52,-14,38
Glenavon,976,7,8,12,10,48,47,1,36
Glentoran,976,8,10,6,14,26,40,-14,36
Portadown,976,9,9,6,15,30,44,-14,33
Dungannon,976,10,8,8,14,47,48,-1,32
Ards,976,11,7,3,20,37,57,-20,24
Crusaders,977,1,20,6,4,62,31,31,66
Linfield,977,2,14,11,5,60,33,27,53
Cliftonville,977,3,15,4,11,48,40,8,49
Ballymena,977,4,12,8,10,51,53,-2,44
Glenavon,977,5,10,12,8,40,45,-5,42
Coleraine,977,6,10,9,11,39,36,3,39
Dungannon,977,7,9,11,10,53,44,9,38
Glentoran,977,8,10,5,15,31,48,-17,35
Ards,977,9,8,7,15,43,57,-14,31
Portadown,977,10,6,10,14,24,42,-18,28
Ballinamalla,977,11,8,3,19,26,48,-22,27
Cliftonville,978,1,18,4,8,62,37,25,58
Ballymena,978,2,14,7,9,55,59,-4,49
Crusaders,978,3,13,8,9,58,41,17,47
Linfield,978,4,12,9,9,55,36,19,45
Glenavon,978,5,10,13,7,45,41,4,43
Dungannon,978,6,11,8,11,50,42,8,41
Glentoran,978,7,10,8,12,37,45,-8,38
Ards,978,8,12,2,16,34,47,-13,38
Coleraine,978,9,10,7,13,40,48,-8,37
Ballinamalla,978,10,10,2,18,30,49,-19,32
Portadown,978,11,9,4,17,20,41,-21,31
Cliftonville,979,1,19,2,9,55,38,17,59
Crusaders,979,2,17,7,6,56,30,26,58
Ballymena,979,3,15,5,10,60,55,5,50
Linfield,979,4,12,12,6,66,39,27,48
Dungannon,979,5,11,9,10,53,41,12,42
Ards,979,6,11,7,12,45,50,-5,40
Coleraine,979,7,9,12,9,38,41,-3,39
Glenavon,979,8,8,13,9,38,41,-3,37
Ballinamalla,979,9,9,5,16,33,56,-23,32
Glentoran,979,10,5,9,16,25,46,-21,24
Portadown,979,11,5,7,18,16,48,-32,22
Crusaders,980,1,16,8,6,52,29,23,56
Linfield,980,2,13,12,5,61,35,26,51
Cliftonville,980,3,16,2,12,48,37,11,50
Ballymena,980,4,14,7,9,58,54,4,49
Coleraine,980,5,12,11,7,40,32,8,47
Glentoran,980,6,10,7,13,31,39,-8,37
Glenavon,980,7,8,12,10,46,47,-1,36
Dungannon,980,8,8,11,11,42,43,-1,35
Portadown,980,9,10,5,15,29,45,-16,35
Ards,980,10,8,6,16,39,57,-18,30
Ballinamalla,980,11,8,3,19,28,56,-28,27
Crusaders,981,1,19,7,4,64,31,33,64
Linfield,981,2,16,7,7,70,44,26,55
Cliftonville,981,3,15,4,11,48,40,8,49
Coleraine,981,4,13,9,8,45,37,8,48
Ballymena,981,5,13,9,8,60,58,2,48
Glenavon,981,6,11,8,11,42,47,-5,41
Glentoran,981,7,10,9,11,36,43,-7,39
Dungannon,981,8,9,9,12,45,45,0,36
Ballinamalla,981,9,9,2,19,30,52,-22,29
Ards,981,10,7,6,17,41,56,-15,27
Portadown,981,11,5,6,19,19,47,-28,21
Linfield,982,1,16,10,4,59,26,33,58
Crusaders,982,2,15,7,8,55,45,10,52
Coleraine,982,3,13,10,7,42,34,8,49
Cliftonville,982,4,14,6,10,54,41,13,48
Glenavon,982,5,12,8,10,48,48,0,44
Ballymena,982,6,13,5,12,58,60,-2,44
Dungannon,982,7,11,7,12,49,41,8,40
Glentoran,982,8,10,6,14,35,47,-12,36
Ards,982,9,10,5,15,39,46,-7,35
Portadown,982,10,8,4,18,28,47,-19,28
Ballinamalla,982,11,7,4,19,29,61,-32,25
Crusaders,983,1,15,9,6,53,33,20,54
Linfield,983,2,13,11,6,53,37,16,50
Cliftonville,983,3,14,7,9,55,41,14,49
Dungannon,983,4,12,9,9,48,35,13,45
Coleraine,983,5,11,11,8,41,35,6,44
Ballymena,983,6,13,5,12,59,59,0,44
Glenavon,983,7,10,12,8,45,43,2,42
Ards,983,8,9,7,14,38,45,-7,34
Glentoran,983,9,8,10,12,27,41,-14,34
Ballinamalla,983,10,9,5,16,31,47,-16,32
Portadown,983,11,6,4,20,22,56,-34,22
Crusaders,984,1,20,7,3,66,27,39,67
Linfield,984,2,14,11,5,57,26,31,53
Ballymena,984,3,14,7,9,59,55,4,49
Coleraine,984,4,11,12,7,42,36,6,45
Glenavon,984,5,12,8,10,51,57,-6,44
Cliftonville,984,6,12,6,12,45,40,5,42
Ballinamalla,984,7,12,3,15,35,52,-17,39
Dungannon,984,8,9,9,12,51,45,6,36
Ards,984,9,7,6,17,32,48,-16,27
Portadown,984,10,7,6,17,18,40,-22,27
Glentoran,984,11,6,7,17,24,54,-30,25
Cliftonville,985,1,18,5,7,59,36,23,59
Linfield,985,2,16,9,5,71,31,40,57
Ballymena,985,3,16,4,10,67,57,10,52
Crusaders,985,4,14,8,8,51,40,11,50
Glenavon,985,5,12,9,9,55,50,5,45
Dungannon,985,6,10,11,9,47,38,9,41
Coleraine,985,7,11,7,12,43,46,-3,40
Ards,985,8,10,5,15,43,55,-12,35
Ballinamalla,985,9,10,5,15,32,50,-18,35
Portadown,985,10,5,8,17,21,50,-29,23
Glentoran,985,11,5,5,20,24,60,-36,20
Crusaders,986,1,19,6,5,55,30,25,63
Linfield,986,2,17,9,4,72,28,44,60
Ballymena,986,3,14,7,9,57,54,3,49
Cliftonville,986,4,14,4,12,47,39,8,46
Coleraine,986,5,9,14,7,42,39,3,41
Glenavon,986,6,9,13,8,44,45,-1,40
Ards,986,7,12,4,14,42,47,-5,40
Glentoran,986,8,9,9,12,37,49,-12,36
Dungannon,986,9,7,10,13,42,48,-6,31
Ballinamalla,986,10,7,5,18,27,51,-24,26
Portadown,986,11,6,3,21,18,53,-35,21
Linfield,987,1,18,7,5,63,30,33,61
Cliftonville,987,2,16,5,9,57,42,15,53
Dungannon,987,3,13,8,9,53,39,14,47
Glentoran,987,4,13,6,11,34,39,-5,45
Ballymena,987,5,13,4,13,51,57,-6,43
Coleraine,987,6,11,9,10,41,44,-3,42
Crusaders,987,7,12,5,13,50,48,2,41
Glenavon,987,8,11,8,11,47,49,-2,41
Ballinamalla,987,9,10,2,18,35,52,-17,32
Portadown,987,10,9,4,17,24,47,-23,31
Ards,987,11,8,4,18,41,49,-8,28
Crusaders,988,1,17,6,7,57,38,19,57
Ballymena,988,2,16,6,8,59,55,4,54
Cliftonville,988,3,15,6,9,50,39,11,51
Coleraine,988,4,12,11,7,50,37,13,47
Glenavon,988,5,11,11,8,50,42,8,44
Linfield,988,6,10,10,10,47,34,13,40
Dungannon,988,7,10,9,11,54,48,6,39
Ards,988,8,12,2,16,42,47,-5,38
Glentoran,988,9,7,10,13,33,46,-13,31
Portadown,988,10,7,6,17,27,57,-30,27
Ballinamalla,988,11,7,5,18,28,54,-26,26
Cliftonville,989,1,17,4,9,57,38,19,55
Crusaders,989,2,15,10,5,54,37,17,55
Linfield,989,3,15,8,7,61,32,29,53
Ballymena,989,4,15,5,10,62,61,1,50
Dungannon,989,5,10,13,7,54,45,9,43
Coleraine,989,6,11,10,9,42,38,4,43
Glenavon,989,7,10,10,10,42,51,-9,40
Ards,989,8,11,6,13,41,48,-7,39
Portadown,989,9,8,4,18,30,50,-20,28
Glentoran,989,10,6,6,18,31,52,-21,24
Ballinamalla,989,11,6,6,18,29,51,-22,24
Crusaders,990,1,20,5,5,66,35,31,65
Cliftonville,990,2,16,5,9,60,46,14,53
Linfield,990,3,14,8,8,58,40,18,50
Glenavon,990,4,13,10,7,50,44,6,49
Glentoran,990,5,14,6,10,41,37,4,48
Dungannon,990,6,12,8,10,56,45,11,44
Coleraine,990,7,11,11,8,44,39,5,44
Ballymena,990,8,11,6,13,56,67,-11,39
Ards,990,9,8,5,17,36,52,-16,29
Ballinamalla,990,10,6,3,21,30,63,-33,21
Portadown,990,11,5,3,22,20,49,-29,18
Linfield,991,1,16,9,5,63,40,23,57
Cliftonville,991,2,16,6,8,55,36,19,54
Crusaders,991,3,15,6,9,55,45,10,51
Coleraine,991,4,12,11,7,47,35,12,47
Glentoran,991,5,13,5,12,41,36,5,44
Glenavon,991,6,10,11,9,49,48,1,41
Ballymena,991,7,11,7,12,56,67,-11,40
Dungannon,991,8,8,9,13,41,43,-2,33
Portadown,991,9,9,6,15,26,45,-19,33
Ballinamalla,991,10,8,5,17,27,46,-19,29
Ards,991,11,7,5,18,31,50,-19,26
Linfield,992,1,14,12,4,61,30,31,54
Crusaders,992,2,15,7,8,53,36,17,52
Cliftonville,992,3,13,8,9,59,47,12,47
Ballymena,992,4,13,7,10,57,57,0,46
Coleraine,992,5,9,14,7,44,41,3,41
Glenavon,992,6,10,11,9,46,44,2,41
Glentoran,992,7,11,6,13,31,43,-12,39
Dungannon,992,8,10,7,13,46,45,1,37
Portadown,992,9,10,6,14,31,46,-15,36
Ards,992,10,9,3,18,35,51,-16,30
Ballinamalla,992,11,9,3,18,29,52,-23,30
Crusaders,993,1,17,8,5,59,39,20,59
Linfield,993,2,17,6,7,66,38,28,57
Cliftonville,993,3,17,4,9,57,40,17,55
Ballymena,993,4,14,7,9,57,53,4,49
Glenavon,993,5,12,10,8,54,47,7,46
Coleraine,993,6,12,8,10,42,42,0,44
Dungannon,993,7,10,10,10,52,44,8,40
Glentoran,993,8,8,7,15,29,45,-16,31
Ballinamalla,993,9,9,3,18,32,53,-21,30
Ards,993,10,7,4,19,36,59,-23,25
Portadown,993,11,7,3,20,27,51,-24,24
Crusaders,994,1,17,7,6,54,27,27,58
Linfield,994,2,14,11,5,59,29,30,53
Cliftonville,994,3,14,6,10,60,45,15,48
Glenavon,994,4,11,12,7,49,44,5,45
Coleraine,994,5,10,12,8,45,42,3,42
Ballymena,994,6,12,6,12,53,59,-6,42
Dungannon,994,7,9,10,11,50,48,2,37
Portadown,994,8,10,6,14,34,50,-16,36
Ards,994,9,9,6,15,38,47,-9,33
Glentoran,994,10,8,9,13,30,51,-21,33
Ballinamalla,994,11,7,3,20,28,58,-30,24
Linfield,995,1,17,8,5,68,30,38,59
Crusaders,995,2,17,6,7,55,34,21,57
Glenavon,995,3,15,8,7,49,38,11,53
Ballymena,995,4,16,5,9,62,56,6,53
Cliftonville,995,5,15,4,11,46,37,9,49
Coleraine,995,6,10,9,11,33,42,-9,39
Ards,995,7,11,4,15,46,52,-6,37
Portadown,995,8,10,4,16,32,43,-11,34
Dungannon,995,9,9,6,15,48,52,-4,33
Glentoran,995,10,6,7,17,26,49,-23,25
Ballinamalla,995,11,6,5,19,27,59,-32,23
Crusaders,996,1,19,6,5,58,26,32,63
Cliftonville,996,2,16,7,7,55,39,16,55
Ballymena,996,3,16,6,8,58,52,6,54
Linfield,996,4,12,11,7,52,28,24,47
Glenavon,996,5,12,10,8,51,51,0,46
Dungannon,996,6,11,8,11,53,49,4,41
Coleraine,996,7,8,11,11,40,46,-6,35
Glentoran,996,8,8,10,12,32,44,-12,34
Ards,996,9,8,7,15,34,47,-13,31
Portadown,996,10,6,6,18,25,47,-22,24
Ballinamalla,996,11,6,4,20,26,55,-29,22
Crusaders,997,1,15,11,4,55,34,21,56
Cliftonville,997,2,16,4,10,59,42,17,52
Glenavon,997,3,13,12,5,55,41,14,51
Coleraine,997,4,14,8,8,52,36,16,50
Linfield,997,5,10,13,7,58,38,20,43
Ballymena,997,6,12,6,12,50,59,-9,42
Ards,997,7,11,6,13,43,49,-6,39
Dungannon,997,8,9,9,12,53,51,2,36
Glentoran,997,9,7,8,15,30,52,-22,29
Ballinamalla,997,10,8,4,18,30,58,-28,28
Portadown,997,11,8,3,19,23,48,-25,27
Crusaders,998,1,18,6,6,59,33,26,60
Ballymena,998,2,18,3,9,57,52,5,57
Cliftonville,998,3,17,4,9,53,41,12,55
Linfield,998,4,14,9,7,56,31,25,51
Glenavon,998,5,12,10,8,56,42,14,46
Dungannon,998,6,12,8,10,47,43,4,44
Coleraine,998,7,8,12,10,40,44,-4,36
Ards,998,8,8,5,17,35,49,-14,29
Ballinamalla,998,9,8,4,18,30,47,-17,28
Glentoran,998,10,6,8,16,25,50,-25,26
Portadown,998,11,7,5,18,29,55,-26,26
Cliftonville,999,1,16,6,8,57,37,20,54
Linfield,999,2,15,7,8,59,39,20,52
Crusaders,999,3,13,10,7,54,43,11,49
Ballymena,999,4,13,7,10,57,56,1,46
Glentoran,999,5,12,8,10,33,39,-6,44
Dungannon,999,6,10,12,8,56,48,8,42
Glenavon,999,7,10,12,8,47,42,5,42
Coleraine,999,8,10,11,9,43,44,-1,41
Ards,999,9,10,7,13,40,44,-4,37
Portadown,999,10,5,7,18,18,41,-23,22
Ballinamalla,999,11,4,7,19,22,53,-31,19
Crusaders,1000,1,17,6,7,55,32,23,57
Cliftonville,1000,2,17,3,10,57,37,20,54
Ballymena,1000,3,13,8,9,56,56,0,47
Linfield,1000,4,12,9,9,52,36,16,45
Glenavon,1000,5,10,14,6,41,42,-1,44
Dungannon,1000,6,11,9,10,51,42,9,42
Coleraine,1000,7,9,12,9,38,37,1,39
Glentoran,1000,8,9,9,12,30,38,-8,36
Ards,1000,9,10,5,15,38,51,-13,35
Portadown,1000,10,8,6,16,30,53,-23,30
Ballinamalla,1000,11,5,7,18,34,58,-24,22
Crusaders,1001,1,17,8,5,50,30,20,59
Ballymena,1001,2,14,9,7,59,55,4,51
Cliftonville,1001,3,14,6,10,50,38,12,48
Linfield,1001,4,13,8,9,59,36,23,47
Glenavon,1001,5,11,11,8,45,45,0,44
Dungannon,1001,6,11,7,12,49,42,7,40
Coleraine,1001,7,8,12,10,35,39,-4,36
Portadown,1001,8,10,4,16,28,45,-17,34
Ards,1001,9,9,6,15,35,47,-12,33
Glentoran,1001,10,8,8,14,27,44,-17,32
Ballinamalla,1001,11,8,5,17,31,47,-16,29
Linfield,1002,1,16,9,5,63,29,34,57
Cliftonville,1002,2,16,4,10,54,38,16,52
Ballymena,1002,3,15,7,8,54,55,-1,52
Crusaders,1002,4,14,7,9,49,35,14,49
Coleraine,1002,5,13,9,8,48,38,10,48
Dungannon,1002,6,9,9,12,46,42,4,36
Ballinamalla,1002,7,9,7,14,29,47,-18,34
Glenavon,1002,8,7,12,11,34,46,-12,33
Glentoran,1002,9,9,5,16,27,42,-15,32
Ards,1002,10,9,4,17,40,54,-14,31
Portadown,1002,11,7,9,14,28,46,-18,30
Linfield,1003,1,16,10,4,65,33,32,58
Ballymena,1003,2,16,7,7,67,50,17,55
Crusaders,1003,3,15,6,9,58,43,15,51
Cliftonville,1003,4,15,6,9,47,34,13,51
Glenavon,1003,5,13,10,7,46,43,3,49
Coleraine,1003,6,11,9,10,44,43,1,42
Dungannon,1003,7,9,9,12,50,50,0,36
Ballinamalla,1003,8,10,5,15,32,52,-20,35
Ards,1003,9,9,6,15,34,44,-10,33
Glentoran,1003,10,7,6,17,32,52,-20,27
Portadown,1003,11,3,8,19,24,55,-31,17
Crusaders,1004,1,16,7,7,54,37,17,55
Linfield,1004,2,13,14,3,59,29,30,53
Coleraine,1004,3,13,9,8,42,36,6,48
Cliftonville,1004,4,14,5,11,56,40,16,47
Ballymena,1004,5,12,9,9,52,57,-5,45
Dungannon,1004,6,12,7,11,50,39,11,43
Glenavon,1004,7,10,12,8,46,43,3,42
Ards,1004,8,12,4,14,43,49,-6,40
Glentoran,1004,9,6,10,14,28,47,-19,28
Portadown,1004,10,7,7,16,21,44,-23,28
Ballinamalla,1004,11,6,4,20,22,52,-30,22
Crusaders,1005,1,17,5,8,55,41,14,56
Linfield,1005,2,15,9,6,64,34,30,54
Cliftonville,1005,3,16,4,10,58,41,17,52
Coleraine,1005,4,13,10,7,47,38,9,49
Dungannon,1005,5,12,9,9,59,48,11,45
Glenavon,1005,6,10,11,9,51,46,5,41
Ballymena,1005,7,12,4,14,60,65,-5,40
Glentoran,1005,8,11,6,13,32,48,-16,39
Ards,1005,9,12,2,16,44,49,-5,38
Portadown,1005,10,6,7,17,26,50,-24,25
Ballinamalla,1005,11,5,5,20,31,67,-36,20
Linfield,1006,1,18,8,4,67,27,40,62
Cliftonville,1006,2,16,4,10,53,36,17,52
Crusaders,1006,3,14,7,9,52,41,11,49
Glenavon,1006,4,11,12,7,42,41,1,45
Coleraine,1006,5,11,11,8,42,41,1,44
Ballymena,1006,6,13,5,12,51,57,-6,44
Glentoran,1006,7,10,8,12,35,44,-9,38
Ards,1006,8,10,7,13,35,41,-6,37
Dungannon,1006,9,7,9,14,49,50,-1,30
Ballinamalla,1006,10,9,3,18,37,57,-20,30
Portadown,1006,11,7,4,19,24,52,-28,25
Crusaders,1007,1,14,8,8,51,36,15,50
Ballymena,1007,2,14,7,9,62,53,9,49
Cliftonville,1007,3,14,6,10,48,38,10,48
Linfield,1007,4,12,11,7,55,35,20,47
Dungannon,1007,5,12,11,7,55,37,18,47
Coleraine,1007,6,11,11,8,40,35,5,44
Glenavon,1007,7,10,11,9,48,49,-1,41
Glentoran,1007,8,9,9,12,31,46,-15,36
Ards,1007,9,8,10,12,39,44,-5,34
Portadown,1007,10,8,5,17,22,48,-26,29
Ballinamalla,1007,11,5,7,18,26,56,-30,22
Crusaders,1008,1,17,9,4,58,29,29,60
Cliftonville,1008,2,16,6,8,47,33,14,54
Linfield,1008,3,14,11,5,57,28,29,53
Ballymena,1008,4,14,6,10,67,58,9,48
Coleraine,1008,5,10,11,9,36,40,-4,41
Dungannon,1008,6,8,12,10,52,52,0,36
Glenavon,1008,7,7,14,9,39,42,-3,35
Ards,1008,8,7,10,13,39,47,-8,31
Glentoran,1008,9,7,10,13,31,46,-15,31
Ballinamalla,1008,10,8,5,17,26,59,-33,29
Portadown,1008,11,7,6,17,25,43,-18,27
Crusaders,1009,1,20,7,3,63,30,33,67
Linfield,1009,2,13,10,7,53,32,21,49
Ballymena,1009,3,12,8,10,58,61,-3,44
Coleraine,1009,4,11,10,9,39,37,2,43
Cliftonville,1009,5,12,7,11,51,50,1,43
Dungannon,1009,6,10,10,10,43,38,5,40
Ballinamalla,1009,7,11,4,15,29,42,-13,37
Ards,1009,8,10,6,14,39,44,-5,36
Glenavon,1009,9,8,10,12,37,44,-7,34
Portadown,1009,10,9,6,15,26,40,-14,33
Glentoran,1009,11,6,8,16,28,48,-20,26
Crusaders,1010,1,17,5,8,48,39,9,56
Cliftonville,1010,2,16,4,10,56,43,13,52
Linfield,1010,3,14,9,7,54,32,22,51
Ballymena,1010,4,15,6,9,60,53,7,51
Coleraine,1010,5,11,10,9,45,36,9,43
Glentoran,1010,6,12,6,12,27,35,-8,42
Glenavon,1010,7,9,14,7,46,43,3,41
Dungannon,1010,8,9,12,9,53,43,10,39
Ards,1010,9,7,7,16,31,42,-11,28
Ballinamalla,1010,10,8,3,19,30,54,-24,27
Portadown,1010,11,5,8,17,22,52,-30,23
Crusaders,1011,1,15,10,5,59,38,21,55
Linfield,1011,2,14,12,4,64,34,30,54
Ballymena,1011,3,15,7,8,63,56,7,52
Cliftonville,1011,4,14,8,8,54,37,17,50
Coleraine,1011,5,11,10,9,41,39,2,43
Dungannon,1011,6,9,10,11,47,45,2,37
Glenavon,1011,7,8,12,10,41,46,-5,36
Ards,1011,8,9,5,16,43,53,-10,32
Glentoran,1011,9,6,14,10,30,45,-15,32
Ballinamalla,1011,10,7,7,16,31,49,-18,28
Portadown,1011,11,6,7,17,23,54,-31,25
Cliftonville,1012,1,18,4,8,59,34,25,58
Linfield,1012,2,15,12,3,59,24,35,57
Crusaders,1012,3,16,9,5,57,34,23,57
Glenavon,1012,4,13,10,7,47,42,5,49
Coleraine,1012,5,13,7,10,45,44,1,46
Glentoran,1012,6,10,10,10,34,38,-4,40
Ballymena,1012,7,11,6,13,52,62,-10,39
Dungannon,1012,8,8,9,13,45,44,1,33
Ballinamalla,1012,9,7,5,18,33,54,-21,26
Ards,1012,10,7,4,19,33,61,-28,25
Portadown,1012,11,6,6,18,25,52,-27,24
Crusaders,1013,1,16,9,5,59,36,23,57
Ballymena,1013,2,16,5,9,60,53,7,53
Cliftonville,1013,3,15,4,11,55,44,11,49
Linfield,1013,4,12,8,10,52,38,14,44
Coleraine,1013,5,11,11,8,40,36,4,44
Glenavon,1013,6,11,11,8,47,44,3,44
Glentoran,1013,7,10,6,14,32,50,-18,36
Dungannon,1013,8,9,7,14,47,48,-1,34
Ballinamalla,1013,9,9,7,14,31,41,-10,34
Ards,1013,10,9,6,15,34,47,-13,33
Portadown,1013,11,6,8,16,22,42,-20,26
Crusaders,1014,1,17,6,7,54,33,21,57
Ballymena,1014,2,16,6,8,61,56,5,54
Cliftonville,1014,3,15,5,10,52,41,11,50
Linfield,1014,4,13,10,7,61,41,20,49
Coleraine,1014,5,13,8,9,49,44,5,47
Dungannon,1014,6,12,7,11,60,50,10,43
Glentoran,1014,7,12,7,11,37,38,-1,43
Glenavon,1014,8,12,7,11,50,54,-4,43
Portadown,1014,9,8,3,19,29,46,-17,27
Ballinamalla,1014,10,6,6,18,26,52,-26,24
Ards,1014,11,6,5,19,30,54,-24,23
Linfield,1015,1,14,11,5,57,35,22,53
Cliftonville,1015,2,16,5,9,57,40,17,53
Glenavon,1015,3,14,9,7,52,42,10,51
Crusaders,1015,4,13,10,7,51,37,14,49
Ballymena,1015,5,13,7,10,57,59,-2,46
Coleraine,1015,6,11,10,9,36,35,1,43
Dungannon,1015,7,9,9,12,48,46,2,36
Ards,1015,8,10,5,15,42,49,-7,35
Ballinamalla,1015,9,9,6,15,35,50,-15,33
Glentoran,1015,10,7,9,14,32,46,-14,30
Portadown,1015,11,5,7,18,23,51,-28,22
Linfield,1016,1,18,6,6,62,26,36,60
Cliftonville,1016,2,19,3,8,61,46,15,60
Crusaders,1016,3,13,10,7,51,32,19,49
Ballymena,1016,4,13,7,10,58,58,0,46
Glenavon,1016,5,10,11,9,46,50,-4,41
Coleraine,1016,6,10,10,10,40,41,-1,40
Dungannon,1016,7,10,8,12,50,44,6,38
Ards,1016,8,11,4,15,40,47,-7,37
Glentoran,1016,9,8,9,13,32,47,-15,33
Portadown,1016,10,8,6,16,25,43,-18,30
Ballinamalla,1016,11,6,4,20,30,61,-31,22
Crusaders,1017,1,15,11,4,61,36,25,56
Linfield,1017,2,15,10,5,64,33,31,55
Ballymena,1017,3,16,5,9,58,55,3,53
Coleraine,1017,4,12,12,6,47,36,11,48
Dungannon,1017,5,11,11,8,52,41,11,44
Cliftonville,1017,6,11,7,12,48,46,2,40
Glenavon,1017,7,8,13,9,41,48,-7,37
Glentoran,1017,8,7,11,12,25,39,-14,32
Ards,1017,9,8,6,16,33,47,-14,30
Ballinamalla,1017,10,7,7,16,31,53,-22,28
Portadown,1017,11,5,7,18,25,51,-26,22
Crusaders,1018,1,18,7,5,56,31,25,61
Linfield,1018,2,16,10,4,63,30,33,58
Glenavon,1018,3,13,7,10,58,50,8,46
Ballymena,1018,4,12,10,8,58,60,-2,46
Dungannon,1018,5,12,8,10,53,40,13,44
Cliftonville,1018,6,13,5,12,49,44,5,44
Coleraine,1018,7,10,11,9,43,43,0,41
Glentoran,1018,8,10,6,14,25,40,-15,36
Ards,1018,9,9,6,15,37,52,-15,33
Portadown,1018,10,9,5,16,28,44,-16,32
Ballinamalla,1018,11,3,5,22,25,61,-36,14
Crusaders,1019,1,18,5,7,56,34,22,59
Coleraine,1019,2,14,10,6,49,34,15,52
Cliftonville,1019,3,15,5,10,51,39,12,50
Ballymena,1019,4,14,5,11,59,65,-6,47
Linfield,1019,5,11,12,7,51,31,20,45
Dungannon,1019,6,12,9,9,51,41,10,45
Glenavon,1019,7,11,10,9,45,42,3,43
Ards,1019,8,9,6,15,38,43,-5,33
Glentoran,1019,9,8,8,14,31,49,-18,32
Portadown,1019,10,7,6,17,23,45,-22,27
Ballinamalla,1019,11,4,8,18,24,55,-31,20
Crusaders,1020,1,16,7,7,50,30,20,55
Linfield,1020,2,15,8,7,57,33,24,53
Ballymena,1020,3,16,5,9,58,53,5,53
Glenavon,1020,4,14,10,6,54,44,10,52
Cliftonville,1020,5,14,4,12,50,44,6,46
Ards,1020,6,12,4,14,44,48,-4,40
Coleraine,1020,7,10,9,11,39,44,-5,39
Dungannon,1020,8,10,8,12,49,42,7,38
Portadown,1020,9,9,5,16,27,43,-16,32
Ballinamalla,1020,10,7,5,18,28,51,-23,26
Glentoran,1020,11,6,7,17,26,50,-24,25
Linfield,1021,1,19,7,4,67,27,40,64
Cliftonville,1021,2,15,8,7,54,40,14,53
Crusaders,1021,3,14,6,10,56,37,19,48
Glenavon,1021,4,12,9,9,50,47,3,45
Ballymena,1021,5,13,6,11,57,59,-2,45
Coleraine,1021,6,10,12,8,38,41,-3,42
Ards,1021,7,11,6,13,43,51,-8,39
Dungannon,1021,8,8,10,12,48,49,-1,34
Glentoran,1021,9,7,8,15,30,44,-14,29
Ballinamalla,1021,10,8,5,17,33,56,-23,29
Portadown,1021,11,6,7,17,19,44,-25,25
Crusaders,1022,1,17,8,5,56,30,26,59
Cliftonville,1022,2,16,4,10,52,41,11,52
Ballymena,1022,3,15,6,9,67,62,5,51
Linfield,1022,4,12,9,9,54,35,19,45
Glenavon,1022,5,12,9,9,54,47,7,45
Coleraine,1022,6,11,11,8,42,40,2,44
Dungannon,1022,7,10,10,10,51,43,8,40
Ballinamalla,1022,8,10,6,14,33,45,-12,36
Ards,1022,9,8,6,16,40,58,-18,30
Glentoran,1022,10,7,6,17,31,56,-25,27
Portadown,1022,11,7,5,18,25,48,-23,26
Crusaders,1023,1,17,6,7,56,34,22,57
Linfield,1023,2,16,6,8,64,37,27,54
Ballymena,1023,3,16,5,9,65,58,7,53
Glenavon,1023,4,14,9,7,46,41,5,51
Cliftonville,1023,5,14,7,9,52,38,14,49
Coleraine,1023,6,12,11,7,48,36,12,47
Dungannon,1023,7,10,8,12,54,47,7,38
Ballinamalla,1023,8,9,5,16,36,54,-18,32
Glentoran,1023,9,6,8,16,31,57,-26,26
Portadown,1023,10,7,5,18,20,47,-27,26
Ards,1023,11,7,4,19,32,55,-23,25
Linfield,1024,1,17,8,5,57,28,29,59
Cliftonville,1024,2,17,5,8,54,30,24,56
Crusaders,1024,3,16,8,6,55,33,22,56
Coleraine,1024,4,10,14,6,41,34,7,44
Glenavon,1024,5,10,10,10,42,47,-5,40
Ballymena,1024,6,11,6,13,50,61,-11,39
Ards,1024,7,11,5,14,46,51,-5,38
Dungannon,1024,8,8,12,10,48,43,5,36
Glentoran,1024,9,10,5,15,36,51,-15,35
Portadown,1024,10,7,7,16,25,44,-19,28
Ballinamalla,1024,11,5,6,19,28,60,-32,21
Crusaders,1025,1,17,7,6,55,38,17,58
Linfield,1025,2,16,7,7,64,33,31,55
Cliftonville,1025,3,16,5,9,54,36,18,53
Ballymena,1025,4,15,6,9,54,50,4,51
Glenavon,1025,5,12,12,6,51,46,5,48
Coleraine,1025,6,12,10,8,47,36,11,46
Ards,1025,7,11,5,14,42,58,-16,38
Dungannon,1025,8,9,7,14,45,44,1,34
Portadown,1025,9,8,5,17,30,44,-14,29
Glentoran,1025,10,6,7,17,33,56,-23,25
Ballinamalla,1025,11,5,5,20,27,61,-34,20
Cliftonville,1026,1,17,5,8,59,34,25,56
Linfield,1026,2,14,10,6,51,26,25,52
Crusaders,1026,3,15,7,8,59,42,17,52
Ballymena,1026,4,14,7,9,52,52,0,49
Coleraine,1026,5,12,11,7,42,34,8,47
Glenavon,1026,6,11,10,9,50,45,5,43
Dungannon,1026,7,12,7,11,51,48,3,43
Ards,1026,8,9,7,14,38,45,-7,34
Portadown,1026,9,7,6,17,27,49,-22,27
Glentoran,1026,10,6,8,16,24,50,-26,26
Ballinamalla,1026,11,7,4,19,27,55,-28,25
Crusaders,1027,1,16,8,6,56,33,23,56
Cliftonville,1027,2,15,5,10,57,40,17,50
Linfield,1027,3,13,10,7,58,34,24,49
Dungannon,1027,4,12,9,9,50,41,9,45
Ballymena,1027,5,12,7,11,55,66,-11,43
Coleraine,1027,6,10,12,8,45,39,6,42
Glenavon,1027,7,10,12,8,50,47,3,42
Ards,1027,8,11,6,13,41,45,-4,39
Glentoran,1027,9,10,7,13,30,47,-17,37
Ballinamalla,1027,10,5,9,16,24,48,-24,24
Portadown,1027,11,6,5,19,23,49,-26,23
Crusaders,1028,1,16,7,7,55,32,23,55
Linfield,1028,2,15,10,5,52,29,23,55
Cliftonville,1028,3,16,5,9,59,37,22,53
Ballymena,1028,4,15,4,11,54,54,0,49
Glenavon,1028,5,12,11,7,54,48,6,47
Coleraine,1028,6,9,10,11,37,44,-7,37
Dungannon,1028,7,9,9,12,49,45,4,36
Glentoran,1028,8,10,6,14,37,47,-10,36
Ballinamalla,1028,9,10,4,16,33,48,-15,34
Ards,1028,10,9,5,16,30,50,-20,32
Portadown,1028,11,5,7,18,29,55,-26,22
Crusaders,1029,1,16,9,5,52,28,24,57
Linfield,1029,2,16,8,6,61,32,29,56
Glenavon,1029,3,14,9,7,54,42,12,51
Ballymena,1029,4,15,4,11,65,62,3,49
Cliftonville,1029,5,14,5,11,50,42,8,47
Coleraine,1029,6,12,7,11,43,43,0,43
Glentoran,1029,7,11,5,14,29,45,-16,38
Ards,1029,8,10,6,14,39,48,-9,36
Dungannon,1029,9,8,10,12,52,51,1,34
Ballinamalla,1029,10,7,6,17,30,54,-24,27
Portadown,1029,11,5,5,20,23,51,-28,20
Linfield,1030,1,16,9,5,66,31,35,57
Cliftonville,1030,2,16,6,8,51,33,18,54
Crusaders,1030,3,14,7,9,52,34,18,49
Coleraine,1030,4,12,11,7,36,32,4,47
Ballymena,1030,5,12,9,9,56,58,-2,45
Dungannon,1030,6,11,10,9,42,37,5,43
Glenavon,1030,7,11,10,9,49,47,2,43
Ards,1030,8,13,2,15,43,47,-4,41
Ballinamalla,1030,9,7,8,15,28,47,-19,29
Glentoran,1030,10,7,6,17,26,53,-27,27
Portadown,1030,11,4,6,20,21,51,-30,18
Glenavon,1031,1,17,9,4,59,36,23,60
Cliftonville,1031,2,17,5,8,59,40,19,56
Coleraine,1031,3,13,12,5,53,33,20,51
Crusaders,1031,4,14,7,9,54,39,15,49
Ballymena,1031,5,12,9,9,56,58,-2,45
Linfield,1031,6,10,12,8,52,34,18,42
Dungannon,1031,7,9,8,13,49,56,-7,35
Ards,1031,8,9,5,16,47,59,-12,32
Ballinamalla,1031,9,8,5,17,30,50,-20,29
Portadown,1031,10,7,6,17,28,48,-20,27
Glentoran,1031,11,6,8,16,31,65,-34,26
Crusaders,1032,1,14,10,6,54,35,19,52
Cliftonville,1032,2,15,7,8,53,39,14,52
Linfield,1032,3,14,9,7,55,29,26,51
Glenavon,1032,4,12,11,7,49,42,7,47
Ballymena,1032,5,13,6,11,64,62,2,45
Glentoran,1032,6,11,6,13,33,42,-9,39
Dungannon,1032,7,9,11,10,54,49,5,38
Coleraine,1032,8,9,11,10,40,45,-5,38
Ards,1032,9,9,6,15,34,49,-15,33
Ballinamalla,1032,10,7,7,16,22,43,-21,28
Portadown,1032,11,8,4,18,25,48,-23,28
Crusaders,1033,1,19,5,6,63,37,26,62
Ballymena,1033,2,14,9,7,59,53,6,51
Coleraine,1033,3,13,11,6,42,32,10,50
Linfield,1033,4,12,12,6,51,30,21,48
Dungannon,1033,5,12,7,11,53,42,11,43
Cliftonville,1033,6,12,6,12,46,43,3,42
Glenavon,1033,7,9,12,9,38,44,-6,39
Glentoran,1033,8,9,8,13,28,40,-12,35
Ards,1033,9,8,6,16,38,53,-15,30
Ballinamalla,1033,10,9,2,19,32,52,-20,29
Portadown,1033,11,6,6,18,20,44,-24,24
Cliftonville,1034,1,18,5,7,61,34,27,59
Crusaders,1034,2,14,9,7,56,38,18,51
Coleraine,1034,3,14,9,7,46,32,14,51
Ballymena,1034,4,15,5,10,53,51,2,50
Glenavon,1034,5,12,12,6,51,45,6,48
Linfield,1034,6,12,10,8,50,34,16,46
Dungannon,1034,7,11,10,9,52,48,4,43
Glentoran,1034,8,8,10,12,31,44,-13,34
Ballinamalla,1034,9,7,5,18,28,56,-28,26
Ards,1034,10,6,7,17,35,54,-19,25
Portadown,1034,11,5,4,21,23,50,-27,19
Crusaders,1035,1,15,7,8,48,37,11,52
Ballymena,1035,2,14,9,7,59,57,2,51
Linfield,1035,3,13,11,6,53,32,21,50
Glenavon,1035,4,13,11,6,56,39,17,50
Cliftonville,1035,5,15,5,10,53,38,15,50
Coleraine,1035,6,12,9,9,42,37,5,45
Dungannon,1035,7,12,7,11,52,44,8,43
Glentoran,1035,8,8,9,13,30,43,-13,33
Ards,1035,9,7,8,15,37,47,-10,29
Ballinamalla,1035,10,7,5,18,28,58,-30,26
Portadown,1035,11,3,11,16,23,49,-26,20
Crusaders,1036,1,17,7,6,53,35,18,58
Linfield,1036,2,14,13,3,61,28,33,55
Cliftonville,1036,3,15,3,12,51,44,7,48
Glenavon,1036,4,13,9,8,47,44,3,48
Coleraine,1036,5,13,8,9,43,42,1,47
Ballymena,1036,6,12,5,13,57,65,-8,41
Glentoran,1036,7,11,6,13,44,52,-8,39
Dungannon,1036,8,8,9,13,44,44,0,33
Ards,1036,9,9,4,17,42,54,-12,31
Ballinamalla,1036,10,8,6,16,31,48,-17,30
Portadown,1036,11,6,8,16,30,47,-17,26
Crusaders,1037,1,16,8,6,50,31,19,56
Linfield,1037,2,15,8,7,60,34,26,53
Cliftonville,1037,3,15,5,10,49,33,16,50
Glenavon,1037,4,11,14,5,45,37,8,47
Ballymena,1037,5,13,6,11,52,60,-8,45
Dungannon,1037,6,10,11,9,53,39,14,41
Portadown,1037,7,11,5,14,30,42,-12,38
Glentoran,1037,8,9,10,11,28,35,-7,37
Coleraine,1037,9,7,12,11,31,40,-9,33
Ards,1037,10,7,8,15,32,50,-18,29
Ballinamalla,1037,11,4,7,19,20,49,-29,19
Crusaders,1038,1,15,11,4,58,30,28,56
Linfield,1038,2,14,12,4,57,26,31,54
Cliftonville,1038,3,17,3,10,43,33,10,54
Ballymena,1038,4,14,7,9,59,55,4,49
Coleraine,1038,5,10,9,11,41,44,-3,39
Portadown,1038,6,11,4,15,23,39,-16,37
Glenavon,1038,7,8,12,10,40,43,-3,36
Dungannon,1038,8,8,10,12,46,46,0,34
Glentoran,1038,9,9,6,15,33,50,-17,33
Ards,1038,10,8,8,14,37,46,-9,32
Ballinamalla,1038,11,7,6,17,26,51,-25,27
Crusaders,1039,1,16,8,6,50,33,17,56
Linfield,1039,2,15,9,6,56,30,26,54
Coleraine,1039,3,15,8,7,52,36,16,53
Glenavon,1039,4,12,10,8,52,47,5,46
Cliftonville,1039,5,14,3,13,51,45,6,45
Dungannon,1039,6,12,7,11,52,42,10,43
Ballymena,1039,7,12,6,12,56,65,-9,42
Glentoran,1039,8,9,8,13,29,39,-10,35
Ards,1039,9,9,7,14,39,47,-8,34
Portadown,1039,10,8,3,19,30,54,-24,27
Ballinamalla,1039,11,6,5,19,29,58,-29,23
Cliftonville,1040,1,17,4,9,51,36,15,55
Ballymena,1040,2,16,6,8,54,45,9,54
Coleraine,1040,3,13,11,6,45,31,14,50
Glenavon,1040,4,12,9,9,51,43,8,45
Linfield,1040,5,11,11,8,50,30,20,44
Dungannon,1040,6,12,8,10,51,45,6,44
Crusaders,1040,7,12,6,12,48,44,4,42
Glentoran,1040,8,8,8,14,27,39,-12,32
Ards,1040,9,8,6,16,30,50,-20,30
Portadown,1040,10,8,6,16,22,43,-21,30
Ballinamalla,1040,11,9,3,18,23,46,-23,30
Cliftonville,1041,1,19,5,6,61,33,28,62
Crusaders,1041,2,16,9,5,55,32,23,57
Glenavon,1041,3,15,9,6,49,35,14,54
Linfield,1041,4,12,8,10,59,40,19,44
Coleraine,1041,5,12,8,10,43,36,7,44
Ballymena,1041,6,12,5,13,56,71,-15,41
Dungannon,1041,7,10,8,12,51,43,8,38
Glentoran,1041,8,9,8,13,27,43,-16,35
Ards,1041,9,10,4,16,41,49,-8,34
Ballinamalla,1041,10,9,2,19,30,56,-26,29
Portadown,1041,11,6,4,20,20,54,-34,22
Ballymena,1042,1,17,6,7,69,55,14,57
Linfield,1042,2,16,8,6,64,34,30,56
Dungannon,1042,3,15,6,9,59,40,19,51
Cliftonville,1042,4,14,6,10,50,39,11,48
Crusaders,1042,5,14,6,10,50,42,8,48
Coleraine,1042,6,11,11,8,46,40,6,44
Glenavon,1042,7,10,10,10,52,49,3,40
Portadown,1042,8,10,2,18,34,50,-16,32
Ards,1042,9,8,5,17,34,55,-21,29
Glentoran,1042,10,5,11,14,23,48,-25,26
Ballinamalla,1042,11,7,5,18,26,55,-29,26
Linfield,1043,1,18,8,4,65,26,39,62
Crusaders,1043,2,17,5,8,57,37,20,56
Cliftonville,1043,3,15,6,9,55,35,20,51
Dungannon,1043,4,11,9,10,52,44,8,42
Glenavon,1043,5,10,12,8,56,57,-1,42
Ballymena,1043,6,12,4,14,54,64,-10,40
Ards,1043,7,11,5,14,41,54,-13,38
Ballinamalla,1043,8,11,3,16,35,53,-18,36
Glentoran,1043,9,9,6,15,39,55,-16,33
Coleraine,1043,10,8,8,14,41,50,-9,32
Portadown,1043,11,7,6,17,24,44,-20,27
Cliftonville,1044,1,18,5,7,58,35,23,59
Crusaders,1044,2,16,9,5,55,32,23,57
Linfield,1044,3,14,9,7,59,34,25,51
Coleraine,1044,4,13,9,8,46,37,9,48
Ballymena,1044,5,15,3,12,58,60,-2,48
Glenavon,1044,6,12,8,10,49,45,4,44
Dungannon,1044,7,9,10,11,45,40,5,37
Glentoran,1044,8,10,7,13,33,44,-11,37
Ards,1044,9,10,4,16,33,49,-16,34
Portadown,1044,10,5,8,17,22,47,-25,23
Ballinamalla,1044,11,5,4,21,23,58,-35,19
Crusaders,1045,1,21,5,4,63,26,37,68
Linfield,1045,2,13,10,7,54,31,23,49
Coleraine,1045,3,13,10,7,43,31,12,49
Glenavon,1045,4,13,8,9,50,48,2,47
Cliftonville,1045,5,13,4,13,48,44,4,43
Ballymena,1045,6,11,6,13,51,59,-8,39
Dungannon,1045,7,9,11,10,46,45,1,38
Glentoran,1045,8,11,5,14,27,40,-13,38
Ards,1045,9,8,7,15,33,48,-15,31
Ballinamalla,1045,10,7,6,17,30,49,-19,27
Portadown,1045,11,7,6,17,23,47,-24,27
Crusaders,1046,1,20,7,3,62,24,38,67
Linfield,1046,2,16,11,3,60,26,34,59
Cliftonville,1046,3,16,4,10,63,46,17,52
Glenavon,1046,4,12,8,10,51,53,-2,44
Dungannon,1046,5,11,10,9,51,42,9,43
Ballymena,1046,6,11,7,12,53,57,-4,40
Coleraine,1046,7,10,9,11,42,45,-3,39
Ballinamalla,1046,8,8,5,17,28,57,-29,29
Glentoran,1046,9,7,7,16,28,51,-23,28
Ards,1046,10,7,6,17,33,51,-18,27
Portadown,1046,11,7,6,17,27,46,-19,27
Ballymena,1047,1,17,5,8,58,47,11,56
Cliftonville,1047,2,15,6,9,56,39,17,51
Linfield,1047,3,14,8,8,58,35,23,50
Crusaders,1047,4,13,10,7,47,34,13,49
Coleraine,1047,5,11,12,7,38,31,7,45
Glentoran,1047,6,12,8,10,30,32,-2,44
Glenavon,1047,7,9,10,11,41,58,-17,37
Dungannon,1047,8,9,9,12,50,44,6,36
Ards,1047,9,9,7,14,42,49,-7,34
Portadown,1047,10,6,8,16,19,41,-22,26
Ballinamalla,1047,11,6,5,19,28,57,-29,23
Cliftonville,1048,1,17,6,7,58,35,23,57
Linfield,1048,2,14,11,5,60,27,33,53
Crusaders,1048,3,12,11,7,50,42,8,47
Coleraine,1048,4,13,8,9,43,42,1,47
Ballymena,1048,5,14,4,12,53,60,-7,46
Glenavon,1048,6,11,11,8,47,41,6,44
Dungannon,1048,7,11,9,10,53,44,9,42
Ballinamalla,1048,8,11,3,16,36,48,-12,36
Glentoran,1048,9,9,6,15,30,48,-18,33
Portadown,1048,10,7,6,17,28,48,-20,27
Ards,1048,11,6,5,19,34,57,-23,23
Linfield,1049,1,15,10,5,57,28,29,55
Crusaders,1049,2,15,8,7,54,34,20,53
Ballymena,1049,3,14,7,9,61,58,3,49
Dungannon,1049,4,13,9,8,56,40,16,48
Cliftonville,1049,5,12,8,10,46,40,6,44
Glenavon,1049,6,10,10,10,44,41,3,40
Coleraine,1049,7,10,10,10,35,41,-6,40
Glentoran,1049,8,8,10,12,31,46,-15,34
Ards,1049,9,9,5,16,35,46,-11,32
Ballinamalla,1049,10,8,6,16,33,52,-19,30
Portadown,1049,11,5,9,16,21,47,-26,24
Crusaders,1050,1,17,7,6,63,41,22,58
Ballymena,1050,2,14,8,8,58,57,1,50
Linfield,1050,3,13,10,7,55,33,22,49
Coleraine,1050,4,11,12,7,41,34,7,45
Glenavon,1050,5,11,9,10,51,45,6,42
Cliftonville,1050,6,11,8,11,44,40,4,41
Ards,1050,7,11,5,14,48,50,-2,38
Dungannon,1050,8,8,11,11,41,47,-6,35
Ballinamalla,1050,9,9,7,14,32,45,-13,34
Glentoran,1050,10,8,9,13,28,42,-14,33
Portadown,1050,11,6,6,18,21,48,-27,24
Crusaders,1051,1,16,8,6,56,34,22,56
Ballymena,1051,2,15,7,8,64,60,4,52
Cliftonville,1051,3,15,6,9,53,33,20,51
Linfield,1051,4,13,9,8,59,37,22,48
Glenavon,1051,5,10,13,7,44,45,-1,43
Dungannon,1051,6,9,10,11,43,41,2,37
Glentoran,1051,7,9,9,12,29,43,-14,36
Coleraine,1051,8,8,10,12,38,47,-9,34
Portadown,1051,9,8,9,13,25,39,-14,33
Ards,1051,10,8,6,16,31,40,-9,30
Ballinamalla,1051,11,9,3,18,36,59,-23,30
Crusaders,1052,1,17,8,5,54,31,23,59
Linfield,1052,2,13,13,4,63,26,37,52
Coleraine,1052,3,13,13,4,51,32,19,52
Cliftonville,1052,4,13,7,10,49,39,10,46
Glenavon,1052,5,12,9,9,52,45,7,45
Ballymena,1052,6,12,9,9,50,55,-5,45
Dungannon,1052,7,9,11,10,45,41,4,38
Glentoran,1052,8,9,8,13,31,48,-17,35
Ards,1052,9,8,7,15,31,49,-18,31
Portadown,1052,10,6,4,20,20,51,-31,22
Ballinamalla,1052,11,4,9,17,25,54,-29,21
Linfield,1053,1,15,10,5,68,36,32,55
Glenavon,1053,2,15,10,5,66,44,22,55
Cliftonville,1053,3,15,5,10,56,45,11,50
Crusaders,1053,4,14,7,9,49,38,11,49
Ballymena,1053,5,14,5,11,54,61,-7,47
Dungannon,1053,6,10,8,12,52,43,9,38
Coleraine,1053,7,9,11,10,40,40,0,38
Ards,1053,8,11,3,16,35,47,-12,36
Portadown,1053,9,10,5,15,31,45,-14,35
Glentoran,1053,10,8,7,15,32,52,-20,31
Ballinamalla,1053,11,6,5,19,27,59,-32,23
Linfield,1054,1,18,8,4,64,26,38,62
Crusaders,1054,2,16,9,5,53,32,21,57
Glenavon,1054,3,15,8,7,52,47,5,53
Coleraine,1054,4,10,12,8,39,37,2,42
Cliftonville,1054,5,11,7,12,48,41,7,40
Ballymena,1054,6,9,10,11,49,60,-11,37
Dungannon,1054,7,9,9,12,47,46,1,36
Ards,1054,8,9,9,12,42,44,-2,36
Portadown,1054,9,8,8,14,31,43,-12,32
Glentoran,1054,10,6,11,13,25,43,-18,29
Ballinamalla,1054,11,6,5,19,28,59,-31,23
Ballymena,1055,1,17,4,9,54,52,2,55
Crusaders,1055,2,16,6,8,57,44,13,54
Cliftonville,1055,3,17,3,10,52,40,12,54
Linfield,1055,4,15,8,7,61,38,23,53
Glenavon,1055,5,13,10,7,57,46,11,49
Coleraine,1055,6,11,11,8,46,38,8,44
Dungannon,1055,7,9,11,10,53,46,7,38
Ards,1055,8,10,7,13,45,47,-2,37
Portadown,1055,9,8,4,18,27,50,-23,28
Glentoran,1055,10,7,5,18,26,44,-18,26
Ballinamalla,1055,11,5,5,20,24,57,-33,20
Linfield,1056,1,18,8,4,71,33,38,62
Crusaders,1056,2,16,9,5,62,38,24,57
Cliftonville,1056,3,17,2,11,57,42,15,53
Ballymena,1056,4,12,8,10,55,62,-7,44
Coleraine,1056,5,10,11,9,36,36,0,41
Glentoran,1056,6,10,6,14,33,38,-5,36
Dungannon,1056,7,8,10,12,47,53,-6,34
Glenavon,1056,8,7,12,11,35,43,-8,33
Portadown,1056,9,8,8,14,24,41,-17,32
Ards,1056,10,8,6,16,31,46,-15,30
Ballinamalla,1056,11,7,8,15,31,50,-19,29
Crusaders,1057,1,17,6,7,60,34,26,57
Linfield,1057,2,15,11,4,66,33,33,56
Cliftonville,1057,3,15,5,10,52,38,14,50
Ballymena,1057,4,14,7,9,61,63,-2,49
Coleraine,1057,5,10,14,6,42,36,6,44
Glentoran,1057,6,11,7,12,36,49,-13,40
Dungannon,1057,7,10,7,13,49,46,3,37
Glenavon,1057,8,8,11,11,43,55,-12,35
Ards,1057,9,9,6,15,40,47,-7,33
Ballinamalla,1057,10,8,3,19,31,55,-24,27
Portadown,1057,11,5,9,16,33,57,-24,24
Crusaders,1058,1,16,7,7,58,41,17,55
Cliftonville,1058,2,16,4,10,60,41,19,52
Linfield,1058,3,13,12,5,56,27,29,51
Ballymena,1058,4,15,6,9,57,53,4,51
Coleraine,1058,5,12,9,9,43,42,1,45
Glenavon,1058,6,10,11,9,49,54,-5,41
Dungannon,1058,7,9,11,10,49,47,2,38
Ards,1058,8,11,4,15,45,50,-5,37
Glentoran,1058,9,9,6,15,37,47,-10,33
Portadown,1058,10,8,5,17,27,49,-22,29
Ballinamalla,1058,11,5,7,18,26,56,-30,22
Linfield,1059,1,17,10,3,68,28,40,61
Crusaders,1059,2,14,9,7,49,35,14,51
Cliftonville,1059,3,15,5,10,52,39,13,50
Ballymena,1059,4,13,6,11,59,62,-3,45
Glenavon,1059,5,11,11,8,50,43,7,44
Coleraine,1059,6,10,11,9,37,37,0,41
Portadown,1059,7,10,6,14,28,40,-12,36
Ballinamalla,1059,8,9,6,15,36,51,-15,33
Ards,1059,9,9,6,15,35,51,-16,33
Glentoran,1059,10,7,8,15,29,50,-21,29
Dungannon,1059,11,6,10,14,44,51,-7,28
Cliftonville,1060,1,19,5,6,57,32,25,62
Crusaders,1060,2,15,9,6,51,33,18,54
Linfield,1060,3,12,11,7,57,32,25,47
Ballymena,1060,4,12,9,9,51,53,-2,45
Coleraine,1060,5,11,11,8,46,43,3,44
Ards,1060,6,10,8,12,45,47,-2,38
Dungannon,1060,7,9,9,12,44,41,3,36
Glenavon,1060,8,8,12,10,45,53,-8,36
Portadown,1060,9,7,8,15,28,44,-16,29
Ballinamalla,1060,10,7,8,15,31,49,-18,29
Glentoran,1060,11,6,8,16,28,56,-28,26
Cliftonville,1061,1,18,4,8,59,37,22,58
Crusaders,1061,2,14,10,6,52,30,22,52
Linfield,1061,3,13,11,6,60,32,28,50
Ballymena,1061,4,14,4,12,51,62,-11,46
Coleraine,1061,5,10,13,7,44,37,7,43
Glenavon,1061,6,11,10,9,46,48,-2,43
Dungannon,1061,7,10,10,10,48,37,11,40
Portadown,1061,8,7,11,12,24,38,-14,32
Glentoran,1061,9,8,7,15,23,47,-24,31
Ards,1061,10,6,9,15,34,51,-17,27
Ballinamalla,1061,11,6,7,17,31,53,-22,25
Crusaders,1062,1,19,7,4,61,27,34,64
Cliftonville,1062,2,17,3,10,62,47,15,54
Linfield,1062,3,14,8,8,56,32,24,50
Ballymena,1062,4,13,7,10,54,59,-5,46
Dungannon,1062,5,12,9,9,49,37,12,45
Glenavon,1062,6,11,10,9,52,52,0,43
Ballinamalla,1062,7,10,5,15,34,50,-16,35
Coleraine,1062,8,8,10,12,43,48,-5,34
Ards,1062,9,10,4,16,43,53,-10,34
Glentoran,1062,10,5,11,14,25,48,-23,26
Portadown,1062,11,5,8,17,17,43,-26,23
Crusaders,1063,1,19,6,5,63,35,28,63
Linfield,1063,2,16,7,7,65,34,31,55
Coleraine,1063,3,14,13,3,51,30,21,55
Cliftonville,1063,4,13,5,12,48,46,2,44
Dungannon,1063,5,10,10,10,48,43,5,40
Glentoran,1063,6,10,9,11,34,41,-7,39
Glenavon,1063,7,9,11,10,43,48,-5,38
Ballymena,1063,8,10,6,14,48,63,-15,36
Ards,1063,9,9,6,15,40,57,-17,33
Ballinamalla,1063,10,8,5,17,37,51,-14,29
Portadown,1063,11,5,6,19,21,50,-29,21
Crusaders,1064,1,17,9,4,64,34,30,60
Cliftonville,1064,2,19,3,8,62,42,20,60
Linfield,1064,3,14,9,7,59,33,26,51
Ballymena,1064,4,15,4,11,64,56,8,49
Coleraine,1064,5,13,7,10,46,43,3,46
Dungannon,1064,6,12,9,9,54,41,13,45
Glenavon,1064,7,11,10,9,47,47,0,43
Glentoran,1064,8,10,7,13,36,48,-12,37
Ards,1064,9,9,4,17,41,55,-14,31
Ballinamalla,1064,10,5,4,21,29,61,-32,19
Portadown,1064,11,5,4,21,24,66,-42,19
Crusaders,1065,1,17,6,7,55,35,20,57
Cliftonville,1065,2,15,7,8,52,35,17,52
Linfield,1065,3,13,8,9,50,37,13,47
Glenavon,1065,4,13,8,9,50,46,4,47
Ballymena,1065,5,14,5,11,54,58,-4,47
Dungannon,1065,6,12,9,9,51,39,12,45
Coleraine,1065,7,9,10,11,37,38,-1,37
Portadown,1065,8,9,5,16,28,43,-15,32
Ards,1065,9,8,7,15,36,44,-8,31
Ballinamalla,1065,10,8,7,15,32,53,-21,31
Glentoran,1065,11,6,10,14,29,46,-17,28
Crusaders,1066,1,16,8,6,54,37,17,56
Cliftonville,1066,2,16,4,10,51,36,15,52
Coleraine,1066,3,13,12,5,46,32,14,51
Glenavon,1066,4,11,16,3,53,40,13,49
Ballymena,1066,5,12,8,10,47,51,-4,44
Linfield,1066,6,11,10,9,57,39,18,43
Dungannon,1066,7,9,11,10,55,46,9,38
Glentoran,1066,8,7,10,13,33,47,-14,31
Portadown,1066,9,8,6,16,20,42,-22,30
Ards,1066,10,7,8,15,32,50,-18,29
Ballinamalla,1066,11,5,7,18,25,53,-28,22
Crusaders,1067,1,18,9,3,58,32,26,63
Ballymena,1067,2,15,8,7,62,54,8,53
Glenavon,1067,3,12,12,6,57,44,13,48
Cliftonville,1067,4,14,6,10,49,38,11,48
Linfield,1067,5,12,10,8,61,39,22,46
Coleraine,1067,6,10,12,8,41,41,0,42
Dungannon,1067,7,8,7,15,49,53,-4,31
Ards,1067,8,7,10,13,40,51,-11,31
Ballinamalla,1067,9,9,4,17,34,51,-17,31
Portadown,1067,10,8,6,16,27,48,-21,30
Glentoran,1067,11,6,8,16,28,55,-27,26
Linfield,1068,1,16,11,3,60,25,35,59
Crusaders,1068,2,14,8,8,50,40,10,50
Cliftonville,1068,3,14,6,10,51,40,11,48
Ballymena,1068,4,13,8,9,57,55,2,47
Dungannon,1068,5,11,10,9,57,39,18,43
Glenavon,1068,6,11,10,9,49,46,3,43
Coleraine,1068,7,10,11,9,35,38,-3,41
Ards,1068,8,8,9,13,39,52,-13,33
Glentoran,1068,9,8,9,13,28,42,-14,33
Portadown,1068,10,5,11,14,29,47,-18,26
Ballinamalla,1068,11,7,3,20,25,56,-31,24
Cliftonville,1069,1,17,4,9,55,36,19,55
Crusaders,1069,2,15,9,6,56,35,21,54
Ballymena,1069,3,14,6,10,60,59,1,48
Dungannon,1069,4,13,8,9,57,43,14,47
Coleraine,1069,5,11,10,9,39,39,0,43
Linfield,1069,6,11,8,11,52,38,14,41
Glenavon,1069,7,10,9,11,47,49,-2,39
Glentoran,1069,8,8,13,9,33,42,-9,37
Ards,1069,9,8,6,16,35,51,-16,30
Portadown,1069,10,8,6,16,26,49,-23,30
Ballinamalla,1069,11,8,5,17,35,54,-19,29
Crusaders,1070,1,15,11,4,53,29,24,56
Cliftonville,1070,2,16,5,9,51,37,14,53
Linfield,1070,3,14,8,8,62,39,23,50
Coleraine,1070,4,12,11,7,47,33,14,47
Glenavon,1070,5,11,12,7,48,42,6,45
Dungannon,1070,6,12,8,10,51,41,10,44
Ballymena,1070,7,10,7,13,46,58,-12,37
Glentoran,1070,8,8,8,14,29,47,-18,32
Ards,1070,9,9,4,17,33,52,-19,31
Ballinamalla,1070,10,8,6,16,32,50,-18,30
Portadown,1070,11,8,4,18,26,50,-24,28
Ballymena,1071,1,15,7,8,62,52,10,52
Crusaders,1071,2,15,6,9,50,36,14,51
Linfield,1071,3,13,11,6,59,33,26,50
Glenavon,1071,4,12,10,8,50,45,5,46
Dungannon,1071,5,11,12,7,54,43,11,45
Coleraine,1071,6,11,12,7,45,41,4,45
Cliftonville,1071,7,13,5,12,47,44,3,44
Ballinamalla,1071,8,11,4,15,39,46,-7,37
Glentoran,1071,9,8,8,14,31,52,-21,32
Ards,1071,10,7,5,18,36,55,-19,26
Portadown,1071,11,6,6,18,25,51,-26,24
Linfield,1072,1,17,7,6,56,25,31,58
Coleraine,1072,2,13,12,5,46,37,9,51
Crusaders,1072,3,14,8,8,49,35,14,50
Glenavon,1072,4,12,11,7,45,46,-1,47
Cliftonville,1072,5,13,7,10,56,45,11,46
Ballymena,1072,6,12,6,12,59,56,3,42
Dungannon,1072,7,10,9,11,48,41,7,39
Portadown,1072,8,9,6,15,25,47,-22,33
Ards,1072,9,9,5,16,43,49,-6,32
Glentoran,1072,10,8,7,15,28,47,-19,31
Ballinamalla,1072,11,6,6,18,27,54,-27,24
Linfield,1073,1,15,10,5,61,31,30,55
Glenavon,1073,2,15,10,5,53,41,12,55
Crusaders,1073,3,16,5,9,52,36,16,53
Cliftonville,1073,4,14,7,9,52,39,13,49
Coleraine,1073,5,12,9,9,44,39,5,45
Ballymena,1073,6,12,7,11,54,63,-9,43
Dungannon,1073,7,11,8,11,52,45,7,41
Glentoran,1073,8,9,9,12,27,38,-11,36
Ards,1073,9,9,6,15,38,48,-10,33
Portadown,1073,10,5,7,18,28,54,-26,22
Ballinamalla,1073,11,5,6,19,28,55,-27,21
Crusaders,1074,1,18,7,5,60,33,27,61
Cliftonville,1074,2,15,5,10,57,47,10,50
Linfield,1074,3,12,11,7,59,43,16,47
Coleraine,1074,4,12,11,7,45,38,7,47
Ballymena,1074,5,13,7,10,61,60,1,46
Dungannon,1074,6,11,10,9,50,41,9,43
Glenavon,1074,7,11,9,10,48,49,-1,42
Glentoran,1074,8,8,11,11,29,39,-10,35
Ards,1074,9,8,6,16,36,47,-11,30
Ballinamalla,1074,10,6,7,17,29,53,-24,25
Portadown,1074,11,5,8,17,26,50,-24,23
Linfield,1075,1,16,8,6,61,29,32,56
Cliftonville,1075,2,18,2,10,59,36,23,56
Coleraine,1075,3,16,8,6,51,35,16,56
Crusaders,1075,4,15,8,7,50,38,12,53
Ballymena,1075,5,15,5,10,64,63,1,50
Glenavon,1075,6,10,10,10,42,44,-2,40
Glentoran,1075,7,9,10,11,29,34,-5,37
Dungannon,1075,8,9,7,14,48,52,-4,34
Ballinamalla,1075,9,7,6,17,30,52,-22,27
Portadown,1075,10,7,4,19,26,58,-32,25
Ards,1075,11,6,6,18,36,55,-19,24
Crusaders,1076,1,19,6,5,58,37,21,63
Cliftonville,1076,2,15,6,9,58,43,15,51
Linfield,1076,3,12,9,9,55,37,18,45
Coleraine,1076,4,10,14,6,42,38,4,44
Ballymena,1076,5,10,11,9,58,59,-1,41
Glenavon,1076,6,10,11,9,40,42,-2,41
Ards,1076,7,11,4,15,35,47,-12,37
Glentoran,1076,8,9,8,13,31,41,-10,35
Ballinamalla,1076,9,9,7,14,33,47,-14,34
Portadown,1076,10,7,8,15,26,45,-19,29
Dungannon,1076,11,6,10,14,51,51,0,28
Crusaders,1077,1,18,8,4,58,32,26,62
Ballymena,1077,2,14,8,8,59,52,7,50
Linfield,1077,3,12,12,6,60,33,27,48
Cliftonville,1077,4,13,8,9,50,42,8,47
Glenavon,1077,5,11,11,8,51,49,2,44
Coleraine,1077,6,9,13,8,42,40,2,40
Portadown,1077,7,10,6,14,29,44,-15,36
Glentoran,1077,8,7,11,12,25,40,-15,32
Dungannon,1077,9,7,9,14,42,46,-4,30
Ards,1077,10,7,9,14,31,46,-15,30
Ballinamalla,1077,11,6,7,17,31,54,-23,25
Linfield,1078,1,14,10,6,59,33,26,52
Coleraine,1078,2,14,9,7,50,30,20,51
Crusaders,1078,3,14,9,7,48,38,10,51
Cliftonville,1078,4,14,7,9,48,35,13,49
Glenavon,1078,5,13,10,7,47,37,10,49
Ballymena,1078,6,12,7,11,50,62,-12,43
Dungannon,1078,7,11,9,10,47,39,8,42
Glentoran,1078,8,8,11,11,34,40,-6,35
Ards,1078,9,8,6,16,32,51,-19,30
Ballinamalla,1078,10,7,4,19,33,53,-20,25
Portadown,1078,11,6,6,18,22,52,-30,24
Crusaders,1079,1,19,7,4,70,37,33,64
Cliftonville,1079,2,19,2,9,59,44,15,59
Ballymena,1079,3,14,5,11,67,65,2,47
Linfield,1079,4,11,11,8,52,37,15,44
Dungannon,1079,5,11,10,9,58,42,16,43
Coleraine,1079,6,11,9,10,46,41,5,42
Glenavon,1079,7,11,9,10,47,49,-2,42
Glentoran,1079,8,9,8,13,29,46,-17,35
Ards,1079,9,9,6,15,37,48,-11,33
Portadown,1079,10,7,6,17,23,49,-26,27
Ballinamalla,1079,11,6,3,21,26,56,-30,21
Linfield,1080,1,17,9,4,64,30,34,60
Crusaders,1080,2,16,7,7,61,41,20,55
Ballymena,1080,3,15,7,8,61,50,11,52
Cliftonville,1080,4,14,7,9,55,46,9,49
Coleraine,1080,5,12,9,9,47,48,-1,45
Glenavon,1080,6,10,11,9,55,45,10,41
Ards,1080,7,10,7,13,42,44,-2,37
Dungannon,1080,8,6,12,12,41,50,-9,30
Ballinamalla,1080,9,9,3,18,31,57,-26,30
Glentoran,1080,10,6,10,14,25,44,-19,28
Portadown,1080,11,6,6,18,25,52,-27,24
Crusaders,1081,1,18,5,7,64,32,32,59
Ballymena,1081,2,15,6,9,60,63,-3,51
Linfield,1081,3,13,10,7,55,29,26,49
Cliftonville,1081,4,14,5,11,53,43,10,47
Coleraine,1081,5,12,10,8,45,39,6,46
Dungannon,1081,6,11,10,9,53,44,9,43
Glenavon,1081,7,10,12,8,41,42,-1,42
Ballinamalla,1081,8,10,4,16,35,50,-15,34
Glentoran,1081,9,7,8,15,29,47,-18,29
Ards,1081,10,8,5,17,37,59,-22,29
Portadown,1081,11,7,5,18,27,51,-24,26
Linfield,1082,1,17,8,5,57,27,30,59
Crusaders,1082,2,15,9,6,60,35,25,54
Ballymena,1082,3,14,8,8,52,53,-1,50
Cliftonville,1082,4,13,6,11,44,42,2,45
Glenavon,1082,5,10,12,8,42,37,5,42
Coleraine,1082,6,9,12,9,40,41,-1,39
Portadown,1082,7,10,8,12,22,33,-11,38
Dungannon,1082,8,7,13,10,50,41,9,34
Glentoran,1082,9,8,9,13,31,46,-15,33
Ards,1082,10,8,5,17,33,45,-12,29
Ballinamalla,1082,11,7,4,19,28,59,-31,25
Crusaders,1083,1,16,6,8,57,34,23,54
Ballymena,1083,2,15,5,10,65,65,0,50
Cliftonville,1083,3,14,5,11,49,41,8,47
Linfield,1083,4,13,7,10,57,40,17,46
Glenavon,1083,5,11,13,6,42,39,3,46
Ards,1083,6,12,6,12,40,42,-2,42
Portadown,1083,7,11,5,14,33,39,-6,38
Dungannon,1083,8,7,15,8,52,51,1,36
Coleraine,1083,9,9,8,13,38,44,-6,35
Glentoran,1083,10,7,9,14,30,48,-18,30
Ballinamalla,1083,11,7,7,16,31,51,-20,28
Linfield,1084,1,17,6,7,62,32,30,57
Crusaders,1084,2,15,7,8,52,34,18,52
Cliftonville,1084,3,14,6,10,52,41,11,48
Glenavon,1084,4,11,13,6,47,41,6,46
Ballymena,1084,5,13,6,11,56,60,-4,45
Coleraine,1084,6,11,11,8,47,36,11,44
Dungannon,1084,7,10,9,11,44,39,5,39
Glentoran,1084,8,8,9,13,26,38,-12,33
Portadown,1084,9,7,9,14,23,45,-22,30
Ards,1084,10,8,5,17,34,50,-16,29
Ballinamalla,1084,11,8,5,17,27,54,-27,29
Ballymena,1085,1,18,3,9,62,57,5,57
Linfield,1085,2,15,10,5,63,32,31,55
Crusaders,1085,3,14,11,5,63,42,21,53
Cliftonville,1085,4,15,7,8,56,45,11,52
Glenavon,1085,5,11,10,9,53,48,5,43
Coleraine,1085,6,11,10,9,45,40,5,43
Dungannon,1085,7,11,9,10,53,43,10,42
Glentoran,1085,8,8,8,14,33,52,-19,32
Ards,1085,9,7,6,17,35,55,-20,27
Portadown,1085,10,7,4,19,22,44,-22,25
Ballinamalla,1085,11,7,4,19,28,55,-27,25
Crusaders,1086,1,18,7,5,52,28,24,61
Cliftonville,1086,2,16,6,8,56,40,16,54
Linfield,1086,3,13,10,7,56,33,23,49
Ballymena,1086,4,13,8,9,59,57,2,47
Dungannon,1086,5,11,8,11,53,42,11,41
Coleraine,1086,6,9,14,7,39,39,0,41
Glenavon,1086,7,10,10,10,42,42,0,40
Portadown,1086,8,10,4,16,28,42,-14,34
Ards,1086,9,9,6,15,41,49,-8,33
Ballinamalla,1086,10,9,2,19,32,54,-22,29
Glentoran,1086,11,5,9,16,25,57,-32,24
Crusaders,1087,1,17,8,5,61,33,28,59
Linfield,1087,2,15,9,6,66,29,37,54
Ballymena,1087,3,15,8,7,63,56,7,53
Cliftonville,1087,4,14,7,9,47,38,9,49
Dungannon,1087,5,11,9,10,54,49,5,42
Glenavon,1087,6,10,11,9,48,54,-6,41
Coleraine,1087,7,8,10,12,37,48,-11,34
Ards,1087,8,7,11,12,44,55,-11,32
Glentoran,1087,9,8,8,14,30,51,-21,32
Ballinamalla,1087,10,7,8,15,33,49,-16,29
Portadown,1087,11,6,5,19,26,47,-21,23
Linfield,1088,1,17,9,4,67,34,33,60
Crusaders,1088,2,14,8,8,54,42,12,50
Glenavon,1088,3,13,10,7,47,38,9,49
Cliftonville,1088,4,15,3,12,52,46,6,48
Ballymena,1088,5,14,5,11,59,52,7,47
Coleraine,1088,6,12,8,10,44,43,1,44
Dungannon,1088,7,8,12,10,44,41,3,36
Ards,1088,8,10,4,16,42,53,-11,34
Ballinamalla,1088,9,9,4,17,32,56,-24,31
Portadown,1088,10,8,6,16,29,49,-20,30
Glentoran,1088,11,7,7,16,24,40,-16,28
Crusaders,1089,1,15,8,7,58,36,22,53
Linfield,1089,2,13,11,6,61,33,28,50
Glenavon,1089,3,13,9,8,57,45,12,48
Coleraine,1089,4,13,8,9,42,37,5,47
Cliftonville,1089,5,13,6,11,49,43,6,45
Ballymena,1089,6,11,9,10,53,60,-7,42
Dungannon,1089,7,11,7,12,46,41,5,40
Glentoran,1089,8,10,8,12,32,41,-9,38
Portadown,1089,9,9,7,14,31,48,-17,34
Ards,1089,10,8,8,14,41,56,-15,32
Ballinamalla,1089,11,5,7,18,30,60,-30,22
Ballymena,1090,1,18,6,6,67,55,12,60
Crusaders,1090,2,16,8,6,57,34,23,56
Cliftonville,1090,3,15,7,8,54,37,17,52
Glenavon,1090,4,14,10,6,51,44,7,52
Linfield,1090,5,11,11,8,62,37,25,44
Coleraine,1090,6,11,11,8,45,42,3,44
Dungannon,1090,7,10,9,11,54,49,5,39
Glentoran,1090,8,7,9,14,31,47,-16,30
Portadown,1090,9,8,5,17,28,52,-24,29
Ards,1090,10,6,5,19,37,59,-22,23
Ballinamalla,1090,11,6,5,19,25,55,-30,23
Crusaders,1091,1,18,7,5,61,32,29,61
Linfield,1091,2,15,9,6,57,26,31,54
Cliftonville,1091,3,15,4,11,53,40,13,49
Glenavon,1091,4,11,13,6,44,40,4,46
Ballymena,1091,5,13,7,10,51,58,-7,46
Dungannon,1091,6,12,6,12,50,41,9,42
Coleraine,1091,7,10,10,10,35,36,-1,40
Ards,1091,8,9,5,16,35,46,-11,32
Glentoran,1091,9,8,7,15,28,51,-23,31
Portadown,1091,10,7,7,16,27,46,-19,28
Ballinamalla,1091,11,7,5,18,24,49,-25,26
Crusaders,1092,1,16,10,4,56,34,22,58
Cliftonville,1092,2,18,4,8,62,43,19,58
Glenavon,1092,3,12,11,7,51,42,9,47
Ballymena,1092,4,12,9,9,63,56,7,45
Linfield,1092,5,9,12,9,48,37,11,39
Coleraine,1092,6,10,9,11,47,51,-4,39
Ballinamalla,1092,7,11,6,13,35,45,-10,39
Ards,1092,8,9,7,14,37,43,-6,34
Dungannon,1092,9,7,10,13,45,51,-6,31
Portadown,1092,10,8,6,16,28,47,-19,30
Glentoran,1092,11,5,12,13,26,49,-23,27
Crusaders,1093,1,18,6,6,56,30,26,60
Ballymena,1093,2,15,7,8,62,52,10,52
Linfield,1093,3,14,9,7,57,32,25,51
Dungannon,1093,4,13,9,8,51,39,12,48
Coleraine,1093,5,13,9,8,43,40,3,48
Cliftonville,1093,6,12,6,12,44,43,1,42
Glentoran,1093,7,12,6,12,40,39,1,42
Glenavon,1093,8,8,9,13,45,55,-10,33
Ards,1093,9,8,5,17,34,56,-22,29
Portadown,1093,10,8,4,18,31,51,-20,28
Ballinamalla,1093,11,6,6,18,29,55,-26,24
Crusaders,1094,1,15,9,6,50,29,21,54
Linfield,1094,2,13,7,10,58,37,21,46
Dungannon,1094,3,13,7,10,51,40,11,46
Glenavon,1094,3,12,10,8,51,40,11,46
Ballymena,1094,5,13,7,10,58,58,0,46
Cliftonville,1094,6,11,6,13,47,44,3,39
Coleraine,1094,7,9,12,9,35,40,-5,39
Ards,1094,8,11,6,13,40,46,-6,39
Glentoran,1094,9,8,9,13,27,42,-15,33
Ballinamalla,1094,10,10,3,17,32,55,-23,33
Portadown,1094,11,8,8,14,25,43,-18,32
Linfield,1095,1,15,9,6,63,32,31,54
Crusaders,1095,2,14,12,4,54,32,22,54
Glenavon,1095,3,13,10,7,51,46,5,49
Ballymena,1095,4,14,6,10,56,60,-4,48
Cliftonville,1095,5,13,6,11,49,40,9,45
Coleraine,1095,6,12,9,9,38,34,4,45
Dungannon,1095,7,9,8,13,49,50,-1,35
Portadown,1095,8,8,8,14,27,43,-16,32
Ards,1095,9,8,7,15,44,55,-11,31
Glentoran,1095,10,7,8,15,33,52,-19,29
Ballinamalla,1095,11,8,5,17,31,51,-20,29
Linfield,1096,1,16,10,4,59,31,28,58
Crusaders,1096,2,17,7,6,56,31,25,58
Cliftonville,1096,3,17,5,8,55,37,18,56
Ballymena,1096,4,13,7,10,58,57,1,46
Dungannon,1096,5,12,9,9,51,43,8,45
Coleraine,1096,6,10,9,11,37,41,-4,39
Glenavon,1096,7,8,14,8,42,45,-3,38
Glentoran,1096,8,9,8,13,38,50,-12,35
Portadown,1096,9,8,5,17,32,46,-14,29
Ards,1096,10,8,5,17,36,56,-20,29
Ballinamalla,1096,11,5,5,20,26,53,-27,20
Cliftonville,1097,1,16,5,9,53,36,17,53
Linfield,1097,2,13,12,5,59,33,26,51
Ballymena,1097,3,14,6,10,59,59,0,48
Crusaders,1097,4,13,8,9,56,38,18,47
Glenavon,1097,5,13,7,10,45,43,2,46
Glentoran,1097,6,11,10,9,41,44,-3,43
Coleraine,1097,7,9,11,10,47,48,-1,38
Dungannon,1097,8,9,9,12,48,54,-6,36
Ards,1097,9,9,5,16,33,45,-12,32
Ballinamalla,1097,10,8,6,16,37,58,-21,30
Portadown,1097,11,8,5,17,25,45,-20,29
Crusaders,1098,1,17,9,4,66,38,28,60
Cliftonville,1098,2,16,6,8,54,36,18,54
Linfield,1098,3,12,11,7,55,32,23,47
Ballymena,1098,4,13,6,11,55,59,-4,45
Glenavon,1098,5,10,13,7,42,42,0,43
Coleraine,1098,6,9,15,6,35,33,2,42
Glentoran,1098,7,10,9,11,33,40,-7,39
Ards,1098,8,9,6,15,40,47,-7,33
Dungannon,1098,9,5,14,11,45,49,-4,29
Portadown,1098,10,7,6,17,23,45,-22,27
Ballinamalla,1098,11,6,7,17,28,55,-27,25
Crusaders,1099,1,17,9,4,58,40,18,60
Linfield,1099,2,14,11,5,57,34,23,53
Cliftonville,1099,3,16,5,9,58,43,15,53
Ballymena,1099,4,14,6,10,67,63,4,48
Coleraine,1099,5,10,10,10,38,41,-3,40
Dungannon,1099,6,10,9,11,46,39,7,39
Glenavon,1099,7,9,11,10,43,44,-1,38
Portadown,1099,8,10,4,16,31,46,-15,34
Ballinamalla,1099,9,10,3,17,30,48,-18,33
Ards,1099,10,8,6,16,44,55,-11,30
Glentoran,1099,11,6,8,16,26,45,-19,26
Cliftonville,1100,1,18,4,8,61,39,22,58
Crusaders,1100,2,16,9,5,56,38,18,57
Linfield,1100,3,15,9,6,60,29,31,54
Ballymena,1100,4,13,9,8,65,61,4,48
Coleraine,1100,5,9,13,8,37,35,2,40
Glenavon,1100,6,8,13,9,44,48,-4,37
Ards,1100,7,9,7,14,37,49,-12,34
Glentoran,1100,8,8,10,12,28,40,-12,34
Portadown,1100,9,9,3,18,30,52,-22,30
Dungannon,1100,10,6,11,13,41,44,-3,29
Ballinamalla,1100,11,6,8,16,25,49,-24,26
Crusaders,1101,1,19,6,5,56,29,27,63
Linfield,1101,2,15,8,7,54,30,24,53
Cliftonville,1101,3,14,8,8,52,34,18,50
Ballymena,1101,4,14,7,9,62,56,6,49
Coleraine,1101,5,11,10,9,43,41,2,43
Dungannon,1101,6,11,8,11,49,43,6,41
Glenavon,1101,7,9,12,9,54,49,5,39
Glentoran,1101,8,10,6,14,33,46,-13,36
Ards,1101,9,9,3,18,36,53,-17,30
Ballinamalla,1101,10,9,3,18,31,56,-25,30
Portadown,1101,11,6,5,19,24,57,-33,23
Cliftonville,1102,1,16,6,8,59,41,18,54
Crusaders,1102,2,15,8,7,50,31,19,53
Ballymena,1102,3,14,9,7,57,52,5,51
Coleraine,1102,4,13,11,6,43,33,10,50
Linfield,1102,5,12,10,8,53,30,23,46
Glenavon,1102,6,10,12,8,42,40,2,42
Dungannon,1102,7,9,9,12,54,47,7,36
Ards,1102,8,10,6,14,35,51,-16,36
Glentoran,1102,9,9,7,14,32,48,-16,34
Portadown,1102,10,5,9,16,20,46,-26,24
Ballinamalla,1102,11,5,7,18,18,44,-26,22
Crusaders,1103,1,17,9,4,58,31,27,60
Ballymena,1103,2,16,6,8,53,51,2,54
Glenavon,1103,3,14,8,8,49,38,11,50
Linfield,1103,4,13,10,7,58,36,22,49
Coleraine,1103,5,12,10,8,43,41,2,46
Cliftonville,1103,6,12,6,12,55,44,11,42
Dungannon,1103,7,8,11,11,49,53,-4,35
Portadown,1103,8,10,4,16,32,40,-8,34
Ards,1103,9,9,5,16,40,52,-12,32
Ballinamalla,1103,10,7,7,16,36,59,-23,28
Glentoran,1103,11,5,8,17,23,51,-28,23
Crusaders,1104,1,17,6,7,55,36,19,57
Linfield,1104,2,15,9,6,59,29,30,54
Cliftonville,1104,3,15,5,10,57,43,14,50
Glenavon,1104,4,13,9,8,52,45,7,48
Coleraine,1104,5,12,10,8,45,36,9,46
Ballymena,1104,6,12,5,13,59,67,-8,41
Ards,1104,7,11,4,15,47,53,-6,37
Dungannon,1104,8,9,9,12,54,46,8,36
Ballinamalla,1104,9,10,4,16,32,53,-21,34
Portadown,1104,10,9,5,16,29,54,-25,32
Glentoran,1104,11,6,6,18,27,54,-27,24
Linfield,1105,1,17,8,5,63,29,34,59
Cliftonville,1105,2,17,5,8,61,37,24,56
Crusaders,1105,3,15,7,8,47,29,18,52
Glenavon,1105,4,15,7,8,52,42,10,52
Coleraine,1105,5,11,9,10,42,42,0,42
Ards,1105,6,12,4,14,38,44,-6,40
Ballymena,1105,7,11,7,12,53,62,-9,40
Dungannon,1105,8,8,11,11,42,44,-2,35
Ballinamalla,1105,9,8,5,17,26,49,-23,29
Glentoran,1105,10,7,7,16,29,52,-23,28
Portadown,1105,11,6,6,18,28,51,-23,24
Crusaders,1106,1,20,4,6,59,30,29,64
Linfield,1106,2,14,9,7,64,33,31,51
Ballymena,1106,3,15,5,10,62,62,0,50
Glenavon,1106,4,10,12,8,43,44,-1,42
Coleraine,1106,5,11,9,10,44,50,-6,42
Dungannon,1106,6,9,12,9,50,41,9,39
Cliftonville,1106,7,11,6,13,48,45,3,39
Ards,1106,8,11,3,16,37,48,-11,36
Portadown,1106,9,9,6,15,26,42,-16,33
Glentoran,1106,10,8,8,14,32,52,-20,32
Ballinamalla,1106,11,8,4,18,32,50,-18,28
Crusaders,1107,1,16,6,8,55,34,21,54
Ballymena,1107,2,15,7,8,63,58,5,52
Linfield,1107,3,14,8,8,64,31,33,50
Dungannon,1107,4,14,7,9,56,42,14,49
Cliftonville,1107,5,13,5,12,50,47,3,44
Coleraine,1107,6,11,10,9,36,35,1,43
Glenavon,1107,7,10,12,8,43,41,2,42
Ards,1107,8,10,6,14,37,46,-9,36
Portadown,1107,9,10,5,15,30,45,-15,35
Glentoran,1107,10,6,9,15,28,58,-30,27
Ballinamalla,1107,11,6,5,19,29,54,-25,23
Crusaders,1108,1,18,7,5,55,30,25,61
Linfield,1108,2,16,8,6,62,33,29,56
Glenavon,1108,3,14,11,5,51,40,11,53
Coleraine,1108,4,13,9,8,45,41,4,48
Ballymena,1108,5,12,8,10,56,56,0,44
Cliftonville,1108,6,12,5,13,43,40,3,41
Ards,1108,7,12,5,13,46,46,0,41
Dungannon,1108,8,7,11,12,52,50,2,32
Portadown,1108,9,8,6,16,24,42,-18,30
Glentoran,1108,10,7,6,17,27,57,-30,27
Ballinamalla,1108,11,7,2,21,26,52,-26,23
Crusaders,1109,1,20,5,5,63,34,29,65
Cliftonville,1109,2,18,5,7,58,38,20,59
Linfield,1109,3,14,11,5,56,26,30,53
Coleraine,1109,4,12,12,6,46,33,13,48
Ballymena,1109,5,12,8,10,55,61,-6,44
Dungannon,1109,6,10,10,10,55,47,8,40
Ards,1109,7,10,6,14,42,50,-8,36
Glenavon,1109,8,8,10,12,38,48,-10,34
Glentoran,1109,9,7,6,17,32,53,-21,27
Ballinamalla,1109,10,5,11,14,27,52,-25,26
Portadown,1109,11,5,4,21,19,49,-30,19
Crusaders,1110,1,16,6,8,56,36,20,54
Linfield,1110,2,14,10,6,59,28,31,52
Ballymena,1110,3,15,4,11,57,57,0,49
Cliftonville,1110,4,13,7,10,54,46,8,46
Coleraine,1110,5,11,12,7,45,38,7,45
Glenavon,1110,6,8,14,8,42,42,0,38
Dungannon,1110,7,9,10,11,44,41,3,37
Ards,1110,8,9,8,13,41,53,-12,35
Glentoran,1110,9,8,8,14,23,40,-17,32
Portadown,1110,10,8,7,15,25,42,-17,31
Ballinamalla,1110,11,8,6,16,31,54,-23,30
Crusaders,1111,1,18,5,7,55,31,24,59
Linfield,1111,2,16,8,6,54,26,28,56
Ballymena,1111,3,16,4,10,60,50,10,52
Glenavon,1111,4,14,10,6,57,48,9,52
Cliftonville,1111,5,14,5,11,53,40,13,47
Coleraine,1111,6,11,10,9,46,44,2,43
Dungannon,1111,7,9,11,10,42,43,-1,38
Ballinamalla,1111,8,7,9,14,21,42,-21,30
Portadown,1111,9,8,5,17,27,44,-17,29
Glentoran,1111,10,6,8,16,25,48,-23,26
Ards,1111,11,6,5,19,30,54,-24,23
Cliftonville,1112,1,16,5,9,49,32,17,53
Crusaders,1112,2,15,7,8,49,33,16,52
Ballymena,1112,3,14,7,9,52,50,2,49
Glenavon,1112,4,13,9,8,48,47,1,48
Linfield,1112,5,12,11,7,51,28,23,47
Coleraine,1112,6,12,7,11,42,44,-2,43
Dungannon,1112,7,10,10,10,50,42,8,40
Ards,1112,8,10,5,15,40,49,-9,35
Portadown,1112,9,10,4,16,28,41,-13,34
Ballinamalla,1112,10,9,4,17,36,55,-19,31
Glentoran,1112,11,7,5,18,30,54,-24,26
Crusaders,1113,1,16,9,5,52,33,19,57
Cliftonville,1113,2,17,5,8,60,39,21,56
Linfield,1113,3,13,10,7,57,30,27,49
Ballymena,1113,4,14,5,11,54,58,-4,47
Glenavon,1113,5,10,9,11,40,46,-6,39
Ards,1113,6,10,8,12,37,42,-5,38
Dungannon,1113,7,8,13,9,54,44,10,37
Coleraine,1113,8,8,12,10,37,42,-5,36
Portadown,1113,9,9,5,16,21,43,-22,32
Glentoran,1113,10,7,10,13,29,41,-12,31
Ballinamalla,1113,11,5,10,15,25,48,-23,25
Crusaders,1114,1,17,7,6,64,38,26,58
Cliftonville,1114,2,15,6,9,61,46,15,51
Linfield,1114,3,12,13,5,60,37,23,49
Ballymena,1114,4,14,6,10,58,59,-1,48
Glenavon,1114,5,12,11,7,56,47,9,47
Coleraine,1114,6,9,9,12,43,49,-6,36
Ards,1114,7,10,6,14,45,52,-7,36
Dungannon,1114,8,8,10,12,45,42,3,34
Portadown,1114,9,9,5,16,29,50,-21,32
Glentoran,1114,10,8,7,15,28,51,-23,31
Ballinamalla,1114,11,8,6,16,29,47,-18,30
Crusaders,1115,1,15,9,6,57,42,15,54
Cliftonville,1115,2,16,5,9,50,33,17,53
Ballymena,1115,3,16,3,11,57,58,-1,51
Linfield,1115,4,12,12,6,54,35,19,48
Glentoran,1115,5,13,7,10,34,35,-1,46
Glenavon,1115,6,12,9,9,53,49,4,45
Coleraine,1115,7,10,9,11,39,39,0,39
Dungannon,1115,8,10,7,13,56,47,9,37
Ards,1115,9,9,4,17,37,50,-13,31
Ballinamalla,1115,10,7,6,17,28,51,-23,27
Portadown,1115,11,6,7,17,21,47,-26,25
Crusaders,1116,1,20,6,4,63,32,31,66
Linfield,1116,2,16,8,6,65,36,29,56
Ballymena,1116,3,15,6,9,57,50,7,51
Cliftonville,1116,4,14,6,10,54,46,8,48
Glenavon,1116,5,11,10,9,49,48,1,43
Coleraine,1116,6,9,15,6,39,33,6,42
Dungannon,1116,7,9,8,13,45,45,0,35
Glentoran,1116,8,9,6,15,32,49,-17,33
Ballinamalla,1116,9,7,7,16,33,53,-20,28
Ards,1116,10,6,7,17,35,56,-21,25
Portadown,1116,11,6,7,17,29,53,-24,25
Crusaders,1117,1,15,8,7,52,37,15,53
Linfield,1117,2,14,9,7,53,21,32,51
Coleraine,1117,3,13,11,6,46,37,9,50
Cliftonville,1117,4,14,6,10,52,46,6,48
Ballymena,1117,5,12,8,10,58,57,1,44
Glenavon,1117,6,8,14,8,43,51,-8,38
Ballinamalla,1117,7,11,4,15,33,44,-11,37
Dungannon,1117,8,7,12,11,46,48,-2,33
Ards,1117,9,9,6,15,43,53,-10,33
Glentoran,1117,10,7,10,13,31,42,-11,31
Portadown,1117,11,8,6,16,27,48,-21,30
Crusaders,1118,1,18,6,6,55,32,23,60
Linfield,1118,2,15,11,4,56,26,30,56
Ballymena,1118,3,15,6,9,68,53,15,51
Coleraine,1118,4,14,9,7,50,40,10,51
Cliftonville,1118,5,15,5,10,53,42,11,50
Glenavon,1118,6,13,8,9,50,47,3,47
Dungannon,1118,7,8,11,11,46,53,-7,35
Ards,1118,8,8,4,18,43,53,-10,28
Ballinamalla,1118,9,8,4,18,26,53,-27,28
Portadown,1118,10,7,5,18,26,51,-25,26
Glentoran,1118,11,6,7,17,25,48,-23,25
Linfield,1119,1,15,10,5,62,30,32,55
Crusaders,1119,2,15,9,6,51,37,14,54
Cliftonville,1119,3,16,4,10,53,36,17,52
Ballymena,1119,4,15,5,10,62,57,5,50
Glenavon,1119,5,12,10,8,55,49,6,46
Dungannon,1119,6,11,9,10,56,46,10,42
Coleraine,1119,7,10,10,10,44,40,4,40
Glentoran,1119,8,9,8,13,27,39,-12,35
Ards,1119,9,8,5,17,33,55,-22,29
Ballinamalla,1119,10,7,7,16,25,50,-25,28
Portadown,1119,11,5,7,18,22,51,-29,22
Crusaders,1120,1,16,9,5,55,28,27,57
Cliftonville,1120,2,15,7,8,56,38,18,52
Ballymena,1120,3,14,8,8,56,49,7,50
Linfield,1120,4,12,11,7,51,32,19,47
Glenavon,1120,5,10,11,9,47,48,-1,41
Coleraine,1120,6,9,12,9,38,38,0,39
Glentoran,1120,7,9,9,12,35,45,-10,36
Portadown,1120,8,10,5,15,26,47,-21,35
Ards,1120,9,9,7,14,37,48,-11,34
Dungannon,1120,10,8,9,13,48,46,2,33
Ballinamalla,1120,11,6,6,18,25,55,-30,24
Ballymena,1121,1,16,5,9,54,51,3,53
Linfield,1121,2,14,10,6,51,30,21,52
Crusaders,1121,3,15,7,8,50,36,14,52
Cliftonville,1121,4,14,6,10,56,40,16,48
Coleraine,1121,5,11,10,9,39,38,1,43
Glentoran,1121,6,11,7,12,30,41,-11,40
Dungannon,1121,7,8,11,11,43,40,3,35
Glenavon,1121,8,7,14,9,44,49,-5,35
Ards,1121,9,10,5,15,41,51,-10,35
Portadown,1121,10,7,11,12,28,35,-7,32
Ballinamalla,1121,11,6,6,18,27,52,-25,24
Crusaders,1122,1,18,8,4,57,32,25,62
Cliftonville,1122,2,16,4,10,59,41,18,52
Ballymena,1122,3,14,8,8,58,52,6,50
Linfield,1122,4,13,10,7,53,34,19,49
Dungannon,1122,5,11,9,10,54,41,13,42
Glenavon,1122,6,10,10,10,40,46,-6,40
Coleraine,1122,7,9,10,11,36,35,1,37
Ards,1122,8,10,6,14,39,49,-10,36
Glentoran,1122,9,8,10,12,32,48,-16,34
Ballinamalla,1122,10,8,3,19,29,56,-27,27
Portadown,1122,11,6,6,18,25,48,-23,24
Linfield,1123,1,16,10,4,58,26,32,58
Crusaders,1123,2,18,4,8,56,40,16,58
Ballymena,1123,3,14,7,9,65,60,5,49
Dungannon,1123,4,12,9,9,60,48,12,45
Glenavon,1123,5,12,9,9,50,43,7,45
Cliftonville,1123,6,13,4,13,44,42,2,43
Coleraine,1123,7,11,9,10,36,40,-4,42
Glentoran,1123,8,10,6,14,28,44,-16,36
Ards,1123,9,9,5,16,33,45,-12,32
Portadown,1123,10,8,3,19,27,47,-20,27
Ballinamalla,1123,11,7,4,19,30,52,-22,25
Linfield,1124,1,16,7,7,57,33,24,55
Glenavon,1124,2,13,12,5,58,44,14,51
Crusaders,1124,3,14,8,8,55,41,14,50
Cliftonville,1124,4,15,5,10,53,39,14,50
Ballymena,1124,5,12,8,10,57,59,-2,44
Dungannon,1124,6,12,7,11,50,44,6,43
Coleraine,1124,7,11,9,10,52,48,4,42
Glentoran,1124,8,10,8,12,38,42,-4,38
Ards,1124,9,7,9,14,43,64,-21,30
Portadown,1124,10,7,6,17,25,48,-23,27
Ballinamalla,1124,11,7,3,20,32,58,-26,24
Linfield,1125,1,16,9,5,68,26,42,57
Cliftonville,1125,2,16,6,8,62,43,19,54
Crusaders,1125,3,15,8,7,50,32,18,53
Ballymena,1125,4,16,4,10,60,55,5,52
Coleraine,1125,5,13,10,7,40,33,7,49
Portadown,1125,6,11,8,11,34,40,-6,41
Glenavon,1125,7,10,10,10,45,44,1,40
Ards,1125,8,8,6,16,34,51,-17,30
Dungannon,1125,9,6,10,14,48,50,-2,28
Glentoran,1125,10,6,8,16,24,54,-30,26
Ballinamalla,1125,11,6,5,19,26,63,-37,23
Cliftonville,1126,1,18,5,7,53,32,21,59
Coleraine,1126,2,13,12,5,46,34,12,51
Crusaders,1126,3,14,8,8,51,36,15,50
Linfield,1126,4,13,8,9,51,31,20,47
Glenavon,1126,5,11,10,9,45,46,-1,43
Ballymena,1126,6,12,7,11,57,61,-4,43
Dungannon,1126,7,10,9,11,45,42,3,39
Glentoran,1126,8,10,8,12,33,44,-11,38
Ards,1126,9,10,6,14,42,50,-8,36
Ballinamalla,1126,10,8,3,19,28,50,-22,27
Portadown,1126,11,5,6,19,22,47,-25,21
Linfield,1127,1,18,8,4,60,25,35,62
Cliftonville,1127,2,17,5,8,54,36,18,56
Crusaders,1127,3,15,9,6,52,34,18,54
Glenavon,1127,4,14,8,8,54,46,8,50
Ballymena,1127,5,14,7,9,59,62,-3,49
Coleraine,1127,6,12,10,8,49,42,7,46
Dungannon,1127,7,11,7,12,52,48,4,40
Glentoran,1127,8,8,8,14,28,43,-15,32
Ards,1127,9,8,3,19,32,52,-20,27
Portadown,1127,10,6,5,19,24,46,-22,23
Ballinamalla,1127,11,5,4,21,29,59,-30,19
Cliftonville,1128,1,16,5,9,64,40,24,53
Crusaders,1128,2,14,9,7,57,39,18,51
Linfield,1128,3,14,8,8,64,42,22,50
Ballymena,1128,4,14,8,8,63,57,6,50
Dungannon,1128,5,13,7,10,55,42,13,46
Glenavon,1128,6,11,12,7,40,41,-1,45
Coleraine,1128,7,11,9,10,43,48,-5,42
Ballinamalla,1128,8,9,6,15,41,52,-11,33
Ards,1128,9,8,7,15,37,55,-18,31
Glentoran,1128,10,8,5,17,21,45,-24,29
Portadown,1128,11,6,6,18,25,49,-24,24
Cliftonville,1129,1,17,6,7,65,42,23,57
Crusaders,1129,2,16,7,7,54,40,14,55
Ballymena,1129,3,15,7,8,73,59,14,52
Linfield,1129,4,13,8,9,52,40,12,47
Coleraine,1129,5,11,12,7,46,35,11,45
Glenavon,1129,6,9,12,9,52,51,1,39
Dungannon,1129,7,9,10,11,52,49,3,37
Ards,1129,8,9,8,13,39,49,-10,35
Glentoran,1129,9,8,6,16,29,49,-20,30
Ballinamalla,1129,10,8,5,17,30,53,-23,29
Portadown,1129,11,6,7,17,23,48,-25,25
Cliftonville,1130,1,16,6,8,54,37,17,54
Glenavon,1130,2,15,9,6,52,36,16,54
Crusaders,1130,3,15,9,6,53,38,15,54
Linfield,1130,4,11,13,6,50,29,21,46
Ballymena,1130,5,11,10,9,55,58,-3,43
Dungannon,1130,6,11,9,10,49,41,8,42
Coleraine,1130,7,9,11,10,42,43,-1,38
Ards,1130,8,9,8,13,36,43,-7,35
Glentoran,1130,9,7,13,10,27,40,-13,34
Ballinamalla,1130,10,5,9,16,27,52,-25,24
Portadown,1130,11,4,7,19,19,47,-28,19
Crusaders,1131,1,15,11,4,62,37,25,56
Cliftonville,1131,2,16,6,8,57,42,15,54
Linfield,1131,3,15,6,9,59,33,26,51
Ballymena,1131,4,15,5,10,57,55,2,50
Glenavon,1131,5,11,13,6,42,42,0,46
Dungannon,1131,6,11,9,10,52,47,5,42
Ballinamalla,1131,7,12,3,15,37,46,-9,39
Glentoran,1131,8,9,7,14,39,49,-10,34
Coleraine,1131,9,7,12,11,40,47,-7,33
Ards,1131,10,8,6,16,41,52,-11,30
Portadown,1131,11,5,4,21,18,54,-36,19
Cliftonville,1132,1,19,4,7,57,36,21,61
Crusaders,1132,2,17,5,8,51,35,16,56
Coleraine,1132,3,14,11,5,49,33,16,53
Linfield,1132,4,14,10,6,60,38,22,52
Glenavon,1132,5,10,12,8,49,44,5,42
Ballymena,1132,6,11,8,11,58,63,-5,41
Ards,1132,7,10,5,15,48,50,-2,35
Dungannon,1132,8,9,8,13,43,48,-5,35
Glentoran,1132,9,8,7,15,27,44,-17,31
Portadown,1132,10,8,4,18,31,54,-23,28
Ballinamalla,1132,11,6,4,20,35,63,-28,22
Crusaders,1133,1,18,6,6,57,33,24,60
Cliftonville,1133,2,17,5,8,61,34,27,56
Glenavon,1133,3,15,8,7,55,42,13,53
Ballymena,1133,4,15,6,9,68,57,11,51
Linfield,1133,5,13,11,6,58,30,28,50
Coleraine,1133,6,9,12,9,38,39,-1,39
Dungannon,1133,7,8,10,12,46,53,-7,34
Glentoran,1133,8,9,6,15,31,51,-20,33
Portadown,1133,9,9,4,17,25,54,-29,31
Ards,1133,10,6,7,17,34,51,-17,25
Ballinamalla,1133,11,6,5,19,31,60,-29,23
Crusaders,1134,1,16,8,6,60,38,22,56
Glenavon,1134,2,15,9,6,57,46,11,54
Linfield,1134,3,12,10,8,54,36,18,46
Ballymena,1134,4,13,7,10,54,59,-5,46
Dungannon,1134,5,12,9,9,58,42,16,45
Cliftonville,1134,6,13,6,11,50,42,8,45
Coleraine,1134,7,11,11,8,45,35,10,44
Ards,1134,8,11,5,14,43,47,-4,38
Portadown,1134,9,8,5,17,29,48,-19,29
Glentoran,1134,10,8,5,17,26,53,-27,29
Ballinamalla,1134,11,8,1,21,30,60,-30,25
Crusaders,1135,1,17,8,5,58,40,18,59
Ballymena,1135,2,14,7,9,64,60,4,49
Cliftonville,1135,3,15,3,12,53,43,10,48
Linfield,1135,4,12,11,7,56,30,26,47
Coleraine,1135,5,11,11,8,44,42,2,44
Glenavon,1135,6,10,12,8,42,47,-5,42
Dungannon,1135,7,9,10,11,49,41,8,37
Ballinamalla,1135,8,10,7,13,35,46,-11,37
Ards,1135,9,8,9,13,34,43,-9,33
Portadown,1135,10,7,7,16,30,42,-12,28
Glentoran,1135,11,7,5,18,27,58,-31,26
Crusaders,1136,1,17,8,5,55,27,28,59
Linfield,1136,2,14,9,7,53,30,23,51
Coleraine,1136,3,13,11,6,51,32,19,50
Glenavon,1136,4,12,14,4,51,37,14,50
Dungannon,1136,5,13,8,9,51,40,11,47
Ballymena,1136,6,13,7,10,57,59,-2,46
Cliftonville,1136,7,12,4,14,50,53,-3,40
Glentoran,1136,8,6,11,13,33,56,-23,29
Portadown,1136,9,7,6,17,27,53,-26,27
Ballinamalla,1136,10,6,7,17,33,52,-19,25
Ards,1136,11,5,9,16,28,50,-22,24
Linfield,1137,1,15,9,6,54,29,25,54
Cliftonville,1137,2,16,6,8,56,39,17,54
Crusaders,1137,3,15,7,8,61,50,11,52
Ballymena,1137,4,14,7,9,59,55,4,49
Coleraine,1137,5,10,11,9,42,35,7,41
Glenavon,1137,6,9,12,9,46,50,-4,39
Ards,1137,7,12,3,15,42,48,-6,39
Dungannon,1137,8,9,9,12,50,43,7,36
Ballinamalla,1137,9,10,2,18,29,50,-21,32
Portadown,1137,10,8,7,15,23,43,-20,31
Glentoran,1137,11,7,7,16,28,48,-20,28
Ballymena,1138,1,17,6,7,59,52,7,57
Crusaders,1138,2,16,7,7,52,25,27,55
Cliftonville,1138,3,15,8,7,51,32,19,53
Linfield,1138,4,14,9,7,56,27,29,51
Glenavon,1138,5,13,10,7,45,39,6,49
Coleraine,1138,6,9,11,10,34,43,-9,38
Dungannon,1138,7,10,7,13,45,44,1,37
Ballinamalla,1138,8,9,4,17,27,46,-19,31
Ards,1138,9,7,7,16,33,51,-18,28
Glentoran,1138,10,5,12,13,23,42,-19,27
Portadown,1138,11,6,7,17,25,49,-24,25
Linfield,1139,1,16,8,6,66,31,35,56
Crusaders,1139,2,16,8,6,58,33,25,56
Coleraine,1139,3,15,9,6,48,33,15,54
Glenavon,1139,4,11,12,7,43,39,4,45
Ballymena,1139,5,13,6,11,56,59,-3,45
Dungannon,1139,6,11,11,8,53,43,10,44
Cliftonville,1139,7,10,9,11,40,39,1,39
Glentoran,1139,8,9,6,15,26,41,-15,33
Ards,1139,9,8,4,18,34,57,-23,28
Ballinamalla,1139,10,7,6,17,33,53,-20,27
Portadown,1139,11,7,5,18,22,51,-29,26
Cliftonville,1140,1,16,5,9,55,44,11,53
Crusaders,1140,2,15,7,8,60,41,19,52
Linfield,1140,3,13,9,8,65,40,25,48
Ballymena,1140,4,13,8,9,62,62,0,47
Glentoran,1140,5,12,8,10,39,42,-3,44
Glenavon,1140,6,11,10,9,49,54,-5,43
Coleraine,1140,7,9,14,7,36,33,3,41
Dungannon,1140,8,11,7,12,48,48,0,40
Ards,1140,9,7,8,15,39,53,-14,29
Portadown,1140,10,7,8,15,25,42,-17,29
Ballinamalla,1140,11,6,6,18,35,54,-19,24
Crusaders,1141,1,17,9,4,62,37,25,60
Cliftonville,1141,2,17,3,10,57,39,18,54
Linfield,1141,3,14,8,8,55,30,25,50
Ballymena,1141,4,14,6,10,54,58,-4,48
Glenavon,1141,5,11,13,6,46,43,3,46
Dungannon,1141,6,12,9,9,49,38,11,45
Coleraine,1141,7,10,12,8,43,36,7,42
Ards,1141,8,9,6,15,35,49,-14,33
Glentoran,1141,9,7,7,16,26,43,-17,28
Portadown,1141,10,7,6,17,26,51,-25,27
Ballinamalla,1141,11,6,3,21,28,57,-29,21
Linfield,1142,1,16,9,5,61,28,33,57
Crusaders,1142,2,16,7,7,57,41,16,55
Cliftonville,1142,3,15,4,11,55,42,13,49
Coleraine,1142,4,13,10,7,47,34,13,49
Ballymena,1142,5,12,6,12,51,67,-16,42
Glenavon,1142,6,10,10,10,57,54,3,40
Dungannon,1142,7,10,7,13,46,49,-3,37
Ards,1142,8,10,5,15,40,51,-11,35
Glentoran,1142,9,9,7,14,31,43,-12,34
Ballinamalla,1142,10,10,4,16,34,49,-15,34
Portadown,1142,11,6,7,17,22,43,-21,25
Linfield,1143,1,17,9,4,64,32,32,60
Cliftonville,1143,2,16,8,6,54,34,20,56
Ballymena,1143,3,15,7,8,66,57,9,52
Crusaders,1143,4,15,6,9,58,43,15,51
Glenavon,1143,5,10,10,10,46,48,-2,40
Coleraine,1143,6,9,12,9,37,39,-2,39
Dungannon,1143,7,10,7,13,49,49,0,37
Ards,1143,8,9,6,15,37,42,-5,33
Portadown,1143,9,8,7,15,34,46,-12,31
Glentoran,1143,10,6,9,15,23,50,-27,27
Ballinamalla,1143,11,6,7,17,29,57,-28,25
Linfield,1144,1,19,6,5,61,22,39,63
Crusaders,1144,2,17,5,8,59,42,17,56
Ballymena,1144,3,14,6,10,59,53,6,48
Glenavon,1144,4,13,8,9,41,39,2,47
Coleraine,1144,5,11,11,8,44,37,7,44
Cliftonville,1144,6,12,7,11,50,43,7,43
Dungannon,1144,7,11,6,13,50,47,3,39
Ballinamalla,1144,8,10,3,17,32,53,-21,33
Glentoran,1144,9,9,6,15,29,53,-24,33
Ards,1144,10,9,3,18,41,54,-13,30
Portadown,1144,11,8,3,19,25,48,-23,27
Crusaders,1145,1,16,11,3,54,27,27,59
Ballymena,1145,2,16,5,9,59,52,7,53
Linfield,1145,3,13,10,7,50,32,18,49
Cliftonville,1145,4,15,3,12,51,39,12,48
Coleraine,1145,5,12,10,8,40,32,8,46
Dungannon,1145,6,12,7,11,50,43,7,43
Glenavon,1145,7,7,14,9,40,43,-3,35
Ards,1145,8,10,5,15,37,48,-11,35
Glentoran,1145,9,9,8,13,31,44,-13,35
Portadown,1145,10,9,4,17,23,46,-23,31
Ballinamalla,1145,11,4,7,19,22,51,-29,19
Crusaders,1146,1,16,8,6,61,37,24,56
Cliftonville,1146,2,17,3,10,58,39,19,54
Linfield,1146,3,14,9,7,57,31,26,51
Ballymena,1146,4,12,8,10,53,61,-8,44
Dungannon,1146,5,11,9,10,54,47,7,42
Glenavon,1146,6,10,12,8,44,43,1,42
Coleraine,1146,7,10,11,9,43,45,-2,41
Ballinamalla,1146,8,10,4,16,36,53,-17,34
Glentoran,1146,9,9,6,15,33,49,-16,33
Ards,1146,10,9,5,16,37,48,-11,32
Portadown,1146,11,7,5,18,23,46,-23,26
Crusaders,1147,1,17,5,8,57,38,19,56
Ballymena,1147,2,15,8,7,61,53,8,53
Cliftonville,1147,3,14,6,10,56,44,12,48
Linfield,1147,4,11,14,5,60,35,25,47
Glenavon,1147,5,11,13,6,46,41,5,46
Coleraine,1147,6,10,15,5,39,31,8,45
Dungannon,1147,7,12,8,10,51,38,13,44
Glentoran,1147,8,10,6,14,29,44,-15,36
Portadown,1147,9,7,7,16,22,48,-26,28
Ards,1147,10,6,7,17,34,54,-20,25
Ballinamalla,1147,11,5,5,20,25,54,-29,20
Cliftonville,1148,1,18,5,7,64,40,24,59
Crusaders,1148,2,17,5,8,55,37,18,56
Linfield,1148,3,15,8,7,61,33,28,53
Coleraine,1148,4,13,9,8,45,38,7,48
Ballymena,1148,5,14,6,10,60,57,3,48
Glenavon,1148,6,9,13,8,48,50,-2,40
Ards,1148,7,11,5,14,45,45,0,38
Dungannon,1148,8,9,9,12,50,56,-6,36
Glentoran,1148,9,10,5,15,29,44,-15,35
Ballinamalla,1148,10,8,4,18,33,58,-25,28
Portadown,1148,11,3,7,20,17,49,-32,16
Crusaders,1149,1,18,8,4,60,27,33,62
Linfield,1149,2,15,9,6,61,28,33,54
Ballymena,1149,3,15,7,8,60,55,5,52
Coleraine,1149,4,11,11,8,52,45,7,44
Glenavon,1149,5,11,10,9,49,48,1,43
Dungannon,1149,6,9,12,9,49,50,-1,39
Cliftonville,1149,7,11,3,16,45,51,-6,36
Glentoran,1149,8,10,6,14,31,44,-13,36
Portadown,1149,9,10,3,17,27,50,-23,33
Ballinamalla,1149,10,8,5,17,31,50,-19,29
Ards,1149,11,7,6,17,35,52,-17,27
Crusaders,1150,1,17,8,5,54,28,26,59
Cliftonville,1150,2,17,5,8,58,39,19,56
Ballymena,1150,3,14,6,10,55,51,4,48
Linfield,1150,4,12,10,8,58,39,19,46
Glenavon,1150,5,11,12,7,46,44,2,45
Dungannon,1150,6,12,8,10,50,40,10,44
Coleraine,1150,7,10,9,11,40,46,-6,39
Ards,1150,8,9,5,16,33,44,-11,32
Ballinamalla,1150,9,9,5,16,30,52,-22,32
Portadown,1150,10,8,3,19,28,50,-22,27
Glentoran,1150,11,5,11,14,27,46,-19,26
Linfield,1151,1,15,9,6,65,34,31,54
Ballymena,1151,2,15,8,7,60,55,5,53
Crusaders,1151,3,15,7,8,56,41,15,52
Cliftonville,1151,4,15,5,10,54,39,15,50
Glenavon,1151,5,13,11,6,53,39,14,50
Coleraine,1151,6,10,10,10,33,37,-4,40
Dungannon,1151,7,9,10,11,44,47,-3,37
Portadown,1151,8,10,6,14,27,41,-14,36
Ards,1151,9,11,2,17,36,46,-10,35
Glentoran,1151,10,6,7,17,23,46,-23,25
Ballinamalla,1151,11,6,5,19,29,55,-26,23
Crusaders,1152,1,16,6,8,53,44,9,54
Linfield,1152,2,13,10,7,56,31,25,49
Coleraine,1152,3,13,10,7,46,30,16,49
Cliftonville,1152,4,15,4,11,53,42,11,49
Ballymena,1152,5,13,8,9,56,56,0,47
Dungannon,1152,6,10,10,10,57,46,11,40
Glenavon,1152,7,9,13,8,42,44,-2,40
Glentoran,1152,8,11,7,12,38,50,-12,40
Ballinamalla,1152,9,8,6,16,31,52,-21,30
Ards,1152,10,7,8,15,32,50,-18,29
Portadown,1152,11,7,4,19,25,44,-19,25
Linfield,1153,1,15,7,8,56,34,22,52
Crusaders,1153,2,14,10,6,52,30,22,52
Ballymena,1153,3,15,7,8,63,56,7,52
Glenavon,1153,4,13,10,7,51,40,11,49
Cliftonville,1153,5,14,5,11,49,42,7,47
Dungannon,1153,6,11,10,9,53,43,10,43
Coleraine,1153,7,9,11,10,34,39,-5,38
Glentoran,1153,8,9,10,11,30,39,-9,37
Ards,1153,9,9,7,14,42,52,-10,34
Portadown,1153,10,7,6,17,22,47,-25,27
Ballinamalla,1153,11,6,3,21,24,54,-30,21
Crusaders,1154,1,17,8,5,57,33,24,59
Linfield,1154,2,16,8,6,61,31,30,56
Ballymena,1154,3,14,6,10,58,54,4,48
Cliftonville,1154,4,13,6,11,47,40,7,45
Coleraine,1154,5,11,11,8,42,38,4,44
Glenavon,1154,6,10,9,11,51,54,-3,39
Dungannon,1154,7,9,10,11,51,49,2,37
Portadown,1154,8,10,5,15,28,45,-17,35
Glentoran,1154,9,8,10,12,32,45,-13,34
Ards,1154,10,9,3,18,36,54,-18,30
Ballinamalla,1154,11,8,4,18,32,52,-20,28
Crusaders,1155,1,22,5,3,72,28,44,71
Linfield,1155,2,17,7,6,64,27,37,58
Cliftonville,1155,3,14,4,12,50,42,8,46
Coleraine,1155,4,12,10,8,39,38,1,46
Glenavon,1155,5,11,12,7,43,40,3,45
Glentoran,1155,6,12,6,12,34,43,-9,42
Ballymena,1155,7,12,5,13,58,63,-5,41
Dungannon,1155,8,9,12,9,42,40,2,39
Ballinamalla,1155,9,9,3,18,26,49,-23,30
Ards,1155,10,6,5,19,33,53,-20,23
Portadown,1155,11,5,3,22,23,61,-38,18
Crusaders,1156,1,20,5,5,62,30,32,65
Linfield,1156,2,14,8,8,62,38,24,50
Cliftonville,1156,3,12,9,9,50,42,8,45
Coleraine,1156,4,11,12,7,43,40,3,45
Glenavon,1156,5,11,11,8,49,45,4,44
Ballymena,1156,6,10,10,10,55,61,-6,40
Dungannon,1156,7,10,9,11,46,42,4,39
Glentoran,1156,8,10,6,14,30,45,-15,36
Ards,1156,9,9,7,14,36,44,-8,34
Ballinamalla,1156,10,7,6,17,29,53,-24,27
Portadown,1156,11,6,7,17,21,43,-22,25
Cliftonville,1157,1,18,5,7,56,35,21,59
Crusaders,1157,2,16,8,6,51,27,24,56
Ballymena,1157,3,15,7,8,62,57,5,52
Coleraine,1157,4,11,12,7,39,37,2,45
Linfield,1157,5,12,8,10,50,34,16,44
Glenavon,1157,6,11,9,10,46,45,1,42
Ards,1157,7,11,5,14,38,44,-6,38
Dungannon,1157,8,9,10,11,46,46,0,37
Portadown,1157,9,9,4,17,27,44,-17,31
Ballinamalla,1157,10,6,8,16,21,45,-24,26
Glentoran,1157,11,6,6,18,24,46,-22,24
Crusaders,1158,1,17,7,6,51,28,23,58
Coleraine,1158,2,13,10,7,50,33,17,49
Linfield,1158,3,12,11,7,53,32,21,47
Cliftonville,1158,4,13,6,11,54,46,8,45
Ballymena,1158,5,13,5,12,53,61,-8,44
Dungannon,1158,6,11,10,9,56,46,10,43
Glenavon,1158,7,11,10,9,47,46,1,43
Ards,1158,8,11,2,17,39,54,-15,35
Glentoran,1158,9,8,8,14,33,49,-16,32
Portadown,1158,10,8,6,16,26,42,-16,30
Ballinamalla,1158,11,8,5,17,29,54,-25,29
Linfield,1159,1,15,11,4,62,29,33,56
Crusaders,1159,2,15,8,7,51,37,14,53
Cliftonville,1159,3,15,6,9,61,46,15,51
Coleraine,1159,4,13,10,7,46,35,11,49
Glenavon,1159,5,9,16,5,47,41,6,43
Ballymena,1159,6,10,11,9,47,60,-13,41
Dungannon,1159,7,8,11,11,48,47,1,35
Glentoran,1159,8,8,7,15,26,40,-14,31
Portadown,1159,9,8,7,15,33,48,-15,31
Ballinamalla,1159,10,8,7,15,32,49,-17,31
Ards,1159,11,7,4,19,34,55,-21,25
Cliftonville,1160,1,19,3,8,67,41,26,60
Crusaders,1160,2,16,9,5,65,45,20,57
Linfield,1160,3,12,12,6,54,26,28,48
Coleraine,1160,4,12,8,10,47,42,5,44
Glenavon,1160,5,10,10,10,50,52,-2,40
Ballymena,1160,6,11,7,12,48,59,-11,40
Ballinamalla,1160,7,11,3,16,38,49,-11,36
Glentoran,1160,8,7,12,11,31,42,-11,33
Ards,1160,9,9,6,15,39,58,-19,33
Dungannon,1160,10,8,8,14,45,51,-6,32
Portadown,1160,11,8,6,16,26,45,-19,30
Crusaders,1161,1,19,6,5,54,29,25,63
Linfield,1161,2,15,6,9,59,43,16,51
Cliftonville,1161,3,14,7,9,55,40,15,49
Glenavon,1161,4,11,13,6,45,40,5,46
Glentoran,1161,5,11,8,11,40,43,-3,41
Coleraine,1161,6,8,16,6,38,35,3,40
Dungannon,1161,7,10,8,12,51,46,5,38
Ballymena,1161,8,11,5,14,47,59,-12,38
Portadown,1161,9,8,7,15,29,40,-11,31
Ards,1161,10,8,5,17,35,53,-18,29
Ballinamalla,1161,11,8,3,19,31,56,-25,27
Linfield,1162,1,16,7,7,67,34,33,55
Cliftonville,1162,2,16,6,8,65,46,19,54
Crusaders,1162,3,16,6,8,55,41,14,54
Coleraine,1162,4,13,10,7,46,40,6,49
Glentoran,1162,5,11,8,11,34,46,-12,41
Glenavon,1162,6,9,11,10,48,45,3,38
Ballymena,1162,7,10,6,14,54,64,-10,36
Dungannon,1162,8,8,11,11,48,45,3,35
Ballinamalla,1162,9,10,4,16,37,55,-18,34
Ards,1162,10,8,6,16,38,51,-13,30
Portadown,1162,11,7,7,16,22,47,-25,28
Crusaders,1163,1,18,7,5,61,33,28,61
Cliftonville,1163,2,16,4,10,47,39,8,52
Coleraine,1163,3,13,10,7,47,35,12,49
Ballymena,1163,4,14,6,10,57,50,7,48
Linfield,1163,5,12,7,11,49,42,7,43
Dungannon,1163,6,11,8,11,48,44,4,41
Glenavon,1163,7,9,12,9,40,45,-5,39
Glentoran,1163,8,7,11,12,37,48,-11,32
Ards,1163,9,8,7,15,44,51,-7,31
Ballinamalla,1163,10,8,7,15,27,48,-21,31
Portadown,1163,11,7,5,18,24,46,-22,26
Linfield,1164,1,16,8,6,55,30,25,56
Crusaders,1164,2,14,9,7,49,36,13,51
Ballymena,1164,3,13,10,7,53,50,3,49
Cliftonville,1164,4,14,5,11,55,45,10,47
Glenavon,1164,5,11,12,7,50,47,3,45
Coleraine,1164,6,11,10,9,43,36,7,43
Dungannon,1164,7,9,12,9,52,40,12,39
Ards,1164,8,10,5,15,38,46,-8,35
Glentoran,1164,9,9,6,15,33,47,-14,33
Portadown,1164,10,6,9,15,26,48,-22,27
Ballinamalla,1164,11,6,6,18,22,51,-29,24
Crusaders,1165,1,17,6,7,61,42,19,57
Cliftonville,1165,2,17,3,10,54,37,17,54
Linfield,1165,3,13,10,7,65,39,26,49
Ballymena,1165,4,15,4,11,60,57,3,49
Glenavon,1165,5,12,10,8,59,51,8,46
Dungannon,1165,6,11,8,11,50,48,2,41
Glentoran,1165,7,9,11,10,35,39,-4,38
Ballinamalla,1165,8,10,5,15,35,48,-13,35
Coleraine,1165,9,7,10,13,33,47,-14,31
Ards,1165,10,7,7,16,36,57,-21,28
Portadown,1165,11,6,8,16,30,53,-23,26
Crusaders,1166,1,16,9,5,47,27,20,57
Linfield,1166,2,15,10,5,60,33,27,55
Cliftonville,1166,3,15,7,8,50,37,13,52
Ballymena,1166,4,12,9,9,55,56,-1,45
Glenavon,1166,5,11,11,8,54,42,12,44
Coleraine,1166,6,10,10,10,43,39,4,40
Dungannon,1166,7,10,9,11,54,50,4,39
Ards,1166,8,8,8,14,39,53,-14,32
Portadown,1166,9,8,7,15,35,52,-17,31
Ballinamalla,1166,10,7,6,17,35,58,-23,27
Glentoran,1166,11,5,10,15,25,50,-25,25
Linfield,1167,1,17,7,6,70,30,40,58
Crusaders,1167,2,17,6,7,53,35,18,57
Cliftonville,1167,3,16,5,9,57,42,15,53
Ballymena,1167,4,14,7,9,57,57,0,49
Coleraine,1167,5,10,13,7,42,44,-2,43
Glenavon,1167,6,11,9,10,43,45,-2,42
Dungannon,1167,7,10,10,10,53,41,12,40
Glentoran,1167,8,9,9,12,33,43,-10,36
Ballinamalla,1167,9,8,5,17,27,48,-21,29
Portadown,1167,10,7,5,18,19,44,-25,26
Ards,1167,11,5,6,19,29,54,-25,21
Linfield,1168,1,16,10,4,65,27,38,58
Cliftonville,1168,2,17,5,8,54,38,16,56
Crusaders,1168,3,13,7,10,52,36,16,46
Coleraine,1168,4,10,12,8,41,37,4,42
Ballymena,1168,5,11,9,10,55,57,-2,42
Dungannon,1168,6,10,9,11,47,45,2,39
Ballinamalla,1168,7,10,7,13,34,48,-14,37
Ards,1168,8,8,10,12,36,45,-9,34
Glenavon,1168,9,8,10,12,40,56,-16,34
Portadown,1168,10,9,5,16,24,41,-17,32
Glentoran,1168,11,6,10,14,24,42,-18,28
Linfield,1169,1,17,7,6,63,28,35,58
Ballymena,1169,2,17,5,8,65,61,4,56
Glenavon,1169,3,15,7,8,52,44,8,52
Crusaders,1169,4,14,7,9,52,40,12,49
Cliftonville,1169,5,13,4,13,58,48,10,43
Dungannon,1169,6,11,7,12,48,41,7,40
Coleraine,1169,7,10,10,10,40,40,0,40
Ards,1169,8,9,5,16,32,48,-16,32
Portadown,1169,9,9,5,16,25,43,-18,32
Glentoran,1169,10,7,8,15,32,50,-18,29
Ballinamalla,1169,11,8,5,17,30,54,-24,29
Crusaders,1170,1,19,5,6,63,31,32,62
Linfield,1170,2,14,9,7,59,37,22,51
Cliftonville,1170,3,15,6,9,53,39,14,51
Ballymena,1170,4,14,7,9,53,53,0,49
Dungannon,1170,5,13,9,8,55,42,13,48
Coleraine,1170,6,10,9,11,36,38,-2,39
Glentoran,1170,7,10,5,15,34,50,-16,35
Glenavon,1170,8,7,13,10,38,46,-8,34
Ballinamalla,1170,9,9,6,15,30,47,-17,33
Ards,1170,10,7,7,16,34,50,-16,28
Portadown,1170,11,6,6,18,23,45,-22,24
Crusaders,1171,1,19,5,6,60,33,27,62
Cliftonville,1171,2,16,6,8,61,43,18,54
Linfield,1171,3,14,10,6,64,35,29,52
Coleraine,1171,4,13,13,4,46,30,16,52
Ballymena,1171,5,12,8,10,55,61,-6,44
Dungannon,1171,6,11,8,11,54,44,10,41
Glentoran,1171,7,11,7,12,36,45,-9,40
Glenavon,1171,8,9,12,9,48,49,-1,39
Ards,1171,9,7,4,19,33,57,-24,25
Portadown,1171,10,6,6,18,23,50,-27,24
Ballinamalla,1171,11,5,5,20,25,58,-33,20
Crusaders,1172,1,16,8,6,54,34,20,56
Cliftonville,1172,2,17,4,9,52,36,16,55
Ballymena,1172,3,15,7,8,58,52,6,52
Linfield,1172,4,13,8,9,53,31,22,47
Coleraine,1172,5,11,11,8,40,35,5,44
Dungannon,1172,6,10,12,8,49,39,10,42
Glenavon,1172,7,9,14,7,43,45,-2,41
Ards,1172,8,9,5,16,34,47,-13,32
Ballinamalla,1172,9,8,5,17,26,50,-24,29
Portadown,1172,10,8,4,18,31,49,-18,28
Glentoran,1172,11,6,8,16,27,49,-22,26
Cliftonville,1173,1,21,2,7,61,31,30,65
Crusaders,1173,2,15,8,7,52,39,13,53
Ballymena,1173,3,14,7,9,53,56,-3,49
Linfield,1173,4,13,9,8,52,33,19,48
Glenavon,1173,5,13,9,8,54,47,7,48
Ards,1173,6,12,4,14,45,46,-1,40
Dungannon,1173,7,10,9,11,52,49,3,39
Coleraine,1173,8,8,11,11,36,44,-8,35
Ballinamalla,1173,9,7,6,17,30,51,-21,27
Portadown,1173,10,6,8,16,23,46,-23,26
Glentoran,1173,11,6,7,17,27,43,-16,25
Cliftonville,1174,1,18,3,9,55,34,21,57
Ballymena,1174,2,17,6,7,69,55,14,57
Coleraine,1174,3,13,10,7,42,35,7,49
Crusaders,1174,4,14,5,11,47,41,6,47
Linfield,1174,5,12,7,11,56,36,20,43
Dungannon,1174,6,10,10,10,49,43,6,40
Glenavon,1174,7,10,10,10,40,45,-5,40
Ards,1174,8,9,7,14,40,48,-8,34
Glentoran,1174,9,9,7,14,34,49,-15,34
Portadown,1174,10,9,4,17,27,47,-20,31
Ballinamalla,1174,11,6,7,17,21,47,-26,25
Linfield,1175,1,16,10,4,60,25,35,58
Cliftonville,1175,2,16,4,10,56,40,16,52
Crusaders,1175,3,13,10,7,50,39,11,49
Glenavon,1175,4,12,12,6,46,39,7,48
Ballymena,1175,5,13,7,10,56,57,-1,46
Coleraine,1175,6,10,11,9,42,44,-2,41
Dungannon,1175,7,9,11,10,48,40,8,38
Portadown,1175,8,8,8,14,25,45,-20,32
Ards,1175,9,8,6,16,32,49,-17,30
Glentoran,1175,10,8,5,17,25,45,-20,29
Ballinamalla,1175,11,8,4,18,36,53,-17,28
Crusaders,1176,1,19,7,4,65,36,29,64
Linfield,1176,2,15,9,6,57,32,25,54
Ballymena,1176,3,14,7,9,53,50,3,49
Glenavon,1176,4,12,9,9,50,39,11,45
Cliftonville,1176,5,14,3,13,56,52,4,45
Coleraine,1176,6,12,8,10,49,42,7,44
Dungannon,1176,7,12,7,11,56,50,6,43
Ards,1176,8,9,6,15,40,52,-12,33
Glentoran,1176,9,8,8,14,29,48,-19,32
Ballinamalla,1176,10,7,5,18,37,59,-22,26
Portadown,1176,11,7,3,20,25,57,-32,24
Cliftonville,1177,1,17,5,8,56,36,20,56
Crusaders,1177,2,16,6,8,54,33,21,54
Ballymena,1177,3,15,7,8,59,54,5,52
Linfield,1177,4,14,8,8,56,35,21,50
Glenavon,1177,5,13,8,9,47,46,1,47
Coleraine,1177,6,10,11,9,43,45,-2,41
Glentoran,1177,7,10,8,12,36,42,-6,38
Dungannon,1177,8,8,10,12,50,48,2,34
Ards,1177,9,8,8,14,34,45,-11,32
Portadown,1177,10,8,6,16,27,46,-19,30
Ballinamalla,1177,11,5,5,20,23,55,-32,20
Linfield,1178,1,16,8,6,62,30,32,56
Coleraine,1178,2,15,8,7,52,36,16,53
Crusaders,1178,3,15,5,10,51,34,17,50
Ballymena,1178,4,15,5,10,56,63,-7,50
Cliftonville,1178,5,15,4,11,57,49,8,49
Dungannon,1178,6,12,7,11,53,46,7,43
Glentoran,1178,7,12,7,11,35,40,-5,43
Glenavon,1178,8,11,9,10,51,46,5,42
Ards,1178,9,9,6,15,37,46,-9,33
Ballinamalla,1178,10,6,5,19,34,66,-32,23
Portadown,1178,11,5,4,21,20,52,-32,19
Cliftonville,1179,1,17,3,10,52,41,11,54
Crusaders,1179,2,14,8,8,47,33,14,50
Ballymena,1179,3,15,5,10,60,52,8,50
Linfield,1179,4,13,10,7,60,34,26,49
Glenavon,1179,5,12,10,8,52,49,3,46
Coleraine,1179,6,9,10,11,39,46,-7,37
Ballinamalla,1179,7,11,4,15,34,43,-9,37
Ards,1179,8,10,6,14,45,48,-3,36
Dungannon,1179,9,8,10,12,46,50,-4,34
Glentoran,1179,10,9,6,15,30,48,-18,33
Portadown,1179,11,9,4,17,26,47,-21,31
Linfield,1180,1,15,9,6,60,34,26,54
Cliftonville,1180,2,15,6,9,53,38,15,51
Crusaders,1180,3,13,11,6,51,35,16,50
Ballymena,1180,4,13,9,8,52,53,-1,48
Glenavon,1180,5,11,11,8,46,44,2,44
Coleraine,1180,6,10,11,9,43,42,1,41
Dungannon,1180,7,10,9,11,49,41,8,39
Ards,1180,8,10,6,14,44,44,0,36
Glentoran,1180,9,7,11,12,28,44,-16,32
Portadown,1180,10,8,4,18,27,52,-25,28
Ballinamalla,1180,11,5,9,16,29,55,-26,24
Crusaders,1181,1,19,5,6,60,35,25,62
Linfield,1181,2,16,10,4,68,30,38,58
Ballymena,1181,3,13,8,9,60,60,0,47
Cliftonville,1181,4,13,6,11,51,43,8,45
Dungannon,1181,5,11,8,11,54,51,3,41
Portadown,1181,6,11,5,14,31,42,-11,38
Coleraine,1181,7,8,13,9,39,45,-6,37
Glenavon,1181,8,9,10,11,47,55,-8,37
Ards,1181,9,10,4,16,38,47,-9,34
Glentoran,1181,10,7,8,15,32,48,-16,29
Ballinamalla,1181,11,8,3,19,32,56,-24,27
Linfield,1182,1,18,9,3,69,30,39,63
Cliftonville,1182,2,15,8,7,55,33,22,53
Ballymena,1182,3,14,7,9,64,64,0,49
Glenavon,1182,4,12,12,6,49,43,6,48
Crusaders,1182,5,12,9,9,46,34,12,45
Coleraine,1182,6,10,11,9,43,40,3,41
Dungannon,1182,7,9,11,10,48,45,3,38
Ards,1182,8,10,6,14,41,46,-5,36
Glentoran,1182,9,9,7,14,30,50,-20,34
Portadown,1182,10,6,4,20,25,52,-27,22
Ballinamalla,1182,11,5,6,19,21,54,-33,21
Crusaders,1183,1,17,7,6,66,44,22,58
Linfield,1183,2,15,11,4,72,31,41,56
Cliftonville,1183,3,16,4,10,57,48,9,52
Ballymena,1183,4,12,8,10,59,67,-8,44
Glenavon,1183,5,10,12,8,49,50,-1,42
Dungannon,1183,6,10,11,9,52,45,7,41
Coleraine,1183,7,8,15,7,37,35,2,39
Ards,1183,8,9,6,15,43,55,-12,33
Ballinamalla,1183,9,10,3,17,34,51,-17,33
Glentoran,1183,10,6,9,15,30,48,-18,27
Portadown,1183,11,6,6,18,27,52,-25,24
Crusaders,1184,1,17,8,5,55,31,24,59
Linfield,1184,2,13,10,7,57,31,26,49
Cliftonville,1184,3,13,5,12,59,45,14,44
Ballymena,1184,4,11,9,10,53,58,-5,42
Dungannon,1184,5,11,7,12,55,50,5,40
Glenavon,1184,6,9,13,8,40,45,-5,40
Coleraine,1184,7,9,11,10,38,41,-3,38
Glentoran,1184,8,9,10,11,28,40,-12,37
Ards,1184,9,10,6,14,40,47,-7,36
Portadown,1184,10,10,6,14,29,40,-11,36
Ballinamalla,1184,11,9,3,18,26,52,-26,30
Cliftonville,1185,1,17,5,8,49,32,17,56
Crusaders,1185,2,15,9,6,60,40,20,54
Ballymena,1185,3,16,5,9,59,52,7,53
Linfield,1185,4,13,9,8,55,32,23,48
Glenavon,1185,5,11,11,8,42,45,-3,44
Dungannon,1185,6,12,7,11,48,41,7,43
Coleraine,1185,7,10,12,8,33,30,3,42
Glentoran,1185,8,11,7,12,34,40,-6,40
Ards,1185,9,8,7,15,34,46,-12,31
Portadown,1185,10,7,5,18,22,44,-22,26
Ballinamalla,1185,11,5,3,22,26,60,-34,18
Crusaders,1186,1,18,6,6,60,41,19,60
Glenavon,1186,2,13,10,7,53,46,7,49
Cliftonville,1186,3,14,6,10,48,38,10,48
Linfield,1186,4,13,7,10,57,37,20,46
Ballymena,1186,5,13,7,10,55,53,2,46
Dungannon,1186,6,11,10,9,51,38,13,43
Coleraine,1186,7,11,9,10,39,42,-3,42
Portadown,1186,8,9,7,14,28,40,-12,34
Ballinamalla,1186,9,8,5,17,34,55,-21,29
Ards,1186,10,6,10,14,36,48,-12,28
Glentoran,1186,11,7,7,16,24,47,-23,28
Crusaders,1187,1,19,6,5,54,26,28,63
Ballymena,1187,2,16,7,7,61,51,10,55
Linfield,1187,3,14,11,5,63,40,23,53
Cliftonville,1187,4,13,5,12,48,39,9,44
Dungannon,1187,5,11,8,11,51,47,4,41
Glenavon,1187,6,9,13,8,46,43,3,40
Coleraine,1187,7,10,10,10,36,37,-1,40
Glentoran,1187,8,9,8,13,32,47,-15,35
Ballinamalla,1187,9,7,10,13,29,47,-18,31
Ards,1187,10,8,3,19,34,52,-18,27
Portadown,1187,11,6,5,19,30,55,-25,23
Crusaders,1188,1,15,9,6,53,31,22,54
Linfield,1188,2,15,7,8,63,38,25,52
Cliftonville,1188,3,14,5,11,51,39,12,47
Glentoran,1188,4,13,6,11,39,39,0,45
Ballymena,1188,5,12,8,10,53,58,-5,44
Ards,1188,6,12,7,11,42,40,2,43
Glenavon,1188,7,9,13,8,49,47,2,40
Ballinamalla,1188,8,10,5,15,37,53,-16,35
Coleraine,1188,9,7,12,11,35,49,-14,33
Dungannon,1188,10,8,8,14,41,47,-6,32
Portadown,1188,11,7,6,17,23,45,-22,27
Crusaders,1189,1,18,5,7,59,38,21,59
Linfield,1189,2,15,9,6,65,32,33,54
Cliftonville,1189,3,14,8,8,49,39,10,50
Glenavon,1189,4,13,9,8,50,44,6,48
Coleraine,1189,5,9,13,8,36,34,2,40
Ballymena,1189,6,10,8,12,54,62,-8,38
Dungannon,1189,7,9,10,11,56,48,8,37
Glentoran,1189,8,10,6,14,31,45,-14,36
Ards,1189,9,8,7,15,38,49,-11,31
Portadown,1189,10,8,6,16,26,52,-26,30
Ballinamalla,1189,11,7,7,16,32,53,-21,28
Linfield,1190,1,17,8,5,66,32,34,59
Crusaders,1190,2,16,6,8,55,34,21,54
Coleraine,1190,3,15,8,7,53,37,16,53
Ballymena,1190,4,14,7,9,57,55,2,49
Cliftonville,1190,5,12,6,12,46,40,6,42
Glenavon,1190,6,11,9,10,50,47,3,42
Glentoran,1190,7,11,5,14,30,41,-11,38
Dungannon,1190,8,9,8,13,44,51,-7,35
Portadown,1190,9,9,5,16,27,46,-19,32
Ballinamalla,1190,10,9,5,16,28,48,-20,32
Ards,1190,11,5,7,18,30,55,-25,22
Linfield,1191,1,16,10,4,66,27,39,58
Cliftonville,1191,2,15,4,11,55,42,13,49
Crusaders,1191,3,14,7,9,49,41,8,49
Coleraine,1191,4,13,9,8,38,37,1,48
Ballymena,1191,5,13,5,12,58,62,-4,44
Glenavon,1191,6,11,9,10,44,40,4,42
Glentoran,1191,7,11,8,11,34,40,-6,41
Ards,1191,8,11,5,14,40,47,-7,38
Dungannon,1191,9,8,11,11,47,43,4,35
Ballinamalla,1191,10,8,5,17,29,53,-24,29
Portadown,1191,11,5,7,18,22,50,-28,22
Crusaders,1192,1,20,5,5,62,33,29,65
Linfield,1192,2,15,8,7,57,33,24,53
Ballymena,1192,3,14,6,10,58,55,3,48
Cliftonville,1192,4,13,5,12,56,44,12,44
Dungannon,1192,5,10,12,8,51,40,11,42
Coleraine,1192,6,10,9,11,42,50,-8,39
Portadown,1192,7,11,4,15,36,49,-13,37
Glenavon,1192,8,8,12,10,51,53,-2,36
Ards,1192,9,9,6,15,39,52,-13,33
Ballinamalla,1192,10,9,4,17,32,53,-21,31
Glentoran,1192,11,6,9,15,28,50,-22,27
Crusaders,1193,1,19,6,5,56,32,24,63
Linfield,1193,2,15,10,5,55,29,26,55
Ballymena,1193,3,14,8,8,55,52,3,50
Cliftonville,1193,4,14,5,11,50,48,2,47
Coleraine,1193,5,11,10,9,41,37,4,43
Glenavon,1193,6,9,15,6,56,47,9,42
Dungannon,1193,7,9,10,11,44,38,6,37
Ards,1193,8,9,6,15,30,48,-18,33
Glentoran,1193,9,7,11,12,34,44,-10,32
Ballinamalla,1193,10,8,3,19,29,51,-22,27
Portadown,1193,11,6,4,20,29,53,-24,22
Linfield,1194,1,18,9,3,65,22,43,63
Crusaders,1194,2,17,8,5,58,36,22,59
Ballymena,1194,3,15,5,10,57,55,2,50
Cliftonville,1194,4,15,4,11,50,41,9,49
Glenavon,1194,5,11,9,10,43,45,-2,42
Dungannon,1194,6,11,7,12,43,38,5,40
Coleraine,1194,7,8,9,13,36,50,-14,33
Glentoran,1194,8,8,8,14,26,42,-16,32
Portadown,1194,9,9,5,16,22,42,-20,32
Ballinamalla,1194,10,9,3,18,33,51,-18,30
Ards,1194,11,8,5,17,40,51,-11,29
Ballymena,1195,1,16,6,8,62,54,8,54
Cliftonville,1195,2,16,4,10,54,39,15,52
Crusaders,1195,3,14,8,8,52,39,13,50
Linfield,1195,4,12,13,5,54,32,22,49
Glentoran,1195,5,14,7,9,41,39,2,49
Dungannon,1195,6,11,8,11,49,41,8,41
Glenavon,1195,7,10,10,10,45,47,-2,40
Ards,1195,8,9,6,15,33,45,-12,33
Coleraine,1195,9,7,11,12,37,43,-6,32
Portadown,1195,10,7,6,17,23,45,-22,27
Ballinamalla,1195,11,7,5,18,33,59,-26,26
Crusaders,1196,1,15,7,8,48,34,14,52
Coleraine,1196,2,13,11,6,46,30,16,50
Linfield,1196,3,13,9,8,52,32,20,48
Ballymena,1196,4,13,9,8,60,58,2,48
Glenavon,1196,5,13,7,10,40,39,1,46
Cliftonville,1196,6,12,6,12,48,44,4,42
Glentoran,1196,7,11,8,11,33,37,-4,41
Dungannon,1196,8,9,10,11,46,44,2,37
Ballinamalla,1196,9,9,5,16,32,50,-18,32
Portadown,1196,10,8,5,17,30,46,-16,29
Ards,1196,11,8,5,17,32,53,-21,29
Crusaders,1197,1,20,6,4,61,24,37,66
Linfield,1197,2,13,12,5,53,31,22,51
Ballymena,1197,3,13,10,7,56,54,2,49
Cliftonville,1197,4,14,5,11,53,47,6,47
Dungannon,1197,5,10,11,9,45,41,4,41
Coleraine,1197,6,10,11,9,41,40,1,41
Glenavon,1197,7,9,13,8,43,46,-3,40
Ards,1197,8,9,7,14,39,46,-7,34
Glentoran,1197,9,9,7,14,30,45,-15,34
Ballinamalla,1197,10,7,3,20,31,55,-24,24
Portadown,1197,11,6,5,19,26,49,-23,23
Crusaders,1198,1,16,11,3,52,27,25,59
Ballymena,1198,2,15,8,7,61,53,8,53
Linfield,1198,3,14,10,6,55,28,27,52
Cliftonville,1198,4,15,6,9,57,42,15,51
Glenavon,1198,5,13,11,6,45,38,7,50
Ards,1198,6,11,6,13,37,43,-6,39
Coleraine,1198,7,9,11,10,37,42,-5,38
Dungannon,1198,8,9,6,15,52,48,4,33
Glentoran,1198,9,7,8,15,26,44,-18,29
Portadown,1198,10,7,4,19,28,55,-27,25
Ballinamalla,1198,11,5,7,18,27,57,-30,22
Crusaders,1199,1,15,7,8,56,41,15,52
Ballymena,1199,2,16,4,10,58,55,3,52
Glenavon,1199,3,14,9,7,50,37,13,51
Cliftonville,1199,4,16,3,11,53,41,12,51
Coleraine,1199,5,13,9,8,48,39,9,48
Linfield,1199,6,13,7,10,51,32,19,46
Dungannon,1199,7,10,8,12,51,47,4,38
Portadown,1199,8,11,3,16,28,45,-17,36
Glentoran,1199,9,9,8,13,30,43,-13,35
Ards,1199,10,9,5,16,37,53,-16,32
Ballinamalla,1199,11,6,3,21,19,48,-29,21
Linfield,1200,1,18,8,4,67,28,39,62
Crusaders,1200,2,16,7,7,62,46,16,55
Ballymena,1200,3,17,4,9,69,60,9,55
Coleraine,1200,4,12,9,9,43,43,0,45
Cliftonville,1200,5,12,6,12,52,46,6,42
Dungannon,1200,6,9,11,10,49,49,0,38
Glenavon,1200,7,9,11,10,46,48,-2,38
Glentoran,1200,8,8,10,12,36,45,-9,34
Ards,1200,9,9,6,15,40,49,-9,33
Ballinamalla,1200,10,9,3,18,28,52,-24,30
Portadown,1200,11,7,3,20,26,52,-26,24
Crusaders,1201,1,16,9,5,54,32,22,57
Cliftonville,1201,2,18,3,9,53,37,16,57
Coleraine,1201,3,13,10,7,48,38,10,49
Ballymena,1201,4,14,7,9,56,52,4,49
Glenavon,1201,5,12,10,8,47,45,2,46
Linfield,1201,6,12,9,9,53,31,22,45
Dungannon,1201,7,10,8,12,47,46,1,38
Glentoran,1201,8,9,5,16,33,46,-13,32
Ards,1201,9,8,5,17,38,54,-16,29
Ballinamalla,1201,10,8,5,17,30,54,-24,29
Portadown,1201,11,7,5,18,23,47,-24,26
Crusaders,1202,1,18,6,6,58,26,32,60
Ballymena,1202,2,15,7,8,65,54,11,52
Linfield,1202,3,13,9,8,52,32,20,48
Glenavon,1202,4,12,9,9,42,42,0,45
Cliftonville,1202,5,13,5,12,47,41,6,44
Coleraine,1202,6,10,13,7,41,38,3,43
Ards,1202,7,11,5,14,43,48,-5,38
Dungannon,1202,8,9,10,11,45,44,1,37
Glentoran,1202,9,9,10,11,31,41,-10,37
Ballinamalla,1202,10,9,2,19,27,55,-28,29
Portadown,1202,11,5,6,19,20,50,-30,21
Crusaders,1203,1,18,8,4,68,33,35,62
Cliftonville,1203,2,16,5,9,54,35,19,53
Linfield,1203,3,13,11,6,51,30,21,50
Ballymena,1203,4,14,5,11,54,55,-1,47
Coleraine,1203,5,12,10,8,40,37,3,46
Glenavon,1203,6,11,11,8,47,45,2,44
Glentoran,1203,7,10,8,12,31,44,-13,38
Dungannon,1203,8,10,6,14,53,55,-2,36
Ballinamalla,1203,9,10,3,17,35,57,-22,33
Portadown,1203,10,7,5,18,21,44,-23,26
Ards,1203,11,6,4,20,30,49,-19,22
Ballymena,1204,1,17,4,9,61,56,5,55
Crusaders,1204,2,15,8,7,62,38,24,53
Linfield,1204,3,14,10,6,56,29,27,52
Cliftonville,1204,4,15,5,10,51,41,10,50
Coleraine,1204,5,11,11,8,44,39,5,44
Dungannon,1204,6,9,12,9,47,40,7,39
Glenavon,1204,7,9,12,9,42,45,-3,39
Ards,1204,8,9,6,15,37,50,-13,33
Portadown,1204,9,9,6,15,23,40,-17,33
Glentoran,1204,10,8,7,15,27,43,-16,31
Ballinamalla,1204,11,6,5,19,30,59,-29,23
Crusaders,1205,1,19,6,5,66,32,34,63
Linfield,1205,2,16,7,7,63,29,34,55
Cliftonville,1205,3,15,4,11,54,45,9,49
Glenavon,1205,4,12,10,8,48,42,6,46
Coleraine,1205,5,12,8,10,42,38,4,44
Ballymena,1205,6,12,6,12,60,65,-5,42
Dungannon,1205,7,9,10,11,52,46,6,37
Ards,1205,8,10,4,16,38,54,-16,34
Ballinamalla,1205,9,8,8,14,34,52,-18,32
Glentoran,1205,10,8,7,15,27,51,-24,31
Portadown,1205,11,6,6,18,22,52,-30,24
Linfield,1206,1,15,9,6,62,38,24,54
Cliftonville,1206,2,16,6,8,52,41,11,54
Crusaders,1206,3,14,7,9,48,43,5,49
Ballymena,1206,4,14,6,10,52,53,-1,48
Glenavon,1206,5,12,10,8,55,46,9,46
Dungannon,1206,6,11,10,9,54,40,14,43
Ballinamalla,1206,7,10,5,15,41,56,-15,35
Coleraine,1206,8,9,7,14,35,43,-8,34
Glentoran,1206,9,9,6,15,35,46,-11,33
Ards,1206,10,8,6,16,38,49,-11,30
Portadown,1206,11,8,6,16,26,43,-17,30
Crusaders,1207,1,18,6,6,64,33,31,60
Ballymena,1207,2,16,5,9,63,52,11,53
Cliftonville,1207,3,16,3,11,47,37,10,51
Linfield,1207,4,14,8,8,55,37,18,50
Coleraine,1207,5,13,10,7,48,35,13,49
Glenavon,1207,6,10,11,9,52,54,-2,41
Dungannon,1207,7,9,9,12,48,45,3,36
Ards,1207,8,10,4,16,36,45,-9,34
Glentoran,1207,9,9,5,16,34,57,-23,32
Ballinamalla,1207,10,9,4,17,31,51,-20,31
Portadown,1207,11,7,3,20,18,50,-32,24
Linfield,1208,1,15,9,6,61,37,24,54
Crusaders,1208,2,15,9,6,54,31,23,54
Ballymena,1208,3,16,6,8,57,49,8,54
Cliftonville,1208,4,13,5,12,46,35,11,44
Coleraine,1208,5,10,14,6,35,30,5,44
Glenavon,1208,6,8,14,8,46,45,1,38
Ards,1208,7,11,5,14,43,48,-5,38
Ballinamalla,1208,8,11,4,15,34,50,-16,37
Glentoran,1208,9,7,10,13,28,48,-20,31
Dungannon,1208,10,6,11,13,43,48,-5,29
Portadown,1208,11,7,5,18,28,54,-26,26
Crusaders,1209,1,16,8,6,55,29,26,56
Linfield,1209,2,16,7,7,61,28,33,55
Cliftonville,1209,3,16,6,8,63,44,19,54
Ballymena,1209,4,14,7,9,55,55,0,49
Dungannon,1209,5,11,9,10,52,42,10,42
Glenavon,1209,6,10,12,8,45,48,-3,42
Coleraine,1209,7,10,9,11,49,51,-2,39
Ards,1209,8,10,5,15,36,49,-13,35
Glentoran,1209,9,8,8,14,30,52,-22,32
Portadown,1209,10,7,7,16,21,41,-20,28
Ballinamalla,1209,11,7,2,21,25,53,-28,23
Cliftonville,1210,1,18,4,8,52,37,15,58
Crusaders,1210,2,16,7,7,51,34,17,55
Linfield,1210,3,14,10,6,57,28,29,52
Coleraine,1210,4,12,11,7,38,33,5,47
Ballymena,1210,5,12,8,10,49,55,-6,44
Glenavon,1210,6,10,12,8,46,49,-3,42
Dungannon,1210,7,10,9,11,57,43,14,39
Ards,1210,8,9,5,16,37,50,-13,32
Portadown,1210,9,8,6,16,25,40,-15,30
Glentoran,1210,10,7,9,14,27,46,-19,30
Ballinamalla,1210,11,7,3,20,29,53,-24,24
Crusaders,1211,1,16,9,5,59,34,25,57
Cliftonville,1211,2,17,3,10,49,38,11,54
Linfield,1211,3,14,10,6,55,30,25,52
Glenavon,1211,4,13,12,5,53,44,9,51
Ballymena,1211,5,13,6,11,56,57,-1,45
Coleraine,1211,6,10,12,8,41,35,6,42
Dungannon,1211,7,8,11,11,45,48,-3,35
Ards,1211,8,8,7,15,32,44,-12,31
Portadown,1211,9,6,12,12,27,42,-15,30
Glentoran,1211,10,6,8,16,28,52,-24,26
Ballinamalla,1211,11,6,6,18,31,52,-21,24
Cliftonville,1212,1,16,4,10,58,43,15,52
Crusaders,1212,2,14,9,7,56,38,18,51
Glenavon,1212,3,13,11,6,46,40,6,50
Coleraine,1212,4,13,9,8,41,34,7,48
Ballymena,1212,5,13,8,9,60,61,-1,47
Linfield,1212,6,13,7,10,59,43,16,46
Dungannon,1212,7,10,13,7,60,41,19,43
Ards,1212,8,12,3,15,40,44,-4,39
Glentoran,1212,9,8,9,13,33,43,-10,33
Portadown,1212,10,6,6,18,29,60,-31,24
Ballinamalla,1212,11,6,3,21,24,59,-35,21
Crusaders,1213,1,16,8,6,61,39,22,56
Cliftonville,1213,2,17,4,9,57,40,17,55
Linfield,1213,3,12,11,7,54,36,18,47
Glenavon,1213,4,12,10,8,50,49,1,46
Ballymena,1213,5,10,12,8,51,52,-1,42
Coleraine,1213,6,10,10,10,41,40,1,40
Ards,1213,7,11,6,13,42,52,-10,39
Dungannon,1213,8,9,7,14,46,42,4,34
Glentoran,1213,9,8,9,13,32,44,-12,33
Ballinamalla,1213,10,9,3,18,33,56,-23,30
Portadown,1213,11,6,10,14,21,38,-17,28
Linfield,1214,1,19,7,4,65,30,35,64
Cliftonville,1214,2,17,3,10,54,36,18,54
Crusaders,1214,3,15,7,8,48,35,13,52
Ballymena,1214,4,14,7,9,52,50,2,49
Coleraine,1214,5,13,8,9,50,40,10,47
Portadown,1214,6,11,6,13,34,39,-5,39
Glenavon,1214,7,9,10,11,48,54,-6,37
Glentoran,1214,8,11,4,15,32,48,-16,37
Dungannon,1214,9,9,9,12,46,46,0,36
Ards,1214,10,7,3,20,33,58,-25,24
Ballinamalla,1214,11,6,4,20,24,50,-26,22
Cliftonville,1215,1,17,4,9,54,36,18,55
Crusaders,1215,2,14,8,8,49,35,14,50
Linfield,1215,3,12,12,6,56,33,23,48
Glenavon,1215,4,12,10,8,59,47,12,46
Dungannon,1215,5,12,10,8,57,45,12,46
Ballymena,1215,6,13,7,10,56,55,1,46
Coleraine,1215,7,11,12,7,45,41,4,45
Ballinamalla,1215,8,9,4,17,29,50,-21,31
Glentoran,1215,9,8,6,16,26,43,-17,30
Ards,1215,10,7,8,15,38,53,-15,29
Portadown,1215,11,6,7,17,24,55,-31,25
Crusaders,1216,1,16,8,6,56,38,18,56
Cliftonville,1216,2,16,5,9,59,42,17,53
Linfield,1216,3,14,9,7,57,36,21,51
Ballymena,1216,4,13,7,10,59,58,1,46
Coleraine,1216,5,11,9,10,47,49,-2,42
Ards,1216,6,12,6,12,41,45,-4,42
Glenavon,1216,7,9,10,11,39,47,-8,37
Dungannon,1216,8,8,12,10,49,44,5,36
Portadown,1216,9,10,6,14,34,42,-8,36
Glentoran,1216,10,6,11,13,26,39,-13,29
Ballinamalla,1216,11,5,7,18,26,53,-27,22
Cliftonville,1217,1,18,4,8,59,37,22,58
Linfield,1217,2,15,10,5,61,33,28,55
Crusaders,1217,3,16,4,10,51,39,12,52
Glenavon,1217,4,12,11,7,47,46,1,47
Ballymena,1217,5,13,7,10,59,55,4,46
Coleraine,1217,6,11,10,9,43,37,6,43
Dungannon,1217,7,10,9,11,49,42,7,39
Glentoran,1217,8,9,10,11,31,40,-9,37
Ards,1217,9,9,4,17,36,52,-16,31
Ballinamalla,1217,10,7,6,17,28,48,-20,27
Portadown,1217,11,6,3,21,19,54,-35,21
Linfield,1218,1,15,12,3,55,22,33,57
Crusaders,1218,2,14,11,5,50,30,20,53
Cliftonville,1218,3,15,6,9,51,36,15,51
Coleraine,1218,4,14,9,7,43,34,9,51
Dungannon,1218,5,14,7,9,58,44,14,49
Ballymena,1218,6,13,8,9,58,57,1,47
Glenavon,1218,7,10,9,11,45,44,1,39
Glentoran,1218,8,8,6,16,29,47,-18,30
Ards,1218,9,8,5,17,36,51,-15,29
Portadown,1218,10,8,5,17,28,52,-24,29
Ballinamalla,1218,11,6,2,22,21,57,-36,20
Cliftonville,1219,1,18,5,7,60,36,24,59
Glenavon,1219,2,13,10,7,52,48,4,49
Coleraine,1219,3,13,9,8,45,39,6,48
Ballymena,1219,4,14,5,11,64,64,0,47
Crusaders,1219,5,13,6,11,51,42,9,45
Linfield,1219,6,11,10,9,50,38,12,43
Dungannon,1219,7,9,10,11,57,50,7,37
Ards,1219,8,11,4,15,40,48,-8,37
Portadown,1219,9,9,6,15,26,45,-19,33
Glentoran,1219,10,9,5,16,28,47,-19,32
Ballinamalla,1219,11,7,6,17,35,51,-16,27
Linfield,1220,1,18,9,3,66,27,39,63
Glenavon,1220,2,15,11,4,59,39,20,56
Crusaders,1220,3,16,8,6,56,37,19,56
Cliftonville,1220,4,17,2,11,60,46,14,53
Ballymena,1220,5,13,7,10,57,58,-1,46
Glentoran,1220,6,9,10,11,37,43,-6,37
Coleraine,1220,7,8,9,13,36,47,-11,33
Dungannon,1220,8,7,9,14,47,51,-4,30
Ballinamalla,1220,9,8,4,18,27,51,-24,28
Ards,1220,10,7,6,17,33,56,-23,27
Portadown,1220,11,6,7,17,23,46,-23,25
Crusaders,1221,1,18,9,3,60,27,33,63
Linfield,1221,2,15,9,6,60,32,28,54
Cliftonville,1221,3,17,3,10,56,41,15,54
Coleraine,1221,4,12,12,6,42,34,8,48
Glenavon,1221,5,10,10,10,47,49,-2,40
Glentoran,1221,6,11,7,12,37,42,-5,40
Ballymena,1221,7,9,10,11,58,68,-10,37
Dungannon,1221,8,8,8,14,47,51,-4,32
Portadown,1221,9,8,7,15,33,53,-20,31
Ards,1221,10,7,5,18,36,56,-20,26
Ballinamalla,1221,11,6,8,16,32,55,-23,26
Linfield,1222,1,17,9,4,63,28,35,60
Crusaders,1222,2,14,8,8,48,37,11,50
Cliftonville,1222,3,14,6,10,54,42,12,48
Glenavon,1222,4,11,12,7,51,45,6,45
Ballymena,1222,5,11,10,9,54,56,-2,43
Coleraine,1222,6,9,13,8,41,42,-1,40
Portadown,1222,7,11,6,13,30,40,-10,39
Ards,1222,8,9,6,15,43,46,-3,33
Dungannon,1222,9,7,11,12,42,42,0,32
Glentoran,1222,10,8,6,16,25,50,-25,30
Ballinamalla,1222,11,8,5,17,26,49,-23,29
Linfield,1223,1,15,10,5,58,27,31,55
Crusaders,1223,2,13,13,4,53,34,19,52
Cliftonville,1223,3,14,5,11,55,41,14,47
Glenavon,1223,4,12,10,8,45,41,4,46
Dungannon,1223,5,11,10,9,49,39,10,43
Coleraine,1223,6,10,11,9,40,40,0,41
Ballymena,1223,7,10,10,10,49,60,-11,40
Ballinamalla,1223,8,10,5,15,35,45,-10,35
Glentoran,1223,9,8,9,13,29,47,-18,33
Ards,1223,10,9,4,17,39,53,-14,31
Portadown,1223,11,6,7,17,19,44,-25,25
Coleraine,1224,1,15,12,3,51,30,21,57
Crusaders,1224,2,16,5,9,52,41,11,53
Glenavon,1224,3,14,10,6,56,42,14,52
Cliftonville,1224,4,15,6,9,44,31,13,51
Ballymena,1224,5,13,8,9,59,59,0,47
Linfield,1224,6,9,13,8,47,31,16,40
Ards,1224,7,10,7,13,41,44,-3,37
Glentoran,1224,8,8,11,11,31,43,-12,35
Portadown,1224,9,8,7,15,27,45,-18,31
Ballinamalla,1224,10,6,6,18,21,50,-29,24
Dungannon,1224,11,5,7,18,39,52,-13,22
Crusaders,1225,1,19,6,5,58,29,29,63
Cliftonville,1225,2,17,3,10,52,39,13,54
Linfield,1225,3,15,8,7,52,32,20,53
Ballymena,1225,4,13,5,12,58,61,-3,44
Glenavon,1225,5,11,10,9,43,44,-1,43
Coleraine,1225,6,10,10,10,43,42,1,40
Dungannon,1225,7,9,8,13,47,45,2,35
Glentoran,1225,8,8,10,12,37,47,-10,34
Ards,1225,9,8,8,14,38,49,-11,32
Portadown,1225,10,7,7,16,27,43,-16,28
Ballinamalla,1225,11,6,9,15,26,50,-24,27
Cliftonville,1226,1,16,8,6,52,34,18,56
Linfield,1226,2,15,10,5,54,28,26,55
Crusaders,1226,3,16,7,7,56,34,22,55
Glenavon,1226,4,13,10,7,49,40,9,49
Coleraine,1226,5,10,9,11,41,40,1,39
Ballymena,1226,6,9,11,10,51,66,-15,38
Glentoran,1226,7,9,7,14,31,42,-11,34
Dungannon,1226,8,8,9,13,48,48,0,33
Ballinamalla,1226,9,10,3,17,32,52,-20,33
Ards,1226,10,9,5,16,34,45,-11,32
Portadown,1226,11,7,7,16,21,40,-19,28
Linfield,1227,1,18,8,4,68,29,39,62
Cliftonville,1227,2,19,3,8,57,34,23,60
Ballymena,1227,3,19,3,8,59,51,8,60
Crusaders,1227,4,12,8,10,48,39,9,44
Glenavon,1227,5,9,14,7,40,42,-2,41
Dungannon,1227,6,10,10,10,50,42,8,40
Coleraine,1227,7,9,11,10,42,41,1,38
Glentoran,1227,8,10,5,15,26,41,-15,35
Ards,1227,9,10,2,18,37,54,-17,32
Ballinamalla,1227,10,8,2,20,27,51,-24,26
Portadown,1227,11,6,4,20,24,54,-30,22
Linfield,1228,1,16,8,6,59,31,28,56
Crusaders,1228,2,16,7,7,58,35,23,55
Cliftonville,1228,3,16,7,7,60,41,19,55
Coleraine,1228,4,13,12,5,41,26,15,51
Ballymena,1228,5,12,9,9,57,53,4,45
Glenavon,1228,6,8,15,7,45,46,-1,39
Dungannon,1228,7,8,10,12,53,55,-2,34
Glentoran,1228,8,9,7,14,34,53,-19,34
Ballinamalla,1228,9,9,5,16,31,49,-18,32
Ards,1228,10,8,5,17,35,54,-19,29
Portadown,1228,11,5,5,20,26,56,-30,20
Cliftonville,1229,1,18,5,7,52,31,21,59
Crusaders,1229,2,16,9,5,53,34,19,57
Linfield,1229,3,13,9,8,58,38,20,48
Ballymena,1229,4,13,6,11,57,57,0,45
Coleraine,1229,5,12,8,10,38,36,2,44
Dungannon,1229,6,11,8,11,56,45,11,41
Glenavon,1229,7,10,10,10,46,47,-1,40
Glentoran,1229,8,10,6,14,25,43,-18,36
Ballinamalla,1229,9,9,5,16,30,48,-18,32
Ards,1229,10,7,8,15,35,46,-11,29
Portadown,1229,11,6,6,18,21,46,-25,24
Linfield,1230,1,15,8,7,62,32,30,53
Crusaders,1230,2,14,6,10,57,43,14,48
Dungannon,1230,3,13,8,9,54,43,11,47
Ballymena,1230,4,13,8,9,54,59,-5,47
Coleraine,1230,5,11,10,9,45,44,1,43
Glenavon,1230,6,11,10,9,45,45,0,43
Glentoran,1230,7,11,10,9,33,36,-3,43
Cliftonville,1230,8,12,5,13,52,48,4,41
Portadown,1230,9,10,4,16,28,47,-19,34
Ards,1230,10,9,5,16,40,50,-10,32
Ballinamalla,1230,11,7,4,19,30,53,-23,25
Crusaders,1231,1,17,10,3,60,28,32,61
Cliftonville,1231,2,15,7,8,55,44,11,52
Ballymena,1231,3,14,8,8,60,58,2,50
Coleraine,1231,4,13,9,8,43,37,6,48
Linfield,1231,5,12,10,8,59,40,19,46
Glenavon,1231,6,11,9,10,43,42,1,42
Glentoran,1231,7,11,7,12,36,46,-10,40
Dungannon,1231,8,8,9,13,46,50,-4,33
Ballinamalla,1231,9,9,4,17,32,47,-15,31
Portadown,1231,10,8,4,18,25,48,-23,28
Ards,1231,11,7,3,20,33,52,-19,24
Crusaders,1232,1,18,9,3,61,32,29,63
Linfield,1232,2,18,6,6,68,37,31,60
Cliftonville,1232,3,16,3,11,55,40,15,51
Coleraine,1232,4,11,11,8,44,39,5,44
Ballymena,1232,5,13,5,12,59,61,-2,44
Dungannon,1232,6,11,10,9,52,45,7,43
Glenavon,1232,7,9,14,7,43,40,3,41
Portadown,1232,8,9,4,17,30,46,-16,31
Glentoran,1232,9,7,9,14,33,52,-19,30
Ards,1232,10,7,6,17,35,56,-21,27
Ballinamalla,1232,11,5,5,20,25,57,-32,20
Crusaders,1233,1,19,7,4,57,31,26,64
Linfield,1233,2,14,10,6,63,30,33,52
Ballymena,1233,3,15,5,10,65,52,13,50
Cliftonville,1233,4,14,6,10,49,38,11,48
Glenavon,1233,5,13,9,8,52,43,9,48
Coleraine,1233,6,12,10,8,45,39,6,46
Dungannon,1233,7,10,8,12,45,38,7,38
Ballinamalla,1233,8,9,3,18,35,55,-20,30
Ards,1233,9,9,3,18,34,58,-24,30
Glentoran,1233,10,6,9,15,19,43,-24,27
Portadown,1233,11,6,6,18,20,57,-37,24
Crusaders,1234,1,19,5,6,60,32,28,62
Ballymena,1234,2,17,4,9,58,51,7,55
Linfield,1234,3,14,10,6,56,29,27,52
Cliftonville,1234,4,16,4,10,54,40,14,52
Dungannon,1234,5,12,7,11,59,54,5,43
Glenavon,1234,6,10,10,10,44,48,-4,40
Coleraine,1234,7,10,10,10,39,43,-4,40
Ards,1234,8,11,3,16,40,51,-11,36
Portadown,1234,9,10,4,16,28,42,-14,34
Glentoran,1234,10,8,7,15,26,39,-13,31
Ballinamalla,1234,11,4,4,22,24,59,-35,16
Crusaders,1235,1,20,5,5,63,29,34,65
Cliftonville,1235,2,14,7,9,55,45,10,49
Ballymena,1235,3,13,9,8,65,57,8,48
Dungannon,1235,4,12,9,9,58,49,9,45
Linfield,1235,5,11,10,9,53,38,15,43
Coleraine,1235,6,11,9,10,41,39,2,42
Glenavon,1235,7,10,12,8,41,40,1,42
Ards,1235,8,11,3,16,39,49,-10,36
Glentoran,1235,9,10,6,14,31,44,-13,36
Ballinamalla,1235,10,7,4,19,25,51,-26,25
Portadown,1235,11,7,4,19,23,53,-30,25
Crusaders,1236,1,17,6,7,65,39,26,57
Cliftonville,1236,2,16,3,11,55,42,13,51
Linfield,1236,3,13,9,8,60,37,23,48
Ballymena,1236,4,13,7,10,56,57,-1,46
Glenavon,1236,5,11,12,7,47,47,0,45
Coleraine,1236,6,11,10,9,42,40,2,43
Dungannon,1236,7,11,9,10,50,39,11,42
Portadown,1236,8,9,6,15,22,38,-16,33
Glentoran,1236,9,9,5,16,27,49,-22,32
Ards,1236,10,8,7,15,41,55,-14,31
Ballinamalla,1236,11,8,4,18,29,51,-22,28
Crusaders,1237,1,19,6,5,61,38,23,63
Cliftonville,1237,2,17,3,10,48,35,13,54
Glenavon,1237,3,13,12,5,54,41,13,51
Coleraine,1237,4,12,13,5,44,36,8,49
Linfield,1237,5,12,8,10,53,38,15,44
Dungannon,1237,6,10,10,10,53,47,6,40
Ballymena,1237,7,11,7,12,56,64,-8,40
Glentoran,1237,8,8,6,16,36,50,-14,30
Ards,1237,9,9,3,18,34,50,-16,30
Portadown,1237,10,8,5,17,21,39,-18,29
Ballinamalla,1237,11,8,3,19,34,56,-22,27
Linfield,1238,1,16,9,5,69,33,36,57
Ballymena,1238,2,16,6,8,56,54,2,54
Coleraine,1238,3,15,7,8,48,34,14,52
Crusaders,1238,4,15,5,10,48,37,11,50
Cliftonville,1238,5,13,4,13,47,43,4,43
Glenavon,1238,6,11,10,9,44,41,3,43
Dungannon,1238,7,11,9,10,52,44,8,42
Ballinamalla,1238,8,9,5,16,34,47,-13,32
Glentoran,1238,9,9,5,16,25,46,-21,32
Ards,1238,10,8,5,17,36,56,-20,29
Portadown,1238,11,6,7,17,26,50,-24,25
Cliftonville,1239,1,17,4,9,47,30,17,55
Crusaders,1239,2,14,11,5,50,30,20,53
Ballymena,1239,3,14,7,9,59,59,0,49
Linfield,1239,4,13,8,9,61,41,20,47
Dungannon,1239,5,12,9,9,49,37,12,45
Glenavon,1239,6,10,12,8,44,46,-2,42
Coleraine,1239,7,10,9,11,37,43,-6,39
Glentoran,1239,8,10,9,11,34,44,-10,39
Ards,1239,9,10,4,16,38,46,-8,34
Ballinamalla,1239,10,7,6,17,28,48,-20,27
Portadown,1239,11,6,5,19,22,45,-23,23
Linfield,1240,1,15,10,5,64,33,31,55
Cliftonville,1240,2,15,7,8,63,44,19,52
Glenavon,1240,3,15,7,8,47,35,12,52
Ballymena,1240,4,15,5,10,58,52,6,50
Crusaders,1240,5,12,10,8,48,37,11,46
Coleraine,1240,6,11,10,9,44,40,4,43
Glentoran,1240,7,9,9,12,36,51,-15,36
Dungannon,1240,8,7,11,12,39,43,-4,32
Ards,1240,9,9,5,16,41,52,-11,32
Ballinamalla,1240,10,7,7,16,30,52,-22,28
Portadown,1240,11,7,5,18,20,51,-31,26
Crusaders,1241,1,16,10,4,54,32,22,58
Linfield,1241,2,14,10,6,66,34,32,52
Coleraine,1241,3,14,10,6,50,36,14,52
Glenavon,1241,4,13,12,5,47,36,11,51
Ballymena,1241,5,13,7,10,53,60,-7,46
Cliftonville,1241,6,13,5,12,48,42,6,44
Dungannon,1241,7,9,10,11,45,41,4,37
Ards,1241,8,8,7,15,42,49,-7,31
Ballinamalla,1241,9,9,3,18,30,55,-25,30
Portadown,1241,10,7,6,17,26,57,-31,27
Glentoran,1241,11,6,6,18,23,42,-19,24
Crusaders,1242,1,20,6,4,62,34,28,66
Linfield,1242,2,12,12,6,55,32,23,48
Cliftonville,1242,3,14,6,10,54,41,13,48
Coleraine,1242,4,12,10,8,43,36,7,46
Glenavon,1242,5,12,10,8,51,46,5,46
Ballymena,1242,6,13,5,12,58,59,-1,44
Portadown,1242,7,9,8,13,25,41,-16,35
Dungannon,1242,8,9,7,14,42,46,-4,34
Glentoran,1242,9,7,12,11,28,39,-11,33
Ballinamalla,1242,10,8,4,18,28,50,-22,28
Ards,1242,11,6,6,18,27,49,-22,24
Cliftonville,1243,1,17,4,9,55,37,18,55
Crusaders,1243,2,15,9,6,60,37,23,54
Ballymena,1243,3,16,6,8,57,52,5,54
Linfield,1243,4,13,9,8,61,38,23,48
Glenavon,1243,5,12,8,10,51,50,1,44
Dungannon,1243,6,11,9,10,58,47,11,42
Glentoran,1243,7,11,7,12,37,41,-4,40
Coleraine,1243,8,9,10,11,37,45,-8,37
Ballinamalla,1243,9,8,6,16,31,50,-19,30
Ards,1243,10,8,5,17,34,54,-20,29
Portadown,1243,11,7,3,20,21,51,-30,24
Crusaders,1244,1,19,7,4,63,34,29,64
Cliftonville,1244,2,17,4,9,57,32,25,55
Linfield,1244,3,14,10,6,59,38,21,52
Glenavon,1244,4,15,7,8,55,44,11,52
Dungannon,1244,5,12,7,11,55,41,14,43
Coleraine,1244,6,9,12,9,38,44,-6,39
Ballymena,1244,7,11,6,13,51,58,-7,39
Glentoran,1244,8,9,8,13,32,42,-10,35
Ards,1244,9,9,4,17,36,53,-17,31
Ballinamalla,1244,10,8,3,19,30,59,-29,27
Portadown,1244,11,5,6,19,20,51,-31,21
Crusaders,1245,1,18,5,7,53,31,22,59
Cliftonville,1245,2,16,2,12,61,41,20,50
Ballymena,1245,3,13,8,9,54,49,5,47
Linfield,1245,4,12,10,8,49,27,22,46
Glenavon,1245,5,11,11,8,47,45,2,44
Coleraine,1245,6,12,7,11,37,42,-5,43
Ards,1245,7,12,6,12,43,45,-2,42
Ballinamalla,1245,8,12,3,15,34,41,-7,39
Glentoran,1245,9,10,8,12,31,45,-14,38
Dungannon,1245,10,9,7,14,40,50,-10,34
Portadown,1245,11,4,5,21,15,48,-33,17
Crusaders,1246,1,18,6,6,64,40,24,60
Ballymena,1246,2,15,7,8,63,54,9,52
Linfield,1246,3,13,9,8,57,41,16,48
Cliftonville,1246,4,14,6,10,57,45,12,48
Dungannon,1246,5,12,8,10,49,40,9,44
Coleraine,1246,6,10,11,9,40,42,-2,41
Ards,1246,7,11,4,15,42,50,-8,37
Glenavon,1246,8,8,12,10,41,49,-8,36
Portadown,1246,9,9,7,14,34,41,-7,34
Glentoran,1246,10,7,9,14,29,45,-16,30
Ballinamalla,1246,11,7,3,20,30,59,-29,24
Cliftonville,1247,1,18,5,7,57,37,20,59
Ballymena,1247,2,18,5,7,61,50,11,59
Crusaders,1247,3,16,9,5,56,36,20,57
Glenavon,1247,4,12,10,8,47,44,3,46
Linfield,1247,5,12,8,10,57,36,21,44
Dungannon,1247,6,11,9,10,54,45,9,42
Coleraine,1247,7,9,11,10,39,43,-4,38
Ballinamalla,1247,8,9,3,18,29,51,-22,30
Ards,1247,9,7,8,15,39,53,-14,29
Glentoran,1247,10,6,8,16,28,48,-20,26
Portadown,1247,11,6,6,18,24,48,-24,24
Crusaders,1248,1,17,8,5,54,30,24,59
Cliftonville,1248,2,17,6,7,58,37,21,57
Linfield,1248,3,13,10,7,54,33,21,49
Glenavon,1248,4,13,10,7,55,47,8,49
Ballymena,1248,5,14,6,10,61,62,-1,48
Coleraine,1248,6,10,7,13,39,48,-9,37
Ards,1248,7,9,7,14,46,50,-4,34
Dungannon,1248,8,7,10,13,49,52,-3,31
Ballinamalla,1248,9,7,10,13,33,49,-16,31
Glentoran,1248,10,7,10,13,28,44,-16,31
Portadown,1248,11,5,8,17,25,50,-25,23
Linfield,1249,1,16,9,5,57,26,31,57
Crusaders,1249,2,17,6,7,54,33,21,57
Cliftonville,1249,3,16,4,10,57,38,19,52
Ballymena,1249,4,14,5,11,49,57,-8,47
Coleraine,1249,5,12,10,8,39,34,5,46
Glenavon,1249,6,10,13,7,48,48,0,43
Ards,1249,7,10,6,14,36,41,-5,36
Dungannon,1249,8,7,12,11,48,44,4,33
Glentoran,1249,9,8,7,15,29,43,-14,31
Portadown,1249,10,7,6,17,20,44,-24,27
Ballinamalla,1249,11,6,6,18,19,48,-29,24
Coleraine,1250,1,15,10,5,50,30,20,55
Crusaders,1250,2,15,8,7,54,38,16,53
Linfield,1250,3,13,10,7,56,31,25,49
Ballymena,1250,4,13,9,8,52,56,-4,48
Glenavon,1250,5,13,8,9,52,45,7,47
Cliftonville,1250,6,12,5,13,50,42,8,41
Portadown,1250,7,10,6,14,27,43,-16,36
Dungannon,1250,8,8,11,11,49,49,0,35
Glentoran,1250,9,8,8,14,30,41,-11,32
Ballinamalla,1250,10,7,7,16,26,51,-25,28
Ards,1250,11,6,8,16,37,57,-20,26
Linfield,1251,1,15,8,7,60,34,26,53
Glenavon,1251,2,14,8,8,58,50,8,50
Cliftonville,1251,3,15,4,11,54,43,11,49
Crusaders,1251,4,12,12,6,46,34,12,48
Coleraine,1251,5,13,9,8,43,38,5,48
Dungannon,1251,6,12,8,10,45,39,6,44
Ballymena,1251,7,12,7,11,52,52,0,43
Glentoran,1251,8,9,8,13,28,39,-11,35
Ards,1251,9,9,4,17,37,50,-13,31
Ballinamalla,1251,10,9,2,19,26,47,-21,29
Portadown,1251,11,6,8,16,25,48,-23,26
Crusaders,1252,1,15,11,4,54,34,20,56
Linfield,1252,2,15,10,5,56,28,28,55
Glenavon,1252,3,14,11,5,51,36,15,53
Cliftonville,1252,4,14,5,11,55,46,9,47
Coleraine,1252,5,11,10,9,45,35,10,43
Dungannon,1252,6,9,9,12,48,49,-1,36
Ballymena,1252,7,8,11,11,55,69,-14,35
Glentoran,1252,8,8,9,13,30,43,-13,33
Ards,1252,9,9,5,16,34,51,-17,32
Ballinamalla,1252,10,9,5,16,36,55,-19,32
Portadown,1252,11,6,8,16,29,47,-18,26
Linfield,1253,1,17,8,5,57,31,26,59
Crusaders,1253,2,16,7,7,54,34,20,55
Cliftonville,1253,3,15,7,8,55,34,21,52
Coleraine,1253,4,14,8,8,42,34,8,50
Ballymena,1253,5,13,7,10,54,60,-6,46
Dungannon,1253,6,10,9,11,46,39,7,39
Glenavon,1253,7,8,13,9,38,42,-4,37
Glentoran,1253,8,10,6,14,33,45,-12,36
Ards,1253,9,9,5,16,39,52,-13,32
Portadown,1253,10,7,6,17,27,47,-20,27
Ballinamalla,1253,11,5,6,19,22,49,-27,21
Cliftonville,1254,1,17,5,8,54,34,20,56
Crusaders,1254,2,13,10,7,51,34,17,49
Ballymena,1254,3,13,9,8,58,54,4,48
Glenavon,1254,4,12,11,7,42,45,-3,47
Dungannon,1254,5,12,9,9,51,40,11,45
Linfield,1254,6,11,11,8,51,33,18,44
Ards,1254,7,13,4,13,35,39,-4,43
Coleraine,1254,8,9,9,12,39,40,-1,36
Glentoran,1254,9,9,7,14,26,41,-15,34
Portadown,1254,10,6,7,17,26,51,-25,25
Ballinamalla,1254,11,5,8,17,31,53,-22,23
Cliftonville,1255,1,17,4,9,52,35,17,55
Crusaders,1255,2,16,5,9,56,35,21,53
Linfield,1255,3,15,7,8,60,37,23,52
Dungannon,1255,4,13,9,8,49,37,12,48
Coleraine,1255,5,12,9,9,43,36,7,45
Glenavon,1255,6,10,12,8,45,41,4,42
Ballymena,1255,7,12,6,12,49,57,-8,42
Ards,1255,8,9,7,14,36,46,-10,34
Glentoran,1255,9,8,8,14,31,47,-16,32
Portadown,1255,10,8,5,17,24,43,-19,29
Ballinamalla,1255,11,7,4,19,32,63,-31,25
Linfield,1256,1,14,9,7,58,38,20,51
Ballymena,1256,2,15,5,10,56,56,0,50
Crusaders,1256,3,14,7,9,48,32,16,49
Glenavon,1256,4,12,12,6,52,41,11,48
Cliftonville,1256,5,15,3,12,50,39,11,48
Ballinamalla,1256,6,13,5,12,35,40,-5,44
Coleraine,1256,7,10,9,11,36,41,-5,39
Dungannon,1256,8,10,7,13,42,38,4,37
Ards,1256,9,9,5,16,40,52,-12,32
Glentoran,1256,10,8,7,15,31,54,-23,31
Portadown,1256,11,8,5,17,28,45,-17,29
Crusaders,1257,1,17,9,4,57,30,27,60
Ballymena,1257,2,17,5,8,58,54,4,56
Linfield,1257,3,15,8,7,62,33,29,53
Glenavon,1257,4,11,12,7,57,44,13,45
Cliftonville,1257,5,12,5,13,52,52,0,41
Coleraine,1257,6,9,11,10,38,41,-3,38
Dungannon,1257,7,9,7,14,47,49,-2,34
Portadown,1257,8,9,6,15,26,47,-21,33
Ards,1257,9,8,8,14,36,43,-7,32
Ballinamalla,1257,10,10,2,18,33,51,-18,32
Glentoran,1257,11,8,7,15,26,48,-22,31
Crusaders,1258,1,20,6,4,62,33,29,66
Ballymena,1258,2,16,6,8,54,50,4,54
Cliftonville,1258,3,13,9,8,47,34,13,48
Glenavon,1258,4,13,9,8,50,44,6,48
Linfield,1258,5,12,11,7,51,29,22,47
Dungannon,1258,6,10,10,10,51,44,7,40
Coleraine,1258,7,10,10,10,42,41,1,40
Glentoran,1258,8,9,7,14,31,41,-10,34
Ards,1258,9,9,5,16,37,54,-17,32
Portadown,1258,10,7,6,17,18,39,-21,27
Ballinamalla,1258,11,5,3,22,24,58,-34,18
Ballymena,1259,1,16,6,8,57,52,5,54
Cliftonville,1259,2,15,5,10,49,36,13,50
Crusaders,1259,3,13,9,8,43,32,11,48
Linfield,1259,4,12,10,8,58,41,17,46
Glenavon,1259,5,10,13,7,50,48,2,43
Coleraine,1259,6,9,10,11,42,42,0,37
Ards,1259,7,11,4,15,48,49,-1,37
Portadown,1259,8,10,6,14,27,43,-16,36
Ballinamalla,1259,9,11,2,17,37,51,-14,35
Glentoran,1259,10,9,7,14,22,39,-17,34
Dungannon,1259,11,7,12,11,51,51,0,33
Crusaders,1260,1,18,7,5,56,30,26,61
Cliftonville,1260,2,16,4,10,52,42,10,52
Glenavon,1260,3,14,9,7,44,35,9,51
Coleraine,1260,4,13,9,8,50,38,12,48
Ballymena,1260,5,14,6,10,57,55,2,48
Linfield,1260,6,12,9,9,47,29,18,45
Dungannon,1260,7,10,10,10,54,43,11,40
Glentoran,1260,8,9,7,14,29,41,-12,34
Ards,1260,9,9,3,18,33,52,-19,30
Ballinamalla,1260,10,7,5,18,23,54,-31,26
Portadown,1260,11,7,3,20,23,49,-26,24
Crusaders,1261,1,17,4,9,61,43,18,55
Cliftonville,1261,2,17,4,9,57,40,17,55
Coleraine,1261,3,14,9,7,48,35,13,51
Ballymena,1261,4,15,4,11,53,52,1,49
Linfield,1261,5,13,8,9,59,40,19,47
Glenavon,1261,6,10,11,9,47,49,-2,41
Ballinamalla,1261,7,12,4,14,38,49,-11,40
Dungannon,1261,8,9,8,13,50,49,1,35
Glentoran,1261,9,8,8,14,32,55,-23,32
Portadown,1261,10,8,6,16,32,47,-15,30
Ards,1261,11,7,4,19,35,53,-18,25
Linfield,1262,1,17,9,4,74,31,43,60
Crusaders,1262,2,16,8,6,53,31,22,56
Coleraine,1262,3,12,10,8,41,36,5,46
Ballymena,1262,4,12,8,10,52,52,0,44
Glenavon,1262,5,10,11,9,45,44,1,41
Cliftonville,1262,6,12,4,14,46,48,-2,40
Ards,1262,7,11,4,15,37,47,-10,37
Ballinamalla,1262,8,11,4,15,32,47,-15,37
Glentoran,1262,9,7,13,10,30,40,-10,34
Dungannon,1262,10,8,9,13,49,50,-1,33
Portadown,1262,11,7,4,19,24,57,-33,25
Crusaders,1263,1,19,6,5,60,28,32,63
Cliftonville,1263,2,14,7,9,52,43,9,49
Coleraine,1263,3,12,12,6,49,39,10,48
Glenavon,1263,4,11,10,9,44,39,5,43
Ballymena,1263,5,11,9,10,57,59,-2,42
Linfield,1263,6,11,8,11,53,42,11,41
Dungannon,1263,7,8,12,10,44,43,1,36
Ballinamalla,1263,8,10,6,14,31,46,-15,36
Ards,1263,9,10,4,16,36,51,-15,34
Portadown,1263,10,9,6,15,31,44,-13,33
Glentoran,1263,11,6,8,16,27,50,-23,26
Crusaders,1264,1,16,9,5,57,40,17,57
Linfield,1264,2,13,10,7,53,27,26,49
Coleraine,1264,3,12,11,7,39,31,8,47
Cliftonville,1264,4,13,7,10,50,41,9,46
Ballymena,1264,5,13,7,10,52,51,1,46
Glenavon,1264,6,9,12,9,43,43,0,39
Portadown,1264,7,11,5,14,29,42,-13,38
Glentoran,1264,8,9,9,12,38,43,-5,36
Dungannon,1264,9,7,12,11,51,50,1,33
Ballinamalla,1264,10,8,5,17,31,54,-23,29
Ards,1264,11,6,9,15,30,51,-21,27
Linfield,1265,1,15,11,4,59,28,31,56
Crusaders,1265,2,15,10,5,50,32,18,55
Coleraine,1265,3,13,10,7,45,35,10,49
Ballymena,1265,4,13,6,11,60,62,-2,45
Cliftonville,1265,5,13,5,12,52,45,7,44
Dungannon,1265,6,11,9,10,55,44,11,42
Glenavon,1265,7,11,9,10,44,43,1,42
Glentoran,1265,8,11,5,14,33,46,-13,38
Portadown,1265,9,9,5,16,23,44,-21,32
Ards,1265,10,8,7,15,39,52,-13,31
Ballinamalla,1265,11,5,5,20,30,59,-29,20
Linfield,1266,1,17,8,5,60,27,33,59
Cliftonville,1266,2,18,4,8,53,35,18,58
Crusaders,1266,3,16,7,7,56,35,21,55
Ballymena,1266,4,17,4,9,77,63,14,55
Coleraine,1266,5,10,12,8,37,42,-5,42
Dungannon,1266,6,11,7,12,55,48,7,40
Glenavon,1266,7,10,10,10,51,51,0,40
Glentoran,1266,8,8,7,15,25,47,-22,31
Ballinamalla,1266,9,8,4,18,26,52,-26,28
Ards,1266,10,8,3,19,33,53,-20,27
Portadown,1266,11,6,6,18,31,51,-20,24
Linfield,1267,1,15,9,6,58,32,26,54
Crusaders,1267,2,15,9,6,58,35,23,54
Cliftonville,1267,3,14,9,7,55,37,18,51
Glenavon,1267,4,13,11,6,53,39,14,50
Coleraine,1267,5,9,13,8,47,44,3,40
Dungannon,1267,6,9,10,11,47,47,0,37
Ards,1267,7,11,3,16,41,50,-9,36
Glentoran,1267,8,10,6,14,27,47,-20,36
Ballymena,1267,9,9,8,13,55,65,-10,35
Portadown,1267,10,8,6,16,25,43,-18,30
Ballinamalla,1267,11,8,4,18,30,57,-27,28
Cliftonville,1268,1,16,3,11,54,42,12,51
Ballymena,1268,2,14,9,7,62,52,10,51
Coleraine,1268,3,13,11,6,52,39,13,50
Linfield,1268,4,13,10,7,55,40,15,49
Crusaders,1268,5,13,10,7,50,37,13,49
Dungannon,1268,6,14,6,10,53,44,9,48
Glenavon,1268,7,11,11,8,52,43,9,44
Glentoran,1268,8,9,8,13,35,46,-11,35
Ballinamalla,1268,9,7,8,15,34,52,-18,29
Ards,1268,10,6,6,18,34,56,-22,24
Portadown,1268,11,6,4,20,20,50,-30,22
Crusaders,1269,1,18,6,6,58,37,21,60
Linfield,1269,2,14,12,4,68,34,34,54
Cliftonville,1269,3,15,5,10,53,37,16,50
Coleraine,1269,4,13,11,6,44,36,8,50
Glenavon,1269,5,12,10,8,54,47,7,46
Ballymena,1269,6,13,6,11,55,56,-1,45
Dungannon,1269,7,10,9,11,53,42,11,39
Glentoran,1269,8,9,9,12,35,41,-6,36
Ards,1269,9,8,4,18,34,56,-22,28
Portadown,1269,10,6,6,18,25,55,-30,24
Ballinamalla,1269,11,5,6,19,26,64,-38,21
Crusaders,1270,1,17,5,8,53,35,18,56
Ballymena,1270,2,17,4,9,65,58,7,55
Linfield,1270,3,15,8,7,67,29,38,53
Glenavon,1270,4,13,11,6,45,36,9,50
Cliftonville,1270,5,15,4,11,60,43,17,49
Coleraine,1270,6,10,9,11,39,42,-3,39
Dungannon,1270,7,10,8,12,52,49,3,38
Ards,1270,8,10,3,17,39,51,-12,33
Glentoran,1270,9,9,6,15,30,51,-21,33
Ballinamalla,1270,10,7,6,17,29,53,-24,27
Portadown,1270,11,7,6,17,23,55,-32,27
Crusaders,1271,1,18,7,5,63,38,25,61
Cliftonville,1271,2,17,3,10,52,39,13,54
Ballymena,1271,3,15,7,8,53,49,4,52
Linfield,1271,4,13,10,7,50,27,23,49
Glenavon,1271,5,12,8,10,51,49,2,44
Coleraine,1271,6,9,11,10,38,39,-1,38
Glentoran,1271,7,10,6,14,33,43,-10,36
Dungannon,1271,8,9,8,13,47,42,5,35
Ballinamalla,1271,9,9,5,16,28,54,-26,32
Ards,1271,10,7,7,16,35,50,-15,28
Portadown,1271,11,6,8,16,21,41,-20,26
Linfield,1272,1,18,7,5,65,28,37,61
Crusaders,1272,2,16,7,7,52,29,23,55
Ballymena,1272,3,15,5,10,57,55,2,50
Coleraine,1272,4,11,13,6,47,39,8,46
Cliftonville,1272,5,13,6,11,50,43,7,45
Glenavon,1272,6,11,11,8,48,48,0,44
Dungannon,1272,7,11,9,10,49,39,10,42
Portadown,1272,8,9,5,16,23,46,-23,32
Glentoran,1272,9,7,9,14,23,39,-16,30
Ballinamalla,1272,10,7,5,18,26,53,-27,26
Ards,1272,11,6,5,19,34,55,-21,23
Linfield,1273,1,17,9,4,58,25,33,60
Cliftonville,1273,2,17,3,10,54,42,12,54
Crusaders,1273,3,16,5,9,58,35,23,53
Glenavon,1273,4,13,10,7,48,43,5,49
Coleraine,1273,5,11,9,10,39,38,1,42
Ballymena,1273,6,11,6,13,48,58,-10,39
Ballinamalla,1273,7,11,5,14,37,44,-7,38
Glentoran,1273,8,10,6,14,26,39,-13,36
Dungannon,1273,9,7,9,14,44,50,-6,30
Ards,1273,10,8,6,16,36,51,-15,30
Portadown,1273,11,8,4,18,26,49,-23,28
Linfield,1274,1,15,10,5,64,35,29,55
Coleraine,1274,2,15,10,5,49,34,15,55
Ballymena,1274,3,17,4,9,69,59,10,55
Crusaders,1274,4,15,8,7,44,27,17,53
Cliftonville,1274,5,15,6,9,49,39,10,51
Glenavon,1274,6,12,9,9,52,47,5,45
Ards,1274,7,9,5,16,40,54,-14,32
Ballinamalla,1274,8,9,5,16,35,51,-16,32
Dungannon,1274,9,6,10,14,39,49,-10,28
Glentoran,1274,10,7,6,17,25,44,-19,27
Portadown,1274,11,6,5,19,25,52,-27,23
Cliftonville,1275,1,17,4,9,55,41,14,55
Crusaders,1275,2,15,8,7,49,31,18,53
Coleraine,1275,3,15,8,7,45,35,10,53
Ballymena,1275,4,14,5,11,56,55,1,47
Linfield,1275,5,12,9,9,50,29,21,45
Glenavon,1275,6,11,9,10,46,42,4,42
Dungannon,1275,7,10,8,12,49,42,7,38
Ards,1275,8,11,4,15,40,50,-10,37
Glentoran,1275,9,10,7,13,30,43,-13,37
Ballinamalla,1275,10,8,4,18,29,52,-23,28
Portadown,1275,11,7,4,19,22,51,-29,25
Linfield,1276,1,16,8,6,60,27,33,56
Crusaders,1276,2,15,7,8,49,38,11,52
Cliftonville,1276,3,15,6,9,49,39,10,51
Glenavon,1276,4,12,10,8,53,47,6,46
Coleraine,1276,5,11,10,9,43,36,7,43
Ballymena,1276,6,12,6,12,53,58,-5,42
Dungannon,1276,7,10,10,10,49,39,10,40
Ards,1276,8,10,5,15,34,48,-14,35
Glentoran,1276,9,9,6,15,31,46,-15,33
Ballinamalla,1276,10,10,3,17,30,49,-19,33
Portadown,1276,11,7,5,18,24,48,-24,26
Crusaders,1277,1,20,4,6,58,29,29,64
Ballymena,1277,2,16,6,8,55,49,6,54
Coleraine,1277,3,14,7,9,39,36,3,49
Linfield,1277,4,13,9,8,53,34,19,48
Cliftonville,1277,5,15,3,12,49,38,11,48
Glenavon,1277,6,10,10,10,42,50,-8,40
Ballinamalla,1277,7,10,4,16,27,42,-15,34
Dungannon,1277,8,8,9,13,42,45,-3,33
Ards,1277,9,9,6,15,39,48,-9,33
Portadown,1277,10,9,4,17,30,47,-17,31
Glentoran,1277,11,7,6,17,30,46,-16,27
Crusaders,1278,1,17,8,5,63,42,21,59
Cliftonville,1278,2,17,5,8,50,36,14,56
Linfield,1278,3,15,9,6,57,28,29,54
Glenavon,1278,4,14,10,6,53,41,12,52
Ballymena,1278,5,14,4,12,63,55,8,46
Coleraine,1278,6,9,12,9,43,43,0,39
Dungannon,1278,7,10,8,12,47,48,-1,38
Glentoran,1278,8,8,8,14,31,43,-12,32
Ballinamalla,1278,9,8,6,16,32,52,-20,30
Ards,1278,10,8,5,17,34,53,-19,29
Portadown,1278,11,4,7,19,25,57,-32,19
Crusaders,1279,1,17,7,6,57,34,23,58
Cliftonville,1279,2,18,3,9,56,36,20,57
Ballymena,1279,3,15,7,8,65,56,9,52
Linfield,1279,4,13,11,6,60,35,25,50
Coleraine,1279,5,13,9,8,50,45,5,48
Glenavon,1279,6,9,12,9,47,49,-2,39
Dungannon,1279,7,9,10,11,50,44,6,37
Glentoran,1279,8,7,10,13,30,49,-19,31
Portadown,1279,9,9,4,17,27,48,-21,31
Ards,1279,10,7,6,17,35,53,-18,27
Ballinamalla,1279,11,5,7,18,29,57,-28,22
Cliftonville,1280,1,17,5,8,51,37,14,56
Crusaders,1280,2,15,9,6,53,34,19,54
Linfield,1280,3,14,9,7,60,29,31,51
Coleraine,1280,4,14,8,8,49,39,10,50
Dungannon,1280,5,11,9,10,52,42,10,42
Ballymena,1280,6,13,3,14,49,65,-16,42
Glenavon,1280,7,9,14,7,47,42,5,41
Glentoran,1280,8,11,6,13,37,42,-5,39
Ards,1280,9,9,4,17,41,61,-20,31
Portadown,1280,10,9,2,19,22,43,-21,29
Ballinamalla,1280,11,6,5,19,29,56,-27,23
Crusaders,1281,1,16,9,5,56,38,18,57
Ballymena,1281,2,16,8,6,65,56,9,56
Coleraine,1281,3,12,13,5,49,36,13,49
Linfield,1281,4,12,9,9,58,36,22,45
Cliftonville,1281,5,13,6,11,57,53,4,45
Glenavon,1281,6,10,10,10,42,43,-1,40
Dungannon,1281,7,10,9,11,48,42,6,39
Ards,1281,8,10,6,14,40,43,-3,36
Glentoran,1281,9,8,9,13,30,42,-12,33
Portadown,1281,10,7,6,17,25,52,-27,27
Ballinamalla,1281,11,7,3,20,20,49,-29,24
Crusaders,1282,1,16,5,9,56,39,17,53
Cliftonville,1282,2,15,7,8,58,43,15,52
Linfield,1282,3,14,7,9,60,35,25,49
Ballymena,1282,4,15,4,11,54,56,-2,49
Glenavon,1282,5,12,12,6,56,50,6,48
Dungannon,1282,6,12,8,10,59,49,10,44
Coleraine,1282,7,9,11,10,41,45,-4,38
Glentoran,1282,8,9,7,14,31,47,-16,34
Ballinamalla,1282,9,8,7,15,36,51,-15,31
Ards,1282,10,8,6,16,37,50,-13,30
Portadown,1282,11,8,4,18,31,54,-23,28
Linfield,1283,1,16,8,6,68,41,27,56
Crusaders,1283,2,14,10,6,56,34,22,52
Glenavon,1283,3,14,10,6,51,40,11,52
Cliftonville,1283,4,15,4,11,52,41,11,49
Dungannon,1283,5,12,9,9,64,57,7,45
Ballymena,1283,6,13,5,12,65,59,6,44
Coleraine,1283,7,9,10,11,42,48,-6,37
Ballinamalla,1283,8,9,4,17,30,47,-17,31
Glentoran,1283,9,7,10,13,31,49,-18,31
Portadown,1283,10,8,6,16,26,52,-26,30
Ards,1283,11,7,6,17,36,53,-17,27
Linfield,1284,1,17,8,5,64,34,30,59
Crusaders,1284,2,15,8,7,55,34,21,53
Ballymena,1284,3,16,3,11,72,60,12,51
Glenavon,1284,4,12,11,7,45,43,2,47
Cliftonville,1284,5,13,7,10,56,45,11,46
Coleraine,1284,6,12,9,9,42,36,6,45
Dungannon,1284,7,9,10,11,48,41,7,37
Ards,1284,8,10,2,18,35,52,-17,32
Portadown,1284,9,7,9,14,27,44,-17,30
Glentoran,1284,10,7,8,15,26,52,-26,29
Ballinamalla,1284,11,7,5,18,24,53,-29,26
Linfield,1285,1,18,8,4,58,25,33,62
Crusaders,1285,2,17,6,7,60,37,23,57
Glenavon,1285,3,14,9,7,48,42,6,51
Cliftonville,1285,4,15,5,10,50,33,17,50
Ballymena,1285,5,13,5,12,60,60,0,44
Coleraine,1285,6,10,9,11,38,43,-5,39
Ards,1285,7,11,4,15,40,46,-6,37
Dungannon,1285,8,8,10,12,53,50,3,34
Portadown,1285,9,9,5,16,29,51,-22,32
Glentoran,1285,10,7,10,13,31,48,-17,31
Ballinamalla,1285,11,6,3,21,25,57,-32,21
Crusaders,1286,1,18,8,4,57,31,26,62
Linfield,1286,2,15,9,6,61,30,31,54
Cliftonville,1286,3,15,7,8,53,35,18,52
Glenavon,1286,4,13,8,9,53,50,3,47
Ballymena,1286,5,14,4,12,53,54,-1,46
Dungannon,1286,6,10,10,10,48,40,8,40
Coleraine,1286,7,9,8,13,42,47,-5,35
Glentoran,1286,8,9,8,13,33,46,-13,35
Ballinamalla,1286,9,8,7,15,30,47,-17,31
Ards,1286,10,8,4,18,30,49,-19,28
Portadown,1286,11,7,5,18,21,52,-31,26
Linfield,1287,1,15,10,5,60,34,26,55
Crusaders,1287,2,15,8,7,52,33,19,53
Cliftonville,1287,3,15,5,10,51,38,13,50
Ballymena,1287,4,12,7,11,58,60,-2,43
Glenavon,1287,5,11,10,9,43,45,-2,43
Dungannon,1287,6,9,10,11,47,43,4,37
Portadown,1287,7,11,4,15,35,42,-7,37
Coleraine,1287,8,9,9,12,39,40,-1,36
Glentoran,1287,9,8,10,12,35,49,-14,34
Ballinamalla,1287,10,10,4,16,33,55,-22,34
Ards,1287,11,8,7,15,37,51,-14,31
Crusaders,1288,1,17,9,4,63,32,31,60
Linfield,1288,2,17,7,6,57,24,33,58
Ballymena,1288,3,13,10,7,49,47,2,49
Dungannon,1288,4,10,11,9,51,40,11,41
Cliftonville,1288,5,11,7,12,45,50,-5,40
Glenavon,1288,6,9,10,11,50,51,-1,37
Glentoran,1288,7,10,7,13,39,48,-9,37
Coleraine,1288,8,8,12,10,35,41,-6,36
Portadown,1288,9,8,9,13,29,41,-12,33
Ards,1288,10,7,8,15,32,45,-13,29
Ballinamalla,1288,11,7,6,17,28,59,-31,27
Linfield,1289,1,17,8,5,62,27,35,59
Crusaders,1289,2,17,7,6,55,31,24,58
Cliftonville,1289,3,15,6,9,52,38,14,51
Coleraine,1289,4,13,11,6,42,34,8,50
Ballymena,1289,5,12,8,10,53,59,-6,44
Dungannon,1289,6,10,9,11,46,44,2,39
Glenavon,1289,7,9,9,12,50,51,-1,36
Ards,1289,8,10,2,18,40,51,-11,32
Ballinamalla,1289,9,10,2,18,33,55,-22,32
Glentoran,1289,10,7,7,16,31,51,-20,28
Portadown,1289,11,7,7,16,24,47,-23,28
Cliftonville,1290,1,15,7,8,59,39,20,52
Linfield,1290,2,14,9,7,56,32,24,51
Crusaders,1290,3,13,11,6,45,34,11,50
Coleraine,1290,4,12,11,7,39,28,11,47
Glenavon,1290,5,11,12,7,45,44,1,45
Ballymena,1290,6,13,5,12,54,59,-5,44
Glentoran,1290,7,10,10,10,40,44,-4,40
Dungannon,1290,8,8,11,11,47,45,2,35
Ards,1290,9,7,8,15,36,48,-12,29
Ballinamalla,1290,10,7,8,15,28,49,-21,29
Portadown,1290,11,7,4,19,24,51,-27,25
Crusaders,1291,1,18,9,3,57,30,27,63
Ballymena,1291,2,16,4,10,62,56,6,52
Glenavon,1291,3,14,9,7,52,39,13,51
Linfield,1291,4,13,10,7,57,37,20,49
Cliftonville,1291,5,13,7,10,48,41,7,46
Dungannon,1291,6,10,11,9,44,40,4,41
Coleraine,1291,7,10,10,10,41,36,5,40
Glentoran,1291,8,8,9,13,27,41,-14,33
Portadown,1291,9,9,5,16,29,44,-15,32
Ards,1291,10,8,4,18,39,56,-17,28
Ballinamalla,1291,11,4,6,20,25,61,-36,18
Linfield,1292,1,16,9,5,64,28,36,57
Crusaders,1292,2,16,8,6,62,41,21,56
Ballymena,1292,3,16,5,9,60,56,4,53
Cliftonville,1292,4,15,6,9,54,46,8,51
Ballinamalla,1292,5,11,5,14,43,52,-9,38
Coleraine,1292,6,8,13,9,38,36,2,37
Dungannon,1292,7,9,9,12,43,41,2,36
Ards,1292,8,9,8,13,46,51,-5,35
Glentoran,1292,9,7,10,13,30,50,-20,31
Portadown,1292,10,8,6,16,25,47,-22,30
Glenavon,1292,11,6,9,15,38,55,-17,27
Crusaders,1293,1,17,9,4,54,31,23,60
Linfield,1293,2,16,10,4,60,24,36,58
Cliftonville,1293,3,17,5,8,52,36,16,56
Glenavon,1293,4,13,12,5,46,35,11,51
Coleraine,1293,5,11,10,9,39,30,9,43
Ballymena,1293,6,12,6,12,51,54,-3,42
Dungannon,1293,7,8,11,11,48,51,-3,35
Glentoran,1293,8,8,6,16,27,52,-25,30
Ards,1293,9,8,5,17,41,49,-8,29
Portadown,1293,10,7,7,16,24,49,-25,28
Ballinamalla,1293,11,5,5,20,24,55,-31,20
Crusaders,1294,1,20,5,5,58,34,24,65
Cliftonville,1294,2,17,2,11,57,42,15,53
Ballymena,1294,3,16,5,9,56,55,1,53
Coleraine,1294,4,14,9,7,42,34,8,51
Linfield,1294,5,12,9,9,51,37,14,45
Dungannon,1294,6,9,9,12,47,41,6,36
Glenavon,1294,7,8,12,10,42,47,-5,36
Ballinamalla,1294,8,9,6,15,34,47,-13,33
Glentoran,1294,9,8,8,14,29,45,-16,32
Ards,1294,10,7,6,17,37,53,-16,27
Portadown,1294,11,7,5,18,24,42,-18,26
Cliftonville,1295,1,20,3,7,66,39,27,63
Linfield,1295,2,16,10,4,64,30,34,58
Crusaders,1295,3,14,7,9,57,46,11,49
Ballymena,1295,4,13,8,9,51,48,3,47
Glenavon,1295,5,12,9,9,46,44,2,45
Coleraine,1295,6,10,9,11,39,44,-5,39
Dungannon,1295,7,9,7,14,47,48,-1,34
Ards,1295,8,9,6,15,36,47,-11,33
Glentoran,1295,9,8,9,13,27,41,-14,33
Ballinamalla,1295,10,9,5,16,35,51,-16,32
Portadown,1295,11,6,5,19,19,49,-30,23
Crusaders,1296,1,17,5,8,57,38,19,56
Linfield,1296,2,16,6,8,52,28,24,54
Ballymena,1296,3,15,6,9,55,53,2,51
Glenavon,1296,4,13,9,8,50,50,0,48
Coleraine,1296,5,12,11,7,44,36,8,47
Cliftonville,1296,6,11,6,13,44,43,1,39
Ards,1296,7,10,6,14,46,48,-2,36
Portadown,1296,8,10,6,14,34,43,-9,36
Dungannon,1296,9,8,10,12,52,49,3,34
Glentoran,1296,10,7,9,14,24,42,-18,30
Ballinamalla,1296,11,7,4,19,28,56,-28,25
Crusaders,1297,1,16,8,6,54,34,20,56
Glenavon,1297,2,13,11,6,53,41,12,50
Ballymena,1297,3,14,6,10,56,60,-4,48
Cliftonville,1297,4,14,5,11,46,37,9,47
Linfield,1297,5,13,7,10,53,35,18,46
Dungannon,1297,6,12,9,9,51,37,14,45
Coleraine,1297,7,10,10,10,42,42,0,40
Glentoran,1297,8,8,9,13,26,39,-13,33
Portadown,1297,9,9,5,16,28,46,-18,32
Ards,1297,10,8,5,17,42,56,-14,29
Ballinamalla,1297,11,8,5,17,27,51,-24,29
Crusaders,1298,1,17,9,4,55,31,24,60
Cliftonville,1298,2,19,2,9,52,32,20,59
Linfield,1298,3,15,9,6,57,28,29,54
Glenavon,1298,4,12,9,9,49,48,1,45
Ballymena,1298,5,13,6,11,48,56,-8,45
Dungannon,1298,6,11,9,10,56,45,11,42
Ards,1298,7,12,4,14,44,47,-3,40
Coleraine,1298,8,10,7,13,39,43,-4,37
Glentoran,1298,9,7,7,16,36,54,-18,28
Ballinamalla,1298,10,7,6,17,30,56,-26,27
Portadown,1298,11,4,8,18,20,46,-26,20
Linfield,1299,1,14,9,7,58,33,25,51
Crusaders,1299,2,14,8,8,44,33,11,50
Cliftonville,1299,3,14,7,9,51,37,14,49
Ballymena,1299,4,14,5,11,53,55,-2,47
Coleraine,1299,5,12,10,8,40,35,5,46
Glenavon,1299,6,11,12,7,47,40,7,45
Portadown,1299,7,10,5,15,31,44,-13,35
Glentoran,1299,8,8,10,12,33,45,-12,34
Ards,1299,9,9,6,15,38,51,-13,33
Ballinamalla,1299,10,8,8,14,28,46,-18,32
Dungannon,1299,11,6,10,14,48,52,-4,28
Ballymena,1300,1,18,5,7,62,49,13,59
Crusaders,1300,2,15,8,7,57,42,15,53
Glenavon,1300,3,13,9,8,49,44,5,48
Linfield,1300,4,11,12,7,54,36,18,45
Coleraine,1300,5,10,13,7,39,31,8,43
Cliftonville,1300,6,12,7,11,46,44,2,43
Glentoran,1300,7,11,7,12,39,43,-4,40
Dungannon,1300,8,10,9,11,48,39,9,39
Ards,1300,9,10,5,15,38,53,-15,35
Portadown,1300,10,7,7,16,27,45,-18,28
Ballinamalla,1300,11,6,2,22,22,55,-33,20
Crusaders,1301,1,18,6,6,60,36,24,60
Cliftonville,1301,2,17,5,8,60,44,16,56
Linfield,1301,3,15,8,7,59,33,26,53
Ballymena,1301,4,15,5,10,62,55,7,50
Glenavon,1301,5,10,15,5,52,45,7,45
Coleraine,1301,6,11,8,11,45,47,-2,41
Dungannon,1301,7,9,11,10,53,42,11,38
Glentoran,1301,8,8,7,15,29,54,-25,31
Portadown,1301,9,7,7,16,28,43,-15,28
Ards,1301,10,7,5,18,38,62,-24,26
Ballinamalla,1301,11,7,5,18,32,57,-25,26
Crusaders,1302,1,18,7,5,63,38,25,61
Linfield,1302,2,15,10,5,64,32,32,55
Cliftonville,1302,3,16,4,10,52,40,12,52
Ballymena,1302,4,16,4,10,66,56,10,52
Coleraine,1302,5,10,14,6,45,41,4,44
Glentoran,1302,6,11,7,12,38,40,-2,40
Glenavon,1302,7,9,11,10,44,49,-5,38
Dungannon,1302,8,9,7,14,49,52,-3,34
Ards,1302,9,9,4,17,33,53,-20,31
Portadown,1302,10,8,5,17,28,48,-20,29
Ballinamalla,1302,11,6,3,21,32,65,-33,21
Crusaders,1303,1,16,5,9,55,37,18,53
Linfield,1303,2,14,9,7,55,29,26,51
Dungannon,1303,3,14,9,7,55,33,22,51
Cliftonville,1303,4,14,6,10,54,43,11,48
Glenavon,1303,5,12,11,7,54,43,11,47
Ballymena,1303,6,14,4,12,59,67,-8,46
Coleraine,1303,7,11,12,7,43,41,2,45
Glentoran,1303,8,8,9,13,31,46,-15,33
Portadown,1303,9,8,7,15,26,45,-19,31
Ards,1303,10,7,5,18,32,51,-19,26
Ballinamalla,1303,11,6,5,19,26,55,-29,23
Crusaders,1304,1,17,7,6,53,29,24,58
Cliftonville,1304,2,17,6,7,56,34,22,57
Ballymena,1304,3,15,5,10,58,55,3,50
Coleraine,1304,4,13,9,8,45,42,3,48
Linfield,1304,5,12,11,7,60,37,23,47
Glenavon,1304,6,10,12,8,44,45,-1,42
Dungannon,1304,7,10,8,12,52,43,9,38
Glentoran,1304,8,8,9,13,34,50,-16,33
Ards,1304,9,8,6,16,35,51,-16,30
Portadown,1304,10,7,9,14,31,48,-17,30
Ballinamalla,1304,11,5,4,21,22,56,-34,19
Cliftonville,1305,1,17,5,8,58,39,19,56
Linfield,1305,2,16,7,7,59,39,20,55
Crusaders,1305,3,15,9,6,53,32,21,54
Dungannon,1305,4,12,11,7,61,37,24,47
Ballymena,1305,5,12,8,10,57,57,0,44
Coleraine,1305,6,10,13,7,44,42,2,43
Glentoran,1305,7,8,11,11,32,43,-11,35
Glenavon,1305,8,9,7,14,50,56,-6,34
Portadown,1305,9,8,7,15,26,45,-19,31
Ards,1305,10,8,5,17,41,58,-17,29
Ballinamalla,1305,11,6,5,19,26,59,-33,23
Crusaders,1306,1,16,7,7,56,36,20,55
Linfield,1306,2,14,10,6,63,34,29,52
Cliftonville,1306,3,15,6,9,59,39,20,51
Glenavon,1306,4,12,10,8,49,41,8,46
Coleraine,1306,5,11,12,7,49,43,6,45
Ballymena,1306,6,12,9,9,58,56,2,45
Glentoran,1306,7,11,7,12,29,40,-11,40
Portadown,1306,8,9,8,13,31,46,-15,35
Dungannon,1306,9,7,10,13,43,48,-5,31
Ards,1306,10,7,6,17,33,52,-19,27
Ballinamalla,1306,11,7,3,20,23,58,-35,24
Crusaders,1307,1,16,10,4,55,31,24,58
Cliftonville,1307,2,17,5,8,51,30,21,56
Linfield,1307,3,14,11,5,60,33,27,53
Coleraine,1307,4,11,14,5,44,34,10,47
Ballymena,1307,5,14,5,11,61,61,0,47
Glenavon,1307,6,11,10,9,52,50,2,43
Dungannon,1307,7,10,9,11,51,49,2,39
Portadown,1307,8,9,4,17,25,44,-19,31
Glentoran,1307,9,8,6,16,32,53,-21,30
Ards,1307,10,6,8,16,35,54,-19,26
Ballinamalla,1307,11,7,2,21,31,58,-27,23
Crusaders,1308,1,17,9,4,62,35,27,60
Coleraine,1308,2,16,9,5,45,28,17,57
Ballymena,1308,3,15,7,8,60,47,13,52
Glenavon,1308,4,13,10,7,46,41,5,49
Linfield,1308,5,11,13,6,55,34,21,46
Cliftonville,1308,6,13,7,10,45,36,9,46
Ards,1308,7,10,4,16,36,52,-16,34
Glentoran,1308,8,7,10,13,34,51,-17,31
Dungannon,1308,9,6,10,14,41,50,-9,28
Portadown,1308,10,5,8,17,23,46,-23,23
Ballinamalla,1308,11,6,5,19,32,59,-27,23
Crusaders,1309,1,17,7,6,56,35,21,58
Cliftonville,1309,2,16,4,10,56,46,10,52
Ballymena,1309,3,16,4,10,57,54,3,52
Linfield,1309,4,13,7,10,55,37,18,46
Coleraine,1309,5,12,9,9,42,35,7,45
Glenavon,1309,6,9,14,7,45,42,3,41
Glentoran,1309,7,10,7,13,34,45,-11,37
Ards,1309,8,10,4,16,42,52,-10,34
Dungannon,1309,9,6,13,11,44,46,-2,31
Ballinamalla,1309,10,9,4,17,30,47,-17,31
Portadown,1309,11,8,5,17,23,45,-22,29
Crusaders,1310,1,16,7,7,56,35,21,55
Cliftonville,1310,2,17,4,9,53,39,14,55
Ballymena,1310,3,16,6,8,68,55,13,54
Glenavon,1310,4,13,8,9,51,47,4,47
Linfield,1310,5,12,9,9,55,40,15,45
Coleraine,1310,6,10,11,9,42,43,-1,41
Ards,1310,7,11,5,14,41,45,-4,38
Dungannon,1310,8,8,12,10,53,48,5,36
Portadown,1310,9,8,6,16,25,46,-21,30
Ballinamalla,1310,10,7,6,17,32,57,-25,27
Glentoran,1310,11,5,10,15,34,55,-21,25
Crusaders,1311,1,18,7,5,57,37,20,61
Dungannon,1311,2,13,10,7,58,42,16,49
Linfield,1311,3,12,11,7,58,36,22,47
Cliftonville,1311,4,13,8,9,58,42,16,47
Glenavon,1311,5,11,12,7,50,46,4,45
Coleraine,1311,6,11,10,9,44,35,9,43
Ballymena,1311,7,12,6,12,60,65,-5,42
Ards,1311,8,9,8,13,39,49,-10,35
Glentoran,1311,9,9,7,14,32,49,-17,34
Ballinamalla,1311,10,6,8,16,28,56,-28,26
Portadown,1311,11,5,5,20,24,51,-27,20
Linfield,1312,1,18,8,4,62,26,36,62
Crusaders,1312,2,13,12,5,53,34,19,51
Cliftonville,1312,3,14,7,9,52,39,13,49
Ballymena,1312,4,14,6,10,57,59,-2,48
Glenavon,1312,5,11,11,8,52,49,3,44
Coleraine,1312,6,10,11,9,39,34,5,41
Glentoran,1312,7,10,8,12,35,44,-9,38
Dungannon,1312,8,8,11,11,52,49,3,35
Ards,1312,9,10,3,17,35,48,-13,33
Portadown,1312,10,8,4,18,28,51,-23,28
Ballinamalla,1312,11,5,7,18,30,62,-32,22
Crusaders,1313,1,18,7,5,59,30,29,61
Linfield,1313,2,17,8,5,66,29,37,59
Coleraine,1313,3,13,9,8,43,38,5,48
Cliftonville,1313,4,14,5,11,55,46,9,47
Glenavon,1313,5,12,11,7,49,45,4,47
Ballymena,1313,6,13,5,12,59,59,0,44
Portadown,1313,7,11,3,16,29,44,-15,36
Dungannon,1313,8,8,7,15,45,57,-12,31
Glentoran,1313,9,8,7,15,32,48,-16,31
Ballinamalla,1313,10,8,5,17,35,54,-19,29
Ards,1313,11,7,5,18,32,54,-22,26
Crusaders,1314,1,16,9,5,52,30,22,57
Coleraine,1314,2,13,12,5,48,34,14,51
Cliftonville,1314,3,14,8,8,51,37,14,50
Glenavon,1314,4,14,8,8,49,43,6,50
Linfield,1314,5,13,10,7,54,33,21,49
Ballymena,1314,6,10,8,12,53,60,-7,38
Glentoran,1314,7,10,8,12,34,43,-9,38
Dungannon,1314,8,8,11,11,46,44,2,35
Portadown,1314,9,8,7,15,25,45,-20,31
Ballinamalla,1314,10,6,8,16,29,49,-20,26
Ards,1314,11,5,7,18,29,52,-23,22
Crusaders,1315,1,16,8,6,55,34,21,56
Coleraine,1315,2,15,8,7,43,27,16,53
Cliftonville,1315,3,16,5,9,52,42,10,53
Linfield,1315,4,14,10,6,58,33,25,52
Ballymena,1315,5,15,4,11,54,56,-2,49
Glenavon,1315,6,13,9,8,45,43,2,48
Dungannon,1315,7,11,8,11,56,47,9,41
Ards,1315,8,9,8,13,36,43,-7,35
Ballinamalla,1315,9,7,6,17,41,55,-14,27
Glentoran,1315,10,6,5,19,21,54,-33,23
Portadown,1315,11,5,5,20,19,46,-27,20
Crusaders,1316,1,15,10,5,57,36,21,55
Cliftonville,1316,2,15,6,9,54,43,11,51
Linfield,1316,3,13,11,6,58,33,25,50
Ballymena,1316,4,13,9,8,67,60,7,48
Coleraine,1316,5,12,9,9,43,41,2,45
Dungannon,1316,6,11,8,11,51,42,9,41
Glenavon,1316,7,9,12,9,45,48,-3,39
Ballinamalla,1316,8,12,3,15,44,53,-9,39
Glentoran,1316,9,7,8,15,28,49,-21,29
Portadown,1316,10,7,7,16,28,49,-21,28
Ards,1316,11,7,5,18,32,53,-21,26
Linfield,1317,1,15,9,6,57,30,27,54
Ballymena,1317,2,14,9,7,57,54,3,51
Cliftonville,1317,3,15,5,10,53,39,14,50
Glenavon,1317,4,13,11,6,50,38,12,50
Crusaders,1317,5,12,9,9,42,43,-1,45
Coleraine,1317,6,11,10,9,40,41,-1,43
Dungannon,1317,7,10,10,10,62,45,17,40
Glentoran,1317,8,9,10,11,30,37,-7,37
Ards,1317,9,8,5,17,33,52,-19,29
Ballinamalla,1317,10,9,2,19,34,57,-23,29
Portadown,1317,11,6,6,18,23,45,-22,24
Crusaders,1318,1,17,7,6,54,27,27,58
Cliftonville,1318,2,15,7,8,51,35,16,52
Linfield,1318,3,12,10,8,46,27,19,46
Coleraine,1318,4,12,10,8,43,41,2,46
Ballymena,1318,5,13,7,10,53,54,-1,46
Glenavon,1318,6,10,11,9,46,42,4,41
Glentoran,1318,7,8,11,11,28,41,-13,35
Ballinamalla,1318,8,9,7,14,31,46,-15,34
Dungannon,1318,9,8,9,13,45,50,-5,33
Portadown,1318,10,9,4,17,23,44,-21,31
Ards,1318,11,7,7,16,35,48,-13,28
Crusaders,1319,1,17,8,5,59,35,24,59
Glenavon,1319,2,13,12,5,56,41,15,51
Cliftonville,1319,3,15,4,11,52,45,7,49
Linfield,1319,4,13,9,8,57,34,23,48
Coleraine,1319,5,12,12,6,46,38,8,48
Dungannon,1319,6,10,12,8,54,43,11,42
Ballymena,1319,7,10,9,11,51,61,-10,39
Ballinamalla,1319,8,9,6,15,34,49,-15,33
Glentoran,1319,9,8,6,16,28,48,-20,30
Portadown,1319,10,6,8,16,25,46,-21,26
Ards,1319,11,8,2,20,33,55,-22,26
Crusaders,1320,1,17,5,8,56,35,21,56
Cliftonville,1320,2,17,5,8,54,37,17,56
Ballymena,1320,3,15,8,7,72,53,19,53
Linfield,1320,4,14,8,8,51,30,21,50
Glentoran,1320,5,11,9,10,34,38,-4,42
Coleraine,1320,6,9,13,8,37,39,-2,40
Glenavon,1320,7,10,10,10,42,46,-4,40
Ards,1320,8,10,6,14,36,47,-11,36
Dungannon,1320,9,8,9,13,45,45,0,33
Portadown,1320,10,7,5,18,24,53,-29,26
Ballinamalla,1320,11,5,6,19,25,53,-28,21
Crusaders,1321,1,18,8,4,59,32,27,62
Ballymena,1321,2,17,6,7,65,50,15,57
Linfield,1321,3,15,8,7,54,28,26,53
Glenavon,1321,4,11,11,8,50,50,0,44
Cliftonville,1321,5,12,7,11,46,39,7,43
Coleraine,1321,6,9,9,12,36,44,-8,36
Portadown,1321,7,9,8,13,30,42,-12,35
Ards,1321,8,10,4,16,41,47,-6,34
Dungannon,1321,9,7,10,13,45,50,-5,31
Glentoran,1321,10,8,7,15,28,45,-17,31
Ballinamalla,1321,11,7,6,17,28,55,-27,27
Crusaders,1322,1,16,8,6,53,27,26,56
Cliftonville,1322,2,16,3,11,49,42,7,51
Ballymena,1322,3,15,6,9,60,54,6,51
Linfield,1322,4,11,12,7,54,36,18,45
Dungannon,1322,5,12,9,9,53,40,13,45
Ards,1322,6,13,5,12,45,46,-1,44
Glenavon,1322,7,9,11,10,42,46,-4,38
Coleraine,1322,8,9,10,11,41,42,-1,37
Glentoran,1322,9,10,7,13,33,44,-11,37
Ballinamalla,1322,10,8,4,18,24,49,-25,28
Portadown,1322,11,6,5,19,19,47,-28,23
Cliftonville,1323,1,17,4,9,54,41,13,55
Crusaders,1323,2,15,6,9,54,43,11,51
Glenavon,1323,3,13,10,7,53,45,8,49
Linfield,1323,4,12,12,6,49,25,24,48
Coleraine,1323,5,13,8,9,47,35,12,47
Ballymena,1323,6,13,8,9,50,52,-2,47
Glentoran,1323,7,11,9,10,38,40,-2,42
Dungannon,1323,8,9,10,11,45,44,1,37
Portadown,1323,9,9,6,15,28,43,-15,33
Ards,1323,10,7,5,18,37,53,-16,26
Ballinamalla,1323,11,5,4,21,23,57,-34,19
Linfield,1324,1,16,10,4,60,24,36,58
Crusaders,1324,2,15,8,7,57,34,23,53
Glenavon,1324,3,13,9,8,50,42,8,48
Cliftonville,1324,4,13,8,9,51,44,7,47
Ballymena,1324,5,12,7,11,59,61,-2,43
Ards,1324,6,12,6,12,42,44,-2,42
Coleraine,1324,7,9,10,11,34,43,-9,37
Portadown,1324,8,9,7,14,32,47,-15,34
Dungannon,1324,9,7,11,12,43,41,2,32
Ballinamalla,1324,10,9,4,17,33,52,-19,31
Glentoran,1324,11,6,8,16,29,58,-29,26
Crusaders,1325,1,21,6,3,60,28,32,69
Ballymena,1325,2,16,6,8,60,53,7,54
Cliftonville,1325,3,15,5,10,54,37,17,50
Linfield,1325,4,12,11,7,50,32,18,47
Dungannon,1325,5,12,9,9,52,36,16,45
Glenavon,1325,6,8,12,10,41,45,-4,36
Coleraine,1325,7,8,11,11,38,49,-11,35
Glentoran,1325,8,8,9,13,31,50,-19,33
Ards,1325,9,9,4,17,38,49,-11,31
Portadown,1325,10,9,4,17,29,46,-17,31
Ballinamalla,1325,11,6,5,19,28,56,-28,23
Crusaders,1326,1,15,9,6,55,34,21,54
Cliftonville,1326,2,17,3,10,55,37,18,54
Linfield,1326,3,15,8,7,54,32,22,53
Coleraine,1326,4,13,12,5,52,37,15,51
Glenavon,1326,5,10,14,6,46,44,2,44
Dungannon,1326,6,9,12,9,48,41,7,39
Ballymena,1326,7,11,6,13,49,57,-8,39
Glentoran,1326,8,9,5,16,32,49,-17,32
Ards,1326,9,8,6,16,35,55,-20,30
Ballinamalla,1326,10,7,7,16,30,50,-20,28
Portadown,1326,11,6,8,16,26,46,-20,26
Crusaders,1327,1,17,6,7,57,34,23,57
Linfield,1327,2,14,11,5,53,24,29,53
Cliftonville,1327,3,15,6,9,56,41,15,51
Coleraine,1327,4,12,10,8,41,36,5,46
Glenavon,1327,5,10,11,9,44,51,-7,41
Ballymena,1327,6,11,7,12,54,59,-5,40
Dungannon,1327,7,9,12,9,52,43,9,39
Ards,1327,8,11,5,14,35,39,-4,38
Ballinamalla,1327,9,9,5,16,29,48,-19,32
Glentoran,1327,10,8,6,16,24,47,-23,30
Portadown,1327,11,7,5,18,22,45,-23,26
Crusaders,1328,1,17,6,7,57,34,23,57
Ballymena,1328,2,16,7,7,51,49,2,55
Cliftonville,1328,3,15,6,9,56,37,19,51
Linfield,1328,4,13,10,7,59,40,19,49
Dungannon,1328,5,10,9,11,49,42,7,39
Coleraine,1328,6,9,11,10,39,40,-1,38
Glenavon,1328,7,9,11,10,43,46,-3,38
Glentoran,1328,8,10,6,14,32,40,-8,36
Ards,1328,9,8,8,14,31,42,-11,32
Portadown,1328,10,8,5,17,25,49,-24,29
Ballinamalla,1328,11,7,7,16,32,55,-23,28
Crusaders,1329,1,20,6,4,57,26,31,66
Glenavon,1329,2,15,9,6,55,36,19,54
Linfield,1329,3,14,10,6,60,35,25,52
Cliftonville,1329,4,14,6,10,49,42,7,48
Ballymena,1329,5,12,6,12,52,63,-11,42
Coleraine,1329,6,10,8,12,40,42,-2,38
Ards,1329,7,10,7,13,42,47,-5,37
Ballinamalla,1329,8,10,4,16,28,47,-19,34
Dungannon,1329,9,8,9,13,52,54,-2,33
Glentoran,1329,10,7,10,13,31,45,-14,31
Portadown,1329,11,4,7,19,21,50,-29,19
Crusaders,1330,1,17,9,4,56,37,19,60
Linfield,1330,2,13,11,6,57,34,23,50
Cliftonville,1330,3,15,3,12,56,46,10,48
Coleraine,1330,4,13,9,8,44,35,9,48
Glenavon,1330,5,12,10,8,46,44,2,46
Ballymena,1330,6,13,6,11,58,62,-4,45
Dungannon,1330,7,11,11,8,57,43,14,44
Glentoran,1330,8,10,8,12,35,43,-8,38
Portadown,1330,9,7,5,18,26,44,-18,26
Ballinamalla,1330,10,7,4,19,28,56,-28,25
Ards,1330,11,6,6,18,35,54,-19,24
Crusaders,1331,1,15,11,4,63,35,28,56
Linfield,1331,2,16,8,6,52,30,22,56
Glenavon,1331,3,15,9,6,61,41,20,54
Coleraine,1331,4,14,10,6,45,36,9,52
Cliftonville,1331,5,14,8,8,41,35,6,50
Ballymena,1331,6,14,7,9,59,55,4,49
Dungannon,1331,7,9,8,13,51,48,3,35
Ards,1331,8,9,5,16,35,52,-17,32
Portadown,1331,9,6,6,18,21,45,-24,24
Glentoran,1331,10,6,6,18,23,48,-25,24
Ballinamalla,1331,11,6,4,20,30,56,-26,22
Cliftonville,1332,1,17,7,6,55,33,22,58
Ballymena,1332,2,15,5,10,62,56,6,50
Crusaders,1332,3,13,9,8,47,37,10,48
Glenavon,1332,4,13,8,9,51,47,4,47
Linfield,1332,5,11,11,8,49,28,21,44
Dungannon,1332,6,12,7,11,49,37,12,43
Coleraine,1332,7,11,10,9,42,40,2,43
Glentoran,1332,8,11,6,13,39,49,-10,39
Ards,1332,9,8,8,14,33,48,-15,32
Ballinamalla,1332,10,9,1,20,36,59,-23,28
Portadown,1332,11,6,6,18,19,48,-29,24
Crusaders,1333,1,18,6,6,54,33,21,60
Linfield,1333,2,15,7,8,66,37,29,52
Ballymena,1333,3,15,3,12,63,64,-1,48
Cliftonville,1333,4,14,4,12,53,46,7,46
Coleraine,1333,5,13,7,10,47,45,2,46
Glenavon,1333,6,12,9,9,52,46,6,45
Dungannon,1333,7,11,8,11,54,45,9,41
Glentoran,1333,8,11,7,12,34,48,-14,40
Ards,1333,9,11,5,14,41,47,-6,38
Ballinamalla,1333,10,9,3,18,32,52,-20,30
Portadown,1333,11,5,3,22,25,58,-33,18
Ballymena,1334,1,16,5,9,65,58,7,53
Linfield,1334,2,14,10,6,59,31,28,52
Crusaders,1334,3,15,6,9,61,41,20,51
Coleraine,1334,4,10,15,5,44,37,7,45
Cliftonville,1334,5,12,7,11,49,46,3,43
Glenavon,1334,6,10,13,7,46,44,2,43
Dungannon,1334,7,11,9,10,50,41,9,42
Glentoran,1334,8,9,5,16,30,47,-17,32
Ards,1334,9,8,6,16,41,57,-16,30
Ballinamalla,1334,10,8,6,16,31,49,-18,30
Portadown,1334,11,8,6,16,30,55,-25,30
Crusaders,1335,1,15,8,7,57,42,15,53
Cliftonville,1335,2,14,7,9,50,41,9,49
Glenavon,1335,3,13,8,9,48,43,5,47
Ballymena,1335,4,13,8,9,54,55,-1,47
Linfield,1335,5,12,9,9,57,38,19,45
Coleraine,1335,6,12,8,10,43,37,6,44
Dungannon,1335,7,11,9,10,50,39,11,42
Glentoran,1335,8,8,9,13,40,51,-11,33
Ards,1335,9,10,3,17,42,58,-16,33
Portadown,1335,10,9,5,16,30,45,-15,32
Ballinamalla,1335,11,9,4,17,29,51,-22,31
Linfield,1336,1,17,8,5,69,29,40,59
Cliftonville,1336,2,16,5,9,54,40,14,53
Crusaders,1336,3,15,7,8,49,38,11,52
Glenavon,1336,4,11,15,4,51,39,12,48
Ballymena,1336,5,14,6,10,58,57,1,48
Dungannon,1336,6,9,12,9,49,41,8,39
Coleraine,1336,7,9,11,10,37,43,-6,38
Ards,1336,8,9,9,12,33,39,-6,36
Glentoran,1336,9,8,8,14,31,45,-14,32
Ballinamalla,1336,10,5,7,18,27,54,-27,22
Portadown,1336,11,4,8,18,26,59,-33,20
Linfield,1337,1,14,10,6,62,30,32,52
Ballymena,1337,2,15,6,9,53,51,2,51
Crusaders,1337,3,14,8,8,48,37,11,50
Cliftonville,1337,4,14,5,11,55,48,7,47
Dungannon,1337,5,12,8,10,53,42,11,44
Coleraine,1337,6,12,8,10,44,43,1,44
Glentoran,1337,7,11,8,11,40,42,-2,41
Ards,1337,8,10,8,12,43,45,-2,38
Glenavon,1337,9,9,9,12,43,51,-8,36
Ballinamalla,1337,10,8,4,18,32,55,-23,28
Portadown,1337,11,7,4,19,25,54,-29,25
Crusaders,1338,1,15,8,7,52,34,18,53
Cliftonville,1338,2,16,4,10,56,39,17,52
Linfield,1338,3,14,9,7,59,33,26,51
Ballymena,1338,4,15,6,9,57,58,-1,51
Glenavon,1338,5,13,11,6,53,42,11,50
Coleraine,1338,6,10,12,8,40,36,4,42
Glentoran,1338,7,10,8,12,36,49,-13,38
Dungannon,1338,8,9,8,13,50,50,0,35
Ards,1338,9,7,9,14,32,44,-12,30
Portadown,1338,10,8,4,18,28,48,-20,28
Ballinamalla,1338,11,6,5,19,31,61,-30,23
Linfield,1339,1,16,7,7,59,33,26,55
Cliftonville,1339,2,17,4,9,58,40,18,55
Ballymena,1339,3,15,7,8,62,57,5,52
Glenavon,1339,4,12,10,8,56,51,5,46
Crusaders,1339,5,12,8,10,50,38,12,44
Coleraine,1339,6,10,9,11,45,48,-3,39
Ards,1339,7,12,3,15,35,50,-15,39
Dungannon,1339,8,9,8,13,55,49,6,35
Glentoran,1339,9,9,8,13,32,46,-14,35
Portadown,1339,10,9,3,18,28,49,-21,30
Ballinamalla,1339,11,8,5,17,31,50,-19,29
Crusaders,1340,1,18,7,5,55,29,26,61
Linfield,1340,2,14,9,7,59,42,17,51
Cliftonville,1340,3,15,4,11,50,41,9,49
Ballymena,1340,4,13,6,11,57,59,-2,45
Dungannon,1340,5,11,9,10,55,43,12,42
Coleraine,1340,6,10,11,9,38,39,-1,41
Glenavon,1340,7,9,9,12,47,48,-1,36
Glentoran,1340,8,9,8,13,36,47,-11,35
Ballinamalla,1340,9,10,5,15,33,48,-15,35
Ards,1340,10,9,5,16,38,51,-13,32
Portadown,1340,11,8,5,17,29,50,-21,29
Crusaders,1341,1,15,10,5,51,29,22,55
Coleraine,1341,2,15,9,6,49,31,18,54
Cliftonville,1341,3,17,3,10,49,35,14,54
Linfield,1341,4,15,8,7,52,30,22,53
Ballymena,1341,5,14,6,10,50,52,-2,48
Dungannon,1341,6,11,8,11,51,41,10,41
Glenavon,1341,7,8,10,12,43,52,-9,34
Ballinamalla,1341,8,11,1,18,29,51,-22,34
Portadown,1341,9,9,5,16,31,48,-17,32
Ards,1341,10,7,6,17,38,51,-13,27
Glentoran,1341,11,6,8,16,23,46,-23,26
Crusaders,1342,1,20,4,6,63,29,34,64
Cliftonville,1342,2,17,4,9,57,38,19,55
Linfield,1342,3,15,8,7,60,36,24,53
Ballymena,1342,4,15,5,10,59,55,4,50
Glenavon,1342,5,11,10,9,44,44,0,43
Dungannon,1342,6,11,9,10,50,44,6,42
Coleraine,1342,7,10,10,10,37,39,-2,40
Glentoran,1342,8,6,11,13,26,42,-16,29
Portadown,1342,9,7,6,17,22,44,-22,27
Ards,1342,10,6,8,16,29,51,-22,26
Ballinamalla,1342,11,6,7,17,26,51,-25,25
Crusaders,1343,1,17,7,6,52,30,22,58
Cliftonville,1343,2,15,8,7,58,38,20,53
Linfield,1343,3,13,11,6,48,24,24,50
Coleraine,1343,4,13,8,9,48,43,5,47
Glenavon,1343,5,10,10,10,53,54,-1,40
Ballymena,1343,6,12,4,14,59,66,-7,40
Glentoran,1343,7,10,8,12,27,40,-13,38
Dungannon,1343,8,9,8,13,46,46,0,35
Ards,1343,9,9,5,16,37,45,-8,32
Portadown,1343,10,9,5,16,25,44,-19,32
Ballinamalla,1343,11,9,4,17,34,57,-23,31
Cliftonville,1344,1,17,5,8,63,34,29,56
Glenavon,1344,2,13,11,6,54,39,15,50
Crusaders,1344,3,14,8,8,49,38,11,50
Dungannon,1344,4,14,6,10,51,41,10,48
Linfield,1344,5,13,8,9,58,39,19,47
Coleraine,1344,6,10,12,8,40,37,3,42
Ballymena,1344,7,10,5,15,49,75,-26,35
Ards,1344,8,9,7,14,42,47,-5,34
Portadown,1344,9,9,6,15,28,42,-14,33
Glentoran,1344,10,9,5,16,28,47,-19,32
Ballinamalla,1344,11,9,3,18,26,49,-23,30
Linfield,1345,1,15,8,7,52,29,23,53
Cliftonville,1345,2,16,5,9,57,38,19,53
Ballymena,1345,3,16,3,11,61,57,4,51
Crusaders,1345,4,13,10,7,50,45,5,49
Glenavon,1345,5,12,10,8,48,42,6,46
Glentoran,1345,6,11,8,11,31,34,-3,41
Coleraine,1345,7,10,10,10,45,45,0,40
Dungannon,1345,8,10,9,11,52,47,5,39
Ards,1345,9,8,6,16,36,53,-17,30
Portadown,1345,10,6,10,14,25,43,-18,28
Ballinamalla,1345,11,6,5,19,26,50,-24,23
Cliftonville,1346,1,16,6,8,55,37,18,54
Linfield,1346,2,14,11,5,64,32,32,53
Crusaders,1346,3,14,11,5,54,30,24,53
Coleraine,1346,4,15,8,7,45,34,11,53
Ballymena,1346,5,15,4,11,63,62,1,49
Glenavon,1346,6,10,12,8,43,44,-1,42
Dungannon,1346,7,8,11,11,49,48,1,35
Glentoran,1346,8,9,8,13,25,42,-17,35
Ballinamalla,1346,9,8,6,16,36,53,-17,30
Ards,1346,10,8,4,18,38,60,-22,28
Portadown,1346,11,5,5,20,21,51,-30,20
Crusaders,1347,1,21,5,4,60,27,33,68
Linfield,1347,2,15,10,5,64,32,32,55
Ballymena,1347,3,14,4,12,60,62,-2,46
Cliftonville,1347,4,13,6,11,50,47,3,45
Glenavon,1347,5,10,10,10,41,41,0,40
Ards,1347,6,11,6,13,45,44,1,39
Coleraine,1347,7,9,11,10,38,46,-8,38
Dungannon,1347,8,9,10,11,49,42,7,37
Glentoran,1347,9,8,9,13,32,43,-11,33
Portadown,1347,10,8,8,14,30,49,-19,32
Ballinamalla,1347,11,5,5,20,28,64,-36,20
Linfield,1348,1,17,8,5,61,27,34,59
Crusaders,1348,2,16,6,8,53,32,21,54
Cliftonville,1348,3,15,5,10,56,39,17,50
Ballymena,1348,4,14,7,9,56,55,1,49
Glenavon,1348,5,11,13,6,52,45,7,46
Dungannon,1348,6,11,9,10,55,51,4,42
Coleraine,1348,7,10,9,11,41,42,-1,39
Glentoran,1348,8,11,5,14,36,49,-13,38
Ards,1348,9,9,4,17,32,49,-17,31
Portadown,1348,10,8,5,17,27,48,-21,29
Ballinamalla,1348,11,6,3,21,28,60,-32,21
Crusaders,1349,1,18,9,3,61,33,28,63
Linfield,1349,2,15,8,7,63,34,29,53
Ballymena,1349,3,15,6,9,61,53,8,51
Glenavon,1349,4,13,10,7,60,51,9,49
Cliftonville,1349,5,13,5,12,54,48,6,44
Coleraine,1349,6,11,8,11,41,48,-7,41
Dungannon,1349,7,10,8,12,50,46,4,38
Portadown,1349,8,10,4,16,29,46,-17,34
Glentoran,1349,9,8,7,15,32,47,-15,31
Ards,1349,10,9,4,17,44,60,-16,31
Ballinamalla,1349,11,7,3,20,34,63,-29,24
Crusaders,1350,1,15,8,7,53,34,19,53
Ballymena,1350,2,14,7,9,59,57,2,49
Cliftonville,1350,3,13,8,9,53,38,15,47
Glenavon,1350,4,12,11,7,53,48,5,47
Linfield,1350,5,10,12,8,49,37,12,42
Coleraine,1350,6,10,12,8,47,39,8,42
Dungannon,1350,7,11,9,10,50,45,5,42
Glentoran,1350,8,9,8,13,33,42,-9,35
Ards,1350,9,9,5,16,37,48,-11,32
Portadown,1350,10,9,4,17,29,52,-23,31
Ballinamalla,1350,11,9,4,17,27,50,-23,31
Linfield,1351,1,15,11,4,58,25,33,56
Cliftonville,1351,2,16,5,9,62,42,20,53
Ballymena,1351,3,15,6,9,58,54,4,51
Crusaders,1351,4,13,10,7,50,37,13,49
Glenavon,1351,5,12,11,7,49,47,2,47
Dungannon,1351,6,11,10,9,54,45,9,43
Coleraine,1351,7,10,11,9,39,36,3,41
Glentoran,1351,8,7,10,13,26,40,-14,31
Portadown,1351,9,9,4,17,27,50,-23,31
Ballinamalla,1351,10,7,6,17,29,52,-23,27
Ards,1351,11,5,6,19,30,54,-24,21
Crusaders,1352,1,17,6,7,53,37,16,57
Ballymena,1352,2,16,4,10,56,54,2,52
Cliftonville,1352,3,14,6,10,53,41,12,48
Coleraine,1352,4,11,12,7,44,39,5,45
Glenavon,1352,5,11,12,7,42,37,5,45
Linfield,1352,6,11,11,8,49,30,19,44
Glentoran,1352,7,10,7,13,31,42,-11,37
Dungannon,1352,8,8,12,10,47,44,3,36
Ards,1352,9,9,7,14,37,46,-9,34
Portadown,1352,10,7,7,16,24,43,-19,28
Ballinamalla,1352,11,7,4,19,26,49,-23,25
Glenavon,1353,1,15,9,6,50,35,15,54
Linfield,1353,2,14,10,6,62,40,22,52
Crusaders,1353,3,14,7,9,52,39,13,49
Ballymena,1353,4,14,5,11,61,60,1,47
Cliftonville,1353,5,13,7,10,48,38,10,46
Coleraine,1353,6,9,14,7,39,37,2,41
Dungannon,1353,7,9,10,11,46,41,5,37
Ballinamalla,1353,8,10,4,16,30,45,-15,34
Portadown,1353,9,8,8,14,24,43,-19,32
Glentoran,1353,10,8,7,15,35,48,-13,31
Ards,1353,11,8,5,17,29,50,-21,29
Crusaders,1354,1,17,5,8,54,33,21,56
Linfield,1354,2,15,7,8,65,39,26,52
Glenavon,1354,3,14,10,6,49,39,10,52
Cliftonville,1354,4,15,5,10,46,34,12,50
Ballymena,1354,5,13,7,10,55,56,-1,46
Glentoran,1354,6,13,6,11,37,40,-3,45
Coleraine,1354,7,10,11,9,39,38,1,41
Dungannon,1354,8,9,11,10,52,43,9,38
Portadown,1354,9,7,5,18,22,48,-26,26
Ballinamalla,1354,10,7,5,18,28,56,-28,26
Ards,1354,11,6,6,18,39,60,-21,24
Crusaders,1355,1,18,6,6,54,29,25,60
Cliftonville,1355,2,16,3,11,55,40,15,51
Linfield,1355,3,13,9,8,54,31,23,48
Coleraine,1355,4,12,12,6,49,40,9,48
Glenavon,1355,5,12,10,8,51,45,6,46
Ballymena,1355,6,14,4,12,59,58,1,46
Dungannon,1355,7,9,10,11,48,50,-2,37
Glentoran,1355,8,10,7,13,32,48,-16,37
Ards,1355,9,10,6,14,43,48,-5,36
Portadown,1355,10,7,5,18,29,57,-28,26
Ballinamalla,1355,11,6,4,20,27,55,-28,22
Crusaders,1356,1,19,7,4,58,29,29,64
Cliftonville,1356,2,15,7,8,59,44,15,52
Glenavon,1356,3,13,9,8,45,42,3,48
Linfield,1356,4,12,11,7,57,38,19,47
Ballymena,1356,5,14,5,11,56,60,-4,47
Coleraine,1356,6,11,10,9,38,34,4,43
Dungannon,1356,7,10,10,10,54,41,13,40
Ards,1356,8,11,6,13,36,44,-8,39
Glentoran,1356,9,9,8,13,37,45,-8,35
Ballinamalla,1356,10,8,4,18,29,49,-20,28
Portadown,1356,11,3,3,24,20,63,-43,12
Crusaders,1357,1,17,8,5,55,35,20,59
Glenavon,1357,2,15,8,7,50,41,9,53
Cliftonville,1357,3,16,4,10,52,40,12,52
Ballymena,1357,4,14,5,11,60,57,3,47
Linfield,1357,5,12,9,9,51,35,16,45
Dungannon,1357,6,11,8,11,57,41,16,41
Ards,1357,7,12,3,15,39,46,-7,39
Coleraine,1357,8,10,8,12,40,43,-3,38
Glentoran,1357,9,8,7,15,34,49,-15,31
Portadown,1357,10,7,6,17,22,45,-23,27
Ballinamalla,1357,11,7,6,17,25,53,-28,27
Cliftonville,1358,1,16,6,8,51,37,14,54
Crusaders,1358,2,15,7,8,55,36,19,52
Linfield,1358,3,13,11,6,55,33,22,50
Ballymena,1358,4,13,8,9,55,55,0,47
Glenavon,1358,5,10,13,7,48,42,6,43
Dungannon,1358,6,9,11,10,56,51,5,38
Coleraine,1358,7,8,14,8,36,41,-5,38
Ards,1358,8,10,4,16,36,46,-10,34
Portadown,1358,9,9,7,14,24,37,-13,34
Glentoran,1358,10,8,7,15,26,43,-17,31
Ballinamalla,1358,11,6,8,16,27,48,-21,26
Crusaders,1359,1,17,8,5,57,34,23,59
Cliftonville,1359,2,16,5,9,52,36,16,53
Ballymena,1359,3,16,5,9,56,53,3,53
Linfield,1359,4,14,10,6,51,29,22,52
Glenavon,1359,5,11,12,7,44,38,6,45
Coleraine,1359,6,11,11,8,44,37,7,44
Dungannon,1359,7,11,7,12,54,44,10,40
Glentoran,1359,8,9,10,11,27,36,-9,37
Ards,1359,9,6,6,18,31,56,-25,24
Portadown,1359,10,5,7,18,25,50,-25,22
Ballinamalla,1359,11,5,7,18,23,51,-28,22
Crusaders,1360,1,17,6,7,56,33,23,57
Cliftonville,1360,2,17,4,9,55,41,14,55
Linfield,1360,3,13,11,6,59,31,28,50
Ballymena,1360,4,13,7,10,52,54,-2,46
Glenavon,1360,5,10,13,7,51,43,8,43
Coleraine,1360,6,10,12,8,38,42,-4,42
Dungannon,1360,7,10,10,10,45,39,6,40
Ards,1360,8,11,4,15,47,52,-5,37
Glentoran,1360,9,8,8,14,33,46,-13,32
Ballinamalla,1360,10,7,6,17,36,64,-28,27
Portadown,1360,11,5,7,18,16,43,-27,22
Cliftonville,1361,1,16,6,8,60,42,18,54
Coleraine,1361,2,13,11,6,44,38,6,50
Linfield,1361,3,13,10,7,56,35,21,49
Crusaders,1361,4,14,7,9,53,43,10,49
Glenavon,1361,5,11,13,6,52,47,5,46
Ballymena,1361,6,12,6,12,56,60,-4,42
Portadown,1361,7,12,2,16,29,44,-15,38
Glentoran,1361,8,9,7,14,35,45,-10,34
Ballinamalla,1361,9,9,6,15,31,45,-14,33
Dungannon,1361,10,7,10,13,50,53,-3,31
Ards,1361,11,7,6,17,38,52,-14,27
Crusaders,1362,1,16,8,6,54,32,22,56
Ballymena,1362,2,16,7,7,59,52,7,55
Cliftonville,1362,3,16,6,8,57,39,18,54
Linfield,1362,4,14,10,6,59,32,27,52
Glenavon,1362,5,13,11,6,49,43,6,50
Coleraine,1362,6,11,11,8,40,34,6,44
Glentoran,1362,7,9,7,14,29,47,-18,34
Ballinamalla,1362,8,9,4,17,26,48,-22,31
Dungannon,1362,9,6,10,14,47,53,-6,28
Portadown,1362,10,6,7,17,27,48,-21,25
Ards,1362,11,5,7,18,31,50,-19,22
Crusaders,1363,1,15,9,6,49,33,16,54
Linfield,1363,2,15,8,7,56,32,24,53
Cliftonville,1363,3,16,4,10,53,44,9,52
Coleraine,1363,4,12,10,8,50,42,8,46
Glenavon,1363,5,11,11,8,40,35,5,44
Dungannon,1363,6,11,10,9,52,38,14,43
Ballymena,1363,7,11,6,13,51,58,-7,39
Glentoran,1363,8,10,9,11,29,40,-11,39
Ards,1363,9,9,5,16,37,46,-9,32
Portadown,1363,10,8,4,18,25,45,-20,28
Ballinamalla,1363,11,7,4,19,26,55,-29,25
Linfield,1364,1,15,10,5,58,26,32,55
Crusaders,1364,2,15,9,6,56,37,19,54
Dungannon,1364,3,14,8,8,64,42,22,50
Cliftonville,1364,4,14,6,10,57,47,10,48
Coleraine,1364,5,12,10,8,41,40,1,46
Ballymena,1364,6,14,3,13,55,59,-4,45
Glenavon,1364,7,11,10,9,45,43,2,43
Glentoran,1364,8,7,12,11,30,44,-14,33
Ards,1364,9,7,8,15,36,51,-15,29
Ballinamalla,1364,10,7,6,17,24,49,-25,27
Portadown,1364,11,5,6,19,20,48,-28,21
Linfield,1365,1,17,8,5,57,25,32,59
Crusaders,1365,2,15,8,7,55,36,19,53
Cliftonville,1365,3,13,6,11,49,40,9,45
Coleraine,1365,4,12,9,9,45,41,4,45
Glenavon,1365,5,11,12,7,45,42,3,45
Ballymena,1365,6,12,6,12,54,60,-6,42
Dungannon,1365,7,10,9,11,48,41,7,39
Glentoran,1365,8,10,7,13,31,45,-14,37
Portadown,1365,9,9,7,14,30,45,-15,34
Ards,1365,10,9,3,18,33,50,-17,30
Ballinamalla,1365,11,7,5,18,24,46,-22,26
Cliftonville,1366,1,15,6,9,53,39,14,51
Crusaders,1366,2,14,8,8,63,47,16,50
Linfield,1366,3,13,9,8,55,33,22,48
Dungannon,1366,4,13,8,9,56,46,10,47
Ballymena,1366,5,13,8,9,61,57,4,47
Coleraine,1366,6,11,12,7,41,33,8,45
Glentoran,1366,7,13,5,12,33,38,-5,44
Glenavon,1366,8,8,10,12,45,55,-10,34
Ards,1366,9,9,5,16,35,46,-11,32
Portadown,1366,10,9,3,18,25,49,-24,30
Ballinamalla,1366,11,7,6,17,34,58,-24,27
Cliftonville,1367,1,18,4,8,59,37,22,58
Linfield,1367,2,16,8,6,65,34,31,56
Crusaders,1367,3,16,6,8,59,37,22,54
Coleraine,1367,4,13,10,7,48,37,11,49
Glenavon,1367,5,12,11,7,50,44,6,47
Ballymena,1367,6,12,7,11,56,58,-2,43
Dungannon,1367,7,11,9,10,50,46,4,42
Glentoran,1367,8,10,6,14,30,43,-13,36
Portadown,1367,9,8,4,18,25,50,-25,28
Ards,1367,10,6,7,17,31,54,-23,25
Ballinamalla,1367,11,4,6,20,29,62,-33,18
Crusaders,1368,1,15,9,6,52,32,20,54
Linfield,1368,2,13,9,8,52,32,20,48
Cliftonville,1368,3,14,6,10,53,45,8,48
Ballymena,1368,4,14,5,11,56,63,-7,47
Coleraine,1368,5,11,12,7,45,30,15,45
Glenavon,1368,6,11,10,9,45,46,-1,43
Dungannon,1368,7,10,12,8,53,41,12,42
Glentoran,1368,8,10,8,12,38,44,-6,38
Ards,1368,9,10,5,15,41,51,-10,35
Ballinamalla,1368,10,7,5,18,35,62,-27,26
Portadown,1368,11,5,9,16,21,45,-24,24
Cliftonville,1369,1,18,4,8,59,35,24,58
Ballymena,1369,2,17,6,7,61,49,12,57
Crusaders,1369,3,15,9,6,62,40,22,54
Linfield,1369,4,12,10,8,55,38,17,46
Dungannon,1369,5,13,6,11,58,45,13,45
Coleraine,1369,6,10,11,9,44,37,7,41
Glenavon,1369,7,8,12,10,38,44,-6,36
Portadown,1369,8,11,3,16,26,48,-22,36
Ards,1369,9,9,5,16,41,49,-8,32
Glentoran,1369,10,6,8,16,27,53,-26,26
Ballinamalla,1369,11,7,4,19,26,59,-33,25
Cliftonville,1370,1,16,6,8,53,40,13,54
Ballymena,1370,2,15,6,9,58,55,3,51
Linfield,1370,3,13,9,8,49,30,19,48
Glenavon,1370,4,12,11,7,52,44,8,47
Crusaders,1370,5,12,9,9,51,40,11,45
Coleraine,1370,6,11,9,10,45,43,2,42
Glentoran,1370,7,10,8,12,34,48,-14,38
Dungannon,1370,8,8,11,11,47,48,-1,35
Portadown,1370,9,9,5,16,25,41,-16,32
Ards,1370,10,8,7,15,40,46,-6,31
Ballinamalla,1370,11,7,7,16,32,51,-19,28
Crusaders,1371,1,19,5,6,63,33,30,62
Ballymena,1371,2,16,6,8,62,55,7,54
Cliftonville,1371,3,16,5,9,53,40,13,53
Linfield,1371,4,13,9,8,49,30,19,48
Glenavon,1371,5,9,15,6,53,53,0,42
Coleraine,1371,6,10,11,9,36,34,2,41
Glentoran,1371,7,8,10,12,34,43,-9,34
Ards,1371,8,9,7,14,37,48,-11,34
Dungannon,1371,9,6,12,12,43,45,-2,30
Portadown,1371,10,8,6,16,33,52,-19,30
Ballinamalla,1371,11,4,8,18,25,55,-30,20
Cliftonville,1372,1,16,7,7,56,39,17,55
Glenavon,1372,2,15,9,6,52,40,12,54
Crusaders,1372,3,14,9,7,53,35,18,51
Linfield,1372,4,13,10,7,57,36,21,49
Ballymena,1372,5,13,8,9,61,56,5,47
Dungannon,1372,6,12,8,10,46,36,10,44
Coleraine,1372,7,9,11,10,43,46,-3,38
Glentoran,1372,8,9,6,15,29,46,-17,33
Ballinamalla,1372,9,7,7,16,29,48,-19,28
Portadown,1372,10,7,5,18,22,50,-28,26
Ards,1372,11,5,10,15,28,44,-16,25
Cliftonville,1373,1,19,3,8,59,35,24,60
Linfield,1373,2,16,10,4,68,29,39,58
Crusaders,1373,3,14,8,8,51,38,13,50
Glentoran,1373,4,12,7,11,37,38,-1,43
Dungannon,1373,5,10,12,8,49,40,9,42
Coleraine,1373,6,11,9,10,44,41,3,42
Glenavon,1373,7,10,11,9,47,49,-2,41
Ballymena,1373,8,10,5,15,51,70,-19,35
Ards,1373,9,9,3,18,36,51,-15,30
Portadown,1373,10,8,6,16,24,50,-26,30
Ballinamalla,1373,11,7,4,19,27,52,-25,25
Crusaders,1374,1,18,6,6,61,34,27,60
Linfield,1374,2,14,11,5,55,24,31,53
Ballymena,1374,3,15,7,8,61,56,5,52
Cliftonville,1374,4,14,6,10,54,42,12,48
Coleraine,1374,5,12,12,6,40,32,8,48
Glenavon,1374,6,8,11,11,37,42,-5,35
Portadown,1374,7,9,6,15,30,43,-13,33
Ballinamalla,1374,8,8,8,14,29,47,-18,32
Ards,1374,9,7,9,14,35,45,-10,30
Dungannon,1374,10,6,11,13,45,50,-5,29
Glentoran,1374,11,7,7,16,23,55,-32,28
Crusaders,1375,1,17,9,4,54,31,23,60
Glenavon,1375,2,14,10,6,54,42,12,52
Ballymena,1375,3,13,8,9,51,54,-3,47
Linfield,1375,4,12,8,10,54,42,12,44
Cliftonville,1375,5,12,5,13,42,42,0,41
Coleraine,1375,6,10,8,12,45,45,0,38
Ards,1375,7,11,4,15,41,50,-9,37
Dungannon,1375,8,8,12,10,55,48,7,36
Ballinamalla,1375,9,11,3,16,33,48,-15,36
Portadown,1375,10,9,6,15,25,40,-15,33
Glentoran,1375,11,8,7,15,32,44,-12,31
Linfield,1376,1,19,8,3,58,20,38,65
Crusaders,1376,2,16,8,6,54,34,20,56
Ballymena,1376,3,16,5,9,54,51,3,53
Cliftonville,1376,4,15,5,10,55,40,15,50
Coleraine,1376,5,13,10,7,47,33,14,49
Glenavon,1376,6,11,8,11,49,48,1,41
Ballinamalla,1376,7,12,2,16,31,53,-22,38
Dungannon,1376,8,9,8,13,46,47,-1,35
Glentoran,1376,9,9,5,16,31,48,-17,32
Ards,1376,10,7,4,19,31,50,-19,25
Portadown,1376,11,4,5,21,17,49,-32,17
Glenavon,1377,1,16,8,6,52,40,12,56
Linfield,1377,2,15,7,8,64,32,32,52
Crusaders,1377,3,15,6,9,54,37,17,51
Coleraine,1377,4,13,8,9,46,39,7,47
Ballymena,1377,5,13,7,10,53,58,-5,46
Cliftonville,1377,6,13,4,13,43,42,1,43
Ards,1377,7,13,4,13,44,47,-3,43
Dungannon,1377,8,7,12,11,45,43,2,33
Glentoran,1377,9,9,6,15,31,48,-17,33
Portadown,1377,10,7,8,15,24,44,-20,29
Ballinamalla,1377,11,7,4,19,28,54,-26,25
Crusaders,1378,1,18,6,6,56,33,23,60
Linfield,1378,2,17,8,5,67,31,36,59
Coleraine,1378,3,14,10,6,49,33,16,52
Cliftonville,1378,4,15,5,10,52,41,11,50
Ballymena,1378,5,14,6,10,59,57,2,48
Dungannon,1378,6,9,11,10,53,47,6,38
Glenavon,1378,7,9,9,12,43,49,-6,36
Ards,1378,8,9,6,15,36,46,-10,33
Portadown,1378,9,8,6,16,27,50,-23,30
Glentoran,1378,10,8,6,16,28,52,-24,30
Ballinamalla,1378,11,5,5,20,26,57,-31,20
Linfield,1379,1,16,8,6,63,31,32,56
Crusaders,1379,2,16,7,7,50,26,24,55
Cliftonville,1379,3,16,5,9,50,35,15,53
Ballymena,1379,4,15,7,8,61,55,6,52
Coleraine,1379,5,12,11,7,51,41,10,47
Glenavon,1379,6,12,9,9,49,43,6,45
Ards,1379,7,10,4,16,38,55,-17,34
Dungannon,1379,8,7,11,12,44,46,-2,32
Portadown,1379,9,9,4,17,28,46,-18,31
Glentoran,1379,10,8,6,16,31,55,-24,30
Ballinamalla,1379,11,7,2,21,29,61,-32,23
Crusaders,1380,1,19,5,6,57,34,23,62
Linfield,1380,2,16,9,5,63,29,34,57
Cliftonville,1380,3,14,7,9,53,38,15,49
Ballymena,1380,4,14,4,12,53,58,-5,46
Dungannon,1380,5,11,10,9,50,38,12,43
Coleraine,1380,6,10,10,10,42,37,5,40
Glentoran,1380,7,10,6,14,31,49,-18,36
Glenavon,1380,8,7,14,9,42,49,-7,35
Portadown,1380,9,10,5,15,30,42,-12,35
Ards,1380,10,9,6,15,33,50,-17,33
Ballinamalla,1380,11,5,4,21,26,56,-30,19
Linfield,1381,1,16,7,7,66,36,30,55
Crusaders,1381,2,16,7,7,62,33,29,55
Ballymena,1381,3,14,6,10,60,60,0,48
Glenavon,1381,4,12,10,8,48,43,5,46
Cliftonville,1381,5,11,9,10,43,42,1,42
Coleraine,1381,6,9,11,10,41,42,-1,38
Dungannon,1381,7,10,8,12,47,50,-3,38
Ards,1381,8,11,5,14,41,47,-6,38
Glentoran,1381,9,8,12,10,35,44,-9,36
Portadown,1381,10,8,5,17,28,43,-15,29
Ballinamalla,1381,11,8,4,18,24,55,-31,28
Linfield,1382,1,17,8,5,57,24,33,59
Crusaders,1382,2,17,8,5,54,27,27,59
Cliftonville,1382,3,16,5,9,58,35,23,53
Ballymena,1382,4,16,4,10,63,59,4,52
Glenavon,1382,5,13,11,6,49,41,8,50
Dungannon,1382,6,8,11,11,46,43,3,35
Ards,1382,7,10,5,15,40,50,-10,35
Coleraine,1382,8,9,8,13,34,47,-13,35
Glentoran,1382,9,7,7,16,30,54,-24,28
Ballinamalla,1382,10,7,6,17,27,52,-25,27
Portadown,1382,11,6,5,19,27,53,-26,23
Cliftonville,1383,1,19,4,7,66,40,26,61
Crusaders,1383,2,18,6,6,60,37,23,60
Linfield,1383,3,14,8,8,51,30,21,50
Glenavon,1383,4,11,12,7,43,42,1,45
Dungannon,1383,5,12,8,10,51,41,10,44
Ballymena,1383,6,12,5,13,49,60,-11,41
Coleraine,1383,7,10,8,12,38,36,2,38
Glentoran,1383,8,10,6,14,33,46,-13,36
Ards,1383,9,8,5,17,36,52,-16,29
Portadown,1383,10,8,5,17,28,47,-19,29
Ballinamalla,1383,11,8,3,19,24,48,-24,27
Linfield,1384,1,16,8,6,54,29,25,56
Ballymena,1384,2,15,5,10,66,56,10,50
Coleraine,1384,3,13,10,7,41,37,4,49
Crusaders,1384,4,14,6,10,55,40,15,48
Cliftonville,1384,5,14,5,11,50,44,6,47
Dungannon,1384,6,10,11,9,51,42,9,41
Glenavon,1384,7,10,11,9,47,49,-2,41
Glentoran,1384,8,11,5,14,38,49,-11,38
Portadown,1384,9,9,6,15,29,45,-16,33
Ballinamalla,1384,10,8,4,18,26,48,-22,28
Ards,1384,11,7,5,18,37,55,-18,26
Linfield,1385,1,15,9,6,55,29,26,54
Coleraine,1385,2,13,12,5,44,30,14,51
Crusaders,1385,3,14,8,8,57,43,14,50
Cliftonville,1385,4,15,4,11,57,43,14,49
Glenavon,1385,5,12,12,6,48,38,10,48
Ballymena,1385,6,13,6,11,64,62,2,45
Dungannon,1385,7,8,12,10,49,46,3,36
Ards,1385,8,10,6,14,41,50,-9,36
Glentoran,1385,9,8,9,13,36,51,-15,33
Portadown,1385,10,6,8,16,20,48,-28,26
Ballinamalla,1385,11,5,6,19,25,56,-31,21
Crusaders,1386,1,16,7,7,52,39,13,55
Glenavon,1386,2,13,11,6,52,41,11,50
Linfield,1386,3,12,12,6,63,36,27,48
Ballymena,1386,4,13,8,9,59,59,0,47
Coleraine,1386,5,11,12,7,43,37,6,45
Dungannon,1386,6,9,11,10,52,39,13,38
Glentoran,1386,7,10,8,12,40,48,-8,38
Cliftonville,1386,8,11,5,14,46,57,-11,38
Ards,1386,9,11,3,16,38,51,-13,36
Ballinamalla,1386,10,7,7,16,27,46,-19,28
Portadown,1386,11,7,6,17,29,48,-19,27
Crusaders,1387,1,17,6,7,53,29,24,57
Linfield,1387,2,15,9,6,60,37,23,54
Cliftonville,1387,3,15,4,11,53,44,9,49
Ballymena,1387,4,14,7,9,69,67,2,49
Glenavon,1387,5,13,9,8,54,43,11,48
Dungannon,1387,6,13,7,10,60,48,12,46
Glentoran,1387,7,11,7,12,33,41,-8,40
Coleraine,1387,8,9,9,12,40,43,-3,36
Ballinamalla,1387,9,10,4,16,31,46,-15,34
Ards,1387,10,7,4,19,32,51,-19,25
Portadown,1387,11,7,2,21,20,56,-36,23
Cliftonville,1388,1,15,8,7,55,38,17,53
Crusaders,1388,2,15,6,9,54,42,12,51
Linfield,1388,3,13,10,7,62,39,23,49
Coleraine,1388,4,11,14,5,46,34,12,47
Ballymena,1388,5,12,6,12,62,68,-6,42
Glenavon,1388,6,9,13,8,49,45,4,40
Ards,1388,7,11,6,13,44,44,0,39
Dungannon,1388,8,10,7,13,49,49,0,37
Glentoran,1388,9,10,7,13,39,48,-9,37
Portadown,1388,10,7,7,16,21,47,-26,28
Ballinamalla,1388,11,6,8,16,29,56,-27,26
Crusaders,1389,1,18,7,5,62,34,28,61
Cliftonville,1389,2,17,4,9,66,52,14,55
Ballymena,1389,3,14,6,10,60,57,3,48
Linfield,1389,4,12,11,7,56,39,17,47
Coleraine,1389,5,12,10,8,46,38,8,46
Dungannon,1389,6,10,11,9,53,43,10,41
Ballinamalla,1389,7,13,2,15,40,47,-7,41
Glenavon,1389,8,7,12,11,42,48,-6,33
Glentoran,1389,9,8,7,15,26,43,-17,31
Ards,1389,10,8,6,16,37,53,-16,30
Portadown,1389,11,5,6,19,20,54,-34,21
Crusaders,1390,1,16,10,4,53,30,23,58
Linfield,1390,2,13,10,7,60,34,26,49
Cliftonville,1390,3,14,7,9,50,38,12,49
Ballymena,1390,4,14,7,9,58,62,-4,49
Glenavon,1390,5,13,8,9,52,47,5,47
Coleraine,1390,6,12,9,9,45,38,7,45
Dungannon,1390,7,10,9,11,50,44,6,39
Glentoran,1390,8,8,10,12,34,49,-15,34
Ards,1390,9,10,3,17,49,55,-6,33
Ballinamalla,1390,10,7,6,17,26,51,-25,27
Portadown,1390,11,6,5,19,20,49,-29,23
Linfield,1391,1,16,10,4,58,24,34,58
Crusaders,1391,2,16,6,8,47,31,16,54
Cliftonville,1391,3,15,5,10,52,36,16,50
Glenavon,1391,4,12,10,8,50,40,10,46
Dungannon,1391,5,12,9,9,49,39,10,45
Ballymena,1391,6,11,7,12,49,58,-9,40
Coleraine,1391,7,10,9,11,36,43,-7,39
Portadown,1391,8,9,8,13,25,39,-14,35
Ards,1391,9,9,7,14,34,46,-12,34
Glentoran,1391,10,7,7,16,31,52,-21,28
Ballinamalla,1391,11,6,6,18,28,51,-23,24
Linfield,1392,1,15,9,6,58,27,31,54
Crusaders,1392,2,14,9,7,54,35,19,51
Cliftonville,1392,3,14,8,8,46,37,9,50
Coleraine,1392,4,13,10,7,45,33,12,49
Dungannon,1392,5,13,9,8,54,41,13,48
Glenavon,1392,6,11,13,6,49,42,7,46
Ballymena,1392,7,11,7,12,50,57,-7,40
Glentoran,1392,8,10,6,14,34,48,-14,36
Ballinamalla,1392,9,8,5,17,27,44,-17,29
Ards,1392,10,7,6,17,35,56,-21,27
Portadown,1392,11,6,4,20,24,56,-32,22
Crusaders,1393,1,16,8,6,58,36,22,56
Dungannon,1393,2,12,12,6,51,36,15,48
Cliftonville,1393,3,15,3,12,46,42,4,48
Coleraine,1393,4,12,10,8,41,34,7,46
Linfield,1393,5,11,11,8,54,41,13,44
Glentoran,1393,6,11,8,11,37,48,-11,41
Ballymena,1393,7,11,7,12,52,58,-6,40
Glenavon,1393,8,9,12,9,42,44,-2,39
Ballinamalla,1393,9,10,4,16,36,50,-14,34
Ards,1393,10,8,5,17,40,52,-12,29
Portadown,1393,11,8,4,18,31,47,-16,28
Crusaders,1394,1,18,5,7,61,40,21,59
Linfield,1394,2,16,10,4,68,29,39,58
Cliftonville,1394,3,16,4,10,53,37,16,52
Ballymena,1394,4,14,7,9,59,62,-3,49
Glenavon,1394,5,9,13,8,44,48,-4,40
Glentoran,1394,6,11,7,12,30,38,-8,40
Coleraine,1394,7,9,12,9,44,47,-3,39
Dungannon,1394,8,7,11,12,45,46,-1,32
Ards,1394,9,8,8,14,43,52,-9,32
Portadown,1394,10,6,9,15,30,49,-19,27
Ballinamalla,1394,11,6,4,20,26,55,-29,22
Crusaders,1395,1,19,7,4,57,29,28,64
Ballymena,1395,2,17,4,9,61,54,7,55
Linfield,1395,3,15,9,6,62,34,28,54
Cliftonville,1395,4,16,4,10,57,43,14,52
Coleraine,1395,5,9,14,7,44,41,3,41
Dungannon,1395,6,10,10,10,49,43,6,40
Glenavon,1395,7,9,13,8,48,49,-1,40
Glentoran,1395,8,9,5,16,30,47,-17,32
Ards,1395,9,9,4,17,37,54,-17,31
Ballinamalla,1395,10,6,5,19,27,54,-27,23
Portadown,1395,11,5,7,18,23,47,-24,22
Cliftonville,1396,1,21,4,5,58,29,29,67
Linfield,1396,2,15,9,6,62,26,36,54
Crusaders,1396,3,15,4,11,51,38,13,49
Glenavon,1396,4,12,11,7,45,43,2,47
Ballymena,1396,5,13,5,12,57,63,-6,44
Dungannon,1396,6,10,10,10,51,43,8,40
Glentoran,1396,7,10,10,10,26,32,-6,40
Coleraine,1396,8,10,9,11,38,42,-4,39
Ballinamalla,1396,9,10,5,15,31,44,-13,35
Ards,1396,10,7,5,18,32,49,-17,26
Portadown,1396,11,3,6,21,20,62,-42,15
Crusaders,1397,1,17,8,5,67,37,30,59
Cliftonville,1397,2,17,5,8,58,39,19,56
Ballymena,1397,3,15,5,10,64,59,5,50
Linfield,1397,4,12,9,9,54,33,21,45
Coleraine,1397,5,12,9,9,47,43,4,45
Ards,1397,6,12,5,13,42,45,-3,41
Glenavon,1397,7,10,9,11,53,53,0,39
Dungannon,1397,8,9,10,11,44,46,-2,37
Glentoran,1397,9,8,9,13,36,54,-18,33
Ballinamalla,1397,10,9,3,18,38,63,-25,30
Portadown,1397,11,6,4,20,26,57,-31,22
Crusaders,1398,1,17,7,6,57,29,28,58
Linfield,1398,2,16,9,5,57,24,33,57
Cliftonville,1398,3,16,6,8,51,38,13,54
Ballymena,1398,4,13,9,8,62,56,6,48
Glenavon,1398,5,11,11,8,52,48,4,44
Coleraine,1398,6,11,10,9,46,41,5,43
Ards,1398,7,10,5,15,40,47,-7,35
Glentoran,1398,8,8,9,13,28,47,-19,33
Ballinamalla,1398,9,7,6,17,34,62,-28,27
Portadown,1398,10,6,8,16,23,45,-22,26
Dungannon,1398,11,5,10,15,40,53,-13,25
Linfield,1399,1,18,7,5,58,25,33,61
Crusaders,1399,2,16,7,7,61,41,20,55
Ballymena,1399,3,15,4,11,62,58,4,49
Glenavon,1399,4,13,9,8,55,44,11,48
Cliftonville,1399,5,13,7,10,51,47,4,46
Portadown,1399,6,11,6,13,32,43,-11,39
Coleraine,1399,7,9,11,10,39,40,-1,38
Dungannon,1399,8,9,7,14,44,45,-1,34
Glentoran,1399,9,9,7,14,28,44,-16,34
Ards,1399,10,9,4,17,36,47,-11,31
Ballinamalla,1399,11,7,3,20,24,56,-32,24
Crusaders,1400,1,17,9,4,49,26,23,60
Linfield,1400,2,13,12,5,62,36,26,51
Ballymena,1400,3,14,8,8,63,55,8,50
Coleraine,1400,4,13,10,7,48,40,8,49
Glenavon,1400,5,12,9,9,48,38,10,45
Cliftonville,1400,6,13,6,11,54,49,5,45
Dungannon,1400,7,9,8,13,44,48,-4,35
Ards,1400,8,8,6,16,35,51,-16,30
Glentoran,1400,9,8,6,16,33,52,-19,30
Portadown,1400,10,8,6,16,28,50,-22,30
Ballinamalla,1400,11,7,6,17,36,55,-19,27
Crusaders,1401,1,19,6,5,59,31,28,63
Linfield,1401,2,15,9,6,63,40,23,54
Cliftonville,1401,3,14,6,10,56,41,15,48
Ballymena,1401,4,13,6,11,63,61,2,45
Coleraine,1401,5,11,9,10,54,49,5,42
Glenavon,1401,6,10,10,10,48,50,-2,40
Dungannon,1401,7,9,9,12,47,45,2,36
Ards,1401,8,10,6,14,44,55,-11,36
Ballinamalla,1401,9,10,2,18,35,56,-21,32
Glentoran,1401,10,8,7,15,31,53,-22,31
Portadown,1401,11,8,6,16,25,44,-19,30
Crusaders,1402,1,15,10,5,57,38,19,55
Ballymena,1402,2,15,8,7,61,50,11,53
Cliftonville,1402,3,15,6,9,54,38,16,51
Coleraine,1402,4,12,11,7,49,43,6,47
Linfield,1402,5,12,10,8,52,39,13,46
Glenavon,1402,6,10,14,6,40,37,3,44
Glentoran,1402,7,10,6,14,30,49,-19,36
Ards,1402,8,9,6,15,39,46,-7,33
Ballinamalla,1402,9,8,7,15,33,49,-16,31
Dungannon,1402,10,6,10,14,44,45,-1,28
Portadown,1402,11,6,6,18,25,50,-25,24
Crusaders,1403,1,15,9,6,57,35,22,54
Ballymena,1403,2,16,5,9,63,57,6,53
Cliftonville,1403,3,15,6,9,58,45,13,51
Linfield,1403,4,14,8,8,58,30,28,50
Glenavon,1403,5,9,12,9,41,45,-4,39
Coleraine,1403,6,9,11,10,36,38,-2,38
Ards,1403,7,10,8,12,36,42,-6,38
Dungannon,1403,8,8,10,12,44,45,-1,34
Ballinamalla,1403,9,9,5,16,34,55,-21,32
Glentoran,1403,10,7,10,13,23,39,-16,31
Portadown,1403,11,8,6,16,25,44,-19,30
Crusaders,1404,1,18,7,5,54,29,25,61
Ballymena,1404,2,13,7,10,57,61,-4,46
Dungannon,1404,3,12,9,9,55,40,15,45
Cliftonville,1404,4,12,8,10,50,42,8,44
Linfield,1404,5,12,7,11,58,39,19,43
Glenavon,1404,6,10,10,10,45,49,-4,40
Coleraine,1404,7,9,12,9,44,41,3,39
Glentoran,1404,8,10,9,11,30,37,-7,39
Portadown,1404,9,10,6,14,31,49,-18,36
Ards,1404,10,8,7,15,36,52,-16,31
Ballinamalla,1404,11,7,6,17,27,48,-21,27
Cliftonville,1405,1,20,2,8,58,38,20,62
Linfield,1405,2,18,7,5,67,30,37,61
Crusaders,1405,3,16,5,9,48,34,14,53
Glenavon,1405,4,14,9,7,58,50,8,51
Coleraine,1405,5,11,11,8,48,39,9,44
Ballymena,1405,6,12,7,11,53,60,-7,43
Dungannon,1405,7,10,10,10,50,47,3,40
Glentoran,1405,8,9,5,16,31,45,-14,32
Ballinamalla,1405,9,8,3,19,26,54,-28,27
Portadown,1405,10,7,5,18,23,43,-20,26
Ards,1405,11,6,4,20,33,55,-22,22
Crusaders,1406,1,19,6,5,61,32,29,63
Ballymena,1406,2,18,5,7,68,50,18,59
Glentoran,1406,3,14,7,9,43,43,0,49
Cliftonville,1406,4,14,6,10,52,40,12,48
Linfield,1406,5,13,8,9,49,31,18,47
Glenavon,1406,6,11,10,9,48,44,4,43
Coleraine,1406,7,8,12,10,39,44,-5,36
Ards,1406,8,9,5,16,38,52,-14,32
Ballinamalla,1406,9,8,4,18,28,54,-26,28
Portadown,1406,10,7,5,18,26,51,-25,26
Dungannon,1406,11,5,10,15,40,51,-11,25
Crusaders,1407,1,18,6,6,56,27,29,60
Ballymena,1407,2,15,7,8,59,54,5,52
Cliftonville,1407,3,15,6,9,50,40,10,51
Linfield,1407,4,14,8,8,63,36,27,50
Glenavon,1407,5,12,9,9,47,42,5,45
Coleraine,1407,6,9,15,6,43,40,3,42
Dungannon,1407,7,11,8,11,50,45,5,41
Glentoran,1407,8,9,6,15,31,49,-18,33
Portadown,1407,9,8,5,17,29,52,-23,29
Ballinamalla,1407,10,8,4,18,34,55,-21,28
Ards,1407,11,7,4,19,28,50,-22,25
Linfield,1408,1,16,10,4,62,33,29,58
Cliftonville,1408,2,18,4,8,64,37,27,58
Coleraine,1408,3,15,7,8,59,43,16,52
Crusaders,1408,4,13,9,8,52,38,14,48
Glenavon,1408,5,11,11,8,50,44,6,44
Dungannon,1408,6,12,8,10,52,49,3,44
Ballymena,1408,7,11,4,15,55,69,-14,37
Ballinamalla,1408,8,9,6,15,34,50,-16,33
Glentoran,1408,9,8,8,14,32,50,-18,32
Ards,1408,10,7,6,17,38,57,-19,27
Portadown,1408,11,7,3,20,23,51,-28,24
Linfield,1409,1,15,9,6,64,34,30,54
Ballymena,1409,2,16,5,9,56,49,7,53
Crusaders,1409,3,15,7,8,53,34,19,52
Cliftonville,1409,4,15,4,11,46,39,7,49
Glenavon,1409,5,11,11,8,53,47,6,44
Coleraine,1409,6,9,14,7,39,37,2,41
Dungannon,1409,7,10,8,12,49,48,1,38
Glentoran,1409,8,9,8,13,35,48,-13,35
Ards,1409,9,8,9,13,36,46,-10,33
Ballinamalla,1409,10,7,7,16,29,50,-21,28
Portadown,1409,11,5,8,17,16,44,-28,23
Linfield,1410,1,19,8,3,69,28,41,65
Glenavon,1410,2,15,10,5,54,41,13,55
Crusaders,1410,3,15,9,6,53,35,18,54
Cliftonville,1410,4,14,8,8,53,36,17,50
Ballymena,1410,5,11,7,12,50,58,-8,40
Coleraine,1410,6,9,11,10,37,41,-4,38
Dungannon,1410,7,8,10,12,53,55,-2,34
Glentoran,1410,8,9,7,14,33,50,-17,34
Ards,1410,9,9,5,16,36,49,-13,32
Portadown,1410,10,8,5,17,29,49,-20,29
Ballinamalla,1410,11,6,4,20,24,49,-25,22
Crusaders,1411,1,18,7,5,62,35,27,61
Cliftonville,1411,2,15,8,7,59,38,21,53
Linfield,1411,3,13,11,6,59,33,26,50
Glenavon,1411,4,11,11,8,43,46,-3,44
Ards,1411,5,13,4,13,43,48,-5,43
Coleraine,1411,6,10,10,10,46,46,0,40
Ballymena,1411,7,9,10,11,49,56,-7,37
Glentoran,1411,8,7,12,11,27,41,-14,33
Portadown,1411,9,7,9,14,27,48,-21,30
Dungannon,1411,10,5,13,12,46,49,-3,28
Ballinamalla,1411,11,8,3,19,32,53,-21,27
Crusaders,1412,1,20,6,4,53,24,29,66
Cliftonville,1412,2,16,4,10,52,36,16,52
Coleraine,1412,3,12,10,8,41,34,7,46
Linfield,1412,4,12,9,9,52,31,21,45
Ballymena,1412,5,13,6,11,50,55,-5,45
Dungannon,1412,6,11,10,9,59,47,12,43
Glenavon,1412,7,10,12,8,43,43,0,42
Ards,1412,8,8,7,15,39,52,-13,31
Ballinamalla,1412,9,9,4,17,36,56,-20,31
Glentoran,1412,10,7,8,15,36,56,-20,29
Portadown,1412,11,4,10,16,23,50,-27,22
Crusaders,1413,1,18,9,3,61,32,29,63
Linfield,1413,2,17,8,5,68,35,33,59
Cliftonville,1413,3,13,7,10,50,44,6,46
Ballymena,1413,4,13,4,13,54,60,-6,43
Coleraine,1413,5,10,11,9,38,41,-3,41
Glenavon,1413,6,10,10,10,52,46,6,40
Glentoran,1413,7,10,6,14,28,41,-13,36
Portadown,1413,8,10,5,15,28,41,-13,35
Ards,1413,9,9,7,14,38,47,-9,34
Dungannon,1413,10,7,8,15,44,52,-8,29
Ballinamalla,1413,11,8,5,17,31,53,-22,29
Crusaders,1414,1,16,8,6,63,41,22,56
Cliftonville,1414,2,16,7,7,56,37,19,55
Ballymena,1414,3,15,8,7,74,63,11,53
Linfield,1414,4,13,8,9,51,33,18,47
Coleraine,1414,5,11,9,10,46,49,-3,42
Dungannon,1414,6,10,10,10,51,44,7,40
Glenavon,1414,7,8,15,7,40,40,0,39
Glentoran,1414,8,8,10,12,38,50,-12,34
Portadown,1414,9,8,6,16,27,43,-16,30
Ballinamalla,1414,10,7,6,17,33,55,-22,27
Ards,1414,11,6,7,17,33,57,-24,25
Crusaders,1415,1,14,10,6,55,35,20,52
Ballymena,1415,2,15,7,8,57,48,9,52
Cliftonville,1415,3,14,7,9,56,43,13,49
Linfield,1415,4,13,9,8,59,39,20,48
Coleraine,1415,5,9,14,7,41,34,7,41
Dungannon,1415,6,10,9,11,55,50,5,39
Glenavon,1415,7,7,15,8,40,48,-8,36
Ards,1415,8,9,8,13,40,50,-10,35
Glentoran,1415,9,9,7,14,31,44,-13,34
Ballinamalla,1415,10,9,4,17,36,57,-21,31
Portadown,1415,11,8,6,16,26,48,-22,30
Linfield,1416,1,14,12,4,60,28,32,54
Crusaders,1416,2,15,7,8,54,36,18,52
Cliftonville,1416,3,15,3,12,53,42,11,48
Ballymena,1416,4,13,9,8,60,57,3,48
Glenavon,1416,5,12,11,7,46,41,5,47
Coleraine,1416,6,11,11,8,51,41,10,44
Glentoran,1416,7,11,7,12,29,46,-17,40
Dungannon,1416,8,9,10,11,51,47,4,37
Ballinamalla,1416,9,8,5,17,30,52,-22,29
Ards,1416,10,8,3,19,33,54,-21,27
Portadown,1416,11,7,6,17,24,47,-23,27
Coleraine,1417,1,15,11,4,45,28,17,56
Ballymena,1417,2,16,7,7,62,48,14,55
Crusaders,1417,3,15,6,9,51,41,10,51
Linfield,1417,4,13,10,7,58,32,26,49
Cliftonville,1417,5,13,4,13,51,50,1,43
Ards,1417,6,13,4,13,37,42,-5,43
Glenavon,1417,7,11,9,10,48,49,-1,42
Dungannon,1417,8,9,8,13,44,43,1,35
Glentoran,1417,9,9,8,13,33,44,-11,35
Portadown,1417,10,6,7,17,29,49,-20,25
Ballinamalla,1417,11,7,2,21,28,60,-32,23
Crusaders,1418,1,19,6,5,58,36,22,63
Linfield,1418,2,15,10,5,64,32,32,55
Cliftonville,1418,3,14,4,12,50,43,7,46
Coleraine,1418,4,12,9,9,43,37,6,45
Glenavon,1418,5,12,9,9,51,47,4,45
Ballymena,1418,6,13,6,11,58,60,-2,45
Ards,1418,7,12,4,14,38,46,-8,40
Dungannon,1418,8,10,9,11,46,46,0,39
Glentoran,1418,9,10,5,15,39,48,-9,35
Portadown,1418,10,9,3,18,25,47,-22,30
Ballinamalla,1418,11,5,3,22,26,56,-30,18
Linfield,1419,1,16,11,3,56,22,34,59
Crusaders,1419,2,16,9,5,56,37,19,57
Ballymena,1419,3,14,7,9,60,56,4,49
Cliftonville,1419,4,13,8,9,46,34,12,47
Dungannon,1419,5,11,10,9,57,43,14,43
Coleraine,1419,6,10,10,10,37,41,-4,40
Glenavon,1419,7,8,12,10,43,43,0,36
Portadown,1419,8,8,6,16,25,42,-17,30
Glentoran,1419,9,7,9,14,26,46,-20,30
Ards,1419,10,7,8,15,36,53,-17,29
Ballinamalla,1419,11,6,8,16,29,54,-25,26
Crusaders,1420,1,14,11,5,54,31,23,53
Linfield,1420,2,13,10,7,55,26,29,49
Ballymena,1420,3,14,7,9,60,56,4,49
Coleraine,1420,4,12,12,6,42,32,10,48
Glenavon,1420,5,12,11,7,50,42,8,47
Cliftonville,1420,6,14,4,12,53,46,7,46
Ards,1420,7,13,4,13,38,43,-5,43
Dungannon,1420,8,10,9,11,53,50,3,39
Glentoran,1420,9,8,9,13,31,47,-16,33
Ballinamalla,1420,10,8,4,18,30,60,-30,28
Portadown,1420,11,4,5,21,26,59,-33,17
Crusaders,1421,1,15,11,4,51,29,22,56
Cliftonville,1421,2,16,6,8,56,37,19,54
Ballymena,1421,3,15,6,9,55,54,1,51
Dungannon,1421,4,13,8,9,55,44,11,47
Linfield,1421,5,12,10,8,52,30,22,46
Glenavon,1421,6,11,10,9,44,42,2,43
Coleraine,1421,7,9,10,11,37,40,-3,37
Ards,1421,8,8,9,13,41,50,-9,33
Glentoran,1421,9,8,9,13,29,43,-14,33
Portadown,1421,10,7,8,15,27,46,-19,29
Ballinamalla,1421,11,5,5,20,28,60,-32,20
Cliftonville,1422,1,17,6,7,58,35,23,57
Crusaders,1422,2,17,5,8,52,42,10,56
Linfield,1422,3,15,9,6,68,35,33,54
Glenavon,1422,4,13,9,8,47,42,5,48
Ballymena,1422,5,13,7,10,51,56,-5,46
Coleraine,1422,6,12,9,9,48,39,9,45
Ards,1422,7,11,5,14,39,45,-6,38
Dungannon,1422,8,8,9,13,45,48,-3,33
Ballinamalla,1422,9,8,4,18,23,43,-20,28
Portadown,1422,10,7,6,17,25,48,-23,27
Glentoran,1422,11,6,7,17,26,49,-23,25
Crusaders,1423,1,18,6,6,56,29,27,60
Linfield,1423,2,16,8,6,64,31,33,56
Cliftonville,1423,3,15,3,12,46,42,4,48
Ballymena,1423,4,14,4,12,65,67,-2,46
Dungannon,1423,5,12,7,11,56,47,9,43
Glenavon,1423,6,11,10,9,44,41,3,43
Coleraine,1423,7,11,9,10,38,40,-2,42
Portadown,1423,8,10,4,16,30,46,-16,34
Glentoran,1423,9,9,6,15,31,47,-16,33
Ballinamalla,1423,10,9,3,18,31,50,-19,30
Ards,1423,11,7,6,17,30,51,-21,27
Crusaders,1424,1,19,8,3,61,31,30,65
Linfield,1424,2,16,7,7,56,30,26,55
Ballymena,1424,3,15,7,8,69,58,11,52
Glenavon,1424,4,12,10,8,45,40,5,46
Coleraine,1424,5,12,10,8,44,45,-1,46
Cliftonville,1424,6,12,7,11,47,40,7,43
Dungannon,1424,7,10,8,12,49,45,4,38
Glentoran,1424,8,10,6,14,37,46,-9,36
Ards,1424,9,8,4,18,40,62,-22,28
Portadown,1424,10,6,6,18,27,50,-23,24
Ballinamalla,1424,11,7,3,20,25,53,-28,24
Crusaders,1425,1,19,5,6,59,29,30,62
Linfield,1425,2,16,9,5,62,31,31,57
Cliftonville,1425,3,15,4,11,49,44,5,49
Ballymena,1425,4,14,7,9,56,55,1,49
Coleraine,1425,5,12,10,8,41,36,5,46
Glenavon,1425,6,11,11,8,51,41,10,44
Dungannon,1425,7,11,8,11,47,46,1,41
Glentoran,1425,8,9,10,11,34,41,-7,37
Ballinamalla,1425,9,6,7,17,28,50,-22,25
Portadown,1425,10,6,6,18,20,47,-27,24
Ards,1425,11,5,5,20,28,55,-27,20
Linfield,1426,1,19,7,4,66,34,32,64
Crusaders,1426,2,17,5,8,55,36,19,56
Glenavon,1426,3,15,8,7,48,37,11,53
Coleraine,1426,4,14,7,9,43,37,6,49
Cliftonville,1426,5,14,4,12,51,45,6,46
Ballymena,1426,6,12,4,14,60,63,-3,40
Dungannon,1426,7,11,6,13,46,43,3,39
Ballinamalla,1426,8,9,6,15,34,48,-14,33
Ards,1426,9,9,4,17,34,51,-17,31
Glentoran,1426,10,6,9,15,30,45,-15,27
Portadown,1426,11,7,4,19,26,54,-28,25
Linfield,1427,1,17,8,5,64,25,39,59
Crusaders,1427,2,16,9,5,55,35,20,57
Ballymena,1427,3,16,8,6,64,49,15,56
Cliftonville,1427,4,15,5,10,48,35,13,50
Coleraine,1427,5,11,10,9,39,37,2,43
Glenavon,1427,6,10,11,9,52,50,2,41
Dungannon,1427,7,9,12,9,48,39,9,39
Glentoran,1427,8,8,8,14,24,43,-19,32
Ballinamalla,1427,9,8,4,18,26,52,-26,28
Ards,1427,10,7,4,19,29,55,-26,25
Portadown,1427,11,6,5,19,21,50,-29,23
Ballymena,1428,1,16,6,8,59,53,6,54
Coleraine,1428,2,13,12,5,52,38,14,51
Linfield,1428,3,14,8,8,60,39,21,50
Crusaders,1428,4,14,7,9,53,52,1,49
Cliftonville,1428,5,12,8,10,48,40,8,44
Glenavon,1428,6,11,9,10,52,47,5,42
Portadown,1428,7,11,8,11,34,40,-6,41
Ballinamalla,1428,8,11,3,16,34,48,-14,36
Glentoran,1428,9,9,7,14,32,45,-13,34
Dungannon,1428,10,7,8,15,45,51,-6,29
Ards,1428,11,7,4,19,37,53,-16,25
Ballymena,1429,1,17,5,8,61,55,6,56
Crusaders,1429,2,16,6,8,53,36,17,54
Glenavon,1429,3,12,12,6,56,43,13,48
Cliftonville,1429,4,14,6,10,45,34,11,48
Coleraine,1429,5,12,10,8,40,37,3,46
Linfield,1429,6,12,8,10,59,39,20,44
Dungannon,1429,7,11,9,10,53,45,8,42
Ards,1429,8,12,3,15,38,48,-10,39
Glentoran,1429,9,8,7,15,36,52,-16,31
Portadown,1429,10,6,6,18,24,49,-25,24
Ballinamalla,1429,11,6,6,18,28,55,-27,24
Linfield,1430,1,13,11,6,58,38,20,50
Cliftonville,1430,2,15,5,10,45,36,9,50
Ballymena,1430,3,13,7,10,60,60,0,46
Crusaders,1430,4,12,9,9,48,44,4,45
Glenavon,1430,5,11,11,8,49,41,8,44
Ards,1430,6,11,6,13,41,43,-2,39
Ballinamalla,1430,7,11,6,13,39,50,-11,39
Dungannon,1430,8,9,11,10,57,47,10,38
Glentoran,1430,9,9,9,12,38,42,-4,36
Coleraine,1430,10,8,11,11,31,40,-9,35
Portadown,1430,11,7,6,17,27,52,-25,27
Crusaders,1431,1,16,8,6,55,39,16,56
Cliftonville,1431,2,15,6,9,57,41,16,51
Ballymena,1431,3,14,7,9,54,57,-3,49
Linfield,1431,4,11,12,7,50,33,17,45
Glenavon,1431,5,10,12,8,52,48,4,42
Coleraine,1431,6,10,8,12,38,40,-2,38
Ballinamalla,1431,7,10,6,14,35,45,-10,36
Dungannon,1431,8,9,8,13,46,48,-2,35
Ards,1431,9,9,7,14,38,46,-8,34
Glentoran,1431,10,8,10,12,27,42,-15,34
Portadown,1431,11,7,8,15,32,45,-13,29
Cliftonville,1432,1,18,6,6,50,31,19,60
Crusaders,1432,2,15,10,5,61,34,27,55
Coleraine,1432,3,14,10,6,54,40,14,52
Linfield,1432,4,12,10,8,53,32,21,46
Glenavon,1432,5,10,11,9,46,46,0,41
Ballymena,1432,6,12,4,14,54,57,-3,40
Dungannon,1432,7,9,12,9,51,43,8,39
Ards,1432,8,10,7,13,41,47,-6,37
Glentoran,1432,9,7,8,15,31,49,-18,29
Ballinamalla,1432,10,8,3,19,26,59,-33,27
Portadown,1432,11,6,7,17,20,49,-29,25
Linfield,1433,1,18,9,3,63,24,39,63
Cliftonville,1433,2,18,4,8,65,40,25,58
Ballymena,1433,3,17,3,10,64,54,10,54
Crusaders,1433,4,14,7,9,47,35,12,49
Glenavon,1433,5,12,10,8,45,45,0,46
Coleraine,1433,6,9,15,6,39,37,2,42
Dungannon,1433,7,8,9,13,44,47,-3,33
Ards,1433,8,8,6,16,37,55,-18,30
Ballinamalla,1433,9,7,7,16,29,50,-21,28
Glentoran,1433,10,5,10,15,25,47,-22,25
Portadown,1433,11,6,6,18,24,48,-24,24
Linfield,1434,1,17,10,3,63,30,33,61
Ballymena,1434,2,19,4,7,64,46,18,61
Crusaders,1434,3,16,5,9,52,36,16,53
Cliftonville,1434,4,12,10,8,48,39,9,46
Coleraine,1434,5,10,12,8,41,32,9,42
Glenavon,1434,6,9,13,8,37,39,-2,40
Glentoran,1434,7,9,9,12,33,40,-7,36
Dungannon,1434,8,8,11,11,44,44,0,35
Ards,1434,9,7,5,18,32,53,-21,26
Portadown,1434,10,6,8,16,22,47,-25,26
Ballinamalla,1434,11,6,5,19,23,53,-30,23
Crusaders,1435,1,17,7,6,54,28,26,58
Ballymena,1435,2,17,5,8,55,50,5,56
Linfield,1435,3,15,9,6,59,35,24,54
Cliftonville,1435,4,14,6,10,51,36,15,48
Portadown,1435,5,12,4,14,33,42,-9,40
Coleraine,1435,6,9,10,11,40,41,-1,37
Glenavon,1435,7,9,10,11,37,41,-4,37
Ards,1435,8,11,4,15,42,52,-10,37
Dungannon,1435,9,8,11,11,46,47,-1,35
Glentoran,1435,10,9,5,16,25,40,-15,32
Ballinamalla,1435,11,5,7,18,22,52,-30,22
Crusaders,1436,1,18,7,5,60,37,23,61
Linfield,1436,2,17,8,5,63,23,40,59
Cliftonville,1436,3,16,4,10,59,45,14,52
Ballymena,1436,4,14,7,9,57,56,1,49
Coleraine,1436,5,12,8,10,48,42,6,44
Dungannon,1436,6,10,10,10,49,40,9,40
Glenavon,1436,7,9,12,9,44,47,-3,39
Ards,1436,8,9,5,16,38,50,-12,32
Glentoran,1436,9,8,7,15,26,48,-22,31
Portadown,1436,10,7,8,15,22,47,-25,29
Ballinamalla,1436,11,5,4,21,26,57,-31,19
Linfield,1437,1,16,9,5,65,32,33,57
Glenavon,1437,2,15,9,6,56,35,21,54
Crusaders,1437,3,15,8,7,51,37,14,53
Ballymena,1437,4,16,5,9,59,57,2,53
Cliftonville,1437,5,16,3,11,60,45,15,51
Coleraine,1437,6,9,11,10,38,42,-4,38
Dungannon,1437,7,9,10,11,47,48,-1,37
Glentoran,1437,8,9,5,16,28,47,-19,32
Ards,1437,9,8,5,17,41,52,-11,29
Ballinamalla,1437,10,8,5,17,33,54,-21,29
Portadown,1437,11,7,4,19,26,55,-29,25
Linfield,1438,1,16,8,6,60,32,28,56
Crusaders,1438,2,16,6,8,52,34,18,54
Cliftonville,1438,3,16,5,9,62,43,19,53
Dungannon,1438,4,13,7,10,59,41,18,46
Ballymena,1438,5,13,5,12,55,60,-5,44
Glentoran,1438,6,11,9,10,32,35,-3,42
Glenavon,1438,7,9,13,8,42,46,-4,40
Coleraine,1438,8,10,8,12,40,41,-1,38
Ards,1438,9,9,7,14,34,46,-12,34
Ballinamalla,1438,10,10,1,19,29,52,-23,31
Portadown,1438,11,5,5,20,24,59,-35,20
Cliftonville,1439,1,20,3,7,63,35,28,63
Ballymena,1439,2,18,4,8,57,53,4,58
Crusaders,1439,3,17,5,8,52,36,16,56
Linfield,1439,4,15,7,8,58,34,24,52
Coleraine,1439,5,12,8,10,45,38,7,44
Glenavon,1439,6,11,9,10,45,42,3,42
Dungannon,1439,7,10,8,12,56,46,10,38
Glentoran,1439,8,9,7,14,32,40,-8,34
Ards,1439,9,8,5,17,32,51,-19,29
Ballinamalla,1439,10,8,4,18,31,56,-25,28
Portadown,1439,11,6,2,22,22,62,-40,20
Linfield,1440,1,15,8,7,57,31,26,53
Cliftonville,1440,2,16,5,9,52,33,19,53
Glenavon,1440,3,13,11,6,54,42,12,50
Crusaders,1440,4,14,7,9,48,35,13,49
Coleraine,1440,5,13,10,7,43,37,6,49
Dungannon,1440,6,11,10,9,51,41,10,43
Ballymena,1440,7,11,6,13,52,67,-15,39
Ballinamalla,1440,8,10,7,13,36,46,-10,37
Glentoran,1440,9,8,11,11,35,43,-8,35
Ards,1440,10,8,4,18,38,60,-22,28
Portadown,1440,11,4,5,21,23,54,-31,17
Crusaders,1441,1,17,6,7,51,28,23,57
Ballymena,1441,2,16,5,9,66,52,14,53
Linfield,1441,3,13,8,9,56,35,21,47
Cliftonville,1441,4,14,5,11,48,37,11,47
Coleraine,1441,5,10,12,8,40,40,0,42
Dungannon,1441,6,11,8,11,48,41,7,41
Glentoran,1441,7,10,7,13,38,47,-9,37
Portadown,1441,8,11,4,15,31,48,-17,37
Glenavon,1441,9,7,15,8,40,46,-6,36
Ards,1441,10,9,3,18,37,56,-19,30
Ballinamalla,1441,11,9,3,18,35,60,-25,30
Linfield,1442,1,17,9,4,67,30,37,60
Crusaders,1442,2,17,7,6,67,41,26,58
Ballymena,1442,3,16,5,9,62,56,6,53
Cliftonville,1442,4,15,6,9,51,40,11,51
Dungannon,1442,5,11,11,8,55,46,9,44
Coleraine,1442,6,12,8,10,44,45,-1,44
Glenavon,1442,7,11,9,10,45,47,-2,42
Ards,1442,8,9,6,15,45,55,-10,33
Glentoran,1442,9,6,9,15,26,46,-20,27
Portadown,1442,10,7,3,20,26,54,-28,24
Ballinamalla,1442,11,6,3,21,24,52,-28,21
Crusaders,1443,1,17,9,4,63,31,32,60
Ballymena,1443,2,14,10,6,65,65,0,52
Linfield,1443,3,14,7,9,61,39,22,49
Dungannon,1443,4,14,6,10,59,43,16,48
Cliftonville,1443,5,14,5,11,59,45,14,47
Glenavon,1443,6,12,9,9,47,49,-2,45
Coleraine,1443,7,10,10,10,45,41,4,40
Glentoran,1443,8,8,9,13,37,53,-16,33
Ards,1443,9,9,4,17,36,51,-15,31
Ballinamalla,1443,10,7,5,18,28,55,-27,26
Portadown,1443,11,6,6,18,26,54,-28,24
Crusaders,1444,1,20,8,2,63,30,33,68
Cliftonville,1444,2,16,6,8,58,46,12,54
Ballymena,1444,3,16,5,9,65,54,11,53
Linfield,1444,4,11,12,7,50,32,18,45
Coleraine,1444,5,11,9,10,43,43,0,42
Glenavon,1444,6,9,12,9,46,49,-3,39
Dungannon,1444,7,8,11,11,42,46,-4,35
Portadown,1444,8,10,5,15,33,43,-10,35
Ards,1444,9,8,6,16,39,54,-15,30
Glentoran,1444,10,8,4,18,31,48,-17,28
Ballinamalla,1444,11,6,6,18,23,48,-25,24
Linfield,1445,1,14,11,5,56,28,28,53
Coleraine,1445,2,15,8,7,46,35,11,53
Cliftonville,1445,3,15,6,9,55,40,15,51
Crusaders,1445,4,14,7,9,53,35,18,49
Ballymena,1445,5,14,4,12,57,59,-2,46
Glenavon,1445,6,12,9,9,45,40,5,45
Dungannon,1445,7,10,7,13,49,50,-1,37
Glentoran,1445,8,8,10,12,35,45,-10,34
Portadown,1445,9,9,5,16,26,43,-17,32
Ballinamalla,1445,10,9,3,18,31,59,-28,30
Ards,1445,11,7,6,17,37,56,-19,27
Crusaders,1446,1,17,8,5,52,33,19,59
Linfield,1446,2,16,8,6,64,29,35,56
Ballymena,1446,3,16,4,10,54,58,-4,52
Coleraine,1446,4,11,10,9,41,39,2,43
Cliftonville,1446,5,12,6,12,48,43,5,42
Dungannon,1446,6,10,10,10,45,40,5,40
Glenavon,1446,7,10,10,10,42,43,-1,40
Ballinamalla,1446,8,11,4,15,37,47,-10,37
Ards,1446,9,8,7,15,39,48,-9,31
Portadown,1446,10,7,7,16,22,41,-19,28
Glentoran,1446,11,6,8,16,31,54,-23,26
Cliftonville,1447,1,20,4,6,62,30,32,64
Crusaders,1447,2,16,9,5,47,31,16,57
Linfield,1447,3,14,8,8,54,31,23,50
Ballymena,1447,4,15,5,10,52,53,-1,50
Glenavon,1447,5,12,12,6,44,34,10,48
Coleraine,1447,6,9,13,8,35,34,1,40
Dungannon,1447,7,8,8,14,42,48,-6,32
Glentoran,1447,8,6,12,12,27,42,-15,30
Ballinamalla,1447,9,8,5,17,27,46,-19,29
Ards,1447,10,7,6,17,32,46,-14,27
Portadown,1447,11,6,6,18,20,47,-27,24
Cliftonville,1448,1,18,5,7,51,29,22,59
Ballymena,1448,2,16,5,9,52,50,2,53
Crusaders,1448,3,13,11,6,48,30,18,50
Coleraine,1448,4,13,9,8,43,34,9,48
Glenavon,1448,5,11,12,7,43,43,0,45
Linfield,1448,6,11,10,9,52,29,23,43
Dungannon,1448,7,10,10,10,47,41,6,40
Glentoran,1448,8,9,5,16,32,47,-15,32
Ballinamalla,1448,9,9,4,17,28,46,-18,31
Ards,1448,10,9,3,18,36,57,-21,30
Portadown,1448,11,5,8,17,14,40,-26,23
Crusaders,1449,1,16,8,6,53,34,19,56
Ballymena,1449,2,15,5,10,59,56,3,50
Cliftonville,1449,3,14,5,11,52,44,8,47
Linfield,1449,4,11,11,8,55,38,17,44
Glenavon,1449,5,11,11,8,46,43,3,44
Coleraine,1449,6,10,11,9,44,43,1,41
Dungannon,1449,7,10,10,10,53,48,5,40
Glentoran,1449,8,11,7,12,32,40,-8,40
Ards,1449,9,10,7,13,43,43,0,37
Portadown,1449,10,8,5,17,24,42,-18,29
Ballinamalla,1449,11,7,4,19,23,53,-30,25
Linfield,1450,1,14,10,6,57,28,29,52
Crusaders,1450,2,15,5,10,54,38,16,50
Ballymena,1450,3,15,5,10,57,54,3,50
Cliftonville,1450,4,15,3,12,51,44,7,48
Glenavon,1450,5,12,9,9,50,49,1,45
Dungannon,1450,6,12,8,10,53,44,9,44
Coleraine,1450,7,9,12,9,39,37,2,39
Ards,1450,8,10,7,13,33,43,-10,37
Glentoran,1450,9,9,8,13,26,41,-15,35
Portadown,1450,10,8,6,16,26,45,-19,30
Ballinamalla,1450,11,7,5,18,28,51,-23,26
Crusaders,1451,1,16,8,6,51,36,15,56
Linfield,1451,2,14,11,5,55,27,28,53
Cliftonville,1451,3,16,5,9,53,36,17,53
Glenavon,1451,4,12,11,7,47,42,5,47
Ballymena,1451,5,12,8,10,57,60,-3,44
Glentoran,1451,6,12,7,11,28,34,-6,43
Dungannon,1451,7,10,10,10,53,45,8,40
Coleraine,1451,8,10,9,11,44,42,2,39
Ards,1451,9,9,4,17,38,56,-18,31
Ballinamalla,1451,10,9,1,20,31,54,-23,28
Portadown,1451,11,5,6,19,25,50,-25,21
Linfield,1452,1,15,9,6,61,27,34,54
Crusaders,1452,2,15,9,6,51,31,20,54
Ballymena,1452,3,16,6,8,60,55,5,54
Cliftonville,1452,4,14,4,12,53,47,6,46
Dungannon,1452,5,12,7,11,49,43,6,43
Glentoran,1452,6,12,7,11,38,36,2,43
Glenavon,1452,7,11,10,9,43,44,-1,43
Coleraine,1452,8,10,9,11,46,44,2,39
Ballinamalla,1452,9,7,8,15,29,50,-21,29
Portadown,1452,10,6,7,17,26,50,-24,25
Ards,1452,11,6,6,18,29,58,-29,24
Ballymena,1453,1,16,6,8,67,52,15,54
Linfield,1453,2,14,10,6,57,28,29,52
Cliftonville,1453,3,14,8,8,52,35,17,50
Crusaders,1453,4,13,10,7,48,36,12,49
Glenavon,1453,5,12,12,6,45,37,8,48
Coleraine,1453,6,10,10,10,35,44,-9,40
Ballinamalla,1453,7,10,7,13,36,48,-12,37
Glentoran,1453,8,7,11,12,28,43,-15,32
Portadown,1453,9,7,8,15,26,47,-21,29
Dungannon,1453,10,6,10,14,40,49,-9,28
Ards,1453,11,5,10,15,31,46,-15,25
Crusaders,1454,1,18,6,6,62,35,27,60
Linfield,1454,2,14,11,5,61,29,32,53
Cliftonville,1454,3,14,5,11,49,39,10,47
Ballymena,1454,4,13,6,11,50,60,-10,45
Dungannon,1454,5,11,8,11,49,46,3,41
Glenavon,1454,6,9,13,8,43,42,1,40
Glentoran,1454,7,10,9,11,26,37,-11,39
Coleraine,1454,8,8,13,9,37,39,-2,37
Ards,1454,9,8,7,15,37,47,-10,31
Portadown,1454,10,7,8,15,28,43,-15,29
Ballinamalla,1454,11,7,6,17,27,52,-25,27
Crusaders,1455,1,20,5,5,58,27,31,65
Linfield,1455,2,16,8,6,74,39,35,56
Ballymena,1455,3,15,7,8,59,58,1,52
Glenavon,1455,4,12,11,7,51,44,7,47
Cliftonville,1455,5,13,5,12,50,46,4,44
Coleraine,1455,6,11,11,8,45,41,4,44
Dungannon,1455,7,9,11,10,46,41,5,38
Ards,1455,8,9,6,15,39,51,-12,33
Portadown,1455,9,7,6,17,25,49,-24,27
Ballinamalla,1455,10,7,5,18,28,52,-24,26
Glentoran,1455,11,4,9,17,30,57,-27,21
Cliftonville,1456,1,16,7,7,55,39,16,55
Crusaders,1456,2,16,6,8,55,35,20,54
Linfield,1456,3,13,10,7,59,32,27,49
Glenavon,1456,4,12,10,8,44,40,4,46
Coleraine,1456,5,11,10,9,43,37,6,43
Ballymena,1456,6,12,7,11,56,60,-4,43
Glentoran,1456,7,9,10,11,37,45,-8,37
Ards,1456,8,11,2,17,40,59,-19,35
Portadown,1456,9,9,5,16,36,54,-18,32
Ballinamalla,1456,10,9,4,17,37,53,-16,31
Dungannon,1456,11,7,9,14,45,53,-8,30
Cliftonville,1457,1,16,5,9,51,36,15,53
Crusaders,1457,2,15,7,8,55,41,14,52
Linfield,1457,3,13,11,6,54,31,23,50
Ballymena,1457,4,13,7,10,62,60,2,46
Glenavon,1457,5,11,10,9,55,51,4,43
Dungannon,1457,6,11,8,11,52,43,9,41
Coleraine,1457,7,10,11,9,41,39,2,41
Glentoran,1457,8,10,7,13,33,43,-10,37
Ards,1457,9,9,4,17,36,56,-20,31
Ballinamalla,1457,10,10,1,19,35,55,-20,31
Portadown,1457,11,7,9,14,24,43,-19,30
Crusaders,1458,1,17,9,4,59,40,19,60
Linfield,1458,2,15,10,5,57,28,29,55
Ballymena,1458,3,16,7,7,70,57,13,55
Coleraine,1458,4,13,11,6,41,35,6,50
Cliftonville,1458,5,12,8,10,48,41,7,44
Glenavon,1458,6,10,10,10,45,47,-2,40
Dungannon,1458,7,9,8,13,47,45,2,35
Glentoran,1458,8,7,10,13,30,43,-13,31
Ards,1458,9,8,6,16,35,51,-16,30
Ballinamalla,1458,10,6,7,17,30,48,-18,25
Portadown,1458,11,6,6,18,19,46,-27,24
Crusaders,1459,1,17,7,6,64,40,24,58
Coleraine,1459,2,16,9,5,54,33,21,57
Linfield,1459,3,15,10,5,56,27,29,55
Glenavon,1459,4,14,7,9,55,47,8,49
Cliftonville,1459,5,12,5,13,49,41,8,41
Ballymena,1459,6,11,6,13,53,69,-16,39
Dungannon,1459,7,10,8,12,47,51,-4,38
Ards,1459,8,9,5,16,41,52,-11,32
Portadown,1459,9,8,7,15,25,43,-18,31
Glentoran,1459,10,7,9,14,31,44,-13,30
Ballinamalla,1459,11,7,5,18,30,58,-28,26
Crusaders,1460,1,17,7,6,65,45,20,58
Ballymena,1460,2,15,7,8,53,53,0,52
Cliftonville,1460,3,15,4,11,52,44,8,49
Linfield,1460,4,10,11,9,50,39,11,41
Coleraine,1460,5,10,11,9,46,43,3,41
Ards,1460,6,12,4,14,45,45,0,40
Glentoran,1460,7,11,7,12,38,46,-8,40
Dungannon,1460,8,10,9,11,51,48,3,39
Glenavon,1460,9,10,9,11,46,50,-4,39
Portadown,1460,10,8,5,17,23,40,-17,29
Ballinamalla,1460,11,6,8,16,40,56,-16,26
Crusaders,1461,1,16,9,5,54,32,22,57
Linfield,1461,2,16,7,7,60,36,24,55
Cliftonville,1461,3,16,6,8,55,37,18,54
Ballymena,1461,4,14,5,11,64,61,3,47
Coleraine,1461,5,11,13,6,50,38,12,46
Glenavon,1461,6,11,10,9,45,47,-2,43
Dungannon,1461,7,10,9,11,49,47,2,39
Glentoran,1461,8,10,6,14,37,46,-9,36
Ards,1461,9,7,7,16,33,48,-15,28
Ballinamalla,1461,10,8,3,19,31,58,-27,27
Portadown,1461,11,6,5,19,27,55,-28,23
Crusaders,1462,1,17,8,5,58,34,24,59
Ballymena,1462,2,17,6,7,63,59,4,57
Linfield,1462,3,13,10,7,55,31,24,49
Coleraine,1462,4,10,14,6,45,37,8,44
Cliftonville,1462,5,12,7,11,48,40,8,43
Dungannon,1462,6,9,12,9,54,49,5,39
Glenavon,1462,7,7,15,8,43,47,-4,36
Ards,1462,8,10,5,15,38,48,-10,35
Ballinamalla,1462,9,8,6,16,37,55,-18,30
Glentoran,1462,10,8,5,17,35,55,-20,29
Portadown,1462,11,7,6,17,23,44,-21,27
Crusaders,1463,1,15,7,8,53,38,15,52
Glenavon,1463,2,13,12,5,54,45,9,51
Cliftonville,1463,3,15,4,11,50,35,15,49
Coleraine,1463,4,12,10,8,44,39,5,46
Linfield,1463,5,11,12,7,53,28,25,45
Ballymena,1463,6,13,5,12,54,61,-7,44
Dungannon,1463,7,11,10,9,49,42,7,43
Ards,1463,8,9,6,15,37,46,-9,33
Glentoran,1463,9,8,9,13,32,44,-12,33
Portadown,1463,10,6,10,14,25,46,-21,28
Ballinamalla,1463,11,7,5,18,26,53,-27,26
Crusaders,1464,1,16,8,6,49,36,13,56
Linfield,1464,2,14,11,5,64,29,35,53
Cliftonville,1464,3,16,4,10,58,45,13,52
Glenavon,1464,4,13,10,7,52,40,12,49
Coleraine,1464,5,9,14,7,48,44,4,41
Ballymena,1464,6,12,5,13,58,73,-15,41
Glentoran,1464,7,9,11,10,33,40,-7,38
Dungannon,1464,8,9,10,11,45,44,1,37
Ards,1464,9,8,5,17,40,55,-15,29
Ballinamalla,1464,10,7,8,15,30,50,-20,29
Portadown,1464,11,8,2,20,32,53,-21,26
Cliftonville,1465,1,18,3,9,55,35,20,57
Linfield,1465,2,16,8,6,66,39,27,56
Crusaders,1465,3,16,7,7,53,32,21,55
Glenavon,1465,4,12,11,7,50,43,7,47
Ballymena,1465,5,13,6,11,47,53,-6,45
Coleraine,1465,6,11,11,8,44,38,6,44
Dungannon,1465,7,8,12,10,45,39,6,36
Portadown,1465,8,10,4,16,28,44,-16,34
Glentoran,1465,9,8,8,14,34,48,-14,32
Ards,1465,10,8,5,17,39,57,-18,29
Ballinamalla,1465,11,5,5,20,23,56,-33,20
Crusaders,1466,1,22,7,1,65,22,43,73
Linfield,1466,2,15,8,7,53,27,26,53
Cliftonville,1466,3,15,5,10,52,38,14,50
Coleraine,1466,4,11,13,6,44,36,8,46
Glenavon,1466,5,11,10,9,42,41,1,43
Dungannon,1466,6,10,7,13,45,46,-1,37
Ballymena,1466,7,11,4,15,46,56,-10,37
Glentoran,1466,8,9,8,13,29,41,-12,35
Ballinamalla,1466,9,8,6,16,26,46,-20,30
Ards,1466,10,7,5,18,29,50,-21,26
Portadown,1466,11,7,5,18,19,47,-28,26
Crusaders,1467,1,16,10,4,53,32,21,58
Cliftonville,1467,2,16,7,7,55,34,21,55
Linfield,1467,3,15,9,6,64,33,31,54
Coleraine,1467,4,14,9,7,45,33,12,51
Glenavon,1467,5,10,13,7,51,44,7,43
Dungannon,1467,6,11,9,10,49,37,12,42
Ballymena,1467,7,12,5,13,48,64,-16,41
Portadown,1467,8,8,8,14,27,40,-13,32
Glentoran,1467,9,8,7,15,28,47,-19,31
Ards,1467,10,7,5,18,35,54,-19,26
Ballinamalla,1467,11,4,6,20,23,60,-37,18
Crusaders,1468,1,18,9,3,63,32,31,63
Cliftonville,1468,2,18,6,6,59,34,25,60
Linfield,1468,3,13,11,6,56,38,18,50
Glenavon,1468,4,11,11,8,46,41,5,44
Ballymena,1468,5,12,7,11,52,65,-13,43
Glentoran,1468,6,10,9,11,43,46,-3,39
Coleraine,1468,7,8,14,8,42,44,-2,38
Dungannon,1468,8,9,10,11,53,50,3,37
Ards,1468,9,8,8,14,33,42,-9,32
Portadown,1468,10,4,8,18,23,50,-27,20
Ballinamalla,1468,11,5,5,20,30,58,-28,20
Linfield,1469,1,18,7,5,67,31,36,61
Crusaders,1469,2,17,6,7,55,32,23,57
Cliftonville,1469,3,17,2,11,55,45,10,53
Coleraine,1469,4,13,8,9,41,37,4,47
Glenavon,1469,5,11,13,6,47,38,9,46
Ballymena,1469,6,12,6,12,59,68,-9,42
Dungannon,1469,7,9,9,12,47,43,4,36
Glentoran,1469,8,10,6,14,36,46,-10,36
Ards,1469,9,8,6,16,32,45,-13,30
Ballinamalla,1469,10,7,5,18,27,54,-27,26
Portadown,1469,11,6,6,18,23,50,-27,24
Linfield,1470,1,17,11,2,67,28,39,62
Crusaders,1470,2,17,9,4,55,28,27,60
Coleraine,1470,3,14,9,7,49,36,13,51
Cliftonville,1470,4,15,4,11,48,41,7,49
Ballymena,1470,5,14,5,11,56,56,0,47
Glenavon,1470,6,12,8,10,46,46,0,44
Dungannon,1470,7,6,14,10,43,46,-3,32
Ballinamalla,1470,8,9,5,16,28,46,-18,32
Ards,1470,9,8,4,18,38,55,-17,28
Portadown,1470,10,8,2,20,28,51,-23,26
Glentoran,1470,11,6,7,17,31,56,-25,25
Crusaders,1471,1,17,7,6,58,38,20,58
Ballymena,1471,2,17,5,8,65,55,10,56
Cliftonville,1471,3,15,5,10,59,41,18,50
Linfield,1471,4,13,10,7,63,39,24,49
Coleraine,1471,5,13,9,8,49,40,9,48
Dungannon,1471,6,11,11,8,51,41,10,44
Glenavon,1471,7,9,9,12,49,53,-4,36
Ballinamalla,1471,8,9,5,16,31,58,-27,32
Ards,1471,9,8,7,15,41,58,-17,31
Glentoran,1471,10,6,8,16,32,47,-15,26
Portadown,1471,11,6,6,18,20,48,-28,24
Crusaders,1472,1,18,7,5,61,33,28,61
Cliftonville,1472,2,18,3,9,67,42,25,57
Ballymena,1472,3,15,6,9,58,59,-1,51
Glenavon,1472,4,11,11,8,38,39,-1,44
Linfield,1472,5,11,10,9,56,39,17,43
Coleraine,1472,6,11,10,9,42,38,4,43
Dungannon,1472,7,9,10,11,50,51,-1,37
Ards,1472,8,10,4,16,41,52,-11,34
Glentoran,1472,9,8,9,13,24,41,-17,33
Ballinamalla,1472,10,7,6,17,29,49,-20,27
Portadown,1472,11,5,8,17,30,53,-23,23
Crusaders,1473,1,15,7,8,59,38,21,52
Ballymena,1473,2,15,7,8,63,57,6,52
Linfield,1473,3,12,11,7,62,37,25,47
Cliftonville,1473,4,14,5,11,49,45,4,47
Glenavon,1473,5,11,11,8,54,50,4,44
Coleraine,1473,6,11,9,10,49,50,-1,42
Glentoran,1473,7,10,9,11,32,41,-9,39
Dungannon,1473,8,9,11,10,50,45,5,38
Ards,1473,9,9,7,14,47,56,-9,34
Ballinamalla,1473,10,9,4,17,38,62,-24,31
Portadown,1473,11,6,7,17,25,47,-22,25
Crusaders,1474,1,17,5,8,56,42,14,56
Linfield,1474,2,13,8,9,60,37,23,47
Dungannon,1474,3,13,8,9,56,40,16,47
Ballymena,1474,4,13,8,9,61,60,1,47
Cliftonville,1474,5,13,5,12,48,41,7,44
Glenavon,1474,6,11,9,10,48,52,-4,42
Coleraine,1474,7,9,13,8,42,42,0,40
Glentoran,1474,8,11,7,12,36,42,-6,40
Ards,1474,9,12,3,15,38,43,-5,39
Portadown,1474,10,11,2,17,35,50,-15,35
Ballinamalla,1474,11,6,4,20,31,62,-31,22
Linfield,1475,1,18,6,6,58,30,28,60
Crusaders,1475,2,15,8,7,57,40,17,53
Glenavon,1475,3,13,11,6,55,44,11,50
Ballymena,1475,4,13,6,11,62,58,4,45
Coleraine,1475,5,10,12,8,43,40,3,42
Dungannon,1475,6,10,9,11,47,41,6,39
Glentoran,1475,7,11,6,13,36,47,-11,39
Cliftonville,1475,8,11,4,15,47,54,-7,37
Portadown,1475,9,9,5,16,25,43,-18,32
Ards,1475,10,7,9,14,36,46,-10,30
Ballinamalla,1475,11,7,6,17,34,57,-23,27
Linfield,1476,1,19,8,3,64,24,40,65
Crusaders,1476,2,16,6,8,58,38,20,54
Ballymena,1476,3,15,4,11,50,56,-6,49
Cliftonville,1476,4,14,5,11,53,41,12,47
Glenavon,1476,5,10,13,7,44,44,0,43
Glentoran,1476,6,12,6,12,32,42,-10,42
Coleraine,1476,7,9,12,9,42,41,1,39
Ards,1476,8,10,4,16,39,49,-10,34
Ballinamalla,1476,9,10,4,16,41,52,-11,34
Dungannon,1476,10,7,7,16,41,52,-11,28
Portadown,1476,11,6,5,19,25,50,-25,23
Crusaders,1477,1,16,8,6,62,37,25,56
Ballymena,1477,2,15,7,8,66,64,2,52
Linfield,1477,3,14,7,9,60,44,16,49
Cliftonville,1477,4,14,7,9,51,37,14,49
Glenavon,1477,5,12,12,6,60,49,11,48
Coleraine,1477,6,11,12,7,52,43,9,45
Glentoran,1477,7,11,7,12,31,39,-8,40
Dungannon,1477,8,9,6,15,48,54,-6,33
Ards,1477,9,9,6,15,44,54,-10,33
Portadown,1477,10,7,5,18,22,48,-26,26
Ballinamalla,1477,11,6,5,19,28,55,-27,23
Crusaders,1478,1,20,5,5,61,32,29,65
Cliftonville,1478,2,18,4,8,65,38,27,58
Linfield,1478,3,14,8,8,57,30,27,50
Glenavon,1478,4,13,10,7,51,40,11,49
Ballymena,1478,5,12,8,10,54,67,-13,44
Coleraine,1478,6,10,12,8,41,39,2,42
Dungannon,1478,7,8,9,13,49,50,-1,33
Portadown,1478,8,8,6,16,26,45,-19,30
Glentoran,1478,9,7,7,16,21,43,-22,28
Ballinamalla,1478,10,7,7,16,27,50,-23,28
Ards,1478,11,7,6,17,27,45,-18,27
Crusaders,1479,1,19,7,4,63,36,27,64
Linfield,1479,2,14,11,5,60,31,29,53
Cliftonville,1479,3,16,4,10,59,40,19,52
Glenavon,1479,4,12,13,5,52,41,11,49
Ballymena,1479,5,13,6,11,55,59,-4,45
Dungannon,1479,6,12,7,11,54,47,7,43
Coleraine,1479,7,8,10,12,39,44,-5,34
Ballinamalla,1479,8,9,6,15,32,50,-18,33
Ards,1479,9,8,5,17,35,55,-20,29
Glentoran,1479,10,7,8,15,34,54,-20,29
Portadown,1479,11,5,7,18,17,43,-26,22
Crusaders,1480,1,18,7,5,58,34,24,61
Cliftonville,1480,2,18,5,7,58,41,17,59
Ballymena,1480,3,16,6,8,66,55,11,54
Linfield,1480,4,15,8,7,62,36,26,53
Coleraine,1480,5,12,9,9,46,38,8,45
Glenavon,1480,6,10,9,11,43,46,-3,39
Dungannon,1480,7,8,9,13,43,44,-1,33
Portadown,1480,8,9,6,15,29,47,-18,33
Ards,1480,9,8,5,17,35,52,-17,29
Glentoran,1480,10,8,4,18,32,53,-21,28
Ballinamalla,1480,11,7,4,19,35,61,-26,25
Crusaders,1481,1,15,9,6,49,34,15,54
Glenavon,1481,2,14,11,5,53,34,19,53
Linfield,1481,3,13,12,5,55,31,24,51
Cliftonville,1481,4,13,9,8,54,39,15,48
Ballymena,1481,5,11,10,9,52,53,-1,43
Glentoran,1481,6,9,10,11,35,40,-5,37
Portadown,1481,7,10,7,13,25,36,-11,37
Coleraine,1481,8,9,9,12,35,41,-6,36
Dungannon,1481,9,8,9,13,45,46,-1,33
Ards,1481,10,9,5,16,33,48,-15,32
Ballinamalla,1481,11,7,3,20,24,58,-34,24
Cliftonville,1482,1,18,4,8,58,35,23,58
Linfield,1482,2,13,10,7,60,37,23,49
Crusaders,1482,3,13,9,8,49,32,17,48
Glenavon,1482,4,12,10,8,49,43,6,46
Ballymena,1482,5,13,7,10,55,62,-7,46
Coleraine,1482,6,11,12,7,46,40,6,45
Ballinamalla,1482,7,12,4,14,39,48,-9,40
Portadown,1482,8,9,6,15,28,41,-13,33
Ards,1482,9,9,5,16,37,55,-18,32
Dungannon,1482,10,8,7,15,43,50,-7,31
Glentoran,1482,11,5,10,15,34,55,-21,25
Cliftonville,1483,1,16,5,9,59,38,21,53
Crusaders,1483,2,15,8,7,56,38,18,53
Ballymena,1483,3,13,7,10,55,58,-3,46
Coleraine,1483,4,11,12,7,44,34,10,45
Linfield,1483,5,11,10,9,53,35,18,43
Dungannon,1483,6,11,10,9,50,37,13,43
Glenavon,1483,7,10,12,8,46,45,1,42
Ards,1483,8,10,9,11,37,42,-5,39
Ballinamalla,1483,9,8,6,16,32,51,-19,30
Glentoran,1483,10,7,8,15,25,50,-25,29
Portadown,1483,11,5,9,16,21,50,-29,24
Linfield,1484,1,16,9,5,58,26,32,57
Crusaders,1484,2,14,10,6,48,31,17,52
Cliftonville,1484,3,14,6,10,56,40,16,48
Ballymena,1484,4,14,5,11,57,61,-4,47
Dungannon,1484,5,12,9,9,51,35,16,45
Coleraine,1484,6,12,9,9,41,40,1,45
Glenavon,1484,7,11,9,10,49,51,-2,42
Ballinamalla,1484,8,9,7,14,30,44,-14,34
Glentoran,1484,9,9,7,14,29,45,-16,34
Ards,1484,10,7,5,18,35,56,-21,26
Portadown,1484,11,6,6,18,28,53,-25,24
Linfield,1485,1,18,7,5,59,24,35,61
Cliftonville,1485,2,16,7,7,53,31,22,55
Crusaders,1485,3,14,11,5,51,35,16,53
Ballymena,1485,4,15,6,9,65,57,8,51
Glenavon,1485,5,12,10,8,47,42,5,46
Dungannon,1485,6,8,12,10,50,46,4,36
Coleraine,1485,7,8,10,12,40,47,-7,34
Glentoran,1485,8,9,6,15,26,43,-17,33
Ballinamalla,1485,9,9,5,16,30,50,-20,32
Ards,1485,10,8,4,18,38,57,-19,28
Portadown,1485,11,6,6,18,26,53,-27,24
Crusaders,1486,1,19,6,5,65,35,30,63
Ballymena,1486,2,15,6,9,62,56,6,51
Cliftonville,1486,3,15,5,10,59,43,16,50
Coleraine,1486,4,13,8,9,45,43,2,47
Glentoran,1486,5,13,6,11,36,39,-3,45
Linfield,1486,6,10,9,11,50,44,6,39
Glenavon,1486,7,9,11,10,44,47,-3,38
Dungannon,1486,8,9,10,11,49,48,1,37
Ards,1486,9,8,7,15,34,49,-15,31
Portadown,1486,10,8,5,17,23,41,-18,29
Ballinamalla,1486,11,7,5,18,26,48,-22,26
Glenavon,1487,1,13,12,5,53,41,12,51
Linfield,1487,2,13,10,7,50,29,21,49
Crusaders,1487,3,14,7,9,53,41,12,49
Ballymena,1487,4,15,4,11,59,54,5,49
Glentoran,1487,5,13,5,12,41,52,-11,44
Dungannon,1487,6,11,9,10,54,44,10,42
Cliftonville,1487,7,12,4,14,47,44,3,40
Coleraine,1487,8,10,9,11,43,44,-1,39
Ards,1487,9,8,7,15,35,48,-13,31
Portadown,1487,10,8,7,15,36,53,-17,31
Ballinamalla,1487,11,7,8,15,29,50,-21,29
Cliftonville,1488,1,18,4,8,55,34,21,58
Crusaders,1488,2,15,10,5,63,36,27,55
Linfield,1488,3,12,14,4,56,29,27,50
Ballymena,1488,4,14,8,8,63,59,4,50
Coleraine,1488,5,13,8,9,45,39,6,47
Glenavon,1488,6,8,12,10,37,43,-6,36
Glentoran,1488,7,8,10,12,31,43,-12,34
Dungannon,1488,8,7,11,12,43,44,-1,32
Ballinamalla,1488,9,7,8,15,32,51,-19,29
Ards,1488,10,8,5,17,38,62,-24,29
Portadown,1488,11,5,10,15,25,48,-23,25
Linfield,1489,1,16,10,4,64,26,38,58
Crusaders,1489,2,16,7,7,51,34,17,55
Cliftonville,1489,3,15,6,9,58,39,19,51
Coleraine,1489,4,13,11,6,37,29,8,50
Ballymena,1489,5,12,7,11,52,55,-3,43
Glenavon,1489,6,10,10,10,42,50,-8,40
Dungannon,1489,7,9,9,12,47,46,1,36
Glentoran,1489,8,8,9,13,35,49,-14,33
Ards,1489,9,8,6,16,32,47,-15,30
Ballinamalla,1489,10,8,6,16,33,52,-19,30
Portadown,1489,11,6,7,17,22,46,-24,25
Cliftonville,1490,1,17,5,8,56,37,19,56
Crusaders,1490,2,15,8,7,61,42,19,53
Glenavon,1490,3,14,11,5,47,38,9,53
Linfield,1490,4,15,6,9,56,31,25,51
Ballymena,1490,5,12,7,11,53,56,-3,43
Dungannon,1490,6,9,9,12,55,47,8,36
Coleraine,1490,7,9,9,12,39,43,-4,36
Ards,1490,8,10,6,14,42,49,-7,36
Glentoran,1490,9,9,9,12,29,43,-14,36
Ballinamalla,1490,10,10,1,19,32,57,-25,31
Portadown,1490,11,6,7,17,28,55,-27,25
Crusaders,1491,1,20,5,5,68,31,37,65
Cliftonville,1491,2,17,6,7,54,35,19,57
Linfield,1491,3,12,13,5,51,31,20,49
Glenavon,1491,4,11,13,6,48,41,7,46
Ballymena,1491,5,13,7,10,57,61,-4,46
Coleraine,1491,6,10,10,10,42,40,2,40
Dungannon,1491,7,9,12,9,52,48,4,39
Glentoran,1491,8,9,7,14,30,43,-13,34
Ards,1491,9,8,5,17,36,54,-18,29
Portadown,1491,10,6,8,16,28,53,-25,26
Ballinamalla,1491,11,4,6,20,25,54,-29,18
Ballymena,1492,1,18,5,7,57,50,7,59
Crusaders,1492,2,16,8,6,51,33,18,56
Linfield,1492,3,13,9,8,53,31,22,48
Cliftonville,1492,4,14,5,11,48,38,10,47
Coleraine,1492,5,12,10,8,46,40,6,46
Glenavon,1492,6,10,11,9,44,46,-2,41
Portadown,1492,7,11,5,14,31,39,-8,38
Dungannon,1492,8,8,11,11,44,42,2,35
Ards,1492,9,10,4,16,35,45,-10,34
Glentoran,1492,10,6,8,16,26,47,-21,26
Ballinamalla,1492,11,6,6,18,33,57,-24,24
Crusaders,1493,1,18,7,5,65,33,32,61
Linfield,1493,2,15,8,7,64,37,27,53
Cliftonville,1493,3,15,5,10,55,45,10,50
Ballymena,1493,4,14,6,10,57,61,-4,48
Coleraine,1493,5,12,10,8,47,40,7,46
Ards,1493,6,14,2,14,39,41,-2,44
Glenavon,1493,7,9,12,9,44,50,-6,39
Dungannon,1493,8,9,8,13,48,45,3,35
Glentoran,1493,9,9,7,14,33,49,-16,34
Ballinamalla,1493,10,6,8,16,30,48,-18,26
Portadown,1493,11,5,5,20,21,54,-33,20
Crusaders,1494,1,16,10,4,56,30,26,58
Ballymena,1494,2,17,6,7,59,46,13,57
Coleraine,1494,3,13,10,7,46,38,8,49
Linfield,1494,4,13,8,9,56,37,19,47
Cliftonville,1494,5,12,5,13,46,43,3,41
Ards,1494,6,12,5,13,41,44,-3,41
Glentoran,1494,7,10,8,12,28,38,-10,38
Dungannon,1494,8,9,10,11,47,46,1,37
Glenavon,1494,9,8,11,11,36,43,-7,35
Ballinamalla,1494,10,9,1,20,29,53,-24,28
Portadown,1494,11,5,8,17,21,47,-26,23
Coleraine,1495,1,16,8,6,44,32,12,56
Linfield,1495,2,16,7,7,66,31,35,55
Crusaders,1495,3,14,9,7,58,41,17,51
Cliftonville,1495,4,15,3,12,47,41,6,48
Ballymena,1495,5,14,5,11,56,65,-9,47
Dungannon,1495,6,13,7,10,57,42,15,46
Glenavon,1495,7,12,7,11,43,42,1,43
Ards,1495,8,10,4,16,37,46,-9,34
Ballinamalla,1495,9,9,4,17,37,57,-20,31
Portadown,1495,10,8,5,17,24,44,-20,29
Glentoran,1495,11,4,9,17,24,52,-28,21
Ballymena,1496,1,17,4,9,63,53,10,55
Dungannon,1496,2,15,8,7,60,39,21,53
Cliftonville,1496,3,15,6,9,54,39,15,51
Crusaders,1496,4,14,9,7,54,40,14,51
Linfield,1496,5,13,8,9,55,39,16,47
Coleraine,1496,6,12,9,9,49,42,7,45
Glenavon,1496,7,7,16,7,46,49,-3,37
Glentoran,1496,8,8,8,14,30,49,-19,32
Ards,1496,9,9,4,17,39,55,-16,31
Ballinamalla,1496,10,7,7,16,28,49,-21,28
Portadown,1496,11,6,5,19,23,47,-24,23
Cliftonville,1497,1,18,4,8,60,40,20,58
Linfield,1497,2,16,9,5,61,27,34,57
Glenavon,1497,3,14,9,7,50,39,11,51
Ballymena,1497,4,14,6,10,66,60,6,48
Crusaders,1497,5,12,8,10,48,45,3,44
Coleraine,1497,6,11,9,10,43,41,2,42
Dungannon,1497,7,10,9,11,57,54,3,39
Ballinamalla,1497,8,11,5,14,36,52,-16,38
Glentoran,1497,9,7,7,16,29,51,-22,28
Ards,1497,10,8,3,19,40,59,-19,27
Portadown,1497,11,5,9,16,25,47,-22,24
Crusaders,1498,1,17,7,6,65,31,34,58
Linfield,1498,2,16,9,5,54,23,31,57
Cliftonville,1498,3,15,4,11,51,39,12,49
Ballymena,1498,4,14,6,10,55,56,-1,48
Coleraine,1498,5,11,12,7,46,36,10,45
Dungannon,1498,6,11,7,12,41,46,-5,40
Glentoran,1498,7,10,6,14,28,45,-17,36
Glenavon,1498,8,7,13,10,42,47,-5,34
Portadown,1498,9,9,6,15,27,48,-21,33
Ballinamalla,1498,10,9,2,19,31,50,-19,29
Ards,1498,11,7,6,17,33,52,-19,27
Linfield,1499,1,16,8,6,61,34,27,56
Crusaders,1499,2,14,11,5,53,32,21,53
Coleraine,1499,3,13,11,6,51,38,13,50
Ballymena,1499,4,13,10,7,63,56,7,49
Cliftonville,1499,5,13,9,8,55,44,11,48
Glenavon,1499,6,10,11,9,49,54,-5,41
Glentoran,1499,7,10,9,11,29,40,-11,39
Dungannon,1499,8,8,9,13,50,55,-5,33
Ards,1499,9,8,4,18,39,55,-16,28
Portadown,1499,10,6,8,16,29,46,-17,26
Ballinamalla,1499,11,6,6,18,25,50,-25,24
Crusaders,1500,1,20,5,5,59,27,32,65
Linfield,1500,2,17,9,4,70,37,33,60
Ballymena,1500,3,15,5,10,62,58,4,50
Cliftonville,1500,4,15,4,11,52,45,7,49
Coleraine,1500,5,11,10,9,41,36,5,43
Glenavon,1500,6,11,8,11,46,47,-1,41
Portadown,1500,7,11,2,17,30,48,-18,35
Dungannon,1500,8,9,7,14,50,44,6,34
Glentoran,1500,9,8,8,14,28,45,-17,32
Ards,1500,10,7,7,16,34,56,-22,28
Ballinamalla,1500,11,6,5,19,27,56,-29,23
Crusaders,1501,1,18,9,3,59,26,33,63
Linfield,1501,2,17,6,7,66,33,33,57
Cliftonville,1501,3,17,3,10,56,38,18,54
Ballymena,1501,4,16,5,9,57,53,4,53
Coleraine,1501,5,13,8,9,49,47,2,47
Dungannon,1501,6,11,9,10,53,44,9,42
Glenavon,1501,7,8,12,10,44,50,-6,36
Glentoran,1501,8,8,7,15,32,51,-19,31
Ards,1501,9,7,6,17,38,58,-20,27
Ballinamalla,1501,10,8,3,19,30,58,-28,27
Portadown,1501,11,6,4,20,23,49,-26,22
Ballymena,1502,1,16,9,5,52,42,10,57
Linfield,1502,2,14,13,3,61,30,31,55
Crusaders,1502,3,13,11,6,54,38,16,50
Coleraine,1502,4,12,11,7,48,34,14,47
Cliftonville,1502,5,14,5,11,46,38,8,47
Glenavon,1502,6,10,11,9,52,54,-2,41
Dungannon,1502,7,10,9,11,49,47,2,39
Ards,1502,8,8,7,15,36,48,-12,31
Ballinamalla,1502,9,7,6,17,32,53,-21,27
Glentoran,1502,10,6,8,16,26,49,-23,26
Portadown,1502,10,6,8,16,26,49,-23,26
Crusaders,1503,1,16,7,7,57,37,20,55
Linfield,1503,2,15,7,8,59,34,25,52
Coleraine,1503,3,13,11,6,47,34,13,50
Glenavon,1503,4,13,10,7,44,39,5,49
Cliftonville,1503,5,15,3,12,50,40,10,48
Ballymena,1503,6,13,7,10,51,55,-4,46
Glentoran,1503,7,10,8,12,37,46,-9,38
Dungannon,1503,8,8,9,13,54,48,6,33
Ards,1503,9,10,3,17,34,49,-15,33
Portadown,1503,10,9,4,17,25,44,-19,31
Ballinamalla,1503,11,6,5,19,24,56,-32,23
Crusaders,1504,1,14,11,5,47,31,16,53
Linfield,1504,2,15,7,8,56,23,33,52
Cliftonville,1504,3,13,5,12,53,46,7,44
Coleraine,1504,4,12,8,10,41,41,0,44
Ballymena,1504,5,13,4,13,52,59,-7,43
Glenavon,1504,6,10,12,8,46,42,4,42
Ards,1504,7,11,7,12,39,45,-6,40
Dungannon,1504,8,9,11,10,46,41,5,38
Ballinamalla,1504,9,10,6,14,32,46,-14,36
Glentoran,1504,10,8,9,13,31,46,-15,33
Portadown,1504,11,5,10,15,22,45,-23,25
Crusaders,1505,1,17,9,4,57,29,28,60
Ballymena,1505,2,18,4,8,71,59,12,58
Linfield,1505,3,14,9,7,54,33,21,51
Cliftonville,1505,4,15,5,10,58,45,13,50
Coleraine,1505,5,9,12,9,43,45,-2,39
Glenavon,1505,6,9,11,10,44,46,-2,38
Dungannon,1505,7,8,13,9,50,44,6,37
Glentoran,1505,8,9,7,14,33,49,-16,34
Ards,1505,9,9,5,16,40,54,-14,32
Ballinamalla,1505,10,10,2,18,27,45,-18,32
Portadown,1505,11,6,5,19,28,56,-28,23
Ballymena,1506,1,16,7,7,61,54,7,55
Crusaders,1506,2,13,14,3,53,31,22,53
Linfield,1506,3,13,13,4,64,30,34,52
Cliftonville,1506,4,14,8,8,47,35,12,50
Coleraine,1506,5,10,9,11,43,44,-1,39
Dungannon,1506,6,9,11,10,45,45,0,38
Ards,1506,7,11,5,14,43,48,-5,38
Glentoran,1506,8,9,9,12,31,41,-10,36
Glenavon,1506,9,8,11,11,40,53,-13,35
Ballinamalla,1506,10,6,8,16,29,48,-19,26
Portadown,1506,11,5,7,18,27,54,-27,22
Linfield,1507,1,16,10,4,56,28,28,58
Crusaders,1507,2,16,10,4,55,37,18,58
Cliftonville,1507,3,15,9,6,58,37,21,54
Coleraine,1507,4,11,10,9,37,37,0,43
Ballymena,1507,5,11,8,11,61,60,1,41
Glenavon,1507,6,9,12,9,39,40,-1,39
Dungannon,1507,7,8,12,10,43,45,-2,36
Glentoran,1507,8,8,10,12,31,46,-15,34
Ards,1507,9,8,5,17,37,49,-12,29
Portadown,1507,10,7,8,15,22,42,-20,29
Ballinamalla,1507,11,7,4,19,35,53,-18,25
Crusaders,1508,1,17,6,7,53,32,21,57
Ballymena,1508,2,15,9,6,63,54,9,54
Linfield,1508,3,14,10,6,55,34,21,52
Glenavon,1508,4,12,10,8,45,43,2,46
Cliftonville,1508,5,12,6,12,50,45,5,42
Coleraine,1508,6,10,10,10,42,42,0,40
Dungannon,1508,7,10,9,11,45,42,3,39
Ards,1508,8,10,6,14,35,44,-9,36
Ballinamalla,1508,9,11,2,17,32,48,-16,35
Portadown,1508,10,9,3,18,32,47,-15,30
Glentoran,1508,11,6,7,17,24,45,-21,25
Crusaders,1509,1,16,9,5,57,36,21,57
Linfield,1509,2,16,8,6,63,34,29,56
Cliftonville,1509,3,15,7,8,48,31,17,52
Glenavon,1509,4,12,12,6,52,47,5,48
Ballymena,1509,5,14,4,12,54,53,1,46
Dungannon,1509,6,12,9,9,60,38,22,45
Coleraine,1509,7,10,9,11,37,42,-5,39
Glentoran,1509,8,10,8,12,29,38,-9,38
Ards,1509,9,7,5,18,38,59,-21,26
Ballinamalla,1509,10,8,2,20,29,65,-36,26
Portadown,1509,11,4,9,17,18,42,-24,21
Crusaders,1510,1,16,8,6,52,36,16,56
Cliftonville,1510,2,16,5,9,56,39,17,53
Linfield,1510,3,12,10,8,54,31,23,46
Ballymena,1510,4,12,10,8,62,60,2,46
Glentoran,1510,5,13,7,10,37,41,-4,46
Glenavon,1510,6,11,9,10,46,46,0,42
Coleraine,1510,7,8,12,10,40,41,-1,36
Dungannon,1510,8,9,8,13,50,49,1,35
Ballinamalla,1510,9,11,1,18,32,49,-17,34
Portadown,1510,10,10,2,18,25,46,-21,32
Ards,1510,11,8,6,16,33,49,-16,30
Linfield,1511,1,17,7,6,71,33,38,58
Cliftonville,1511,2,17,5,8,57,42,15,56
Coleraine,1511,3,14,10,6,51,38,13,52
Crusaders,1511,4,14,5,11,46,36,10,47
Ballymena,1511,5,13,5,12,54,60,-6,44
Dungannon,1511,6,12,7,11,60,43,17,43
Glenavon,1511,7,9,11,10,43,56,-13,38
Glentoran,1511,8,9,7,14,33,48,-15,34
Ballinamalla,1511,9,8,6,16,35,52,-17,30
Ards,1511,10,8,5,17,36,57,-21,29
Portadown,1511,11,8,4,18,24,45,-21,28
Crusaders,1512,1,22,5,3,73,34,39,71
Cliftonville,1512,2,15,5,10,59,46,13,50
Ballymena,1512,3,13,7,10,61,57,4,46
Linfield,1512,4,12,9,9,59,43,16,45
Glenavon,1512,5,11,8,11,53,54,-1,41
Ards,1512,6,11,6,13,41,43,-2,39
Dungannon,1512,7,9,11,10,50,44,6,38
Coleraine,1512,8,9,11,10,45,45,0,38
Portadown,1512,9,10,6,14,26,44,-18,36
Glentoran,1512,10,7,6,17,25,55,-30,27
Ballinamalla,1512,11,7,4,19,33,60,-27,25
Ballymena,1513,1,18,5,7,59,51,8,59
Cliftonville,1513,2,17,3,10,61,39,22,54
Crusaders,1513,3,15,9,6,54,37,17,54
Linfield,1513,4,14,8,8,63,32,31,50
Coleraine,1513,5,11,10,9,43,41,2,43
Glenavon,1513,6,11,9,10,49,57,-8,42
Dungannon,1513,7,9,9,12,47,46,1,36
Glentoran,1513,8,8,9,13,30,44,-14,33
Ards,1513,9,8,6,16,34,53,-19,30
Portadown,1513,10,9,3,18,27,46,-19,30
Ballinamalla,1513,11,7,5,18,31,52,-21,26
Crusaders,1514,1,18,10,2,61,28,33,64
Cliftonville,1514,2,15,5,10,56,36,20,50
Linfield,1514,3,13,10,7,63,41,22,49
Ballymena,1514,4,11,10,9,58,58,0,43
Glenavon,1514,5,10,11,9,51,49,2,41
Glentoran,1514,6,10,11,9,36,42,-6,41
Ards,1514,7,11,5,14,43,49,-6,38
Coleraine,1514,8,10,8,12,38,55,-17,38
Dungannon,1514,9,8,10,12,48,49,-1,34
Portadown,1514,10,7,6,17,23,45,-22,27
Ballinamalla,1514,11,7,4,19,31,56,-25,25
Linfield,1515,1,14,9,7,58,30,28,51
Crusaders,1515,2,14,9,7,53,38,15,51
Cliftonville,1515,3,16,3,11,50,38,12,51
Dungannon,1515,4,13,8,9,49,36,13,47
Coleraine,1515,5,12,9,9,37,35,2,45
Ballymena,1515,6,12,7,11,57,56,1,43
Glenavon,1515,7,9,11,10,42,46,-4,38
Glentoran,1515,8,10,8,12,31,45,-14,38
Ards,1515,9,11,2,17,38,48,-10,35
Portadown,1515,10,8,6,16,25,46,-21,30
Ballinamalla,1515,11,7,6,17,28,50,-22,27
Crusaders,1516,1,15,8,7,55,35,20,53
Cliftonville,1516,2,15,8,7,56,40,16,53
Glenavon,1516,3,13,12,5,46,36,10,51
Linfield,1516,4,13,8,9,55,36,19,47
Ballymena,1516,5,14,5,11,57,57,0,47
Coleraine,1516,6,9,11,10,40,42,-2,38
Dungannon,1516,7,8,11,11,54,55,-1,35
Glentoran,1516,8,9,8,13,35,44,-9,35
Portadown,1516,9,10,4,16,28,46,-18,34
Ards,1516,10,9,5,16,44,53,-9,32
Ballinamalla,1516,11,8,4,18,28,54,-26,28
Linfield,1517,1,14,12,4,64,30,34,54
Crusaders,1517,2,16,6,8,53,32,21,54
Cliftonville,1517,3,16,6,8,57,40,17,54
Coleraine,1517,4,11,10,9,41,37,4,43
Ballymena,1517,5,12,6,12,57,69,-12,42
Dungannon,1517,6,10,11,9,50,45,5,41
Glenavon,1517,7,10,11,9,44,43,1,41
Ards,1517,8,9,8,13,40,46,-6,35
Ballinamalla,1517,9,8,7,15,33,52,-19,31
Portadown,1517,10,9,4,17,31,50,-19,31
Glentoran,1517,11,7,5,18,25,51,-26,26
Cliftonville,1518,1,17,5,8,56,37,19,56
Linfield,1518,2,13,11,6,61,36,25,50
Ballymena,1518,3,15,5,10,62,61,1,50
Crusaders,1518,4,14,7,9,45,35,10,49
Coleraine,1518,5,11,11,8,45,38,7,44
Glenavon,1518,6,10,10,10,46,47,-1,40
Ards,1518,7,11,4,15,44,49,-5,37
Dungannon,1518,8,8,10,12,40,44,-4,34
Glentoran,1518,9,8,10,12,32,45,-13,34
Ballinamalla,1518,10,8,6,16,32,50,-18,30
Portadown,1518,11,9,3,18,27,48,-21,30
Ballymena,1519,1,17,5,8,61,51,10,56
Crusaders,1519,2,16,7,7,52,32,20,55
Linfield,1519,3,15,9,6,54,27,27,54
Cliftonville,1519,4,15,7,8,46,37,9,52
Dungannon,1519,5,12,7,11,54,41,13,43
Coleraine,1519,6,10,11,9,39,35,4,41
Glenavon,1519,7,10,10,10,45,47,-2,40
Portadown,1519,8,10,5,15,31,46,-15,35
Ards,1519,9,8,7,15,36,53,-17,31
Ballinamalla,1519,10,7,4,19,26,56,-30,25
Glentoran,1519,11,5,8,17,23,42,-19,23
Linfield,1520,1,13,11,6,58,33,25,50
Cliftonville,1520,2,15,5,10,47,37,10,50
Glenavon,1520,3,13,10,7,57,48,9,49
Crusaders,1520,4,12,12,6,52,40,12,48
Dungannon,1520,5,12,9,9,56,41,15,45
Ballymena,1520,6,12,6,12,55,60,-5,42
Glentoran,1520,7,11,9,10,37,47,-10,42
Coleraine,1520,8,10,9,11,39,43,-4,39
Ards,1520,9,9,5,16,37,48,-11,32
Ballinamalla,1520,10,7,7,16,31,51,-20,28
Portadown,1520,11,7,5,18,29,50,-21,26
Linfield,1521,1,15,9,6,62,30,32,54
Cliftonville,1521,2,16,5,9,49,40,9,53
Crusaders,1521,3,14,10,6,51,28,23,52
Glenavon,1521,4,12,12,6,51,38,13,48
Ballymena,1521,5,14,5,11,64,67,-3,47
Dungannon,1521,6,12,8,10,48,41,7,44
Coleraine,1521,7,9,12,9,38,41,-3,39
Ards,1521,8,10,6,14,42,53,-11,36
Glentoran,1521,9,9,9,12,30,41,-11,36
Ballinamalla,1521,10,5,7,18,26,57,-31,22
Portadown,1521,11,4,7,19,27,52,-25,19
Crusaders,1522,1,15,9,6,47,30,17,54
Linfield,1522,2,14,10,6,53,26,27,52
Cliftonville,1522,3,15,6,9,55,38,17,51
Coleraine,1522,4,12,10,8,46,38,8,46
Ballymena,1522,5,13,5,12,58,61,-3,44
Glenavon,1522,6,9,12,9,37,39,-2,39
Dungannon,1522,7,9,10,11,47,44,3,37
Ards,1522,8,11,3,16,38,51,-13,36
Glentoran,1522,9,9,7,14,33,44,-11,34
Ballinamalla,1522,10,9,5,16,26,45,-19,32
Portadown,1522,11,9,3,18,22,46,-24,30
Linfield,1523,1,17,8,5,65,32,33,59
Crusaders,1523,2,17,6,7,54,30,24,57
Cliftonville,1523,3,17,4,9,47,38,9,55
Ballymena,1523,4,16,4,10,63,60,3,52
Coleraine,1523,5,11,11,8,45,37,8,44
Dungannon,1523,6,11,10,9,48,36,12,43
Glenavon,1523,7,10,9,11,46,48,-2,39
Ards,1523,8,8,7,15,32,46,-14,31
Ballinamalla,1523,9,8,6,16,29,51,-22,30
Glentoran,1523,10,6,9,15,25,45,-20,27
Portadown,1523,11,3,8,19,20,51,-31,17
Cliftonville,1524,1,17,7,6,57,30,27,58
Linfield,1524,2,16,9,5,63,32,31,57
Crusaders,1524,3,16,6,8,52,34,18,54
Ballymena,1524,4,15,5,10,58,58,0,50
Coleraine,1524,5,10,12,8,48,43,5,42
Glenavon,1524,6,11,9,10,46,49,-3,42
Dungannon,1524,7,9,10,11,47,46,1,37
Ards,1524,8,9,6,15,35,45,-10,33
Portadown,1524,9,9,4,17,25,48,-23,31
Ballinamalla,1524,10,8,5,17,39,57,-18,29
Glentoran,1524,11,5,7,18,27,55,-28,22
Crusaders,1525,1,18,7,5,65,32,33,61
Ballymena,1525,2,15,6,9,51,51,0,51
Cliftonville,1525,3,14,8,8,50,37,13,50
Linfield,1525,4,12,10,8,50,35,15,46
Coleraine,1525,5,12,10,8,41,33,8,46
Dungannon,1525,6,12,7,11,51,41,10,43
Glenavon,1525,7,10,13,7,44,46,-2,43
Glentoran,1525,8,9,6,15,28,44,-16,33
Ards,1525,9,7,9,14,36,47,-11,30
Portadown,1525,10,6,7,17,16,41,-25,25
Ballinamalla,1525,11,5,7,18,31,56,-25,22
Crusaders,1526,1,16,9,5,51,33,18,57
Linfield,1526,2,14,9,7,56,29,27,51
Glenavon,1526,3,13,11,6,55,40,15,50
Cliftonville,1526,4,15,5,10,53,40,13,50
Dungannon,1526,5,12,10,8,62,48,14,46
Ballymena,1526,6,12,7,11,52,61,-9,43
Coleraine,1526,7,10,8,12,38,45,-7,38
Portadown,1526,8,9,7,14,33,42,-9,34
Ballinamalla,1526,9,7,7,16,31,52,-21,28
Glentoran,1526,10,7,7,16,33,55,-22,28
Ards,1526,11,7,6,17,38,57,-19,27
Crusaders,1527,1,18,6,6,58,33,25,60
Linfield,1527,2,14,8,8,56,34,22,50
Glenavon,1527,3,11,12,7,57,47,10,45
Cliftonville,1527,4,13,5,12,54,48,6,44
Dungannon,1527,5,11,9,10,51,46,5,42
Ballymena,1527,6,11,8,11,54,61,-7,41
Glentoran,1527,7,12,5,13,32,45,-13,41
Coleraine,1527,8,9,12,9,47,44,3,39
Ards,1527,9,9,5,16,39,53,-14,32
Ballinamalla,1527,10,9,5,16,29,47,-18,32
Portadown,1527,11,7,7,16,25,44,-19,28
Crusaders,1528,1,16,8,6,53,31,22,56
Linfield,1528,2,13,13,4,56,30,26,52
Ballymena,1528,3,16,4,10,58,56,2,52
Coleraine,1528,4,12,13,5,42,29,13,49
Glenavon,1528,5,11,12,7,50,45,5,45
Cliftonville,1528,6,13,4,13,43,40,3,43
Ballinamalla,1528,7,11,5,14,29,41,-12,38
Glentoran,1528,8,8,10,12,29,40,-11,34
Dungannon,1528,9,8,8,14,43,45,-2,32
Ards,1528,10,7,8,15,29,47,-18,29
Portadown,1528,11,6,3,21,19,47,-28,21
Linfield,1529,1,17,9,4,62,27,35,60
Coleraine,1529,2,15,9,6,47,33,14,54
Crusaders,1529,3,14,9,7,51,44,7,51
Cliftonville,1529,4,14,6,10,52,44,8,48
Dungannon,1529,5,13,8,9,56,43,13,47
Ballymena,1529,6,13,5,12,58,64,-6,44
Glenavon,1529,7,9,11,10,41,44,-3,38
Glentoran,1529,8,7,10,13,30,43,-13,31
Ards,1529,9,7,7,16,37,52,-15,28
Ballinamalla,1529,10,8,3,19,34,51,-17,27
Portadown,1529,11,7,5,18,24,47,-23,26
Crusaders,1530,1,17,7,6,55,39,16,58
Cliftonville,1530,2,17,4,9,55,39,16,55
Linfield,1530,3,14,10,6,63,32,31,52
Coleraine,1530,4,12,12,6,46,35,11,48
Glenavon,1530,5,13,9,8,49,42,7,48
Dungannon,1530,6,11,8,11,59,41,18,41
Ballymena,1530,7,11,7,12,55,63,-8,40
Ards,1530,8,9,4,17,33,51,-18,31
Glentoran,1530,9,7,9,14,24,42,-18,30
Ballinamalla,1530,10,9,2,19,26,50,-24,29
Portadown,1530,11,8,2,20,18,49,-31,26
Glenavon,1531,1,16,9,5,58,43,15,57
Crusaders,1531,2,16,7,7,56,38,18,55
Linfield,1531,3,15,7,8,64,40,24,52
Coleraine,1531,4,13,10,7,45,34,11,49
Ballymena,1531,5,12,8,10,53,59,-6,44
Cliftonville,1531,6,13,4,13,48,41,7,43
Dungannon,1531,7,12,7,11,56,50,6,43
Glentoran,1531,8,9,7,14,32,46,-14,34
Ards,1531,9,8,4,18,35,50,-15,28
Portadown,1531,10,8,4,18,29,49,-20,28
Ballinamalla,1531,11,8,3,19,31,57,-26,27
Crusaders,1532,1,16,8,6,55,32,23,56
Linfield,1532,2,16,7,7,61,32,29,55
Coleraine,1532,3,15,8,7,54,40,14,53
Cliftonville,1532,4,14,5,11,50,43,7,47
Ballymena,1532,5,12,7,11,55,64,-9,43
Ards,1532,6,12,4,14,45,52,-7,40
Glenavon,1532,7,9,12,9,48,50,-2,39
Dungannon,1532,8,9,9,12,48,42,6,36
Glentoran,1532,9,7,10,13,28,41,-13,31
Ballinamalla,1532,10,7,7,16,27,55,-28,28
Portadown,1532,11,5,9,16,19,39,-20,24
Linfield,1533,1,16,9,5,56,26,30,57
Cliftonville,1533,2,17,4,9,58,44,14,55
Crusaders,1533,3,15,9,6,54,34,20,54
Glenavon,1533,4,12,10,8,51,48,3,46
Coleraine,1533,5,11,10,9,47,42,5,43
Ballymena,1533,6,12,3,15,53,61,-8,39
Glentoran,1533,7,9,9,12,32,41,-9,36
Ards,1533,8,9,6,15,36,44,-8,33
Dungannon,1533,9,7,11,12,48,51,-3,32
Portadown,1533,10,9,5,16,25,47,-22,32
Ballinamalla,1533,11,7,6,17,25,47,-22,27
Linfield,1534,1,16,8,6,58,33,25,56
Cliftonville,1534,2,17,4,9,53,35,18,55
Crusaders,1534,3,16,6,8,56,35,21,54
Ballymena,1534,4,15,7,8,58,57,1,52
Coleraine,1534,5,12,8,10,42,38,4,44
Glenavon,1534,6,11,9,10,52,47,5,42
Ballinamalla,1534,7,10,6,14,32,50,-18,36
Dungannon,1534,8,9,8,13,53,54,-1,35
Ards,1534,9,10,3,17,43,56,-13,33
Portadown,1534,10,7,6,17,30,48,-18,27
Glentoran,1534,11,6,7,17,29,53,-24,25
Coleraine,1535,1,15,8,7,50,35,15,53
Cliftonville,1535,2,15,6,9,49,37,12,51
Linfield,1535,3,12,14,4,58,29,29,50
Crusaders,1535,4,14,8,8,49,37,12,50
Ballymena,1535,5,12,8,10,60,54,6,44
Portadown,1535,6,11,8,11,31,35,-4,41
Glenavon,1535,7,8,12,10,46,52,-6,36
Dungannon,1535,8,9,8,13,47,52,-5,35
Ballinamalla,1535,9,9,6,15,28,47,-19,33
Ards,1535,10,9,5,16,37,50,-13,32
Glentoran,1535,11,7,5,18,25,52,-27,26
Linfield,1536,1,14,11,5,60,30,30,53
Crusaders,1536,2,15,7,8,57,42,15,52
Coleraine,1536,3,14,9,7,55,36,19,51
Cliftonville,1536,4,15,3,12,55,41,14,48
Glenavon,1536,5,12,11,7,45,41,4,47
Ballymena,1536,6,13,6,11,63,64,-1,45
Dungannon,1536,7,9,10,11,54,55,-1,37
Glentoran,1536,8,10,7,13,36,46,-10,37
Portadown,1536,9,8,7,15,31,48,-17,31
Ards,1536,10,7,6,17,32,53,-21,27
Ballinamalla,1536,11,7,5,18,23,55,-32,26
Linfield,1537,1,14,10,6,59,33,26,52
Cliftonville,1537,2,16,4,10,51,38,13,52
Crusaders,1537,3,14,9,7,52,35,17,51
Glenavon,1537,4,14,9,7,52,39,13,51
Ballymena,1537,5,14,8,8,72,61,11,50
Dungannon,1537,6,12,10,8,50,38,12,46
Coleraine,1537,7,9,10,11,35,42,-7,37
Glentoran,1537,8,9,8,13,31,48,-17,35
Ards,1537,9,9,4,17,37,50,-13,31
Portadown,1537,10,7,6,17,23,47,-24,27
Ballinamalla,1537,11,5,6,19,25,56,-31,21
Linfield,1538,1,18,8,4,61,29,32,62
Crusaders,1538,2,16,6,8,62,38,24,54
Cliftonville,1538,3,16,2,12,53,42,11,50
Ballymena,1538,4,14,8,8,64,58,6,50
Coleraine,1538,5,12,13,5,52,38,14,49
Dungannon,1538,6,13,7,10,55,42,13,46
Glenavon,1538,7,7,12,11,40,53,-13,33
Ballinamalla,1538,8,9,4,17,30,52,-22,31
Ards,1538,9,7,6,17,44,62,-18,27
Glentoran,1538,10,6,9,15,32,52,-20,27
Portadown,1538,11,8,3,19,29,56,-27,27
Crusaders,1539,1,16,10,4,59,31,28,58
Linfield,1539,2,16,9,5,62,29,33,57
Cliftonville,1539,3,13,7,10,52,40,12,46
Ballymena,1539,4,12,10,8,60,58,2,46
Glenavon,1539,5,11,11,8,49,50,-1,44
Coleraine,1539,6,9,13,8,51,44,7,40
Dungannon,1539,7,10,10,10,48,45,3,40
Portadown,1539,8,10,5,15,27,45,-18,35
Glentoran,1539,9,9,6,15,36,52,-16,33
Ards,1539,10,6,10,14,31,48,-17,28
Ballinamalla,1539,11,5,5,20,24,57,-33,20
Ballymena,1540,1,16,7,7,60,48,12,55
Cliftonville,1540,2,17,3,10,56,42,14,54
Linfield,1540,3,15,8,7,57,32,25,53
Glenavon,1540,4,14,10,6,59,41,18,52
Crusaders,1540,5,12,9,9,50,37,13,45
Ards,1540,6,11,4,15,46,49,-3,37
Dungannon,1540,7,9,9,12,41,41,0,36
Coleraine,1540,8,8,10,12,36,50,-14,34
Glentoran,1540,9,9,7,14,33,52,-19,34
Ballinamalla,1540,10,10,1,19,35,55,-20,31
Portadown,1540,11,8,4,18,27,53,-26,28
Cliftonville,1541,1,18,6,6,62,35,27,60
Linfield,1541,2,16,11,3,60,30,30,59
Crusaders,1541,3,14,7,9,51,38,13,49
Ballymena,1541,4,14,7,9,64,61,3,49
Coleraine,1541,5,13,9,8,46,39,7,48
Dungannon,1541,6,11,10,9,51,43,8,43
Glenavon,1541,7,9,11,10,44,45,-1,38
Glentoran,1541,8,8,7,15,29,44,-15,31
Ards,1541,9,7,7,16,37,49,-12,28
Ballinamalla,1541,10,7,5,18,26,58,-32,26
Portadown,1541,11,6,4,20,25,53,-28,22
Linfield,1542,1,17,8,5,62,33,29,59
Crusaders,1542,2,16,7,7,64,41,23,55
Ballymena,1542,3,15,6,9,64,56,8,51
Coleraine,1542,4,12,8,10,44,41,3,44
Glenavon,1542,5,11,11,8,50,48,2,44
Cliftonville,1542,6,12,6,12,49,48,1,42
Dungannon,1542,7,10,10,10,54,44,10,40
Glentoran,1542,8,11,6,13,33,46,-13,39
Ballinamalla,1542,9,8,5,17,36,55,-19,29
Portadown,1542,10,7,6,17,21,47,-26,27
Ards,1542,11,6,7,17,38,56,-18,25
Linfield,1543,1,16,7,7,56,25,31,55
Crusaders,1543,2,16,7,7,51,39,12,55
Cliftonville,1543,3,15,6,9,55,36,19,51
Ballymena,1543,4,14,6,10,56,52,4,48
Coleraine,1543,5,12,11,7,46,37,9,47
Dungannon,1543,6,10,8,12,46,42,4,38
Glenavon,1543,7,8,14,8,43,40,3,38
Glentoran,1543,8,9,8,13,28,40,-12,35
Portadown,1543,9,10,3,17,25,51,-26,33
Ballinamalla,1543,10,8,5,17,28,51,-23,29
Ards,1543,11,8,3,19,32,53,-21,27
Crusaders,1544,1,20,6,4,64,30,34,66
Ballymena,1544,2,15,6,9,61,55,6,51
Cliftonville,1544,3,13,7,10,51,42,9,46
Dungannon,1544,4,12,8,10,59,47,12,44
Coleraine,1544,5,10,12,8,40,37,3,42
Linfield,1544,6,10,11,9,54,38,16,41
Ards,1544,7,10,9,11,42,45,-3,39
Ballinamalla,1544,8,10,5,15,37,55,-18,35
Glenavon,1544,9,6,13,11,43,61,-18,31
Portadown,1544,10,8,6,16,25,43,-18,30
Glentoran,1544,11,4,11,15,25,48,-23,23
Crusaders,1545,1,15,8,7,50,36,14,53
Linfield,1545,2,13,13,4,58,27,31,52
Cliftonville,1545,3,15,6,9,57,41,16,51
Ballymena,1545,4,13,9,8,65,64,1,48
Glenavon,1545,5,12,11,7,50,43,7,47
Dungannon,1545,6,12,8,10,48,37,11,44
Coleraine,1545,7,9,11,10,40,42,-2,38
Ards,1545,8,10,6,14,38,44,-6,36
Glentoran,1545,9,9,9,12,36,47,-11,36
Portadown,1545,10,7,4,19,22,49,-27,25
Ballinamalla,1545,11,6,3,21,23,57,-34,21
Crusaders,1546,1,17,7,6,63,43,20,58
Glenavon,1546,2,16,8,6,68,43,25,56
Linfield,1546,3,15,8,7,61,38,23,53
Cliftonville,1546,4,15,5,10,58,42,16,50
Coleraine,1546,5,13,9,8,55,44,11,48
Ballymena,1546,6,13,6,11,63,72,-9,45
Dungannon,1546,7,10,9,11,50,51,-1,39
Glentoran,1546,8,10,7,13,34,50,-16,37
Ards,1546,9,7,5,18,41,56,-15,26
Ballinamalla,1546,10,7,4,19,35,62,-27,25
Portadown,1546,11,6,4,20,25,52,-27,22
Crusaders,1547,1,18,5,7,55,33,22,59
Ballymena,1547,2,16,7,7,55,43,12,55
Linfield,1547,3,14,8,8,60,38,22,50
Cliftonville,1547,4,15,5,10,47,41,6,50
Dungannon,1547,5,13,7,10,55,41,14,46
Coleraine,1547,6,11,9,10,37,42,-5,42
Glenavon,1547,7,10,8,12,42,46,-4,38
Glentoran,1547,8,8,10,12,34,48,-14,34
Ballinamalla,1547,9,10,3,17,38,51,-13,33
Portadown,1547,10,9,3,18,30,47,-17,30
Ards,1547,11,7,3,20,30,53,-23,24
Crusaders,1548,1,18,8,4,59,32,27,62
Linfield,1548,2,14,9,7,52,31,21,51
Cliftonville,1548,3,14,7,9,55,43,12,49
Glenavon,1548,4,12,11,7,55,49,6,47
Coleraine,1548,5,10,13,7,47,41,6,43
Ballymena,1548,6,11,8,11,47,55,-8,41
Dungannon,1548,7,10,9,11,50,43,7,39
Ards,1548,8,10,6,14,42,46,-4,36
Glentoran,1548,9,10,5,15,32,44,-12,35
Portadown,1548,10,7,6,17,33,55,-22,27
Ballinamalla,1548,11,5,6,19,32,65,-33,21
Linfield,1549,1,17,10,3,64,27,37,61
Crusaders,1549,2,17,7,6,56,39,17,58
Cliftonville,1549,3,13,6,11,46,44,2,45
Ballymena,1549,4,12,8,10,60,57,3,44
Coleraine,1549,5,10,10,10,36,33,3,40
Dungannon,1549,6,10,9,11,51,43,8,39
Ards,1549,7,11,6,13,36,43,-7,39
Glenavon,1549,8,9,9,12,40,48,-8,36
Portadown,1549,9,9,5,16,27,45,-18,32
Ballinamalla,1549,10,9,4,17,31,56,-25,31
Glentoran,1549,11,7,8,15,33,45,-12,29
Linfield,1550,1,16,9,5,61,23,38,57
Glenavon,1550,2,14,10,6,53,38,15,52
Crusaders,1550,3,14,6,10,52,41,11,48
Ballymena,1550,4,14,4,12,51,53,-2,46
Cliftonville,1550,5,14,3,13,47,45,2,45
Coleraine,1550,6,11,10,9,40,36,4,43
Dungannon,1550,7,11,8,11,54,48,6,41
Glentoran,1550,8,10,8,12,34,43,-9,38
Portadown,1550,9,8,8,14,26,46,-20,32
Ards,1550,10,8,5,17,33,53,-20,29
Ballinamalla,1550,11,7,5,18,31,56,-25,26
Crusaders,1551,1,19,8,3,62,29,33,65
Linfield,1551,2,14,10,6,59,33,26,52
Glenavon,1551,3,14,10,6,55,45,10,52
Cliftonville,1551,4,15,3,12,63,43,20,48
Coleraine,1551,5,12,10,8,41,36,5,46
Ballymena,1551,6,11,6,13,57,70,-13,39
Dungannon,1551,7,9,9,12,48,46,2,36
Ballinamalla,1551,8,11,3,16,31,51,-20,36
Glentoran,1551,9,7,10,13,32,48,-16,31
Ards,1551,10,7,5,18,37,58,-21,26
Portadown,1551,11,7,4,19,24,50,-26,25
Cliftonville,1552,1,17,3,10,65,38,27,54
Crusaders,1552,2,16,6,8,55,44,11,54
Linfield,1552,3,14,9,7,54,32,22,51
Ballymena,1552,4,13,6,11,59,60,-1,45
Coleraine,1552,5,11,11,8,40,38,2,44
Glenavon,1552,6,10,11,9,48,45,3,41
Ards,1552,7,12,4,14,40,43,-3,40
Glentoran,1552,8,9,7,14,33,49,-16,34
Portadown,1552,9,9,6,15,27,41,-14,33
Ballinamalla,1552,10,9,4,17,33,55,-22,31
Dungannon,1552,11,7,9,14,42,51,-9,30
Cliftonville,1553,1,17,5,8,53,38,15,56
Ballymena,1553,2,16,6,8,62,54,8,54
Crusaders,1553,3,15,7,8,52,36,16,52
Linfield,1553,4,13,11,6,57,34,23,50
Coleraine,1553,5,14,8,8,46,35,11,50
Glenavon,1553,6,10,9,11,42,42,0,39
Dungannon,1553,7,9,11,10,47,38,9,38
Glentoran,1553,8,7,11,12,31,43,-12,32
Ards,1553,9,7,8,15,34,48,-14,29
Portadown,1553,10,7,6,17,19,44,-25,27
Ballinamalla,1553,11,6,6,18,23,54,-31,24
Crusaders,1554,1,18,7,5,58,31,27,61
Cliftonville,1554,2,16,5,9,55,40,15,53
Ballymena,1554,3,15,8,7,65,55,10,53
Linfield,1554,4,13,8,9,57,35,22,47
Dungannon,1554,5,12,7,11,50,44,6,43
Glenavon,1554,6,10,13,7,45,42,3,43
Coleraine,1554,7,10,11,9,40,38,2,41
Ards,1554,8,10,5,15,44,49,-5,35
Glentoran,1554,9,9,7,14,30,44,-14,34
Ballinamalla,1554,10,6,7,17,29,55,-26,25
Portadown,1554,11,4,6,20,18,58,-40,18
Linfield,1555,1,15,11,4,56,28,28,56
Crusaders,1555,2,16,8,6,57,34,23,56
Cliftonville,1555,3,13,9,8,52,40,12,48
Ballymena,1555,4,13,6,11,55,59,-4,45
Glenavon,1555,5,11,11,8,46,44,2,44
Coleraine,1555,6,11,10,9,42,36,6,43
Dungannon,1555,7,9,11,10,53,49,4,38
Ballinamalla,1555,8,10,3,17,34,51,-17,33
Glentoran,1555,9,9,5,16,28,49,-21,32
Ards,1555,10,9,4,17,35,49,-14,31
Portadown,1555,11,8,4,18,29,48,-19,28
Cliftonville,1556,1,16,6,8,59,39,20,54
Crusaders,1556,2,15,8,7,60,48,12,53
Linfield,1556,3,14,9,7,60,39,21,51
Glenavon,1556,4,13,9,8,53,41,12,48
Ballymena,1556,5,12,8,10,62,66,-4,44
Dungannon,1556,6,11,10,9,53,40,13,43
Coleraine,1556,7,10,13,7,42,35,7,43
Glentoran,1556,8,8,7,15,35,50,-15,31
Portadown,1556,9,8,7,15,25,50,-25,31
Ards,1556,10,7,6,17,37,58,-21,27
Ballinamalla,1556,11,7,5,18,24,44,-20,26
Crusaders,1557,1,17,8,5,60,35,25,59
Linfield,1557,2,14,10,6,53,31,22,52
Coleraine,1557,3,12,10,8,48,38,10,46
Glentoran,1557,4,13,6,11,40,42,-2,45
Ballymena,1557,5,13,6,11,59,62,-3,45
Dungannon,1557,6,12,8,10,51,45,6,44
Glenavon,1557,7,12,8,10,47,44,3,44
Cliftonville,1557,8,11,4,15,47,50,-3,37
Portadown,1557,9,10,5,15,30,44,-14,35
Ballinamalla,1557,10,8,3,19,31,53,-22,27
Ards,1557,11,7,4,19,38,60,-22,25
Linfield,1558,1,17,7,6,71,35,36,58
Crusaders,1558,2,16,7,7,63,38,25,55
Cliftonville,1558,3,14,9,7,57,42,15,51
Glenavon,1558,4,13,9,8,58,57,1,48
Coleraine,1558,5,11,12,7,48,42,6,45
Ballymena,1558,6,12,7,11,63,64,-1,43
Dungannon,1558,7,10,8,12,52,55,-3,38
Glentoran,1558,8,9,8,13,26,46,-20,35
Ballinamalla,1558,9,8,4,18,29,47,-18,28
Portadown,1558,10,8,4,18,30,53,-23,28
Ards,1558,11,6,7,17,33,51,-18,25
Crusaders,1559,1,16,9,5,56,33,23,57
Cliftonville,1559,2,16,4,10,53,37,16,52
Linfield,1559,3,14,9,7,56,34,22,51
Ballymena,1559,4,14,5,11,52,58,-6,47
Coleraine,1559,5,12,9,9,40,41,-1,45
Glenavon,1559,6,11,10,9,50,46,4,43
Glentoran,1559,7,11,8,11,37,43,-6,41
Ards,1559,8,11,4,15,44,45,-1,37
Dungannon,1559,9,9,9,12,53,48,5,36
Portadown,1559,10,8,6,16,30,46,-16,30
Ballinamalla,1559,11,5,3,22,17,57,-40,18
Linfield,1560,1,16,8,6,64,28,36,56
Crusaders,1560,2,15,10,5,53,41,12,55
Coleraine,1560,3,11,13,6,41,33,8,46
Cliftonville,1560,4,12,8,10,49,43,6,44
Dungannon,1560,5,11,10,9,48,34,14,43
Ballymena,1560,6,12,7,11,53,56,-3,43
Glenavon,1560,7,9,12,9,43,48,-5,39
Ards,1560,8,10,7,13,32,38,-6,37
Glentoran,1560,9,8,7,15,25,44,-19,31
Ballinamalla,1560,10,7,6,17,28,52,-24,27
Portadown,1560,11,5,10,15,27,46,-19,25
Cliftonville,1561,1,17,4,9,58,37,21,55
Crusaders,1561,2,16,6,8,51,35,16,54
Ballymena,1561,3,16,5,9,67,57,10,53
Linfield,1561,4,13,12,5,63,37,26,51
Glenavon,1561,5,13,12,5,50,36,14,51
Dungannon,1561,6,11,11,8,44,36,8,44
Coleraine,1561,7,11,8,11,41,42,-1,41
Glentoran,1561,8,8,10,12,34,47,-13,34
Portadown,1561,9,7,6,17,22,45,-23,27
Ards,1561,10,7,5,18,35,56,-21,26
Ballinamalla,1561,11,4,5,21,23,60,-37,17
Crusaders,1562,1,20,6,4,63,33,30,66
Linfield,1562,2,15,9,6,59,34,25,54
Coleraine,1562,3,13,11,6,51,33,18,50
Cliftonville,1562,4,13,8,9,49,45,4,47
Ballymena,1562,5,12,8,10,59,65,-6,44
Glenavon,1562,6,11,8,11,47,50,-3,41
Dungannon,1562,7,9,8,13,53,51,2,35
Ballinamalla,1562,8,9,5,16,39,53,-14,32
Portadown,1562,9,8,7,15,30,50,-20,31
Ards,1562,10,7,6,17,31,47,-16,27
Glentoran,1562,11,5,10,15,21,41,-20,25
Cliftonville,1563,1,17,5,8,61,35,26,56
Ballymena,1563,2,15,8,7,62,54,8,53
Linfield,1563,3,14,9,7,61,37,24,51
Crusaders,1563,4,14,9,7,50,37,13,51
Glenavon,1563,5,12,10,8,47,45,2,46
Coleraine,1563,6,11,10,9,37,39,-2,43
Dungannon,1563,7,11,7,12,54,45,9,40
Glentoran,1563,8,10,7,13,33,39,-6,37
Ballinamalla,1563,9,8,4,18,25,48,-23,28
Ards,1563,10,7,5,18,31,49,-18,26
Portadown,1563,11,6,6,18,24,57,-33,24
Crusaders,1564,1,16,7,7,57,42,15,55
Linfield,1564,2,15,8,7,64,38,26,53
Ballymena,1564,3,16,5,9,60,57,3,53
Glenavon,1564,4,14,9,7,55,41,14,51
Cliftonville,1564,5,16,3,11,57,44,13,51
Dungannon,1564,6,11,8,11,53,48,5,41
Coleraine,1564,7,10,11,9,39,39,0,41
Ballinamalla,1564,8,9,3,18,32,49,-17,30
Portadown,1564,9,8,5,17,27,49,-22,29
Glentoran,1564,10,7,7,16,22,40,-18,28
Ards,1564,11,8,4,18,32,51,-19,28
Ballymena,1565,1,17,5,8,60,50,10,56
Cliftonville,1565,2,17,3,10,49,33,16,54
Linfield,1565,3,13,12,5,60,31,29,51
Coleraine,1565,4,13,8,9,42,38,4,47
Crusaders,1565,5,12,9,9,46,38,8,45
Dungannon,1565,6,12,8,10,50,38,12,44
Glenavon,1565,7,11,8,11,45,41,4,41
Ards,1565,8,10,5,15,42,54,-12,35
Ballinamalla,1565,9,9,4,17,32,58,-26,31
Glentoran,1565,10,6,9,15,29,51,-22,27
Portadown,1565,11,6,7,17,17,40,-23,25
Crusaders,1566,1,17,9,4,55,30,25,60
Linfield,1566,2,17,8,5,58,21,37,59
Cliftonville,1566,3,16,7,7,57,34,23,55
Ballymena,1566,4,17,4,9,57,56,1,55
Glenavon,1566,5,10,11,9,47,45,2,41
Coleraine,1566,6,11,8,11,42,40,2,41
Dungannon,1566,7,10,8,12,53,49,4,38
Glentoran,1566,8,8,8,14,33,47,-14,32
Ards,1566,9,9,4,17,38,51,-13,31
Portadown,1566,10,7,4,19,23,58,-35,25
Ballinamalla,1566,11,4,7,19,27,59,-32,19
Crusaders,1567,1,17,7,6,52,28,24,58
Ballymena,1567,2,17,6,7,66,56,10,57
Cliftonville,1567,3,15,8,7,51,33,18,53
Coleraine,1567,4,10,12,8,46,41,5,42
Glenavon,1567,5,10,12,8,36,37,-1,42
Linfield,1567,6,10,11,9,52,35,17,41
Ards,1567,7,11,4,15,38,48,-10,37
Dungannon,1567,8,9,9,12,47,42,5,36
Glentoran,1567,9,7,9,14,31,55,-24,30
Portadown,1567,10,7,7,16,28,48,-20,28
Ballinamalla,1567,11,7,5,18,25,49,-24,26
Crusaders,1568,1,16,8,6,54,35,19,56
Cliftonville,1568,2,14,8,8,60,42,18,50
Linfield,1568,3,13,10,7,57,34,23,49
Glenavon,1568,4,13,10,7,56,46,10,49
Coleraine,1568,5,11,10,9,42,40,2,43
Ballymena,1568,6,12,7,11,56,59,-3,43
Dungannon,1568,7,10,11,9,48,42,6,41
Ards,1568,8,11,4,15,38,43,-5,37
Glentoran,1568,9,10,6,14,31,47,-16,36
Ballinamalla,1568,10,7,5,18,26,51,-25,26
Portadown,1568,11,6,5,19,20,49,-29,23
Cliftonville,1569,1,20,4,6,54,30,24,64
Linfield,1569,2,14,13,3,58,24,34,55
Crusaders,1569,3,14,9,7,49,37,12,51
Coleraine,1569,4,13,11,6,48,36,12,50
Ballymena,1569,5,10,9,11,51,58,-7,39
Glenavon,1569,6,9,11,10,39,43,-4,38
Dungannon,1569,7,9,10,11,43,40,3,37
Glentoran,1569,8,10,6,14,33,46,-13,36
Ards,1569,9,8,6,16,33,44,-11,30
Ballinamalla,1569,10,7,5,18,19,47,-28,26
Portadown,1569,11,7,4,19,22,44,-22,25
Linfield,1570,1,15,9,6,63,31,32,54
Crusaders,1570,2,15,9,6,59,40,19,54
Ballymena,1570,3,16,5,9,61,57,4,53
Glenavon,1570,4,14,10,6,46,39,7,52
Cliftonville,1570,5,13,6,11,48,41,7,45
Dungannon,1570,6,10,9,11,49,45,4,39
Coleraine,1570,7,8,14,8,43,38,5,38
Ards,1570,8,9,8,13,38,47,-9,35
Glentoran,1570,9,9,6,15,29,53,-24,33
Ballinamalla,1570,10,8,6,16,28,48,-20,30
Portadown,1570,11,5,4,21,25,50,-25,19
Linfield,1571,1,16,10,4,59,22,37,58
Crusaders,1571,2,17,7,6,60,36,24,58
Cliftonville,1571,3,18,3,9,55,37,18,57
Glenavon,1571,4,11,10,9,46,46,0,43
Ballymena,1571,5,11,8,11,54,60,-6,41
Coleraine,1571,6,9,10,11,34,38,-4,37
Glentoran,1571,7,9,10,11,26,38,-12,37
Ballinamalla,1571,8,8,8,14,32,45,-13,32
Ards,1571,9,8,7,15,39,50,-11,31
Dungannon,1571,10,5,14,11,45,50,-5,29
Portadown,1571,11,6,7,17,22,50,-28,25
Crusaders,1572,1,14,9,7,61,46,15,51
Linfield,1572,2,14,7,9,65,40,25,49
Dungannon,1572,3,13,10,7,53,39,14,49
Ballymena,1572,4,14,5,11,61,65,-4,47
Coleraine,1572,5,11,11,8,47,40,7,44
Glentoran,1572,6,11,8,11,41,47,-6,41
Glenavon,1572,7,9,12,9,56,54,2,39
Cliftonville,1572,8,10,9,11,45,46,-1,39
Portadown,1572,9,10,5,15,31,47,-16,35
Ards,1572,10,8,5,17,36,52,-16,29
Ballinamalla,1572,11,8,5,17,33,53,-20,29
Crusaders,1573,1,19,8,3,62,28,34,65
Linfield,1573,2,16,7,7,59,34,25,55
Cliftonville,1573,3,16,7,7,58,36,22,55
Ballymena,1573,4,12,7,11,66,69,-3,43
Glenavon,1573,5,9,11,10,46,48,-2,38
Ballinamalla,1573,6,11,4,15,33,48,-15,37
Glentoran,1573,7,10,6,14,35,47,-12,36
Coleraine,1573,8,7,14,9,37,46,-9,35
Dungannon,1573,9,7,12,11,45,47,-2,33
Ards,1573,10,8,6,16,38,54,-16,30
Portadown,1573,11,5,8,17,22,44,-22,23
Crusaders,1574,1,15,6,9,54,40,14,51
Cliftonville,1574,2,15,5,10,57,39,18,50
Dungannon,1574,3,13,7,10,53,40,13,46
Ballymena,1574,4,12,10,8,51,50,1,46
Coleraine,1574,5,12,10,8,42,46,-4,46
Glenavon,1574,6,12,9,9,52,50,2,45
Linfield,1574,7,12,7,11,55,39,16,43
Glentoran,1574,8,10,7,13,29,43,-14,37
Portadown,1574,9,10,3,17,34,49,-15,33
Ards,1574,10,9,4,17,41,55,-14,31
Ballinamalla,1574,11,9,4,17,33,50,-17,31
Linfield,1575,1,15,8,7,59,36,23,53
Cliftonville,1575,2,16,5,9,59,40,19,53
Coleraine,1575,3,13,10,7,40,33,7,49
Glenavon,1575,4,12,12,6,48,41,7,48
Crusaders,1575,5,13,7,10,50,33,17,46
Ballymena,1575,6,11,7,12,56,65,-9,40
Glentoran,1575,7,11,7,12,30,39,-9,40
Dungannon,1575,8,8,11,11,41,43,-2,35
Ards,1575,9,8,7,15,34,47,-13,31
Portadown,1575,10,7,8,15,27,47,-20,29
Ballinamalla,1575,11,7,6,17,26,46,-20,27
Crusaders,1576,1,19,6,5,70,34,36,63
Coleraine,1576,2,11,14,5,43,35,8,47
Glenavon,1576,3,11,12,7,48,41,7,45
Linfield,1576,4,12,8,10,53,35,18,44
Cliftonville,1576,5,12,7,11,48,40,8,43
Ballymena,1576,6,10,12,8,52,58,-6,42
Ards,1576,7,11,6,13,44,49,-5,39
Dungannon,1576,8,10,8,12,57,57,0,38
Glentoran,1576,9,9,7,14,32,46,-14,34
Ballinamalla,1576,10,9,2,19,28,56,-28,29
Portadown,1576,11,7,6,17,22,46,-24,27
Glenavon,1577,1,15,8,7,55,42,13,53
Linfield,1577,2,12,13,5,57,31,26,49
Ballymena,1577,3,13,10,7,58,52,6,49
Crusaders,1577,4,13,7,10,53,46,7,46
Dungannon,1577,5,12,9,9,45,35,10,45
Coleraine,1577,6,11,12,7,47,39,8,45
Cliftonville,1577,7,13,5,12,54,50,4,44
Ards,1577,8,9,8,13,41,47,-6,35
Glentoran,1577,9,9,7,14,29,45,-16,34
Portadown,1577,10,7,6,17,29,53,-24,27
Ballinamalla,1577,11,7,3,20,27,55,-28,24
Cliftonville,1578,1,18,4,8,53,35,18,58
Crusaders,1578,2,17,6,7,59,37,22,57
Linfield,1578,3,13,10,7,60,29,31,49
Glenavon,1578,4,12,12,6,55,44,11,48
Coleraine,1578,5,11,12,7,40,38,2,45
Ards,1578,6,13,4,13,47,47,0,43
Ballymena,1578,7,12,7,11,52,56,-4,43
Dungannon,1578,8,8,10,12,50,50,0,34
Glentoran,1578,9,7,10,13,29,47,-18,31
Portadown,1578,10,5,8,17,20,48,-28,23
Ballinamalla,1578,11,5,5,20,24,58,-34,20
Crusaders,1579,1,19,5,6,61,35,26,62
Glenavon,1579,2,16,8,6,54,41,13,56
Linfield,1579,3,14,8,8,56,30,26,50
Cliftonville,1579,4,15,4,11,52,41,11,49
Ballymena,1579,5,14,7,9,60,54,6,49
Ards,1579,6,12,6,12,41,43,-2,42
Dungannon,1579,7,11,7,12,47,40,7,40
Coleraine,1579,8,9,11,10,48,48,0,38
Glentoran,1579,9,6,7,17,33,60,-27,25
Portadown,1579,10,7,4,19,26,54,-28,25
Ballinamalla,1579,11,7,3,20,29,61,-32,24
Linfield,1580,1,17,7,6,61,28,33,58
Ballymena,1580,2,16,7,7,58,49,9,55
Crusaders,1580,3,16,6,8,53,33,20,54
Cliftonville,1580,4,15,4,11,53,43,10,49
Coleraine,1580,5,11,10,9,42,40,2,43
Glenavon,1580,6,10,9,11,36,45,-9,39
Ards,1580,7,10,8,12,41,44,-3,38
Ballinamalla,1580,8,11,5,14,34,46,-12,38
Dungannon,1580,9,7,8,15,46,44,2,29
Glentoran,1580,10,6,9,15,28,52,-24,27
Portadown,1580,11,7,5,18,22,50,-28,26
Ballymena,1581,1,15,6,9,59,55,4,51
Glenavon,1581,2,12,13,5,48,39,9,49
Crusaders,1581,3,14,6,10,50,41,9,48
Linfield,1581,4,12,11,7,59,42,17,47
Cliftonville,1581,5,14,5,11,58,42,16,47
Dungannon,1581,6,12,9,9,55,44,11,45
Coleraine,1581,7,10,12,8,42,41,1,42
Ballinamalla,1581,8,9,7,14,38,50,-12,34
Glentoran,1581,9,7,9,14,29,46,-17,30
Portadown,1581,10,8,5,17,28,52,-24,29
Ards,1581,11,7,7,16,38,52,-14,28
Cliftonville,1582,1,19,3,8,62,38,24,60
Crusaders,1582,2,18,6,6,57,34,23,60
Linfield,1582,3,13,10,7,57,34,23,49
Ballymena,1582,4,14,6,10,60,56,4,48
Coleraine,1582,5,12,9,9,40,36,4,45
Dungannon,1582,6,9,9,12,50,47,3,36
Glenavon,1582,7,8,12,10,43,49,-6,36
Ards,1582,8,9,5,16,38,53,-15,32
Glentoran,1582,9,9,5,16,36,57,-21,32
Portadown,1582,10,8,7,15,35,51,-16,31
Ballinamalla,1582,11,8,4,18,31,54,-23,28
Cliftonville,1583,1,18,3,9,55,38,17,57
Linfield,1583,2,16,8,6,58,30,28,56
Crusaders,1583,3,14,7,9,50,37,13,49
Glenavon,1583,4,11,12,7,47,43,4,45
Ballymena,1583,5,12,7,11,55,54,1,43
Glentoran,1583,6,12,7,11,36,41,-5,43
Coleraine,1583,7,11,8,11,42,41,1,41
Dungannon,1583,8,8,11,11,44,45,-1,35
Ballinamalla,1583,9,9,6,15,32,47,-15,33
Ards,1583,10,6,8,16,32,50,-18,26
Portadown,1583,11,6,7,17,22,47,-25,25
Linfield,1584,1,17,8,5,67,31,36,59
Cliftonville,1584,2,16,4,10,59,42,17,52
Glenavon,1584,3,13,9,8,53,49,4,48
Ballymena,1584,4,14,6,10,65,68,-3,48
Crusaders,1584,5,13,7,10,53,43,10,46
Coleraine,1584,6,11,11,8,44,36,8,44
Ards,1584,7,10,6,14,42,48,-6,36
Glentoran,1584,8,9,9,12,34,43,-9,36
Ballinamalla,1584,9,9,8,13,29,42,-13,35
Dungannon,1584,10,7,11,12,41,49,-8,32
Portadown,1584,11,5,3,22,22,58,-36,18
Linfield,1585,1,14,11,5,59,33,26,53
Crusaders,1585,2,15,7,8,56,36,20,52
Coleraine,1585,3,14,10,6,44,36,8,52
Ballymena,1585,4,14,8,8,64,57,7,50
Cliftonville,1585,5,13,6,11,45,42,3,45
Glenavon,1585,6,10,11,9,48,50,-2,41
Dungannon,1585,7,9,10,11,49,47,2,37
Ballinamalla,1585,8,10,4,16,34,47,-13,34
Glentoran,1585,9,8,9,13,31,44,-13,33
Ards,1585,10,7,7,16,34,47,-13,28
Portadown,1585,11,7,5,18,21,46,-25,26
Crusaders,1586,1,15,10,5,56,30,26,55
Linfield,1586,2,16,7,7,60,35,25,55
Glenavon,1586,3,12,12,6,52,40,12,48
Cliftonville,1586,4,15,3,12,49,39,10,48
Coleraine,1586,5,13,9,8,41,36,5,48
Dungannon,1586,6,12,9,9,53,40,13,45
Ballymena,1586,7,12,7,11,51,58,-7,43
Glentoran,1586,8,8,8,14,31,48,-17,32
Ballinamalla,1586,9,9,3,18,33,57,-24,30
Ards,1586,10,8,5,17,36,50,-14,29
Portadown,1586,11,6,5,19,27,56,-29,23
Crusaders,1587,1,19,7,4,59,30,29,64
Linfield,1587,2,15,9,6,65,31,34,54
Coleraine,1587,3,13,10,7,52,43,9,49
Ballymena,1587,4,14,5,11,50,57,-7,47
Cliftonville,1587,5,13,6,11,47,39,8,45
Dungannon,1587,6,12,6,12,47,47,0,42
Glenavon,1587,7,10,11,9,46,45,1,41
Portadown,1587,8,10,4,16,28,43,-15,34
Ballinamalla,1587,9,8,5,17,29,49,-20,29
Glentoran,1587,10,6,8,16,28,47,-19,26
Ards,1587,11,6,7,17,35,55,-20,25
Coleraine,1588,1,15,9,6,52,37,15,54
Cliftonville,1588,2,16,4,10,56,38,18,52
Crusaders,1588,3,14,10,6,51,35,16,52
Linfield,1588,4,13,11,6,55,31,24,50
Ballymena,1588,5,13,7,10,52,51,1,46
Glenavon,1588,6,9,13,8,50,50,0,40
Dungannon,1588,7,9,11,10,47,43,4,38
Glentoran,1588,8,9,9,12,25,36,-11,36
Ards,1588,9,8,6,16,33,55,-22,30
Ballinamalla,1588,10,8,5,17,24,45,-21,29
Portadown,1588,11,6,5,19,27,51,-24,23
Crusaders,1589,1,17,6,7,57,35,22,57
Linfield,1589,2,15,8,7,63,37,26,53
Ballymena,1589,3,14,9,7,58,52,6,51
Glenavon,1589,4,11,12,7,52,47,5,45
Cliftonville,1589,5,13,4,13,52,48,4,43
Dungannon,1589,6,10,11,9,57,46,11,41
Coleraine,1589,7,9,12,9,42,39,3,39
Glentoran,1589,8,9,9,12,31,42,-11,36
Portadown,1589,9,11,3,16,33,46,-13,36
Ards,1589,10,9,7,14,41,51,-10,34
Ballinamalla,1589,11,4,5,21,19,62,-43,17
Crusaders,1590,1,16,8,6,55,33,22,56
Cliftonville,1590,2,16,3,11,51,43,8,51
Linfield,1590,3,12,13,5,55,32,23,49
Ballymena,1590,4,14,6,10,63,58,5,48
Glenavon,1590,5,12,10,8,46,50,-4,46
Coleraine,1590,6,12,9,9,43,36,7,45
Ards,1590,7,9,7,14,37,49,-12,34
Dungannon,1590,8,8,9,13,53,45,8,33
Portadown,1590,9,8,7,15,29,44,-15,31
Glentoran,1590,10,8,7,15,28,45,-17,31
Ballinamalla,1590,11,9,3,18,26,51,-25,30
Linfield,1591,1,16,10,4,61,31,30,58
Crusaders,1591,2,17,7,6,58,36,22,58
Cliftonville,1591,3,16,2,12,56,39,17,50
Ballymena,1591,4,14,7,9,59,49,10,49
Dungannon,1591,5,13,8,9,57,47,10,47
Coleraine,1591,6,8,12,10,36,40,-4,36
Ards,1591,7,9,8,13,34,47,-13,35
Glenavon,1591,8,7,11,12,37,49,-12,32
Ballinamalla,1591,9,9,5,16,38,52,-14,32
Glentoran,1591,10,7,9,14,30,48,-18,30
Portadown,1591,11,7,5,18,22,50,-28,26
Cliftonville,1592,1,17,4,9,56,35,21,55
Linfield,1592,2,15,9,6,55,27,28,54
Crusaders,1592,3,15,9,6,55,35,20,54
Glenavon,1592,4,11,12,7,53,51,2,45
Ballymena,1592,5,12,8,10,57,61,-4,44
Glentoran,1592,6,11,8,11,31,43,-12,41
Coleraine,1592,7,8,13,9,37,39,-2,37
Dungannon,1592,8,8,10,12,44,47,-3,34
Ards,1592,9,8,7,15,28,41,-13,31
Ballinamalla,1592,10,8,4,18,34,53,-19,28
Portadown,1592,11,6,8,16,26,44,-18,26
Crusaders,1593,1,20,7,3,68,33,35,67
Cliftonville,1593,2,15,5,10,49,45,4,50
Linfield,1593,3,13,7,10,62,38,24,46
Ballymena,1593,4,13,7,10,58,58,0,46
Glenavon,1593,5,10,10,10,48,52,-4,40
Glentoran,1593,6,11,7,12,32,38,-6,40
Dungannon,1593,7,10,9,11,54,48,6,39
Coleraine,1593,8,9,9,12,41,46,-5,36
Portadown,1593,9,9,7,14,29,47,-18,34
Ballinamalla,1593,10,10,2,18,29,47,-18,32
Ards,1593,11,8,4,18,39,57,-18,28
Linfield,1594,1,14,11,5,59,32,27,53
Crusaders,1594,2,13,9,8,48,33,15,48
Ballymena,1594,3,12,9,9,52,56,-4,45
Dungannon,1594,4,10,13,7,46,36,10,43
Cliftonville,1594,5,12,7,11,56,51,5,43
Coleraine,1594,6,11,10,9,43,38,5,43
Glenavon,1594,7,10,11,9,47,49,-2,41
Glentoran,1594,8,9,10,11,30,41,-11,37
Ards,1594,9,9,6,15,39,45,-6,33
Portadown,1594,10,9,5,16,31,47,-16,32
Ballinamalla,1594,11,8,5,17,24,47,-23,29
Crusaders,1595,1,17,10,3,64,32,32,61
Glenavon,1595,2,14,11,5,52,39,13,53
Linfield,1595,3,13,11,6,61,29,32,50
Coleraine,1595,4,13,10,7,38,28,10,49
Cliftonville,1595,5,14,4,12,51,40,11,46
Ballymena,1595,6,11,7,12,54,63,-9,40
Dungannon,1595,7,7,13,10,47,45,2,34
Ards,1595,8,9,5,16,38,49,-11,32
Glentoran,1595,9,8,8,14,33,56,-23,32
Ballinamalla,1595,10,9,4,17,32,58,-26,31
Portadown,1595,11,6,5,19,19,50,-31,23
Linfield,1596,1,17,7,6,61,33,28,58
Crusaders,1596,2,17,6,7,59,33,26,57
Cliftonville,1596,3,16,2,12,55,45,10,50
Dungannon,1596,4,12,9,9,53,37,16,45
Glenavon,1596,5,11,11,8,45,45,0,44
Glentoran,1596,6,11,7,12,34,41,-7,40
Coleraine,1596,7,10,9,11,40,46,-6,39
Ballymena,1596,8,11,5,14,58,66,-8,38
Portadown,1596,9,10,4,16,24,42,-18,34
Ballinamalla,1596,10,8,5,17,31,53,-22,29
Ards,1596,11,8,3,19,33,52,-19,27
Linfield,1597,1,17,9,4,63,28,35,60
Crusaders,1597,2,17,9,4,55,29,26,60
Coleraine,1597,3,13,9,8,43,30,13,48
Ballymena,1597,4,13,7,10,53,56,-3,46
Cliftonville,1597,5,13,5,12,45,40,5,44
Portadown,1597,6,12,5,13,29,40,-11,41
Glenavon,1597,7,10,10,10,48,49,-1,40
Dungannon,1597,8,9,11,10,44,44,0,38
Ards,1597,9,8,4,18,35,50,-15,28
Ballinamalla,1597,10,7,4,19,30,54,-24,25
Glentoran,1597,11,6,7,17,27,52,-25,25
Crusaders,1598,1,15,8,7,56,36,20,53
Cliftonville,1598,2,16,4,10,52,34,18,52
Linfield,1598,3,13,10,7,55,31,24,49
Glenavon,1598,4,13,10,7,48,41,7,49
Ballymena,1598,5,14,5,11,57,58,-1,47
Coleraine,1598,6,11,10,9,39,38,1,43
Dungannon,1598,7,8,12,10,47,45,2,36
Ards,1598,8,10,5,15,40,48,-8,35
Portadown,1598,9,8,7,15,22,42,-20,31
Ballinamalla,1598,10,7,8,15,33,55,-22,29
Glentoran,1598,11,6,9,15,24,45,-21,27
Crusaders,1599,1,16,9,5,52,28,24,57
Linfield,1599,2,15,9,6,61,30,31,54
Cliftonville,1599,3,13,7,10,50,38,12,46
Coleraine,1599,4,12,10,8,42,33,9,46
Glenavon,1599,5,10,14,6,46,45,1,44
Ballymena,1599,6,10,10,10,50,59,-9,40
Glentoran,1599,7,9,10,11,33,41,-8,37
Dungannon,1599,8,8,9,13,44,44,0,33
Portadown,1599,9,8,6,16,30,50,-20,30
Ards,1599,10,8,6,16,29,49,-20,30
Ballinamalla,1599,11,7,8,15,28,48,-20,29
Crusaders,1600,1,17,9,4,55,28,27,60
Cliftonville,1600,2,15,5,10,47,37,10,50
Linfield,1600,3,13,10,7,58,32,26,49
Ballymena,1600,4,13,8,9,58,57,1,47
Coleraine,1600,5,12,10,8,45,35,10,46
Glenavon,1600,6,11,12,7,50,45,5,45
Dungannon,1600,7,9,13,8,54,50,4,40
Portadown,1600,8,8,9,13,31,44,-13,33
Glentoran,1600,9,7,9,14,29,47,-18,30
Ards,1600,10,6,7,17,32,51,-19,25
Ballinamalla,1600,11,6,4,20,28,61,-33,22
Ballymena,1601,1,17,5,8,60,53,7,56
Linfield,1601,2,14,9,7,57,31,26,51
Glenavon,1601,3,14,9,7,56,41,15,51
Crusaders,1601,4,15,6,9,53,39,14,51
Cliftonville,1601,5,13,7,10,56,45,11,46
Coleraine,1601,6,11,10,9,43,40,3,43
Glentoran,1601,7,11,6,13,32,46,-14,39
Dungannon,1601,8,8,10,12,51,46,5,34
Portadown,1601,9,8,6,16,30,52,-22,30
Ballinamalla,1601,10,7,7,16,25,48,-23,28
Ards,1601,11,8,3,19,27,49,-22,27
Crusaders,1602,1,18,7,5,56,31,25,61
Glenavon,1602,2,14,11,5,55,36,19,53
Cliftonville,1602,3,15,5,10,51,38,13,50
Linfield,1602,4,12,12,6,52,29,23,48
Coleraine,1602,5,12,10,8,38,38,0,46
Ballymena,1602,6,11,9,10,57,57,0,42
Glentoran,1602,7,9,10,11,31,40,-9,37
Dungannon,1602,8,8,9,13,45,49,-4,33
Portadown,1602,9,8,4,18,29,53,-24,28
Ballinamalla,1602,10,8,4,18,21,46,-25,28
Ards,1602,11,6,7,17,31,49,-18,25
Crusaders,1603,1,17,11,2,66,30,36,62
Ballymena,1603,2,14,6,10,51,53,-2,48
Linfield,1603,3,12,10,8,57,35,22,46
Glenavon,1603,4,11,12,7,56,49,7,45
Glentoran,1603,5,12,6,12,39,47,-8,42
Cliftonville,1603,6,12,5,13,46,46,0,41
Dungannon,1603,7,10,10,10,50,45,5,40
Coleraine,1603,8,8,12,10,34,39,-5,36
Ards,1603,9,11,3,16,41,52,-11,36
Portadown,1603,10,7,7,16,25,46,-21,28
Ballinamalla,1603,11,6,8,16,27,50,-23,26
Cliftonville,1604,1,19,4,7,65,35,30,61
Linfield,1604,2,17,8,5,60,30,30,59
Crusaders,1604,3,15,8,7,54,38,16,53
Glenavon,1604,4,12,10,8,53,46,7,46
Dungannon,1604,5,12,8,10,53,44,9,44
Ballymena,1604,6,12,8,10,60,64,-4,44
Coleraine,1604,7,9,9,12,41,47,-6,36
Ards,1604,8,9,5,16,36,54,-18,32
Glentoran,1604,9,6,10,14,32,48,-16,28
Ballinamalla,1604,10,7,6,17,22,43,-21,27
Portadown,1604,11,7,4,19,29,56,-27,25
Coleraine,1605,1,16,9,5,44,32,12,57
Linfield,1605,2,16,7,7,55,34,21,55
Crusaders,1605,3,13,12,5,55,41,14,51
Cliftonville,1605,4,13,5,12,48,43,5,44
Glenavon,1605,5,10,13,7,52,42,10,43
Ballymena,1605,6,12,4,14,51,60,-9,40
Glentoran,1605,7,11,6,13,35,44,-9,39
Ballinamalla,1605,8,12,3,15,38,49,-11,39
Dungannon,1605,9,10,8,12,52,46,6,38
Portadown,1605,10,7,7,16,26,46,-20,28
Ards,1605,11,5,6,19,34,53,-19,21
Crusaders,1606,1,21,6,3,62,26,36,69
Cliftonville,1606,2,17,5,8,59,45,14,56
Glenavon,1606,3,15,8,7,49,40,9,53
Linfield,1606,4,11,13,6,53,33,20,46
Coleraine,1606,5,11,10,9,45,41,4,43
Ballymena,1606,6,10,6,14,44,56,-12,36
Ards,1606,7,10,4,16,36,47,-11,34
Dungannon,1606,8,8,8,14,43,49,-6,32
Glentoran,1606,9,8,8,14,27,42,-15,32
Ballinamalla,1606,10,9,3,18,31,53,-22,30
Portadown,1606,11,7,5,18,27,44,-17,26
Cliftonville,1607,1,18,4,8,57,38,19,58
Linfield,1607,2,15,11,4,62,30,32,56
Crusaders,1607,3,16,7,7,56,33,23,55
Glenavon,1607,4,12,10,8,50,43,7,46
Ballymena,1607,5,11,9,10,49,54,-5,42
Dungannon,1607,6,10,10,10,46,42,4,40
Coleraine,1607,7,9,12,9,39,38,1,39
Ards,1607,8,11,6,13,45,50,-5,39
Glentoran,1607,9,7,11,12,24,38,-14,32
Ballinamalla,1607,10,6,4,20,26,59,-33,22
Portadown,1607,11,5,6,19,18,47,-29,21
Crusaders,1608,1,16,7,7,52,31,21,55
Glenavon,1608,2,14,11,5,57,43,14,53
Ballymena,1608,3,15,6,9,59,58,1,51
Coleraine,1608,4,13,10,7,41,32,9,49
Cliftonville,1608,5,15,3,12,57,47,10,48
Linfield,1608,6,12,9,9,56,37,19,45
Dungannon,1608,7,7,12,11,47,50,-3,33
Glentoran,1608,8,7,10,13,24,37,-13,31
Portadown,1608,9,8,6,16,27,47,-20,30
Ballinamalla,1608,10,8,5,17,34,54,-20,29
Ards,1608,11,7,7,16,34,52,-18,28
Crusaders,1609,1,17,6,7,60,38,22,57
Linfield,1609,2,15,9,6,60,32,28,54
Ballymena,1609,3,15,6,9,61,57,4,51
Coleraine,1609,4,13,11,6,44,30,14,50
Cliftonville,1609,5,12,7,11,46,37,9,43
Portadown,1609,6,12,5,13,34,40,-6,41
Glenavon,1609,7,10,9,11,44,50,-6,39
Glentoran,1609,8,9,7,14,34,47,-13,34
Dungannon,1609,9,8,8,14,43,51,-8,32
Ards,1609,10,8,4,18,32,51,-19,28
Ballinamalla,1609,11,7,6,17,30,55,-25,27
Cliftonville,1610,1,17,6,7,57,36,21,57
Linfield,1610,2,15,9,6,58,32,26,54
Crusaders,1610,3,15,7,8,55,38,17,52
Glenavon,1610,4,12,9,9,51,52,-1,45
Coleraine,1610,5,11,11,8,39,29,10,44
Ballymena,1610,6,11,8,11,49,56,-7,41
Dungannon,1610,7,9,10,11,47,47,0,37
Ballinamalla,1610,8,10,4,16,30,46,-16,34
Portadown,1610,9,8,7,15,29,40,-11,31
Glentoran,1610,10,7,8,15,26,47,-21,29
Ards,1610,11,7,7,16,31,49,-18,28
Crusaders,1611,1,18,8,4,59,26,33,62
Linfield,1611,2,13,10,7,57,29,28,49
Ballymena,1611,3,14,6,10,57,61,-4,48
Coleraine,1611,4,12,10,8,49,40,9,46
Glenavon,1611,5,11,12,7,51,48,3,45
Cliftonville,1611,6,13,5,12,49,45,4,44
Dungannon,1611,7,11,7,12,51,48,3,40
Glentoran,1611,8,11,6,13,39,47,-8,39
Ards,1611,9,8,7,15,38,49,-11,31
Ballinamalla,1611,10,8,6,16,31,54,-23,30
Portadown,1611,11,3,9,18,19,53,-34,18
Crusaders,1612,1,17,8,5,58,34,24,59
Cliftonville,1612,2,17,4,9,57,38,19,55
Linfield,1612,3,13,10,7,54,30,24,49
Ballymena,1612,4,14,7,9,55,53,2,49
Ards,1612,5,13,3,14,43,46,-3,42
Dungannon,1612,6,10,11,9,51,46,5,41
Glenavon,1612,7,9,12,9,41,48,-7,39
Glentoran,1612,8,10,9,11,31,39,-8,39
Coleraine,1612,9,9,11,10,45,44,1,38
Portadown,1612,10,5,6,19,24,57,-33,21
Ballinamalla,1612,11,5,5,20,27,51,-24,20
Cliftonville,1613,1,18,3,9,56,36,20,57
Crusaders,1613,2,16,8,6,59,35,24,56
Glenavon,1613,3,14,10,6,46,34,12,52
Coleraine,1613,4,13,10,7,41,36,5,49
Linfield,1613,5,12,12,6,60,35,25,48
Ballymena,1613,6,11,8,11,52,60,-8,41
Dungannon,1613,7,10,8,12,50,46,4,38
Ards,1613,8,8,5,17,33,46,-13,29
Portadown,1613,9,8,5,17,26,48,-22,29
Ballinamalla,1613,10,7,7,16,33,53,-20,28
Glentoran,1613,11,7,6,17,23,50,-27,27
Ballymena,1614,1,17,6,7,59,50,9,57
Linfield,1614,2,16,6,8,65,30,35,54
Cliftonville,1614,3,16,4,10,56,42,14,52
Crusaders,1614,4,14,9,7,54,37,17,51
Coleraine,1614,5,14,9,7,52,38,14,51
Glenavon,1614,6,12,10,8,48,45,3,46
Dungannon,1614,7,9,9,12,50,45,5,36
Glentoran,1614,8,7,9,14,27,48,-21,30
Portadown,1614,9,7,7,16,27,49,-22,28
Ards,1614,10,8,3,19,35,56,-21,27
Ballinamalla,1614,11,7,4,19,23,56,-33,25
Linfield,1615,1,15,10,5,61,29,32,55
Cliftonville,1615,2,16,6,8,54,36,18,54
Crusaders,1615,3,14,10,6,57,38,19,52
Ballymena,1615,4,12,8,10,50,51,-1,44
Glenavon,1615,5,11,10,9,49,43,6,43
Coleraine,1615,6,10,11,9,35,35,0,41
Glentoran,1615,7,10,9,11,33,46,-13,39
Dungannon,1615,8,9,11,10,49,46,3,38
Ards,1615,9,9,6,15,38,46,-8,33
Portadown,1615,10,8,5,17,29,51,-22,29
Ballinamalla,1615,11,6,4,20,26,60,-34,22
Cliftonville,1616,1,19,3,8,58,34,24,60
Crusaders,1616,2,15,5,10,55,41,14,50
Linfield,1616,3,13,8,9,55,39,16,47
Glenavon,1616,4,12,10,8,46,39,7,46
Ballymena,1616,5,13,7,10,52,59,-7,46
Coleraine,1616,6,12,9,9,41,37,4,45
Dungannon,1616,7,8,13,9,54,45,9,37
Glentoran,1616,8,9,10,11,28,39,-11,37
Portadown,1616,9,9,5,16,26,42,-16,32
Ballinamalla,1616,10,8,7,15,42,55,-13,31
Ards,1616,11,7,3,20,36,63,-27,24
Cliftonville,1617,1,18,2,10,57,36,21,56
Crusaders,1617,2,16,6,8,55,37,18,54
Linfield,1617,3,15,7,8,60,32,28,52
Coleraine,1617,4,13,10,7,48,33,15,49
Ballymena,1617,5,15,4,11,54,56,-2,49
Glenavon,1617,6,12,9,9,51,48,3,45
Dungannon,1617,7,9,8,13,45,47,-2,35
Portadown,1617,8,10,4,16,24,47,-23,34
Ards,1617,9,9,4,17,29,41,-12,31
Glentoran,1617,10,7,10,13,28,46,-18,31
Ballinamalla,1617,11,7,4,19,27,55,-28,25
Crusaders,1618,1,18,6,6,62,36,26,60
Linfield,1618,2,14,9,7,68,41,27,51
Coleraine,1618,3,13,11,6,50,38,12,50
Ballymena,1618,4,14,7,9,60,55,5,49
Glenavon,1618,5,12,10,8,50,53,-3,46
Cliftonville,1618,6,12,4,14,42,41,1,40
Dungannon,1618,7,8,11,11,46,43,3,35
Glentoran,1618,8,8,10,12,31,40,-9,34
Portadown,1618,9,9,5,16,24,43,-19,32
Ballinamalla,1618,10,8,6,16,29,49,-20,30
Ards,1618,11,7,5,18,38,61,-23,26
Crusaders,1619,1,17,8,5,58,32,26,59
Linfield,1619,2,15,8,7,60,34,26,53
Ballymena,1619,3,13,8,9,56,56,0,47
Dungannon,1619,4,12,10,8,57,39,18,46
Cliftonville,1619,5,13,6,11,52,44,8,45
Glenavon,1619,6,11,10,9,52,50,2,43
Coleraine,1619,7,10,10,10,43,42,1,40
Ballinamalla,1619,8,10,5,15,34,52,-18,35
Ards,1619,9,10,3,17,37,52,-15,33
Glentoran,1619,10,7,8,15,21,43,-22,29
Portadown,1619,11,8,2,20,27,53,-26,26
Crusaders,1620,1,16,7,7,52,31,21,55
Glenavon,1620,2,14,9,7,59,44,15,51
Coleraine,1620,3,13,11,6,39,33,6,50
Linfield,1620,4,13,10,7,54,29,25,49
Cliftonville,1620,5,15,4,11,55,40,15,49
Ballymena,1620,6,14,6,10,59,58,1,48
Dungannon,1620,7,11,9,10,47,37,10,42
Glentoran,1620,8,10,8,12,27,38,-11,38
Portadown,1620,9,6,8,16,25,48,-23,26
Ballinamalla,1620,10,7,4,19,24,58,-34,25
Ards,1620,11,4,8,18,26,51,-25,20
Linfield,1621,1,16,9,5,57,29,28,57
Coleraine,1621,2,14,11,5,54,38,16,53
Crusaders,1621,3,15,7,8,49,39,10,52
Glenavon,1621,4,14,8,8,61,44,17,50
Ballymena,1621,5,12,10,8,62,59,3,46
Cliftonville,1621,6,12,6,12,48,41,7,42
Dungannon,1621,7,11,8,11,48,46,2,41
Ards,1621,8,10,5,15,39,50,-11,35
Portadown,1621,9,9,5,16,28,47,-19,32
Glentoran,1621,10,7,8,15,27,45,-18,29
Ballinamalla,1621,11,5,3,22,26,61,-35,18
Crusaders,1622,1,19,5,6,60,30,30,62
Linfield,1622,2,15,6,9,53,35,18,51
Cliftonville,1622,3,15,4,11,52,42,10,49
Coleraine,1622,4,12,10,8,47,41,6,46
Ballymena,1622,5,12,6,12,56,67,-11,42
Dungannon,1622,6,11,8,11,53,47,6,41
Glenavon,1622,7,9,10,11,51,53,-2,37
Glentoran,1622,8,8,11,11,38,44,-6,35
Portadown,1622,9,10,5,15,30,43,-13,35
Ards,1622,10,10,2,18,36,52,-16,32
Ballinamalla,1622,11,9,3,18,29,51,-22,30
Cliftonville,1623,1,17,5,8,57,41,16,56
Crusaders,1623,2,14,8,8,59,39,20,50
Linfield,1623,3,13,10,7,56,36,20,49
Ballymena,1623,4,14,7,9,61,55,6,49
Coleraine,1623,5,9,13,8,48,45,3,40
Ards,1623,6,11,6,13,42,46,-4,39
Portadown,1623,7,11,4,15,29,44,-15,37
Dungannon,1623,8,8,10,12,48,47,1,34
Glentoran,1623,9,9,7,14,32,45,-13,34
Glenavon,1623,10,8,9,13,42,55,-13,33
Ballinamalla,1623,11,9,5,16,30,51,-21,32
Crusaders,1624,1,21,7,2,64,28,36,70
Linfield,1624,2,14,10,6,60,32,28,52
Cliftonville,1624,3,13,8,9,51,40,11,47
Ballymena,1624,4,12,8,10,53,61,-8,44
Coleraine,1624,5,9,12,9,38,37,1,39
Dungannon,1624,6,9,10,11,49,49,0,37
Ballinamalla,1624,7,11,3,16,37,53,-16,36
Glenavon,1624,8,8,11,11,45,49,-4,35
Glentoran,1624,9,7,9,14,24,40,-16,30
Portadown,1624,10,8,6,16,27,46,-19,30
Ards,1624,11,7,8,15,37,50,-13,29
Linfield,1625,1,16,7,7,72,38,34,55
Cliftonville,1625,2,16,6,8,56,41,15,54
Crusaders,1625,3,15,8,7,54,35,19,53
Ballymena,1625,4,15,6,9,58,57,1,51
Glenavon,1625,5,11,12,7,53,50,3,45
Dungannon,1625,6,10,12,8,48,39,9,42
Coleraine,1625,7,10,12,8,40,33,7,42
Glentoran,1625,8,10,7,13,34,45,-11,37
Ards,1625,9,10,3,17,34,48,-14,33
Ballinamalla,1625,10,8,4,18,28,53,-25,28
Portadown,1625,11,4,3,23,17,55,-38,15
Crusaders,1626,1,20,7,3,68,33,35,67
Ballymena,1626,2,16,6,8,58,54,4,54
Linfield,1626,3,13,11,6,63,36,27,50
Cliftonville,1626,4,14,6,10,47,38,9,48
Glenavon,1626,5,11,9,10,42,45,-3,42
Coleraine,1626,6,9,12,9,41,37,4,39
Dungannon,1626,7,9,10,11,52,44,8,37
Glentoran,1626,8,9,7,14,29,51,-22,34
Ards,1626,9,9,4,17,34,49,-15,31
Portadown,1626,10,6,9,15,26,43,-17,27
Ballinamalla,1626,11,6,5,19,23,53,-30,23
Ballymena,1627,1,17,5,8,60,49,11,56
Linfield,1627,2,14,10,6,59,32,27,52
Crusaders,1627,3,15,6,9,50,35,15,51
Glenavon,1627,4,12,11,7,49,41,8,47
Coleraine,1627,5,12,9,9,40,38,2,45
Dungannon,1627,6,9,12,9,48,42,6,39
Cliftonville,1627,7,11,6,13,41,43,-2,39
Glentoran,1627,8,9,8,13,29,42,-13,35
Ards,1627,9,8,7,15,39,51,-12,31
Portadown,1627,10,8,5,17,26,46,-20,29
Ballinamalla,1627,11,7,7,16,32,54,-22,28
Linfield,1628,1,16,9,5,62,34,28,57
Crusaders,1628,2,16,8,6,58,31,27,56
Cliftonville,1628,3,16,6,8,54,36,18,54
Dungannon,1628,4,11,9,10,54,43,11,42
Ballymena,1628,5,12,6,12,59,65,-6,42
Coleraine,1628,6,10,11,9,37,41,-4,41
Ards,1628,7,11,7,12,45,46,-1,40
Glentoran,1628,8,9,6,15,32,51,-19,33
Glenavon,1628,9,6,12,12,39,54,-15,30
Portadown,1628,10,8,6,16,24,44,-20,30
Ballinamalla,1628,11,7,6,17,32,51,-19,27
Crusaders,1629,1,18,6,6,56,35,21,60
Linfield,1629,2,15,9,6,58,26,32,54
Coleraine,1629,3,14,8,8,45,34,11,50
Cliftonville,1629,4,15,2,13,57,46,11,47
Ballymena,1629,5,14,5,11,51,54,-3,47
Dungannon,1629,6,12,8,10,52,45,7,44
Glenavon,1629,7,9,11,10,37,43,-6,38
Ards,1629,8,11,3,16,34,43,-9,36
Glentoran,1629,9,9,7,14,32,44,-12,34
Portadown,1629,10,7,6,17,20,40,-20,27
Ballinamalla,1629,11,7,3,20,25,57,-32,24
Crusaders,1630,1,21,5,4,64,28,36,68
Linfield,1630,2,18,9,3,65,31,34,63
Cliftonville,1630,3,15,6,9,52,40,12,51
Glenavon,1630,4,14,9,7,50,38,12,51
Coleraine,1630,5,10,11,9,38,38,0,41
Ballymena,1630,6,10,6,14,47,59,-12,36
Dungannon,1630,7,8,11,11,48,44,4,35
Ards,1630,8,9,5,16,40,48,-8,32
Glentoran,1630,9,7,8,15,20,43,-23,29
Portadown,1630,10,8,5,17,25,51,-26,29
Ballinamalla,1630,11,4,7,19,25,54,-29,19
Ballymena,1631,1,18,7,5,72,51,21,61
Cliftonville,1631,2,16,5,9,53,40,13,53
Crusaders,1631,3,15,7,8,49,35,14,52
Linfield,1631,4,14,9,7,56,33,23,51
Dungannon,1631,5,12,9,9,45,34,11,45
Glenavon,1631,6,10,12,8,47,43,4,42
Ards,1631,7,10,8,12,41,48,-7,38
Coleraine,1631,8,7,11,12,39,50,-11,32
Ballinamalla,1631,9,8,8,14,29,44,-15,32
Glentoran,1631,10,6,6,18,25,51,-26,24
Portadown,1631,11,7,2,21,29,56,-27,23
Crusaders,1632,1,15,9,6,57,35,22,54
Cliftonville,1632,2,16,5,9,58,41,17,53
Linfield,1632,3,13,10,7,51,29,22,49
Coleraine,1632,4,12,11,7,52,36,16,47
Ballymena,1632,5,14,5,11,54,62,-8,47
Glenavon,1632,6,10,13,7,40,38,2,43
Dungannon,1632,7,11,7,12,54,45,9,40
Glentoran,1632,8,10,8,12,37,52,-15,38
Ards,1632,9,9,6,15,42,50,-8,33
Ballinamalla,1632,10,6,7,17,24,50,-26,25
Portadown,1632,11,4,9,17,20,51,-31,21
Linfield,1633,1,19,9,2,62,21,41,66
Cliftonville,1633,2,15,6,9,49,34,15,51
Coleraine,1633,3,13,10,7,47,37,10,49
Ballymena,1633,4,14,7,9,54,54,0,49
Crusaders,1633,5,12,8,10,47,37,10,44
Glenavon,1633,6,11,10,9,48,47,1,43
Glentoran,1633,7,8,11,11,30,43,-13,35
Dungannon,1633,8,7,12,11,44,40,4,33
Ballinamalla,1633,9,9,4,17,33,54,-21,31
Ards,1633,10,8,5,17,37,51,-14,29
Portadown,1633,11,5,6,19,21,54,-33,21
Linfield,1634,1,16,8,6,60,29,31,56
Crusaders,1634,2,14,9,7,51,35,16,51
Coleraine,1634,3,12,13,5,47,33,14,49
Ballymena,1634,4,13,9,8,57,53,4,48
Cliftonville,1634,5,14,5,11,56,42,14,47
Dungannon,1634,6,11,11,8,48,35,13,44
Glenavon,1634,7,11,11,8,48,46,2,44
Glentoran,1634,8,8,8,14,32,47,-15,32
Ards,1634,9,9,4,17,32,55,-23,31
Ballinamalla,1634,10,8,4,18,28,46,-18,28
Portadown,1634,11,5,6,19,18,56,-38,21
Crusaders,1635,1,19,5,6,62,36,26,62
Cliftonville,1635,2,17,4,9,53,35,18,55
Ballymena,1635,3,15,6,9,65,62,3,51
Linfield,1635,4,13,11,6,61,32,29,50
Glenavon,1635,5,11,11,8,48,46,2,44
Glentoran,1635,6,11,7,12,40,44,-4,40
Coleraine,1635,7,10,10,10,42,49,-7,40
Dungannon,1635,8,10,8,12,46,46,0,38
Ards,1635,9,8,4,18,42,56,-14,28
Ballinamalla,1635,10,8,3,19,27,52,-25,27
Portadown,1635,11,7,3,20,25,53,-28,24
Crusaders,1636,1,18,6,6,63,35,28,60
Cliftonville,1636,2,15,7,8,54,41,13,52
Ballymena,1636,3,15,6,9,57,58,-1,51
Coleraine,1636,4,12,12,6,51,35,16,48
Linfield,1636,5,13,9,8,56,41,15,48
Dungannon,1636,6,10,9,11,53,48,5,39
Glenavon,1636,7,9,11,10,46,49,-3,38
Glentoran,1636,8,10,8,12,29,38,-9,38
Ards,1636,9,9,7,14,37,48,-11,34
Portadown,1636,10,5,8,17,21,41,-20,23
Ballinamalla,1636,11,5,5,20,28,61,-33,20
Crusaders,1637,1,18,4,8,55,36,19,58
Ballymena,1637,2,15,6,9,62,58,4,51
Glenavon,1637,3,14,8,8,54,40,14,50
Linfield,1637,4,13,8,9,57,38,19,47
Cliftonville,1637,5,13,5,12,51,48,3,44
Glentoran,1637,6,10,8,12,31,41,-10,38
Coleraine,1637,7,8,13,9,39,40,-1,37
Dungannon,1637,8,9,9,12,52,47,5,36
Ards,1637,9,10,6,14,41,49,-8,36
Ballinamalla,1637,10,9,4,17,34,53,-19,31
Portadown,1637,11,8,5,17,24,50,-26,29
Cliftonville,1638,1,20,3,7,60,38,22,63
Linfield,1638,2,17,9,4,59,26,33,60
Crusaders,1638,3,17,8,5,67,40,27,59
Ballymena,1638,4,14,6,10,53,54,-1,48
Dungannon,1638,5,9,11,10,53,49,4,38
Coleraine,1638,6,8,11,11,39,45,-6,35
Glentoran,1638,7,9,8,13,29,42,-13,35
Glenavon,1638,8,7,10,13,42,52,-10,31
Ards,1638,9,9,4,17,32,47,-15,31
Ballinamalla,1638,10,9,2,19,31,51,-20,29
Portadown,1638,11,7,6,17,24,45,-21,27
Crusaders,1639,1,16,7,7,58,39,19,55
Ballymena,1639,2,16,5,9,67,61,6,53
Cliftonville,1639,3,14,9,7,55,36,19,51
Glenavon,1639,4,13,12,5,48,37,11,51
Dungannon,1639,5,11,10,9,49,33,16,43
Linfield,1639,6,11,10,9,54,39,15,43
Coleraine,1639,7,11,10,9,42,41,1,43
Ards,1639,8,8,8,14,39,49,-10,32
Glentoran,1639,9,7,9,14,28,50,-22,30
Ballinamalla,1639,10,6,8,16,27,55,-28,26
Portadown,1639,11,4,8,18,23,50,-27,20
Linfield,1640,1,16,7,7,60,32,28,55
Cliftonville,1640,2,17,3,10,59,37,22,54
Crusaders,1640,3,14,8,8,50,41,9,50
Coleraine,1640,4,13,9,8,41,37,4,48
Dungannon,1640,5,12,9,9,53,36,17,45
Ballymena,1640,6,12,7,11,58,63,-5,43
Glentoran,1640,7,11,8,11,35,42,-7,41
Glenavon,1640,8,9,11,10,47,52,-5,38
Portadown,1640,9,11,4,15,35,50,-15,37
Ards,1640,10,8,3,19,30,50,-20,27
Ballinamalla,1640,11,5,5,20,22,50,-28,20
Ballymena,1641,1,17,5,8,70,57,13,56
Linfield,1641,2,15,10,5,61,34,27,55
Crusaders,1641,3,13,13,4,47,28,19,52
Cliftonville,1641,4,15,7,8,58,41,17,52
Coleraine,1641,5,9,15,6,38,37,1,42
Dungannon,1641,6,10,10,10,48,43,5,40
Glenavon,1641,7,9,10,11,46,50,-4,37
Glentoran,1641,8,9,9,12,34,46,-12,36
Ards,1641,9,8,4,18,39,51,-12,28
Ballinamalla,1641,10,8,3,19,30,55,-25,27
Portadown,1641,11,6,6,18,30,59,-29,24
Crusaders,1642,1,17,8,5,61,36,25,59
Linfield,1642,2,15,8,7,60,34,26,53
Dungannon,1642,3,14,6,10,50,39,11,48
Ballymena,1642,4,14,6,10,56,57,-1,48
Cliftonville,1642,5,14,4,12,46,40,6,46
Glentoran,1642,6,12,7,11,34,39,-5,43
Coleraine,1642,7,10,9,11,34,40,-6,39
Glenavon,1642,8,10,8,12,47,48,-1,38
Ballinamalla,1642,9,9,4,17,30,49,-19,31
Ards,1642,10,7,8,15,32,46,-14,29
Portadown,1642,11,6,6,18,25,47,-22,24
Crusaders,1643,1,16,10,4,54,37,17,58
Linfield,1643,2,14,11,5,58,28,30,53
Ballymena,1643,3,15,6,9,60,55,5,51
Cliftonville,1643,4,13,8,9,51,42,9,47
Glenavon,1643,5,9,16,5,46,41,5,43
Dungannon,1643,6,11,9,10,54,46,8,42
Coleraine,1643,7,10,10,10,41,36,5,40
Glentoran,1643,8,10,5,15,32,47,-15,35
Ballinamalla,1643,9,8,5,17,30,51,-21,29
Ards,1643,10,8,4,18,38,54,-16,28
Portadown,1643,11,7,4,19,25,52,-27,25
Crusaders,1644,1,17,5,8,56,39,17,56
Cliftonville,1644,2,17,5,8,57,42,15,56
Glenavon,1644,3,14,10,6,57,37,20,52
Ballymena,1644,4,14,7,9,59,53,6,49
Linfield,1644,5,12,10,8,56,34,22,46
Coleraine,1644,6,10,11,9,39,42,-3,41
Dungannon,1644,7,9,7,14,50,55,-5,34
Ards,1644,8,9,5,16,38,57,-19,32
Glentoran,1644,9,8,7,15,26,39,-13,31
Portadown,1644,10,8,7,15,26,40,-14,31
Ballinamalla,1644,11,7,6,17,22,48,-26,27
Crusaders,1645,1,17,8,5,60,31,29,59
Linfield,1645,2,13,8,9,50,32,18,47
Coleraine,1645,3,11,13,6,44,39,5,46
Glenavon,1645,4,12,10,8,44,42,2,46
Dungannon,1645,5,12,9,9,52,37,15,45
Cliftonville,1645,6,13,6,11,53,40,13,45
Glentoran,1645,7,12,7,11,30,37,-7,43
Ballymena,1645,8,11,9,10,50,55,-5,42
Ards,1645,9,9,6,15,42,55,-13,33
Portadown,1645,10,9,3,18,26,50,-24,30
Ballinamalla,1645,11,6,1,23,22,55,-33,19
Crusaders,1646,1,18,6,6,59,26,33,60
Linfield,1646,2,15,8,7,57,34,23,53
Cliftonville,1646,3,14,7,9,49,39,10,49
Dungannon,1646,4,12,11,7,48,35,13,47
Coleraine,1646,5,11,12,7,45,35,10,45
Ballymena,1646,6,12,5,13,52,59,-7,41
Glentoran,1646,7,11,7,12,28,42,-14,40
Glenavon,1646,8,8,14,8,43,47,-4,38
Ards,1646,9,8,7,15,38,50,-12,31
Ballinamalla,1646,10,6,7,17,29,55,-26,25
Portadown,1646,11,5,6,19,25,51,-26,21
Linfield,1647,1,15,8,7,56,33,23,53
Crusaders,1647,2,14,8,8,51,37,14,50
Ballymena,1647,3,12,11,7,56,52,4,47
Glenavon,1647,4,12,11,7,48,45,3,47
Dungannon,1647,5,12,9,9,51,39,12,45
Cliftonville,1647,6,12,8,10,48,39,9,44
Coleraine,1647,7,10,13,7,44,39,5,43
Ards,1647,8,10,3,17,40,50,-10,33
Glentoran,1647,9,8,8,14,28,46,-18,32
Ballinamalla,1647,10,8,6,16,29,49,-20,30
Portadown,1647,11,6,7,17,25,47,-22,25
Linfield,1648,1,19,8,3,65,24,41,65
Ballymena,1648,2,15,4,11,74,64,10,49
Cliftonville,1648,3,15,4,11,51,41,10,49
Crusaders,1648,4,13,9,8,47,36,11,48
Coleraine,1648,5,11,11,8,42,44,-2,44
Glenavon,1648,6,11,10,9,46,41,5,43
Dungannon,1648,7,11,8,11,48,45,3,41
Glentoran,1648,8,10,8,12,36,42,-6,38
Ards,1648,9,9,3,18,33,48,-15,30
Portadown,1648,10,6,7,17,19,45,-26,25
Ballinamalla,1648,11,7,4,19,27,58,-31,25
Linfield,1649,1,15,11,4,59,26,33,56
Crusaders,1649,2,16,8,6,50,30,20,56
Cliftonville,1649,3,15,6,9,55,38,17,51
Ballymena,1649,4,14,9,7,62,57,5,51
Glenavon,1649,5,10,13,7,49,43,6,43
Coleraine,1649,6,9,12,9,43,43,0,39
Portadown,1649,7,9,9,12,31,37,-6,36
Dungannon,1649,8,9,7,14,41,48,-7,34
Ards,1649,9,10,4,16,40,52,-12,34
Glentoran,1649,10,7,7,16,33,58,-25,28
Ballinamalla,1649,11,7,2,21,30,61,-31,23
Crusaders,1650,1,18,4,8,63,36,27,58
Glenavon,1650,2,16,9,5,61,40,21,57
Linfield,1650,3,15,9,6,59,28,31,54
Cliftonville,1650,4,15,5,10,50,38,12,50
Ballymena,1650,5,14,6,10,54,61,-7,48
Glentoran,1650,6,10,9,11,33,43,-10,39
Dungannon,1650,7,8,12,10,50,50,0,36
Coleraine,1650,8,6,12,12,32,39,-7,30
Ards,1650,9,7,6,17,36,52,-16,27
Ballinamalla,1650,10,7,6,17,27,52,-25,27
Portadown,1650,11,7,6,17,22,48,-26,27
Cliftonville,1651,1,17,5,8,51,32,19,56
Glenavon,1651,2,15,9,6,48,39,9,54
Linfield,1651,3,15,8,7,62,31,31,53
Crusaders,1651,4,16,5,9,53,37,16,53
Coleraine,1651,5,11,11,8,36,32,4,44
Ballymena,1651,6,11,8,11,51,55,-4,41
Dungannon,1651,7,9,9,12,48,46,2,36
Ballinamalla,1651,8,10,5,15,36,50,-14,35
Glentoran,1651,9,7,10,13,22,43,-21,31
Ards,1651,10,9,3,18,35,50,-15,30
Portadown,1651,11,6,5,19,24,51,-27,23
Crusaders,1652,1,15,9,6,54,34,20,54
Ballymena,1652,2,16,6,8,61,51,10,54
Glenavon,1652,3,14,11,5,54,40,14,53
Cliftonville,1652,4,14,5,11,56,43,13,47
Linfield,1652,5,12,8,10,59,33,26,44
Coleraine,1652,6,11,10,9,46,43,3,43
Dungannon,1652,7,9,11,10,47,48,-1,38
Glentoran,1652,8,9,9,12,34,52,-18,36
Ards,1652,9,8,9,13,42,49,-7,33
Ballinamalla,1652,10,7,5,18,33,64,-31,26
Portadown,1652,11,5,7,18,25,54,-29,22
Linfield,1653,1,17,7,6,63,34,29,58
Crusaders,1653,2,16,8,6,56,35,21,56
Ballymena,1653,3,17,5,8,71,61,10,56
Coleraine,1653,4,12,8,10,37,32,5,44
Dungannon,1653,5,12,7,11,48,43,5,43
Glenavon,1653,6,11,8,11,41,47,-6,41
Cliftonville,1653,7,12,4,14,52,56,-4,40
Ards,1653,8,10,5,15,42,49,-7,35
Glentoran,1653,9,8,7,15,31,44,-13,31
Ballinamalla,1653,10,8,6,16,29,48,-19,30
Portadown,1653,11,7,5,18,26,47,-21,26
Cliftonville,1654,1,16,3,11,51,43,8,51
Linfield,1654,2,13,11,6,55,29,26,50
Ballymena,1654,3,15,5,10,59,51,8,50
Crusaders,1654,4,14,7,9,54,43,11,49
Coleraine,1654,5,10,10,10,40,38,2,40
Dungannon,1654,6,10,9,11,50,45,5,39
Glenavon,1654,7,9,11,10,45,51,-6,38
Ards,1654,8,11,5,14,44,51,-7,38
Ballinamalla,1654,9,11,5,14,29,45,-16,38
Glentoran,1654,10,7,10,13,34,45,-11,31
Portadown,1654,11,8,6,16,29,49,-20,30
Linfield,1655,1,16,8,6,68,38,30,56
Crusaders,1655,2,16,6,8,57,43,14,54
Ballymena,1655,3,15,5,10,63,58,5,50
Coleraine,1655,4,13,8,9,49,46,3,47
Cliftonville,1655,5,14,4,12,55,43,12,46
Glenavon,1655,6,10,9,11,50,56,-6,39
Glentoran,1655,7,11,6,13,37,47,-10,39
Dungannon,1655,8,9,9,12,53,47,6,36
Ards,1655,9,10,4,16,46,53,-7,34
Portadown,1655,10,8,7,15,26,47,-21,31
Ballinamalla,1655,11,8,4,18,26,52,-26,28
Linfield,1656,1,18,8,4,67,28,39,62
Ballymena,1656,2,17,3,10,58,53,5,54
Crusaders,1656,3,15,7,8,55,35,20,52
Dungannon,1656,4,12,10,8,54,41,13,46
Cliftonville,1656,5,13,6,11,47,39,8,45
Coleraine,1656,6,11,10,9,41,39,2,43
Glenavon,1656,7,11,10,9,45,45,0,43
Ards,1656,8,11,3,16,39,45,-6,36
Glentoran,1656,9,8,6,16,25,51,-26,30
Ballinamalla,1656,10,8,3,19,27,49,-22,27
Portadown,1656,11,5,6,19,21,54,-33,21
Cliftonville,1657,1,18,5,7,55,32,23,59
Crusaders,1657,2,16,9,5,54,33,21,57
Linfield,1657,3,15,8,7,58,34,24,53
Ballymena,1657,4,15,7,8,58,53,5,52
Glenavon,1657,5,11,12,7,53,45,8,45
Glentoran,1657,6,11,6,13,37,42,-5,39
Dungannon,1657,7,7,13,10,43,42,1,34
Coleraine,1657,8,7,12,11,40,50,-10,33
Portadown,1657,9,7,7,16,22,46,-24,28
Ards,1657,10,7,4,19,34,55,-21,25
Ballinamalla,1657,11,6,7,17,34,56,-22,25
Crusaders,1658,1,20,5,5,64,31,33,65
Linfield,1658,2,16,7,7,66,36,30,55
Cliftonville,1658,3,16,5,9,51,41,10,53
Ballymena,1658,4,14,7,9,59,57,2,49
Glenavon,1658,5,13,9,8,55,45,10,48
Coleraine,1658,6,10,12,8,38,39,-1,42
Dungannon,1658,7,10,8,12,46,42,4,38
Glentoran,1658,8,9,7,14,32,44,-12,34
Ards,1658,9,9,5,16,34,50,-16,32
Portadown,1658,10,5,6,19,23,47,-24,21
Ballinamalla,1658,11,5,5,20,26,62,-36,20
Crusaders,1659,1,16,7,7,57,38,19,55
Linfield,1659,2,14,12,4,63,32,31,54
Ballymena,1659,3,15,6,9,60,54,6,51
Coleraine,1659,4,13,10,7,42,39,3,49
Cliftonville,1659,5,14,4,12,49,46,3,46
Glenavon,1659,6,10,11,9,49,47,2,41
Ards,1659,7,11,3,16,36,47,-11,36
Dungannon,1659,8,8,8,14,42,43,-1,32
Ballinamalla,1659,9,10,2,18,32,49,-17,32
Portadown,1659,10,8,6,16,29,43,-14,30
Glentoran,1659,11,7,9,14,30,51,-21,30
Linfield,1660,1,16,9,5,65,31,34,57
Crusaders,1660,2,16,9,5,56,26,30,57
Glenavon,1660,3,13,10,7,48,43,5,49
Coleraine,1660,4,13,7,10,45,40,5,46
Ballymena,1660,5,12,9,9,50,51,-1,45
Cliftonville,1660,6,12,7,11,45,41,4,43
Ards,1660,7,9,5,16,37,50,-13,32
Dungannon,1660,8,7,10,13,43,49,-6,31
Portadown,1660,9,8,7,15,26,43,-17,31
Ballinamalla,1660,10,9,4,17,38,58,-20,31
Glentoran,1660,11,8,7,15,29,50,-21,31
Crusaders,1661,1,17,7,6,54,32,22,58
Cliftonville,1661,2,16,5,9,49,36,13,53
Ballymena,1661,3,15,7,8,64,57,7,52
Coleraine,1661,4,12,11,7,41,33,8,47
Linfield,1661,5,12,9,9,55,35,20,45
Ards,1661,6,12,4,14,47,50,-3,40
Glenavon,1661,7,8,14,8,40,47,-7,38
Dungannon,1661,8,7,12,11,51,48,3,33
Glentoran,1661,9,8,8,14,32,48,-16,32
Ballinamalla,1661,10,7,7,16,28,51,-23,28
Portadown,1661,11,7,4,19,21,45,-24,25
Crusaders,1662,1,19,8,3,62,26,36,65
Linfield,1662,2,16,6,8,59,31,28,54
Ballymena,1662,3,14,8,8,53,48,5,50
Coleraine,1662,4,12,11,7,41,33,8,47
Glenavon,1662,5,12,10,8,47,46,1,46
Cliftonville,1662,6,13,5,12,44,46,-2,44
Dungannon,1662,7,10,8,12,53,50,3,38
Glentoran,1662,8,8,8,14,26,42,-16,32
Ards,1662,9,8,7,15,34,49,-15,31
Ballinamalla,1662,10,7,4,19,28,52,-24,25
Portadown,1662,11,7,3,20,23,47,-24,24
Crusaders,1663,1,16,8,6,50,29,21,56
Linfield,1663,2,15,9,6,49,25,24,54
Ballymena,1663,3,15,8,7,57,46,11,53
Cliftonville,1663,4,13,7,10,50,40,10,46
Glenavon,1663,5,11,9,10,47,47,0,42
Coleraine,1663,6,8,16,6,35,32,3,40
Dungannon,1663,7,9,8,13,43,48,-5,35
Glentoran,1663,8,9,8,13,34,49,-15,35
Ards,1663,9,8,7,15,35,47,-12,31
Portadown,1663,10,7,8,15,30,47,-17,29
Ballinamalla,1663,11,8,4,18,27,47,-20,28
Crusaders,1664,1,18,6,6,61,31,30,60
Linfield,1664,2,16,7,7,68,32,36,55
Cliftonville,1664,3,15,5,10,48,38,10,50
Glenavon,1664,4,12,10,8,48,45,3,46
Coleraine,1664,5,11,12,7,46,37,9,45
Ballymena,1664,6,13,6,11,52,51,1,45
Ballinamalla,1664,7,10,4,16,31,51,-20,34
Ards,1664,8,9,6,15,36,51,-15,33
Glentoran,1664,9,9,4,17,29,58,-29,31
Dungannon,1664,10,7,9,14,42,49,-7,30
Portadown,1664,11,8,5,17,25,43,-18,29
Crusaders,1665,1,17,5,8,55,34,21,56
Cliftonville,1665,2,17,4,9,57,36,21,55
Linfield,1665,3,14,10,6,55,35,20,52
Coleraine,1665,4,11,10,9,46,41,5,43
Glenavon,1665,5,11,10,9,48,49,-1,43
Ballymena,1665,6,12,6,12,48,54,-6,42
Ards,1665,7,10,6,14,37,45,-8,36
Glentoran,1665,8,9,8,13,25,37,-12,35
Dungannon,1665,9,8,10,12,48,50,-2,34
Ballinamalla,1665,10,9,4,17,30,48,-18,31
Portadown,1665,11,8,5,17,25,45,-20,29
Crusaders,1666,1,16,8,6,60,35,25,56
Linfield,1666,2,15,10,5,59,27,32,55
Cliftonville,1666,3,15,5,10,62,52,10,50
Ballymena,1666,4,15,5,10,62,62,0,50
Coleraine,1666,5,12,11,7,49,38,11,47
Dungannon,1666,6,10,11,9,48,40,8,41
Glenavon,1666,7,10,11,9,47,46,1,41
Ards,1666,8,10,3,17,39,48,-9,33
Glentoran,1666,9,9,5,16,31,51,-20,32
Ballinamalla,1666,10,9,3,18,35,58,-23,30
Portadown,1666,11,5,6,19,22,57,-35,21
Crusaders,1667,1,15,10,5,60,41,19,55
Cliftonville,1667,2,15,7,8,51,36,15,52
Ballymena,1667,3,15,6,9,60,53,7,51
Linfield,1667,4,14,8,8,56,35,21,50
Glenavon,1667,5,14,8,8,52,45,7,50
Coleraine,1667,6,12,10,8,50,49,1,46
Dungannon,1667,7,11,11,8,54,39,15,44
Ards,1667,8,10,4,16,38,52,-14,34
Glentoran,1667,9,7,9,14,22,38,-16,30
Portadown,1667,10,6,7,17,25,48,-23,25
Ballinamalla,1667,11,4,4,22,24,56,-32,16
Crusaders,1668,1,16,9,5,50,29,21,57
Linfield,1668,2,15,9,6,62,33,29,54
Glenavon,1668,3,13,11,6,52,42,10,50
Cliftonville,1668,4,13,7,10,52,40,12,46
Ballymena,1668,5,13,7,10,60,63,-3,46
Coleraine,1668,6,11,10,9,46,43,3,43
Ards,1668,7,12,7,11,48,47,1,43
Dungannon,1668,8,9,8,13,47,48,-1,35
Glentoran,1668,9,8,7,15,30,48,-18,31
Ballinamalla,1668,10,8,3,19,27,49,-22,27
Portadown,1668,11,5,6,19,26,58,-32,21
Crusaders,1669,1,21,6,3,64,29,35,69
Linfield,1669,2,13,10,7,59,36,23,49
Ballymena,1669,3,13,7,10,54,58,-4,46
Cliftonville,1669,4,13,6,11,53,41,12,45
Coleraine,1669,5,12,9,9,40,37,3,45
Glenavon,1669,6,10,12,8,47,42,5,42
Glentoran,1669,7,11,7,12,38,42,-4,40
Ards,1669,8,11,4,15,36,52,-16,37
Ballinamalla,1669,9,8,6,16,30,45,-15,30
Portadown,1669,10,7,5,18,22,52,-30,26
Dungannon,1669,11,4,12,14,45,54,-9,24
Crusaders,1670,1,17,9,4,59,34,25,60
Glenavon,1670,2,15,10,5,52,37,15,55
Ballymena,1670,3,14,9,7,60,53,7,51
Linfield,1670,4,14,8,8,56,28,28,50
Cliftonville,1670,5,12,5,13,43,46,-3,41
Coleraine,1670,6,10,9,11,43,38,5,39
Dungannon,1670,7,10,9,11,50,47,3,39
Portadown,1670,8,10,6,14,27,39,-12,36
Glentoran,1670,9,9,7,14,34,45,-11,34
Ards,1670,10,7,5,18,32,59,-27,26
Ballinamalla,1670,11,6,5,19,25,55,-30,23
Crusaders,1671,1,17,7,6,54,32,22,58
Cliftonville,1671,2,17,4,9,53,35,18,55
Linfield,1671,3,15,9,6,54,27,27,54
Ballymena,1671,4,16,5,9,64,60,4,53
Glenavon,1671,5,14,9,7,50,38,12,51
Coleraine,1671,6,12,9,9,43,43,0,45
Dungannon,1671,7,10,8,12,48,42,6,38
Ards,1671,8,8,6,16,39,48,-9,30
Glentoran,1671,9,7,8,15,28,49,-21,29
Ballinamalla,1671,10,7,6,17,22,50,-28,27
Portadown,1671,11,4,5,21,23,54,-31,17
Glenavon,1672,1,14,12,4,56,38,18,54
Crusaders,1672,2,15,8,7,57,32,25,53
Cliftonville,1672,3,15,6,9,57,51,6,51
Linfield,1672,4,13,8,9,53,31,22,47
Coleraine,1672,5,12,10,8,44,39,5,46
Ballymena,1672,6,10,9,11,55,63,-8,39
Dungannon,1672,7,10,7,13,52,52,0,37
Ards,1672,8,10,6,14,40,44,-4,36
Glentoran,1672,9,8,9,13,29,49,-20,33
Ballinamalla,1672,10,9,5,16,27,46,-19,32
Portadown,1672,11,6,6,18,26,51,-25,24
Linfield,1673,1,14,8,8,60,39,21,50
Coleraine,1673,2,14,8,8,52,39,13,50
Ballymena,1673,3,15,4,11,59,56,3,49
Ards,1673,4,14,5,11,45,45,0,47
Crusaders,1673,5,11,11,8,50,42,8,44
Cliftonville,1673,6,13,5,12,49,43,6,44
Glenavon,1673,7,11,10,9,49,52,-3,43
Glentoran,1673,8,10,6,14,38,53,-15,36
Portadown,1673,9,10,5,15,35,50,-15,35
Dungannon,1673,10,8,7,15,50,55,-5,31
Ballinamalla,1673,11,9,3,18,39,52,-13,30
Ballymena,1674,1,18,5,7,62,52,10,59
Linfield,1674,2,16,9,5,59,35,24,57
Crusaders,1674,3,16,8,6,57,34,23,56
Glenavon,1674,4,13,11,6,51,41,10,50
Cliftonville,1674,5,13,7,10,52,42,10,46
Ards,1674,6,11,6,13,45,49,-4,39
Coleraine,1674,7,9,11,10,33,39,-6,38
Dungannon,1674,8,8,8,14,42,44,-2,32
Glentoran,1674,9,7,9,14,33,48,-15,30
Ballinamalla,1674,10,6,5,19,30,54,-24,23
Portadown,1674,11,6,5,19,24,50,-26,23
Crusaders,1675,1,17,5,8,58,40,18,56
Linfield,1675,2,15,8,7,59,32,27,53
Cliftonville,1675,3,16,5,9,52,38,14,53
Glenavon,1675,4,13,10,7,51,37,14,49
Coleraine,1675,5,11,11,8,46,43,3,44
Ballymena,1675,6,13,5,12,54,57,-3,44
Dungannon,1675,7,11,8,11,52,50,2,41
Ards,1675,8,10,6,14,35,48,-13,36
Glentoran,1675,9,9,5,16,31,47,-16,32
Portadown,1675,10,9,3,18,27,48,-21,30
Ballinamalla,1675,11,5,6,19,27,52,-25,21
Ballymena,1676,1,17,6,7,59,49,10,57
Crusaders,1676,2,15,8,7,55,35,20,53
Cliftonville,1676,3,16,3,11,48,40,8,51
Glenavon,1676,4,13,11,6,52,45,7,50
Linfield,1676,5,12,10,8,59,37,22,46
Coleraine,1676,6,11,11,8,42,35,7,44
Ards,1676,7,11,5,14,40,48,-8,38
Glentoran,1676,8,11,5,14,36,46,-10,38
Dungannon,1676,9,9,8,13,45,50,-5,35
Portadown,1676,10,7,4,19,31,53,-22,25
Ballinamalla,1676,11,6,3,21,25,54,-29,21
Linfield,1677,1,18,7,5,73,25,48,61
Crusaders,1677,2,17,6,7,55,30,25,57
Coleraine,1677,3,15,8,7,49,42,7,53
Cliftonville,1677,4,14,6,10,59,47,12,48
Glenavon,1677,5,13,8,9,48,50,-2,47
Dungannon,1677,6,12,9,9,49,37,12,45
Ballymena,1677,7,12,4,14,52,61,-9,40
Portadown,1677,8,11,3,16,33,48,-15,36
Ards,1677,9,10,3,17,44,52,-8,33
Glentoran,1677,10,6,7,17,20,53,-33,25
Ballinamalla,1677,11,5,3,22,27,64,-37,18
Linfield,1678,1,16,9,5,63,30,33,57
Cliftonville,1678,2,16,5,9,55,40,15,53
Crusaders,1678,3,13,9,8,48,39,9,48
Coleraine,1678,4,12,10,8,40,33,7,46
Ballymena,1678,5,13,7,10,67,66,1,46
Glenavon,1678,6,11,12,7,45,42,3,45
Glentoran,1678,7,10,9,11,41,46,-5,39
Dungannon,1678,8,7,12,11,40,39,1,33
Portadown,1678,9,8,7,15,28,44,-16,31
Ballinamalla,1678,10,9,2,19,35,62,-27,29
Ards,1678,11,6,6,18,33,54,-21,24
Linfield,1679,1,16,10,4,59,30,29,58
Crusaders,1679,2,14,10,6,68,47,21,52
Cliftonville,1679,3,14,2,14,54,48,6,44
Ballymena,1679,4,11,10,9,52,59,-7,43
Dungannon,1679,5,10,12,8,52,44,8,42
Glenavon,1679,6,10,12,8,44,42,2,42
Coleraine,1679,7,10,11,9,41,38,3,41
Glentoran,1679,8,11,8,11,34,36,-2,41
Ards,1679,9,9,6,15,36,46,-10,33
Portadown,1679,10,7,6,17,26,50,-24,27
Ballinamalla,1679,11,6,7,17,34,60,-26,25
Crusaders,1680,1,19,6,5,62,30,32,63
Linfield,1680,2,17,7,6,59,31,28,58
Ballymena,1680,3,16,5,9,59,57,2,53
Cliftonville,1680,4,14,4,12,51,41,10,46
Coleraine,1680,5,12,10,8,43,35,8,46
Glenavon,1680,6,9,11,10,44,49,-5,38
Dungannon,1680,7,7,12,11,45,45,0,33
Ards,1680,8,8,7,15,37,47,-10,31
Glentoran,1680,9,8,6,16,27,49,-22,30
Ballinamalla,1680,10,8,6,16,35,60,-25,30
Portadown,1680,11,7,6,17,30,48,-18,27
Crusaders,1681,1,15,8,7,53,36,17,53
Linfield,1681,2,14,9,7,63,35,28,51
Ballymena,1681,3,14,7,9,60,58,2,49
Coleraine,1681,4,13,8,9,43,41,2,47
Glenavon,1681,5,12,8,10,55,49,6,44
Glentoran,1681,6,12,7,11,36,41,-5,43
Cliftonville,1681,7,13,3,14,49,49,0,42
Dungannon,1681,8,8,10,12,51,50,1,34
Ards,1681,9,9,7,14,35,45,-10,34
Ballinamalla,1681,10,9,4,17,31,47,-16,31
Portadown,1681,11,8,5,17,21,46,-25,29
Linfield,1682,1,16,9,5,58,26,32,57
Glenavon,1682,2,14,12,4,47,35,12,54
Ballymena,1682,3,15,7,8,59,57,2,52
Dungannon,1682,4,15,6,9,57,42,15,51
Crusaders,1682,5,13,9,8,51,41,10,48
Cliftonville,1682,6,12,6,12,54,44,10,42
Coleraine,1682,7,10,10,10,35,35,0,40
Glentoran,1682,8,10,9,11,30,40,-10,39
Portadown,1682,9,6,7,17,27,49,-22,25
Ards,1682,10,6,6,18,31,49,-18,24
Ballinamalla,1682,11,5,5,20,26,57,-31,20
Crusaders,1683,1,18,6,6,52,26,26,60
Cliftonville,1683,2,15,5,10,57,42,15,50
Ballymena,1683,3,14,6,10,58,59,-1,48
Linfield,1683,4,12,10,8,51,33,18,46
Glenavon,1683,5,11,11,8,45,46,-1,44
Coleraine,1683,6,11,9,10,47,44,3,42
Ballinamalla,1683,7,11,5,14,36,48,-12,38
Ards,1683,8,10,6,14,40,46,-6,36
Portadown,1683,9,8,7,15,25,42,-17,31
Dungannon,1683,10,7,9,14,46,49,-3,30
Glentoran,1683,11,7,8,15,26,48,-22,29
Linfield,1684,1,17,7,6,67,32,35,58
Ballymena,1684,2,17,6,7,72,54,18,57
Crusaders,1684,3,14,7,9,55,40,15,49
Cliftonville,1684,4,14,7,9,54,43,11,49
Dungannon,1684,5,11,11,8,53,46,7,44
Coleraine,1684,6,10,10,10,37,40,-3,40
Glenavon,1684,7,9,10,11,41,45,-4,37
Ballinamalla,1684,8,11,4,15,39,59,-20,37
Glentoran,1684,9,7,9,14,27,46,-19,30
Portadown,1684,10,7,6,17,25,47,-22,27
Ards,1684,11,7,5,18,33,51,-18,26
Crusaders,1685,1,17,7,6,52,35,17,58
Linfield,1685,2,14,9,7,59,36,23,51
Ballymena,1685,3,13,10,7,52,53,-1,49
Glenavon,1685,4,13,8,9,52,41,11,47
Coleraine,1685,5,12,11,7,43,35,8,47
Cliftonville,1685,6,14,4,12,49,38,11,46
Ballinamalla,1685,7,13,1,16,39,46,-7,40
Dungannon,1685,8,9,10,11,45,41,4,37
Ards,1685,9,7,7,16,36,49,-13,28
Portadown,1685,10,7,6,17,23,49,-26,27
Glentoran,1685,11,6,7,17,26,53,-27,25
Linfield,1686,1,18,9,3,62,27,35,63
Crusaders,1686,2,18,5,7,53,30,23,59
Ballymena,1686,3,13,6,11,59,60,-1,45
Cliftonville,1686,4,12,5,13,45,47,-2,41
Coleraine,1686,5,9,12,9,30,32,-2,39
Glenavon,1686,6,10,9,11,41,47,-6,39
Glentoran,1686,7,11,6,13,31,42,-11,39
Dungannon,1686,8,10,8,12,48,43,5,38
Ards,1686,9,10,5,15,44,47,-3,35
Portadown,1686,10,9,6,15,29,43,-14,33
Ballinamalla,1686,11,9,1,20,25,49,-24,28
Cliftonville,1687,1,17,5,8,51,32,19,56
Glenavon,1687,2,15,10,5,58,41,17,55
Crusaders,1687,3,15,9,6,56,31,25,54
Linfield,1687,4,14,8,8,57,28,29,50
Ballymena,1687,5,13,7,10,57,57,0,46
Coleraine,1687,6,12,9,9,41,45,-4,45
Ards,1687,7,10,8,12,43,49,-6,38
Dungannon,1687,8,7,14,9,46,42,4,35
Portadown,1687,9,10,3,17,25,42,-17,33
Glentoran,1687,10,7,5,18,22,47,-25,26
Ballinamalla,1687,11,3,6,21,22,64,-42,15
Linfield,1688,1,17,7,6,62,30,32,58
Crusaders,1688,2,16,7,7,53,34,19,55
Cliftonville,1688,3,17,3,10,56,43,13,54
Ballymena,1688,4,14,4,12,55,57,-2,46
Coleraine,1688,5,11,11,8,47,40,7,44
Ards,1688,6,13,2,15,48,53,-5,41
Glenavon,1688,7,9,13,8,44,44,0,40
Dungannon,1688,8,10,6,14,46,51,-5,36
Glentoran,1688,9,7,9,14,29,45,-16,30
Ballinamalla,1688,10,8,5,17,29,50,-21,29
Portadown,1688,11,6,7,17,26,48,-22,25
Linfield,1689,1,14,10,6,59,31,28,52
Cliftonville,1689,2,15,6,9,56,37,19,51
Crusaders,1689,3,14,9,7,57,43,14,51
Coleraine,1689,4,13,10,7,52,43,9,49
Glenavon,1689,5,13,9,8,53,48,5,48
Ballymena,1689,6,13,7,10,62,60,2,46
Glentoran,1689,7,11,7,12,34,44,-10,40
Portadown,1689,8,10,5,15,30,41,-11,35
Dungannon,1689,9,8,7,15,47,56,-9,31
Ards,1689,10,8,5,17,39,54,-15,29
Ballinamalla,1689,11,6,5,19,31,63,-32,23
Cliftonville,1690,1,16,4,10,65,41,24,52
Crusaders,1690,2,14,9,7,55,40,15,51
Ballymena,1690,3,14,7,9,62,63,-1,49
Linfield,1690,4,12,12,6,59,37,22,48
Dungannon,1690,5,11,12,7,54,37,17,45
Glenavon,1690,6,11,12,7,58,57,1,45
Glentoran,1690,7,12,6,12,38,48,-10,42
Coleraine,1690,8,11,8,11,42,41,1,41
Ards,1690,9,8,5,17,42,63,-21,29
Portadown,1690,10,6,9,15,28,47,-19,27
Ballinamalla,1690,11,5,6,19,26,55,-29,21
Crusaders,1691,1,17,7,6,53,34,19,58
Ballymena,1691,2,15,7,8,57,55,2,52
Cliftonville,1691,3,15,4,11,52,39,13,49
Linfield,1691,4,12,10,8,58,37,21,46
Glenavon,1691,5,12,9,9,49,48,1,45
Coleraine,1691,6,10,10,10,42,43,-1,40
Ards,1691,7,10,7,13,48,51,-3,37
Dungannon,1691,8,7,12,11,42,41,1,33
Portadown,1691,9,9,5,16,24,37,-13,32
Glentoran,1691,10,7,11,12,34,48,-14,32
Ballinamalla,1691,11,7,6,17,26,52,-26,27
Crusaders,1692,1,17,10,3,60,31,29,61
Linfield,1692,2,15,8,7,60,35,25,53
Cliftonville,1692,3,15,6,9,55,37,18,51
Ballymena,1692,4,15,4,11,64,66,-2,49
Coleraine,1692,5,12,9,9,43,44,-1,45
Glenavon,1692,6,10,11,9,46,47,-1,41
Dungannon,1692,7,9,12,9,48,43,5,39
Ards,1692,8,11,3,16,40,52,-12,36
Ballinamalla,1692,9,8,4,18,35,56,-21,28
Portadown,1692,10,7,6,17,29,46,-17,27
Glentoran,1692,11,6,7,17,31,54,-23,25
Cliftonville,1693,1,17,5,8,56,37,19,56
Linfield,1693,2,14,10,6,61,34,27,52
Crusaders,1693,3,14,8,8,55,40,15,50
Glenavon,1693,4,12,13,5,54,42,12,49
Ballymena,1693,5,12,8,10,58,59,-1,44
Dungannon,1693,6,12,7,11,54,47,7,43
Coleraine,1693,7,10,11,9,41,42,-1,41
Glentoran,1693,8,9,11,10,33,41,-8,38
Ards,1693,9,7,9,14,36,49,-13,30
Ballinamalla,1693,10,9,2,19,34,55,-21,29
Portadown,1693,11,6,2,22,23,59,-36,20
Crusaders,1694,1,17,7,6,64,36,28,58
Coleraine,1694,2,14,10,6,47,38,9,52
Cliftonville,1694,3,16,3,11,49,39,10,51
Linfield,1694,4,11,13,6,58,37,21,46
Ballymena,1694,5,12,8,10,58,56,2,44
Glenavon,1694,6,11,9,10,47,47,0,42
Ards,1694,7,10,7,13,39,47,-8,37
Dungannon,1694,8,8,10,12,47,49,-2,34
Ballinamalla,1694,9,9,5,16,33,53,-20,32
Glentoran,1694,10,6,12,12,34,49,-15,30
Portadown,1694,11,6,6,18,24,49,-25,24
Crusaders,1695,1,17,9,4,62,33,29,60
Linfield,1695,2,16,8,6,65,30,35,56
Cliftonville,1695,3,16,5,9,51,36,15,53
Coleraine,1695,4,12,11,7,45,35,10,47
Ballymena,1695,5,13,6,11,64,67,-3,45
Dungannon,1695,6,11,9,10,55,52,3,42
Ards,1695,7,10,5,15,38,51,-13,35
Glenavon,1695,8,7,14,9,36,49,-13,35
Portadown,1695,9,8,5,17,35,54,-19,29
Glentoran,1695,10,7,6,17,29,50,-21,27
Ballinamalla,1695,11,6,6,18,29,52,-23,24
Crusaders,1696,1,15,8,7,55,39,16,53
Cliftonville,1696,2,14,9,7,47,33,14,51
Glenavon,1696,3,13,10,7,49,42,7,49
Linfield,1696,4,13,7,10,61,37,24,46
Ballymena,1696,5,12,9,9,57,58,-1,45
Dungannon,1696,6,11,9,10,56,43,13,42
Coleraine,1696,7,9,12,9,40,38,2,39
Glentoran,1696,8,9,10,11,29,39,-10,37
Ards,1696,9,9,9,12,38,44,-6,36
Ballinamalla,1696,10,9,4,17,29,53,-24,31
Portadown,1696,11,5,5,20,25,60,-35,20
Linfield,1697,1,14,8,8,63,42,21,50
Ballymena,1697,2,14,8,8,65,55,10,50
Coleraine,1697,3,11,15,4,42,33,9,48
Crusaders,1697,4,13,6,11,49,38,11,45
Cliftonville,1697,5,13,6,11,52,43,9,45
Glentoran,1697,6,12,7,11,36,44,-8,43
Glenavon,1697,7,11,9,10,43,44,-1,42
Dungannon,1697,8,10,9,11,51,45,6,39
Ards,1697,9,11,6,13,38,42,-4,39
Ballinamalla,1697,10,7,5,18,28,54,-26,26
Portadown,1697,11,5,9,16,24,51,-27,24
Crusaders,1698,1,15,8,7,53,36,17,53
Linfield,1698,2,14,9,7,65,34,31,51
Cliftonville,1698,3,15,5,10,52,35,17,50
Coleraine,1698,4,13,9,8,45,38,7,48
Ballymena,1698,5,13,5,12,53,58,-5,44
Glenavon,1698,6,11,9,10,48,49,-1,42
Dungannon,1698,7,9,10,11,44,42,2,37
Ards,1698,8,10,7,13,42,47,-5,37
Ballinamalla,1698,9,10,6,14,29,47,-18,36
Glentoran,1698,10,7,10,13,25,42,-17,31
Portadown,1698,11,6,6,18,21,49,-28,24
Linfield,1699,1,13,14,3,54,29,25,53
Cliftonville,1699,2,14,7,9,55,31,24,49
Crusaders,1699,3,13,9,8,50,40,10,48
Ballymena,1699,4,13,8,9,52,54,-2,47
Glenavon,1699,5,11,12,7,51,43,8,45
Dungannon,1699,6,9,13,8,48,41,7,40
Coleraine,1699,7,9,13,8,33,30,3,40
Ards,1699,8,9,7,14,40,51,-11,34
Ballinamalla,1699,9,10,4,16,29,46,-17,34
Glentoran,1699,10,8,7,15,25,43,-18,31
Portadown,1699,11,6,6,18,21,50,-29,24
Crusaders,1700,1,18,8,4,60,28,32,62
Cliftonville,1700,2,17,5,8,50,32,18,56
Linfield,1700,3,15,8,7,56,29,27,53
Ballymena,1700,4,14,5,11,53,56,-3,47
Coleraine,1700,5,10,10,10,43,43,0,40
Glenavon,1700,6,10,9,11,44,50,-6,39
Portadown,1700,7,10,6,14,25,36,-11,36
Ards,1700,8,9,7,14,39,46,-7,34
Glentoran,1700,9,8,8,14,26,46,-20,32
Ballinamalla,1700,10,7,7,16,30,53,-23,28
Dungannon,1700,11,6,9,15,40,47,-7,27
Crusaders,1701,1,16,9,5,58,36,22,57
Cliftonville,1701,2,16,4,10,59,41,18,52
Linfield,1701,3,14,9,7,54,25,29,51
Coleraine,1701,4,12,11,7,45,35,10,47
Ballymena,1701,5,13,3,14,53,67,-14,42
Glenavon,1701,6,10,11,9,43,43,0,41
Glentoran,1701,7,11,7,12,34,43,-9,40
Dungannon,1701,8,10,8,12,49,49,0,38
Portadown,1701,9,9,5,16,28,47,-19,32
Ards,1701,10,8,7,15,38,47,-9,31
Ballinamalla,1701,11,7,4,19,25,53,-28,25
Linfield,1702,1,16,9,5,64,40,24,57
Crusaders,1702,2,14,8,8,53,41,12,50
Coleraine,1702,3,13,11,6,48,39,9,50
Cliftonville,1702,4,15,4,11,55,40,15,49
Ards,1702,5,13,6,11,52,43,9,45
Ballymena,1702,6,12,7,11,58,61,-3,43
Glenavon,1702,7,9,13,8,47,50,-3,40
Dungannon,1702,8,10,8,12,49,47,2,38
Portadown,1702,9,9,6,15,28,42,-14,33
Glentoran,1702,10,7,8,15,32,47,-15,29
Ballinamalla,1702,11,4,6,20,24,60,-36,18
Crusaders,1703,1,18,7,5,61,35,26,61
Linfield,1703,2,15,8,7,60,33,27,53
Cliftonville,1703,3,16,5,9,49,36,13,53
Ballymena,1703,4,14,6,10,56,54,2,48
Coleraine,1703,5,12,11,7,40,31,9,47
Glenavon,1703,6,11,11,8,50,41,9,44
Glentoran,1703,7,9,9,12,33,51,-18,36
Dungannon,1703,8,8,9,13,44,45,-1,33
Portadown,1703,9,9,4,17,27,48,-21,31
Ards,1703,10,8,4,18,33,51,-18,28
Ballinamalla,1703,11,6,4,20,27,55,-28,22
Crusaders,1704,1,17,6,7,59,41,18,57
Cliftonville,1704,2,16,4,10,52,38,14,52
Ballymena,1704,3,14,7,9,60,62,-2,49
Dungannon,1704,4,13,8,9,49,35,14,47
Linfield,1704,5,12,10,8,57,41,16,46
Coleraine,1704,6,11,10,9,38,38,0,43
Glenavon,1704,7,11,9,10,48,49,-1,42
Glentoran,1704,8,10,9,11,42,43,-1,39
Ballinamalla,1704,9,8,7,15,33,44,-11,31
Portadown,1704,10,7,5,18,27,50,-23,26
Ards,1704,11,6,5,19,33,57,-24,23
Linfield,1705,1,17,9,4,70,29,41,60
Cliftonville,1705,2,15,7,8,52,36,16,52
Dungannon,1705,3,14,9,7,55,35,20,51
Crusaders,1705,4,13,9,8,49,40,9,48
Ballymena,1705,5,13,6,11,60,66,-6,45
Glenavon,1705,6,10,14,6,45,42,3,44
Glentoran,1705,7,10,6,14,27,42,-15,36
Portadown,1705,8,8,8,14,35,48,-13,32
Coleraine,1705,9,7,10,13,33,43,-10,31
Ards,1705,10,6,8,16,34,52,-18,26
Ballinamalla,1705,11,7,4,19,30,57,-27,25
Linfield,1706,1,15,10,5,62,34,28,55
Cliftonville,1706,2,17,3,10,55,40,15,54
Crusaders,1706,3,16,5,9,57,40,17,53
Ballymena,1706,4,16,5,9,58,53,5,53
Coleraine,1706,5,13,9,8,50,42,8,48
Glenavon,1706,6,9,10,11,48,49,-1,37
Glentoran,1706,7,10,5,15,33,45,-12,35
Dungannon,1706,8,8,10,12,50,50,0,34
Portadown,1706,9,10,4,16,26,41,-15,34
Ards,1706,10,7,7,16,34,54,-20,28
Ballinamalla,1706,11,8,4,18,29,54,-25,28
Cliftonville,1707,1,18,5,7,59,34,25,59
Crusaders,1707,2,17,7,6,59,35,24,58
Ballymena,1707,3,15,5,10,56,59,-3,50
Coleraine,1707,4,13,10,7,47,33,14,49
Glentoran,1707,5,12,6,12,36,39,-3,42
Glenavon,1707,6,10,11,9,43,43,0,41
Linfield,1707,7,10,9,11,53,40,13,39
Dungannon,1707,8,10,9,11,48,43,5,39
Ballinamalla,1707,9,7,6,17,26,50,-24,27
Ards,1707,10,7,5,18,34,59,-25,26
Portadown,1707,11,6,7,17,21,47,-26,25
Linfield,1708,1,19,6,5,67,29,38,63
Crusaders,1708,2,15,8,7,52,33,19,53
Glenavon,1708,3,13,11,6,48,40,8,50
Coleraine,1708,4,13,10,7,51,39,12,49
Cliftonville,1708,5,12,7,11,48,39,9,43
Dungannon,1708,6,11,9,10,51,46,5,42
Ballymena,1708,7,11,7,12,57,64,-7,40
Ards,1708,8,11,4,15,36,43,-7,37
Glentoran,1708,9,8,7,15,30,49,-19,31
Portadown,1708,10,8,4,18,21,45,-24,28
Ballinamalla,1708,11,4,7,19,25,59,-34,19
Crusaders,1709,1,16,8,6,60,38,22,56
Linfield,1709,2,15,7,8,62,32,30,52
Cliftonville,1709,3,15,6,9,58,44,14,51
Glenavon,1709,4,13,12,5,48,40,8,51
Ballymena,1709,5,14,6,10,57,60,-3,48
Dungannon,1709,6,11,10,9,56,49,7,43
Coleraine,1709,7,8,13,9,40,42,-2,37
Ards,1709,8,10,6,14,43,49,-6,36
Portadown,1709,9,7,9,14,31,50,-19,30
Glentoran,1709,10,6,7,17,28,52,-24,25
Ballinamalla,1709,11,6,4,20,29,56,-27,22
Crusaders,1710,1,15,9,6,48,27,21,54
Cliftonville,1710,2,16,4,10,52,38,14,52
Ballymena,1710,3,15,6,9,56,52,4,51
Linfield,1710,4,13,9,8,55,33,22,48
Coleraine,1710,5,11,10,9,38,34,4,43
Glenavon,1710,6,10,13,7,49,46,3,43
Dungannon,1710,7,10,8,12,50,43,7,38
Ards,1710,8,9,6,15,35,49,-14,33
Ballinamalla,1710,9,9,6,15,38,54,-16,33
Glentoran,1710,10,9,6,15,30,51,-21,33
Portadown,1710,11,5,9,16,23,47,-24,24
Cliftonville,1711,1,16,6,8,56,40,16,54
Crusaders,1711,2,16,5,9,59,42,17,53
Linfield,1711,3,13,9,8,56,39,17,48
Ballymena,1711,4,14,6,10,63,60,3,48
Glenavon,1711,5,12,11,7,51,43,8,47
Coleraine,1711,6,11,12,7,48,44,4,45
Dungannon,1711,7,10,7,13,48,45,3,37
Portadown,1711,8,10,6,14,32,41,-9,36
Glentoran,1711,9,8,7,15,30,46,-16,31
Ards,1711,10,7,8,15,38,54,-16,29
Ballinamalla,1711,11,8,3,19,29,56,-27,27
Crusaders,1712,1,17,7,6,54,28,26,58
Cliftonville,1712,2,15,4,11,52,42,10,49
Glenavon,1712,3,13,9,8,48,47,1,48
Linfield,1712,4,12,10,8,52,31,21,46
Ballymena,1712,5,13,6,11,53,62,-9,45
Coleraine,1712,6,11,9,10,41,38,3,42
Glentoran,1712,7,10,9,11,31,37,-6,39
Dungannon,1712,8,9,9,12,45,41,4,36
Ards,1712,9,10,6,14,36,42,-6,36
Portadown,1712,10,9,6,15,24,40,-16,33
Ballinamalla,1712,11,8,1,21,26,54,-28,25
Crusaders,1713,1,17,9,4,55,29,26,60
Cliftonville,1713,2,18,4,8,56,32,24,58
Linfield,1713,3,16,8,6,61,34,27,56
Glenavon,1713,4,12,12,6,45,38,7,48
Glentoran,1713,5,10,9,11,34,38,-4,39
Ballymena,1713,6,10,9,11,43,56,-13,39
Coleraine,1713,7,9,9,12,35,41,-6,36
Portadown,1713,8,9,6,15,25,44,-19,33
Dungannon,1713,9,7,8,15,46,52,-6,29
Ballinamalla,1713,10,7,7,16,29,48,-19,28
Ards,1713,11,8,3,19,32,49,-17,27
Crusaders,1714,1,17,9,4,58,33,25,60
Linfield,1714,2,16,8,6,57,33,24,56
Cliftonville,1714,3,15,7,8,50,37,13,52
Coleraine,1714,4,12,9,9,41,37,4,45
Ballymena,1714,5,12,9,9,53,55,-2,45
Dungannon,1714,6,10,8,12,50,42,8,38
Glentoran,1714,7,8,11,11,28,35,-7,35
Glenavon,1714,8,9,8,13,44,53,-9,35
Ards,1714,9,9,6,15,32,46,-14,33
Ballinamalla,1714,10,8,6,16,32,50,-18,30
Portadown,1714,11,6,5,19,25,49,-24,23
Crusaders,1715,1,16,12,2,59,29,30,60
Linfield,1715,2,13,10,7,50,27,23,49
Cliftonville,1715,3,14,7,9,54,39,15,49
Glenavon,1715,4,11,13,6,46,41,5,46
Dungannon,1715,5,12,8,10,49,41,8,44
Coleraine,1715,6,10,12,8,44,40,4,42
Ballymena,1715,7,9,8,13,50,60,-10,35
Portadown,1715,8,9,7,14,29,42,-13,34
Ards,1715,9,9,5,16,36,52,-16,32
Ballinamalla,1715,10,7,8,15,30,52,-22,29
Glentoran,1715,11,6,8,16,19,43,-24,26
Crusaders,1716,1,19,5,6,67,31,36,62
Cliftonville,1716,2,17,5,8,52,32,20,56
Ballymena,1716,3,17,5,8,62,56,6,56
Linfield,1716,4,12,8,10,52,35,17,44
Coleraine,1716,5,11,10,9,46,38,8,43
Glenavon,1716,6,10,11,9,45,49,-4,41
Glentoran,1716,7,9,7,14,30,49,-19,34
Dungannon,1716,8,8,8,14,47,51,-4,32
Portadown,1716,9,8,8,14,28,43,-15,32
Ards,1716,10,8,7,15,38,55,-17,31
Ballinamalla,1716,11,6,6,18,25,53,-28,24
Crusaders,1717,1,17,6,7,56,30,26,57
Linfield,1717,2,16,7,7,64,38,26,55
Cliftonville,1717,3,15,7,8,57,38,19,52
Ballymena,1717,4,14,8,8,64,53,11,50
Coleraine,1717,5,11,13,6,36,31,5,46
Dungannon,1717,6,11,8,11,49,41,8,41
Glenavon,1717,7,9,11,10,41,48,-7,38
Ards,1717,8,11,4,15,42,50,-8,37
Portadown,1717,9,8,5,17,29,54,-25,29
Glentoran,1717,10,7,6,17,27,53,-26,27
Ballinamalla,1717,11,6,5,19,33,62,-29,23
Crusaders,1718,1,17,7,6,53,32,21,58
Linfield,1718,2,15,9,6,56,28,28,54
Cliftonville,1718,3,14,5,11,55,40,15,47
Coleraine,1718,4,12,9,9,46,37,9,45
Ballymena,1718,5,13,5,12,61,67,-6,44
Dungannon,1718,6,11,8,11,51,48,3,41
Glentoran,1718,7,11,7,12,38,41,-3,40
Glenavon,1718,8,10,9,11,44,46,-2,39
Portadown,1718,9,11,4,15,30,48,-18,37
Ards,1718,10,8,5,17,37,59,-22,29
Ballinamalla,1718,11,5,8,17,26,51,-25,23
Crusaders,1719,1,18,4,8,63,37,26,58
Cliftonville,1719,2,14,7,9,56,40,16,49
Linfield,1719,3,13,9,8,55,33,22,48
Ballymena,1719,4,13,9,8,65,62,3,48
Coleraine,1719,5,13,8,9,50,38,12,47
Dungannon,1719,6,10,11,9,57,49,8,41
Glenavon,1719,7,10,11,9,45,50,-5,41
Glentoran,1719,8,10,8,12,39,48,-9,38
Portadown,1719,9,11,5,14,31,46,-15,38
Ards,1719,10,6,7,17,30,54,-24,25
Ballinamalla,1719,11,6,3,21,22,56,-34,21
Crusaders,1720,1,18,7,5,58,29,29,61
Ballymena,1720,2,18,4,8,61,51,10,58
Coleraine,1720,3,14,9,7,50,37,13,51
Cliftonville,1720,4,15,5,10,52,37,15,50
Linfield,1720,5,12,10,8,50,29,21,46
Glenavon,1720,6,11,9,10,49,48,1,42
Dungannon,1720,7,7,11,12,45,49,-4,32
Ards,1720,8,7,9,14,34,49,-15,30
Portadown,1720,9,8,6,16,26,45,-19,30
Glentoran,1720,10,7,9,14,26,48,-22,30
Ballinamalla,1720,11,7,3,20,25,54,-29,24
Linfield,1721,1,17,7,6,66,29,37,58
Crusaders,1721,2,17,7,6,59,35,24,58
Cliftonville,1721,3,17,6,7,57,37,20,57
Glenavon,1721,4,12,8,10,44,47,-3,44
Ballymena,1721,5,12,6,12,55,62,-7,42
Dungannon,1721,6,10,10,10,53,45,8,40
Ballinamalla,1721,7,11,4,15,34,47,-13,37
Coleraine,1721,8,9,9,12,42,43,-1,36
Ards,1721,9,9,7,14,36,46,-10,34
Glentoran,1721,10,7,9,14,23,44,-21,30
Portadown,1721,11,5,5,20,23,57,-34,20
Crusaders,1722,1,16,8,6,64,33,31,56
Ballymena,1722,2,14,6,10,55,61,-6,48
Linfield,1722,3,12,10,8,49,30,19,46
Cliftonville,1722,4,13,5,12,49,51,-2,44
Glenavon,1722,5,11,9,10,49,44,5,42
Coleraine,1722,6,11,9,10,39,39,0,42
Dungannon,1722,7,9,10,11,47,45,2,37
Portadown,1722,8,10,6,14,32,47,-15,36
Ards,1722,9,10,5,15,38,47,-9,35
Glentoran,1722,10,9,8,13,39,49,-10,35
Ballinamalla,1722,11,9,6,15,34,49,-15,33
Crusaders,1723,1,17,10,3,59,31,28,61
Ballymena,1723,2,15,8,7,65,56,9,53
Linfield,1723,3,14,9,7,51,31,20,51
Cliftonville,1723,4,15,5,10,55,44,11,50
Glenavon,1723,5,13,9,8,46,38,8,48
Coleraine,1723,6,10,10,10,35,34,1,40
Dungannon,1723,7,9,9,12,48,45,3,36
Glentoran,1723,8,9,8,13,34,48,-14,35
Ballinamalla,1723,9,8,7,15,39,56,-17,31
Ards,1723,10,8,5,17,29,47,-18,29
Portadown,1723,11,4,6,20,19,50,-31,18
Crusaders,1724,1,19,6,5,64,29,35,63
Linfield,1724,2,17,8,5,65,27,38,59
Cliftonville,1724,3,19,2,9,56,38,18,59
Glenavon,1724,4,12,10,8,49,44,5,46
Coleraine,1724,5,11,10,9,42,43,-1,43
Ballymena,1724,6,11,7,12,47,57,-10,40
Dungannon,1724,7,7,12,11,42,43,-1,33
Ards,1724,8,8,6,16,36,51,-15,30
Portadown,1724,9,8,6,16,24,45,-21,30
Ballinamalla,1724,10,8,5,17,28,52,-24,29
Glentoran,1724,11,6,6,18,21,45,-24,24
Crusaders,1725,1,17,7,6,51,30,21,58
Linfield,1725,2,15,8,7,54,34,20,53
Coleraine,1725,3,12,9,9,43,38,5,45
Ballymena,1725,4,14,3,13,57,60,-3,45
Dungannon,1725,5,11,9,10,60,47,13,42
Cliftonville,1725,6,13,3,14,46,42,4,42
Glenavon,1725,7,10,10,10,48,50,-2,40
Portadown,1725,8,11,4,15,33,47,-14,37
Ards,1725,9,10,6,14,32,41,-9,36
Glentoran,1725,10,8,7,15,36,54,-18,31
Ballinamalla,1725,11,7,8,15,33,50,-17,29
Linfield,1726,1,14,11,5,64,35,29,53
Cliftonville,1726,2,15,5,10,57,41,16,50
Crusaders,1726,3,14,7,9,50,38,12,49
Coleraine,1726,4,13,9,8,42,38,4,48
Ballymena,1726,5,14,4,12,60,58,2,46
Glenavon,1726,6,12,9,9,43,44,-1,45
Dungannon,1726,7,11,9,10,56,46,10,42
Ards,1726,8,12,6,12,41,44,-3,42
Glentoran,1726,9,9,6,15,28,44,-16,33
Ballinamalla,1726,10,7,4,19,28,51,-23,25
Portadown,1726,11,7,4,19,25,55,-30,25
Crusaders,1727,1,16,7,7,55,33,22,55
Linfield,1727,2,15,9,6,59,37,22,54
Coleraine,1727,3,14,9,7,46,34,12,51
Ballymena,1727,4,15,6,9,66,57,9,51
Cliftonville,1727,5,13,4,13,43,42,1,43
Glenavon,1727,6,10,11,9,54,55,-1,41
Dungannon,1727,7,11,7,12,49,43,6,40
Glentoran,1727,8,9,5,16,29,50,-21,32
Ards,1727,9,8,7,15,36,50,-14,31
Portadown,1727,10,9,4,17,28,45,-17,31
Ballinamalla,1727,11,9,3,18,31,50,-19,30
Crusaders,1728,1,20,8,2,59,24,35,68
Linfield,1728,2,15,9,6,62,31,31,54
Cliftonville,1728,3,16,6,8,55,37,18,54
Ballymena,1728,4,14,8,8,62,59,3,50
Glenavon,1728,5,12,10,8,54,46,8,46
Coleraine,1728,6,11,11,8,45,36,9,44
Ards,1728,7,8,8,14,41,53,-12,32
Dungannon,1728,8,7,7,16,41,56,-15,28
Portadown,1728,9,7,6,17,28,53,-25,27
Glentoran,1728,10,5,10,15,25,48,-23,25
Ballinamalla,1728,11,7,3,20,26,55,-29,24
Crusaders,1729,1,17,5,8,63,44,19,56
Cliftonville,1729,2,16,6,8,55,37,18,54
Dungannon,1729,3,13,10,7,55,37,18,49
Linfield,1729,4,14,6,10,65,44,21,48
Ballymena,1729,5,14,5,11,60,62,-2,47
Glenavon,1729,6,11,9,10,51,51,0,42
Coleraine,1729,7,10,11,9,42,40,2,41
Glentoran,1729,8,9,6,15,33,48,-15,33
Ballinamalla,1729,9,10,3,17,28,47,-19,33
Ards,1729,10,7,8,15,37,50,-13,29
Portadown,1729,11,7,5,18,30,59,-29,26
Linfield,1730,1,17,7,6,69,33,36,58
Crusaders,1730,2,15,7,8,52,42,10,52
Cliftonville,1730,3,14,5,11,51,43,8,47
Coleraine,1730,4,12,10,8,45,47,-2,46
Ballymena,1730,5,13,5,12,62,59,3,44
Glenavon,1730,6,10,12,8,46,49,-3,42
Dungannon,1730,7,11,8,11,51,41,10,41
Glentoran,1730,8,10,7,13,33,45,-12,37
Ards,1730,9,10,4,16,40,49,-9,34
Ballinamalla,1730,10,8,5,17,29,46,-17,29
Portadown,1730,11,8,4,18,25,49,-24,28
Coleraine,1731,1,16,9,5,51,32,19,57
Cliftonville,1731,2,17,4,9,61,42,19,55
Ballymena,1731,3,15,4,11,59,61,-2,49
Crusaders,1731,4,13,7,10,51,52,-1,46
Linfield,1731,5,11,12,7,56,34,22,45
Glenavon,1731,6,10,11,9,44,45,-1,41
Glentoran,1731,7,11,8,11,34,42,-8,41
Dungannon,1731,8,8,10,12,53,48,5,34
Ballinamalla,1731,9,10,3,17,39,55,-16,33
Portadown,1731,10,8,5,17,27,50,-23,29
Ards,1731,11,6,7,17,36,50,-14,25
Linfield,1732,1,15,9,6,61,31,30,54
Crusaders,1732,2,15,8,7,51,33,18,53
Cliftonville,1732,3,12,10,8,50,38,12,46
Dungannon,1732,4,12,9,9,50,38,12,45
Ballymena,1732,5,13,6,11,54,61,-7,45
Coleraine,1732,6,10,13,7,45,36,9,43
Glentoran,1732,7,12,7,11,34,37,-3,43
Glenavon,1732,8,11,9,10,49,47,2,42
Portadown,1732,9,7,9,14,24,41,-17,30
Ards,1732,10,7,6,17,32,52,-20,27
Ballinamalla,1732,11,6,4,20,29,65,-36,22
Crusaders,1733,1,14,10,6,55,38,17,52
Ballymena,1733,2,14,8,8,59,59,0,50
Cliftonville,1733,3,14,6,10,47,35,12,48
Linfield,1733,4,12,10,8,54,35,19,46
Coleraine,1733,5,11,13,6,49,40,9,46
Dungannon,1733,6,11,9,10,55,49,6,42
Glenavon,1733,7,9,15,6,49,43,6,42
Glentoran,1733,8,9,9,12,36,49,-13,36
Ards,1733,9,9,7,14,39,50,-11,34
Portadown,1733,10,6,8,16,25,45,-20,26
Ballinamalla,1733,11,6,5,19,30,55,-25,23
Crusaders,1734,1,19,5,6,57,36,21,62
Cliftonville,1734,2,16,5,9,56,36,20,53
Glenavon,1734,3,13,10,7,52,42,10,49
Linfield,1734,4,12,11,7,56,37,19,47
Ballymena,1734,5,13,7,10,52,57,-5,46
Coleraine,1734,6,11,12,7,44,40,4,45
Ards,1734,7,13,3,14,51,53,-2,42
Glentoran,1734,8,7,8,15,32,49,-17,29
Dungannon,1734,9,6,10,14,44,54,-10,28
Portadown,1734,10,7,6,17,25,44,-19,27
Ballinamalla,1734,11,7,5,18,30,51,-21,26
Crusaders,1735,1,16,8,6,58,36,22,56
Linfield,1735,2,14,11,5,58,27,31,53
Ballymena,1735,3,16,5,9,61,60,1,53
Cliftonville,1735,4,15,7,8,58,38,20,52
Glenavon,1735,5,12,11,7,53,42,11,47
Coleraine,1735,6,10,13,7,40,36,4,43
Dungannon,1735,7,8,9,13,48,55,-7,33
Glentoran,1735,8,7,10,13,36,54,-18,31
Ards,1735,9,8,6,16,39,46,-7,30
Ballinamalla,1735,10,8,4,18,29,53,-24,28
Portadown,1735,11,6,6,18,25,58,-33,24
Crusaders,1736,1,16,9,5,55,30,25,57
Ballymena,1736,2,16,6,8,62,56,6,54
Linfield,1736,3,14,9,7,55,34,21,51
Coleraine,1736,4,12,10,8,44,37,7,46
Glenavon,1736,5,12,9,9,48,47,1,45
Cliftonville,1736,6,13,4,13,43,39,4,43
Dungannon,1736,7,9,11,10,46,40,6,38
Ards,1736,8,10,6,14,44,49,-5,36
Glentoran,1736,9,8,10,12,31,43,-12,34
Portadown,1736,10,6,6,18,20,45,-25,24
Ballinamalla,1736,11,6,6,18,31,59,-28,24
Linfield,1737,1,16,9,5,54,26,28,57
Cliftonville,1737,2,18,3,9,60,40,20,57
Ballymena,1737,3,15,5,10,57,51,6,50
Crusaders,1737,4,13,9,8,49,37,12,48
Glenavon,1737,5,13,8,9,47,41,6,47
Glentoran,1737,6,11,7,12,32,40,-8,40
Ards,1737,7,11,5,14,35,39,-4,38
Coleraine,1737,8,8,10,12,38,45,-7,34
Dungannon,1737,9,7,11,12,44,51,-7,32
Ballinamalla,1737,10,9,5,16,29,46,-17,32
Portadown,1737,11,5,6,19,19,48,-29,21
Crusaders,1738,1,17,7,6,56,29,27,58
Linfield,1738,2,15,9,6,61,37,24,54
Ballymena,1738,3,14,8,8,59,54,5,50
Cliftonville,1738,4,14,4,12,45,38,7,46
Glenavon,1738,5,11,11,8,46,41,5,44
Coleraine,1738,6,9,13,8,38,40,-2,40
Dungannon,1738,7,10,8,12,49,43,6,38
Ards,1738,8,8,8,14,33,44,-11,32
Ballinamalla,1738,9,9,5,16,30,49,-19,32
Portadown,1738,10,9,5,16,28,48,-20,32
Glentoran,1738,11,7,6,17,25,47,-22,27
Cliftonville,1739,1,19,3,8,58,30,28,60
Linfield,1739,2,16,6,8,57,31,26,54
Crusaders,1739,3,14,7,9,51,38,13,49
Glenavon,1739,4,12,11,7,49,43,6,47
Coleraine,1739,5,12,10,8,45,40,5,46
Ballymena,1739,6,13,6,11,56,58,-2,45
Dungannon,1739,7,9,10,11,48,44,4,37
Glentoran,1739,8,10,6,14,32,43,-11,36
Ballinamalla,1739,9,9,5,16,25,46,-21,32
Ards,1739,10,7,7,16,37,54,-17,28
Portadown,1739,11,5,7,18,20,51,-31,22
Crusaders,1740,1,21,8,1,66,23,43,71
Linfield,1740,2,16,9,5,65,34,31,57
Cliftonville,1740,3,13,8,9,56,43,13,47
Coleraine,1740,4,11,12,7,41,35,6,45
Ballymena,1740,5,12,7,11,59,63,-4,43
Glenavon,1740,6,10,12,8,43,46,-3,42
Dungannon,1740,7,8,11,11,48,43,5,35
Portadown,1740,8,9,4,17,31,51,-20,31
Ards,1740,9,7,8,15,36,53,-17,29
Glentoran,1740,10,7,8,15,32,51,-19,29
Ballinamalla,1740,11,6,3,21,29,64,-35,21
Linfield,1741,1,17,7,6,62,31,31,58
Ballymena,1741,2,17,6,7,70,59,11,57
Crusaders,1741,3,15,10,5,57,35,22,55
Cliftonville,1741,4,14,7,9,51,42,9,49
Glenavon,1741,5,11,11,8,51,43,8,44
Dungannon,1741,6,10,12,8,46,37,9,42
Ards,1741,7,11,4,15,37,45,-8,37
Coleraine,1741,8,9,9,12,42,54,-12,36
Ballinamalla,1741,9,9,3,18,35,54,-19,30
Glentoran,1741,10,8,5,17,30,49,-19,29
Portadown,1741,11,5,4,21,18,50,-32,19
Crusaders,1742,1,20,6,4,59,32,27,66
Linfield,1742,2,15,9,6,54,30,24,54
Ballymena,1742,3,14,6,10,55,55,0,48
Cliftonville,1742,4,13,7,10,51,43,8,46
Glenavon,1742,5,12,9,9,47,45,2,45
Coleraine,1742,6,11,10,9,44,41,3,43
Dungannon,1742,7,9,12,9,49,42,7,39
Glentoran,1742,8,8,7,15,30,43,-13,31
Portadown,1742,9,9,4,17,28,48,-20,31
Ballinamalla,1742,10,8,4,18,29,47,-18,28
Ards,1742,11,7,4,19,26,46,-20,25
Cliftonville,1743,1,17,4,9,56,42,14,55
Ballymena,1743,2,16,4,10,68,63,5,52
Linfield,1743,3,13,11,6,57,30,27,50
Crusaders,1743,4,14,7,9,50,41,9,49
Coleraine,1743,5,12,9,9,52,41,11,45
Glenavon,1743,6,11,12,7,50,44,6,45
Ards,1743,7,11,5,14,37,46,-9,38
Glentoran,1743,7,10,8,12,37,46,-9,38
Dungannon,1743,9,9,7,14,47,53,-6,34
Ballinamalla,1743,10,9,5,16,31,48,-17,32
Portadown,1743,11,4,6,20,18,49,-31,18
Linfield,1744,1,17,8,5,63,27,36,59
Crusaders,1744,2,16,10,4,50,33,17,58
Cliftonville,1744,3,15,4,11,56,39,17,49
Coleraine,1744,4,11,11,8,47,46,1,44
Glenavon,1744,5,10,11,9,46,40,6,41
Ballymena,1744,6,10,9,11,48,60,-12,39
Dungannon,1744,7,9,9,12,48,49,-1,36
Ards,1744,8,9,8,13,46,51,-5,35
Glentoran,1744,9,9,7,14,29,44,-15,34
Ballinamalla,1744,10,9,2,19,32,53,-21,29
Portadown,1744,11,8,5,17,26,49,-23,29
Cliftonville,1745,1,16,5,9,47,35,12,53
Crusaders,1745,2,13,11,6,55,32,23,50
Linfield,1745,3,13,9,8,54,32,22,48
Coleraine,1745,4,12,11,7,52,36,16,47
Ards,1745,5,14,5,11,41,39,2,47
Glenavon,1745,6,12,10,8,49,47,2,46
Ballymena,1745,7,12,6,12,52,54,-2,42
Dungannon,1745,8,11,7,12,46,43,3,40
Ballinamalla,1745,9,8,4,18,24,55,-31,28
Glentoran,1745,10,6,9,15,25,48,-23,27
Portadown,1745,11,7,5,18,26,50,-24,26
Cliftonville,1746,1,16,5,9,61,38,23,53
Crusaders,1746,2,15,7,8,54,42,12,52
Ballymena,1746,3,14,7,9,57,59,-2,49
Linfield,1746,4,12,11,7,63,39,24,47
Coleraine,1746,5,11,12,7,45,35,10,45
Dungannon,1746,6,12,9,9,48,41,7,45
Glenavon,1746,7,9,10,11,41,46,-5,37
Glentoran,1746,8,9,6,15,26,40,-14,33
Ballinamalla,1746,9,9,6,15,29,46,-17,33
Ards,1746,10,8,8,14,35,47,-12,32
Portadown,1746,11,7,5,18,28,54,-26,26
Crusaders,1747,1,18,4,8,49,33,16,58
Linfield,1747,2,14,12,4,62,31,31,54
Cliftonville,1747,3,16,5,9,50,35,15,53
Ballymena,1747,4,16,4,10,57,54,3,52
Glenavon,1747,5,12,10,8,49,44,5,46
Dungannon,1747,6,11,9,10,54,42,12,42
Coleraine,1747,7,9,12,9,38,42,-4,39
Glentoran,1747,8,11,6,13,34,43,-9,39
Ards,1747,9,7,6,17,38,51,-13,27
Portadown,1747,10,8,3,19,20,45,-25,27
Ballinamalla,1747,11,5,5,20,26,57,-31,20
Crusaders,1748,1,17,7,6,60,34,26,58
Cliftonville,1748,2,16,6,8,50,35,15,54
Ballymena,1748,3,16,4,10,58,54,4,52
Linfield,1748,4,12,11,7,52,31,21,47
Dungannon,1748,5,12,9,9,47,36,11,45
Coleraine,1748,6,12,9,9,40,34,6,45
Glenavon,1748,7,8,12,10,38,48,-10,36
Glentoran,1748,8,8,9,13,28,39,-11,33
Ards,1748,9,9,5,16,34,52,-18,32
Ballinamalla,1748,10,7,6,17,29,49,-20,27
Portadown,1748,11,6,6,18,24,48,-24,24
Linfield,1749,1,17,10,3,64,21,43,61
Ballymena,1749,2,17,6,7,58,52,6,57
Crusaders,1749,3,14,7,9,47,35,12,49
Cliftonville,1749,4,14,5,11,51,41,10,47
Dungannon,1749,5,11,12,7,51,38,13,45
Coleraine,1749,6,11,10,9,41,36,5,43
Glenavon,1749,7,11,9,10,45,43,2,42
Ards,1749,8,9,5,16,38,54,-16,32
Glentoran,1749,9,8,7,15,27,49,-22,31
Ballinamalla,1749,10,7,8,15,30,49,-19,29
Portadown,1749,11,4,5,21,23,57,-34,17
Crusaders,1750,1,19,7,4,63,25,38,64
Linfield,1750,2,16,8,6,65,30,35,56
Glenavon,1750,3,15,8,7,55,51,4,53
Coleraine,1750,4,14,8,8,48,36,12,50
Ballymena,1750,5,12,9,9,52,61,-9,45
Cliftonville,1750,6,12,5,13,47,46,1,41
Dungannon,1750,7,10,7,13,47,47,0,37
Glentoran,1750,8,10,6,14,31,46,-15,36
Ards,1750,9,8,4,18,41,58,-17,28
Portadown,1750,10,8,3,19,30,48,-18,27
Ballinamalla,1750,11,6,5,19,23,54,-31,23
Cliftonville,1751,1,16,6,8,58,46,12,54
Linfield,1751,2,13,10,7,59,29,30,49
Crusaders,1751,3,14,7,9,52,41,11,49
Ballymena,1751,4,14,7,9,62,57,5,49
Glenavon,1751,5,12,11,7,52,43,9,47
Coleraine,1751,6,11,10,9,47,41,6,43
Dungannon,1751,7,10,7,13,52,51,1,37
Glentoran,1751,8,10,6,14,27,44,-17,36
Ards,1751,9,10,5,15,37,47,-10,35
Ballinamalla,1751,10,9,4,17,31,54,-23,31
Portadown,1751,11,6,7,17,23,47,-24,25
Crusaders,1752,1,16,7,7,68,37,31,55
Ballymena,1752,2,16,6,8,62,53,9,54
Linfield,1752,3,15,8,7,59,34,25,53
Cliftonville,1752,4,13,8,9,48,37,11,47
Glenavon,1752,5,13,8,9,48,43,5,47
Dungannon,1752,6,12,10,8,52,40,12,46
Coleraine,1752,7,10,13,7,37,34,3,43
Ards,1752,8,9,5,16,30,42,-12,32
Portadown,1752,9,6,8,16,19,43,-24,26
Glentoran,1752,10,7,5,18,25,58,-33,26
Ballinamalla,1752,11,6,6,18,23,50,-27,24
Linfield,1753,1,18,10,2,69,28,41,64
Glenavon,1753,2,13,10,7,51,51,0,49
Cliftonville,1753,3,14,6,10,51,34,17,48
Ballymena,1753,4,13,7,10,52,59,-7,46
Crusaders,1753,5,12,8,10,53,41,12,44
Coleraine,1753,6,11,10,9,45,43,2,43
Dungannon,1753,7,10,12,8,48,39,9,42
Ards,1753,8,9,6,15,41,51,-10,33
Glentoran,1753,9,7,7,16,28,45,-17,28
Portadown,1753,10,8,4,18,26,48,-22,28
Ballinamalla,1753,11,6,8,16,29,54,-25,26
Crusaders,1754,1,17,7,6,50,27,23,58
Linfield,1754,2,15,10,5,66,34,32,55
Cliftonville,1754,3,14,6,10,51,43,8,48
Ballymena,1754,4,14,5,11,66,60,6,47
Glenavon,1754,5,12,9,9,42,40,2,45
Dungannon,1754,6,12,7,11,53,44,9,43
Coleraine,1754,7,9,11,10,39,44,-5,38
Glentoran,1754,8,10,6,14,34,47,-13,36
Ards,1754,9,9,6,15,45,56,-11,33
Portadown,1754,10,8,9,13,29,44,-15,33
Ballinamalla,1754,11,6,2,22,24,60,-36,20
Crusaders,1755,1,16,9,5,52,33,19,57
Linfield,1755,2,14,9,7,58,36,22,51
Glenavon,1755,3,14,9,7,51,39,12,51
Cliftonville,1755,4,14,5,11,50,41,9,47
Ballymena,1755,5,13,8,9,61,57,4,47
Coleraine,1755,6,9,13,8,41,41,0,40
Dungannon,1755,7,9,10,11,49,43,6,37
Portadown,1755,8,10,5,15,30,45,-15,35
Ards,1755,9,9,7,14,44,57,-13,34
Glentoran,1755,10,7,8,15,26,46,-20,29
Ballinamalla,1755,11,6,5,19,25,49,-24,23
Cliftonville,1756,1,17,6,7,48,32,16,57
Crusaders,1756,2,13,10,7,44,28,16,49
Glenavon,1756,3,12,13,5,48,35,13,49
Linfield,1756,4,13,8,9,60,38,22,47
Ballymena,1756,5,13,7,10,53,53,0,46
Dungannon,1756,6,12,8,10,49,42,7,44
Coleraine,1756,7,11,10,9,43,37,6,43
Glentoran,1756,8,9,7,14,33,50,-17,34
Ards,1756,9,9,5,16,35,48,-13,32
Ballinamalla,1756,10,8,4,18,25,47,-22,28
Portadown,1756,11,6,6,18,33,61,-28,24
Crusaders,1757,1,18,7,5,56,33,23,61
Ballymena,1757,2,15,5,10,64,60,4,50
Linfield,1757,3,12,13,5,54,30,24,49
Cliftonville,1757,4,12,8,10,51,41,10,44
Coleraine,1757,5,11,11,8,37,34,3,44
Glentoran,1757,6,12,7,11,36,41,-5,43
Ards,1757,7,10,5,15,32,41,-9,35
Glenavon,1757,8,8,10,12,43,55,-12,34
Dungannon,1757,9,7,11,12,47,51,-4,32
Portadown,1757,10,9,5,16,28,40,-12,32
Ballinamalla,1757,11,8,4,18,32,54,-22,28
Cliftonville,1758,1,17,5,8,56,39,17,56
Glenavon,1758,2,14,10,6,53,39,14,52
Crusaders,1758,3,15,6,9,57,40,17,51
Linfield,1758,4,14,8,8,53,33,20,50
Dungannon,1758,5,11,9,10,50,46,4,42
Ballymena,1758,6,11,9,10,57,60,-3,42
Coleraine,1758,7,10,10,10,35,36,-1,40
Glentoran,1758,8,9,8,13,36,46,-10,35
Ards,1758,9,9,6,15,38,50,-12,33
Portadown,1758,10,9,6,15,30,45,-15,33
Ballinamalla,1758,11,6,3,21,30,61,-31,21
Crusaders,1759,1,15,10,5,59,40,19,55
Linfield,1759,2,15,9,6,56,27,29,54
Cliftonville,1759,3,15,5,10,50,35,15,50
Coleraine,1759,4,12,10,8,42,38,4,46
Ballymena,1759,5,12,10,8,57,55,2,46
Glenavon,1759,6,11,10,9,51,49,2,43
Ards,1759,7,13,3,14,42,48,-6,42
Dungannon,1759,8,10,11,9,52,47,5,41
Glentoran,1759,9,8,6,16,30,50,-20,30
Ballinamalla,1759,10,6,7,17,26,49,-23,25
Portadown,1759,11,5,5,20,21,48,-27,20
Crusaders,1760,1,17,8,5,56,33,23,59
Linfield,1760,2,15,9,6,60,36,24,54
Cliftonville,1760,3,14,7,9,52,38,14,49
Coleraine,1760,4,13,10,7,48,36,12,49
Ballymena,1760,5,13,7,10,54,58,-4,46
Dungannon,1760,6,11,9,10,45,38,7,42
Glenavon,1760,7,9,11,10,46,57,-11,38
Glentoran,1760,8,7,10,13,35,46,-11,31
Ards,1760,9,8,6,16,33,49,-16,30
Ballinamalla,1760,10,6,8,16,34,54,-20,26
Portadown,1760,11,6,7,17,28,46,-18,25
Linfield,1761,1,17,9,4,61,30,31,60
Crusaders,1761,2,16,6,8,56,44,12,54
Ballymena,1761,3,15,6,9,54,53,1,51
Cliftonville,1761,4,14,5,11,50,44,6,47
Coleraine,1761,5,12,9,9,48,36,12,45
Glenavon,1761,6,11,11,8,53,50,3,44
Dungannon,1761,7,11,9,10,51,44,7,42
Glentoran,1761,8,8,10,12,39,47,-8,34
Portadown,1761,9,7,7,16,30,46,-16,28
Ards,1761,10,8,4,18,35,53,-18,28
Ballinamalla,1761,11,5,6,19,29,59,-30,21
Linfield,1762,1,16,9,5,62,28,34,57
Ballymena,1762,2,18,3,9,60,56,4,57
Cliftonville,1762,3,16,7,7,58,37,21,55
Crusaders,1762,4,14,8,8,48,38,10,50
Glenavon,1762,5,12,10,8,59,48,11,46
Coleraine,1762,6,11,9,10,46,52,-6,42
Dungannon,1762,7,11,8,11,56,46,10,41
Glentoran,1762,8,9,6,15,35,50,-15,33
Ards,1762,9,9,5,16,39,52,-13,32
Portadown,1762,10,5,7,18,24,50,-26,22
Ballinamalla,1762,11,5,6,19,29,59,-30,21
Crusaders,1763,1,20,4,6,67,28,39,64
Linfield,1763,2,17,8,5,60,26,34,59
Cliftonville,1763,3,15,5,10,50,35,15,50
Coleraine,1763,4,12,9,9,35,37,-2,45
Glenavon,1763,5,9,12,9,41,41,0,39
Ballymena,1763,6,11,6,13,44,59,-15,39
Dungannon,1763,7,9,9,12,41,44,-3,36
Ards,1763,8,10,6,14,35,43,-8,36
Glentoran,1763,9,9,8,13,29,46,-17,35
Portadown,1763,10,8,7,15,31,42,-11,31
Ballinamalla,1763,11,6,4,20,23,55,-32,22
Linfield,1764,1,16,10,4,62,30,32,58
Crusaders,1764,2,15,8,7,54,36,18,53
Coleraine,1764,3,14,11,5,47,29,18,53
Cliftonville,1764,4,14,9,7,51,38,13,51
Ballymena,1764,5,13,7,10,67,62,5,46
Glenavon,1764,6,10,9,11,45,49,-4,39
Dungannon,1764,7,9,9,12,54,50,4,36
Ballinamalla,1764,8,10,3,17,30,49,-19,33
Glentoran,1764,9,7,9,14,27,47,-20,30
Ards,1764,10,8,5,17,33,50,-17,29
Portadown,1764,11,5,8,17,24,54,-30,23
Crusaders,1765,1,18,7,5,58,30,28,61
Cliftonville,1765,2,17,3,10,55,40,15,54
Coleraine,1765,3,14,9,7,47,34,13,51
Linfield,1765,4,14,8,8,57,32,25,50
Glenavon,1765,5,13,9,8,48,46,2,48
Ballymena,1765,6,12,7,11,61,64,-3,43
Dungannon,1765,7,9,11,10,52,51,1,38
Glentoran,1765,8,9,8,13,31,45,-14,35
Ballinamalla,1765,9,7,6,17,25,47,-22,27
Ards,1765,10,7,4,19,30,53,-23,25
Portadown,1765,11,6,6,18,25,47,-22,24
Linfield,1766,1,14,12,4,57,27,30,54
Cliftonville,1766,2,15,7,8,50,40,10,52
Ballymena,1766,3,14,9,7,62,58,4,51
Crusaders,1766,4,12,13,5,51,34,17,49
Coleraine,1766,5,12,10,8,46,31,15,46
Glenavon,1766,6,8,12,10,35,36,-1,36
Dungannon,1766,7,8,10,12,47,47,0,34
Glentoran,1766,8,8,10,12,31,45,-14,34
Ballinamalla,1766,9,9,6,15,25,46,-21,33
Ards,1766,10,6,9,15,31,51,-20,27
Portadown,1766,11,5,10,15,25,45,-20,25
Linfield,1767,1,17,7,6,59,24,35,58
Crusaders,1767,2,16,9,5,53,32,21,57
Cliftonville,1767,3,14,8,8,50,32,18,50
Ballymena,1767,4,13,8,9,52,54,-2,47
Coleraine,1767,5,10,13,7,46,34,12,43
Dungannon,1767,6,9,11,10,47,47,0,38
Glenavon,1767,7,9,10,11,45,51,-6,37
Glentoran,1767,8,9,6,15,31,47,-16,33
Ballinamalla,1767,9,8,7,15,30,48,-18,31
Portadown,1767,10,8,6,16,26,47,-21,30
Ards,1767,11,6,7,17,31,54,-23,25
Crusaders,1768,1,18,10,2,60,25,35,64
Linfield,1768,2,14,9,7,55,36,19,51
Dungannon,1768,3,13,9,8,53,38,15,48
Cliftonville,1768,4,14,4,12,53,42,11,46
Coleraine,1768,5,11,11,8,40,39,1,44
Ballymena,1768,6,13,4,13,64,64,0,43
Glenavon,1768,7,11,10,9,41,45,-4,43
Glentoran,1768,8,11,7,12,31,38,-7,40
Ards,1768,9,9,3,18,33,48,-15,30
Ballinamalla,1768,10,7,3,20,32,57,-25,24
Portadown,1768,11,6,6,18,23,53,-30,24
Cliftonville,1769,1,16,4,10,50,34,16,52
Coleraine,1769,2,14,10,6,51,39,12,52
Crusaders,1769,3,14,8,8,51,36,15,50
Dungannon,1769,4,13,7,10,55,45,10,46
Ballymena,1769,5,13,7,10,52,56,-4,46
Linfield,1769,6,12,9,9,55,36,19,45
Portadown,1769,7,11,5,14,36,42,-6,38
Ards,1769,8,11,4,15,47,53,-6,37
Glenavon,1769,9,7,11,12,41,56,-15,32
Glentoran,1769,10,7,10,13,29,42,-13,31
Ballinamalla,1769,11,7,5,18,26,54,-28,26
Crusaders,1770,1,16,9,5,62,40,22,57
Cliftonville,1770,2,16,7,7,54,38,16,55
Ballymena,1770,3,15,8,7,69,59,10,53
Linfield,1770,4,14,10,6,58,28,30,52
Coleraine,1770,5,11,9,10,39,40,-1,42
Glenavon,1770,6,11,9,10,46,52,-6,42
Dungannon,1770,7,8,10,12,45,46,-1,34
Glentoran,1770,8,7,9,14,27,42,-15,30
Portadown,1770,9,8,6,16,31,49,-18,30
Ballinamalla,1770,10,8,5,17,35,55,-20,29
Ards,1770,11,8,4,18,34,51,-17,28
Cliftonville,1771,1,16,5,9,52,40,12,53
Glenavon,1771,2,13,10,7,51,37,14,49
Linfield,1771,3,13,9,8,56,38,18,48
Crusaders,1771,4,13,7,10,47,41,6,46
Coleraine,1771,5,12,9,9,39,33,6,45
Ballymena,1771,6,13,6,11,54,61,-7,45
Dungannon,1771,7,11,8,11,57,44,13,41
Ards,1771,8,11,6,13,40,42,-2,39
Glentoran,1771,9,7,10,13,28,47,-19,31
Portadown,1771,10,8,6,16,25,44,-19,30
Ballinamalla,1771,11,8,4,18,28,50,-22,28
Crusaders,1772,1,17,7,6,58,35,23,58
Cliftonville,1772,2,16,5,9,53,34,19,53
Linfield,1772,3,13,9,8,66,37,29,48
Ballymena,1772,4,14,6,10,54,61,-7,48
Coleraine,1772,5,10,13,7,40,34,6,43
Dungannon,1772,6,10,12,8,57,46,11,42
Glenavon,1772,7,10,11,9,46,46,0,41
Glentoran,1772,8,12,5,13,37,47,-10,41
Ballinamalla,1772,9,9,5,16,31,51,-20,32
Ards,1772,10,8,4,18,36,56,-20,28
Portadown,1772,11,6,3,21,25,56,-31,21
Crusaders,1773,1,17,7,6,64,44,20,58
Cliftonville,1773,2,15,7,8,61,40,21,52
Linfield,1773,3,13,8,9,56,32,24,47
Ballymena,1773,4,14,5,11,51,58,-7,47
Coleraine,1773,5,10,13,7,44,34,10,43
Glenavon,1773,6,9,11,10,51,55,-4,38
Dungannon,1773,7,9,10,11,49,43,6,37
Glentoran,1773,8,9,9,12,35,46,-11,36
Ballinamalla,1773,9,9,7,14,26,47,-21,34
Portadown,1773,10,9,4,17,25,47,-22,31
Ards,1773,11,9,3,18,36,52,-16,30
Linfield,1774,1,17,8,5,65,30,35,59
Cliftonville,1774,2,17,4,9,57,41,16,55
Crusaders,1774,3,15,8,7,54,38,16,53
Glenavon,1774,4,11,11,8,48,45,3,44
Coleraine,1774,5,10,10,10,45,46,-1,40
Ballymena,1774,6,11,7,12,48,57,-9,40
Dungannon,1774,7,10,9,11,47,43,4,39
Glentoran,1774,8,11,6,13,37,41,-4,39
Portadown,1774,9,10,5,15,33,48,-15,35
Ballinamalla,1774,10,7,5,18,29,51,-22,26
Ards,1774,11,7,5,18,34,57,-23,26
Crusaders,1775,1,18,8,4,65,30,35,62
Linfield,1775,2,16,8,6,60,32,28,56
Cliftonville,1775,3,16,5,9,58,42,16,53
Glenavon,1775,4,12,9,9,48,45,3,45
Ballymena,1775,5,13,5,12,47,62,-15,44
Coleraine,1775,6,10,11,9,38,37,1,41
Dungannon,1775,7,9,10,11,47,49,-2,37
Ards,1775,8,9,8,13,38,44,-6,35
Glentoran,1775,9,8,9,13,29,41,-12,33
Ballinamalla,1775,10,7,6,17,29,49,-20,27
Portadown,1775,11,6,3,21,24,52,-28,21
Crusaders,1776,1,16,8,6,59,32,27,56
Cliftonville,1776,2,17,4,9,59,44,15,55
Linfield,1776,3,14,11,5,61,37,24,53
Glenavon,1776,4,12,12,6,53,46,7,48
Ballymena,1776,5,12,9,9,57,60,-3,45
Dungannon,1776,6,11,10,9,57,44,13,43
Coleraine,1776,7,9,10,11,40,45,-5,37
Glentoran,1776,8,9,8,13,35,52,-17,35
Portadown,1776,9,8,5,17,27,46,-19,29
Ards,1776,10,7,5,18,38,55,-17,26
Ballinamalla,1776,11,7,4,19,34,59,-25,25
Crusaders,1777,1,17,7,6,48,25,23,58
Glenavon,1777,2,14,11,5,49,37,12,53
Linfield,1777,3,13,8,9,56,33,23,47
Dungannon,1777,4,11,10,9,56,44,12,43
Cliftonville,1777,5,12,7,11,50,42,8,43
Ballymena,1777,6,12,7,11,53,60,-7,43
Coleraine,1777,7,8,13,9,37,42,-5,37
Ards,1777,8,9,7,14,38,47,-9,34
Ballinamalla,1777,9,10,4,16,32,47,-15,34
Glentoran,1777,10,7,8,15,30,45,-15,29
Portadown,1777,11,7,8,15,26,53,-27,29
Crusaders,1778,1,20,7,3,62,28,34,67
Cliftonville,1778,2,15,6,9,57,43,14,51
Coleraine,1778,3,13,10,7,53,42,11,49
Linfield,1778,4,12,8,10,56,47,9,44
Ballymena,1778,5,12,8,10,49,58,-9,44
Glenavon,1778,6,10,12,8,54,44,10,42
Ards,1778,7,12,6,12,50,48,2,42
Dungannon,1778,8,7,10,13,48,54,-6,31
Portadown,1778,9,7,8,15,23,39,-16,29
Glentoran,1778,10,7,7,16,34,51,-17,28
Ballinamalla,1778,11,8,2,20,28,60,-32,26
Linfield,1779,1,18,8,4,67,27,40,62
Crusaders,1779,2,16,5,9,51,33,18,53
Cliftonville,1779,3,14,5,11,53,40,13,47
Coleraine,1779,4,12,10,8,44,36,8,46
Glenavon,1779,5,11,13,6,48,41,7,46
Ballymena,1779,6,13,5,12,56,65,-9,44
Dungannon,1779,7,10,10,10,50,40,10,40
Glentoran,1779,8,8,10,12,29,44,-15,34
Ards,1779,9,9,4,17,38,52,-14,31
Portadown,1779,10,9,3,18,24,48,-24,30
Ballinamalla,1779,11,5,7,18,17,51,-34,22
Crusaders,1780,1,21,6,3,62,26,36,69
Ballymena,1780,2,17,5,8,64,48,16,56
Linfield,1780,3,12,11,7,57,34,23,47
Coleraine,1780,4,12,10,8,41,32,9,46
Cliftonville,1780,5,13,5,12,50,47,3,44
Glenavon,1780,6,9,13,8,41,44,-3,40
Dungannon,1780,7,9,11,10,44,46,-2,38
Ballinamalla,1780,8,10,4,16,35,47,-12,34
Glentoran,1780,9,9,6,15,33,57,-24,33
Portadown,1780,10,8,4,18,26,50,-24,28
Ards,1780,11,6,3,21,32,54,-22,21
Crusaders,1781,1,19,8,3,57,23,34,65
Linfield,1781,2,17,10,3,56,23,33,61
Glenavon,1781,3,12,12,6,50,44,6,48
Coleraine,1781,4,12,10,8,43,38,5,46
Ballymena,1781,5,13,7,10,52,56,-4,46
Cliftonville,1781,6,13,3,14,50,42,8,42
Dungannon,1781,7,11,6,13,53,45,8,39
Ards,1781,8,9,5,16,35,51,-16,32
Glentoran,1781,9,8,7,15,27,47,-20,31
Portadown,1781,10,7,4,19,27,51,-24,25
Ballinamalla,1781,11,7,2,21,25,55,-30,23
Crusaders,1782,1,16,7,7,60,36,24,55
Cliftonville,1782,2,16,5,9,53,43,10,53
Coleraine,1782,3,12,11,7,47,38,9,47
Glenavon,1782,4,12,10,8,50,39,11,46
Ballymena,1782,5,13,5,12,70,70,0,44
Linfield,1782,6,11,8,11,50,40,10,41
Glentoran,1782,7,11,7,12,34,44,-10,40
Ards,1782,8,10,7,13,37,42,-5,37
Dungannon,1782,9,9,8,13,49,47,2,35
Ballinamalla,1782,10,9,4,17,35,53,-18,31
Portadown,1782,11,8,4,18,20,53,-33,28
Linfield,1783,1,15,11,4,54,25,29,56
Crusaders,1783,2,16,8,6,54,37,17,56
Ballymena,1783,3,15,8,7,59,52,7,53
Cliftonville,1783,4,15,6,9,55,39,16,51
Coleraine,1783,5,13,11,6,48,35,13,50
Glenavon,1783,6,9,11,10,43,45,-2,38
Dungannon,1783,7,8,11,11,44,39,5,35
Glentoran,1783,8,9,7,14,27,42,-15,34
Ards,1783,9,8,4,18,39,56,-17,28
Portadown,1783,10,8,4,18,24,49,-25,28
Ballinamalla,1783,11,6,5,19,25,53,-28,23
Cliftonville,1784,1,20,3,7,61,37,24,63
Crusaders,1784,2,17,6,7,57,32,25,57
Linfield,1784,3,14,11,5,57,32,25,53
Coleraine,1784,4,13,9,8,49,38,11,48
Ballymena,1784,5,13,7,10,54,58,-4,46
Glenavon,1784,6,11,9,10,49,47,2,42
Glentoran,1784,7,8,11,11,27,41,-14,35
Dungannon,1784,8,7,8,15,43,49,-6,29
Ards,1784,9,7,8,15,32,48,-16,29
Ballinamalla,1784,10,8,4,18,28,50,-22,28
Portadown,1784,11,6,6,18,22,47,-25,24
Crusaders,1785,1,19,6,5,62,35,27,63
Cliftonville,1785,2,16,5,9,57,36,21,53
Linfield,1785,3,15,6,9,53,35,18,51
Ballymena,1785,4,16,3,11,58,56,2,51
Glenavon,1785,5,13,10,7,46,39,7,49
Dungannon,1785,6,11,7,12,52,50,2,40
Coleraine,1785,7,11,7,12,38,43,-5,40
Portadown,1785,8,10,4,16,27,43,-16,34
Glentoran,1785,9,9,6,15,25,46,-21,33
Ards,1785,10,10,2,18,40,46,-6,32
Ballinamalla,1785,11,5,4,21,22,51,-29,19
Linfield,1786,1,17,7,6,68,28,40,58
Crusaders,1786,2,16,7,7,56,39,17,55
Ballymena,1786,3,14,7,9,57,53,4,49
Coleraine,1786,4,12,10,8,39,34,5,46
Cliftonville,1786,5,13,6,11,55,45,10,45
Glenavon,1786,6,11,11,8,54,51,3,44
Dungannon,1786,7,10,9,11,49,43,6,39
Ards,1786,8,9,7,14,42,53,-11,34
Glentoran,1786,9,8,9,13,30,43,-13,33
Ballinamalla,1786,10,8,4,18,29,56,-27,28
Portadown,1786,11,6,5,19,26,60,-34,23
Crusaders,1787,1,14,11,5,52,33,19,53
Linfield,1787,2,14,10,6,62,31,31,52
Glenavon,1787,3,12,12,6,55,42,13,48
Ballymena,1787,4,13,7,10,48,52,-4,46
Coleraine,1787,5,11,12,7,43,37,6,45
Glentoran,1787,6,11,9,10,29,39,-10,42
Cliftonville,1787,7,12,5,13,48,45,3,41
Dungannon,1787,8,7,10,13,46,55,-9,31
Ballinamalla,1787,9,9,4,17,33,51,-18,31
Portadown,1787,10,6,11,13,31,43,-12,29
Ards,1787,11,7,7,16,32,51,-19,28
Linfield,1788,1,19,8,3,72,31,41,65
Crusaders,1788,2,15,11,4,55,30,25,56
Cliftonville,1788,3,15,7,8,50,38,12,52
Ballymena,1788,4,14,6,10,64,59,5,48
Coleraine,1788,5,12,10,8,44,40,4,46
Glenavon,1788,6,10,12,8,43,41,2,42
Ballinamalla,1788,7,8,5,17,30,51,-21,29
Dungannon,1788,8,5,13,12,46,51,-5,28
Portadown,1788,9,7,7,16,31,50,-19,28
Ards,1788,10,8,4,18,34,55,-21,28
Glentoran,1788,11,7,7,16,28,51,-23,28
Linfield,1789,1,17,10,3,57,23,34,61
Crusaders,1789,2,15,9,6,55,36,19,54
Ballymena,1789,3,14,6,10,62,55,7,48
Cliftonville,1789,4,13,8,9,46,36,10,47
Coleraine,1789,5,12,11,7,45,36,9,47
Dungannon,1789,6,11,9,10,48,43,5,42
Glenavon,1789,7,9,14,7,42,44,-2,41
Glentoran,1789,8,9,9,12,27,40,-13,36
Ards,1789,9,8,7,15,36,48,-12,31
Portadown,1789,10,6,4,20,24,51,-27,22
Ballinamalla,1789,11,5,5,20,26,56,-30,20
Cliftonville,1790,1,17,3,10,59,44,15,54
Crusaders,1790,2,15,8,7,50,33,17,53
Linfield,1790,3,14,9,7,58,31,27,51
Glenavon,1790,4,13,8,9,51,50,1,47
Ballymena,1790,5,12,8,10,54,55,-1,44
Coleraine,1790,6,11,9,10,45,43,2,42
Dungannon,1790,7,10,7,13,48,48,0,37
Ballinamalla,1790,8,11,3,16,33,48,-15,36
Glentoran,1790,9,9,7,14,31,46,-15,34
Portadown,1790,10,9,5,16,33,48,-15,32
Ards,1790,11,8,5,17,31,47,-16,29
Crusaders,1791,1,20,5,5,58,33,25,65
Linfield,1791,2,18,7,5,63,25,38,61
Ballymena,1791,3,14,6,10,60,60,0,48
Cliftonville,1791,4,13,6,11,53,47,6,45
Coleraine,1791,5,12,9,9,45,40,5,45
Glenavon,1791,6,10,12,8,42,41,1,42
Dungannon,1791,7,10,9,11,54,47,7,39
Ards,1791,8,10,4,16,39,54,-15,34
Glentoran,1791,9,8,9,13,34,49,-15,33
Ballinamalla,1791,10,6,5,19,33,60,-27,23
Portadown,1791,11,6,4,20,21,46,-25,22
Crusaders,1792,1,16,7,7,53,36,17,55
Cliftonville,1792,2,16,4,10,57,43,14,52
Linfield,1792,3,13,9,8,60,36,24,48
Ballymena,1792,4,14,6,10,58,56,2,48
Coleraine,1792,5,12,8,10,40,35,5,44
Glenavon,1792,6,10,12,8,46,45,1,42
Glentoran,1792,7,11,7,12,41,49,-8,40
Dungannon,1792,8,10,9,11,43,40,3,39
Portadown,1792,9,10,4,16,30,47,-17,34
Ards,1792,10,9,4,17,40,56,-16,31
Ballinamalla,1792,11,7,4,19,31,56,-25,25
Crusaders,1793,1,15,8,7,54,41,13,53
Cliftonville,1793,2,15,6,9,51,38,13,51
Glenavon,1793,3,14,9,7,51,42,9,51
Ballymena,1793,4,14,8,8,58,58,0,50
Dungannon,1793,5,10,11,9,49,40,9,41
Ards,1793,6,12,5,13,52,52,0,41
Linfield,1793,7,10,10,10,53,40,13,40
Coleraine,1793,8,8,10,12,35,41,-6,34
Glentoran,1793,9,8,9,13,33,49,-16,33
Ballinamalla,1793,10,8,5,17,36,56,-20,29
Portadown,1793,11,7,7,16,27,42,-15,28
Cliftonville,1794,1,19,5,6,60,35,25,62
Crusaders,1794,2,17,6,7,55,35,20,57
Ballymena,1794,3,15,6,9,55,55,0,51
Linfield,1794,4,12,13,5,56,33,23,49
Glenavon,1794,5,11,10,9,47,47,0,43
Ards,1794,6,10,7,13,36,43,-7,37
Coleraine,1794,7,8,12,10,36,37,-1,36
Portadown,1794,8,9,6,15,34,40,-6,33
Dungannon,1794,9,7,10,13,39,49,-10,31
Ballinamalla,1794,10,6,8,16,23,46,-23,26
Glentoran,1794,11,6,7,17,27,48,-21,25
Linfield,1795,1,18,8,4,68,26,42,62
Crusaders,1795,2,17,7,6,54,32,22,58
Cliftonville,1795,3,14,6,10,52,43,9,48
Coleraine,1795,4,12,8,10,39,35,4,44
Ballymena,1795,5,11,5,14,51,67,-16,38
Dungannon,1795,6,8,12,10,49,46,3,36
Ards,1795,7,9,8,13,44,48,-4,35
Glentoran,1795,8,9,8,13,27,41,-14,35
Portadown,1795,9,9,7,14,30,48,-18,34
Glenavon,1795,10,8,9,13,40,48,-8,33
Ballinamalla,1795,11,8,6,16,33,53,-20,30
Linfield,1796,1,15,10,5,57,29,28,55
Ballymena,1796,2,14,7,9,57,57,0,49
Crusaders,1796,3,13,7,10,48,41,7,46
Coleraine,1796,4,12,10,8,43,36,7,46
Cliftonville,1796,5,14,3,13,47,44,3,45
Glentoran,1796,6,12,9,9,34,33,1,45
Glenavon,1796,7,10,11,9,44,45,-1,41
Dungannon,1796,8,10,10,10,51,44,7,40
Ballinamalla,1796,9,9,6,15,35,48,-13,33
Ards,1796,10,9,3,18,36,49,-13,30
Portadown,1796,11,7,4,19,20,46,-26,25
Crusaders,1797,1,15,9,6,54,26,28,54
Linfield,1797,2,14,10,6,54,29,25,52
Ballymena,1797,3,15,5,10,56,55,1,50
Cliftonville,1797,4,15,4,11,58,42,16,49
Glenavon,1797,5,12,10,8,53,51,2,46
Ards,1797,6,12,4,14,48,51,-3,40
Coleraine,1797,7,10,10,10,36,41,-5,40
Dungannon,1797,8,10,8,12,42,42,0,38
Glentoran,1797,9,11,4,15,30,43,-13,37
Portadown,1797,10,8,5,17,25,47,-22,29
Ballinamalla,1797,11,7,3,20,35,64,-29,24
Crusaders,1798,1,16,7,7,54,36,18,55
Ballymena,1798,2,15,7,8,62,54,8,52
Linfield,1798,3,12,10,8,58,39,19,46
Glenavon,1798,4,11,11,8,43,41,2,44
Cliftonville,1798,5,11,10,9,48,45,3,43
Coleraine,1798,6,10,13,7,45,42,3,43
Dungannon,1798,7,10,11,9,47,36,11,41
Ballinamalla,1798,8,12,3,15,34,45,-11,39
Portadown,1798,9,9,6,15,32,40,-8,33
Glentoran,1798,10,8,6,16,29,54,-25,30
Ards,1798,11,6,6,18,30,50,-20,24
Ballymena,1799,1,19,5,6,66,48,18,62
Crusaders,1799,2,16,7,7,60,39,21,55
Cliftonville,1799,3,17,4,9,53,36,17,55
Glenavon,1799,4,14,9,7,56,42,14,51
Linfield,1799,5,11,12,7,60,43,17,45
Coleraine,1799,6,12,8,10,45,41,4,44
Ards,1799,7,11,6,13,42,47,-5,39
Dungannon,1799,8,8,10,12,54,52,2,34
Ballinamalla,1799,9,9,3,18,32,54,-22,30
Portadown,1799,10,4,8,18,25,55,-30,20
Glentoran,1799,11,4,8,18,19,55,-36,20
Crusaders,1800,1,15,9,6,52,35,17,54
Ballymena,1800,2,15,5,10,53,55,-2,50
Cliftonville,1800,3,14,7,9,51,44,7,49
Linfield,1800,4,13,8,9,56,32,24,47
Coleraine,1800,5,12,9,9,43,39,4,45
Portadown,1800,6,11,7,12,35,38,-3,40
Dungannon,1800,7,10,9,11,51,46,5,39
Glenavon,1800,8,9,12,9,42,47,-5,39
Glentoran,1800,9,8,11,11,25,38,-13,35
Ards,1800,10,9,5,16,38,46,-8,32
Ballinamalla,1800,11,5,6,19,27,53,-26,21
Linfield,1801,1,16,11,3,59,26,33,59
Crusaders,1801,2,15,11,4,55,36,19,56
Ballymena,1801,3,15,7,8,58,51,7,52
Coleraine,1801,4,13,11,6,47,38,9,50
Glenavon,1801,5,12,10,8,50,43,7,46
Cliftonville,1801,6,11,6,13,46,44,2,39
Dungannon,1801,7,8,8,14,42,50,-8,32
Ards,1801,8,9,5,16,32,41,-9,32
Ballinamalla,1801,9,8,6,16,32,50,-18,30
Glentoran,1801,10,7,8,15,28,47,-19,29
Portadown,1801,11,6,7,17,24,47,-23,25
Cliftonville,1802,1,14,9,7,50,33,17,51
Ballymena,1802,2,14,6,10,61,57,4,48
Crusaders,1802,3,14,5,11,50,46,4,47
Linfield,1802,4,11,12,7,52,36,16,45
Glenavon,1802,5,11,12,7,42,42,0,45
Dungannon,1802,6,12,7,11,52,42,10,43
Coleraine,1802,7,10,11,9,42,38,4,41
Ballinamalla,1802,8,10,6,14,42,48,-6,36
Ards,1802,9,8,8,14,39,50,-11,32
Glentoran,1802,10,8,8,14,38,54,-16,32
Portadown,1802,11,7,8,15,26,48,-22,29
Linfield,1803,1,16,8,6,60,34,26,56
Crusaders,1803,2,15,9,6,50,34,16,54
Cliftonville,1803,3,16,5,9,58,43,15,53
Ards,1803,4,14,4,12,46,44,2,46
Coleraine,1803,5,11,12,7,42,36,6,45
Glentoran,1803,6,11,6,13,34,42,-8,39
Ballymena,1803,7,11,6,13,50,61,-11,39
Glenavon,1803,8,9,9,12,50,57,-7,36
Portadown,1803,9,10,6,14,32,40,-8,36
Dungannon,1803,10,9,6,15,52,54,-2,33
Ballinamalla,1803,11,5,5,20,27,56,-29,20
Crusaders,1804,1,20,6,4,70,29,41,66
Cliftonville,1804,2,15,5,10,54,43,11,50
Linfield,1804,3,13,10,7,57,36,21,49
Coleraine,1804,4,13,9,8,45,37,8,48
Glentoran,1804,5,12,8,10,37,45,-8,44
Glenavon,1804,6,11,10,9,55,51,4,43
Dungannon,1804,7,9,11,10,53,43,10,38
Ballymena,1804,8,11,4,15,53,67,-14,37
Ards,1804,9,9,5,16,41,52,-11,32
Ballinamalla,1804,10,6,7,17,26,58,-32,25
Portadown,1804,11,6,5,19,20,50,-30,23
Cliftonville,1805,1,19,2,9,53,36,17,59
Ballymena,1805,2,16,6,8,62,51,11,54
Crusaders,1805,3,16,5,9,53,36,17,53
Linfield,1805,4,13,9,8,53,28,25,48
Coleraine,1805,5,12,10,8,40,38,2,46
Glenavon,1805,6,9,13,8,39,41,-2,40
Dungannon,1805,7,9,11,10,49,46,3,38
Glentoran,1805,8,8,7,15,30,47,-17,31
Portadown,1805,9,7,9,14,27,41,-14,30
Ballinamalla,1805,10,8,5,17,31,51,-20,29
Ards,1805,11,6,7,17,30,52,-22,25
Crusaders,1806,1,15,8,7,55,36,19,53
Cliftonville,1806,2,15,7,8,55,39,16,52
Coleraine,1806,3,14,8,8,45,38,7,50
Linfield,1806,4,12,10,8,60,38,22,46
Glenavon,1806,5,11,10,9,51,47,4,43
Ballymena,1806,6,11,8,11,54,63,-9,41
Glentoran,1806,7,10,7,13,34,46,-12,37
Dungannon,1806,8,8,9,13,51,52,-1,33
Ards,1806,9,8,9,13,39,48,-9,33
Portadown,1806,10,8,7,15,31,49,-18,31
Ballinamalla,1806,11,8,7,15,35,54,-19,31
Crusaders,1807,1,16,10,4,56,31,25,58
Linfield,1807,2,14,10,6,60,34,26,52
Glenavon,1807,3,13,13,4,49,36,13,52
Cliftonville,1807,4,14,6,10,51,42,9,48
Coleraine,1807,5,11,12,7,43,32,11,45
Ballymena,1807,6,11,5,14,50,59,-9,38
Dungannon,1807,7,9,9,12,51,49,2,36
Glentoran,1807,8,8,10,12,33,43,-10,34
Ballinamalla,1807,9,10,2,18,29,56,-27,32
Portadown,1807,10,8,6,16,30,50,-20,30
Ards,1807,11,8,3,19,34,54,-20,27
Cliftonville,1808,1,16,4,10,56,44,12,52
Ballymena,1808,2,16,4,10,62,56,6,52
Linfield,1808,3,14,9,7,59,35,24,51
Crusaders,1808,4,13,9,8,53,38,15,48
Glenavon,1808,5,11,8,11,42,44,-2,41
Ards,1808,6,11,6,13,42,49,-7,39
Ballinamalla,1808,7,12,3,15,36,45,-9,39
Dungannon,1808,8,8,11,11,42,45,-3,35
Glentoran,1808,9,9,8,13,31,46,-15,35
Coleraine,1808,10,8,10,12,37,43,-6,34
Portadown,1808,11,9,4,17,29,44,-15,31
Crusaders,1809,1,16,9,5,57,40,17,57
Ballymena,1809,2,15,7,8,54,50,4,52
Linfield,1809,3,13,10,7,61,35,26,49
Cliftonville,1809,4,14,7,9,54,40,14,49
Glenavon,1809,5,12,10,8,50,43,7,46
Ards,1809,6,12,4,14,45,52,-7,40
Coleraine,1809,7,9,12,9,35,34,1,39
Glentoran,1809,8,7,10,13,25,39,-14,31
Portadown,1809,9,9,4,17,27,44,-17,31
Dungannon,1809,10,6,12,12,43,47,-4,30
Ballinamalla,1809,11,7,5,18,28,55,-27,26
Linfield,1810,1,15,11,4,62,29,33,56
Crusaders,1810,2,15,10,5,55,35,20,55
Cliftonville,1810,3,15,7,8,48,35,13,52
Ballymena,1810,4,15,5,10,59,58,1,50
Coleraine,1810,5,13,10,7,46,41,5,49
Glenavon,1810,6,11,11,8,41,39,2,44
Dungannon,1810,7,10,11,9,51,37,14,41
Ards,1810,8,8,6,16,35,50,-15,30
Portadown,1810,9,8,6,16,28,43,-15,30
Glentoran,1810,10,6,11,13,23,45,-22,29
Ballinamalla,1810,11,3,4,23,17,53,-36,13
Crusaders,1811,1,16,11,3,62,36,26,59
Ballymena,1811,2,16,7,7,61,55,6,55
Glenavon,1811,3,11,14,5,52,40,12,47
Cliftonville,1811,4,13,5,12,50,39,11,44
Linfield,1811,5,11,10,9,52,36,16,43
Coleraine,1811,6,9,12,9,39,44,-5,39
Dungannon,1811,7,9,11,10,47,45,2,38
Glentoran,1811,8,10,7,13,33,45,-12,37
Ballinamalla,1811,9,9,6,15,32,47,-15,33
Ards,1811,10,8,4,18,31,51,-20,28
Portadown,1811,11,6,7,17,24,45,-21,25
Crusaders,1812,1,17,6,7,54,39,15,57
Linfield,1812,2,15,9,6,57,27,30,54
Cliftonville,1812,3,16,5,9,54,41,13,53
Ballymena,1812,4,15,7,8,62,53,9,52
Glenavon,1812,5,12,11,7,45,40,5,47
Coleraine,1812,6,10,12,8,41,36,5,42
Glentoran,1812,7,11,6,13,35,42,-7,39
Ards,1812,8,10,4,16,35,48,-13,34
Dungannon,1812,9,7,8,15,42,48,-6,29
Portadown,1812,10,7,5,18,22,45,-23,26
Ballinamalla,1812,11,5,7,18,30,58,-28,22
Linfield,1813,1,16,7,7,59,34,25,55
Crusaders,1813,2,16,7,7,52,35,17,55
Cliftonville,1813,3,15,5,10,54,44,10,50
Coleraine,1813,4,13,10,7,49,37,12,49
Ballymena,1813,5,12,8,10,50,49,1,44
Glenavon,1813,6,11,11,8,48,47,1,44
Dungannon,1813,7,11,9,10,53,46,7,42
Ards,1813,8,11,2,17,43,52,-9,35
Portadown,1813,9,9,3,18,25,47,-22,30
Glentoran,1813,10,6,11,13,30,44,-14,29
Ballinamalla,1813,11,6,5,19,30,58,-28,23
Crusaders,1814,1,16,9,5,52,29,23,57
Cliftonville,1814,2,18,3,9,56,39,17,57
Ballymena,1814,3,15,5,10,57,55,2,50
Linfield,1814,4,13,10,7,55,34,21,49
Coleraine,1814,5,12,8,10,43,44,-1,44
Glenavon,1814,6,11,10,9,45,40,5,43
Dungannon,1814,7,11,7,12,48,42,6,40
Ards,1814,8,10,6,14,48,52,-4,36
Glentoran,1814,9,7,8,15,30,48,-18,29
Portadown,1814,10,8,4,18,28,49,-21,28
Ballinamalla,1814,11,6,6,18,30,60,-30,24
Crusaders,1815,1,21,6,3,60,22,38,69
Ballymena,1815,2,15,7,8,55,52,3,52
Cliftonville,1815,3,14,5,11,54,42,12,47
Glenavon,1815,4,12,11,7,44,36,8,47
Linfield,1815,5,12,10,8,46,29,17,46
Coleraine,1815,6,11,11,8,37,35,2,44
Dungannon,1815,7,11,7,12,51,43,8,40
Glentoran,1815,8,10,7,13,30,43,-13,37
Ards,1815,9,6,7,17,32,51,-19,25
Ballinamalla,1815,10,7,4,19,27,55,-28,25
Portadown,1815,11,6,5,19,19,47,-28,23
Crusaders,1816,1,15,8,7,49,33,16,53
Glentoran,1816,2,15,7,8,42,36,6,52
Ballymena,1816,3,13,8,9,62,62,0,47
Linfield,1816,4,12,9,9,55,35,20,45
Glenavon,1816,5,12,9,9,47,46,1,45
Cliftonville,1816,6,12,7,11,49,44,5,43
Dungannon,1816,7,10,11,9,45,40,5,41
Coleraine,1816,8,9,12,9,39,37,2,39
Portadown,1816,9,7,9,14,25,41,-16,30
Ards,1816,10,7,8,15,38,51,-13,29
Ballinamalla,1816,11,6,6,18,29,55,-26,24
Crusaders,1817,1,17,7,6,55,35,20,58
Linfield,1817,2,14,13,3,56,25,31,55
Ballymena,1817,3,14,6,10,61,61,0,48
Dungannon,1817,4,12,10,8,55,38,17,46
Cliftonville,1817,5,14,4,12,52,45,7,46
Ards,1817,6,14,4,12,43,40,3,46
Glenavon,1817,7,11,9,10,45,50,-5,42
Coleraine,1817,8,9,11,10,32,33,-1,38
Ballinamalla,1817,9,8,5,17,28,52,-24,29
Portadown,1817,10,6,6,18,30,52,-22,24
Glentoran,1817,11,5,7,18,26,52,-26,22
Crusaders,1818,1,18,6,6,63,34,29,60
Ballymena,1818,2,16,6,8,63,53,10,54
Cliftonville,1818,3,14,6,10,52,41,11,48
Linfield,1818,4,12,11,7,55,37,18,47
Glenavon,1818,5,12,10,8,47,45,2,46
Coleraine,1818,6,11,10,9,45,40,5,43
Ards,1818,7,10,5,15,35,48,-13,35
Ballinamalla,1818,8,10,5,15,26,42,-16,35
Glentoran,1818,9,8,8,14,27,41,-14,32
Portadown,1818,10,8,4,18,27,44,-17,28
Dungannon,1818,11,6,9,15,39,54,-15,27
Linfield,1819,1,17,9,4,61,24,37,60
Crusaders,1819,2,16,8,6,55,37,18,56
Cliftonville,1819,3,15,5,10,61,40,21,50
Glenavon,1819,4,13,10,7,46,39,7,49
Ballymena,1819,5,13,6,11,60,67,-7,45
Coleraine,1819,6,11,10,9,41,36,5,43
Glentoran,1819,7,10,8,12,31,39,-8,38
Ards,1819,8,10,5,15,43,45,-2,35
Dungannon,1819,9,9,8,13,46,52,-6,35
Portadown,1819,10,6,6,18,24,51,-27,24
Ballinamalla,1819,11,5,5,20,21,59,-38,20
Crusaders,1820,1,17,7,6,60,40,20,58
Glenavon,1820,2,13,11,6,50,41,9,50
Ballymena,1820,3,15,5,10,57,57,0,50
Coleraine,1820,4,12,12,6,43,33,10,48
Linfield,1820,5,11,13,6,56,38,18,46
Cliftonville,1820,6,12,6,12,50,49,1,42
Dungannon,1820,7,10,8,12,51,42,9,38
Glentoran,1820,8,8,8,14,31,43,-12,32
Portadown,1820,9,9,4,17,32,47,-15,31
Ballinamalla,1820,10,8,5,17,28,48,-20,29
Ards,1820,11,7,7,16,33,53,-20,28
Ballymena,1821,1,17,7,6,58,49,9,58
Crusaders,1821,2,16,9,5,51,34,17,57
Linfield,1821,3,14,11,5,64,32,32,53
Cliftonville,1821,4,15,5,10,55,41,14,50
Glenavon,1821,5,14,7,9,49,38,11,49
Coleraine,1821,6,10,12,8,42,42,0,42
Dungannon,1821,7,9,9,12,52,46,6,36
Portadown,1821,8,10,2,18,25,47,-22,32
Glentoran,1821,9,6,10,14,25,46,-21,28
Ballinamalla,1821,10,7,6,17,25,47,-22,27
Ards,1821,11,5,6,19,31,55,-24,21
Crusaders,1822,1,16,8,6,49,30,19,56
Coleraine,1822,2,14,10,6,47,31,16,52
Ballymena,1822,3,15,6,9,63,55,8,51
Linfield,1822,4,14,8,8,60,39,21,50
Dungannon,1822,5,13,8,9,57,40,17,47
Glenavon,1822,6,11,11,8,49,44,5,44
Cliftonville,1822,7,10,6,14,40,44,-4,36
Glentoran,1822,8,9,6,15,26,44,-18,33
Ards,1822,9,9,5,16,33,44,-11,32
Ballinamalla,1822,10,10,2,18,32,54,-22,32
Portadown,1822,11,6,6,18,20,51,-31,24
Crusaders,1823,1,18,6,6,59,34,25,60
Linfield,1823,2,15,10,5,73,35,38,55
Cliftonville,1823,3,14,7,9,49,35,14,49
Glenavon,1823,4,13,10,7,51,45,6,49
Coleraine,1823,5,11,12,7,47,42,5,45
Ballymena,1823,6,12,9,9,48,53,-5,45
Dungannon,1823,7,10,11,9,47,40,7,41
Glentoran,1823,8,7,9,14,26,44,-18,30
Ards,1823,9,7,6,17,43,62,-19,27
Portadown,1823,10,5,9,16,23,48,-25,24
Ballinamalla,1823,11,7,3,20,31,59,-28,24
Crusaders,1824,1,17,8,5,60,32,28,59
Linfield,1824,2,14,10,6,57,30,27,52
Glenavon,1824,3,13,12,5,51,42,9,51
Cliftonville,1824,4,14,8,8,52,36,16,50
Ballymena,1824,5,14,7,9,56,58,-2,49
Coleraine,1824,6,9,10,11,41,43,-2,37
Glentoran,1824,7,9,9,12,29,44,-15,36
Dungannon,1824,8,7,12,11,39,39,0,33
Ards,1824,9,8,6,16,41,54,-13,30
Portadown,1824,10,8,4,18,26,47,-21,28
Ballinamalla,1824,11,5,8,17,28,55,-27,23
Cliftonville,1825,1,18,5,7,57,34,23,59
Linfield,1825,2,14,9,7,59,34,25,51
Crusaders,1825,3,14,8,8,58,41,17,50
Glenavon,1825,4,13,10,7,49,41,8,49
Dungannon,1825,5,12,9,9,52,42,10,45
Coleraine,1825,6,11,10,9,44,43,1,43
Ballymena,1825,7,12,6,12,55,61,-6,42
Glentoran,1825,8,9,9,12,38,51,-13,36
Ballinamalla,1825,9,8,7,15,32,50,-18,31
Ards,1825,10,7,5,18,29,49,-20,26
Portadown,1825,11,6,4,20,30,57,-27,22
Crusaders,1826,1,18,8,4,63,30,33,62
Glenavon,1826,2,13,10,7,54,41,13,49
Ballymena,1826,3,14,7,9,57,55,2,49
Linfield,1826,4,12,11,7,56,39,17,47
Cliftonville,1826,5,14,5,11,49,44,5,47
Glentoran,1826,6,12,6,12,34,43,-9,42
Ards,1826,7,10,6,14,41,44,-3,36
Coleraine,1826,8,6,14,10,33,45,-12,32
Dungannon,1826,9,7,9,14,50,49,1,30
Portadown,1826,10,8,6,16,26,48,-22,30
Ballinamalla,1826,11,8,4,18,32,57,-25,28
Crusaders,1827,1,16,9,5,58,31,27,57
Linfield,1827,2,13,12,5,61,31,30,51
Glenavon,1827,3,12,13,5,44,35,9,49
Cliftonville,1827,4,14,5,11,53,44,9,47
Coleraine,1827,5,12,10,8,45,43,2,46
Ballymena,1827,6,13,5,12,51,58,-7,44
Glentoran,1827,7,10,5,15,31,49,-18,35
Dungannon,1827,8,8,9,13,49,48,1,33
Ballinamalla,1827,9,9,6,15,30,49,-19,33
Ards,1827,10,8,5,17,34,49,-15,29
Portadown,1827,11,6,9,15,22,41,-19,27
Crusaders,1828,1,17,7,6,57,37,20,58
Cliftonville,1828,2,16,7,7,53,34,19,55
Coleraine,1828,3,13,10,7,39,30,9,49
Glenavon,1828,4,12,11,7,49,47,2,47
Linfield,1828,5,11,11,8,56,34,22,44
Dungannon,1828,6,10,9,11,55,51,4,39
Glentoran,1828,7,10,9,11,33,38,-5,39
Ballymena,1828,8,10,7,13,50,61,-11,37
Ards,1828,9,8,8,14,35,46,-11,32
Portadown,1828,10,7,6,17,26,48,-22,27
Ballinamalla,1828,11,6,5,19,26,53,-27,23
Linfield,1829,1,16,9,5,67,33,34,57
Crusaders,1829,2,14,7,9,46,35,11,49
Cliftonville,1829,3,14,6,10,49,38,11,48
Coleraine,1829,4,11,14,5,44,33,11,47
Ballymena,1829,5,13,6,11,57,57,0,45
Glenavon,1829,6,11,11,8,48,44,4,44
Dungannon,1829,7,9,11,10,52,43,9,38
Ards,1829,8,11,5,14,39,50,-11,38
Glentoran,1829,9,7,9,14,29,52,-23,30
Ballinamalla,1829,10,8,4,18,31,57,-26,28
Portadown,1829,11,7,6,17,31,51,-20,27
Crusaders,1830,1,18,8,4,63,39,24,62
Ballymena,1830,2,15,7,8,58,54,4,52
Coleraine,1830,3,14,8,8,50,43,7,50
Linfield,1830,4,13,9,8,57,42,15,48
Cliftonville,1830,5,13,8,9,51,38,13,47
Glenavon,1830,6,10,11,9,54,56,-2,41
Glentoran,1830,7,10,7,13,32,41,-9,37
Ballinamalla,1830,8,9,4,17,39,51,-12,31
Dungannon,1830,9,7,9,14,49,51,-2,30
Portadown,1830,10,7,7,16,32,52,-20,28
Ards,1830,11,7,6,17,31,49,-18,27
Cliftonville,1831,1,17,5,8,53,35,18,56
Crusaders,1831,2,15,10,5,55,32,23,55
Ballymena,1831,3,14,6,10,52,56,-4,48
Linfield,1831,4,12,11,7,55,35,20,47
Dungannon,1831,5,13,8,9,52,36,16,47
Glenavon,1831,6,11,11,8,45,42,3,44
Coleraine,1831,7,10,12,8,42,36,6,42
Ards,1831,8,9,7,14,34,45,-11,34
Ballinamalla,1831,9,8,6,16,33,54,-21,30
Glentoran,1831,10,6,7,17,19,43,-24,25
Portadown,1831,11,5,7,18,20,46,-26,22
Linfield,1832,1,18,8,4,61,26,35,62
Crusaders,1832,2,15,11,4,53,32,21,56
Dungannon,1832,3,10,14,6,56,41,15,44
Cliftonville,1832,4,12,7,11,56,45,11,43
Coleraine,1832,5,11,9,10,41,43,-2,42
Ards,1832,6,11,5,14,37,43,-6,38
Ballymena,1832,7,11,5,14,48,62,-14,38
Glenavon,1832,8,9,10,11,45,53,-8,37
Ballinamalla,1832,9,9,5,16,30,49,-19,32
Portadown,1832,10,8,6,16,29,46,-17,30
Glentoran,1832,11,7,8,15,32,48,-16,29
Crusaders,1833,1,19,4,7,56,31,25,61
Linfield,1833,2,16,8,6,66,39,27,56
Glenavon,1833,3,14,7,9,49,42,7,49
Cliftonville,1833,4,14,4,12,53,45,8,46
Ballymena,1833,5,13,6,11,62,59,3,45
Ards,1833,6,13,5,12,45,44,1,44
Coleraine,1833,7,10,10,10,44,49,-5,40
Dungannon,1833,8,9,10,11,43,44,-1,37
Glentoran,1833,9,8,5,17,26,43,-17,29
Portadown,1833,10,8,5,17,26,48,-22,29
Ballinamalla,1833,11,6,6,18,29,55,-26,24
Linfield,1834,1,16,10,4,63,27,36,58
Cliftonville,1834,2,18,2,10,55,44,11,56
Crusaders,1834,3,15,9,6,56,40,16,54
Ballymena,1834,4,15,8,7,61,51,10,53
Coleraine,1834,5,11,13,6,47,35,12,46
Dungannon,1834,6,11,8,11,46,41,5,41
Glenavon,1834,7,7,13,10,42,47,-5,34
Ballinamalla,1834,8,9,5,16,35,56,-21,32
Ards,1834,9,9,3,18,38,58,-20,30
Portadown,1834,10,7,4,19,28,48,-20,25
Glentoran,1834,11,5,9,16,24,48,-24,24
Crusaders,1835,1,16,7,7,60,39,21,55
Ballymena,1835,2,14,7,9,57,57,0,49
Linfield,1835,3,12,12,6,55,38,17,48
Coleraine,1835,4,13,8,9,46,40,6,47
Cliftonville,1835,5,13,6,11,51,44,7,45
Glentoran,1835,6,12,8,10,37,37,0,44
Dungannon,1835,7,11,10,9,51,43,8,43
Glenavon,1835,8,8,13,9,50,49,1,37
Ards,1835,9,10,4,16,35,52,-17,34
Ballinamalla,1835,10,7,5,18,29,51,-22,26
Portadown,1835,11,6,6,18,23,44,-21,24
Linfield,1836,1,18,7,5,62,27,35,61
Crusaders,1836,2,17,7,6,51,30,21,58
Cliftonville,1836,3,15,7,8,53,38,15,52
Ballymena,1836,4,14,7,9,62,57,5,49
Coleraine,1836,5,12,12,6,43,32,11,48
Glenavon,1836,6,9,11,10,43,53,-10,38
Dungannon,1836,7,8,9,13,45,45,0,33
Ards,1836,8,8,6,16,33,50,-17,30
Portadown,1836,9,9,3,18,29,46,-17,30
Glentoran,1836,10,8,6,16,24,46,-22,30
Ballinamalla,1836,11,6,7,17,28,49,-21,25
Dungannon,1837,1,16,6,8,56,34,22,54
Glenavon,1837,2,15,9,6,59,38,21,54
Cliftonville,1837,3,16,5,9,59,39,20,53
Crusaders,1837,4,14,7,9,45,30,15,49
Linfield,1837,5,11,10,9,51,34,17,43
Ballymena,1837,6,12,7,11,53,59,-6,43
Coleraine,1837,7,10,11,9,39,39,0,41
Ards,1837,8,12,4,14,38,48,-10,40
Glentoran,1837,9,10,6,14,28,42,-14,36
Portadown,1837,10,6,7,17,16,47,-31,25
Ballinamalla,1837,11,5,4,21,22,56,-34,19
Crusaders,1838,1,18,6,6,57,35,22,60
Linfield,1838,2,15,10,5,56,26,30,55
Coleraine,1838,3,14,8,8,47,35,12,50
Cliftonville,1838,4,15,3,12,47,42,5,48
Ballymena,1838,5,14,6,10,56,52,4,48
Dungannon,1838,6,11,9,10,51,41,10,42
Glenavon,1838,7,10,10,10,41,47,-6,40
Glentoran,1838,8,10,8,12,30,42,-12,38
Ards,1838,9,8,4,18,32,46,-14,28
Portadown,1838,10,7,7,16,29,46,-17,28
Ballinamalla,1838,11,6,3,21,23,57,-34,21
Cliftonville,1839,1,18,5,7,59,34,25,59
Linfield,1839,2,16,8,6,65,31,34,56
Crusaders,1839,3,14,8,8,56,39,17,50
Dungannon,1839,4,13,8,9,52,42,10,47
Glenavon,1839,5,13,8,9,46,41,5,47
Ballymena,1839,6,14,4,12,51,60,-9,46
Coleraine,1839,7,11,11,8,43,36,7,44
Glentoran,1839,8,9,8,13,26,39,-13,35
Ards,1839,9,10,3,17,34,53,-19,33
Ballinamalla,1839,10,7,4,19,22,48,-26,25
Portadown,1839,11,5,3,22,19,50,-31,18
Crusaders,1840,1,17,6,7,64,39,25,57
Cliftonville,1840,2,16,5,9,60,41,19,53
Coleraine,1840,3,13,9,8,43,37,6,48
Ballymena,1840,4,13,9,8,57,58,-1,48
Linfield,1840,5,13,7,10,59,37,22,46
Glenavon,1840,6,11,12,7,50,45,5,45
Dungannon,1840,7,12,7,11,58,46,12,43
Glentoran,1840,8,8,11,11,25,36,-11,35
Ballinamalla,1840,9,10,3,17,30,53,-23,33
Ards,1840,10,7,7,16,34,55,-21,28
Portadown,1840,11,4,6,20,19,52,-33,18
Crusaders,1841,1,17,8,5,53,36,17,59
Linfield,1841,2,13,13,4,54,27,27,52
Cliftonville,1841,3,15,5,10,53,39,14,50
Ballymena,1841,4,14,7,9,56,60,-4,49
Glenavon,1841,5,11,11,8,44,42,2,44
Dungannon,1841,6,10,11,9,55,45,10,41
Coleraine,1841,7,10,9,11,39,39,0,39
Glentoran,1841,8,8,11,11,33,38,-5,35
Ballinamalla,1841,9,9,3,18,37,52,-15,30
Ards,1841,10,9,3,18,34,52,-18,30
Portadown,1841,11,6,5,19,28,56,-28,23
Linfield,1842,1,16,9,5,59,27,32,57
Cliftonville,1842,2,16,7,7,53,32,21,55
Crusaders,1842,3,13,6,11,51,40,11,45
Coleraine,1842,4,11,12,7,39,38,1,45
Ballymena,1842,5,12,9,9,52,56,-4,45
Glenavon,1842,6,11,9,10,45,45,0,42
Glentoran,1842,7,10,8,12,32,38,-6,38
Ballinamalla,1842,8,10,6,14,32,47,-15,36
Dungannon,1842,9,7,10,13,52,53,-1,31
Ards,1842,10,8,6,16,38,53,-15,30
Portadown,1842,11,7,6,17,22,46,-24,27
Linfield,1843,1,18,7,5,63,29,34,61
Ballymena,1843,2,17,5,8,59,56,3,56
Cliftonville,1843,3,15,5,10,59,47,12,50
Glenavon,1843,4,14,8,8,52,41,11,50
Coleraine,1843,5,12,10,8,40,36,4,46
Crusaders,1843,6,13,6,11,48,42,6,45
Dungannon,1843,7,11,8,11,56,47,9,41
Ballinamalla,1843,8,11,1,18,31,52,-21,34
Ards,1843,9,8,6,16,41,51,-10,30
Glentoran,1843,10,6,7,17,29,52,-23,25
Portadown,1843,11,4,9,17,20,45,-25,21
Crusaders,1844,1,16,6,8,53,41,12,54
Coleraine,1844,2,14,11,5,48,32,16,53
Ballymena,1844,3,15,8,7,62,53,9,53
Dungannon,1844,4,15,6,9,62,41,21,51
Cliftonville,1844,5,13,7,10,56,43,13,46
Glenavon,1844,6,12,8,10,50,45,5,44
Linfield,1844,7,11,9,10,52,33,19,42
Ards,1844,8,9,4,17,38,59,-21,31
Glentoran,1844,9,7,8,15,31,55,-24,29
Ballinamalla,1844,10,9,2,19,29,59,-30,29
Portadown,1844,11,6,7,17,27,47,-20,25
Cliftonville,1845,1,19,4,7,55,29,26,61
Crusaders,1845,2,16,7,7,53,30,23,55
Linfield,1845,3,14,9,7,56,37,19,51
Coleraine,1845,4,13,10,7,44,34,10,49
Glenavon,1845,5,12,9,9,46,40,6,45
Glentoran,1845,6,11,8,11,34,42,-8,41
Ballymena,1845,7,10,8,12,46,64,-18,38
Dungannon,1845,8,7,11,12,44,45,-1,32
Ards,1845,9,8,6,16,36,48,-12,30
Portadown,1845,10,7,8,15,27,40,-13,29
Ballinamalla,1845,11,6,4,20,26,58,-32,22
Crusaders,1846,1,16,8,6,55,38,17,56
Cliftonville,1846,2,16,7,7,55,37,18,55
Linfield,1846,3,14,10,6,61,35,26,52
Coleraine,1846,4,12,11,7,42,34,8,47
Glenavon,1846,5,10,12,8,42,41,1,42
Ballymena,1846,6,10,11,9,57,59,-2,41
Dungannon,1846,7,10,9,11,51,43,8,39
Ards,1846,8,8,6,16,38,52,-14,30
Ballinamalla,1846,9,7,7,16,31,49,-18,28
Portadown,1846,10,7,7,16,25,46,-21,28
Glentoran,1846,11,6,10,14,28,51,-23,28
Crusaders,1847,1,14,8,8,57,42,15,50
Cliftonville,1847,2,15,5,10,48,38,10,50
Ballymena,1847,3,14,6,10,58,53,5,48
Dungannon,1847,4,12,9,9,58,44,14,45
Linfield,1847,5,12,9,9,56,42,14,45
Coleraine,1847,6,11,10,9,45,38,7,43
Glentoran,1847,7,12,7,11,36,42,-6,43
Glenavon,1847,8,8,12,10,48,50,-2,36
Ballinamalla,1847,9,7,10,13,38,54,-16,31
Ards,1847,10,8,6,16,36,55,-19,30
Portadown,1847,11,8,6,16,27,49,-22,30
Cliftonville,1848,1,17,6,7,59,32,27,57
Ballymena,1848,2,15,8,7,57,49,8,53
Linfield,1848,3,13,11,6,55,33,22,50
Crusaders,1848,4,14,7,9,48,38,10,49
Coleraine,1848,5,12,9,9,46,36,10,45
Dungannon,1848,6,12,7,11,52,47,5,43
Glenavon,1848,7,11,9,10,41,41,0,42
Ards,1848,8,10,6,14,34,45,-11,36
Glentoran,1848,9,7,7,16,26,46,-20,28
Portadown,1848,10,6,8,16,21,44,-23,26
Ballinamalla,1848,11,7,4,19,23,51,-28,25
Linfield,1849,1,16,8,6,59,28,31,56
Crusaders,1849,2,16,8,6,54,32,22,56
Cliftonville,1849,3,14,7,9,54,44,10,49
Glenavon,1849,4,13,9,8,48,43,5,48
Coleraine,1849,5,11,12,7,43,39,4,45
Ballymena,1849,6,11,9,10,53,60,-7,42
Dungannon,1849,7,9,9,12,44,46,-2,36
Glentoran,1849,8,9,8,13,37,46,-9,35
Ballinamalla,1849,9,7,7,16,29,48,-19,28
Ards,1849,10,7,6,17,39,55,-16,27
Portadown,1849,11,5,11,14,25,44,-19,26
Crusaders,1850,1,15,10,5,53,33,20,55
Linfield,1850,2,15,8,7,56,31,25,53
Ballymena,1850,3,13,7,10,58,60,-2,46
Glenavon,1850,4,12,9,9,49,46,3,45
Cliftonville,1850,5,13,5,12,53,47,6,44
Ards,1850,6,13,4,13,46,45,1,43
Coleraine,1850,7,9,14,7,36,37,-1,41
Dungannon,1850,8,9,11,10,51,39,12,38
Portadown,1850,9,9,5,16,31,49,-18,32
Ballinamalla,1850,10,9,4,17,33,57,-24,31
Glentoran,1850,11,6,7,17,27,49,-22,25
Cliftonville,1851,1,16,6,8,54,36,18,54
Crusaders,1851,2,15,6,9,59,38,21,51
Ballymena,1851,3,13,8,9,57,58,-1,47
Glenavon,1851,4,13,7,10,49,47,2,46
Linfield,1851,5,12,9,9,50,34,16,45
Dungannon,1851,6,12,7,11,57,46,11,43
Coleraine,1851,7,10,12,8,42,38,4,42
Glentoran,1851,8,11,9,10,36,48,-12,42
Ards,1851,9,10,6,14,38,46,-8,36
Ballinamalla,1851,10,7,4,19,28,55,-27,25
Portadown,1851,11,6,6,18,21,45,-24,24
Crusaders,1852,1,17,8,5,60,40,20,59
Linfield,1852,2,15,11,4,62,31,31,56
Cliftonville,1852,3,16,6,8,54,36,18,54
Coleraine,1852,4,11,12,7,48,40,8,45
Ballymena,1852,5,13,6,11,55,54,1,45
Glenavon,1852,6,10,9,11,46,44,2,39
Dungannon,1852,7,10,7,13,51,53,-2,37
Ballinamalla,1852,8,9,7,14,35,49,-14,34
Ards,1852,9,8,6,16,39,54,-15,30
Glentoran,1852,10,6,9,15,31,59,-28,27
Portadown,1852,11,6,7,17,22,43,-21,25
Linfield,1853,1,15,10,5,61,30,31,55
Crusaders,1853,2,14,10,6,52,35,17,52
Coleraine,1853,3,13,10,7,46,42,4,49
Ballymena,1853,4,11,8,11,59,60,-1,41
Glenavon,1853,5,9,13,8,49,52,-3,40
Ards,1853,6,10,7,13,40,45,-5,37
Glentoran,1853,7,9,10,11,34,45,-11,37
Cliftonville,1853,8,9,9,12,42,41,1,36
Dungannon,1853,9,7,12,11,45,44,1,33
Portadown,1853,10,8,9,13,29,45,-16,33
Ballinamalla,1853,11,8,6,16,29,47,-18,30
Crusaders,1854,1,16,8,6,53,32,21,56
Cliftonville,1854,2,16,4,10,56,38,18,52
Linfield,1854,3,14,9,7,59,36,23,51
Ballymena,1854,4,15,5,10,54,52,2,50
Coleraine,1854,5,13,10,7,48,38,10,49
Glenavon,1854,6,10,12,8,44,46,-2,42
Dungannon,1854,7,9,10,11,46,47,-1,37
Ards,1854,8,9,6,15,39,49,-10,33
Glentoran,1854,9,6,11,13,30,43,-13,29
Portadown,1854,10,8,5,17,24,43,-19,29
Ballinamalla,1854,11,5,8,17,30,59,-29,23
Crusaders,1855,1,19,4,7,60,35,25,61
Linfield,1855,2,14,9,7,58,34,24,51
Ballymena,1855,3,16,3,11,60,59,1,51
Cliftonville,1855,4,15,5,10,50,40,10,50
Glenavon,1855,5,12,12,6,42,37,5,48
Dungannon,1855,6,10,8,12,47,43,4,38
Coleraine,1855,7,10,8,12,36,38,-2,38
Glentoran,1855,8,10,7,13,32,43,-11,37
Portadown,1855,9,9,6,15,28,42,-14,33
Ards,1855,10,8,4,18,33,50,-17,28
Ballinamalla,1855,11,7,4,19,23,48,-25,25
Linfield,1856,1,16,9,5,66,36,30,57
Crusaders,1856,2,15,6,9,53,41,12,51
Ballymena,1856,3,15,6,9,64,60,4,51
Coleraine,1856,4,14,8,8,44,38,6,50
Cliftonville,1856,5,15,4,11,50,40,10,49
Dungannon,1856,6,13,7,10,55,43,12,46
Glenavon,1856,7,11,10,9,47,44,3,43
Ards,1856,8,10,6,14,37,45,-8,36
Glentoran,1856,9,9,7,14,30,42,-12,34
Portadown,1856,10,7,4,19,26,50,-24,25
Ballinamalla,1856,11,4,5,21,31,64,-33,17
Cliftonville,1857,1,19,5,6,57,31,26,62
Linfield,1857,2,13,9,8,51,29,22,48
Ballymena,1857,3,13,8,9,52,52,0,47
Crusaders,1857,4,13,7,10,51,43,8,46
Coleraine,1857,5,11,12,7,44,40,4,45
Ards,1857,6,10,9,11,40,46,-6,39
Glenavon,1857,7,9,11,10,48,52,-4,38
Dungannon,1857,8,10,7,13,51,47,4,37
Ballinamalla,1857,9,9,5,16,30,50,-20,32
Glentoran,1857,10,8,6,16,29,44,-15,30
Portadown,1857,11,7,7,16,27,46,-19,28
Crusaders,1858,1,17,7,6,62,35,27,58
Linfield,1858,2,17,7,6,50,26,24,58
Cliftonville,1858,3,17,4,9,56,34,22,55
Ballymena,1858,4,15,7,8,59,49,10,52
Glenavon,1858,5,12,9,9,47,44,3,45
Glentoran,1858,6,10,8,12,39,40,-1,38
Coleraine,1858,7,9,9,12,38,40,-2,36
Ballinamalla,1858,8,11,3,16,27,47,-20,36
Dungannon,1858,9,9,8,13,44,51,-7,35
Ards,1858,10,5,8,17,29,55,-26,23
Portadown,1858,11,5,6,19,24,54,-30,21
Crusaders,1859,1,18,6,6,55,32,23,60
Cliftonville,1859,2,16,6,8,50,35,15,54
Linfield,1859,3,14,9,7,58,36,22,51
Coleraine,1859,4,11,12,7,46,38,8,45
Ballymena,1859,5,11,8,11,57,61,-4,41
Ballinamalla,1859,6,12,4,14,40,47,-7,40
Dungannon,1859,7,10,8,12,44,39,5,38
Glenavon,1859,8,8,10,12,37,47,-10,34
Portadown,1859,9,9,6,15,32,48,-16,33
Glentoran,1859,10,7,9,14,28,51,-23,30
Ards,1859,11,7,6,17,36,49,-13,27
Crusaders,1860,1,18,8,4,60,28,32,62
Glenavon,1860,2,14,8,8,52,44,8,50
Cliftonville,1860,3,14,7,9,55,42,13,49
Linfield,1860,4,13,9,8,59,33,26,48
Coleraine,1860,5,12,10,8,44,40,4,46
Ballymena,1860,6,10,11,9,52,60,-8,41
Glentoran,1860,7,10,7,13,26,45,-19,37
Dungannon,1860,8,8,12,10,45,42,3,36
Ards,1860,9,9,4,17,37,52,-15,31
Portadown,1860,10,8,6,16,34,49,-15,30
Ballinamalla,1860,11,5,6,19,26,55,-29,21
Crusaders,1861,1,19,5,6,55,38,17,62
Cliftonville,1861,2,15,3,12,57,48,9,48
Coleraine,1861,3,12,12,6,43,34,9,48
Glenavon,1861,4,13,9,8,50,47,3,48
Ballymena,1861,5,13,8,9,56,51,5,47
Linfield,1861,6,12,10,8,55,39,16,46
Dungannon,1861,7,11,9,10,48,41,7,42
Ards,1861,8,8,7,15,37,49,-12,31
Glentoran,1861,9,7,10,13,32,45,-13,31
Portadown,1861,10,9,4,17,37,51,-14,31
Ballinamalla,1861,11,4,7,19,25,52,-27,19
Cliftonville,1862,1,19,4,7,58,34,24,61
Coleraine,1862,2,15,8,7,45,33,12,53
Crusaders,1862,3,15,5,10,47,34,13,50
Glenavon,1862,4,11,12,7,48,40,8,45
Dungannon,1862,5,12,8,10,50,38,12,44
Linfield,1862,6,11,9,10,47,36,11,42
Ballymena,1862,7,11,5,14,57,70,-13,38
Glentoran,1862,8,11,5,14,32,45,-13,38
Ards,1862,9,10,3,17,37,51,-14,33
Portadown,1862,10,7,7,16,29,46,-17,28
Ballinamalla,1862,11,8,4,18,29,52,-23,28
Crusaders,1863,1,19,5,6,63,31,32,62
Coleraine,1863,2,15,10,5,50,32,18,55
Linfield,1863,3,15,8,7,60,33,27,53
Glenavon,1863,4,11,10,9,47,47,0,43
Ballymena,1863,5,11,7,12,52,57,-5,40
Ards,1863,6,11,5,14,36,42,-6,38
Glentoran,1863,7,10,7,13,34,43,-9,37
Dungannon,1863,8,9,9,12,47,53,-6,36
Cliftonville,1863,9,11,3,16,46,59,-13,36
Portadown,1863,10,9,4,17,22,39,-17,31
Ballinamalla,1863,11,8,4,18,27,48,-21,28
Crusaders,1864,1,17,9,4,54,32,22,60
Ballymena,1864,2,15,6,9,63,56,7,51
Coleraine,1864,3,13,8,9,48,37,11,47
Cliftonville,1864,4,13,6,11,49,45,4,45
Linfield,1864,5,10,14,6,61,37,24,44
Glenavon,1864,6,10,14,6,48,44,4,44
Dungannon,1864,7,9,9,12,50,51,-1,36
Portadown,1864,8,9,7,14,30,41,-11,34
Glentoran,1864,9,7,9,14,27,44,-17,30
Ballinamalla,1864,10,7,8,15,32,51,-19,29
Ards,1864,11,8,4,18,34,58,-24,28
Cliftonville,1865,1,17,6,7,54,31,23,57
Linfield,1865,2,15,8,7,60,38,22,53
Ballymena,1865,3,16,5,9,62,55,7,53
Crusaders,1865,4,15,6,9,56,42,14,51
Glenavon,1865,5,12,8,10,53,45,8,44
Ards,1865,6,11,5,14,42,45,-3,38
Dungannon,1865,7,9,10,11,54,45,9,37
Coleraine,1865,8,7,12,11,34,48,-14,33
Glentoran,1865,9,8,7,15,28,46,-18,31
Portadown,1865,10,9,4,17,22,43,-21,31
Ballinamalla,1865,11,8,5,17,24,51,-27,29
Crusaders,1866,1,17,8,5,62,34,28,59
Linfield,1866,2,17,7,6,74,33,41,58
Cliftonville,1866,3,18,2,10,65,40,25,56
Ballymena,1866,4,13,8,9,58,63,-5,47
Coleraine,1866,5,12,9,9,47,40,7,45
Glenavon,1866,6,11,12,7,48,49,-1,45
Glentoran,1866,7,12,6,12,34,41,-7,42
Dungannon,1866,8,9,7,14,39,42,-3,34
Ards,1866,9,9,5,16,36,55,-19,32
Ballinamalla,1866,10,6,4,20,27,57,-30,22
Portadown,1866,11,5,4,21,22,58,-36,19
Crusaders,1867,1,20,5,5,60,34,26,65
Glenavon,1867,2,13,10,7,54,41,13,49
Linfield,1867,3,13,9,8,63,41,22,48
Cliftonville,1867,4,14,6,10,58,46,12,48
Coleraine,1867,5,13,9,8,47,39,8,48
Glentoran,1867,6,14,5,11,38,37,1,47
Ballymena,1867,7,13,5,12,66,68,-2,44
Dungannon,1867,8,9,8,13,44,46,-2,35
Ards,1867,9,10,4,16,32,48,-16,34
Portadown,1867,10,6,5,19,22,51,-29,23
Ballinamalla,1867,11,4,6,20,26,59,-33,18
Crusaders,1868,1,17,7,6,59,32,27,58
Cliftonville,1868,2,15,2,13,54,48,6,47
Ballymena,1868,3,13,5,12,61,65,-4,44
Linfield,1868,4,11,10,9,60,43,17,43
Coleraine,1868,5,11,10,9,40,39,1,43
Glenavon,1868,6,11,10,9,42,42,0,43
Dungannon,1868,7,11,8,11,57,51,6,41
Portadown,1868,8,11,6,13,38,41,-3,39
Ards,1868,9,11,6,13,40,48,-8,39
Glentoran,1868,10,11,4,15,36,51,-15,37
Ballinamalla,1868,11,6,6,18,30,57,-27,24
Crusaders,1869,1,18,9,3,60,27,33,63
Cliftonville,1869,2,17,6,7,54,30,24,57
Linfield,1869,3,14,9,7,53,35,18,51
Glenavon,1869,4,11,13,6,49,39,10,46
Ards,1869,5,13,6,11,47,37,10,45
Ballymena,1869,6,11,8,11,51,56,-5,41
Dungannon,1869,7,9,10,11,44,39,5,37
Coleraine,1869,8,9,10,11,44,48,-4,37
Portadown,1869,9,8,6,16,23,51,-28,30
Glentoran,1869,10,7,6,17,26,51,-25,27
Ballinamalla,1869,11,3,7,20,18,56,-38,16
Crusaders,1870,1,20,4,6,70,34,36,64
Ballymena,1870,2,17,4,9,66,57,9,55
Glenavon,1870,3,13,9,8,52,45,7,48
Linfield,1870,4,12,9,9,51,34,17,45
Dungannon,1870,5,12,9,9,51,46,5,45
Coleraine,1870,6,11,10,9,44,44,0,43
Cliftonville,1870,7,12,5,13,46,49,-3,41
Portadown,1870,8,10,3,17,31,48,-17,33
Ards,1870,9,8,6,16,40,46,-6,30
Ballinamalla,1870,10,7,7,16,26,51,-25,28
Glentoran,1870,11,6,8,16,27,50,-23,26
Crusaders,1871,1,20,8,2,62,28,34,68
Linfield,1871,2,14,11,5,49,26,23,53
Cliftonville,1871,3,15,6,9,54,38,16,51
Coleraine,1871,4,11,10,9,44,40,4,43
Ballymena,1871,5,11,9,10,51,59,-8,42
Glenavon,1871,6,10,11,9,50,50,0,41
Ards,1871,7,10,7,13,40,44,-4,37
Dungannon,1871,8,7,11,12,49,51,-2,32
Glentoran,1871,9,7,11,12,30,40,-10,32
Ballinamalla,1871,10,7,6,17,28,53,-25,27
Portadown,1871,11,5,6,19,21,49,-28,21
Crusaders,1872,1,19,4,7,58,32,26,61
Cliftonville,1872,2,17,4,9,57,37,20,55
Ballymena,1872,3,16,4,10,63,57,6,52
Coleraine,1872,4,11,12,7,41,33,8,45
Linfield,1872,5,12,8,10,56,42,14,44
Glenavon,1872,6,10,11,9,37,45,-8,41
Ballinamalla,1872,7,12,3,15,36,46,-10,39
Glentoran,1872,8,10,8,12,37,42,-5,38
Dungannon,1872,9,7,10,13,48,54,-6,31
Portadown,1872,10,8,3,19,27,52,-25,27
Ards,1872,11,7,5,18,29,49,-20,26
Cliftonville,1873,1,16,7,7,50,36,14,55
Crusaders,1873,2,14,9,7,56,41,15,51
Ballymena,1873,3,14,8,8,60,57,3,50
Linfield,1873,4,13,9,8,57,37,20,48
Dungannon,1873,5,10,12,8,54,40,14,42
Glenavon,1873,6,10,12,8,47,45,2,42
Coleraine,1873,7,9,12,9,43,44,-1,39
Glentoran,1873,8,8,9,13,33,41,-8,33
Ards,1873,9,9,6,15,37,52,-15,33
Portadown,1873,10,6,9,15,22,41,-19,27
Ballinamalla,1873,11,6,7,17,31,56,-25,25
Crusaders,1874,1,18,5,7,62,35,27,59
Linfield,1874,2,14,9,7,66,35,31,51
Cliftonville,1874,3,15,5,10,54,40,14,50
Glenavon,1874,4,13,9,8,44,38,6,48
Ballymena,1874,5,13,8,9,54,59,-5,47
Coleraine,1874,6,11,12,7,46,37,9,45
Ballinamalla,1874,7,13,3,14,38,48,-10,42
Glentoran,1874,8,11,4,15,36,51,-15,37
Dungannon,1874,9,8,9,13,43,57,-14,33
Ards,1874,10,7,5,18,34,51,-17,26
Portadown,1874,11,6,3,21,26,52,-26,21
Linfield,1875,1,17,9,4,61,29,32,60
Crusaders,1875,2,16,8,6,60,38,22,56
Cliftonville,1875,3,15,8,7,60,37,23,53
Coleraine,1875,4,13,10,7,45,37,8,49
Ballymena,1875,5,13,8,9,59,61,-2,47
Glenavon,1875,6,10,10,10,50,53,-3,40
Dungannon,1875,7,8,13,9,51,44,7,37
Glentoran,1875,8,8,7,15,23,43,-20,31
Ards,1875,9,8,5,17,33,49,-16,29
Ballinamalla,1875,10,6,7,17,30,55,-25,25
Portadown,1875,11,7,3,20,21,47,-26,24
Linfield,1876,1,15,11,4,59,29,30,56
Crusaders,1876,2,16,7,7,58,36,22,55
Coleraine,1876,3,14,8,8,52,41,11,50
Dungannon,1876,4,13,8,9,59,40,19,47
Cliftonville,1876,5,14,5,11,51,45,6,47
Glenavon,1876,6,11,10,9,47,47,0,43
Ballymena,1876,7,11,5,14,56,65,-9,38
Glentoran,1876,8,11,5,14,32,49,-17,38
Ards,1876,9,9,3,18,36,54,-18,30
Ballinamalla,1876,10,9,3,18,34,54,-20,30
Portadown,1876,11,7,5,18,25,49,-24,26
Linfield,1877,1,16,10,4,55,21,34,58
Crusaders,1877,2,15,7,8,53,45,8,52
Cliftonville,1877,3,16,3,11,52,35,17,51
Ballymena,1877,4,15,6,9,66,56,10,51
Coleraine,1877,5,11,9,10,41,42,-1,42
Portadown,1877,6,11,5,14,24,39,-15,38
Glenavon,1877,7,9,9,12,44,50,-6,36
Ards,1877,8,10,5,15,36,44,-8,35
Glentoran,1877,9,8,10,12,28,40,-12,34
Dungannon,1877,10,8,7,15,41,48,-7,31
Ballinamalla,1877,11,7,7,16,34,54,-20,28
Crusaders,1878,1,20,5,5,64,31,33,65
Linfield,1878,2,14,8,8,55,39,16,50
Ballymena,1878,3,15,5,10,59,56,3,50
Glenavon,1878,4,12,10,8,54,42,12,46
Cliftonville,1878,5,13,4,13,45,43,2,43
Coleraine,1878,6,10,11,9,39,33,6,41
Glentoran,1878,7,10,7,13,31,45,-14,37
Ballinamalla,1878,8,9,7,14,32,53,-21,34
Dungannon,1878,9,7,10,13,49,54,-5,31
Ards,1878,10,8,6,16,35,49,-14,30
Portadown,1878,11,8,5,17,31,49,-18,29
Linfield,1879,1,17,9,4,62,26,36,60
Crusaders,1879,2,16,7,7,51,30,21,55
Ballymena,1879,3,15,7,8,63,54,9,52
Cliftonville,1879,4,16,3,11,55,42,13,51
Coleraine,1879,5,13,12,5,48,38,10,51
Glenavon,1879,6,11,14,5,49,41,8,47
Dungannon,1879,7,10,11,9,57,43,14,41
Glentoran,1879,8,8,7,15,26,51,-25,31
Ards,1879,9,8,6,16,37,55,-18,30
Ballinamalla,1879,10,4,7,19,22,50,-28,19
Portadown,1879,11,3,5,22,21,61,-40,14
Crusaders,1880,1,20,6,4,57,29,28,66
Linfield,1880,2,16,8,6,63,32,31,56
Cliftonville,1880,3,15,5,10,50,40,10,50
Glenavon,1880,4,12,11,7,49,43,6,47
Ballymena,1880,5,13,6,11,54,55,-1,45
Coleraine,1880,6,10,14,6,39,35,4,44
Dungannon,1880,7,9,6,15,50,52,-2,33
Glentoran,1880,8,7,10,13,25,45,-20,31
Portadown,1880,9,8,6,16,25,45,-20,30
Ards,1880,10,7,6,17,34,46,-12,27
Ballinamalla,1880,11,7,4,19,28,52,-24,25
Crusaders,1881,1,17,7,6,56,31,25,58
Ballymena,1881,2,15,5,10,61,59,2,50
Cliftonville,1881,3,14,4,12,50,40,10,46
Linfield,1881,4,11,10,9,50,38,12,43
Glenavon,1881,5,10,13,7,45,38,7,43
Dungannon,1881,6,10,11,9,55,45,10,41
Coleraine,1881,7,9,13,8,36,35,1,40
Glentoran,1881,8,9,10,11,31,36,-5,37
Ballinamalla,1881,9,10,5,15,28,50,-22,35
Ards,1881,10,9,6,15,34,49,-15,33
Portadown,1881,11,7,4,19,23,48,-25,25
Linfield,1882,1,15,8,7,64,37,27,53
Crusaders,1882,2,16,5,9,55,36,19,53
Cliftonville,1882,3,16,5,9,50,36,14,53
Glenavon,1882,4,14,10,6,58,48,10,52
Dungannon,1882,5,12,8,10,57,46,11,44
Coleraine,1882,6,11,11,8,45,41,4,44
Glentoran,1882,7,12,7,11,42,47,-5,43
Ballymena,1882,8,11,5,14,54,65,-11,38
Portadown,1882,9,9,4,17,26,48,-22,31
Ards,1882,10,6,6,18,37,55,-18,24
Ballinamalla,1882,11,5,7,18,30,59,-29,22
Cliftonville,1883,1,20,3,7,68,39,29,63
Linfield,1883,2,15,9,6,67,34,33,54
Crusaders,1883,3,14,6,10,43,37,6,48
Glentoran,1883,4,13,5,12,43,50,-7,44
Ballymena,1883,5,12,6,12,67,73,-6,42
Glenavon,1883,6,9,13,8,47,48,-1,40
Dungannon,1883,7,8,13,9,45,40,5,37
Coleraine,1883,8,9,10,11,34,38,-4,37
Ballinamalla,1883,9,8,7,15,31,46,-15,31
Portadown,1883,10,8,7,15,29,47,-18,31
Ards,1883,11,6,7,17,32,54,-22,25
Cliftonville,1884,1,18,5,7,60,36,24,59
Linfield,1884,2,15,9,6,60,28,32,54
Crusaders,1884,3,16,5,9,52,37,15,53
Ballymena,1884,4,14,7,9,56,54,2,49
Coleraine,1884,5,12,11,7,40,32,8,47
Glenavon,1884,6,11,10,9,43,41,2,43
Dungannon,1884,7,10,8,12,46,44,2,38
Glentoran,1884,8,8,8,14,32,46,-14,32
Ballinamalla,1884,9,8,6,16,34,51,-17,30
Portadown,1884,10,7,6,17,24,51,-27,27
Ards,1884,11,5,7,18,34,61,-27,22
Linfield,1885,1,17,6,7,61,31,30,57
Crusaders,1885,2,14,8,8,47,39,8,50
Coleraine,1885,3,13,10,7,43,31,12,49
Ballymena,1885,4,15,4,11,60,56,4,49
Glenavon,1885,5,13,8,9,54,46,8,47
Cliftonville,1885,6,13,5,12,49,43,6,44
Dungannon,1885,7,11,9,10,52,42,10,42
Ballinamalla,1885,8,10,4,16,29,44,-15,34
Glentoran,1885,9,8,7,15,34,51,-17,31
Ards,1885,10,9,4,17,38,56,-18,31
Portadown,1885,11,6,7,17,22,50,-28,25
Crusaders,1886,1,14,10,6,52,38,14,52
Cliftonville,1886,2,16,4,10,54,43,11,52
Ballymena,1886,3,15,6,9,56,50,6,51
Linfield,1886,4,14,7,9,60,35,25,49
Coleraine,1886,5,11,10,9,46,34,12,43
Glenavon,1886,6,11,9,10,45,48,-3,42
Glentoran,1886,7,10,8,12,32,40,-8,38
Ards,1886,8,9,7,14,35,45,-10,34
Dungannon,1886,9,8,9,13,47,52,-5,33
Portadown,1886,10,9,6,15,28,45,-17,33
Ballinamalla,1886,11,6,8,16,33,58,-25,26
Crusaders,1887,1,16,9,5,53,28,25,57
Linfield,1887,2,15,10,5,59,30,29,55
Glenavon,1887,3,12,13,5,54,40,14,49
Coleraine,1887,4,13,10,7,43,39,4,49
Ballymena,1887,5,12,11,7,55,56,-1,47
Cliftonville,1887,6,14,4,12,45,40,5,46
Glentoran,1887,7,9,10,11,31,37,-6,37
Dungannon,1887,8,8,11,11,47,46,1,35
Ards,1887,9,6,7,17,38,51,-13,25
Ballinamalla,1887,10,6,6,18,26,57,-31,24
Portadown,1887,11,6,5,19,25,52,-27,23
Crusaders,1888,1,14,12,4,58,33,25,54
Linfield,1888,2,14,9,7,51,31,20,51
Coleraine,1888,3,14,9,7,47,34,13,51
Cliftonville,1888,4,16,2,12,49,42,7,50
Glenavon,1888,5,12,11,7,48,40,8,47
Ballymena,1888,6,13,4,13,55,59,-4,43
Dungannon,1888,7,11,7,12,49,48,1,40
Glentoran,1888,8,10,7,13,29,42,-13,37
Portadown,1888,9,9,8,13,31,42,-11,35
Ards,1888,10,8,4,18,30,45,-15,28
Ballinamalla,1888,11,5,5,20,23,54,-31,20
Ballymena,1889,1,16,7,7,61,53,8,55
Glenavon,1889,2,14,10,6,45,39,6,52
Crusaders,1889,3,15,6,9,55,35,20,51
Linfield,1889,4,12,11,7,55,36,19,47
Cliftonville,1889,5,13,5,12,47,43,4,44
Coleraine,1889,6,12,8,10,48,46,2,44
Dungannon,1889,7,9,12,9,47,45,2,39
Ballinamalla,1889,8,9,5,16,35,46,-11,32
Ards,1889,9,9,5,16,38,50,-12,32
Glentoran,1889,10,8,8,14,30,48,-18,32
Portadown,1889,11,6,7,17,23,43,-20,25
Crusaders,1890,1,17,7,6,52,27,25,58
Linfield,1890,2,15,9,6,65,35,30,54
Glentoran,1890,3,15,7,8,37,32,5,52
Ballymena,1890,4,12,10,8,58,54,4,46
Coleraine,1890,5,12,10,8,39,35,4,46
Glenavon,1890,6,11,11,8,41,46,-5,44
Cliftonville,1890,7,13,4,13,47,40,7,43
Dungannon,1890,8,9,9,12,49,48,1,36
Ards,1890,9,7,8,15,34,47,-13,29
Ballinamalla,1890,10,6,6,18,32,59,-27,24
Portadown,1890,11,4,7,19,20,51,-31,19
Crusaders,1891,1,16,5,9,58,32,26,53
Cliftonville,1891,2,16,5,9,50,38,12,53
Ballymena,1891,3,15,7,8,70,53,17,52
Coleraine,1891,4,12,11,7,39,39,0,47
Linfield,1891,5,13,7,10,55,45,10,46
Dungannon,1891,6,11,9,10,51,42,9,42
Glenavon,1891,7,11,9,10,47,46,1,42
Glentoran,1891,8,10,9,11,34,42,-8,39
Ards,1891,9,8,8,14,37,45,-8,32
Ballinamalla,1891,10,8,6,16,24,46,-22,30
Portadown,1891,11,6,2,22,21,58,-37,20
Crusaders,1892,1,18,7,5,54,26,28,61
Linfield,1892,2,16,9,5,59,28,31,57
Glenavon,1892,3,15,10,5,49,38,11,55
Ballymena,1892,4,13,8,9,54,53,1,47
Cliftonville,1892,5,12,7,11,45,43,2,43
Coleraine,1892,6,9,12,9,38,36,2,39
Dungannon,1892,7,9,10,11,44,39,5,37
Ards,1892,8,9,6,15,38,45,-7,33
Glentoran,1892,9,7,9,14,24,43,-19,30
Ballinamalla,1892,10,8,2,20,31,60,-29,26
Portadown,1892,11,5,8,17,22,47,-25,23
Linfield,1893,1,14,12,4,53,24,29,54
Cliftonville,1893,2,14,8,8,53,39,14,50
Glenavon,1893,3,13,11,6,49,44,5,50
Ballymena,1893,4,13,8,9,53,56,-3,47
Crusaders,1893,5,12,7,11,47,46,1,43
Coleraine,1893,6,10,12,8,44,35,9,42
Ards,1893,7,10,6,14,39,47,-8,36
Dungannon,1893,8,8,9,13,46,41,5,33
Glentoran,1893,9,8,9,13,29,44,-15,33
Ballinamalla,1893,10,9,6,15,30,49,-19,33
Portadown,1893,11,7,6,17,29,47,-18,27
Cliftonville,1894,1,18,5,7,62,33,29,59
Crusaders,1894,2,16,11,3,60,32,28,59
Linfield,1894,3,13,8,9,56,40,16,47
Coleraine,1894,4,11,12,7,41,35,6,45
Ballymena,1894,5,13,4,13,63,71,-8,43
Glenavon,1894,6,11,9,10,48,51,-3,42
Dungannon,1894,7,8,11,11,49,51,-2,35
Portadown,1894,8,9,7,14,36,44,-8,34
Glentoran,1894,9,8,8,14,33,49,-16,32
Ards,1894,10,8,6,16,38,54,-16,30
Ballinamalla,1894,11,7,5,18,27,53,-26,26
Crusaders,1895,1,15,9,6,52,37,15,54
Linfield,1895,2,13,9,8,63,40,23,48
Cliftonville,1895,3,15,3,12,52,40,12,48
Ballymena,1895,4,13,9,8,68,63,5,48
Glenavon,1895,5,11,9,10,55,46,9,42
Ballinamalla,1895,6,13,3,14,44,50,-6,42
Coleraine,1895,7,11,9,10,40,49,-9,42
Glentoran,1895,8,9,8,13,35,49,-14,35
Dungannon,1895,9,8,10,12,45,46,-1,34
Ards,1895,10,9,7,14,44,50,-6,34
Portadown,1895,11,8,4,18,24,52,-28,28
Crusaders,1896,1,16,6,8,54,37,17,54
Linfield,1896,2,14,11,5,58,31,27,53
Cliftonville,1896,3,15,6,9,50,38,12,51
Glenavon,1896,4,11,12,7,54,47,7,45
Coleraine,1896,5,10,13,7,47,43,4,43
Dungannon,1896,6,9,13,8,51,39,12,40
Ballymena,1896,7,11,7,12,52,61,-9,40
Glentoran,1896,8,8,9,13,26,40,-14,33
Ballinamalla,1896,9,9,3,18,32,55,-23,30
Ards,1896,10,7,8,15,29,45,-16,29
Portadown,1896,11,7,8,15,28,45,-17,29
Crusaders,1897,1,19,4,7,57,37,20,61
Cliftonville,1897,2,18,4,8,53,34,19,58
Linfield,1897,3,15,9,6,60,29,31,54
Ballymena,1897,4,14,6,10,60,55,5,48
Coleraine,1897,5,11,9,10,45,39,6,42
Glenavon,1897,6,10,12,8,39,39,0,42
Dungannon,1897,7,10,9,11,55,42,13,39
Glentoran,1897,8,10,8,12,29,41,-12,38
Ballinamalla,1897,9,9,5,16,33,50,-17,32
Ards,1897,10,6,4,20,28,56,-28,22
Portadown,1897,11,6,4,20,26,63,-37,22
Crusaders,1898,1,16,9,5,56,30,26,57
Ballymena,1898,2,17,3,10,61,55,6,54
Linfield,1898,3,14,10,6,59,33,26,52
Glenavon,1898,4,13,9,8,49,43,6,48
Coleraine,1898,5,12,11,7,44,39,5,47
Dungannon,1898,6,11,11,8,47,38,9,44
Cliftonville,1898,7,13,5,12,45,44,1,44
Ards,1898,8,11,6,13,40,46,-6,39
Glentoran,1898,9,5,10,15,31,49,-18,25
Ballinamalla,1898,10,6,6,18,27,50,-23,24
Portadown,1898,11,4,6,20,19,51,-32,18
Crusaders,1899,1,15,8,7,53,37,16,53
Linfield,1899,2,14,9,7,58,31,27,51
Coleraine,1899,3,13,12,5,46,34,12,51
Cliftonville,1899,4,14,7,9,56,38,18,49
Dungannon,1899,5,10,10,10,54,50,4,40
Ballymena,1899,6,11,6,13,48,60,-12,39
Glenavon,1899,7,9,11,10,44,49,-5,38
Glentoran,1899,8,10,7,13,28,42,-14,37
Ards,1899,9,10,6,14,39,48,-9,36
Ballinamalla,1899,10,10,4,16,34,48,-14,34
Portadown,1899,11,6,6,18,32,55,-23,24
Crusaders,1900,1,16,10,4,56,32,24,58
Linfield,1900,2,15,10,5,61,32,29,55
Cliftonville,1900,3,16,5,9,56,40,16,53
Glenavon,1900,4,14,7,9,52,43,9,49
Ballymena,1900,5,14,5,11,68,58,10,47
Coleraine,1900,6,9,11,10,35,44,-9,38
Ards,1900,7,10,6,14,36,44,-8,36
Dungannon,1900,8,8,8,14,42,48,-6,32
Glentoran,1900,9,8,8,14,27,41,-14,32
Ballinamalla,1900,10,9,3,18,28,52,-24,30
Portadown,1900,11,6,7,17,25,52,-27,25
Linfield,1901,1,16,8,6,63,37,26,56
Crusaders,1901,2,16,6,8,56,37,19,54
Cliftonville,1901,3,13,9,8,52,36,16,48
Ballymena,1901,4,14,5,11,57,63,-6,47
Coleraine,1901,5,11,13,6,42,38,4,46
Dungannon,1901,6,11,10,9,51,47,4,43
Glenavon,1901,7,8,12,10,52,58,-6,36
Glentoran,1901,8,10,5,15,34,43,-9,35
Ards,1901,9,9,7,14,40,47,-7,34
Portadown,1901,10,8,4,18,31,51,-20,28
Ballinamalla,1901,11,7,5,18,34,55,-21,26
Crusaders,1902,1,16,8,6,60,34,26,56
Cliftonville,1902,2,17,4,9,55,38,17,55
Ballymena,1902,3,14,7,9,63,58,5,49
Linfield,1902,4,12,10,8,51,36,15,46
Glenavon,1902,5,12,10,8,52,47,5,46
Coleraine,1902,6,10,13,7,41,36,5,43
Dungannon,1902,7,10,8,12,47,46,1,38
Glentoran,1902,8,9,9,12,36,47,-11,36
Portadown,1902,9,7,7,16,29,48,-19,28
Ards,1902,10,7,6,17,37,58,-21,27
Ballinamalla,1902,11,6,8,16,31,54,-23,26
Cliftonville,1903,1,17,6,7,57,33,24,57
Crusaders,1903,2,16,6,8,49,36,13,54
Linfield,1903,3,14,11,5,57,27,30,53
Coleraine,1903,4,12,9,9,41,44,-3,45
Ballymena,1903,5,13,5,12,59,60,-1,44
Glentoran,1903,6,12,6,12,31,44,-13,42
Glenavon,1903,7,9,11,10,42,45,-3,38
Ballinamalla,1903,8,10,4,16,25,44,-19,34
Dungannon,1903,9,8,9,13,49,49,0,33
Ards,1903,10,8,7,15,39,47,-8,31
Portadown,1903,11,6,6,18,23,43,-20,24
Cliftonville,1904,1,16,4,10,52,36,16,52
Linfield,1904,2,14,8,8,62,39,23,50
Crusaders,1904,3,14,7,9,50,41,9,49
Ballymena,1904,4,14,7,9,51,54,-3,49
Coleraine,1904,5,12,10,8,40,40,0,46
Glentoran,1904,6,12,7,11,31,37,-6,43
Glenavon,1904,7,10,9,11,45,42,3,39
Dungannon,1904,8,10,7,13,50,46,4,37
Portadown,1904,9,9,7,14,31,43,-12,34
Ards,1904,10,9,3,18,34,49,-15,30
Ballinamalla,1904,11,8,5,17,33,52,-19,29
Linfield,1905,1,17,8,5,59,27,32,59
Cliftonville,1905,2,17,6,7,66,45,21,57
Ballymena,1905,3,15,5,10,58,56,2,50
Crusaders,1905,4,14,7,9,52,39,13,49
Dungannon,1905,5,12,9,9,55,45,10,45
Glenavon,1905,6,12,8,10,57,51,6,44
Coleraine,1905,7,8,12,10,35,44,-9,36
Glentoran,1905,8,9,6,15,31,46,-15,33
Ards,1905,9,8,6,16,35,49,-14,30
Portadown,1905,10,7,6,17,27,48,-21,27
Ballinamalla,1905,11,8,3,19,27,52,-25,27
Cliftonville,1906,1,16,5,9,52,42,10,53
Dungannon,1906,2,14,9,7,55,36,19,51
Coleraine,1906,3,13,10,7,47,34,13,49
Ballymena,1906,4,14,6,10,58,56,2,48
Glenavon,1906,5,11,11,8,52,45,7,44
Linfield,1906,6,10,13,7,47,33,14,43
Crusaders,1906,7,12,6,12,48,38,10,42
Glentoran,1906,8,11,7,12,31,41,-10,40
Ards,1906,9,12,3,15,39,47,-8,39
Portadown,1906,10,7,7,16,26,50,-24,28
Ballinamalla,1906,11,5,3,22,24,57,-33,18
Cliftonville,1907,1,18,4,8,58,34,24,58
Linfield,1907,2,15,7,8,61,36,25,52
Crusaders,1907,3,14,10,6,53,38,15,52
Ballymena,1907,4,12,7,11,55,64,-9,43
Coleraine,1907,5,10,9,11,39,42,-3,39
Ballinamalla,1907,6,12,3,15,37,52,-15,39
Ards,1907,7,11,4,15,43,50,-7,37
Glenavon,1907,8,9,9,12,44,47,-3,36
Dungannon,1907,9,9,8,13,52,48,4,35
Glentoran,1907,10,9,8,13,33,47,-14,35
Portadown,1907,11,9,5,16,26,43,-17,32
Crusaders,1908,1,15,8,7,59,43,16,53
Coleraine,1908,2,13,10,7,44,40,4,49
Ballymena,1908,3,14,6,10,56,54,2,48
Cliftonville,1908,4,14,4,12,48,44,4,46
Linfield,1908,5,11,11,8,60,41,19,44
Glenavon,1908,6,11,9,10,49,44,5,42
Dungannon,1908,7,9,9,12,49,44,5,36
Glentoran,1908,8,9,8,13,38,50,-12,35
Ards,1908,9,9,7,14,39,48,-9,34
Ballinamalla,1908,10,10,4,16,31,51,-20,34
Portadown,1908,11,9,6,15,32,46,-14,33
Crusaders,1909,1,19,8,3,65,35,30,65
Linfield,1909,2,15,7,8,58,39,19,52
Coleraine,1909,3,13,10,7,43,33,10,49
Glenavon,1909,4,12,12,6,47,41,6,48
Ballymena,1909,5,14,5,11,59,60,-1,47
Cliftonville,1909,6,13,4,13,47,45,2,43
Dungannon,1909,7,10,10,10,59,48,11,40
Ards,1909,8,10,5,15,41,50,-9,35
Glentoran,1909,9,7,8,15,25,43,-18,29
Portadown,1909,10,7,5,18,24,48,-24,26
Ballinamalla,1909,11,6,4,20,29,55,-26,22
Crusaders,1910,1,17,6,7,50,37,13,57
Linfield,1910,2,14,10,6,57,34,23,52
Glenavon,1910,3,13,10,7,54,46,8,49
Cliftonville,1910,4,15,4,11,47,39,8,49
Ballymena,1910,5,13,6,11,57,56,1,45
Coleraine,1910,6,11,10,9,41,37,4,43
Dungannon,1910,7,11,9,10,57,45,12,42
Ards,1910,8,10,5,15,39,46,-7,35
Glentoran,1910,9,8,10,12,26,40,-14,34
Ballinamalla,1910,10,9,3,18,27,48,-21,30
Portadown,1910,11,6,3,21,23,50,-27,21
Crusaders,1911,1,16,11,3,55,32,23,59
Glenavon,1911,2,13,10,7,49,42,7,49
Linfield,1911,3,13,8,9,58,35,23,47
Glentoran,1911,4,13,6,11,35,36,-1,45
Coleraine,1911,5,10,12,8,43,40,3,42
Ballymena,1911,6,10,12,8,54,58,-4,42
Cliftonville,1911,7,11,8,11,50,43,7,41
Dungannon,1911,8,9,10,11,50,45,5,37
Ards,1911,9,7,7,16,36,53,-17,28
Portadown,1911,10,6,10,14,22,44,-22,28
Ballinamalla,1911,11,8,4,18,29,53,-24,28
Crusaders,1912,1,14,8,8,53,40,13,50
Cliftonville,1912,2,14,8,8,51,40,11,50
Linfield,1912,3,13,9,8,50,27,23,48
Dungannon,1912,4,12,11,7,53,40,13,47
Coleraine,1912,5,12,7,11,41,38,3,43
Ballymena,1912,6,11,9,10,51,60,-9,42
Glenavon,1912,7,9,12,9,43,47,-4,39
Glentoran,1912,8,10,8,12,34,41,-7,38
Ards,1912,9,11,3,16,43,47,-4,36
Ballinamalla,1912,10,9,6,15,32,50,-18,33
Portadown,1912,11,7,5,18,25,46,-21,26
Linfield,1913,1,14,10,6,61,35,26,52
Crusaders,1913,2,15,7,8,59,40,19,52
Glenavon,1913,3,14,9,7,58,48,10,51
Cliftonville,1913,4,14,6,10,47,38,9,48
Dungannon,1913,5,12,9,9,57,45,12,45
Ballymena,1913,6,13,6,11,53,58,-5,45
Coleraine,1913,7,10,11,9,52,43,9,41
Glentoran,1913,8,11,7,12,35,45,-10,40
Ards,1913,9,12,3,15,44,57,-13,39
Ballinamalla,1913,10,7,3,20,33,59,-26,24
Portadown,1913,11,5,5,20,23,54,-31,20
Cliftonville,1914,1,19,4,7,67,44,23,61
Crusaders,1914,2,15,10,5,57,37,20,55
Linfield,1914,3,13,10,7,61,33,28,49
Ballymena,1914,4,14,6,10,53,51,2,48
Coleraine,1914,5,10,9,11,46,42,4,39
Dungannon,1914,6,10,9,11,44,42,2,39
Glenavon,1914,7,8,13,9,46,50,-4,37
Portadown,1914,8,10,5,15,29,42,-13,35
Glentoran,1914,9,9,6,15,27,48,-21,33
Ards,1914,10,8,6,16,38,58,-20,30
Ballinamalla,1914,11,8,4,18,26,47,-21,28
Crusaders,1915,1,16,7,7,59,40,19,55
Cliftonville,1915,2,17,4,9,55,36,19,55
Ballymena,1915,3,15,6,9,61,56,5,51
Glenavon,1915,4,11,13,6,51,45,6,46
Linfield,1915,5,11,12,7,56,36,20,45
Coleraine,1915,6,10,10,10,35,42,-7,40
Dungannon,1915,7,9,7,14,49,45,4,34
Ards,1915,8,9,7,14,43,50,-7,34
Glentoran,1915,9,9,6,15,32,47,-15,33
Portadown,1915,10,9,5,16,28,48,-20,32
Ballinamalla,1915,11,8,5,17,28,52,-24,29
Linfield,1916,1,17,8,5,65,32,33,59
Crusaders,1916,2,18,5,7,56,35,21,59
Cliftonville,1916,3,15,5,10,51,41,10,50
Coleraine,1916,4,11,12,7,47,41,6,45
Ballymena,1916,5,12,7,11,59,62,-3,43
Dungannon,1916,6,10,12,8,53,42,11,42
Glenavon,1916,7,9,12,9,48,45,3,39
Ards,1916,8,10,6,14,40,50,-10,36
Portadown,1916,9,9,6,15,28,42,-14,33
Glentoran,1916,10,5,9,16,29,50,-21,24
Ballinamalla,1916,11,6,4,20,28,64,-36,22
Linfield,1917,1,17,6,7,57,27,30,57
Cliftonville,1917,2,17,5,8,62,40,22,56
Ballymena,1917,3,17,4,9,69,57,12,55
Crusaders,1917,4,15,7,8,49,33,16,52
Dungannon,1917,5,11,9,10,50,43,7,42
Coleraine,1917,6,11,9,10,41,40,1,42
Glenavon,1917,7,10,10,10,42,43,-1,40
Glentoran,1917,8,10,6,14,27,43,-16,36
Ballinamalla,1917,9,10,3,17,36,57,-21,33
Ards,1917,10,8,3,19,36,53,-17,27
Portadown,1917,11,6,4,20,23,56,-33,22
Crusaders,1918,1,15,9,6,57,37,20,54
Linfield,1918,2,12,11,7,49,29,20,47
Glenavon,1918,3,13,8,9,44,41,3,47
Ballymena,1918,4,13,7,10,52,55,-3,46
Cliftonville,1918,5,13,6,11,49,38,11,45
Dungannon,1918,6,11,9,10,45,37,8,42
Coleraine,1918,7,10,11,9,41,41,0,41
Ballinamalla,1918,8,11,6,13,33,46,-13,39
Ards,1918,9,9,7,14,38,45,-7,34
Portadown,1918,10,9,5,16,27,41,-14,32
Glentoran,1918,11,5,9,16,22,47,-25,24
Linfield,1919,1,17,8,5,67,28,39,59
Crusaders,1919,2,16,10,4,62,35,27,58
Cliftonville,1919,3,13,7,10,50,38,12,46
Ballymena,1919,4,13,7,10,55,61,-6,46
Dungannon,1919,5,10,13,7,50,43,7,43
Coleraine,1919,6,10,12,8,44,42,2,42
Glenavon,1919,7,9,15,6,46,46,0,42
Glentoran,1919,8,7,11,12,32,47,-15,32
Ards,1919,9,7,7,16,38,53,-15,28
Ballinamalla,1919,10,7,6,17,27,49,-22,27
Portadown,1919,11,5,6,19,21,50,-29,21
Linfield,1920,1,15,8,7,57,34,23,53
Crusaders,1920,2,15,7,8,49,36,13,52
Cliftonville,1920,3,16,3,11,58,44,14,51
Ballymena,1920,4,14,6,10,58,55,3,48
Glenavon,1920,5,12,11,7,57,47,10,47
Ards,1920,6,13,3,14,43,45,-2,42
Dungannon,1920,7,10,11,9,51,44,7,41
Coleraine,1920,8,9,10,11,43,52,-9,37
Ballinamalla,1920,9,10,4,16,35,48,-13,34
Glentoran,1920,10,7,8,15,26,47,-21,29
Portadown,1920,11,5,7,18,22,47,-25,22
Linfield,1921,1,15,10,5,59,31,28,55
Cliftonville,1921,2,16,5,9,56,36,20,53
Coleraine,1921,3,14,8,8,40,35,5,50
Crusaders,1921,4,14,6,10,55,41,14,48
Dungannon,1921,5,13,8,9,57,46,11,47
Ballymena,1921,6,13,4,13,61,67,-6,43
Glenavon,1921,7,10,9,11,40,42,-2,39
Ards,1921,8,11,5,14,37,49,-12,38
Ballinamalla,1921,9,10,3,17,33,52,-19,33
Glentoran,1921,10,7,9,14,31,45,-14,30
Portadown,1921,11,7,3,20,23,48,-25,24
Glenavon,1922,1,16,9,5,57,41,16,57
Crusaders,1922,2,15,8,7,52,37,15,53
Linfield,1922,3,14,10,6,53,31,22,52
Cliftonville,1922,4,14,9,7,55,36,19,51
Coleraine,1922,5,10,13,7,42,39,3,43
Dungannon,1922,6,10,9,11,48,41,7,39
Ards,1922,7,12,3,15,40,47,-7,39
Ballymena,1922,8,11,6,13,53,62,-9,39
Glentoran,1922,9,9,8,13,31,50,-19,35
Portadown,1922,10,6,6,18,26,47,-21,24
Ballinamalla,1922,11,5,5,20,22,48,-26,20
Linfield,1923,1,15,12,3,56,26,30,57
Cliftonville,1923,2,17,2,11,59,40,19,53
Crusaders,1923,3,15,8,7,58,39,19,53
Coleraine,1923,4,12,12,6,52,37,15,48
Ballymena,1923,5,13,6,11,54,59,-5,45
Dungannon,1923,6,11,9,10,50,48,2,42
Ards,1923,7,10,6,14,38,49,-11,36
Ballinamalla,1923,8,11,1,18,34,47,-13,34
Glenavon,1923,9,7,10,13,41,56,-15,31
Glentoran,1923,10,7,9,14,28,43,-15,30
Portadown,1923,11,6,7,17,23,49,-26,25
Crusaders,1924,1,17,6,7,59,39,20,57
Linfield,1924,2,15,8,7,58,33,25,53
Cliftonville,1924,3,16,4,10,52,35,17,52
Ballymena,1924,4,15,4,11,62,59,3,49
Coleraine,1924,5,10,9,11,40,42,-2,39
Glenavon,1924,6,9,11,10,43,49,-6,38
Portadown,1924,7,11,4,15,32,44,-12,37
Dungannon,1924,8,8,11,11,43,40,3,35
Ballinamalla,1924,9,10,3,17,25,45,-20,33
Ards,1924,10,8,8,14,39,53,-14,32
Glentoran,1924,11,8,8,14,33,47,-14,32
Crusaders,1925,1,16,8,6,53,34,19,56
Linfield,1925,2,14,12,4,60,29,31,54
Cliftonville,1925,3,14,6,10,53,43,10,48
Ballymena,1925,4,11,11,8,56,56,0,44
Glenavon,1925,5,10,12,8,40,41,-1,42
Ards,1925,6,12,5,13,48,47,1,41
Coleraine,1925,7,10,9,11,42,45,-3,39
Dungannon,1925,8,10,8,12,51,50,1,38
Glentoran,1925,9,8,10,12,29,40,-11,34
Portadown,1925,10,7,7,16,27,45,-18,28
Ballinamalla,1925,11,7,4,19,23,52,-29,25
Crusaders,1926,1,15,10,5,53,31,22,55
Linfield,1926,2,15,9,6,57,29,28,54
Cliftonville,1926,3,16,4,10,53,40,13,52
Glenavon,1926,4,11,13,6,44,43,1,46
Ards,1926,5,13,4,13,43,39,4,43
Ballymena,1926,6,12,7,11,52,59,-7,43
Coleraine,1926,7,10,9,11,41,39,2,39
Dungannon,1926,8,9,10,11,51,49,2,37
Glentoran,1926,9,10,7,13,34,48,-14,37
Portadown,1926,10,7,6,17,25,42,-17,27
Ballinamalla,1926,11,5,5,20,22,56,-34,20
Linfield,1927,1,15,12,3,59,28,31,57
Cliftonville,1927,2,17,5,8,49,33,16,56
Ballymena,1927,3,15,4,11,56,58,-2,49
Crusaders,1927,4,13,5,12,50,46,4,44
Coleraine,1927,5,11,10,9,40,31,9,43
Glenavon,1927,6,10,12,8,41,42,-1,42
Dungannon,1927,7,9,11,10,49,44,5,38
Ards,1927,8,11,5,14,45,50,-5,38
Glentoran,1927,9,10,6,14,37,44,-7,36
Portadown,1927,10,7,7,16,26,44,-18,28
Ballinamalla,1927,11,7,3,20,31,63,-32,24
Linfield,1928,1,17,8,5,65,30,35,59
Crusaders,1928,2,15,9,6,51,33,18,54
Glenavon,1928,3,13,10,7,58,42,16,49
Ballymena,1928,4,12,8,10,56,60,-4,44
Coleraine,1928,5,10,10,10,44,43,1,40
Glentoran,1928,6,10,9,11,35,38,-3,39
Cliftonville,1928,7,10,8,12,45,47,-2,38
Ards,1928,8,11,5,14,40,46,-6,38
Dungannon,1928,9,8,11,11,46,47,-1,35
Ballinamalla,1928,10,9,4,17,24,49,-25,31
Portadown,1928,11,6,6,18,23,52,-29,24
Cliftonville,1929,1,19,4,7,64,37,27,61
Ballymena,1929,2,17,3,10,62,58,4,54
Glenavon,1929,3,14,9,7,55,40,15,51
Coleraine,1929,4,14,9,7,45,36,9,51
Linfield,1929,5,13,10,7,56,35,21,49
Crusaders,1929,6,14,6,10,54,41,13,48
Dungannon,1929,7,8,11,11,46,48,-2,35
Ards,1929,8,8,5,17,37,55,-18,29
Glentoran,1929,9,7,7,16,32,49,-17,28
Portadown,1929,10,8,4,18,27,53,-26,28
Ballinamalla,1929,11,6,6,18,25,51,-26,24
Crusaders,1930,1,18,6,6,55,29,26,60
Cliftonville,1930,2,17,6,7,59,34,25,57
Ballymena,1930,3,17,6,7,58,46,12,57
Linfield,1930,4,14,10,6,61,37,24,52
Coleraine,1930,5,11,12,7,47,41,6,45
Dungannon,1930,6,9,9,12,51,51,0,36
Glentoran,1930,7,10,5,15,29,43,-14,35
Glenavon,1930,8,8,10,12,45,52,-7,34
Ards,1930,9,8,4,18,32,52,-20,28
Ballinamalla,1930,10,7,5,18,29,54,-25,26
Portadown,1930,11,6,7,17,24,51,-27,25
Crusaders,1931,1,17,6,7,62,37,25,57
Linfield,1931,2,14,11,5,53,28,25,53
Ballymena,1931,3,14,7,9,64,61,3,49
Cliftonville,1931,4,14,4,12,52,46,6,46
Glenavon,1931,5,11,10,9,48,49,-1,43
Dungannon,1931,6,10,12,8,52,42,10,42
Coleraine,1931,7,10,10,10,43,43,0,40
Glentoran,1931,8,9,7,14,25,44,-19,34
Ards,1931,9,7,9,14,37,47,-10,30
Portadown,1931,10,6,12,12,27,41,-14,30
Ballinamalla,1931,11,6,6,18,28,53,-25,24
Linfield,1932,1,17,8,5,64,34,30,59
Crusaders,1932,2,14,11,5,54,34,20,53
Ballymena,1932,3,15,8,7,61,51,10,53
Cliftonville,1932,4,15,7,8,62,47,15,52
Coleraine,1932,5,13,10,7,45,37,8,49
Glenavon,1932,6,9,10,11,47,55,-8,37
Ballinamalla,1932,7,11,4,15,35,45,-10,37
Ards,1932,8,9,4,17,35,48,-13,31
Dungannon,1932,9,7,9,14,42,47,-5,30
Glentoran,1932,10,7,9,14,30,44,-14,30
Portadown,1932,11,5,6,19,21,54,-33,21
Glenavon,1933,1,15,10,5,52,36,16,55
Crusaders,1933,2,15,9,6,54,34,20,54
Ballymena,1933,3,15,8,7,57,51,6,53
Linfield,1933,4,13,9,8,55,37,18,48
Cliftonville,1933,5,13,7,10,53,42,11,46
Coleraine,1933,6,11,12,7,44,41,3,45
Dungannon,1933,7,8,11,11,46,43,3,35
Ards,1933,8,9,7,14,37,49,-12,34
Glentoran,1933,9,9,6,15,29,40,-11,33
Portadown,1933,10,7,4,19,22,48,-26,25
Ballinamalla,1933,11,6,5,19,22,50,-28,23
Crusaders,1934,1,15,9,6,50,29,21,54
Ballymena,1934,2,15,6,9,66,57,9,51
Glenavon,1934,3,14,9,7,44,39,5,51
Coleraine,1934,4,12,12,6,51,45,6,48
Linfield,1934,5,11,14,5,51,30,21,47
Cliftonville,1934,6,13,7,10,55,45,10,46
Dungannon,1934,7,8,12,10,43,40,3,36
Ards,1934,8,8,7,15,36,47,-11,31
Glentoran,1934,9,8,7,15,30,47,-17,31
Ballinamalla,1934,10,6,8,16,29,50,-21,26
Portadown,1934,11,7,5,18,20,46,-26,26
Cliftonville,1935,1,18,5,7,61,31,30,59
Linfield,1935,2,16,8,6,62,27,35,56
Crusaders,1935,3,16,6,8,44,30,14,54
Ballymena,1935,4,15,7,8,56,53,3,52
Glenavon,1935,5,11,10,9,45,40,5,43
Coleraine,1935,6,10,12,8,43,44,-1,42
Ballinamalla,1935,7,9,6,15,35,54,-19,33
Glentoran,1935,8,8,7,15,23,42,-19,31
Dungannon,1935,9,6,12,12,41,46,-5,30
Ards,1935,10,8,6,16,30,48,-18,30
Portadown,1935,11,4,9,17,18,43,-25,21
Crusaders,1936,1,17,8,5,56,31,25,59
Linfield,1936,2,16,8,6,61,31,30,56
Cliftonville,1936,3,16,5,9,60,42,18,53
Dungannon,1936,4,11,10,9,51,45,6,43
Glenavon,1936,5,10,13,7,47,47,0,43
Coleraine,1936,6,9,12,9,40,45,-5,39
Glentoran,1936,7,10,7,13,34,43,-9,37
Ballymena,1936,8,9,9,12,48,57,-9,36
Ards,1936,9,11,3,16,40,49,-9,36
Ballinamalla,1936,10,6,7,17,32,55,-23,25
Portadown,1936,11,5,8,17,24,48,-24,23
Crusaders,1937,1,16,9,5,50,27,23,57
Cliftonville,1937,2,16,7,7,55,31,24,55
Linfield,1937,3,15,8,7,49,25,24,53
Ballymena,1937,4,12,7,11,45,58,-13,43
Coleraine,1937,5,9,15,6,34,30,4,42
Dungannon,1937,6,10,10,10,56,45,11,40
Ards,1937,7,12,3,15,39,43,-4,39
Glenavon,1937,8,9,10,11,43,47,-4,37
Glentoran,1937,9,8,9,13,27,46,-19,33
Portadown,1937,10,7,7,16,31,49,-18,28
Ballinamalla,1937,11,5,7,18,27,55,-28,22
Crusaders,1938,1,18,9,3,58,28,30,63
Linfield,1938,2,16,8,6,63,32,31,56
Glenavon,1938,3,15,9,6,59,44,15,54
Cliftonville,1938,4,15,4,11,52,35,17,49
Ballymena,1938,5,13,8,9,60,57,3,47
Coleraine,1938,6,10,10,10,43,41,2,40
Glentoran,1938,7,11,7,12,33,43,-10,40
Portadown,1938,8,8,6,16,26,47,-21,30
Dungannon,1938,9,6,10,14,39,51,-12,28
Ballinamalla,1938,10,7,6,17,30,57,-27,27
Ards,1938,11,5,5,20,32,60,-28,20
Crusaders,1939,1,16,8,6,55,36,19,56
Ballymena,1939,2,17,4,9,62,52,10,55
Linfield,1939,3,14,9,7,59,35,24,51
Cliftonville,1939,4,14,7,9,52,38,14,49
Coleraine,1939,5,12,9,9,44,48,-4,45
Dungannon,1939,6,11,8,11,57,43,14,41
Glenavon,1939,7,9,13,8,56,54,2,40
Glentoran,1939,8,9,7,14,30,47,-17,34
Portadown,1939,9,9,5,16,32,48,-16,32
Ballinamalla,1939,10,7,6,17,35,56,-21,27
Ards,1939,11,6,6,18,34,59,-25,24
Crusaders,1940,1,17,7,6,55,39,16,58
Linfield,1940,2,13,10,7,60,29,31,49
Coleraine,1940,3,12,12,6,43,34,9,48
Glenavon,1940,4,12,10,8,50,47,3,46
Ballymena,1940,5,13,7,10,54,58,-4,46
Cliftonville,1940,6,12,7,11,47,43,4,43
Glentoran,1940,7,10,7,13,29,41,-12,37
Dungannon,1940,8,8,12,10,50,40,10,36
Ballinamalla,1940,9,8,7,15,34,49,-15,31
Ards,1940,10,8,6,16,35,53,-18,30
Portadown,1940,11,6,7,17,20,44,-24,25
Linfield,1941,1,18,7,5,67,27,40,61
Crusaders,1941,2,15,7,8,54,42,12,52
Cliftonville,1941,3,14,6,10,54,42,12,48
Ballymena,1941,4,13,8,9,61,61,0,47
Glenavon,1941,5,10,14,6,46,43,3,44
Coleraine,1941,6,11,11,8,44,41,3,44
Dungannon,1941,7,10,11,9,49,40,9,41
Glentoran,1941,8,10,6,14,36,53,-17,36
Ballinamalla,1941,9,8,3,19,32,51,-19,27
Ards,1941,10,6,8,16,37,54,-17,26
Portadown,1941,11,6,7,17,29,55,-26,25
Linfield,1942,1,16,8,6,56,29,27,56
Crusaders,1942,2,16,6,8,59,39,20,54
Cliftonville,1942,3,14,6,10,49,32,17,48
Dungannon,1942,4,12,11,7,54,37,17,47
Ballymena,1942,5,13,7,10,51,57,-6,46
Coleraine,1942,6,10,10,10,42,43,-1,40
Ballinamalla,1942,7,11,6,13,33,45,-12,39
Ards,1942,8,10,7,13,47,51,-4,37
Glenavon,1942,9,8,13,9,42,49,-7,37
Glentoran,1942,10,7,4,19,26,54,-28,25
Portadown,1942,11,6,6,18,20,43,-23,24
Crusaders,1943,1,16,8,6,49,31,18,56
Cliftonville,1943,2,17,4,9,57,38,19,55
Linfield,1943,3,13,12,5,58,31,27,51
Ballymena,1943,4,14,7,9,61,57,4,49
Coleraine,1943,5,12,12,6,46,38,8,48
Glenavon,1943,6,12,9,9,47,43,4,45
Dungannon,1943,7,9,12,9,49,41,8,39
Glentoran,1943,8,8,7,15,28,46,-18,31
Ballinamalla,1943,9,8,4,18,34,55,-21,28
Ards,1943,10,5,10,15,31,50,-19,25
Portadown,1943,11,5,7,18,20,50,-30,22
Linfield,1944,1,16,10,4,69,32,37,58
Crusaders,1944,2,16,8,6,52,34,18,56
Cliftonville,1944,3,14,8,8,55,35,20,50
Ballymena,1944,4,13,6,11,55,62,-7,45
Glenavon,1944,5,10,13,7,47,44,3,43
Coleraine,1944,6,10,11,9,35,37,-2,41
Dungannon,1944,7,10,10,10,47,48,-1,40
Glentoran,1944,8,10,7,13,39,45,-6,37
Portadown,1944,9,8,6,16,30,49,-19,30
Ards,1944,10,7,6,17,32,49,-17,27
Ballinamalla,1944,11,6,5,19,27,53,-26,23
Linfield,1945,1,16,9,5,68,35,33,57
Crusaders,1945,2,14,8,8,49,35,14,50
Ballymena,1945,3,13,6,11,61,59,2,45
Glenavon,1945,4,11,12,7,49,47,2,45
Cliftonville,1945,5,13,6,11,46,45,1,45
Dungannon,1945,6,11,10,9,52,44,8,43
Coleraine,1945,7,11,10,9,40,34,6,43
Ards,1945,8,11,4,15,36,46,-10,37
Glentoran,1945,9,7,10,13,30,43,-13,31
Portadown,1945,10,7,8,15,24,40,-16,29
Ballinamalla,1945,11,7,5,18,25,52,-27,26
Cliftonville,1946,1,17,7,6,57,35,22,58
Crusaders,1946,2,16,6,8,54,41,13,54
Linfield,1946,3,13,12,5,54,30,24,51
Ballymena,1946,4,13,6,11,54,61,-7,45
Coleraine,1946,5,10,13,7,41,33,8,43
Dungannon,1946,6,10,10,10,50,40,10,40
Glenavon,1946,7,9,13,8,46,46,0,40
Glentoran,1946,8,9,10,11,29,38,-9,37
Ards,1946,9,9,8,13,41,49,-8,35
Ballinamalla,1946,10,6,7,17,28,51,-23,25
Portadown,1946,11,5,4,21,19,49,-30,19
Crusaders,1947,1,16,9,5,54,31,23,57
Ballymena,1947,2,15,7,8,59,57,2,52
Linfield,1947,3,13,9,8,58,33,25,48
Dungannon,1947,4,13,6,11,51,42,9,45
Cliftonville,1947,5,12,8,10,48,39,9,44
Glenavon,1947,6,10,10,10,42,48,-6,40
Ards,1947,7,11,6,13,40,46,-6,39
Coleraine,1947,8,9,10,11,37,38,-1,37
Ballinamalla,1947,9,11,4,15,41,52,-11,37
Portadown,1947,10,9,4,17,23,43,-20,31
Glentoran,1947,11,6,7,17,24,48,-24,25
Crusaders,1948,1,18,8,4,56,28,28,62
Cliftonville,1948,2,16,5,9,58,36,22,53
Linfield,1948,3,14,8,8,62,37,25,50
Glenavon,1948,4,12,12,6,48,40,8,48
Ballymena,1948,5,15,3,12,50,60,-10,48
Coleraine,1948,6,12,8,10,44,37,7,44
Dungannon,1948,7,9,9,12,44,42,2,36
Glentoran,1948,8,9,8,13,31,44,-13,35
Ards,1948,9,8,7,15,40,54,-14,31
Ballinamalla,1948,10,7,9,14,31,51,-20,30
Portadown,1948,11,3,7,20,23,58,-35,16
Crusaders,1949,1,20,6,4,61,28,33,66
Linfield,1949,2,14,11,5,57,32,25,53
Glenavon,1949,3,13,9,8,53,42,11,48
Cliftonville,1949,4,13,7,10,50,43,7,46
Coleraine,1949,5,11,10,9,46,46,0,43
Ballymena,1949,6,11,9,10,49,51,-2,42
Dungannon,1949,7,10,10,10,45,41,4,40
Ballinamalla,1949,8,10,5,15,35,45,-10,35
Glentoran,1949,9,7,9,14,27,49,-22,30
Ards,1949,10,6,6,18,31,50,-19,24
Portadown,1949,11,5,8,17,19,46,-27,23
Crusaders,1950,1,18,5,7,54,33,21,59
Linfield,1950,2,14,8,8,66,42,24,50
Cliftonville,1950,3,14,5,11,50,43,7,47
Dungannon,1950,4,13,7,10,54,39,15,46
Ballymena,1950,5,13,6,11,61,58,3,45
Glenavon,1950,6,11,10,9,44,45,-1,43
Ards,1950,7,12,4,14,45,45,0,40
Coleraine,1950,8,10,8,12,38,47,-9,38
Glentoran,1950,9,9,8,13,31,44,-13,35
Portadown,1950,10,8,7,15,25,48,-23,31
Ballinamalla,1950,11,7,4,19,34,58,-24,25
Crusaders,1951,1,18,7,5,62,35,27,61
Cliftonville,1951,2,14,8,8,52,38,14,50
Ballymena,1951,3,15,5,10,56,61,-5,50
Linfield,1951,4,13,10,7,54,33,21,49
Coleraine,1951,5,13,10,7,45,39,6,49
Dungannon,1951,6,12,7,11,60,47,13,43
Glenavon,1951,7,10,10,10,50,57,-7,40
Ards,1951,8,11,4,15,41,48,-7,37
Glentoran,1951,9,8,6,16,37,55,-18,30
Ballinamalla,1951,10,6,6,18,25,53,-28,24
Portadown,1951,11,6,5,19,33,49,-16,23
Crusaders,1952,1,17,6,7,54,35,19,57
Linfield,1952,2,15,10,5,67,34,33,55
Cliftonville,1952,3,13,6,11,50,41,9,45
Ballymena,1952,4,12,8,10,51,59,-8,44
Glenavon,1952,5,10,13,7,46,38,8,43
Dungannon,1952,6,11,7,12,52,46,6,40
Ards,1952,7,12,4,14,44,45,-1,40
Glentoran,1952,8,9,11,10,34,41,-7,38
Coleraine,1952,9,8,13,9,35,40,-5,37
Portadown,1952,10,9,6,15,26,48,-22,33
Ballinamalla,1952,11,6,2,22,24,56,-32,20
Crusaders,1953,1,19,6,5,54,30,24,63
Linfield,1953,2,13,10,7,56,35,21,49
Cliftonville,1953,3,14,4,12,51,43,8,46
Coleraine,1953,4,12,10,8,47,43,4,46
Dungannon,1953,5,10,13,7,56,42,14,43
Ards,1953,6,11,6,13,53,52,1,39
Glenavon,1953,7,8,14,8,43,44,-1,38
Ballymena,1953,8,10,8,12,51,58,-7,38
Portadown,1953,9,8,6,16,30,49,-19,30
Glentoran,1953,10,7,9,14,29,50,-21,30
Ballinamalla,1953,11,8,4,18,34,58,-24,28
Crusaders,1954,1,16,10,4,52,30,22,58
Linfield,1954,2,14,9,7,56,34,22,51
Cliftonville,1954,3,14,8,8,51,38,13,50
Ballymena,1954,4,13,8,9,57,58,-1,47
Dungannon,1954,5,13,7,10,49,37,12,46
Glenavon,1954,6,10,13,7,44,48,-4,43
Coleraine,1954,7,10,12,8,42,34,8,42
Glentoran,1954,8,9,8,13,35,46,-11,35
Ards,1954,9,7,7,16,37,50,-13,28
Ballinamalla,1954,10,7,6,17,29,52,-23,27
Portadown,1954,11,6,4,20,25,50,-25,22
Crusaders,1955,1,17,7,6,54,29,25,58
Cliftonville,1955,2,15,5,10,54,44,10,50
Linfield,1955,3,14,7,9,60,32,28,49
Coleraine,1955,4,12,12,6,49,37,12,48
Glenavon,1955,5,11,12,7,49,41,8,45
Ballymena,1955,6,13,6,11,57,64,-7,45
Dungannon,1955,7,10,9,11,45,43,2,39
Glentoran,1955,8,10,8,12,32,43,-11,38
Ards,1955,9,8,5,17,34,51,-17,29
Portadown,1955,10,7,6,17,21,48,-27,27
Ballinamalla,1955,11,5,9,16,31,54,-23,24
Crusaders,1956,1,18,8,4,62,38,24,62
Linfield,1956,2,17,8,5,61,29,32,59
Cliftonville,1956,3,16,5,9,55,41,14,53
Ballymena,1956,4,14,7,9,63,58,5,49
Coleraine,1956,5,11,10,9,42,38,4,43
Glenavon,1956,6,11,9,10,42,44,-2,42
Dungannon,1956,7,9,8,13,46,49,-3,35
Ards,1956,8,10,5,15,40,50,-10,35
Ballinamalla,1956,9,8,6,16,37,47,-10,30
Glentoran,1956,10,8,6,16,26,48,-22,30
Portadown,1956,11,5,4,21,20,52,-32,19
Crusaders,1957,1,18,9,3,58,30,28,63
Linfield,1957,2,16,9,5,58,28,30,57
Coleraine,1957,3,13,11,6,50,40,10,50
Ballymena,1957,4,12,10,8,59,55,4,46
Cliftonville,1957,5,13,6,11,56,50,6,45
Dungannon,1957,6,11,9,10,51,35,16,42
Glenavon,1957,7,7,11,12,42,48,-6,32
Glentoran,1957,8,8,8,14,33,52,-19,32
Portadown,1957,9,8,6,16,25,46,-21,30
Ballinamalla,1957,10,8,4,18,27,50,-23,28
Ards,1957,11,6,7,17,33,58,-25,25
Cliftonville,1958,1,17,4,9,57,40,17,55
Crusaders,1958,2,15,8,7,54,34,20,53
Linfield,1958,3,13,10,7,59,36,23,49
Glenavon,1958,4,13,9,8,52,44,8,48
Glentoran,1958,5,13,7,10,44,44,0,46
Ballymena,1958,6,13,6,11,56,68,-12,45
Dungannon,1958,7,11,11,8,54,42,12,44
Ards,1958,8,9,5,16,42,55,-13,32
Coleraine,1958,9,7,9,14,40,45,-5,30
Portadown,1958,10,7,7,16,28,48,-20,28
Ballinamalla,1958,11,8,2,20,30,60,-30,26
Crusaders,1959,1,19,7,4,60,32,28,64
Linfield,1959,2,16,8,6,62,30,32,56
Cliftonville,1959,3,16,5,9,53,34,19,53
Dungannon,1959,4,13,7,10,55,43,12,46
Coleraine,1959,5,12,9,9,42,34,8,45
Ballymena,1959,6,12,7,11,55,60,-5,43
Glenavon,1959,7,9,10,11,45,48,-3,37
Ards,1959,8,10,4,16,34,55,-21,34
Glentoran,1959,9,7,10,13,33,49,-16,31
Portadown,1959,10,7,6,17,28,52,-24,27
Ballinamalla,1959,11,5,5,20,29,59,-30,20
Linfield,1960,1,19,7,4,58,24,34,64
Crusaders,1960,2,17,8,5,52,32,20,59
Cliftonville,1960,3,17,4,9,54,34,20,55
Coleraine,1960,4,13,7,10,48,37,11,46
Dungannon,1960,5,12,8,10,52,44,8,44
Ballymena,1960,6,13,5,12,58,56,2,44
Glenavon,1960,7,10,10,10,47,50,-3,40
Glentoran,1960,8,8,7,15,26,48,-22,31
Ards,1960,9,8,3,19,38,52,-14,27
Ballinamalla,1960,10,8,2,20,31,58,-27,26
Portadown,1960,11,6,7,17,29,58,-29,25
Cliftonville,1961,1,16,8,6,62,38,24,56
Crusaders,1961,2,16,8,6,51,33,18,56
Glenavon,1961,3,14,10,6,59,44,15,52
Linfield,1961,4,13,9,8,59,31,28,48
Coleraine,1961,5,12,12,6,48,36,12,48
Ballymena,1961,6,11,7,12,51,62,-11,40
Dungannon,1961,7,10,9,11,50,45,5,39
Portadown,1961,8,9,5,16,24,46,-22,32
Glentoran,1961,9,7,10,13,32,47,-15,31
Ards,1961,10,7,4,19,31,57,-26,25
Ballinamalla,1961,11,7,4,19,29,57,-28,25
Linfield,1962,1,15,9,6,59,34,25,54
Cliftonville,1962,2,16,6,8,53,35,18,54
Crusaders,1962,3,15,7,8,52,34,18,52
Coleraine,1962,4,12,12,6,42,34,8,48
Ballymena,1962,5,14,4,12,58,58,0,46
Dungannon,1962,6,12,6,12,52,43,9,42
Glenavon,1962,7,10,10,10,40,48,-8,40
Ards,1962,8,11,4,15,40,47,-7,37
Glentoran,1962,9,10,5,15,26,42,-16,35
Portadown,1962,10,7,7,16,23,48,-25,28
Ballinamalla,1962,11,6,4,20,31,53,-22,22
Linfield,1963,1,15,9,6,55,28,27,54
Crusaders,1963,2,14,9,7,48,31,17,51
Cliftonville,1963,3,14,8,8,48,36,12,50
Glenavon,1963,4,12,12,6,47,42,5,48
Ballymena,1963,5,13,9,8,55,54,1,48
Coleraine,1963,6,11,11,8,44,37,7,44
Dungannon,1963,7,11,9,10,53,43,10,42
Glentoran,1963,8,9,8,13,30,41,-11,35
Ards,1963,9,9,4,17,36,52,-16,31
Portadown,1963,10,7,4,19,29,55,-26,25
Ballinamalla,1963,11,6,5,19,26,52,-26,23
Cliftonville,1964,1,17,5,8,62,38,24,56
Crusaders,1964,2,16,8,6,55,37,18,56
Linfield,1964,3,14,9,7,55,37,18,51
Ballymena,1964,4,14,7,9,56,55,1,49
Coleraine,1964,5,10,12,8,44,38,6,42
Glenavon,1964,6,10,10,10,48,48,0,40
Dungannon,1964,7,9,7,14,46,47,-1,34
Glentoran,1964,8,8,8,14,31,48,-17,32
Ards,1964,9,8,7,15,35,49,-14,31
Ballinamalla,1964,10,8,7,15,29,47,-18,31
Portadown,1964,11,6,10,14,29,46,-17,28
Crusaders,1965,1,18,8,4,54,28,26,62
Linfield,1965,2,16,9,5,61,31,30,57
Glenavon,1965,3,13,12,5,50,37,13,51
Ballymena,1965,4,14,8,8,58,55,3,50
Cliftonville,1965,5,13,4,13,51,45,6,43
Dungannon,1965,6,11,7,12,54,49,5,40
Ards,1965,7,11,5,14,40,44,-4,38
Coleraine,1965,8,9,10,11,38,46,-8,37
Ballinamalla,1965,9,8,5,17,27,51,-24,29
Portadown,1965,10,7,4,19,24,49,-25,25
Glentoran,1965,11,6,6,18,23,45,-22,24
Crusaders,1966,1,16,8,6,49,34,15,56
Linfield,1966,2,15,10,5,62,25,37,55
Ballymena,1966,3,14,7,9,52,55,-3,49
Cliftonville,1966,4,15,3,12,55,45,10,48
Coleraine,1966,5,11,11,8,41,38,3,44
Dungannon,1966,6,11,10,9,51,42,9,43
Ards,1966,7,10,6,14,47,49,-2,36
Glenavon,1966,8,7,14,9,40,43,-3,35
Glentoran,1966,9,9,7,14,30,45,-15,34
Portadown,1966,10,7,7,16,25,45,-20,28
Ballinamalla,1966,11,7,3,20,29,60,-31,24
Linfield,1967,1,15,8,7,65,41,24,53
Crusaders,1967,2,15,8,7,58,41,17,53
Ballymena,1967,3,15,6,9,66,60,6,51
Coleraine,1967,4,13,9,8,42,34,8,48
Cliftonville,1967,5,13,7,10,54,46,8,46
Glentoran,1967,6,10,10,10,32,37,-5,40
Glenavon,1967,7,9,12,9,43,45,-2,39
Dungannon,1967,8,9,10,11,54,46,8,37
Ards,1967,9,10,4,16,40,51,-11,34
Ballinamalla,1967,10,7,6,17,33,53,-20,27
Portadown,1967,11,6,6,18,20,53,-33,24
Crusaders,1968,1,17,7,6,59,34,25,58
Coleraine,1968,2,13,11,6,43,30,13,50
Linfield,1968,3,12,13,5,60,35,25,49
Cliftonville,1968,4,13,6,11,49,41,8,45
Dungannon,1968,5,9,15,6,56,42,14,42
Glenavon,1968,6,10,12,8,43,44,-1,42
Ballymena,1968,7,12,6,12,51,60,-9,42
Glentoran,1968,8,8,10,12,24,40,-16,34
Ballinamalla,1968,9,8,5,17,28,46,-18,29
Portadown,1968,10,6,10,14,27,48,-21,28
Ards,1968,11,6,7,17,31,51,-20,25
Crusaders,1969,1,18,7,5,67,34,33,61
Linfield,1969,2,16,8,6,64,28,36,56
Cliftonville,1969,3,14,6,10,48,41,7,48
Ballymena,1969,4,13,5,12,52,57,-5,44
Glenavon,1969,5,11,10,9,44,43,1,43
Ards,1969,6,12,4,14,41,50,-9,40
Coleraine,1969,7,9,10,11,43,44,-1,37
Dungannon,1969,8,9,9,12,46,46,0,36
Glentoran,1969,9,8,7,15,26,44,-18,31
Portadown,1969,10,8,6,16,26,45,-19,30
Ballinamalla,1969,11,8,6,16,30,55,-25,30
Glenavon,1970,1,16,9,5,62,42,20,57
Cliftonville,1970,2,16,5,9,58,37,21,53
Crusaders,1970,3,15,5,10,48,36,12,50
Linfield,1970,4,14,6,10,57,38,19,48
Ballymena,1970,5,14,5,11,60,61,-1,47
Dungannon,1970,6,12,6,12,48,45,3,42
Glentoran,1970,7,11,7,12,35,40,-5,40
Coleraine,1970,8,9,10,11,36,39,-3,37
Ards,1970,9,8,7,15,39,53,-14,31
Ballinamalla,1970,10,9,4,17,32,52,-20,31
Portadown,1970,11,7,4,19,24,56,-32,25
Crusaders,1971,1,17,8,5,56,35,21,59
Ballymena,1971,2,16,6,8,60,52,8,54
Linfield,1971,3,11,11,8,54,34,20,44
Cliftonville,1971,4,12,7,11,49,45,4,43
Coleraine,1971,5,11,8,11,43,44,-1,41
Ards,1971,6,12,4,14,38,41,-3,40
Glenavon,1971,7,10,10,10,49,53,-4,40
Dungannon,1971,8,10,8,12,53,51,2,38
Ballinamalla,1971,9,12,2,16,37,53,-16,38
Portadown,1971,10,9,5,16,35,46,-11,32
Glentoran,1971,11,7,7,16,26,46,-20,28
Crusaders,1972,1,16,7,7,59,35,24,55
Ballymena,1972,2,15,8,7,59,54,5,53
Linfield,1972,3,14,9,7,60,33,27,51
Dungannon,1972,4,13,8,9,49,40,9,47
Cliftonville,1972,5,13,6,11,49,45,4,45
Ards,1972,6,14,3,13,48,47,1,45
Glenavon,1972,7,10,13,7,49,49,0,43
Coleraine,1972,8,7,14,9,39,40,-1,35
Glentoran,1972,9,7,10,13,34,48,-14,31
Ballinamalla,1972,10,6,7,17,26,54,-28,25
Portadown,1972,11,4,7,19,23,50,-27,19
Crusaders,1973,1,18,9,3,61,33,28,63
Linfield,1973,2,13,13,4,56,31,25,52
Cliftonville,1973,3,14,5,11,55,45,10,47
Coleraine,1973,4,12,10,8,47,39,8,46
Ballymena,1973,5,14,4,12,59,62,-3,46
Glenavon,1973,6,9,13,8,51,55,-4,40
Glentoran,1973,7,10,8,12,38,43,-5,38
Dungannon,1973,8,7,11,12,52,57,-5,32
Ards,1973,9,9,4,17,38,53,-15,31
Portadown,1973,10,8,5,17,30,47,-17,29
Ballinamalla,1973,11,7,6,17,35,57,-22,27
Linfield,1974,1,16,8,6,56,29,27,56
Crusaders,1974,2,16,7,7,56,43,13,55
Cliftonville,1974,3,16,4,10,62,42,20,52
Ballymena,1974,4,14,5,11,62,57,5,47
Glenavon,1974,5,11,11,8,49,46,3,44
Coleraine,1974,6,11,10,9,39,39,0,43
Glentoran,1974,7,12,4,14,34,44,-10,40
Dungannon,1974,8,8,9,13,42,49,-7,33
Portadown,1974,9,9,4,17,30,43,-13,31
Ards,1974,10,9,3,18,34,53,-19,30
Ballinamalla,1974,11,8,5,17,29,48,-19,29
Crusaders,1975,1,17,8,5,55,32,23,59
Cliftonville,1975,2,18,3,9,68,40,28,57
Linfield,1975,3,14,9,7,57,35,22,51
Coleraine,1975,4,12,10,8,45,41,4,46
Ballymena,1975,5,13,7,10,54,56,-2,46
Glenavon,1975,6,10,10,10,46,50,-4,40
Dungannon,1975,7,10,8,12,52,48,4,38
Glentoran,1975,8,10,7,13,31,43,-12,37
Portadown,1975,9,8,5,17,23,50,-27,29
Ballinamalla,1975,10,7,6,17,30,49,-19,27
Ards,1975,11,7,5,18,34,51,-17,26
Crusaders,1976,1,17,6,7,55,37,18,57
Ballymena,1976,2,16,6,8,62,58,4,54
Cliftonville,1976,3,16,5,9,58,40,18,53
Linfield,1976,4,14,9,7,61,37,24,51
Glenavon,1976,5,12,9,9,53,52,1,45
Coleraine,1976,6,10,9,11,44,48,-4,39
Ards,1976,7,11,4,15,41,45,-4,37
Dungannon,1976,8,9,8,13,47,49,-2,35
Glentoran,1976,9,8,7,15,36,52,-16,31
Portadown,1976,10,9,4,17,30,47,-17,31
Ballinamalla,1976,11,6,7,17,32,54,-22,25
Linfield,1977,1,15,8,7,55,30,25,53
Crusaders,1977,2,15,7,8,55,37,18,52
Cliftonville,1977,3,15,4,11,53,43,10,49
Ballymena,1977,4,15,4,11,58,61,-3,49
Dungannon,1977,5,12,9,9,54,40,14,45
Glentoran,1977,6,12,9,9,33,32,1,45
Glenavon,1977,7,11,11,8,42,38,4,44
Coleraine,1977,8,10,11,9,42,42,0,41
Ballinamalla,1977,9,8,5,17,28,53,-25,29
Ards,1977,10,8,3,19,33,50,-17,27
Portadown,1977,11,5,7,18,20,47,-27,22
Linfield,1978,1,15,11,4,61,36,25,56
Crusaders,1978,2,13,8,9,50,39,11,47
Glenavon,1978,3,12,9,9,49,43,6,45
Ballymena,1978,4,12,9,9,58,56,2,45
Cliftonville,1978,5,12,8,10,50,44,6,44
Coleraine,1978,6,11,11,8,45,40,5,44
Ards,1978,7,12,6,12,41,48,-7,42
Dungannon,1978,8,10,10,10,57,50,7,40
Glentoran,1978,9,7,9,14,31,47,-16,30
Portadown,1978,10,8,5,17,29,44,-15,29
Ballinamalla,1978,11,6,8,16,28,52,-24,26
Crusaders,1979,1,18,5,7,63,39,24,59
Ballymena,1979,2,17,5,8,62,53,9,56
Cliftonville,1979,3,16,5,9,56,42,14,53
Coleraine,1979,4,14,11,5,45,31,14,53
Linfield,1979,5,9,15,6,54,37,17,42
Glenavon,1979,6,9,14,7,43,43,0,41
Glentoran,1979,7,9,7,14,30,46,-16,34
Ards,1979,8,8,8,14,33,41,-8,32
Dungannon,1979,9,6,11,13,42,47,-5,29
Portadown,1979,10,6,9,15,27,47,-20,27
Ballinamalla,1979,11,5,6,19,27,56,-29,21
Crusaders,1980,1,18,8,4,62,29,33,62
Linfield,1980,2,14,10,6,64,35,29,52
Cliftonville,1980,3,15,7,8,52,38,14,52
Ballymena,1980,4,15,6,9,66,60,6,51
Glenavon,1980,5,10,11,9,45,44,1,41
Coleraine,1980,6,9,12,9,38,43,-5,39
Dungannon,1980,7,8,11,11,45,44,1,35
Ards,1980,8,10,5,15,34,45,-11,35
Portadown,1980,9,8,6,16,25,44,-19,30
Glentoran,1980,10,7,7,16,22,42,-20,28
Ballinamalla,1980,11,6,7,17,27,56,-29,25
Crusaders,1981,1,16,9,5,51,34,17,57
Cliftonville,1981,2,16,5,9,58,37,21,53
Linfield,1981,3,13,11,6,57,31,26,50
Ballymena,1981,4,13,7,10,59,59,0,46
Glenavon,1981,5,11,12,7,55,47,8,45
Coleraine,1981,6,12,9,9,40,41,-1,45
Dungannon,1981,7,11,7,12,53,41,12,40
Glentoran,1981,8,9,7,14,30,46,-16,34
Portadown,1981,9,7,8,15,24,44,-20,29
Ballinamalla,1981,10,8,5,17,26,53,-27,29
Ards,1981,11,7,4,19,31,51,-20,25
Linfield,1982,1,16,8,6,66,33,33,56
Glenavon,1982,2,14,11,5,61,44,17,53
Crusaders,1982,3,15,7,8,53,39,14,52
Cliftonville,1982,4,15,4,11,50,39,11,49
Coleraine,1982,5,13,10,7,41,35,6,49
Ballymena,1982,6,13,3,14,62,65,-3,42
Glentoran,1982,7,11,7,12,28,41,-13,40
Dungannon,1982,8,8,10,12,55,50,5,34
Ards,1982,9,8,8,14,38,48,-10,32
Ballinamalla,1982,10,8,3,19,25,51,-26,27
Portadown,1982,11,6,5,19,24,58,-34,23
Crusaders,1983,1,15,8,7,58,42,16,53
Cliftonville,1983,2,16,4,10,53,42,11,52
Ballymena,1983,3,14,7,9,59,52,7,49
Ards,1983,4,13,6,11,46,41,5,45
Glenavon,1983,5,11,11,8,46,43,3,44
Linfield,1983,6,10,11,9,53,41,12,41
Coleraine,1983,7,10,10,10,38,35,3,40
Glentoran,1983,8,9,11,10,30,33,-3,38
Dungannon,1983,9,8,10,12,46,51,-5,34
Ballinamalla,1983,10,8,4,18,30,54,-24,28
Portadown,1983,11,6,8,16,24,49,-25,26
Crusaders,1984,1,17,4,9,57,42,15,55
Glenavon,1984,2,15,9,6,63,44,19,54
Linfield,1984,3,13,10,7,56,33,23,49
Ballymena,1984,4,13,8,9,56,56,0,47
Cliftonville,1984,5,13,6,11,50,42,8,45
Coleraine,1984,6,11,10,9,48,52,-4,43
Ballinamalla,1984,7,11,5,14,30,42,-12,38
Ards,1984,8,9,6,15,32,45,-13,33
Dungannon,1984,9,8,8,14,49,49,0,32
Glentoran,1984,10,7,10,13,28,42,-14,31
Portadown,1984,11,8,4,18,26,48,-22,28
Crusaders,1985,1,17,8,5,58,29,29,59
Ballymena,1985,2,17,6,7,59,55,4,57
Linfield,1985,3,15,9,6,68,36,32,54
Glenavon,1985,4,12,11,7,47,41,6,47
Cliftonville,1985,5,13,7,10,51,44,7,46
Coleraine,1985,6,10,12,8,37,34,3,42
Dungannon,1985,7,9,9,12,46,40,6,36
Glentoran,1985,8,8,7,15,30,47,-17,31
Ards,1985,9,8,5,17,37,53,-16,29
Portadown,1985,10,7,5,18,22,47,-25,26
Ballinamalla,1985,11,6,7,17,26,55,-29,25
Crusaders,1986,1,17,10,3,60,30,30,61
Linfield,1986,2,14,11,5,62,34,28,53
Cliftonville,1986,3,12,7,11,46,39,7,43
Ballymena,1986,4,12,7,11,62,64,-2,43
Glentoran,1986,5,11,8,11,34,42,-8,41
Glenavon,1986,6,10,10,10,51,52,-1,40
Coleraine,1986,7,8,15,7,36,34,2,39
Dungannon,1986,8,10,8,12,48,43,5,38
Portadown,1986,9,11,4,15,29,45,-16,37
Ards,1986,10,8,4,18,35,51,-16,28
Ballinamalla,1986,11,8,4,18,31,60,-29,28
Glenavon,1987,1,15,9,6,55,42,13,54
Crusaders,1987,2,16,5,9,64,39,25,53
Cliftonville,1987,3,15,5,10,53,42,11,50
Linfield,1987,4,13,8,9,49,37,12,47
Coleraine,1987,5,12,9,9,47,39,8,45
Glentoran,1987,6,12,6,12,36,44,-8,42
Dungannon,1987,7,10,10,10,53,43,10,40
Ballymena,1987,8,11,6,13,51,64,-13,39
Ards,1987,9,10,5,15,36,44,-8,35
Ballinamalla,1987,10,7,6,17,34,62,-28,27
Portadown,1987,11,7,5,18,22,44,-22,26
Linfield,1988,1,17,8,5,61,24,37,59
Crusaders,1988,2,14,9,7,47,30,17,51
Cliftonville,1988,3,15,3,12,52,45,7,48
Glenavon,1988,4,12,10,8,56,49,7,46
Ballymena,1988,5,13,7,10,58,58,0,46
Dungannon,1988,6,11,8,11,48,44,4,41
Coleraine,1988,7,10,11,9,41,41,0,41
Ards,1988,8,10,5,15,41,54,-13,35
Glentoran,1988,9,8,10,12,33,45,-12,34
Portadown,1988,10,8,5,17,25,44,-19,29
Ballinamalla,1988,11,7,4,19,29,57,-28,25
Linfield,1989,1,16,10,4,66,33,33,58
Crusaders,1989,2,16,9,5,55,32,23,57
Ballymena,1989,3,14,7,9,57,57,0,49
Glenavon,1989,4,12,11,7,48,41,7,47
Ballinamalla,1989,5,13,4,13,41,42,-1,43
Cliftonville,1989,6,12,5,13,44,45,-1,41
Coleraine,1989,7,9,10,11,36,44,-8,37
Glentoran,1989,8,10,5,15,36,49,-13,35
Dungannon,1989,9,7,12,11,47,46,1,33
Ards,1989,10,8,4,18,38,54,-16,28
Portadown,1989,11,6,7,17,24,49,-25,25
Linfield,1990,1,15,9,6,56,35,21,54
Crusaders,1990,2,15,7,8,52,30,22,52
Cliftonville,1990,3,15,7,8,54,40,14,52
Coleraine,1990,4,13,10,7,54,36,18,49
Ballymena,1990,5,13,7,10,55,58,-3,46
Dungannon,1990,6,11,8,11,51,40,11,41
Glenavon,1990,7,10,10,10,40,47,-7,40
Ards,1990,8,10,6,14,40,53,-13,36
Portadown,1990,9,9,4,17,30,49,-19,31
Glentoran,1990,10,7,7,16,35,52,-17,28
Ballinamalla,1990,11,7,5,18,28,55,-27,26
Linfield,1991,1,15,12,3,61,26,35,57
Cliftonville,1991,2,15,5,10,52,40,12,50
Crusaders,1991,3,14,7,9,51,39,12,49
Ballymena,1991,4,14,7,9,58,58,0,49
Coleraine,1991,5,11,12,7,46,36,10,45
Glenavon,1991,6,12,8,10,52,51,1,44
Dungannon,1991,7,12,7,11,50,42,8,43
Ballinamalla,1991,8,12,3,15,39,50,-11,39
Glentoran,1991,9,9,7,14,31,45,-14,34
Ards,1991,10,7,7,16,35,50,-15,28
Portadown,1991,11,4,5,21,24,62,-38,17
Cliftonville,1992,1,15,5,10,61,42,19,50
Crusaders,1992,2,14,8,8,50,33,17,50
Linfield,1992,3,13,10,7,59,38,21,49
Glenavon,1992,4,12,11,7,51,42,9,47
Ballymena,1992,5,14,5,11,69,70,-1,47
Coleraine,1992,6,10,13,7,47,44,3,43
Glentoran,1992,7,11,9,10,34,40,-6,42
Dungannon,1992,8,8,10,12,54,50,4,34
Ards,1992,9,9,7,14,37,45,-8,34
Ballinamalla,1992,10,6,10,14,30,51,-21,28
Portadown,1992,11,6,6,18,19,56,-37,24
Linfield,1993,1,16,10,4,55,26,29,58
Crusaders,1993,2,15,7,8,54,36,18,52
Cliftonville,1993,3,14,7,9,59,44,15,49
Ballymena,1993,4,14,7,9,55,48,7,49
Glenavon,1993,5,12,11,7,43,42,1,47
Coleraine,1993,6,9,13,8,47,40,7,40
Dungannon,1993,7,8,11,11,48,45,3,35
Ballinamalla,1993,8,10,4,16,33,48,-15,34
Glentoran,1993,9,9,7,14,33,49,-16,34
Portadown,1993,10,8,3,19,30,51,-21,27
Ards,1993,11,6,8,16,32,60,-28,26
Crusaders,1994,1,16,7,7,51,35,16,55
Cliftonville,1994,2,16,3,11,54,38,16,51
Linfield,1994,3,14,8,8,51,26,25,50
Coleraine,1994,4,13,10,7,46,37,9,49
Glentoran,1994,5,13,6,11,40,37,3,45
Glenavon,1994,6,11,10,9,53,53,0,43
Ballymena,1994,7,12,5,13,51,64,-13,41
Ards,1994,8,11,3,16,45,58,-13,36
Dungannon,1994,9,9,8,13,46,45,1,35
Ballinamalla,1994,10,8,4,18,33,50,-17,28
Portadown,1994,11,7,6,17,27,54,-27,27
Linfield,1995,1,17,8,5,62,33,29,59
Glenavon,1995,2,16,7,7,55,43,12,55
Crusaders,1995,3,15,8,7,55,35,20,53
Ballymena,1995,4,15,6,9,70,61,9,51
Coleraine,1995,5,13,9,8,43,37,6,48
Cliftonville,1995,6,12,6,12,45,44,1,42
Dungannon,1995,7,10,8,12,56,48,8,38
Glentoran,1995,8,8,8,14,27,45,-18,32
Ards,1995,9,8,6,16,39,52,-13,30
Portadown,1995,10,7,6,17,23,45,-22,27
Ballinamalla,1995,11,5,6,19,26,58,-32,21
Linfield,1996,1,19,7,4,65,27,38,64
Crusaders,1996,2,15,11,4,48,25,23,56
Cliftonville,1996,3,15,3,12,50,46,4,48
Ballymena,1996,4,14,5,11,55,58,-3,47
Dungannon,1996,5,12,8,10,50,39,11,44
Glenavon,1996,6,11,11,8,52,46,6,44
Ards,1996,7,10,5,15,35,48,-13,35
Coleraine,1996,8,6,12,12,36,43,-7,30
Ballinamalla,1996,9,9,3,18,36,52,-16,30
Glentoran,1996,10,7,9,14,29,50,-21,30
Portadown,1996,11,7,6,17,25,47,-22,27
Linfield,1997,1,17,7,6,60,34,26,58
Crusaders,1997,2,16,7,7,57,37,20,55
Ballymena,1997,3,16,7,7,60,52,8,55
Glenavon,1997,4,13,10,7,53,44,9,49
Cliftonville,1997,5,14,5,11,46,38,8,47
Coleraine,1997,6,12,9,9,42,36,6,45
Dungannon,1997,7,11,9,10,50,41,9,42
Ards,1997,8,9,3,18,34,56,-22,30
Glentoran,1997,9,7,6,17,31,48,-17,27
Portadown,1997,10,7,5,18,30,48,-18,26
Ballinamalla,1997,11,7,4,19,23,52,-29,25
Crusaders,1998,1,15,8,7,56,38,18,53
Dungannon,1998,2,15,7,8,63,44,19,52
Linfield,1998,3,13,10,7,52,31,21,49
Glenavon,1998,4,13,8,9,50,48,2,47
Coleraine,1998,5,12,9,9,50,45,5,45
Cliftonville,1998,6,13,5,12,47,40,7,44
Ballymena,1998,7,12,6,12,59,66,-7,42
Ards,1998,8,11,4,15,47,50,-3,37
Glentoran,1998,9,9,7,14,27,44,-17,34
Portadown,1998,10,8,4,18,29,47,-18,28
Ballinamalla,1998,11,8,4,18,32,59,-27,28
Cliftonville,1999,1,18,3,9,62,40,22,57
Glenavon,1999,2,15,10,5,44,35,9,55
Crusaders,1999,3,15,6,9,61,41,20,51
Ballymena,1999,4,15,6,9,57,62,-5,51
Linfield,1999,5,13,11,6,58,32,26,50
Coleraine,1999,6,10,11,9,40,42,-2,41
Dungannon,1999,7,9,10,11,48,42,6,37
Glentoran,1999,8,9,9,12,30,39,-9,36
Ards,1999,9,9,5,16,38,49,-11,32
Ballinamalla,1999,10,6,7,17,27,52,-25,25
Portadown,1999,11,5,4,21,20,51,-31,19
Linfield,2000,1,17,7,6,60,25,35,58
Crusaders,2000,2,17,6,7,61,34,27,57
Cliftonville,2000,3,16,4,10,54,37,17,52
Glenavon,2000,4,14,9,7,51,46,5,51
Ballymena,2000,5,14,7,9,54,50,4,49
Glentoran,2000,6,11,7,12,33,45,-12,40
Ards,2000,7,10,6,14,43,49,-6,36
Dungannon,2000,8,8,11,11,44,49,-5,35
Coleraine,2000,9,8,10,12,39,44,-5,34
Portadown,2000,10,6,5,19,26,55,-29,23
Ballinamalla,2000,11,5,6,19,21,52,-31,21
Linfield,2001,1,16,9,5,63,32,31,57
Crusaders,2001,2,16,7,7,48,31,17,55
Glenavon,2001,3,14,11,5,47,36,11,53
Ballymena,2001,4,15,7,8,61,52,9,52
Coleraine,2001,5,13,12,5,46,31,15,51
Cliftonville,2001,6,12,5,13,41,41,0,41
Dungannon,2001,7,11,7,12,46,43,3,40
Glentoran,2001,8,10,7,13,30,41,-11,37
Ards,2001,9,7,5,18,31,52,-21,26
Ballinamalla,2001,10,7,4,19,25,48,-23,25
Portadown,2001,11,4,6,20,19,50,-31,18
Cliftonville,2002,1,16,6,8,59,39,20,54
Crusaders,2002,2,15,8,7,61,38,23,53
Linfield,2002,3,14,9,7,57,31,26,51
Ballymena,2002,4,13,8,9,62,64,-2,47
Dungannon,2002,5,13,7,10,62,45,17,46
Glenavon,2002,6,12,9,9,50,50,0,45
Glentoran,2002,7,13,5,12,38,47,-9,44
Coleraine,2002,8,10,11,9,36,45,-9,41
Ards,2002,9,8,5,17,32,48,-16,29
Portadown,2002,10,6,7,17,29,50,-21,25
Ballinamalla,2002,11,5,5,20,27,56,-29,20
Crusaders,2003,1,19,7,4,57,26,31,64
Cliftonville,2003,2,16,6,8,58,36,22,54
Linfield,2003,3,13,7,10,54,37,17,46
Ballymena,2003,4,13,7,10,56,60,-4,46
Dungannon,2003,5,11,11,8,51,40,11,44
Glenavon,2003,6,11,11,8,47,45,2,44
Coleraine,2003,7,10,10,10,36,39,-3,40
Ards,2003,8,10,5,15,36,45,-9,35
Ballinamalla,2003,9,10,3,17,28,48,-20,33
Glentoran,2003,10,8,7,15,30,45,-15,31
Portadown,2003,11,3,8,19,23,55,-32,17
Linfield,2004,1,17,8,5,63,29,34,59
Crusaders,2004,2,12,14,4,53,35,18,50
Coleraine,2004,3,12,11,7,47,36,11,47
Cliftonville,2004,4,14,5,11,55,46,9,47
Glenavon,2004,5,11,13,6,50,43,7,46
Ballymena,2004,6,10,12,8,58,61,-3,42
Dungannon,2004,7,10,10,10,50,43,7,40
Glentoran,2004,8,10,8,12,40,49,-9,38
Ards,2004,9,7,7,16,36,56,-20,28
Portadown,2004,10,6,9,15,25,44,-19,27
Ballinamalla,2004,11,5,5,20,31,66,-35,20
Crusaders,2005,1,18,9,3,61,23,38,63
Linfield,2005,2,18,7,5,59,24,35,61
Cliftonville,2005,3,15,5,10,53,38,15,50
Coleraine,2005,4,13,10,7,49,40,9,49
Glenavon,2005,5,12,9,9,46,47,-1,45
Ballymena,2005,6,10,8,12,50,59,-9,38
Ards,2005,7,10,5,15,39,52,-13,35
Dungannon,2005,8,8,10,12,46,48,-2,34
Ballinamalla,2005,9,8,5,17,26,48,-22,29
Glentoran,2005,10,7,7,16,30,56,-26,28
Portadown,2005,11,6,5,19,24,48,-24,23
Crusaders,2006,1,16,7,7,57,36,21,55
Dungannon,2006,2,15,8,7,54,35,19,53
Linfield,2006,3,13,9,8,54,33,21,48
Ballymena,2006,4,13,6,11,57,57,0,45
Coleraine,2006,5,11,10,9,44,44,0,43
Glenavon,2006,6,10,12,8,50,46,4,42
Cliftonville,2006,7,11,6,13,45,42,3,39
Ballinamalla,2006,8,12,3,15,34,51,-17,39
Ards,2006,9,9,7,14,39,48,-9,34
Portadown,2006,10,8,5,17,22,45,-23,29
Glentoran,2006,11,7,7,16,31,50,-19,28
Ballymena,2007,1,16,6,8,64,58,6,54
Crusaders,2007,2,14,11,5,57,40,17,53
Glenavon,2007,3,14,11,5,56,41,15,53
Cliftonville,2007,4,15,5,10,48,37,11,50
Linfield,2007,5,13,10,7,61,33,28,49
Dungannon,2007,6,10,10,10,48,44,4,40
Coleraine,2007,7,7,13,10,43,45,-2,34
Ards,2007,8,9,6,15,37,48,-11,33
Glentoran,2007,9,7,11,12,31,48,-17,32
Ballinamalla,2007,10,7,6,17,32,56,-24,27
Portadown,2007,11,5,7,18,22,49,-27,22
Cliftonville,2008,1,17,5,8,58,39,19,56
Linfield,2008,2,13,12,5,57,28,29,51
Crusaders,2008,3,14,7,9,49,36,13,49
Coleraine,2008,4,14,7,9,42,39,3,49
Glenavon,2008,5,13,9,8,50,38,12,48
Ballymena,2008,6,14,5,11,56,54,2,47
Ballinamalla,2008,7,12,3,15,34,49,-15,39
Glentoran,2008,8,9,8,13,25,35,-10,35
Dungannon,2008,9,8,8,14,39,48,-9,32
Ards,2008,10,8,4,18,38,55,-17,28
Portadown,2008,11,8,2,20,30,57,-27,26
Crusaders,2009,1,17,8,5,54,28,26,59
Linfield,2009,2,14,11,5,63,34,29,53
Ballymena,2009,3,14,7,9,59,56,3,49
Glenavon,2009,4,11,14,5,53,42,11,47
Cliftonville,2009,5,12,8,10,50,41,9,44
Coleraine,2009,6,10,14,6,41,40,1,44
Glentoran,2009,7,11,7,12,37,44,-7,40
Dungannon,2009,8,8,10,12,43,45,-2,34
Ards,2009,9,7,7,16,38,56,-18,28
Ballinamalla,2009,10,5,9,16,24,49,-25,24
Portadown,2009,11,4,9,17,21,48,-27,21
Crusaders,2010,1,17,8,5,60,32,28,59
Linfield,2010,2,16,8,6,59,33,26,56
Ballymena,2010,3,15,5,10,58,58,0,50
Cliftonville,2010,4,14,7,9,53,43,10,49
Coleraine,2010,5,13,9,8,45,31,14,48
Dungannon,2010,6,12,10,8,49,38,11,46
Glenavon,2010,7,10,11,9,41,46,-5,41
Glentoran,2010,8,8,10,12,25,38,-13,34
Ards,2010,9,7,7,16,31,45,-14,28
Ballinamalla,2010,10,5,7,18,22,51,-29,22
Portadown,2010,11,4,6,20,19,47,-28,18
Linfield,2011,1,16,9,5,58,24,34,57
Crusaders,2011,2,17,5,8,56,35,21,56
Ballymena,2011,3,16,7,7,63,53,10,55
Cliftonville,2011,4,15,4,11,50,38,12,49
Coleraine,2011,5,11,12,7,41,36,5,45
Dungannon,2011,6,11,9,10,48,41,7,42
Glenavon,2011,7,9,11,10,45,49,-4,38
Glentoran,2011,8,8,7,15,29,45,-16,31
Ballinamalla,2011,9,8,6,16,31,55,-24,30
Portadown,2011,10,7,6,17,24,48,-24,27
Ards,2011,11,7,4,19,30,51,-21,25
Linfield,2012,1,14,10,6,49,25,24,52
Crusaders,2012,2,14,7,9,51,37,14,49
Cliftonville,2012,3,15,4,11,54,43,11,49
Ballymena,2012,4,13,8,9,56,55,1,47
Coleraine,2012,5,11,10,9,40,33,7,43
Ards,2012,6,12,5,13,44,48,-4,41
Glentoran,2012,7,10,8,12,30,39,-9,38
Glenavon,2012,8,8,13,9,37,45,-8,37
Ballinamalla,2012,9,11,3,16,32,44,-12,36
Dungannon,2012,10,8,9,13,47,51,-4,33
Portadown,2012,11,9,3,18,23,43,-20,30
Crusaders,2013,1,18,8,4,57,32,25,62
Ballymena,2013,2,16,7,7,56,48,8,55
Glenavon,2013,3,12,11,7,52,42,10,47
Coleraine,2013,4,11,11,8,41,34,7,44
Cliftonville,2013,5,12,7,11,44,40,4,43
Linfield,2013,6,11,9,10,53,42,11,42
Dungannon,2013,7,9,10,11,52,47,5,37
Glentoran,2013,8,9,8,13,32,40,-8,35
Ards,2013,9,8,8,14,36,50,-14,32
Portadown,2013,10,6,9,15,26,46,-20,27
Ballinamalla,2013,11,6,6,18,27,55,-28,24
Crusaders,2014,1,18,7,5,55,25,30,61
Ballymena,2014,2,16,7,7,64,56,8,55
Glenavon,2014,3,14,9,7,55,37,18,51
Coleraine,2014,4,13,11,6,48,32,16,50
Linfield,2014,5,13,10,7,51,30,21,49
Dungannon,2014,6,9,11,10,53,52,1,38
Cliftonville,2014,7,10,8,12,47,48,-1,38
Ards,2014,8,10,5,15,37,49,-12,35
Portadown,2014,9,8,6,16,24,40,-16,30
Ballinamalla,2014,10,8,3,19,34,60,-26,27
Glentoran,2014,11,5,5,20,20,59,-39,20
Crusaders,2015,1,17,8,5,54,29,25,59
Cliftonville,2015,2,16,8,6,55,34,21,56
Linfield,2015,3,14,8,8,56,35,21,50
Coleraine,2015,4,11,11,8,43,35,8,44
Ballymena,2015,5,12,8,10,55,64,-9,44
Ballinamalla,2015,6,11,5,14,31,42,-11,38
Glentoran,2015,7,8,12,10,25,34,-9,36
Dungannon,2015,8,7,12,11,52,47,5,33
Glenavon,2015,9,7,12,11,44,53,-9,33
Portadown,2015,10,8,5,17,21,46,-25,29
Ards,2015,11,6,7,17,31,48,-17,25
Crusaders,2016,1,19,8,3,63,32,31,65
Ballymena,2016,2,17,6,7,63,52,11,57
Linfield,2016,3,11,13,6,54,28,26,46
Coleraine,2016,4,12,10,8,45,41,4,46
Glenavon,2016,5,11,10,9,43,46,-3,43
Cliftonville,2016,6,12,5,13,45,46,-1,41
Dungannon,2016,7,11,7,12,49,44,5,40
Glentoran,2016,8,8,10,12,42,49,-7,34
Ards,2016,9,8,4,18,28,47,-19,28
Ballinamalla,2016,10,6,8,16,29,50,-21,26
Portadown,2016,11,7,5,18,24,50,-26,26
Crusaders,2017,1,20,7,3,66,27,39,67
Linfield,2017,2,14,10,6,57,35,22,52
Glenavon,2017,3,14,9,7,57,51,6,51
Cliftonville,2017,4,15,5,10,58,42,16,50
Ballymena,2017,5,14,7,9,56,52,4,49
Coleraine,2017,6,10,8,12,41,46,-5,38
Dungannon,2017,7,9,9,12,51,47,4,36
Ards,2017,8,10,5,15,42,50,-8,35
Ballinamalla,2017,9,7,6,17,32,59,-27,27
Glentoran,2017,10,6,8,16,27,50,-23,26
Portadown,2017,11,7,4,19,30,58,-28,25
Coleraine,2018,1,14,11,5,56,39,17,53
Crusaders,2018,2,15,6,9,55,37,18,51
Cliftonville,2018,3,15,5,10,59,47,12,50
Ballymena,2018,4,14,7,9,57,59,-2,49
Linfield,2018,5,11,10,9,50,35,15,43
Glenavon,2018,6,9,14,7,45,45,0,41
Ards,2018,7,11,4,15,34,46,-12,37
Dungannon,2018,8,9,9,12,48,47,1,36
Ballinamalla,2018,9,10,5,15,32,46,-14,35
Glentoran,2018,10,9,7,14,31,43,-12,34
Portadown,2018,11,7,4,19,28,51,-23,25
Glenavon,2019,1,15,9,6,52,35,17,54
Linfield,2019,2,13,12,5,59,36,23,51
Cliftonville,2019,3,15,6,9,50,37,13,51
Ballymena,2019,4,14,8,8,59,54,5,50
Crusaders,2019,5,14,6,10,51,34,17,48
Coleraine,2019,6,11,11,8,42,36,6,44
Dungannon,2019,7,10,8,12,47,45,2,38
Ards,2019,8,9,6,15,42,49,-7,33
Glentoran,2019,9,8,7,15,27,45,-18,31
Portadown,2019,10,7,6,17,24,47,-23,27
Ballinamalla,2019,11,8,3,19,24,59,-35,27
Ballymena,2020,1,16,6,8,63,54,9,54
Crusaders,2020,2,15,8,7,54,36,18,53
Linfield,2020,3,14,8,8,59,33,26,50
Cliftonville,2020,4,16,2,12,54,41,13,50
Coleraine,2020,5,11,9,10,46,44,2,42
Glenavon,2020,6,11,9,10,42,45,-3,42
Glentoran,2020,7,11,7,12,36,46,-10,40
Ballinamalla,2020,8,11,3,16,34,47,-13,36
Dungannon,2020,9,9,8,13,44,47,-3,35
Ards,2020,10,10,5,15,39,47,-8,35
Portadown,2020,11,7,3,20,24,55,-31,24
Crusaders,2021,1,17,6,7,63,39,24,57
Linfield,2021,2,15,6,9,56,35,21,51
Ballymena,2021,3,15,6,9,64,56,8,51
Cliftonville,2021,4,13,8,9,54,45,9,47
Coleraine,2021,5,12,10,8,45,42,3,46
Glenavon,2021,6,11,11,8,47,44,3,44
Ards,2021,7,10,6,14,37,42,-5,36
Ballinamalla,2021,8,11,3,16,33,50,-17,36
Glentoran,2021,9,8,8,14,26,43,-17,32
Portadown,2021,10,9,3,18,30,49,-19,30
Dungannon,2021,11,5,11,14,49,59,-10,26
Crusaders,2022,1,17,5,8,57,40,17,56
Cliftonville,2022,2,16,4,10,58,40,18,52
Linfield,2022,3,14,8,8,52,29,23,50
Glenavon,2022,4,12,10,8,50,50,0,46
Dungannon,2022,5,12,9,9,50,41,9,45
Ballymena,2022,6,13,3,14,57,62,-5,42
Ards,2022,7,11,5,14,41,43,-2,38
Coleraine,2022,8,8,12,10,37,42,-5,36
Portadown,2022,9,10,5,15,32,46,-14,35
Glentoran,2022,10,7,9,14,28,47,-19,30
Ballinamalla,2022,11,8,4,18,29,51,-22,28
Crusaders,2023,1,19,7,4,59,24,35,64
Cliftonville,2023,2,16,7,7,64,42,22,55
Coleraine,2023,3,14,9,7,47,37,10,51
Ballymena,2023,4,14,5,11,61,63,-2,47
Linfield,2023,5,12,10,8,59,36,23,46
Glenavon,2023,6,12,8,10,49,47,2,44
Dungannon,2023,7,9,8,13,50,54,-4,35
Ards,2023,8,8,8,14,37,50,-13,32
Ballinamalla,2023,9,9,4,17,34,58,-24,31
Glentoran,2023,10,7,8,15,29,54,-25,29
Portadown,2023,11,6,4,20,26,50,-24,22
Crusaders,2024,1,15,11,4,57,37,20,56
Cliftonville,2024,2,16,5,9,51,36,15,53
Ballymena,2024,3,14,5,11,58,53,5,47
Linfield,2024,4,12,10,8,56,38,18,46
Dungannon,2024,5,12,10,8,50,35,15,46
Coleraine,2024,6,10,11,9,37,40,-3,41
Glenavon,2024,7,10,9,11,49,50,-1,39
Glentoran,2024,8,10,6,14,31,40,-9,36
Ards,2024,9,10,4,16,35,48,-13,34
Ballinamalla,2024,10,9,3,18,29,55,-26,30
Portadown,2024,11,6,8,16,21,42,-21,26
Cliftonville,2025,1,18,6,6,57,38,19,60
Crusaders,2025,2,18,5,7,59,35,24,59
Linfield,2025,3,13,9,8,65,40,25,48
Coleraine,2025,4,11,11,8,44,42,2,44
Ballymena,2025,5,13,5,12,59,60,-1,44
Glenavon,2025,6,11,10,9,42,42,0,43
Glentoran,2025,7,11,7,12,32,44,-12,40
Portadown,2025,8,10,5,15,32,45,-13,35
Ards,2025,9,10,3,17,39,52,-13,33
Dungannon,2025,10,8,8,14,51,55,-4,32
Ballinamalla,2025,11,7,1,22,32,59,-27,22
Crusaders,2026,1,15,9,6,52,33,19,54
Cliftonville,2026,2,16,6,8,50,39,11,54
Glenavon,2026,3,14,9,7,47,39,8,51
Linfield,2026,4,13,11,6,63,33,30,50
Ballymena,2026,5,14,4,12,59,57,2,46
Coleraine,2026,6,10,11,9,38,38,0,41
Ballinamalla,2026,7,10,4,16,37,47,-10,34
Dungannon,2026,8,7,12,11,43,44,-1,33
Glentoran,2026,9,8,9,13,26,41,-15,33
Ards,2026,10,9,5,16,39,54,-15,32
Portadown,2026,11,5,8,17,22,51,-29,23
Cliftonville,2027,1,18,5,7,57,37,20,59
Linfield,2027,2,15,10,5,62,35,27,55
Crusaders,2027,3,14,6,10,51,41,10,48
Ballymena,2027,4,14,6,10,65,56,9,48
Glenavon,2027,5,12,9,9,47,40,7,45
Coleraine,2027,6,10,12,8,36,35,1,42
Dungannon,2027,7,10,10,10,51,48,3,40
Glentoran,2027,8,9,9,12,34,45,-11,36
Ards,2027,9,7,7,16,37,52,-15,28
Ballinamalla,2027,10,7,7,16,32,51,-19,28
Portadown,2027,11,6,5,19,20,52,-32,23
Crusaders,2028,1,19,7,4,58,34,24,64
Glenavon,2028,2,14,11,5,56,43,13,53
Linfield,2028,3,15,6,9,52,32,20,51
Cliftonville,2028,4,13,6,11,48,43,5,45
Ballymena,2028,5,12,7,11,59,54,5,43
Coleraine,2028,6,10,13,7,40,36,4,43
Dungannon,2028,7,10,11,9,57,45,12,41
Ards,2028,8,10,5,15,38,50,-12,35
Glentoran,2028,9,7,9,14,28,47,-19,30
Ballinamalla,2028,10,7,4,19,30,56,-26,25
Portadown,2028,11,5,7,18,22,48,-26,22
Linfield,2029,1,18,9,3,63,24,39,63
Cliftonville,2029,2,15,6,9,53,40,13,51
Crusaders,2029,3,14,9,7,55,43,12,51
Dungannon,2029,4,12,9,9,60,43,17,45
Coleraine,2029,5,9,14,7,31,28,3,41
Glentoran,2029,6,10,10,10,33,39,-6,40
Glenavon,2029,7,9,11,10,43,48,-5,38
Ballymena,2029,8,9,10,11,49,61,-12,37
Ards,2029,9,8,7,15,33,45,-12,31
Ballinamalla,2029,10,6,7,17,26,49,-23,25
Portadown,2029,11,7,4,19,21,47,-26,25
Cliftonville,2030,1,17,5,8,66,42,24,56
Crusaders,2030,2,15,8,7,52,34,18,53
Coleraine,2030,3,14,9,7,48,35,13,51
Glenavon,2030,4,14,9,7,48,41,7,51
Linfield,2030,5,12,12,6,49,29,20,48
Ballymena,2030,6,14,6,10,58,58,0,48
Glentoran,2030,7,10,7,13,35,45,-10,37
Dungannon,2030,8,7,10,13,42,43,-1,31
Ballinamalla,2030,9,8,4,18,25,46,-21,28
Ards,2030,10,8,4,18,30,52,-22,28
Portadown,2030,11,6,6,18,20,48,-28,24
Ballymena,2031,1,16,8,6,65,54,11,56
Linfield,2031,2,14,11,5,58,28,30,53
Crusaders,2031,3,14,9,7,55,42,13,51
Coleraine,2031,4,12,12,6,50,37,13,48
Glenavon,2031,5,11,10,9,44,46,-2,43
Cliftonville,2031,6,11,8,11,48,46,2,41
Dungannon,2031,7,10,10,10,51,44,7,40
Glentoran,2031,8,10,6,14,33,51,-18,36
Ards,2031,9,10,5,15,36,47,-11,35
Ballinamalla,2031,10,7,3,20,36,58,-22,24
Portadown,2031,11,6,6,18,26,49,-23,24
Crusaders,2032,1,21,5,4,61,31,30,68
Coleraine,2032,2,15,8,7,45,33,12,53
Cliftonville,2032,3,16,3,11,58,40,18,51
Linfield,2032,4,12,9,9,53,33,20,45
Ballymena,2032,5,12,7,11,53,54,-1,43
Glenavon,2032,6,11,9,10,46,45,1,42
Dungannon,2032,7,9,10,11,51,46,5,37
Ards,2032,8,9,7,14,43,56,-13,34
Glentoran,2032,9,8,6,16,28,51,-23,30
Portadown,2032,10,8,5,17,29,49,-20,29
Ballinamalla,2032,11,7,5,18,33,62,-29,26
Crusaders,2033,1,18,9,3,53,23,30,63
Linfield,2033,2,17,7,6,65,36,29,58
Ballymena,2033,3,15,4,11,66,62,4,49
Glenavon,2033,4,11,12,7,53,48,5,45
Cliftonville,2033,5,13,5,12,49,41,8,44
Coleraine,2033,6,10,10,10,41,45,-4,40
Dungannon,2033,7,8,10,12,44,46,-2,34
Ards,2033,8,10,4,16,36,49,-13,34
Portadown,2033,9,8,8,14,28,46,-18,32
Glentoran,2033,10,8,7,15,33,48,-15,31
Ballinamalla,2033,11,7,4,19,24,48,-24,25
Linfield,2034,1,16,8,6,59,32,27,56
Crusaders,2034,2,16,8,6,55,38,17,56
Cliftonville,2034,3,15,5,10,47,36,11,50
Coleraine,2034,4,12,12,6,43,32,11,48
Glenavon,2034,5,11,10,9,50,54,-4,43
Glentoran,2034,6,11,7,12,35,39,-4,40
Dungannon,2034,7,11,6,13,54,45,9,39
Ballymena,2034,8,10,9,11,47,56,-9,39
Ards,2034,9,8,5,17,37,52,-15,29
Ballinamalla,2034,10,7,6,17,30,51,-21,27
Portadown,2034,11,6,8,16,25,47,-22,26
Glenavon,2035,1,16,8,6,51,40,11,56
Linfield,2035,2,14,11,5,56,25,31,53
Crusaders,2035,3,14,10,6,61,37,24,52
Coleraine,2035,4,14,9,7,48,31,17,51
Cliftonville,2035,5,13,6,11,43,36,7,45
Ballymena,2035,6,13,4,13,49,66,-17,43
Dungannon,2035,7,9,9,12,47,47,0,36
Glentoran,2035,8,9,8,13,34,43,-9,35
Portadown,2035,9,9,5,16,25,50,-25,32
Ards,2035,10,8,6,16,33,46,-13,30
Ballinamalla,2035,11,7,2,21,24,50,-26,23
Crusaders,2036,1,17,8,5,55,29,26,59
Linfield,2036,2,15,10,5,60,29,31,55
Ballymena,2036,3,16,5,9,58,54,4,53
Coleraine,2036,4,14,9,7,44,35,9,51
Cliftonville,2036,5,15,3,12,51,40,11,48
Glenavon,2036,6,10,9,11,40,46,-6,39
Dungannon,2036,7,10,7,13,45,48,-3,37
Glentoran,2036,8,10,6,14,29,41,-12,36
Ards,2036,9,8,7,15,39,45,-6,31
Portadown,2036,10,7,5,18,19,42,-23,26
Ballinamalla,2036,11,7,3,20,25,56,-31,24
Crusaders,2037,1,16,9,5,55,32,23,57
Ballymena,2037,2,16,5,9,57,56,1,53
Cliftonville,2037,3,15,6,9,50,35,15,51
Linfield,2037,4,12,12,6,49,29,20,48
Glenavon,2037,5,11,11,8,46,46,0,44
Coleraine,2037,6,8,15,7,37,33,4,39
Glentoran,2037,7,9,9,12,29,37,-8,36
Ards,2037,8,9,6,15,34,46,-12,33
Ballinamalla,2037,9,8,6,16,30,53,-23,30
Dungannon,2037,10,6,10,14,44,47,-3,28
Portadown,2037,11,7,7,16,25,42,-17,28
Crusaders,2038,1,14,12,4,51,27,24,54
Cliftonville,2038,2,15,6,9,60,40,20,51
Linfield,2038,3,13,12,5,63,46,17,51
Glenavon,2038,4,13,11,6,55,47,8,50
Ballymena,2038,5,14,7,9,61,58,3,49
Coleraine,2038,6,12,9,9,46,39,7,45
Dungannon,2038,7,7,13,10,44,43,1,34
Glentoran,2038,8,8,9,13,30,42,-12,33
Ards,2038,9,9,3,18,39,58,-19,30
Portadown,2038,10,7,6,17,27,49,-22,27
Ballinamalla,2038,11,7,4,19,32,59,-27,25
Linfield,2039,1,15,10,5,64,32,32,55
Crusaders,2039,2,16,7,7,56,38,18,55
Cliftonville,2039,3,14,5,11,51,40,11,47
Coleraine,2039,4,12,11,7,41,33,8,47
Ballymena,2039,5,13,6,11,61,64,-3,45
Glenavon,2039,6,9,13,8,47,44,3,40
Ards,2039,7,12,4,14,42,45,-3,40
Dungannon,2039,8,9,9,12,52,50,2,36
Portadown,2039,9,8,7,15,25,53,-28,31
Glentoran,2039,10,7,8,15,27,47,-20,29
Ballinamalla,2039,11,8,4,18,30,50,-20,28
Crusaders,2040,1,16,8,6,51,31,20,56
Ballymena,2040,2,16,8,6,63,50,13,56
Cliftonville,2040,3,16,6,8,54,35,19,54
Coleraine,2040,4,13,12,5,47,36,11,51
Linfield,2040,5,13,9,8,58,41,17,48
Ards,2040,6,10,7,13,48,51,-3,37
Dungannon,2040,7,8,11,11,47,51,-4,35
Glenavon,2040,8,8,10,12,46,54,-8,34
Glentoran,2040,9,7,8,15,30,46,-16,29
Portadown,2040,10,7,6,17,26,46,-20,27
Ballinamalla,2040,11,6,5,19,26,55,-29,23
Crusaders,2041,1,17,8,5,62,36,26,59
Ballymena,2041,2,16,5,9,56,56,0,53
Linfield,2041,3,14,9,7,61,40,21,51
Cliftonville,2041,4,15,4,11,55,39,16,49
Coleraine,2041,5,12,11,7,51,38,13,47
Glenavon,2041,6,12,9,9,55,48,7,45
Dungannon,2041,7,11,10,9,49,42,7,43
Ards,2041,8,11,5,14,44,50,-6,38
Glentoran,2041,9,7,7,16,26,48,-22,28
Ballinamalla,2041,10,7,5,18,27,52,-25,26
Portadown,2041,11,5,3,22,21,58,-37,18
Crusaders,2042,1,16,8,6,54,31,23,56
Coleraine,2042,2,16,8,6,51,38,13,56
Ballymena,2042,3,16,6,8,63,59,4,54
Linfield,2042,4,12,10,8,65,40,25,46
Dungannon,2042,5,13,7,10,53,42,11,46
Cliftonville,2042,6,13,7,10,48,38,10,46
Glenavon,2042,7,9,10,11,50,53,-3,37
Ards,2042,8,11,4,15,48,52,-4,37
Glentoran,2042,9,9,5,16,34,55,-21,32
Ballinamalla,2042,10,9,3,18,28,52,-24,30
Portadown,2042,11,5,4,21,21,55,-34,19
Crusaders,2043,1,17,7,6,59,34,25,58
Linfield,2043,2,14,11,5,59,31,28,53
Cliftonville,2043,3,16,5,9,52,34,18,53
Coleraine,2043,4,14,7,9,47,41,6,49
Ballymena,2043,5,12,5,13,55,60,-5,41
Glenavon,2043,6,10,10,10,43,48,-5,40
Ards,2043,7,11,5,14,38,44,-6,38
Dungannon,2043,8,8,10,12,44,49,-5,34
Glentoran,2043,9,9,6,15,29,43,-14,33
Ballinamalla,2043,10,9,5,16,27,44,-17,32
Portadown,2043,11,7,5,18,21,46,-25,26
Glenavon,2044,1,16,9,5,61,39,22,57
Crusaders,2044,2,16,5,9,54,34,20,53
Linfield,2044,3,14,8,8,70,39,31,50
Cliftonville,2044,4,14,6,10,56,44,12,48
Ballymena,2044,5,14,6,10,65,64,1,48
Coleraine,2044,6,10,10,10,44,47,-3,40
Glentoran,2044,7,10,8,12,36,48,-12,38
Dungannon,2044,8,10,6,14,41,52,-11,36
Ards,2044,9,8,8,14,37,47,-10,32
Ballinamalla,2044,10,9,3,18,32,52,-20,30
Portadown,2044,11,7,5,18,21,51,-30,26
Cliftonville,2045,1,18,6,6,64,39,25,60
Dungannon,2045,2,13,10,7,57,40,17,49
Ballymena,2045,3,14,6,10,57,59,-2,48
Coleraine,2045,4,12,10,8,39,31,8,46
Linfield,2045,5,11,12,7,51,30,21,45
Crusaders,2045,6,12,8,10,44,44,0,44
Glenavon,2045,7,11,8,11,45,47,-2,41
Glentoran,2045,8,11,6,13,31,45,-14,39
Portadown,2045,9,8,5,17,32,50,-18,29
Ards,2045,10,7,6,17,33,46,-13,27
Ballinamalla,2045,11,6,7,17,27,49,-22,25
Ballymena,2046,1,17,5,8,57,52,5,56
Crusaders,2046,2,16,7,7,60,33,27,55
Cliftonville,2046,3,16,6,8,51,34,17,54
Linfield,2046,4,14,9,7,55,32,23,51
Coleraine,2046,5,12,11,7,44,36,8,47
Glentoran,2046,6,11,7,12,32,42,-10,40
Dungannon,2046,7,9,11,10,55,51,4,38
Glenavon,2046,8,8,12,10,44,51,-7,36
Ards,2046,9,8,3,19,33,50,-17,27
Portadown,2046,10,6,9,15,28,48,-20,27
Ballinamalla,2046,11,7,2,21,31,61,-30,23
Crusaders,2047,1,20,6,4,60,33,27,66
Cliftonville,2047,2,18,4,8,56,35,21,58
Linfield,2047,3,15,8,7,57,28,29,53
Glenavon,2047,4,12,11,7,55,41,14,47
Ballymena,2047,5,13,7,10,54,54,0,46
Ards,2047,6,12,4,14,36,41,-5,40
Dungannon,2047,7,10,9,11,49,44,5,39
Coleraine,2047,8,8,11,11,41,44,-3,35
Portadown,2047,9,8,3,19,23,52,-29,27
Glentoran,2047,10,6,7,17,26,48,-22,25
Ballinamalla,2047,11,6,4,20,27,64,-37,22
Cliftonville,2048,1,16,7,7,56,36,20,55
Ballymena,2048,2,16,6,8,62,50,12,54
Crusaders,2048,3,14,11,5,49,30,19,53
Linfield,2048,4,14,10,6,68,44,24,52
Coleraine,2048,5,10,13,7,38,33,5,43
Glenavon,2048,6,11,10,9,43,40,3,43
Dungannon,2048,7,10,9,11,46,44,2,39
Glentoran,2048,8,10,8,12,33,44,-11,38
Ards,2048,9,7,6,17,37,53,-16,27
Ballinamalla,2048,10,8,2,20,30,60,-30,26
Portadown,2048,11,6,4,20,23,51,-28,22
Crusaders,2049,1,16,6,8,52,34,18,54
Cliftonville,2049,2,17,2,11,51,37,14,53
Linfield,2049,3,15,7,8,60,41,19,52
Coleraine,2049,4,13,10,7,47,39,8,49
Dungannon,2049,5,12,9,9,50,39,11,45
Glenavon,2049,6,11,10,9,47,42,5,43
Ballymena,2049,7,10,8,12,55,63,-8,38
Glentoran,2049,8,9,8,13,32,44,-12,35
Portadown,2049,9,10,4,16,27,46,-19,34
Ards,2049,10,8,5,17,40,57,-17,29
Ballinamalla,2049,11,7,5,18,26,45,-19,26
Crusaders,2050,1,17,5,8,50,36,14,56
Ballymena,2050,2,15,6,9,60,62,-2,51
Cliftonville,2050,3,15,5,10,59,44,15,50
Linfield,2050,4,13,10,7,57,32,25,49
Dungannon,2050,5,12,9,9,54,38,16,45
Coleraine,2050,6,11,11,8,48,40,8,44
Glenavon,2050,7,11,10,9,49,50,-1,43
Glentoran,2050,8,9,8,13,35,48,-13,35
Ards,2050,9,8,4,18,36,55,-19,28
Portadown,2050,10,7,7,16,23,46,-23,28
Ballinamalla,2050,11,8,3,19,32,52,-20,27
Linfield,2051,1,16,9,5,62,30,32,57
Glenavon,2051,2,13,10,7,46,37,9,49
Crusaders,2051,3,12,11,7,47,36,11,47
Coleraine,2051,4,11,11,8,42,39,3,44
Ballymena,2051,5,12,7,11,57,63,-6,43
Cliftonville,2051,6,11,8,11,42,40,2,41
Dungannon,2051,7,10,8,12,49,46,3,38
Glentoran,2051,8,9,9,12,38,46,-8,36
Ards,2051,9,11,3,16,42,55,-13,36
Ballinamalla,2051,10,10,3,17,35,50,-15,33
Portadown,2051,11,6,9,15,22,40,-18,27
Crusaders,2052,1,16,6,8,60,36,24,54
Ballymena,2052,2,16,6,8,60,46,14,54
Coleraine,2052,3,13,10,7,37,35,2,49
Cliftonville,2052,4,14,6,10,47,37,10,48
Linfield,2052,5,12,11,7,54,30,24,47
Glentoran,2052,6,12,6,12,31,38,-7,42
Glenavon,2052,7,9,14,7,43,47,-4,41
Dungannon,2052,8,9,9,12,46,43,3,36
Ards,2052,9,8,8,14,34,43,-9,32
Portadown,2052,10,8,2,20,28,57,-29,26
Ballinamalla,2052,11,6,6,18,24,52,-28,24
Linfield,2053,1,18,6,6,66,32,34,60
Crusaders,2053,2,17,9,4,62,29,33,60
Glenavon,2053,3,14,8,8,52,49,3,50
Coleraine,2053,4,13,9,8,48,36,12,48
Cliftonville,2053,5,14,5,11,45,40,5,47
Ballymena,2053,6,12,5,13,55,67,-12,41
Dungannon,2053,7,10,9,11,46,39,7,39
Glentoran,2053,8,9,8,13,35,43,-8,35
Ards,2053,9,8,6,16,40,56,-16,30
Portadown,2053,10,7,4,19,25,49,-24,25
Ballinamalla,2053,11,8,1,21,31,65,-34,25
Crusaders,2054,1,17,8,5,60,35,25,59
Linfield,2054,2,13,9,8,53,32,21,48
Cliftonville,2054,3,15,3,12,54,39,15,48
Dungannon,2054,4,11,10,9,51,41,10,43
Coleraine,2054,5,10,12,8,44,40,4,42
Ballymena,2054,6,11,8,11,51,57,-6,41
Ards,2054,7,12,4,14,45,45,0,40
Glenavon,2054,8,8,15,7,42,46,-4,39
Glentoran,2054,9,8,10,12,29,41,-12,34
Ballinamalla,2054,10,10,3,17,27,49,-22,33
Portadown,2054,11,5,8,17,21,52,-31,23
Linfield,2055,1,14,10,6,61,32,29,52
Cliftonville,2055,2,14,9,7,50,33,17,51
Crusaders,2055,3,12,12,6,50,34,16,48
Glenavon,2055,4,12,12,6,52,41,11,48
Coleraine,2055,5,11,12,7,44,34,10,45
Ballymena,2055,6,11,8,11,42,56,-14,41
Glentoran,2055,7,11,7,12,33,40,-7,40
Dungannon,2055,8,8,12,10,45,44,1,36
Ballinamalla,2055,9,7,8,15,27,46,-19,29
Ards,2055,10,7,7,16,30,48,-18,28
Portadown,2055,11,6,7,17,23,49,-26,25
Crusaders,2056,1,18,7,5,62,33,29,61
Cliftonville,2056,2,16,4,10,61,49,12,52
Ballymena,2056,3,14,6,10,61,55,6,48
Linfield,2056,4,12,11,7,54,38,16,47
Coleraine,2056,5,10,13,7,48,43,5,43
Dungannon,2056,6,11,9,10,57,47,10,42
Glenavon,2056,7,9,14,7,50,52,-2,41
Glentoran,2056,8,10,9,11,28,32,-4,39
Ballinamalla,2056,9,8,4,18,29,52,-23,28
Ards,2056,10,6,7,17,28,48,-20,25
Portadown,2056,11,5,8,17,28,57,-29,23
Cliftonville,2057,1,18,5,7,52,32,20,59
Crusaders,2057,2,17,7,6,60,32,28,58
Linfield,2057,3,12,10,8,51,28,23,46
Ballymena,2057,4,12,7,11,59,60,-1,43
Glenavon,2057,5,11,10,9,46,48,-2,43
Dungannon,2057,6,11,9,10,54,43,11,42
Coleraine,2057,7,10,11,9,42,33,9,41
Ards,2057,8,10,4,16,42,50,-8,34
Glentoran,2057,9,9,7,14,33,54,-21,34
Portadown,2057,10,9,5,16,25,50,-25,32
Ballinamalla,2057,11,7,3,20,24,58,-34,24
Linfield,2058,1,16,8,6,60,29,31,56
Crusaders,2058,2,16,7,7,57,40,17,55
Cliftonville,2058,3,15,5,10,55,42,13,50
Ballymena,2058,4,11,10,9,54,57,-3,43
Coleraine,2058,5,10,12,8,44,38,6,42
Glenavon,2058,6,10,11,9,49,45,4,41
Ards,2058,7,11,7,12,42,46,-4,40
Portadown,2058,8,9,8,13,28,45,-17,35
Glentoran,2058,9,9,7,14,42,56,-14,34
Dungannon,2058,10,8,8,14,43,49,-6,32
Ballinamalla,2058,11,5,7,18,28,55,-27,22
Crusaders,2059,1,15,11,4,58,34,24,56
Linfield,2059,2,15,10,5,57,32,25,55
Cliftonville,2059,3,14,8,8,56,43,13,50
Glenavon,2059,4,10,13,7,47,42,5,43
Dungannon,2059,5,10,12,8,47,42,5,42
Ballymena,2059,6,11,9,10,60,57,3,42
Coleraine,2059,7,10,11,9,36,38,-2,41
Ards,2059,8,8,11,11,35,39,-4,35
Glentoran,2059,9,8,7,15,32,47,-15,31
Portadown,2059,10,6,7,17,29,52,-23,25
Ballinamalla,2059,11,5,7,18,21,52,-31,22
Linfield,2060,1,16,8,6,55,26,29,56
Crusaders,2060,2,15,11,4,53,32,21,56
Ballymena,2060,3,16,5,9,61,54,7,53
Cliftonville,2060,4,13,9,8,46,36,10,48
Glenavon,2060,5,11,10,9,44,44,0,43
Dungannon,2060,6,11,9,10,48,41,7,42
Ards,2060,7,12,6,12,39,40,-1,42
Coleraine,2060,8,9,11,10,40,42,-2,38
Ballinamalla,2060,9,7,5,18,28,55,-27,26
Portadown,2060,10,6,6,18,20,43,-23,24
Glentoran,2060,11,5,8,17,25,46,-21,23
Crusaders,2061,1,17,7,6,59,35,24,58
Ballymena,2061,2,15,5,10,59,57,2,50
Glenavon,2061,3,13,10,7,50,42,8,49
Cliftonville,2061,4,13,9,8,48,39,9,48
Coleraine,2061,5,11,11,8,47,40,7,44
Linfield,2061,6,12,7,11,53,37,16,43
Dungannon,2061,7,9,10,11,47,39,8,37
Ards,2061,8,10,6,14,39,49,-10,36
Glentoran,2061,9,10,6,14,29,47,-18,36
Ballinamalla,2061,10,8,4,18,32,57,-25,28
Portadown,2061,11,7,5,18,21,42,-21,26
Crusaders,2062,1,15,8,7,52,35,17,53
Glenavon,2062,2,14,10,6,53,41,12,52
Linfield,2062,3,12,11,7,51,34,17,47
Cliftonville,2062,4,13,7,10,46,39,7,46
Coleraine,2062,5,12,9,9,40,34,6,45
Ballymena,2062,6,12,9,9,55,57,-2,45
Dungannon,2062,7,9,12,9,50,40,10,39
Glentoran,2062,8,8,10,12,29,39,-10,34
Ballinamalla,2062,9,8,7,15,37,52,-15,31
Portadown,2062,10,8,7,15,36,52,-16,31
Ards,2062,11,6,6,18,30,56,-26,24
Linfield,2063,1,16,9,5,57,24,33,57
Cliftonville,2063,2,16,7,7,59,37,22,55
Glenavon,2063,3,15,10,5,51,36,15,55
Crusaders,2063,4,14,7,9,49,40,9,49
Dungannon,2063,5,12,8,10,45,39,6,44
Coleraine,2063,6,12,8,10,39,34,5,44
Ballymena,2063,7,12,8,10,56,58,-2,44
Glentoran,2063,8,8,6,16,27,41,-14,30
Ards,2063,9,7,6,17,29,50,-21,27
Portadown,2063,10,7,5,18,25,50,-25,26
Ballinamalla,2063,11,6,6,18,28,56,-28,24
Crusaders,2064,1,15,9,6,55,40,15,54
Ballymena,2064,2,15,6,9,68,59,9,51
Linfield,2064,3,11,11,8,52,38,14,44
Glenavon,2064,4,11,11,8,49,49,0,44
Cliftonville,2064,5,12,7,11,48,42,6,43
Dungannon,2064,6,11,8,11,52,44,8,41
Coleraine,2064,7,10,11,9,45,44,1,41
Ards,2064,8,11,6,13,43,49,-6,39
Glentoran,2064,9,10,6,14,34,49,-15,36
Ballinamalla,2064,10,9,4,17,33,50,-17,31
Portadown,2064,11,7,7,16,28,43,-15,28
Linfield,2065,1,17,8,5,62,30,32,59
Crusaders,2065,2,15,7,8,53,37,16,52
Cliftonville,2065,3,15,4,11,53,40,13,49
Glenavon,2065,4,13,9,8,47,44,3,48
Coleraine,2065,5,12,10,8,45,40,5,46
Ballymena,2065,6,13,4,13,52,62,-10,43
Glentoran,2065,7,11,7,12,38,38,0,40
Dungannon,2065,8,8,10,12,44,46,-2,34
Ballinamalla,2065,9,9,6,15,29,45,-16,33
Portadown,2065,10,9,3,18,21,42,-21,30
Ards,2065,11,7,4,19,32,52,-20,25
Linfield,2066,1,15,9,6,61,33,28,54
Crusaders,2066,2,15,9,6,53,33,20,54
Cliftonville,2066,3,15,5,10,54,42,12,50
Ballymena,2066,4,15,5,10,62,53,9,50
Coleraine,2066,5,11,10,9,48,45,3,43
Dungannon,2066,6,9,14,7,54,42,12,41
Glenavon,2066,7,10,9,11,49,50,-1,39
Ards,2066,8,9,7,14,38,49,-11,34
Glentoran,2066,9,10,4,16,28,51,-23,34
Ballinamalla,2066,10,8,6,16,31,54,-23,30
Portadown,2066,11,6,6,18,23,49,-26,24
Linfield,2067,1,18,7,5,67,30,37,61
Crusaders,2067,2,16,9,5,54,32,22,57
Ballymena,2067,3,16,7,7,66,55,11,55
Cliftonville,2067,4,16,5,9,55,37,18,53
Coleraine,2067,5,12,9,9,46,38,8,45
Glenavon,2067,6,11,11,8,55,51,4,44
Dungannon,2067,7,8,9,13,43,51,-8,33
Ards,2067,8,9,5,16,39,49,-10,32
Glentoran,2067,9,8,5,17,26,52,-26,29
Ballinamalla,2067,10,7,6,17,30,59,-29,27
Portadown,2067,11,6,3,21,23,50,-27,21
Linfield,2068,1,17,10,3,65,25,40,61
Crusaders,2068,2,16,10,4,61,33,28,58
Cliftonville,2068,3,17,4,9,56,40,16,55
Ballymena,2068,4,15,4,11,56,54,2,49
Coleraine,2068,5,11,9,10,37,38,-1,42
Glenavon,2068,6,11,9,10,47,51,-4,42
Dungannon,2068,7,9,11,10,52,46,6,38
Ballinamalla,2068,8,10,4,16,30,49,-19,34
Ards,2068,9,8,6,16,38,56,-18,30
Glentoran,2068,10,6,7,17,29,52,-23,25
Portadown,2068,11,4,8,18,25,52,-27,20
Crusaders,2069,1,18,6,6,60,39,21,60
Linfield,2069,2,15,11,4,72,36,36,56
Cliftonville,2069,3,17,5,8,56,33,23,56
Glenavon,2069,4,10,15,5,51,38,13,45
Ballymena,2069,5,13,6,11,57,62,-5,45
Coleraine,2069,6,9,9,12,40,45,-5,36
Glentoran,2069,7,9,8,13,36,49,-13,35
Dungannon,2069,8,7,10,13,46,47,-1,31
Ballinamalla,2069,9,7,8,15,32,50,-18,29
Portadown,2069,10,7,7,16,23,56,-33,28
Ards,2069,11,5,11,14,34,52,-18,26
Crusaders,2070,1,14,12,4,59,38,21,54
Linfield,2070,2,14,10,6,69,39,30,52
Coleraine,2070,3,14,8,8,45,35,10,50
Glenavon,2070,4,12,12,6,55,47,8,48
Cliftonville,2070,5,14,5,11,52,46,6,47
Ballymena,2070,6,11,7,12,54,63,-9,40
Dungannon,2070,7,9,12,9,53,48,5,39
Ards,2070,8,9,8,13,39,46,-7,35
Portadown,2070,9,9,6,15,33,50,-17,33
Glentoran,2070,10,8,7,15,27,45,-18,31
Ballinamalla,2070,11,6,3,21,24,53,-29,21
Cliftonville,2071,1,16,6,8,59,46,13,54
Crusaders,2071,2,14,8,8,59,36,23,50
Glenavon,2071,3,13,10,7,44,46,-2,49
Coleraine,2071,4,12,12,6,46,32,14,48
Ballymena,2071,5,13,8,9,60,59,1,47
Linfield,2071,6,11,13,6,58,34,24,46
Glentoran,2071,7,10,9,11,36,44,-8,39
Dungannon,2071,8,9,9,12,49,48,1,36
Portadown,2071,9,7,8,15,25,42,-17,29
Ards,2071,10,7,7,16,39,55,-16,28
Ballinamalla,2071,11,6,4,20,32,65,-33,22
Crusaders,2072,1,17,7,6,60,34,26,58
Linfield,2072,2,16,8,6,63,33,30,56
Ballymena,2072,3,15,8,7,60,50,10,53
Cliftonville,2072,4,15,7,8,49,33,16,52
Glenavon,2072,5,14,10,6,55,48,7,52
Coleraine,2072,6,11,10,9,45,41,4,43
Dungannon,2072,7,7,11,12,47,45,2,32
Ards,2072,8,8,4,18,34,56,-22,28
Portadown,2072,9,7,7,16,28,50,-22,28
Glentoran,2072,10,7,7,16,30,55,-25,28
Ballinamalla,2072,11,6,5,19,28,54,-26,23
Linfield,2073,1,15,9,6,66,31,35,54
Cliftonville,2073,2,15,7,8,49,35,14,52
Ballymena,2073,3,13,10,7,62,56,6,49
Dungannon,2073,4,12,11,7,59,43,16,47
Crusaders,2073,5,13,7,10,47,40,7,46
Glenavon,2073,6,10,13,7,47,46,1,43
Coleraine,2073,7,9,12,9,36,41,-5,39
Ballinamalla,2073,8,10,5,15,42,55,-13,35
Glentoran,2073,9,8,8,14,37,53,-16,32
Portadown,2073,10,7,6,17,22,47,-25,27
Ards,2073,11,7,4,19,36,56,-20,25
Crusaders,2074,1,15,8,7,56,39,17,53
Cliftonville,2074,2,16,5,9,58,43,15,53
Ballymena,2074,3,15,6,9,58,56,2,51
Linfield,2074,4,13,10,7,60,35,25,49
Coleraine,2074,5,12,12,6,49,34,15,48
Glenavon,2074,6,11,11,8,45,47,-2,44
Dungannon,2074,7,11,9,10,49,46,3,42
Ards,2074,8,9,4,17,33,47,-14,31
Portadown,2074,9,8,5,17,28,48,-20,29
Glentoran,2074,10,6,9,15,26,44,-18,27
Ballinamalla,2074,11,8,3,19,28,51,-23,27
Crusaders,2075,1,17,9,4,67,38,29,60
Linfield,2075,2,16,10,4,68,32,36,58
Cliftonville,2075,3,16,5,9,56,42,14,53
Dungannon,2075,4,10,12,8,54,43,11,42
Coleraine,2075,5,9,14,7,39,37,2,41
Ballymena,2075,6,11,7,12,52,61,-9,40
Ards,2075,7,11,5,14,47,51,-4,38
Glenavon,2075,8,8,13,9,48,55,-7,37
Glentoran,2075,9,10,5,15,29,45,-16,35
Ballinamalla,2075,10,7,4,19,23,50,-27,25
Portadown,2075,11,6,4,20,24,53,-29,22
Crusaders,2076,1,17,6,7,58,33,25,57
Cliftonville,2076,2,17,4,9,56,35,21,55
Linfield,2076,3,14,10,6,64,31,33,52
Glenavon,2076,4,11,11,8,51,45,6,44
Coleraine,2076,5,12,8,10,39,45,-6,44
Ballymena,2076,6,11,9,10,52,63,-11,42
Glentoran,2076,7,9,9,12,32,45,-13,36
Dungannon,2076,8,8,11,11,44,43,1,35
Ards,2076,9,8,8,14,32,46,-14,32
Portadown,2076,10,9,5,16,28,43,-15,32
Ballinamalla,2076,11,5,7,18,29,56,-27,22
Crusaders,2077,1,18,4,8,66,42,24,58
Linfield,2077,2,15,9,6,61,34,27,54
Cliftonville,2077,3,15,6,9,52,35,17,51
Ballymena,2077,4,14,5,11,63,63,0,47
Dungannon,2077,5,12,9,9,50,37,13,45
Coleraine,2077,6,10,11,9,43,38,5,41
Ards,2077,7,11,4,15,38,49,-11,37
Glenavon,2077,8,8,12,10,40,54,-14,36
Ballinamalla,2077,9,10,5,15,35,54,-19,35
Glentoran,2077,10,9,7,14,34,47,-13,34
Portadown,2077,11,5,4,21,22,51,-29,19
Crusaders,2078,1,16,6,8,52,30,22,54
Glenavon,2078,2,14,8,8,55,44,11,50
Linfield,2078,3,12,13,5,56,29,27,49
Cliftonville,2078,4,14,4,12,56,49,7,46
Coleraine,2078,5,11,13,6,43,37,6,46
Ballymena,2078,6,13,7,10,48,51,-3,46
Glentoran,2078,7,11,9,10,35,41,-6,42
Dungannon,2078,8,8,9,13,49,49,0,33
Ballinamalla,2078,9,9,5,16,33,48,-15,32
Ards,2078,10,8,7,15,35,49,-14,31
Portadown,2078,11,6,5,19,19,54,-35,23
Linfield,2079,1,15,11,4,68,40,28,56
Cliftonville,2079,2,18,2,10,59,43,16,56
Crusaders,2079,3,15,9,6,58,43,15,54
Dungannon,2079,4,14,7,9,53,41,12,49
Coleraine,2079,5,12,11,7,39,31,8,47
Ballymena,2079,6,13,6,11,66,65,1,45
Glenavon,2079,7,9,11,10,42,44,-2,38
Glentoran,2079,8,8,10,12,36,46,-10,34
Ballinamalla,2079,9,6,8,16,29,48,-19,26
Portadown,2079,10,7,5,18,31,55,-24,26
Ards,2079,11,5,6,19,26,51,-25,21
Linfield,2080,1,17,8,5,76,35,41,59
Crusaders,2080,2,17,8,5,57,35,22,59
Ballymena,2080,3,14,9,7,65,58,7,51
Cliftonville,2080,4,14,8,8,55,45,10,50
Coleraine,2080,5,11,10,9,42,46,-4,43
Glenavon,2080,6,10,11,9,56,49,7,41
Dungannon,2080,7,10,6,14,56,50,6,36
Ards,2080,8,9,4,17,41,53,-12,31
Glentoran,2080,9,7,9,14,25,45,-20,30
Portadown,2080,10,6,8,16,24,52,-28,26
Ballinamalla,2080,11,6,7,17,27,56,-29,25
Linfield,2081,1,16,7,7,61,35,26,55
Crusaders,2081,2,15,9,6,56,34,22,54
Cliftonville,2081,3,16,5,9,53,34,19,53
Ballymena,2081,4,16,4,10,58,49,9,52
Dungannon,2081,5,11,8,11,51,44,7,41
Coleraine,2081,6,9,13,8,43,41,2,40
Glenavon,2081,7,9,12,9,49,48,1,39
Glentoran,2081,8,10,6,14,34,52,-18,36
Ballinamalla,2081,9,9,3,18,32,55,-23,30
Portadown,2081,10,7,7,16,28,51,-23,28
Ards,2081,11,6,8,16,37,59,-22,26
Linfield,2082,1,16,11,3,60,27,33,59
Crusaders,2082,2,16,8,6,62,46,16,56
Cliftonville,2082,3,14,7,9,52,36,16,49
Ballymena,2082,4,14,5,11,57,56,1,47
Dungannon,2082,5,12,10,8,56,42,14,46
Glenavon,2082,6,10,12,8,39,37,2,42
Coleraine,2082,7,7,14,9,34,39,-5,35
Ards,2082,8,9,7,14,39,49,-10,34
Glentoran,2082,9,7,8,15,27,47,-20,29
Ballinamalla,2082,10,7,7,16,32,52,-20,28
Portadown,2082,11,5,7,18,23,50,-27,22
Linfield,2083,1,17,10,3,66,28,38,61
Crusaders,2083,2,16,7,7,51,30,21,55
Cliftonville,2083,3,16,4,10,58,43,15,52
Ballymena,2083,4,16,4,10,62,56,6,52
Glenavon,2083,5,12,10,8,55,49,6,46
Dungannon,2083,6,11,9,10,48,40,8,42
Glentoran,2083,7,9,9,12,34,46,-12,36
Coleraine,2083,8,8,11,11,35,41,-6,35
Ballinamalla,2083,9,9,5,16,30,51,-21,32
Ards,2083,10,7,4,19,36,60,-24,25
Portadown,2083,11,4,7,19,27,58,-31,19
Crusaders,2084,1,17,6,7,62,32,30,57
Linfield,2084,2,16,8,6,60,30,30,56
Ballymena,2084,3,16,6,8,68,60,8,54
Cliftonville,2084,4,14,6,10,50,46,4,48
Glenavon,2084,4,12,12,6,50,46,4,48
Coleraine,2084,6,12,10,8,44,35,9,46
Dungannon,2084,7,8,9,13,46,51,-5,33
Portadown,2084,8,9,5,16,35,50,-15,32
Glentoran,2084,9,6,10,14,28,50,-22,28
Ards,2084,10,8,3,19,35,54,-19,27
Ballinamalla,2084,11,8,3,19,32,56,-24,27
Linfield,2085,1,16,9,5,64,32,32,57
Crusaders,2085,2,16,7,7,56,30,26,55
Dungannon,2085,3,14,7,9,59,44,15,49
Ballymena,2085,4,14,6,10,52,53,-1,48
Glenavon,2085,5,12,10,8,57,51,6,46
Glentoran,2085,6,12,7,11,38,43,-5,43
Cliftonville,2085,7,13,3,14,50,47,3,42
Coleraine,2085,8,9,10,11,37,41,-4,37
Ards,2085,9,6,9,15,36,57,-21,27
Ballinamalla,2085,10,7,5,18,27,57,-30,26
Portadown,2085,11,6,7,17,32,53,-21,25
Crusaders,2086,1,20,5,5,59,31,28,65
Cliftonville,2086,2,18,4,8,61,40,21,58
Ballymena,2086,3,15,5,10,54,57,-3,50
Coleraine,2086,4,13,10,7,45,37,8,49
Linfield,2086,5,12,8,10,56,35,21,44
Dungannon,2086,6,11,9,10,55,48,7,42
Glenavon,2086,7,11,9,10,44,44,0,42
Portadown,2086,8,9,4,17,27,45,-18,31
Ards,2086,9,8,5,17,40,56,-16,29
Ballinamalla,2086,10,8,2,20,27,51,-24,26
Glentoran,2086,11,6,7,17,21,45,-24,25
Linfield,2087,1,14,9,7,56,32,24,51
Coleraine,2087,2,14,8,8,52,40,12,50
Crusaders,2087,3,12,11,7,55,44,11,47
Cliftonville,2087,4,13,8,9,54,45,9,47
Ballymena,2087,5,12,8,10,51,58,-7,44
Glenavon,2087,6,11,10,9,49,48,1,43
Dungannon,2087,7,9,11,10,55,49,6,38
Ards,2087,8,10,7,13,42,48,-6,37
Glentoran,2087,9,9,8,13,36,46,-10,35
Ballinamalla,2087,10,9,6,15,38,57,-19,33
Portadown,2087,11,7,4,19,26,47,-21,25
Crusaders,2088,1,16,10,4,52,29,23,58
Linfield,2088,2,15,11,4,59,29,30,56
Cliftonville,2088,3,15,5,10,45,35,10,50
Dungannon,2088,4,12,9,9,59,40,19,45
Ballymena,2088,5,13,6,11,60,59,1,45
Coleraine,2088,6,10,12,8,46,43,3,42
Glenavon,2088,7,9,12,9,45,47,-2,39
Ards,2088,8,9,6,15,35,46,-11,33
Glentoran,2088,9,8,9,13,27,44,-17,33
Portadown,2088,10,7,5,18,25,51,-26,26
Ballinamalla,2088,11,4,9,17,20,50,-30,21
Crusaders,2089,1,18,6,6,53,35,18,60
Linfield,2089,2,15,8,7,54,32,22,53
Cliftonville,2089,3,14,6,10,46,35,11,48
Ballymena,2089,4,14,5,11,66,62,4,47
Dungannon,2089,5,13,7,10,53,41,12,46
Coleraine,2089,6,12,10,8,46,36,10,46
Ards,2089,7,12,3,15,31,46,-15,39
Glenavon,2089,8,9,10,11,47,53,-6,37
Portadown,2089,9,9,3,18,38,51,-13,30
Ballinamalla,2089,10,8,4,18,31,50,-19,28
Glentoran,2089,11,6,8,16,27,51,-24,26
Ballymena,2090,1,18,3,9,64,54,10,57
Linfield,2090,2,14,8,8,57,29,28,50
Crusaders,2090,3,13,11,6,50,34,16,50
Coleraine,2090,4,12,10,8,42,39,3,46
Cliftonville,2090,5,13,6,11,47,45,2,45
Glenavon,2090,6,12,8,10,55,50,5,44
Ards,2090,7,10,5,15,36,47,-11,35
Dungannon,2090,8,8,10,12,50,47,3,34
Glentoran,2090,9,8,9,13,36,52,-16,33
Portadown,2090,10,9,5,16,29,47,-18,32
Ballinamalla,2090,11,9,3,18,31,53,-22,30
Crusaders,2091,1,17,9,4,51,31,20,60
Linfield,2091,2,15,7,8,50,28,22,52
Cliftonville,2091,3,16,4,10,46,33,13,52
Ballymena,2091,4,15,7,8,62,56,6,52
Coleraine,2091,5,12,9,9,47,34,13,45
Glenavon,2091,6,11,12,7,41,39,2,45
Glentoran,2091,7,7,13,10,33,44,-11,34
Dungannon,2091,8,5,13,12,42,44,-2,28
Ballinamalla,2091,9,7,7,16,33,53,-20,28
Portadown,2091,10,8,4,18,24,48,-24,28
Ards,2091,11,7,5,18,37,56,-19,26
Crusaders,2092,1,17,8,5,58,30,28,59
Ballymena,2092,2,16,4,10,64,58,6,52
Glenavon,2092,3,12,11,7,46,47,-1,47
Cliftonville,2092,4,14,4,12,48,39,9,46
Coleraine,2092,5,13,7,10,37,36,1,46
Linfield,2092,6,12,7,11,49,33,16,43
Ards,2092,7,11,5,14,38,44,-6,38
Dungannon,2092,8,8,9,13,45,45,0,33
Glentoran,2092,9,9,6,15,31,47,-16,33
Portadown,2092,10,9,5,16,25,42,-17,32
Ballinamalla,2092,11,9,4,17,33,53,-20,31
Crusaders,2093,1,19,6,5,62,35,27,63
Linfield,2093,2,15,10,5,72,38,34,55
Coleraine,2093,3,15,9,6,46,32,14,54
Cliftonville,2093,4,15,5,10,49,41,8,50
Ballymena,2093,5,13,5,12,58,60,-2,44
Dungannon,2093,6,10,10,10,49,44,5,40
Glenavon,2093,7,9,9,12,40,48,-8,36
Glentoran,2093,8,8,7,15,32,51,-19,31
Ards,2093,9,8,5,17,32,46,-14,29
Portadown,2093,10,7,7,16,26,49,-23,28
Ballinamalla,2093,11,7,5,18,32,54,-22,26
Crusaders,2094,1,15,11,4,57,38,19,56
Glenavon,2094,2,12,11,7,49,42,7,47
Linfield,2094,3,12,10,8,55,32,23,46
Cliftonville,2094,4,12,10,8,50,40,10,46
Ballymena,2094,5,13,7,10,58,60,-2,46
Coleraine,2094,6,12,9,9,38,42,-4,45
Dungannon,2094,7,9,11,10,50,50,0,38
Ards,2094,8,9,7,14,40,46,-6,34
Ballinamalla,2094,9,9,5,16,43,55,-12,32
Glentoran,2094,10,7,9,14,25,41,-16,30
Portadown,2094,11,5,10,15,25,44,-19,25
Crusaders,2095,1,15,10,5,53,32,21,55
Linfield,2095,2,15,8,7,68,37,31,53
Ballymena,2095,3,14,7,9,63,63,0,49
Cliftonville,2095,4,14,4,12,53,45,8,46
Ards,2095,5,13,5,12,43,43,0,44
Glenavon,2095,6,10,13,7,49,45,4,43
Dungannon,2095,7,9,12,9,49,44,5,39
Glentoran,2095,8,10,6,14,33,47,-14,36
Coleraine,2095,9,8,10,12,37,43,-6,34
Ballinamalla,2095,10,7,7,16,26,50,-24,28
Portadown,2095,11,7,4,19,25,50,-25,25
Crusaders,2096,1,19,8,3,62,28,34,65
Cliftonville,2096,2,17,6,7,51,35,16,57
Linfield,2096,3,13,11,6,60,32,28,50
Coleraine,2096,4,12,9,9,46,37,9,45
Ballymena,2096,5,12,6,12,52,58,-6,42
Glenavon,2096,6,10,11,9,47,44,3,41
Dungannon,2096,7,9,10,11,51,47,4,37
Glentoran,2096,8,9,4,17,28,49,-21,31
Ballinamalla,2096,9,9,4,17,30,55,-25,31
Portadown,2096,10,8,6,16,30,47,-17,30
Ards,2096,11,7,5,18,33,58,-25,26
Crusaders,2097,1,18,9,3,58,28,30,63
Linfield,2097,2,17,8,5,65,31,34,59
Cliftonville,2097,3,13,6,11,49,43,6,45
Coleraine,2097,4,10,14,6,36,30,6,44
Ballymena,2097,5,12,6,12,52,59,-7,42
Glentoran,2097,6,10,10,10,31,36,-5,40
Glenavon,2097,7,10,9,11,49,58,-9,39
Portadown,2097,8,9,7,14,26,36,-10,34
Ards,2097,9,8,6,16,38,51,-13,30
Dungannon,2097,10,6,9,15,43,50,-7,27
Ballinamalla,2097,11,7,6,17,26,51,-25,27
Linfield,2098,1,17,7,6,61,31,30,58
Crusaders,2098,2,17,7,6,61,34,27,58
Cliftonville,2098,3,15,5,10,53,40,13,50
Glenavon,2098,4,10,12,8,41,37,4,42
Ballymena,2098,5,11,9,10,52,58,-6,42
Coleraine,2098,6,9,13,8,34,36,-2,40
Dungannon,2098,7,7,12,11,42,42,0,33
Ballinamalla,2098,8,9,6,15,33,47,-14,33
Glentoran,2098,9,9,6,15,33,48,-15,33
Portadown,2098,10,8,7,15,30,50,-20,31
Ards,2098,11,8,6,16,32,49,-17,30
Crusaders,2099,1,16,7,7,52,33,19,55
Linfield,2099,2,14,12,4,59,31,28,54
Coleraine,2099,3,15,9,6,56,45,11,54
Glenavon,2099,4,12,10,8,48,41,7,46
Cliftonville,2099,5,14,3,13,49,43,6,45
Ballymena,2099,6,12,7,11,58,62,-4,43
Dungannon,2099,7,10,10,10,55,50,5,40
Ards,2099,8,9,4,17,33,48,-15,31
Glentoran,2099,9,7,8,15,31,47,-16,29
Portadown,2099,10,7,8,15,24,43,-19,29
Ballinamalla,2099,11,7,6,17,33,55,-22,27
Crusaders,2100,1,18,6,6,58,31,27,60
Cliftonville,2100,2,17,3,10,58,40,18,54
Ballymena,2100,3,15,7,8,63,57,6,52
Linfield,2100,4,14,7,9,51,31,20,49
Coleraine,2100,5,13,9,8,48,36,12,48
Glenavon,2100,6,12,10,8,45,44,1,46
Dungannon,2100,7,10,9,11,48,43,5,39
Ards,2100,8,10,4,16,35,48,-13,34
Glentoran,2100,9,9,6,15,30,48,-18,33
Ballinamalla,2100,10,8,2,20,27,55,-28,26
Portadown,2100,11,6,3,21,22,52,-30,21
Linfield,2101,1,18,8,4,65,23,42,62
Crusaders,2101,2,15,10,5,53,35,18,55
Coleraine,2101,3,15,10,5,49,34,15,55
Cliftonville,2101,4,13,5,12,50,42,8,44
Glenavon,2101,5,10,12,8,49,50,-1,42
Ballymena,2101,6,12,5,13,55,65,-10,41
Portadown,2101,7,11,4,15,34,44,-10,37
Dungannon,2101,8,8,9,13,48,49,-1,33
Ballinamalla,2101,9,10,3,17,37,56,-19,33
Ards,2101,10,8,5,17,39,57,-18,29
Glentoran,2101,11,5,9,16,23,47,-24,24
Linfield,2102,1,15,9,6,73,44,29,54
Crusaders,2102,2,14,9,7,47,32,15,51
Ballymena,2102,3,15,5,10,57,57,0,50
Glenavon,2102,4,13,9,8,48,42,6,48
Dungannon,2102,5,12,10,8,57,45,12,46
Cliftonville,2102,6,13,6,11,48,38,10,45
Coleraine,2102,7,10,10,10,40,39,1,40
Glentoran,2102,8,10,8,12,31,41,-10,38
Ards,2102,9,9,3,18,35,46,-11,30
Portadown,2102,10,7,6,17,24,52,-28,27
Ballinamalla,2102,11,7,5,18,30,54,-24,26
Linfield,2103,1,16,10,4,67,26,41,58
Crusaders,2103,2,16,8,6,51,28,23,56
Ballymena,2103,3,15,5,10,56,52,4,50
Cliftonville,2103,4,14,5,11,48,40,8,47
Coleraine,2103,5,12,8,10,42,40,2,44
Dungannon,2103,6,11,10,9,47,44,3,43
Glenavon,2103,7,10,12,8,48,50,-2,42
Ballinamalla,2103,8,9,4,17,31,50,-19,31
Glentoran,2103,9,8,6,16,31,52,-21,30
Ards,2103,10,8,5,17,37,49,-12,29
Portadown,2103,11,7,5,18,28,55,-27,26
Linfield,2104,1,17,7,6,63,35,28,58
Crusaders,2104,2,15,8,7,52,31,21,53
Coleraine,2104,3,14,10,6,43,32,11,52
Ballymena,2104,4,14,7,9,58,53,5,49
Cliftonville,2104,5,14,4,12,47,44,3,46
Dungannon,2104,6,12,8,10,55,44,11,44
Glentoran,2104,7,10,7,13,36,43,-7,37
Glenavon,2104,8,9,10,11,39,49,-10,37
Ards,2104,9,8,7,15,35,46,-11,31
Portadown,2104,10,7,7,16,30,45,-15,28
Ballinamalla,2104,11,6,3,21,24,60,-36,21
Linfield,2105,1,14,12,4,60,25,35,54
Cliftonville,2105,2,16,3,11,49,34,15,51
Glenavon,2105,3,13,10,7,51,45,6,49
Crusaders,2105,4,13,9,8,53,34,19,48
Ballymena,2105,5,12,7,11,55,63,-8,43
Coleraine,2105,6,10,10,10,37,35,2,40
Ards,2105,7,11,6,13,37,42,-5,39
Dungannon,2105,8,9,10,11,43,44,-1,37
Portadown,2105,9,9,6,15,26,42,-16,33
Glentoran,2105,10,7,8,15,30,52,-22,29
Ballinamalla,2105,11,6,9,15,24,49,-25,27
Cliftonville,2106,1,20,3,7,61,35,26,63
Crusaders,2106,2,17,8,5,55,32,23,59
Linfield,2106,3,15,8,7,51,25,26,53
Glenavon,2106,4,13,9,8,49,39,10,48
Ballymena,2106,5,11,8,11,52,63,-11,41
Glentoran,2106,6,10,10,10,33,37,-4,40
Coleraine,2106,7,9,10,11,38,44,-6,37
Dungannon,2106,8,8,9,13,47,51,-4,33
Ards,2106,9,9,6,15,34,43,-9,33
Ballinamalla,2106,10,8,2,20,24,49,-25,26
Portadown,2106,11,6,5,19,20,46,-26,23
Ballymena,2107,1,17,5,8,69,57,12,56
Crusaders,2107,2,16,7,7,57,39,18,55
Cliftonville,2107,3,16,6,8,52,39,13,54
Linfield,2107,4,12,10,8,56,38,18,46
Glenavon,2107,5,11,9,10,53,47,6,42
Coleraine,2107,6,8,14,8,42,42,0,38
Glentoran,2107,7,10,7,13,31,48,-17,37
Dungannon,2107,8,9,9,12,55,54,1,36
Ards,2107,9,8,7,15,40,50,-10,31
Portadown,2107,10,7,8,15,28,45,-17,29
Ballinamalla,2107,11,7,6,17,34,58,-24,27
Crusaders,2108,1,16,9,5,59,35,24,57
Linfield,2108,2,15,10,5,62,34,28,55
Ballymena,2108,3,16,5,9,68,56,12,53
Cliftonville,2108,4,14,5,11,53,43,10,47
Coleraine,2108,5,12,10,8,42,36,6,46
Dungannon,2108,6,9,11,10,52,48,4,38
Glenavon,2108,7,9,10,11,44,55,-11,37
Portadown,2108,8,10,4,16,27,45,-18,34
Ards,2108,9,8,7,15,33,45,-12,31
Glentoran,2108,10,7,10,13,32,48,-16,31
Ballinamalla,2108,11,6,5,19,20,47,-27,23
Crusaders,2109,1,15,7,8,52,39,13,52
Cliftonville,2109,2,14,9,7,53,35,18,51
Linfield,2109,3,12,12,6,55,30,25,48
Ballymena,2109,4,14,6,10,62,54,8,48
Dungannon,2109,5,11,12,7,58,41,17,45
Coleraine,2109,6,11,12,7,45,40,5,45
Glentoran,2109,7,8,12,10,27,34,-7,36
Glenavon,2109,8,8,9,13,39,52,-13,33
Ards,2109,9,8,8,14,37,51,-14,32
Portadown,2109,10,8,6,16,21,47,-26,30
Ballinamalla,2109,11,8,3,19,28,54,-26,27
Crusaders,2110,1,17,7,6,60,37,23,58
Cliftonville,2110,2,15,7,8,55,39,16,52
Glenavon,2110,3,13,12,5,55,40,15,51
Linfield,2110,4,13,10,7,60,35,25,49
Coleraine,2110,5,11,11,8,40,38,2,44
Ballymena,2110,6,12,8,10,52,53,-1,44
Dungannon,2110,7,11,9,10,51,40,11,42
Glentoran,2110,8,9,8,13,31,46,-15,35
Ards,2110,9,10,4,16,40,58,-18,34
Portadown,2110,10,5,7,18,27,50,-23,22
Ballinamalla,2110,11,5,5,20,24,59,-35,20
Linfield,2111,1,18,8,4,60,26,34,62
Crusaders,2111,2,15,5,10,53,42,11,50
Cliftonville,2111,3,15,5,10,49,39,10,50
Coleraine,2111,4,13,10,7,41,34,7,49
Dungannon,2111,5,12,8,10,52,43,9,44
Ballymena,2111,6,13,5,12,56,65,-9,44
Glenavon,2111,7,10,12,8,49,48,1,42
Ards,2111,8,11,4,15,41,48,-7,37
Glentoran,2111,9,9,8,13,27,37,-10,35
Portadown,2111,10,7,5,18,27,45,-18,26
Ballinamalla,2111,11,4,6,20,30,58,-28,18
Crusaders,2112,1,18,6,6,60,34,26,60
Ballymena,2112,2,15,6,9,66,59,7,51
Glenavon,2112,3,14,8,8,46,43,3,50
Linfield,2112,4,13,8,9,59,38,21,47
Coleraine,2112,5,11,10,9,39,34,5,43
Ards,2112,6,12,4,14,37,40,-3,40
Dungannon,2112,7,10,8,12,53,44,9,38
Cliftonville,2112,8,11,5,14,42,50,-8,38
Ballinamalla,2112,9,12,1,17,38,51,-13,37
Portadown,2112,10,7,9,14,30,52,-22,30
Glentoran,2112,11,5,9,16,27,52,-25,24
Crusaders,2113,1,17,8,5,60,35,25,59
Linfield,2113,2,15,8,7,70,40,30,53
Glenavon,2113,3,12,11,7,50,44,6,47
Cliftonville,2113,4,14,3,13,48,41,7,45
Ballymena,2113,5,13,4,13,54,66,-12,43
Dungannon,2113,6,10,10,10,51,44,7,40
Coleraine,2113,7,10,10,10,42,46,-4,40
Ards,2113,8,11,4,15,44,49,-5,37
Glentoran,2113,9,8,10,12,33,46,-13,34
Portadown,2113,10,9,5,16,28,43,-15,32
Ballinamalla,2113,11,7,5,18,27,53,-26,26
Crusaders,2114,1,16,11,3,61,32,29,59
Cliftonville,2114,2,18,5,7,62,34,28,59
Linfield,2114,3,11,13,6,57,33,24,46
Coleraine,2114,4,12,10,8,46,43,3,46
Ballymena,2114,5,11,8,11,50,56,-6,41
Dungannon,2114,6,9,11,10,48,46,2,38
Glenavon,2114,7,8,14,8,43,46,-3,38
Ards,2114,8,10,6,14,37,48,-11,36
Ballinamalla,2114,9,8,7,15,36,54,-18,31
Portadown,2114,10,8,6,16,27,49,-22,30
Glentoran,2114,11,6,5,19,26,52,-26,23
Crusaders,2115,1,15,11,4,54,30,24,56
Linfield,2115,2,14,10,6,58,33,25,52
Ballymena,2115,3,14,8,8,57,51,6,50
Coleraine,2115,4,12,11,7,41,32,9,47
Cliftonville,2115,5,14,4,12,50,38,12,46
Glenavon,2115,6,12,9,9,46,43,3,45
Dungannon,2115,7,11,10,9,50,43,7,43
Portadown,2115,8,9,5,16,26,45,-19,32
Ballinamalla,2115,9,8,7,15,33,51,-18,31
Ards,2115,10,6,7,17,35,58,-23,25
Glentoran,2115,11,6,6,18,26,52,-26,24
Crusaders,2116,1,18,8,4,49,24,25,62
Linfield,2116,2,14,10,6,53,28,25,52
Cliftonville,2116,3,16,4,10,55,37,18,52
Glenavon,2116,4,10,13,7,46,42,4,43
Ballymena,2116,5,12,5,13,56,65,-9,41
Dungannon,2116,6,9,11,10,48,43,5,38
Coleraine,2116,7,9,11,10,39,42,-3,38
Glentoran,2116,8,9,10,11,30,39,-9,37
Ards,2116,9,9,4,17,38,50,-12,31
Ballinamalla,2116,10,8,6,16,27,47,-20,30
Portadown,2116,11,7,6,17,23,47,-24,27
Crusaders,2117,1,17,6,7,59,36,23,57
Linfield,2117,2,15,9,6,56,29,27,54
Ballymena,2117,3,14,8,8,58,58,0,50
Coleraine,2117,4,13,10,7,41,32,9,49
Cliftonville,2117,5,15,3,12,48,39,9,48
Glenavon,2117,6,9,13,8,47,49,-2,40
Glentoran,2117,7,9,10,11,39,43,-4,37
Dungannon,2117,8,8,11,11,48,48,0,35
Ards,2117,9,9,6,15,39,54,-15,33
Portadown,2117,10,8,4,18,28,45,-17,28
Ballinamalla,2117,11,7,2,21,23,53,-30,23
Coleraine,2118,1,19,7,4,56,29,27,64
Linfield,2118,2,16,7,7,63,28,35,55
Crusaders,2118,3,14,9,7,50,36,14,51
Cliftonville,2118,4,13,5,12,54,45,9,44
Ballymena,2118,5,12,7,11,51,61,-10,43
Dungannon,2118,6,10,11,9,54,44,10,41
Glenavon,2118,7,9,9,12,41,46,-5,36
Ards,2118,8,10,6,14,32,43,-11,36
Ballinamalla,2118,9,10,4,16,31,49,-18,34
Glentoran,2118,10,8,7,15,27,49,-22,31
Portadown,2118,11,5,6,19,18,47,-29,21
Linfield,2119,1,16,9,5,58,28,30,57
Crusaders,2119,2,17,6,7,58,38,20,57
Cliftonville,2119,3,16,5,9,56,40,16,53
Ballymena,2119,4,13,5,12,55,64,-9,44
Coleraine,2119,5,10,12,8,42,40,2,42
Glenavon,2119,6,9,14,7,50,46,4,41
Ards,2119,7,10,6,14,41,48,-7,36
Dungannon,2119,8,8,10,12,43,46,-3,34
Glentoran,2119,9,8,9,13,28,37,-9,33
Ballinamalla,2119,10,9,4,17,36,53,-17,31
Portadown,2119,11,7,4,19,25,52,-27,25
Crusaders,2120,1,17,7,6,64,36,28,58
Cliftonville,2120,2,17,6,7,56,40,16,57
Linfield,2120,3,14,9,7,56,32,24,51
Ballymena,2120,4,14,6,10,58,55,3,48
Glenavon,2120,5,11,9,10,43,47,-4,42
Dungannon,2120,6,11,7,12,51,45,6,40
Coleraine,2120,7,9,11,10,39,39,0,38
Glentoran,2120,8,10,8,12,30,43,-13,38
Ards,2120,9,9,5,16,42,55,-13,32
Portadown,2120,10,8,5,17,25,42,-17,29
Ballinamalla,2120,11,6,5,19,26,56,-30,23
Linfield,2121,1,16,8,6,60,35,25,56
Crusaders,2121,2,16,6,8,53,32,21,54
Cliftonville,2121,3,13,7,10,49,43,6,46
Glenavon,2121,4,11,12,7,45,44,1,45
Ballymena,2121,5,13,5,12,54,55,-1,44
Dungannon,2121,6,9,12,9,47,43,4,39
Ards,2121,7,11,5,14,43,51,-8,38
Portadown,2121,8,9,8,13,29,33,-4,35
Coleraine,2121,9,8,11,11,35,41,-6,35
Glentoran,2121,10,10,4,16,29,42,-13,34
Ballinamalla,2121,11,9,2,19,31,56,-25,29
Linfield,2122,1,16,8,6,59,32,27,56
Cliftonville,2122,2,16,6,8,62,40,22,54
Ballymena,2122,3,16,4,10,76,62,14,52
Crusaders,2122,4,13,11,6,46,34,12,50
Glentoran,2122,5,11,8,11,38,46,-8,41
Glenavon,2122,6,8,14,8,41,43,-2,38
Coleraine,2122,7,9,11,10,38,41,-3,38
Ards,2122,8,9,6,15,35,47,-12,33
Portadown,2122,9,9,4,17,28,49,-21,31
Dungannon,2122,10,6,12,12,45,48,-3,30
Ballinamalla,2122,11,5,10,15,27,53,-26,25
Crusaders,2123,1,19,7,4,58,24,34,64
Linfield,2123,2,17,7,6,65,33,32,58
Cliftonville,2123,3,18,3,9,57,35,22,57
Dungannon,2123,4,10,11,9,52,43,9,41
Ballymena,2123,5,12,3,15,56,61,-5,39
Coleraine,2123,6,10,9,11,36,41,-5,39
Glenavon,2123,7,8,13,9,40,45,-5,37
Glentoran,2123,8,9,7,14,24,40,-16,34
Ards,2123,9,10,3,17,37,50,-13,33
Ballinamalla,2123,10,9,3,18,29,60,-31,30
Portadown,2123,11,8,4,18,27,49,-22,28
Crusaders,2124,1,21,6,3,61,25,36,69
Cliftonville,2124,2,17,3,10,59,41,18,54
Coleraine,2124,3,12,10,8,45,39,6,46
Linfield,2124,4,12,9,9,56,33,23,45
Glenavon,2124,5,11,11,8,46,48,-2,44
Ballymena,2124,6,12,7,11,46,53,-7,43
Glentoran,2124,7,8,12,10,32,41,-9,36
Dungannon,2124,8,8,9,13,42,48,-6,33
Portadown,2124,9,9,6,15,28,42,-14,33
Ards,2124,10,7,8,15,34,49,-15,29
Ballinamalla,2124,11,4,7,19,27,57,-30,19
Ballymena,2125,1,17,5,8,63,60,3,56
Crusaders,2125,2,16,6,8,55,37,18,54
Linfield,2125,3,14,8,8,63,34,29,50
Coleraine,2125,4,13,10,7,50,37,13,49
Cliftonville,2125,5,14,4,12,50,43,7,46
Dungannon,2125,6,12,8,10,56,43,13,44
Glenavon,2125,7,10,11,9,44,45,-1,41
Ards,2125,8,11,4,15,40,50,-10,37
Glentoran,2125,9,8,7,15,23,45,-22,31
Ballinamalla,2125,10,7,5,18,24,52,-28,26
Portadown,2125,11,6,6,18,24,46,-22,24
Crusaders,2126,1,16,9,5,53,35,18,57
Ballymena,2126,2,15,6,9,58,55,3,51
Linfield,2126,3,13,11,6,60,32,28,50
Cliftonville,2126,4,14,7,9,58,46,12,49
Coleraine,2126,5,10,13,7,43,38,5,43
Glenavon,2126,6,11,9,10,45,53,-8,42
Glentoran,2126,7,11,8,11,37,46,-9,41
Dungannon,2126,8,10,7,13,50,41,9,37
Ards,2126,9,8,5,17,37,51,-14,29
Portadown,2126,10,7,7,16,30,50,-20,28
Ballinamalla,2126,11,6,6,18,27,51,-24,24
Ballymena,2127,1,18,4,8,61,54,7,58
Cliftonville,2127,2,16,6,8,54,35,19,54
Linfield,2127,3,13,10,7,56,33,23,49
Crusaders,2127,4,12,10,8,56,44,12,46
Coleraine,2127,5,11,10,9,42,37,5,43
Glentoran,2127,6,11,7,12,36,42,-6,40
Glenavon,2127,7,10,9,11,40,47,-7,39
Dungannon,2127,8,9,11,10,48,45,3,38
Ards,2127,9,10,6,14,39,48,-9,36
Ballinamalla,2127,10,8,7,15,32,47,-15,31
Portadown,2127,11,5,4,21,28,60,-32,19
Crusaders,2128,1,17,7,6,59,39,20,58
Cliftonville,2128,2,14,8,8,52,37,15,50
Linfield,2128,3,12,13,5,53,30,23,49
Ballymena,2128,4,13,9,8,60,58,2,48
Glenavon,2128,5,12,10,8,47,45,2,46
Coleraine,2128,6,11,10,9,48,37,11,43
Glentoran,2128,7,10,7,13,36,45,-9,37
Dungannon,2128,8,8,10,12,45,43,2,34
Ards,2128,9,10,4,16,35,48,-13,34
Ballinamalla,2128,10,9,4,17,29,53,-24,31
Portadown,2128,11,5,6,19,25,54,-29,21
Crusaders,2129,1,16,8,6,56,27,29,56
Linfield,2129,2,14,11,5,60,29,31,53
Cliftonville,2129,3,13,6,11,46,38,8,45
Ballymena,2129,4,13,6,11,54,57,-3,45
Coleraine,2129,5,10,11,9,42,40,2,41
Ards,2129,6,12,5,13,36,46,-10,41
Dungannon,2129,7,9,10,11,44,41,3,37
Glenavon,2129,8,8,13,9,40,45,-5,37
Glentoran,2129,9,8,10,12,24,38,-14,34
Ballinamalla,2129,10,9,5,16,27,46,-19,32
Portadown,2129,11,8,5,17,22,44,-22,29
Linfield,2130,1,18,9,3,64,28,36,63
Crusaders,2130,2,18,7,5,53,26,27,61
Coleraine,2130,3,12,12,6,43,35,8,48
Cliftonville,2130,4,13,5,12,49,43,6,44
Ballymena,2130,5,12,7,11,57,59,-2,43
Glenavon,2130,6,9,15,6,47,44,3,42
Dungannon,2130,7,10,9,11,46,46,0,39
Portadown,2130,8,8,8,14,28,43,-15,32
Ards,2130,9,7,6,17,32,47,-15,27
Glentoran,2130,10,5,12,13,21,40,-19,27
Ballinamalla,2130,11,4,8,18,21,50,-29,20
Cliftonville,2131,1,18,5,7,56,36,20,59
Crusaders,2131,2,16,5,9,58,35,23,53
Ballymena,2131,3,16,5,9,59,53,6,53
Linfield,2131,4,13,9,8,50,28,22,48
Glenavon,2131,5,11,12,7,52,45,7,45
Dungannon,2131,6,9,9,12,49,50,-1,36
Coleraine,2131,7,8,10,12,37,41,-4,34
Ballinamalla,2131,8,10,4,16,30,46,-16,34
Portadown,2131,9,9,6,15,32,54,-22,33
Glentoran,2131,10,8,8,14,27,45,-18,32
Ards,2131,11,9,3,18,40,57,-17,30
Linfield,2132,1,17,8,5,53,23,30,59
Cliftonville,2132,2,15,6,9,49,32,17,51
Crusaders,2132,3,12,9,9,43,30,13,45
Coleraine,2132,4,11,11,8,41,39,2,44
Ballymena,2132,5,13,5,12,50,52,-2,44
Glenavon,2132,5,12,8,10,50,52,-2,44
Dungannon,2132,7,9,10,11,44,39,5,37
Ards,2132,8,11,4,15,39,50,-11,37
Glentoran,2132,9,9,9,12,30,41,-11,36
Portadown,2132,10,8,6,16,28,45,-17,30
Ballinamalla,2132,11,8,4,18,30,54,-24,28
Cliftonville,2133,1,16,8,6,57,33,24,56
Ballymena,2133,2,15,8,7,61,54,7,53
Crusaders,2133,3,15,6,9,47,28,19,51
Linfield,2133,4,12,12,6,55,31,24,48
Coleraine,2133,5,11,12,7,42,41,1,45
Glenavon,2133,6,11,9,10,42,49,-7,42
Dungannon,2133,7,10,10,10,49,41,8,40
Glentoran,2133,8,9,7,14,29,43,-14,34
Ards,2133,9,8,6,16,36,50,-14,30
Ballinamalla,2133,10,8,4,18,30,55,-25,28
Portadown,2133,11,6,6,18,23,46,-23,24
Crusaders,2134,1,19,8,3,63,32,31,65
Linfield,2134,2,14,10,6,57,30,27,52
Cliftonville,2134,3,15,4,11,56,45,11,49
Ballymena,2134,4,14,7,9,56,52,4,49
Coleraine,2134,5,12,8,10,45,43,2,44
Ards,2134,6,13,4,13,54,45,9,43
Dungannon,2134,7,9,9,12,48,52,-4,36
Glenavon,2134,8,6,13,11,38,49,-11,31
Ballinamalla,2134,9,9,4,17,34,52,-18,31
Glentoran,2134,10,8,7,15,23,44,-21,31
Portadown,2134,11,6,6,18,24,54,-30,24
Crusaders,2135,1,15,7,8,50,30,20,52
Linfield,2135,2,13,12,5,64,37,27,51
Coleraine,2135,3,14,7,9,45,38,7,49
Cliftonville,2135,4,14,4,12,56,48,8,46
Glenavon,2135,5,12,9,9,52,48,4,45
Ballymena,2135,6,13,6,11,53,57,-4,45
Dungannon,2135,7,11,9,10,49,39,10,42
Glentoran,2135,8,10,6,14,32,49,-17,36
Ballinamalla,2135,9,9,6,15,28,47,-19,33
Ards,2135,10,9,4,17,36,51,-15,31
Portadown,2135,11,7,6,17,28,49,-21,27
Linfield,2136,1,14,12,4,56,26,30,54
Cliftonville,2136,2,16,5,9,56,38,18,53
Crusaders,2136,3,14,9,7,52,40,12,51
Coleraine,2136,4,13,9,8,42,31,11,48
Ballymena,2136,5,13,9,8,56,53,3,48
Dungannon,2136,6,10,11,9,54,41,13,41
Ards,2136,7,9,6,15,33,50,-17,33
Glentoran,2136,8,8,8,14,27,49,-22,32
Glenavon,2136,9,6,13,11,41,52,-11,31
Portadown,2136,10,8,6,16,26,42,-16,30
Ballinamalla,2136,11,7,6,17,34,55,-21,27
Linfield,2137,1,19,7,4,67,29,38,64
Cliftonville,2137,2,16,6,8,48,32,16,54
Crusaders,2137,3,15,6,9,54,42,12,51
Coleraine,2137,4,13,10,7,48,36,12,49
Glenavon,2137,5,12,8,10,50,46,4,44
Ballymena,2137,6,11,3,16,47,62,-15,36
Dungannon,2137,7,8,11,11,50,48,2,35
Glentoran,2137,8,8,10,12,35,47,-12,34
Ards,2137,9,10,4,16,35,52,-17,34
Portadown,2137,10,8,5,17,23,42,-19,29
Ballinamalla,2137,11,6,8,16,28,49,-21,26
Crusaders,2138,1,19,6,5,61,29,32,63
Linfield,2138,2,14,10,6,62,37,25,52
Ballymena,2138,3,13,9,8,50,51,-1,48
Cliftonville,2138,4,13,8,9,46,39,7,47
Dungannon,2138,5,11,8,11,53,45,8,41
Glenavon,2138,6,9,13,8,46,43,3,40
Coleraine,2138,7,9,11,10,46,44,2,38
Glentoran,2138,8,8,12,10,35,49,-14,36
Ards,2138,9,6,10,14,39,52,-13,28
Portadown,2138,10,7,7,16,25,44,-19,28
Ballinamalla,2138,11,7,4,19,30,60,-30,25
Crusaders,2139,1,17,6,7,62,36,26,57
Cliftonville,2139,2,15,5,10,60,47,13,50
Linfield,2139,3,12,13,5,58,38,20,49
Coleraine,2139,4,12,12,6,49,35,14,48
Glenavon,2139,5,12,9,9,45,47,-2,45
Ballymena,2139,6,12,7,11,59,64,-5,43
Dungannon,2139,7,11,9,10,53,46,7,42
Glentoran,2139,8,7,13,10,30,39,-9,34
Portadown,2139,9,7,8,15,36,48,-12,29
Ballinamalla,2139,10,7,5,18,30,58,-28,26
Ards,2139,11,6,7,17,32,56,-24,25
Crusaders,2140,1,16,6,8,56,33,23,54
Cliftonville,2140,2,16,6,8,54,39,15,54
Coleraine,2140,3,12,11,7,40,36,4,47
Linfield,2140,4,12,10,8,50,31,19,46
Ballymena,2140,5,12,9,9,54,54,0,45
Dungannon,2140,6,11,10,9,55,48,7,43
Glenavon,2140,7,10,10,10,51,48,3,40
Glentoran,2140,8,9,10,11,31,43,-12,37
Portadown,2140,9,7,9,14,28,42,-14,30
Ballinamalla,2140,10,7,7,16,30,54,-24,28
Ards,2140,11,5,8,17,30,51,-21,23
Cliftonville,2141,1,18,6,6,60,36,24,60
Crusaders,2141,2,14,10,6,55,34,21,52
Dungannon,2141,3,13,8,9,53,43,10,47
Linfield,2141,4,12,10,8,52,36,16,46
Ballymena,2141,5,13,7,10,58,58,0,46
Coleraine,2141,6,12,9,9,41,37,4,45
Glenavon,2141,7,12,7,11,54,51,3,43
Ballinamalla,2141,8,11,4,15,39,51,-12,37
Glentoran,2141,9,6,9,15,26,49,-23,27
Ards,2141,10,7,5,18,35,53,-18,26
Portadown,2141,11,6,7,17,26,51,-25,25
Crusaders,2142,1,18,7,5,61,33,28,61
Cliftonville,2142,2,18,4,8,54,36,18,58
Ballymena,2142,3,16,6,8,61,57,4,54
Linfield,2142,4,15,7,8,61,35,26,52
Glenavon,2142,5,13,10,7,52,39,13,49
Coleraine,2142,6,11,10,9,38,35,3,43
Glentoran,2142,7,8,7,15,26,45,-19,31
Dungannon,2142,8,6,12,12,45,47,-2,30
Ballinamalla,2142,9,8,5,17,32,54,-22,29
Ards,2142,10,7,5,18,36,62,-26,26
Portadown,2142,11,6,5,19,34,57,-23,23
Crusaders,2143,1,17,9,4,56,28,28,60
Linfield,2143,2,15,9,6,64,34,30,54
Ballymena,2143,3,14,9,7,59,54,5,51
Cliftonville,2143,4,11,8,11,48,40,8,41
Dungannon,2143,5,9,13,8,52,40,12,40
Glenavon,2143,6,10,10,10,47,48,-1,40
Coleraine,2143,7,9,13,8,36,38,-2,40
Glentoran,2143,8,8,9,13,32,45,-13,33
Ballinamalla,2143,9,8,9,13,34,48,-14,33
Portadown,2143,10,8,5,17,28,55,-27,29
Ards,2143,11,7,4,19,31,57,-26,25
Crusaders,2144,1,17,8,5,52,27,25,59
Linfield,2144,2,15,10,5,59,32,27,55
Cliftonville,2144,3,14,7,9,45,33,12,49
Glenavon,2144,4,11,12,7,47,37,10,45
Dungannon,2144,5,11,11,8,49,39,10,44
Ballymena,2144,6,12,6,12,53,64,-11,42
Coleraine,2144,7,9,11,10,35,36,-1,38
Glentoran,2144,8,9,8,13,36,41,-5,35
Portadown,2144,9,9,6,15,28,42,-14,33
Ards,2144,10,8,8,14,38,52,-14,32
Ballinamalla,2144,11,5,3,22,25,64,-39,18
Linfield,2145,1,16,9,5,63,35,28,57
Glenavon,2145,2,13,12,5,52,42,10,51
Cliftonville,2145,3,15,5,10,61,47,14,50
Crusaders,2145,4,12,10,8,52,41,11,46
Ballymena,2145,5,13,7,10,68,63,5,46
Dungannon,2145,6,11,10,9,58,42,16,43
Coleraine,2145,7,9,11,10,46,50,-4,38
Ards,2145,8,9,8,13,48,55,-7,35
Glentoran,2145,9,8,6,16,31,54,-23,30
Portadown,2145,10,7,7,16,32,52,-20,28
Ballinamalla,2145,11,7,5,18,26,56,-30,26
Crusaders,2146,1,14,10,6,53,36,17,52
Cliftonville,2146,2,15,7,8,51,36,15,52
Coleraine,2146,3,13,10,7,42,34,8,49
Linfield,2146,4,12,11,7,53,34,19,47
Ballymena,2146,5,14,5,11,58,54,4,47
Dungannon,2146,6,10,8,12,55,51,4,38
Glentoran,2146,7,8,11,11,34,46,-12,35
Ballinamalla,2146,8,9,7,14,38,51,-13,34
Glenavon,2146,9,7,11,12,44,54,-10,32
Ards,2146,10,8,7,15,36,50,-14,31
Portadown,2146,11,7,9,14,28,46,-18,30
Crusaders,2147,1,18,8,4,64,31,33,62
Linfield,2147,2,15,8,7,66,34,32,53
Coleraine,2147,3,15,8,7,46,36,10,53
Ballymena,2147,4,15,4,11,61,60,1,49
Cliftonville,2147,5,14,5,11,51,42,9,47
Ards,2147,6,12,4,14,41,54,-13,40
Glentoran,2147,7,10,5,15,29,45,-16,35
Dungannon,2147,8,9,7,14,49,52,-3,34
Glenavon,2147,9,7,9,14,47,58,-11,30
Portadown,2147,10,8,6,16,28,51,-23,30
Ballinamalla,2147,11,8,4,18,32,51,-19,28
Crusaders,2148,1,18,10,2,68,35,33,64
Cliftonville,2148,2,16,7,7,59,39,20,55
Linfield,2148,3,13,10,7,52,32,20,49
Glenavon,2148,4,10,14,6,43,37,6,44
Ballymena,2148,5,12,5,13,62,67,-5,41
Coleraine,2148,6,10,10,10,44,41,3,40
Ards,2148,7,11,5,14,41,50,-9,38
Dungannon,2148,8,9,10,11,49,42,7,37
Glentoran,2148,9,9,6,15,30,49,-19,33
Portadown,2148,10,7,8,15,29,53,-24,29
Ballinamalla,2148,11,7,1,22,26,58,-32,22
Crusaders,2149,1,16,10,4,53,28,25,58
Cliftonville,2149,2,15,7,8,58,37,21,52
Ballymena,2149,3,13,8,9,55,54,1,47
Linfield,2149,4,11,11,8,46,29,17,44
Coleraine,2149,5,10,12,8,49,46,3,42
Glenavon,2149,6,9,11,10,43,53,-10,38
Dungannon,2149,7,8,13,9,51,44,7,37
Ards,2149,8,9,7,14,39,47,-8,34
Portadown,2149,9,8,8,14,19,37,-18,32
Glentoran,2149,10,6,13,11,23,37,-14,31
Ballinamalla,2149,11,7,6,17,29,53,-24,27
Cliftonville,2150,1,17,4,9,52,41,11,55
Coleraine,2150,2,13,10,7,46,40,6,49
Linfield,2150,3,13,8,9,59,39,20,47
Crusaders,2150,4,14,5,11,46,35,11,47
Glenavon,2150,5,10,13,7,56,48,8,43
Dungannon,2150,6,11,10,9,52,45,7,43
Ards,2150,7,13,4,13,43,43,0,43
Ballymena,2150,8,11,7,12,58,64,-6,40
Ballinamalla,2150,9,11,3,16,40,51,-11,36
Glentoran,2150,10,8,8,14,31,46,-15,32
Portadown,2150,11,6,4,20,29,60,-31,22
Crusaders,2151,1,18,8,4,56,28,28,62
Linfield,2151,2,14,9,7,52,29,23,51
Coleraine,2151,3,14,9,7,48,34,14,51
Ballymena,2151,4,14,9,7,56,47,9,51
Cliftonville,2151,5,13,6,11,50,43,7,45
Glenavon,2151,6,10,12,8,47,47,0,42
Dungannon,2151,7,10,9,11,56,48,8,39
Glentoran,2151,8,10,5,15,27,42,-15,35
Ballinamalla,2151,9,7,6,17,27,50,-23,27
Portadown,2151,10,7,6,17,27,54,-27,27
Ards,2151,11,6,5,19,33,57,-24,23
Cliftonville,2152,1,17,4,9,60,39,21,55
Crusaders,2152,2,16,6,8,57,37,20,54
Ballymena,2152,3,16,6,8,63,58,5,54
Glenavon,2152,4,13,9,8,49,45,4,48
Coleraine,2152,5,12,8,10,42,39,3,44
Dungannon,2152,6,11,10,9,48,39,9,43
Linfield,2152,7,11,8,11,47,36,11,41
Ards,2152,8,12,5,13,39,40,-1,41
Glentoran,2152,9,8,7,15,29,45,-16,31
Portadown,2152,10,8,3,19,29,52,-23,27
Ballinamalla,2152,11,5,6,19,23,56,-33,21
Crusaders,2153,1,16,7,7,61,42,19,55
Ballymena,2153,2,14,8,8,62,54,8,50
Coleraine,2153,3,14,8,8,44,41,3,50
Linfield,2153,4,13,9,8,58,35,23,48
Cliftonville,2153,5,13,6,11,53,48,5,45
Glenavon,2153,6,9,13,8,50,43,7,40
Dungannon,2153,7,11,7,12,48,45,3,40
Glentoran,2153,8,9,8,13,38,47,-9,35
Ards,2153,9,9,7,14,34,46,-12,34
Ballinamalla,2153,10,10,4,16,34,51,-17,34
Portadown,2153,11,6,5,19,21,51,-30,23
Cliftonville,2154,1,16,5,9,55,39,16,53
Crusaders,2154,2,14,10,6,53,31,22,52
Coleraine,2154,3,13,12,5,40,32,8,51
Linfield,2154,4,13,11,6,56,29,27,50
Ballymena,2154,5,14,5,11,57,56,1,47
Glenavon,2154,6,11,9,10,53,48,5,42
Glentoran,2154,7,10,8,12,38,45,-7,38
Dungannon,2154,8,8,11,11,41,46,-5,35
Ards,2154,9,8,7,15,35,46,-11,31
Portadown,2154,10,7,6,17,28,55,-27,27
Ballinamalla,2154,11,6,6,18,26,55,-29,24
Crusaders,2155,1,17,5,8,52,33,19,56
Linfield,2155,2,15,10,5,59,28,31,55
Glenavon,2155,3,11,14,5,49,41,8,47
Cliftonville,2155,4,13,5,12,49,41,8,44
Ballymena,2155,5,12,6,12,47,61,-14,42
Coleraine,2155,6,10,11,9,40,39,1,41
Dungannon,2155,7,10,9,11,50,45,5,39
Glentoran,2155,8,11,6,13,38,42,-4,39
Ards,2155,9,11,5,14,36,41,-5,38
Ballinamalla,2155,10,9,5,16,33,52,-19,32
Portadown,2155,11,6,4,20,21,51,-30,22
Cliftonville,2156,1,18,4,8,60,37,23,58
Linfield,2156,2,16,8,6,74,35,39,56
Crusaders,2156,3,16,7,7,53,36,17,55
Ballymena,2156,4,14,7,9,55,56,-1,49
Dungannon,2156,5,12,9,9,52,41,11,45
Coleraine,2156,6,10,11,9,43,41,2,41
Glentoran,2156,7,10,6,14,36,50,-14,36
Ards,2156,8,10,5,15,35,50,-15,35
Glenavon,2156,9,8,8,14,42,60,-18,32
Ballinamalla,2156,10,8,3,19,30,53,-23,27
Portadown,2156,11,7,4,19,27,48,-21,25
Linfield,2157,1,16,9,5,60,23,37,57
Crusaders,2157,2,16,5,9,54,39,15,53
Cliftonville,2157,3,16,3,11,57,43,14,51
Ballymena,2157,4,15,5,10,57,55,2,50
Coleraine,2157,5,12,10,8,49,37,12,46
Glenavon,2157,6,11,10,9,45,49,-4,43
Dungannon,2157,7,11,8,11,51,39,12,41
Glentoran,2157,8,9,7,14,31,49,-18,34
Ballinamalla,2157,9,8,5,17,30,52,-22,29
Portadown,2157,10,7,6,17,21,48,-27,27
Ards,2157,11,6,8,16,33,54,-21,26
Glenavon,2158,1,14,9,7,53,40,13,51
Cliftonville,2158,2,15,5,10,55,44,11,50
Crusaders,2158,3,14,7,9,52,42,10,49
Linfield,2158,4,13,9,8,56,32,24,48
Ballymena,2158,5,13,6,11,59,58,1,45
Coleraine,2158,6,12,8,10,39,39,0,44
Glentoran,2158,7,11,8,11,31,41,-10,41
Dungannon,2158,8,9,10,11,52,49,3,37
Ards,2158,9,9,7,14,42,50,-8,34
Ballinamalla,2158,10,9,3,18,30,55,-25,30
Portadown,2158,11,7,6,17,32,51,-19,27
Crusaders,2159,1,19,6,5,63,28,35,63
Ballymena,2159,2,18,4,8,64,54,10,58
Glenavon,2159,3,14,12,4,57,42,15,54
Linfield,2159,4,14,9,7,54,33,21,51
Cliftonville,2159,5,13,5,12,45,44,1,44
Coleraine,2159,6,9,12,9,45,35,10,39
Dungannon,2159,7,10,7,13,45,42,3,37
Ards,2159,8,10,4,16,37,48,-11,34
Portadown,2159,9,8,4,18,21,50,-29,28
Ballinamalla,2159,10,8,3,19,30,55,-25,27
Glentoran,2159,11,6,6,18,30,60,-30,24
Crusaders,2160,1,19,5,6,56,30,26,62
Linfield,2160,2,14,10,6,61,33,28,52
Glenavon,2160,3,13,10,7,49,41,8,49
Cliftonville,2160,4,13,7,10,46,39,7,46
Ballymena,2160,5,11,9,10,53,60,-7,42
Dungannon,2160,6,9,12,9,46,40,6,39
Coleraine,2160,7,9,10,11,39,41,-2,37
Glentoran,2160,8,9,9,12,36,44,-8,36
Ards,2160,9,9,6,15,34,44,-10,33
Ballinamalla,2160,10,8,6,16,28,51,-23,30
Portadown,2160,11,6,6,18,25,50,-25,24
Linfield,2161,1,17,8,5,66,29,37,59
Crusaders,2161,2,15,10,5,56,32,24,55
Cliftonville,2161,3,17,2,11,61,50,11,53
Ballymena,2161,4,16,3,11,65,59,6,51
Glenavon,2161,5,12,10,8,46,44,2,46
Coleraine,2161,6,11,10,9,41,44,-3,43
Dungannon,2161,7,11,7,12,54,46,8,40
Ards,2161,8,9,6,15,39,47,-8,33
Ballinamalla,2161,9,8,5,17,28,50,-22,29
Portadown,2161,10,7,5,18,26,52,-26,26
Glentoran,2161,11,5,8,17,26,55,-29,23
Linfield,2162,1,16,9,5,66,30,36,57
Crusaders,2162,2,15,9,6,51,29,22,54
Coleraine,2162,3,15,9,6,46,34,12,54
Ballymena,2162,4,16,6,8,63,55,8,54
Cliftonville,2162,5,15,3,12,52,44,8,48
Dungannon,2162,6,12,10,8,53,42,11,46
Glenavon,2162,7,8,12,10,43,46,-3,36
Ballinamalla,2162,8,11,2,17,30,48,-18,35
Ards,2162,9,9,2,19,38,58,-20,29
Glentoran,2162,10,7,8,15,24,46,-22,29
Portadown,2162,11,4,4,22,19,53,-34,16
Linfield,2163,1,16,9,5,63,37,26,57
Glenavon,2163,2,14,9,7,53,40,13,51
Crusaders,2163,3,14,7,9,48,40,8,49
Cliftonville,2163,4,13,9,8,52,40,12,48
Coleraine,2163,5,12,9,9,43,39,4,45
Ballymena,2163,6,13,5,12,59,61,-2,44
Dungannon,2163,7,10,7,13,55,51,4,37
Ards,2163,8,11,4,15,43,54,-11,37
Glentoran,2163,9,8,10,12,33,46,-13,34
Ballinamalla,2163,10,8,4,18,39,58,-19,28
Portadown,2163,11,7,5,18,22,44,-22,26
Crusaders,2164,1,18,7,5,57,35,22,61
Cliftonville,2164,2,16,5,9,58,41,17,53
Linfield,2164,3,14,9,7,64,31,33,51
Ballymena,2164,4,13,7,10,61,71,-10,46
Glenavon,2164,5,10,13,7,55,52,3,43
Coleraine,2164,6,10,11,9,44,43,1,41
Dungannon,2164,7,10,8,12,54,50,4,38
Ards,2164,8,9,6,15,38,47,-9,33
Ballinamalla,2164,9,8,6,16,39,57,-18,30
Glentoran,2164,10,7,8,15,34,51,-17,29
Portadown,2164,11,7,6,17,24,50,-26,27
Linfield,2165,1,15,9,6,66,32,34,54
Crusaders,2165,2,16,6,8,59,39,20,54
Cliftonville,2165,3,16,5,9,61,41,20,53
Ballymena,2165,4,15,6,9,54,54,0,51
Coleraine,2165,5,12,12,6,51,38,13,48
Dungannon,2165,6,11,10,9,50,46,4,43
Glenavon,2165,7,9,11,10,40,46,-6,38
Ards,2165,8,8,6,16,36,51,-15,30
Ballinamalla,2165,9,9,3,18,32,54,-22,30
Glentoran,2165,10,7,8,15,28,48,-20,29
Portadown,2165,11,7,4,19,28,56,-28,25
Cliftonville,2166,1,17,7,6,52,29,23,58
Crusaders,2166,2,16,9,5,58,35,23,57
Linfield,2166,3,15,9,6,57,36,21,54
Coleraine,2166,4,11,10,9,50,47,3,43
Ballymena,2166,5,13,4,13,48,56,-8,43
Dungannon,2166,6,11,7,12,53,44,9,40
Ards,2166,7,12,4,14,46,45,1,40
Glenavon,2166,8,10,8,12,44,51,-7,38
Glentoran,2166,9,9,5,16,27,47,-20,32
Ballinamalla,2166,10,8,4,18,26,49,-23,28
Portadown,2166,11,7,5,18,25,47,-22,26
Linfield,2167,1,19,8,3,76,32,44,65
Crusaders,2167,2,15,6,9,51,38,13,51
Glenavon,2167,3,13,9,8,48,43,5,48
Ballymena,2167,4,14,6,10,58,59,-1,48
Cliftonville,2167,5,14,3,13,50,47,3,45
Coleraine,2167,6,12,9,9,38,35,3,45
Dungannon,2167,7,10,9,11,51,43,8,39
Glentoran,2167,8,10,7,13,32,47,-15,37
Portadown,2167,9,9,5,16,28,45,-17,32
Ards,2167,10,7,7,16,34,46,-12,28
Ballinamalla,2167,11,6,3,21,29,60,-31,21
Ballymena,2168,1,19,4,7,67,52,15,61
Crusaders,2168,2,16,6,8,59,36,23,54
Coleraine,2168,3,14,9,7,52,41,11,51
Linfield,2168,4,12,12,6,61,39,22,48
Cliftonville,2168,5,15,3,12,52,45,7,48
Glenavon,2168,6,11,10,9,47,48,-1,43
Glentoran,2168,7,9,11,10,33,37,-4,38
Dungannon,2168,8,8,9,13,45,48,-3,33
Portadown,2168,9,9,4,17,29,46,-17,31
Ards,2168,10,8,3,19,35,56,-21,27
Ballinamalla,2168,11,7,3,20,28,60,-32,24
Cliftonville,2169,1,17,4,9,56,40,16,55
Crusaders,2169,2,16,6,8,57,41,16,54
Ballymena,2169,3,14,6,10,58,62,-4,48
Glenavon,2169,4,13,8,9,50,44,6,47
Linfield,2169,5,13,7,10,49,34,15,46
Dungannon,2169,6,10,8,12,47,46,1,38
Ards,2169,7,11,5,14,44,45,-1,38
Coleraine,2169,8,10,8,12,39,40,-1,38
Glentoran,2169,9,9,9,12,38,47,-9,36
Ballinamalla,2169,10,8,6,16,31,53,-22,30
Portadown,2169,11,7,7,16,29,46,-17,28
Linfield,2170,1,14,9,7,56,33,23,51
Coleraine,2170,2,13,11,6,46,36,10,50
Crusaders,2170,3,14,7,9,56,45,11,49
Ballymena,2170,4,13,9,8,59,59,0,48
Dungannon,2170,5,11,9,10,54,43,11,42
Cliftonville,2170,6,12,6,12,57,50,7,42
Glenavon,2170,7,11,9,10,42,47,-5,42
Glentoran,2170,8,9,8,13,36,51,-15,35
Portadown,2170,9,8,7,15,28,42,-14,31
Ballinamalla,2170,10,8,6,16,37,50,-13,30
Ards,2170,11,7,9,14,35,50,-15,30
Crusaders,2171,1,15,7,8,53,39,14,52
Ballymena,2171,2,16,3,11,62,63,-1,51
Cliftonville,2171,3,15,5,10,57,40,17,50
Linfield,2171,4,13,8,9,60,37,23,47
Coleraine,2171,5,12,10,8,42,41,1,46
Glenavon,2171,6,11,11,8,47,43,4,44
Ards,2171,7,11,6,13,37,39,-2,39
Dungannon,2171,8,9,8,13,51,51,0,35
Ballinamalla,2171,9,10,4,16,34,50,-16,34
Portadown,2171,10,10,3,17,37,52,-15,33
Glentoran,2171,11,6,9,15,24,49,-25,27
Crusaders,2172,1,18,6,6,62,32,30,60
Cliftonville,2172,2,18,4,8,58,35,23,58
Linfield,2172,3,15,11,4,55,29,26,56
Coleraine,2172,4,12,12,6,41,30,11,48
Ballymena,2172,5,12,6,12,52,62,-10,42
Glenavon,2172,6,9,11,10,36,45,-9,38
Dungannon,2172,7,9,7,14,47,53,-6,34
Ards,2172,8,10,4,16,38,44,-6,34
Glentoran,2172,9,8,8,14,33,48,-15,32
Portadown,2172,10,8,7,15,29,42,-13,31
Ballinamalla,2172,11,6,4,20,21,52,-31,22
Linfield,2173,1,17,8,5,67,31,36,59
Cliftonville,2173,2,17,6,7,62,38,24,57
Crusaders,2173,3,16,8,6,57,36,21,56
Glenavon,2173,4,14,9,7,54,48,6,51
Ballymena,2173,5,14,7,9,62,58,4,49
Dungannon,2173,6,10,9,11,55,43,12,39
Coleraine,2173,7,10,9,11,47,50,-3,39
Glentoran,2173,8,10,5,15,28,46,-18,35
Ards,2173,9,10,4,16,39,54,-15,34
Ballinamalla,2173,10,6,3,21,24,57,-33,21
Portadown,2173,11,6,2,22,22,56,-34,20
Crusaders,2174,1,18,8,4,68,39,29,62
Cliftonville,2174,2,18,5,7,58,41,17,59
Linfield,2174,3,15,8,7,67,37,30,53
Coleraine,2174,4,11,11,8,42,39,3,44
Glenavon,2174,5,10,11,9,44,47,-3,41
Ballymena,2174,6,11,6,13,55,65,-10,39
Dungannon,2174,7,10,8,12,54,46,8,38
Glentoran,2174,8,10,6,14,36,48,-12,36
Ards,2174,9,8,6,16,35,49,-14,30
Ballinamalla,2174,10,8,6,16,29,50,-21,30
Portadown,2174,11,6,5,19,22,49,-27,23
Linfield,2175,1,16,9,5,58,27,31,57
Crusaders,2175,2,12,12,6,51,35,16,48
Cliftonville,2175,3,14,6,10,49,37,12,48
Ballymena,2175,4,14,6,10,59,56,3,48
Dungannon,2175,5,12,9,9,53,41,12,45
Glenavon,2175,6,11,12,7,46,43,3,45
Coleraine,2175,7,11,9,10,46,42,4,42
Ards,2175,8,11,4,15,37,45,-8,37
Glentoran,2175,9,8,8,14,29,45,-16,32
Portadown,2175,10,8,6,16,22,42,-20,30
Ballinamalla,2175,11,6,3,21,20,57,-37,21
Ballymena,2176,1,15,8,7,62,50,12,53
Linfield,2176,2,13,12,5,58,28,30,51
Cliftonville,2176,3,15,6,9,55,40,15,51
Crusaders,2176,4,13,9,8,49,40,9,48
Glenavon,2176,5,9,16,5,48,43,5,43
Coleraine,2176,6,10,11,9,35,36,-1,41
Dungannon,2176,7,8,12,10,49,43,6,36
Ballinamalla,2176,8,9,5,16,28,43,-15,32
Ards,2176,9,9,5,16,31,50,-19,32
Glentoran,2176,10,8,8,14,29,50,-21,32
Portadown,2176,11,5,10,15,29,50,-21,25
Crusaders,2177,1,17,7,6,62,31,31,58
Linfield,2177,2,16,9,5,61,28,33,57
Cliftonville,2177,3,17,3,10,61,45,16,54
Coleraine,2177,4,13,10,7,48,38,10,49
Ballymena,2177,5,13,6,11,64,66,-2,45
Glenavon,2177,6,10,12,8,44,45,-1,42
Dungannon,2177,7,9,11,10,54,44,10,38
Ards,2177,8,10,3,17,41,53,-12,33
Glentoran,2177,9,7,8,15,32,57,-25,29
Portadown,2177,10,7,5,18,24,55,-31,26
Ballinamalla,2177,11,6,6,18,29,58,-29,24
Crusaders,2178,1,20,6,4,66,33,33,66
Cliftonville,2178,2,17,3,10,60,40,20,54
Ballymena,2178,3,15,7,8,54,52,2,52
Linfield,2178,4,14,8,8,63,34,29,50
Coleraine,2178,5,13,9,8,42,36,6,48
Glentoran,2178,6,11,7,12,38,46,-8,40
Glenavon,2178,7,10,9,11,43,51,-8,39
Dungannon,2178,8,8,10,12,46,51,-5,34
Ballinamalla,2178,9,8,6,16,34,57,-23,30
Ards,2178,10,8,5,17,31,47,-16,29
Portadown,2178,11,4,4,22,23,53,-30,16
Linfield,2179,1,15,9,6,53,32,21,54
Cliftonville,2179,2,15,4,11,54,39,15,49
Ballymena,2179,3,14,7,9,59,55,4,49
Crusaders,2179,4,14,6,10,42,33,9,48
Coleraine,2179,5,13,8,9,45,35,10,47
Glenavon,2179,6,11,13,6,54,42,12,46
Dungannon,2179,7,8,14,8,53,48,5,38
Ards,2179,8,10,4,16,31,44,-13,34
Glentoran,2179,9,8,8,14,32,46,-14,32
Portadown,2179,10,7,8,15,26,51,-25,29
Ballinamalla,2179,11,8,3,19,33,57,-24,27
Linfield,2180,1,14,10,6,67,35,32,52
Cliftonville,2180,2,15,7,8,54,35,19,52
Crusaders,2180,3,14,9,7,60,46,14,51
Glenavon,2180,4,13,8,9,49,45,4,47
Ballymena,2180,5,14,3,13,47,64,-17,45
Coleraine,2180,6,11,10,9,44,41,3,43
Dungannon,2180,7,11,9,10,54,42,12,42
Glentoran,2180,8,9,7,14,29,42,-13,34
Ards,2180,9,9,5,16,37,45,-8,32
Portadown,2180,10,8,7,15,27,44,-17,31
Ballinamalla,2180,11,7,5,18,32,61,-29,26
Linfield,2181,1,15,10,5,58,32,26,55
Crusaders,2181,2,15,8,7,51,32,19,53
Coleraine,2181,3,13,8,9,46,36,10,47
Ballymena,2181,4,13,8,9,59,55,4,47
Dungannon,2181,5,12,9,9,56,40,16,45
Glenavon,2181,6,11,12,7,46,42,4,45
Cliftonville,2181,7,11,7,12,46,43,3,40
Glentoran,2181,8,11,6,13,41,55,-14,39
Ards,2181,9,8,6,16,35,52,-17,30
Ballinamalla,2181,10,9,3,18,28,54,-26,30
Portadown,2181,11,5,7,18,26,51,-25,22
Cliftonville,2182,1,18,7,5,60,35,25,61
Crusaders,2182,2,15,8,7,61,35,26,53
Linfield,2182,3,14,10,6,58,30,28,52
Coleraine,2182,4,13,10,7,46,40,6,49
Ballymena,2182,5,13,8,9,54,52,2,47
Dungannon,2182,6,11,8,11,50,43,7,41
Glenavon,2182,7,10,11,9,49,52,-3,41
Ards,2182,8,10,5,15,39,56,-17,35
Glentoran,2182,9,7,9,14,30,48,-18,30
Ballinamalla,2182,10,7,4,19,34,54,-20,25
Portadown,2182,11,4,6,20,23,59,-36,18
Linfield,2183,1,16,9,5,63,33,30,57
Crusaders,2183,2,14,8,8,51,39,12,50
Ballymena,2183,3,13,10,7,66,58,8,49
Cliftonville,2183,4,12,9,9,51,38,13,45
Dungannon,2183,5,11,11,8,49,37,12,44
Coleraine,2183,6,11,10,9,44,45,-1,43
Glenavon,2183,7,7,13,10,40,41,-1,34
Ballinamalla,2183,8,10,4,16,34,51,-17,34
Glentoran,2183,9,7,11,12,31,45,-14,32
Ards,2183,10,8,7,15,35,52,-17,31
Portadown,2183,11,7,6,17,25,50,-25,27
Glenavon,2184,1,16,9,5,60,38,22,57
Crusaders,2184,2,16,7,7,59,36,23,55
Linfield,2184,3,14,10,6,58,30,28,52
Ballymena,2184,4,15,6,9,58,52,6,51
Cliftonville,2184,5,16,2,12,53,41,12,50
Coleraine,2184,6,11,8,11,41,37,4,41
Dungannon,2184,7,9,9,12,41,47,-6,36
Ards,2184,8,9,7,14,38,51,-13,34
Ballinamalla,2184,9,10,3,17,31,51,-20,33
Glentoran,2184,10,6,9,15,25,48,-23,27
Portadown,2184,11,5,6,19,25,58,-33,21
Linfield,2185,1,16,8,6,58,30,28,56
Crusaders,2185,2,16,8,6,55,36,19,56
Cliftonville,2185,3,15,5,10,55,45,10,50
Dungannon,2185,4,13,7,10,46,35,11,46
Ballymena,2185,5,13,6,11,58,62,-4,45
Glenavon,2185,6,8,14,8,46,50,-4,38
Coleraine,2185,7,8,12,10,43,44,-1,36
Ards,2185,8,9,9,12,42,49,-7,36
Portadown,2185,9,10,4,16,32,43,-11,34
Glentoran,2185,10,8,6,16,31,47,-16,30
Ballinamalla,2185,11,7,5,18,28,53,-25,26
Crusaders,2186,1,18,6,6,56,32,24,60
Linfield,2186,2,15,9,6,62,30,32,54
Ballymena,2186,3,15,6,9,64,57,7,51
Cliftonville,2186,4,14,6,10,54,43,11,48
Glenavon,2186,5,11,10,9,47,45,2,43
Coleraine,2186,6,11,8,11,41,48,-7,41
Ballinamalla,2186,7,10,7,13,40,48,-8,37
Dungannon,2186,8,8,10,12,45,43,2,34
Glentoran,2186,9,7,10,13,30,43,-13,31
Ards,2186,10,8,6,16,32,51,-19,30
Portadown,2186,11,7,4,19,21,52,-31,25
Crusaders,2187,1,15,9,6,62,38,24,54
Ballymena,2187,2,14,9,7,57,53,4,51
Linfield,2187,3,13,10,7,54,34,20,49
Cliftonville,2187,4,13,9,8,54,42,12,48
Ballinamalla,2187,5,12,3,15,33,45,-12,39
Dungannon,2187,6,9,10,11,52,46,6,37
Glenavon,2187,7,8,13,9,45,46,-1,37
Ards,2187,8,10,6,14,39,49,-10,36
Coleraine,2187,9,7,13,10,40,49,-9,34
Glentoran,2187,10,8,8,14,30,41,-11,32
Portadown,2187,11,9,4,17,28,51,-23,31
Cliftonville,2188,1,19,4,7,58,32,26,61
Crusaders,2188,2,15,9,6,50,31,19,54
Ballymena,2188,3,16,3,11,57,56,1,51
Glenavon,2188,4,12,10,8,47,41,6,46
Linfield,2188,5,11,12,7,56,38,18,45
Coleraine,2188,6,10,8,12,33,39,-6,38
Dungannon,2188,7,9,10,11,48,47,1,37
Ards,2188,8,9,5,16,39,48,-9,32
Glentoran,2188,9,9,5,16,31,49,-18,32
Ballinamalla,2188,10,9,5,16,33,53,-20,32
Portadown,2188,11,7,7,16,32,50,-18,28
Crusaders,2189,1,17,6,7,53,38,15,57
Linfield,2189,2,15,10,5,57,30,27,55
Cliftonville,2189,3,16,5,9,52,37,15,53
Glenavon,2189,4,13,9,8,51,44,7,48
Ballymena,2189,5,12,9,9,61,62,-1,45
Glentoran,2189,6,12,8,10,40,37,3,44
Dungannon,2189,7,10,9,11,51,43,8,39
Coleraine,2189,8,9,12,9,39,42,-3,39
Ards,2189,9,7,5,18,30,50,-20,26
Ballinamalla,2189,10,7,4,19,29,50,-21,25
Portadown,2189,11,6,5,19,22,52,-30,23
Crusaders,2190,1,18,8,4,70,32,38,62
Glenavon,2190,2,14,12,4,49,36,13,54
Cliftonville,2190,3,16,4,10,58,43,15,52
Linfield,2190,4,13,10,7,55,34,21,49
Ballymena,2190,5,13,7,10,52,59,-7,46
Coleraine,2190,6,11,10,9,39,37,2,43
Dungannon,2190,7,10,12,8,53,45,8,42
Glentoran,2190,8,8,9,13,32,46,-14,33
Ballinamalla,2190,9,6,6,18,27,56,-29,24
Ards,2190,10,6,5,19,38,57,-19,23
Portadown,2190,11,6,5,19,22,50,-28,23
Crusaders,2191,1,15,10,5,59,32,27,55
Ballymena,2191,2,16,7,7,64,59,5,55
Linfield,2191,3,14,11,5,56,29,27,53
Cliftonville,2191,4,16,5,9,57,39,18,53
Dungannon,2191,5,14,9,7,65,42,23,51
Glenavon,2191,6,11,11,8,43,43,0,44
Coleraine,2191,7,10,9,11,43,43,0,39
Glentoran,2191,8,7,10,13,24,42,-18,31
Ballinamalla,2191,9,7,5,18,28,52,-24,26
Portadown,2191,10,7,4,19,29,58,-29,25
Ards,2191,11,5,5,20,27,56,-29,20
Linfield,2192,1,18,8,4,69,28,41,62
Crusaders,2192,2,15,11,4,58,39,19,56
Ballymena,2192,3,15,5,10,58,55,3,50
Cliftonville,2192,4,14,7,9,55,43,12,49
Coleraine,2192,5,10,10,10,39,37,2,40
Glenavon,2192,6,9,11,10,51,48,3,38
Glentoran,2192,7,9,9,12,31,43,-12,36
Dungannon,2192,8,8,10,12,46,50,-4,34
Ballinamalla,2192,9,9,6,15,31,51,-20,33
Portadown,2192,10,8,5,17,22,42,-20,29
Ards,2192,11,7,4,19,29,53,-24,25
Crusaders,2193,1,17,9,4,59,35,24,60
Linfield,2193,2,17,7,6,69,31,38,58
Ballymena,2193,3,15,6,9,62,57,5,51
Glenavon,2193,4,12,10,8,50,48,2,46
Cliftonville,2193,5,13,6,11,42,40,2,45
Dungannon,2193,6,10,13,7,51,38,13,43
Coleraine,2193,7,10,9,11,45,44,1,39
Glentoran,2193,8,7,8,15,30,50,-20,29
Ballinamalla,2193,9,9,2,19,34,56,-22,29
Ards,2193,10,7,7,16,32,50,-18,28
Portadown,2193,11,6,7,17,24,49,-25,25
Linfield,2194,1,17,8,5,66,34,32,59
Crusaders,2194,2,16,10,4,62,35,27,58
Dungannon,2194,3,14,8,8,53,39,14,50
Coleraine,2194,4,13,8,9,51,44,7,47
Ballymena,2194,5,14,5,11,63,67,-4,47
Cliftonville,2194,6,13,4,13,50,48,2,43
Glenavon,2194,7,10,11,9,46,48,-2,41
Ards,2194,8,9,5,16,48,54,-6,32
Ballinamalla,2194,9,9,3,18,28,49,-21,30
Portadown,2194,10,7,5,18,31,55,-24,26
Glentoran,2194,11,6,7,17,29,54,-25,25
Crusaders,2195,1,17,6,7,59,39,20,57
Cliftonville,2195,2,17,6,7,50,31,19,57
Linfield,2195,3,14,9,7,56,34,22,51
Coleraine,2195,4,13,10,7,45,35,10,49
Ballymena,2195,5,14,5,11,55,59,-4,47
Dungannon,2195,6,11,12,7,53,38,15,45
Glenavon,2195,7,10,10,10,48,46,2,40
Glentoran,2195,8,8,7,15,33,48,-15,31
Ballinamalla,2195,9,9,4,17,32,52,-20,31
Ards,2195,10,7,5,18,32,51,-19,26
Portadown,2195,11,6,4,20,26,56,-30,22
Crusaders,2196,1,18,6,6,57,36,21,60
Coleraine,2196,2,14,9,7,51,37,14,51
Linfield,2196,3,13,11,6,56,28,28,50
Ballymena,2196,4,14,6,10,55,56,-1,48
Cliftonville,2196,5,14,4,12,46,38,8,46
Glenavon,2196,6,10,12,8,49,50,-1,42
Portadown,2196,7,12,2,16,30,45,-15,38
Ards,2196,8,9,6,15,35,45,-10,33
Ballinamalla,2196,9,9,6,15,34,48,-14,33
Dungannon,2196,10,6,11,13,43,52,-9,29
Glentoran,2196,11,5,9,16,25,46,-21,24
Cliftonville,2197,1,17,5,8,56,36,20,56
Glenavon,2197,2,16,8,6,56,38,18,56
Crusaders,2197,3,14,10,6,53,35,18,52
Linfield,2197,4,14,8,8,51,29,22,50
Glentoran,2197,5,12,9,9,37,37,0,45
Ballymena,2197,6,12,6,12,52,58,-6,42
Coleraine,2197,7,10,11,9,45,44,1,41
Dungannon,2197,8,7,12,11,53,57,-4,33
Ards,2197,9,7,7,16,31,47,-16,28
Ballinamalla,2197,10,7,5,18,27,51,-24,26
Portadown,2197,11,4,9,17,18,47,-29,21
Crusaders,2198,1,17,9,4,56,28,28,60
Cliftonville,2198,2,17,4,9,52,40,12,55
Linfield,2198,3,14,11,5,62,26,36,53
Glenavon,2198,4,14,8,8,43,40,3,50
Dungannon,2198,5,12,8,10,49,37,12,44
Coleraine,2198,6,11,9,10,39,44,-5,42
Ballymena,2198,7,11,6,13,51,63,-12,39
Ards,2198,8,11,2,17,46,55,-9,35
Glentoran,2198,9,9,8,13,32,42,-10,35
Portadown,2198,10,6,5,19,27,47,-20,23
Ballinamalla,2198,11,6,4,20,22,57,-35,22
Crusaders,2199,1,16,10,4,50,24,26,58
Cliftonville,2199,2,17,3,10,57,39,18,54
Linfield,2199,3,14,9,7,57,33,24,51
Glenavon,2199,4,11,14,5,46,42,4,47
Coleraine,2199,5,12,8,10,45,38,7,44
Ballymena,2199,6,13,4,13,59,63,-4,43
Glentoran,2199,7,10,7,13,28,41,-13,37
Ards,2199,8,10,4,16,33,49,-16,34
Ballinamalla,2199,9,9,4,17,27,46,-19,31
Portadown,2199,10,8,6,16,33,51,-18,30
Dungannon,2199,11,5,11,14,41,50,-9,26
Linfield,2200,1,16,9,5,57,24,33,57
Ballymena,2200,2,16,6,8,60,53,7,54
Crusaders,2200,3,14,10,6,51,34,17,52
Dungannon,2200,4,12,11,7,58,42,16,47
Coleraine,2200,5,12,11,7,44,40,4,47
Glenavon,2200,6,10,12,8,45,43,2,42
Cliftonville,2200,7,12,5,13,49,50,-1,41
Ards,2200,8,10,6,14,43,50,-7,36
Glentoran,2200,9,8,8,14,38,49,-11,32
Portadown,2200,10,8,5,17,31,51,-20,29
Ballinamalla,2200,11,4,3,23,22,62,-40,15
Coleraine,2201,1,15,9,6,50,40,10,54
Ballymena,2201,2,17,3,10,66,62,4,54
Cliftonville,2201,3,15,4,11,51,42,9,49
Linfield,2201,4,13,8,9,60,40,20,47
Crusaders,2201,5,13,6,11,52,44,8,45
Glenavon,2201,6,12,9,9,45,42,3,45
Dungannon,2201,7,11,8,11,47,44,3,41
Glentoran,2201,8,10,9,11,34,42,-8,39
Ards,2201,9,8,7,15,41,51,-10,31
Ballinamalla,2201,10,9,4,17,38,54,-16,31
Portadown,2201,11,6,5,19,30,53,-23,23
Crusaders,2202,1,17,7,6,59,40,19,58
Linfield,2202,2,16,8,6,56,29,27,56
Ballymena,2202,3,16,5,9,61,55,6,53
Coleraine,2202,4,14,8,8,46,36,10,50
Cliftonville,2202,5,15,4,11,52,50,2,49
Ards,2202,6,11,5,14,51,48,3,38
Glentoran,2202,7,10,7,13,32,43,-11,37
Glenavon,2202,8,8,12,10,44,48,-4,36
Dungannon,2202,9,8,10,12,49,45,4,34
Ballinamalla,2202,10,9,3,18,29,52,-23,30
Portadown,2202,11,4,5,21,18,51,-33,17
Crusaders,2203,1,19,9,2,59,24,35,66
Linfield,2203,2,14,8,8,60,35,25,50
Cliftonville,2203,3,12,8,10,55,43,12,44
Glenavon,2203,4,11,10,9,46,45,1,43
Ballymena,2203,5,12,7,11,54,63,-9,43
Dungannon,2203,6,11,9,10,47,40,7,42
Coleraine,2203,7,9,13,8,42,43,-1,40
Glentoran,2203,8,8,8,14,30,46,-16,32
Ards,2203,9,8,7,15,44,59,-15,31
Ballinamalla,2203,10,8,7,15,32,47,-15,31
Portadown,2203,11,7,6,17,30,54,-24,27
Linfield,2204,1,15,10,5,56,29,27,55
Ballymena,2204,2,16,5,9,53,50,3,53
Crusaders,2204,3,14,8,8,53,39,14,50
Coleraine,2204,4,13,11,6,40,26,14,50
Glenavon,2204,5,11,12,7,51,47,4,45
Cliftonville,2204,6,12,6,12,51,45,6,42
Glentoran,2204,7,9,7,14,31,46,-15,34
Dungannon,2204,8,8,8,14,50,56,-6,32
Ards,2204,9,9,5,16,39,53,-14,32
Ballinamalla,2204,10,9,5,16,37,54,-17,32
Portadown,2204,11,7,7,16,28,44,-16,28
Crusaders,2205,1,16,6,8,59,40,19,54
Ballymena,2205,2,16,5,9,60,57,3,53
Linfield,2205,3,15,7,8,58,31,27,52
Dungannon,2205,4,11,10,9,52,39,13,43
Cliftonville,2205,5,12,7,11,52,45,7,43
Glenavon,2205,6,10,13,7,44,46,-2,43
Glentoran,2205,7,11,9,10,35,42,-7,42
Coleraine,2205,8,9,11,10,38,39,-1,38
Ballinamalla,2205,9,10,4,16,33,48,-15,34
Ards,2205,10,8,9,13,32,42,-10,33
Portadown,2205,11,3,7,20,16,50,-34,16
Cliftonville,2206,1,18,5,7,47,30,17,59
Crusaders,2206,2,17,7,6,54,31,23,58
Ballymena,2206,3,15,4,11,54,58,-4,49
Linfield,2206,4,12,9,9,54,34,20,45
Coleraine,2206,5,12,9,9,47,40,7,45
Glenavon,2206,6,10,11,9,49,43,6,41
Ards,2206,7,10,6,14,34,44,-10,36
Dungannon,2206,8,8,10,12,45,45,0,34
Ballinamalla,2206,9,8,7,15,33,51,-18,31
Portadown,2206,10,8,7,15,28,46,-18,31
Glentoran,2206,11,6,7,17,33,56,-23,25
Cliftonville,2207,1,17,3,10,55,37,18,54
Linfield,2207,2,14,9,7,56,32,24,51
Coleraine,2207,3,12,12,6,43,27,16,48
Glenavon,2207,4,12,10,8,50,44,6,46
Crusaders,2207,5,12,8,10,55,46,9,44
Ballymena,2207,6,12,5,13,49,61,-12,41
Ballinamalla,2207,7,12,4,14,32,46,-14,40
Ards,2207,8,11,5,14,33,42,-9,38
Dungannon,2207,9,9,9,12,52,50,2,36
Glentoran,2207,10,8,10,12,28,38,-10,34
Portadown,2207,11,6,5,19,18,48,-30,23
Crusaders,2208,1,18,6,6,53,28,25,60
Linfield,2208,2,16,9,5,56,26,30,57
Cliftonville,2208,3,17,3,10,61,44,17,54
Coleraine,2208,4,10,11,9,41,40,1,41
Glenavon,2208,5,10,11,9,41,45,-4,41
Dungannon,2208,6,9,10,11,43,40,3,37
Ballymena,2208,7,10,6,14,48,60,-12,36
Portadown,2208,8,10,6,14,27,39,-12,36
Ards,2208,9,9,6,15,34,47,-13,33
Glentoran,2208,10,8,7,15,29,45,-16,31
Ballinamalla,2208,11,8,5,17,29,48,-19,29
Crusaders,2209,1,17,9,4,62,31,31,60
Linfield,2209,2,15,10,5,62,30,32,55
Coleraine,2209,3,13,11,6,52,37,15,50
Cliftonville,2209,4,14,8,8,49,37,12,50
Glenavon,2209,5,13,11,6,53,42,11,50
Ballymena,2209,6,13,8,9,64,59,5,47
Glentoran,2209,7,10,5,15,34,52,-18,35
Dungannon,2209,8,7,13,10,51,50,1,34
Ballinamalla,2209,9,7,5,18,33,55,-22,26
Ards,2209,10,7,4,19,34,61,-27,25
Portadown,2209,11,4,6,20,26,66,-40,18
Cliftonville,2210,1,18,7,5,61,32,29,61
Crusaders,2210,2,15,9,6,48,31,17,54
Ballymena,2210,3,15,6,9,64,60,4,51
Linfield,2210,4,10,13,7,55,36,19,43
Coleraine,2210,5,10,11,9,42,43,-1,41
Glenavon,2210,6,10,10,10,48,51,-3,40
Ballinamalla,2210,7,12,3,15,40,53,-13,39
Ards,2210,8,9,7,14,41,51,-10,34
Dungannon,2210,9,8,9,13,42,43,-1,33
Glentoran,2210,10,8,7,15,35,49,-14,31
Portadown,2210,11,5,8,17,26,53,-27,23
Cliftonville,2211,1,18,3,9,58,40,18,57
Linfield,2211,2,15,11,4,62,28,34,56
Crusaders,2211,3,15,8,7,45,31,14,53
Ballymena,2211,4,15,8,7,56,49,7,53
Glenavon,2211,5,11,11,8,48,44,4,44
Coleraine,2211,6,10,11,9,38,37,1,41
Dungannon,2211,7,10,9,11,49,46,3,39
Glentoran,2211,8,9,8,13,29,43,-14,35
Ards,2211,9,10,4,16,38,54,-16,34
Ballinamalla,2211,10,8,3,19,34,55,-21,27
Portadown,2211,11,4,4,22,19,49,-30,16
Crusaders,2212,1,16,10,4,52,30,22,58
Linfield,2212,2,14,10,6,52,25,27,52
Ballymena,2212,3,15,4,11,58,55,3,49
Coleraine,2212,4,12,11,7,43,36,7,47
Dungannon,2212,5,11,10,9,45,35,10,43
Glentoran,2212,6,11,9,10,30,32,-2,42
Glenavon,2212,7,11,8,11,48,49,-1,41
Cliftonville,2212,8,11,5,14,46,46,0,38
Ards,2212,9,9,7,14,42,47,-5,34
Ballinamalla,2212,10,7,6,17,26,56,-30,27
Portadown,2212,11,5,6,19,25,56,-31,21
Cliftonville,2213,1,17,5,8,61,37,24,56
Linfield,2213,2,15,10,5,62,33,29,55
Crusaders,2213,3,15,6,9,60,47,13,51
Ballymena,2213,4,14,5,11,56,58,-2,47
Glenavon,2213,5,10,13,7,45,43,2,43
Ards,2213,6,12,5,13,41,41,0,41
Coleraine,2213,7,9,12,9,36,37,-1,39
Dungannon,2213,8,10,7,13,47,45,2,37
Glentoran,2213,9,10,6,14,34,49,-15,36
Ballinamalla,2213,10,8,6,16,26,49,-23,30
Portadown,2213,11,5,5,20,28,57,-29,20
Crusaders,2214,1,16,8,6,49,28,21,56
Linfield,2214,2,15,9,6,56,26,30,54
Cliftonville,2214,3,17,3,10,57,43,14,54
Glenavon,2214,4,10,12,8,44,42,2,42
Glentoran,2214,5,12,6,12,33,37,-4,42
Portadown,2214,6,12,6,12,35,41,-6,42
Coleraine,2214,7,8,12,10,40,44,-4,36
Ards,2214,8,11,3,16,38,45,-7,36
Ballymena,2214,9,9,9,12,44,57,-13,36
Dungannon,2214,10,7,10,13,43,52,-9,31
Ballinamalla,2214,11,6,6,18,30,54,-24,24
Linfield,2215,1,15,12,3,59,26,33,57
Crusaders,2215,2,14,10,6,55,33,22,52
Dungannon,2215,3,15,7,8,57,39,18,52
Cliftonville,2215,4,15,6,9,56,40,16,51
Glenavon,2215,5,12,9,9,49,50,-1,45
Ballymena,2215,6,13,5,12,48,58,-10,44
Coleraine,2215,7,10,10,10,40,40,0,40
Glentoran,2215,8,9,8,13,29,41,-12,35
Ballinamalla,2215,9,6,9,15,29,52,-23,27
Ards,2215,10,6,8,16,39,57,-18,26
Portadown,2215,11,5,6,19,24,49,-25,21
Ballymena,2216,1,18,5,7,63,47,16,59
Crusaders,2216,2,16,8,6,64,44,20,56
Cliftonville,2216,3,16,5,9,54,39,15,53
Linfield,2216,4,14,10,6,65,36,29,52
Glenavon,2216,5,11,12,7,53,44,9,45
Dungannon,2216,6,12,8,10,63,53,10,44
Coleraine,2216,7,10,11,9,52,44,8,41
Glentoran,2216,8,6,11,13,27,43,-16,29
Ards,2216,9,8,4,18,37,58,-21,28
Portadown,2216,10,7,3,20,25,55,-30,24
Ballinamalla,2216,11,7,3,20,30,70,-40,24
Crusaders,2217,1,18,6,6,58,36,22,60
Linfield,2217,2,14,9,7,56,31,25,51
Coleraine,2217,3,13,12,5,47,37,10,51
Cliftonville,2217,4,13,6,11,48,41,7,45
Ballymena,2217,5,13,6,11,61,64,-3,45
Glenavon,2217,6,12,7,11,46,48,-2,43
Dungannon,2217,7,10,9,11,51,48,3,39
Ballinamalla,2217,8,10,4,16,40,55,-15,34
Ards,2217,9,9,6,15,39,50,-11,33
Glentoran,2217,10,8,7,15,35,50,-15,31
Portadown,2217,11,6,6,18,27,48,-21,24
Linfield,2218,1,17,7,6,62,28,34,58
Cliftonville,2218,2,17,6,7,56,35,21,57
Ballymena,2218,3,14,8,8,56,54,2,50
Crusaders,2218,4,12,12,6,54,37,17,48
Glenavon,2218,5,12,10,8,55,48,7,46
Dungannon,2218,6,10,10,10,55,44,11,40
Glentoran,2218,7,9,10,11,31,44,-13,37
Coleraine,2218,8,8,9,13,41,48,-7,33
Portadown,2218,9,8,6,16,25,48,-23,30
Ards,2218,10,7,6,17,37,56,-19,27
Ballinamalla,2218,11,8,2,20,26,56,-30,26
Crusaders,2219,1,15,11,4,52,30,22,56
Linfield,2219,2,13,11,6,55,31,24,50
Cliftonville,2219,3,15,4,11,50,38,12,49
Ballymena,2219,4,14,7,9,54,52,2,49
Dungannon,2219,5,12,10,8,56,44,12,46
Glenavon,2219,6,12,9,9,49,41,8,45
Coleraine,2219,7,10,12,8,37,41,-4,42
Ards,2219,8,9,6,15,36,45,-9,33
Glentoran,2219,9,8,9,13,31,46,-15,33
Ballinamalla,2219,10,7,6,17,32,53,-21,27
Portadown,2219,11,4,7,19,18,49,-31,19
Crusaders,2220,1,16,8,6,62,36,26,56
Linfield,2220,2,14,10,6,58,35,23,52
Cliftonville,2220,3,14,6,10,51,40,11,48
Ballymena,2220,4,14,6,10,67,60,7,48
Glenavon,2220,5,10,15,5,40,35,5,45
Coleraine,2220,6,9,16,5,47,44,3,43
Glentoran,2220,7,11,9,10,29,34,-5,42
Dungannon,2220,8,8,9,13,44,48,-4,33
Ards,2220,9,8,7,15,33,44,-11,31
Ballinamalla,2220,10,7,4,19,28,55,-27,25
Portadown,2220,11,6,6,18,23,51,-28,24
Linfield,2221,1,19,8,3,70,22,48,65
Cliftonville,2221,2,17,4,9,54,36,18,55
Ballymena,2221,3,14,7,9,55,50,5,49
Crusaders,2221,4,13,8,9,48,38,10,47
Glenavon,2221,5,9,13,8,51,51,0,40
Coleraine,2221,6,10,10,10,34,35,-1,40
Dungannon,2221,7,9,9,12,42,40,2,36
Glentoran,2221,8,9,9,12,34,46,-12,36
Ards,2221,9,9,6,15,39,52,-13,33
Ballinamalla,2221,10,7,5,18,25,48,-23,26
Portadown,2221,11,5,9,16,20,54,-34,24
Crusaders,2222,1,18,6,6,62,37,25,60
Glenavon,2222,2,13,12,5,52,40,12,51
Linfield,2222,3,13,9,8,62,35,27,48
Ballymena,2222,4,13,8,9,65,59,6,47
Dungannon,2222,5,13,7,10,54,46,8,46
Coleraine,2222,6,12,8,10,42,35,7,44
Cliftonville,2222,7,11,8,11,46,45,1,41
Glentoran,2222,8,9,11,10,32,43,-11,38
Portadown,2222,9,8,5,17,28,52,-24,29
Ards,2222,10,8,4,18,39,58,-19,28
Ballinamalla,2222,11,6,4,20,25,57,-32,22
Cliftonville,2223,1,16,7,7,59,41,18,55
Crusaders,2223,2,14,8,8,52,40,12,50
Ballymena,2223,3,13,11,6,57,52,5,50
Glenavon,2223,4,11,14,5,50,41,9,47
Linfield,2223,5,10,12,8,52,36,16,42
Glentoran,2223,6,11,8,11,35,41,-6,41
Coleraine,2223,7,9,13,8,43,46,-3,40
Dungannon,2223,8,10,7,13,42,41,1,37
Ards,2223,9,9,5,16,41,48,-7,32
Portadown,2223,10,8,6,16,25,44,-19,30
Ballinamalla,2223,11,6,5,19,24,50,-26,23
Ballymena,2224,1,17,6,7,69,55,14,57
Linfield,2224,2,14,11,5,60,32,28,53
Cliftonville,2224,3,16,5,9,52,36,16,53
Crusaders,2224,4,15,7,8,44,27,17,52
Glenavon,2224,5,12,10,8,50,51,-1,46
Coleraine,2224,6,11,10,9,45,46,-1,43
Dungannon,2224,7,9,9,12,49,44,5,36
Glentoran,2224,8,8,9,13,33,47,-14,33
Ards,2224,9,9,4,17,39,55,-16,31
Portadown,2224,10,8,5,17,24,45,-21,29
Ballinamalla,2224,11,7,2,21,32,59,-27,23
Crusaders,2225,1,15,8,7,50,32,18,53
Cliftonville,2225,2,16,3,11,58,43,15,51
Glenavon,2225,3,14,9,7,57,42,15,51
Linfield,2225,4,14,8,8,61,40,21,50
Ballymena,2225,5,14,8,8,55,56,-1,50
Ards,2225,6,12,6,12,43,45,-2,42
Coleraine,2225,7,10,11,9,39,35,4,41
Dungannon,2225,8,9,11,10,50,46,4,38
Portadown,2225,9,7,6,17,22,47,-25,27
Glentoran,2225,10,6,8,16,29,54,-25,26
Ballinamalla,2225,11,4,10,16,23,47,-24,22
Linfield,2226,1,14,11,5,56,30,26,53
Cliftonville,2226,2,16,5,9,57,41,16,53
Glenavon,2226,3,14,8,8,53,44,9,50
Ballymena,2226,4,15,5,10,55,53,2,50
Crusaders,2226,5,13,6,11,49,40,9,45
Glentoran,2226,6,11,9,10,30,41,-11,42
Ards,2226,7,12,4,14,48,44,4,40
Coleraine,2226,8,10,10,10,37,37,0,40
Dungannon,2226,9,10,9,11,45,44,1,39
Portadown,2226,10,5,7,18,24,49,-25,22
Ballinamalla,2226,11,6,4,20,28,59,-31,22
Cliftonville,2227,1,18,4,8,59,40,19,58
Linfield,2227,2,16,9,5,64,33,31,57
Crusaders,2227,3,16,9,5,61,39,22,57
Ballymena,2227,4,14,7,9,55,55,0,49
Glenavon,2227,5,11,9,10,50,45,5,42
Ards,2227,6,11,5,14,35,43,-8,38
Coleraine,2227,7,7,15,8,33,35,-2,36
Glentoran,2227,8,10,6,14,38,48,-10,36
Dungannon,2227,9,7,12,11,46,43,3,33
Ballinamalla,2227,10,7,5,18,29,57,-28,26
Portadown,2227,11,4,7,19,25,57,-32,19
Crusaders,2228,1,17,6,7,57,32,25,57
Cliftonville,2228,2,16,4,10,55,42,13,52
Linfield,2228,3,14,9,7,56,31,25,51
Ballymena,2228,4,14,7,9,53,55,-2,49
Glenavon,2228,5,12,11,7,51,41,10,47
Coleraine,2228,6,11,11,8,41,38,3,44
Ards,2228,7,10,5,15,35,45,-10,35
Dungannon,2228,8,8,9,13,44,43,1,33
Glentoran,2228,9,7,9,14,27,49,-22,30
Ballinamalla,2228,10,8,5,17,29,54,-25,29
Portadown,2228,11,6,8,16,21,39,-18,26
Linfield,2229,1,19,7,4,65,28,37,64
Ballymena,2229,2,16,6,8,65,49,16,54
Cliftonville,2229,3,14,7,9,51,38,13,49
Crusaders,2229,4,13,8,9,46,39,7,47
Dungannon,2229,5,11,10,9,55,44,11,43
Glenavon,2229,6,11,10,9,50,48,2,43
Coleraine,2229,7,10,11,9,40,43,-3,41
Glentoran,2229,8,9,5,16,26,48,-22,32
Ballinamalla,2229,9,7,8,15,27,47,-20,29
Ards,2229,10,8,3,19,33,51,-18,27
Portadown,2229,11,8,3,19,26,49,-23,27
Crusaders,2230,1,15,10,5,62,41,21,55
Cliftonville,2230,2,17,4,9,54,38,16,55
Linfield,2230,3,13,10,7,56,32,24,49
Ballymena,2230,4,13,7,10,59,58,1,46
Glenavon,2230,5,11,10,9,51,50,1,43
Glentoran,2230,6,10,8,12,33,42,-9,38
Coleraine,2230,7,9,10,11,38,44,-6,37
Dungannon,2230,8,8,10,12,41,44,-3,34
Ards,2230,9,8,8,14,36,46,-10,32
Ballinamalla,2230,10,9,5,16,27,43,-16,32
Portadown,2230,11,7,8,15,28,47,-19,29
Crusaders,2231,1,18,10,2,57,31,26,64
Linfield,2231,2,13,11,6,61,34,27,50
Ballymena,2231,3,14,7,9,63,56,7,49
Dungannon,2231,4,12,8,10,48,39,9,44
Cliftonville,2231,5,13,4,13,55,49,6,43
Coleraine,2231,6,11,8,11,41,44,-3,41
Glenavon,2231,7,9,10,11,43,50,-7,37
Ards,2231,8,10,5,15,39,49,-10,35
Glentoran,2231,9,9,8,13,34,47,-13,35
Portadown,2231,10,7,7,16,22,43,-21,28
Ballinamalla,2231,11,7,6,17,28,49,-21,27
Cliftonville,2232,1,16,5,9,55,35,20,53
Linfield,2232,2,14,9,7,56,35,21,51
Ballymena,2232,3,15,6,9,60,56,4,51
Crusaders,2232,4,12,7,11,48,39,9,43
Coleraine,2232,5,11,10,9,39,37,2,43
Dungannon,2232,6,11,9,10,49,46,3,42
Ards,2232,7,11,7,12,46,42,4,40
Glentoran,2232,8,11,6,13,32,40,-8,39
Glenavon,2232,9,8,13,9,46,48,-2,37
Ballinamalla,2232,10,7,6,17,29,58,-29,27
Portadown,2232,11,6,8,16,24,48,-24,26
Linfield,2233,1,17,9,4,64,29,35,60
Crusaders,2233,2,16,8,6,58,32,26,56
Coleraine,2233,3,12,11,7,42,29,13,47
Cliftonville,2233,4,14,5,11,51,43,8,47
Ballymena,2233,5,13,7,10,55,57,-2,46
Glenavon,2233,6,11,10,9,45,47,-2,43
Ards,2233,7,9,7,14,37,54,-17,34
Dungannon,2233,8,8,9,13,52,49,3,33
Glentoran,2233,9,6,12,12,22,37,-15,30
Ballinamalla,2233,10,8,4,18,27,56,-29,28
Portadown,2233,11,7,6,17,26,46,-20,27
Linfield,2234,1,16,7,7,62,34,28,55
Cliftonville,2234,2,15,7,8,56,38,18,52
Crusaders,2234,3,14,9,7,51,36,15,51
Ballymena,2234,4,12,9,9,58,55,3,45
Dungannon,2234,5,12,8,10,57,43,14,44
Coleraine,2234,6,11,11,8,41,36,5,44
Glenavon,2234,7,10,11,9,44,51,-7,41
Ards,2234,8,11,5,14,40,43,-3,38
Glentoran,2234,9,9,8,13,32,44,-12,35
Portadown,2234,10,7,6,17,25,54,-29,27
Ballinamalla,2234,11,6,3,21,25,57,-32,21
Ballymena,2235,1,17,7,6,58,45,13,58
Crusaders,2235,2,16,8,6,56,33,23,56
Linfield,2235,3,11,12,7,51,29,22,45
Cliftonville,2235,4,13,6,11,51,44,7,45
Glenavon,2235,5,11,12,7,49,44,5,45
Coleraine,2235,6,11,11,8,42,41,1,44
Glentoran,2235,7,9,9,12,31,43,-12,36
Dungannon,2235,8,8,11,11,51,54,-3,35
Portadown,2235,9,8,6,16,26,43,-17,30
Ards,2235,10,7,7,16,37,49,-12,28
Ballinamalla,2235,11,6,7,17,24,51,-27,25
Linfield,2236,1,18,10,2,64,25,39,64
Ballymena,2236,2,17,6,7,64,59,5,57
Crusaders,2236,3,14,8,8,61,49,12,50
Glenavon,2236,4,11,12,7,45,43,2,45
Cliftonville,2236,5,12,7,11,53,43,10,43
Dungannon,2236,6,9,11,10,51,47,4,38
Ards,2236,7,10,7,13,43,47,-4,37
Coleraine,2236,8,9,10,11,32,37,-5,37
Glentoran,2236,9,7,8,15,31,47,-16,29
Portadown,2236,10,6,7,17,25,48,-23,25
Ballinamalla,2236,11,6,6,18,28,52,-24,24
Crusaders,2237,1,17,9,4,59,28,31,60
Ballymena,2237,2,15,8,7,56,53,3,53
Linfield,2237,3,14,9,7,57,36,21,51
Cliftonville,2237,4,13,7,10,49,37,12,46
Coleraine,2237,5,11,12,7,46,39,7,45
Glenavon,2237,6,9,13,8,45,47,-2,40
Dungannon,2237,7,9,10,11,49,47,2,37
Ards,2237,8,9,7,14,40,51,-11,34
Glentoran,2237,9,8,10,12,27,41,-14,34
Portadown,2237,10,6,8,16,27,49,-22,26
Ballinamalla,2237,11,5,5,20,29,56,-27,20
Linfield,2238,1,17,7,6,65,33,32,58
Crusaders,2238,2,15,9,6,57,34,23,54
Cliftonville,2238,3,14,10,6,54,34,20,52
Coleraine,2238,4,12,11,7,42,37,5,47
Ballymena,2238,5,12,9,9,52,50,2,45
Dungannon,2238,6,10,10,10,52,52,0,40
Glenavon,2238,7,10,10,10,48,53,-5,40
Ards,2238,8,10,5,15,39,46,-7,35
Ballinamalla,2238,9,9,5,16,34,50,-16,32
Portadown,2238,10,5,8,17,22,52,-30,23
Glentoran,2238,11,4,10,16,20,44,-24,22
Linfield,2239,1,16,8,6,63,33,30,56
Cliftonville,2239,2,16,5,9,55,37,18,53
Crusaders,2239,3,14,8,8,51,38,13,50
Ballymena,2239,4,14,7,9,63,58,5,49
Coleraine,2239,5,11,10,9,45,42,3,43
Glenavon,2239,6,11,9,10,45,48,-3,42
Dungannon,2239,7,10,10,10,56,46,10,40
Portadown,2239,8,9,7,14,36,41,-5,34
Glentoran,2239,9,10,4,16,35,56,-21,34
Ards,2239,10,8,5,17,32,49,-17,29
Ballinamalla,2239,11,8,3,19,28,61,-33,27
Ballymena,2240,1,18,5,7,69,53,16,59
Cliftonville,2240,2,16,6,8,57,41,16,54
Linfield,2240,3,13,10,7,59,33,26,49
Crusaders,2240,4,14,7,9,51,38,13,49
Glenavon,2240,5,12,11,7,49,48,1,47
Dungannon,2240,6,10,10,10,55,41,14,40
Coleraine,2240,7,7,13,10,41,45,-4,34
Ballinamalla,2240,8,10,4,16,39,56,-17,34
Glentoran,2240,9,9,7,14,26,46,-20,34
Ards,2240,10,8,6,16,35,54,-19,30
Portadown,2240,11,6,5,19,19,45,-26,23
Linfield,2241,1,18,9,3,60,20,40,63
Cliftonville,2241,2,16,5,9,55,37,18,53
Crusaders,2241,3,14,10,6,47,42,5,52
Ballymena,2241,4,13,5,12,60,54,6,44
Coleraine,2241,5,11,11,8,40,39,1,44
Glenavon,2241,6,9,16,5,48,44,4,43
Dungannon,2241,7,11,8,11,43,37,6,41
Ards,2241,8,10,4,16,38,51,-13,34
Glentoran,2241,9,8,6,16,30,48,-18,30
Portadown,2241,10,5,11,14,23,42,-19,26
Ballinamalla,2241,11,6,3,21,30,60,-30,21
Crusaders,2242,1,18,7,5,52,31,21,61
Cliftonville,2242,2,16,4,10,53,44,9,52
Linfield,2242,3,14,9,7,58,29,29,51
Coleraine,2242,4,11,11,8,38,36,2,44
Glenavon,2242,5,10,10,10,45,49,-4,40
Ballymena,2242,6,12,3,15,48,64,-16,39
Ards,2242,7,10,8,12,41,41,0,38
Ballinamalla,2242,8,11,5,14,32,44,-12,38
Glentoran,2242,9,8,11,11,27,38,-11,35
Dungannon,2242,10,8,8,14,47,43,4,32
Portadown,2242,11,6,6,18,26,48,-22,24
Crusaders,2243,1,17,8,5,63,41,22,59
Cliftonville,2243,2,14,9,7,58,43,15,51
Linfield,2243,3,14,8,8,64,39,25,50
Coleraine,2243,4,13,9,8,46,35,11,48
Ballymena,2243,5,13,6,11,54,56,-2,45
Glenavon,2243,6,10,12,8,50,47,3,42
Dungannon,2243,7,11,8,11,49,46,3,41
Ards,2243,8,9,6,15,37,48,-11,33
Glentoran,2243,9,8,9,13,29,42,-13,33
Portadown,2243,10,8,5,17,29,45,-16,29
Ballinamalla,2243,11,6,4,20,25,62,-37,22
Crusaders,2244,1,17,7,6,58,39,19,58
Linfield,2244,2,13,11,6,57,33,24,50
Cliftonville,2244,3,14,5,11,52,40,12,47
Ballymena,2244,4,14,4,12,51,64,-13,46
Coleraine,2244,5,11,9,10,40,40,0,42
Dungannon,2244,6,10,11,9,54,46,8,41
Glenavon,2244,7,10,9,11,44,48,-4,39
Ballinamalla,2244,8,11,2,17,40,53,-13,35
Ards,2244,9,9,7,14,38,44,-6,34
Glentoran,2244,10,8,9,13,28,46,-18,33
Portadown,2244,11,9,4,17,33,42,-9,31
Crusaders,2245,1,17,8,5,56,31,25,59
Linfield,2245,2,16,8,6,59,28,31,56
Coleraine,2245,3,12,11,7,41,35,6,47
Cliftonville,2245,4,12,7,11,49,40,9,43
Ballymena,2245,5,11,10,9,50,59,-9,43
Glenavon,2245,6,11,9,10,50,45,5,42
Glentoran,2245,7,10,10,10,35,41,-6,40
Dungannon,2245,8,8,10,12,43,46,-3,34
Ards,2245,9,9,7,14,39,51,-12,34
Ballinamalla,2245,10,8,3,19,37,63,-26,27
Portadown,2245,11,6,7,17,24,44,-20,25
Crusaders,2246,1,18,8,4,54,26,28,62
Coleraine,2246,2,14,12,4,51,38,13,54
Cliftonville,2246,3,15,8,7,55,35,20,53
Linfield,2246,4,12,13,5,57,33,24,49
Ballymena,2246,5,11,8,11,56,63,-7,41
Glenavon,2246,6,8,14,8,40,43,-3,38
Dungannon,2246,7,9,9,12,42,42,0,36
Ards,2246,8,7,9,14,39,49,-10,30
Glentoran,2246,9,7,7,16,29,49,-20,28
Portadown,2246,10,7,7,16,23,44,-21,28
Ballinamalla,2246,11,6,7,17,23,47,-24,25
Crusaders,2247,1,15,8,7,55,38,17,53
Ballymena,2247,2,14,9,7,57,50,7,51
Linfield,2247,3,14,8,8,55,35,20,50
Glenavon,2247,4,13,10,7,54,40,14,49
Coleraine,2247,5,11,11,8,45,40,5,44
Dungannon,2247,6,11,10,9,58,44,14,43
Cliftonville,2247,7,13,4,13,47,45,2,43
Glentoran,2247,8,8,9,13,29,43,-14,33
Ballinamalla,2247,9,9,4,17,31,57,-26,31
Ards,2247,10,8,5,17,39,52,-13,29
Portadown,2247,11,5,10,15,18,44,-26,25
Crusaders,2248,1,20,6,4,56,27,29,66
Linfield,2248,2,15,7,8,61,29,32,52
Ballymena,2248,3,15,7,8,58,54,4,52
Cliftonville,2248,4,13,6,11,52,42,10,45
Coleraine,2248,5,11,12,7,42,37,5,45
Glenavon,2248,6,12,9,9,42,44,-2,45
Dungannon,2248,7,9,10,11,44,40,4,37
Ards,2248,8,9,4,17,36,53,-17,31
Ballinamalla,2248,9,8,6,16,33,56,-23,30
Glentoran,2248,10,7,7,16,30,51,-21,28
Portadown,2248,11,6,6,18,24,45,-21,24
Linfield,2249,1,17,9,4,61,30,31,60
Crusaders,2249,2,16,7,7,60,41,19,55
Glenavon,2249,3,15,8,7,52,44,8,53
Cliftonville,2249,4,14,5,11,49,42,7,47
Coleraine,2249,5,11,11,8,43,35,8,44
Ballymena,2249,6,12,6,12,52,58,-6,42
Dungannon,2249,7,10,9,11,52,39,13,39
Portadown,2249,8,9,6,15,25,40,-15,33
Ards,2249,9,9,4,17,35,56,-21,31
Ballinamalla,2249,10,8,3,19,37,58,-21,27
Glentoran,2249,11,7,6,17,25,48,-23,27
Linfield,2250,1,14,8,8,54,34,20,50
Glenavon,2250,2,13,10,7,51,42,9,49
Dungannon,2250,3,14,6,10,59,41,18,48
Cliftonville,2250,4,14,5,11,50,38,12,47
Crusaders,2250,5,13,8,9,49,41,8,47
Ballymena,2250,6,12,7,11,55,56,-1,43
Coleraine,2250,7,11,10,9,38,41,-3,43
Glentoran,2250,8,11,6,13,30,42,-12,39
Ards,2250,9,10,6,14,37,42,-5,36
Portadown,2250,10,9,4,17,28,46,-18,31
Ballinamalla,2250,11,6,6,18,27,55,-28,24
Crusaders,2251,1,16,7,7,61,40,21,55
Linfield,2251,2,14,9,7,55,31,24,51
Dungannon,2251,3,12,10,8,59,41,18,46
Ballymena,2251,4,13,7,10,53,57,-4,46
Coleraine,2251,5,11,12,7,45,37,8,45
Cliftonville,2251,6,10,10,10,48,45,3,40
Glenavon,2251,7,9,13,8,40,45,-5,40
Ards,2251,8,11,5,14,40,43,-3,38
Ballinamalla,2251,9,9,5,16,29,53,-24,32
Portadown,2251,10,8,5,17,27,44,-17,29
Glentoran,2251,11,7,7,16,29,50,-21,28
Crusaders,2252,1,15,9,6,53,33,20,54
Cliftonville,2252,2,16,5,9,52,32,20,53
Linfield,2252,3,14,9,7,58,31,27,51
Ballymena,2252,4,15,5,10,52,51,1,50
Glenavon,2252,5,12,11,7,50,48,2,47
Dungannon,2252,6,12,8,10,48,43,5,44
Coleraine,2252,7,10,11,9,42,43,-1,41
Glentoran,2252,8,11,8,11,34,39,-5,41
Ards,2252,9,10,5,15,42,49,-7,35
Ballinamalla,2252,10,6,4,20,29,52,-23,22
Portadown,2252,11,5,3,22,20,59,-39,18
Crusaders,2253,1,15,8,7,50,42,8,53
Linfield,2253,2,14,10,6,58,30,28,52
Coleraine,2253,3,13,12,5,39,28,11,51
Cliftonville,2253,4,14,5,11,44,34,10,47
Ballymena,2253,5,13,8,9,57,54,3,47
Dungannon,2253,6,10,10,10,54,42,12,40
Portadown,2253,7,10,8,12,29,37,-8,38
Ards,2253,8,11,4,15,36,50,-14,37
Glenavon,2253,9,7,10,13,32,45,-13,31
Glentoran,2253,10,7,8,15,30,46,-16,29
Ballinamalla,2253,11,7,5,18,28,49,-21,26
Linfield,2254,1,14,11,5,51,26,25,53
Crusaders,2254,2,15,7,8,49,34,15,52
Cliftonville,2254,3,15,3,12,48,38,10,48
Coleraine,2254,4,11,14,5,42,30,12,47
Ballymena,2254,5,12,10,8,56,49,7,46
Glenavon,2254,6,12,10,8,45,39,6,46
Ards,2254,7,11,6,13,42,45,-3,39
Dungannon,2254,8,9,10,11,50,47,3,37
Glentoran,2254,9,9,7,14,33,51,-18,34
Ballinamalla,2254,10,9,3,18,33,59,-26,30
Portadown,2254,11,5,5,20,19,50,-31,20
Crusaders,2255,1,15,6,9,52,38,14,51
Cliftonville,2255,2,16,3,11,49,38,11,51
Linfield,2255,3,14,8,8,63,37,26,50
Coleraine,2255,4,13,10,7,44,29,15,49
Ballymena,2255,5,13,7,10,53,55,-2,46
Dungannon,2255,6,11,10,9,52,40,12,43
Glenavon,2255,7,9,11,10,39,47,-8,38
Glentoran,2255,8,10,6,14,31,43,-12,36
Ards,2255,9,10,5,15,45,55,-10,35
Portadown,2255,10,8,6,16,30,53,-23,30
Ballinamalla,2255,11,8,4,18,32,55,-23,28
Linfield,2256,1,18,6,6,63,33,30,60
Crusaders,2256,2,17,8,5,57,27,30,59
Coleraine,2256,3,13,9,8,46,41,5,48
Ballymena,2256,4,13,6,11,58,63,-5,45
Cliftonville,2256,5,13,5,12,52,49,3,44
Glenavon,2256,6,11,8,11,44,45,-1,41
Ards,2256,7,11,4,15,42,55,-13,37
Dungannon,2256,8,9,9,12,48,47,1,36
Glentoran,2256,9,8,8,14,28,40,-12,32
Portadown,2256,10,8,6,16,21,39,-18,30
Ballinamalla,2256,11,8,3,19,31,51,-20,27
Linfield,2257,1,16,9,5,67,31,36,57
Crusaders,2257,2,16,6,8,53,33,20,54
Ballymena,2257,3,15,8,7,58,48,10,53
Cliftonville,2257,4,14,6,10,56,41,15,48
Glenavon,2257,5,9,15,6,38,40,-2,42
Dungannon,2257,6,9,12,9,46,42,4,39
Ards,2257,7,11,6,13,38,45,-7,39
Coleraine,2257,8,7,13,10,33,43,-10,34
Portadown,2257,9,8,6,16,31,50,-19,30
Ballinamalla,2257,10,6,8,16,31,53,-22,26
Glentoran,2257,11,6,7,17,24,49,-25,25
Cliftonville,2258,1,16,6,8,54,34,20,54
Crusaders,2258,2,15,6,9,52,38,14,51
Ballymena,2258,3,15,6,9,64,58,6,51
Linfield,2258,4,13,11,6,65,35,30,50
Coleraine,2258,5,12,11,7,46,37,9,47
Dungannon,2258,6,13,7,10,55,45,10,46
Glenavon,2258,7,12,10,8,43,43,0,46
Glentoran,2258,8,9,7,14,33,46,-13,34
Portadown,2258,9,8,5,17,30,48,-18,29
Ballinamalla,2258,10,7,7,16,30,53,-23,28
Ards,2258,11,4,6,20,31,66,-35,18
Cliftonville,2259,1,19,5,6,60,31,29,62
Ballymena,2259,2,17,4,9,61,58,3,55
Crusaders,2259,3,16,6,8,54,40,14,54
Linfield,2259,4,13,8,9,56,36,20,47
Glenavon,2259,5,12,11,7,54,47,7,47
Coleraine,2259,6,10,12,8,41,39,2,42
Dungannon,2259,7,10,9,11,53,47,6,39
Ards,2259,8,9,4,17,37,49,-12,31
Glentoran,2259,9,8,7,15,26,48,-22,31
Portadown,2259,10,7,4,19,29,51,-22,25
Ballinamalla,2259,11,7,4,19,29,54,-25,25
Crusaders,2260,1,17,7,6,66,39,27,58
Cliftonville,2260,2,17,3,10,58,39,19,54
Ballymena,2260,3,15,9,6,60,54,6,54
Linfield,2260,4,15,7,8,62,33,29,52
Glenavon,2260,5,10,11,9,47,50,-3,41
Coleraine,2260,6,9,12,9,43,45,-2,39
Dungannon,2260,7,8,11,11,47,44,3,35
Glentoran,2260,8,9,6,15,26,42,-16,33
Portadown,2260,9,9,5,16,27,52,-25,32
Ards,2260,10,8,4,18,38,53,-15,28
Ballinamalla,2260,11,7,7,16,29,52,-23,28
Linfield,2261,1,16,8,6,59,30,29,56
Cliftonville,2261,2,16,5,9,57,40,17,53
Crusaders,2261,3,14,9,7,58,37,21,51
Ballymena,2261,4,12,10,8,53,55,-2,46
Dungannon,2261,5,11,10,9,53,43,10,43
Coleraine,2261,6,11,10,9,41,31,10,43
Glenavon,2261,7,9,11,10,44,47,-3,38
Ards,2261,8,10,7,13,44,46,-2,37
Ballinamalla,2261,9,7,7,16,27,49,-22,28
Glentoran,2261,10,7,7,16,31,61,-30,28
Portadown,2261,11,6,8,16,21,49,-28,26
Cliftonville,2262,1,17,4,9,51,38,13,55
Crusaders,2262,2,15,9,6,63,44,19,54
Ballymena,2262,3,15,6,9,55,51,4,51
Coleraine,2262,4,13,11,6,46,35,11,50
Linfield,2262,5,12,11,7,52,25,27,47
Glenavon,2262,6,10,10,10,46,48,-2,40
Dungannon,2262,7,8,11,11,45,45,0,35
Glentoran,2262,8,8,10,12,31,46,-15,34
Ballinamalla,2262,9,8,5,17,33,52,-19,29
Ards,2262,10,6,9,15,32,51,-19,27
Portadown,2262,11,5,10,15,18,37,-19,25
Crusaders,2263,1,16,9,5,61,36,25,57
Cliftonville,2263,2,16,3,11,55,39,16,51
Glenavon,2263,3,13,9,8,51,45,6,48
Ballymena,2263,4,14,6,10,61,59,2,48
Linfield,2263,5,11,12,7,65,46,19,45
Coleraine,2263,6,11,9,10,37,40,-3,42
Glentoran,2263,7,12,5,13,36,50,-14,41
Ards,2263,8,11,4,15,42,45,-3,37
Dungannon,2263,9,9,8,13,55,55,0,35
Portadown,2263,10,8,3,19,30,58,-28,27
Ballinamalla,2263,11,6,8,16,31,51,-20,26
Crusaders,2264,1,14,12,4,51,32,19,54
Ballymena,2264,2,16,5,9,56,54,2,53
Cliftonville,2264,3,15,6,9,47,37,10,51
Dungannon,2264,4,12,10,8,49,36,13,46
Linfield,2264,5,12,9,9,61,39,22,45
Glenavon,2264,6,11,11,8,49,44,5,44
Coleraine,2264,7,9,12,9,42,40,2,39
Ards,2264,8,10,7,13,37,41,-4,37
Glentoran,2264,9,8,11,11,29,41,-12,35
Portadown,2264,10,7,5,18,23,47,-24,26
Ballinamalla,2264,11,5,4,21,21,54,-33,19
Crusaders,2265,1,15,9,6,49,31,18,54
Ballymena,2265,2,15,6,9,56,59,-3,51
Cliftonville,2265,3,14,7,9,52,41,11,49
Linfield,2265,4,10,12,8,59,42,17,42
Coleraine,2265,5,10,12,8,47,42,5,42
Glenavon,2265,6,10,10,10,43,47,-4,40
Portadown,2265,7,11,6,13,30,36,-6,39
Dungannon,2265,8,9,8,13,46,46,0,35
Glentoran,2265,9,8,10,12,29,44,-15,34
Ballinamalla,2265,10,9,6,15,35,46,-11,33
Ards,2265,11,7,8,15,43,55,-12,29
Glenavon,2266,1,14,9,7,60,43,17,51
Crusaders,2266,2,15,6,9,49,41,8,51
Linfield,2266,3,13,11,6,55,30,25,50
Cliftonville,2266,4,15,5,10,53,38,15,50
Dungannon,2266,5,13,10,7,52,46,6,49
Ballymena,2266,6,13,7,10,59,53,6,46
Coleraine,2266,7,11,10,9,42,37,5,43
Ards,2266,8,8,7,15,34,49,-15,31
Glentoran,2266,9,9,4,17,27,48,-21,31
Ballinamalla,2266,10,9,1,20,28,49,-21,28
Portadown,2266,11,6,8,16,27,52,-25,26
Crusaders,2267,1,18,10,2,59,30,29,64
Linfield,2267,2,14,7,9,54,30,24,49
Glenavon,2267,3,12,12,6,45,39,6,48
Ballymena,2267,4,14,6,10,59,57,2,48
Cliftonville,2267,5,14,5,11,45,37,8,47
Coleraine,2267,6,11,9,10,43,37,6,42
Glentoran,2267,7,11,6,13,35,54,-19,39
Dungannon,2267,8,9,11,10,48,44,4,38
Ards,2267,9,9,4,17,41,46,-5,31
Portadown,2267,10,6,8,16,21,47,-26,26
Ballinamalla,2267,11,5,6,19,31,60,-29,21
Linfield,2268,1,15,11,4,60,29,31,56
Crusaders,2268,2,16,6,8,59,41,18,54
Cliftonville,2268,3,15,6,9,60,47,13,51
Ballymena,2268,4,12,11,7,65,57,8,47
Glenavon,2268,5,10,14,6,49,43,6,44
Coleraine,2268,6,11,11,8,40,39,1,44
Dungannon,2268,7,9,12,9,50,47,3,39
Glentoran,2268,8,8,10,12,32,44,-12,34
Ards,2268,9,7,7,16,36,51,-15,28
Ballinamalla,2268,10,6,6,18,30,57,-27,24
Portadown,2268,11,4,10,16,24,50,-26,22
Coleraine,2269,1,16,9,5,56,35,21,57
Crusaders,2269,2,15,6,9,50,38,12,51
Cliftonville,2269,3,15,5,10,49,38,11,50
Linfield,2269,4,12,12,6,59,36,23,48
Ballymena,2269,5,13,8,9,57,55,2,47
Dungannon,2269,6,12,9,9,50,38,12,45
Glenavon,2269,7,10,11,9,43,45,-2,41
Ards,2269,8,10,4,16,38,49,-11,34
Glentoran,2269,9,9,6,15,36,50,-14,33
Portadown,2269,10,6,6,18,25,51,-26,24
Ballinamalla,2269,11,6,6,18,26,54,-28,24
Crusaders,2270,1,18,7,5,58,30,28,61
Cliftonville,2270,2,16,3,11,51,38,13,51
Ballymena,2270,3,14,7,9,61,62,-1,49
Linfield,2270,4,13,9,8,58,36,22,48
Glenavon,2270,5,12,8,10,51,44,7,44
Glentoran,2270,6,10,11,9,35,38,-3,41
Coleraine,2270,7,10,10,10,39,38,1,40
Dungannon,2270,8,9,10,11,43,42,1,37
Ards,2270,9,10,5,15,37,51,-14,35
Ballinamalla,2270,10,8,5,17,34,58,-24,29
Portadown,2270,11,6,3,21,17,47,-30,21
Crusaders,2271,1,18,7,5,55,29,26,61
Ballymena,2271,2,16,6,8,60,50,10,54
Glentoran,2271,3,15,5,10,40,38,2,50
Glenavon,2271,4,12,9,9,51,46,5,45
Cliftonville,2271,5,12,8,10,47,43,4,44
Linfield,2271,6,10,9,11,52,39,13,39
Dungannon,2271,7,11,6,13,46,49,-3,39
Coleraine,2271,8,9,10,11,42,48,-6,37
Ards,2271,9,10,4,16,35,46,-11,34
Portadown,2271,10,8,5,17,27,45,-18,29
Ballinamalla,2271,11,7,5,18,21,43,-22,26
Cliftonville,2272,1,17,7,6,65,45,20,58
Crusaders,2272,2,15,11,4,57,33,24,56
Glenavon,2272,3,13,12,5,51,42,9,51
Linfield,2272,4,12,12,6,57,34,23,48
Coleraine,2272,5,10,11,9,40,35,5,41
Ballymena,2272,6,11,8,11,55,61,-6,41
Ards,2272,7,9,6,15,40,52,-12,33
Glentoran,2272,8,8,9,13,34,47,-13,33
Dungannon,2272,9,7,11,12,43,45,-2,32
Ballinamalla,2272,10,8,5,17,35,56,-21,29
Portadown,2272,11,6,6,18,22,49,-27,24
Linfield,2273,1,18,8,4,63,26,37,62
Crusaders,2273,2,16,8,6,58,40,18,56
Cliftonville,2273,3,14,5,11,55,43,12,47
Glenavon,2273,4,11,11,8,54,50,4,44
Ballymena,2273,5,12,7,11,50,59,-9,43
Dungannon,2273,6,11,8,11,58,47,11,41
Glentoran,2273,7,11,8,11,40,45,-5,41
Coleraine,2273,8,9,10,11,38,41,-3,37
Ballinamalla,2273,9,9,4,17,33,56,-23,31
Portadown,2273,10,7,5,18,32,52,-20,26
Ards,2273,11,6,8,16,31,53,-22,26
Crusaders,2274,1,15,7,8,54,39,15,52
Linfield,2274,2,13,11,6,61,38,23,50
Cliftonville,2274,3,15,4,11,54,46,8,49
Ballymena,2274,4,14,5,11,61,63,-2,47
Glenavon,2274,5,12,9,9,57,46,11,45
Coleraine,2274,6,12,9,9,45,43,2,45
Dungannon,2274,7,10,9,11,55,45,10,39
Glentoran,2274,8,11,6,13,37,44,-7,39
Portadown,2274,9,8,8,14,30,47,-17,32
Ards,2274,10,9,4,17,37,53,-16,31
Ballinamalla,2274,11,8,4,18,30,57,-27,28
Crusaders,2275,1,16,9,5,56,32,24,57
Linfield,2275,2,15,9,6,69,37,32,54
Glenavon,2275,3,15,8,7,46,38,8,53
Cliftonville,2275,4,15,5,10,48,38,10,50
Dungannon,2275,5,12,10,8,51,35,16,46
Ballymena,2275,6,11,10,9,55,54,1,43
Coleraine,2275,7,9,9,12,42,50,-8,36
Glentoran,2275,8,7,12,11,31,42,-11,33
Ballinamalla,2275,9,8,6,16,32,56,-24,30
Portadown,2275,10,6,6,18,25,48,-23,24
Ards,2275,11,6,6,18,35,60,-25,24
Crusaders,2276,1,15,8,7,59,40,19,53
Cliftonville,2276,2,16,4,10,49,35,14,52
Coleraine,2276,3,12,11,7,43,42,1,47
Glenavon,2276,4,12,9,9,51,49,2,45
Ballymena,2276,5,12,9,9,56,56,0,45
Linfield,2276,6,11,10,9,52,34,18,43
Dungannon,2276,7,10,8,12,51,49,2,38
Ballinamalla,2276,8,11,5,14,42,51,-9,38
Glentoran,2276,9,9,8,13,35,47,-12,35
Ards,2276,10,8,7,15,39,52,-13,31
Portadown,2276,11,6,7,17,25,47,-22,25
Linfield,2277,1,16,9,5,65,27,38,57
Crusaders,2277,2,15,9,6,54,39,15,54
Cliftonville,2277,3,15,6,9,59,48,11,51
Coleraine,2277,4,14,8,8,52,40,12,50
Glenavon,2277,5,12,10,8,47,44,3,46
Ballymena,2277,6,10,8,12,55,63,-8,38
Ards,2277,7,10,7,13,44,50,-6,37
Portadown,2277,8,10,6,14,34,46,-12,36
Dungannon,2277,9,7,11,12,47,51,-4,32
Glentoran,2277,10,5,10,15,34,55,-21,25
Ballinamalla,2277,11,6,6,18,25,53,-28,24
Crusaders,2278,1,14,9,7,54,35,19,51
Coleraine,2278,2,14,9,7,50,37,13,51
Ballymena,2278,3,15,6,9,55,53,2,51
Glenavon,2278,4,13,11,6,56,47,9,50
Linfield,2278,5,12,11,7,60,34,26,47
Cliftonville,2278,6,14,4,12,48,40,8,46
Glentoran,2278,7,11,6,13,30,46,-16,39
Dungannon,2278,8,9,9,12,45,43,2,36
Ards,2278,9,8,8,14,42,50,-8,32
Ballinamalla,2278,10,7,5,18,29,53,-24,26
Portadown,2278,11,7,4,19,24,55,-31,25
Crusaders,2279,1,16,8,6,49,32,17,56
Linfield,2279,2,13,10,7,52,33,19,49
Dungannon,2279,3,12,12,6,50,33,17,48
Cliftonville,2279,4,14,6,10,55,43,12,48
Ballymena,2279,5,12,8,10,53,54,-1,44
Coleraine,2279,6,9,12,9,40,42,-2,39
Ards,2279,7,10,8,12,37,42,-5,38
Glenavon,2279,8,9,9,12,47,52,-5,36
Ballinamalla,2279,9,10,4,16,34,49,-15,34
Portadown,2279,10,9,6,15,32,46,-14,33
Glentoran,2279,11,4,11,15,22,45,-23,23
Crusaders,2280,1,21,4,5,61,33,28,67
Ballymena,2280,2,15,6,9,59,60,-1,51
Coleraine,2280,3,12,11,7,46,33,13,47
Dungannon,2280,4,11,10,9,49,40,9,43
Glenavon,2280,5,11,10,9,46,47,-1,43
Linfield,2280,6,10,10,10,50,35,15,40
Cliftonville,2280,7,11,7,12,44,43,1,40
Portadown,2280,8,10,6,14,30,41,-11,36
Glentoran,2280,9,8,7,15,32,50,-18,31
Ards,2280,10,8,6,16,33,44,-11,30
Ballinamalla,2280,11,7,5,18,27,51,-24,26
Linfield,2281,1,15,8,7,60,30,30,53
Crusaders,2281,2,15,7,8,52,37,15,52
Ballymena,2281,3,15,6,9,59,53,6,51
Coleraine,2281,4,12,11,7,48,39,9,47
Glenavon,2281,5,12,10,8,44,44,0,46
Cliftonville,2281,6,13,6,11,48,46,2,45
Dungannon,2281,7,10,9,11,55,45,10,39
Ards,2281,8,9,5,16,32,49,-17,32
Glentoran,2281,9,7,9,14,22,37,-15,30
Ballinamalla,2281,10,9,3,18,33,51,-18,30
Portadown,2281,11,7,8,15,25,47,-22,29
Cliftonville,2282,1,17,4,9,53,35,18,55
Crusaders,2282,2,16,7,7,52,36,16,55
Ballymena,2282,3,16,6,8,59,56,3,54
Linfield,2282,4,14,10,6,61,36,25,52
Coleraine,2282,5,14,9,7,48,37,11,51
Glentoran,2282,6,10,8,12,31,41,-10,38
Dungannon,2282,7,8,10,12,49,42,7,34
Ards,2282,8,10,3,17,36,46,-10,33
Glenavon,2282,9,7,11,12,42,54,-12,32
Portadown,2282,10,6,9,15,26,46,-20,27
Ballinamalla,2282,11,7,3,20,27,55,-28,24
Crusaders,2283,1,17,6,7,64,36,28,57
Cliftonville,2283,2,15,6,9,57,47,10,51
Coleraine,2283,3,13,10,7,41,34,7,49
Linfield,2283,4,12,11,7,51,31,20,47
Dungannon,2283,5,12,10,8,53,41,12,46
Ballymena,2283,6,13,7,10,60,58,2,46
Glentoran,2283,7,10,7,13,32,48,-16,37
Ards,2283,8,9,8,13,38,44,-6,35
Glenavon,2283,9,8,9,13,34,47,-13,33
Portadown,2283,10,9,6,15,25,38,-13,33
Ballinamalla,2283,11,6,2,22,24,55,-31,20
Ballymena,2284,1,16,7,7,62,54,8,55
Linfield,2284,2,15,6,9,57,37,20,51
Crusaders,2284,3,15,6,9,54,38,16,51
Cliftonville,2284,4,15,6,9,55,42,13,51
Coleraine,2284,5,12,10,8,44,39,5,46
Glentoran,2284,6,11,8,11,33,35,-2,41
Glenavon,2284,7,10,9,11,46,51,-5,39
Dungannon,2284,8,9,11,10,50,45,5,38
Ards,2284,9,10,6,14,40,45,-5,36
Ballinamalla,2284,10,6,6,18,26,54,-28,24
Portadown,2284,11,6,5,19,24,51,-27,23
Crusaders,2285,1,17,6,7,45,28,17,57
Linfield,2285,2,15,8,7,57,33,24,53
Cliftonville,2285,3,15,4,11,52,39,13,49
Coleraine,2285,4,12,12,6,38,28,10,48
Glenavon,2285,5,11,13,6,51,43,8,46
Ballymena,2285,6,12,6,12,55,65,-10,42
Portadown,2285,7,10,7,13,26,34,-8,37
Dungannon,2285,8,8,12,10,45,40,5,36
Glentoran,2285,9,7,10,13,26,41,-15,31
Ards,2285,10,8,5,17,35,53,-18,29
Ballinamalla,2285,11,6,5,19,28,54,-26,23
Linfield,2286,1,14,10,6,61,33,28,52
Cliftonville,2286,2,15,6,9,52,35,17,51
Crusaders,2286,3,14,9,7,48,32,16,51
Ballymena,2286,4,12,10,8,55,57,-2,46
Glenavon,2286,5,9,13,8,41,46,-5,40
Coleraine,2286,6,9,12,9,36,40,-4,39
Dungannon,2286,7,9,10,11,47,43,4,37
Glentoran,2286,8,6,14,10,25,38,-13,32
Portadown,2286,9,8,8,14,34,48,-14,32
Ballinamalla,2286,10,9,5,16,35,51,-16,32
Ards,2286,11,8,7,15,36,47,-11,31
Linfield,2287,1,18,7,5,72,26,46,61
Crusaders,2287,2,17,8,5,53,32,21,59
Cliftonville,2287,3,16,6,8,56,36,20,54
Glenavon,2287,4,11,12,7,46,38,8,45
Coleraine,2287,5,11,8,11,35,39,-4,41
Glentoran,2287,6,10,10,10,30,43,-13,40
Ballymena,2287,7,10,8,12,53,60,-7,38
Dungannon,2287,8,8,8,14,43,46,-3,32
Ballinamalla,2287,9,8,6,16,28,51,-23,30
Portadown,2287,10,7,6,17,22,50,-28,27
Ards,2287,11,5,9,16,32,49,-17,24
Crusaders,2288,1,18,8,4,58,33,25,62
Linfield,2288,2,15,8,7,65,38,27,53
Cliftonville,2288,3,15,6,9,52,36,16,51
Ballymena,2288,4,14,8,8,60,54,6,50
Coleraine,2288,5,12,9,9,37,31,6,45
Glenavon,2288,6,10,10,10,39,42,-3,40
Dungannon,2288,7,9,12,9,45,40,5,39
Glentoran,2288,8,8,10,12,30,40,-10,34
Ards,2288,9,8,5,17,30,49,-19,29
Portadown,2288,10,7,7,16,23,47,-24,28
Ballinamalla,2288,11,4,7,19,28,57,-29,19
Cliftonville,2289,1,19,2,9,56,39,17,59
Crusaders,2289,2,16,8,6,53,36,17,56
Linfield,2289,3,13,9,8,61,39,22,48
Ballymena,2289,4,14,6,10,60,59,1,48
Coleraine,2289,5,12,8,10,44,36,8,44
Glenavon,2289,6,11,11,8,46,43,3,44
Ards,2289,7,11,3,16,39,48,-9,36
Portadown,2289,8,10,6,14,31,41,-10,36
Dungannon,2289,9,9,8,13,50,47,3,35
Glentoran,2289,10,9,7,14,34,51,-17,34
Ballinamalla,2289,11,4,6,20,27,62,-35,18
Crusaders,2290,1,17,8,5,61,37,24,59
Cliftonville,2290,2,18,3,9,58,39,19,57
Coleraine,2290,3,12,9,9,40,37,3,45
Linfield,2290,4,10,14,6,45,27,18,44
Ballymena,2290,5,13,5,12,48,58,-10,44
Glenavon,2290,6,11,9,10,46,51,-5,42
Dungannon,2290,7,9,11,10,51,41,10,38
Ards,2290,8,9,7,14,37,46,-9,34
Glentoran,2290,9,8,8,14,26,40,-14,32
Ballinamalla,2290,10,9,4,17,34,48,-14,31
Portadown,2290,11,7,6,17,25,47,-22,27
Linfield,2291,1,17,8,5,60,26,34,59
Crusaders,2291,2,17,7,6,61,40,21,58
Cliftonville,2291,3,16,4,10,56,38,18,52
Ballymena,2291,4,15,5,10,57,56,1,50
Coleraine,2291,5,11,10,9,45,39,6,43
Glenavon,2291,6,10,10,10,49,56,-7,40
Ards,2291,7,11,5,14,47,48,-1,38
Glentoran,2291,8,8,9,13,29,44,-15,33
Dungannon,2291,9,8,8,14,41,49,-8,32
Ballinamalla,2291,10,9,2,19,29,53,-24,29
Portadown,2291,11,8,2,20,25,50,-25,26
Crusaders,2292,1,17,6,7,52,36,16,57
Linfield,2292,2,15,9,6,65,35,30,54
Glenavon,2292,3,12,10,8,57,40,17,46
Dungannon,2292,4,12,9,9,49,42,7,45
Ballymena,2292,5,13,6,11,62,62,0,45
Coleraine,2292,6,10,13,7,44,35,9,43
Cliftonville,2292,7,13,3,14,43,45,-2,42
Glentoran,2292,8,9,9,12,35,42,-7,36
Ards,2292,9,7,9,14,36,52,-16,30
Ballinamalla,2292,10,9,2,19,28,58,-30,29
Portadown,2292,11,7,6,17,22,46,-24,27
Crusaders,2293,1,16,8,6,55,34,21,56
Ballymena,2293,2,15,8,7,57,49,8,53
Linfield,2293,3,13,11,6,56,34,22,50
Cliftonville,2293,4,15,5,10,54,47,7,50
Coleraine,2293,5,9,15,6,40,37,3,42
Glenavon,2293,6,10,10,10,46,43,3,40
Dungannon,2293,7,8,11,11,46,40,6,35
Glentoran,2293,8,8,10,12,37,50,-13,34
Ballinamalla,2293,9,9,5,16,30,52,-22,32
Ards,2293,10,8,7,15,33,43,-10,31
Portadown,2293,11,6,6,18,24,49,-25,24
Crusaders,2294,1,18,7,5,57,32,25,61
Linfield,2294,2,14,11,5,60,36,24,53
Cliftonville,2294,3,15,7,8,57,36,21,52
Coleraine,2294,4,12,10,8,48,43,5,46
Ballymena,2294,5,14,4,12,61,63,-2,46
Dungannon,2294,6,9,11,10,47,44,3,38
Glentoran,2294,7,10,6,14,30,42,-12,36
Glenavon,2294,8,8,10,12,37,47,-10,34
Ards,2294,9,9,6,15,37,47,-10,33
Ballinamalla,2294,10,9,3,18,31,50,-19,30
Portadown,2294,11,8,3,19,29,54,-25,27
Crusaders,2295,1,20,5,5,62,33,29,65
Linfield,2295,2,17,9,4,61,28,33,60
Cliftonville,2295,3,15,5,10,61,44,17,50
Ballymena,2295,4,14,4,12,56,62,-6,46
Dungannon,2295,5,10,10,10,47,42,5,40
Glenavon,2295,6,9,10,11,43,47,-4,37
Coleraine,2295,7,9,10,11,35,41,-6,37
Portadown,2295,8,9,8,13,32,42,-10,35
Glentoran,2295,9,8,7,15,25,45,-20,31
Ards,2295,10,8,6,16,35,51,-16,30
Ballinamalla,2295,11,6,6,18,28,50,-22,24
Crusaders,2296,1,14,10,6,50,29,21,52
Cliftonville,2296,2,15,5,10,57,39,18,50
Ballymena,2296,3,15,5,10,63,57,6,50
Linfield,2296,4,11,12,7,56,38,18,45
Coleraine,2296,5,11,10,9,46,45,1,43
Ards,2296,6,12,6,12,48,50,-2,42
Dungannon,2296,7,11,8,11,53,47,6,41
Glenavon,2296,8,10,10,10,46,45,1,40
Ballinamalla,2296,9,10,2,18,33,56,-23,32
Glentoran,2296,10,8,7,15,25,50,-25,31
Portadown,2296,11,7,7,16,33,54,-21,28
Linfield,2297,1,15,9,6,61,37,24,54
Glenavon,2297,2,14,10,6,54,43,11,52
Crusaders,2297,3,14,7,9,53,32,21,49
Ballymena,2297,4,13,8,9,61,55,6,47
Coleraine,2297,5,12,10,8,46,41,5,46
Cliftonville,2297,6,12,5,13,49,51,-2,41
Dungannon,2297,7,9,12,9,55,46,9,39
Glentoran,2297,8,8,12,10,32,45,-13,36
Ards,2297,9,9,7,14,39,51,-12,34
Ballinamalla,2297,10,7,5,18,30,56,-26,26
Portadown,2297,11,6,7,17,27,50,-23,25
Crusaders,2298,1,18,6,6,61,34,27,60
Ballymena,2298,2,14,6,10,60,58,2,48
Linfield,2298,3,13,8,9,54,34,20,47
Cliftonville,2298,4,14,5,11,50,40,10,47
Dungannon,2298,5,12,8,10,57,45,12,44
Glenavon,2298,6,11,10,9,52,49,3,43
Coleraine,2298,7,10,12,8,41,42,-1,42
Glentoran,2298,8,10,11,9,35,43,-8,41
Ards,2298,9,9,6,15,34,49,-15,33
Ballinamalla,2298,10,7,4,19,28,52,-24,25
Portadown,2298,11,7,4,19,25,51,-26,25
Linfield,2299,1,16,9,5,65,27,38,57
Crusaders,2299,2,16,9,5,55,32,23,57
Glenavon,2299,3,12,12,6,48,44,4,48
Coleraine,2299,4,12,10,8,41,33,8,46
Cliftonville,2299,5,12,9,9,47,39,8,45
Ballymena,2299,6,12,7,11,45,55,-10,43
Dungannon,2299,7,11,8,11,51,43,8,41
Glentoran,2299,8,9,7,14,28,43,-15,34
Ards,2299,9,9,4,17,40,52,-12,31
Portadown,2299,10,8,5,17,18,44,-26,29
Ballinamalla,2299,11,5,6,19,29,55,-26,21
Cliftonville,2300,1,16,4,10,56,44,12,52
Glenavon,2300,2,14,9,7,61,49,12,51
Crusaders,2300,3,14,9,7,55,43,12,51
Ballymena,2300,4,15,5,10,62,59,3,50
Linfield,2300,5,14,7,9,52,31,21,49
Coleraine,2300,6,10,10,10,39,40,-1,40
Glentoran,2300,7,11,7,12,36,44,-8,40
Dungannon,2300,8,10,9,11,50,44,6,39
Ards,2300,9,10,6,14,36,44,-8,36
Portadown,2300,10,8,3,19,25,53,-28,27
Ballinamalla,2300,11,6,5,19,31,52,-21,23
Linfield,2301,1,15,11,4,63,34,29,56
Crusaders,2301,2,15,7,8,55,41,14,52
Cliftonville,2301,3,16,4,10,53,39,14,52
Ballymena,2301,4,13,4,13,61,64,-3,43
Glenavon,2301,5,10,11,9,41,48,-7,41
Dungannon,2301,6,10,10,10,49,39,10,40
Glentoran,2301,7,9,11,10,41,46,-5,38
Coleraine,2301,8,9,10,11,33,36,-3,37
Ballinamalla,2301,9,10,4,16,32,49,-17,34
Portadown,2301,10,9,4,17,27,46,-19,31
Ards,2301,11,7,8,15,38,51,-13,29
Crusaders,2302,1,17,8,5,57,33,24,59
Ballymena,2302,2,16,6,8,61,54,7,54
Linfield,2302,3,14,10,6,63,35,28,52
Glenavon,2302,4,13,9,8,51,50,1,48
Cliftonville,2302,5,13,5,12,45,43,2,44
Coleraine,2302,6,8,13,9,44,45,-1,37
Glentoran,2302,7,10,6,14,38,47,-9,36
Portadown,2302,8,10,3,17,31,47,-16,33
Dungannon,2302,9,8,8,14,48,48,0,32
Ballinamalla,2302,10,8,7,15,30,46,-16,31
Ards,2302,11,8,5,17,35,55,-20,29
Linfield,2303,1,15,9,6,64,37,27,54
Crusaders,2303,2,15,9,6,51,31,20,54
Cliftonville,2303,3,15,5,10,51,42,9,50
Glenavon,2303,4,13,11,6,46,38,8,50
Ballymena,2303,5,13,8,9,53,56,-3,47
Dungannon,2303,6,10,11,9,50,40,10,41
Coleraine,2303,7,10,9,11,42,41,1,39
Ards,2303,8,9,7,14,46,51,-5,34
Ballinamalla,2303,9,8,5,17,28,51,-23,29
Portadown,2303,10,8,4,18,29,50,-21,28
Glentoran,2303,11,7,6,17,33,56,-23,27
Crusaders,2304,1,16,8,6,52,29,23,56
Linfield,2304,2,15,10,5,63,33,30,55
Cliftonville,2304,3,13,10,7,54,40,14,49
Coleraine,2304,4,13,10,7,52,46,6,49
Ballymena,2304,5,11,9,10,59,56,3,42
Glenavon,2304,6,10,12,8,51,48,3,42
Ards,2304,7,11,8,11,39,43,-4,41
Dungannon,2304,8,8,9,13,46,50,-4,33
Ballinamalla,2304,9,6,9,15,32,56,-24,27
Glentoran,2304,10,6,8,16,30,53,-23,26
Portadown,2304,11,6,7,17,24,48,-24,25
Crusaders,2305,1,19,8,3,64,32,32,65
Linfield,2305,2,13,10,7,53,34,19,49
Ballymena,2305,3,14,4,12,56,55,1,46
Cliftonville,2305,4,14,3,13,58,53,5,45
Glenavon,2305,5,12,8,10,49,49,0,44
Coleraine,2305,6,11,10,9,43,39,4,43
Glentoran,2305,7,11,7,12,37,40,-3,40
Portadown,2305,8,10,4,16,24,47,-23,34
Ballinamalla,2305,9,10,3,17,33,50,-17,33
Dungannon,2305,10,8,7,15,45,48,-3,31
Ards,2305,11,8,6,16,38,53,-15,30
Linfield,2306,1,17,9,4,63,30,33,60
Crusaders,2306,2,15,7,8,47,32,15,52
Ballymena,2306,3,14,6,10,56,55,1,48
Cliftonville,2306,4,13,8,9,50,38,12,47
Dungannon,2306,5,11,11,8,52,41,11,44
Glenavon,2306,6,10,13,7,50,43,7,43
Coleraine,2306,7,10,12,8,44,42,2,42
Glentoran,2306,8,9,8,13,34,50,-16,35
Ballinamalla,2306,9,8,5,17,32,52,-20,29
Portadown,2306,10,6,7,17,26,50,-24,25
Ards,2306,11,6,6,18,33,54,-21,24
Crusaders,2307,1,16,5,9,50,37,13,53
Cliftonville,2307,2,16,4,10,54,41,13,52
Ballymena,2307,3,15,6,9,63,54,9,51
Linfield,2307,4,14,7,9,60,41,19,49
Coleraine,2307,5,13,9,8,46,41,5,48
Dungannon,2307,6,13,7,10,56,38,18,46
Glenavon,2307,7,11,10,9,46,44,2,43
Glentoran,2307,8,12,5,13,41,44,-3,41
Ballinamalla,2307,9,9,5,16,36,55,-19,32
Ards,2307,10,7,5,18,34,58,-24,26
Portadown,2307,11,5,5,20,19,52,-33,20
Cliftonville,2308,1,20,2,8,59,38,21,62
Crusaders,2308,2,15,7,8,53,42,11,52
Linfield,2308,3,13,10,7,55,32,23,49
Coleraine,2308,4,11,12,7,44,37,7,45
Ballymena,2308,5,13,5,12,60,60,0,44
Glenavon,2308,6,11,10,9,49,46,3,43
Glentoran,2308,7,9,10,11,37,45,-8,37
Ballinamalla,2308,8,11,4,15,32,45,-13,37
Ards,2308,9,10,4,16,40,49,-9,34
Dungannon,2308,10,7,9,14,51,57,-6,30
Portadown,2308,11,6,5,19,24,53,-29,23
Crusaders,2309,1,17,8,5,50,30,20,59
Cliftonville,2309,2,17,5,8,56,34,22,56
Linfield,2309,3,16,7,7,60,32,28,55
Ballymena,2309,4,13,10,7,46,51,-5,49
Glenavon,2309,5,10,12,8,44,42,2,42
Coleraine,2309,6,10,11,9,47,44,3,41
Glentoran,2309,7,8,8,14,32,40,-8,32
Ards,2309,8,8,8,14,30,42,-12,32
Dungannon,2309,9,7,10,13,40,46,-6,31
Portadown,2309,10,8,6,16,23,41,-18,30
Ballinamalla,2309,11,6,5,19,25,51,-26,23
Cliftonville,2310,1,19,3,8,63,37,26,60
Ballymena,2310,2,17,6,7,77,67,10,57
Linfield,2310,3,14,9,7,64,35,29,51
Crusaders,2310,4,15,6,9,54,37,17,51
Glenavon,2310,5,12,10,8,58,51,7,46
Coleraine,2310,6,11,12,7,41,35,6,45
Glentoran,2310,7,10,7,13,33,46,-13,37
Dungannon,2310,8,8,12,10,44,40,4,36
Ards,2310,9,7,4,19,32,56,-24,25
Ballinamalla,2310,10,8,1,21,35,65,-30,25
Portadown,2310,11,7,4,19,24,56,-32,25
Crusaders,2311,1,19,7,4,57,34,23,64
Ballymena,2311,2,17,4,9,60,55,5,55
Linfield,2311,3,12,11,7,60,35,25,47
Glenavon,2311,4,12,11,7,48,44,4,47
Cliftonville,2311,5,14,3,13,52,47,5,45
Dungannon,2311,6,12,8,10,55,45,10,44
Coleraine,2311,7,12,8,10,44,38,6,44
Glentoran,2311,8,8,9,13,30,43,-13,33
Ards,2311,9,8,8,14,37,44,-7,32
Portadown,2311,10,7,4,19,26,52,-26,25
Ballinamalla,2311,11,6,3,21,23,55,-32,21
Crusaders,2312,1,17,9,4,65,34,31,60
Cliftonville,2312,2,16,4,10,47,35,12,52
Ballymena,2312,3,14,9,7,57,52,5,51
Linfield,2312,4,13,10,7,58,38,20,49
Glenavon,2312,5,12,9,9,43,44,-1,45
Dungannon,2312,6,12,8,10,51,37,14,44
Coleraine,2312,7,9,11,10,36,38,-2,38
Ards,2312,8,10,4,16,34,46,-12,34
Glentoran,2312,9,7,10,13,27,44,-17,31
Portadown,2312,10,9,4,17,30,48,-18,31
Ballinamalla,2312,11,4,6,20,27,59,-32,18
Crusaders,2313,1,17,7,6,53,37,16,58
Coleraine,2313,2,14,9,7,43,33,10,51
Cliftonville,2313,3,14,6,10,51,39,12,48
Ballymena,2313,4,14,6,10,60,57,3,48
Linfield,2313,5,12,10,8,56,30,26,46
Glentoran,2313,6,13,5,12,31,44,-13,44
Glenavon,2313,7,10,10,10,40,41,-1,40
Ballinamalla,2313,8,10,5,15,28,42,-14,35
Dungannon,2313,9,9,7,14,43,43,0,34
Portadown,2313,10,7,6,17,24,43,-19,27
Ards,2313,11,7,5,18,32,52,-20,26
Crusaders,2314,1,18,6,6,55,33,22,60
Ballymena,2314,2,17,4,9,64,52,12,55
Cliftonville,2314,3,14,6,10,48,43,5,48
Coleraine,2314,4,11,13,6,43,33,10,46
Linfield,2314,5,11,11,8,53,35,18,44
Dungannon,2314,6,11,10,9,53,41,12,43
Glenavon,2314,7,10,12,8,48,49,-1,42
Glentoran,2314,8,12,5,13,30,37,-7,41
Portadown,2314,9,9,7,14,30,45,-15,34
Ards,2314,10,7,5,18,32,53,-21,26
Ballinamalla,2314,11,4,3,23,24,59,-35,15
Crusaders,2315,1,17,8,5,57,34,23,59
Linfield,2315,2,16,9,5,60,30,30,57
Cliftonville,2315,3,16,3,11,56,46,10,51
Ballymena,2315,4,14,4,12,54,52,2,46
Glenavon,2315,5,12,8,10,48,43,5,44
Dungannon,2315,6,12,7,11,50,40,10,43
Coleraine,2315,7,11,9,10,42,47,-5,42
Glentoran,2315,8,10,5,15,28,38,-10,35
Ballinamalla,2315,9,11,2,17,38,57,-19,35
Ards,2315,10,8,4,18,34,52,-18,28
Portadown,2315,11,7,3,20,24,52,-28,24
Linfield,2316,1,16,8,6,60,29,31,56
Crusaders,2316,2,16,7,7,55,36,19,55
Cliftonville,2316,3,15,6,9,51,34,17,51
Coleraine,2316,4,13,10,7,41,32,9,49
Ballymena,2316,5,14,4,12,55,60,-5,46
Glenavon,2316,6,9,13,8,41,46,-5,40
Ards,2316,7,11,5,14,41,47,-6,38
Dungannon,2316,8,9,10,11,44,43,1,37
Glentoran,2316,9,9,5,16,29,48,-19,32
Portadown,2316,10,7,5,18,22,46,-24,26
Ballinamalla,2316,11,6,7,17,34,52,-18,25
Linfield,2317,1,17,8,5,63,24,39,59
Cliftonville,2317,2,18,5,7,62,35,27,59
Crusaders,2317,3,15,10,5,56,36,20,55
Dungannon,2317,4,11,9,10,50,39,11,42
Ballymena,2317,5,11,8,11,40,49,-9,41
Glenavon,2317,6,10,10,10,43,49,-6,40
Ards,2317,7,12,3,15,41,49,-8,39
Glentoran,2317,8,10,7,13,32,42,-10,37
Coleraine,2317,9,8,10,12,37,45,-8,34
Portadown,2317,10,8,4,18,25,55,-30,28
Ballinamalla,2317,11,6,4,20,28,54,-26,22
Crusaders,2318,1,18,7,5,60,31,29,61
Ballymena,2318,2,18,5,7,65,49,16,59
Cliftonville,2318,3,15,6,9,58,38,20,51
Linfield,2318,4,12,10,8,54,32,22,46
Coleraine,2318,5,11,10,9,39,40,-1,43
Dungannon,2318,6,11,7,12,57,46,11,40
Portadown,2318,7,12,4,14,31,41,-10,40
Glenavon,2318,8,10,9,11,43,49,-6,39
Glentoran,2318,9,7,9,14,23,48,-25,30
Ards,2318,10,7,6,17,30,51,-21,27
Ballinamalla,2318,11,5,5,20,23,58,-35,20
Crusaders,2319,1,16,8,6,58,37,21,56
Ballymena,2319,2,14,8,8,59,56,3,50
Linfield,2319,3,13,9,8,58,39,19,48
Cliftonville,2319,4,13,7,10,46,43,3,46
Coleraine,2319,5,12,9,9,41,40,1,45
Glenavon,2319,6,11,10,9,43,41,2,43
Ards,2319,7,12,5,13,45,47,-2,41
Dungannon,2319,8,10,10,10,55,47,8,40
Glentoran,2319,9,8,7,15,31,43,-12,31
Ballinamalla,2319,10,8,4,18,34,53,-19,28
Portadown,2319,11,6,7,17,21,45,-24,25
Crusaders,2320,1,15,9,6,58,40,18,54
Cliftonville,2320,2,15,8,7,57,38,19,53
Coleraine,2320,3,12,12,6,48,35,13,48
Glenavon,2320,4,13,9,8,48,47,1,48
Ballymena,2320,5,13,7,10,60,61,-1,46
Linfield,2320,6,11,12,7,55,34,21,45
Glentoran,2320,7,12,8,10,32,34,-2,44
Dungannon,2320,8,10,8,12,58,52,6,38
Ards,2320,9,8,5,17,35,53,-18,29
Ballinamalla,2320,10,7,5,18,28,56,-28,26
Portadown,2320,11,3,9,18,23,52,-29,18
Crusaders,2321,1,17,8,5,61,34,27,59
Linfield,2321,2,15,10,5,59,33,26,55
Coleraine,2321,3,13,11,6,42,33,9,50
Cliftonville,2321,4,15,4,11,42,37,5,49
Dungannon,2321,5,12,11,7,58,41,17,47
Ballymena,2321,6,13,5,12,52,64,-12,44
Glenavon,2321,7,9,12,9,52,49,3,39
Ballinamalla,2321,8,10,3,17,29,49,-20,33
Ards,2321,9,9,4,17,33,50,-17,31
Glentoran,2321,10,7,6,17,29,47,-18,27
Portadown,2321,11,5,6,19,23,43,-20,21
Linfield,2322,1,17,9,4,68,29,39,60
Cliftonville,2322,2,17,4,9,58,45,13,55
Crusaders,2322,3,14,8,8,52,31,21,50
Ballymena,2322,4,15,5,10,56,54,2,50
Glenavon,2322,5,10,12,8,43,47,-4,42
Dungannon,2322,6,10,9,11,51,46,5,39
Coleraine,2322,7,9,10,11,41,42,-1,37
Ards,2322,8,11,4,15,39,47,-8,37
Glentoran,2322,9,9,8,13,32,44,-12,35
Ballinamalla,2322,10,8,4,18,32,60,-28,28
Portadown,2322,11,5,7,18,23,50,-27,22
Crusaders,2323,1,16,9,5,58,31,27,57
Linfield,2323,2,15,8,7,57,30,27,53
Ballymena,2323,3,16,5,9,61,59,2,53
Cliftonville,2323,4,15,4,11,62,51,11,49
Dungannon,2323,5,13,9,8,54,39,15,48
Coleraine,2323,6,11,8,11,44,46,-2,41
Glenavon,2323,7,10,9,11,51,54,-3,39
Glentoran,2323,8,10,5,15,32,53,-21,35
Ards,2323,9,10,3,17,40,52,-12,33
Portadown,2323,10,9,4,17,27,45,-18,31
Ballinamalla,2323,11,7,2,21,33,59,-26,23
Linfield,2324,1,15,8,7,58,33,25,53
Coleraine,2324,2,15,8,7,54,40,14,53
Cliftonville,2324,3,16,4,10,50,43,7,52
Crusaders,2324,4,15,6,9,49,31,18,51
Ballymena,2324,5,13,7,10,58,59,-1,46
Dungannon,2324,6,12,7,11,52,40,12,43
Ards,2324,7,12,5,13,46,48,-2,41
Glenavon,2324,8,10,10,10,50,57,-7,40
Glentoran,2324,9,8,6,16,33,52,-19,30
Portadown,2324,10,6,7,17,23,46,-23,25
Ballinamalla,2324,11,6,6,18,27,51,-24,24
Crusaders,2325,1,17,6,7,51,30,21,57
Linfield,2325,2,16,7,7,59,30,29,55
Cliftonville,2325,3,16,3,11,51,39,12,51
Ballymena,2325,4,13,6,11,59,62,-3,45
Glenavon,2325,5,11,11,8,39,44,-5,44
Coleraine,2325,6,10,12,8,38,37,1,42
Dungannon,2325,7,11,8,11,54,45,9,41
Ballinamalla,2325,8,8,8,14,29,44,-15,32
Ards,2325,9,9,4,17,40,47,-7,31
Glentoran,2325,10,7,10,13,26,45,-19,31
Portadown,2325,11,6,7,17,26,49,-23,25
Linfield,2326,1,15,9,6,65,28,37,54
Crusaders,2326,2,15,7,8,48,34,14,52
Ballymena,2326,3,15,6,9,60,57,3,51
Cliftonville,2326,4,14,4,12,50,43,7,46
Glenavon,2326,5,12,9,9,50,49,1,45
Coleraine,2326,6,12,8,10,42,41,1,44
Dungannon,2326,7,9,13,8,51,41,10,40
Ards,2326,8,10,7,13,39,42,-3,37
Glentoran,2326,9,9,7,14,25,41,-16,34
Ballinamalla,2326,10,8,3,19,25,49,-24,27
Portadown,2326,11,6,7,17,16,46,-30,25
Crusaders,2327,1,16,10,4,56,29,27,58
Linfield,2327,2,13,11,6,61,39,22,50
Dungannon,2327,3,13,10,7,54,34,20,49
Cliftonville,2327,4,14,5,11,48,45,3,47
Ballymena,2327,5,13,7,10,59,58,1,46
Glenavon,2327,6,10,10,10,47,46,1,40
Portadown,2327,7,10,8,12,33,43,-10,38
Coleraine,2327,8,8,13,9,39,44,-5,37
Ballinamalla,2327,9,8,4,18,37,53,-16,28
Ards,2327,10,7,7,16,35,52,-17,28
Glentoran,2327,11,6,9,15,28,54,-26,27
Linfield,2328,1,15,10,5,61,30,31,55
Crusaders,2328,2,15,7,8,52,32,20,52
Dungannon,2328,3,13,11,6,58,38,20,50
Cliftonville,2328,4,14,5,11,48,45,3,47
Coleraine,2328,5,11,11,8,40,31,9,44
Ballymena,2328,6,12,7,11,54,60,-6,43
Glenavon,2328,7,8,13,9,43,47,-4,37
Portadown,2328,8,10,7,13,29,39,-10,37
Ards,2328,9,8,9,13,37,46,-9,33
Glentoran,2328,10,8,6,16,27,50,-23,30
Ballinamalla,2328,11,6,4,20,22,53,-31,22
Crusaders,2329,1,16,7,7,60,42,18,55
Glenavon,2329,2,14,10,6,59,38,21,52
Linfield,2329,3,13,12,5,53,31,22,51
Cliftonville,2329,4,15,3,12,55,41,14,48
Dungannon,2329,5,13,7,10,52,44,8,46
Ballymena,2329,6,13,5,12,55,63,-8,44
Coleraine,2329,7,7,12,11,34,50,-16,33
Ards,2329,8,9,5,16,38,48,-10,32
Glentoran,2329,9,8,8,14,30,44,-14,32
Ballinamalla,2329,10,9,5,16,32,49,-17,32
Portadown,2329,11,9,4,17,29,47,-18,31
Crusaders,2330,1,16,7,7,50,32,18,55
Linfield,2330,2,14,9,7,56,30,26,51
Coleraine,2330,3,14,9,7,46,34,12,51
Ballymena,2330,4,15,3,12,53,52,1,48
Cliftonville,2330,5,15,2,13,52,46,6,47
Glenavon,2330,6,12,9,9,50,50,0,45
Dungannon,2330,7,11,8,11,46,45,1,41
Ards,2330,8,11,4,15,39,47,-8,37
Ballinamalla,2330,9,11,3,16,38,48,-10,36
Glentoran,2330,10,6,8,16,24,47,-23,26
Portadown,2330,11,7,4,19,30,53,-23,25
Crusaders,2331,1,18,5,7,52,32,20,59
Linfield,2331,2,15,8,7,70,37,33,53
Cliftonville,2331,3,14,5,11,56,42,14,47
Coleraine,2331,4,13,8,9,52,46,6,47
Ballymena,2331,5,12,7,11,56,62,-6,43
Dungannon,2331,6,11,9,10,48,39,9,42
Glenavon,2331,7,10,10,10,45,49,-4,40
Portadown,2331,8,10,6,14,33,45,-12,36
Glentoran,2331,9,9,8,13,36,47,-11,35
Ards,2331,10,10,2,18,34,55,-21,32
Ballinamalla,2331,11,6,6,18,26,54,-28,24
Cliftonville,2332,1,17,5,8,56,37,19,56
Crusaders,2332,2,14,10,6,62,38,24,52
Linfield,2332,3,13,10,7,55,42,13,49
Glenavon,2332,4,12,10,8,49,47,2,46
Dungannon,2332,5,11,10,9,57,46,11,43
Ballymena,2332,6,11,10,9,56,58,-2,43
Coleraine,2332,7,10,11,9,48,43,5,41
Ards,2332,8,10,6,14,41,50,-9,36
Portadown,2332,9,9,4,17,31,49,-18,31
Ballinamalla,2332,10,7,8,15,28,47,-19,29
Glentoran,2332,11,5,8,17,27,53,-26,23
Cliftonville,2333,1,17,7,6,58,33,25,58
Crusaders,2333,2,15,7,8,56,38,18,52
Linfield,2333,3,13,12,5,60,33,27,51
Glenavon,2333,4,13,9,8,48,45,3,48
Coleraine,2333,5,13,7,10,41,44,-3,46
Ballymena,2333,6,13,6,11,66,59,7,45
Dungannon,2333,7,12,7,11,50,41,9,43
Glentoran,2333,8,9,5,16,35,53,-18,32
Portadown,2333,9,9,4,17,28,52,-24,31
Ballinamalla,2333,10,7,6,17,28,49,-21,27
Ards,2333,11,6,6,18,35,58,-23,24
Crusaders,2334,1,20,6,4,67,33,34,66
Linfield,2334,2,17,8,5,59,27,32,59
Cliftonville,2334,3,16,6,8,51,36,15,54
Ballymena,2334,4,16,3,11,58,53,5,51
Coleraine,2334,5,10,12,8,39,37,2,42
Glenavon,2334,6,10,12,8,43,43,0,42
Dungannon,2334,7,10,7,13,49,45,4,37
Glentoran,2334,8,10,6,14,26,42,-16,36
Ballinamalla,2334,9,8,3,19,31,54,-23,27
Ards,2334,10,7,4,19,30,49,-19,25
Portadown,2334,11,6,3,21,20,54,-34,21
Crusaders,2335,1,18,9,3,57,29,28,63
Linfield,2335,2,13,10,7,58,37,21,49
Cliftonville,2335,3,14,6,10,47,36,11,48
Dungannon,2335,4,12,9,9,59,39,20,45
Glenavon,2335,5,11,12,7,47,42,5,45
Ballymena,2335,6,13,6,11,60,57,3,45
Coleraine,2335,7,10,9,11,38,44,-6,39
Glentoran,2335,8,9,8,13,32,44,-12,35
Portadown,2335,9,8,8,14,28,45,-17,32
Ards,2335,10,6,7,17,28,54,-26,25
Ballinamalla,2335,11,7,4,19,23,50,-27,25
Cliftonville,2336,1,15,5,10,52,36,16,50
Crusaders,2336,2,14,8,8,50,37,13,50
Linfield,2336,3,13,10,7,50,28,22,49
Glenavon,2336,4,13,10,7,54,51,3,49
Ballymena,2336,5,14,5,11,66,60,6,47
Coleraine,2336,6,12,10,8,46,40,6,46
Dungannon,2336,7,11,7,12,49,43,6,40
Glentoran,2336,8,10,7,13,32,45,-13,37
Ballinamalla,2336,9,9,5,16,34,54,-20,32
Portadown,2336,10,6,9,15,29,52,-23,27
Ards,2336,11,6,8,16,35,51,-16,26
Crusaders,2337,1,16,9,5,52,29,23,57
Linfield,2337,2,16,8,6,66,28,38,56
Glenavon,2337,3,16,8,6,52,36,16,56
Cliftonville,2337,4,15,9,6,48,32,16,54
Ballymena,2337,5,11,9,10,47,54,-7,42
Coleraine,2337,6,9,10,11,35,46,-11,37
Dungannon,2337,7,9,9,12,43,40,3,36
Ards,2337,8,10,5,15,34,44,-10,35
Glentoran,2337,9,8,6,16,23,41,-18,30
Portadown,2337,10,6,8,16,20,43,-23,26
Ballinamalla,2337,11,5,7,18,23,50,-27,22
Crusaders,2338,1,15,9,6,53,40,13,54
Linfield,2338,2,14,10,6,57,29,28,52
Cliftonville,2338,3,15,6,9,53,38,15,51
Glenavon,2338,4,13,9,8,52,44,8,48
Coleraine,2338,5,13,8,9,49,33,16,47
Ballymena,2338,6,13,5,12,54,63,-9,44
Dungannon,2338,7,11,9,10,52,44,8,42
Ards,2338,8,12,4,14,35,43,-8,40
Glentoran,2338,9,8,8,14,30,45,-15,32
Ballinamalla,2338,10,7,3,20,24,52,-28,24
Portadown,2338,11,5,7,18,25,53,-28,22
Crusaders,2339,1,19,7,4,56,27,29,64
Ballymena,2339,2,16,6,8,66,56,10,54
Linfield,2339,3,13,8,9,60,35,25,47
Cliftonville,2339,4,13,5,12,56,48,8,44
Coleraine,2339,5,9,13,8,43,40,3,40
Dungannon,2339,6,10,8,12,50,47,3,38
Glenavon,2339,7,9,11,10,43,46,-3,38
Glentoran,2339,8,8,9,13,30,43,-13,33
Ballinamalla,2339,9,9,6,15,29,50,-21,33
Ards,2339,10,9,5,16,34,53,-19,32
Portadown,2339,11,9,4,17,24,46,-22,31
Crusaders,2340,1,17,8,5,54,28,26,59
Cliftonville,2340,2,14,6,10,48,43,5,48
Ballymena,2340,3,15,3,12,63,65,-2,48
Linfield,2340,4,11,12,7,53,34,19,45
Coleraine,2340,5,10,10,10,40,39,1,40
Ards,2340,6,12,4,14,38,47,-9,40
Glenavon,2340,7,10,9,11,46,49,-3,39
Glentoran,2340,8,11,5,14,34,42,-8,38
Ballinamalla,2340,9,11,4,15,35,44,-9,37
Dungannon,2340,10,8,12,10,49,45,4,36
Portadown,2340,11,6,7,17,28,52,-24,25
Linfield,2341,1,15,10,5,65,38,27,55
Crusaders,2341,2,16,6,8,59,38,21,54
Glenavon,2341,3,13,9,8,54,44,10,48
Cliftonville,2341,4,14,5,11,54,43,11,47
Coleraine,2341,5,11,7,12,43,46,-3,40
Ballymena,2341,6,11,7,12,58,74,-16,40
Portadown,2341,7,12,3,15,36,51,-15,39
Ards,2341,8,10,8,12,43,46,-3,38
Glentoran,2341,9,9,9,12,41,51,-10,36
Dungannon,2341,10,9,8,13,53,49,4,35
Ballinamalla,2341,11,6,6,18,25,51,-26,24
Cliftonville,2342,1,18,5,7,58,33,25,59
Ballymena,2342,2,18,4,8,64,52,12,58
Crusaders,2342,3,15,10,5,55,33,22,55
Linfield,2342,4,14,8,8,53,33,20,50
Glenavon,2342,5,12,10,8,54,43,11,46
Coleraine,2342,6,10,12,8,42,43,-1,42
Dungannon,2342,7,10,7,13,47,48,-1,37
Glentoran,2342,8,9,7,14,25,42,-17,34
Ballinamalla,2342,9,9,3,18,33,55,-22,30
Portadown,2342,10,6,7,17,21,47,-26,25
Ards,2342,11,6,3,21,34,57,-23,21
Crusaders,2343,1,16,8,6,66,32,34,56
Ballymena,2343,2,16,6,8,61,54,7,54
Linfield,2343,3,14,11,5,58,35,23,53
Cliftonville,2343,4,15,8,7,55,38,17,53
Coleraine,2343,5,10,12,8,39,40,-1,42
Glenavon,2343,6,9,11,10,44,47,-3,38
Portadown,2343,7,10,5,15,29,47,-18,35
Ards,2343,8,8,8,14,34,46,-12,32
Dungannon,2343,9,6,11,13,46,49,-3,29
Glentoran,2343,10,6,10,14,25,47,-22,28
Ballinamalla,2343,11,7,6,17,30,52,-22,27
Crusaders,2344,1,16,7,7,61,36,25,55
Linfield,2344,2,15,8,7,60,32,28,53
Cliftonville,2344,3,14,7,9,51,36,15,49
Glenavon,2344,4,12,13,5,56,43,13,49
Ballymena,2344,5,15,4,11,59,61,-2,49
Coleraine,2344,6,11,12,7,44,39,5,45
Glentoran,2344,7,11,9,10,35,40,-5,42
Dungannon,2344,8,9,10,11,46,43,3,37
Ards,2344,9,7,6,17,34,49,-15,27
Portadown,2344,10,7,4,19,20,52,-32,25
Ballinamalla,2344,11,6,4,20,24,59,-35,22
Crusaders,2345,1,17,8,5,61,37,24,59
Linfield,2345,2,15,9,6,65,29,36,54
Cliftonville,2345,3,14,7,9,47,42,5,49
Coleraine,2345,4,11,11,8,41,37,4,44
Ballymena,2345,5,12,7,11,56,58,-2,43
Glenavon,2345,6,11,8,11,44,46,-2,41
Dungannon,2345,7,10,10,10,48,39,9,40
Ards,2345,8,9,6,15,29,41,-12,33
Ballinamalla,2345,9,10,3,17,36,56,-20,33
Glentoran,2345,10,8,8,14,31,47,-16,32
Portadown,2345,11,6,7,17,21,47,-26,25
Crusaders,2346,1,17,10,3,60,32,28,61
Linfield,2346,2,13,12,5,60,34,26,51
Coleraine,2346,3,13,12,5,48,34,14,51
Ballymena,2346,4,15,5,10,62,58,4,50
Cliftonville,2346,5,15,3,12,51,42,9,48
Glenavon,2346,6,10,10,10,51,55,-4,40
Dungannon,2346,7,9,10,11,46,46,0,37
Glentoran,2346,8,8,8,14,29,40,-11,32
Ards,2346,9,8,6,16,35,53,-18,30
Ballinamalla,2346,10,8,4,18,33,56,-23,28
Portadown,2346,11,5,8,17,24,49,-25,23
Crusaders,2347,1,17,7,6,62,34,28,58
Cliftonville,2347,2,18,2,10,50,38,12,56
Linfield,2347,3,14,7,9,54,35,19,49
Coleraine,2347,4,13,10,7,41,33,8,49
Dungannon,2347,5,12,9,9,51,41,10,45
Ballymena,2347,6,12,7,11,50,49,1,43
Glenavon,2347,7,10,10,10,45,46,-1,40
Glentoran,2347,8,11,7,12,33,42,-9,40
Portadown,2347,9,9,4,17,27,52,-25,31
Ards,2347,10,6,6,18,36,53,-17,24
Ballinamalla,2347,11,6,5,19,25,51,-26,23
Cliftonville,2348,1,18,4,8,58,36,22,58
Linfield,2348,2,14,10,6,59,28,31,52
Crusaders,2348,3,14,6,10,48,43,5,48
Glenavon,2348,4,12,8,10,44,44,0,44
Dungannon,2348,5,11,9,10,60,48,12,42
Coleraine,2348,6,11,9,10,40,35,5,42
Ballymena,2348,7,12,5,13,54,64,-10,41
Glentoran,2348,8,10,9,11,33,40,-7,39
Portadown,2348,9,11,5,14,30,47,-17,38
Ballinamalla,2348,10,9,2,19,35,56,-21,29
Ards,2348,11,6,7,17,36,56,-20,25
Crusaders,2349,1,15,9,6,53,30,23,54
Cliftonville,2349,2,16,5,9,47,35,12,53
Linfield,2349,3,14,10,6,57,31,26,52
Coleraine,2349,4,11,12,7,42,36,6,45
Ballymena,2349,5,11,9,10,54,63,-9,42
Glenavon,2349,6,11,8,11,46,42,4,41
Dungannon,2349,7,9,11,10,42,38,4,38
Glentoran,2349,8,9,11,10,27,36,-9,38
Portadown,2349,9,8,8,14,31,44,-13,32
Ards,2349,10,8,6,16,36,49,-13,30
Ballinamalla,2349,11,6,5,19,27,58,-31,23
Crusaders,2350,1,20,5,5,57,30,27,65
Cliftonville,2350,2,17,5,8,62,38,24,56
Linfield,2350,3,15,8,7,61,37,24,53
Ballymena,2350,4,14,7,9,59,57,2,49
Coleraine,2350,5,12,11,7,50,41,9,47
Glenavon,2350,6,10,10,10,42,46,-4,40
Glentoran,2350,7,10,7,13,37,48,-11,37
Dungannon,2350,8,7,12,11,42,44,-2,33
Ards,2350,9,7,6,17,37,57,-20,27
Ballinamalla,2350,10,8,3,19,31,53,-22,27
Portadown,2350,11,4,8,18,28,55,-27,20
Crusaders,2351,1,16,11,3,59,31,28,59
Glenavon,2351,2,15,8,7,51,41,10,53
Cliftonville,2351,3,14,8,8,51,39,12,50
Dungannon,2351,4,12,9,9,53,38,15,45
Glentoran,2351,5,13,6,11,28,35,-7,45
Linfield,2351,6,12,7,11,58,35,23,43
Ballymena,2351,7,12,7,11,49,59,-10,43
Coleraine,2351,8,9,11,10,37,41,-4,38
Ards,2351,9,10,7,13,45,48,-3,37
Ballinamalla,2351,10,5,6,19,21,49,-28,21
Portadown,2351,11,4,6,20,23,59,-36,18
Linfield,2352,1,16,9,5,63,24,39,57
Cliftonville,2352,2,17,5,8,52,30,22,56
Ballymena,2352,3,17,5,8,65,59,6,56
Crusaders,2352,4,14,10,6,51,36,15,52
Glenavon,2352,5,12,10,8,46,44,2,46
Dungannon,2352,6,9,9,12,54,50,4,36
Coleraine,2352,7,7,12,11,41,54,-13,33
Ards,2352,8,9,5,16,43,53,-10,32
Glentoran,2352,9,7,9,14,31,50,-19,30
Ballinamalla,2352,10,7,9,14,28,49,-21,30
Portadown,2352,11,4,9,17,21,46,-25,21
Crusaders,2353,1,16,8,6,58,34,24,56
Cliftonville,2353,2,15,6,9,57,45,12,51
Linfield,2353,3,14,8,8,60,34,26,50
Coleraine,2353,4,12,10,8,46,38,8,46
Ballymena,2353,5,12,7,11,59,56,3,43
Glentoran,2353,6,11,6,13,30,42,-12,39
Glenavon,2353,7,9,11,10,45,48,-3,38
Ards,2353,8,10,6,14,44,54,-10,36
Dungannon,2353,9,8,9,13,52,54,-2,33
Ballinamalla,2353,10,9,5,16,37,59,-22,32
Portadown,2353,11,9,4,17,22,46,-24,31
Crusaders,2354,1,19,6,5,62,26,36,63
Linfield,2354,2,14,9,7,56,28,28,51
Glenavon,2354,3,13,11,6,47,39,8,50
Cliftonville,2354,4,14,4,12,44,40,4,46
Dungannon,2354,5,12,8,10,47,38,9,44
Coleraine,2354,6,11,11,8,44,40,4,44
Ballymena,2354,7,11,10,9,52,54,-2,43
Ards,2354,8,9,6,15,36,46,-10,33
Glentoran,2354,9,7,10,13,25,42,-17,31
Ballinamalla,2354,10,6,6,18,17,50,-33,24
Portadown,2354,11,4,9,17,15,42,-27,21
Crusaders,2355,1,16,8,6,52,29,23,56
Linfield,2355,2,14,11,5,57,35,22,53
Cliftonville,2355,3,15,3,12,56,42,14,48
Ballymena,2355,4,14,6,10,57,54,3,48
Glenavon,2355,5,11,8,11,43,45,-2,41
Coleraine,2355,6,10,10,10,35,36,-1,40
Portadown,2355,7,11,4,15,33,48,-15,37
Dungannon,2355,8,9,9,12,48,45,3,36
Glentoran,2355,9,9,7,14,34,50,-16,34
Ards,2355,10,8,9,13,36,45,-9,33
Ballinamalla,2355,11,8,5,17,30,52,-22,29
Crusaders,2356,1,20,7,3,61,27,34,67
Linfield,2356,2,14,9,7,61,35,26,51
Dungannon,2356,3,15,6,9,54,41,13,51
Cliftonville,2356,4,15,5,10,46,40,6,50
Ballymena,2356,5,13,6,11,64,63,1,45
Coleraine,2356,6,9,11,10,36,35,1,38
Glenavon,2356,7,8,11,11,34,41,-7,35
Glentoran,2356,8,10,5,15,34,47,-13,35
Ards,2356,9,9,5,16,36,47,-11,32
Ballinamalla,2356,10,7,7,16,24,46,-22,28
Portadown,2356,11,6,6,18,22,50,-28,24
Crusaders,2357,1,15,9,6,53,32,21,54
Coleraine,2357,2,15,9,6,49,31,18,54
Linfield,2357,3,14,8,8,57,32,25,50
Ballymena,2357,4,13,6,11,55,59,-4,45
Cliftonville,2357,5,12,8,10,48,42,6,44
Glenavon,2357,6,10,10,10,50,54,-4,40
Ballinamalla,2357,7,12,4,14,40,46,-6,40
Dungannon,2357,8,9,12,9,57,49,8,39
Glentoran,2357,9,10,4,16,27,45,-18,34
Portadown,2357,10,9,5,16,27,46,-19,32
Ards,2357,11,7,3,20,31,58,-27,24
Cliftonville,2358,1,18,4,8,56,37,19,58
Linfield,2358,2,16,7,7,62,36,26,55
Crusaders,2358,3,15,7,8,48,35,13,52
Coleraine,2358,4,10,14,6,44,37,7,44
Glenavon,2358,5,10,12,8,46,43,3,42
Glentoran,2358,6,10,8,12,39,46,-7,38
Ballymena,2358,7,10,7,13,56,69,-13,37
Dungannon,2358,8,8,12,10,54,49,5,36
Portadown,2358,9,9,6,15,28,42,-14,33
Ards,2358,10,9,4,17,36,50,-14,31
Ballinamalla,2358,11,5,9,16,27,52,-25,24
Crusaders,2359,1,19,6,5,66,33,33,63
Ballymena,2359,2,16,5,9,69,60,9,53
Linfield,2359,3,14,10,6,57,29,28,52
Cliftonville,2359,4,15,7,8,57,44,13,52
Dungannon,2359,5,10,11,9,49,40,9,41
Glenavon,2359,6,10,9,11,41,45,-4,39
Coleraine,2359,7,8,13,9,43,49,-6,37
Ards,2359,8,8,8,14,39,50,-11,32
Portadown,2359,9,9,4,17,29,50,-21,31
Glentoran,2359,10,6,8,16,27,48,-21,26
Ballinamalla,2359,11,7,5,18,27,56,-29,26
Crusaders,2360,1,15,8,7,55,38,17,53
Linfield,2360,2,14,9,7,58,38,20,51
Cliftonville,2360,3,14,8,8,55,40,15,50
Dungannon,2360,4,12,9,9,53,39,14,45
Ballymena,2360,5,10,11,9,51,53,-2,41
Glenavon,2360,6,8,14,8,44,49,-5,38
Coleraine,2360,7,8,14,8,41,46,-5,38
Ards,2360,8,10,7,13,47,50,-3,37
Glentoran,2360,9,8,8,14,34,47,-13,32
Ballinamalla,2360,10,9,5,16,32,49,-17,32
Portadown,2360,11,7,7,16,31,52,-21,28
Crusaders,2361,1,15,7,8,53,33,20,52
Cliftonville,2361,2,15,5,10,54,41,13,50
Coleraine,2361,3,13,9,8,42,34,8,48
Linfield,2361,4,12,9,9,55,37,18,45
Ballymena,2361,5,12,5,13,50,62,-12,41
Glenavon,2361,6,10,10,10,48,46,2,40
Portadown,2361,7,11,5,14,26,38,-12,38
Glentoran,2361,8,10,8,12,32,47,-15,38
Ards,2361,9,11,4,15,40,45,-5,37
Dungannon,2361,10,9,9,12,48,46,2,36
Ballinamalla,2361,11,10,3,17,29,48,-19,33
Crusaders,2362,1,15,11,4,58,35,23,56
Cliftonville,2362,2,14,6,10,51,41,10,48
Linfield,2362,3,12,9,9,52,32,20,45
Ballymena,2362,4,12,9,9,58,60,-2,45
Glenavon,2362,5,11,11,8,48,47,1,44
Ards,2362,6,13,4,13,40,42,-2,43
Dungannon,2362,7,10,12,8,51,43,8,42
Coleraine,2362,8,10,11,9,40,38,2,41
Glentoran,2362,9,8,7,15,27,43,-16,31
Ballinamalla,2362,10,9,3,18,30,51,-21,30
Portadown,2362,11,7,5,18,29,52,-23,26
Crusaders,2363,1,16,8,6,57,35,22,56
Cliftonville,2363,2,16,3,11,50,37,13,51
Linfield,2363,3,14,8,8,51,34,17,50
Coleraine,2363,4,13,9,8,37,32,5,48
Ballymena,2363,5,12,8,10,55,54,1,44
Glenavon,2363,6,11,10,9,43,40,3,43
Dungannon,2363,7,9,9,12,42,43,-1,36
Ballinamalla,2363,8,10,5,15,28,42,-14,35
Ards,2363,9,9,5,16,39,47,-8,32
Glentoran,2363,10,8,8,14,25,40,-15,32
Portadown,2363,11,8,5,17,23,46,-23,29
Crusaders,2364,1,17,6,7,50,31,19,57
Linfield,2364,2,15,11,4,62,26,36,56
Glenavon,2364,3,13,11,6,48,40,8,50
Cliftonville,2364,4,14,4,12,49,50,-1,46
Dungannon,2364,5,11,11,8,57,42,15,44
Coleraine,2364,6,11,11,8,38,36,2,44
Ballymena,2364,7,13,4,13,51,53,-2,43
Ards,2364,8,9,7,14,37,43,-6,34
Glentoran,2364,9,7,10,13,26,39,-13,31
Portadown,2364,10,7,6,17,24,49,-25,27
Ballinamalla,2364,11,5,5,20,28,61,-33,20
Linfield,2365,1,16,8,6,64,33,31,56
Cliftonville,2365,2,16,4,10,51,38,13,52
Crusaders,2365,3,14,7,9,50,40,10,49
Ballymena,2365,4,14,6,10,68,59,9,48
Coleraine,2365,5,12,11,7,51,39,12,47
Glenavon,2365,6,10,12,8,48,44,4,42
Ballinamalla,2365,7,12,4,14,38,51,-13,40
Dungannon,2365,8,9,9,12,44,49,-5,36
Glentoran,2365,9,9,7,14,32,46,-14,34
Ards,2365,10,8,3,19,34,56,-22,27
Portadown,2365,11,7,5,18,27,52,-25,26
Cliftonville,2366,1,19,3,8,49,35,14,60
Crusaders,2366,2,18,5,7,70,41,29,59
Linfield,2366,3,13,8,9,56,37,19,47
Coleraine,2366,4,11,10,9,48,39,9,43
Glenavon,2366,5,11,10,9,52,48,4,43
Ballymena,2366,6,12,7,11,54,61,-7,43
Dungannon,2366,7,10,8,12,47,50,-3,38
Glentoran,2366,8,9,10,11,35,43,-8,37
Ards,2366,9,7,7,16,34,51,-17,28
Portadown,2366,10,7,7,16,30,47,-17,28
Ballinamalla,2366,11,7,7,16,29,52,-23,28
Crusaders,2367,1,18,7,5,54,27,27,61
Cliftonville,2367,2,16,4,10,51,33,18,52
Linfield,2367,3,14,9,7,54,33,21,51
Ballymena,2367,4,13,8,9,58,56,2,47
Dungannon,2367,5,12,9,9,53,40,13,45
Coleraine,2367,6,11,9,10,35,34,1,42
Glenavon,2367,7,9,11,10,46,52,-6,38
Glentoran,2367,8,10,7,13,30,39,-9,37
Ballinamalla,2367,9,10,4,16,34,55,-21,34
Portadown,2367,10,6,8,16,26,48,-22,26
Ards,2367,11,7,2,21,30,54,-24,23
Cliftonville,2368,1,18,6,6,60,39,21,60
Crusaders,2368,2,17,8,5,55,35,20,59
Linfield,2368,3,16,9,5,60,30,30,57
Ballymena,2368,4,13,8,9,57,55,2,47
Glenavon,2368,5,10,13,7,41,37,4,43
Dungannon,2368,6,8,12,10,56,56,0,36
Coleraine,2368,7,8,10,12,36,40,-4,34
Glentoran,2368,8,8,7,15,32,49,-17,31
Ballinamalla,2368,9,8,5,17,38,60,-22,29
Ards,2368,10,6,9,15,37,52,-15,27
Portadown,2368,11,7,5,18,34,53,-19,26
Crusaders,2369,1,17,10,3,61,32,29,61
Cliftonville,2369,2,15,7,8,57,37,20,52
Ballymena,2369,3,15,5,10,64,56,8,50
Coleraine,2369,4,11,10,9,40,41,-1,43
Linfield,2369,5,10,9,11,53,42,11,39
Glenavon,2369,6,9,11,10,43,49,-6,38
Ards,2369,7,10,7,13,36,47,-11,37
Glentoran,2369,8,9,8,13,29,44,-15,35
Dungannon,2369,9,9,7,14,54,46,8,34
Ballinamalla,2369,10,9,5,16,31,52,-21,32
Portadown,2369,11,7,9,14,26,48,-22,30
Cliftonville,2370,1,17,7,6,59,36,23,58
Crusaders,2370,2,16,9,5,58,37,21,57
Linfield,2370,3,13,10,7,58,37,21,49
Coleraine,2370,4,12,9,9,42,40,2,45
Glenavon,2370,5,11,11,8,45,40,5,44
Ballymena,2370,6,10,10,10,50,55,-5,40
Dungannon,2370,7,10,8,12,54,46,8,38
Glentoran,2370,8,8,10,12,28,42,-14,34
Ards,2370,9,9,5,16,44,52,-8,32
Portadown,2370,10,7,7,16,26,47,-21,28
Ballinamalla,2370,11,7,4,19,29,61,-32,25
Crusaders,2371,1,17,7,6,56,36,20,58
Linfield,2371,2,16,7,7,64,36,28,55
Glenavon,2371,3,14,10,6,51,41,10,52
Cliftonville,2371,4,15,4,11,55,45,10,49
Ballymena,2371,5,14,5,11,56,57,-1,47
Dungannon,2371,6,9,10,11,55,45,10,37
Ards,2371,7,11,4,15,41,47,-6,37
Coleraine,2371,8,8,11,11,36,45,-9,35
Portadown,2371,9,10,5,15,28,44,-16,35
Glentoran,2371,10,7,7,16,29,51,-22,28
Ballinamalla,2371,11,5,8,17,31,55,-24,23
Crusaders,2372,1,16,10,4,58,34,24,58
Cliftonville,2372,2,16,5,9,52,38,14,53
Linfield,2372,3,14,9,7,59,32,27,51
Ballymena,2372,4,14,7,9,61,57,4,49
Glenavon,2372,5,13,10,7,42,41,1,49
Coleraine,2372,6,12,11,7,43,37,6,47
Dungannon,2372,7,7,11,12,47,49,-2,32
Ballinamalla,2372,8,8,8,14,31,48,-17,32
Glentoran,2372,9,6,12,12,35,45,-10,30
Ards,2372,10,7,4,19,34,56,-22,25
Portadown,2372,11,5,7,18,31,56,-25,22
Crusaders,2373,1,16,8,6,57,35,22,56
Linfield,2373,2,15,9,6,61,30,31,54
Cliftonville,2373,3,16,4,10,47,37,10,52
Coleraine,2373,4,11,11,8,46,37,9,44
Ballymena,2373,5,12,8,10,51,55,-4,44
Dungannon,2373,6,11,9,10,52,45,7,42
Glenavon,2373,7,9,13,8,50,48,2,40
Portadown,2373,8,9,7,14,30,44,-14,34
Glentoran,2373,9,8,9,13,36,48,-12,33
Ards,2373,10,9,3,18,34,55,-21,30
Ballinamalla,2373,11,6,5,19,29,59,-30,23
Cliftonville,2374,1,18,3,9,58,40,18,57
Crusaders,2374,2,14,11,5,51,32,19,53
Coleraine,2374,3,14,7,9,50,39,11,49
Linfield,2374,4,12,11,7,60,38,22,47
Ballymena,2374,5,14,4,12,61,65,-4,46
Glenavon,2374,6,11,11,8,46,43,3,44
Dungannon,2374,7,9,12,9,51,43,8,39
Ards,2374,8,10,9,11,47,49,-2,39
Glentoran,2374,9,7,10,13,32,47,-15,31
Ballinamalla,2374,10,6,6,18,28,56,-28,24
Portadown,2374,11,5,6,19,20,52,-32,21
Crusaders,2375,1,19,7,4,67,34,33,64
Ballymena,2375,2,17,4,9,58,52,6,55
Cliftonville,2375,3,15,6,9,50,37,13,51
Coleraine,2375,4,13,10,7,42,35,7,49
Linfield,2375,5,12,10,8,56,33,23,46
Glentoran,2375,6,11,4,15,32,45,-13,37
Glenavon,2375,7,9,9,12,43,49,-6,36
Dungannon,2375,8,8,11,11,53,49,4,35
Ards,2375,9,10,4,16,37,52,-15,34
Portadown,2375,10,7,5,18,25,52,-27,26
Ballinamalla,2375,11,7,4,19,27,52,-25,25
Crusaders,2376,1,16,7,7,55,40,15,55
Cliftonville,2376,2,16,6,8,54,34,20,54
Glenavon,2376,3,11,14,5,51,41,10,47
Coleraine,2376,4,12,10,8,44,34,10,46
Ballymena,2376,5,11,10,9,54,56,-2,43
Linfield,2376,6,10,12,8,54,39,15,42
Glentoran,2376,7,10,6,14,33,42,-9,36
Ards,2376,8,10,6,14,39,49,-10,36
Dungannon,2376,9,9,8,13,42,44,-2,35
Portadown,2376,10,8,8,14,31,48,-17,32
Ballinamalla,2376,11,5,7,18,24,54,-30,22
Linfield,2377,1,14,9,7,55,30,25,51
Crusaders,2377,2,13,11,6,57,45,12,50
Dungannon,2377,3,13,8,9,51,37,14,47
Ballymena,2377,4,13,8,9,54,53,1,47
Cliftonville,2377,5,13,7,10,49,39,10,46
Coleraine,2377,6,13,7,10,45,43,2,46
Glenavon,2377,7,10,13,7,46,44,2,43
Glentoran,2377,8,10,9,11,33,39,-6,39
Portadown,2377,9,7,8,15,29,46,-17,29
Ballinamalla,2377,10,7,5,18,26,50,-24,26
Ards,2377,11,6,7,17,34,53,-19,25
Cliftonville,2378,1,17,7,6,61,38,23,58
Crusaders,2378,2,12,8,10,49,40,9,44
Linfield,2378,3,10,13,7,56,41,15,43
Glenavon,2378,4,10,13,7,44,46,-2,43
Ballymena,2378,5,11,10,9,50,54,-4,43
Dungannon,2378,6,10,12,8,48,37,11,42
Coleraine,2378,7,11,9,10,46,43,3,42
Glentoran,2378,8,11,8,11,35,40,-5,41
Ards,2378,9,11,4,15,37,45,-8,37
Ballinamalla,2378,10,8,5,17,30,51,-21,29
Portadown,2378,11,7,5,18,23,44,-21,26
Linfield,2379,1,16,9,5,60,35,25,57
Crusaders,2379,2,15,9,6,60,41,19,54
Ballymena,2379,3,16,6,8,66,54,12,54
Glenavon,2379,4,14,8,8,55,43,12,50
Cliftonville,2379,5,14,7,9,56,45,11,49
Coleraine,2379,6,9,11,10,39,40,-1,38
Dungannon,2379,7,9,8,13,51,45,6,35
Ballinamalla,2379,8,9,5,16,34,50,-16,32
Ards,2379,9,8,6,16,44,59,-15,30
Portadown,2379,10,7,7,16,24,47,-23,28
Glentoran,2379,11,7,6,17,24,54,-30,27
Crusaders,2380,1,17,8,5,51,33,18,59
Cliftonville,2380,2,16,5,9,56,36,20,53
Linfield,2380,3,14,10,6,56,30,26,52
Coleraine,2380,4,14,8,8,47,36,11,50
Glenavon,2380,5,12,10,8,50,44,6,46
Ballymena,2380,6,12,5,13,55,63,-8,41
Dungannon,2380,7,9,13,8,53,42,11,40
Glentoran,2380,8,7,10,13,27,45,-18,31
Ballinamalla,2380,9,8,5,17,29,52,-23,29
Ards,2380,10,7,5,18,34,57,-23,26
Portadown,2380,11,5,9,16,25,45,-20,24
Crusaders,2381,1,18,7,5,54,26,28,61
Coleraine,2381,2,14,11,5,50,36,14,53
Linfield,2381,3,13,10,7,67,36,31,49
Ballymena,2381,4,15,4,11,61,57,4,49
Dungannon,2381,5,12,9,9,55,40,15,45
Glenavon,2381,6,11,11,8,50,43,7,44
Cliftonville,2381,7,13,5,12,49,50,-1,44
Glentoran,2381,8,8,8,14,30,48,-18,32
Portadown,2381,9,8,6,16,24,45,-21,30
Ards,2381,10,6,7,17,39,59,-20,25
Ballinamalla,2381,11,6,4,20,24,63,-39,22
Crusaders,2382,1,17,9,4,54,28,26,60
Cliftonville,2382,2,17,4,9,52,31,21,55
Linfield,2382,3,15,8,7,65,37,28,53
Ballymena,2382,4,13,9,8,57,59,-2,48
Coleraine,2382,5,12,8,10,38,41,-3,44
Dungannon,2382,6,10,9,11,50,39,11,39
Glentoran,2382,7,9,12,9,33,42,-9,39
Glenavon,2382,8,8,11,11,37,46,-9,35
Ards,2382,9,7,7,16,30,45,-15,28
Portadown,2382,10,7,7,16,29,49,-20,28
Ballinamalla,2382,11,5,6,19,24,52,-28,21
Cliftonville,2383,1,18,3,9,58,30,28,57
Crusaders,2383,2,17,4,9,51,39,12,55
Linfield,2383,3,14,11,5,63,33,30,53
Ballymena,2383,4,14,6,10,61,61,0,48
Glenavon,2383,5,11,11,8,48,43,5,44
Dungannon,2383,6,11,9,10,48,40,8,42
Coleraine,2383,7,10,11,9,47,45,2,41
Glentoran,2383,8,9,9,12,29,39,-10,36
Ards,2383,9,8,6,16,34,51,-17,30
Portadown,2383,10,7,4,19,25,51,-26,25
Ballinamalla,2383,11,7,4,19,28,60,-32,25
Crusaders,2384,1,17,9,4,60,33,27,60
Linfield,2384,2,16,9,5,64,37,27,57
Cliftonville,2384,3,13,5,12,53,49,4,44
Ballymena,2384,4,13,5,12,61,67,-6,44
Dungannon,2384,5,11,10,9,52,43,9,43
Glenavon,2384,6,10,12,8,47,41,6,42
Coleraine,2384,7,9,11,10,37,42,-5,38
Glentoran,2384,8,9,8,13,35,45,-10,35
Ards,2384,9,9,7,14,40,54,-14,34
Ballinamalla,2384,10,9,3,18,36,53,-17,30
Portadown,2384,11,6,7,17,22,43,-21,25
Linfield,2385,1,14,9,7,55,32,23,51
Ballymena,2385,2,14,7,9,60,64,-4,49
Crusaders,2385,3,13,7,10,49,38,11,46
Dungannon,2385,4,11,10,9,51,37,14,43
Coleraine,2385,5,12,7,11,46,45,1,43
Cliftonville,2385,6,13,3,14,54,45,9,42
Glenavon,2385,7,11,9,10,44,46,-2,42
Glentoran,2385,8,10,10,10,37,41,-4,40
Ards,2385,9,11,6,13,42,49,-7,39
Portadown,2385,10,10,4,16,25,45,-20,34
Ballinamalla,2385,11,8,4,18,31,52,-21,28
Ballymena,2386,1,15,6,9,61,55,6,51
Cliftonville,2386,2,15,5,10,52,44,8,50
Glenavon,2386,3,14,7,9,57,46,11,49
Crusaders,2386,4,13,9,8,48,37,11,48
Dungannon,2386,5,13,8,9,56,42,14,47
Linfield,2386,6,12,9,9,59,39,20,45
Ards,2386,7,13,4,13,42,46,-4,43
Coleraine,2386,8,11,8,11,44,48,-4,41
Ballinamalla,2386,9,9,5,16,37,47,-10,32
Glentoran,2386,10,8,7,15,31,48,-17,31
Portadown,2386,11,6,4,20,19,54,-35,22
Linfield,2387,1,19,7,4,62,23,39,64
Crusaders,2387,2,15,8,7,59,41,18,53
Ballymena,2387,3,14,6,10,53,56,-3,48
Coleraine,2387,4,12,9,9,49,39,10,45
Glenavon,2387,5,11,12,7,46,41,5,45
Cliftonville,2387,6,12,7,11,52,45,7,43
Dungannon,2387,7,9,10,11,40,36,4,37
Ards,2387,8,9,5,16,35,49,-14,32
Ballinamalla,2387,9,8,6,16,35,55,-20,30
Portadown,2387,10,6,10,14,24,46,-22,28
Glentoran,2387,11,6,8,16,35,59,-24,26
Crusaders,2388,1,17,8,5,59,33,26,59
Cliftonville,2388,2,18,4,8,61,34,27,58
Linfield,2388,3,12,12,6,52,34,18,48
Ballymena,2388,4,13,8,9,65,59,6,47
Coleraine,2388,5,12,10,8,43,43,0,46
Glentoran,2388,6,10,8,12,39,49,-10,38
Ards,2388,7,10,7,13,35,44,-9,37
Dungannon,2388,8,9,9,12,48,45,3,36
Glenavon,2388,9,9,7,14,47,52,-5,34
Portadown,2388,10,6,8,16,26,53,-27,26
Ballinamalla,2388,11,6,5,19,24,53,-29,23
Crusaders,2389,1,17,7,6,55,32,23,58
Linfield,2389,2,12,12,6,56,35,21,48
Ballymena,2389,3,13,8,9,53,53,0,47
Cliftonville,2389,4,14,4,12,49,45,4,46
Coleraine,2389,5,12,8,10,43,42,1,44
Glenavon,2389,6,11,10,9,45,42,3,43
Glentoran,2389,7,10,9,11,31,42,-11,39
Ballinamalla,2389,8,11,3,16,36,50,-14,36
Ards,2389,9,10,4,16,43,51,-8,34
Dungannon,2389,10,7,9,14,42,48,-6,30
Portadown,2389,11,8,6,16,28,41,-13,30
Crusaders,2390,1,19,5,6,57,30,27,62
Linfield,2390,2,15,10,5,58,33,25,55
Cliftonville,2390,3,14,6,10,53,38,15,48
Glenavon,2390,4,12,12,6,54,46,8,48
Coleraine,2390,5,10,11,9,44,43,1,41
Glentoran,2390,6,11,7,12,42,47,-5,40
Ballymena,2390,7,11,7,12,47,56,-9,40
Ards,2390,8,9,7,14,42,48,-6,34
Dungannon,2390,9,7,10,13,43,50,-7,31
Ballinamalla,2390,10,7,6,17,26,50,-24,27
Portadown,2390,11,7,5,18,26,51,-25,26
Crusaders,2391,1,17,7,6,60,34,26,58
Linfield,2391,2,16,9,5,61,29,32,57
Cliftonville,2391,3,17,4,9,53,34,19,55
Ballymena,2391,4,17,4,9,62,51,11,55
Glenavon,2391,5,10,12,8,43,40,3,42
Coleraine,2391,6,10,10,10,36,40,-4,40
Ards,2391,7,12,4,14,41,46,-5,40
Dungannon,2391,8,9,8,13,44,46,-2,35
Ballinamalla,2391,9,6,9,15,29,52,-23,27
Glentoran,2391,10,7,4,19,32,56,-24,25
Portadown,2391,11,6,5,19,20,53,-33,23
Crusaders,2392,1,16,6,8,58,44,14,54
Linfield,2392,2,15,8,7,58,29,29,53
Cliftonville,2392,3,15,6,9,54,36,18,51
Glenavon,2392,4,13,11,6,59,50,9,50
Dungannon,2392,5,11,11,8,59,45,14,44
Coleraine,2392,6,10,11,9,43,40,3,41
Ballymena,2392,7,11,5,14,53,66,-13,38
Ards,2392,8,11,4,15,44,47,-3,37
Glentoran,2392,9,10,6,14,35,56,-21,36
Ballinamalla,2392,10,8,5,17,34,56,-22,29
Portadown,2392,11,7,3,20,27,55,-28,24
Linfield,2393,1,16,8,6,63,38,25,56
Crusaders,2393,2,16,7,7,54,35,19,55
Cliftonville,2393,3,14,5,11,56,48,8,47
Coleraine,2393,4,12,11,7,51,43,8,47
Glenavon,2393,5,10,12,8,51,44,7,42
Ballymena,2393,6,11,7,12,61,67,-6,40
Ballinamalla,2393,7,12,3,15,35,42,-7,39
Dungannon,2393,8,9,10,11,54,48,6,37
Glentoran,2393,9,9,7,14,34,46,-12,34
Portadown,2393,10,9,5,16,25,53,-28,32
Ards,2393,11,7,5,18,39,59,-20,26
Crusaders,2394,1,19,6,5,63,29,34,63
Linfield,2394,2,14,11,5,66,28,38,53
Coleraine,2394,3,13,11,6,45,35,10,50
Cliftonville,2394,4,14,4,12,48,45,3,46
Glenavon,2394,5,9,14,7,45,44,1,41
Glentoran,2394,6,10,10,10,37,46,-9,40
Dungannon,2394,7,10,9,11,46,41,5,39
Ballymena,2394,8,9,11,10,53,62,-9,38
Portadown,2394,9,7,7,16,24,47,-23,28
Ballinamalla,2394,10,7,7,16,34,59,-25,28
Ards,2394,11,5,6,19,33,58,-25,21
Crusaders,2395,1,14,9,7,56,41,15,51
Cliftonville,2395,2,15,5,10,58,36,22,50
Coleraine,2395,3,13,11,6,53,44,9,50
Linfield,2395,4,13,10,7,49,29,20,49
Ballymena,2395,5,14,7,9,52,59,-7,49
Glenavon,2395,6,12,9,9,53,47,6,45
Dungannon,2395,7,10,8,12,54,48,6,38
Glentoran,2395,8,8,11,11,33,46,-13,35
Ards,2395,9,9,5,16,35,50,-15,32
Ballinamalla,2395,10,7,6,17,29,51,-22,27
Portadown,2395,11,5,9,16,20,41,-21,24
Crusaders,2396,1,17,5,8,57,35,22,56
Cliftonville,2396,2,15,7,8,54,36,18,52
Ballymena,2396,3,13,11,6,62,60,2,50
Dungannon,2396,4,12,11,7,56,40,16,47
Coleraine,2396,5,12,11,7,40,32,8,47
Glenavon,2396,6,10,12,8,44,43,1,42
Linfield,2396,7,9,11,10,48,39,9,38
Glentoran,2396,8,9,8,13,32,46,-14,35
Ards,2396,9,8,5,17,38,49,-11,29
Ballinamalla,2396,10,7,6,17,27,52,-25,27
Portadown,2396,11,5,9,16,24,50,-26,24
Linfield,2397,1,16,7,7,59,29,30,55
Cliftonville,2397,2,17,4,9,50,37,13,55
Crusaders,2397,3,16,5,9,56,38,18,53
Ballymena,2397,4,15,3,12,56,54,2,48
Glenavon,2397,5,13,8,9,49,45,4,47
Coleraine,2397,6,11,10,9,40,39,1,43
Dungannon,2397,7,11,9,10,48,43,5,42
Glentoran,2397,8,9,8,13,29,40,-11,35
Ards,2397,9,8,7,15,40,50,-10,31
Ballinamalla,2397,10,7,5,18,26,52,-26,26
Portadown,2397,11,7,4,19,22,48,-26,25
Crusaders,2398,1,15,9,6,55,38,17,54
Linfield,2398,2,14,9,7,59,35,24,51
Cliftonville,2398,3,16,3,11,53,42,11,51
Coleraine,2398,4,12,11,7,46,36,10,47
Ballymena,2398,5,10,10,10,60,62,-2,40
Glenavon,2398,6,9,13,8,42,48,-6,40
Dungannon,2398,7,10,8,12,47,48,-1,38
Glentoran,2398,8,10,7,13,37,46,-9,37
Ards,2398,9,10,5,15,38,46,-8,35
Ballinamalla,2398,10,9,4,17,34,49,-15,31
Portadown,2398,11,8,5,17,28,49,-21,29
Crusaders,2399,1,18,6,6,59,33,26,60
Linfield,2399,2,15,9,6,66,37,29,54
Ballymena,2399,3,15,8,7,57,59,-2,53
Cliftonville,2399,4,14,6,10,50,38,12,48
Coleraine,2399,5,11,12,7,48,41,7,45
Glenavon,2399,6,9,13,8,38,37,1,40
Glentoran,2399,7,11,6,13,34,48,-14,39
Dungannon,2399,8,9,8,13,47,50,-3,35
Ards,2399,9,8,8,14,42,50,-8,32
Portadown,2399,10,5,11,14,30,49,-19,26
Ballinamalla,2399,11,5,3,22,23,52,-29,18
Crusaders,2400,1,19,7,4,62,32,30,64
Linfield,2400,2,16,11,3,64,29,35,59
Ballymena,2400,3,16,8,6,69,53,16,56
Dungannon,2400,4,12,8,10,55,38,17,44
Coleraine,2400,5,11,10,9,44,40,4,43
Glenavon,2400,6,10,10,10,44,48,-4,40
Cliftonville,2400,7,10,8,12,44,45,-1,38
Glentoran,2400,8,6,11,13,29,51,-22,29
Ballinamalla,2400,9,7,6,17,30,57,-27,27
Ards,2400,10,7,5,18,35,57,-22,26
Portadown,2400,11,6,6,18,21,47,-26,24
Cliftonville,2401,1,19,3,8,61,38,23,60
Crusaders,2401,2,14,9,7,55,49,6,51
Linfield,2401,3,13,11,6,59,30,29,50
Ballymena,2401,4,14,5,11,55,50,5,47
Glenavon,2401,5,11,11,8,43,45,-2,44
Coleraine,2401,6,10,10,10,45,42,3,40
Dungannon,2401,7,9,12,9,42,36,6,39
Ards,2401,8,9,5,16,36,50,-14,32
Portadown,2401,9,9,5,16,29,46,-17,32
Glentoran,2401,10,7,8,15,25,45,-20,29
Ballinamalla,2401,11,7,7,16,28,47,-19,28
Ballymena,2402,1,16,7,7,56,52,4,55
Linfield,2402,2,15,9,6,61,27,34,54
Crusaders,2402,3,15,8,7,57,39,18,53
Cliftonville,2402,4,13,7,10,47,39,8,46
Dungannon,2402,5,10,12,8,50,43,7,42
Glentoran,2402,6,11,8,11,33,38,-5,41
Coleraine,2402,7,9,10,11,40,40,0,37
Glenavon,2402,8,8,12,10,40,44,-4,36
Ballinamalla,2402,9,10,5,15,26,43,-17,35
Portadown,2402,10,5,10,15,20,43,-23,25
Ards,2402,11,6,6,18,33,55,-22,24
Crusaders,2403,1,18,7,5,59,33,26,61
Linfield,2403,2,16,9,5,62,30,32,57
Ballymena,2403,3,15,8,7,53,47,6,53
Cliftonville,2403,4,16,4,10,50,35,15,52
Coleraine,2403,5,12,11,7,44,40,4,47
Glenavon,2403,6,10,11,9,48,46,2,41
Portadown,2403,7,11,4,15,30,42,-12,37
Glentoran,2403,8,9,6,15,31,49,-18,33
Dungannon,2403,9,6,9,15,40,47,-7,27
Ards,2403,10,7,6,17,35,54,-19,27
Ballinamalla,2403,11,5,5,20,28,57,-29,20
Crusaders,2404,1,17,7,6,53,31,22,58
Linfield,2404,2,13,12,5,62,36,26,51
Cliftonville,2404,3,14,6,10,59,42,17,48
Coleraine,2404,4,13,9,8,48,34,14,48
Ballymena,2404,5,13,6,11,57,57,0,45
Glenavon,2404,6,12,9,9,44,44,0,45
Dungannon,2404,7,10,10,10,50,47,3,40
Portadown,2404,8,10,5,15,26,44,-18,35
Ards,2404,9,9,7,14,39,51,-12,34
Ballinamalla,2404,10,7,4,19,32,55,-23,25
Glentoran,2404,11,6,7,17,25,54,-29,25
Crusaders,2405,1,17,6,7,55,34,21,57
Ballymena,2405,2,15,7,8,62,56,6,52
Glenavon,2405,3,12,12,6,49,46,3,48
Coleraine,2405,4,12,11,7,49,40,9,47
Linfield,2405,5,12,9,9,53,37,16,45
Cliftonville,2405,6,12,7,11,53,45,8,43
Dungannon,2405,7,9,9,12,53,54,-1,36
Glentoran,2405,8,8,10,12,29,43,-14,34
Ards,2405,9,8,6,16,40,53,-13,30
Portadown,2405,10,8,6,16,20,38,-18,30
Ballinamalla,2405,11,8,5,17,35,52,-17,29
Cliftonville,2406,1,18,5,7,57,35,22,59
Linfield,2406,2,15,10,5,68,38,30,55
Glenavon,2406,3,13,11,6,53,41,12,50
Ballymena,2406,4,14,6,10,61,59,2,48
Crusaders,2406,5,13,8,9,52,41,11,47
Coleraine,2406,6,11,11,8,49,46,3,44
Ards,2406,7,11,3,16,35,53,-18,36
Dungannon,2406,8,8,11,11,46,44,2,35
Glentoran,2406,9,8,8,14,31,50,-19,32
Ballinamalla,2406,10,6,6,18,26,48,-22,24
Portadown,2406,11,6,5,19,24,47,-23,23
Crusaders,2407,1,15,9,6,50,32,18,54
Ballymena,2407,2,14,9,7,59,52,7,51
Coleraine,2407,3,14,8,8,45,39,6,50
Cliftonville,2407,4,14,7,9,55,46,9,49
Linfield,2407,5,13,9,8,60,34,26,48
Glenavon,2407,6,8,17,5,49,43,6,41
Dungannon,2407,7,8,11,11,50,43,7,35
Ards,2407,8,10,5,15,38,51,-13,35
Ballinamalla,2407,9,9,6,15,34,49,-15,33
Glentoran,2407,10,6,9,15,30,51,-21,27
Portadown,2407,11,6,6,18,22,52,-30,24
Crusaders,2408,1,18,8,4,56,28,28,62
Cliftonville,2408,2,15,6,9,54,39,15,51
Ballymena,2408,3,16,3,11,55,60,-5,51
Linfield,2408,4,14,8,8,62,34,28,50
Glenavon,2408,5,11,11,8,53,46,7,44
Dungannon,2408,6,11,10,9,46,36,10,43
Coleraine,2408,7,9,12,9,41,43,-2,39
Ards,2408,8,8,7,15,39,51,-12,31
Glentoran,2408,9,8,7,15,28,48,-20,31
Ballinamalla,2408,10,9,2,19,32,49,-17,29
Portadown,2408,11,6,6,18,22,54,-32,24
Crusaders,2409,1,16,7,7,56,32,24,55
Cliftonville,2409,2,16,5,9,59,41,18,53
Ballymena,2409,3,15,6,9,63,57,6,51
Linfield,2409,4,12,10,8,51,34,17,46
Glenavon,2409,5,11,12,7,45,46,-1,45
Dungannon,2409,6,11,9,10,51,45,6,42
Coleraine,2409,7,10,12,8,46,40,6,42
Ards,2409,8,9,7,14,38,51,-13,34
Portadown,2409,9,9,4,17,23,44,-21,31
Glentoran,2409,10,7,7,16,27,45,-18,28
Ballinamalla,2409,11,8,3,19,27,51,-24,27
Glenavon,2410,1,13,12,5,53,40,13,51
Ballymena,2410,2,14,8,8,51,52,-1,50
Linfield,2410,3,13,10,7,60,36,24,49
Coleraine,2410,4,11,12,7,40,30,10,45
Crusaders,2410,5,12,9,9,50,44,6,45
Dungannon,2410,6,12,8,10,51,44,7,44
Glentoran,2410,7,12,8,10,37,40,-3,44
Cliftonville,2410,8,11,7,12,42,42,0,40
Ards,2410,9,11,3,16,37,55,-18,36
Portadown,2410,10,6,7,17,29,47,-18,25
Ballinamalla,2410,11,6,4,20,34,54,-20,22
Crusaders,2411,1,18,5,7,62,33,29,59
Ballymena,2411,2,17,6,7,62,48,14,57
Cliftonville,2411,3,15,6,9,54,40,14,51
Coleraine,2411,4,11,10,9,47,46,1,43
Linfield,2411,5,11,9,10,55,40,15,42
Dungannon,2411,6,10,11,9,50,39,11,41
Glenavon,2411,7,10,10,10,45,53,-8,40
Ballinamalla,2411,8,11,4,15,33,49,-16,37
Glentoran,2411,9,8,8,14,37,52,-15,32
Ards,2411,10,7,7,16,39,54,-15,28
Portadown,2411,11,6,6,18,21,51,-30,24
Crusaders,2412,1,16,6,8,57,34,23,54
Ballymena,2412,2,14,7,9,63,59,4,49
Cliftonville,2412,3,14,4,12,53,42,11,46
Coleraine,2412,4,12,10,8,42,38,4,46
Linfield,2412,5,12,9,9,48,40,8,45
Dungannon,2412,6,11,10,9,48,42,6,43
Glenavon,2412,7,11,9,10,44,45,-1,42
Glentoran,2412,8,9,8,13,30,44,-14,35
Portadown,2412,9,9,6,15,29,43,-14,33
Ballinamalla,2412,10,9,4,17,30,52,-22,31
Ards,2412,11,7,9,14,39,44,-5,30
Cliftonville,2413,1,18,5,7,59,34,25,59
Crusaders,2413,2,14,8,8,54,39,15,50
Linfield,2413,3,13,10,7,52,35,17,49
Ballymena,2413,4,15,4,11,61,58,3,49
Dungannon,2413,5,13,9,8,54,36,18,48
Glenavon,2413,6,9,11,10,44,54,-10,38
Coleraine,2413,7,9,9,12,38,45,-7,36
Glentoran,2413,8,9,8,13,35,45,-10,35
Ards,2413,9,9,5,16,40,52,-12,32
Portadown,2413,10,9,5,16,30,48,-18,32
Ballinamalla,2413,11,9,2,19,33,54,-21,29
Crusaders,2414,1,18,8,4,65,33,32,62
Cliftonville,2414,2,17,4,9,58,46,12,55
Coleraine,2414,3,12,13,5,51,39,12,49
Ballymena,2414,4,14,5,11,61,61,0,47
Linfield,2414,5,11,9,10,57,47,10,42
Ards,2414,6,12,3,15,50,53,-3,39
Glenavon,2414,7,9,10,11,42,44,-2,37
Dungannon,2414,8,9,8,13,46,49,-3,35
Glentoran,2414,9,9,8,13,32,45,-13,35
Portadown,2414,10,9,6,15,32,49,-17,33
Ballinamalla,2414,11,6,4,20,26,54,-28,22
Linfield,2415,1,16,11,3,64,25,39,59
Cliftonville,2415,2,18,5,7,55,34,21,59
Crusaders,2415,3,14,10,6,58,43,15,52
Glenavon,2415,4,12,10,8,45,42,3,46
Ballymena,2415,5,12,7,11,54,58,-4,43
Dungannon,2415,6,9,9,12,46,44,2,36
Ards,2415,7,10,5,15,39,47,-8,35
Coleraine,2415,8,8,9,13,37,47,-10,33
Glentoran,2415,9,7,9,14,29,44,-15,30
Ballinamalla,2415,10,7,8,15,34,51,-17,29
Portadown,2415,11,7,7,16,25,51,-26,28
Crusaders,2416,1,17,8,5,56,30,26,59
Linfield,2416,2,14,11,5,59,33,26,53
Ballymena,2416,3,14,8,8,61,56,5,50
Coleraine,2416,4,13,8,9,45,33,12,47
Cliftonville,2416,5,15,2,13,52,46,6,47
Glenavon,2416,6,10,12,8,53,50,3,42
Dungannon,2416,7,8,12,10,45,43,2,36
Glentoran,2416,8,10,4,16,31,49,-18,34
Ards,2416,9,8,5,17,33,47,-14,29
Portadown,2416,10,7,8,15,24,49,-25,29
Ballinamalla,2416,11,7,6,17,29,52,-23,27
Glenavon,2417,1,15,10,5,59,40,19,55
Linfield,2417,2,15,8,7,64,41,23,53
Cliftonville,2417,3,16,4,10,58,44,14,52
Crusaders,2417,4,13,8,9,51,40,11,47
Coleraine,2417,5,12,11,7,43,37,6,47
Ballymena,2417,6,12,8,10,52,55,-3,44
Dungannon,2417,7,9,10,11,51,47,4,37
Glentoran,2417,8,8,11,11,31,40,-9,35
Ards,2417,9,8,8,14,40,54,-14,32
Ballinamalla,2417,10,9,5,16,35,54,-19,32
Portadown,2417,11,4,5,21,23,55,-32,17
Cliftonville,2418,1,18,5,7,58,33,25,59
Crusaders,2418,2,16,8,6,48,31,17,56
Glenavon,2418,3,14,8,8,56,40,16,50
Ballymena,2418,4,14,8,8,65,61,4,50
Coleraine,2418,5,12,13,5,41,29,12,49
Linfield,2418,6,11,13,6,61,40,21,46
Dungannon,2418,7,8,9,13,49,45,4,33
Ards,2418,8,9,5,16,37,55,-18,32
Glentoran,2418,9,8,7,15,26,45,-19,31
Portadown,2418,10,6,8,16,22,46,-24,26
Ballinamalla,2418,11,5,4,21,27,65,-38,19
Crusaders,2419,1,16,10,4,52,28,24,58
Linfield,2419,2,15,10,5,66,34,32,55
Cliftonville,2419,3,16,4,10,54,42,12,52
Ballymena,2419,4,14,6,10,59,58,1,48
Glenavon,2419,5,11,10,9,45,43,2,43
Coleraine,2419,6,8,14,8,34,36,-2,38
Ards,2419,7,10,6,14,45,49,-4,36
Portadown,2419,8,10,6,14,33,44,-11,36
Glentoran,2419,9,8,7,15,28,48,-20,31
Dungannon,2419,10,6,9,15,39,48,-9,27
Ballinamalla,2419,11,7,6,17,28,53,-25,27
Linfield,2420,1,15,11,4,57,29,28,56
Crusaders,2420,2,15,8,7,53,37,16,53
Cliftonville,2420,3,15,5,10,59,44,15,50
Coleraine,2420,4,13,10,7,51,35,16,49
Ballymena,2420,5,13,5,12,55,62,-7,44
Glenavon,2420,6,9,11,10,38,45,-7,38
Ards,2420,7,10,6,14,42,50,-8,36
Dungannon,2420,8,9,8,13,49,44,5,35
Glentoran,2420,9,9,8,13,34,46,-12,35
Portadown,2420,10,10,4,16,31,48,-17,34
Ballinamalla,2420,11,7,4,19,29,58,-29,25
Crusaders,2421,1,17,9,4,62,29,33,60
Cliftonville,2421,2,15,6,9,53,43,10,51
Linfield,2421,3,13,9,8,63,34,29,48
Ballymena,2421,4,13,8,9,57,58,-1,47
Glenavon,2421,5,11,10,9,47,51,-4,43
Coleraine,2421,6,9,13,8,45,42,3,40
Ards,2421,7,10,5,15,33,45,-12,35
Dungannon,2421,8,8,10,12,51,52,-1,34
Ballinamalla,2421,9,10,3,17,41,54,-13,33
Glentoran,2421,10,8,7,15,36,59,-23,31
Portadown,2421,11,6,10,14,26,47,-21,28
Crusaders,2422,1,16,10,4,52,31,21,58
Ballymena,2422,2,16,5,9,65,59,6,53
Linfield,2422,3,13,10,7,62,38,24,49
Cliftonville,2422,4,14,5,11,54,42,12,47
Glenavon,2422,5,11,11,8,52,47,5,44
Coleraine,2422,6,11,11,8,45,40,5,44
Dungannon,2422,7,9,11,10,50,48,2,38
Ballinamalla,2422,8,10,6,14,34,49,-15,36
Ards,2422,9,10,5,15,37,46,-9,35
Portadown,2422,10,6,6,18,19,44,-25,24
Glentoran,2422,11,6,6,18,27,53,-26,24
Linfield,2423,1,15,9,6,61,31,30,54
Glenavon,2423,2,14,12,4,58,39,19,54
Dungannon,2423,3,15,7,8,58,38,20,52
Crusaders,2423,4,14,8,8,54,42,12,50
Cliftonville,2423,5,14,6,10,55,38,17,48
Ballymena,2423,6,12,10,8,62,58,4,46
Coleraine,2423,7,11,9,10,47,49,-2,42
Ards,2423,8,9,5,16,33,50,-17,32
Glentoran,2423,9,7,9,14,34,50,-16,30
Portadown,2423,10,6,6,18,18,50,-32,24
Ballinamalla,2423,11,5,5,20,26,61,-35,20
Crusaders,2424,1,20,7,3,59,29,30,67
Ballymena,2424,2,17,7,6,68,53,15,58
Linfield,2424,3,15,10,5,60,29,31,55
Cliftonville,2424,4,15,3,12,55,49,6,48
Glenavon,2424,5,12,9,9,48,49,-1,45
Dungannon,2424,6,10,9,11,46,42,4,39
Coleraine,2424,7,10,9,11,44,40,4,39
Glentoran,2424,8,10,8,12,31,46,-15,38
Portadown,2424,9,7,4,19,22,46,-24,25
Ballinamalla,2424,10,6,5,19,29,56,-27,23
Ards,2424,11,5,5,20,31,54,-23,20
Crusaders,2425,1,17,7,6,60,32,28,58
Linfield,2425,2,14,9,7,53,36,17,51
Glenavon,2425,3,13,11,6,58,42,16,50
Ballymena,2425,4,14,7,9,62,61,1,49
Cliftonville,2425,5,14,6,10,53,46,7,48
Coleraine,2425,6,10,12,8,42,35,7,42
Dungannon,2425,7,9,11,10,55,46,9,38
Ballinamalla,2425,8,11,4,15,39,59,-20,37
Portadown,2425,9,6,9,15,24,43,-19,27
Ards,2425,10,7,5,18,34,57,-23,26
Glentoran,2425,11,6,7,17,28,51,-23,25
Crusaders,2426,1,16,11,3,52,31,21,59
Linfield,2426,2,15,7,8,55,32,23,52
Cliftonville,2426,3,14,5,11,47,41,6,47
Coleraine,2426,4,12,10,8,44,40,4,46
Ballymena,2426,5,13,6,11,59,60,-1,45
Glenavon,2426,6,10,10,10,49,47,2,40
Dungannon,2426,7,8,14,8,53,43,10,38
Glentoran,2426,8,11,5,14,28,39,-11,38
Ballinamalla,2426,9,11,4,15,33,49,-16,37
Ards,2426,10,6,7,17,35,52,-17,25
Portadown,2426,11,6,7,17,26,47,-21,25
Crusaders,2427,1,14,10,6,47,30,17,52
Cliftonville,2427,2,16,2,12,50,40,10,50
Linfield,2427,3,12,11,7,59,34,25,47
Glenavon,2427,4,12,11,7,49,41,8,47
Ballymena,2427,5,13,7,10,60,60,0,46
Coleraine,2427,6,11,11,8,43,37,6,44
Dungannon,2427,7,10,9,11,48,41,7,39
Glentoran,2427,8,8,10,12,28,43,-15,34
Ards,2427,9,9,6,15,36,49,-13,33
Ballinamalla,2427,10,8,7,15,32,48,-16,31
Portadown,2427,11,7,6,17,21,50,-29,27
Crusaders,2428,1,20,7,3,59,28,31,67
Linfield,2428,2,16,8,6,64,35,29,56
Ballymena,2428,3,15,7,8,67,57,10,52
Coleraine,2428,4,12,10,8,38,34,4,46
Glenavon,2428,5,12,9,9,48,42,6,45
Cliftonville,2428,6,13,6,11,45,44,1,45
Dungannon,2428,7,9,9,12,51,44,7,36
Glentoran,2428,8,8,6,16,33,50,-17,30
Portadown,2428,9,7,6,17,24,47,-23,27
Ballinamalla,2428,10,8,3,19,31,56,-25,27
Ards,2428,11,6,7,17,36,59,-23,25
Crusaders,2429,1,17,8,5,56,36,20,59
Cliftonville,2429,2,15,7,8,55,36,19,52
Ballymena,2429,3,14,7,9,58,58,0,49
Coleraine,2429,4,13,9,8,40,32,8,48
Linfield,2429,5,12,10,8,60,36,24,46
Glenavon,2429,6,10,10,10,46,48,-2,40
Dungannon,2429,7,8,14,8,44,41,3,38
Ards,2429,8,7,9,14,38,50,-12,30
Glentoran,2429,9,7,9,14,26,43,-17,30
Portadown,2429,10,5,11,14,25,46,-21,26
Ballinamalla,2429,11,6,8,16,30,52,-22,26
Crusaders,2430,1,19,6,5,62,31,31,63
Ballymena,2430,2,16,8,6,66,54,12,56
Cliftonville,2430,3,14,6,10,51,44,7,48
Linfield,2430,4,11,13,6,60,36,24,46
Coleraine,2430,5,10,11,9,38,43,-5,41
Glenavon,2430,6,9,9,12,42,49,-7,36
Ards,2430,7,9,8,13,41,46,-5,35
Glentoran,2430,8,8,10,12,27,40,-13,34
Dungannon,2430,9,8,7,15,46,52,-6,31
Portadown,2430,10,9,4,17,28,43,-15,31
Ballinamalla,2430,11,9,4,17,28,51,-23,31
Linfield,2431,1,13,11,6,60,34,26,50
Crusaders,2431,2,13,11,6,54,38,16,50
Glenavon,2431,3,12,12,6,53,37,16,48
Cliftonville,2431,4,12,10,8,53,41,12,46
Ballymena,2431,5,13,6,11,52,56,-4,45
Coleraine,2431,6,11,11,8,37,33,4,44
Dungannon,2431,7,9,12,9,47,39,8,39
Ballinamalla,2431,8,10,5,15,32,48,-16,35
Glentoran,2431,9,8,8,14,32,50,-18,32
Ards,2431,10,6,10,14,27,46,-19,28
Portadown,2431,11,6,8,16,25,50,-25,26
Linfield,2432,1,18,7,5,70,29,41,61
Crusaders,2432,2,18,5,7,58,43,15,59
Cliftonville,2432,3,16,5,9,62,45,17,53
Coleraine,2432,4,13,9,8,50,41,9,48
Dungannon,2432,5,13,8,9,58,43,15,47
Ballymena,2432,6,13,7,10,56,58,-2,46
Glenavon,2432,7,11,10,9,48,51,-3,43
Glentoran,2432,8,7,8,15,33,54,-21,29
Ards,2432,9,7,5,18,34,54,-20,26
Ballinamalla,2432,10,6,7,17,33,55,-22,25
Portadown,2432,11,4,7,19,19,48,-29,19
Crusaders,2433,1,18,8,4,58,32,26,62
Ballymena,2433,2,13,8,9,57,57,0,47
Linfield,2433,3,12,10,8,54,34,20,46
Glenavon,2433,4,12,9,9,55,43,12,45
Coleraine,2433,5,11,11,8,43,35,8,44
Dungannon,2433,6,10,11,9,48,41,7,41
Cliftonville,2433,7,12,3,15,46,44,2,39
Glentoran,2433,8,9,7,14,32,49,-17,34
Ards,2433,9,9,6,15,35,53,-18,33
Portadown,2433,10,8,8,14,29,46,-17,32
Ballinamalla,2433,11,8,5,17,26,49,-23,29
Crusaders,2434,1,17,8,5,56,33,23,59
Ballymena,2434,2,16,4,10,68,62,6,52
Cliftonville,2434,3,16,3,11,49,35,14,51
Dungannon,2434,4,13,9,8,52,37,15,48
Glenavon,2434,5,12,11,7,44,39,5,47
Glentoran,2434,6,12,6,12,30,41,-11,42
Linfield,2434,7,11,8,11,49,35,14,41
Coleraine,2434,8,10,9,11,46,40,6,39
Ards,2434,9,8,5,17,36,53,-17,29
Ballinamalla,2434,10,8,2,20,31,56,-25,26
Portadown,2434,11,7,5,18,25,55,-30,26
Crusaders,2435,1,21,5,4,56,25,31,68
Linfield,2435,2,16,7,7,59,35,24,55
Cliftonville,2435,3,16,5,9,56,36,20,53
Ballymena,2435,4,14,6,10,55,56,-1,48
Glenavon,2435,5,11,12,7,41,41,0,45
Glentoran,2435,6,12,6,12,38,41,-3,42
Dungannon,2435,7,8,13,9,50,46,4,37
Coleraine,2435,8,9,9,12,43,48,-5,36
Ballinamalla,2435,9,8,6,16,29,51,-22,30
Ards,2435,10,6,5,19,34,54,-20,23
Portadown,2435,11,5,4,21,20,48,-28,19
Crusaders,2436,1,20,6,4,70,35,35,66
Linfield,2436,2,16,8,6,60,30,30,56
Ballymena,2436,3,14,5,11,59,62,-3,47
Cliftonville,2436,4,13,6,11,51,43,8,45
Dungannon,2436,5,12,8,10,52,43,9,44
Coleraine,2436,6,11,10,9,42,36,6,43
Ards,2436,7,13,2,15,46,52,-6,41
Glenavon,2436,8,9,12,9,45,49,-4,39
Glentoran,2436,9,9,5,16,26,47,-21,32
Portadown,2436,10,6,6,18,24,51,-27,24
Ballinamalla,2436,11,5,6,19,25,52,-27,21
Cliftonville,2437,1,18,3,9,65,46,19,57
Crusaders,2437,2,17,5,8,55,37,18,56
Ballymena,2437,3,16,7,7,59,55,4,55
Linfield,2437,4,12,9,9,59,42,17,45
Glenavon,2437,5,10,13,7,46,45,1,43
Ards,2437,6,11,6,13,39,43,-4,39
Dungannon,2437,7,9,11,10,46,40,6,38
Coleraine,2437,8,9,11,10,39,42,-3,38
Ballinamalla,2437,9,9,6,15,36,50,-14,33
Portadown,2437,10,8,5,17,30,47,-17,29
Glentoran,2437,11,4,8,18,25,52,-27,20
Linfield,2438,1,16,10,4,65,30,35,58
Cliftonville,2438,2,17,5,8,56,37,19,56
Crusaders,2438,3,15,9,6,58,41,17,54
Ballymena,2438,4,15,6,9,68,58,10,51
Glenavon,2438,5,10,10,10,46,53,-7,40
Coleraine,2438,6,10,9,11,40,42,-2,39
Ballinamalla,2438,7,10,6,14,34,45,-11,36
Glentoran,2438,8,9,6,15,36,46,-10,33
Ards,2438,9,9,5,16,40,59,-19,32
Portadown,2438,10,9,3,18,30,47,-17,30
Dungannon,2438,11,7,7,16,49,64,-15,28
Crusaders,2439,1,18,10,2,62,32,30,64
Cliftonville,2439,2,15,5,10,47,39,8,50
Coleraine,2439,3,13,10,7,50,37,13,49
Glenavon,2439,4,13,10,7,57,46,11,49
Linfield,2439,5,13,9,8,54,36,18,48
Ballymena,2439,6,13,7,10,52,58,-6,46
Dungannon,2439,7,8,14,8,50,43,7,38
Glentoran,2439,8,8,6,16,32,48,-16,30
Portadown,2439,9,6,9,15,28,50,-22,27
Ballinamalla,2439,10,7,5,18,24,51,-27,26
Ards,2439,11,5,7,18,32,48,-16,22
Cliftonville,2440,1,17,5,8,58,42,16,56
Crusaders,2440,2,15,9,6,51,34,17,54
Linfield,2440,3,12,14,4,61,33,28,50
Ballymena,2440,4,13,8,9,65,63,2,47
Glenavon,2440,5,10,14,6,45,45,0,44
Coleraine,2440,6,10,12,8,43,44,-1,42
Dungannon,2440,7,10,9,11,54,48,6,39
Glentoran,2440,8,9,8,13,39,50,-11,35
Ards,2440,9,9,6,15,37,45,-8,33
Portadown,2440,10,6,7,17,22,47,-25,25
Ballinamalla,2440,11,5,6,19,24,48,-24,21
Crusaders,2441,1,16,11,3,61,34,27,59
Linfield,2441,2,15,8,7,59,30,29,53
Ballymena,2441,3,15,5,10,56,58,-2,50
Cliftonville,2441,4,14,6,10,48,39,9,48
Glenavon,2441,5,11,12,7,53,44,9,45
Coleraine,2441,6,9,11,10,34,36,-2,38
Glentoran,2441,7,9,9,12,35,47,-12,36
Ards,2441,8,10,4,16,43,52,-9,34
Dungannon,2441,9,7,10,13,45,51,-6,31
Portadown,2441,10,9,3,18,26,52,-26,30
Ballinamalla,2441,11,6,9,15,38,55,-17,27
Crusaders,2442,1,17,7,6,58,33,25,58
Linfield,2442,2,15,7,8,60,31,29,52
Ballymena,2442,3,15,6,9,57,55,2,51
Cliftonville,2442,4,14,4,12,49,45,4,46
Glenavon,2442,5,11,9,10,53,51,2,42
Coleraine,2442,6,11,9,10,47,48,-1,42
Dungannon,2442,7,10,9,11,43,40,3,39
Ards,2442,8,11,4,15,39,49,-10,37
Glentoran,2442,9,10,5,15,31,46,-15,35
Portadown,2442,10,9,6,15,24,36,-12,33
Ballinamalla,2442,11,7,4,19,27,54,-27,25
Crusaders,2443,1,19,7,4,57,30,27,64
Linfield,2443,2,17,8,5,61,29,32,59
Ballymena,2443,3,16,5,9,58,50,8,53
Cliftonville,2443,4,14,4,12,54,45,9,46
Coleraine,2443,5,9,13,8,44,41,3,40
Dungannon,2443,6,10,9,11,48,51,-3,39
Glenavon,2443,7,8,12,10,41,48,-7,36
Ballinamalla,2443,8,9,5,16,28,44,-16,32
Ards,2443,9,8,7,15,35,43,-8,31
Glentoran,2443,10,8,6,16,26,44,-18,30
Portadown,2443,11,6,6,18,22,49,-27,24
Linfield,2444,1,17,6,7,58,33,25,57
Cliftonville,2444,2,16,5,9,53,39,14,53
Crusaders,2444,3,14,8,8,55,41,14,50
Coleraine,2444,4,12,10,8,44,37,7,46
Ballymena,2444,5,13,6,11,62,61,1,45
Glenavon,2444,6,10,13,7,50,47,3,43
Dungannon,2444,7,10,10,10,52,48,4,40
Ballinamalla,2444,8,12,2,16,33,46,-13,38
Glentoran,2444,9,8,8,14,33,47,-14,32
Portadown,2444,10,8,3,19,30,52,-22,27
Ards,2444,11,5,9,16,29,48,-19,24
Linfield,2445,1,17,8,5,65,27,38,59
Crusaders,2445,2,14,8,8,54,38,16,50
Coleraine,2445,3,13,11,6,50,37,13,50
Glenavon,2445,4,13,11,6,44,35,9,50
Ballymena,2445,5,13,6,11,57,66,-9,45
Dungannon,2445,6,12,8,10,45,37,8,44
Cliftonville,2445,7,12,7,11,40,41,-1,43
Ballinamalla,2445,8,9,4,17,33,48,-15,31
Glentoran,2445,9,9,4,17,30,48,-18,31
Portadown,2445,10,7,6,17,21,45,-24,27
Ards,2445,11,7,5,18,33,50,-17,26
Linfield,2446,1,16,9,5,63,27,36,57
Crusaders,2446,2,16,8,6,53,37,16,56
Ballymena,2446,3,15,7,8,67,60,7,52
Coleraine,2446,4,13,9,8,48,35,13,48
Cliftonville,2446,5,14,4,12,53,50,3,46
Glenavon,2446,6,10,10,10,45,42,3,40
Dungannon,2446,7,8,11,11,41,42,-1,35
Ards,2446,8,9,7,14,37,42,-5,34
Ballinamalla,2446,9,10,4,16,28,46,-18,34
Glentoran,2446,10,7,8,15,29,51,-22,29
Portadown,2446,11,6,5,19,24,56,-32,23
Crusaders,2447,1,16,10,4,51,28,23,58
Cliftonville,2447,2,17,4,9,55,37,18,55
Ballymena,2447,3,15,4,11,63,65,-2,49
Glenavon,2447,4,12,11,7,48,43,5,47
Linfield,2447,5,12,10,8,54,33,21,46
Coleraine,2447,6,11,10,9,42,40,2,43
Ards,2447,7,10,6,14,37,42,-5,36
Dungannon,2447,8,7,11,12,48,50,-2,32
Glentoran,2447,9,6,14,10,28,42,-14,32
Ballinamalla,2447,10,8,7,15,29,45,-16,31
Portadown,2447,11,5,5,20,24,54,-30,20
Crusaders,2448,1,19,5,6,65,32,33,62
Cliftonville,2448,2,19,4,7,58,34,24,61
Linfield,2448,3,16,9,5,65,34,31,57
Dungannon,2448,4,12,10,8,61,42,19,46
Ballymena,2448,5,11,8,11,50,58,-8,41
Coleraine,2448,6,10,10,10,42,45,-3,40
Glenavon,2448,7,7,10,13,38,55,-17,31
Ards,2448,8,8,6,16,40,55,-15,30
Glentoran,2448,9,7,9,14,27,43,-16,30
Ballinamalla,2448,10,8,4,18,28,53,-25,28
Portadown,2448,11,6,9,15,24,47,-23,27
Linfield,2449,1,14,10,6,54,35,19,52
Crusaders,2449,2,14,9,7,53,32,21,51
Cliftonville,2449,3,14,8,8,55,35,20,50
Coleraine,2449,4,13,11,6,48,38,10,50
Ballymena,2449,5,15,4,11,63,61,2,49
Glenavon,2449,6,12,11,7,44,39,5,47
Dungannon,2449,7,9,9,12,47,45,2,36
Ards,2449,8,10,5,15,40,48,-8,35
Glentoran,2449,9,8,8,14,33,49,-16,32
Portadown,2449,10,9,3,18,26,51,-25,30
Ballinamalla,2449,11,6,4,20,29,59,-30,22
Crusaders,2450,1,18,8,4,62,34,28,62
Cliftonville,2450,2,17,5,8,58,42,16,56
Linfield,2450,3,14,9,7,63,37,26,51
Coleraine,2450,4,12,11,7,45,37,8,47
Glenavon,2450,5,11,10,9,47,47,0,43
Ballymena,2450,6,11,8,11,51,59,-8,41
Dungannon,2450,7,9,11,10,51,47,4,38
Ards,2450,8,10,4,16,44,53,-9,34
Ballinamalla,2450,9,7,7,16,29,49,-20,28
Glentoran,2450,10,6,8,16,26,47,-21,26
Portadown,2450,11,7,5,18,34,58,-24,26
Crusaders,2451,1,17,9,4,56,33,23,60
Cliftonville,2451,2,17,3,10,59,38,21,54
Ballymena,2451,3,16,6,8,57,48,9,54
Linfield,2451,4,14,10,6,53,27,26,52
Coleraine,2451,5,12,11,7,50,42,8,47
Glentoran,2451,6,10,9,11,31,39,-8,39
Dungannon,2451,7,8,10,12,52,53,-1,34
Glenavon,2451,8,8,10,12,41,52,-11,34
Ballinamalla,2451,9,9,4,17,30,49,-19,31
Ards,2451,10,8,4,18,35,51,-16,28
Portadown,2451,11,6,4,20,20,52,-32,22
Crusaders,2452,1,16,9,5,55,28,27,57
Coleraine,2452,2,16,7,7,47,33,14,55
Cliftonville,2452,3,16,6,8,52,36,16,54
Linfield,2452,4,14,10,6,57,33,24,52
Ballymena,2452,5,15,5,10,54,56,-2,50
Glenavon,2452,6,10,11,9,45,40,5,41
Ards,2452,7,10,5,15,40,49,-9,35
Dungannon,2452,8,6,13,11,42,45,-3,31
Glentoran,2452,9,6,9,15,27,46,-19,27
Portadown,2452,10,7,5,18,22,47,-25,26
Ballinamalla,2452,11,7,4,19,28,56,-28,25
Cliftonville,2453,1,17,7,6,54,32,22,58
Crusaders,2453,2,17,6,7,52,32,20,57
Linfield,2453,3,13,10,7,63,37,26,49
Dungannon,2453,4,12,10,8,60,46,14,46
Coleraine,2453,5,11,11,8,39,38,1,44
Glenavon,2453,6,10,12,8,38,39,-1,42
Ballymena,2453,7,11,9,10,51,58,-7,42
Ards,2453,8,8,7,15,35,44,-9,31
Glentoran,2453,9,7,10,13,26,41,-15,31
Portadown,2453,10,7,5,18,24,46,-22,26
Ballinamalla,2453,11,7,3,20,24,53,-29,24
Crusaders,2454,1,19,5,6,61,35,26,62
Cliftonville,2454,2,18,2,10,58,38,20,56
Linfield,2454,3,13,11,6,58,31,27,50
Dungannon,2454,4,12,10,8,58,42,16,46
Coleraine,2454,5,10,11,9,36,36,0,41
Ballymena,2454,6,12,5,13,53,62,-9,41
Portadown,2454,7,9,7,14,32,42,-10,34
Glenavon,2454,8,8,10,12,44,57,-13,34
Ards,2454,9,10,4,16,33,47,-14,34
Glentoran,2454,10,8,9,13,27,45,-18,33
Ballinamalla,2454,11,7,4,19,29,54,-25,25
Crusaders,2455,1,18,5,7,60,40,20,59
Linfield,2455,2,14,10,6,54,28,26,52
Ballymena,2455,3,14,9,7,56,54,2,51
Coleraine,2455,4,13,9,8,47,36,11,48
Cliftonville,2455,5,14,5,11,57,45,12,47
Glenavon,2455,6,12,10,8,51,48,3,46
Dungannon,2455,7,11,9,10,54,43,11,42
Glentoran,2455,8,9,7,14,31,43,-12,34
Portadown,2455,9,8,7,15,24,41,-17,31
Ards,2455,10,7,5,18,33,52,-19,26
Ballinamalla,2455,11,5,4,21,25,62,-37,19
Cliftonville,2456,1,19,3,8,60,36,24,60
Crusaders,2456,2,16,10,4,59,29,30,58
Linfield,2456,3,13,10,7,54,33,21,49
Ballymena,2456,4,12,10,8,55,57,-2,46
Dungannon,2456,5,10,13,7,55,38,17,43
Glenavon,2456,6,10,10,10,48,47,1,40
Coleraine,2456,7,9,10,11,37,41,-4,37
Ballinamalla,2456,8,9,4,17,27,51,-24,31
Ards,2456,9,8,6,16,36,56,-20,30
Glentoran,2456,10,6,10,14,30,53,-23,28
Portadown,2456,11,7,6,17,25,45,-20,27
Linfield,2457,1,17,10,3,62,29,33,61
Crusaders,2457,2,15,10,5,60,36,24,55
Cliftonville,2457,3,15,5,10,47,33,14,50
Ballymena,2457,4,13,5,12,48,55,-7,44
Glenavon,2457,5,10,11,9,49,49,0,41
Ards,2457,6,12,5,13,36,40,-4,41
Dungannon,2457,7,10,10,10,52,49,3,40
Coleraine,2457,8,9,10,11,40,41,-1,37
Ballinamalla,2457,9,9,7,14,39,52,-13,34
Portadown,2457,10,6,7,17,27,48,-21,25
Glentoran,2457,11,6,6,18,29,57,-28,24
Crusaders,2458,1,18,6,6,57,27,30,60
Linfield,2458,2,15,7,8,66,46,20,52
Glenavon,2458,3,14,10,6,47,36,11,52
Cliftonville,2458,4,15,5,10,52,39,13,50
Ballymena,2458,5,15,5,10,65,56,9,50
Coleraine,2458,6,11,10,9,35,36,-1,43
Dungannon,2458,7,10,7,13,45,48,-3,37
Ards,2458,8,9,5,16,36,48,-12,32
Portadown,2458,9,8,5,17,24,47,-23,29
Glentoran,2458,10,7,7,16,25,47,-22,28
Ballinamalla,2458,11,6,7,17,26,48,-22,25
Linfield,2459,1,17,7,6,58,29,29,58
Crusaders,2459,2,15,7,8,53,39,14,52
Ballymena,2459,3,16,4,10,61,61,0,52
Glenavon,2459,4,12,12,6,52,44,8,48
Cliftonville,2459,5,12,5,13,50,48,2,41
Dungannon,2459,6,10,10,10,57,44,13,40
Coleraine,2459,7,9,12,9,41,43,-2,39
Ballinamalla,2459,8,12,2,16,42,51,-9,38
Portadown,2459,9,9,4,17,28,46,-18,31
Glentoran,2459,10,7,9,14,30,47,-17,30
Ards,2459,11,7,6,17,31,51,-20,27
Glenavon,2460,1,15,12,3,57,36,21,57
Cliftonville,2460,2,17,5,8,53,39,14,56
Coleraine,2460,3,14,10,6,41,30,11,52
Linfield,2460,4,14,9,7,53,31,22,51
Ballymena,2460,5,13,8,9,54,54,0,47
Crusaders,2460,6,13,7,10,53,47,6,46
Dungannon,2460,7,10,10,10,48,39,9,40
Ards,2460,8,10,4,16,42,50,-8,34
Glentoran,2460,9,6,11,13,27,42,-15,29
Ballinamalla,2460,10,8,2,20,31,58,-27,26
Portadown,2460,11,4,4,22,19,52,-33,16
Crusaders,2461,1,20,5,5,70,36,34,65
Linfield,2461,2,15,8,7,59,35,24,53
Ballymena,2461,3,13,8,9,56,58,-2,47
Dungannon,2461,4,13,7,10,58,47,11,46
Cliftonville,2461,5,14,4,12,49,40,9,46
Ards,2461,6,12,7,11,50,43,7,43
Coleraine,2461,7,11,8,11,41,41,0,41
Glenavon,2461,8,9,11,10,40,47,-7,38
Ballinamalla,2461,9,8,4,18,27,52,-25,28
Portadown,2461,10,7,4,19,27,55,-28,25
Glentoran,2461,11,4,12,14,32,55,-23,24
Linfield,2462,1,17,8,5,64,26,38,59
Crusaders,2462,2,16,5,9,58,40,18,53
Ballymena,2462,3,16,3,11,55,53,2,51
Coleraine,2462,4,14,7,9,47,37,10,49
Cliftonville,2462,5,15,4,11,45,46,-1,49
Dungannon,2462,6,12,8,10,58,45,13,44
Glenavon,2462,7,10,11,9,50,51,-1,41
Ards,2462,8,10,3,17,36,51,-15,33
Glentoran,2462,9,8,6,16,27,44,-17,30
Ballinamalla,2462,10,8,6,16,27,47,-20,30
Portadown,2462,11,6,5,19,25,52,-27,23
Ballymena,2463,1,18,6,6,64,49,15,60
Cliftonville,2463,2,17,6,7,56,37,19,57
Crusaders,2463,3,15,5,10,51,42,9,50
Coleraine,2463,4,12,11,7,43,35,8,47
Glenavon,2463,5,11,12,7,50,42,8,45
Dungannon,2463,6,12,9,9,45,37,8,45
Linfield,2463,7,11,10,9,57,36,21,43
Ballinamalla,2463,8,10,4,16,33,48,-15,34
Glentoran,2463,9,7,6,17,30,52,-22,27
Portadown,2463,10,6,7,17,26,53,-27,25
Ards,2463,11,6,4,20,28,52,-24,22
Crusaders,2464,1,18,6,6,58,34,24,60
Glenavon,2464,2,14,9,7,53,43,10,51
Cliftonville,2464,3,15,5,10,52,38,14,50
Ballymena,2464,4,14,6,10,54,56,-2,48
Linfield,2464,5,10,13,7,53,32,21,43
Coleraine,2464,6,9,14,7,37,35,2,41
Dungannon,2464,7,10,9,11,48,48,0,39
Ards,2464,8,10,7,13,38,41,-3,37
Glentoran,2464,9,9,9,12,30,43,-13,36
Portadown,2464,10,7,3,20,25,52,-27,24
Ballinamalla,2464,11,5,7,18,26,52,-26,22
Ballymena,2465,1,15,8,7,58,55,3,53
Cliftonville,2465,2,14,7,9,54,39,15,49
Crusaders,2465,3,13,10,7,48,33,15,49
Linfield,2465,4,12,11,7,50,29,21,47
Glenavon,2465,5,10,12,8,55,49,6,42
Ards,2465,6,11,8,11,42,45,-3,41
Coleraine,2465,7,9,12,9,38,41,-3,39
Glentoran,2465,8,9,8,13,31,38,-7,35
Dungannon,2465,9,8,9,13,44,50,-6,33
Portadown,2465,10,7,8,15,27,45,-18,29
Ballinamalla,2465,11,8,5,17,30,53,-23,29
Linfield,2466,1,19,7,4,69,28,41,64
Crusaders,2466,2,15,7,8,53,34,19,52
Coleraine,2466,3,14,10,6,48,35,13,52
Cliftonville,2466,4,13,7,10,53,44,9,46
Ballymena,2466,5,14,4,12,56,62,-6,46
Dungannon,2466,6,12,8,10,52,44,8,44
Glenavon,2466,7,11,10,9,49,49,0,43
Glentoran,2466,8,8,7,15,32,46,-14,31
Ards,2466,9,9,3,18,37,56,-19,30
Portadown,2466,10,7,7,16,26,47,-21,28
Ballinamalla,2466,11,6,4,20,27,57,-30,22
Crusaders,2467,1,16,10,4,59,35,24,58
Linfield,2467,2,15,12,3,62,26,36,57
Coleraine,2467,3,13,11,6,44,36,8,50
Ballymena,2467,4,14,7,9,55,50,5,49
Cliftonville,2467,5,13,7,10,53,42,11,46
Glenavon,2467,6,11,12,7,45,43,2,45
Dungannon,2467,7,7,13,10,52,53,-1,34
Portadown,2467,8,8,6,16,25,46,-21,30
Glentoran,2467,9,6,11,13,30,44,-14,29
Ards,2467,10,7,5,18,30,54,-24,26
Ballinamalla,2467,11,5,6,19,25,51,-26,21
Glenavon,2468,1,16,8,6,60,44,16,56
Crusaders,2468,2,15,8,7,51,37,14,53
Ballymena,2468,3,15,7,8,56,51,5,52
Linfield,2468,4,14,9,7,56,31,25,51
Cliftonville,2468,5,14,6,10,58,41,17,48
Coleraine,2468,6,11,11,8,43,36,7,44
Dungannon,2468,7,9,10,11,45,44,1,37
Glentoran,2468,8,9,6,15,24,42,-18,33
Ards,2468,9,9,2,19,33,51,-18,29
Portadown,2468,10,6,8,16,26,50,-24,26
Ballinamalla,2468,11,7,5,18,31,56,-25,26
Ballymena,2469,1,16,7,7,68,56,12,55
Crusaders,2469,2,15,7,8,53,33,20,52
Coleraine,2469,3,13,10,7,48,37,11,49
Glenavon,2469,4,13,9,8,51,49,2,48
Linfield,2469,5,12,10,8,55,41,14,46
Dungannon,2469,6,10,11,9,50,39,11,41
Cliftonville,2469,7,12,5,13,48,50,-2,41
Glentoran,2469,8,11,7,12,37,48,-11,40
Ards,2469,9,9,5,16,37,49,-12,32
Ballinamalla,2469,10,9,4,17,38,55,-17,31
Portadown,2469,11,5,5,20,19,47,-28,20
Crusaders,2470,1,18,6,6,58,34,24,60
Cliftonville,2470,2,15,4,11,53,43,10,49
Linfield,2470,3,13,8,9,59,40,19,47
Coleraine,2470,4,12,9,9,45,36,9,45
Ballymena,2470,5,13,6,11,58,56,2,45
Glenavon,2470,6,10,12,8,49,49,0,42
Glentoran,2470,7,11,7,12,36,45,-9,40
Portadown,2470,8,10,6,14,31,40,-9,36
Ards,2470,9,10,4,16,38,53,-15,34
Dungannon,2470,10,7,12,11,44,48,-4,33
Ballinamalla,2470,11,7,4,19,25,52,-27,25
Crusaders,2471,1,17,7,6,57,29,28,58
Linfield,2471,2,15,8,7,56,33,23,53
Dungannon,2471,3,14,10,6,57,33,24,52
Ballymena,2471,4,14,5,11,63,55,8,47
Cliftonville,2471,5,12,6,12,43,38,5,42
Coleraine,2471,6,11,8,11,36,47,-11,41
Glenavon,2471,7,10,10,10,43,48,-5,40
Glentoran,2471,8,9,7,14,27,42,-15,34
Ards,2471,9,9,5,16,36,48,-12,32
Portadown,2471,10,8,6,16,23,43,-20,30
Ballinamalla,2471,11,8,4,18,33,58,-25,28
Cliftonville,2472,1,18,5,7,58,32,26,59
Linfield,2472,2,15,8,7,59,28,31,53
Crusaders,2472,3,15,7,8,51,40,11,52
Coleraine,2472,4,13,10,7,46,36,10,49
Glenavon,2472,5,10,15,5,49,43,6,45
Ballymena,2472,6,13,6,11,57,55,2,45
Dungannon,2472,7,10,10,10,51,44,7,40
Ards,2472,8,10,4,16,36,52,-16,34
Portadown,2472,9,7,6,17,17,50,-33,27
Glentoran,2472,10,6,8,16,30,51,-21,26
Ballinamalla,2472,11,6,5,19,30,53,-23,23
Linfield,2473,1,16,9,5,57,29,28,57
Crusaders,2473,2,15,7,8,54,38,16,52
Ballymena,2473,3,14,6,10,60,58,2,48
Glenavon,2473,4,10,14,6,46,44,2,44
Coleraine,2473,5,11,10,9,49,40,9,43
Cliftonville,2473,6,12,7,11,49,42,7,43
Dungannon,2473,7,10,11,9,54,45,9,41
Glentoran,2473,8,9,9,12,39,49,-10,36
Ards,2473,9,10,5,15,42,56,-14,35
Portadown,2473,10,7,5,18,32,50,-18,26
Ballinamalla,2473,11,6,7,17,29,60,-31,25
Crusaders,2474,1,17,8,5,57,33,24,59
Linfield,2474,2,17,7,6,66,34,32,58
Cliftonville,2474,3,15,7,8,58,37,21,52
Coleraine,2474,4,13,9,8,45,35,10,48
Ballymena,2474,5,12,10,8,56,58,-2,46
Glenavon,2474,6,11,12,7,49,51,-2,45
Dungannon,2474,7,9,9,12,49,49,0,36
Ards,2474,8,9,4,17,37,58,-21,31
Ballinamalla,2474,9,8,6,16,31,55,-24,30
Glentoran,2474,10,7,6,17,31,51,-20,27
Portadown,2474,11,5,6,19,26,44,-18,21
Crusaders,2475,1,18,4,8,57,38,19,58
Cliftonville,2475,2,16,6,8,52,34,18,54
Ballymena,2475,3,14,7,9,58,56,2,49
Glenavon,2475,4,13,9,8,48,43,5,48
Linfield,2475,5,12,8,10,51,35,16,44
Coleraine,2475,6,10,13,7,45,35,10,43
Glentoran,2475,7,11,6,13,44,47,-3,39
Dungannon,2475,8,10,8,12,49,47,2,38
Portadown,2475,9,7,7,16,26,53,-27,28
Ards,2475,10,7,6,17,33,48,-15,27
Ballinamalla,2475,11,7,6,17,28,55,-27,27
Crusaders,2476,1,17,6,7,58,35,23,57
Linfield,2476,2,16,8,6,56,28,28,56
Ballymena,2476,3,16,8,6,68,56,12,56
Coleraine,2476,4,12,12,6,48,35,13,48
Glenavon,2476,5,12,12,6,44,38,6,48
Cliftonville,2476,6,13,4,13,50,48,2,43
Dungannon,2476,7,9,11,10,50,44,6,38
Ards,2476,8,9,4,17,41,56,-15,31
Glentoran,2476,9,7,7,16,28,48,-20,28
Ballinamalla,2476,10,7,5,18,24,53,-29,26
Portadown,2476,11,6,5,19,29,55,-26,23
Cliftonville,2477,1,16,6,8,54,39,15,54
Ballymena,2477,2,15,8,7,67,55,12,53
Glenavon,2477,3,14,8,8,55,40,15,50
Linfield,2477,4,13,9,8,57,36,21,48
Coleraine,2477,5,12,11,7,49,41,8,47
Crusaders,2477,6,13,6,11,44,40,4,45
Dungannon,2477,7,8,10,12,42,42,0,34
Ards,2477,8,9,7,14,38,48,-10,34
Portadown,2477,9,8,7,15,30,47,-17,31
Glentoran,2477,10,7,8,15,25,44,-19,29
Ballinamalla,2477,11,7,6,17,33,62,-29,27
Cliftonville,2478,1,18,5,7,64,38,26,59
Crusaders,2478,2,17,6,7,57,39,18,57
Linfield,2478,3,15,8,7,61,38,23,53
Dungannon,2478,4,13,9,8,56,40,16,48
Ballymena,2478,5,12,6,12,54,62,-8,42
Coleraine,2478,6,10,11,9,40,41,-1,41
Glenavon,2478,7,9,12,9,46,46,0,39
Glentoran,2478,8,9,9,12,27,35,-8,36
Ards,2478,9,8,5,17,39,55,-16,29
Portadown,2478,10,6,7,17,27,50,-23,25
Ballinamalla,2478,11,5,8,17,25,52,-27,23
Cliftonville,2479,1,18,3,9,56,35,21,57
Crusaders,2479,2,16,7,7,55,37,18,55
Linfield,2479,3,15,7,8,54,36,18,52
Glenavon,2479,4,12,12,6,53,41,12,48
Coleraine,2479,5,13,8,9,38,36,2,47
Ballymena,2479,6,13,3,14,56,61,-5,42
Ards,2479,7,12,3,15,37,44,-7,39
Dungannon,2479,8,10,8,12,48,47,1,38
Glentoran,2479,9,11,5,14,30,39,-9,38
Ballinamalla,2479,10,7,7,16,30,49,-19,28
Portadown,2479,11,4,5,21,22,54,-32,17
Cliftonville,2480,1,15,7,8,55,40,15,52
Linfield,2480,2,14,9,7,54,31,23,51
Ballymena,2480,3,15,6,9,51,53,-2,51
Glenavon,2480,4,14,8,8,55,42,13,50
Crusaders,2480,5,13,9,8,52,35,17,48
Coleraine,2480,6,11,9,10,41,41,0,42
Ballinamalla,2480,7,11,6,13,37,44,-7,39
Dungannon,2480,8,7,15,8,48,44,4,36
Ards,2480,9,9,5,16,34,45,-11,32
Glentoran,2480,10,7,7,16,30,58,-28,28
Portadown,2480,11,5,7,18,21,45,-24,22
Linfield,2481,1,20,7,3,69,26,43,67
Cliftonville,2481,2,15,7,8,56,41,15,52
Crusaders,2481,3,15,7,8,54,41,13,52
Glenavon,2481,4,12,12,6,51,39,12,48
Dungannon,2481,5,11,9,10,58,49,9,42
Ballymena,2481,6,11,7,12,58,64,-6,40
Coleraine,2481,7,9,11,10,39,42,-3,38
Glentoran,2481,8,9,8,13,34,45,-11,35
Ballinamalla,2481,9,9,5,16,33,53,-20,32
Ards,2481,10,6,7,17,34,53,-19,25
Portadown,2481,11,6,4,20,23,56,-33,22
Crusaders,2482,1,16,7,7,57,36,21,55
Cliftonville,2482,2,15,8,7,60,41,19,53
Linfield,2482,3,13,9,8,59,33,26,48
Ballymena,2482,4,14,6,10,51,57,-6,48
Dungannon,2482,5,13,7,10,57,48,9,46
Coleraine,2482,6,12,10,8,45,42,3,46
Glenavon,2482,7,11,12,7,49,43,6,45
Glentoran,2482,8,9,4,17,34,56,-22,31
Portadown,2482,9,8,6,16,30,47,-17,30
Ards,2482,10,7,7,16,34,55,-21,28
Ballinamalla,2482,11,7,4,19,33,51,-18,25
Crusaders,2483,1,19,8,3,66,30,36,65
Linfield,2483,2,15,10,5,62,33,29,55
Cliftonville,2483,3,13,6,11,48,45,3,45
Coleraine,2483,4,10,14,6,40,34,6,44
Glenavon,2483,5,11,11,8,50,49,1,44
Ballymena,2483,6,11,9,10,55,58,-3,42
Dungannon,2483,7,10,10,10,50,47,3,40
Glentoran,2483,8,10,8,12,36,42,-6,38
Portadown,2483,9,8,7,15,27,48,-21,31
Ards,2483,10,9,2,19,42,55,-13,29
Ballinamalla,2483,11,4,5,21,22,57,-35,17
Crusaders,2484,1,16,6,8,54,42,12,54
Glenavon,2484,2,14,10,6,49,39,10,52
Ballymena,2484,3,15,6,9,62,65,-3,51
Linfield,2484,4,13,11,6,58,32,26,50
Cliftonville,2484,5,13,7,10,49,42,7,46
Dungannon,2484,6,10,10,10,52,44,8,40
Glentoran,2484,7,11,6,13,41,42,-1,39
Coleraine,2484,8,9,11,10,41,42,-1,38
Ards,2484,9,8,6,16,39,52,-13,30
Portadown,2484,10,7,6,17,26,47,-21,27
Ballinamalla,2484,11,7,5,18,23,47,-24,26
Crusaders,2485,1,17,7,6,59,35,24,58
Linfield,2485,2,14,9,7,59,32,27,51
Coleraine,2485,3,14,9,7,48,35,13,51
Dungannon,2485,4,13,9,8,51,40,11,48
Ballymena,2485,5,14,6,10,62,58,4,48
Cliftonville,2485,6,12,4,14,50,47,3,40
Glenavon,2485,7,10,10,10,48,47,1,40
Portadown,2485,8,10,5,15,23,39,-16,35
Ards,2485,9,8,6,16,32,47,-15,30
Glentoran,2485,10,7,8,15,34,56,-22,29
Ballinamalla,2485,11,8,3,19,30,60,-30,27
Crusaders,2486,1,18,8,4,51,27,24,62
Linfield,2486,2,15,10,5,65,32,33,55
Ballymena,2486,3,16,4,10,62,59,3,52
Cliftonville,2486,4,14,5,11,54,44,10,47
Glenavon,2486,5,10,12,8,45,45,0,42
Dungannon,2486,6,9,11,10,51,45,6,38
Ards,2486,7,9,8,13,44,50,-6,35
Coleraine,2486,8,8,8,14,40,53,-13,32
Glentoran,2486,9,8,8,14,31,46,-15,32
Portadown,2486,10,8,6,16,30,48,-18,30
Ballinamalla,2486,11,7,6,17,31,55,-24,27
Cliftonville,2487,1,17,6,7,59,40,19,57
Crusaders,2487,2,16,8,6,56,34,22,56
Linfield,2487,3,14,10,6,63,39,24,52
Ballymena,2487,4,14,8,8,53,56,-3,50
Glenavon,2487,5,12,9,9,51,44,7,45
Coleraine,2487,6,11,11,8,38,32,6,44
Ards,2487,7,9,6,15,37,47,-10,33
Dungannon,2487,8,8,8,14,47,49,-2,32
Glentoran,2487,9,8,8,14,27,42,-15,32
Portadown,2487,10,7,7,16,25,45,-20,28
Ballinamalla,2487,11,5,7,18,30,58,-28,22
Cliftonville,2488,1,16,5,9,51,34,17,53
Dungannon,2488,2,14,9,7,57,42,15,51
Linfield,2488,3,13,9,8,50,31,19,48
Ballymena,2488,4,14,5,11,59,55,4,47
Crusaders,2488,5,13,7,10,46,36,10,46
Coleraine,2488,6,11,12,7,42,40,2,45
Glenavon,2488,7,10,12,8,52,54,-2,42
Ards,2488,8,9,8,13,37,41,-4,35
Glentoran,2488,9,8,8,14,24,39,-15,32
Ballinamalla,2488,10,9,3,18,32,54,-22,30
Portadown,2488,11,7,4,19,26,50,-24,25
Crusaders,2489,1,19,8,3,61,28,33,65
Ballymena,2489,2,15,6,9,61,55,6,51
Linfield,2489,3,12,10,8,51,36,15,46
Cliftonville,2489,4,13,5,12,49,41,8,44
Glenavon,2489,5,10,13,7,47,48,-1,43
Portadown,2489,6,12,5,13,39,45,-6,41
Coleraine,2489,7,10,9,11,38,38,0,39
Ards,2489,8,10,6,14,38,45,-7,36
Glentoran,2489,9,9,9,12,31,43,-12,36
Dungannon,2489,10,8,8,14,46,49,-3,32
Ballinamalla,2489,11,5,5,20,24,57,-33,20
Linfield,2490,1,17,9,4,60,27,33,60
Cliftonville,2490,2,17,6,7,57,41,16,57
Crusaders,2490,3,15,7,8,53,39,14,52
Coleraine,2490,4,12,11,7,44,42,2,47
Ballymena,2490,5,12,7,11,59,62,-3,43
Glenavon,2490,6,9,11,10,43,50,-7,38
Glentoran,2490,7,10,7,13,37,44,-7,37
Ards,2490,8,9,5,16,36,46,-10,32
Portadown,2490,9,9,5,16,30,51,-21,32
Dungannon,2490,10,7,7,16,44,46,-2,28
Ballinamalla,2490,11,7,7,16,33,48,-15,28
Crusaders,2491,1,17,7,6,48,32,16,58
Coleraine,2491,2,15,8,7,44,29,15,53
Ballymena,2491,3,15,6,9,57,55,2,51
Linfield,2491,4,14,8,8,56,37,19,50
Cliftonville,2491,5,14,5,11,52,35,17,47
Dungannon,2491,6,12,9,9,53,37,16,45
Glenavon,2491,7,8,13,9,41,45,-4,37
Glentoran,2491,8,9,6,15,28,43,-15,33
Ards,2491,9,9,4,17,36,49,-13,31
Portadown,2491,10,6,9,15,19,46,-27,27
Ballinamalla,2491,11,6,5,19,28,54,-26,23
Crusaders,2492,1,15,8,7,48,32,16,53
Cliftonville,2492,2,16,4,10,52,39,13,52
Linfield,2492,3,14,8,8,55,30,25,50
Ballymena,2492,4,15,5,10,55,58,-3,50
Dungannon,2492,5,12,8,10,54,39,15,44
Coleraine,2492,6,10,14,6,43,38,5,44
Glenavon,2492,7,10,11,9,45,44,1,41
Glentoran,2492,8,8,9,13,26,43,-17,33
Ards,2492,9,9,5,16,33,48,-15,32
Ballinamalla,2492,10,8,4,18,27,49,-22,28
Portadown,2492,11,7,6,17,25,43,-18,27
Cliftonville,2493,1,16,7,7,54,34,20,55
Crusaders,2493,2,15,9,6,59,38,21,54
Glenavon,2493,3,12,13,5,46,40,6,49
Linfield,2493,4,11,9,10,50,34,16,42
Ballymena,2493,5,12,6,12,50,60,-10,42
Coleraine,2493,6,10,11,9,41,36,5,41
Dungannon,2493,7,10,9,11,51,43,8,39
Portadown,2493,8,10,6,14,31,42,-11,36
Ards,2493,9,9,5,16,39,50,-11,32
Glentoran,2493,10,7,9,14,24,45,-21,30
Ballinamalla,2493,11,8,6,16,28,51,-23,30
Cliftonville,2494,1,18,4,8,58,38,20,58
Crusaders,2494,2,14,7,9,53,46,7,49
Ballymena,2494,3,14,7,9,58,56,2,49
Linfield,2494,4,13,9,8,58,33,25,48
Coleraine,2494,5,12,12,6,44,36,8,48
Glenavon,2494,6,12,10,8,50,45,5,46
Dungannon,2494,7,10,10,10,55,48,7,40
Ards,2494,8,8,9,13,34,46,-12,33
Portadown,2494,9,8,5,17,24,42,-18,29
Ballinamalla,2494,10,7,5,18,32,57,-25,26
Glentoran,2494,11,5,10,15,27,46,-19,25
Linfield,2495,1,15,10,5,60,31,29,55
Cliftonville,2495,2,16,5,9,50,40,10,53
Crusaders,2495,3,14,10,6,54,39,15,52
Ballymena,2495,4,14,9,7,60,51,9,51
Dungannon,2495,5,11,8,11,54,43,11,41
Coleraine,2495,6,9,11,10,35,37,-2,38
Glenavon,2495,7,9,10,11,41,47,-6,37
Ballinamalla,2495,8,10,4,16,31,46,-15,34
Glentoran,2495,9,9,7,14,29,44,-15,34
Ards,2495,10,9,6,15,38,47,-9,33
Portadown,2495,11,6,6,18,23,50,-27,24
Crusaders,2496,1,19,7,4,61,31,30,64
Linfield,2496,2,14,9,7,61,38,23,51
Cliftonville,2496,3,16,3,11,56,41,15,51
Ballymena,2496,4,14,8,8,50,49,1,50
Coleraine,2496,5,10,12,8,49,38,11,42
Dungannon,2496,6,11,8,11,51,44,7,41
Glenavon,2496,7,9,10,11,46,55,-9,37
Glentoran,2496,8,8,9,13,31,43,-12,33
Ballinamalla,2496,9,8,6,16,30,49,-19,30
Portadown,2496,10,9,3,18,25,49,-24,30
Ards,2496,11,7,5,18,32,55,-23,26
Glenavon,2497,1,15,8,7,55,45,10,53
Coleraine,2497,2,14,10,6,47,33,14,52
Cliftonville,2497,3,15,7,8,53,41,12,52
Crusaders,2497,4,14,7,9,46,35,11,49
Linfield,2497,5,13,9,8,55,33,22,48
Ballymena,2497,6,11,8,11,57,65,-8,41
Ards,2497,7,11,3,16,43,45,-2,36
Glentoran,2497,8,9,9,12,31,40,-9,36
Dungannon,2497,9,7,10,13,40,49,-9,31
Portadown,2497,10,8,5,17,29,48,-19,29
Ballinamalla,2497,11,7,6,17,40,62,-22,27
Linfield,2498,1,16,9,5,66,29,37,57
Cliftonville,2498,2,17,6,7,59,38,21,57
Crusaders,2498,3,13,10,7,53,44,9,49
Coleraine,2498,4,12,11,7,45,38,7,47
Glenavon,2498,5,11,12,7,51,44,7,45
Ballymena,2498,6,12,7,11,63,66,-3,43
Glentoran,2498,7,12,6,12,34,40,-6,42
Dungannon,2498,8,7,12,11,49,53,-4,33
Ards,2498,9,9,4,17,38,56,-18,31
Ballinamalla,2498,10,7,5,18,34,54,-20,26
Portadown,2498,11,6,4,20,29,59,-30,22
Crusaders,2499,1,18,8,4,60,31,29,62
Linfield,2499,2,16,11,3,63,29,34,59
Cliftonville,2499,3,16,5,9,58,41,17,53
Coleraine,2499,4,13,10,7,41,31,10,49
Ballymena,2499,5,14,7,9,52,53,-1,49
Glenavon,2499,6,11,9,10,45,48,-3,42
Dungannon,2499,7,7,11,12,50,49,1,32
Portadown,2499,8,7,8,15,24,45,-21,29
Ards,2499,9,7,6,17,34,51,-17,27
Ballinamalla,2499,10,7,4,19,27,54,-27,25
Glentoran,2499,11,5,9,16,23,45,-22,24
Glenavon,2500,1,16,9,5,56,37,19,57
Crusaders,2500,2,15,9,6,51,29,22,54
Ballymena,2500,3,15,6,9,57,52,5,51
Cliftonville,2500,4,14,6,10,46,36,10,48
Linfield,2500,5,10,11,9,44,34,10,41
Glentoran,2500,6,11,7,12,29,37,-8,40
Dungannon,2500,7,9,11,10,43,43,0,38
Ards,2500,8,11,4,15,45,51,-6,37
Coleraine,2500,9,8,11,11,35,43,-8,35
Ballinamalla,2500,10,9,5,16,28,47,-19,32
Portadown,2500,11,6,3,21,23,48,-25,21
Cliftonville,2501,1,16,6,8,57,37,20,54
Crusaders,2501,2,14,10,6,47,27,20,52
Ballymena,2501,3,15,7,8,61,53,8,52
Linfield,2501,4,12,12,6,62,38,24,48
Coleraine,2501,5,11,11,8,41,46,-5,44
Glenavon,2501,6,10,11,9,41,44,-3,41
Dungannon,2501,7,8,11,11,42,40,2,35
Ards,2501,8,10,5,15,42,47,-5,35
Glentoran,2501,9,7,10,13,31,45,-14,31
Ballinamalla,2501,10,7,7,16,26,51,-25,28
Portadown,2501,11,6,8,16,28,50,-22,26
Cliftonville,2502,1,16,6,8,58,36,22,54
Crusaders,2502,2,15,9,6,49,27,22,54
Ballymena,2502,3,15,7,8,62,57,5,52
Linfield,2502,4,14,9,7,53,33,20,51
Dungannon,2502,5,11,10,9,48,36,12,43
Coleraine,2502,6,10,12,8,42,37,5,42
Glenavon,2502,7,10,11,9,47,51,-4,41
Glentoran,2502,8,8,7,15,29,48,-19,31
Ards,2502,9,8,5,17,29,47,-18,29
Ballinamalla,2502,10,8,4,18,27,47,-20,28
Portadown,2502,11,8,4,18,23,48,-25,28
Cliftonville,2503,1,15,6,9,50,38,12,51
Dungannon,2503,2,14,8,8,57,35,22,50
Crusaders,2503,3,14,8,8,52,37,15,50
Linfield,2503,4,13,10,7,54,30,24,49
Ballymena,2503,5,12,7,11,54,61,-7,43
Glenavon,2503,6,11,8,11,44,48,-4,41
Coleraine,2503,7,10,10,10,38,38,0,40
Portadown,2503,8,10,6,14,26,40,-14,36
Ards,2503,9,10,4,16,37,48,-11,34
Glentoran,2503,10,8,7,15,29,47,-18,31
Ballinamalla,2503,11,9,4,17,34,53,-19,31
Cliftonville,2504,1,18,2,10,55,34,21,56
Linfield,2504,2,15,9,6,62,28,34,54
Crusaders,2504,3,15,8,7,57,40,17,53
Ballymena,2504,4,15,4,11,63,62,1,49
Glentoran,2504,5,12,8,10,41,42,-1,44
Coleraine,2504,6,10,10,10,46,48,-2,40
Glenavon,2504,7,10,9,11,46,54,-8,39
Dungannon,2504,8,9,11,10,52,51,1,38
Ards,2504,9,10,3,17,42,52,-10,33
Ballinamalla,2504,10,7,6,17,35,57,-22,27
Portadown,2504,11,6,6,18,30,61,-31,24
Crusaders,2505,1,17,8,5,52,32,20,59
Linfield,2505,2,13,11,6,51,27,24,50
Ballymena,2505,3,14,5,11,60,54,6,47
Cliftonville,2505,4,13,6,11,48,40,8,45
Coleraine,2505,5,11,11,8,39,35,4,44
Dungannon,2505,6,10,10,10,46,39,7,40
Glentoran,2505,7,11,6,13,36,42,-6,39
Glenavon,2505,8,8,12,10,41,46,-5,36
Ballinamalla,2505,9,9,7,14,30,50,-20,34
Ards,2505,10,8,9,13,33,43,-10,33
Portadown,2505,11,5,7,18,26,54,-28,22
Linfield,2506,1,19,7,4,69,30,39,64
Crusaders,2506,2,16,8,6,54,30,24,56
Cliftonville,2506,3,17,4,9,60,42,18,55
Glenavon,2506,4,11,10,9,41,44,-3,43
Ballymena,2506,5,11,8,11,54,60,-6,41
Dungannon,2506,6,9,9,12,48,47,1,36
Coleraine,2506,7,8,12,10,42,45,-3,36
Ballinamalla,2506,8,9,5,16,33,49,-16,32
Ards,2506,9,8,6,16,36,51,-15,30
Portadown,2506,10,8,6,16,29,48,-19,30
Glentoran,2506,11,6,11,13,23,43,-20,29
Linfield,2507,1,15,10,5,59,28,31,55
Crusaders,2507,2,14,9,7,54,43,11,51
Cliftonville,2507,3,13,8,9,50,37,13,47
Ballymena,2507,4,14,5,11,59,63,-4,47
Glenavon,2507,5,11,11,8,51,46,5,44
Dungannon,2507,6,9,12,9,54,46,8,39
Glentoran,2507,7,10,9,11,30,37,-7,39
Coleraine,2507,8,8,11,11,47,50,-3,35
Ards,2507,9,8,7,15,39,55,-16,31
Ballinamalla,2507,10,9,4,17,31,50,-19,31
Portadown,2507,11,7,8,15,27,46,-19,29
Linfield,2508,1,17,6,7,61,29,32,57
Cliftonville,2508,2,16,5,9,57,41,16,53
Crusaders,2508,3,15,8,7,56,43,13,53
Glenavon,2508,4,14,10,6,57,39,18,52
Ballymena,2508,5,13,8,9,56,55,1,47
Dungannon,2508,6,9,14,7,50,41,9,41
Coleraine,2508,7,7,14,9,36,39,-3,35
Glentoran,2508,8,9,6,15,32,50,-18,33
Portadown,2508,9,9,5,16,31,50,-19,32
Ards,2508,10,8,5,17,36,52,-16,29
Ballinamalla,2508,11,5,5,20,29,62,-33,20
Linfield,2509,1,16,10,4,66,24,42,58
Cliftonville,2509,2,16,6,8,55,40,15,54
Crusaders,2509,3,15,8,7,53,42,11,53
Glenavon,2509,4,13,10,7,60,42,18,49
Ballymena,2509,5,13,6,11,53,59,-6,45
Coleraine,2509,6,11,10,9,42,48,-6,43
Glentoran,2509,7,11,7,12,35,40,-5,40
Dungannon,2509,8,8,11,11,48,46,2,35
Ards,2509,9,8,7,15,36,50,-14,31
Portadown,2509,10,8,4,18,25,48,-23,28
Ballinamalla,2509,11,5,3,22,23,57,-34,18
Crusaders,2510,1,18,8,4,64,35,29,62
Linfield,2510,2,16,8,6,66,33,33,56
Ballymena,2510,3,15,6,9,66,60,6,51
Cliftonville,2510,4,15,5,10,50,40,10,50
Coleraine,2510,5,14,8,8,41,38,3,50
Glenavon,2510,6,10,10,10,48,46,2,40
Dungannon,2510,7,10,9,11,51,43,8,39
Portadown,2510,8,8,6,16,29,46,-17,30
Glentoran,2510,9,6,11,13,23,44,-21,29
Ards,2510,10,7,5,18,30,50,-20,26
Ballinamalla,2510,11,6,4,20,23,56,-33,22
Cliftonville,2511,1,21,3,6,65,34,31,66
Crusaders,2511,2,14,9,7,52,39,13,51
Ballymena,2511,3,14,7,9,56,56,0,49
Linfield,2511,4,13,9,8,61,43,18,48
Glenavon,2511,5,12,11,7,56,44,12,47
Coleraine,2511,6,12,11,7,48,36,12,47
Dungannon,2511,7,9,11,10,46,42,4,38
Portadown,2511,8,7,9,14,25,44,-19,30
Ballinamalla,2511,9,6,7,17,25,53,-28,25
Glentoran,2511,10,5,9,16,23,46,-23,24
Ards,2511,11,5,8,17,32,52,-20,23
Crusaders,2512,1,20,7,3,55,23,32,67
Glenavon,2512,2,15,9,6,54,42,12,54
Ballymena,2512,3,14,7,9,62,58,4,49
Coleraine,2512,4,12,12,6,38,30,8,48
Linfield,2512,5,11,9,10,51,41,10,42
Cliftonville,2512,6,11,9,10,45,42,3,42
Dungannon,2512,7,9,10,11,51,44,7,37
Ards,2512,8,9,6,15,38,48,-10,33
Ballinamalla,2512,9,9,3,18,36,59,-23,30
Glentoran,2512,10,6,8,16,31,54,-23,26
Portadown,2512,11,6,6,18,24,44,-20,24
Crusaders,2513,1,16,10,4,52,29,23,58
Cliftonville,2513,2,15,4,11,56,43,13,49
Linfield,2513,3,13,9,8,55,34,21,48
Ards,2513,4,13,6,11,47,49,-2,45
Ballymena,2513,5,12,7,11,54,52,2,43
Dungannon,2513,6,10,12,8,48,39,9,42
Coleraine,2513,7,9,10,11,33,40,-7,37
Glentoran,2513,8,9,7,14,31,43,-12,34
Glenavon,2513,9,8,9,13,42,48,-6,33
Portadown,2513,10,9,5,16,27,46,-19,32
Ballinamalla,2513,11,8,7,15,28,50,-22,31
Cliftonville,2514,1,16,5,9,55,42,13,53
Crusaders,2514,2,15,7,8,59,40,19,52
Linfield,2514,3,14,9,7,61,31,30,51
Glenavon,2514,4,13,8,9,53,45,8,47
Coleraine,2514,5,12,11,7,47,41,6,47
Ballymena,2514,6,13,4,13,53,64,-11,43
Dungannon,2514,7,10,9,11,49,45,4,39
Glentoran,2514,8,9,6,15,30,49,-19,33
Ards,2514,9,9,5,16,32,47,-15,32
Ballinamalla,2514,10,9,4,17,29,48,-19,31
Portadown,2514,11,8,6,16,31,47,-16,30
Crusaders,2515,1,14,10,6,53,40,13,52
Dungannon,2515,2,14,9,7,65,38,27,51
Linfield,2515,3,13,11,6,64,34,30,50
Coleraine,2515,4,14,8,8,51,40,11,50
Ards,2515,5,13,5,12,51,51,0,44
Glenavon,2515,6,11,10,9,50,46,4,43
Ballymena,2515,7,12,6,12,44,61,-17,42
Cliftonville,2515,8,11,5,14,45,51,-6,38
Glentoran,2515,9,8,6,16,32,49,-17,30
Portadown,2515,10,8,6,16,25,46,-21,30
Ballinamalla,2515,11,7,4,19,28,52,-24,25
Crusaders,2516,1,17,6,7,55,34,21,57
Linfield,2516,2,15,8,7,64,34,30,53
Ballymena,2516,3,16,4,10,67,60,7,52
Cliftonville,2516,4,15,6,9,51,33,18,51
Coleraine,2516,5,13,9,8,44,40,4,48
Glenavon,2516,6,11,11,8,44,46,-2,44
Dungannon,2516,7,10,8,12,60,49,11,38
Glentoran,2516,8,10,7,13,34,43,-9,37
Ards,2516,9,10,5,15,39,51,-12,35
Portadown,2516,10,7,4,19,25,58,-33,25
Ballinamalla,2516,11,6,2,22,24,59,-35,20
Cliftonville,2517,1,15,7,8,59,37,22,52
Linfield,2517,2,14,8,8,56,31,25,50
Crusaders,2517,3,14,7,9,48,34,14,49
Ballymena,2517,4,15,4,11,56,49,7,49
Glenavon,2517,5,11,11,8,41,42,-1,44
Coleraine,2517,6,11,10,9,41,39,2,43
Dungannon,2517,7,9,8,13,43,44,-1,35
Portadown,2517,8,9,8,13,26,43,-17,35
Ballinamalla,2517,9,10,4,16,31,47,-16,34
Ards,2517,10,9,6,15,40,56,-16,33
Glentoran,2517,11,8,7,15,28,47,-19,31
Cliftonville,2518,1,17,6,7,64,36,28,57
Crusaders,2518,2,15,6,9,56,45,11,51
Coleraine,2518,3,13,10,7,38,30,8,49
Linfield,2518,4,13,9,8,57,37,20,48
Dungannon,2518,5,13,8,9,61,45,16,47
Ballymena,2518,6,12,9,9,50,53,-3,45
Glenavon,2518,7,12,8,10,47,47,0,44
Ards,2518,8,11,4,15,40,51,-11,37
Glentoran,2518,9,7,8,15,29,45,-16,29
Ballinamalla,2518,10,8,5,17,30,52,-22,29
Portadown,2518,11,5,5,20,20,51,-31,20
Cliftonville,2519,1,18,3,9,58,39,19,57
Linfield,2519,2,14,10,6,59,33,26,52
Crusaders,2519,3,14,6,10,57,49,8,48
Glenavon,2519,4,12,11,7,50,45,5,47
Coleraine,2519,5,11,13,6,41,34,7,46
Ards,2519,6,11,6,13,40,41,-1,39
Ballymena,2519,7,10,9,11,56,65,-9,39
Dungannon,2519,8,9,8,13,48,46,2,35
Glentoran,2519,9,8,7,15,26,48,-22,31
Portadown,2519,10,8,6,16,33,50,-17,30
Ballinamalla,2519,11,9,3,18,38,56,-18,30
Cliftonville,2520,1,19,3,8,63,37,26,60
Crusaders,2520,2,18,6,6,58,32,26,60
Linfield,2520,3,17,8,5,72,35,37,59
Coleraine,2520,4,13,8,9,43,38,5,47
Ballymena,2520,5,14,4,12,58,52,6,46
Glentoran,2520,6,12,6,12,30,40,-10,42
Dungannon,2520,7,10,10,10,50,46,4,40
Glenavon,2520,8,9,11,10,42,49,-7,38
Ards,2520,9,6,7,17,34,54,-20,25
Ballinamalla,2520,10,7,2,21,30,64,-34,23
Portadown,2520,11,6,3,21,21,54,-33,21
Linfield,2521,1,16,9,5,57,29,28,57
Crusaders,2521,2,16,8,6,58,35,23,56
Ballymena,2521,3,14,8,8,57,54,3,50
Cliftonville,2521,4,13,8,9,48,41,7,47
Coleraine,2521,5,10,13,7,44,35,9,43
Dungannon,2521,6,11,9,10,48,49,-1,42
Glenavon,2521,7,9,13,8,48,43,5,40
Glentoran,2521,8,8,9,13,30,45,-15,33
Ards,2521,9,8,7,15,34,44,-10,31
Portadown,2521,10,8,4,18,32,48,-16,28
Ballinamalla,2521,11,5,6,19,22,55,-33,21
Crusaders,2522,1,18,7,5,63,36,27,61
Linfield,2522,2,15,8,7,64,37,27,53
Glenavon,2522,3,13,10,7,54,42,12,49
Ballymena,2522,4,14,6,10,62,59,3,48
Cliftonville,2522,5,13,5,12,45,44,1,44
Coleraine,2522,6,11,10,9,45,45,0,43
Glentoran,2522,7,9,10,11,28,40,-12,37
Dungannon,2522,8,8,10,12,52,48,4,34
Portadown,2522,9,9,5,16,25,46,-21,32
Ballinamalla,2522,10,8,5,17,30,54,-24,29
Ards,2522,11,6,6,18,36,53,-17,24
Crusaders,2523,1,18,8,4,54,28,26,62
Coleraine,2523,2,16,8,6,52,33,19,56
Linfield,2523,3,16,6,8,65,31,34,54
Cliftonville,2523,4,15,5,10,51,38,13,50
Glenavon,2523,5,10,13,7,46,45,1,43
Glentoran,2523,6,12,6,12,35,41,-6,42
Ballymena,2523,7,12,5,13,57,68,-11,41
Dungannon,2523,8,7,10,13,47,50,-3,31
Ballinamalla,2523,9,8,6,16,33,53,-20,30
Portadown,2523,10,7,4,19,25,52,-27,25
Ards,2523,11,7,3,20,37,63,-26,24
Linfield,2524,1,15,8,7,60,35,25,53
Glenavon,2524,2,12,11,7,52,45,7,47
Crusaders,2524,3,13,7,10,48,41,7,46
Coleraine,2524,4,11,12,7,44,37,7,45
Cliftonville,2524,5,12,8,10,53,43,10,44
Ballymena,2524,6,12,6,12,54,57,-3,42
Ards,2524,7,11,5,14,36,48,-12,38
Dungannon,2524,8,10,7,13,50,48,2,37
Portadown,2524,9,11,4,15,33,47,-14,37
Glentoran,2524,10,9,8,13,32,43,-11,35
Ballinamalla,2524,11,9,4,17,35,53,-18,31
Linfield,2525,1,15,10,5,59,28,31,55
Crusaders,2525,2,14,9,7,46,34,12,51
Dungannon,2525,3,13,8,9,62,39,23,47
Ballymena,2525,4,14,5,11,52,57,-5,47
Cliftonville,2525,5,14,4,12,47,36,11,46
Coleraine,2525,6,12,9,9,42,39,3,45
Glenavon,2525,7,11,10,9,45,46,-1,43
Glentoran,2525,8,10,8,12,31,42,-11,38
Ards,2525,9,8,5,17,31,50,-19,29
Portadown,2525,10,8,5,17,27,48,-21,29
Ballinamalla,2525,11,7,5,18,26,49,-23,26
Crusaders,2526,1,16,6,8,55,33,22,54
Ballymena,2526,2,16,5,9,61,55,6,53
Linfield,2526,3,14,10,6,64,38,26,52
Cliftonville,2526,4,15,4,11,49,42,7,49
Coleraine,2526,5,13,9,8,43,39,4,48
Dungannon,2526,6,13,8,9,54,38,16,47
Glenavon,2526,7,11,11,8,53,51,2,44
Ballinamalla,2526,8,10,7,13,30,43,-13,37
Glentoran,2526,9,8,5,17,25,44,-19,29
Ards,2526,10,6,6,18,37,58,-21,24
Portadown,2526,11,5,5,20,23,53,-30,20
Dungannon,2527,1,15,8,7,59,40,19,53
Ballymena,2527,2,15,7,8,58,52,6,52
Cliftonville,2527,3,15,5,10,54,43,11,50
Crusaders,2527,4,14,7,9,54,36,18,49
Linfield,2527,5,13,9,8,59,39,20,48
Coleraine,2527,6,11,7,12,40,45,-5,40
Glenavon,2527,7,10,8,12,43,49,-6,38
Ards,2527,8,10,7,13,38,50,-12,37
Portadown,2527,9,10,5,15,31,44,-13,35
Ballinamalla,2527,10,8,5,17,34,53,-19,29
Glentoran,2527,11,6,8,16,30,49,-19,26
Cliftonville,2528,1,18,2,10,59,49,10,56
Crusaders,2528,2,15,10,5,58,35,23,55
Linfield,2528,3,14,10,6,57,29,28,52
Dungannon,2528,4,11,11,8,54,43,11,44
Coleraine,2528,5,12,8,10,39,35,4,44
Glenavon,2528,6,11,10,9,41,40,1,43
Glentoran,2528,7,11,7,12,40,46,-6,40
Ballymena,2528,8,10,5,15,54,69,-15,35
Portadown,2528,9,9,5,16,28,43,-15,32
Ballinamalla,2528,10,7,7,16,32,53,-21,28
Ards,2528,11,6,7,17,34,54,-20,25
Crusaders,2529,1,19,5,6,66,40,26,62
Ballymena,2529,2,15,6,9,57,57,0,51
Cliftonville,2529,3,15,5,10,49,38,11,50
Linfield,2529,4,13,8,9,53,34,19,47
Dungannon,2529,5,13,7,10,49,41,8,46
Glenavon,2529,6,12,9,9,51,39,12,45
Coleraine,2529,7,10,9,11,34,35,-1,39
Glentoran,2529,8,10,6,14,31,47,-16,36
Ards,2529,9,10,3,17,37,50,-13,33
Ballinamalla,2529,10,8,3,19,29,48,-19,27
Portadown,2529,11,6,7,17,20,47,-27,25
Crusaders,2530,1,17,8,5,58,31,27,59
Linfield,2530,2,16,9,5,67,27,40,57
Cliftonville,2530,3,17,5,8,57,42,15,56
Dungannon,2530,4,13,7,10,50,45,5,46
Ballymena,2530,5,14,4,12,60,56,4,46
Glenavon,2530,6,10,12,8,45,40,5,42
Coleraine,2530,7,10,12,8,39,42,-3,42
Glentoran,2530,8,9,7,14,28,50,-22,34
Ards,2530,9,7,5,18,34,52,-18,26
Portadown,2530,10,7,5,18,27,53,-26,26
Ballinamalla,2530,11,6,4,20,28,55,-27,22
Crusaders,2531,1,18,6,6,53,30,23,60
Cliftonville,2531,2,17,2,11,54,43,11,53
Coleraine,2531,3,12,10,8,43,36,7,46
Ballymena,2531,4,14,4,12,63,59,4,46
Linfield,2531,5,11,10,9,53,36,17,43
Glenavon,2531,6,11,9,10,48,42,6,42
Glentoran,2531,7,12,6,12,34,42,-8,42
Dungannon,2531,8,9,9,12,49,49,0,36
Ballinamalla,2531,9,9,5,16,28,47,-19,32
Ards,2531,10,7,8,15,31,47,-16,29
Portadown,2531,11,8,5,17,20,45,-25,29
Cliftonville,2532,1,17,6,7,64,41,23,57
Linfield,2532,2,13,11,6,62,34,28,50
Crusaders,2532,3,14,8,8,51,39,12,50
Coleraine,2532,4,13,11,6,50,39,11,50
Ballymena,2532,5,13,6,11,58,62,-4,45
Ards,2532,6,12,3,15,36,45,-9,39
Dungannon,2532,7,9,11,10,48,41,7,38
Glentoran,2532,8,11,5,14,35,46,-11,38
Glenavon,2532,9,8,12,10,42,45,-3,36
Ballinamalla,2532,10,7,5,18,25,54,-29,26
Portadown,2532,11,6,6,18,22,47,-25,24
Crusaders,2533,1,18,8,4,61,32,29,62
Glenavon,2533,2,15,10,5,61,40,21,55
Coleraine,2533,3,13,9,8,46,35,11,48
Ballymena,2533,4,14,4,12,58,59,-1,46
Linfield,2533,5,12,9,9,56,33,23,45
Cliftonville,2533,6,13,5,12,53,49,4,44
Dungannon,2533,7,12,7,11,47,42,5,43
Glentoran,2533,8,9,9,12,33,46,-13,36
Ballinamalla,2533,9,9,6,15,30,48,-18,33
Ards,2533,10,6,6,18,34,57,-23,24
Portadown,2533,11,5,5,20,19,57,-38,20
Ballymena,2534,1,18,4,8,65,54,11,58
Linfield,2534,2,15,10,5,60,30,30,55
Crusaders,2534,3,15,7,8,53,46,7,52
Cliftonville,2534,4,13,7,10,50,38,12,46
Glenavon,2534,5,10,13,7,49,46,3,43
Dungannon,2534,6,11,9,10,55,42,13,42
Coleraine,2534,7,11,9,10,41,46,-5,42
Portadown,2534,8,8,5,17,30,46,-16,29
Ballinamalla,2534,9,8,5,17,32,50,-18,29
Glentoran,2534,10,7,8,15,36,55,-19,29
Ards,2534,11,7,7,16,37,55,-18,28
Crusaders,2535,1,15,8,7,54,39,15,53
Cliftonville,2535,2,14,7,9,49,38,11,49
Glenavon,2535,3,11,13,6,48,44,4,46
Ballymena,2535,4,13,7,10,53,53,0,46
Linfield,2535,5,11,9,10,49,31,18,42
Ards,2535,6,12,5,13,51,48,3,41
Coleraine,2535,7,10,11,9,45,46,-1,41
Glentoran,2535,8,11,7,12,36,43,-7,40
Dungannon,2535,9,6,13,11,43,41,2,31
Portadown,2535,10,8,6,16,23,44,-21,30
Ballinamalla,2535,11,7,8,15,25,49,-24,29
Linfield,2536,1,18,7,5,75,34,41,61
Cliftonville,2536,2,16,6,8,55,37,18,54
Crusaders,2536,3,14,9,7,55,36,19,51
Coleraine,2536,4,11,14,5,47,34,13,47
Ballymena,2536,5,11,9,10,51,57,-6,42
Dungannon,2536,6,9,12,9,52,45,7,39
Glenavon,2536,7,9,12,9,45,52,-7,39
Glentoran,2536,8,7,10,13,27,44,-17,31
Ballinamalla,2536,9,7,7,16,28,50,-22,28
Portadown,2536,10,6,9,15,22,46,-24,27
Ards,2536,11,6,7,17,33,55,-22,25
Cliftonville,2537,1,16,5,9,56,39,17,53
Crusaders,2537,2,14,8,8,52,33,19,50
Linfield,2537,3,14,7,9,59,37,22,49
Ballymena,2537,4,15,4,11,59,58,1,49
Coleraine,2537,5,12,10,8,43,39,4,46
Dungannon,2537,6,11,9,10,52,44,8,42
Glenavon,2537,7,9,12,9,49,48,1,39
Glentoran,2537,8,9,9,12,33,42,-9,36
Ballinamalla,2537,9,10,6,14,36,49,-13,36
Portadown,2537,10,9,6,15,31,47,-16,33
Ards,2537,11,6,4,20,29,63,-34,22
Linfield,2538,1,16,9,5,60,31,29,57
Cliftonville,2538,2,17,4,9,54,37,17,55
Crusaders,2538,3,16,6,8,51,35,16,54
Dungannon,2538,4,14,8,8,55,38,17,50
Ballymena,2538,5,13,6,11,65,60,5,45
Glenavon,2538,6,12,8,10,45,44,1,44
Ards,2538,7,10,6,14,37,44,-7,36
Coleraine,2538,8,8,11,11,37,38,-1,35
Glentoran,2538,9,8,10,12,28,43,-15,34
Ballinamalla,2538,10,7,5,18,33,62,-29,26
Portadown,2538,11,5,5,20,24,57,-33,20
Crusaders,2539,1,18,7,5,63,32,31,61
Cliftonville,2539,2,16,5,9,57,37,20,53
Linfield,2539,3,15,7,8,53,31,22,52
Coleraine,2539,4,13,12,5,44,33,11,51
Ballymena,2539,5,13,7,10,50,55,-5,46
Dungannon,2539,6,10,9,11,49,47,2,39
Portadown,2539,7,10,5,15,28,44,-16,35
Ballinamalla,2539,8,9,5,16,32,55,-23,32
Glenavon,2539,9,6,12,12,39,49,-10,30
Glentoran,2539,10,7,9,14,32,43,-11,30
Ards,2539,11,6,6,18,32,53,-21,24
Crusaders,2540,1,15,9,6,51,28,23,54
Ballymena,2540,2,16,6,8,57,49,8,54
Cliftonville,2540,3,15,6,9,57,41,16,51
Coleraine,2540,4,13,10,7,43,34,9,49
Linfield,2540,5,13,9,8,55,33,22,48
Glenavon,2540,6,9,12,9,45,43,2,39
Ards,2540,7,10,5,15,32,45,-13,35
Glentoran,2540,8,9,8,13,27,41,-14,35
Dungannon,2540,9,8,10,12,40,43,-3,34
Portadown,2540,10,8,7,15,31,51,-20,31
Ballinamalla,2540,11,6,4,20,26,56,-30,22
Ballymena,2541,1,17,6,7,61,49,12,57
Crusaders,2541,2,15,11,4,51,29,22,56
Linfield,2541,3,12,12,6,59,33,26,48
Coleraine,2541,4,11,13,6,44,36,8,46
Dungannon,2541,5,12,8,10,50,40,10,44
Cliftonville,2541,6,12,7,11,52,43,9,43
Glenavon,2541,7,10,10,10,50,52,-2,40
Ards,2541,8,10,5,15,35,49,-14,35
Portadown,2541,9,8,7,15,27,41,-14,31
Ballinamalla,2541,10,7,4,19,29,57,-28,25
Glentoran,2541,11,5,9,16,22,51,-29,24
Ballymena,2542,1,17,6,7,60,52,8,57
Crusaders,2542,2,16,7,7,62,43,19,55
Coleraine,2542,3,12,13,5,47,33,14,49
Linfield,2542,4,12,11,7,63,34,29,47
Cliftonville,2542,5,14,4,12,46,40,6,46
Dungannon,2542,6,11,9,10,56,50,6,42
Glenavon,2542,7,9,13,8,47,50,-3,40
Ballinamalla,2542,8,11,3,16,39,56,-17,36
Ards,2542,9,10,5,15,50,52,-2,35
Glentoran,2542,10,7,6,17,28,57,-29,27
Portadown,2542,11,5,5,20,19,50,-31,20
Crusaders,2543,1,18,8,4,50,24,26,62
Linfield,2543,2,15,8,7,61,34,27,53
Ballymena,2543,3,15,6,9,62,56,6,51
Coleraine,2543,4,13,9,8,50,42,8,48
Cliftonville,2543,5,14,4,12,47,37,10,46
Glenavon,2543,6,12,7,11,48,48,0,43
Glentoran,2543,7,11,10,9,27,36,-9,43
Dungannon,2543,8,9,9,12,46,53,-7,36
Portadown,2543,9,8,6,16,23,41,-18,30
Ballinamalla,2543,10,8,2,20,35,56,-21,26
Ards,2543,11,6,3,21,35,57,-22,21
Crusaders,2544,1,17,8,5,60,37,23,59
Linfield,2544,2,14,8,8,55,36,19,50
Coleraine,2544,3,13,9,8,38,31,7,48
Cliftonville,2544,4,14,6,10,50,45,5,48
Ballymena,2544,5,13,6,11,64,56,8,45
Dungannon,2544,6,11,9,10,55,52,3,42
Glenavon,2544,7,8,11,11,47,53,-6,35
Ards,2544,8,11,2,17,42,48,-6,35
Portadown,2544,9,9,8,13,29,44,-15,35
Glentoran,2544,10,8,7,15,30,46,-16,31
Ballinamalla,2544,11,7,6,17,32,54,-22,27
Crusaders,2545,1,16,8,6,56,35,21,56
Linfield,2545,2,15,8,7,53,34,19,53
Ballymena,2545,3,14,7,9,57,56,1,49
Glenavon,2545,4,12,9,9,52,46,6,45
Cliftonville,2545,5,13,6,11,44,43,1,45
Dungannon,2545,6,10,10,10,49,43,6,40
Coleraine,2545,7,10,10,10,39,36,3,40
Glentoran,2545,8,11,7,12,37,42,-5,40
Ballinamalla,2545,9,9,4,17,33,52,-19,31
Ards,2545,10,8,5,17,36,50,-14,29
Portadown,2545,11,7,6,17,24,43,-19,27
Linfield,2546,1,19,8,3,63,25,38,65
Cliftonville,2546,2,15,8,7,52,33,19,53
Crusaders,2546,3,14,9,7,51,34,17,51
Glenavon,2546,4,11,12,7,44,43,1,45
Ballymena,2546,5,13,6,11,60,64,-4,45
Coleraine,2546,6,11,11,8,43,35,8,44
Portadown,2546,7,10,6,14,34,44,-10,36
Dungannon,2546,8,9,7,14,45,51,-6,34
Glentoran,2546,9,7,8,15,33,52,-19,29
Ards,2546,10,7,6,17,34,51,-17,27
Ballinamalla,2546,11,6,5,19,25,52,-27,23
Linfield,2547,1,16,12,2,58,21,37,60
Crusaders,2547,2,15,9,6,55,33,22,54
Cliftonville,2547,3,15,6,9,49,35,14,51
Coleraine,2547,4,10,12,8,37,34,3,42
Dungannon,2547,5,9,12,9,45,37,8,39
Ballymena,2547,6,10,9,11,55,64,-9,39
Glenavon,2547,7,8,13,9,35,41,-6,37
Ards,2547,8,9,6,15,34,43,-9,33
Portadown,2547,9,8,8,14,27,43,-16,32
Glentoran,2547,10,6,11,13,25,46,-21,29
Ballinamalla,2547,11,6,8,16,23,46,-23,26
Crusaders,2548,1,18,6,6,56,30,26,60
Linfield,2548,2,16,8,6,53,25,28,56
Cliftonville,2548,3,15,4,11,60,42,18,49
Ballymena,2548,4,13,5,12,59,64,-5,44
Coleraine,2548,5,11,10,9,38,41,-3,43
Glenavon,2548,6,10,10,10,45,45,0,40
Ards,2548,7,12,4,14,39,46,-7,40
Dungannon,2548,8,9,11,10,47,46,1,38
Glentoran,2548,9,8,9,13,32,44,-12,33
Ballinamalla,2548,10,8,4,18,29,49,-20,28
Portadown,2548,11,7,5,18,24,50,-26,26
Crusaders,2549,1,16,11,3,61,36,25,59
Cliftonville,2549,2,18,3,9,57,39,18,57
Linfield,2549,3,15,10,5,57,24,33,55
Glenavon,2549,4,14,8,8,54,45,9,50
Ballymena,2549,5,11,8,11,60,69,-9,41
Ballinamalla,2549,6,12,4,14,39,48,-9,40
Coleraine,2549,7,9,9,12,35,43,-8,36
Glentoran,2549,8,8,8,14,31,53,-22,32
Ards,2549,9,8,6,16,32,48,-16,30
Portadown,2549,10,7,7,16,27,42,-15,28
Dungannon,2549,11,7,6,17,49,55,-6,27
Crusaders,2550,1,18,8,4,61,30,31,62
Linfield,2550,2,15,11,4,65,36,29,56
Cliftonville,2550,3,15,7,8,55,38,17,52
Coleraine,2550,4,10,12,8,41,35,6,42
Dungannon,2550,5,9,12,9,52,45,7,39
Glenavon,2550,6,7,14,9,46,51,-5,35
Portadown,2550,7,9,8,13,30,42,-12,35
Glentoran,2550,8,9,8,13,29,44,-15,35
Ards,2550,9,9,6,15,38,54,-16,33
Ballymena,2550,10,9,6,15,49,67,-18,33
Ballinamalla,2550,11,6,6,18,30,54,-24,24
Crusaders,2551,1,17,6,7,56,37,19,57
Linfield,2551,2,16,8,6,69,37,32,56
Glenavon,2551,3,14,10,6,58,46,12,52
Ballymena,2551,4,14,5,11,58,61,-3,47
Cliftonville,2551,5,13,5,12,49,48,1,44
Coleraine,2551,6,9,14,7,48,45,3,41
Dungannon,2551,7,9,10,11,55,44,11,37
Glentoran,2551,8,9,10,11,35,44,-9,37
Ards,2551,9,10,6,14,40,50,-10,36
Portadown,2551,10,7,5,18,27,51,-24,26
Ballinamalla,2551,11,6,3,21,25,57,-32,21
Cliftonville,2552,1,18,3,9,60,38,22,57
Crusaders,2552,2,15,8,7,48,35,13,53
Linfield,2552,3,15,7,8,67,34,33,52
Ballymena,2552,4,15,7,8,57,53,4,52
Coleraine,2552,5,11,12,7,49,46,3,45
Dungannon,2552,6,11,10,9,59,42,17,43
Glenavon,2552,7,9,10,11,47,52,-5,37
Ards,2552,8,11,4,15,40,49,-9,37
Glentoran,2552,9,9,9,12,30,43,-13,36
Portadown,2552,10,6,4,20,26,57,-31,22
Ballinamalla,2552,11,6,4,20,24,58,-34,22
Ballymena,2553,1,15,8,7,59,50,9,53
Linfield,2553,2,14,10,6,54,29,25,52
Cliftonville,2553,3,14,10,6,52,36,16,52
Crusaders,2553,4,15,6,9,61,41,20,51
Coleraine,2553,5,10,14,6,44,37,7,44
Glenavon,2553,6,9,12,9,48,50,-2,39
Glentoran,2553,7,10,6,14,30,42,-12,36
Dungannon,2553,8,8,11,11,47,50,-3,35
Portadown,2553,9,9,6,15,33,47,-14,33
Ards,2553,10,8,7,15,39,51,-12,31
Ballinamalla,2553,11,5,6,19,22,56,-34,21
Crusaders,2554,1,17,6,7,64,35,29,57
Linfield,2554,2,16,7,7,60,37,23,55
Cliftonville,2554,3,16,5,9,57,45,12,53
Coleraine,2554,4,13,9,8,47,41,6,48
Ards,2554,5,11,5,14,49,51,-2,38
Glenavon,2554,6,9,11,10,49,56,-7,38
Ballymena,2554,7,11,5,14,55,67,-12,38
Dungannon,2554,8,9,10,11,47,45,2,37
Portadown,2554,9,11,3,16,34,47,-13,36
Glentoran,2554,10,8,7,15,32,50,-18,31
Ballinamalla,2554,11,8,4,18,30,50,-20,28
Crusaders,2555,1,19,6,5,65,30,35,63
Coleraine,2555,2,15,10,5,48,33,15,55
Cliftonville,2555,3,15,7,8,55,41,14,52
Linfield,2555,4,13,10,7,62,37,25,49
Ballymena,2555,5,13,5,12,57,64,-7,44
Glenavon,2555,6,8,12,10,42,51,-9,36
Ards,2555,7,9,7,14,37,45,-8,34
Glentoran,2555,8,8,8,14,33,49,-16,32
Dungannon,2555,9,6,11,13,42,48,-6,29
Ballinamalla,2555,10,7,7,16,35,55,-20,28
Portadown,2555,11,7,7,16,26,49,-23,28
Crusaders,2556,1,18,4,8,63,36,27,58
Linfield,2556,2,15,10,5,53,29,24,55
Cliftonville,2556,3,16,3,11,53,43,10,51
Glenavon,2556,4,11,13,6,47,40,7,46
Coleraine,2556,5,11,12,7,42,35,7,45
Ballymena,2556,6,10,10,10,51,59,-8,40
Ballinamalla,2556,7,10,6,14,33,46,-13,36
Dungannon,2556,8,7,12,11,46,47,-1,33
Ards,2556,9,8,7,15,32,46,-14,31
Portadown,2556,10,7,7,16,28,47,-19,28
Glentoran,2556,11,6,8,16,29,49,-20,26
Crusaders,2557,1,22,5,3,65,29,36,71
Linfield,2557,2,17,8,5,70,35,35,59
Coleraine,2557,3,13,10,7,42,33,9,49
Ballymena,2557,4,12,6,12,47,56,-9,42
Glenavon,2557,5,10,10,10,51,56,-5,40
Dungannon,2557,6,11,6,13,46,40,6,39
Ards,2557,7,10,6,14,37,49,-12,36
Glentoran,2557,8,10,6,14,33,45,-12,36
Cliftonville,2557,9,10,5,15,40,47,-7,35
Ballinamalla,2557,10,8,4,18,29,52,-23,28
Portadown,2557,11,7,4,19,26,44,-18,25
Crusaders,2558,1,19,7,4,61,31,30,64
Cliftonville,2558,2,18,4,8,57,34,23,58
Linfield,2558,3,14,10,6,59,31,28,52
Coleraine,2558,4,11,13,6,46,35,11,46
Ballymena,2558,5,12,6,12,55,66,-11,42
Glenavon,2558,6,9,12,9,46,47,-1,39
Dungannon,2558,7,10,8,12,52,54,-2,38
Ards,2558,8,10,5,15,36,49,-13,35
Glentoran,2558,9,9,7,14,38,49,-11,34
Portadown,2558,10,6,9,15,28,47,-19,27
Ballinamalla,2558,11,4,5,21,25,60,-35,17
Cliftonville,2559,1,19,2,9,62,33,29,59
Linfield,2559,2,16,9,5,63,38,25,57
Crusaders,2559,3,17,6,7,53,33,20,57
Coleraine,2559,4,10,12,8,41,48,-7,42
Glenavon,2559,5,10,10,10,43,46,-3,40
Dungannon,2559,6,10,9,11,47,41,6,39
Ballymena,2559,7,11,5,14,52,58,-6,38
Ards,2559,8,10,5,15,37,45,-8,35
Ballinamalla,2559,9,9,5,16,29,44,-15,32
Glentoran,2559,10,8,6,16,33,55,-22,30
Portadown,2559,11,6,9,15,26,45,-19,27
Crusaders,2560,1,16,5,9,52,35,17,53
Ballymena,2560,2,16,5,9,58,56,2,53
Cliftonville,2560,3,15,6,9,48,36,12,51
Linfield,2560,4,13,10,7,56,33,23,49
Coleraine,2560,5,13,10,7,45,34,11,49
Dungannon,2560,6,12,10,8,53,43,10,46
Glenavon,2560,7,9,12,9,46,46,0,39
Ards,2560,8,8,7,15,35,46,-11,31
Portadown,2560,9,8,6,16,26,42,-16,30
Glentoran,2560,10,7,8,15,32,52,-20,29
Ballinamalla,2560,11,5,7,18,25,53,-28,22
Crusaders,2561,1,17,9,4,57,31,26,60
Linfield,2561,2,14,10,6,61,33,28,52
Glenavon,2561,3,13,10,7,48,38,10,49
Cliftonville,2561,4,14,6,10,46,38,8,48
Ballymena,2561,5,14,5,11,54,54,0,47
Coleraine,2561,6,9,12,9,41,38,3,39
Dungannon,2561,7,9,10,11,48,47,1,37
Glentoran,2561,8,8,10,12,28,40,-12,34
Portadown,2561,9,9,7,14,27,41,-14,34
Ards,2561,10,7,7,16,35,57,-22,28
Ballinamalla,2561,11,5,6,19,24,52,-28,21
Crusaders,2562,1,19,4,7,53,23,30,61
Linfield,2562,2,14,10,6,56,32,24,52
Cliftonville,2562,3,15,4,11,48,40,8,49
Coleraine,2562,4,12,11,7,43,33,10,47
Glenavon,2562,5,11,11,8,44,41,3,44
Ballymena,2562,6,12,6,12,53,59,-6,42
Glentoran,2562,7,12,5,13,31,50,-19,41
Dungannon,2562,8,10,9,11,48,41,7,39
Portadown,2562,9,9,9,12,29,39,-10,36
Ballinamalla,2562,10,7,3,20,32,58,-26,24
Ards,2562,11,5,6,19,32,53,-21,21
Cliftonville,2563,1,20,2,8,61,37,24,62
Crusaders,2563,2,18,6,6,53,32,21,60
Ballymena,2563,3,15,5,10,56,52,4,50
Linfield,2563,4,13,10,7,47,25,22,49
Glenavon,2563,5,12,12,6,47,40,7,48
Dungannon,2563,6,10,8,12,45,39,6,38
Glentoran,2563,7,10,8,12,34,42,-8,38
Coleraine,2563,8,9,9,12,35,46,-11,36
Ards,2563,9,8,3,19,33,49,-16,27
Portadown,2563,10,7,5,18,28,48,-20,26
Ballinamalla,2563,11,8,2,20,28,57,-29,26
Crusaders,2564,1,17,7,6,57,36,21,58
Ballymena,2564,2,18,4,8,74,57,17,58
Cliftonville,2564,3,15,4,11,55,43,12,49
Linfield,2564,4,13,9,8,55,37,18,48
Glenavon,2564,5,11,10,9,53,51,2,43
Dungannon,2564,6,11,8,11,48,46,2,41
Coleraine,2564,7,9,11,10,43,43,0,38
Ards,2564,8,10,7,13,43,47,-4,37
Portadown,2564,9,8,7,15,28,45,-17,31
Glentoran,2564,10,7,9,14,27,51,-24,30
Ballinamalla,2564,11,7,2,21,28,55,-27,23
Linfield,2565,1,16,9,5,62,32,30,57
Cliftonville,2565,2,16,6,8,56,36,20,54
Ballymena,2565,3,16,6,8,58,53,5,54
Crusaders,2565,4,13,8,9,50,38,12,47
Glenavon,2565,5,10,11,9,46,46,0,41
Coleraine,2565,6,10,10,10,39,41,-2,40
Dungannon,2565,7,10,9,11,49,48,1,39
Ards,2565,8,10,4,16,41,53,-12,34
Glentoran,2565,9,7,11,12,30,42,-12,32
Ballinamalla,2565,10,8,7,15,36,49,-13,31
Portadown,2565,11,6,5,19,22,51,-29,23
Linfield,2566,1,16,6,8,58,29,29,54
Crusaders,2566,2,16,6,8,60,37,23,54
Cliftonville,2566,3,15,5,10,48,37,11,50
Coleraine,2566,4,14,8,8,47,37,10,50
Ards,2566,5,13,3,14,46,44,2,42
Ballymena,2566,6,12,5,13,48,60,-12,41
Ballinamalla,2566,7,10,5,15,34,48,-14,35
Portadown,2566,8,11,2,17,30,49,-19,35
Glentoran,2566,9,9,7,14,30,46,-16,34
Dungannon,2566,10,7,12,11,47,45,2,33
Glenavon,2566,11,8,9,13,37,53,-16,33
Crusaders,2567,1,15,7,8,52,38,14,52
Linfield,2567,2,13,10,7,56,28,28,49
Cliftonville,2567,3,14,6,10,52,43,9,48
Ballymena,2567,4,13,8,9,58,57,1,47
Coleraine,2567,5,12,10,8,44,37,7,46
Glenavon,2567,6,12,9,9,51,46,5,45
Glentoran,2567,7,9,11,10,32,42,-10,38
Portadown,2567,8,10,6,14,26,38,-12,36
Dungannon,2567,9,8,9,13,48,47,1,33
Ards,2567,10,9,5,16,39,54,-15,32
Ballinamalla,2567,11,6,7,17,26,54,-28,25
Linfield,2568,1,19,6,5,63,28,35,63
Cliftonville,2568,2,18,4,8,63,43,20,58
Crusaders,2568,3,16,7,7,58,40,18,55
Ballymena,2568,4,15,6,9,67,57,10,51
Coleraine,2568,5,11,10,9,41,35,6,43
Glenavon,2568,6,10,10,10,40,45,-5,40
Dungannon,2568,7,9,11,10,51,47,4,38
Glentoran,2568,8,8,6,16,33,54,-21,30
Portadown,2568,9,9,3,18,36,58,-22,30
Ards,2568,10,7,5,18,33,53,-20,26
Ballinamalla,2568,11,7,4,19,26,51,-25,25
Crusaders,2569,1,17,6,7,64,41,23,57
Cliftonville,2569,2,17,5,8,58,38,20,56
Linfield,2569,3,14,7,9,55,35,20,49
Glentoran,2569,4,12,7,11,35,41,-6,43
Coleraine,2569,5,10,12,8,44,42,2,42
Dungannon,2569,6,11,8,11,49,45,4,41
Ballymena,2569,7,11,6,13,50,68,-18,39
Glenavon,2569,8,9,11,10,44,47,-3,38
Ards,2569,9,11,5,14,36,42,-6,38
Ballinamalla,2569,10,10,3,17,35,47,-12,33
Portadown,2569,11,6,4,20,27,51,-24,22
Cliftonville,2570,1,17,5,8,54,36,18,56
Crusaders,2570,2,16,6,8,65,40,25,54
Coleraine,2570,3,13,10,7,48,38,10,49
Ballymena,2570,4,15,4,11,60,61,-1,49
Linfield,2570,5,12,9,9,58,37,21,45
Glenavon,2570,6,12,8,10,50,53,-3,44
Dungannon,2570,7,12,7,11,47,38,9,43
Portadown,2570,8,9,6,15,29,45,-16,33
Glentoran,2570,9,8,7,15,32,48,-16,31
Ballinamalla,2570,10,9,3,18,29,53,-24,30
Ards,2570,11,8,3,19,36,59,-23,27
Ballymena,2571,1,16,6,8,58,48,10,54
Linfield,2571,2,15,8,7,61,30,31,53
Cliftonville,2571,3,16,4,10,62,45,17,52
Crusaders,2571,4,14,9,7,50,35,15,51
Glenavon,2571,5,13,9,8,48,44,4,48
Dungannon,2571,6,13,7,10,50,41,9,46
Coleraine,2571,7,12,7,11,43,42,1,43
Glentoran,2571,8,9,8,13,32,46,-14,35
Ards,2571,9,8,5,17,29,49,-20,29
Ballinamalla,2571,10,8,3,19,25,48,-23,27
Portadown,2571,11,5,6,19,23,53,-30,21
Linfield,2572,1,16,11,3,62,25,37,59
Crusaders,2572,2,16,7,7,57,30,27,55
Cliftonville,2572,3,15,6,9,48,38,10,51
Ballymena,2572,4,15,6,9,55,51,4,51
Glenavon,2572,5,14,8,8,45,42,3,50
Coleraine,2572,6,11,9,10,35,34,1,42
Dungannon,2572,7,10,8,12,50,44,6,38
Glentoran,2572,8,8,8,14,32,46,-14,32
Ards,2572,9,9,5,16,33,48,-15,32
Portadown,2572,10,7,6,17,24,51,-27,27
Ballinamalla,2572,11,4,6,20,21,53,-32,18
Crusaders,2573,1,18,7,5,55,28,27,61
Cliftonville,2573,2,15,6,9,58,40,18,51
Linfield,2573,3,14,8,8,61,34,27,50
Dungannon,2573,4,13,8,9,50,36,14,47
Glenavon,2573,5,12,11,7,45,39,6,47
Ballymena,2573,6,11,7,12,57,68,-11,40
Glentoran,2573,7,10,6,14,41,56,-15,36
Ards,2573,8,9,7,14,38,47,-9,34
Coleraine,2573,9,7,11,12,44,49,-5,32
Portadown,2573,10,9,5,16,27,49,-22,32
Ballinamalla,2573,11,7,4,19,27,57,-30,25
Crusaders,2574,1,18,6,6,61,35,26,60
Cliftonville,2574,2,15,4,11,56,43,13,49
Ballymena,2574,3,14,7,9,66,60,6,49
Glenavon,2574,4,13,9,8,51,46,5,48
Linfield,2574,5,12,10,8,52,36,16,46
Coleraine,2574,6,11,10,9,40,40,0,43
Dungannon,2574,7,11,9,10,48,39,9,42
Ballinamalla,2574,8,11,3,16,33,48,-15,36
Glentoran,2574,9,9,8,13,27,41,-14,35
Portadown,2574,10,5,10,15,28,53,-25,25
Ards,2574,11,6,4,20,31,52,-21,22
Linfield,2575,1,18,7,5,66,39,27,61
Cliftonville,2575,2,17,4,9,52,37,15,55
Crusaders,2575,3,14,11,5,58,35,23,53
Ballymena,2575,4,15,5,10,59,55,4,50
Glenavon,2575,5,10,12,8,50,48,2,42
Coleraine,2575,6,10,10,10,41,41,0,40
Glentoran,2575,7,11,5,14,40,51,-11,38
Dungannon,2575,8,9,9,12,54,51,3,36
Ards,2575,9,8,5,17,42,63,-21,29
Portadown,2575,10,8,4,18,31,49,-18,28
Ballinamalla,2575,11,7,4,19,33,57,-24,25
Linfield,2576,1,18,7,5,62,28,34,61
Cliftonville,2576,2,15,7,8,53,37,16,52
Coleraine,2576,3,13,11,6,50,36,14,50
Crusaders,2576,4,13,10,7,57,47,10,49
Glenavon,2576,5,11,12,7,44,40,4,45
Dungannon,2576,6,11,10,9,55,40,15,43
Ballymena,2576,7,11,5,14,50,61,-11,38
Glentoran,2576,8,10,5,15,31,45,-14,35
Ballinamalla,2576,9,8,7,15,29,47,-18,31
Ards,2576,10,8,4,18,31,53,-22,28
Portadown,2576,11,5,6,19,19,47,-28,21
Crusaders,2577,1,19,9,2,62,29,33,66
Cliftonville,2577,2,15,6,9,53,42,11,51
Ballymena,2577,3,15,6,9,59,54,5,51
Linfield,2577,4,12,9,9,60,43,17,45
Glenavon,2577,5,12,9,9,47,49,-2,45
Coleraine,2577,6,11,10,9,39,38,1,43
Ards,2577,7,10,5,15,40,50,-10,35
Dungannon,2577,8,8,10,12,56,48,8,34
Glentoran,2577,9,8,7,15,26,41,-15,31
Portadown,2577,10,7,6,17,30,50,-20,27
Ballinamalla,2577,11,8,3,19,31,59,-28,27
Linfield,2578,1,17,8,5,61,28,33,59
Cliftonville,2578,2,16,7,7,49,34,15,55
Crusaders,2578,3,13,7,10,53,41,12,46
Glenavon,2578,4,12,10,8,48,44,4,46
Ballymena,2578,5,14,4,12,60,59,1,46
Coleraine,2578,6,11,10,9,47,40,7,43
Dungannon,2578,7,10,10,10,47,41,6,40
Ards,2578,8,10,5,15,37,47,-10,35
Ballinamalla,2578,9,10,1,19,29,54,-25,31
Glentoran,2578,10,7,8,15,32,49,-17,29
Portadown,2578,11,8,4,18,21,47,-26,28
Crusaders,2579,1,17,6,7,61,35,26,57
Linfield,2579,2,15,9,6,57,31,26,54
Cliftonville,2579,3,15,5,10,52,45,7,50
Coleraine,2579,4,12,12,6,43,31,12,48
Glenavon,2579,5,12,9,9,49,44,5,45
Ballymena,2579,6,12,7,11,55,59,-4,43
Glentoran,2579,7,11,6,13,27,38,-11,39
Dungannon,2579,8,8,10,12,52,50,2,34
Portadown,2579,9,8,7,15,37,52,-15,31
Ards,2579,10,8,6,16,29,46,-17,30
Ballinamalla,2579,11,6,5,19,25,56,-31,23
Crusaders,2580,1,21,7,2,59,24,35,70
Glenavon,2580,2,14,8,8,57,47,10,50
Linfield,2580,3,12,10,8,60,32,28,46
Ballymena,2580,4,13,7,10,52,58,-6,46
Cliftonville,2580,5,12,6,12,41,37,4,42
Coleraine,2580,6,9,12,9,39,41,-2,39
Dungannon,2580,7,8,12,10,50,47,3,36
Glentoran,2580,8,9,9,12,28,44,-16,36
Ballinamalla,2580,9,9,6,15,30,47,-17,33
Portadown,2580,10,7,6,17,21,43,-22,27
Ards,2580,11,5,9,16,34,51,-17,24
Crusaders,2581,1,16,8,6,51,30,21,56
Linfield,2581,2,16,7,7,59,37,22,55
Cliftonville,2581,3,15,5,10,52,39,13,50
Ballymena,2581,4,13,7,10,53,55,-2,46
Glenavon,2581,5,11,11,8,49,46,3,44
Coleraine,2581,6,10,12,8,48,42,6,42
Dungannon,2581,7,11,8,11,50,40,10,41
Ards,2581,8,10,4,16,48,62,-14,34
Glentoran,2581,9,9,7,14,33,47,-14,34
Ballinamalla,2581,10,7,6,17,31,55,-24,27
Portadown,2581,11,6,7,17,20,41,-21,25
Crusaders,2582,1,14,11,5,56,33,23,53
Cliftonville,2582,2,15,5,10,53,41,12,50
Linfield,2582,3,13,10,7,52,29,23,49
Ballymena,2582,4,13,7,10,55,59,-4,46
Dungannon,2582,5,10,10,10,48,42,6,40
Coleraine,2582,6,9,13,8,41,39,2,40
Glenavon,2582,7,9,12,9,40,42,-2,39
Portadown,2582,8,11,5,14,29,40,-11,38
Glentoran,2582,9,9,9,12,33,47,-14,36
Ballinamalla,2582,10,6,10,14,28,48,-20,28
Ards,2582,11,7,6,17,37,52,-15,27
Crusaders,2583,1,18,7,5,56,27,29,61
Linfield,2583,2,15,9,6,58,27,31,54
Ballymena,2583,3,16,5,9,56,52,4,53
Coleraine,2583,4,14,8,8,39,32,7,50
Cliftonville,2583,5,14,7,9,46,31,15,49
Glenavon,2583,6,12,7,11,45,42,3,43
Dungannon,2583,7,10,7,13,44,39,5,37
Ballinamalla,2583,8,9,4,17,32,54,-22,31
Portadown,2583,9,8,5,17,21,43,-22,29
Ards,2583,10,7,5,18,30,55,-25,26
Glentoran,2583,11,5,10,15,30,55,-25,25
Linfield,2584,1,15,10,5,61,32,29,55
Crusaders,2584,2,15,10,5,55,35,20,55
Cliftonville,2584,3,16,3,11,59,45,14,51
Coleraine,2584,4,13,10,7,43,31,12,49
Ballymena,2584,5,12,8,10,52,55,-3,44
Dungannon,2584,6,11,7,12,50,47,3,40
Glenavon,2584,7,8,11,11,39,45,-6,35
Ballinamalla,2584,8,9,7,14,28,46,-18,34
Portadown,2584,9,9,6,15,25,45,-20,33
Glentoran,2584,10,6,10,14,33,48,-15,28
Ards,2584,11,6,8,16,32,48,-16,26
Crusaders,2585,1,17,9,4,57,37,20,60
Coleraine,2585,2,12,12,6,47,42,5,48
Linfield,2585,3,12,11,7,50,29,21,47
Cliftonville,2585,4,14,5,11,52,40,12,47
Ballymena,2585,5,13,5,12,60,64,-4,44
Glentoran,2585,6,12,7,11,42,44,-2,43
Glenavon,2585,7,10,11,9,46,44,2,41
Ards,2585,8,10,6,14,41,44,-3,36
Dungannon,2585,9,8,10,12,49,56,-7,34
Ballinamalla,2585,10,6,9,15,37,57,-20,27
Portadown,2585,11,4,9,17,25,49,-24,21
Crusaders,2586,1,18,6,6,52,33,19,60
Cliftonville,2586,2,15,5,10,51,43,8,50
Linfield,2586,3,13,10,7,53,30,23,49
Ballymena,2586,4,12,11,7,60,56,4,47
Glenavon,2586,5,11,12,7,55,48,7,45
Glentoran,2586,6,11,7,12,31,38,-7,40
Coleraine,2586,7,8,14,8,40,39,1,38
Dungannon,2586,8,7,10,13,44,44,0,31
Ballinamalla,2586,9,8,7,15,30,47,-17,31
Ards,2586,10,8,6,16,33,47,-14,30
Portadown,2586,11,6,8,16,22,46,-24,26
Linfield,2587,1,16,9,5,62,35,27,57
Cliftonville,2587,2,16,5,9,55,36,19,53
Crusaders,2587,3,14,10,6,50,34,16,52
Coleraine,2587,4,10,13,7,42,37,5,43
Ballymena,2587,5,12,7,11,59,68,-9,43
Glenavon,2587,6,10,12,8,47,43,4,42
Ards,2587,7,10,7,13,41,45,-4,37
Dungannon,2587,8,9,9,12,54,50,4,36
Glentoran,2587,9,8,8,14,32,40,-8,32
Portadown,2587,10,7,7,16,27,53,-26,28
Ballinamalla,2587,11,7,5,18,27,55,-28,26
Crusaders,2588,1,18,8,4,56,30,26,62
Ballymena,2588,2,16,6,8,56,49,7,54
Coleraine,2588,3,13,8,9,41,34,7,47
Cliftonville,2588,4,13,7,10,57,39,18,46
Linfield,2588,5,11,12,7,49,31,18,45
Glenavon,2588,6,9,13,8,38,34,4,40
Ards,2588,7,10,7,13,35,43,-8,37
Glentoran,2588,8,9,8,13,27,40,-13,35
Ballinamalla,2588,9,8,5,17,29,54,-25,29
Dungannon,2588,10,6,10,14,43,54,-11,28
Portadown,2588,11,7,6,17,29,52,-23,27
Linfield,2589,1,14,10,6,56,33,23,52
Crusaders,2589,2,14,9,7,56,36,20,51
Ballymena,2589,3,15,6,9,60,59,1,51
Cliftonville,2589,4,15,4,11,49,36,13,49
Dungannon,2589,5,12,11,7,61,42,19,47
Glenavon,2589,6,10,13,7,46,39,7,43
Coleraine,2589,7,10,12,8,39,43,-4,42
Ards,2589,8,8,8,14,35,45,-10,32
Glentoran,2589,9,7,9,14,31,47,-16,30
Ballinamalla,2589,10,8,6,16,27,52,-25,30
Portadown,2589,11,5,6,19,23,51,-28,21
Cliftonville,2590,1,15,7,8,59,43,16,52
Crusaders,2590,2,14,9,7,53,35,18,51
Ballymena,2590,3,14,7,9,68,63,5,49
Linfield,2590,4,13,8,9,62,40,22,47
Dungannon,2590,5,11,9,10,52,44,8,42
Glenavon,2590,6,9,12,9,44,45,-1,39
Portadown,2590,7,10,8,12,34,44,-10,38
Ballinamalla,2590,8,11,5,14,38,50,-12,38
Coleraine,2590,9,8,10,12,38,46,-8,34
Glentoran,2590,10,8,7,15,25,45,-20,31
Ards,2590,11,8,6,16,35,53,-18,30
Linfield,2591,1,18,7,5,61,27,34,61
Crusaders,2591,2,17,5,8,59,39,20,56
Cliftonville,2591,3,15,6,9,52,37,15,51
Ballymena,2591,4,14,6,10,63,58,5,48
Coleraine,2591,5,11,11,8,37,31,6,44
Glenavon,2591,6,10,8,12,46,52,-6,38
Glentoran,2591,7,9,9,12,26,35,-9,36
Dungannon,2591,8,8,10,12,47,50,-3,34
Ards,2591,9,7,10,13,32,47,-15,31
Portadown,2591,10,7,6,17,23,47,-24,27
Ballinamalla,2591,11,6,8,16,31,54,-23,26
Linfield,2592,1,16,9,5,59,27,32,57
Crusaders,2592,2,16,8,6,59,39,20,56
Cliftonville,2592,3,15,6,9,53,37,16,51
Ballymena,2592,4,15,5,10,57,56,1,50
Coleraine,2592,5,13,8,9,43,32,11,47
Glenavon,2592,6,12,11,7,47,40,7,47
Dungannon,2592,7,9,10,11,50,42,8,37
Ards,2592,8,7,7,16,31,48,-17,28
Portadown,2592,9,8,4,18,26,52,-26,28
Glentoran,2592,10,7,6,17,27,49,-22,27
Ballinamalla,2592,11,7,6,17,26,56,-30,27
Linfield,2593,1,14,10,6,54,31,23,52
Crusaders,2593,2,13,11,6,55,35,20,50
Glenavon,2593,3,12,11,7,52,43,9,47
Coleraine,2593,4,12,11,7,41,36,5,47
Cliftonville,2593,5,14,4,12,48,44,4,46
Ballymena,2593,6,13,6,11,49,54,-5,45
Dungannon,2593,7,11,10,9,51,41,10,43
Glentoran,2593,8,12,6,12,44,41,3,42
Ballinamalla,2593,9,7,8,15,29,52,-23,29
Portadown,2593,10,7,6,17,21,43,-22,27
Ards,2593,11,6,5,19,35,59,-24,23
Linfield,2594,1,16,8,6,67,34,33,56
Cliftonville,2594,2,16,5,9,55,40,15,53
Crusaders,2594,3,14,8,8,53,39,14,50
Ballymena,2594,4,13,5,12,54,55,-1,44
Dungannon,2594,5,11,10,9,54,50,4,43
Ards,2594,6,12,7,11,44,45,-1,43
Glenavon,2594,7,11,9,10,49,53,-4,42
Coleraine,2594,8,10,11,9,39,35,4,41
Glentoran,2594,9,8,7,15,28,43,-15,31
Ballinamalla,2594,10,9,3,18,27,49,-22,30
Portadown,2594,11,6,5,19,20,47,-27,23
Crusaders,2595,1,15,7,8,52,35,17,52
Dungannon,2595,2,15,6,9,69,37,32,51
Cliftonville,2595,3,15,4,11,45,34,11,49
Coleraine,2595,4,13,9,8,42,33,9,48
Ballymena,2595,5,14,5,11,57,64,-7,47
Linfield,2595,6,12,10,8,56,38,18,46
Glenavon,2595,7,12,9,9,46,44,2,45
Ballinamalla,2595,8,10,5,15,33,47,-14,35
Glentoran,2595,9,9,7,14,26,47,-21,34
Portadown,2595,10,6,7,17,25,54,-29,25
Ards,2595,11,5,9,16,34,52,-18,24
Crusaders,2596,1,19,6,5,59,30,29,63
Glenavon,2596,2,15,9,6,63,43,20,54
Cliftonville,2596,3,16,4,10,59,39,20,52
Linfield,2596,4,12,10,8,63,40,23,46
Ballymena,2596,5,13,5,12,54,59,-5,44
Coleraine,2596,6,10,12,8,45,40,5,42
Dungannon,2596,7,10,7,13,42,54,-12,37
Glentoran,2596,8,9,8,13,35,45,-10,35
Ards,2596,9,10,4,16,39,54,-15,34
Portadown,2596,10,7,6,17,20,47,-27,27
Ballinamalla,2596,11,6,5,19,31,59,-28,23
Crusaders,2597,1,17,7,6,58,31,27,58
Linfield,2597,2,15,9,6,60,27,33,54
Cliftonville,2597,3,17,2,11,57,37,20,53
Coleraine,2597,4,13,12,5,41,32,9,51
Ballymena,2597,5,13,5,12,62,60,2,44
Glentoran,2597,6,11,6,13,35,45,-10,39
Dungannon,2597,7,9,11,10,50,48,2,38
Ards,2597,8,9,7,14,34,49,-15,34
Glenavon,2597,9,7,12,11,42,49,-7,33
Ballinamalla,2597,10,6,7,17,28,55,-27,25
Portadown,2597,11,6,6,18,28,62,-34,24
Cliftonville,2598,1,19,4,7,51,31,20,61
Crusaders,2598,2,17,9,4,60,33,27,60
Ballymena,2598,3,16,4,10,60,63,-3,52
Linfield,2598,4,13,9,8,65,36,29,48
Dungannon,2598,5,11,9,10,46,46,0,42
Coleraine,2598,6,10,11,9,39,34,5,41
Glenavon,2598,7,8,14,8,42,43,-1,38
Ards,2598,8,8,6,16,37,49,-12,30
Glentoran,2598,9,7,9,14,26,43,-17,30
Portadown,2598,10,7,4,19,24,46,-22,25
Ballinamalla,2598,11,6,7,17,28,54,-26,25
Linfield,2599,1,16,10,4,62,27,35,58
Glenavon,2599,2,15,9,6,55,43,12,54
Crusaders,2599,3,14,9,7,54,38,16,51
Cliftonville,2599,4,15,6,9,56,43,13,51
Ballymena,2599,5,13,9,8,51,53,-2,48
Coleraine,2599,6,12,9,9,44,37,7,45
Dungannon,2599,7,8,12,10,47,40,7,36
Ballinamalla,2599,8,7,8,15,30,51,-21,29
Glentoran,2599,9,6,9,15,26,42,-16,27
Ards,2599,10,7,6,17,33,55,-22,27
Portadown,2599,11,5,7,18,20,49,-29,22
Cliftonville,2600,1,17,6,7,59,35,24,57
Crusaders,2600,2,16,7,7,46,28,18,55
Coleraine,2600,3,12,12,6,45,36,9,48
Ballymena,2600,4,12,10,8,50,56,-6,46
Linfield,2600,5,12,9,9,56,39,17,45
Dungannon,2600,6,12,7,11,59,47,12,43
Ards,2600,7,11,4,15,32,44,-12,37
Glenavon,2600,8,9,9,12,41,46,-5,36
Ballinamalla,2600,9,9,6,15,37,51,-14,33
Glentoran,2600,10,7,9,14,29,44,-15,30
Portadown,2600,11,7,3,20,23,51,-28,24
Cliftonville,2601,1,19,4,7,63,37,26,61
Crusaders,2601,2,17,6,7,53,33,20,57
Linfield,2601,3,15,8,7,54,31,23,53
Ballymena,2601,4,16,5,9,63,59,4,53
Coleraine,2601,5,12,10,8,46,43,3,46
Dungannon,2601,6,11,10,9,60,45,15,43
Glenavon,2601,7,7,13,10,44,48,-4,34
Glentoran,2601,8,8,9,13,25,41,-16,33
Ards,2601,9,8,5,17,42,61,-19,29
Portadown,2601,10,7,6,17,34,53,-19,27
Ballinamalla,2601,11,5,4,21,26,59,-33,19
Crusaders,2602,1,21,6,3,67,31,36,69
Linfield,2602,2,20,7,3,59,18,41,67
Ballymena,2602,3,14,7,9,53,54,-1,49
Coleraine,2602,4,13,9,8,44,33,11,48
Cliftonville,2602,5,14,6,10,47,37,10,48
Glenavon,2602,6,11,9,10,39,43,-4,42
Dungannon,2602,7,8,8,14,47,49,-2,32
Glentoran,2602,8,7,8,15,26,48,-22,29
Ballinamalla,2602,9,7,4,19,28,50,-22,25
Ards,2602,10,6,6,18,32,56,-24,24
Portadown,2602,11,5,8,17,19,42,-23,23
Linfield,2603,1,16,10,4,60,28,32,58
Crusaders,2603,2,15,8,7,55,37,18,53
Glenavon,2603,3,13,11,6,46,36,10,50
Cliftonville,2603,4,14,6,10,47,37,10,48
Ballymena,2603,5,14,4,12,63,58,5,46
Ards,2603,6,11,7,12,37,40,-3,40
Coleraine,2603,7,10,10,10,38,42,-4,40
Dungannon,2603,8,9,10,11,43,41,2,37
Ballinamalla,2603,9,11,4,15,31,49,-18,37
Glentoran,2603,10,6,5,19,24,48,-24,23
Portadown,2603,11,5,7,18,22,50,-28,22
Linfield,2604,1,14,12,4,57,26,31,54
Cliftonville,2604,2,16,4,10,57,39,18,52
Crusaders,2604,3,15,7,8,52,40,12,52
Coleraine,2604,4,14,10,6,42,32,10,52
Ballymena,2604,5,12,9,9,57,55,2,45
Glenavon,2604,6,9,12,9,43,41,2,39
Ards,2604,7,11,5,14,35,43,-8,38
Dungannon,2604,8,7,11,12,47,52,-5,32
Portadown,2604,9,8,8,14,31,44,-13,32
Ballinamalla,2604,10,9,5,16,34,52,-18,32
Glentoran,2604,11,5,7,18,21,52,-31,22
Crusaders,2605,1,18,7,5,61,34,27,61
Cliftonville,2605,2,17,5,8,58,39,19,56
Linfield,2605,3,14,9,7,60,35,25,51
Glenavon,2605,4,12,10,8,52,46,6,46
Ards,2605,5,14,3,13,43,40,3,45
Ballymena,2605,6,13,5,12,52,57,-5,44
Coleraine,2605,7,11,9,10,45,42,3,42
Dungannon,2605,8,8,8,14,50,57,-7,32
Portadown,2605,9,6,10,14,33,51,-18,28
Ballinamalla,2605,10,8,4,18,32,51,-19,28
Glentoran,2605,11,6,6,18,21,55,-34,24
Linfield,2606,1,15,10,5,59,27,32,55
Crusaders,2606,2,16,6,8,55,36,19,54
Cliftonville,2606,3,16,4,10,57,38,19,52
Glenavon,2606,4,12,14,4,54,39,15,50
Ballymena,2606,5,12,9,9,48,59,-11,45
Coleraine,2606,6,11,10,9,42,40,2,43
Dungannon,2606,7,10,10,10,43,41,2,40
Glentoran,2606,8,9,8,13,27,42,-15,35
Ards,2606,9,7,7,16,42,56,-14,28
Portadown,2606,10,6,8,16,34,57,-23,26
Ballinamalla,2606,11,5,6,19,22,48,-26,21
Crusaders,2607,1,16,8,6,58,36,22,56
Ballymena,2607,2,15,6,9,59,60,-1,51
Linfield,2607,3,13,11,6,60,36,24,50
Dungannon,2607,4,13,7,10,51,40,11,46
Cliftonville,2607,5,13,5,12,47,44,3,44
Glenavon,2607,6,10,11,9,47,44,3,41
Ards,2607,7,11,7,12,46,49,-3,40
Coleraine,2607,8,9,12,9,38,39,-1,39
Glentoran,2607,9,10,9,11,34,42,-8,39
Portadown,2607,10,8,5,17,32,49,-17,29
Ballinamalla,2607,11,5,3,22,28,61,-33,18
Linfield,2608,1,16,8,6,68,30,38,56
Crusaders,2608,2,14,10,6,51,34,17,52
Ballymena,2608,3,16,4,10,57,51,6,52
Cliftonville,2608,4,14,8,8,53,42,11,50
Glenavon,2608,5,11,11,8,41,42,-1,44
Ards,2608,6,12,3,15,40,45,-5,39
Coleraine,2608,7,9,10,11,36,44,-8,37
Dungannon,2608,8,8,10,12,49,51,-2,34
Glentoran,2608,9,8,9,13,30,42,-12,33
Portadown,2608,10,8,7,15,28,47,-19,31
Ballinamalla,2608,11,6,6,18,28,53,-25,24
Crusaders,2609,1,19,5,6,66,36,30,62
Linfield,2609,2,15,7,8,67,32,35,52
Cliftonville,2609,3,15,7,8,54,37,17,52
Ballymena,2609,4,14,5,11,53,60,-7,47
Glenavon,2609,5,10,12,8,51,49,2,42
Coleraine,2609,6,11,8,11,42,40,2,41
Glentoran,2609,7,11,7,12,33,44,-11,40
Ards,2609,8,11,4,15,36,44,-8,37
Dungannon,2609,9,9,7,14,45,50,-5,34
Portadown,2609,10,8,6,16,30,52,-22,30
Ballinamalla,2609,11,6,4,20,25,58,-33,22
Linfield,2610,1,15,8,7,60,32,28,53
Glenavon,2610,2,13,10,7,50,46,4,49
Crusaders,2610,3,13,9,8,49,35,14,48
Coleraine,2610,4,12,11,7,45,36,9,47
Cliftonville,2610,5,12,6,12,49,45,4,42
Ballymena,2610,6,12,6,12,50,62,-12,42
Dungannon,2610,7,9,11,10,53,45,8,38
Glentoran,2610,8,9,9,12,30,40,-10,36
Portadown,2610,9,9,8,13,29,41,-12,35
Ards,2610,10,8,7,15,34,43,-9,31
Ballinamalla,2610,11,7,7,16,30,54,-24,28
Crusaders,2611,1,19,7,4,66,40,26,64
Ballymena,2611,2,15,6,9,61,57,4,51
Linfield,2611,3,13,9,8,59,41,18,48
Cliftonville,2611,4,14,5,11,52,46,6,47
Coleraine,2611,5,12,10,8,50,42,8,46
Glenavon,2611,6,10,11,9,53,50,3,41
Dungannon,2611,7,10,9,11,49,46,3,39
Glentoran,2611,8,9,7,14,34,44,-10,34
Ards,2611,9,9,6,15,38,46,-8,33
Ballinamalla,2611,10,7,5,18,27,53,-26,26
Portadown,2611,11,6,7,17,27,51,-24,25
Linfield,2612,1,18,8,4,65,28,37,62
Cliftonville,2612,2,17,5,8,58,36,22,56
Glenavon,2612,3,13,12,5,52,39,13,51
Crusaders,2612,4,14,7,9,48,40,8,49
Dungannon,2612,5,11,8,11,45,36,9,41
Coleraine,2612,6,10,9,11,39,36,3,39
Ballymena,2612,7,10,8,12,51,60,-9,38
Portadown,2612,8,8,7,15,25,48,-23,31
Glentoran,2612,9,7,9,14,25,43,-18,30
Ballinamalla,2612,10,8,6,16,30,52,-22,30
Ards,2612,11,8,3,19,35,55,-20,27
Linfield,2613,1,16,8,6,55,22,33,56
Glenavon,2613,2,15,10,5,57,44,13,55
Cliftonville,2613,3,15,6,9,52,42,10,51
Ballymena,2613,4,15,6,9,55,52,3,51
Crusaders,2613,5,14,6,10,52,39,13,48
Coleraine,2613,6,12,8,10,49,45,4,44
Dungannon,2613,7,8,11,11,45,41,4,35
Portadown,2613,8,8,8,14,24,38,-14,32
Ards,2613,9,9,4,17,34,49,-15,31
Ballinamalla,2613,10,8,4,18,26,54,-28,28
Glentoran,2613,11,5,9,16,24,47,-23,24
Linfield,2614,1,16,7,7,60,26,34,55
Crusaders,2614,2,16,7,7,60,44,16,55
Glenavon,2614,3,14,10,6,51,40,11,52
Ballymena,2614,4,14,6,10,55,56,-1,48
Coleraine,2614,5,10,13,7,41,34,7,43
Cliftonville,2614,6,11,8,11,41,41,0,41
Glentoran,2614,7,9,10,11,35,47,-12,37
Dungannon,2614,8,9,9,12,57,53,4,36
Ards,2614,9,9,7,14,39,46,-7,34
Ballinamalla,2614,10,7,6,17,28,49,-21,27
Portadown,2614,11,6,5,19,27,58,-31,23
Crusaders,2615,1,16,7,7,47,31,16,55
Cliftonville,2615,2,17,4,9,50,36,14,55
Linfield,2615,3,13,12,5,53,26,27,51
Coleraine,2615,4,11,12,7,46,38,8,45
Ballymena,2615,5,13,6,11,52,57,-5,45
Glenavon,2615,6,11,11,8,47,41,6,44
Dungannon,2615,7,10,9,11,52,48,4,39
Glentoran,2615,8,10,8,12,31,41,-10,38
Ards,2615,9,8,7,15,33,46,-13,31
Ballinamalla,2615,10,7,5,18,31,52,-21,26
Portadown,2615,11,5,7,18,22,48,-26,22
Crusaders,2616,1,18,7,5,63,40,23,61
Cliftonville,2616,2,15,7,8,55,38,17,52
Linfield,2616,3,12,12,6,57,35,22,48
Coleraine,2616,4,11,11,8,43,37,6,44
Ballymena,2616,5,12,6,12,58,61,-3,42
Glenavon,2616,6,10,10,10,44,48,-4,40
Portadown,2616,7,11,7,12,30,41,-11,40
Dungannon,2616,8,9,9,12,47,43,4,36
Glentoran,2616,9,8,10,12,31,43,-12,34
Ards,2616,10,6,8,16,32,49,-17,26
Ballinamalla,2616,11,6,7,17,28,53,-25,25
Crusaders,2617,1,17,7,6,60,36,24,58
Ballymena,2617,2,17,6,7,64,51,13,57
Cliftonville,2617,3,17,3,10,56,41,15,54
Linfield,2617,4,14,9,7,59,27,32,51
Glenavon,2617,5,12,10,8,52,50,2,46
Coleraine,2617,6,8,14,8,41,47,-6,38
Dungannon,2617,7,8,11,11,46,36,10,35
Ards,2617,8,9,6,15,41,54,-13,33
Glentoran,2617,9,7,8,15,25,46,-21,29
Portadown,2617,10,6,8,16,26,49,-23,26
Ballinamalla,2617,11,7,4,19,29,62,-33,25
Crusaders,2618,1,16,8,6,62,36,26,56
Linfield,2618,2,14,12,4,55,27,28,54
Glenavon,2618,3,13,8,9,52,55,-3,47
Ballymena,2618,4,12,9,9,52,50,2,45
Cliftonville,2618,5,12,8,10,47,41,6,44
Coleraine,2618,6,11,10,9,48,42,6,43
Dungannon,2618,7,11,8,11,57,47,10,41
Ballinamalla,2618,8,10,4,16,31,48,-17,34
Glentoran,2618,9,9,6,15,26,51,-25,33
Ards,2618,10,7,10,13,39,46,-7,31
Portadown,2618,11,5,7,18,25,51,-26,22
Cliftonville,2619,1,17,4,9,55,41,14,55
Crusaders,2619,2,15,9,6,54,35,19,54
Linfield,2619,3,14,10,6,53,31,22,52
Glenavon,2619,4,11,11,8,52,46,6,44
Dungannon,2619,5,10,12,8,53,45,8,42
Ards,2619,6,12,6,12,49,43,6,42
Coleraine,2619,7,10,11,9,48,48,0,41
Ballymena,2619,8,10,11,9,54,58,-4,41
Glentoran,2619,9,6,11,13,35,49,-14,29
Portadown,2619,10,5,9,16,25,49,-24,24
Ballinamalla,2619,11,6,4,20,29,62,-33,22
Crusaders,2620,1,17,8,5,68,37,31,59
Cliftonville,2620,2,18,2,10,60,48,12,56
Glenavon,2620,3,13,13,4,48,39,9,52
Linfield,2620,4,14,9,7,60,36,24,51
Ballymena,2620,5,12,9,9,60,60,0,45
Coleraine,2620,6,11,11,8,45,39,6,44
Ards,2620,7,11,6,13,43,49,-6,39
Dungannon,2620,8,9,8,13,49,48,1,35
Glentoran,2620,9,6,9,15,29,50,-21,27
Portadown,2620,10,5,7,18,26,51,-25,22
Ballinamalla,2620,11,6,4,20,28,59,-31,22
Crusaders,2621,1,17,6,7,61,38,23,57
Linfield,2621,2,13,12,5,60,35,25,51
Cliftonville,2621,3,15,5,10,57,43,14,50
Coleraine,2621,4,12,10,8,43,40,3,46
Ballymena,2621,5,13,5,12,60,64,-4,44
Dungannon,2621,6,11,9,10,52,44,8,42
Glenavon,2621,7,8,11,11,50,54,-4,35
Ards,2621,8,10,5,15,38,52,-14,35
Portadown,2621,9,9,6,15,36,50,-14,33
Glentoran,2621,10,6,12,12,27,45,-18,30
Ballinamalla,2621,11,8,5,17,31,50,-19,29
Cliftonville,2622,1,17,3,10,48,35,13,54
Crusaders,2622,2,15,7,8,56,33,23,52
Ballymena,2622,3,14,8,8,54,57,-3,50
Glenavon,2622,4,12,11,7,50,44,6,47
Linfield,2622,5,12,10,8,57,33,24,46
Coleraine,2622,6,11,10,9,38,34,4,43
Glentoran,2622,7,11,8,11,35,43,-8,41
Dungannon,2622,8,10,10,10,52,45,7,40
Ards,2622,9,10,4,16,37,48,-11,34
Ballinamalla,2622,10,7,5,18,27,52,-25,26
Portadown,2622,11,5,6,19,18,48,-30,21
Crusaders,2623,1,19,4,7,63,35,28,61
Linfield,2623,2,17,9,4,64,22,42,60
Glenavon,2623,3,15,10,5,54,39,15,55
Cliftonville,2623,4,14,3,13,50,44,6,45
Ballymena,2623,5,11,6,13,46,62,-16,39
Dungannon,2623,6,10,8,12,45,44,1,38
Coleraine,2623,7,9,9,12,36,41,-5,36
Glentoran,2623,8,10,6,14,31,45,-14,36
Ards,2623,9,9,6,15,41,56,-15,33
Ballinamalla,2623,10,8,6,16,33,56,-23,30
Portadown,2623,11,8,3,19,26,45,-19,27
Crusaders,2624,1,15,8,7,54,36,18,53
Linfield,2624,2,14,9,7,60,35,25,51
Dungannon,2624,3,13,8,9,53,43,10,47
Cliftonville,2624,4,14,5,11,50,40,10,47
Glentoran,2624,5,12,10,8,37,35,2,46
Glenavon,2624,6,10,12,8,42,46,-4,42
Ballinamalla,2624,7,13,2,15,37,44,-7,41
Coleraine,2624,8,9,12,9,36,36,0,39
Ballymena,2624,9,10,7,13,53,64,-11,37
Ards,2624,10,8,6,16,37,49,-12,30
Portadown,2624,11,5,5,20,24,55,-31,20
Linfield,2625,1,16,9,5,62,31,31,57
Cliftonville,2625,2,17,6,7,51,33,18,57
Crusaders,2625,3,16,7,7,50,34,16,55
Ballymena,2625,4,14,6,10,58,54,4,48
Coleraine,2625,5,10,12,8,39,39,0,42
Dungannon,2625,6,9,11,10,50,44,6,38
Glenavon,2625,7,9,11,10,42,46,-4,38
Ballinamalla,2625,8,9,4,17,32,53,-21,31
Ards,2625,9,8,6,16,36,47,-11,30
Glentoran,2625,10,8,5,17,28,48,-20,29
Portadown,2625,11,7,7,16,27,46,-19,28
Linfield,2626,1,17,9,4,64,27,37,60
Crusaders,2626,2,17,5,8,53,34,19,56
Coleraine,2626,3,14,10,6,44,30,14,52
Ballymena,2626,4,13,8,9,51,55,-4,47
Cliftonville,2626,5,13,3,14,49,43,6,42
Glenavon,2626,6,10,11,9,44,43,1,41
Dungannon,2626,7,11,7,12,49,41,8,40
Ards,2626,8,10,6,14,34,49,-15,36
Portadown,2626,9,8,6,16,25,48,-23,30
Glentoran,2626,10,7,8,15,30,46,-16,29
Ballinamalla,2626,11,5,7,18,27,54,-27,22
Linfield,2627,1,17,9,4,65,28,37,60
Crusaders,2627,2,16,9,5,59,37,22,57
Cliftonville,2627,3,14,4,12,52,45,7,46
Dungannon,2627,4,12,8,10,53,38,15,44
Glenavon,2627,5,11,9,10,51,53,-2,42
Coleraine,2627,6,9,12,9,39,37,2,39
Ballymena,2627,7,10,9,11,56,60,-4,39
Glentoran,2627,8,11,5,14,41,54,-13,38
Ards,2627,9,10,4,16,49,59,-10,34
Portadown,2627,10,8,7,15,29,45,-16,31
Ballinamalla,2627,11,7,4,19,31,69,-38,25
Linfield,2628,1,15,9,6,62,31,31,54
Crusaders,2628,2,15,9,6,50,36,14,54
Cliftonville,2628,3,14,8,8,48,35,13,50
Coleraine,2628,4,12,11,7,46,40,6,47
Ards,2628,5,12,5,13,51,44,7,41
Ballymena,2628,6,12,5,13,53,62,-9,41
Glenavon,2628,7,9,13,8,45,46,-1,40
Glentoran,2628,8,9,10,11,31,38,-7,37
Dungannon,2628,9,8,12,10,50,46,4,36
Portadown,2628,10,9,5,16,23,45,-22,32
Ballinamalla,2628,11,5,3,22,28,64,-36,18
Crusaders,2629,1,20,6,4,61,30,31,66
Linfield,2629,2,13,10,7,53,36,17,49
Coleraine,2629,3,12,12,6,43,36,7,48
Cliftonville,2629,4,14,5,11,56,39,17,47
Ballymena,2629,5,13,5,12,59,60,-1,44
Glenavon,2629,6,9,12,9,52,54,-2,39
Ards,2629,7,10,6,14,41,48,-7,36
Glentoran,2629,8,9,9,12,30,52,-22,36
Dungannon,2629,9,8,10,12,49,45,4,34
Ballinamalla,2629,10,8,3,19,32,55,-23,27
Portadown,2629,11,6,8,16,30,51,-21,26
Crusaders,2630,1,17,7,6,55,33,22,58
Ballymena,2630,2,15,6,9,57,53,4,51
Linfield,2630,3,14,8,8,58,36,22,50
Cliftonville,2630,4,13,6,11,47,37,10,45
Coleraine,2630,5,11,12,7,35,33,2,45
Glenavon,2630,6,11,11,8,44,40,4,44
Dungannon,2630,7,9,10,11,48,41,7,37
Ballinamalla,2630,8,9,6,15,33,49,-16,33
Portadown,2630,9,8,6,16,24,46,-22,30
Ards,2630,10,7,8,15,34,49,-15,29
Glentoran,2630,11,7,8,15,22,40,-18,29
Crusaders,2631,1,17,8,5,57,35,22,59
Cliftonville,2631,2,17,4,9,60,40,20,55
Coleraine,2631,3,14,9,7,48,36,12,51
Linfield,2631,4,13,9,8,55,33,22,48
Ballymena,2631,5,14,5,11,55,61,-6,47
Glentoran,2631,6,12,6,12,39,49,-10,42
Glenavon,2631,7,10,11,9,55,51,4,41
Dungannon,2631,8,9,8,13,45,47,-2,35
Ards,2631,9,10,3,17,51,56,-5,33
Portadown,2631,10,6,9,15,25,43,-18,27
Ballinamalla,2631,11,6,2,22,22,61,-39,20
Crusaders,2632,1,18,5,7,58,34,24,59
Cliftonville,2632,2,16,6,8,57,41,16,54
Coleraine,2632,3,14,11,5,54,32,22,53
Linfield,2632,4,15,7,8,57,36,21,52
Ballymena,2632,5,13,7,10,57,60,-3,46
Dungannon,2632,6,11,11,8,48,37,11,44
Glenavon,2632,7,10,10,10,44,49,-5,40
Ards,2632,8,9,5,16,39,50,-11,32
Ballinamalla,2632,9,8,4,18,32,57,-25,28
Glentoran,2632,10,6,8,16,31,55,-24,26
Portadown,2632,11,5,6,19,23,49,-26,21
Crusaders,2633,1,19,6,5,58,31,27,63
Ballymena,2633,2,17,4,9,57,51,6,55
Linfield,2633,3,13,9,8,57,35,22,48
Cliftonville,2633,4,14,4,12,49,39,10,46
Glenavon,2633,5,12,10,8,56,53,3,46
Coleraine,2633,6,10,11,9,39,46,-7,41
Dungannon,2633,7,9,11,10,53,44,9,38
Ards,2633,8,9,7,14,39,45,-6,34
Portadown,2633,9,9,4,17,28,49,-21,31
Glentoran,2633,10,6,9,15,26,45,-19,27
Ballinamalla,2633,11,8,3,19,32,56,-24,27
Crusaders,2634,1,19,6,5,64,30,34,63
Coleraine,2634,2,12,13,5,42,30,12,49
Linfield,2634,3,13,8,9,58,33,25,47
Cliftonville,2634,4,12,9,9,48,41,7,45
Ballymena,2634,5,13,5,12,57,60,-3,44
Glenavon,2634,6,9,12,9,41,47,-6,39
Dungannon,2634,7,9,11,10,46,43,3,38
Ards,2634,8,11,5,14,36,41,-5,38
Portadown,2634,9,11,5,14,26,40,-14,38
Glentoran,2634,10,8,6,16,24,50,-26,30
Ballinamalla,2634,11,6,4,20,31,58,-27,22
Linfield,2635,1,16,9,5,57,27,30,57
Crusaders,2635,2,15,9,6,61,43,18,54
Ballymena,2635,3,15,8,7,58,51,7,53
Cliftonville,2635,4,14,6,10,59,44,15,48
Coleraine,2635,5,12,10,8,44,35,9,46
Glenavon,2635,6,12,10,8,52,47,5,46
Dungannon,2635,7,10,8,12,49,50,-1,38
Glentoran,2635,8,9,5,16,25,39,-14,32
Ards,2635,9,9,5,16,38,53,-15,32
Ballinamalla,2635,10,7,4,19,30,55,-25,25
Portadown,2635,11,6,6,18,24,53,-29,24
Crusaders,2636,1,17,7,6,58,31,27,58
Linfield,2636,2,15,11,4,64,32,32,56
Ballymena,2636,3,16,5,9,64,57,7,53
Coleraine,2636,4,12,10,8,46,40,6,46
Cliftonville,2636,5,13,4,13,54,52,2,43
Glenavon,2636,6,9,11,10,44,48,-4,38
Dungannon,2636,7,8,12,10,46,44,2,36
Glentoran,2636,8,8,9,13,29,45,-16,33
Ballinamalla,2636,9,9,5,16,30,46,-16,32
Portadown,2636,10,9,5,16,27,45,-18,32
Ards,2636,11,7,5,18,30,52,-22,26
Linfield,2637,1,19,7,4,71,27,44,64
Crusaders,2637,2,18,5,7,52,40,12,59
Ballymena,2637,3,14,7,9,58,51,7,49
Glenavon,2637,4,12,11,7,55,42,13,47
Cliftonville,2637,5,14,5,11,56,55,1,47
Coleraine,2637,6,11,13,6,43,37,6,46
Dungannon,2637,7,7,11,12,48,44,4,32
Glentoran,2637,8,7,7,16,26,42,-16,28
Ballinamalla,2637,9,8,4,18,29,51,-22,28
Ards,2637,10,8,4,18,34,60,-26,28
Portadown,2637,11,6,8,16,21,44,-23,26
Linfield,2638,1,15,9,6,59,31,28,54
Crusaders,2638,2,15,9,6,54,34,20,54
Cliftonville,2638,3,15,6,9,48,35,13,51
Glenavon,2638,4,12,11,7,44,42,2,47
Coleraine,2638,5,12,9,9,40,32,8,45
Glentoran,2638,6,11,7,12,30,39,-9,40
Dungannon,2638,7,8,12,10,45,41,4,36
Ballymena,2638,8,10,6,14,52,64,-12,36
Ards,2638,9,8,6,16,37,50,-13,30
Portadown,2638,10,8,6,16,22,39,-17,30
Ballinamalla,2638,11,7,7,16,26,50,-24,28
Crusaders,2639,1,17,8,5,56,33,23,59
Ballymena,2639,2,16,7,7,62,54,8,55
Glenavon,2639,3,15,9,6,61,41,20,54
Linfield,2639,4,14,10,6,59,31,28,52
Cliftonville,2639,5,15,3,12,51,40,11,48
Coleraine,2639,6,11,9,10,45,45,0,42
Dungannon,2639,7,10,9,11,52,43,9,39
Ards,2639,8,9,5,16,36,52,-16,32
Glentoran,2639,9,8,8,14,30,50,-20,32
Portadown,2639,10,7,4,19,26,49,-23,25
Ballinamalla,2639,11,5,4,21,20,60,-40,19
Linfield,2640,1,15,8,7,59,30,29,53
Ballymena,2640,2,14,9,7,58,55,3,51
Coleraine,2640,3,13,10,7,46,36,10,49
Crusaders,2640,4,13,9,8,48,39,9,48
Cliftonville,2640,5,12,9,9,47,43,4,45
Dungannon,2640,6,11,8,11,52,44,8,41
Glenavon,2640,7,10,10,10,41,42,-1,40
Portadown,2640,8,11,6,13,36,46,-10,39
Ards,2640,9,10,5,15,41,44,-3,35
Glentoran,2640,10,7,10,13,26,42,-16,31
Ballinamalla,2640,11,3,8,19,18,51,-33,17
Cliftonville,2641,1,17,4,9,58,41,17,55
Linfield,2641,2,15,9,6,60,31,29,54
Crusaders,2641,3,15,5,10,52,33,19,50
Ballymena,2641,4,14,6,10,62,61,1,48
Coleraine,2641,5,12,11,7,44,33,11,47
Glenavon,2641,6,12,9,9,45,40,5,45
Dungannon,2641,7,12,8,10,56,47,9,44
Glentoran,2641,8,8,9,13,31,52,-21,33
Ards,2641,9,8,7,15,33,48,-15,31
Portadown,2641,10,7,5,18,29,53,-24,26
Ballinamalla,2641,11,6,5,19,26,57,-31,23
Linfield,2642,1,18,8,4,66,27,39,62
Cliftonville,2642,2,14,9,7,48,37,11,51
Ballymena,2642,3,14,5,11,63,59,4,47
Crusaders,2642,4,12,10,8,51,37,14,46
Glenavon,2642,5,10,13,7,50,48,2,43
Coleraine,2642,6,10,10,10,44,51,-7,40
Glentoran,2642,7,11,7,12,33,43,-10,40
Dungannon,2642,8,9,12,9,47,43,4,39
Portadown,2642,9,10,4,16,31,43,-12,34
Ards,2642,10,8,4,18,36,57,-21,28
Ballinamalla,2642,11,5,6,19,22,46,-24,21
Crusaders,2643,1,17,8,5,59,29,30,59
Linfield,2643,2,15,9,6,59,32,27,54
Cliftonville,2643,3,15,6,9,53,38,15,51
Coleraine,2643,4,11,9,10,40,40,0,42
Glenavon,2643,5,10,12,8,41,42,-1,42
Ballymena,2643,6,10,8,12,48,64,-16,38
Glentoran,2643,7,9,10,11,35,40,-5,37
Dungannon,2643,8,9,9,12,47,49,-2,36
Ballinamalla,2643,9,8,8,14,33,47,-14,32
Ards,2643,10,8,6,16,39,52,-13,30
Portadown,2643,11,7,7,16,30,51,-21,28
Cliftonville,2644,1,16,7,7,57,36,21,55
Linfield,2644,2,14,11,5,64,33,31,53
Crusaders,2644,3,14,9,7,51,38,13,51
Ballymena,2644,4,15,6,9,60,59,1,51
Dungannon,2644,5,12,8,10,53,41,12,44
Glenavon,2644,6,11,11,8,47,44,3,44
Coleraine,2644,7,8,11,11,36,42,-6,35
Ards,2644,8,9,7,14,33,42,-9,34
Ballinamalla,2644,9,8,7,15,33,50,-17,31
Glentoran,2644,10,8,6,16,29,48,-19,30
Portadown,2644,11,7,3,20,28,58,-30,24
Cliftonville,2645,1,16,5,9,49,37,12,53
Crusaders,2645,2,15,7,8,46,35,11,52
Ballymena,2645,3,13,9,8,52,52,0,48
Coleraine,2645,4,11,11,8,42,35,7,44
Linfield,2645,5,11,10,9,52,40,12,43
Dungannon,2645,6,10,12,8,52,42,10,42
Glenavon,2645,7,10,9,11,46,52,-6,39
Ards,2645,8,11,4,15,37,43,-6,37
Glentoran,2645,9,8,9,13,31,43,-12,33
Portadown,2645,10,9,4,17,35,47,-12,31
Ballinamalla,2645,11,9,4,17,33,49,-16,31
Cliftonville,2646,1,19,4,7,58,38,20,61
Crusaders,2646,2,16,10,4,61,36,25,58
Ballymena,2646,3,16,5,9,57,57,0,53
Dungannon,2646,4,11,10,9,51,44,7,43
Glenavon,2646,5,11,9,10,50,46,4,42
Linfield,2646,6,10,10,10,53,39,14,40
Coleraine,2646,7,9,12,9,40,43,-3,39
Ards,2646,8,10,4,16,44,52,-8,34
Glentoran,2646,9,9,6,15,31,46,-15,33
Ballinamalla,2646,10,7,7,16,29,51,-22,28
Portadown,2646,11,6,5,19,24,46,-22,23
Cliftonville,2647,1,18,4,8,54,29,25,58
Linfield,2647,2,14,11,5,62,33,29,53
Crusaders,2647,3,15,8,7,47,33,14,53
Glenavon,2647,4,12,12,6,46,38,8,48
Ballymena,2647,5,14,6,10,54,58,-4,48
Coleraine,2647,6,10,11,9,40,39,1,41
Glentoran,2647,7,10,6,14,32,47,-15,36
Ards,2647,8,10,5,15,34,41,-7,35
Dungannon,2647,9,8,9,13,44,44,0,33
Portadown,2647,10,8,7,15,24,46,-22,31
Ballinamalla,2647,11,5,3,22,23,52,-29,18
Linfield,2648,1,17,8,5,66,32,34,59
Crusaders,2648,2,16,10,4,58,31,27,58
Cliftonville,2648,3,16,5,9,61,43,18,53
Glenavon,2648,4,13,9,8,50,43,7,48
Coleraine,2648,5,12,11,7,47,37,10,47
Ballymena,2648,6,11,11,8,55,60,-5,44
Glentoran,2648,7,9,7,14,26,39,-13,34
Portadown,2648,8,10,2,18,30,47,-17,32
Dungannon,2648,9,7,7,16,42,49,-7,28
Ards,2648,10,7,7,16,32,51,-19,28
Ballinamalla,2648,11,6,5,19,21,56,-35,23
Ballymena,2649,1,17,5,8,62,54,8,56
Dungannon,2649,2,13,9,8,57,44,13,48
Crusaders,2649,3,14,6,10,53,42,11,48
Coleraine,2649,4,12,11,7,50,38,12,47
Linfield,2649,5,12,9,9,57,37,20,45
Cliftonville,2649,6,13,3,14,51,49,2,42
Ards,2649,7,12,4,14,44,46,-2,40
Glentoran,2649,8,10,7,13,36,55,-19,37
Glenavon,2649,9,8,12,10,41,44,-3,36
Ballinamalla,2649,10,9,5,16,36,53,-17,32
Portadown,2649,11,6,7,17,30,55,-25,25
Linfield,2650,1,15,9,6,59,26,33,54
Crusaders,2650,2,15,8,7,50,39,11,53
Cliftonville,2650,3,14,7,9,49,36,13,49
Glenavon,2650,4,13,8,9,47,40,7,47
Ballymena,2650,5,12,7,11,57,64,-7,43
Ards,2650,6,13,3,14,40,46,-6,42
Portadown,2650,7,11,5,14,34,40,-6,38
Dungannon,2650,8,8,12,10,50,52,-2,36
Coleraine,2650,9,9,8,13,41,44,-3,35
Ballinamalla,2650,10,8,6,16,28,47,-19,30
Glentoran,2650,11,5,11,14,20,41,-21,26
Linfield,2651,1,19,8,3,67,26,41,65
Crusaders,2651,2,18,6,6,58,32,26,60
Cliftonville,2651,3,17,3,10,56,40,16,54
Glenavon,2651,4,12,8,10,56,54,2,44
Dungannon,2651,5,11,9,10,56,44,12,42
Coleraine,2651,6,11,7,12,39,42,-3,40
Ballymena,2651,7,11,5,14,56,65,-9,38
Portadown,2651,8,10,4,16,36,58,-22,34
Glentoran,2651,9,9,6,15,34,48,-14,33
Ards,2651,10,7,6,17,35,57,-22,27
Ballinamalla,2651,11,7,4,19,33,60,-27,25
Crusaders,2652,1,14,9,7,49,32,17,51
Cliftonville,2652,2,14,6,10,51,38,13,48
Ballymena,2652,3,14,5,11,55,63,-8,47
Linfield,2652,4,12,10,8,57,36,21,46
Glenavon,2652,5,11,13,6,50,43,7,46
Coleraine,2652,6,11,10,9,40,39,1,43
Dungannon,2652,7,9,13,8,50,39,11,40
Ards,2652,8,11,4,15,35,45,-10,37
Glentoran,2652,9,9,9,12,34,44,-10,36
Ballinamalla,2652,10,10,6,14,32,48,-16,36
Portadown,2652,11,4,7,19,24,50,-26,19
Linfield,2653,1,17,9,4,54,22,32,60
Cliftonville,2653,2,14,7,9,56,41,15,49
Crusaders,2653,3,14,7,9,49,36,13,49
Dungannon,2653,4,12,9,9,54,43,11,45
Glenavon,2653,5,10,12,8,50,49,1,42
Ballymena,2653,6,12,6,12,54,62,-8,42
Glentoran,2653,7,10,11,9,36,39,-3,41
Coleraine,2653,8,9,12,9,49,50,-1,39
Ballinamalla,2653,9,10,5,15,30,43,-13,35
Ards,2653,10,8,5,17,37,52,-15,29
Portadown,2653,11,4,7,19,20,52,-32,19
Linfield,2654,1,17,10,3,60,28,32,61
Crusaders,2654,2,17,8,5,58,32,26,59
Cliftonville,2654,3,15,6,9,54,38,16,51
Ballymena,2654,4,13,4,13,52,57,-5,43
Glenavon,2654,5,10,12,8,45,43,2,42
Portadown,2654,6,10,7,13,38,47,-9,37
Ards,2654,7,10,5,15,42,48,-6,35
Coleraine,2654,8,8,10,12,36,43,-7,34
Dungannon,2654,9,8,9,13,44,50,-6,33
Glentoran,2654,10,8,7,15,35,51,-16,31
Ballinamalla,2654,11,7,6,17,27,54,-27,27
Linfield,2655,1,16,11,3,70,29,41,59
Crusaders,2655,2,14,7,9,48,37,11,49
Cliftonville,2655,3,14,6,10,45,39,6,48
Ballymena,2655,4,13,8,9,55,54,1,47
Coleraine,2655,5,12,10,8,41,38,3,46
Glenavon,2655,6,11,12,7,47,36,11,45
Dungannon,2655,7,10,9,11,52,43,9,39
Glentoran,2655,8,6,12,12,36,54,-18,30
Portadown,2655,9,7,8,15,21,43,-22,29
Ards,2655,10,8,4,18,36,57,-21,28
Ballinamalla,2655,11,6,9,15,27,48,-21,27
Cliftonville,2656,1,15,7,8,56,40,16,52
Crusaders,2656,2,15,7,8,46,35,11,52
Ballymena,2656,3,15,6,9,61,59,2,51
Linfield,2656,4,11,11,8,56,35,21,44
Coleraine,2656,5,10,14,6,45,39,6,44
Glenavon,2656,6,11,10,9,52,50,2,43
Dungannon,2656,7,9,11,10,48,40,8,38
Glentoran,2656,8,10,8,12,33,40,-7,38
Ballinamalla,2656,9,9,6,15,29,47,-18,33
Ards,2656,10,9,5,16,38,51,-13,32
Portadown,2656,11,6,5,19,18,46,-28,23
Crusaders,2657,1,18,7,5,57,33,24,61
Glenavon,2657,2,15,9,6,51,37,14,54
Coleraine,2657,3,14,9,7,49,31,18,51
Linfield,2657,4,14,8,8,58,38,20,50
Cliftonville,2657,5,14,7,9,52,39,13,49
Ballymena,2657,6,14,5,11,56,59,-3,47
Dungannon,2657,7,9,9,12,47,49,-2,36
Ballinamalla,2657,8,9,4,17,34,53,-19,31
Glentoran,2657,9,7,9,14,31,48,-17,30
Portadown,2657,10,6,6,18,25,50,-25,24
Ards,2657,11,5,7,18,30,53,-23,22
Linfield,2658,1,18,7,5,59,31,28,61
Coleraine,2658,2,14,11,5,49,35,14,53
Glenavon,2658,3,12,12,6,55,39,16,48
Crusaders,2658,4,13,8,9,50,45,5,47
Ballymena,2658,5,12,8,10,59,58,1,44
Dungannon,2658,6,12,7,11,60,52,8,43
Cliftonville,2658,7,13,3,14,50,51,-1,42
Glentoran,2658,8,8,8,14,31,45,-14,32
Portadown,2658,9,8,5,17,25,46,-21,29
Ards,2658,10,7,7,16,39,53,-14,28
Ballinamalla,2658,11,8,4,18,31,53,-22,28
Crusaders,2659,1,17,8,5,60,37,23,59
Linfield,2659,2,15,8,7,62,30,32,53
Cliftonville,2659,3,15,3,12,47,42,5,48
Coleraine,2659,4,12,10,8,51,36,15,46
Glenavon,2659,5,10,12,8,52,48,4,42
Ards,2659,6,13,3,14,41,44,-3,42
Dungannon,2659,7,10,10,10,49,45,4,40
Ballymena,2659,8,10,7,13,50,70,-20,37
Glentoran,2659,9,9,9,12,35,45,-10,36
Ballinamalla,2659,10,9,1,20,27,54,-27,28
Portadown,2659,11,7,5,18,25,48,-23,26
Crusaders,2660,1,16,7,7,56,36,20,55
Glenavon,2660,2,14,11,5,56,43,13,53
Cliftonville,2660,3,15,5,10,59,44,15,50
Coleraine,2660,4,11,9,10,42,38,4,42
Ballymena,2660,5,12,6,12,56,67,-11,42
Linfield,2660,6,10,10,10,46,41,5,40
Dungannon,2660,7,10,10,10,49,46,3,40
Glentoran,2660,8,11,6,13,39,43,-4,39
Portadown,2660,9,11,5,14,32,41,-9,38
Ards,2660,10,8,7,15,29,41,-12,31
Ballinamalla,2660,11,7,4,19,30,54,-24,25
Crusaders,2661,1,17,8,5,54,30,24,59
Ballymena,2661,2,15,7,8,56,49,7,52
Glenavon,2661,3,12,10,8,48,42,6,46
Coleraine,2661,4,11,12,7,42,35,7,45
Cliftonville,2661,5,13,6,11,47,44,3,45
Linfield,2661,6,11,9,10,53,35,18,42
Ards,2661,7,11,6,13,37,41,-4,39
Dungannon,2661,8,9,11,10,47,42,5,38
Glentoran,2661,9,9,7,14,28,41,-13,34
Portadown,2661,10,7,9,14,28,47,-19,30
Ballinamalla,2661,11,5,5,20,24,58,-34,20
Crusaders,2662,1,16,9,5,58,36,22,57
Linfield,2662,2,16,8,6,63,29,34,56
Cliftonville,2662,3,17,4,9,60,36,24,55
Ballymena,2662,4,14,6,10,59,56,3,48
Coleraine,2662,5,13,7,10,43,40,3,46
Glenavon,2662,6,10,11,9,46,47,-1,41
Dungannon,2662,7,9,11,10,47,48,-1,38
Ards,2662,8,9,8,13,38,51,-13,35
Glentoran,2662,9,6,10,14,25,47,-22,28
Ballinamalla,2662,10,7,4,19,30,52,-22,25
Portadown,2662,11,5,8,17,24,51,-27,23
Crusaders,2663,1,17,6,7,54,34,20,57
Ballymena,2663,2,16,5,9,66,55,11,53
Linfield,2663,3,15,6,9,56,31,25,51
Coleraine,2663,4,13,10,7,44,38,6,49
Cliftonville,2663,5,15,3,12,52,39,13,48
Glenavon,2663,6,12,11,7,51,43,8,47
Dungannon,2663,7,10,8,12,49,45,4,38
Glentoran,2663,8,10,8,12,31,38,-7,38
Portadown,2663,9,8,4,18,30,58,-28,28
Ards,2663,10,7,5,18,33,53,-20,26
Ballinamalla,2663,11,7,4,19,27,59,-32,25
Crusaders,2664,1,21,6,3,64,23,41,69
Linfield,2664,2,13,11,6,55,33,22,50
Cliftonville,2664,3,15,4,11,56,42,14,49
Coleraine,2664,4,12,11,7,42,37,5,47
Glenavon,2664,5,10,13,7,46,46,0,43
Ballymena,2664,6,12,6,12,57,63,-6,42
Dungannon,2664,7,10,9,11,43,39,4,39
Glentoran,2664,8,9,10,11,34,52,-18,37
Portadown,2664,9,8,5,17,30,48,-18,29
Ards,2664,10,7,7,16,33,49,-16,28
Ballinamalla,2664,11,3,8,19,25,53,-28,17
Crusaders,2665,1,18,6,6,62,33,29,60
Ballymena,2665,2,16,3,11,60,63,-3,51
Linfield,2665,3,13,11,6,59,34,25,50
Cliftonville,2665,4,16,2,12,62,51,11,50
Coleraine,2665,5,11,9,10,40,36,4,42
Glenavon,2665,6,9,14,7,45,44,1,41
Dungannon,2665,7,8,10,12,55,52,3,34
Ballinamalla,2665,8,10,4,16,39,57,-18,34
Ards,2665,9,9,5,16,40,55,-15,32
Portadown,2665,10,9,5,16,33,48,-15,32
Glentoran,2665,11,7,9,14,29,51,-22,30
Crusaders,2666,1,16,9,5,58,33,25,57
Linfield,2666,2,14,10,6,69,34,35,52
Cliftonville,2666,3,15,7,8,57,36,21,52
Glenavon,2666,4,14,8,8,50,50,0,50
Dungannon,2666,5,11,9,10,56,47,9,42
Ballymena,2666,6,12,6,12,53,60,-7,42
Coleraine,2666,7,10,9,11,41,48,-7,39
Glentoran,2666,8,10,8,12,31,43,-12,38
Ards,2666,9,7,10,13,36,47,-11,31
Ballinamalla,2666,10,7,5,18,29,56,-27,26
Portadown,2666,11,5,7,18,18,44,-26,22
Linfield,2667,1,16,8,6,60,31,29,56
Crusaders,2667,2,16,7,7,54,36,18,55
Ballymena,2667,3,15,6,9,55,49,6,51
Cliftonville,2667,4,14,5,11,47,33,14,47
Coleraine,2667,5,12,10,8,40,32,8,46
Glenavon,2667,6,12,9,9,42,45,-3,45
Ballinamalla,2667,7,11,4,15,37,53,-16,37
Dungannon,2667,8,9,9,12,51,45,6,36
Portadown,2667,9,9,3,18,24,49,-25,30
Ards,2667,10,7,7,16,30,47,-17,28
Glentoran,2667,11,6,8,16,25,45,-20,26
Crusaders,2668,1,17,7,6,56,36,20,58
Linfield,2668,2,15,8,7,65,42,23,53
Coleraine,2668,3,12,11,7,44,35,9,47
Cliftonville,2668,4,13,6,11,57,42,15,45
Dungannon,2668,5,12,8,10,54,40,14,44
Glenavon,2668,6,11,10,9,49,53,-4,43
Ballymena,2668,7,10,10,10,56,59,-3,40
Portadown,2668,8,11,3,16,28,46,-18,36
Ards,2668,9,9,5,16,39,56,-17,32
Glentoran,2668,10,7,8,15,35,50,-15,29
Ballinamalla,2668,11,8,4,18,31,55,-24,28
Cliftonville,2669,1,18,4,8,59,36,23,58
Linfield,2669,2,17,6,7,58,34,24,57
Crusaders,2669,3,15,5,10,53,39,14,50
Ballymena,2669,4,14,7,9,60,56,4,49
Glenavon,2669,5,11,10,9,55,49,6,43
Coleraine,2669,6,10,12,8,38,40,-2,42
Dungannon,2669,7,10,10,10,51,46,5,40
Glentoran,2669,8,9,6,15,26,45,-19,33
Ards,2669,9,9,5,16,39,49,-10,32
Ballinamalla,2669,10,9,4,17,35,50,-15,31
Portadown,2669,11,6,5,19,21,51,-30,23
Ballymena,2670,1,16,7,7,62,50,12,55
Glentoran,2670,2,15,6,9,44,38,6,51
Linfield,2670,3,13,10,7,50,31,19,49
Crusaders,2670,4,13,10,7,59,41,18,49
Coleraine,2670,5,12,10,8,44,36,8,46
Cliftonville,2670,6,14,4,12,48,47,1,46
Glenavon,2670,7,10,9,11,44,51,-7,39
Dungannon,2670,8,9,10,11,55,49,6,37
Portadown,2670,9,8,5,17,28,44,-16,29
Ards,2670,10,8,5,17,38,56,-18,29
Ballinamalla,2670,11,6,6,18,26,55,-29,24
Crusaders,2671,1,16,5,9,53,38,15,53
Linfield,2671,2,13,9,8,56,33,23,48
Coleraine,2671,3,11,13,6,42,34,8,46
Ballymena,2671,4,13,7,10,55,57,-2,46
Dungannon,2671,5,11,10,9,53,35,18,43
Cliftonville,2671,6,13,4,13,45,49,-4,43
Glenavon,2671,7,9,13,8,43,39,4,40
Glentoran,2671,8,11,7,12,34,43,-9,40
Ards,2671,9,11,6,13,42,45,-3,39
Portadown,2671,10,10,6,14,27,42,-15,36
Ballinamalla,2671,11,6,2,22,23,58,-35,20
Crusaders,2672,1,15,9,6,59,39,20,54
Cliftonville,2672,2,16,6,8,58,41,17,54
Glenavon,2672,3,12,12,6,49,43,6,48
Ballymena,2672,4,13,8,9,63,56,7,47
Dungannon,2672,5,12,9,9,54,43,11,45
Linfield,2672,6,12,8,10,51,34,17,44
Coleraine,2672,7,11,8,11,42,44,-2,41
Portadown,2672,8,9,5,16,27,42,-15,32
Ballinamalla,2672,9,8,6,16,36,57,-21,30
Glentoran,2672,10,5,13,12,24,42,-18,28
Ards,2672,11,8,4,18,34,56,-22,28
Ballymena,2673,1,17,6,7,70,56,14,57
Crusaders,2673,2,15,10,5,55,35,20,55
Coleraine,2673,3,14,10,6,47,32,15,52
Cliftonville,2673,4,15,4,11,53,39,14,49
Linfield,2673,5,12,12,6,51,32,19,48
Glenavon,2673,6,10,12,8,44,44,0,42
Ards,2673,7,10,3,17,37,55,-18,33
Glentoran,2673,8,9,5,16,31,54,-23,32
Dungannon,2673,9,6,13,11,48,47,1,31
Ballinamalla,2673,10,7,7,16,28,47,-19,28
Portadown,2673,11,6,6,18,22,45,-23,24
Crusaders,2674,1,15,11,4,52,30,22,56
Linfield,2674,2,14,10,6,61,32,29,52
Coleraine,2674,3,14,10,6,47,33,14,52
Cliftonville,2674,4,14,5,11,46,39,7,47
Ballymena,2674,5,12,8,10,55,59,-4,44
Dungannon,2674,6,9,11,10,47,41,6,38
Glenavon,2674,7,8,14,8,40,41,-1,38
Ballinamalla,2674,8,8,7,15,31,48,-17,31
Portadown,2674,9,8,7,15,22,40,-18,31
Glentoran,2674,10,7,9,14,27,48,-21,30
Ards,2674,11,6,8,16,36,53,-17,26
Linfield,2675,1,15,10,5,59,32,27,55
Crusaders,2675,2,16,7,7,56,34,22,55
Cliftonville,2675,3,15,5,10,51,36,15,50
Ballymena,2675,4,13,8,9,58,61,-3,47
Coleraine,2675,5,12,10,8,43,35,8,46
Glenavon,2675,6,11,12,7,56,45,11,45
Dungannon,2675,7,9,11,10,49,47,2,38
Glentoran,2675,8,8,9,13,33,45,-12,33
Ards,2675,9,9,4,17,36,56,-20,31
Portadown,2675,10,6,8,16,25,48,-23,26
Ballinamalla,2675,11,6,6,18,25,52,-27,24
Crusaders,2676,1,17,6,7,56,34,22,57
Cliftonville,2676,2,14,7,9,47,36,11,49
Ballymena,2676,3,13,8,9,57,59,-2,47
Glenavon,2676,4,12,10,8,51,45,6,46
Coleraine,2676,5,11,12,7,44,34,10,45
Linfield,2676,6,11,9,10,52,41,11,42
Ballinamalla,2676,7,13,2,15,39,49,-10,41
Dungannon,2676,8,10,8,12,46,41,5,38
Ards,2676,9,10,4,16,36,47,-11,34
Glentoran,2676,10,8,7,15,24,43,-19,31
Portadown,2676,11,8,3,19,27,50,-23,27
Ballymena,2677,1,15,8,7,62,56,6,53
Linfield,2677,2,14,10,6,55,32,23,52
Crusaders,2677,3,13,7,10,57,46,11,46
Cliftonville,2677,4,14,4,12,52,43,9,46
Glenavon,2677,5,12,10,8,54,47,7,46
Dungannon,2677,6,11,11,8,58,45,13,44
Coleraine,2677,7,11,11,8,45,34,11,44
Ballinamalla,2677,8,11,7,12,41,48,-7,40
Glentoran,2677,9,8,7,15,32,51,-19,31
Ards,2677,10,8,6,16,42,58,-16,30
Portadown,2677,11,4,7,19,21,59,-38,19
Cliftonville,2678,1,16,4,10,56,41,15,52
Crusaders,2678,2,13,10,7,52,42,10,49
Glenavon,2678,3,12,11,7,54,49,5,47
Coleraine,2678,4,12,10,8,47,43,4,46
Linfield,2678,5,12,9,9,58,44,14,45
Dungannon,2678,6,12,8,10,55,43,12,44
Ballymena,2678,7,11,8,11,51,56,-5,41
Glentoran,2678,8,11,5,14,30,42,-12,38
Ballinamalla,2678,9,10,4,16,37,52,-15,34
Ards,2678,10,9,5,16,40,46,-6,32
Portadown,2678,11,7,6,17,28,50,-22,27
Crusaders,2679,1,16,8,6,56,30,26,56
Cliftonville,2679,2,16,6,8,58,36,22,54
Linfield,2679,3,13,10,7,60,31,29,49
Coleraine,2679,4,12,10,8,42,34,8,46
Glenavon,2679,5,10,13,7,47,47,0,43
Ards,2679,6,11,7,12,39,44,-5,40
Ballymena,2679,7,11,7,12,49,60,-11,40
Dungannon,2679,8,10,9,11,47,40,7,39
Glentoran,2679,9,9,7,14,31,49,-18,34
Ballinamalla,2679,10,7,6,17,29,55,-26,27
Portadown,2679,11,5,7,18,17,49,-32,22
Crusaders,2680,1,19,9,2,67,29,38,66
Linfield,2680,2,17,8,5,61,33,28,59
Cliftonville,2680,3,16,5,9,57,38,19,53
Ballymena,2680,4,14,6,10,65,67,-2,48
Dungannon,2680,5,12,9,9,53,42,11,45
Coleraine,2680,6,9,13,8,40,42,-2,40
Glenavon,2680,7,8,10,12,42,48,-6,34
Ballinamalla,2680,8,7,8,15,33,52,-19,29
Ards,2680,9,6,8,16,34,52,-18,26
Glentoran,2680,10,5,10,15,25,49,-24,25
Portadown,2680,11,6,6,18,25,50,-25,24
Linfield,2681,1,16,9,5,63,31,32,57
Crusaders,2681,2,16,9,5,58,40,18,57
Cliftonville,2681,3,17,4,9,61,41,20,55
Coleraine,2681,4,12,9,9,37,38,-1,45
Ballymena,2681,5,12,7,11,49,55,-6,43
Dungannon,2681,6,11,9,10,52,43,9,42
Glenavon,2681,7,10,9,11,46,52,-6,39
Ballinamalla,2681,8,10,2,18,32,48,-16,32
Portadown,2681,9,8,7,15,28,40,-12,31
Glentoran,2681,10,7,7,16,30,52,-22,28
Ards,2681,11,7,6,17,41,57,-16,27
Cliftonville,2682,1,17,6,7,55,32,23,57
Linfield,2682,2,14,10,6,58,28,30,52
Coleraine,2682,3,13,13,4,45,31,14,52
Ballymena,2682,4,14,6,10,58,53,5,48
Crusaders,2682,5,13,6,11,47,38,9,45
Glenavon,2682,6,10,13,7,44,45,-1,43
Ards,2682,7,11,6,13,39,40,-1,39
Dungannon,2682,8,8,10,12,43,43,0,34
Portadown,2682,9,7,7,16,19,43,-24,28
Glentoran,2682,10,7,6,17,26,56,-30,27
Ballinamalla,2682,11,6,7,17,26,51,-25,25
Linfield,2683,1,15,9,6,66,36,30,54
Crusaders,2683,2,15,8,7,56,36,20,53
Cliftonville,2683,3,14,6,10,48,40,8,48
Coleraine,2683,4,10,12,8,46,43,3,42
Glenavon,2683,5,11,9,10,50,49,1,42
Dungannon,2683,6,10,9,11,55,49,6,39
Ballymena,2683,7,11,6,13,53,62,-9,39
Glentoran,2683,8,11,5,14,36,54,-18,38
Ards,2683,9,11,3,16,35,48,-13,36
Ballinamalla,2683,10,10,5,15,35,53,-18,35
Portadown,2683,11,8,6,16,34,44,-10,30
Linfield,2684,1,17,8,5,65,29,36,59
Cliftonville,2684,2,18,5,7,55,30,25,59
Crusaders,2684,3,15,7,8,61,39,22,52
Glenavon,2684,4,11,11,8,45,43,2,44
Coleraine,2684,5,11,10,9,39,41,-2,43
Dungannon,2684,6,11,8,11,49,42,7,41
Ballymena,2684,7,11,6,13,54,71,-17,39
Glentoran,2684,8,9,8,13,29,40,-11,35
Portadown,2684,9,10,5,15,28,42,-14,35
Ards,2684,10,7,6,17,37,55,-18,27
Ballinamalla,2684,11,5,6,19,25,55,-30,21
Crusaders,2685,1,17,9,4,62,30,32,60
Ballymena,2685,2,16,7,7,56,44,12,55
Glenavon,2685,3,12,13,5,47,40,7,49
Linfield,2685,4,13,8,9,50,37,13,47
Coleraine,2685,5,12,9,9,40,30,10,45
Cliftonville,2685,6,12,9,9,40,31,9,45
Dungannon,2685,7,8,10,12,47,45,2,34
Ards,2685,8,9,5,16,37,51,-14,32
Glentoran,2685,9,8,8,14,25,43,-18,32
Portadown,2685,10,5,10,15,26,49,-23,25
Ballinamalla,2685,11,6,6,18,28,58,-30,24
Linfield,2686,1,16,11,3,64,27,37,59
Dungannon,2686,2,14,7,9,60,40,20,49
Crusaders,2686,3,13,9,8,44,35,9,48
Cliftonville,2686,4,14,5,11,52,40,12,47
Glenavon,2686,5,11,13,6,56,48,8,46
Coleraine,2686,6,12,8,10,44,38,6,44
Ballymena,2686,7,13,4,13,59,63,-4,43
Ards,2686,8,8,10,12,41,44,-3,34
Glentoran,2686,9,8,8,14,25,48,-23,32
Ballinamalla,2686,10,8,4,18,25,57,-32,28
Portadown,2686,11,7,3,20,21,51,-30,24
Crusaders,2687,1,18,7,5,52,31,21,61
Ballymena,2687,2,19,4,7,62,47,15,61
Cliftonville,2687,3,17,5,8,59,39,20,56
Linfield,2687,4,14,11,5,58,31,27,53
Glenavon,2687,5,10,12,8,48,48,0,42
Dungannon,2687,6,10,10,10,52,42,10,40
Coleraine,2687,7,10,10,10,43,40,3,40
Glentoran,2687,8,7,10,13,28,46,-18,31
Ards,2687,9,6,8,16,41,56,-15,26
Ballinamalla,2687,10,6,4,20,29,64,-35,22
Portadown,2687,11,5,5,20,19,47,-28,20
Crusaders,2688,1,19,7,4,54,30,24,64
Linfield,2688,2,13,10,7,56,33,23,49
Ballymena,2688,3,13,6,11,50,56,-6,45
Cliftonville,2688,4,12,8,10,45,37,8,44
Coleraine,2688,5,10,11,9,39,35,4,41
Dungannon,2688,6,10,9,11,44,40,4,39
Glenavon,2688,7,9,11,10,42,42,0,38
Ballinamalla,2688,8,11,5,14,35,48,-13,38
Ards,2688,9,9,8,13,43,50,-7,35
Portadown,2688,10,8,6,16,28,45,-17,30
Glentoran,2688,11,6,9,15,30,50,-20,27
Crusaders,2689,1,15,8,7,58,42,16,53
Cliftonville,2689,2,16,4,10,56,42,14,52
Linfield,2689,3,13,9,8,53,31,22,48
Ballymena,2689,4,14,6,10,57,62,-5,48
Coleraine,2689,5,12,8,10,47,45,2,44
Dungannon,2689,6,10,10,10,55,47,8,40
Glenavon,2689,7,10,10,10,49,46,3,40
Ballinamalla,2689,8,11,5,14,32,42,-10,38
Ards,2689,9,10,4,16,43,54,-11,34
Glentoran,2689,10,8,8,14,31,47,-16,32
Portadown,2689,11,7,6,17,34,57,-23,27
Crusaders,2690,1,15,7,8,54,35,19,52
Glenavon,2690,2,13,12,5,45,36,9,51
Ballymena,2690,3,15,6,9,57,52,5,51
Linfield,2690,4,12,10,8,53,34,19,46
Dungannon,2690,5,12,9,9,56,43,13,45
Coleraine,2690,6,11,11,8,32,30,2,44
Cliftonville,2690,7,12,6,12,41,37,4,42
Ballinamalla,2690,8,9,6,15,36,55,-19,33
Glentoran,2690,9,7,10,13,34,51,-17,31
Portadown,2690,10,7,7,16,28,48,-20,28
Ards,2690,11,6,8,16,35,50,-15,26
Linfield,2691,1,17,8,5,67,32,35,59
Cliftonville,2691,2,17,4,9,60,38,22,55
Crusaders,2691,3,16,6,8,54,39,15,54
Glenavon,2691,4,14,8,8,57,43,14,50
Glentoran,2691,5,11,8,11,35,44,-9,41
Ballymena,2691,6,10,8,12,53,58,-5,38
Coleraine,2691,7,9,11,10,38,46,-8,38
Ballinamalla,2691,8,11,3,16,40,58,-18,36
Dungannon,2691,9,8,9,13,50,56,-6,33
Ards,2691,10,8,6,16,34,45,-11,30
Portadown,2691,11,4,9,17,21,50,-29,21
Cliftonville,2692,1,19,3,8,60,38,22,60
Linfield,2692,2,15,9,6,66,28,38,54
Crusaders,2692,3,16,6,8,50,32,18,54
Ballymena,2692,4,16,5,9,60,52,8,53
Glenavon,2692,5,10,11,9,49,55,-6,41
Coleraine,2692,6,9,9,12,37,43,-6,36
Glentoran,2692,7,10,4,16,28,46,-18,34
Dungannon,2692,8,7,12,11,48,51,-3,33
Ballinamalla,2692,9,10,3,17,35,50,-15,33
Ards,2692,10,9,5,16,38,56,-18,32
Portadown,2692,11,8,5,17,24,44,-20,29
Crusaders,2693,1,17,9,4,57,31,26,60
Linfield,2693,2,16,9,5,58,26,32,57
Cliftonville,2693,3,12,8,10,46,38,8,44
Ballymena,2693,4,11,10,9,51,55,-4,43
Coleraine,2693,5,10,12,8,44,41,3,42
Portadown,2693,6,10,8,12,32,38,-6,38
Ards,2693,7,11,4,15,45,49,-4,37
Dungannon,2693,8,8,10,12,40,42,-2,34
Glenavon,2693,9,7,12,11,39,52,-13,33
Ballinamalla,2693,10,10,3,17,30,48,-18,33
Glentoran,2693,11,6,9,15,26,48,-22,27
Linfield,2694,1,17,8,5,64,28,36,59
Crusaders,2694,2,17,8,5,56,34,22,59
Cliftonville,2694,3,17,4,9,56,41,15,55
Ballymena,2694,4,14,8,8,57,56,1,50
Glenavon,2694,5,10,14,6,47,45,2,44
Coleraine,2694,6,10,12,8,43,36,7,42
Dungannon,2694,7,8,9,13,56,54,2,33
Ballinamalla,2694,8,7,7,16,32,53,-21,28
Ards,2694,9,6,9,15,42,60,-18,27
Glentoran,2694,10,7,6,17,32,51,-19,27
Portadown,2694,11,6,7,17,23,50,-27,25
Crusaders,2695,1,19,6,5,65,32,33,63
Cliftonville,2695,2,19,4,7,54,30,24,61
Linfield,2695,3,15,10,5,60,31,29,55
Dungannon,2695,4,12,10,8,51,40,11,46
Ballymena,2695,5,13,6,11,53,52,1,45
Coleraine,2695,6,10,14,6,40,34,6,44
Glenavon,2695,7,7,12,11,43,53,-10,33
Ards,2695,8,7,7,16,34,49,-15,28
Ballinamalla,2695,9,7,6,17,35,60,-25,27
Portadown,2695,10,7,5,18,20,47,-27,26
Glentoran,2695,11,5,8,17,26,53,-27,23
Cliftonville,2696,1,18,3,9,60,43,17,57
Linfield,2696,2,14,12,4,60,33,27,54
Crusaders,2696,3,13,9,8,47,33,14,48
Glenavon,2696,4,12,11,7,53,54,-1,47
Ballymena,2696,5,13,7,10,62,63,-1,46
Glentoran,2696,6,10,9,11,32,42,-10,39
Dungannon,2696,7,9,9,12,48,44,4,36
Coleraine,2696,8,8,12,10,42,45,-3,36
Portadown,2696,9,9,6,15,37,44,-7,33
Ards,2696,10,8,8,14,34,45,-11,32
Ballinamalla,2696,11,6,4,20,24,53,-29,22
Crusaders,2697,1,18,9,3,57,29,28,63
Linfield,2697,2,15,9,6,58,32,26,54
Cliftonville,2697,3,16,5,9,52,38,14,53
Coleraine,2697,4,11,14,5,45,33,12,47
Ballymena,2697,5,13,6,11,54,54,0,45
Glenavon,2697,6,11,11,8,39,39,0,44
Dungannon,2697,7,8,7,15,45,46,-1,31
Glentoran,2697,8,7,10,13,31,46,-15,31
Ballinamalla,2697,9,7,8,15,30,50,-20,29
Ards,2697,10,7,7,16,38,51,-13,28
Portadown,2697,11,6,6,18,21,52,-31,24
Linfield,2698,1,16,9,5,63,28,35,57
Crusaders,2698,2,17,5,8,53,40,13,56
Cliftonville,2698,3,13,7,10,53,42,11,46
Glenavon,2698,4,12,10,8,47,42,5,46
Dungannon,2698,5,12,9,9,50,38,12,45
Ballymena,2698,6,13,6,11,55,55,0,45
Glentoran,2698,7,12,5,13,38,44,-6,41
Coleraine,2698,8,10,10,10,40,38,2,40
Ards,2698,9,10,4,16,35,50,-15,34
Portadown,2698,10,7,4,19,18,50,-32,25
Ballinamalla,2698,11,7,3,20,27,52,-25,24
Cliftonville,2699,1,18,4,8,67,39,28,58
Ballymena,2699,2,16,5,9,64,58,6,53
Crusaders,2699,3,15,6,9,51,37,14,51
Linfield,2699,4,12,8,10,56,42,14,44
Glenavon,2699,5,12,8,10,50,50,0,44
Dungannon,2699,6,10,10,10,49,44,5,40
Coleraine,2699,7,10,10,10,39,40,-1,40
Glentoran,2699,8,10,7,13,35,45,-10,37
Ballinamalla,2699,9,8,7,15,29,49,-20,31
Portadown,2699,10,8,6,16,30,50,-20,30
Ards,2699,11,8,5,17,33,49,-16,29
Crusaders,2700,1,17,7,6,54,26,28,58
Ballymena,2700,2,16,4,10,66,57,9,52
Linfield,2700,3,14,7,9,52,31,21,49
Cliftonville,2700,4,11,10,9,47,41,6,43
Coleraine,2700,5,10,13,7,41,39,2,43
Glenavon,2700,6,10,12,8,53,46,7,42
Dungannon,2700,7,10,9,11,45,41,4,39
Ards,2700,8,10,5,15,35,48,-13,35
Portadown,2700,9,10,4,16,29,46,-17,34
Ballinamalla,2700,10,10,3,17,34,55,-21,33
Glentoran,2700,11,6,8,16,27,53,-26,26
Linfield,2701,1,16,10,4,65,32,33,58
Crusaders,2701,2,16,6,8,54,41,13,54
Cliftonville,2701,3,15,5,10,55,45,10,50
Ballymena,2701,4,15,5,10,60,59,1,50
Dungannon,2701,5,13,9,8,58,43,15,48
Glenavon,2701,6,12,11,7,51,41,10,47
Coleraine,2701,7,11,9,10,43,40,3,42
Ards,2701,8,10,5,15,46,53,-7,35
Glentoran,2701,9,8,7,15,28,45,-17,31
Ballinamalla,2701,10,7,2,21,28,62,-34,23
Portadown,2701,11,5,5,20,28,55,-27,20
Crusaders,2702,1,14,11,5,61,36,25,53
Glenavon,2702,2,14,8,8,58,46,12,50
Ballymena,2702,3,13,8,9,60,60,0,47
Cliftonville,2702,4,13,7,10,47,37,10,46
Coleraine,2702,5,11,10,9,40,39,1,43
Linfield,2702,6,10,11,9,51,43,8,41
Ards,2702,7,11,6,13,45,50,-5,39
Glentoran,2702,8,9,8,13,29,46,-17,35
Ballinamalla,2702,9,10,4,16,36,53,-17,34
Dungannon,2702,10,7,12,11,49,50,-1,33
Portadown,2702,11,7,7,16,34,50,-16,28
Crusaders,2703,1,17,7,6,54,32,22,58
Linfield,2703,2,16,8,6,59,28,31,56
Cliftonville,2703,3,15,5,10,47,34,13,50
Ballymena,2703,4,15,4,11,50,53,-3,49
Glenavon,2703,5,11,10,9,49,44,5,43
Coleraine,2703,6,10,11,9,42,40,2,41
Ards,2703,7,11,6,13,40,43,-3,39
Glentoran,2703,8,10,7,13,33,45,-12,37
Dungannon,2703,9,7,12,11,46,44,2,33
Ballinamalla,2703,10,8,3,19,26,55,-29,27
Portadown,2703,11,6,5,19,19,47,-28,23
Crusaders,2704,1,18,7,5,63,31,32,61
Linfield,2704,2,15,8,7,62,30,32,53
Coleraine,2704,3,14,10,6,50,33,17,52
Cliftonville,2704,4,15,5,10,53,49,4,50
Ballymena,2704,5,15,3,12,60,62,-2,48
Glenavon,2704,6,12,11,7,48,41,7,47
Dungannon,2704,7,10,10,10,50,45,5,40
Glentoran,2704,8,10,7,13,31,40,-9,37
Ards,2704,9,8,6,16,34,53,-19,30
Portadown,2704,10,5,5,20,24,57,-33,20
Ballinamalla,2704,11,4,6,20,25,59,-34,18
Crusaders,2705,1,17,7,6,52,33,19,58
Cliftonville,2705,2,17,4,9,55,37,18,55
Ballymena,2705,3,14,8,8,48,48,0,50
Linfield,2705,4,13,10,7,49,25,24,49
Glenavon,2705,5,11,13,6,51,42,9,46
Coleraine,2705,6,12,10,8,42,36,6,46
Dungannon,2705,7,10,8,12,51,44,7,38
Ards,2705,8,9,6,15,32,48,-16,33
Ballinamalla,2705,9,7,6,17,23,47,-24,27
Glentoran,2705,10,7,5,18,22,44,-22,26
Portadown,2705,11,6,7,17,25,46,-21,25
Crusaders,2706,1,18,7,5,63,36,27,61
Linfield,2706,2,16,9,5,63,31,32,57
Cliftonville,2706,3,15,4,11,49,40,9,49
Ballymena,2706,4,14,5,11,55,60,-5,47
Glenavon,2706,5,11,11,8,50,46,4,44
Coleraine,2706,6,10,11,9,44,37,7,41
Dungannon,2706,7,9,11,10,49,46,3,38
Glentoran,2706,8,11,5,14,35,47,-12,38
Ards,2706,9,10,7,13,41,47,-6,37
Portadown,2706,10,6,6,18,24,50,-26,24
Ballinamalla,2706,11,5,4,21,24,57,-33,19
Linfield,2707,1,17,8,5,66,30,36,59
Crusaders,2707,2,16,7,7,51,37,14,55
Glenavon,2707,3,14,9,7,56,44,12,51
Coleraine,2707,4,10,12,8,45,36,9,42
Cliftonville,2707,5,12,6,12,50,45,5,42
Dungannon,2707,6,10,9,11,51,43,8,39
Ballinamalla,2707,7,12,3,15,38,49,-11,39
Ballymena,2707,8,11,6,13,51,64,-13,39
Glentoran,2707,9,9,7,14,35,49,-14,34
Portadown,2707,10,9,4,17,28,46,-18,31
Ards,2707,11,7,5,18,36,64,-28,26
Ballymena,2708,1,18,6,6,73,53,20,60
Cliftonville,2708,2,16,6,8,59,42,17,54
Crusaders,2708,3,15,7,8,56,39,17,52
Linfield,2708,4,13,9,8,55,36,19,48
Glenavon,2708,5,10,12,8,45,44,1,42
Dungannon,2708,6,9,11,10,58,48,10,38
Coleraine,2708,7,10,8,12,40,48,-8,38
Ballinamalla,2708,8,9,6,15,37,55,-18,33
Portadown,2708,9,9,6,15,24,42,-18,33
Glentoran,2708,10,6,10,14,23,47,-24,28
Ards,2708,11,7,5,18,33,49,-16,26
Linfield,2709,1,17,9,4,65,27,38,60
Crusaders,2709,2,16,9,5,58,36,22,57
Cliftonville,2709,3,14,8,8,58,37,21,50
Coleraine,2709,4,13,9,8,45,40,5,48
Dungannon,2709,5,10,10,10,49,44,5,40
Ballymena,2709,6,11,5,14,52,60,-8,38
Glentoran,2709,7,11,5,14,33,44,-11,38
Glenavon,2709,8,9,9,12,42,46,-4,36
Ards,2709,9,8,6,16,36,54,-18,30
Ballinamalla,2709,10,8,5,17,27,49,-22,29
Portadown,2709,11,7,7,16,24,52,-28,28
Crusaders,2710,1,18,6,6,56,37,19,60
Linfield,2710,2,15,9,6,64,31,33,54
Coleraine,2710,3,13,11,6,39,29,10,50
Dungannon,2710,4,14,7,9,53,39,14,49
Cliftonville,2710,5,14,7,9,52,39,13,49
Ballymena,2710,6,14,7,9,58,59,-1,49
Glenavon,2710,7,8,10,12,40,44,-4,34
Portadown,2710,8,8,6,16,28,47,-19,30
Ards,2710,9,8,4,18,38,52,-14,28
Glentoran,2710,10,6,9,15,25,47,-22,27
Ballinamalla,2710,11,7,4,19,26,55,-29,25
Crusaders,2711,1,18,8,4,58,30,28,62
Linfield,2711,2,15,11,4,65,30,35,56
Coleraine,2711,3,13,12,5,49,33,16,51
Cliftonville,2711,4,14,5,11,48,48,0,47
Ballymena,2711,5,13,6,11,59,62,-3,45
Dungannon,2711,6,9,12,9,46,39,7,39
Glenavon,2711,7,8,11,11,38,46,-8,35
Glentoran,2711,8,9,8,13,34,45,-11,35
Ards,2711,9,7,7,16,31,43,-12,28
Portadown,2711,10,6,8,16,23,44,-21,26
Ballinamalla,2711,11,7,4,19,25,56,-31,25
Crusaders,2712,1,17,6,7,58,37,21,57
Cliftonville,2712,2,15,7,8,53,42,11,52
Coleraine,2712,3,13,10,7,53,37,16,49
Ballymena,2712,4,13,9,8,68,65,3,48
Linfield,2712,5,11,12,7,55,35,20,45
Glentoran,2712,6,11,8,11,35,42,-7,41
Dungannon,2712,7,10,9,11,48,47,1,39
Glenavon,2712,8,10,9,11,45,47,-2,39
Ards,2712,9,8,7,15,30,45,-15,31
Ballinamalla,2712,10,7,4,19,27,51,-24,25
Portadown,2712,11,6,7,17,25,49,-24,25
Cliftonville,2713,1,18,3,9,56,38,18,57
Linfield,2713,2,16,8,6,56,25,31,56
Crusaders,2713,3,16,6,8,56,42,14,54
Glenavon,2713,4,12,10,8,46,44,2,46
Dungannon,2713,5,11,9,10,45,35,10,42
Ballymena,2713,6,12,6,12,52,58,-6,42
Coleraine,2713,7,10,10,10,39,36,3,40
Glentoran,2713,8,10,6,14,33,45,-12,36
Ards,2713,9,9,6,15,35,46,-11,33
Ballinamalla,2713,10,9,3,18,27,49,-22,30
Portadown,2713,11,6,5,19,18,45,-27,23
Crusaders,2714,1,19,7,4,57,36,21,64
Linfield,2714,2,14,10,6,60,31,29,52
Cliftonville,2714,3,16,4,10,66,42,24,52
Dungannon,2714,4,13,7,10,45,38,7,46
Coleraine,2714,5,12,10,8,41,34,7,46
Glenavon,2714,6,11,11,8,48,40,8,44
Ballymena,2714,7,13,5,12,47,56,-9,44
Ards,2714,8,9,5,16,39,54,-15,32
Glentoran,2714,9,7,7,16,27,48,-21,28
Ballinamalla,2714,10,6,6,18,30,52,-22,24
Portadown,2714,11,6,6,18,24,53,-29,24
Cliftonville,2715,1,19,3,8,56,35,21,60
Ballymena,2715,2,15,7,8,63,58,5,52
Glenavon,2715,3,13,9,8,45,40,5,48
Linfield,2715,4,12,10,8,51,28,23,46
Crusaders,2715,5,12,10,8,44,34,10,46
Dungannon,2715,6,11,7,12,46,39,7,40
Glentoran,2715,7,10,9,11,31,40,-9,39
Coleraine,2715,8,9,10,11,37,42,-5,37
Ballinamalla,2715,9,9,5,16,31,47,-16,32
Portadown,2715,10,9,5,16,22,45,-23,32
Ards,2715,11,6,5,19,32,50,-18,23
Glenavon,2716,1,15,9,6,52,36,16,54
Linfield,2716,2,14,7,9,57,31,26,49
Crusaders,2716,3,13,7,10,47,35,12,46
Coleraine,2716,4,12,10,8,41,40,1,46
Cliftonville,2716,5,14,3,13,46,42,4,45
Ballymena,2716,6,13,6,11,57,54,3,45
Dungannon,2716,7,11,9,10,46,41,5,42
Glentoran,2716,8,11,5,14,34,49,-15,38
Ballinamalla,2716,9,10,4,16,29,45,-16,34
Ards,2716,10,8,6,16,31,49,-18,30
Portadown,2716,11,8,6,16,26,44,-18,30
Linfield,2717,1,15,11,4,63,33,30,56
Crusaders,2717,2,14,11,5,52,30,22,53
Ballymena,2717,3,15,7,8,68,55,13,52
Cliftonville,2717,4,13,9,8,48,40,8,48
Coleraine,2717,5,10,12,8,42,40,2,42
Dungannon,2717,6,10,11,9,51,42,9,41
Glenavon,2717,7,8,14,8,49,51,-2,38
Glentoran,2717,8,10,6,14,28,45,-17,36
Ards,2717,9,9,5,16,39,54,-15,32
Portadown,2717,10,6,10,14,24,45,-21,28
Ballinamalla,2717,11,5,4,21,28,57,-29,19
Linfield,2718,1,15,11,4,65,33,32,56
Crusaders,2718,2,15,9,6,59,40,19,54
Cliftonville,2718,3,12,10,8,53,41,12,46
Ballymena,2718,4,12,9,9,57,58,-1,45
Glentoran,2718,5,12,8,10,40,43,-3,44
Dungannon,2718,6,11,10,9,55,42,13,43
Coleraine,2718,7,9,11,10,38,37,1,38
Glenavon,2718,8,9,8,13,37,44,-7,35
Ards,2718,9,8,8,14,38,50,-12,32
Portadown,2718,10,9,3,18,28,50,-22,30
Ballinamalla,2718,11,8,3,19,28,60,-32,27
Cliftonville,2719,1,18,3,9,59,36,23,57
Linfield,2719,2,15,10,5,58,25,33,55
Crusaders,2719,3,16,7,7,49,36,13,55
Ballymena,2719,4,12,8,10,55,61,-6,44
Glenavon,2719,5,10,11,9,48,46,2,41
Coleraine,2719,6,10,10,10,49,47,2,40
Dungannon,2719,7,10,9,11,54,47,7,39
Glentoran,2719,8,10,8,12,30,46,-16,38
Ballinamalla,2719,9,9,6,15,35,48,-13,33
Ards,2719,10,9,3,18,34,49,-15,30
Portadown,2719,11,7,3,20,23,53,-30,24
Glenavon,2720,1,15,11,4,60,46,14,56
Linfield,2720,2,14,12,4,60,28,32,54
Crusaders,2720,3,15,7,8,56,39,17,52
Cliftonville,2720,4,14,7,9,49,37,12,49
Ballymena,2720,5,14,5,11,57,57,0,47
Coleraine,2720,6,9,10,11,41,47,-6,37
Ards,2720,7,9,8,13,39,47,-8,35
Ballinamalla,2720,8,9,7,14,31,44,-13,34
Dungannon,2720,9,8,9,13,47,47,0,33
Portadown,2720,10,8,5,17,27,50,-23,29
Glentoran,2720,11,7,5,18,27,52,-25,26
Cliftonville,2721,1,19,4,7,57,32,25,61
Crusaders,2721,2,14,10,6,50,30,20,52
Linfield,2721,3,13,11,6,52,32,20,50
Coleraine,2721,4,12,11,7,46,38,8,47
Glenavon,2721,5,12,10,8,45,47,-2,46
Ballymena,2721,6,10,9,11,52,54,-2,39
Ards,2721,7,11,3,16,43,51,-8,36
Dungannon,2721,8,8,11,11,46,44,2,35
Glentoran,2721,9,7,9,14,22,41,-19,30
Ballinamalla,2721,10,6,8,16,21,42,-21,26
Portadown,2721,11,6,8,16,22,45,-23,26
Crusaders,2722,1,18,8,4,58,34,24,62
Ballymena,2722,2,15,6,9,62,57,5,51
Linfield,2722,3,12,11,7,54,36,18,47
Dungannon,2722,4,12,8,10,54,44,10,44
Coleraine,2722,5,11,10,9,45,44,1,43
Cliftonville,2722,6,12,6,12,48,42,6,42
Portadown,2722,7,11,6,13,29,37,-8,39
Ards,2722,8,10,5,15,39,50,-11,35
Glenavon,2722,9,7,11,12,47,55,-8,32
Glentoran,2722,10,7,9,14,29,45,-16,30
Ballinamalla,2722,11,7,6,17,24,45,-21,27
Linfield,2723,1,18,9,3,72,31,41,63
Crusaders,2723,2,14,6,10,55,41,14,48
Cliftonville,2723,3,14,6,10,52,43,9,48
Glenavon,2723,4,13,9,8,51,44,7,48
Coleraine,2723,5,12,10,8,43,36,7,46
Ballymena,2723,6,12,5,13,53,69,-16,41
Ards,2723,7,11,7,12,38,41,-3,40
Glentoran,2723,8,9,8,13,34,46,-12,35
Ballinamalla,2723,9,8,8,14,31,46,-15,32
Dungannon,2723,10,7,10,13,52,54,-2,31
Portadown,2723,11,6,4,20,22,52,-30,22
Crusaders,2724,1,14,9,7,50,34,16,51
Cliftonville,2724,2,15,5,10,52,38,14,50
Linfield,2724,3,14,7,9,50,32,18,49
Dungannon,2724,4,13,7,10,55,41,14,46
Glentoran,2724,5,13,6,11,41,41,0,45
Glenavon,2724,6,10,12,8,45,40,5,42
Ballymena,2724,7,11,8,11,58,65,-7,41
Coleraine,2724,8,8,13,9,43,51,-8,37
Ards,2724,9,10,7,13,39,51,-12,37
Portadown,2724,10,8,6,16,31,49,-18,30
Ballinamalla,2724,11,6,6,18,31,53,-22,24
Cliftonville,2725,1,19,5,6,58,29,29,62
Linfield,2725,2,17,9,4,63,29,34,60
Crusaders,2725,3,16,8,6,56,31,25,56
Coleraine,2725,4,14,10,6,47,33,14,52
Ballymena,2725,5,12,4,14,50,62,-12,40
Glenavon,2725,6,9,9,12,51,54,-3,36
Dungannon,2725,7,9,8,13,49,51,-2,35
Glentoran,2725,8,9,6,15,30,46,-16,33
Ards,2725,9,8,4,18,36,57,-21,28
Ballinamalla,2725,10,7,7,16,30,54,-24,28
Portadown,2725,11,8,4,18,26,50,-24,28
Crusaders,2726,1,18,10,2,66,34,32,64
Cliftonville,2726,2,16,5,9,55,40,15,53
Linfield,2726,3,14,10,6,63,34,29,52
Coleraine,2726,4,12,11,7,46,38,8,47
Ballymena,2726,5,12,11,7,55,53,2,47
Glenavon,2726,6,10,11,9,51,46,5,41
Glentoran,2726,7,8,9,13,31,51,-20,33
Portadown,2726,8,8,7,15,27,43,-16,31
Dungannon,2726,9,6,12,12,47,51,-4,30
Ards,2726,10,8,5,17,38,58,-20,29
Ballinamalla,2726,11,5,5,20,26,57,-31,20
Linfield,2727,1,17,9,4,64,28,36,60
Crusaders,2727,2,16,7,7,56,40,16,55
Cliftonville,2727,3,14,8,8,51,36,15,50
Glenavon,2727,4,11,11,8,45,45,0,44
Coleraine,2727,5,11,10,9,43,38,5,43
Ballymena,2727,6,12,7,11,54,60,-6,43
Dungannon,2727,7,11,8,11,49,42,7,41
Portadown,2727,8,9,7,14,23,38,-15,34
Glentoran,2727,9,8,6,16,25,46,-21,30
Ballinamalla,2727,10,9,2,19,27,48,-21,29
Ards,2727,11,7,5,18,29,45,-16,26
Cliftonville,2728,1,17,5,8,61,40,21,56
Ballymena,2728,2,17,5,8,66,56,10,56
Crusaders,2728,3,15,8,7,50,39,11,53
Linfield,2728,4,14,7,9,52,36,16,49
Coleraine,2728,5,12,10,8,44,35,9,46
Glenavon,2728,6,12,10,8,42,41,1,46
Ards,2728,7,11,6,13,40,46,-6,39
Glentoran,2728,8,10,7,13,32,39,-7,37
Dungannon,2728,9,8,8,14,41,45,-4,32
Portadown,2728,10,7,5,18,24,44,-20,26
Ballinamalla,2728,11,5,3,22,23,54,-31,18
Crusaders,2729,1,15,10,5,48,25,23,55
Linfield,2729,2,13,10,7,54,34,20,49
Coleraine,2729,3,13,10,7,40,31,9,49
Ballymena,2729,4,13,7,10,51,52,-1,46
Glenavon,2729,5,10,14,6,53,44,9,44
Cliftonville,2729,6,12,8,10,45,38,7,44
Dungannon,2729,7,8,14,8,48,38,10,38
Glentoran,2729,8,9,8,13,29,44,-15,35
Portadown,2729,9,8,10,12,29,39,-10,34
Ards,2729,10,7,4,19,33,59,-26,25
Ballinamalla,2729,11,6,7,17,28,54,-26,25
Crusaders,2730,1,19,7,4,63,26,37,64
Cliftonville,2730,2,17,2,11,58,38,20,53
Ballymena,2730,3,16,5,9,55,53,2,53
Coleraine,2730,4,11,12,7,45,37,8,45
Linfield,2730,5,12,8,10,56,45,11,44
Glenavon,2730,6,10,12,8,46,49,-3,42
Glentoran,2730,7,10,6,14,41,53,-12,36
Dungannon,2730,8,8,9,13,47,51,-4,33
Portadown,2730,9,9,4,17,27,48,-21,31
Ballinamalla,2730,10,9,3,18,29,48,-19,30
Ards,2730,11,8,4,18,33,52,-19,28
Linfield,2731,1,15,10,5,59,29,30,55
Crusaders,2731,2,16,6,8,51,28,23,54
Ballymena,2731,3,14,7,9,55,48,7,49
Coleraine,2731,4,12,11,7,48,39,9,47
Cliftonville,2731,5,13,7,10,46,37,9,46
Glenavon,2731,6,11,12,7,47,42,5,45
Dungannon,2731,7,10,9,11,49,45,4,39
Glentoran,2731,8,9,8,13,32,45,-13,35
Portadown,2731,9,7,9,14,24,42,-18,30
Ballinamalla,2731,10,7,5,18,29,65,-36,26
Ards,2731,11,7,4,19,31,51,-20,25
Crusaders,2732,1,18,7,5,65,41,24,61
Linfield,2732,2,15,10,5,58,26,32,55
Cliftonville,2732,3,15,4,11,53,40,13,49
Ballymena,2732,4,14,6,10,58,63,-5,48
Coleraine,2732,5,9,13,8,45,47,-2,40
Glenavon,2732,6,9,11,10,49,51,-2,38
Glentoran,2732,7,10,8,12,34,42,-8,38
Ards,2732,8,10,7,13,37,45,-8,37
Portadown,2732,9,8,6,16,29,45,-16,30
Ballinamalla,2732,10,8,5,17,32,50,-18,29
Dungannon,2732,11,6,9,15,42,52,-10,27
Crusaders,2733,1,22,5,3,63,27,36,71
Cliftonville,2733,2,15,4,11,54,42,12,49
Ballymena,2733,3,15,4,11,56,54,2,49
Linfield,2733,4,13,9,8,59,35,24,48
Glentoran,2733,5,13,6,11,41,38,3,45
Glenavon,2733,6,10,10,10,47,53,-6,40
Coleraine,2733,7,9,12,9,46,48,-2,39
Dungannon,2733,8,10,7,13,48,50,-2,37
Ards,2733,9,10,5,15,42,50,-8,35
Portadown,2733,10,7,5,18,23,49,-26,26
Ballinamalla,2733,11,6,3,21,27,60,-33,21
Crusaders,2734,1,17,8,5,62,37,25,59
Cliftonville,2734,2,16,7,7,50,31,19,55
Linfield,2734,3,15,7,8,58,36,22,52
Glenavon,2734,4,13,9,8,44,40,4,48
Coleraine,2734,5,12,9,9,43,34,9,45
Ballymena,2734,6,11,9,10,60,63,-3,42
Dungannon,2734,7,10,9,11,50,47,3,39
Ards,2734,8,10,5,15,40,48,-8,35
Glentoran,2734,9,8,8,14,27,47,-20,32
Portadown,2734,10,6,6,18,22,45,-23,24
Ballinamalla,2734,11,6,5,19,28,56,-28,23
Crusaders,2735,1,14,12,4,51,30,21,54
Glenavon,2735,2,15,8,7,50,44,6,53
Linfield,2735,3,13,9,8,57,41,16,48
Cliftonville,2735,4,13,7,10,49,42,7,46
Ballymena,2735,5,13,6,11,65,62,3,45
Coleraine,2735,6,10,14,6,41,36,5,44
Dungannon,2735,7,9,10,11,41,42,-1,37
Glentoran,2735,8,10,7,13,32,45,-13,37
Ballinamalla,2735,9,9,4,17,35,51,-16,31
Ards,2735,10,7,7,16,39,48,-9,28
Portadown,2735,11,7,6,17,31,50,-19,27
Crusaders,2736,1,18,6,6,64,36,28,60
Linfield,2736,2,15,12,3,65,29,36,57
Cliftonville,2736,3,16,5,9,61,44,17,53
Ballymena,2736,4,15,7,8,64,55,9,52
Glenavon,2736,5,9,13,8,44,46,-2,40
Coleraine,2736,6,10,9,11,45,48,-3,39
Dungannon,2736,7,10,6,14,51,55,-4,36
Glentoran,2736,8,7,9,14,29,51,-22,30
Ballinamalla,2736,9,8,5,17,31,47,-16,29
Portadown,2736,10,7,8,15,26,47,-21,29
Ards,2736,11,8,4,18,32,54,-22,28
Crusaders,2737,1,17,6,7,62,37,25,57
Coleraine,2737,2,14,10,6,52,38,14,52
Cliftonville,2737,3,15,6,9,51,40,11,51
Linfield,2737,4,14,8,8,55,36,19,50
Glenavon,2737,5,12,10,8,46,38,8,46
Ballymena,2737,6,11,6,13,49,62,-13,39
Dungannon,2737,7,10,8,12,51,42,9,38
Ards,2737,8,11,3,16,38,49,-11,36
Glentoran,2737,9,8,7,15,33,48,-15,31
Ballinamalla,2737,10,8,5,17,29,52,-23,29
Portadown,2737,11,8,5,17,24,48,-24,29
Linfield,2738,1,15,10,5,65,30,35,55
Ballymena,2738,2,16,7,7,64,49,15,55
Crusaders,2738,3,15,7,8,50,30,20,52
Cliftonville,2738,4,14,7,9,54,39,15,49
Coleraine,2738,5,13,10,7,40,34,6,49
Dungannon,2738,6,10,8,12,46,48,-2,38
Glenavon,2738,7,9,11,10,38,44,-6,38
Glentoran,2738,8,9,9,12,35,48,-13,36
Portadown,2738,9,8,6,16,29,50,-21,30
Ards,2738,10,7,6,17,34,52,-18,27
Ballinamalla,2738,11,6,5,19,28,59,-31,23
Crusaders,2739,1,18,6,6,57,34,23,60
Ballymena,2739,2,15,6,9,64,51,13,51
Linfield,2739,3,13,9,8,61,33,28,48
Cliftonville,2739,4,14,5,11,48,47,1,47
Dungannon,2739,5,10,12,8,55,42,13,42
Coleraine,2739,6,10,12,8,42,44,-2,42
Ards,2739,7,10,7,13,39,48,-9,37
Glenavon,2739,8,9,9,12,47,53,-6,36
Glentoran,2739,9,8,10,12,33,44,-11,34
Portadown,2739,10,8,7,15,30,51,-21,31
Ballinamalla,2739,11,6,5,19,26,55,-29,23
Linfield,2740,1,17,9,4,63,28,35,60
Cliftonville,2740,2,17,6,7,61,40,21,57
Crusaders,2740,3,13,11,6,51,34,17,50
Coleraine,2740,4,11,10,9,45,44,1,43
Ballymena,2740,5,12,7,11,57,58,-1,43
Glentoran,2740,6,11,6,13,33,42,-9,39
Dungannon,2740,7,8,11,11,53,48,5,35
Glenavon,2740,8,8,11,11,43,53,-10,35
Ards,2740,9,8,7,15,37,47,-10,31
Ballinamalla,2740,10,8,5,17,31,51,-20,29
Portadown,2740,11,8,5,17,25,54,-29,29
Crusaders,2741,1,19,5,6,64,33,31,62
Coleraine,2741,2,14,12,4,48,31,17,54
Cliftonville,2741,3,15,6,9,52,37,15,51
Glenavon,2741,4,12,11,7,46,42,4,47
Ballymena,2741,5,14,5,11,59,58,1,47
Linfield,2741,6,11,12,7,57,32,25,45
Dungannon,2741,7,10,9,11,48,48,0,39
Glentoran,2741,8,8,10,12,32,49,-17,34
Ards,2741,9,10,3,17,33,51,-18,33
Portadown,2741,10,5,8,17,26,54,-28,23
Ballinamalla,2741,11,4,5,21,26,56,-30,17
Crusaders,2742,1,17,8,5,57,41,16,59
Ballymena,2742,2,14,9,7,57,52,5,51
Glenavon,2742,3,12,11,7,49,45,4,47
Coleraine,2742,4,13,7,10,48,39,9,46
Linfield,2742,5,11,12,7,51,32,19,45
Cliftonville,2742,6,14,3,13,47,48,-1,45
Dungannon,2742,7,10,12,8,51,37,14,42
Ards,2742,8,10,5,15,36,41,-5,35
Glentoran,2742,9,8,7,15,29,47,-18,31
Ballinamalla,2742,10,7,7,16,33,50,-17,28
Portadown,2742,11,5,7,18,21,47,-26,22
Crusaders,2743,1,19,6,5,57,30,27,63
Linfield,2743,2,13,10,7,50,31,19,49
Cliftonville,2743,3,15,4,11,58,42,16,49
Ballymena,2743,4,14,7,9,60,56,4,49
Coleraine,2743,5,12,11,7,50,43,7,47
Glenavon,2743,6,11,11,8,46,40,6,44
Dungannon,2743,7,11,6,13,54,51,3,39
Glentoran,2743,8,10,7,13,37,49,-12,37
Portadown,2743,9,6,8,16,26,44,-18,26
Ballinamalla,2743,10,7,5,18,29,59,-30,26
Ards,2743,11,6,7,17,32,54,-22,25
Linfield,2744,1,17,8,5,60,29,31,59
Cliftonville,2744,2,17,4,9,57,38,19,55
Crusaders,2744,3,15,7,8,50,35,15,52
Ballymena,2744,4,12,8,10,64,60,4,44
Coleraine,2744,5,11,10,9,38,36,2,43
Glenavon,2744,6,11,8,11,42,44,-2,41
Glentoran,2744,7,10,9,11,27,35,-8,39
Dungannon,2744,8,9,7,14,42,46,-4,34
Ballinamalla,2744,9,9,6,15,34,50,-16,33
Portadown,2744,10,9,3,18,27,53,-26,30
Ards,2744,11,8,4,18,35,50,-15,28
Crusaders,2745,1,17,6,7,61,35,26,57
Coleraine,2745,2,15,12,3,43,28,15,57
Linfield,2745,3,16,8,6,60,28,32,56
Cliftonville,2745,4,16,3,11,56,41,15,51
Dungannon,2745,5,11,8,11,48,43,5,41
Ballymena,2745,6,11,8,11,54,62,-8,41
Glenavon,2745,7,10,8,12,50,54,-4,38
Ards,2745,8,10,3,17,38,49,-11,33
Glentoran,2745,9,8,8,14,29,48,-19,32
Portadown,2745,10,9,4,17,31,46,-15,31
Ballinamalla,2745,11,6,4,20,22,58,-36,22
Crusaders,2746,1,15,10,5,65,36,29,55
Linfield,2746,2,14,11,5,65,34,31,53
Coleraine,2746,3,12,11,7,50,38,12,47
Ballymena,2746,4,13,7,10,58,58,0,46
Cliftonville,2746,5,12,7,11,50,49,1,43
Glenavon,2746,6,8,15,7,45,50,-5,39
Glentoran,2746,7,10,8,12,37,46,-9,38
Dungannon,2746,8,9,9,12,50,48,2,36
Ards,2746,9,9,8,13,34,46,-12,35
Portadown,2746,10,7,7,16,22,42,-20,28
Ballinamalla,2746,11,6,7,17,26,55,-29,25
Crusaders,2747,1,19,6,5,52,27,25,63
Linfield,2747,2,17,7,6,64,31,33,58
Cliftonville,2747,3,15,6,9,50,35,15,51
Dungannon,2747,4,13,7,10,53,40,13,46
Glenavon,2747,5,11,8,11,45,45,0,41
Ballymena,2747,6,12,5,13,58,68,-10,41
Coleraine,2747,7,9,10,11,36,41,-5,37
Glentoran,2747,8,10,5,15,32,47,-15,35
Ards,2747,9,8,6,16,31,47,-16,30
Portadown,2747,10,8,5,17,25,44,-19,29
Ballinamalla,2747,11,8,5,17,30,51,-21,29
Crusaders,2748,1,19,5,6,64,37,27,62
Cliftonville,2748,2,17,5,8,59,37,22,56
Ballymena,2748,3,15,6,9,53,51,2,51
Glenavon,2748,4,13,10,7,55,47,8,49
Linfield,2748,5,12,10,8,55,35,20,46
Dungannon,2748,6,11,8,11,49,47,2,41
Ards,2748,7,10,3,17,40,53,-13,33
Portadown,2748,8,8,8,14,36,44,-8,32
Coleraine,2748,9,7,10,13,34,44,-10,31
Glentoran,2748,10,8,7,15,33,49,-16,31
Ballinamalla,2748,11,7,4,19,26,60,-34,25
Crusaders,2749,1,18,7,5,62,28,34,61
Linfield,2749,2,16,9,5,62,30,32,57
Ballymena,2749,3,14,8,8,66,64,2,50
Dungannon,2749,4,13,8,9,59,41,18,47
Cliftonville,2749,5,13,4,13,54,58,-4,43
Glenavon,2749,6,11,8,11,45,42,3,41
Coleraine,2749,7,9,13,8,43,43,0,40
Portadown,2749,8,10,4,16,35,46,-11,34
Glentoran,2749,9,8,9,13,31,44,-13,33
Ballinamalla,2749,10,8,3,19,30,59,-29,27
Ards,2749,11,5,7,18,22,54,-32,22
Crusaders,2750,1,17,6,7,58,39,19,57
Linfield,2750,2,14,12,4,70,36,34,54
Coleraine,2750,3,13,10,7,44,37,7,49
Cliftonville,2750,4,15,3,12,51,39,12,48
Ballymena,2750,5,13,7,10,61,55,6,46
Dungannon,2750,6,11,9,10,56,47,9,42
Glentoran,2750,7,11,7,12,33,43,-10,40
Glenavon,2750,8,8,10,12,48,58,-10,34
Ballinamalla,2750,9,10,2,18,30,52,-22,32
Ards,2750,10,8,4,18,33,51,-18,28
Portadown,2750,11,7,6,17,31,58,-27,27
Crusaders,2751,1,17,5,8,57,38,19,56
Ballymena,2751,2,16,5,9,64,60,4,53
Dungannon,2751,3,15,7,8,60,42,18,52
Linfield,2751,4,13,10,7,60,35,25,49
Cliftonville,2751,5,15,4,11,60,47,13,49
Glenavon,2751,6,10,9,11,53,54,-1,39
Glentoran,2751,7,11,6,13,36,50,-14,39
Coleraine,2751,8,9,7,14,40,43,-3,34
Ballinamalla,2751,9,10,4,16,34,54,-20,34
Portadown,2751,10,7,7,16,26,47,-21,28
Ards,2751,11,7,6,17,35,55,-20,27
Linfield,2752,1,16,10,4,63,30,33,58
Ballymena,2752,2,16,7,7,58,50,8,55
Crusaders,2752,3,16,5,9,57,40,17,53
Cliftonville,2752,4,14,5,11,51,46,5,47
Glenavon,2752,5,12,10,8,50,47,3,46
Dungannon,2752,6,11,8,11,57,53,4,41
Coleraine,2752,7,10,10,10,36,38,-2,40
Ballinamalla,2752,8,9,6,15,32,47,-15,33
Ards,2752,9,9,5,16,35,44,-9,32
Glentoran,2752,10,6,9,15,32,48,-16,27
Portadown,2752,11,6,5,19,26,54,-28,23
Crusaders,2753,1,17,6,7,58,33,25,57
Cliftonville,2753,2,17,3,10,51,40,11,54
Linfield,2753,3,14,10,6,58,32,26,52
Dungannon,2753,4,12,8,10,51,41,10,44
Glenavon,2753,5,10,13,7,48,41,7,43
Coleraine,2753,6,11,10,9,43,42,1,43
Ballymena,2753,7,12,6,12,56,57,-1,42
Glentoran,2753,8,9,8,13,29,42,-13,35
Ards,2753,9,8,7,15,37,52,-15,31
Portadown,2753,10,7,7,16,24,45,-21,28
Ballinamalla,2753,11,7,4,19,28,58,-30,25
Linfield,2754,1,16,8,6,61,28,33,56
Cliftonville,2754,2,17,4,9,64,51,13,55
Crusaders,2754,3,16,6,8,55,39,16,54
Ballymena,2754,4,15,7,8,57,50,7,52
Coleraine,2754,5,11,10,9,39,36,3,43
Glenavon,2754,6,10,11,9,44,42,2,41
Dungannon,2754,7,11,7,12,52,44,8,40
Glentoran,2754,8,10,7,13,35,45,-10,37
Ards,2754,9,8,5,17,36,56,-20,29
Ballinamalla,2754,10,8,4,18,26,50,-24,28
Portadown,2754,11,5,7,18,25,53,-28,22
Crusaders,2755,1,17,6,7,61,39,22,57
Linfield,2755,2,15,8,7,62,42,20,53
Ballymena,2755,3,14,9,7,59,48,11,51
Dungannon,2755,4,11,9,10,51,42,9,42
Cliftonville,2755,5,10,11,9,43,39,4,41
Coleraine,2755,6,10,11,9,43,43,0,41
Glentoran,2755,7,10,9,11,36,48,-12,39
Glenavon,2755,8,8,12,10,41,44,-3,36
Ards,2755,9,10,6,14,34,46,-12,36
Ballinamalla,2755,10,8,3,19,31,52,-21,27
Portadown,2755,11,6,8,16,25,43,-18,26
Crusaders,2756,1,17,7,6,55,33,22,58
Linfield,2756,2,14,10,6,57,32,25,52
Cliftonville,2756,3,14,7,9,56,40,16,49
Coleraine,2756,4,12,11,7,45,34,11,47
Ballymena,2756,5,12,9,9,59,60,-1,45
Glenavon,2756,6,9,13,8,45,45,0,40
Ards,2756,7,10,4,16,37,55,-18,34
Dungannon,2756,8,8,9,13,44,46,-2,33
Glentoran,2756,9,8,8,14,31,43,-12,32
Portadown,2756,10,8,7,15,25,48,-23,31
Ballinamalla,2756,11,8,5,17,33,51,-18,29
Linfield,2757,1,15,10,5,59,31,28,55
Ballymena,2757,2,15,7,8,57,56,1,52
Crusaders,2757,3,14,9,7,56,37,19,51
Cliftonville,2757,4,14,6,10,55,47,8,48
Coleraine,2757,5,11,8,11,41,41,0,41
Dungannon,2757,6,9,12,9,45,38,7,39
Glenavon,2757,7,8,13,9,44,45,-1,37
Ards,2757,8,10,6,14,41,50,-9,36
Portadown,2757,9,9,7,14,30,38,-8,34
Glentoran,2757,10,7,8,15,30,56,-26,29
Ballinamalla,2757,11,7,6,17,31,50,-19,27
Linfield,2758,1,16,9,5,65,30,35,57
Crusaders,2758,2,17,5,8,51,33,18,56
Cliftonville,2758,3,16,5,9,59,41,18,53
Glenavon,2758,4,13,10,7,57,43,14,49
Coleraine,2758,5,12,10,8,44,46,-2,46
Ballymena,2758,6,14,4,12,53,63,-10,46
Dungannon,2758,7,10,10,10,49,43,6,40
Glentoran,2758,8,7,9,14,29,43,-14,30
Ards,2758,9,7,6,17,36,53,-17,27
Ballinamalla,2758,10,7,5,18,26,48,-22,26
Portadown,2758,11,5,9,16,23,49,-26,24
Ballymena,2759,1,16,6,8,63,55,8,54
Cliftonville,2759,2,15,8,7,52,38,14,53
Crusaders,2759,3,14,10,6,50,38,12,52
Linfield,2759,4,12,9,9,55,38,17,45
Glenavon,2759,5,10,11,9,44,40,4,41
Dungannon,2759,6,9,12,9,52,42,10,39
Glentoran,2759,7,9,9,12,41,49,-8,36
Coleraine,2759,8,8,11,11,37,41,-4,35
Ballinamalla,2759,9,9,6,15,34,49,-15,33
Ards,2759,10,9,5,16,35,53,-18,32
Portadown,2759,11,5,11,14,29,49,-20,26
Linfield,2760,1,16,9,5,63,34,29,57
Crusaders,2760,2,16,9,5,57,32,25,57
Cliftonville,2760,3,15,7,8,53,34,19,52
Ballymena,2760,4,12,8,10,54,58,-4,44
Glenavon,2760,5,10,12,8,49,47,2,42
Coleraine,2760,6,10,12,8,40,38,2,42
Ballinamalla,2760,7,12,2,16,39,51,-12,38
Dungannon,2760,8,8,11,11,50,46,4,35
Ards,2760,9,9,4,17,37,50,-13,31
Glentoran,2760,10,6,10,14,26,47,-21,28
Portadown,2760,11,8,2,20,27,58,-31,26
Crusaders,2761,1,17,9,4,57,36,21,60
Linfield,2761,2,14,10,6,54,29,25,52
Cliftonville,2761,3,16,4,10,57,45,12,52
Glenavon,2761,4,14,9,7,46,35,11,51
Coleraine,2761,5,10,12,8,40,38,2,42
Ballymena,2761,6,13,3,14,50,62,-12,42
Ballinamalla,2761,7,10,5,15,30,43,-13,35
Dungannon,2761,8,8,10,12,49,47,2,34
Glentoran,2761,9,10,4,16,37,50,-13,34
Ards,2761,10,8,4,18,42,55,-13,28
Portadown,2761,11,7,6,17,27,49,-22,27
Crusaders,2762,1,20,7,3,67,31,36,67
Linfield,2762,2,16,10,4,62,28,34,58
Glenavon,2762,3,13,11,6,53,47,6,50
Ballymena,2762,4,13,7,10,55,62,-7,46
Cliftonville,2762,5,13,6,11,53,45,8,45
Coleraine,2762,6,10,12,8,49,44,5,42
Ards,2762,7,9,7,14,40,49,-9,34
Glentoran,2762,8,8,8,14,27,44,-17,32
Dungannon,2762,9,5,12,13,38,45,-7,27
Ballinamalla,2762,10,7,6,17,26,47,-21,27
Portadown,2762,11,5,6,19,23,51,-28,21
Linfield,2763,1,14,10,6,55,32,23,52
Cliftonville,2763,2,16,4,10,50,35,15,52
Crusaders,2763,3,14,8,8,49,31,18,50
Ballymena,2763,4,13,8,9,52,56,-4,47
Glenavon,2763,5,12,10,8,48,40,8,46
Ards,2763,6,12,6,12,42,50,-8,42
Coleraine,2763,7,10,10,10,41,35,6,40
Dungannon,2763,8,10,8,12,41,47,-6,38
Ballinamalla,2763,9,10,3,17,36,52,-16,33
Glentoran,2763,10,9,5,16,36,46,-10,32
Portadown,2763,11,8,2,20,19,45,-26,26
Crusaders,2764,1,15,8,7,60,43,17,53
Linfield,2764,2,13,11,6,48,25,23,50
Coleraine,2764,3,11,13,6,41,35,6,46
Ballymena,2764,4,11,8,11,53,52,1,41
Dungannon,2764,5,10,9,11,50,43,7,39
Cliftonville,2764,6,11,6,13,42,43,-1,39
Ards,2764,7,11,5,14,44,47,-3,38
Glenavon,2764,8,8,14,8,39,42,-3,38
Portadown,2764,9,9,9,12,28,39,-11,36
Glentoran,2764,10,8,10,12,31,48,-17,34
Ballinamalla,2764,11,9,5,16,33,52,-19,32
Linfield,2765,1,18,9,3,66,32,34,63
Crusaders,2765,2,17,7,6,48,32,16,58
Cliftonville,2765,3,15,4,11,57,44,13,49
Coleraine,2765,4,12,10,8,55,40,15,46
Dungannon,2765,5,10,13,7,49,36,13,43
Ballymena,2765,6,10,7,13,50,61,-11,37
Glenavon,2765,7,8,12,10,40,46,-6,36
Ballinamalla,2765,8,9,6,15,30,44,-14,33
Glentoran,2765,9,8,6,16,26,41,-15,30
Portadown,2765,10,7,9,14,28,55,-27,30
Ards,2765,11,7,5,18,34,52,-18,26
Crusaders,2766,1,16,7,7,54,34,20,55
Coleraine,2766,2,13,13,4,45,32,13,52
Linfield,2766,3,14,9,7,56,35,21,51
Dungannon,2766,4,13,6,11,54,44,10,45
Cliftonville,2766,5,13,5,12,49,42,7,44
Ballymena,2766,6,12,8,10,56,59,-3,44
Glentoran,2766,7,12,7,11,36,36,0,43
Glenavon,2766,8,9,9,12,45,53,-8,36
Ballinamalla,2766,9,9,4,17,29,52,-23,31
Portadown,2766,10,8,6,16,24,45,-21,30
Ards,2766,11,7,4,19,39,55,-16,25
Crusaders,2767,1,17,7,6,53,33,20,58
Linfield,2767,2,16,7,7,65,33,32,55
Cliftonville,2767,3,15,7,8,57,34,23,52
Coleraine,2767,4,12,11,7,41,32,9,47
Dungannon,2767,5,12,8,10,50,45,5,44
Glenavon,2767,6,11,11,8,43,39,4,44
Ballymena,2767,7,12,6,12,54,68,-14,42
Ards,2767,8,9,8,13,35,42,-7,35
Glentoran,2767,9,7,8,15,27,47,-20,29
Portadown,2767,10,7,7,16,22,43,-21,28
Ballinamalla,2767,11,3,8,19,24,55,-31,17
Crusaders,2768,1,16,8,6,54,31,23,56
Glenavon,2768,2,13,9,8,48,40,8,48
Ballymena,2768,3,13,8,9,56,55,1,47
Coleraine,2768,4,12,10,8,43,38,5,46
Linfield,2768,5,11,12,7,52,36,16,45
Dungannon,2768,6,11,10,9,51,40,11,43
Cliftonville,2768,7,13,4,13,52,45,7,43
Ards,2768,8,10,8,12,42,44,-2,38
Portadown,2768,9,9,5,16,26,45,-19,32
Glentoran,2768,10,7,7,16,31,54,-23,28
Ballinamalla,2768,11,7,5,18,25,52,-27,26
Crusaders,2769,1,19,7,4,61,29,32,64
Linfield,2769,2,13,10,7,61,33,28,49
Ballymena,2769,3,13,8,9,58,68,-10,47
Cliftonville,2769,4,13,7,10,53,46,7,46
Dungannon,2769,5,11,9,10,54,43,11,42
Coleraine,2769,6,10,10,10,51,47,4,40
Ballinamalla,2769,7,10,6,14,39,48,-9,36
Glenavon,2769,8,8,11,11,43,51,-8,35
Ards,2769,9,10,4,16,41,54,-13,34
Glentoran,2769,10,9,7,14,32,48,-16,34
Portadown,2769,11,5,9,16,25,51,-26,24
Crusaders,2770,1,16,9,5,60,34,26,57
Cliftonville,2770,2,16,6,8,59,37,22,54
Ballymena,2770,3,17,3,10,66,55,11,54
Linfield,2770,4,14,9,7,59,37,22,51
Coleraine,2770,5,11,10,9,46,41,5,43
Glenavon,2770,6,9,12,9,48,51,-3,39
Ballinamalla,2770,7,10,5,15,31,44,-13,35
Dungannon,2770,8,9,7,14,46,44,2,34
Portadown,2770,9,9,4,17,25,47,-22,31
Glentoran,2770,10,8,7,15,23,50,-27,31
Ards,2770,11,8,4,18,33,56,-23,28
Crusaders,2771,1,16,9,5,55,37,18,57
Cliftonville,2771,2,16,8,6,57,35,22,56
Ballymena,2771,3,14,10,6,64,51,13,52
Linfield,2771,4,11,10,9,55,36,19,43
Glenavon,2771,5,11,9,10,49,50,-1,42
Ards,2771,6,12,4,14,43,47,-4,40
Coleraine,2771,7,8,13,9,34,35,-1,37
Glentoran,2771,8,10,6,14,33,47,-14,36
Dungannon,2771,9,8,11,11,53,47,6,35
Portadown,2771,10,6,8,16,24,55,-31,26
Ballinamalla,2771,11,5,8,17,29,56,-27,23
Crusaders,2772,1,18,7,5,55,34,21,61
Linfield,2772,2,14,10,6,60,37,23,52
Ballymena,2772,3,15,7,8,65,58,7,52
Glenavon,2772,4,13,8,9,44,40,4,47
Cliftonville,2772,5,13,6,11,53,48,5,45
Dungannon,2772,6,12,8,10,55,41,14,44
Ards,2772,7,10,5,15,45,54,-9,35
Glentoran,2772,8,8,9,13,37,48,-11,33
Coleraine,2772,9,7,9,14,35,45,-10,30
Portadown,2772,10,7,7,16,28,49,-21,28
Ballinamalla,2772,11,8,4,18,29,52,-23,28
Crusaders,2773,1,17,8,5,61,31,30,59
Linfield,2773,2,14,8,8,54,32,22,50
Cliftonville,2773,3,13,8,9,53,42,11,47
Glentoran,2773,4,13,6,11,35,40,-5,45
Glenavon,2773,5,12,8,10,46,50,-4,44
Ballymena,2773,6,12,7,11,54,63,-9,43
Portadown,2773,7,10,5,15,26,41,-15,35
Dungannon,2773,8,8,10,12,50,46,4,34
Coleraine,2773,9,8,10,12,37,41,-4,34
Ballinamalla,2773,10,11,1,18,38,52,-14,34
Ards,2773,11,10,3,17,39,55,-16,33
Crusaders,2774,1,16,8,6,54,32,22,56
Coleraine,2774,2,14,9,7,46,33,13,51
Linfield,2774,3,13,11,6,58,39,19,50
Cliftonville,2774,4,13,7,10,52,46,6,46
Glenavon,2774,5,11,10,9,56,50,6,43
Ballymena,2774,6,12,7,11,57,64,-7,43
Glentoran,2774,7,10,7,13,36,48,-12,37
Portadown,2774,8,9,8,13,35,43,-8,35
Ards,2774,9,9,7,14,42,52,-10,34
Dungannon,2774,10,8,8,14,44,48,-4,32
Ballinamalla,2774,11,6,6,18,31,56,-25,24
Crusaders,2775,1,17,6,7,61,30,31,57
Glenavon,2775,2,14,10,6,54,40,14,52
Coleraine,2775,3,14,8,8,52,35,17,50
Ballymena,2775,4,15,4,11,62,64,-2,49
Cliftonville,2775,5,15,3,12,49,42,7,48
Dungannon,2775,6,13,7,10,49,41,8,46
Linfield,2775,7,11,10,9,55,40,15,43
Glentoran,2775,8,11,5,14,30,46,-16,38
Ballinamalla,2775,9,9,4,17,31,54,-23,31
Ards,2775,10,7,4,19,30,51,-21,25
Portadown,2775,11,6,5,19,24,54,-30,23
Linfield,2776,1,16,8,6,70,31,39,56
Crusaders,2776,2,16,7,7,55,35,20,55
Ballymena,2776,3,14,5,11,54,61,-7,47
Coleraine,2776,4,12,10,8,44,36,8,46
Cliftonville,2776,5,13,4,13,52,47,5,43
Ballinamalla,2776,6,13,2,15,36,46,-10,41
Glentoran,2776,7,11,6,13,39,44,-5,39
Dungannon,2776,8,10,8,12,48,45,3,38
Glenavon,2776,9,9,11,10,44,49,-5,38
Ards,2776,10,9,8,13,35,46,-11,35
Portadown,2776,11,6,3,21,20,57,-37,21
Crusaders,2777,1,17,7,6,56,35,21,58
Coleraine,2777,2,14,9,7,49,36,13,51
Glenavon,2777,3,12,12,6,47,46,1,48
Cliftonville,2777,4,14,4,12,49,35,14,46
Linfield,2777,5,12,9,9,52,37,15,45
Ballymena,2777,6,11,8,11,53,57,-4,41
Glentoran,2777,7,11,6,13,35,42,-7,39
Ballinamalla,2777,8,11,5,14,41,49,-8,38
Portadown,2777,9,9,4,17,24,47,-23,31
Dungannon,2777,10,7,9,14,44,48,-4,30
Ards,2777,11,8,5,17,35,53,-18,29
Ballymena,2778,1,16,6,8,58,53,5,54
Crusaders,2778,2,14,10,6,59,41,18,52
Cliftonville,2778,3,15,5,10,51,34,17,50
Linfield,2778,4,13,10,7,59,34,25,49
Coleraine,2778,5,12,10,8,49,36,13,46
Glenavon,2778,6,11,11,8,52,48,4,44
Dungannon,2778,7,11,10,9,45,41,4,43
Glentoran,2778,8,9,9,12,28,43,-15,36
Ards,2778,9,7,8,15,31,51,-20,29
Ballinamalla,2778,10,8,4,18,33,53,-20,28
Portadown,2778,11,4,7,19,27,58,-31,19
Cliftonville,2779,1,19,4,7,51,28,23,61
Linfield,2779,2,14,12,4,68,35,33,54
Crusaders,2779,3,13,8,9,55,44,11,47
Glenavon,2779,4,11,14,5,48,38,10,47
Ballymena,2779,5,12,9,9,61,63,-2,45
Dungannon,2779,6,9,11,10,53,44,9,38
Coleraine,2779,7,8,12,10,37,45,-8,36
Ards,2779,8,8,8,14,39,50,-11,32
Glentoran,2779,9,7,11,12,30,46,-16,32
Ballinamalla,2779,10,7,6,17,24,45,-21,27
Portadown,2779,11,8,3,19,24,52,-28,27
Linfield,2780,1,15,10,5,64,29,35,55
Crusaders,2780,2,15,8,7,60,40,20,53
Cliftonville,2780,3,15,7,8,62,42,20,52
Dungannon,2780,4,12,8,10,60,42,18,44
Glenavon,2780,5,11,11,8,44,43,1,44
Coleraine,2780,6,11,11,8,43,42,1,44
Ballymena,2780,7,12,7,11,54,64,-10,43
Glentoran,2780,8,7,10,13,31,49,-18,31
Portadown,2780,9,7,8,15,28,51,-23,29
Ballinamalla,2780,10,7,6,17,28,49,-21,27
Ards,2780,11,7,6,17,27,50,-23,27
Ballymena,2781,1,17,5,8,69,63,6,56
Linfield,2781,2,16,7,7,64,28,36,55
Crusaders,2781,3,16,7,7,56,41,15,55
Cliftonville,2781,4,15,7,8,60,36,24,52
Glenavon,2781,5,12,12,6,51,40,11,48
Coleraine,2781,6,11,9,10,44,44,0,42
Glentoran,2781,7,11,7,12,35,43,-8,40
Dungannon,2781,8,10,8,12,49,47,2,38
Ards,2781,9,8,4,18,33,55,-22,28
Ballinamalla,2781,10,8,4,18,30,54,-24,28
Portadown,2781,11,4,4,22,20,60,-40,16
Linfield,2782,1,19,7,4,57,21,36,64
Crusaders,2782,2,19,7,4,61,29,32,64
Cliftonville,2782,3,15,3,12,53,41,12,48
Coleraine,2782,4,13,9,8,51,41,10,48
Glenavon,2782,5,11,12,7,44,43,1,45
Ballymena,2782,6,12,4,14,46,57,-11,40
Dungannon,2782,7,9,9,12,44,44,0,36
Glentoran,2782,8,9,7,14,30,43,-13,34
Ards,2782,9,9,5,16,31,45,-14,32
Portadown,2782,10,8,4,18,25,47,-22,28
Ballinamalla,2782,11,5,5,20,26,57,-31,20
Cliftonville,2783,1,18,3,9,54,36,18,57
Coleraine,2783,2,14,9,7,47,34,13,51
Crusaders,2783,3,14,7,9,58,38,20,49
Ballymena,2783,4,14,6,10,60,60,0,48
Linfield,2783,5,13,8,9,57,36,21,47
Glenavon,2783,6,12,8,10,52,56,-4,44
Glentoran,2783,7,10,8,12,32,37,-5,38
Ards,2783,8,11,5,14,41,55,-14,38
Dungannon,2783,9,8,11,11,49,49,0,35
Portadown,2783,10,7,6,17,25,47,-22,27
Ballinamalla,2783,11,5,7,18,30,57,-27,22
Linfield,2784,1,18,9,3,66,26,40,63
Crusaders,2784,2,16,8,6,55,35,20,56
Cliftonville,2784,3,16,5,9,57,41,16,53
Glenavon,2784,4,13,8,9,50,48,2,47
Ballymena,2784,5,13,7,10,60,57,3,46
Dungannon,2784,6,8,11,11,46,45,1,35
Ballinamalla,2784,7,10,4,16,31,45,-14,34
Glentoran,2784,8,9,7,14,29,47,-18,34
Coleraine,2784,9,8,9,13,40,48,-8,33
Ards,2784,10,9,4,17,44,55,-11,31
Portadown,2784,11,6,6,18,21,52,-31,24
Crusaders,2785,1,15,10,5,56,32,24,55
Cliftonville,2785,2,15,5,10,50,38,12,50
Linfield,2785,3,13,8,9,53,36,17,47
Coleraine,2785,4,12,9,9,40,33,7,45
Ballymena,2785,5,13,6,11,56,58,-2,45
Ards,2785,6,12,5,13,40,46,-6,41
Glentoran,2785,7,11,7,12,31,37,-6,40
Glenavon,2785,8,9,12,9,39,46,-7,39
Dungannon,2785,9,9,8,13,51,55,-4,35
Portadown,2785,10,7,8,15,31,48,-17,29
Ballinamalla,2785,11,6,8,16,25,43,-18,26
Linfield,2786,1,15,12,3,59,28,31,57
Cliftonville,2786,2,16,5,9,49,42,7,53
Crusaders,2786,3,13,9,8,53,36,17,48
Glentoran,2786,4,12,9,9,35,40,-5,45
Dungannon,2786,5,12,8,10,51,36,15,44
Ballymena,2786,6,12,8,10,56,58,-2,44
Coleraine,2786,7,9,14,7,42,37,5,41
Glenavon,2786,8,10,10,10,53,49,4,40
Ards,2786,9,10,4,16,42,54,-12,34
Portadown,2786,10,6,5,19,23,51,-28,23
Ballinamalla,2786,11,7,2,21,24,56,-32,23
Dungannon,2787,1,15,8,7,63,44,19,53
Crusaders,2787,2,15,6,9,57,40,17,51
Ballymena,2787,3,14,8,8,58,56,2,50
Cliftonville,2787,4,15,4,11,57,44,13,49
Coleraine,2787,5,12,12,6,42,31,11,48
Linfield,2787,6,10,15,5,48,29,19,45
Glenavon,2787,7,8,13,9,46,48,-2,37
Glentoran,2787,8,10,7,13,37,47,-10,37
Ards,2787,9,10,6,14,44,52,-8,36
Portadown,2787,10,6,5,19,20,52,-32,23
Ballinamalla,2787,11,6,4,20,31,60,-29,22
Linfield,2788,1,14,9,7,56,31,25,51
Crusaders,2788,2,14,9,7,50,37,13,51
Ballymena,2788,3,14,6,10,54,54,0,48
Cliftonville,2788,4,14,5,11,54,42,12,47
Coleraine,2788,5,11,11,8,42,39,3,44
Glenavon,2788,6,9,13,8,45,40,5,40
Dungannon,2788,7,10,10,10,50,46,4,40
Portadown,2788,8,11,6,13,26,31,-5,39
Ards,2788,9,10,4,16,38,51,-13,34
Glentoran,2788,10,8,8,14,24,42,-18,32
Ballinamalla,2788,11,6,7,17,25,51,-26,25
Crusaders,2789,1,18,4,8,58,38,20,58
Linfield,2789,2,16,7,7,62,38,24,55
Glenavon,2789,3,12,11,7,46,42,4,47
Ballymena,2789,4,13,8,9,57,60,-3,47
Coleraine,2789,5,11,12,7,44,35,9,45
Cliftonville,2789,6,13,6,11,53,46,7,45
Dungannon,2789,7,11,10,9,59,41,18,43
Glentoran,2789,8,10,7,13,32,40,-8,37
Ards,2789,9,7,6,17,37,57,-20,27
Ballinamalla,2789,10,7,5,18,27,55,-28,26
Portadown,2789,11,7,4,19,23,46,-23,25
Linfield,2790,1,18,8,4,64,28,36,62
Cliftonville,2790,2,16,3,11,50,40,10,51
Ballymena,2790,3,14,5,11,63,58,5,47
Crusaders,2790,4,12,9,9,50,40,10,45
Coleraine,2790,5,10,12,8,37,34,3,42
Glenavon,2790,6,10,11,9,43,47,-4,41
Dungannon,2790,7,10,8,12,45,41,4,38
Glentoran,2790,8,10,6,14,32,46,-14,36
Ards,2790,9,8,8,14,36,46,-10,32
Ballinamalla,2790,10,9,4,17,28,46,-18,31
Portadown,2790,11,7,8,15,23,45,-22,29
Cliftonville,2791,1,16,6,8,54,32,22,54
Crusaders,2791,2,16,6,8,53,36,17,54
Linfield,2791,3,14,9,7,59,33,26,51
Coleraine,2791,4,13,12,5,45,31,14,51
Glenavon,2791,5,12,12,6,61,46,15,48
Ballymena,2791,6,12,8,10,52,54,-2,44
Glentoran,2791,7,12,5,13,33,45,-12,41
Dungannon,2791,8,7,11,12,44,49,-5,32
Ards,2791,9,7,6,17,37,58,-21,27
Portadown,2791,10,7,6,17,25,51,-26,27
Ballinamalla,2791,11,6,5,19,30,58,-28,23
Ballymena,2792,1,18,6,6,62,52,10,60
Linfield,2792,2,16,8,6,63,28,35,56
Crusaders,2792,3,16,6,8,52,32,20,54
Coleraine,2792,4,12,12,6,49,37,12,48
Cliftonville,2792,5,14,5,11,53,42,11,47
Glenavon,2792,6,10,15,5,46,38,8,45
Ards,2792,7,10,6,14,35,48,-13,36
Portadown,2792,8,9,5,16,33,49,-16,32
Dungannon,2792,9,6,10,14,46,54,-8,28
Glentoran,2792,10,6,9,15,27,48,-21,27
Ballinamalla,2792,11,4,6,20,24,62,-38,18
Crusaders,2793,1,16,10,4,54,28,26,58
Ballymena,2793,2,15,7,8,61,53,8,52
Cliftonville,2793,3,15,5,10,50,35,15,50
Linfield,2793,4,13,9,8,58,38,20,48
Coleraine,2793,5,13,9,8,43,40,3,48
Ards,2793,6,14,3,13,42,47,-5,45
Glenavon,2793,7,10,8,12,45,50,-5,38
Dungannon,2793,8,9,10,11,51,46,5,37
Glentoran,2793,9,8,8,14,31,44,-13,32
Portadown,2793,10,8,4,18,27,52,-25,28
Ballinamalla,2793,11,4,7,19,26,55,-29,19
Crusaders,2794,1,18,6,6,59,30,29,60
Linfield,2794,2,15,8,7,65,29,36,53
Cliftonville,2794,3,16,3,11,47,42,5,51
Glenavon,2794,4,12,10,8,43,42,1,46
Ballymena,2794,5,13,4,13,51,57,-6,43
Coleraine,2794,6,10,11,9,40,37,3,41
Ards,2794,7,11,6,13,45,50,-5,39
Dungannon,2794,8,8,11,11,46,43,3,35
Portadown,2794,9,9,5,16,22,44,-22,32
Glentoran,2794,10,8,6,16,27,49,-22,30
Ballinamalla,2794,11,8,4,18,27,49,-22,28
Linfield,2795,1,16,8,6,70,37,33,56
Ballymena,2795,2,16,4,10,59,57,2,52
Crusaders,2795,3,14,7,9,55,41,14,49
Coleraine,2795,4,12,11,7,48,43,5,47
Cliftonville,2795,5,12,8,10,48,46,2,44
Ballinamalla,2795,6,11,8,11,40,45,-5,41
Ards,2795,7,11,7,12,41,43,-2,40
Dungannon,2795,8,9,12,9,50,39,11,39
Glenavon,2795,9,7,12,11,39,50,-11,33
Glentoran,2795,10,8,7,15,36,51,-15,31
Portadown,2795,11,5,4,21,22,56,-34,19
Ballymena,2796,1,16,7,7,56,48,8,55
Glenavon,2796,2,13,11,6,54,45,9,50
Linfield,2796,3,13,10,7,56,35,21,49
Cliftonville,2796,4,14,6,10,54,45,9,48
Crusaders,2796,5,12,8,10,46,38,8,44
Dungannon,2796,6,10,9,11,48,42,6,39
Coleraine,2796,7,9,12,9,39,38,1,39
Glentoran,2796,8,10,6,14,42,49,-7,36
Ballinamalla,2796,9,9,5,16,39,58,-19,32
Portadown,2796,10,9,4,17,21,43,-22,31
Ards,2796,11,7,8,15,40,54,-14,29
Linfield,2797,1,16,9,5,63,30,33,57
Crusaders,2797,2,15,10,5,64,41,23,55
Glenavon,2797,3,13,12,5,53,40,13,51
Cliftonville,2797,4,14,5,11,50,42,8,47
Ballymena,2797,5,13,5,12,56,60,-4,44
Dungannon,2797,6,11,10,9,51,44,7,43
Coleraine,2797,7,11,10,9,39,39,0,43
Ards,2797,8,8,8,14,42,52,-10,32
Ballinamalla,2797,9,7,7,16,25,50,-25,28
Portadown,2797,10,6,7,17,23,43,-20,25
Glentoran,2797,11,6,7,17,24,49,-25,25
Linfield,2798,1,16,9,5,68,33,35,57
Crusaders,2798,2,16,7,7,55,34,21,55
Cliftonville,2798,3,14,8,8,55,39,16,50
Glenavon,2798,4,12,10,8,50,45,5,46
Ballymena,2798,5,13,6,11,55,59,-4,45
Coleraine,2798,6,10,9,11,38,48,-10,39
Dungannon,2798,7,9,11,10,51,44,7,38
Glentoran,2798,8,9,7,14,31,37,-6,34
Ballinamalla,2798,9,8,7,15,28,45,-17,31
Portadown,2798,10,7,7,16,28,50,-22,28
Ards,2798,11,7,7,16,30,55,-25,28
Crusaders,2799,1,18,5,7,56,36,20,59
Ballymena,2799,2,16,5,9,60,58,2,53
Cliftonville,2799,3,16,4,10,55,41,14,52
Linfield,2799,4,13,8,9,55,35,20,47
Coleraine,2799,5,11,11,8,44,39,5,44
Glentoran,2799,6,10,7,13,32,42,-10,37
Glenavon,2799,7,9,9,12,42,46,-4,36
Ards,2799,8,10,6,14,41,47,-6,36
Dungannon,2799,9,8,9,13,47,47,0,33
Portadown,2799,10,9,5,16,27,44,-17,32
Ballinamalla,2799,11,9,3,18,33,57,-24,30
Cliftonville,2800,1,18,5,7,55,40,15,59
Linfield,2800,2,15,11,4,65,29,36,56
Crusaders,2800,3,15,7,8,59,41,18,52
Ballymena,2800,4,13,7,10,51,58,-7,46
Glenavon,2800,5,11,12,7,57,51,6,45
Coleraine,2800,6,11,10,9,41,40,1,43
Dungannon,2800,7,8,10,12,44,45,-1,34
Glentoran,2800,8,7,10,13,30,46,-16,31
Ards,2800,9,7,8,15,41,54,-13,29
Ballinamalla,2800,10,8,5,17,31,46,-15,29
Portadown,2800,11,5,9,16,23,47,-24,24
Linfield,2801,1,16,8,6,65,35,30,56
Crusaders,2801,2,15,10,5,59,39,20,55
Cliftonville,2801,3,14,5,11,59,48,11,47
Coleraine,2801,4,10,13,7,39,36,3,43
Glenavon,2801,5,10,12,8,55,46,9,42
Ballymena,2801,6,12,5,13,49,60,-11,41
Ards,2801,7,11,5,14,40,46,-6,38
Dungannon,2801,8,8,11,11,52,55,-3,35
Ballinamalla,2801,9,9,7,14,27,43,-16,34
Glentoran,2801,10,7,9,14,26,44,-18,30
Portadown,2801,11,8,5,17,32,51,-19,29
Crusaders,2802,1,17,8,5,60,35,25,59
Cliftonville,2802,2,16,6,8,54,36,18,54
Linfield,2802,3,13,11,6,53,33,20,50
Ballymena,2802,4,13,9,8,56,54,2,48
Glenavon,2802,5,12,9,9,44,44,0,45
Coleraine,2802,6,11,10,9,40,37,3,43
Dungannon,2802,7,8,11,11,45,43,2,35
Ards,2802,8,9,8,13,40,42,-2,35
Glentoran,2802,9,9,8,13,27,38,-11,35
Portadown,2802,10,6,6,18,27,54,-27,24
Ballinamalla,2802,11,6,4,20,25,55,-30,22
Crusaders,2803,1,19,5,6,56,36,20,62
Linfield,2803,2,16,8,6,58,29,29,56
Ballymena,2803,3,15,5,10,63,59,4,50
Cliftonville,2803,4,13,7,10,51,41,10,46
Glenavon,2803,5,11,11,8,46,42,4,44
Dungannon,2803,6,12,7,11,49,39,10,43
Coleraine,2803,7,9,10,11,43,44,-1,37
Ards,2803,8,10,4,16,38,50,-12,34
Ballinamalla,2803,9,10,4,16,34,51,-17,34
Glentoran,2803,10,7,7,16,30,51,-21,28
Portadown,2803,11,7,4,19,20,46,-26,25
Crusaders,2804,1,15,8,7,60,42,18,53
Cliftonville,2804,2,16,5,9,56,43,13,53
Linfield,2804,3,13,11,6,59,32,27,50
Ballymena,2804,4,14,8,8,53,50,3,50
Glenavon,2804,5,12,9,9,52,49,3,45
Dungannon,2804,6,12,8,10,49,41,8,44
Coleraine,2804,7,10,10,10,39,40,-1,40
Glentoran,2804,8,10,9,11,35,42,-7,39
Portadown,2804,9,7,6,17,29,49,-20,27
Ballinamalla,2804,10,7,6,17,32,55,-23,27
Ards,2804,11,6,6,18,29,50,-21,24
Crusaders,2805,1,18,6,6,61,35,26,60
Cliftonville,2805,2,18,4,8,54,34,20,58
Glenavon,2805,3,12,11,7,52,48,4,47
Dungannon,2805,4,12,10,8,59,45,14,46
Linfield,2805,5,12,9,9,54,36,18,45
Ballymena,2805,6,12,8,10,57,59,-2,44
Coleraine,2805,7,11,9,10,42,41,1,42
Glentoran,2805,8,11,4,15,37,53,-16,37
Ards,2805,9,8,7,15,37,50,-13,31
Ballinamalla,2805,10,7,5,18,32,49,-17,26
Portadown,2805,11,5,5,20,25,60,-35,20
Linfield,2806,1,18,7,5,66,29,37,61
Crusaders,2806,2,17,7,6,59,34,25,58
Cliftonville,2806,3,15,5,10,56,48,8,50
Glenavon,2806,4,12,9,9,43,42,1,45
Ballymena,2806,5,12,9,9,58,62,-4,45
Dungannon,2806,6,10,10,10,51,41,10,40
Coleraine,2806,7,8,11,11,34,37,-3,35
Ballinamalla,2806,8,9,5,16,29,49,-20,32
Portadown,2806,9,8,7,15,27,42,-15,31
Ards,2806,10,8,6,16,36,54,-18,30
Glentoran,2806,11,7,6,17,29,50,-21,27
Crusaders,2807,1,17,8,5,62,35,27,59
Cliftonville,2807,2,17,6,7,69,45,24,57
Linfield,2807,3,13,10,7,53,35,18,49
Ballymena,2807,4,14,6,10,57,55,2,48
Glenavon,2807,5,11,13,6,44,41,3,46
Dungannon,2807,6,10,10,10,52,49,3,40
Coleraine,2807,7,10,10,10,45,46,-1,40
Ballinamalla,2807,8,9,5,16,30,48,-18,32
Ards,2807,9,8,6,16,37,52,-15,30
Glentoran,2807,10,5,12,13,27,44,-17,27
Portadown,2807,11,4,8,18,22,48,-26,20
Glenavon,2808,1,15,9,6,52,41,11,54
Linfield,2808,2,14,9,7,55,35,20,51
Crusaders,2808,3,14,7,9,54,43,11,49
Ballymena,2808,4,13,7,10,63,63,0,46
Dungannon,2808,5,11,12,7,60,44,16,45
Coleraine,2808,6,11,10,9,40,42,-2,43
Cliftonville,2808,7,12,5,13,50,43,7,41
Ards,2808,8,11,4,15,41,49,-8,37
Ballinamalla,2808,9,9,5,16,37,51,-14,32
Portadown,2808,10,7,7,16,26,47,-21,28
Glentoran,2808,11,5,11,14,28,48,-20,26
Linfield,2809,1,16,9,5,65,32,33,57
Crusaders,2809,2,16,6,8,53,30,23,54
Coleraine,2809,3,14,10,6,47,38,9,52
Cliftonville,2809,4,13,6,11,45,41,4,45
Glenavon,2809,5,11,11,8,52,46,6,44
Ballymena,2809,6,11,9,10,63,61,2,42
Dungannon,2809,7,11,8,11,51,45,6,41
Glentoran,2809,8,9,6,15,32,49,-17,33
Ballinamalla,2809,9,8,7,15,31,52,-21,31
Ards,2809,10,7,6,17,40,59,-19,27
Portadown,2809,11,7,6,17,22,48,-26,27
Cliftonville,2810,1,16,5,9,47,33,14,53
Glenavon,2810,2,14,7,9,52,47,5,49
Crusaders,2810,3,14,6,10,50,44,6,48
Linfield,2810,4,12,11,7,52,30,22,47
Coleraine,2810,5,12,9,9,43,35,8,45
Dungannon,2810,6,12,8,10,50,42,8,44
Ballymena,2810,7,11,7,12,50,58,-8,40
Portadown,2810,8,10,6,14,24,34,-10,36
Ards,2810,9,9,7,14,34,43,-9,34
Glentoran,2810,10,9,5,16,26,42,-16,32
Ballinamalla,2810,11,8,5,17,29,49,-20,29
Linfield,2811,1,17,7,6,65,35,30,58
Crusaders,2811,2,16,6,8,56,39,17,54
Cliftonville,2811,3,15,6,9,46,36,10,51
Ballymena,2811,4,14,4,12,57,55,2,46
Glenavon,2811,5,13,7,10,49,49,0,46
Dungannon,2811,6,11,8,11,53,49,4,41
Coleraine,2811,7,9,10,11,44,47,-3,37
Glentoran,2811,8,9,8,13,37,48,-11,35
Ballinamalla,2811,9,10,4,16,38,53,-15,34
Portadown,2811,10,8,7,15,31,45,-14,31
Ards,2811,11,7,5,18,36,56,-20,26
Crusaders,2812,1,17,7,6,60,41,19,58
Ballymena,2812,2,16,5,9,61,59,2,53
Linfield,2812,3,14,9,7,57,28,29,51
Cliftonville,2812,4,15,4,11,53,47,6,49
Glenavon,2812,5,13,9,8,57,48,9,48
Coleraine,2812,6,10,8,12,40,41,-1,38
Glentoran,2812,7,9,8,13,34,46,-12,35
Portadown,2812,8,9,6,15,29,45,-16,33
Ards,2812,9,9,5,16,34,46,-12,32
Dungannon,2812,10,7,10,13,44,50,-6,31
Ballinamalla,2812,11,7,7,16,31,49,-18,28
Crusaders,2813,1,16,8,6,51,35,16,56
Ballymena,2813,2,15,7,8,60,52,8,52
Linfield,2813,3,14,9,7,65,39,26,51
Cliftonville,2813,4,14,8,8,52,38,14,50
Glenavon,2813,5,13,9,8,56,46,10,48
Coleraine,2813,6,10,12,8,42,37,5,42
Dungannon,2813,7,9,10,11,58,51,7,37
Ards,2813,8,10,6,14,37,49,-12,36
Glentoran,2813,9,8,6,16,29,49,-20,30
Portadown,2813,10,7,6,17,22,46,-24,27
Ballinamalla,2813,11,7,3,20,32,62,-30,24
Linfield,2814,1,17,7,6,63,33,30,58
Crusaders,2814,2,15,9,6,60,37,23,54
Cliftonville,2814,3,14,5,11,50,41,9,47
Glenavon,2814,4,10,12,8,46,48,-2,42
Ballymena,2814,5,10,8,12,53,65,-12,38
Dungannon,2814,6,9,10,11,48,43,5,37
Coleraine,2814,7,8,13,9,37,37,0,37
Glentoran,2814,8,10,7,13,38,48,-10,37
Ards,2814,9,9,8,13,39,46,-7,35
Portadown,2814,10,9,6,15,27,43,-16,33
Ballinamalla,2814,11,8,7,15,31,51,-20,31
Crusaders,2815,1,16,9,5,56,37,19,57
Linfield,2815,2,16,8,6,58,27,31,56
Cliftonville,2815,3,14,6,10,53,41,12,48
Ballymena,2815,4,13,7,10,49,54,-5,46
Coleraine,2815,5,10,11,9,39,41,-2,41
Glenavon,2815,6,10,10,10,47,49,-2,40
Dungannon,2815,7,10,9,11,53,45,8,39
Ards,2815,8,9,6,15,44,53,-9,33
Glentoran,2815,9,8,9,13,32,43,-11,33
Ballinamalla,2815,10,9,4,17,27,46,-19,31
Portadown,2815,11,8,5,17,22,44,-22,29
Cliftonville,2816,1,18,5,7,56,30,26,59
Crusaders,2816,2,16,7,7,53,34,19,55
Glenavon,2816,3,13,9,8,49,43,6,48
Linfield,2816,4,13,8,9,54,33,21,47
Ballymena,2816,5,14,5,11,61,60,1,47
Dungannon,2816,6,9,11,10,46,43,3,38
Glentoran,2816,7,9,10,11,31,43,-12,37
Coleraine,2816,8,9,9,12,39,42,-3,36
Ards,2816,9,9,6,15,40,54,-14,33
Ballinamalla,2816,10,7,8,15,31,51,-20,29
Portadown,2816,11,7,4,19,23,50,-27,25
Crusaders,2817,1,16,8,6,56,40,16,56
Cliftonville,2817,2,16,6,8,54,38,16,54
Linfield,2817,3,14,9,7,56,30,26,51
Ballymena,2817,4,15,5,10,53,51,2,50
Coleraine,2817,5,13,10,7,43,36,7,49
Dungannon,2817,6,12,10,8,49,36,13,46
Portadown,2817,7,10,3,17,30,44,-14,33
Glenavon,2817,8,8,7,15,41,50,-9,31
Glentoran,2817,9,7,10,13,27,46,-19,31
Ards,2817,10,8,4,18,38,55,-17,28
Ballinamalla,2817,11,7,6,17,26,47,-21,27
Cliftonville,2818,1,16,4,10,62,46,16,52
Ballymena,2818,2,16,4,10,64,58,6,52
Crusaders,2818,3,13,10,7,58,44,14,49
Linfield,2818,4,13,8,9,62,44,18,47
Glenavon,2818,5,12,10,8,57,47,10,46
Dungannon,2818,6,12,9,9,60,44,16,45
Coleraine,2818,7,11,7,12,48,53,-5,40
Glentoran,2818,8,10,8,12,35,45,-10,38
Ards,2818,9,9,6,15,37,46,-9,33
Ballinamalla,2818,10,10,3,17,35,61,-26,33
Portadown,2818,11,5,7,18,19,49,-30,22
Cliftonville,2819,1,18,4,8,54,35,19,58
Linfield,2819,2,16,9,5,59,30,29,57
Crusaders,2819,3,15,8,7,54,32,22,53
Ballymena,2819,4,14,6,10,58,61,-3,48
Coleraine,2819,5,10,12,8,41,37,4,42
Ballinamalla,2819,6,12,3,15,38,50,-12,39
Glenavon,2819,7,8,12,10,45,47,-2,36
Dungannon,2819,8,8,10,12,44,47,-3,34
Ards,2819,9,8,8,14,34,44,-10,32
Portadown,2819,10,8,5,17,24,47,-23,29
Glentoran,2819,11,4,11,15,24,45,-21,23
Crusaders,2820,1,18,8,4,57,25,32,62
Cliftonville,2820,2,16,5,9,60,41,19,53
Linfield,2820,3,13,11,6,61,41,20,50
Ballymena,2820,4,15,5,10,61,61,0,50
Coleraine,2820,5,11,9,10,42,48,-6,42
Dungannon,2820,6,10,10,10,55,47,8,40
Glenavon,2820,7,9,12,9,44,48,-4,39
Glentoran,2820,8,7,12,11,33,43,-10,33
Ards,2820,9,8,7,15,43,52,-9,31
Portadown,2820,10,8,5,17,28,49,-21,29
Ballinamalla,2820,11,5,6,19,27,56,-29,21
Linfield,2821,1,18,8,4,64,29,35,62
Crusaders,2821,2,18,6,6,63,33,30,60
Cliftonville,2821,3,16,3,11,55,45,10,51
Glenavon,2821,4,11,9,10,52,44,8,42
Ballymena,2821,5,11,9,10,54,60,-6,42
Dungannon,2821,6,11,8,11,52,42,10,41
Coleraine,2821,7,10,10,10,44,55,-11,40
Ballinamalla,2821,8,9,5,16,32,51,-19,32
Glentoran,2821,9,8,7,15,33,53,-20,31
Portadown,2821,10,9,3,18,29,52,-23,30
Ards,2821,11,7,6,17,35,49,-14,27
Crusaders,2822,1,20,6,4,64,28,36,66
Linfield,2822,2,14,9,7,55,35,20,51
Cliftonville,2822,3,13,7,10,50,40,10,46
Dungannon,2822,4,11,9,10,47,43,4,42
Ballymena,2822,5,11,8,11,47,59,-12,41
Coleraine,2822,6,10,10,10,32,33,-1,40
Portadown,2822,7,10,9,11,31,38,-7,39
Glenavon,2822,8,9,11,10,42,44,-2,38
Glentoran,2822,9,9,8,13,28,36,-8,35
Ards,2822,10,8,5,17,37,49,-12,29
Ballinamalla,2822,11,6,6,18,29,57,-28,24
Crusaders,2823,1,18,6,6,56,33,23,60
Cliftonville,2823,2,16,5,9,53,36,17,53
Linfield,2823,3,13,10,7,63,38,25,49
Coleraine,2823,4,12,10,8,45,37,8,46
Ballymena,2823,5,13,7,10,69,67,2,46
Glenavon,2823,6,10,9,11,47,46,1,39
Ards,2823,7,11,6,13,44,47,-3,39
Glentoran,2823,8,9,8,13,29,46,-17,35
Dungannon,2823,9,8,8,14,42,54,-12,32
Portadown,2823,10,8,8,14,31,47,-16,32
Ballinamalla,2823,11,7,3,20,28,56,-28,24
Linfield,2824,1,15,10,5,49,28,21,55
Crusaders,2824,2,15,8,7,54,34,20,53
Cliftonville,2824,3,15,6,9,51,45,6,51
Ballymena,2824,4,13,10,7,62,53,9,49
Dungannon,2824,5,12,9,9,51,39,12,45
Glenavon,2824,6,10,13,7,51,44,7,43
Coleraine,2824,7,10,13,7,37,35,2,43
Ards,2824,8,11,5,14,37,43,-6,38
Portadown,2824,9,6,6,18,24,47,-23,24
Glentoran,2824,10,5,9,16,25,50,-25,24
Ballinamalla,2824,11,5,7,18,27,50,-23,22
Ballymena,2825,1,18,4,8,69,60,9,58
Crusaders,2825,2,17,5,8,53,34,19,56
Linfield,2825,3,14,10,6,58,32,26,52
Glenavon,2825,4,15,7,8,54,45,9,52
Dungannon,2825,5,13,10,7,55,38,17,49
Cliftonville,2825,6,12,4,14,45,41,4,40
Coleraine,2825,7,10,10,10,40,39,1,40
Portadown,2825,8,8,6,16,28,43,-15,30
Glentoran,2825,9,7,7,16,28,54,-26,28
Ards,2825,10,7,6,17,29,47,-18,27
Ballinamalla,2825,11,8,3,19,30,56,-26,27
Cliftonville,2826,1,18,4,8,56,36,20,58
Coleraine,2826,2,15,11,4,59,31,28,56
Ballymena,2826,3,15,6,9,60,56,4,51
Crusaders,2826,4,13,8,9,47,37,10,47
Linfield,2826,5,12,9,9,48,38,10,45
Glenavon,2826,6,11,10,9,43,44,-1,43
Glentoran,2826,7,10,7,13,33,46,-13,37
Dungannon,2826,8,9,9,12,46,43,3,36
Ballinamalla,2826,9,9,5,16,37,50,-13,32
Ards,2826,10,7,7,16,35,54,-19,28
Portadown,2826,11,5,6,19,18,47,-29,21
Crusaders,2827,1,16,9,5,52,31,21,57
Linfield,2827,2,14,10,6,61,35,26,52
Ballymena,2827,3,13,8,9,58,60,-2,47
Dungannon,2827,4,13,7,10,56,40,16,46
Cliftonville,2827,5,13,7,10,50,40,10,46
Glenavon,2827,6,12,10,8,50,43,7,46
Coleraine,2827,7,11,11,8,43,37,6,44
Ballinamalla,2827,8,10,3,17,33,53,-20,33
Glentoran,2827,9,8,5,17,30,52,-22,29
Portadown,2827,10,8,5,17,27,50,-23,29
Ards,2827,11,6,7,17,33,52,-19,25
Linfield,2828,1,19,6,5,72,27,45,63
Ballymena,2828,2,16,4,10,69,56,13,52
Glenavon,2828,3,13,9,8,50,46,4,48
Crusaders,2828,4,14,5,11,50,36,14,47
Coleraine,2828,5,12,11,7,43,36,7,47
Ballinamalla,2828,6,14,3,13,37,41,-4,45
Cliftonville,2828,7,12,8,10,51,48,3,44
Portadown,2828,8,9,4,17,28,44,-16,31
Glentoran,2828,9,7,10,13,27,50,-23,31
Ards,2828,10,7,5,18,33,51,-18,26
Dungannon,2828,11,5,9,16,36,61,-25,24
Crusaders,2829,1,19,6,5,66,38,28,63
Glenavon,2829,2,15,8,7,53,38,15,53
Linfield,2829,3,12,12,6,58,33,25,48
Cliftonville,2829,4,13,7,10,53,50,3,46
Ballymena,2829,5,11,9,10,53,58,-5,42
Glentoran,2829,6,11,8,11,30,37,-7,41
Coleraine,2829,7,10,10,10,40,38,2,40
Dungannon,2829,8,9,9,12,48,44,4,36
Ballinamalla,2829,9,9,4,17,33,54,-21,31
Portadown,2829,10,7,6,17,26,46,-20,27
Ards,2829,11,6,7,17,32,56,-24,25
Crusaders,2830,1,17,9,4,54,30,24,60
Cliftonville,2830,2,17,6,7,62,35,27,57
Ballymena,2830,3,16,4,10,62,54,8,52
Linfield,2830,4,12,9,9,53,35,18,45
Coleraine,2830,5,11,11,8,47,40,7,44
Dungannon,2830,6,10,13,7,47,34,13,43
Glenavon,2830,7,9,14,7,46,44,2,41
Glentoran,2830,8,8,7,15,28,50,-22,31
Ballinamalla,2830,9,7,8,15,25,45,-20,29
Ards,2830,10,6,7,17,34,56,-22,25
Portadown,2830,11,5,6,19,22,57,-35,21
Crusaders,2831,1,15,7,8,51,39,12,52
Linfield,2831,2,13,8,9,51,34,17,47
Ballymena,2831,3,14,5,11,62,55,7,47
Coleraine,2831,4,12,10,8,44,41,3,46
Dungannon,2831,5,12,9,9,50,44,6,45
Glentoran,2831,6,13,5,12,29,39,-10,44
Cliftonville,2831,7,12,7,11,42,35,7,43
Glenavon,2831,8,11,10,9,50,44,6,43
Ards,2831,9,10,5,15,42,51,-9,35
Ballinamalla,2831,10,7,6,17,34,52,-18,27
Portadown,2831,11,7,6,17,26,47,-21,27
Linfield,2832,1,15,8,7,64,37,27,53
Glenavon,2832,2,13,13,4,49,37,12,52
Crusaders,2832,3,14,7,9,46,35,11,49
Ballymena,2832,4,14,5,11,59,60,-1,47
Cliftonville,2832,5,14,4,12,46,39,7,46
Glentoran,2832,6,12,7,11,39,39,0,43
Coleraine,2832,7,10,11,9,43,43,0,41
Dungannon,2832,8,9,11,10,50,48,2,38
Portadown,2832,9,8,6,16,25,46,-21,30
Ballinamalla,2832,10,8,4,18,36,54,-18,28
Ards,2832,11,8,4,18,35,54,-19,28
Linfield,2833,1,16,10,4,62,27,35,58
Coleraine,2833,2,13,10,7,40,27,13,49
Crusaders,2833,3,13,7,10,49,42,7,46
Ballymena,2833,4,13,7,10,55,56,-1,46
Cliftonville,2833,5,12,8,10,47,38,9,44
Glenavon,2833,6,9,13,8,42,43,-1,40
Dungannon,2833,7,10,9,11,51,46,5,39
Ards,2833,8,10,4,16,35,52,-17,34
Glentoran,2833,9,8,8,14,34,46,-12,32
Ballinamalla,2833,10,9,5,16,29,46,-17,32
Portadown,2833,11,9,5,16,32,53,-21,32
Linfield,2834,1,16,9,5,63,29,34,57
Crusaders,2834,2,17,5,8,57,44,13,56
Cliftonville,2834,3,15,5,10,49,38,11,50
Ballymena,2834,4,13,7,10,51,53,-2,46
Dungannon,2834,5,12,7,11,59,50,9,43
Coleraine,2834,6,10,11,9,39,37,2,41
Ards,2834,7,10,6,14,40,50,-10,36
Ballinamalla,2834,8,10,5,15,27,44,-17,35
Glenavon,2834,9,8,10,12,46,51,-5,34
Glentoran,2834,10,9,6,15,29,44,-15,33
Portadown,2834,11,7,5,18,30,50,-20,26
Linfield,2835,1,16,9,5,59,29,30,57
Crusaders,2835,2,15,9,6,53,35,18,54
Ballymena,2835,3,15,7,8,58,52,6,52
Cliftonville,2835,4,15,5,10,48,35,13,50
Dungannon,2835,5,10,11,9,53,37,16,41
Coleraine,2835,6,10,9,11,42,40,2,39
Glenavon,2835,7,8,13,9,35,44,-9,37
Ballinamalla,2835,8,11,4,15,29,47,-18,37
Ards,2835,9,8,6,16,37,49,-12,30
Glentoran,2835,10,6,10,14,25,44,-19,28
Portadown,2835,11,6,7,17,27,54,-27,25
Crusaders,2836,1,17,6,7,58,32,26,57
Cliftonville,2836,2,17,5,8,53,33,20,56
Ballymena,2836,3,14,7,9,59,53,6,49
Linfield,2836,4,13,7,10,58,45,13,46
Coleraine,2836,5,11,8,11,40,47,-7,41
Glenavon,2836,6,9,11,10,44,49,-5,38
Dungannon,2836,7,8,12,10,43,43,0,36
Ards,2836,8,11,3,16,43,46,-3,36
Glentoran,2836,9,9,8,13,29,42,-13,35
Portadown,2836,10,9,6,15,26,41,-15,33
Ballinamalla,2836,11,9,3,18,29,51,-22,30
Crusaders,2837,1,15,8,7,51,32,19,53
Ballymena,2837,2,15,6,9,65,63,2,51
Linfield,2837,3,14,8,8,60,39,21,50
Cliftonville,2837,4,14,5,11,48,41,7,47
Glenavon,2837,5,11,11,8,45,41,4,44
Coleraine,2837,6,11,8,11,42,45,-3,41
Dungannon,2837,7,11,7,12,47,43,4,40
Ards,2837,8,12,3,15,38,43,-5,39
Portadown,2837,9,10,4,16,34,46,-12,34
Glentoran,2837,10,8,7,15,32,43,-11,31
Ballinamalla,2837,11,9,3,18,28,54,-26,30
Crusaders,2838,1,19,6,5,58,30,28,63
Linfield,2838,2,13,11,6,49,27,22,50
Coleraine,2838,3,13,10,7,49,40,9,49
Cliftonville,2838,4,13,7,10,49,45,4,46
Ballymena,2838,5,11,9,10,52,58,-6,42
Glenavon,2838,6,9,11,10,50,49,1,38
Portadown,2838,7,11,5,14,31,40,-9,38
Dungannon,2838,8,8,12,10,47,43,4,36
Ards,2838,9,8,7,15,29,47,-18,31
Glentoran,2838,10,5,13,12,27,42,-15,28
Ballinamalla,2838,11,6,7,17,27,47,-20,25
Ballymena,2839,1,19,4,7,67,54,13,61
Crusaders,2839,2,17,8,5,68,40,28,59
Cliftonville,2839,3,14,7,9,54,40,14,49
Linfield,2839,4,13,9,8,61,38,23,48
Coleraine,2839,5,9,11,10,38,39,-1,38
Ards,2839,6,11,5,14,37,47,-10,38
Dungannon,2839,7,8,12,10,50,53,-3,36
Glenavon,2839,8,7,12,11,44,55,-11,33
Ballinamalla,2839,9,9,6,15,39,53,-14,33
Portadown,2839,10,8,6,16,35,52,-17,30
Glentoran,2839,11,5,10,15,32,54,-22,25
Crusaders,2840,1,21,7,2,69,29,40,70
Linfield,2840,2,16,11,3,65,30,35,59
Cliftonville,2840,3,16,6,8,52,40,12,54
Ballymena,2840,4,13,8,9,56,55,1,47
Glenavon,2840,5,12,10,8,46,41,5,46
Coleraine,2840,6,10,10,10,38,40,-2,40
Dungannon,2840,7,8,10,12,47,48,-1,34
Ballinamalla,2840,8,10,3,17,37,55,-18,33
Glentoran,2840,9,6,7,17,31,51,-20,25
Ards,2840,10,7,4,19,33,56,-23,25
Portadown,2840,11,6,4,20,23,52,-29,22
Cliftonville,2841,1,18,2,10,58,38,20,56
Crusaders,2841,2,16,7,7,60,40,20,55
Coleraine,2841,3,15,8,7,51,34,17,53
Linfield,2841,4,14,9,7,65,37,28,51
Ballymena,2841,5,15,4,11,67,58,9,49
Dungannon,2841,6,11,10,9,54,43,11,43
Glenavon,2841,7,9,10,11,40,49,-9,37
Ards,2841,8,9,6,15,35,52,-17,33
Glentoran,2841,9,8,7,15,29,48,-19,31
Portadown,2841,10,8,4,18,26,60,-34,28
Ballinamalla,2841,11,5,7,18,27,53,-26,22
Crusaders,2842,1,17,6,7,51,32,19,57
Linfield,2842,2,14,9,7,51,28,23,51
Cliftonville,2842,3,14,7,9,49,41,8,49
Coleraine,2842,4,13,9,8,48,37,11,48
Ballymena,2842,5,14,5,11,59,59,0,47
Glenavon,2842,6,11,10,9,46,45,1,43
Dungannon,2842,7,10,11,9,54,44,10,41
Glentoran,2842,8,10,6,14,31,43,-12,36
Ballinamalla,2842,9,9,5,16,32,50,-18,32
Ards,2842,10,7,6,17,30,50,-20,27
Portadown,2842,11,5,8,17,23,45,-22,23
Cliftonville,2843,1,18,4,8,60,41,19,58
Linfield,2843,2,16,9,5,64,32,32,57
Crusaders,2843,3,16,8,6,63,44,19,56
Coleraine,2843,4,13,10,7,48,42,6,49
Dungannon,2843,5,12,9,9,57,42,15,45
Glenavon,2843,6,10,11,9,45,47,-2,41
Ballymena,2843,7,11,7,12,56,59,-3,40
Glentoran,2843,8,11,5,14,39,43,-4,38
Ards,2843,9,6,7,17,30,53,-23,25
Portadown,2843,10,7,4,19,25,54,-29,25
Ballinamalla,2843,11,7,2,21,33,63,-30,23
Crusaders,2844,1,19,7,4,62,28,34,64
Linfield,2844,2,14,7,9,57,38,19,49
Cliftonville,2844,3,14,4,12,51,39,12,46
Glenavon,2844,4,12,9,9,48,45,3,45
Ballymena,2844,5,13,6,11,53,58,-5,45
Ards,2844,6,12,5,13,47,44,3,41
Coleraine,2844,7,9,10,11,40,48,-8,37
Dungannon,2844,8,9,9,12,48,50,-2,36
Portadown,2844,9,10,6,14,30,45,-15,36
Ballinamalla,2844,10,9,4,17,35,53,-18,31
Glentoran,2844,11,7,7,16,32,55,-23,28
Linfield,2845,1,17,6,7,62,29,33,57
Cliftonville,2845,2,18,3,9,63,43,20,57
Crusaders,2845,3,14,8,8,58,41,17,50
Dungannon,2845,4,13,7,10,58,48,10,46
Coleraine,2845,5,11,10,9,46,46,0,43
Glenavon,2845,6,10,12,8,49,48,1,42
Ballymena,2845,7,12,6,12,60,67,-7,42
Ards,2845,8,9,7,14,39,51,-12,34
Glentoran,2845,9,8,9,13,35,44,-9,33
Portadown,2845,10,8,4,18,25,53,-28,28
Ballinamalla,2845,11,8,2,20,33,58,-25,26
Crusaders,2846,1,20,7,3,61,31,30,67
Linfield,2846,2,15,10,5,55,26,29,55
Ballymena,2846,3,17,4,9,60,49,11,55
Coleraine,2846,4,13,11,6,45,37,8,50
Glenavon,2846,5,12,9,9,50,42,8,45
Cliftonville,2846,6,12,4,14,41,44,-3,40
Ards,2846,7,9,4,17,34,51,-17,31
Glentoran,2846,8,8,7,15,27,46,-19,31
Dungannon,2846,9,6,11,13,52,52,0,29
Ballinamalla,2846,10,7,5,18,31,54,-23,26
Portadown,2846,11,6,8,16,21,45,-24,26
Crusaders,2847,1,17,8,5,60,33,27,59
Glenavon,2847,2,15,9,6,51,42,9,54
Coleraine,2847,3,13,9,8,45,41,4,48
Ballymena,2847,4,12,8,10,57,56,1,44
Dungannon,2847,5,12,7,11,49,40,9,43
Linfield,2847,6,11,9,10,55,38,17,42
Cliftonville,2847,7,12,6,12,46,46,0,42
Glentoran,2847,8,10,9,11,29,42,-13,39
Portadown,2847,9,10,3,17,32,42,-10,33
Ards,2847,10,8,4,18,34,54,-20,28
Ballinamalla,2847,11,7,4,19,28,52,-24,25
Linfield,2848,1,14,11,5,58,29,29,53
Glenavon,2848,2,12,11,7,49,38,11,47
Cliftonville,2848,3,14,5,11,45,39,6,47
Crusaders,2848,4,12,10,8,45,37,8,46
Dungannon,2848,5,12,9,9,47,39,8,45
Ballymena,2848,6,13,4,13,61,61,0,43
Coleraine,2848,7,10,11,9,40,41,-1,41
Ballinamalla,2848,8,10,5,15,35,48,-13,35
Ards,2848,9,8,7,15,36,47,-11,31
Portadown,2848,10,7,10,13,22,41,-19,31
Glentoran,2848,11,7,9,14,27,45,-18,30
Crusaders,2849,1,17,7,6,51,24,27,58
Ballymena,2849,2,16,7,7,68,57,11,55
Linfield,2849,3,14,10,6,59,39,20,52
Cliftonville,2849,4,14,8,8,47,38,9,50
Glenavon,2849,5,11,12,7,45,41,4,45
Coleraine,2849,6,10,12,8,40,36,4,42
Dungannon,2849,7,11,6,13,46,46,0,39
Portadown,2849,8,9,5,16,36,45,-9,32
Glentoran,2849,9,7,8,15,23,37,-14,29
Ballinamalla,2849,10,7,5,18,28,54,-26,26
Ards,2849,11,6,6,18,27,53,-26,24
Cliftonville,2850,1,18,5,7,52,35,17,59
Crusaders,2850,2,15,6,9,56,40,16,51
Ballymena,2850,3,14,7,9,58,57,1,49
Coleraine,2850,4,11,12,7,45,35,10,45
Linfield,2850,5,12,8,10,52,44,8,44
Dungannon,2850,6,12,7,11,52,42,10,43
Glenavon,2850,7,11,10,9,57,52,5,43
Ards,2850,8,10,7,13,41,49,-8,37
Glentoran,2850,9,7,10,13,31,46,-15,31
Portadown,2850,10,8,4,18,26,45,-19,28
Ballinamalla,2850,11,6,6,18,33,58,-25,24
Crusaders,2851,1,16,9,5,53,33,20,57
Dungannon,2851,2,14,9,7,54,34,20,51
Linfield,2851,3,14,7,9,59,41,18,49
Glenavon,2851,4,11,11,8,45,45,0,44
Coleraine,2851,5,11,10,9,45,38,7,43
Cliftonville,2851,6,12,7,11,47,45,2,43
Ballymena,2851,7,11,10,9,54,55,-1,43
Ards,2851,8,11,6,13,38,44,-6,39
Ballinamalla,2851,9,7,7,16,40,54,-14,28
Glentoran,2851,10,6,9,15,30,50,-20,27
Portadown,2851,11,7,5,18,25,51,-26,26
Crusaders,2852,1,18,9,3,64,32,32,63
Linfield,2852,2,14,10,6,60,31,29,52
Cliftonville,2852,3,13,5,12,50,41,9,44
Coleraine,2852,4,11,11,8,39,36,3,44
Glenavon,2852,5,11,10,9,49,44,5,43
Ballymena,2852,6,12,7,11,52,61,-9,43
Ards,2852,7,9,7,14,37,49,-12,34
Ballinamalla,2852,8,10,4,16,34,53,-19,34
Dungannon,2852,9,7,12,11,47,45,2,33
Glentoran,2852,10,7,9,14,32,45,-13,30
Portadown,2852,11,8,6,16,24,51,-27,30
Crusaders,2853,1,18,7,5,57,32,25,61
Ballymena,2853,2,15,8,7,62,48,14,53
Glenavon,2853,3,14,8,8,52,42,10,50
Cliftonville,2853,4,15,4,11,46,38,8,49
Linfield,2853,5,13,8,9,61,34,27,47
Coleraine,2853,6,10,11,9,39,37,2,41
Glentoran,2853,7,10,9,11,37,43,-6,39
Dungannon,2853,8,8,9,13,46,50,-4,33
Ballinamalla,2853,9,8,6,16,27,52,-25,30
Ards,2853,10,7,7,16,38,59,-21,28
Portadown,2853,11,7,3,20,24,54,-30,24
Crusaders,2854,1,19,8,3,67,31,36,65
Linfield,2854,2,13,11,6,58,32,26,50
Glenavon,2854,3,13,10,7,49,39,10,49
Coleraine,2854,4,13,9,8,42,34,8,48
Cliftonville,2854,5,12,8,10,44,39,5,44
Dungannon,2854,6,10,11,9,48,43,5,41
Ballymena,2854,7,11,7,12,48,57,-9,40
Ards,2854,8,9,7,14,36,47,-11,34
Portadown,2854,9,6,8,16,23,45,-22,26
Glentoran,2854,10,6,8,16,24,49,-25,26
Ballinamalla,2854,11,6,7,17,28,51,-23,25
Crusaders,2855,1,19,6,5,54,31,23,63
Cliftonville,2855,2,16,3,11,53,38,15,51
Linfield,2855,3,14,8,8,56,33,23,50
Glentoran,2855,4,13,8,9,37,37,0,47
Ballymena,2855,5,13,8,9,53,60,-7,47
Coleraine,2855,6,11,13,6,48,31,17,46
Glenavon,2855,7,10,13,7,52,47,5,43
Dungannon,2855,8,6,9,15,44,56,-12,27
Ballinamalla,2855,9,6,9,15,32,53,-21,27
Ards,2855,10,7,5,18,37,58,-21,26
Portadown,2855,11,7,4,19,26,48,-22,25
Crusaders,2856,1,15,8,7,55,44,11,53
Linfield,2856,2,14,10,6,55,34,21,52
Glenavon,2856,3,13,12,5,55,41,14,51
Cliftonville,2856,4,15,5,10,54,41,13,50
Coleraine,2856,5,13,7,10,42,36,6,46
Dungannon,2856,6,9,12,9,49,48,1,39
Glentoran,2856,7,11,6,13,35,41,-6,39
Ballymena,2856,8,10,7,13,44,56,-12,37
Ards,2856,9,10,4,16,39,47,-8,34
Portadown,2856,10,7,9,14,31,49,-18,30
Ballinamalla,2856,11,6,4,20,30,52,-22,22
Crusaders,2857,1,20,6,4,63,37,26,66
Linfield,2857,2,14,9,7,65,38,27,51
Cliftonville,2857,3,15,4,11,53,43,10,49
Ballymena,2857,4,13,8,9,59,56,3,47
Coleraine,2857,5,11,11,8,43,37,6,44
Glenavon,2857,6,11,11,8,47,46,1,44
Glentoran,2857,7,9,9,12,34,44,-10,36
Dungannon,2857,8,8,9,13,47,47,0,33
Ards,2857,9,8,5,17,35,53,-18,29
Portadown,2857,10,7,6,17,29,53,-24,27
Ballinamalla,2857,11,6,8,16,34,55,-21,26
Linfield,2858,1,19,8,3,71,24,47,65
Crusaders,2858,2,15,9,6,55,35,20,54
Ballymena,2858,3,13,7,10,60,59,1,46
Coleraine,2858,4,11,9,10,42,44,-2,42
Dungannon,2858,5,10,8,12,47,42,5,38
Glenavon,2858,6,8,14,8,42,42,0,38
Cliftonville,2858,7,10,8,12,40,42,-2,38
Glentoran,2858,8,10,6,14,32,52,-20,36
Ards,2858,9,9,6,15,38,46,-8,33
Portadown,2858,10,8,7,15,28,46,-18,31
Ballinamalla,2858,11,9,4,17,31,54,-23,31
Linfield,2859,1,18,8,4,73,33,40,62
Coleraine,2859,2,13,10,7,46,35,11,49
Crusaders,2859,3,13,9,8,52,40,12,48
Ballymena,2859,4,14,6,10,60,65,-5,48
Cliftonville,2859,5,14,2,14,46,45,1,44
Dungannon,2859,6,11,10,9,49,40,9,43
Glenavon,2859,7,11,10,9,42,41,1,43
Ards,2859,8,10,5,15,35,49,-14,35
Portadown,2859,9,9,2,19,25,47,-22,29
Ballinamalla,2859,10,7,7,16,31,45,-14,28
Glentoran,2859,11,6,9,15,27,46,-19,27
Cliftonville,2860,1,16,6,8,55,37,18,54
Crusaders,2860,2,14,9,7,55,39,16,51
Ballymena,2860,3,13,7,10,71,62,9,46
Dungannon,2860,4,12,8,10,49,39,10,44
Linfield,2860,5,11,9,10,55,45,10,42
Coleraine,2860,6,11,8,11,37,49,-12,41
Glenavon,2860,7,9,13,8,47,47,0,40
Glentoran,2860,8,10,9,11,30,42,-12,39
Ards,2860,9,9,7,14,41,44,-3,34
Portadown,2860,10,9,5,16,27,47,-20,32
Ballinamalla,2860,11,9,3,18,34,50,-16,30
Crusaders,2861,1,18,6,6,63,37,26,60
Cliftonville,2861,2,15,8,7,54,38,16,53
Ballymena,2861,3,14,5,11,58,57,1,47
Glenavon,2861,4,12,10,8,49,47,2,46
Linfield,2861,5,11,8,11,54,40,14,41
Coleraine,2861,6,10,10,10,39,45,-6,40
Dungannon,2861,7,10,8,12,44,44,0,38
Glentoran,2861,8,9,10,11,35,47,-12,37
Ards,2861,9,10,5,15,47,48,-1,35
Ballinamalla,2861,10,9,4,17,31,50,-19,31
Portadown,2861,11,7,6,17,22,43,-21,27
Cliftonville,2862,1,18,3,9,55,37,18,57
Linfield,2862,2,15,9,6,62,33,29,54
Crusaders,2862,3,13,10,7,51,37,14,49
Ballymena,2862,4,13,6,11,61,57,4,45
Coleraine,2862,5,10,13,7,47,45,2,43
Glenavon,2862,6,10,12,8,44,44,0,42
Dungannon,2862,7,9,11,10,49,49,0,38
Ards,2862,8,8,8,14,38,47,-9,32
Glentoran,2862,9,7,9,14,32,49,-17,30
Ballinamalla,2862,10,8,6,16,31,50,-19,30
Portadown,2862,11,9,3,18,30,52,-22,30
Crusaders,2863,1,17,9,4,58,36,22,60
Coleraine,2863,2,14,10,6,42,30,12,52
Linfield,2863,3,14,9,7,53,24,29,51
Dungannon,2863,4,14,9,7,56,39,17,51
Glenavon,2863,5,13,11,6,50,41,9,50
Ballymena,2863,6,13,7,10,57,57,0,46
Cliftonville,2863,7,13,3,14,44,42,2,42
Glentoran,2863,8,10,7,13,30,41,-11,37
Ards,2863,9,9,3,18,31,49,-18,30
Ballinamalla,2863,10,7,2,21,29,56,-27,23
Portadown,2863,11,4,4,22,20,55,-35,16
Crusaders,2864,1,16,5,9,50,31,19,53
Linfield,2864,2,14,10,6,56,32,24,52
Ballymena,2864,3,15,6,9,54,50,4,51
Coleraine,2864,4,13,11,6,46,34,12,50
Dungannon,2864,5,13,10,7,54,36,18,49
Cliftonville,2864,6,14,7,9,54,39,15,49
Glentoran,2864,7,9,7,14,31,45,-14,34
Glenavon,2864,8,8,9,13,35,47,-12,33
Ards,2864,9,8,6,16,42,56,-14,30
Ballinamalla,2864,10,9,3,18,28,53,-25,30
Portadown,2864,11,5,8,17,24,51,-27,23
Ballymena,2865,1,17,5,8,63,56,7,56
Crusaders,2865,2,15,7,8,56,36,20,52
Coleraine,2865,3,14,9,7,38,31,7,51
Linfield,2865,4,14,6,10,61,40,21,48
Cliftonville,2865,5,15,3,12,56,49,7,48
Glentoran,2865,6,12,8,10,30,33,-3,44
Glenavon,2865,7,10,7,13,44,47,-3,37
Ards,2865,8,10,6,14,38,47,-9,36
Ballinamalla,2865,9,11,3,16,38,52,-14,36
Dungannon,2865,10,8,7,15,39,48,-9,31
Portadown,2865,11,7,3,20,23,47,-24,24
Crusaders,2866,1,17,6,7,54,35,19,57
Ballymena,2866,2,17,5,8,71,56,15,56
Cliftonville,2866,3,15,5,10,58,37,21,50
Glenavon,2866,4,12,13,5,54,42,12,49
Linfield,2866,5,13,9,8,54,33,21,48
Dungannon,2866,6,11,9,10,47,41,6,42
Coleraine,2866,7,9,9,12,44,51,-7,36
Glentoran,2866,8,8,9,13,28,41,-13,33
Ballinamalla,2866,9,9,3,18,25,52,-27,30
Ards,2866,10,8,5,17,34,50,-16,29
Portadown,2866,11,7,5,18,29,60,-31,26
Crusaders,2867,1,17,7,6,54,30,24,58
Linfield,2867,2,14,10,6,64,32,32,52
Portadown,2867,3,15,4,11,35,34,1,49
Cliftonville,2867,4,14,5,11,52,39,13,47
Ballymena,2867,5,13,7,10,53,58,-5,46
Coleraine,2867,6,12,9,9,40,39,1,45
Glenavon,2867,7,10,11,9,42,43,-1,41
Dungannon,2867,8,7,13,10,48,45,3,34
Glentoran,2867,9,8,9,13,32,45,-13,33
Ballinamalla,2867,10,7,4,19,22,49,-27,25
Ards,2867,11,7,3,20,32,60,-28,24
Linfield,2868,1,14,12,4,61,29,32,54
Crusaders,2868,2,14,9,7,51,36,15,51
Cliftonville,2868,3,16,3,11,54,44,10,51
Ballymena,2868,4,15,6,9,62,58,4,51
Glenavon,2868,5,12,12,6,53,40,13,48
Coleraine,2868,6,12,9,9,43,43,0,45
Dungannon,2868,7,10,10,10,51,43,8,40
Ballinamalla,2868,8,9,6,15,32,46,-14,33
Glentoran,2868,9,5,13,12,27,43,-16,28
Ards,2868,10,7,5,18,35,58,-23,26
Portadown,2868,11,4,9,17,22,51,-29,21
Coleraine,2869,1,14,11,5,47,32,15,53
Linfield,2869,2,14,10,6,53,29,24,52
Crusaders,2869,3,15,6,9,55,31,24,51
Cliftonville,2869,4,14,7,9,49,40,9,49
Ballymena,2869,5,14,4,12,55,61,-6,46
Glenavon,2869,6,10,12,8,46,44,2,42
Glentoran,2869,7,10,7,13,29,41,-12,37
Dungannon,2869,8,8,11,11,48,47,1,35
Ards,2869,9,10,5,15,36,45,-9,35
Ballinamalla,2869,10,9,3,18,25,47,-22,30
Portadown,2869,11,6,6,18,24,50,-26,24
Crusaders,2870,1,17,7,6,59,38,21,58
Linfield,2870,2,16,6,8,56,27,29,54
Cliftonville,2870,3,17,3,10,56,44,12,54
Ballymena,2870,4,14,6,10,61,61,0,48
Glenavon,2870,5,11,12,7,52,47,5,45
Dungannon,2870,6,8,14,8,54,46,8,38
Coleraine,2870,7,9,10,11,39,41,-2,37
Ards,2870,8,9,6,15,33,47,-14,33
Glentoran,2870,9,9,6,15,34,51,-17,33
Portadown,2870,10,8,4,18,31,48,-17,28
Ballinamalla,2870,11,6,8,16,32,57,-25,26
Crusaders,2871,1,18,7,5,53,32,21,61
Linfield,2871,2,15,8,7,62,36,26,53
Cliftonville,2871,3,15,6,9,57,36,21,51
Ballymena,2871,4,15,6,9,59,57,2,51
Dungannon,2871,5,13,8,9,51,33,18,47
Glenavon,2871,6,9,9,12,40,50,-10,36
Glentoran,2871,7,10,6,14,30,42,-12,36
Coleraine,2871,8,8,11,11,38,38,0,35
Ards,2871,9,9,6,15,36,44,-8,33
Portadown,2871,10,8,4,18,26,56,-30,28
Ballinamalla,2871,11,8,3,19,25,53,-28,27
Linfield,2872,1,15,10,5,58,31,27,55
Cliftonville,2872,2,16,5,9,55,34,21,53
Crusaders,2872,3,15,7,8,49,36,13,52
Coleraine,2872,4,11,10,9,36,36,0,43
Ballymena,2872,5,11,10,9,48,54,-6,43
Glenavon,2872,6,8,13,9,41,42,-1,37
Dungannon,2872,7,9,10,11,39,40,-1,37
Ards,2872,8,9,6,15,41,52,-11,33
Portadown,2872,9,8,9,13,27,39,-12,33
Glentoran,2872,10,8,8,14,26,39,-13,32
Ballinamalla,2872,11,9,4,17,34,51,-17,31
Crusaders,2873,1,17,7,6,60,33,27,58
Ballymena,2873,2,15,6,9,65,59,6,51
Cliftonville,2873,3,13,9,8,49,39,10,48
Coleraine,2873,4,11,13,6,43,33,10,46
Dungannon,2873,5,10,11,9,48,40,8,41
Linfield,2873,6,10,10,10,49,41,8,40
Glenavon,2873,7,9,13,8,47,48,-1,40
Ballinamalla,2873,8,10,4,16,34,54,-20,34
Ards,2873,9,8,8,14,42,52,-10,32
Glentoran,2873,10,8,7,15,36,52,-16,31
Portadown,2873,11,6,8,16,28,50,-22,26
Crusaders,2874,1,17,7,6,62,36,26,58
Cliftonville,2874,2,16,4,10,49,40,9,52
Ballymena,2874,3,16,4,10,58,61,-3,52
Linfield,2874,4,14,9,7,67,38,29,51
Coleraine,2874,5,14,9,7,47,36,11,51
Glenavon,2874,6,11,10,9,42,39,3,43
Glentoran,2874,7,11,7,12,34,43,-9,40
Ballinamalla,2874,8,9,3,18,34,55,-21,30
Dungannon,2874,9,6,10,14,45,49,-4,28
Ards,2874,10,6,8,16,32,48,-16,26
Portadown,2874,11,7,5,18,24,49,-25,26
Crusaders,2875,1,19,7,4,54,28,26,64
Cliftonville,2875,2,15,8,7,53,37,16,53
Linfield,2875,3,14,8,8,56,40,16,50
Ballymena,2875,4,13,7,10,60,66,-6,46
Coleraine,2875,5,11,11,8,43,36,7,44
Dungannon,2875,6,10,9,11,58,48,10,39
Glenavon,2875,7,8,11,11,42,47,-5,35
Portadown,2875,8,9,8,13,28,39,-11,35
Glentoran,2875,9,9,7,14,38,47,-9,34
Ballinamalla,2875,10,8,5,17,30,52,-22,29
Ards,2875,11,6,5,19,38,60,-22,23
Linfield,2876,1,16,8,6,60,31,29,56
Crusaders,2876,2,14,9,7,61,45,16,51
Ballymena,2876,3,15,6,9,62,56,6,51
Cliftonville,2876,4,14,8,8,50,37,13,50
Glenavon,2876,5,12,9,9,49,45,4,45
Dungannon,2876,6,11,7,12,54,43,11,40
Coleraine,2876,7,9,10,11,33,38,-5,37
Ards,2876,8,10,5,15,36,47,-11,35
Glentoran,2876,9,8,9,13,24,41,-17,33
Portadown,2876,10,9,4,17,24,42,-18,31
Ballinamalla,2876,11,7,5,18,26,54,-28,26
Crusaders,2877,1,22,6,2,57,21,36,72
Linfield,2877,2,16,8,6,60,28,32,56
Ballymena,2877,3,15,4,11,60,60,0,49
Coleraine,2877,4,11,12,7,46,37,9,45
Cliftonville,2877,5,13,3,14,44,42,2,42
Glenavon,2877,6,9,10,11,47,49,-2,37
Dungannon,2877,7,9,9,12,52,47,5,36
Ards,2877,8,9,8,13,39,51,-12,35
Ballinamalla,2877,9,9,5,16,31,49,-18,32
Portadown,2877,10,7,6,17,22,48,-26,27
Glentoran,2877,11,5,9,16,23,49,-26,24
Glenavon,2878,1,15,10,5,60,42,18,55
Linfield,2878,2,14,11,5,56,30,26,53
Cliftonville,2878,3,14,8,8,52,39,13,50
Crusaders,2878,4,14,7,9,53,42,11,49
Ballymena,2878,5,10,10,10,53,58,-5,40
Portadown,2878,6,11,6,13,28,39,-11,39
Coleraine,2878,7,8,14,8,36,38,-2,38
Ards,2878,8,10,8,12,41,47,-6,38
Dungannon,2878,9,8,9,13,51,57,-6,33
Glentoran,2878,10,7,7,16,33,42,-9,28
Ballinamalla,2878,11,7,4,19,31,60,-29,25
Linfield,2879,1,19,7,4,61,23,38,64
Crusaders,2879,2,15,9,6,51,35,16,54
Cliftonville,2879,3,16,4,10,47,36,11,52
Ballymena,2879,4,15,3,12,65,55,10,48
Coleraine,2879,5,11,10,9,50,42,8,43
Glenavon,2879,6,11,10,9,51,53,-2,43
Dungannon,2879,7,11,8,11,50,44,6,41
Ards,2879,8,10,5,15,35,46,-11,35
Glentoran,2879,9,8,7,15,27,48,-21,31
Ballinamalla,2879,10,7,5,18,28,53,-25,26
Portadown,2879,11,6,4,20,24,54,-30,22
Linfield,2880,1,14,10,6,57,30,27,52
Glenavon,2880,2,14,10,6,51,43,8,52
Cliftonville,2880,3,15,6,9,51,46,5,51
Coleraine,2880,4,13,10,7,45,34,11,49
Crusaders,2880,5,14,6,10,53,35,18,48
Ards,2880,6,13,4,13,47,44,3,43
Ballymena,2880,7,12,6,12,51,56,-5,42
Dungannon,2880,8,9,10,11,48,46,2,37
Glentoran,2880,9,7,8,15,30,48,-18,29
Ballinamalla,2880,10,6,8,16,28,51,-23,26
Portadown,2880,11,8,2,20,22,50,-28,26
Crusaders,2881,1,17,9,4,56,33,23,60
Cliftonville,2881,2,17,3,10,58,38,20,54
Linfield,2881,3,12,13,5,54,31,23,49
Coleraine,2881,4,13,9,8,46,40,6,48
Ballymena,2881,5,14,5,11,59,61,-2,47
Glenavon,2881,6,12,9,9,51,44,7,45
Dungannon,2881,7,10,8,12,54,47,7,38
Glentoran,2881,8,10,6,14,31,45,-14,36
Ards,2881,9,9,3,18,36,51,-15,30
Ballinamalla,2881,10,8,4,18,32,62,-30,28
Portadown,2881,11,6,5,19,27,52,-25,23
Crusaders,2882,1,16,8,6,54,32,22,56
Ballymena,2882,2,15,8,7,62,51,11,53
Linfield,2882,3,14,7,9,62,36,26,49
Coleraine,2882,4,13,10,7,43,36,7,49
Glenavon,2882,5,11,10,9,46,49,-3,43
Cliftonville,2882,6,12,5,13,47,46,1,41
Portadown,2882,7,12,4,14,31,41,-10,40
Dungannon,2882,8,9,9,12,45,46,-1,36
Ballinamalla,2882,9,10,3,17,28,47,-19,33
Ards,2882,10,9,3,18,37,51,-14,30
Glentoran,2882,11,6,9,15,31,51,-20,27
Linfield,2883,1,15,9,6,55,31,24,54
Cliftonville,2883,2,15,8,7,52,36,16,53
Crusaders,2883,3,14,7,9,55,34,21,49
Glenavon,2883,4,12,11,7,53,46,7,47
Coleraine,2883,5,10,11,9,39,41,-2,41
Ballymena,2883,6,10,10,10,54,62,-8,40
Glentoran,2883,7,9,12,9,32,39,-7,39
Dungannon,2883,8,10,7,13,41,47,-6,37
Ards,2883,9,9,7,14,38,47,-9,34
Portadown,2883,10,7,7,16,28,45,-17,28
Ballinamalla,2883,11,8,3,19,31,50,-19,27
Crusaders,2884,1,16,7,7,59,40,19,55
Ballymena,2884,2,15,5,10,64,60,4,50
Linfield,2884,3,13,10,7,55,35,20,49
Cliftonville,2884,4,15,3,12,53,46,7,48
Glenavon,2884,5,12,11,7,55,44,11,47
Dungannon,2884,6,11,11,8,57,43,14,44
Coleraine,2884,7,11,10,9,43,40,3,43
Glentoran,2884,8,11,6,13,34,42,-8,39
Ards,2884,9,8,6,16,32,47,-15,30
Portadown,2884,10,6,10,14,27,47,-20,28
Ballinamalla,2884,11,5,5,20,25,60,-35,20
Cliftonville,2885,1,18,4,8,63,35,28,58
Crusaders,2885,2,15,11,4,57,36,21,56
Ballymena,2885,3,14,8,8,57,54,3,50
Linfield,2885,4,12,11,7,49,27,22,47
Coleraine,2885,5,12,9,9,41,40,1,45
Dungannon,2885,6,11,7,12,49,47,2,40
Glenavon,2885,7,8,14,8,50,52,-2,38
Ards,2885,8,9,6,15,33,46,-13,33
Ballinamalla,2885,9,9,6,15,33,47,-14,33
Glentoran,2885,10,6,9,15,29,46,-17,27
Portadown,2885,11,6,5,19,26,57,-31,23
Linfield,2886,1,16,9,5,59,28,31,57
Crusaders,2886,2,16,7,7,58,42,16,55
Coleraine,2886,3,12,12,6,53,36,17,48
Ballymena,2886,4,12,11,7,48,53,-5,47
Glenavon,2886,5,12,8,10,43,39,4,44
Cliftonville,2886,6,12,7,11,51,45,6,43
Dungannon,2886,7,9,11,10,51,45,6,38
Glentoran,2886,8,8,10,12,30,47,-17,34
Ballinamalla,2886,9,9,5,16,28,50,-22,32
Portadown,2886,10,7,6,17,23,42,-19,27
Ards,2886,11,7,4,19,40,57,-17,25
Linfield,2887,1,16,8,6,56,29,27,56
Cliftonville,2887,2,16,5,9,61,40,21,53
Glenavon,2887,3,13,10,7,49,41,8,49
Crusaders,2887,4,13,9,8,51,36,15,48
Glentoran,2887,5,12,8,10,37,40,-3,44
Coleraine,2887,6,11,10,9,45,41,4,43
Ballymena,2887,7,12,7,11,59,62,-3,43
Dungannon,2887,8,11,7,12,49,44,5,40
Ards,2887,9,8,4,18,34,53,-19,28
Portadown,2887,10,8,4,18,17,46,-29,28
Ballinamalla,2887,11,8,2,20,31,57,-26,26
Glenavon,2888,1,15,12,3,53,36,17,57
Linfield,2888,2,15,11,4,59,27,32,56
Ballymena,2888,3,16,5,9,62,56,6,53
Crusaders,2888,4,14,10,6,59,37,22,52
Cliftonville,2888,5,14,6,10,46,38,8,48
Coleraine,2888,6,10,13,7,38,37,1,43
Dungannon,2888,7,9,7,14,45,47,-2,34
Ballinamalla,2888,8,9,4,17,30,49,-19,31
Glentoran,2888,9,7,8,15,29,48,-19,29
Ards,2888,10,7,6,17,34,49,-15,27
Portadown,2888,11,4,8,18,25,56,-31,20
Cliftonville,2889,1,17,4,9,51,34,17,55
Glenavon,2889,2,14,10,6,55,45,10,52
Linfield,2889,3,12,12,6,49,25,24,48
Ballymena,2889,4,14,6,10,54,60,-6,48
Crusaders,2889,5,13,8,9,48,41,7,47
Dungannon,2889,6,11,12,7,51,33,18,45
Coleraine,2889,7,11,11,8,42,37,5,44
Glentoran,2889,8,12,7,11,34,37,-3,43
Ards,2889,9,8,5,17,32,45,-13,29
Ballinamalla,2889,10,7,7,16,29,52,-23,28
Portadown,2889,11,3,4,23,17,53,-36,13
Cliftonville,2890,1,17,6,7,56,33,23,57
Linfield,2890,2,13,11,6,58,32,26,50
Ballymena,2890,3,14,7,9,58,55,3,49
Crusaders,2890,4,12,12,6,46,33,13,48
Glenavon,2890,5,12,12,6,45,36,9,48
Glentoran,2890,6,12,8,10,40,46,-6,44
Coleraine,2890,7,10,11,9,42,41,1,41
Ards,2890,8,11,4,15,39,52,-13,37
Dungannon,2890,9,8,9,13,47,48,-1,33
Portadown,2890,10,7,3,20,25,53,-28,24
Ballinamalla,2890,11,6,3,21,26,53,-27,21
Linfield,2891,1,14,7,9,51,30,21,49
Crusaders,2891,2,13,8,9,60,43,17,47
Dungannon,2891,3,12,8,10,55,45,10,44
Coleraine,2891,4,11,11,8,40,38,2,44
Cliftonville,2891,5,14,2,14,50,49,1,44
Glenavon,2891,6,10,13,7,55,54,1,43
Ballymena,2891,7,12,5,13,51,63,-12,41
Ballinamalla,2891,8,12,3,15,38,49,-11,39
Portadown,2891,9,11,5,14,34,43,-9,38
Glentoran,2891,10,10,6,14,34,43,-9,36
Ards,2891,11,10,4,16,38,49,-11,34
Linfield,2892,1,16,8,6,60,28,32,56
Ballymena,2892,2,16,4,10,65,58,7,52
Coleraine,2892,3,13,11,6,45,32,13,50
Cliftonville,2892,4,13,8,9,51,42,9,47
Glenavon,2892,5,12,10,8,50,43,7,46
Crusaders,2892,6,13,6,11,49,38,11,45
Dungannon,2892,7,10,8,12,46,47,-1,38
Glentoran,2892,8,9,8,13,31,47,-16,35
Ballinamalla,2892,9,10,3,17,28,47,-19,33
Portadown,2892,10,6,9,15,20,41,-21,27
Ards,2892,11,6,7,17,39,61,-22,25
Coleraine,2893,1,15,10,5,54,30,24,55
Linfield,2893,2,15,7,8,64,41,23,52
Cliftonville,2893,3,15,5,10,55,39,16,50
Crusaders,2893,4,14,7,9,47,37,10,49
Ballymena,2893,5,14,5,11,54,61,-7,47
Glenavon,2893,6,11,11,8,52,49,3,44
Dungannon,2893,7,9,8,13,51,49,2,35
Ards,2893,8,10,4,16,40,54,-14,34
Portadown,2893,9,9,5,16,31,48,-17,32
Glentoran,2893,10,8,7,15,28,45,-17,31
Ballinamalla,2893,11,8,5,17,29,52,-23,29
Crusaders,2894,1,18,5,7,51,31,20,59
Cliftonville,2894,2,17,4,9,67,43,24,55
Linfield,2894,3,14,9,7,57,35,22,51
Ballymena,2894,4,13,8,9,57,60,-3,47
Glenavon,2894,5,12,9,9,49,41,8,45
Glentoran,2894,6,13,6,11,36,40,-4,45
Dungannon,2894,7,9,10,11,45,40,5,37
Coleraine,2894,8,8,13,9,37,38,-1,37
Ballinamalla,2894,9,9,5,16,27,46,-19,32
Ards,2894,10,8,5,17,32,49,-17,29
Portadown,2894,11,3,8,19,19,54,-35,17
Crusaders,2895,1,17,6,7,54,36,18,57
Linfield,2895,2,14,12,4,53,26,27,54
Glenavon,2895,3,15,9,6,51,38,13,54
Cliftonville,2895,4,15,4,11,53,39,14,49
Dungannon,2895,5,10,10,10,52,48,4,40
Coleraine,2895,6,9,10,11,37,43,-6,37
Ballymena,2895,7,10,6,14,53,60,-7,36
Ards,2895,8,10,5,15,41,48,-7,35
Glentoran,2895,9,9,6,15,30,44,-14,33
Ballinamalla,2895,10,8,7,15,33,52,-19,31
Portadown,2895,11,9,3,18,31,54,-23,30
Crusaders,2896,1,16,9,5,54,30,24,57
Cliftonville,2896,2,17,5,8,57,40,17,56
Linfield,2896,3,13,10,7,52,28,24,49
Glenavon,2896,4,13,10,7,56,52,4,49
Coleraine,2896,5,11,12,7,43,36,7,45
Ballymena,2896,6,13,6,11,51,55,-4,45
Glentoran,2896,7,10,7,13,32,43,-11,37
Portadown,2896,8,9,3,18,29,48,-19,30
Ballinamalla,2896,9,9,3,18,34,54,-20,30
Ards,2896,10,8,5,17,34,51,-17,29
Dungannon,2896,11,6,10,14,42,47,-5,28
Crusaders,2897,1,17,8,5,53,31,22,59
Ballymena,2897,2,17,6,7,68,51,17,57
Linfield,2897,3,14,10,6,60,33,27,52
Cliftonville,2897,4,14,4,12,48,37,11,46
Glenavon,2897,5,10,11,9,50,49,1,41
Coleraine,2897,6,10,11,9,41,44,-3,41
Glentoran,2897,7,11,8,11,31,40,-9,41
Dungannon,2897,8,8,9,13,44,48,-4,33
Portadown,2897,9,8,7,15,21,45,-24,31
Ards,2897,10,8,5,17,37,51,-14,29
Ballinamalla,2897,11,7,3,20,30,54,-24,24
Crusaders,2898,1,19,6,5,56,30,26,63
Ballymena,2898,2,18,4,8,69,54,15,58
Cliftonville,2898,3,15,6,9,45,35,10,51
Coleraine,2898,4,12,10,8,41,39,2,46
Dungannon,2898,5,12,8,10,47,41,6,44
Linfield,2898,6,11,10,9,55,37,18,43
Glenavon,2898,7,8,12,10,41,46,-5,36
Ards,2898,8,10,6,14,39,45,-6,36
Glentoran,2898,9,8,8,14,35,44,-9,32
Ballinamalla,2898,10,6,6,18,30,55,-25,24
Portadown,2898,11,6,4,20,18,50,-32,22
Linfield,2899,1,16,8,6,62,25,37,56
Cliftonville,2899,2,16,5,9,52,38,14,53
Crusaders,2899,3,15,6,9,49,34,15,51
Ballymena,2899,4,14,7,9,62,60,2,49
Coleraine,2899,5,12,10,8,46,39,7,46
Dungannon,2899,6,10,10,10,49,46,3,40
Glenavon,2899,7,10,9,11,48,52,-4,39
Ards,2899,8,11,5,14,39,47,-8,38
Glentoran,2899,9,10,7,13,37,50,-13,37
Ballinamalla,2899,10,8,4,18,31,53,-22,28
Portadown,2899,11,5,5,20,20,51,-31,20
Linfield,2900,1,17,8,5,54,22,32,59
Crusaders,2900,2,16,7,7,49,35,14,55
Cliftonville,2900,3,15,6,9,49,34,15,51
Ballymena,2900,4,14,5,11,56,54,2,47
Coleraine,2900,5,12,10,8,41,37,4,46
Glenavon,2900,6,10,11,9,43,42,1,41
Glentoran,2900,7,9,8,13,32,44,-12,35
Portadown,2900,8,9,6,15,25,42,-17,33
Dungannon,2900,9,7,10,13,44,45,-1,31
Ards,2900,10,8,5,17,35,49,-14,29
Ballinamalla,2900,11,8,4,18,25,49,-24,28
Crusaders,2901,1,17,6,7,52,34,18,57
Glenavon,2901,2,15,9,6,56,45,11,54
Cliftonville,2901,3,16,5,9,53,38,15,53
Linfield,2901,4,14,8,8,55,29,26,50
Ballymena,2901,5,14,7,9,55,52,3,49
Coleraine,2901,6,12,8,10,49,40,9,44
Dungannon,2901,7,10,10,10,53,44,9,40
Glentoran,2901,8,9,5,16,24,48,-24,32
Ards,2901,9,9,4,17,31,46,-15,31
Portadown,2901,10,8,4,18,28,50,-22,28
Ballinamalla,2901,11,7,2,21,31,61,-30,23
Crusaders,2902,1,18,7,5,67,35,32,61
Linfield,2902,2,16,10,4,63,31,32,58
Cliftonville,2902,3,17,5,8,59,41,18,56
Coleraine,2902,4,12,11,7,45,35,10,47
Ballymena,2902,5,13,7,10,60,58,2,46
Dungannon,2902,6,11,9,10,48,44,4,42
Glenavon,2902,7,9,12,9,43,49,-6,39
Ards,2902,8,10,6,14,41,47,-6,36
Portadown,2902,9,7,3,20,20,49,-29,24
Ballinamalla,2902,10,5,7,18,27,57,-30,22
Glentoran,2902,11,4,9,17,27,54,-27,21
Linfield,2903,1,15,8,7,61,30,31,53
Crusaders,2903,2,14,9,7,55,41,14,51
Ballymena,2903,3,13,10,7,59,56,3,49
Glenavon,2903,4,11,12,7,50,42,8,45
Cliftonville,2903,5,12,7,11,55,48,7,43
Coleraine,2903,6,10,11,9,37,38,-1,41
Glentoran,2903,7,10,8,12,29,41,-12,38
Dungannon,2903,8,7,11,12,48,49,-1,32
Portadown,2903,9,8,8,14,29,44,-15,32
Ballinamalla,2903,10,8,7,15,31,49,-18,31
Ards,2903,11,7,9,14,30,46,-16,30
Crusaders,2904,1,17,7,6,62,32,30,58
Cliftonville,2904,2,16,6,8,54,35,19,54
Linfield,2904,3,14,8,8,58,38,20,50
Dungannon,2904,4,13,8,9,51,37,14,47
Glenavon,2904,5,11,11,8,51,42,9,44
Ballymena,2904,6,12,6,12,51,64,-13,42
Glentoran,2904,7,11,7,12,41,46,-5,40
Coleraine,2904,8,8,10,12,34,46,-12,34
Ards,2904,9,8,7,15,33,44,-11,31
Ballinamalla,2904,10,8,6,16,26,51,-25,30
Portadown,2904,11,6,6,18,22,48,-26,24
Linfield,2905,1,15,8,7,61,33,28,53
Coleraine,2905,2,14,11,5,46,30,16,53
Crusaders,2905,3,15,7,8,55,38,17,52
Cliftonville,2905,4,15,6,9,53,38,15,51
Ballymena,2905,5,12,10,8,61,59,2,46
Dungannon,2905,6,10,10,10,47,45,2,40
Glenavon,2905,7,9,10,11,46,49,-3,37
Portadown,2905,8,11,4,15,35,49,-14,37
Glentoran,2905,9,9,6,15,31,50,-19,33
Ards,2905,10,9,3,18,34,50,-16,30
Ballinamalla,2905,11,7,3,20,33,61,-28,24
Crusaders,2906,1,17,7,6,59,34,25,58
Linfield,2906,2,14,9,7,60,31,29,51
Ballymena,2906,3,15,6,9,57,56,1,51
Glenavon,2906,4,14,8,8,56,45,11,50
Dungannon,2906,5,12,9,9,49,38,11,45
Coleraine,2906,6,12,9,9,41,38,3,45
Cliftonville,2906,7,11,5,14,37,38,-1,38
Ards,2906,8,11,3,16,38,52,-14,36
Glentoran,2906,9,10,5,15,32,47,-15,35
Ballinamalla,2906,10,8,6,16,34,51,-17,30
Portadown,2906,11,5,5,20,24,57,-33,20
Linfield,2907,1,14,11,5,52,26,26,53
Crusaders,2907,2,15,8,7,50,35,15,53
Coleraine,2907,3,14,10,6,43,33,10,52
Cliftonville,2907,4,14,6,10,50,38,12,48
Ballymena,2907,5,12,8,10,52,53,-1,44
Glenavon,2907,6,11,10,9,46,42,4,43
Glentoran,2907,7,10,9,11,31,39,-8,39
Dungannon,2907,8,9,9,12,49,44,5,36
Ards,2907,9,9,4,17,37,48,-11,31
Ballinamalla,2907,10,8,4,18,26,48,-22,28
Portadown,2907,11,8,3,19,24,54,-30,27
Crusaders,2908,1,16,7,7,57,37,20,55
Glenavon,2908,2,14,10,6,52,40,12,52
Ballymena,2908,3,15,7,8,61,55,6,52
Linfield,2908,4,14,9,7,54,33,21,51
Cliftonville,2908,5,14,5,11,55,46,9,47
Dungannon,2908,6,10,11,9,55,45,10,41
Ballinamalla,2908,7,10,6,14,41,48,-7,36
Coleraine,2908,8,8,10,12,41,50,-9,34
Ards,2908,9,9,6,15,41,51,-10,33
Glentoran,2908,10,6,9,15,29,51,-22,27
Portadown,2908,11,6,6,18,28,58,-30,24
Crusaders,2909,1,16,8,6,60,37,23,56
Cliftonville,2909,2,16,6,8,56,36,20,54
Linfield,2909,3,13,9,8,58,35,23,48
Ballymena,2909,4,14,6,10,55,56,-1,48
Coleraine,2909,5,11,11,8,44,42,2,44
Glentoran,2909,6,11,8,11,30,37,-7,41
Glenavon,2909,7,9,12,9,45,48,-3,39
Dungannon,2909,8,8,12,10,43,39,4,36
Ballinamalla,2909,9,9,3,18,34,55,-21,30
Portadown,2909,10,7,7,16,28,50,-22,28
Ards,2909,11,7,6,17,36,54,-18,27
Linfield,2910,1,17,9,4,58,26,32,60
Crusaders,2910,2,15,9,6,51,34,17,54
Cliftonville,2910,3,14,6,10,52,43,9,48
Dungannon,2910,4,12,11,7,53,38,15,47
Ballymena,2910,5,13,8,9,65,58,7,47
Coleraine,2910,6,9,15,6,41,34,7,42
Glenavon,2910,7,11,9,10,44,49,-5,42
Glentoran,2910,8,10,5,15,34,49,-15,35
Ards,2910,9,8,6,16,38,53,-15,30
Ballinamalla,2910,10,7,3,20,31,55,-24,24
Portadown,2910,11,5,7,18,19,47,-28,22
Linfield,2911,1,15,9,6,64,34,30,54
Dungannon,2911,2,15,7,8,54,39,15,52
Glenavon,2911,3,14,10,6,52,41,11,52
Cliftonville,2911,4,15,6,9,54,38,16,51
Crusaders,2911,5,14,8,8,52,35,17,50
Ballymena,2911,6,13,7,10,56,54,2,46
Coleraine,2911,7,11,7,12,37,45,-8,40
Glentoran,2911,8,9,8,13,29,39,-10,35
Ards,2911,9,8,6,16,35,51,-16,30
Ballinamalla,2911,10,7,7,16,28,46,-18,28
Portadown,2911,11,5,3,22,19,58,-39,18
Crusaders,2912,1,16,10,4,59,31,28,58
Cliftonville,2912,2,17,5,8,59,34,25,56
Coleraine,2912,3,15,11,4,54,35,19,56
Linfield,2912,4,13,8,9,56,35,21,47
Ballymena,2912,5,14,5,11,52,58,-6,47
Glenavon,2912,6,10,10,10,44,48,-4,40
Dungannon,2912,7,9,10,11,47,48,-1,37
Glentoran,2912,8,8,9,13,29,41,-12,33
Portadown,2912,9,9,4,17,24,45,-21,31
Ards,2912,10,8,4,18,40,56,-16,28
Ballinamalla,2912,11,5,6,19,21,54,-33,21
Crusaders,2913,1,20,7,3,72,31,41,67
Ballymena,2913,2,14,7,9,54,58,-4,49
Cliftonville,2913,3,14,6,10,52,44,8,48
Linfield,2913,4,13,8,9,57,39,18,47
Glenavon,2913,5,11,11,8,46,44,2,44
Glentoran,2913,6,10,11,9,39,44,-5,41
Dungannon,2913,7,10,8,12,55,49,6,38
Coleraine,2913,8,9,10,11,40,48,-8,37
Ards,2913,9,9,6,15,39,48,-9,33
Portadown,2913,10,8,4,18,28,46,-18,28
Ballinamalla,2913,11,6,4,20,25,56,-31,22
Crusaders,2914,1,18,6,6,61,37,24,60
Linfield,2914,2,17,7,6,65,28,37,58
Cliftonville,2914,3,15,6,9,53,40,13,51
Coleraine,2914,4,14,8,8,54,41,13,50
Ballymena,2914,5,14,6,10,58,59,-1,48
Glenavon,2914,6,11,10,9,45,46,-1,43
Dungannon,2914,7,11,7,12,51,45,6,40
Ballinamalla,2914,8,10,5,15,31,45,-14,35
Glentoran,2914,9,6,10,14,24,44,-20,28
Portadown,2914,10,6,5,19,24,54,-30,23
Ards,2914,11,6,4,20,36,63,-27,22
Ballymena,2915,1,15,7,8,61,57,4,52
Linfield,2915,2,13,11,6,57,28,29,50
Cliftonville,2915,3,13,7,10,52,39,13,46
Crusaders,2915,4,13,6,11,50,40,10,45
Glenavon,2915,5,11,10,9,45,46,-1,43
Ards,2915,6,12,6,12,38,41,-3,42
Coleraine,2915,7,10,9,11,37,44,-7,39
Glentoran,2915,8,11,6,13,37,46,-9,39
Dungannon,2915,9,10,8,12,50,50,0,38
Portadown,2915,10,9,6,15,31,46,-15,33
Ballinamalla,2915,11,8,4,18,25,46,-21,28
Linfield,2916,1,14,11,5,64,34,30,53
Crusaders,2916,2,15,8,7,52,40,12,53
Glenavon,2916,3,11,14,5,59,41,18,47
Cliftonville,2916,4,14,4,12,49,44,5,46
Coleraine,2916,5,11,11,8,42,38,4,44
Ballymena,2916,6,12,6,12,60,63,-3,42
Dungannon,2916,7,9,11,10,48,47,1,38
Ards,2916,8,8,8,14,39,50,-11,32
Ballinamalla,2916,9,8,8,14,36,51,-15,32
Glentoran,2916,10,8,8,14,32,47,-15,32
Portadown,2916,11,7,7,16,26,52,-26,28
Linfield,2917,1,16,9,5,63,31,32,57
Crusaders,2917,2,15,10,5,52,32,20,55
Coleraine,2917,3,11,13,6,44,36,8,46
Cliftonville,2917,4,13,7,10,51,47,4,46
Dungannon,2917,5,12,9,9,49,39,10,45
Glenavon,2917,6,11,12,7,52,50,2,45
Glentoran,2917,7,11,7,12,40,43,-3,40
Ballymena,2917,8,10,8,12,55,64,-9,38
Portadown,2917,9,8,4,18,30,47,-17,28
Ards,2917,10,8,4,18,41,60,-19,28
Ballinamalla,2917,11,7,3,20,26,54,-28,24
Crusaders,2918,1,19,4,7,60,37,23,61
Linfield,2918,2,16,7,7,60,37,23,55
Cliftonville,2918,3,15,6,9,52,39,13,51
Glenavon,2918,4,13,11,6,53,42,11,50
Ballymena,2918,5,12,9,9,57,56,1,45
Dungannon,2918,6,11,10,9,53,42,11,43
Coleraine,2918,7,11,8,11,41,43,-2,41
Ards,2918,8,12,4,14,42,45,-3,40
Glentoran,2918,9,8,6,16,24,44,-20,30
Ballinamalla,2918,10,6,5,19,23,49,-26,23
Portadown,2918,11,5,4,21,18,49,-31,19
Crusaders,2919,1,18,7,5,59,33,26,61
Linfield,2919,2,15,10,5,59,31,28,55
Cliftonville,2919,3,16,6,8,60,39,21,54
Ballymena,2919,4,14,6,10,57,55,2,48
Glenavon,2919,5,11,10,9,45,45,0,43
Coleraine,2919,6,10,12,8,38,35,3,42
Dungannon,2919,7,10,8,12,52,47,5,38
Glentoran,2919,8,8,9,13,28,44,-16,33
Ards,2919,9,9,4,17,38,55,-17,31
Portadown,2919,10,7,6,17,26,51,-25,27
Ballinamalla,2919,11,5,6,19,22,49,-27,21
Crusaders,2920,1,17,5,8,63,41,22,56
Linfield,2920,2,14,11,5,54,26,28,53
Ballymena,2920,3,15,6,9,66,62,4,51
Cliftonville,2920,4,15,4,11,52,41,11,49
Coleraine,2920,5,12,10,8,37,33,4,46
Glenavon,2920,6,12,8,10,47,45,2,44
Ards,2920,7,12,5,13,43,45,-2,41
Dungannon,2920,8,9,8,13,52,45,7,35
Glentoran,2920,9,9,7,14,34,48,-14,34
Portadown,2920,10,8,5,17,24,47,-23,29
Ballinamalla,2920,11,5,5,20,21,60,-39,20
Linfield,2921,1,17,9,4,55,24,31,60
Ballymena,2921,2,16,6,8,62,57,5,54
Cliftonville,2921,3,17,2,11,54,42,12,53
Coleraine,2921,4,14,9,7,45,33,12,51
Crusaders,2921,5,13,10,7,49,32,17,49
Glenavon,2921,6,9,12,9,42,44,-2,39
Dungannon,2921,7,7,12,11,47,45,2,33
Ards,2921,8,8,6,16,36,50,-14,30
Portadown,2921,9,8,5,17,22,43,-21,29
Ballinamalla,2921,10,8,5,17,25,48,-23,29
Glentoran,2921,11,5,10,15,25,44,-19,25
Linfield,2922,1,16,8,6,61,33,28,56
Crusaders,2922,2,14,8,8,54,35,19,50
Glenavon,2922,3,14,8,8,52,42,10,50
Ballymena,2922,4,15,4,11,60,56,4,49
Coleraine,2922,5,12,10,8,46,45,1,46
Cliftonville,2922,6,12,7,11,54,49,5,43
Ards,2922,7,12,3,15,40,50,-10,39
Dungannon,2922,8,9,11,10,53,38,15,38
Ballinamalla,2922,9,9,3,18,30,54,-24,30
Portadown,2922,10,8,5,17,29,50,-21,29
Glentoran,2922,11,7,7,16,30,57,-27,28
Crusaders,2923,1,17,8,5,56,27,29,59
Linfield,2923,2,15,8,7,63,32,31,53
Ballymena,2923,3,15,3,12,65,66,-1,48
Cliftonville,2923,4,14,4,12,43,40,3,46
Glenavon,2923,5,10,15,5,46,42,4,45
Dungannon,2923,6,9,12,9,48,38,10,39
Coleraine,2923,7,9,11,10,41,46,-5,38
Ards,2923,8,10,7,13,39,48,-9,37
Glentoran,2923,9,9,9,12,34,43,-9,36
Ballinamalla,2923,10,9,4,17,28,54,-26,31
Portadown,2923,11,4,7,19,20,47,-27,19
Crusaders,2924,1,17,7,6,59,37,22,58
Linfield,2924,2,15,10,5,60,32,28,55
Cliftonville,2924,3,15,6,9,53,41,12,51
Ballymena,2924,4,12,9,9,52,52,0,45
Glenavon,2924,5,10,13,7,47,47,0,43
Coleraine,2924,6,8,13,9,39,40,-1,37
Portadown,2924,7,10,5,15,34,44,-10,35
Glentoran,2924,8,10,5,15,31,48,-17,35
Dungannon,2924,9,8,10,12,53,46,7,34
Ards,2924,10,9,4,17,35,53,-18,31
Ballinamalla,2924,11,8,4,18,35,58,-23,28
Crusaders,2925,1,17,9,4,54,31,23,60
Linfield,2925,2,14,9,7,67,42,25,51
Cliftonville,2925,3,15,4,11,51,38,13,49
Coleraine,2925,4,12,11,7,39,33,6,47
Ballymena,2925,5,14,4,12,56,64,-8,46
Dungannon,2925,6,10,10,10,49,40,9,40
Ards,2925,7,12,2,16,40,47,-7,38
Ballinamalla,2925,8,10,5,15,30,47,-17,35
Glenavon,2925,9,6,15,9,44,50,-6,33
Glentoran,2925,10,7,10,13,33,50,-17,31
Portadown,2925,11,6,5,19,27,48,-21,23
Crusaders,2926,1,16,7,7,56,32,24,55
Linfield,2926,2,13,9,8,54,35,19,48
Cliftonville,2926,3,13,9,8,46,33,13,48
Glenavon,2926,4,13,9,8,47,40,7,48
Ballymena,2926,5,12,6,12,53,58,-5,42
Coleraine,2926,6,10,10,10,41,43,-2,40
Dungannon,2926,7,8,13,9,53,44,9,37
Ards,2926,8,10,6,14,43,45,-2,36
Ballinamalla,2926,9,10,4,16,35,56,-21,34
Portadown,2926,10,8,8,14,24,44,-20,32
Glentoran,2926,11,9,5,16,24,46,-22,32
Crusaders,2927,1,18,9,3,53,27,26,63
Ballymena,2927,2,16,5,9,61,56,5,53
Linfield,2927,3,12,16,2,62,29,33,52
Cliftonville,2927,4,14,8,8,55,43,12,50
Coleraine,2927,5,10,13,7,45,36,9,43
Dungannon,2927,6,10,8,12,52,47,5,38
Portadown,2927,7,9,7,14,27,44,-17,34
Glenavon,2927,8,7,12,11,38,47,-9,33
Glentoran,2927,9,7,7,16,27,49,-22,28
Ards,2927,10,7,6,17,32,47,-15,27
Ballinamalla,2927,11,7,5,18,26,53,-27,26
Crusaders,2928,1,16,6,8,54,37,17,54
Linfield,2928,2,14,11,5,57,31,26,53
Dungannon,2928,3,13,10,7,55,33,22,49
Cliftonville,2928,4,15,4,11,57,38,19,49
Ballymena,2928,5,13,6,11,55,62,-7,45
Coleraine,2928,6,11,8,11,45,47,-2,41
Glenavon,2928,7,9,11,10,48,56,-8,38
Glentoran,2928,8,10,7,13,32,46,-14,37
Ards,2928,9,10,4,16,40,49,-9,34
Portadown,2928,10,8,6,16,24,46,-22,30
Ballinamalla,2928,11,8,3,19,28,50,-22,27
Linfield,2929,1,17,9,4,67,29,38,60
Crusaders,2929,2,17,7,6,60,41,19,58
Ballymena,2929,3,16,6,8,67,54,13,54
Glenavon,2929,4,12,11,7,49,48,1,47
Coleraine,2929,5,12,9,9,41,37,4,45
Cliftonville,2929,6,12,6,12,47,43,4,42
Dungannon,2929,7,9,9,12,47,51,-4,36
Portadown,2929,8,10,5,15,30,44,-14,35
Ballinamalla,2929,9,9,4,17,34,51,-17,31
Ards,2929,10,8,4,18,38,55,-17,28
Glentoran,2929,11,6,4,20,24,51,-27,22
Crusaders,2930,1,18,7,5,63,34,29,61
Cliftonville,2930,2,14,5,11,52,41,11,47
Ballymena,2930,3,14,5,11,59,59,0,47
Linfield,2930,4,11,12,7,51,37,14,45
Coleraine,2930,5,10,13,7,42,36,6,43
Glentoran,2930,6,12,6,12,37,45,-8,42
Dungannon,2930,7,9,9,12,47,42,5,36
Glenavon,2930,8,8,12,10,37,43,-6,36
Portadown,2930,9,9,7,14,27,41,-14,34
Ballinamalla,2930,10,10,3,17,29,51,-22,33
Ards,2930,11,8,5,17,35,50,-15,29
Crusaders,2931,1,17,9,4,58,32,26,60
Ballymena,2931,2,16,6,8,61,52,9,54
Cliftonville,2931,3,15,6,9,55,41,14,51
Glenavon,2931,4,13,9,8,51,49,2,48
Linfield,2931,5,11,9,10,56,40,16,42
Coleraine,2931,6,11,9,10,40,44,-4,42
Portadown,2931,7,11,4,15,30,41,-11,37
Dungannon,2931,8,9,8,13,46,43,3,35
Ards,2931,9,10,4,16,40,54,-14,34
Glentoran,2931,10,8,7,15,34,46,-12,31
Ballinamalla,2931,11,7,3,20,26,55,-29,24
Crusaders,2932,1,20,6,4,62,32,30,66
Linfield,2932,2,15,8,7,55,32,23,53
Cliftonville,2932,3,15,7,8,55,37,18,52
Coleraine,2932,4,13,10,7,48,42,6,49
Ballymena,2932,5,13,4,13,52,58,-6,43
Glenavon,2932,6,10,9,11,45,48,-3,39
Dungannon,2932,7,8,13,9,46,43,3,37
Ballinamalla,2932,8,11,2,17,36,53,-17,35
Glentoran,2932,9,9,7,14,30,41,-11,34
Ards,2932,10,7,5,18,42,56,-14,26
Portadown,2932,11,6,5,19,26,55,-29,23
Linfield,2933,1,19,8,3,63,30,33,65
Cliftonville,2933,2,18,4,8,54,40,14,58
Crusaders,2933,3,15,11,4,55,29,26,56
Ballymena,2933,4,13,6,11,59,60,-1,45
Coleraine,2933,5,11,8,11,47,39,8,41
Dungannon,2933,6,10,11,9,46,39,7,41
Glenavon,2933,7,10,10,10,44,47,-3,40
Glentoran,2933,8,10,5,15,36,49,-13,35
Ards,2933,9,9,4,17,38,55,-17,31
Ballinamalla,2933,10,7,4,19,27,51,-24,25
Portadown,2933,11,4,7,19,19,49,-30,19
Cliftonville,2934,1,19,4,7,59,32,27,61
Linfield,2934,2,16,9,5,66,30,36,57
Crusaders,2934,3,16,9,5,54,36,18,57
Ballymena,2934,4,13,7,10,57,56,1,46
Glenavon,2934,5,11,11,8,45,43,2,44
Coleraine,2934,6,10,11,9,40,37,3,41
Dungannon,2934,7,9,10,11,43,44,-1,37
Glentoran,2934,8,10,7,13,37,44,-7,37
Portadown,2934,9,7,5,18,22,44,-22,26
Ballinamalla,2934,10,7,5,18,26,53,-27,26
Ards,2934,11,4,8,18,29,59,-30,20
Crusaders,2935,1,19,5,6,61,35,26,62
Cliftonville,2935,2,16,5,9,50,35,15,53
Linfield,2935,3,11,13,6,56,36,20,46
Coleraine,2935,4,12,10,8,46,41,5,46
Ballymena,2935,5,12,7,11,54,61,-7,43
Glenavon,2935,6,9,13,8,42,42,0,40
Ards,2935,7,11,6,13,43,48,-5,39
Dungannon,2935,8,9,8,13,48,49,-1,35
Portadown,2935,9,10,4,16,27,41,-14,34
Glentoran,2935,10,9,7,14,30,46,-16,34
Ballinamalla,2935,11,7,2,21,36,59,-23,23
Crusaders,2936,1,17,8,5,55,33,22,59
Cliftonville,2936,2,16,5,9,58,45,13,53
Ballymena,2936,3,15,6,9,58,53,5,51
Linfield,2936,4,13,10,7,51,29,22,49
Coleraine,2936,5,9,11,10,37,40,-3,38
Dungannon,2936,6,8,12,10,44,41,3,36
Ards,2936,7,10,5,15,34,40,-6,35
Portadown,2936,8,10,5,15,34,49,-15,35
Glenavon,2936,9,8,10,12,42,51,-9,34
Glentoran,2936,10,9,6,15,29,41,-12,33
Ballinamalla,2936,11,8,6,16,31,51,-20,30
Ballymena,2937,1,17,6,7,63,51,12,57
Crusaders,2937,2,15,9,6,52,31,21,54
Coleraine,2937,3,14,8,8,44,34,10,50
Linfield,2937,4,12,10,8,55,35,20,46
Cliftonville,2937,5,13,7,10,50,42,8,46
Dungannon,2937,6,9,12,9,42,38,4,39
Glenavon,2937,7,9,10,11,37,43,-6,37
Glentoran,2937,8,8,9,13,27,42,-15,33
Ballinamalla,2937,9,7,9,14,28,44,-16,30
Ards,2937,10,8,5,17,31,47,-16,29
Portadown,2937,11,7,7,16,24,46,-22,28
Crusaders,2938,1,16,8,6,58,35,23,56
Cliftonville,2938,2,16,4,10,56,45,11,52
Linfield,2938,3,13,10,7,58,36,22,49
Glenavon,2938,4,12,11,7,50,41,9,47
Ballymena,2938,5,14,4,12,53,59,-6,46
Coleraine,2938,6,10,12,8,45,45,0,42
Portadown,2938,7,10,6,14,31,42,-11,36
Dungannon,2938,8,9,8,13,44,42,2,35
Glentoran,2938,9,10,5,15,28,44,-16,35
Ards,2938,10,9,4,17,37,47,-10,31
Ballinamalla,2938,11,8,4,18,31,55,-24,28
Crusaders,2939,1,20,6,4,62,30,32,66
Linfield,2939,2,16,8,6,58,27,31,56
Ballymena,2939,3,16,5,9,56,48,8,53
Glenavon,2939,4,12,9,9,46,40,6,45
Cliftonville,2939,5,13,3,14,48,44,4,42
Coleraine,2939,6,11,9,10,41,41,0,42
Dungannon,2939,7,10,8,12,47,47,0,38
Glentoran,2939,8,9,8,13,29,46,-17,35
Ards,2939,9,9,5,16,44,54,-10,32
Ballinamalla,2939,10,8,3,19,28,51,-23,27
Portadown,2939,11,7,4,19,22,53,-31,25
Cliftonville,2940,1,19,4,7,62,36,26,61
Linfield,2940,2,15,8,7,54,36,18,53
Crusaders,2940,3,14,9,7,52,39,13,51
Coleraine,2940,4,11,10,9,40,38,2,43
Ballymena,2940,5,11,10,9,57,58,-1,43
Glenavon,2940,6,9,12,9,46,47,-1,39
Glentoran,2940,7,11,6,13,36,44,-8,39
Ards,2940,8,9,8,13,40,44,-4,35
Dungannon,2940,9,6,11,13,41,46,-5,29
Ballinamalla,2940,10,7,8,15,33,49,-16,29
Portadown,2940,11,7,6,17,23,47,-24,27
Crusaders,2941,1,16,9,5,51,35,16,57
Glenavon,2941,2,13,11,6,52,43,9,50
Cliftonville,2941,3,13,9,8,53,42,11,48
Linfield,2941,4,11,10,9,56,39,17,43
Coleraine,2941,5,11,10,9,42,40,2,43
Dungannon,2941,6,11,9,10,51,43,8,42
Ballymena,2941,7,11,7,12,51,56,-5,40
Ards,2941,8,10,5,15,36,45,-9,35
Glentoran,2941,9,9,6,15,33,48,-15,33
Portadown,2941,10,9,5,16,25,39,-14,32
Ballinamalla,2941,11,7,7,16,30,50,-20,28
Linfield,2942,1,16,9,5,61,25,36,57
Crusaders,2942,2,17,6,7,55,34,21,57
Coleraine,2942,3,15,8,7,47,32,15,53
Ballymena,2942,4,15,6,9,67,53,14,51
Glenavon,2942,5,12,10,8,48,41,7,46
Dungannon,2942,6,10,8,12,49,44,5,38
Cliftonville,2942,7,10,5,15,46,57,-11,35
Glentoran,2942,8,9,6,15,29,55,-26,33
Ballinamalla,2942,9,8,7,15,28,42,-14,31
Portadown,2942,10,9,4,17,23,50,-27,31
Ards,2942,11,5,9,16,33,53,-20,24
Linfield,2943,1,16,9,5,64,34,30,57
Crusaders,2943,2,14,7,9,53,38,15,49
Glenavon,2943,3,12,10,8,47,39,8,46
Ballymena,2943,4,13,7,10,56,54,2,46
Cliftonville,2943,5,12,8,10,53,45,8,44
Dungannon,2943,6,10,8,12,53,48,5,38
Portadown,2943,7,10,7,13,32,41,-9,37
Glentoran,2943,8,10,6,14,30,42,-12,36
Ballinamalla,2943,9,10,5,15,36,52,-16,35
Coleraine,2943,10,7,12,11,34,47,-13,33
Ards,2943,11,8,7,15,36,54,-18,31
Cliftonville,2944,1,19,5,6,60,38,22,62
Linfield,2944,2,14,8,8,57,38,19,50
Crusaders,2944,3,15,5,10,58,43,15,50
Glenavon,2944,4,11,12,7,44,44,0,45
Ballymena,2944,5,13,6,11,52,55,-3,45
Dungannon,2944,6,11,9,10,53,44,9,42
Coleraine,2944,7,8,15,7,38,36,2,39
Glentoran,2944,8,9,6,15,34,47,-13,33
Ballinamalla,2944,9,8,7,15,29,47,-18,31
Ards,2944,10,8,5,17,38,51,-13,29
Portadown,2944,11,6,8,16,24,44,-20,26
Cliftonville,2945,1,16,7,7,58,40,18,55
Crusaders,2945,2,16,7,7,56,38,18,55
Ballymena,2945,3,13,9,8,65,66,-1,48
Linfield,2945,4,12,9,9,52,37,15,45
Coleraine,2945,5,12,9,9,42,40,2,45
Glenavon,2945,6,11,10,9,46,40,6,43
Dungannon,2945,7,11,9,10,56,42,14,42
Ballinamalla,2945,8,10,4,16,33,47,-14,34
Ards,2945,9,9,6,15,40,51,-11,33
Glentoran,2945,10,7,8,15,34,53,-19,29
Portadown,2945,11,5,8,17,24,52,-28,23
Linfield,2946,1,15,9,6,56,29,27,54
Ballymena,2946,2,17,3,10,66,51,15,54
Cliftonville,2946,3,15,6,9,48,37,11,51
Crusaders,2946,4,13,9,8,57,45,12,48
Glenavon,2946,5,12,10,8,49,48,1,46
Dungannon,2946,6,11,10,9,49,40,9,43
Coleraine,2946,7,9,12,9,36,45,-9,39
Ards,2946,8,8,7,15,38,51,-13,31
Glentoran,2946,9,6,11,13,31,40,-9,29
Ballinamalla,2946,10,7,8,15,27,44,-17,29
Portadown,2946,11,7,5,18,24,51,-27,26
Coleraine,2947,1,15,11,4,53,29,24,56
Glenavon,2947,2,15,9,6,50,43,7,54
Linfield,2947,3,13,11,6,59,32,27,50
Cliftonville,2947,4,15,5,10,48,40,8,50
Crusaders,2947,5,14,6,10,51,43,8,48
Ballymena,2947,6,11,8,11,63,69,-6,41
Ards,2947,7,12,2,16,37,52,-15,38
Dungannon,2947,8,9,7,14,48,47,1,34
Glentoran,2947,9,8,8,14,32,45,-13,32
Portadown,2947,10,8,5,17,28,43,-15,29
Ballinamalla,2947,11,8,2,20,34,60,-26,26
Crusaders,2948,1,17,7,6,60,32,28,58
Cliftonville,2948,2,18,2,10,51,32,19,56
Linfield,2948,3,16,7,7,56,27,29,55
Glenavon,2948,4,14,11,5,55,42,13,53
Coleraine,2948,5,12,9,9,39,41,-2,45
Ballymena,2948,6,13,5,12,52,56,-4,44
Dungannon,2948,7,9,8,13,47,41,6,35
Ards,2948,8,11,2,17,37,47,-10,35
Glentoran,2948,9,10,5,15,27,46,-19,35
Ballinamalla,2948,10,8,3,19,24,53,-29,27
Portadown,2948,11,4,7,19,18,49,-31,19
Linfield,2949,1,16,10,4,59,27,32,58
Ballymena,2949,2,17,6,7,55,51,4,57
Cliftonville,2949,3,18,2,10,58,40,18,56
Crusaders,2949,4,14,8,8,53,38,15,50
Glenavon,2949,5,11,14,5,48,40,8,47
Coleraine,2949,6,10,12,8,38,34,4,42
Glentoran,2949,7,10,8,12,33,40,-7,38
Dungannon,2949,8,7,11,12,47,50,-3,32
Ards,2949,9,8,5,17,33,51,-18,29
Ballinamalla,2949,10,6,7,17,27,48,-21,25
Portadown,2949,11,4,5,21,18,50,-32,17
Linfield,2950,1,15,7,8,56,36,20,52
Crusaders,2950,2,13,12,5,52,36,16,51
Glenavon,2950,3,13,10,7,48,46,2,49
Cliftonville,2950,4,13,7,10,54,40,14,46
Dungannon,2950,5,12,8,10,55,42,13,44
Glentoran,2950,6,11,7,12,35,41,-6,40
Ballymena,2950,7,11,7,12,55,62,-7,40
Coleraine,2950,8,9,11,10,38,45,-7,38
Ards,2950,9,10,5,15,42,51,-9,35
Ballinamalla,2950,10,8,5,17,33,51,-18,29
Portadown,2950,11,7,7,16,29,47,-18,28
Crusaders,2951,1,17,5,8,55,34,21,56
Cliftonville,2951,2,16,7,7,54,32,22,55
Linfield,2951,3,15,9,6,52,25,27,54
Coleraine,2951,4,12,12,6,51,35,16,48
Ballymena,2951,5,14,5,11,56,60,-4,47
Glenavon,2951,6,9,13,8,48,50,-2,40
Dungannon,2951,7,9,9,12,48,49,-1,36
Ards,2951,8,10,4,16,35,49,-14,34
Portadown,2951,9,8,7,15,27,45,-18,31
Glentoran,2951,10,7,7,16,27,48,-21,28
Ballinamalla,2951,11,8,2,20,25,51,-26,26
Linfield,2952,1,16,10,4,61,29,32,58
Cliftonville,2952,2,17,6,7,62,35,27,57
Crusaders,2952,3,15,11,4,55,32,23,56
Ballymena,2952,4,16,5,9,60,54,6,53
Glenavon,2952,5,10,14,6,48,43,5,44
Coleraine,2952,6,10,9,11,38,45,-7,39
Dungannon,2952,7,7,10,13,46,52,-6,31
Glentoran,2952,8,8,7,15,36,50,-14,31
Ards,2952,9,9,4,17,34,54,-20,31
Ballinamalla,2952,10,7,8,15,32,50,-18,29
Portadown,2952,11,5,6,19,26,54,-28,21
Linfield,2953,1,18,6,6,61,29,32,60
Crusaders,2953,2,17,9,4,58,38,20,60
Cliftonville,2953,3,17,3,10,59,39,20,54
Ballymena,2953,4,14,4,12,61,61,0,46
Glenavon,2953,5,11,11,8,50,47,3,44
Coleraine,2953,6,9,13,8,39,37,2,40
Dungannon,2953,7,9,10,11,53,52,1,37
Ards,2953,8,10,7,13,41,48,-7,37
Glentoran,2953,9,8,8,14,25,40,-15,32
Ballinamalla,2953,10,8,4,18,30,50,-20,28
Portadown,2953,11,4,5,21,20,56,-36,17
Crusaders,2954,1,17,5,8,56,40,16,56
Linfield,2954,2,15,9,6,60,35,25,54
Cliftonville,2954,3,14,5,11,52,43,9,47
Glenavon,2954,4,12,10,8,49,40,9,46
Ballymena,2954,5,14,3,13,67,65,2,45
Portadown,2954,6,12,5,13,26,38,-12,41
Coleraine,2954,7,10,9,11,39,42,-3,39
Ards,2954,8,11,6,13,44,49,-5,39
Dungannon,2954,9,10,8,12,48,44,4,38
Ballinamalla,2954,10,8,4,18,33,55,-22,28
Glentoran,2954,11,7,6,17,26,49,-23,27
Crusaders,2955,1,18,9,3,62,29,33,63
Linfield,2955,2,14,13,3,61,28,33,55
Cliftonville,2955,3,16,4,10,51,37,14,52
Coleraine,2955,4,14,10,6,44,33,11,52
Glenavon,2955,5,11,10,9,51,52,-1,43
Glentoran,2955,6,12,7,11,36,41,-5,43
Ballymena,2955,7,11,6,13,50,60,-10,39
Ards,2955,8,8,7,15,38,51,-13,31
Dungannon,2955,9,6,9,15,46,52,-6,27
Portadown,2955,10,6,7,17,31,54,-23,25
Ballinamalla,2955,11,6,4,20,30,63,-33,22
Cliftonville,2956,1,17,6,7,55,33,22,57
Linfield,2956,2,16,8,6,55,25,30,56
Crusaders,2956,3,15,10,5,53,30,23,55
Ballymena,2956,4,14,6,10,56,58,-2,48
Coleraine,2956,5,11,10,9,42,37,5,43
Dungannon,2956,6,9,10,11,50,45,5,37
Glentoran,2956,7,9,8,13,26,40,-14,35
Glenavon,2956,8,6,15,9,42,48,-6,33
Ards,2956,9,9,5,16,36,52,-16,32
Ballinamalla,2956,10,8,5,17,25,47,-22,29
Portadown,2956,11,7,5,18,19,44,-25,26
Linfield,2957,1,16,6,8,60,37,23,54
Cliftonville,2957,2,16,4,10,53,40,13,52
Crusaders,2957,3,16,4,10,50,41,9,52
Ballymena,2957,4,15,5,10,56,52,4,50
Glenavon,2957,5,12,12,6,53,37,16,48
Dungannon,2957,6,12,7,11,51,41,10,43
Glentoran,2957,7,9,9,12,29,42,-13,36
Coleraine,2957,8,8,11,11,31,40,-9,35
Portadown,2957,9,11,2,17,23,38,-15,35
Ards,2957,10,8,5,17,37,52,-15,29
Ballinamalla,2957,11,7,5,18,28,51,-23,26
Linfield,2958,1,16,11,3,68,31,37,59
Cliftonville,2958,2,15,7,8,56,42,14,52
Coleraine,2958,3,13,10,7,40,35,5,49
Ballymena,2958,4,14,6,10,60,58,2,48
Crusaders,2958,5,13,8,9,52,44,8,47
Glenavon,2958,6,11,13,6,51,38,13,46
Dungannon,2958,7,11,9,10,50,46,4,42
Glentoran,2958,8,7,10,13,25,42,-17,31
Ards,2958,9,7,7,16,34,51,-17,28
Ballinamalla,2958,10,6,6,18,25,46,-21,24
Portadown,2958,11,6,5,19,25,53,-28,23
Crusaders,2959,1,17,5,8,53,40,13,56
Linfield,2959,2,14,9,7,67,36,31,51
Ballymena,2959,3,16,3,11,57,60,-3,51
Cliftonville,2959,4,14,6,10,55,47,8,48
Coleraine,2959,5,11,12,7,47,39,8,45
Glenavon,2959,6,11,9,10,48,47,1,42
Glentoran,2959,7,12,6,12,36,40,-4,42
Dungannon,2959,8,11,7,12,55,46,9,40
Ards,2959,9,9,6,15,47,56,-9,33
Portadown,2959,10,7,6,17,21,46,-25,27
Ballinamalla,2959,11,7,3,20,26,55,-29,24
Crusaders,2960,1,19,7,4,55,29,26,64
Ballymena,2960,2,17,6,7,63,55,8,57
Linfield,2960,3,12,13,5,52,30,22,49
Coleraine,2960,4,11,12,7,43,37,6,45
Glenavon,2960,5,11,10,9,48,42,6,43
Cliftonville,2960,6,12,5,13,51,43,8,41
Dungannon,2960,7,9,9,12,46,50,-4,36
Ballinamalla,2960,8,11,3,16,34,51,-17,36
Glentoran,2960,9,8,7,15,35,50,-15,31
Ards,2960,10,8,5,17,31,52,-21,29
Portadown,2960,11,6,5,19,25,44,-19,23
Crusaders,2961,1,20,7,3,60,29,31,67
Linfield,2961,2,15,11,4,59,28,31,56
Cliftonville,2961,3,15,6,9,48,35,13,51
Ballymena,2961,4,14,8,8,62,57,5,50
Coleraine,2961,5,10,11,9,39,34,5,41
Glenavon,2961,6,8,12,10,44,48,-4,36
Ballinamalla,2961,7,10,6,14,32,43,-11,36
Glentoran,2961,8,9,7,14,28,47,-19,34
Dungannon,2961,9,8,8,14,47,54,-7,32
Ards,2961,10,8,4,18,31,49,-18,28
Portadown,2961,11,6,4,20,27,53,-26,22
Crusaders,2962,1,19,8,3,60,35,25,65
Linfield,2962,2,15,10,5,64,32,32,55
Cliftonville,2962,3,16,5,9,54,41,13,53
Ballymena,2962,4,15,8,7,61,54,7,53
Glenavon,2962,5,11,10,9,42,39,3,43
Coleraine,2962,6,11,8,11,40,40,0,41
Dungannon,2962,7,9,7,14,46,46,0,34
Ballinamalla,2962,8,9,6,15,36,47,-11,33
Glentoran,2962,9,7,7,16,27,49,-22,28
Portadown,2962,10,7,5,18,26,44,-18,26
Ards,2962,11,6,6,18,29,58,-29,24
Crusaders,2963,1,15,11,4,53,32,21,56
Coleraine,2963,2,13,13,4,45,29,16,52
Cliftonville,2963,3,15,6,9,52,40,12,51
Linfield,2963,4,13,10,7,55,34,21,49
Ballymena,2963,5,13,6,11,62,62,0,45
Glenavon,2963,6,10,12,8,45,43,2,42
Dungannon,2963,7,9,8,13,41,45,-4,35
Glentoran,2963,8,9,6,15,33,46,-13,33
Ballinamalla,2963,9,8,6,16,32,55,-23,30
Ards,2963,10,6,10,14,38,50,-12,28
Portadown,2963,11,7,6,17,30,50,-20,27
Ballymena,2964,1,17,5,8,61,53,8,56
Cliftonville,2964,2,15,4,11,45,35,10,49
Glenavon,2964,3,12,11,7,55,44,11,47
Crusaders,2964,4,12,9,9,52,40,12,45
Linfield,2964,5,12,8,10,54,34,20,44
Coleraine,2964,6,10,14,6,43,36,7,44
Dungannon,2964,7,11,9,10,57,52,5,42
Glentoran,2964,8,10,9,11,36,46,-10,39
Portadown,2964,9,9,6,15,24,45,-21,33
Ballinamalla,2964,10,9,2,19,27,52,-25,29
Ards,2964,11,6,7,17,35,52,-17,25
Cliftonville,2965,1,17,6,7,57,37,20,57
Crusaders,2965,2,15,9,6,54,44,10,54
Linfield,2965,3,14,6,10,56,37,19,48
Coleraine,2965,4,12,9,9,40,38,2,45
Ballymena,2965,5,13,6,11,54,53,1,45
Dungannon,2965,6,10,8,12,52,45,7,38
Glentoran,2965,7,10,8,12,34,46,-12,38
Glenavon,2965,8,8,13,9,41,42,-1,37
Ballinamalla,2965,9,10,3,17,34,51,-17,33
Ards,2965,10,9,5,16,40,52,-12,32
Portadown,2965,11,6,9,15,27,44,-17,27
Crusaders,2966,1,17,7,6,61,36,25,58
Cliftonville,2966,2,18,4,8,53,35,18,58
Ballymena,2966,3,16,6,8,64,55,9,54
Coleraine,2966,4,12,11,7,46,33,13,47
Linfield,2966,5,11,12,7,56,35,21,45
Dungannon,2966,6,12,7,11,50,45,5,43
Glenavon,2966,7,10,11,9,43,48,-5,41
Ards,2966,8,10,7,13,45,47,-2,37
Portadown,2966,9,9,3,18,23,46,-23,30
Glentoran,2966,10,8,5,17,32,51,-19,29
Ballinamalla,2966,11,5,1,24,24,66,-42,16
Crusaders,2967,1,20,7,3,58,30,28,67
Linfield,2967,2,17,8,5,65,29,36,59
Cliftonville,2967,3,16,3,11,56,38,18,51
Ballymena,2967,4,15,5,10,64,60,4,50
Glenavon,2967,5,9,13,8,45,43,2,40
Coleraine,2967,6,9,12,9,39,39,0,39
Ards,2967,7,11,4,15,44,52,-8,37
Dungannon,2967,8,7,9,14,49,53,-4,30
Glentoran,2967,9,8,6,16,24,47,-23,30
Ballinamalla,2967,10,8,5,17,30,51,-21,29
Portadown,2967,11,6,6,18,21,53,-32,24
Ballymena,2968,1,16,7,7,60,52,8,55
Crusaders,2968,2,15,9,6,54,31,23,54
Cliftonville,2968,3,16,5,9,60,40,20,53
Linfield,2968,4,14,9,7,55,36,19,51
Dungannon,2968,5,12,11,7,49,32,17,47
Coleraine,2968,6,10,10,10,42,44,-2,40
Glenavon,2968,7,8,11,11,37,44,-7,35
Ards,2968,8,9,6,15,35,51,-16,33
Glentoran,2968,9,8,8,14,29,47,-18,32
Portadown,2968,10,6,8,16,26,49,-23,26
Ballinamalla,2968,11,7,4,19,33,54,-21,25
Crusaders,2969,1,17,8,5,58,33,25,59
Linfield,2969,2,14,10,6,57,28,29,52
Glenavon,2969,3,14,9,7,49,45,4,51
Cliftonville,2969,4,14,6,10,53,45,8,48
Ballymena,2969,5,11,11,8,57,59,-2,44
Coleraine,2969,6,9,13,8,41,40,1,40
Dungannon,2969,7,10,9,11,52,40,12,39
Glentoran,2969,8,7,10,13,33,52,-19,31
Portadown,2969,9,8,7,15,29,48,-19,31
Ards,2969,10,7,6,17,37,50,-13,27
Ballinamalla,2969,11,7,5,18,24,50,-26,26
Crusaders,2970,1,16,6,8,49,31,18,54
Linfield,2970,2,13,13,4,65,37,28,52
Cliftonville,2970,3,15,6,9,58,43,15,51
Ballymena,2970,4,14,9,7,57,53,4,51
Glenavon,2970,5,13,10,7,57,52,5,49
Coleraine,2970,6,9,13,8,45,39,6,40
Glentoran,2970,7,11,6,13,30,39,-9,39
Dungannon,2970,8,7,10,13,46,52,-6,31
Ards,2970,9,8,6,16,37,52,-15,30
Portadown,2970,10,7,7,16,28,46,-18,28
Ballinamalla,2970,11,6,6,18,27,55,-28,24
Linfield,2971,1,16,7,7,67,36,31,55
Crusaders,2971,2,14,10,6,52,37,15,52
Cliftonville,2971,3,14,7,9,58,43,15,49
Ballymena,2971,4,15,4,11,57,60,-3,49
Dungannon,2971,5,12,12,6,61,37,24,48
Coleraine,2971,6,9,13,8,39,36,3,40
Ards,2971,7,10,6,14,36,44,-8,36
Glenavon,2971,8,8,10,12,44,59,-15,34
Ballinamalla,2971,9,9,6,15,30,49,-19,33
Glentoran,2971,10,7,7,16,29,50,-21,28
Portadown,2971,11,8,4,18,27,49,-22,28
Crusaders,2972,1,18,6,6,60,35,25,60
Linfield,2972,2,14,9,7,61,35,26,51
Glenavon,2972,3,12,13,5,51,44,7,49
Cliftonville,2972,4,14,6,10,48,39,9,48
Ballymena,2972,5,14,6,10,59,59,0,48
Dungannon,2972,6,10,8,12,48,48,0,38
Glentoran,2972,7,10,8,12,34,40,-6,38
Coleraine,2972,8,9,10,11,36,40,-4,37
Ards,2972,9,9,5,16,43,48,-5,32
Ballinamalla,2972,10,7,7,16,26,50,-24,28
Portadown,2972,11,5,8,17,23,51,-28,23
Linfield,2973,1,16,10,4,63,27,36,58
Crusaders,2973,2,15,10,5,65,43,22,55
Glentoran,2973,3,14,7,9,36,33,3,49
Cliftonville,2973,4,14,6,10,55,43,12,48
Ballymena,2973,5,14,6,10,55,53,2,48
Coleraine,2973,6,12,9,9,40,40,0,45
Glenavon,2973,7,12,7,11,49,49,0,43
Dungannon,2973,8,7,11,12,44,48,-4,32
Ballinamalla,2973,9,6,7,17,32,52,-20,25
Ards,2973,10,7,4,19,33,58,-25,25
Portadown,2973,11,6,7,17,27,53,-26,25
Crusaders,2974,1,16,8,6,57,35,22,56
Cliftonville,2974,2,17,5,8,56,38,18,56
Linfield,2974,3,14,10,6,63,35,28,52
Ballymena,2974,4,14,8,8,56,53,3,50
Ards,2974,5,12,5,13,43,51,-8,41
Coleraine,2974,6,9,11,10,39,40,-1,38
Glenavon,2974,7,10,8,12,47,51,-4,38
Dungannon,2974,8,8,12,10,46,44,2,36
Ballinamalla,2974,9,10,3,17,33,44,-11,33
Glentoran,2974,10,8,5,17,30,49,-19,29
Portadown,2974,11,7,5,18,25,55,-30,26
Crusaders,2975,1,16,11,3,51,27,24,59
Linfield,2975,2,14,9,7,56,31,25,51
Coleraine,2975,3,13,10,7,44,30,14,49
Ballymena,2975,4,14,5,11,61,63,-2,47
Cliftonville,2975,5,13,6,11,52,43,9,45
Glenavon,2975,6,11,10,9,46,46,0,43
Ards,2975,7,11,4,15,39,48,-9,37
Glentoran,2975,8,10,7,13,33,49,-16,37
Portadown,2975,9,9,5,16,23,37,-14,32
Ballinamalla,2975,10,8,5,17,33,53,-20,29
Dungannon,2975,11,5,10,15,42,53,-11,25
Linfield,2976,1,16,10,4,70,34,36,58
Crusaders,2976,2,17,6,7,52,33,19,57
Cliftonville,2976,3,15,5,10,61,46,15,50
Coleraine,2976,4,14,8,8,50,38,12,50
Glenavon,2976,5,12,9,9,48,43,5,45
Ballymena,2976,6,12,7,11,57,67,-10,43
Dungannon,2976,7,10,9,11,57,50,7,39
Glentoran,2976,8,8,7,15,29,46,-17,31
Ballinamalla,2976,9,8,7,15,35,53,-18,31
Ards,2976,10,6,9,15,32,52,-20,27
Portadown,2976,11,5,7,18,28,57,-29,22
Crusaders,2977,1,19,7,4,58,29,29,64
Ballymena,2977,2,16,5,9,62,55,7,53
Cliftonville,2977,3,15,3,12,50,39,11,48
Linfield,2977,4,12,10,8,55,38,17,46
Coleraine,2977,5,12,9,9,45,43,2,45
Dungannon,2977,6,10,8,12,50,47,3,38
Glenavon,2977,7,10,8,12,47,46,1,38
Glentoran,2977,8,9,8,13,31,46,-15,35
Ards,2977,9,8,8,14,37,48,-11,32
Ballinamalla,2977,10,9,5,16,31,54,-23,32
Portadown,2977,11,7,5,18,29,50,-21,26
Linfield,2978,1,17,7,6,64,28,36,58
Crusaders,2978,2,17,7,6,57,33,24,58
Cliftonville,2978,3,15,4,11,50,44,6,49
Coleraine,2978,4,13,8,9,45,37,8,47
Ballymena,2978,5,13,8,9,51,53,-2,47
Glenavon,2978,6,12,10,8,51,40,11,46
Dungannon,2978,7,10,11,9,44,38,6,41
Glentoran,2978,8,8,9,13,32,44,-12,33
Ards,2978,9,8,6,16,36,52,-16,30
Ballinamalla,2978,10,6,7,17,27,55,-28,25
Portadown,2978,11,5,5,20,19,52,-33,20
Cliftonville,2979,1,20,3,7,56,33,23,63
Glenavon,2979,2,15,7,8,54,43,11,52
Ballymena,2979,3,15,6,9,61,61,0,51
Crusaders,2979,4,14,7,9,48,38,10,49
Linfield,2979,5,11,10,9,55,38,17,43
Dungannon,2979,6,10,10,10,49,40,9,40
Coleraine,2979,7,10,9,11,36,41,-5,39
Portadown,2979,8,11,4,15,31,45,-14,37
Glentoran,2979,9,8,11,11,38,46,-8,35
Ards,2979,10,8,7,15,47,55,-8,31
Ballinamalla,2979,11,3,6,21,24,59,-35,15
Crusaders,2980,1,15,11,4,58,36,22,56
Linfield,2980,2,15,9,6,63,33,30,54
Cliftonville,2980,3,15,5,10,56,42,14,50
Ballymena,2980,4,14,6,10,51,59,-8,48
Coleraine,2980,5,13,8,9,50,37,13,47
Glenavon,2980,6,12,9,9,46,45,1,45
Glentoran,2980,7,10,9,11,40,43,-3,39
Portadown,2980,8,10,2,18,30,45,-15,32
Ards,2980,9,8,5,17,34,54,-20,29
Dungannon,2980,10,6,10,14,39,50,-11,28
Ballinamalla,2980,11,8,4,18,33,56,-23,28
Crusaders,2981,1,19,8,3,71,32,39,65
Ballymena,2981,2,17,4,9,65,55,10,55
Linfield,2981,3,14,10,6,59,35,24,52
Cliftonville,2981,4,14,6,10,50,38,12,48
Dungannon,2981,5,12,7,11,50,48,2,43
Coleraine,2981,6,10,12,8,41,38,3,42
Glenavon,2981,7,10,12,8,47,45,2,42
Glentoran,2981,8,8,8,14,28,45,-17,32
Ballinamalla,2981,9,10,2,18,34,60,-26,32
Portadown,2981,10,7,3,20,28,53,-25,24
Ards,2981,11,5,6,19,27,51,-24,21
Crusaders,2982,1,15,11,4,60,31,29,56
Linfield,2982,2,14,9,7,60,34,26,51
Ballymena,2982,3,14,8,8,62,58,4,50
Cliftonville,2982,4,15,4,11,48,38,10,49
Coleraine,2982,5,13,7,10,44,42,2,46
Glentoran,2982,6,11,9,10,29,35,-6,42
Ards,2982,7,11,6,13,40,48,-8,39
Glenavon,2982,8,7,14,9,44,49,-5,35
Dungannon,2982,9,6,10,14,47,56,-9,28
Ballinamalla,2982,10,7,6,17,28,49,-21,27
Portadown,2982,11,6,8,16,30,52,-22,26
Crusaders,2983,1,20,7,3,57,26,31,67
Linfield,2983,2,15,9,6,62,34,28,54
Ballymena,2983,3,14,8,8,61,54,7,50
Cliftonville,2983,4,15,4,11,53,38,15,49
Coleraine,2983,5,12,10,8,42,36,6,46
Dungannon,2983,6,8,11,11,50,51,-1,35
Glenavon,2983,7,7,12,11,43,53,-10,33
Ards,2983,8,10,3,17,35,47,-12,33
Glentoran,2983,9,8,8,14,32,47,-15,32
Ballinamalla,2983,10,8,5,17,28,50,-22,29
Portadown,2983,11,7,5,18,25,52,-27,26
Crusaders,2984,1,21,5,4,60,27,33,68
Ballymena,2984,2,18,7,5,59,47,12,61
Linfield,2984,3,13,11,6,56,31,25,50
Glenavon,2984,4,13,10,7,58,49,9,49
Cliftonville,2984,5,12,8,10,49,43,6,44
Coleraine,2984,6,9,12,9,44,40,4,39
Dungannon,2984,7,9,10,11,52,49,3,37
Glentoran,2984,8,7,7,16,26,44,-18,28
Ards,2984,9,8,4,18,35,56,-21,28
Ballinamalla,2984,10,7,4,19,25,51,-26,25
Portadown,2984,11,5,8,17,21,48,-27,23
Dungannon,2985,1,15,8,7,55,38,17,53
Crusaders,2985,2,14,10,6,55,34,21,52
Cliftonville,2985,3,15,6,9,49,43,6,51
Linfield,2985,4,13,9,8,51,27,24,48
Coleraine,2985,5,11,12,7,41,35,6,45
Glentoran,2985,6,12,6,12,34,41,-7,42
Ballymena,2985,7,11,6,13,49,60,-11,39
Glenavon,2985,8,9,10,11,45,50,-5,37
Ards,2985,9,10,5,15,40,45,-5,35
Ballinamalla,2985,10,8,4,18,28,49,-21,28
Portadown,2985,11,7,4,19,23,48,-25,25
Crusaders,2986,1,17,6,7,53,29,24,57
Ballymena,2986,2,16,5,9,58,56,2,53
Linfield,2986,3,14,10,6,63,37,26,52
Cliftonville,2986,4,16,4,10,55,36,19,52
Glenavon,2986,5,15,7,8,45,43,2,52
Coleraine,2986,6,10,10,10,43,41,2,40
Ballinamalla,2986,7,10,5,15,34,47,-13,35
Dungannon,2986,8,8,10,12,48,47,1,34
Ards,2986,9,8,7,15,36,47,-11,31
Portadown,2986,10,7,6,17,27,51,-24,27
Glentoran,2986,11,5,8,17,24,52,-28,23
Crusaders,2987,1,17,6,7,52,32,20,57
Linfield,2987,2,15,11,4,60,30,30,56
Ballymena,2987,3,15,5,10,64,61,3,50
Cliftonville,2987,4,14,5,11,48,39,9,47
Glenavon,2987,5,12,9,9,50,42,8,45
Coleraine,2987,6,10,11,9,41,41,0,41
Dungannon,2987,7,9,9,12,51,48,3,36
Glentoran,2987,8,10,6,14,31,44,-13,36
Ards,2987,9,9,5,16,38,53,-15,32
Portadown,2987,10,8,6,16,27,46,-19,30
Ballinamalla,2987,11,6,7,17,28,54,-26,25
Crusaders,2988,1,17,7,6,51,33,18,58
Linfield,2988,2,16,9,5,65,30,35,57
Glenavon,2988,3,16,8,6,55,40,15,56
Cliftonville,2988,4,16,5,9,56,42,14,53
Glentoran,2988,5,11,6,13,33,46,-13,39
Coleraine,2988,6,9,10,11,37,38,-1,37
Ballymena,2988,7,10,6,14,51,63,-12,36
Dungannon,2988,8,8,11,11,48,42,6,35
Ards,2988,9,10,4,16,40,50,-10,34
Ballinamalla,2988,10,8,4,18,29,58,-29,28
Portadown,2988,11,7,4,19,23,46,-23,25
Crusaders,2989,1,16,8,6,54,31,23,56
Cliftonville,2989,2,17,4,9,66,35,31,55
Linfield,2989,3,13,11,6,60,35,25,50
Glenavon,2989,4,12,11,7,47,41,6,47
Ballymena,2989,5,12,7,11,55,63,-8,43
Coleraine,2989,6,10,11,9,43,37,6,41
Dungannon,2989,7,8,10,12,40,43,-3,34
Ards,2989,8,10,4,16,36,55,-19,34
Portadown,2989,9,10,3,17,31,49,-18,33
Glentoran,2989,10,7,11,12,23,40,-17,32
Ballinamalla,2989,11,8,4,18,28,54,-26,28
Linfield,2990,1,17,8,5,61,32,29,59
Cliftonville,2990,2,17,3,10,50,34,16,54
Crusaders,2990,3,14,8,8,57,38,19,50
Ballymena,2990,4,13,8,9,61,55,6,47
Glenavon,2990,5,10,12,8,49,47,2,42
Coleraine,2990,6,10,11,9,40,39,1,41
Dungannon,2990,7,10,10,10,49,43,6,40
Glentoran,2990,8,9,10,11,33,42,-9,37
Ards,2990,9,9,3,18,34,53,-19,30
Portadown,2990,10,7,8,15,23,46,-23,29
Ballinamalla,2990,11,5,7,18,29,57,-28,22
Crusaders,2991,1,17,5,8,57,35,22,56
Linfield,2991,2,15,9,6,63,34,29,54
Ballymena,2991,3,15,5,10,61,52,9,50
Cliftonville,2991,4,15,5,10,45,45,0,50
Glenavon,2991,5,11,11,8,47,49,-2,44
Coleraine,2991,6,10,12,8,43,36,7,42
Glentoran,2991,7,11,7,12,35,38,-3,40
Dungannon,2991,8,10,8,12,53,43,10,38
Ards,2991,9,11,3,16,41,53,-12,36
Portadown,2991,10,7,6,17,24,45,-21,27
Ballinamalla,2991,11,6,3,21,26,65,-39,21
Crusaders,2992,1,14,9,7,55,37,18,51
Ballymena,2992,2,15,6,9,63,57,6,51
Cliftonville,2992,3,14,8,8,54,44,10,50
Linfield,2992,4,14,7,9,57,34,23,49
Glenavon,2992,5,12,10,8,52,48,4,46
Dungannon,2992,6,11,12,7,58,43,15,45
Coleraine,2992,7,11,10,9,46,50,-4,43
Glentoran,2992,8,9,9,12,35,42,-7,36
Ballinamalla,2992,9,8,5,17,31,50,-19,29
Portadown,2992,10,7,5,18,27,54,-27,26
Ards,2992,11,6,7,17,33,52,-19,25
Linfield,2993,1,17,8,5,64,31,33,59
Cliftonville,2993,2,14,6,10,55,43,12,48
Crusaders,2993,3,13,8,9,49,39,10,47
Ballymena,2993,4,13,7,10,60,60,0,46
Dungannon,2993,5,12,8,10,48,36,12,44
Glenavon,2993,6,11,9,10,49,48,1,42
Coleraine,2993,7,10,10,10,40,42,-2,40
Ards,2993,8,11,6,13,50,49,1,39
Ballinamalla,2993,9,9,4,17,32,52,-20,31
Portadown,2993,10,9,4,17,28,51,-23,31
Glentoran,2993,11,7,8,15,23,47,-24,29
Linfield,2994,1,17,8,5,60,29,31,59
Crusaders,2994,2,14,11,5,51,34,17,53
Ballymena,2994,3,16,5,9,65,56,9,53
Glenavon,2994,4,12,10,8,49,44,5,46
Coleraine,2994,5,11,9,10,48,44,4,42
Cliftonville,2994,6,12,4,14,45,42,3,40
Ards,2994,7,11,6,13,44,45,-1,39
Dungannon,2994,8,9,10,11,48,45,3,37
Glentoran,2994,9,9,7,14,30,46,-16,34
Portadown,2994,10,6,8,16,22,47,-25,26
Ballinamalla,2994,11,6,6,18,22,52,-30,24
Crusaders,2995,1,16,9,5,60,32,28,57
Linfield,2995,2,15,8,7,60,35,25,53
Cliftonville,2995,3,16,3,11,50,39,11,51
Ballymena,2995,4,14,7,9,56,53,3,49
Coleraine,2995,5,12,8,10,38,42,-4,44
Dungannon,2995,6,10,10,10,56,47,9,40
Glentoran,2995,7,11,6,13,39,52,-13,39
Glenavon,2995,8,9,11,10,38,42,-4,38
Ballinamalla,2995,9,10,3,17,36,54,-18,33
Ards,2995,10,7,6,17,34,46,-12,27
Portadown,2995,11,8,3,19,22,47,-25,27
Crusaders,2996,1,18,7,5,62,31,31,61
Ballymena,2996,2,17,6,7,68,50,18,57
Linfield,2996,3,13,9,8,54,34,20,48
Cliftonville,2996,4,14,6,10,48,42,6,48
Glenavon,2996,5,11,12,7,51,46,5,45
Coleraine,2996,6,10,9,11,40,44,-4,39
Dungannon,2996,7,9,10,11,49,49,0,37
Ards,2996,8,10,6,14,43,53,-10,36
Portadown,2996,9,7,7,16,25,44,-19,28
Glentoran,2996,10,6,10,14,29,50,-21,28
Ballinamalla,2996,11,5,8,17,28,54,-26,23
Crusaders,2997,1,18,10,2,59,28,31,64
Linfield,2997,2,18,6,6,61,28,33,60
Cliftonville,2997,3,16,5,9,53,35,18,53
Glenavon,2997,4,12,10,8,52,46,6,46
Ballymena,2997,5,10,8,12,59,65,-6,38
Coleraine,2997,6,8,12,10,44,50,-6,36
Ards,2997,7,10,6,14,47,57,-10,36
Dungannon,2997,8,7,11,12,46,49,-3,32
Portadown,2997,9,7,8,15,31,49,-18,29
Glentoran,2997,10,7,8,15,25,44,-19,29
Ballinamalla,2997,11,8,4,18,30,56,-26,28
Cliftonville,2998,1,18,4,8,64,43,21,58
Ballymena,2998,2,15,6,9,46,49,-3,51
Linfield,2998,3,13,10,7,56,35,21,49
Crusaders,2998,4,13,9,8,53,37,16,48
Coleraine,2998,5,13,8,9,41,33,8,47
Glenavon,2998,6,12,8,10,47,43,4,44
Dungannon,2998,7,10,11,9,50,45,5,41
Glentoran,2998,8,9,7,14,29,45,-16,34
Ards,2998,9,9,4,17,44,55,-11,31
Ballinamalla,2998,10,8,7,15,31,50,-19,31
Portadown,2998,11,5,6,19,25,51,-26,21
Linfield,2999,1,16,10,4,61,32,29,58
Cliftonville,2999,2,16,5,9,58,41,17,53
Crusaders,2999,3,13,8,9,44,37,7,47
Ballymena,2999,4,14,5,11,61,59,2,47
Glenavon,2999,5,11,12,7,51,44,7,45
Dungannon,2999,6,10,12,8,53,40,13,42
Coleraine,2999,7,10,11,9,48,42,6,41
Ards,2999,8,9,9,12,43,45,-2,36
Glentoran,2999,9,6,11,13,27,44,-17,29
Portadown,2999,10,7,7,16,24,50,-26,28
Ballinamalla,2999,11,5,6,19,25,61,-36,21
Crusaders,3000,1,18,6,6,55,34,21,60
Cliftonville,3000,2,17,4,9,57,34,23,55
Linfield,3000,3,15,8,7,55,32,23,53
Ballymena,3000,4,15,5,10,59,59,0,50
Coleraine,3000,5,11,12,7,41,35,6,45
Glenavon,3000,6,11,10,9,48,45,3,43
Portadown,3000,7,10,4,16,28,43,-15,34
Ballinamalla,3000,8,10,3,17,31,50,-19,33
Dungannon,3000,9,7,9,14,51,57,-6,30
Ards,3000,10,7,7,16,34,51,-17,28
Glentoran,3000,11,7,6,17,29,48,-19,27
Cliftonville,3001,1,17,5,8,57,37,20,56
Crusaders,3001,2,16,6,8,62,38,24,54
Linfield,3001,3,14,8,8,55,33,22,50
Ballymena,3001,4,14,6,10,60,60,0,48
Coleraine,3001,5,9,16,5,47,39,8,43
Glenavon,3001,6,11,10,9,42,47,-5,43
Ards,3001,7,12,3,15,44,50,-6,39
Dungannon,3001,8,8,10,12,46,47,-1,34
Glentoran,3001,9,8,9,13,30,45,-15,33
Ballinamalla,3001,10,9,4,17,37,58,-21,31
Portadown,3001,11,5,7,18,16,42,-26,22
Cliftonville,3002,1,16,5,9,48,35,13,53
Crusaders,3002,2,13,13,4,53,35,18,52
Coleraine,3002,3,14,9,7,47,37,10,51
Ballymena,3002,4,12,8,10,51,55,-4,44
Dungannon,3002,5,11,10,9,51,41,10,43
Linfield,3002,6,10,9,11,50,36,14,39
Glentoran,3002,7,11,6,13,41,49,-8,39
Ards,3002,8,11,5,14,46,50,-4,38
Portadown,3002,9,9,7,14,29,43,-14,34
Glenavon,3002,10,7,9,14,39,53,-14,30
Ballinamalla,3002,11,7,7,16,35,56,-21,28
Cliftonville,3003,1,19,3,8,52,37,15,60
Crusaders,3003,2,16,9,5,60,31,29,57
Linfield,3003,3,16,8,6,65,30,35,56
Dungannon,3003,4,11,11,8,51,39,12,44
Ballymena,3003,5,13,5,12,57,61,-4,44
Glenavon,3003,6,10,11,9,47,46,1,41
Coleraine,3003,7,10,9,11,44,47,-3,39
Ards,3003,8,9,7,14,36,46,-10,34
Ballinamalla,3003,9,8,7,15,34,53,-19,31
Glentoran,3003,10,6,7,17,27,55,-28,25
Portadown,3003,11,6,5,19,19,47,-28,23
Ballymena,3004,1,16,5,9,58,50,8,53
Cliftonville,3004,2,16,3,11,58,48,10,51
Linfield,3004,3,12,10,8,53,33,20,46
Glenavon,3004,4,12,10,8,50,41,9,46
Crusaders,3004,5,13,6,11,52,37,15,45
Coleraine,3004,6,12,8,10,40,40,0,44
Dungannon,3004,7,11,10,9,56,45,11,43
Glentoran,3004,8,9,9,12,29,43,-14,36
Ballinamalla,3004,9,10,6,14,28,43,-15,36
Ards,3004,10,8,6,16,36,51,-15,30
Portadown,3004,11,6,7,17,26,55,-29,25
Ballymena,3005,1,17,6,7,65,48,17,57
Crusaders,3005,2,17,6,7,56,41,15,57
Cliftonville,3005,3,15,8,7,55,34,21,53
Linfield,3005,4,13,11,6,55,32,23,50
Glenavon,3005,5,10,13,7,45,42,3,43
Coleraine,3005,6,8,11,11,37,44,-7,35
Ards,3005,7,8,10,12,33,44,-11,34
Glentoran,3005,8,8,8,14,37,50,-13,32
Ballinamalla,3005,9,9,5,16,37,53,-16,32
Dungannon,3005,10,7,10,13,41,49,-8,31
Portadown,3005,11,4,10,16,21,45,-24,22
Crusaders,3006,1,16,8,6,55,33,22,56
Cliftonville,3006,2,17,3,10,52,37,15,54
Linfield,3006,3,15,7,8,59,31,28,52
Ballymena,3006,4,14,6,10,60,58,2,48
Coleraine,3006,5,12,10,8,40,34,6,46
Glenavon,3006,6,10,10,10,51,50,1,40
Dungannon,3006,7,10,8,12,53,53,0,38
Ards,3006,8,10,6,14,39,52,-13,36
Ballinamalla,3006,9,9,6,15,35,54,-19,33
Portadown,3006,10,8,5,17,28,50,-22,29
Glentoran,3006,11,5,9,16,26,46,-20,24
Crusaders,3007,1,18,8,4,64,32,32,62
Cliftonville,3007,2,16,6,8,61,40,21,54
Linfield,3007,3,12,13,5,58,34,24,49
Ballymena,3007,4,15,4,11,52,54,-2,49
Dungannon,3007,5,12,9,9,51,39,12,45
Glenavon,3007,6,10,11,9,44,44,0,41
Coleraine,3007,7,8,8,14,42,52,-10,32
Ards,3007,8,9,5,16,37,51,-14,32
Glentoran,3007,9,8,7,15,29,51,-22,31
Portadown,3007,10,9,4,17,31,55,-24,31
Ballinamalla,3007,11,9,3,18,30,47,-17,30
Crusaders,3008,1,18,8,4,58,32,26,62
Linfield,3008,2,14,10,6,56,35,21,52
Glenavon,3008,3,13,11,6,54,46,8,50
Cliftonville,3008,4,15,4,11,47,36,11,49
Dungannon,3008,5,11,9,10,55,43,12,42
Ballymena,3008,6,12,5,13,55,63,-8,41
Coleraine,3008,7,10,8,12,35,41,-6,38
Ards,3008,8,9,8,13,45,50,-5,35
Ballinamalla,3008,9,8,6,16,34,49,-15,30
Glentoran,3008,10,7,7,16,28,47,-19,28
Portadown,3008,11,7,6,17,20,45,-25,27
Crusaders,3009,1,18,7,5,54,25,29,61
Linfield,3009,2,16,10,4,64,28,36,58
Cliftonville,3009,3,17,6,7,56,35,21,57
Ballymena,3009,4,16,5,9,62,56,6,53
Glenavon,3009,5,11,11,8,46,45,1,44
Dungannon,3009,6,9,10,11,51,48,3,37
Coleraine,3009,7,8,12,10,39,44,-5,36
Glentoran,3009,8,9,7,14,29,42,-13,34
Ards,3009,9,8,5,17,37,57,-20,29
Portadown,3009,10,5,7,18,25,51,-26,22
Ballinamalla,3009,11,6,4,20,25,57,-32,22
Crusaders,3010,1,19,8,3,66,33,33,65
Cliftonville,3010,2,17,4,9,55,29,26,55
Ballymena,3010,3,14,7,9,59,58,1,49
Linfield,3010,4,12,12,6,51,28,23,48
Coleraine,3010,5,10,12,8,41,45,-4,42
Glenavon,3010,6,9,13,8,45,47,-2,40
Glentoran,3010,7,11,7,12,34,45,-11,40
Dungannon,3010,8,10,8,12,55,52,3,38
Portadown,3010,9,8,3,19,23,45,-22,27
Ards,3010,10,6,8,16,34,51,-17,26
Ballinamalla,3010,11,5,6,19,26,56,-30,21
Crusaders,3011,1,16,9,5,57,35,22,57
Linfield,3011,2,15,9,6,62,30,32,54
Ballymena,3011,3,14,7,9,60,56,4,49
Glenavon,3011,4,12,12,6,52,45,7,48
Cliftonville,3011,5,13,6,11,48,44,4,45
Coleraine,3011,6,11,9,10,41,46,-5,42
Ards,3011,7,11,6,13,46,48,-2,39
Dungannon,3011,8,9,9,12,49,50,-1,36
Ballinamalla,3011,9,8,5,17,34,52,-18,29
Glentoran,3011,10,6,9,15,31,50,-19,27
Portadown,3011,11,6,7,17,23,47,-24,25
Cliftonville,3012,1,18,6,6,58,31,27,60
Linfield,3012,2,16,9,5,62,29,33,57
Glenavon,3012,3,12,10,8,46,45,1,46
Glentoran,3012,4,12,8,10,30,36,-6,44
Crusaders,3012,5,12,6,12,50,49,1,42
Coleraine,3012,6,9,14,7,45,42,3,41
Ballymena,3012,7,12,3,15,53,65,-12,39
Ards,3012,8,11,4,15,44,45,-1,37
Dungannon,3012,9,9,9,12,51,49,2,36
Portadown,3012,10,9,6,15,25,41,-16,33
Ballinamalla,3012,11,6,3,21,27,59,-32,21
Cliftonville,3013,1,17,5,8,52,32,20,56
Crusaders,3013,2,14,9,7,51,35,16,51
Glenavon,3013,3,13,11,6,47,45,2,50
Linfield,3013,4,13,10,7,56,28,28,49
Coleraine,3013,5,13,7,10,47,42,5,46
Dungannon,3013,6,10,9,11,50,42,8,39
Ballymena,3013,7,11,6,13,52,60,-8,39
Glentoran,3013,8,11,5,14,32,46,-14,38
Ards,3013,9,8,6,16,38,54,-16,30
Portadown,3013,10,9,3,18,26,46,-20,30
Ballinamalla,3013,11,8,5,17,22,43,-21,29
Crusaders,3014,1,16,7,7,56,34,22,55
Cliftonville,3014,2,15,6,9,56,40,16,51
Coleraine,3014,3,13,10,7,47,40,7,49
Ballymena,3014,4,14,6,10,58,61,-3,48
Linfield,3014,5,13,8,9,52,37,15,47
Dungannon,3014,6,12,10,8,55,43,12,46
Glenavon,3014,7,9,9,12,46,52,-6,36
Glentoran,3014,8,8,9,13,31,46,-15,33
Ards,3014,9,8,7,15,44,56,-12,31
Portadown,3014,10,8,6,16,30,45,-15,30
Ballinamalla,3014,11,8,4,18,32,53,-21,28
Crusaders,3015,1,18,10,2,57,31,26,64
Glenavon,3015,2,14,9,7,59,47,12,51
Cliftonville,3015,3,14,6,10,48,39,9,48
Linfield,3015,4,12,11,7,60,37,23,47
Coleraine,3015,5,11,11,8,45,39,6,44
Ballymena,3015,6,11,8,11,51,58,-7,41
Glentoran,3015,7,10,10,10,36,41,-5,40
Dungannon,3015,8,9,8,13,49,47,2,35
Portadown,3015,9,8,5,17,27,46,-19,29
Ards,3015,10,7,7,16,30,48,-18,28
Ballinamalla,3015,11,7,3,20,24,53,-29,24
Crusaders,3016,1,15,11,4,60,37,23,56
Linfield,3016,2,14,11,5,56,29,27,53
Ballymena,3016,3,15,6,9,58,54,4,51
Coleraine,3016,4,12,9,9,37,36,1,45
Glenavon,3016,5,10,13,7,45,45,0,43
Dungannon,3016,6,10,11,9,57,53,4,41
Cliftonville,3016,7,11,6,13,39,34,5,39
Portadown,3016,8,11,4,15,39,45,-6,37
Ards,3016,9,8,9,13,37,46,-9,33
Glentoran,3016,10,7,7,16,22,41,-19,28
Ballinamalla,3016,11,6,5,19,26,56,-30,23
Linfield,3017,1,15,9,6,67,27,40,54
Crusaders,3017,2,15,9,6,58,39,19,54
Cliftonville,3017,3,16,6,8,57,40,17,54
Ballymena,3017,4,16,6,8,63,55,8,54
Glenavon,3017,5,15,8,7,59,42,17,53
Coleraine,3017,6,10,12,8,45,47,-2,42
Dungannon,3017,7,9,8,13,42,50,-8,35
Ards,3017,8,9,4,17,38,56,-18,31
Glentoran,3017,9,6,8,16,33,53,-20,26
Ballinamalla,3017,10,7,5,18,27,53,-26,26
Portadown,3017,11,7,5,18,30,57,-27,26
Linfield,3018,1,15,11,4,58,28,30,56
Crusaders,3018,2,15,10,5,52,33,19,55
Cliftonville,3018,3,14,6,10,55,47,8,48
Ballymena,3018,4,13,9,8,56,57,-1,48
Dungannon,3018,5,12,10,8,52,38,14,46
Coleraine,3018,6,9,13,8,36,36,0,40
Glenavon,3018,7,8,11,11,44,49,-5,35
Ards,3018,8,9,8,13,37,42,-5,35
Ballinamalla,3018,9,8,6,16,30,51,-21,30
Portadown,3018,10,8,5,17,26,44,-18,29
Glentoran,3018,11,7,5,18,28,49,-21,26
Linfield,3019,1,17,6,7,58,31,27,57
Crusaders,3019,2,16,8,6,52,35,17,56
Ballymena,3019,3,15,7,8,60,54,6,52
Cliftonville,3019,4,14,7,9,48,40,8,49
Coleraine,3019,5,13,9,8,47,41,6,48
Glenavon,3019,6,12,10,8,59,49,10,46
Dungannon,3019,7,8,10,12,53,50,3,34
Portadown,3019,8,10,2,18,29,43,-14,32
Glentoran,3019,9,9,5,16,28,46,-18,32
Ards,3019,10,7,8,15,35,50,-15,29
Ballinamalla,3019,11,6,4,20,29,59,-30,22
Cliftonville,3020,1,15,7,8,52,38,14,52
Crusaders,3020,2,14,10,6,55,43,12,52
Ballymena,3020,3,13,10,7,56,50,6,49
Glenavon,3020,4,12,11,7,53,41,12,47
Coleraine,3020,5,12,10,8,43,38,5,46
Linfield,3020,6,11,11,8,54,41,13,44
Dungannon,3020,7,10,9,11,49,43,6,39
Ards,3020,8,9,6,15,39,50,-11,33
Glentoran,3020,9,8,9,13,33,45,-12,33
Ballinamalla,3020,10,7,6,17,26,49,-23,27
Portadown,3020,11,7,5,18,27,49,-22,26
Linfield,3021,1,20,7,3,66,25,41,67
Cliftonville,3021,2,16,5,9,58,40,18,53
Crusaders,3021,3,15,7,8,47,32,15,52
Ballymena,3021,4,15,6,9,62,54,8,51
Glenavon,3021,5,13,12,5,46,38,8,51
Coleraine,3021,6,12,10,8,44,36,8,46
Glentoran,3021,7,10,5,15,36,48,-12,35
Dungannon,3021,8,8,6,16,43,53,-10,30
Portadown,3021,9,9,3,18,21,50,-29,30
Ards,3021,10,6,6,18,28,49,-21,24
Ballinamalla,3021,11,6,3,21,28,54,-26,21
Crusaders,3022,1,19,5,6,57,31,26,62
Ballymena,3022,2,16,7,7,58,52,6,55
Cliftonville,3022,3,14,7,9,57,42,15,49
Linfield,3022,4,12,9,9,50,34,16,45
Glenavon,3022,5,11,11,8,51,43,8,44
Coleraine,3022,6,12,7,11,37,42,-5,43
Dungannon,3022,7,11,9,10,48,41,7,42
Glentoran,3022,8,8,9,13,32,46,-14,33
Ballinamalla,3022,9,7,8,15,30,48,-18,29
Portadown,3022,10,8,4,18,31,55,-24,28
Ards,3022,11,7,4,19,35,52,-17,25
Crusaders,3023,1,19,5,6,53,31,22,62
Linfield,3023,2,16,7,7,69,30,39,55
Dungannon,3023,3,15,7,8,53,37,16,52
Coleraine,3023,4,13,10,7,47,40,7,49
Cliftonville,3023,5,13,5,12,47,43,4,44
Ballymena,3023,6,12,7,11,56,58,-2,43
Glenavon,3023,7,11,9,10,45,48,-3,42
Portadown,3023,8,8,6,16,25,45,-20,30
Glentoran,3023,9,7,8,15,34,53,-19,29
Ards,3023,10,8,4,18,38,55,-17,28
Ballinamalla,3023,11,8,2,20,29,56,-27,26
Crusaders,3024,1,14,13,3,51,27,24,55
Cliftonville,3024,2,17,3,10,52,45,7,54
Ballymena,3024,3,15,5,10,61,56,5,50
Glenavon,3024,4,13,10,7,54,39,15,49
Linfield,3024,5,13,9,8,51,32,19,48
Coleraine,3024,6,11,12,7,43,34,9,45
Dungannon,3024,7,9,12,9,53,44,9,39
Glentoran,3024,8,10,6,14,33,46,-13,36
Portadown,3024,9,8,6,16,30,50,-20,30
Ards,3024,10,7,5,18,40,57,-17,26
Ballinamalla,3024,11,5,5,20,20,58,-38,20
Crusaders,3025,1,17,5,8,53,38,15,56
Ballymena,3025,2,15,5,10,60,52,8,50
Cliftonville,3025,3,15,3,12,52,43,9,48
Linfield,3025,4,13,7,10,60,40,20,46
Dungannon,3025,5,12,9,9,60,45,15,45
Coleraine,3025,6,12,9,9,45,44,1,45
Glenavon,3025,7,11,9,10,40,44,-4,42
Ballinamalla,3025,8,11,1,18,33,49,-16,34
Ards,3025,9,9,6,15,34,46,-12,33
Portadown,3025,10,9,5,16,28,49,-21,32
Glentoran,3025,11,8,7,15,28,43,-15,31
Crusaders,3026,1,15,9,6,61,36,25,54
Cliftonville,3026,2,16,5,9,59,41,18,53
Linfield,3026,3,14,8,8,57,34,23,50
Glenavon,3026,4,13,10,7,54,48,6,49
Ballymena,3026,5,15,3,12,56,57,-1,48
Dungannon,3026,6,11,9,10,56,48,8,42
Ards,3026,7,11,5,14,47,47,0,38
Coleraine,3026,8,8,11,11,38,45,-7,35
Glentoran,3026,9,8,8,14,33,56,-23,32
Ballinamalla,3026,10,8,6,16,36,59,-23,30
Portadown,3026,11,5,8,17,22,48,-26,23
Linfield,3027,1,16,9,5,59,30,29,57
Crusaders,3027,2,15,9,6,56,33,23,54
Cliftonville,3027,3,16,5,9,52,32,20,53
Ballymena,3027,4,14,8,8,58,60,-2,50
Dungannon,3027,5,12,7,11,52,41,11,43
Coleraine,3027,6,9,12,9,42,40,2,39
Glenavon,3027,7,10,9,11,42,52,-10,39
Glentoran,3027,8,9,8,13,35,43,-8,35
Ards,3027,9,10,4,16,36,52,-16,34
Portadown,3027,10,8,5,17,30,46,-16,29
Ballinamalla,3027,11,5,6,19,31,64,-33,21
Cliftonville,3028,1,18,3,9,63,43,20,57
Crusaders,3028,2,15,9,6,59,37,22,54
Ballymena,3028,3,16,3,11,65,54,11,51
Linfield,3028,4,13,7,10,55,33,22,46
Glenavon,3028,5,11,12,7,58,45,13,45
Coleraine,3028,6,11,8,11,40,43,-3,41
Ards,3028,7,12,5,13,40,45,-5,41
Dungannon,3028,8,10,9,11,47,51,-4,39
Glentoran,3028,9,8,7,15,23,44,-21,31
Portadown,3028,10,9,4,17,34,59,-25,31
Ballinamalla,3028,11,7,3,20,24,54,-30,24
Linfield,3029,1,15,9,6,56,24,32,54
Crusaders,3029,2,16,6,8,59,46,13,54
Cliftonville,3029,3,16,5,9,55,39,16,53
Glenavon,3029,4,14,9,7,53,43,10,51
Coleraine,3029,5,11,10,9,42,40,2,43
Ballymena,3029,6,12,7,11,53,63,-10,43
Dungannon,3029,7,10,8,12,50,42,8,38
Glentoran,3029,8,7,10,13,27,45,-18,31
Portadown,3029,9,8,7,15,27,46,-19,31
Ballinamalla,3029,10,7,8,15,37,55,-18,29
Ards,3029,11,7,5,18,33,49,-16,26
Cliftonville,3030,1,15,6,9,50,39,11,51
Crusaders,3030,2,14,8,8,49,37,12,50
Linfield,3030,3,13,10,7,59,37,22,49
Glenavon,3030,4,12,12,6,47,38,9,48
Ballymena,3030,5,11,10,9,52,54,-2,43
Coleraine,3030,6,10,11,9,41,43,-2,41
Ards,3030,7,12,4,14,48,48,0,40
Dungannon,3030,8,11,6,13,50,45,5,39
Glentoran,3030,9,10,6,14,32,46,-14,36
Ballinamalla,3030,10,8,6,16,30,49,-19,30
Portadown,3030,11,6,7,17,24,46,-22,25
Crusaders,3031,1,18,7,5,58,31,27,61
Linfield,3031,2,14,9,7,54,31,23,51
Cliftonville,3031,3,15,5,10,58,46,12,50
Glenavon,3031,4,11,12,7,49,42,7,45
Coleraine,3031,5,11,11,8,42,39,3,44
Ballymena,3031,6,12,8,10,51,54,-3,44
Glentoran,3031,7,11,9,10,31,38,-7,42
Dungannon,3031,8,10,6,14,45,45,0,36
Ards,3031,9,9,5,16,40,47,-7,32
Portadown,3031,10,8,4,18,24,47,-23,28
Ballinamalla,3031,11,5,6,19,24,56,-32,21
Crusaders,3032,1,18,7,5,61,31,30,61
Linfield,3032,2,14,11,5,62,31,31,53
Cliftonville,3032,3,15,6,9,51,37,14,51
Ballymena,3032,4,15,5,10,59,59,0,50
Coleraine,3032,5,11,11,8,39,35,4,44
Glenavon,3032,6,10,10,10,43,49,-6,40
Portadown,3032,7,10,6,14,31,45,-14,36
Dungannon,3032,8,8,10,12,48,49,-1,34
Glentoran,3032,9,8,6,16,27,46,-19,30
Ards,3032,10,8,5,17,34,51,-17,29
Ballinamalla,3032,11,8,3,19,23,45,-22,27
Crusaders,3033,1,16,8,6,60,39,21,56
Cliftonville,3033,2,17,3,10,57,37,20,54
Linfield,3033,3,14,8,8,60,37,23,50
Glenavon,3033,4,12,14,4,47,39,8,50
Coleraine,3033,5,12,11,7,45,35,10,47
Ballymena,3033,6,13,7,10,58,59,-1,46
Glentoran,3033,7,9,8,13,33,46,-13,35
Ards,3033,8,10,5,15,38,54,-16,35
Dungannon,3033,9,8,10,12,45,44,1,34
Portadown,3033,10,7,4,19,20,46,-26,25
Ballinamalla,3033,11,6,4,20,34,61,-27,22
Crusaders,3034,1,17,8,5,58,32,26,59
Linfield,3034,2,16,9,5,63,33,30,57
Cliftonville,3034,3,17,4,9,59,41,18,55
Ballymena,3034,4,15,7,8,62,50,12,52
Dungannon,3034,5,13,7,10,54,41,13,46
Glenavon,3034,6,10,9,11,45,49,-4,39
Glentoran,3034,7,11,6,13,31,42,-11,39
Coleraine,3034,8,7,11,12,31,44,-13,32
Ards,3034,9,8,3,19,37,60,-23,27
Portadown,3034,10,6,8,16,26,47,-21,26
Ballinamalla,3034,11,7,4,19,32,59,-27,25
Crusaders,3035,1,18,7,5,52,32,20,61
Linfield,3035,2,15,11,4,59,29,30,56
Cliftonville,3035,3,12,8,10,47,38,9,44
Glenavon,3035,4,11,11,8,51,47,4,44
Ballymena,3035,5,12,5,13,53,60,-7,41
Dungannon,3035,6,9,10,11,54,48,6,37
Coleraine,3035,7,8,13,9,45,47,-2,37
Ards,3035,8,10,6,14,45,49,-4,36
Glentoran,3035,9,9,9,12,33,43,-10,36
Portadown,3035,10,8,7,15,25,49,-24,31
Ballinamalla,3035,11,7,5,18,32,54,-22,26
Linfield,3036,1,16,9,5,64,33,31,57
Crusaders,3036,2,15,8,7,55,35,20,53
Cliftonville,3036,3,16,5,9,56,44,12,53
Ballymena,3036,4,13,6,11,59,59,0,45
Glenavon,3036,5,11,9,10,49,52,-3,42
Coleraine,3036,6,10,11,9,52,50,2,41
Dungannon,3036,7,9,11,10,49,41,8,38
Ballinamalla,3036,8,10,5,15,35,46,-11,35
Ards,3036,9,9,7,14,38,52,-14,34
Portadown,3036,10,7,6,17,23,45,-22,27
Glentoran,3036,11,6,9,15,27,50,-23,27
Crusaders,3037,1,19,7,4,63,34,29,64
Ballymena,3037,2,15,6,9,67,59,8,51
Glenavon,3037,3,13,11,6,53,47,6,50
Cliftonville,3037,4,15,4,11,58,47,11,49
Linfield,3037,5,13,7,10,54,35,19,46
Coleraine,3037,6,10,9,11,44,50,-6,39
Dungannon,3037,7,8,11,11,47,46,1,35
Glentoran,3037,8,9,6,15,33,47,-14,33
Ballinamalla,3037,9,10,2,18,32,49,-17,32
Ards,3037,10,8,6,16,35,51,-16,30
Portadown,3037,11,8,5,17,23,44,-21,29
Crusaders,3038,1,16,9,5,55,33,22,57
Coleraine,3038,2,14,11,5,50,34,16,53
Cliftonville,3038,3,14,5,11,52,42,10,47
Ballymena,3038,4,14,5,11,57,58,-1,47
Linfield,3038,5,11,12,7,50,33,17,45
Glenavon,3038,6,11,10,9,49,45,4,43
Dungannon,3038,7,11,10,9,48,44,4,43
Glentoran,3038,8,9,8,13,31,39,-8,35
Ards,3038,9,9,6,15,37,45,-8,33
Ballinamalla,3038,10,6,6,18,28,52,-24,24
Portadown,3038,11,6,6,18,30,62,-32,24
Crusaders,3039,1,15,9,6,61,32,29,54
Coleraine,3039,2,13,12,5,47,36,11,51
Cliftonville,3039,3,15,5,10,47,33,14,50
Linfield,3039,4,13,9,8,60,42,18,48
Ballymena,3039,5,13,5,12,54,59,-5,44
Glenavon,3039,6,10,11,9,52,51,1,41
Dungannon,3039,7,9,12,9,48,38,10,39
Ballinamalla,3039,8,9,7,14,35,50,-15,34
Glentoran,3039,9,9,7,14,30,49,-19,34
Ards,3039,10,9,6,15,34,49,-15,33
Portadown,3039,11,5,7,18,23,52,-29,22
Crusaders,3040,1,18,6,6,63,39,24,60
Linfield,3040,2,17,7,6,64,33,31,58
Cliftonville,3040,3,15,5,10,50,40,10,50
Dungannon,3040,4,13,7,10,56,44,12,46
Coleraine,3040,5,11,9,10,44,39,5,42
Glenavon,3040,6,11,9,10,45,51,-6,42
Ballymena,3040,7,12,5,13,50,57,-7,41
Glentoran,3040,8,11,7,12,39,44,-5,40
Ards,3040,9,9,4,17,41,53,-12,31
Portadown,3040,10,7,5,18,28,54,-26,26
Ballinamalla,3040,11,6,6,18,32,58,-26,24
Linfield,3041,1,16,8,6,65,32,33,56
Ballymena,3041,2,15,6,9,64,64,0,51
Coleraine,3041,3,12,13,5,47,29,18,49
Crusaders,3041,4,13,8,9,51,35,16,47
Cliftonville,3041,5,14,5,11,56,50,6,47
Glenavon,3041,6,11,11,8,52,49,3,44
Dungannon,3041,7,9,12,9,52,42,10,39
Ards,3041,8,10,6,14,39,47,-8,36
Glentoran,3041,9,7,8,15,29,54,-25,29
Ballinamalla,3041,10,8,5,17,29,56,-27,29
Portadown,3041,11,6,6,18,27,53,-26,24
Crusaders,3042,1,16,11,3,62,38,24,59
Ballymena,3042,2,16,6,8,62,56,6,54
Linfield,3042,3,15,8,7,58,32,26,53
Coleraine,3042,4,12,11,7,49,38,11,47
Cliftonville,3042,5,13,3,14,52,49,3,42
Glenavon,3042,6,9,12,9,38,43,-5,39
Dungannon,3042,7,8,10,12,50,48,2,34
Glentoran,3042,8,7,11,12,29,44,-15,32
Ballinamalla,3042,9,9,5,16,36,52,-16,32
Portadown,3042,10,8,6,16,26,45,-19,30
Ards,3042,11,6,9,15,36,53,-17,27
Crusaders,3043,1,19,7,4,56,32,24,64
Cliftonville,3043,2,16,6,8,60,35,25,54
Linfield,3043,3,14,11,5,57,30,27,53
Coleraine,3043,4,12,12,6,46,34,12,48
Glenavon,3043,5,13,9,8,48,47,1,48
Ballymena,3043,6,12,7,11,54,56,-2,43
Dungannon,3043,7,8,11,11,46,46,0,35
Glentoran,3043,8,9,8,13,26,42,-16,35
Portadown,3043,9,7,6,17,27,48,-21,27
Ballinamalla,3043,10,7,6,17,25,48,-23,27
Ards,3043,11,4,5,21,29,56,-27,17
Linfield,3044,1,16,10,4,61,31,30,58
Crusaders,3044,2,14,7,9,48,37,11,49
Cliftonville,3044,3,14,7,9,49,42,7,49
Ballymena,3044,4,15,3,12,61,56,5,48
Coleraine,3044,5,13,8,9,47,40,7,47
Dungannon,3044,6,11,10,9,46,40,6,43
Glentoran,3044,7,10,8,12,38,42,-4,38
Glenavon,3044,8,9,10,11,50,54,-4,37
Ards,3044,9,8,8,14,38,47,-9,32
Ballinamalla,3044,10,8,5,17,29,49,-20,29
Portadown,3044,11,5,8,17,20,49,-29,23
Cliftonville,3045,1,16,5,9,54,35,19,53
Crusaders,3045,2,15,8,7,47,28,19,53
Glenavon,3045,3,14,8,8,46,43,3,50
Linfield,3045,4,14,7,9,59,37,22,49
Ballymena,3045,5,13,7,10,55,58,-3,46
Dungannon,3045,6,10,10,10,52,45,7,40
Coleraine,3045,7,9,9,12,38,42,-4,36
Glentoran,3045,8,9,9,12,27,37,-10,36
Portadown,3045,9,10,5,15,28,44,-16,35
Ballinamalla,3045,10,9,5,16,35,56,-21,32
Ards,3045,11,6,7,17,32,48,-16,25
Linfield,3046,1,14,10,6,62,34,28,52
Crusaders,3046,2,14,9,7,54,39,15,51
Cliftonville,3046,3,13,6,11,50,41,9,45
Ards,3046,4,12,7,11,51,47,4,43
Dungannon,3046,5,11,9,10,56,41,15,42
Ballymena,3046,6,11,8,11,49,57,-8,41
Glenavon,3046,7,9,12,9,45,48,-3,39
Coleraine,3046,8,8,13,9,43,46,-3,37
Glentoran,3046,9,10,7,13,31,49,-18,37
Portadown,3046,10,9,7,14,27,44,-17,34
Ballinamalla,3046,11,8,4,18,32,54,-22,28
Crusaders,3047,1,16,9,5,58,35,23,57
Linfield,3047,2,15,10,5,68,36,32,55
Cliftonville,3047,3,17,2,11,55,44,11,53
Glenavon,3047,4,14,10,6,51,36,15,52
Ballymena,3047,5,13,9,8,57,55,2,48
Coleraine,3047,6,12,9,9,48,46,2,45
Dungannon,3047,7,10,10,10,48,45,3,40
Glentoran,3047,8,9,11,10,41,46,-5,38
Ballinamalla,3047,9,6,5,19,29,55,-26,23
Portadown,3047,10,5,6,19,24,53,-29,21
Ards,3047,11,5,5,20,28,56,-28,20
Ballymena,3048,1,16,8,6,67,50,17,56
Crusaders,3048,2,14,10,6,54,36,18,52
Glenavon,3048,3,14,10,6,51,39,12,52
Linfield,3048,4,13,10,7,53,36,17,49
Coleraine,3048,5,13,10,7,46,34,12,49
Cliftonville,3048,6,14,5,11,54,43,11,47
Ballinamalla,3048,7,10,7,13,36,45,-9,37
Dungannon,3048,8,7,9,14,43,51,-8,30
Glentoran,3048,9,8,6,16,35,52,-17,30
Portadown,3048,10,8,4,18,31,58,-27,28
Ards,3048,11,5,7,18,27,53,-26,22
Linfield,3049,1,15,10,5,54,29,25,55
Cliftonville,3049,2,17,4,9,55,35,20,55
Crusaders,3049,3,15,7,8,48,36,12,52
Coleraine,3049,4,11,13,6,45,34,11,46
Ballymena,3049,5,13,5,12,52,64,-12,44
Dungannon,3049,6,11,10,9,52,42,10,43
Glenavon,3049,7,10,10,10,41,40,1,40
Glentoran,3049,8,9,10,11,33,40,-7,37
Ards,3049,9,9,6,15,33,46,-13,33
Portadown,3049,10,7,7,16,21,41,-20,28
Ballinamalla,3049,11,5,4,21,33,60,-27,19
Crusaders,3050,1,17,6,7,62,36,26,57
Coleraine,3050,2,14,12,4,55,38,17,54
Linfield,3050,3,15,8,7,59,34,25,53
Cliftonville,3050,4,13,7,10,51,45,6,46
Ballymena,3050,5,13,7,10,63,64,-1,46
Glenavon,3050,6,12,8,10,56,57,-1,44
Dungannon,3050,7,10,11,9,49,44,5,41
Ards,3050,8,8,7,15,41,54,-13,31
Glentoran,3050,9,7,9,14,28,45,-17,30
Ballinamalla,3050,10,7,4,19,30,53,-23,25
Portadown,3050,11,6,7,17,25,49,-24,25
Crusaders,3051,1,18,8,4,59,33,26,62
Cliftonville,3051,2,17,4,9,55,38,17,55
Linfield,3051,3,14,7,9,56,28,28,49
Glenavon,3051,4,12,9,9,42,43,-1,45
Ballymena,3051,5,12,7,11,53,55,-2,43
Coleraine,3051,6,10,10,10,39,38,1,40
Dungannon,3051,7,9,11,10,54,49,5,38
Portadown,3051,8,9,7,14,28,48,-20,34
Glentoran,3051,9,8,9,13,23,37,-14,33
Ards,3051,10,8,7,15,32,45,-13,31
Ballinamalla,3051,11,6,5,19,29,56,-27,23
Linfield,3052,1,17,9,4,63,26,37,60
Crusaders,3052,2,17,8,5,56,28,28,59
Cliftonville,3052,3,15,4,11,51,45,6,49
Coleraine,3052,4,12,11,7,41,35,6,47
Glenavon,3052,5,11,9,10,44,45,-1,42
Dungannon,3052,6,10,11,9,49,43,6,41
Ballymena,3052,7,12,4,14,54,62,-8,40
Ards,3052,8,10,4,16,40,51,-11,34
Portadown,3052,9,9,4,17,30,46,-16,31
Glentoran,3052,10,8,6,16,22,47,-25,30
Ballinamalla,3052,11,8,2,20,32,54,-22,26
Crusaders,3053,1,16,7,7,60,44,16,55
Ballymena,3053,2,16,5,9,63,58,5,53
Cliftonville,3053,3,14,9,7,64,41,23,51
Coleraine,3053,4,13,12,5,50,39,11,51
Linfield,3053,5,13,11,6,52,31,21,50
Glenavon,3053,6,9,14,7,52,51,1,41
Ards,3053,7,11,6,13,40,42,-2,39
Dungannon,3053,8,9,10,11,50,47,3,37
Ballinamalla,3053,9,8,4,18,29,50,-21,28
Portadown,3053,10,7,5,18,27,53,-26,26
Glentoran,3053,11,4,7,19,27,58,-31,19
Crusaders,3054,1,19,5,6,58,31,27,62
Cliftonville,3054,2,16,4,10,53,37,16,52
Ballymena,3054,3,15,4,11,64,66,-2,49
Coleraine,3054,4,13,8,9,41,33,8,47
Linfield,3054,5,13,7,10,53,34,19,46
Glenavon,3054,6,12,9,9,49,47,2,45
Glentoran,3054,7,10,7,13,31,41,-10,37
Dungannon,3054,8,9,8,13,45,49,-4,35
Ballinamalla,3054,9,10,3,17,27,49,-22,33
Portadown,3054,10,8,7,15,30,44,-14,31
Ards,3054,11,7,4,19,31,51,-20,25
Linfield,3055,1,16,9,5,60,31,29,57
Crusaders,3055,2,15,9,6,60,36,24,54
Ballymena,3055,3,14,7,9,58,55,3,49
Cliftonville,3055,4,14,6,10,53,42,11,48
Coleraine,3055,5,13,8,9,43,38,5,47
Glenavon,3055,6,12,9,9,46,43,3,45
Dungannon,3055,7,11,9,10,52,43,9,42
Ards,3055,8,9,5,16,36,50,-14,32
Glentoran,3055,9,7,11,12,27,46,-19,32
Portadown,3055,10,7,5,18,26,48,-22,26
Ballinamalla,3055,11,5,6,19,22,51,-29,21
Cliftonville,3056,1,17,3,10,56,39,17,54
Linfield,3056,2,15,8,7,63,34,29,53
Crusaders,3056,3,13,11,6,51,34,17,50
Coleraine,3056,4,12,10,8,49,40,9,46
Dungannon,3056,5,12,8,10,51,45,6,44
Glentoran,3056,6,11,7,12,40,44,-4,40
Glenavon,3056,7,10,10,10,46,53,-7,40
Ballymena,3056,8,12,4,14,50,67,-17,40
Ards,3056,9,9,5,16,43,53,-10,32
Ballinamalla,3056,10,8,5,17,29,49,-20,29
Portadown,3056,10,8,5,17,29,49,-20,29
Linfield,3057,1,17,8,5,60,26,34,59
Crusaders,3057,2,17,8,5,58,34,24,59
Glenavon,3057,3,15,10,5,49,36,13,55
Cliftonville,3057,4,16,4,10,55,41,14,52
Ballymena,3057,5,12,8,10,57,61,-4,44
Coleraine,3057,6,10,11,9,41,45,-4,41
Ards,3057,7,8,8,14,36,49,-13,32
Ballinamalla,3057,8,8,7,15,32,47,-15,31
Dungannon,3057,9,7,8,15,45,54,-9,29
Glentoran,3057,10,6,9,15,33,50,-17,27
Portadown,3057,11,6,5,19,24,47,-23,23
Crusaders,3058,1,19,7,4,60,33,27,64
Linfield,3058,2,14,11,5,59,28,31,53
Cliftonville,3058,3,13,10,7,55,40,15,49
Ballymena,3058,4,13,8,9,62,59,3,47
Coleraine,3058,5,11,12,7,48,49,-1,45
Dungannon,3058,6,9,11,10,48,43,5,38
Glenavon,3058,7,8,13,9,49,50,-1,37
Ards,3058,8,11,4,15,49,52,-3,37
Portadown,3058,9,9,4,17,27,45,-18,31
Glentoran,3058,10,6,10,14,28,49,-21,28
Ballinamalla,3058,11,6,2,22,27,64,-37,20
Linfield,3059,1,15,10,5,55,26,29,55
Crusaders,3059,2,14,8,8,54,40,14,50
Cliftonville,3059,3,13,7,10,51,42,9,46
Coleraine,3059,4,12,10,8,43,35,8,46
Glenavon,3059,5,12,9,9,50,48,2,45
Ballymena,3059,6,12,7,11,52,54,-2,43
Ards,3059,7,12,6,12,41,45,-4,42
Dungannon,3059,8,9,9,12,49,53,-4,36
Portadown,3059,9,8,8,14,32,47,-15,32
Ballinamalla,3059,10,8,5,17,36,51,-15,29
Glentoran,3059,11,6,9,15,24,46,-22,27
Crusaders,3060,1,15,10,5,61,37,24,55
Ballymena,3060,2,16,6,8,62,57,5,54
Linfield,3060,3,14,11,5,57,28,29,53
Cliftonville,3060,4,15,5,10,56,40,16,50
Coleraine,3060,5,13,11,6,45,37,8,50
Dungannon,3060,6,11,9,10,55,48,7,42
Glenavon,3060,7,9,11,10,43,49,-6,38
Glentoran,3060,8,9,8,13,34,50,-16,35
Ballinamalla,3060,9,8,5,17,35,55,-20,29
Ards,3060,10,7,5,18,38,52,-14,26
Portadown,3060,11,5,5,20,24,57,-33,20
Cliftonville,3061,1,18,5,7,61,30,31,59
Ballymena,3061,2,18,5,7,64,52,12,59
Linfield,3061,3,13,11,6,59,33,26,50
Crusaders,3061,4,13,9,8,53,41,12,48
Coleraine,3061,5,12,10,8,40,34,6,46
Dungannon,3061,6,12,8,10,54,47,7,44
Glentoran,3061,7,10,8,12,41,46,-5,38
Glenavon,3061,8,8,11,11,45,53,-8,35
Ballinamalla,3061,9,8,5,17,30,56,-26,29
Ards,3061,10,6,5,19,30,56,-26,23
Portadown,3061,11,6,5,19,27,56,-29,23
Linfield,3062,1,17,7,6,71,34,37,58
Crusaders,3062,2,16,8,6,58,35,23,56
Cliftonville,3062,3,15,6,9,50,36,14,51
Coleraine,3062,4,14,7,9,47,42,5,49
Glenavon,3062,5,12,9,9,50,52,-2,45
Ballymena,3062,6,12,5,13,57,59,-2,41
Dungannon,3062,7,9,10,11,45,45,0,37
Glentoran,3062,8,9,9,12,32,41,-9,36
Ards,3062,9,9,5,16,37,55,-18,32
Ballinamalla,3062,10,9,3,18,33,53,-20,30
Portadown,3062,11,5,7,18,22,50,-28,22
Linfield,3063,1,14,10,6,63,34,29,52
Crusaders,3063,2,14,9,7,57,45,12,51
Ballymena,3063,3,14,8,8,61,57,4,50
Cliftonville,3063,4,13,8,9,54,40,14,47
Coleraine,3063,5,11,12,7,50,38,12,45
Ards,3063,6,12,6,12,41,47,-6,42
Dungannon,3063,7,10,10,10,55,51,4,40
Glenavon,3063,8,10,10,10,48,50,-2,40
Portadown,3063,9,7,8,15,26,42,-16,29
Ballinamalla,3063,10,8,3,19,27,52,-25,27
Glentoran,3063,11,5,10,15,32,58,-26,25
Crusaders,3064,1,19,6,5,58,32,26,63
Linfield,3064,2,17,7,6,65,31,34,58
Ballymena,3064,3,16,4,10,52,51,1,52
Coleraine,3064,4,13,11,6,44,32,12,50
Cliftonville,3064,5,13,7,10,49,43,6,46
Portadown,3064,6,12,3,15,37,41,-4,39
Glenavon,3064,7,8,11,11,44,53,-9,35
Dungannon,3064,8,7,11,12,49,46,3,32
Ards,3064,9,8,5,17,30,48,-18,29
Glentoran,3064,10,7,6,17,27,49,-22,27
Ballinamalla,3064,11,7,5,18,32,61,-29,26
Linfield,3065,1,17,11,2,60,25,35,62
Crusaders,3065,2,16,7,7,55,36,19,55
Coleraine,3065,3,12,11,7,44,32,12,47
Cliftonville,3065,4,14,5,11,55,45,10,47
Glenavon,3065,5,11,10,9,41,43,-2,43
Ballymena,3065,6,12,4,14,56,59,-3,40
Dungannon,3065,7,9,10,11,54,48,6,37
Ards,3065,8,10,6,14,39,50,-11,36
Ballinamalla,3065,9,9,5,16,31,48,-17,32
Glentoran,3065,10,7,8,15,24,46,-22,29
Portadown,3065,11,7,5,18,25,52,-27,26
Crusaders,3066,1,17,8,5,63,38,25,59
Coleraine,3066,2,13,11,6,41,30,11,50
Linfield,3066,3,13,10,7,56,32,24,49
Ballymena,3066,4,13,8,9,53,47,6,47
Cliftonville,3066,5,14,5,11,50,44,6,47
Glenavon,3066,6,9,13,8,43,44,-1,40
Glentoran,3066,7,10,10,10,38,46,-8,40
Dungannon,3066,8,9,9,12,45,44,1,36
Portadown,3066,9,7,8,15,27,46,-19,29
Ards,3066,10,8,4,18,36,54,-18,28
Ballinamalla,3066,11,7,4,19,28,55,-27,25
Linfield,3067,1,17,8,5,68,36,32,59
Crusaders,3067,2,17,8,5,53,29,24,59
Cliftonville,3067,3,16,4,10,51,38,13,52
Coleraine,3067,4,14,9,7,48,37,11,51
Ballymena,3067,5,13,7,10,58,69,-11,46
Glenavon,3067,6,10,14,6,51,45,6,44
Dungannon,3067,7,10,7,13,50,47,3,37
Portadown,3067,8,9,7,14,34,47,-13,34
Glentoran,3067,9,7,6,17,28,45,-17,27
Ards,3067,10,7,4,19,35,56,-21,25
Ballinamalla,3067,11,7,2,21,29,56,-27,23
Crusaders,3068,1,19,6,5,58,30,28,63
Ballymena,3068,2,14,8,8,49,51,-2,50
Cliftonville,3068,3,14,7,9,50,35,15,49
Linfield,3068,4,12,11,7,57,35,22,47
Glenavon,3068,5,12,10,8,47,39,8,46
Coleraine,3068,6,8,13,9,40,43,-3,37
Glentoran,3068,7,10,7,13,29,43,-14,37
Dungannon,3068,8,8,11,11,51,54,-3,35
Ballinamalla,3068,9,9,4,17,37,52,-15,31
Portadown,3068,10,8,6,16,21,40,-19,30
Ards,3068,11,8,3,19,40,57,-17,27
Linfield,3069,1,15,11,4,61,28,33,56
Cliftonville,3069,2,16,6,8,52,40,12,54
Crusaders,3069,3,14,8,8,52,37,15,50
Coleraine,3069,4,13,9,8,51,42,9,48
Glenavon,3069,5,11,13,6,52,43,9,46
Ballymena,3069,6,13,7,10,60,59,1,46
Dungannon,3069,7,10,9,11,46,42,4,39
Ards,3069,8,10,7,13,44,45,-1,37
Ballinamalla,3069,9,7,6,17,28,55,-27,27
Portadown,3069,10,5,8,17,20,44,-24,23
Glentoran,3069,11,5,8,17,25,56,-31,23
Crusaders,3070,1,17,9,4,60,31,29,60
Linfield,3070,2,15,8,7,61,33,28,53
Cliftonville,3070,3,14,7,9,56,37,19,49
Glenavon,3070,4,11,13,6,49,45,4,46
Dungannon,3070,5,10,11,9,52,48,4,41
Coleraine,3070,6,9,10,11,38,41,-3,37
Glentoran,3070,7,10,7,13,30,43,-13,37
Portadown,3070,8,10,6,14,29,41,-12,36
Ballymena,3070,9,9,7,14,50,69,-19,34
Ards,3070,10,8,9,13,40,48,-8,33
Ballinamalla,3070,11,7,3,20,29,58,-29,24
Crusaders,3071,1,19,7,4,59,34,25,64
Linfield,3071,2,16,7,7,67,35,32,55
Cliftonville,3071,3,14,6,10,57,45,12,48
Glenavon,3071,4,11,12,7,47,40,7,45
Coleraine,3071,5,11,9,10,40,41,-1,42
Ballymena,3071,6,11,9,10,51,54,-3,42
Glentoran,3071,7,10,8,12,34,38,-4,38
Dungannon,3071,8,9,9,12,46,47,-1,36
Portadown,3071,9,9,5,16,24,44,-20,32
Ballinamalla,3071,10,8,6,16,31,51,-20,30
Ards,3071,11,6,4,20,29,56,-27,22
Crusaders,3072,1,19,9,2,63,28,35,66
Linfield,3072,2,17,10,3,67,36,31,61
Ballymena,3072,3,14,6,10,50,53,-3,48
Glenavon,3072,4,11,13,6,49,37,12,46
Cliftonville,3072,5,13,7,10,46,38,8,46
Coleraine,3072,6,9,13,8,36,35,1,40
Glentoran,3072,7,8,7,15,28,45,-17,31
Dungannon,3072,8,6,11,13,40,46,-6,29
Ards,3072,9,7,7,16,36,52,-16,28
Ballinamalla,3072,10,7,6,17,27,52,-25,27
Portadown,3072,11,5,9,16,24,44,-20,24
Crusaders,3073,1,17,6,7,53,41,12,57
Linfield,3073,2,15,7,8,58,35,23,52
Cliftonville,3073,3,15,6,9,49,33,16,51
Coleraine,3073,4,12,11,7,41,34,7,47
Glenavon,3073,5,12,11,7,44,40,4,47
Ballymena,3073,6,13,6,11,56,58,-2,45
Glentoran,3073,7,11,5,14,38,46,-8,38
Dungannon,3073,8,7,12,11,51,47,4,33
Ards,3073,9,10,3,17,43,56,-13,33
Ballinamalla,3073,10,8,4,18,34,52,-18,28
Portadown,3073,11,6,7,17,26,51,-25,25
Crusaders,3074,1,15,9,6,51,33,18,54
Cliftonville,3074,2,17,2,11,56,39,17,53
Coleraine,3074,3,15,8,7,44,35,9,53
Ballymena,3074,4,15,5,10,52,53,-1,50
Linfield,3074,5,14,7,9,54,35,19,49
Glenavon,3074,6,12,9,9,53,49,4,45
Glentoran,3074,7,12,6,12,31,35,-4,42
Ards,3074,8,8,7,15,34,44,-10,31
Dungannon,3074,9,7,9,14,46,51,-5,30
Portadown,3074,10,7,5,18,25,46,-21,26
Ballinamalla,3074,11,7,5,18,22,48,-26,26
Cliftonville,3075,1,17,7,6,56,33,23,58
Linfield,3075,2,15,8,7,60,34,26,53
Crusaders,3075,3,14,8,8,47,35,12,50
Coleraine,3075,4,12,10,8,50,43,7,46
Dungannon,3075,5,12,9,9,51,42,9,45
Ballymena,3075,6,13,4,13,55,63,-8,43
Glenavon,3075,7,10,11,9,48,47,1,41
Glentoran,3075,8,7,11,12,27,40,-13,32
Ballinamalla,3075,9,9,4,17,30,48,-18,31
Portadown,3075,10,7,8,15,31,51,-20,29
Ards,3075,11,7,4,19,32,51,-19,25
Crusaders,3076,1,18,7,5,57,36,21,61
Linfield,3076,2,15,9,6,65,35,30,54
Ballymena,3076,3,15,6,9,58,51,7,51
Cliftonville,3076,4,14,4,12,51,44,7,46
Glenavon,3076,5,11,10,9,45,45,0,43
Dungannon,3076,6,10,9,11,52,45,7,39
Coleraine,3076,7,9,10,11,34,36,-2,37
Glentoran,3076,8,9,7,14,30,46,-16,34
Ards,3076,9,10,3,17,32,45,-13,33
Ballinamalla,3076,10,8,6,16,27,47,-20,30
Portadown,3076,11,8,5,17,28,49,-21,29
Crusaders,3077,1,18,8,4,55,33,22,62
Ballymena,3077,2,16,5,9,55,53,2,53
Linfield,3077,3,14,10,6,61,34,27,52
Glenavon,3077,4,13,11,6,55,44,11,50
Cliftonville,3077,5,14,6,10,51,37,14,48
Dungannon,3077,6,9,10,11,49,44,5,37
Coleraine,3077,7,7,12,11,36,44,-8,33
Glentoran,3077,8,8,8,14,35,45,-10,32
Ards,3077,9,9,5,16,35,52,-17,32
Portadown,3077,10,6,8,16,23,45,-22,26
Ballinamalla,3077,11,7,5,18,27,51,-24,26
Crusaders,3078,1,16,9,5,57,37,20,57
Ballymena,3078,2,15,6,9,60,60,0,51
Dungannon,3078,3,14,8,8,60,37,23,50
Coleraine,3078,4,13,10,7,51,38,13,49
Linfield,3078,5,13,9,8,61,44,17,48
Glenavon,3078,6,10,13,7,51,45,6,43
Cliftonville,3078,7,13,3,14,45,48,-3,42
Ards,3078,8,10,3,17,41,53,-12,33
Portadown,3078,9,8,7,15,34,47,-13,31
Glentoran,3078,10,6,10,14,25,44,-19,28
Ballinamalla,3078,11,6,4,20,26,58,-32,22
Crusaders,3079,1,18,8,4,58,31,27,62
Linfield,3079,2,18,6,6,68,28,40,60
Coleraine,3079,3,12,12,6,38,32,6,48
Cliftonville,3079,4,13,7,10,53,45,8,46
Glenavon,3079,5,12,10,8,43,40,3,46
Ballymena,3079,6,13,6,11,58,64,-6,45
Portadown,3079,7,11,4,15,32,48,-16,37
Ards,3079,8,9,4,17,35,47,-12,31
Dungannon,3079,9,7,8,15,41,48,-7,29
Glentoran,3079,10,7,7,16,27,46,-19,28
Ballinamalla,3079,11,7,4,19,23,47,-24,25
Crusaders,3080,1,19,5,6,55,27,28,62
Ballymena,3080,2,17,4,9,65,59,6,55
Glenavon,3080,3,14,12,4,50,38,12,54
Linfield,3080,4,13,6,11,60,38,22,45
Cliftonville,3080,5,14,3,13,43,38,5,45
Ards,3080,6,14,3,13,38,42,-4,45
Coleraine,3080,7,11,8,11,48,50,-2,41
Dungannon,3080,8,10,8,12,43,42,1,38
Glentoran,3080,9,7,6,17,27,48,-21,27
Portadown,3080,10,7,5,18,25,48,-23,26
Ballinamalla,3080,11,6,6,18,24,48,-24,24
Crusaders,3081,1,19,6,5,59,30,29,63
Glenavon,3081,2,14,9,7,48,38,10,51
Linfield,3081,3,14,8,8,59,34,25,50
Dungannon,3081,4,14,6,10,56,40,16,48
Cliftonville,3081,5,14,5,11,55,43,12,47
Ballymena,3081,6,14,5,11,58,64,-6,47
Coleraine,3081,7,9,13,8,39,40,-1,40
Glentoran,3081,8,9,8,13,37,47,-10,35
Ballinamalla,3081,9,7,7,16,26,51,-25,28
Ards,3081,10,7,5,18,33,53,-20,26
Portadown,3081,11,6,4,20,23,53,-30,22
Crusaders,3082,1,18,5,7,63,42,21,59
Linfield,3082,2,16,7,7,56,31,25,55
Ballymena,3082,3,16,5,9,60,54,6,53
Glenavon,3082,4,12,9,9,47,47,0,45
Cliftonville,3082,5,12,6,12,51,44,7,42
Coleraine,3082,6,10,11,9,45,40,5,41
Portadown,3082,7,11,5,14,34,45,-11,38
Glentoran,3082,8,10,7,13,30,37,-7,37
Dungannon,3082,9,9,9,12,50,45,5,36
Ards,3082,10,10,2,18,31,52,-21,32
Ballinamalla,3082,11,6,4,20,23,53,-30,22
Cliftonville,3083,1,15,5,10,51,35,16,50
Glenavon,3083,2,13,11,6,50,44,6,50
Ballymena,3083,3,14,7,9,53,52,1,49
Crusaders,3083,4,13,7,10,46,40,6,46
Linfield,3083,5,11,10,9,52,35,17,43
Portadown,3083,6,11,6,13,27,37,-10,39
Ards,3083,7,11,5,14,46,47,-1,38
Dungannon,3083,8,8,11,11,43,40,3,35
Coleraine,3083,9,7,14,9,35,39,-4,35
Glentoran,3083,10,10,5,15,35,47,-12,35
Ballinamalla,3083,11,9,5,16,28,50,-22,32
Crusaders,3084,1,16,7,7,59,41,18,55
Ballymena,3084,2,17,4,9,64,52,12,55
Coleraine,3084,3,14,8,8,46,37,9,50
Linfield,3084,4,13,10,7,58,34,24,49
Dungannon,3084,5,13,9,8,59,40,19,48
Cliftonville,3084,6,13,4,13,39,48,-9,43
Glenavon,3084,7,9,7,14,41,51,-10,34
Portadown,3084,8,9,6,15,28,44,-16,33
Glentoran,3084,9,8,8,14,35,48,-13,32
Ballinamalla,3084,10,9,5,16,32,49,-17,32
Ards,3084,11,8,4,18,35,52,-17,28
Cliftonville,3085,1,16,5,9,53,39,14,53
Glenavon,3085,2,13,10,7,53,48,5,49
Coleraine,3085,3,12,11,7,54,41,13,47
Crusaders,3085,4,14,5,11,51,46,5,47
Ballymena,3085,5,14,4,12,60,59,1,46
Linfield,3085,6,12,9,9,53,36,17,45
Dungannon,3085,7,12,8,10,56,53,3,44
Glentoran,3085,8,9,9,12,37,43,-6,36
Ards,3085,9,9,6,15,45,55,-10,33
Portadown,3085,10,8,5,17,22,39,-17,29
Ballinamalla,3085,11,8,4,18,34,59,-25,28
Linfield,3086,1,15,8,7,55,29,26,53
Crusaders,3086,2,15,8,7,56,35,21,53
Cliftonville,3086,3,14,9,7,53,35,18,51
Ballymena,3086,4,15,5,10,53,55,-2,50
Dungannon,3086,5,10,9,11,47,45,2,39
Glenavon,3086,6,9,11,10,46,49,-3,38
Coleraine,3086,7,7,16,7,40,39,1,37
Glentoran,3086,8,8,11,11,32,42,-10,35
Ballinamalla,3086,9,10,5,15,38,52,-14,35
Portadown,3086,10,8,5,17,25,49,-24,29
Ards,3086,11,7,7,16,35,50,-15,28
Cliftonville,3087,1,18,6,6,56,34,22,60
Crusaders,3087,2,15,11,4,63,43,20,56
Linfield,3087,3,15,8,7,59,27,32,53
Coleraine,3087,4,12,9,9,45,41,4,45
Glenavon,3087,5,10,11,9,48,51,-3,41
Ballymena,3087,6,12,5,13,54,64,-10,41
Dungannon,3087,7,10,7,13,54,48,6,37
Ballinamalla,3087,8,9,7,14,36,52,-16,34
Glentoran,3087,9,8,7,15,34,58,-24,31
Ards,3087,10,8,5,17,40,50,-10,29
Portadown,3087,11,7,6,17,21,42,-21,27
Crusaders,3088,1,15,12,3,56,28,28,57
Linfield,3088,2,15,9,6,66,37,29,54
Ballymena,3088,3,14,8,8,66,58,8,50
Cliftonville,3088,4,14,4,12,51,50,1,46
Dungannon,3088,5,12,8,10,56,45,11,44
Glenavon,3088,6,10,12,8,52,47,5,42
Coleraine,3088,7,9,13,8,43,41,2,40
Ards,3088,8,9,5,16,38,53,-15,32
Glentoran,3088,9,7,9,14,29,49,-20,30
Ballinamalla,3088,10,9,3,18,26,49,-23,30
Portadown,3088,11,6,7,17,24,50,-26,25
Crusaders,3089,1,18,6,6,60,32,28,60
Cliftonville,3089,2,19,3,8,58,32,26,60
Linfield,3089,3,14,9,7,60,35,25,51
Ballymena,3089,4,13,9,8,53,57,-4,48
Glenavon,3089,5,12,11,7,54,42,12,47
Coleraine,3089,6,11,11,8,39,33,6,44
Dungannon,3089,7,8,11,11,46,45,1,35
Portadown,3089,8,8,7,15,30,49,-19,31
Ballinamalla,3089,9,9,3,18,33,58,-25,30
Glentoran,3089,10,6,8,16,23,46,-23,26
Ards,3089,11,5,6,19,31,58,-27,21
Crusaders,3090,1,15,10,5,54,37,17,55
Linfield,3090,2,14,9,7,56,26,30,51
Glenavon,3090,3,12,11,7,47,39,8,47
Cliftonville,3090,4,13,7,10,52,44,8,46
Ballymena,3090,5,13,6,11,58,58,0,45
Ards,3090,6,13,4,13,40,48,-8,43
Dungannon,3090,7,11,9,10,53,50,3,42
Ballinamalla,3090,8,11,3,16,41,47,-6,36
Glentoran,3090,9,8,7,15,30,49,-19,31
Coleraine,3090,10,7,9,14,36,49,-13,30
Portadown,3090,11,7,7,16,28,48,-20,28
Crusaders,3091,1,19,6,5,63,32,31,63
Cliftonville,3091,2,15,6,9,48,39,9,51
Glenavon,3091,3,14,8,8,49,39,10,50
Linfield,3091,4,13,9,8,54,35,19,48
Coleraine,3091,5,12,10,8,45,38,7,46
Dungannon,3091,6,11,11,8,51,38,13,44
Ballymena,3091,7,10,8,12,45,55,-10,38
Glentoran,3091,8,9,7,14,33,50,-17,34
Ards,3091,9,8,6,16,35,46,-11,30
Portadown,3091,10,7,5,18,30,56,-26,26
Ballinamalla,3091,11,7,4,19,26,51,-25,25
Cliftonville,3092,1,18,3,9,57,33,24,57
Linfield,3092,2,15,11,4,58,28,30,56
Glenavon,3092,3,13,12,5,46,35,11,51
Crusaders,3092,4,14,7,9,51,43,8,49
Coleraine,3092,5,13,8,9,44,35,9,47
Dungannon,3092,6,9,12,9,51,40,11,39
Ballymena,3092,7,11,4,15,53,66,-13,37
Glentoran,3092,8,9,9,12,31,42,-11,36
Ards,3092,9,9,8,13,42,50,-8,35
Portadown,3092,10,5,8,17,29,60,-31,23
Ballinamalla,3092,11,6,4,20,20,50,-30,22
Crusaders,3093,1,20,7,3,64,30,34,67
Cliftonville,3093,2,14,7,9,57,36,21,49
Linfield,3093,3,13,8,9,55,37,18,47
Ballymena,3093,4,13,8,9,51,51,0,47
Coleraine,3093,5,11,13,6,44,40,4,46
Glenavon,3093,6,10,12,8,46,44,2,42
Dungannon,3093,7,8,12,10,53,52,1,36
Portadown,3093,8,10,6,14,28,39,-11,36
Ards,3093,9,7,6,17,32,57,-25,27
Ballinamalla,3093,10,6,8,16,30,52,-22,26
Glentoran,3093,11,5,9,16,25,47,-22,24
Crusaders,3094,1,19,8,3,59,26,33,65
Linfield,3094,2,14,10,6,60,30,30,52
Ballymena,3094,3,16,4,10,61,60,1,52
Dungannon,3094,4,11,9,10,55,48,7,42
Glentoran,3094,5,11,8,11,33,37,-4,41
Coleraine,3094,6,10,10,10,44,45,-1,40
Ards,3094,7,12,3,15,43,48,-5,39
Glenavon,3094,8,10,8,12,44,50,-6,38
Cliftonville,3094,9,11,4,15,42,44,-2,37
Portadown,3094,10,7,6,17,22,48,-26,27
Ballinamalla,3094,11,8,2,20,27,54,-27,26
Crusaders,3095,1,15,8,7,60,45,15,53
Ballymena,3095,2,14,7,9,56,59,-3,49
Cliftonville,3095,3,14,6,10,58,42,16,48
Coleraine,3095,4,12,11,7,42,31,11,47
Linfield,3095,5,12,10,8,57,38,19,46
Glenavon,3095,6,11,11,8,46,50,-4,44
Dungannon,3095,7,12,7,11,53,37,16,43
Glentoran,3095,8,9,8,13,29,41,-12,35
Ards,3095,9,11,2,17,37,52,-15,35
Ballinamalla,3095,10,8,7,15,34,53,-19,31
Portadown,3095,11,6,5,19,21,45,-24,23
Linfield,3096,1,15,10,5,59,31,28,55
Crusaders,3096,2,15,8,7,56,40,16,53
Cliftonville,3096,3,16,5,9,56,41,15,53
Ballymena,3096,4,14,6,10,69,62,7,48
Coleraine,3096,5,12,8,10,49,50,-1,44
Glenavon,3096,6,10,11,9,52,54,-2,41
Glentoran,3096,7,11,7,12,35,47,-12,40
Dungannon,3096,8,9,10,11,51,41,10,37
Ards,3096,9,11,4,15,38,46,-8,37
Portadown,3096,10,6,7,17,18,46,-28,25
Ballinamalla,3096,11,7,2,21,29,54,-25,23
Crusaders,3097,1,18,9,3,62,29,33,63
Cliftonville,3097,2,17,3,10,56,38,18,54
Ballymena,3097,3,14,7,9,65,62,3,49
Glenavon,3097,4,13,9,8,51,45,6,48
Coleraine,3097,5,13,9,8,49,45,4,48
Linfield,3097,6,11,10,9,54,40,14,43
Ballinamalla,3097,7,10,4,16,37,51,-14,34
Dungannon,3097,8,8,9,13,39,47,-8,33
Glentoran,3097,9,8,8,14,33,50,-17,32
Portadown,3097,10,8,6,16,26,43,-17,30
Ards,3097,11,5,6,19,30,52,-22,21
Cliftonville,3098,1,20,2,8,57,33,24,62
Crusaders,3098,2,17,6,7,60,39,21,57
Linfield,3098,3,14,11,5,57,30,27,53
Coleraine,3098,4,13,9,8,44,37,7,48
Ballymena,3098,5,14,5,11,58,58,0,47
Dungannon,3098,6,10,8,12,47,41,6,38
Glenavon,3098,7,10,8,12,47,54,-7,38
Glentoran,3098,8,10,5,15,33,48,-15,35
Ballinamalla,3098,9,10,2,18,32,51,-19,32
Ards,3098,10,8,4,18,33,51,-18,28
Portadown,3098,11,6,6,18,25,51,-26,24
Crusaders,3099,1,19,8,3,55,29,26,65
Linfield,3099,2,15,9,6,55,28,27,54
Cliftonville,3099,3,15,4,11,48,37,11,49
Glenavon,3099,4,12,11,7,51,41,10,47
Ballymena,3099,5,12,6,12,54,55,-1,42
Coleraine,3099,6,11,9,10,40,42,-2,42
Dungannon,3099,7,8,10,12,44,43,1,34
Portadown,3099,8,9,7,14,26,40,-14,34
Glentoran,3099,9,8,8,14,28,48,-20,32
Ballinamalla,3099,10,7,7,16,32,52,-20,28
Ards,3099,11,7,5,18,37,55,-18,26
Crusaders,3100,1,18,7,5,60,31,29,61
Linfield,3100,2,15,9,6,51,23,28,54
Cliftonville,3100,3,14,7,9,49,34,15,49
Coleraine,3100,4,11,12,7,41,30,11,45
Glenavon,3100,5,10,12,8,48,51,-3,42
Ballymena,3100,6,11,7,12,55,64,-9,40
Dungannon,3100,7,9,8,13,46,46,0,35
Glentoran,3100,8,8,10,12,29,39,-10,34
Portadown,3100,9,9,6,15,33,43,-10,33
Ards,3100,10,9,4,17,34,57,-23,31
Ballinamalla,3100,11,7,6,17,28,56,-28,27
Linfield,3101,1,17,8,5,52,32,20,59
Coleraine,3101,2,16,8,6,49,33,16,56
Crusaders,3101,3,15,5,10,46,39,7,50
Glenavon,3101,4,12,10,8,58,47,11,46
Cliftonville,3101,5,13,6,11,54,49,5,45
Glentoran,3101,6,11,9,10,39,39,0,42
Dungannon,3101,7,9,10,11,49,42,7,37
Ballinamalla,3101,8,11,3,16,31,50,-19,36
Ballymena,3101,9,10,4,16,48,62,-14,34
Ards,3101,10,10,3,17,39,46,-7,33
Portadown,3101,11,6,4,20,24,50,-26,22
Crusaders,3102,1,19,8,3,59,26,33,65
Linfield,3102,2,14,11,5,59,30,29,53
Ballymena,3102,3,12,8,10,54,58,-4,44
Glenavon,3102,4,10,13,7,45,49,-4,43
Cliftonville,3102,5,12,6,12,47,40,7,42
Ards,3102,6,12,4,14,42,45,-3,40
Coleraine,3102,7,10,8,12,48,51,-3,38
Dungannon,3102,8,8,11,11,45,43,2,35
Glentoran,3102,9,9,7,14,23,42,-19,34
Ballinamalla,3102,10,9,5,16,27,43,-16,32
Portadown,3102,11,6,7,17,22,44,-22,25
Crusaders,3103,1,16,9,5,57,31,26,57
Dungannon,3103,2,14,8,8,56,40,16,50
Linfield,3103,3,12,13,5,57,32,25,49
Ballymena,3103,4,13,6,11,60,61,-1,45
Coleraine,3103,5,10,12,8,38,35,3,42
Cliftonville,3103,6,12,5,13,48,44,4,41
Glenavon,3103,7,9,12,9,47,52,-5,39
Ards,3103,8,10,6,14,44,51,-7,36
Glentoran,3103,9,9,9,12,39,53,-14,36
Portadown,3103,10,7,7,16,24,46,-22,28
Ballinamalla,3103,11,7,5,18,30,55,-25,26
Crusaders,3104,1,19,7,4,60,32,28,64
Cliftonville,3104,2,17,2,11,53,41,12,53
Glenavon,3104,3,14,10,6,49,41,8,52
Linfield,3104,4,12,12,6,53,32,21,48
Ballymena,3104,5,13,6,11,52,52,0,45
Coleraine,3104,6,11,10,9,39,37,2,43
Ballinamalla,3104,7,12,3,15,34,44,-10,39
Dungannon,3104,8,7,10,13,40,43,-3,31
Portadown,3104,9,8,6,16,28,42,-14,30
Glentoran,3104,10,8,6,16,27,51,-24,30
Ards,3104,11,6,4,20,30,50,-20,22
Ballymena,3105,1,18,4,8,63,50,13,58
Cliftonville,3105,2,17,3,10,53,37,16,54
Linfield,3105,3,14,9,7,56,32,24,51
Crusaders,3105,4,15,6,9,50,39,11,51
Dungannon,3105,5,13,7,10,61,42,19,46
Glenavon,3105,6,10,11,9,50,53,-3,41
Ards,3105,7,11,5,14,38,44,-6,38
Glentoran,3105,8,10,7,13,30,45,-15,37
Coleraine,3105,9,9,9,12,37,42,-5,36
Ballinamalla,3105,10,5,9,16,29,51,-22,24
Portadown,3105,11,4,8,18,20,52,-32,20
Crusaders,3106,1,16,11,3,55,29,26,59
Ballymena,3106,2,15,8,7,59,49,10,53
Linfield,3106,3,14,9,7,57,37,20,51
Cliftonville,3106,4,15,6,9,53,34,19,51
Coleraine,3106,5,10,14,6,46,38,8,44
Dungannon,3106,6,10,12,8,49,39,10,42
Portadown,3106,7,10,4,16,22,39,-17,34
Ards,3106,8,9,6,15,36,48,-12,33
Glenavon,3106,9,7,12,11,40,54,-14,33
Glentoran,3106,10,6,8,16,26,47,-21,26
Ballinamalla,3106,11,5,6,19,27,56,-29,21
Cliftonville,3107,1,15,8,7,60,41,19,53
Ballymena,3107,2,14,6,10,61,62,-1,48
Crusaders,3107,3,13,8,9,50,39,11,47
Glenavon,3107,4,12,10,8,48,44,4,46
Linfield,3107,5,11,9,10,47,35,12,42
Dungannon,3107,6,10,10,10,56,46,10,40
Coleraine,3107,7,9,12,9,38,41,-3,39
Portadown,3107,8,11,5,14,34,42,-8,38
Glentoran,3107,9,10,6,14,31,44,-13,36
Ballinamalla,3107,10,10,3,17,27,46,-19,33
Ards,3107,11,9,5,16,37,49,-12,32
Crusaders,3108,1,18,9,3,56,27,29,63
Linfield,3108,2,14,11,5,57,27,30,53
Cliftonville,3108,3,14,7,9,52,36,16,49
Coleraine,3108,4,14,7,9,46,43,3,49
Ballymena,3108,5,12,10,8,57,51,6,46
Glenavon,3108,6,10,14,6,43,45,-2,44
Dungannon,3108,7,10,9,11,47,38,9,39
Ards,3108,8,10,3,17,33,48,-15,33
Glentoran,3108,9,7,9,14,27,42,-15,30
Ballinamalla,3108,10,7,5,18,31,55,-24,26
Portadown,3108,11,4,6,20,18,55,-37,18
Linfield,3109,1,15,8,7,62,33,29,53
Crusaders,3109,2,15,8,7,58,38,20,53
Cliftonville,3109,3,16,4,10,49,37,12,52
Dungannon,3109,4,14,8,8,60,44,16,50
Coleraine,3109,5,12,9,9,41,38,3,45
Ballymena,3109,6,13,5,12,58,60,-2,44
Glenavon,3109,7,9,14,7,44,46,-2,41
Glentoran,3109,8,10,7,13,33,45,-12,37
Ards,3109,9,8,6,16,34,53,-19,30
Portadown,3109,10,7,8,15,26,42,-16,29
Ballinamalla,3109,11,5,5,20,21,50,-29,20
Crusaders,3110,1,16,8,6,53,33,20,56
Linfield,3110,2,15,10,5,62,29,33,55
Dungannon,3110,3,13,10,7,53,39,14,49
Cliftonville,3110,4,14,6,10,51,39,12,48
Glenavon,3110,5,10,13,7,49,42,7,43
Coleraine,3110,6,10,9,11,37,44,-7,39
Ballymena,3110,7,10,7,13,49,59,-10,37
Portadown,3110,8,9,6,15,23,42,-19,33
Ballinamalla,3110,9,9,5,16,34,49,-15,32
Glentoran,3110,10,7,9,14,24,45,-21,30
Ards,3110,11,6,9,15,32,46,-14,27
Crusaders,3111,1,17,8,5,53,30,23,59
Ballymena,3111,2,16,4,10,64,53,11,52
Linfield,3111,3,13,10,7,57,42,15,49
Glenavon,3111,4,11,11,8,52,44,8,44
Cliftonville,3111,5,12,7,11,50,45,5,43
Coleraine,3111,6,10,12,8,43,38,5,42
Glentoran,3111,7,10,8,12,35,46,-11,38
Dungannon,3111,8,9,10,11,51,48,3,37
Portadown,3111,9,10,3,17,32,50,-18,33
Ards,3111,10,8,5,17,29,47,-18,29
Ballinamalla,3111,11,7,6,17,31,54,-23,27
Linfield,3112,1,16,9,5,62,29,33,57
Crusaders,3112,2,16,9,5,60,33,27,57
Glenavon,3112,3,11,14,5,46,36,10,47
Cliftonville,3112,4,13,5,12,50,43,7,44
Coleraine,3112,5,11,11,8,47,42,5,44
Ballymena,3112,6,12,8,10,56,62,-6,44
Dungannon,3112,7,11,10,9,48,40,8,43
Ards,3112,8,8,6,16,38,59,-21,30
Glentoran,3112,9,7,7,16,25,45,-20,28
Ballinamalla,3112,10,7,7,16,29,51,-22,28
Portadown,3112,11,6,8,16,23,44,-21,26
Crusaders,3113,1,16,9,5,57,32,25,57
Linfield,3113,2,15,9,6,53,33,20,54
Cliftonville,3113,3,16,5,9,56,38,18,53
Ballymena,3113,4,15,5,10,53,49,4,50
Coleraine,3113,5,11,12,7,43,37,6,45
Dungannon,3113,6,8,13,9,49,40,9,37
Glenavon,3113,7,7,15,8,43,49,-6,36
Ards,3113,8,10,6,14,40,49,-9,36
Glentoran,3113,9,10,5,15,29,44,-15,35
Portadown,3113,10,5,8,17,22,47,-25,23
Ballinamalla,3113,11,6,5,19,31,58,-27,23
Crusaders,3114,1,15,9,6,58,34,24,54
Ballymena,3114,2,15,8,7,68,56,12,53
Glenavon,3114,3,12,11,7,51,47,4,47
Dungannon,3114,4,12,10,8,57,44,13,46
Cliftonville,3114,5,13,6,11,49,41,8,45
Coleraine,3114,6,12,9,9,46,39,7,45
Linfield,3114,7,11,8,11,58,45,13,41
Ballinamalla,3114,8,10,5,15,41,53,-12,35
Glentoran,3114,9,9,6,15,31,54,-23,33
Ards,3114,10,9,4,17,38,55,-17,31
Portadown,3114,11,7,4,19,25,54,-29,25
Crusaders,3115,1,17,7,6,57,28,29,58
Linfield,3115,2,16,9,5,66,31,35,57
Cliftonville,3115,3,16,4,10,52,41,11,52
Coleraine,3115,4,10,11,9,42,41,1,41
Ballymena,3115,5,12,5,13,53,62,-9,41
Glenavon,3115,6,10,10,10,41,52,-11,40
Dungannon,3115,7,9,11,10,46,47,-1,38
Glentoran,3115,8,10,8,12,35,43,-8,38
Ballinamalla,3115,9,9,6,15,30,44,-14,33
Portadown,3115,10,8,5,17,27,47,-20,29
Ards,3115,11,7,6,17,38,51,-13,27
Linfield,3116,1,15,8,7,61,37,24,53
Cliftonville,3116,2,16,4,10,52,39,13,52
Coleraine,3116,3,13,11,6,44,33,11,50
Glenavon,3116,4,13,10,7,55,40,15,49
Crusaders,3116,5,13,6,11,44,41,3,45
Ards,3116,6,13,5,12,47,49,-2,44
Dungannon,3116,7,10,11,9,57,43,14,41
Ballymena,3116,8,11,5,14,47,57,-10,38
Portadown,3116,9,7,7,16,28,49,-21,28
Glentoran,3116,10,7,7,16,21,42,-21,28
Ballinamalla,3116,11,7,6,17,32,58,-26,27
Linfield,3117,1,16,7,7,66,31,35,55
Cliftonville,3117,2,16,5,9,56,40,16,53
Crusaders,3117,3,14,10,6,48,36,12,52
Ballymena,3117,4,14,7,9,60,54,6,49
Glenavon,3117,5,11,13,6,50,43,7,46
Coleraine,3117,6,11,11,8,40,39,1,44
Dungannon,3117,7,9,11,10,46,44,2,38
Ards,3117,8,10,6,14,45,50,-5,36
Ballinamalla,3117,9,8,5,17,29,47,-18,29
Portadown,3117,10,7,5,18,27,51,-24,26
Glentoran,3117,11,4,10,16,23,55,-32,22
Crusaders,3118,1,18,8,4,59,36,23,62
Coleraine,3118,2,14,10,6,50,37,13,52
Ballymena,3118,3,14,7,9,55,54,1,49
Cliftonville,3118,4,13,7,10,52,39,13,46
Linfield,3118,5,11,11,8,52,34,18,44
Glenavon,3118,6,8,13,9,48,49,-1,37
Dungannon,3118,7,8,11,11,44,48,-4,35
Glentoran,3118,8,8,10,12,32,41,-9,34
Ards,3118,9,10,4,16,35,45,-10,34
Ballinamalla,3118,10,7,9,14,28,47,-19,30
Portadown,3118,11,6,6,18,22,47,-25,24
Crusaders,3119,1,19,7,4,57,25,32,64
Cliftonville,3119,2,19,3,8,53,33,20,60
Linfield,3119,3,16,9,5,65,28,37,57
Glenavon,3119,4,11,12,7,44,35,9,45
Dungannon,3119,5,10,11,9,47,43,4,41
Ballymena,3119,6,12,4,14,47,62,-15,40
Coleraine,3119,7,10,9,11,38,42,-4,39
Glentoran,3119,8,9,8,13,29,42,-13,35
Ballinamalla,3119,9,8,5,17,30,56,-26,29
Ards,3119,10,7,5,18,31,51,-20,26
Portadown,3119,11,6,3,21,19,43,-24,21
Crusaders,3120,1,18,6,6,54,27,27,60
Cliftonville,3120,2,17,7,6,52,31,21,58
Linfield,3120,3,16,7,7,66,32,34,55
Glenavon,3120,4,13,11,6,57,42,15,50
Ballymena,3120,5,14,5,11,54,57,-3,47
Dungannon,3120,6,11,9,10,49,41,8,42
Coleraine,3120,7,10,9,11,40,46,-6,39
Ards,3120,8,10,2,18,39,57,-18,32
Glentoran,3120,9,8,6,16,31,47,-16,30
Portadown,3120,10,7,6,17,21,48,-27,27
Ballinamalla,3120,11,5,4,21,27,62,-35,19
Linfield,3121,1,15,10,5,66,31,35,55
Crusaders,3121,2,14,12,4,49,32,17,54
Ballymena,3121,3,16,5,9,61,55,6,53
Cliftonville,3121,4,16,3,11,47,38,9,51
Glenavon,3121,5,11,10,9,46,45,1,43
Coleraine,3121,6,10,12,8,41,33,8,42
Dungannon,3121,7,11,8,11,57,47,10,41
Portadown,3121,8,9,6,15,29,45,-16,33
Ards,3121,9,8,7,15,37,50,-13,31
Glentoran,3121,10,6,9,15,26,51,-25,27
Ballinamalla,3121,11,5,6,19,24,56,-32,21
Crusaders,3122,1,15,10,5,56,34,22,55
Coleraine,3122,2,15,10,5,45,28,17,55
Cliftonville,3122,3,15,3,12,52,46,6,48
Ballymena,3122,4,13,8,9,60,61,-1,47
Linfield,3122,5,11,11,8,57,38,19,44
Glenavon,3122,6,11,8,11,51,51,0,41
Dungannon,3122,7,9,11,10,47,47,0,38
Ards,3122,8,10,7,13,37,43,-6,37
Glentoran,3122,9,7,9,14,34,48,-14,30
Portadown,3122,10,8,5,17,30,50,-20,29
Ballinamalla,3122,11,7,6,17,30,53,-23,27
Cliftonville,3123,1,17,4,9,60,37,23,55
Crusaders,3123,2,14,10,6,49,37,12,52
Ballymena,3123,3,15,7,8,60,55,5,52
Glenavon,3123,4,13,11,6,52,41,11,50
Linfield,3123,5,12,10,8,53,37,16,46
Dungannon,3123,6,9,10,11,44,45,-1,37
Ards,3123,7,11,3,16,37,43,-6,36
Coleraine,3123,8,7,12,11,42,51,-9,33
Glentoran,3123,9,8,9,13,36,47,-11,33
Ballinamalla,3123,10,7,10,13,25,40,-15,31
Portadown,3123,11,6,6,18,23,48,-25,24
Crusaders,3124,1,19,5,6,62,32,30,62
Linfield,3124,2,15,11,4,65,34,31,56
Ballymena,3124,3,13,8,9,58,60,-2,47
Glenavon,3124,4,12,9,9,51,49,2,45
Cliftonville,3124,5,13,5,12,51,45,6,44
Dungannon,3124,6,10,10,10,52,39,13,40
Coleraine,3124,7,10,10,10,42,44,-2,40
Portadown,3124,8,10,6,14,37,47,-10,36
Ards,3124,9,10,5,15,40,53,-13,35
Glentoran,3124,10,7,6,17,31,55,-24,27
Ballinamalla,3124,11,7,3,20,36,67,-31,24
Linfield,3125,1,14,13,3,65,32,33,55
Crusaders,3125,2,15,10,5,60,45,15,55
Cliftonville,3125,3,15,6,9,54,40,14,51
Ballymena,3125,4,14,6,10,64,55,9,48
Dungannon,3125,5,13,7,10,65,52,13,46
Glenavon,3125,6,11,10,9,59,57,2,43
Glentoran,3125,7,9,9,12,33,42,-9,36
Coleraine,3125,8,9,9,12,38,52,-14,36
Ards,3125,9,8,6,16,41,51,-10,30
Portadown,3125,10,7,6,17,28,55,-27,27
Ballinamalla,3125,11,8,2,20,31,57,-26,26
Crusaders,3126,1,16,7,7,51,35,16,55
Cliftonville,3126,2,16,6,8,56,39,17,54
Ballymena,3126,3,15,4,11,67,60,7,49
Glenavon,3126,4,12,10,8,48,42,6,46
Linfield,3126,5,11,12,7,54,33,21,45
Dungannon,3126,6,10,12,8,55,44,11,42
Ards,3126,7,12,5,13,38,43,-5,41
Coleraine,3126,8,10,10,10,40,43,-3,40
Glentoran,3126,9,8,7,15,27,50,-23,31
Portadown,3126,10,6,7,17,28,48,-20,25
Ballinamalla,3126,11,7,4,19,23,50,-27,25
Linfield,3127,1,14,11,5,51,25,26,53
Crusaders,3127,2,16,5,9,58,39,19,53
Cliftonville,3127,3,15,6,9,50,36,14,51
Glenavon,3127,4,12,12,6,47,42,5,48
Ballymena,3127,5,12,7,11,54,60,-6,43
Coleraine,3127,6,9,12,9,39,40,-1,39
Dungannon,3127,7,9,11,10,45,44,1,38
Ards,3127,8,9,5,16,40,47,-7,32
Portadown,3127,9,8,7,15,25,41,-16,31
Glentoran,3127,10,7,10,13,28,46,-18,31
Ballinamalla,3127,11,8,6,16,32,49,-17,30
Crusaders,3128,1,18,4,8,56,33,23,58
Linfield,3128,2,16,8,6,65,36,29,56
Cliftonville,3128,3,16,4,10,45,33,12,52
Ballymena,3128,4,14,5,11,60,61,-1,47
Coleraine,3128,5,12,10,8,46,37,9,46
Glenavon,3128,6,12,8,10,51,50,1,44
Dungannon,3128,7,10,12,8,51,41,10,42
Glentoran,3128,8,9,6,15,33,51,-18,33
Ballinamalla,3128,9,9,4,17,29,48,-19,31
Ards,3128,10,8,4,18,34,54,-20,28
Portadown,3128,11,6,5,19,22,48,-26,23
Linfield,3129,1,15,7,8,56,30,26,52
Cliftonville,3129,2,16,3,11,53,37,16,51
Coleraine,3129,3,13,11,6,48,37,11,50
Crusaders,3129,4,13,8,9,47,37,10,47
Glenavon,3129,5,12,10,8,51,50,1,46
Ballymena,3129,6,13,7,10,60,60,0,46
Ballinamalla,3129,7,12,4,14,37,44,-7,40
Glentoran,3129,8,10,5,15,29,44,-15,35
Dungannon,3129,9,9,7,14,48,49,-1,34
Portadown,3129,10,9,5,16,26,47,-21,32
Ards,3129,11,8,3,19,30,50,-20,27
Crusaders,3130,1,18,5,7,63,36,27,59
Cliftonville,3130,2,18,4,8,59,35,24,58
Linfield,3130,3,14,10,6,60,32,28,52
Ballymena,3130,4,14,6,10,60,57,3,48
Glenavon,3130,5,12,11,7,46,43,3,47
Coleraine,3130,6,12,9,9,42,40,2,45
Dungannon,3130,7,8,12,10,47,49,-2,36
Ballinamalla,3130,8,10,3,17,29,49,-20,33
Glentoran,3130,9,7,7,16,34,52,-18,28
Ards,3130,10,8,4,18,33,53,-20,28
Portadown,3130,11,5,7,18,23,50,-27,22
Crusaders,3131,1,15,7,8,56,45,11,52
Cliftonville,3131,2,15,6,9,58,40,18,51
Linfield,3131,3,13,9,8,57,37,20,48
Glenavon,3131,4,13,9,8,47,41,6,48
Ballymena,3131,5,13,8,9,52,46,6,47
Coleraine,3131,6,11,11,8,40,37,3,44
Portadown,3131,7,10,7,13,23,36,-13,37
Dungannon,3131,8,8,10,12,48,45,3,34
Ballinamalla,3131,9,9,4,17,27,54,-27,31
Ards,3131,10,8,6,16,31,44,-13,30
Glentoran,3131,11,6,11,13,30,44,-14,29
Crusaders,3132,1,18,6,6,61,34,27,60
Linfield,3132,2,15,9,6,58,34,24,54
Dungannon,3132,3,14,8,8,61,41,20,50
Glenavon,3132,4,14,8,8,64,47,17,50
Ballymena,3132,5,14,5,11,61,62,-1,47
Cliftonville,3132,6,11,6,13,49,46,3,39
Coleraine,3132,7,10,9,11,39,50,-11,39
Ards,3132,8,10,3,17,38,52,-14,33
Portadown,3132,9,9,4,17,27,48,-21,31
Ballinamalla,3132,10,9,3,18,34,54,-20,30
Glentoran,3132,11,7,7,16,31,55,-24,28
Crusaders,3133,1,18,9,3,66,35,31,63
Glenavon,3133,2,14,11,5,56,42,14,53
Linfield,3133,3,14,9,7,58,29,29,51
Ballymena,3133,4,14,7,9,60,61,-1,49
Cliftonville,3133,5,14,6,10,56,40,16,48
Coleraine,3133,6,11,11,8,45,40,5,44
Glentoran,3133,7,9,8,13,31,47,-16,35
Dungannon,3133,8,8,10,12,45,47,-2,34
Portadown,3133,9,7,8,15,26,45,-19,29
Ards,3133,10,6,5,19,35,59,-24,23
Ballinamalla,3133,11,6,4,20,29,62,-33,22
Crusaders,3134,1,18,7,5,56,30,26,61
Cliftonville,3134,2,15,6,9,53,34,19,51
Ballymena,3134,3,14,7,9,58,57,1,49
Dungannon,3134,4,13,9,8,51,36,15,48
Linfield,3134,5,13,8,9,59,38,21,47
Coleraine,3134,6,12,10,8,45,37,8,46
Glenavon,3134,7,9,11,10,42,47,-5,38
Ards,3134,8,9,7,14,36,51,-15,34
Glentoran,3134,9,7,9,14,31,50,-19,30
Ballinamalla,3134,10,6,6,18,30,54,-24,24
Portadown,3134,11,6,6,18,27,54,-27,24
Crusaders,3135,1,14,10,6,51,33,18,52
Cliftonville,3135,2,16,2,12,57,47,10,50
Linfield,3135,3,12,13,5,59,34,25,49
Ballymena,3135,4,14,7,9,64,62,2,49
Glenavon,3135,5,13,9,8,50,42,8,48
Coleraine,3135,6,10,9,11,42,44,-2,39
Glentoran,3135,7,10,9,11,37,50,-13,39
Dungannon,3135,8,9,10,11,58,52,6,37
Ards,3135,9,10,7,13,43,51,-8,37
Portadown,3135,10,7,5,18,30,52,-22,26
Ballinamalla,3135,11,7,5,18,32,56,-24,26
Crusaders,3136,1,17,7,6,58,35,23,58
Coleraine,3136,2,14,11,5,49,34,15,53
Ballymena,3136,3,16,5,9,60,57,3,53
Linfield,3136,4,13,11,6,67,38,29,50
Cliftonville,3136,5,15,5,10,51,41,10,50
Dungannon,3136,6,12,7,11,56,38,18,43
Glenavon,3136,7,11,10,9,46,48,-2,43
Glentoran,3136,8,11,5,14,33,49,-16,38
Ards,3136,9,6,6,18,33,54,-21,24
Ballinamalla,3136,10,7,3,20,23,58,-35,24
Portadown,3136,11,4,8,18,18,42,-24,20
Crusaders,3137,1,15,8,7,59,35,24,53
Cliftonville,3137,2,15,8,7,60,40,20,53
Glenavon,3137,3,13,11,6,47,45,2,50
Linfield,3137,4,12,11,7,54,37,17,47
Dungannon,3137,5,10,14,6,53,42,11,44
Coleraine,3137,6,10,13,7,40,38,2,43
Ballymena,3137,7,11,9,10,56,55,1,42
Ards,3137,8,10,4,16,42,53,-11,34
Glentoran,3137,9,9,7,14,26,39,-13,34
Portadown,3137,10,8,5,17,28,48,-20,29
Ballinamalla,3137,11,5,4,21,24,57,-33,19
Crusaders,3138,1,18,6,6,57,31,26,60
Cliftonville,3138,2,17,4,9,55,30,25,55
Coleraine,3138,3,13,9,8,42,38,4,48
Linfield,3138,4,13,8,9,52,34,18,47
Dungannon,3138,5,11,8,11,47,43,4,41
Glentoran,3138,6,12,4,14,37,49,-12,40
Ballymena,3138,7,12,3,15,55,70,-15,39
Portadown,3138,8,11,2,17,28,42,-14,35
Ards,3138,9,9,7,14,35,43,-8,34
Glenavon,3138,10,8,10,12,39,49,-10,34
Ballinamalla,3138,11,9,3,18,32,50,-18,30
Crusaders,3139,1,17,8,5,54,28,26,59
Linfield,3139,2,16,7,7,64,32,32,55
Ballymena,3139,3,16,6,8,56,52,4,54
Cliftonville,3139,4,16,4,10,59,48,11,52
Glenavon,3139,5,11,9,10,50,47,3,42
Coleraine,3139,6,10,11,9,42,37,5,41
Dungannon,3139,7,10,7,13,51,48,3,37
Glentoran,3139,8,9,7,14,30,50,-20,34
Ards,3139,9,9,6,15,38,49,-11,33
Ballinamalla,3139,10,9,2,19,29,53,-24,29
Portadown,3139,11,6,5,19,20,49,-29,23
Crusaders,3140,1,20,7,3,60,26,34,67
Linfield,3140,2,13,12,5,53,25,28,51
Glenavon,3140,3,14,9,7,50,39,11,51
Cliftonville,3140,4,14,6,10,47,39,8,48
Ballymena,3140,5,14,6,10,56,63,-7,48
Coleraine,3140,6,10,11,9,41,37,4,41
Dungannon,3140,7,9,7,14,46,47,-1,34
Ballinamalla,3140,8,10,4,16,30,48,-18,34
Glentoran,3140,9,8,6,16,32,47,-15,30
Ards,3140,10,7,7,16,32,49,-17,28
Portadown,3140,11,5,7,18,24,51,-27,22
Linfield,3141,1,16,7,7,65,33,32,55
Cliftonville,3141,2,16,7,7,50,36,14,55
Dungannon,3141,3,15,8,7,67,42,25,53
Crusaders,3141,4,14,6,10,52,45,7,48
Glenavon,3141,5,10,12,8,46,47,-1,42
Coleraine,3141,6,9,14,7,49,43,6,41
Ballymena,3141,7,10,9,11,55,63,-8,39
Glentoran,3141,8,10,8,12,34,47,-13,38
Ards,3141,9,7,9,14,39,49,-10,30
Portadown,3141,10,5,8,17,19,45,-26,23
Ballinamalla,3141,11,4,10,16,30,56,-26,22
Coleraine,3142,1,17,8,5,51,35,16,59
Crusaders,3142,2,17,5,8,56,34,22,56
Cliftonville,3142,3,14,7,9,50,32,18,49
Linfield,3142,4,11,12,7,56,34,22,45
Ballymena,3142,5,13,6,11,61,60,1,45
Dungannon,3142,6,11,10,9,52,45,7,43
Glenavon,3142,7,10,10,10,43,56,-13,40
Glentoran,3142,8,9,11,10,33,41,-8,38
Ballinamalla,3142,9,9,5,16,35,52,-17,32
Ards,3142,10,7,7,16,34,51,-17,28
Portadown,3142,11,4,5,21,23,54,-31,17
Linfield,3143,1,16,8,6,68,31,37,56
Ballymena,3143,2,15,5,10,62,56,6,50
Coleraine,3143,3,12,11,7,43,39,4,47
Crusaders,3143,4,13,6,11,48,45,3,45
Cliftonville,3143,5,12,5,13,41,37,4,41
Ards,3143,6,12,5,13,39,46,-7,41
Glenavon,3143,7,9,13,8,50,48,2,40
Dungannon,3143,8,8,11,11,45,51,-6,35
Portadown,3143,9,10,4,16,28,40,-12,34
Glentoran,3143,10,9,7,14,30,46,-16,34
Ballinamalla,3143,11,9,5,16,36,51,-15,32
Crusaders,3144,1,18,7,5,56,29,27,61
Cliftonville,3144,2,17,5,8,55,33,22,56
Ballymena,3144,3,17,4,9,60,52,8,55
Linfield,3144,4,13,9,8,56,35,21,48
Glenavon,3144,5,11,9,10,47,45,2,42
Ards,3144,6,12,4,14,47,52,-5,40
Coleraine,3144,7,9,11,10,35,44,-9,38
Dungannon,3144,8,7,13,10,42,40,2,34
Ballinamalla,3144,9,8,6,16,32,50,-18,30
Glentoran,3144,10,6,9,15,27,45,-18,27
Portadown,3144,11,6,5,19,19,51,-32,23
Crusaders,3145,1,17,8,5,59,35,24,59
Cliftonville,3145,2,15,5,10,52,41,11,50
Linfield,3145,3,13,7,10,51,30,21,46
Glenavon,3145,4,10,13,7,48,47,1,43
Dungannon,3145,5,10,10,10,45,36,9,40
Glentoran,3145,6,12,4,14,33,42,-9,40
Ballymena,3145,7,12,4,14,50,61,-11,40
Ballinamalla,3145,8,11,6,13,34,42,-8,39
Ards,3145,9,12,3,15,38,48,-10,39
Coleraine,3145,10,8,11,11,40,44,-4,35
Portadown,3145,11,5,9,16,21,45,-24,24
Crusaders,3146,1,17,5,8,54,35,19,56
Linfield,3146,2,14,8,8,57,39,18,50
Ards,3146,3,15,4,11,49,42,7,49
Coleraine,3146,4,12,10,8,48,38,10,46
Cliftonville,3146,5,13,5,12,46,44,2,44
Ballymena,3146,6,12,8,10,54,54,0,44
Glenavon,3146,7,10,11,9,39,37,2,41
Glentoran,3146,8,9,8,13,29,43,-14,35
Dungannon,3146,9,8,10,12,55,51,4,34
Portadown,3146,10,8,5,17,24,43,-19,29
Ballinamalla,3146,11,8,4,18,35,64,-29,28
Ballymena,3147,1,18,4,8,61,54,7,58
Linfield,3147,2,14,9,7,58,35,23,51
Crusaders,3147,3,13,9,8,52,44,8,48
Cliftonville,3147,4,14,5,11,49,42,7,47
Glenavon,3147,5,12,9,9,49,40,9,45
Dungannon,3147,6,11,9,10,50,39,11,42
Coleraine,3147,7,10,9,11,44,47,-3,39
Glentoran,3147,8,11,5,14,35,45,-10,38
Ards,3147,9,9,6,15,38,49,-11,33
Ballinamalla,3147,10,8,5,17,38,56,-18,29
Portadown,3147,11,8,4,18,23,46,-23,28
Linfield,3148,1,16,8,6,63,28,35,56
Crusaders,3148,2,16,8,6,59,36,23,56
Ballymena,3148,3,16,7,7,58,49,9,55
Cliftonville,3148,4,12,7,11,43,41,2,43
Coleraine,3148,5,10,11,9,38,38,0,41
Glenavon,3148,6,10,10,10,45,48,-3,40
Dungannon,3148,7,9,11,10,47,43,4,38
Ards,3148,8,10,6,14,39,49,-10,36
Glentoran,3148,9,9,8,13,34,49,-15,35
Portadown,3148,10,8,6,16,25,42,-17,30
Ballinamalla,3148,11,6,4,20,32,60,-28,22
Crusaders,3149,1,17,7,6,55,36,19,58
Linfield,3149,2,15,12,3,60,28,32,57
Cliftonville,3149,3,13,6,11,49,41,8,45
Dungannon,3149,4,12,8,10,49,37,12,44
Glenavon,3149,5,11,11,8,41,48,-7,44
Coleraine,3149,6,9,13,8,38,36,2,40
Ballymena,3149,7,10,7,13,59,65,-6,37
Glentoran,3149,8,8,13,9,32,39,-7,37
Portadown,3149,9,9,6,15,31,39,-8,33
Ards,3149,10,6,8,16,31,50,-19,26
Ballinamalla,3149,11,6,7,17,26,52,-26,25
Cliftonville,3150,1,16,5,9,57,40,17,53
Linfield,3150,2,13,12,5,59,33,26,51
Crusaders,3150,3,13,9,8,59,45,14,48
Ballymena,3150,4,13,8,9,53,55,-2,47
Glentoran,3150,5,12,7,11,40,47,-7,43
Coleraine,3150,6,10,10,10,44,43,1,40
Dungannon,3150,7,10,9,11,48,44,4,39
Glenavon,3150,8,9,10,11,42,44,-2,37
Ards,3150,9,9,5,16,40,54,-14,32
Portadown,3150,10,9,5,16,25,42,-17,32
Ballinamalla,3150,11,8,6,16,35,55,-20,30
Linfield,3151,1,16,8,6,57,32,25,56
Cliftonville,3151,2,15,8,7,54,36,18,53
Ballymena,3151,3,16,5,9,61,56,5,53
Crusaders,3151,4,15,7,8,54,40,14,52
Coleraine,3151,5,11,13,6,46,37,9,46
Glenavon,3151,6,11,11,8,46,46,0,44
Ards,3151,7,10,6,14,45,49,-4,36
Dungannon,3151,8,8,9,13,47,47,0,33
Glentoran,3151,9,9,6,15,28,47,-19,33
Ballinamalla,3151,10,8,3,19,29,49,-20,27
Portadown,3151,11,6,4,20,28,56,-28,22
Crusaders,3152,1,18,7,5,63,31,32,61
Ballymena,3152,2,18,5,7,69,57,12,59
Linfield,3152,3,14,9,7,59,36,23,51
Cliftonville,3152,4,14,3,13,46,39,7,45
Coleraine,3152,5,11,10,9,42,35,7,43
Glenavon,3152,6,11,9,10,47,45,2,42
Dungannon,3152,7,10,10,10,51,41,10,40
Ards,3152,8,11,4,15,41,56,-15,37
Glentoran,3152,9,7,10,13,27,48,-21,31
Ballinamalla,3152,10,7,4,19,32,56,-24,25
Portadown,3152,11,7,3,20,25,58,-33,24
Linfield,3153,1,18,8,4,66,30,36,62
Cliftonville,3153,2,18,5,7,61,34,27,59
Coleraine,3153,3,13,12,5,45,30,15,51
Crusaders,3153,4,13,10,7,49,34,15,49
Ballymena,3153,5,13,7,10,59,57,2,46
Dungannon,3153,6,11,9,10,54,47,7,42
Glentoran,3153,7,11,7,12,32,42,-10,40
Glenavon,3153,8,7,10,13,38,50,-12,31
Ards,3153,9,9,3,18,38,55,-17,30
Ballinamalla,3153,10,6,6,18,33,66,-33,24
Portadown,3153,11,5,5,20,25,55,-30,20
Crusaders,3154,1,18,7,5,61,36,25,61
Ballymena,3154,2,15,6,9,56,54,2,51
Linfield,3154,3,13,11,6,52,27,25,50
Dungannon,3154,4,13,7,10,59,46,13,46
Cliftonville,3154,5,13,6,11,56,52,4,45
Glenavon,3154,6,11,10,9,43,45,-2,43
Coleraine,3154,7,9,14,7,38,31,7,41
Glentoran,3154,8,10,7,13,32,40,-8,37
Ards,3154,9,9,5,16,37,49,-12,32
Portadown,3154,10,6,7,17,28,50,-22,25
Ballinamalla,3154,11,6,4,20,28,60,-32,22
Linfield,3155,1,17,9,4,63,29,34,60
Cliftonville,3155,2,18,2,10,59,47,12,56
Ballymena,3155,3,15,8,7,66,60,6,53
Crusaders,3155,4,14,7,9,52,36,16,49
Glenavon,3155,5,11,12,7,57,47,10,45
Glentoran,3155,6,11,7,12,38,47,-9,40
Dungannon,3155,7,10,9,11,46,41,5,39
Coleraine,3155,8,9,12,9,44,44,0,39
Portadown,3155,9,8,6,16,26,50,-24,30
Ballinamalla,3155,10,7,3,20,31,56,-25,24
Ards,3155,11,5,5,20,32,57,-25,20
Crusaders,3156,1,17,9,4,56,28,28,60
Linfield,3156,2,13,10,7,53,26,27,49
Cliftonville,3156,3,15,4,11,54,37,17,49
Glenavon,3156,4,11,11,8,43,42,1,44
Coleraine,3156,5,12,7,11,39,37,2,43
Ballymena,3156,6,11,10,9,55,61,-6,43
Dungannon,3156,7,10,12,8,50,38,12,42
Ards,3156,8,9,6,15,36,51,-15,33
Portadown,3156,9,8,7,15,31,49,-18,31
Glentoran,3156,10,7,8,15,30,46,-16,29
Ballinamalla,3156,11,8,4,18,24,56,-32,28
Crusaders,3157,1,16,7,7,58,36,22,55
Linfield,3157,2,15,9,6,62,30,32,54
Glenavon,3157,3,13,13,4,53,39,14,52
Ballymena,3157,4,15,7,8,55,50,5,52
Cliftonville,3157,5,14,5,11,51,48,3,47
Coleraine,3157,6,10,13,7,51,45,6,43
Dungannon,3157,7,9,11,10,51,45,6,38
Ards,3157,8,9,4,17,36,53,-17,31
Glentoran,3157,9,6,9,15,23,48,-25,27
Ballinamalla,3157,10,6,8,16,26,54,-28,26
Portadown,3157,11,6,6,18,26,44,-18,24
Cliftonville,3158,1,16,4,10,61,45,16,52
Linfield,3158,2,14,9,7,54,31,23,51
Ballymena,3158,3,15,5,10,52,57,-5,50
Crusaders,3158,4,13,8,9,51,37,14,47
Glenavon,3158,5,10,12,8,50,47,3,42
Coleraine,3158,6,10,9,11,36,37,-1,39
Ards,3158,7,11,6,13,42,45,-3,39
Dungannon,3158,8,9,9,12,45,46,-1,36
Portadown,3158,9,10,4,16,35,49,-14,34
Ballinamalla,3158,10,9,6,15,35,46,-11,33
Glentoran,3158,11,8,8,14,23,44,-21,32
Crusaders,3159,1,18,7,5,59,28,31,61
Cliftonville,3159,2,15,4,11,52,45,7,49
Ballymena,3159,3,14,7,9,61,59,2,49
Glenavon,3159,4,12,10,8,49,41,8,46
Glentoran,3159,5,13,5,12,37,45,-8,44
Linfield,3159,6,11,9,10,49,36,13,42
Coleraine,3159,7,11,9,10,39,35,4,42
Ballinamalla,3159,8,11,4,15,38,49,-11,37
Dungannon,3159,9,9,7,14,50,54,-4,34
Portadown,3159,10,9,4,17,31,49,-18,31
Ards,3159,11,7,4,19,31,55,-24,25
Crusaders,3160,1,16,7,7,49,29,20,55
Linfield,3160,2,14,10,6,60,34,26,52
Cliftonville,3160,3,13,8,9,46,37,9,47
Ballymena,3160,4,13,8,9,55,55,0,47
Coleraine,3160,5,12,10,8,37,34,3,46
Glenavon,3160,6,9,13,8,38,40,-2,40
Glentoran,3160,7,10,9,11,37,45,-8,39
Ards,3160,8,10,4,16,46,50,-4,34
Ballinamalla,3160,9,10,3,17,32,55,-23,33
Dungannon,3160,10,6,11,13,38,43,-5,29
Portadown,3160,11,7,7,16,32,48,-16,28
Crusaders,3161,1,16,8,6,57,34,23,56
Linfield,3161,2,14,11,5,59,29,30,53
Ballymena,3161,3,13,10,7,60,55,5,49
Cliftonville,3161,4,13,8,9,49,47,2,47
Coleraine,3161,5,10,12,8,42,40,2,42
Glenavon,3161,6,9,12,9,50,51,-1,39
Dungannon,3161,7,9,8,13,45,44,1,35
Ballinamalla,3161,8,11,2,17,33,46,-13,35
Glentoran,3161,9,9,7,14,29,43,-14,34
Ards,3161,10,9,4,17,36,50,-14,31
Portadown,3161,11,8,6,16,25,46,-21,30
Cliftonville,3162,1,16,5,9,50,37,13,53
Linfield,3162,2,13,9,8,59,39,20,48
Glenavon,3162,3,12,12,6,57,44,13,48
Ballymena,3162,4,13,9,8,60,62,-2,48
Crusaders,3162,5,12,11,7,47,36,11,47
Coleraine,3162,6,11,12,7,48,40,8,45
Dungannon,3162,7,9,9,12,49,44,5,36
Ards,3162,8,10,6,14,47,48,-1,36
Ballinamalla,3162,9,10,3,17,26,48,-22,33
Glentoran,3162,10,8,7,15,32,48,-16,31
Portadown,3162,11,7,5,18,22,51,-29,26
Crusaders,3163,1,16,9,5,52,33,19,57
Coleraine,3163,2,16,7,7,43,30,13,55
Linfield,3163,3,15,9,6,61,33,28,54
Cliftonville,3163,4,16,6,8,56,36,20,54
Ballymena,3163,5,12,7,11,57,60,-3,43
Glenavon,3163,6,9,12,9,46,50,-4,39
Dungannon,3163,7,9,10,11,50,47,3,37
Portadown,3163,8,9,5,16,31,43,-12,32
Ards,3163,9,8,7,15,43,58,-15,31
Glentoran,3163,10,8,7,15,32,51,-19,31
Ballinamalla,3163,11,5,5,20,25,55,-30,20
Crusaders,3164,1,19,7,4,60,32,28,64
Linfield,3164,2,15,8,7,58,33,25,53
Cliftonville,3164,3,16,4,10,58,38,20,52
Ballymena,3164,4,13,6,11,53,59,-6,45
Coleraine,3164,5,10,13,7,45,38,7,43
Glenavon,3164,6,10,12,8,49,44,5,42
Ballinamalla,3164,7,11,4,15,35,49,-14,37
Dungannon,3164,8,8,11,11,52,48,4,35
Ards,3164,9,10,4,16,39,50,-11,34
Glentoran,3164,10,9,6,15,33,47,-14,33
Portadown,3164,11,4,5,21,15,59,-44,17
Cliftonville,3165,1,19,3,8,61,40,21,60
Linfield,3165,2,15,9,6,59,29,30,54
Crusaders,3165,3,14,8,8,53,38,15,50
Glenavon,3165,4,14,8,8,48,41,7,50
Ballymena,3165,5,13,10,7,54,52,2,49
Coleraine,3165,6,11,10,9,40,38,2,43
Dungannon,3165,7,9,9,12,47,47,0,36
Glentoran,3165,8,9,7,14,27,39,-12,34
Ballinamalla,3165,9,10,3,17,34,53,-19,33
Ards,3165,10,7,4,19,32,53,-21,25
Portadown,3165,11,6,5,19,21,46,-25,23
Crusaders,3166,1,18,7,5,61,37,24,61
Cliftonville,3166,2,18,4,8,59,32,27,58
Linfield,3166,3,15,8,7,63,37,26,53
Glenavon,3166,4,12,12,6,57,46,11,48
Ballymena,3166,5,14,6,10,58,57,1,48
Coleraine,3166,6,9,12,9,40,44,-4,39
Dungannon,3166,7,9,11,10,50,47,3,38
Ards,3166,8,10,6,14,35,44,-9,36
Portadown,3166,9,7,4,19,31,58,-27,25
Ballinamalla,3166,10,7,4,19,24,52,-28,25
Glentoran,3166,11,6,6,18,25,49,-24,24
Crusaders,3167,1,16,5,9,56,37,19,53
Linfield,3167,2,14,9,7,58,32,26,51
Cliftonville,3167,3,16,3,11,57,42,15,51
Coleraine,3167,4,13,10,7,47,34,13,49
Glenavon,3167,5,12,8,10,41,39,2,44
Dungannon,3167,6,10,9,11,48,46,2,39
Glentoran,3167,7,11,6,13,32,39,-7,39
Ballymena,3167,8,10,8,12,48,60,-12,38
Ards,3167,9,10,5,15,39,51,-12,35
Portadown,3167,10,10,5,15,23,38,-15,35
Ballinamalla,3167,11,6,6,18,24,55,-31,24
Linfield,3168,1,16,10,4,57,26,31,58
Crusaders,3168,2,15,9,6,53,37,16,54
Coleraine,3168,3,13,11,6,53,38,15,50
Cliftonville,3168,4,15,4,11,57,45,12,49
Glenavon,3168,5,12,12,6,47,40,7,48
Ballymena,3168,6,13,6,11,53,52,1,45
Glentoran,3168,7,8,8,14,29,45,-16,32
Dungannon,3168,8,6,13,11,48,50,-2,31
Ballinamalla,3168,9,8,7,15,30,48,-18,31
Portadown,3168,10,6,8,16,24,47,-23,26
Ards,3168,11,7,4,19,28,51,-23,25
Crusaders,3169,1,17,6,7,57,37,20,57
Cliftonville,3169,2,16,6,8,57,41,16,54
Coleraine,3169,3,11,12,7,38,35,3,45
Linfield,3169,4,11,11,8,55,34,21,44
Glenavon,3169,5,12,8,10,51,47,4,44
Ballymena,3169,6,12,7,11,62,62,0,43
Glentoran,3169,7,10,12,8,35,38,-3,42
Dungannon,3169,8,11,8,11,51,39,12,41
Ballinamalla,3169,9,8,6,16,29,52,-23,30
Ards,3169,10,7,7,16,33,52,-19,28
Portadown,3169,11,7,3,20,31,62,-31,24
Crusaders,3170,1,17,11,2,61,30,31,62
Linfield,3170,2,15,9,6,63,37,26,54
Coleraine,3170,3,12,13,5,49,36,13,49
Cliftonville,3170,4,14,5,11,49,45,4,47
Ballymena,3170,5,12,8,10,53,56,-3,44
Glenavon,3170,6,9,11,10,39,45,-6,38
Dungannon,3170,7,9,10,11,45,37,8,37
Glentoran,3170,8,7,12,11,26,36,-10,33
Ards,3170,9,8,6,16,32,49,-17,30
Portadown,3170,10,6,9,15,18,38,-20,27
Ballinamalla,3170,11,7,4,19,33,59,-26,25
Linfield,3171,1,16,6,8,53,29,24,54
Cliftonville,3171,2,16,3,11,56,51,5,51
Crusaders,3171,3,14,8,8,51,35,16,50
Dungannon,3171,4,13,9,8,59,40,19,48
Glenavon,3171,5,12,8,10,47,46,1,44
Glentoran,3171,6,11,8,11,39,43,-4,41
Coleraine,3171,7,10,10,10,39,36,3,40
Ballymena,3171,8,11,7,12,57,67,-10,40
Ards,3171,9,10,4,16,39,52,-13,34
Portadown,3171,10,8,5,17,29,46,-17,29
Ballinamalla,3171,11,8,4,18,31,55,-24,28
Crusaders,3172,1,15,9,6,55,36,19,54
Ballymena,3172,2,16,6,8,61,53,8,54
Linfield,3172,3,13,11,6,62,39,23,50
Cliftonville,3172,4,14,7,9,52,36,16,49
Glentoran,3172,5,13,7,10,33,38,-5,46
Coleraine,3172,6,10,10,10,43,45,-2,40
Glenavon,3172,7,10,9,11,48,48,0,39
Dungannon,3172,8,9,9,12,47,45,2,36
Ards,3172,9,8,5,17,38,54,-16,29
Ballinamalla,3172,10,8,5,17,33,51,-18,29
Portadown,3172,11,7,6,17,28,55,-27,27
Cliftonville,3173,1,17,5,8,53,36,17,56
Crusaders,3173,2,15,7,8,55,36,19,52
Ballymena,3173,3,15,4,11,58,58,0,49
Linfield,3173,4,13,8,9,63,35,28,47
Glenavon,3173,5,12,9,9,45,47,-2,45
Coleraine,3173,6,11,10,9,43,38,5,43
Dungannon,3173,7,11,8,11,47,46,1,41
Ards,3173,8,10,6,14,43,50,-7,36
Ballinamalla,3173,9,10,3,17,29,45,-16,33
Portadown,3173,10,9,4,17,21,45,-24,31
Glentoran,3173,11,7,6,17,28,49,-21,27
Ballymena,3174,1,17,5,8,55,51,4,56
Cliftonville,3174,2,15,5,10,53,36,17,50
Crusaders,3174,3,14,7,9,48,37,11,49
Glenavon,3174,4,13,10,7,46,37,9,49
Linfield,3174,5,13,7,10,50,31,19,46
Ards,3174,6,13,5,12,42,42,0,44
Dungannon,3174,7,11,10,9,44,41,3,43
Coleraine,3174,8,8,9,13,38,45,-7,33
Portadown,3174,9,9,5,16,30,46,-16,32
Glentoran,3174,10,7,7,16,30,48,-18,28
Ballinamalla,3174,11,8,4,18,22,44,-22,28
Crusaders,3175,1,17,9,4,56,36,20,60
Glenavon,3175,2,15,9,6,50,38,12,54
Cliftonville,3175,3,16,5,9,56,39,17,53
Linfield,3175,4,14,9,7,59,36,23,51
Coleraine,3175,5,13,10,7,48,37,11,49
Ballymena,3175,6,12,3,15,57,64,-7,39
Dungannon,3175,7,8,8,14,49,52,-3,32
Ards,3175,8,8,8,14,44,51,-7,32
Portadown,3175,9,9,4,17,28,47,-19,31
Glentoran,3175,10,7,8,15,29,51,-22,29
Ballinamalla,3175,11,6,7,17,30,55,-25,25
Crusaders,3176,1,17,7,6,59,29,30,58
Ballymena,3176,2,17,5,8,63,53,10,56
Cliftonville,3176,3,15,6,9,52,42,10,51
Linfield,3176,4,13,10,7,55,35,20,49
Glenavon,3176,5,10,13,7,49,46,3,43
Glentoran,3176,6,11,6,13,31,45,-14,39
Coleraine,3176,7,9,11,10,41,43,-2,38
Dungannon,3176,8,9,6,15,53,52,1,33
Ballinamalla,3176,9,8,9,13,34,47,-13,33
Portadown,3176,10,7,6,17,30,52,-22,27
Ards,3176,11,7,5,18,33,56,-23,26
Crusaders,3177,1,17,7,6,61,35,26,58
Coleraine,3177,2,13,11,6,52,40,12,50
Cliftonville,3177,3,15,4,11,50,40,10,49
Ballymena,3177,4,13,5,12,57,65,-8,44
Linfield,3177,5,11,8,11,48,38,10,41
Glentoran,3177,6,11,8,11,38,40,-2,41
Ards,3177,7,10,7,13,45,45,0,37
Glenavon,3177,8,9,10,11,50,57,-7,37
Portadown,3177,9,10,7,13,27,39,-12,37
Dungannon,3177,10,9,7,14,49,50,-1,34
Ballinamalla,3177,11,8,4,18,32,60,-28,28
Crusaders,3178,1,18,5,7,58,34,24,59
Cliftonville,3178,2,16,2,12,57,44,13,50
Linfield,3178,3,13,10,7,58,35,23,49
Ballymena,3178,4,14,4,12,57,61,-4,46
Glenavon,3178,5,11,11,8,46,44,2,44
Glentoran,3178,6,11,8,11,34,44,-10,41
Coleraine,3178,7,10,10,10,39,40,-1,40
Dungannon,3178,8,8,13,9,47,44,3,37
Ballinamalla,3178,9,10,5,15,38,51,-13,35
Portadown,3178,10,9,4,17,29,47,-18,31
Ards,3178,11,6,6,18,31,50,-19,24
Crusaders,3179,1,16,8,6,54,37,17,56
Linfield,3179,2,14,10,6,59,39,20,52
Cliftonville,3179,3,15,5,10,53,37,16,50
Dungannon,3179,4,12,10,8,56,41,15,46
Ballymena,3179,5,12,5,13,56,67,-11,41
Coleraine,3179,6,9,12,9,51,49,2,39
Ards,3179,7,10,6,14,41,48,-7,36
Ballinamalla,3179,8,10,6,14,37,51,-14,36
Glenavon,3179,9,8,10,12,44,50,-6,34
Glentoran,3179,10,7,12,11,32,41,-9,33
Portadown,3179,11,8,4,18,27,50,-23,28
Linfield,3180,1,18,8,4,66,29,37,62
Crusaders,3180,2,18,6,6,57,31,26,60
Cliftonville,3180,3,17,4,9,52,41,11,55
Glenavon,3180,4,12,9,9,50,42,8,45
Ballymena,3180,5,12,9,9,55,55,0,45
Coleraine,3180,6,10,13,7,49,41,8,43
Glentoran,3180,7,9,8,13,35,46,-11,35
Dungannon,3180,8,7,10,13,42,45,-3,31
Ballinamalla,3180,9,7,6,17,29,56,-27,27
Ards,3180,10,6,7,17,31,55,-24,25
Portadown,3180,11,7,4,19,25,50,-25,25
Crusaders,3181,1,14,10,6,51,37,14,52
Linfield,3181,2,13,11,6,64,36,28,50
Cliftonville,3181,3,14,7,9,53,41,12,49
Ballymena,3181,4,13,8,9,60,58,2,47
Coleraine,3181,5,12,9,9,50,42,8,45
Glenavon,3181,6,9,13,8,42,43,-1,40
Dungannon,3181,7,10,9,11,44,39,5,39
Glentoran,3181,8,10,9,11,40,50,-10,39
Ards,3181,9,9,6,15,37,52,-15,33
Portadown,3181,10,8,4,18,19,41,-22,28
Ballinamalla,3181,11,6,8,16,28,49,-21,26
Cliftonville,3182,1,19,4,7,61,33,28,61
Ballymena,3182,2,16,4,10,60,53,7,52
Coleraine,3182,3,13,12,5,52,33,19,51
Linfield,3182,4,14,6,10,58,47,11,48
Glenavon,3182,5,12,11,7,49,44,5,47
Crusaders,3182,6,12,9,9,47,38,9,45
Dungannon,3182,7,8,13,9,50,45,5,37
Ards,3182,8,10,5,15,41,51,-10,35
Glentoran,3182,9,8,6,16,28,46,-18,30
Portadown,3182,10,8,4,18,27,52,-25,28
Ballinamalla,3182,11,6,4,20,30,61,-31,22
Crusaders,3183,1,16,9,5,56,31,25,57
Ballymena,3183,2,15,7,8,53,51,2,52
Linfield,3183,3,13,10,7,60,37,23,49
Cliftonville,3183,4,15,4,11,52,43,9,49
Dungannon,3183,5,13,8,9,59,45,14,47
Glenavon,3183,6,12,8,10,52,45,7,44
Coleraine,3183,7,12,8,10,45,39,6,44
Glentoran,3183,8,10,7,13,30,41,-11,37
Ards,3183,9,9,3,18,31,51,-20,30
Portadown,3183,10,8,5,17,26,49,-23,29
Ballinamalla,3183,11,6,3,21,23,55,-32,21
Ballymena,3184,1,17,7,6,61,54,7,58
Linfield,3184,2,15,11,4,60,29,31,56
Crusaders,3184,3,16,7,7,51,29,22,55
Cliftonville,3184,4,13,7,10,48,38,10,46
Glenavon,3184,5,11,11,8,42,41,1,44
Coleraine,3184,6,10,11,9,39,35,4,41
Dungannon,3184,7,10,10,10,56,44,12,40
Glentoran,3184,8,10,6,14,27,42,-15,36
Ballinamalla,3184,9,8,3,19,29,59,-30,27
Ards,3184,10,6,7,17,36,54,-18,25
Portadown,3184,11,6,6,18,29,53,-24,24
Crusaders,3185,1,19,4,7,60,27,33,61
Coleraine,3185,2,13,10,7,47,36,11,49
Ballymena,3185,3,14,5,11,54,55,-1,47
Linfield,3185,4,12,9,9,61,41,20,45
Cliftonville,3185,5,13,6,11,47,48,-1,45
Glentoran,3185,6,12,6,12,36,44,-8,42
Dungannon,3185,7,11,8,11,48,45,3,41
Glenavon,3185,8,10,11,9,49,55,-6,41
Portadown,3185,9,10,6,14,37,40,-3,36
Ards,3185,10,10,3,17,35,49,-14,33
Ballinamalla,3185,11,6,2,22,27,61,-34,20
Linfield,3186,1,16,9,5,61,31,30,57
Crusaders,3186,2,16,7,7,53,32,21,55
Glenavon,3186,3,11,12,7,48,41,7,45
Ballymena,3186,4,12,9,9,64,60,4,45
Cliftonville,3186,5,13,5,12,38,35,3,44
Coleraine,3186,6,11,10,9,46,43,3,43
Portadown,3186,7,10,6,14,30,44,-14,36
Ards,3186,8,10,5,15,38,45,-7,35
Dungannon,3186,9,8,10,12,43,45,-2,34
Ballinamalla,3186,10,10,4,16,29,49,-20,34
Glentoran,3186,11,6,7,17,25,50,-25,25
Crusaders,3187,1,15,8,7,54,31,23,53
Cliftonville,3187,2,15,7,8,55,35,20,52
Linfield,3187,3,14,9,7,55,33,22,51
Glenavon,3187,4,13,10,7,44,35,9,49
Coleraine,3187,5,12,10,8,46,35,11,46
Glentoran,3187,6,11,9,10,32,38,-6,42
Ballymena,3187,7,11,7,12,56,69,-13,40
Dungannon,3187,8,10,8,12,47,45,2,38
Ballinamalla,3187,9,8,5,17,27,45,-18,29
Portadown,3187,10,7,6,17,24,49,-25,27
Ards,3187,11,6,7,17,32,57,-25,25
Ballymena,3188,1,17,5,8,63,53,10,56
Crusaders,3188,2,15,9,6,64,41,23,54
Coleraine,3188,3,12,12,6,54,43,11,48
Linfield,3188,4,12,9,9,52,40,12,45
Cliftonville,3188,5,12,6,12,51,46,5,42
Glenavon,3188,6,10,11,9,44,45,-1,41
Dungannon,3188,7,8,12,10,49,43,6,36
Ards,3188,8,10,5,15,42,54,-12,35
Glentoran,3188,9,8,9,13,39,47,-8,33
Ballinamalla,3188,10,9,4,17,31,56,-25,31
Portadown,3188,11,8,6,16,24,45,-21,30
Crusaders,3189,1,21,4,5,59,28,31,67
Cliftonville,3189,2,14,4,12,45,39,6,46
Ballymena,3189,3,13,7,10,49,54,-5,46
Linfield,3189,4,12,9,9,55,37,18,45
Glenavon,3189,5,11,12,7,58,48,10,45
Dungannon,3189,6,12,8,10,58,44,14,44
Coleraine,3189,7,10,9,11,35,42,-7,39
Glentoran,3189,8,10,7,13,32,42,-10,37
Ards,3189,9,9,5,16,39,49,-10,32
Portadown,3189,10,8,6,16,29,44,-15,30
Ballinamalla,3189,11,8,3,19,30,62,-32,27
Cliftonville,3190,1,17,6,7,60,35,25,57
Crusaders,3190,2,16,6,8,55,39,16,54
Linfield,3190,3,13,13,4,59,34,25,52
Ballymena,3190,4,14,9,7,58,45,13,51
Coleraine,3190,5,12,8,10,39,37,2,44
Glenavon,3190,6,12,8,10,47,50,-3,44
Glentoran,3190,7,11,8,11,32,44,-12,41
Dungannon,3190,8,7,11,12,49,44,5,32
Ards,3190,9,7,7,16,40,54,-14,28
Ballinamalla,3190,10,7,4,19,27,58,-31,25
Portadown,3190,11,6,6,18,23,49,-26,24
Linfield,3191,1,16,8,6,63,40,23,56
Dungannon,3191,2,16,6,8,54,36,18,54
Crusaders,3191,3,14,8,8,53,38,15,50
Ballymena,3191,4,15,5,10,63,56,7,50
Coleraine,3191,5,13,8,9,48,36,12,47
Cliftonville,3191,6,13,6,11,47,44,3,45
Glenavon,3191,7,11,10,9,48,45,3,43
Ards,3191,8,10,3,17,37,45,-8,33
Glentoran,3191,9,7,9,14,25,45,-20,30
Portadown,3191,10,9,3,18,25,53,-28,30
Ballinamalla,3191,11,7,2,21,30,55,-25,23
Linfield,3192,1,17,7,6,63,32,31,58
Crusaders,3192,2,16,10,4,57,33,24,58
Cliftonville,3192,3,14,6,10,43,37,6,48
Coleraine,3192,4,12,11,7,43,36,7,47
Ballymena,3192,5,12,8,10,57,56,1,44
Glenavon,3192,6,10,10,10,44,46,-2,40
Ards,3192,7,11,5,14,41,45,-4,38
Dungannon,3192,8,8,11,11,44,42,2,35
Ballinamalla,3192,9,9,6,15,35,52,-17,33
Glentoran,3192,10,6,10,14,27,47,-20,28
Portadown,3192,11,7,2,21,21,49,-28,23
Crusaders,3193,1,18,7,5,61,31,30,61
Linfield,3193,2,15,9,6,56,29,27,54
Cliftonville,3193,3,15,5,10,64,46,18,50
Ballymena,3193,4,14,7,9,60,59,1,49
Glenavon,3193,5,12,9,9,44,43,1,45
Coleraine,3193,6,10,11,9,41,44,-3,41
Dungannon,3193,7,10,10,10,55,51,4,40
Glentoran,3193,8,10,8,12,34,43,-9,38
Portadown,3193,9,9,3,18,25,48,-23,30
Ards,3193,10,8,3,19,34,53,-19,27
Ballinamalla,3193,11,6,4,20,29,56,-27,22
Linfield,3194,1,16,10,4,67,33,34,58
Glenavon,3194,2,16,10,4,55,37,18,58
Cliftonville,3194,3,15,3,12,53,42,11,48
Ballymena,3194,4,14,5,11,51,51,0,47
Crusaders,3194,5,12,8,10,48,37,11,44
Dungannon,3194,6,11,9,10,46,43,3,42
Coleraine,3194,7,9,11,10,39,40,-1,38
Glentoran,3194,8,9,8,13,29,43,-14,35
Ards,3194,9,10,4,16,39,51,-12,34
Ballinamalla,3194,10,8,4,18,27,50,-23,28
Portadown,3194,11,6,6,18,22,49,-27,24
Crusaders,3195,1,17,8,5,62,33,29,59
Linfield,3195,2,13,11,6,57,31,26,50
Glenavon,3195,3,12,12,6,52,44,8,48
Coleraine,3195,4,12,9,9,47,37,10,45
Ballymena,3195,5,13,6,11,57,57,0,45
Cliftonville,3195,6,13,5,12,47,51,-4,44
Dungannon,3195,7,9,12,9,50,44,6,39
Glentoran,3195,8,8,9,13,33,41,-8,33
Ards,3195,9,8,6,16,39,57,-18,30
Portadown,3195,10,7,7,16,22,46,-24,28
Ballinamalla,3195,11,7,7,16,24,49,-25,28
Crusaders,3196,1,17,7,6,56,32,24,58
Ballymena,3196,2,16,6,8,69,53,16,54
Cliftonville,3196,3,15,6,9,52,42,10,51
Linfield,3196,4,13,10,7,53,34,19,49
Dungannon,3196,5,11,9,10,52,41,11,42
Glenavon,3196,6,9,13,8,45,45,0,40
Coleraine,3196,7,8,14,8,41,44,-3,38
Ards,3196,8,10,7,13,35,45,-10,37
Glentoran,3196,9,9,6,15,26,42,-16,33
Ballinamalla,3196,10,7,4,19,26,57,-31,25
Portadown,3196,11,5,8,17,32,52,-20,23
Crusaders,3197,1,17,8,5,62,42,20,59
Ballymena,3197,2,15,6,9,59,52,7,51
Glenavon,3197,3,13,10,7,53,42,11,49
Linfield,3197,4,12,11,7,59,36,23,47
Dungannon,3197,5,11,10,9,54,43,11,43
Cliftonville,3197,6,12,6,12,48,40,8,42
Coleraine,3197,7,10,10,10,44,43,1,40
Glentoran,3197,8,9,8,13,35,50,-15,35
Ards,3197,9,7,8,15,33,51,-18,29
Portadown,3197,10,7,8,15,23,48,-25,29
Ballinamalla,3197,11,6,7,17,35,58,-23,25
Cliftonville,3198,1,16,3,11,57,37,20,51
Crusaders,3198,2,14,9,7,55,40,15,51
Linfield,3198,3,14,8,8,55,32,23,50
Glenavon,3198,4,13,11,6,51,43,8,50
Dungannon,3198,5,13,9,8,56,45,11,48
Ballymena,3198,6,13,6,11,53,57,-4,45
Coleraine,3198,7,10,10,10,36,34,2,40
Portadown,3198,8,9,7,14,25,41,-16,34
Ards,3198,9,8,6,16,44,54,-10,30
Glentoran,3198,10,7,8,15,31,55,-24,29
Ballinamalla,3198,11,5,9,16,27,52,-25,24
Crusaders,3199,1,15,8,7,52,31,21,53
Coleraine,3199,2,13,11,6,48,33,15,50
Linfield,3199,3,13,9,8,59,37,22,48
Dungannon,3199,4,12,10,8,50,41,9,46
Cliftonville,3199,5,14,4,12,46,40,6,46
Ballymena,3199,6,14,4,12,50,53,-3,46
Glenavon,3199,7,9,11,10,44,49,-5,38
Ards,3199,8,12,2,16,40,53,-13,38
Glentoran,3199,9,10,7,13,25,39,-14,37
Portadown,3199,10,8,5,17,23,44,-21,29
Ballinamalla,3199,11,7,5,18,36,53,-17,26
Crusaders,3200,1,17,6,7,60,39,21,57
Linfield,3200,2,15,8,7,60,38,22,53
Coleraine,3200,3,14,10,6,49,32,17,52
Cliftonville,3200,4,15,6,9,51,36,15,51
Ballymena,3200,5,14,6,10,57,61,-4,48
Ballinamalla,3200,6,13,3,14,43,46,-3,42
Dungannon,3200,7,9,8,13,55,51,4,35
Glenavon,3200,8,8,10,12,45,58,-13,34
Glentoran,3200,9,9,5,16,31,46,-15,32
Ards,3200,10,9,2,19,32,54,-22,29
Portadown,3200,11,7,6,17,24,46,-22,27
Linfield,3201,1,14,10,6,57,32,25,52
Cliftonville,3201,2,15,6,9,54,43,11,51
Coleraine,3201,3,12,11,7,44,34,10,47
Glenavon,3201,4,11,13,6,49,43,6,46
Crusaders,3201,5,12,8,10,48,43,5,44
Ballymena,3201,6,12,8,10,56,61,-5,44
Ards,3201,7,12,5,13,38,42,-4,41
Glentoran,3201,8,10,7,13,27,35,-8,37
Dungannon,3201,9,7,10,13,46,49,-3,31
Ballinamalla,3201,10,7,8,15,29,50,-21,29
Portadown,3201,11,8,4,18,30,46,-16,28
Cliftonville,3202,1,15,7,8,48,33,15,52
Linfield,3202,2,13,10,7,56,32,24,49
Crusaders,3202,3,13,10,7,49,35,14,49
Ards,3202,4,14,5,11,48,42,6,47
Glenavon,3202,5,12,9,9,55,44,11,45
Coleraine,3202,6,10,13,7,39,39,0,43
Ballymena,3202,7,11,9,10,53,57,-4,42
Dungannon,3202,8,8,9,13,49,47,2,33
Glentoran,3202,9,8,9,13,31,50,-19,33
Ballinamalla,3202,10,8,6,16,21,49,-28,30
Portadown,3202,11,5,9,16,29,50,-21,24
Crusaders,3203,1,18,6,6,64,36,28,60
Linfield,3203,2,13,12,5,59,35,24,51
Cliftonville,3203,3,15,5,10,55,42,13,50
Ballymena,3203,4,13,8,9,54,55,-1,47
Coleraine,3203,5,12,10,8,42,38,4,46
Glentoran,3203,6,10,10,10,32,36,-4,40
Glenavon,3203,7,9,11,10,44,49,-5,38
Dungannon,3203,8,8,11,11,55,51,4,35
Ards,3203,9,9,5,16,45,58,-13,32
Ballinamalla,3203,10,8,5,17,23,47,-24,29
Portadown,3203,11,6,5,19,21,47,-26,23
Linfield,3204,1,15,11,4,61,28,33,56
Cliftonville,3204,2,16,6,8,49,35,14,54
Glenavon,3204,3,14,9,7,45,39,6,51
Crusaders,3204,4,14,7,9,53,43,10,49
Ballymena,3204,5,12,6,12,57,66,-9,42
Dungannon,3204,6,10,11,9,48,38,10,41
Coleraine,3204,7,10,11,9,42,38,4,41
Ballinamalla,3204,8,10,4,16,33,48,-15,34
Glentoran,3204,9,8,7,15,31,51,-20,31
Ards,3204,10,8,6,16,36,43,-7,30
Portadown,3204,11,6,6,18,18,44,-26,24
Crusaders,3205,1,18,7,5,56,25,31,61
Glenavon,3205,2,14,10,6,53,44,9,52
Linfield,3205,3,13,11,6,59,29,30,50
Cliftonville,3205,4,14,7,9,50,40,10,49
Ballymena,3205,5,13,7,10,60,64,-4,46
Coleraine,3205,6,10,12,8,44,37,7,42
Glentoran,3205,7,9,10,11,32,44,-12,37
Dungannon,3205,8,9,9,12,41,41,0,36
Ballinamalla,3205,9,8,5,17,28,50,-22,29
Ards,3205,10,7,7,16,41,57,-16,28
Portadown,3205,11,6,3,21,22,55,-33,21
Linfield,3206,1,18,8,4,65,30,35,62
Crusaders,3206,2,17,9,4,61,30,31,60
Ballymena,3206,3,15,6,9,61,57,4,51
Cliftonville,3206,4,12,8,10,42,34,8,44
Coleraine,3206,5,10,10,10,46,45,1,40
Glenavon,3206,6,10,9,11,43,46,-3,39
Dungannon,3206,7,9,10,11,46,40,6,37
Ards,3206,8,9,6,15,42,56,-14,33
Glentoran,3206,9,8,9,13,32,49,-17,33
Portadown,3206,10,9,2,19,28,52,-24,29
Ballinamalla,3206,11,8,3,19,34,61,-27,27
Linfield,3207,1,17,8,5,66,34,32,59
Crusaders,3207,2,15,6,9,53,35,18,51
Ballymena,3207,3,14,6,10,61,66,-5,48
Cliftonville,3207,4,14,3,13,43,34,9,45
Glenavon,3207,5,11,12,7,42,40,2,45
Coleraine,3207,6,11,11,8,50,42,8,44
Dungannon,3207,7,9,11,10,48,39,9,38
Glentoran,3207,8,10,7,13,33,44,-11,37
Ballinamalla,3207,9,11,2,17,33,51,-18,35
Ards,3207,10,7,6,17,32,54,-22,27
Portadown,3207,11,7,6,17,28,50,-22,27
Crusaders,3208,1,17,9,4,55,31,24,60
Ballymena,3208,2,17,6,7,66,52,14,57
Linfield,3208,3,14,11,5,58,23,35,53
Cliftonville,3208,4,13,4,13,47,46,1,43
Coleraine,3208,5,10,12,8,44,38,6,42
Glentoran,3208,6,11,6,13,36,45,-9,39
Glenavon,3208,7,8,12,10,41,53,-12,36
Portadown,3208,8,9,8,13,28,42,-14,35
Dungannon,3208,9,9,6,15,47,44,3,33
Ards,3208,10,8,6,16,34,50,-16,30
Ballinamalla,3208,11,8,2,20,27,59,-32,26
Linfield,3209,1,14,9,7,67,41,26,51
Cliftonville,3209,2,15,6,9,52,37,15,51
Crusaders,3209,3,15,6,9,48,35,13,51
Glenavon,3209,4,12,10,8,51,53,-2,46
Coleraine,3209,5,11,12,7,46,37,9,45
Dungannon,3209,6,11,11,8,51,37,14,44
Ballymena,3209,7,13,5,12,60,66,-6,44
Glentoran,3209,8,9,10,11,28,39,-11,37
Ards,3209,9,9,6,15,36,45,-9,33
Ballinamalla,3209,10,8,3,19,29,48,-19,27
Portadown,3209,11,6,6,18,22,52,-30,24
Cliftonville,3210,1,19,5,6,63,33,30,62
Crusaders,3210,2,16,6,8,57,43,14,54
Linfield,3210,3,13,7,10,53,36,17,46
Glentoran,3210,4,12,7,11,33,34,-1,43
Dungannon,3210,5,11,9,10,46,41,5,42
Glenavon,3210,6,10,12,8,52,52,0,42
Coleraine,3210,7,11,8,11,41,41,0,41
Ballymena,3210,8,10,9,11,57,68,-11,39
Ards,3210,9,10,3,17,38,47,-9,33
Ballinamalla,3210,10,10,2,18,33,55,-22,32
Portadown,3210,11,6,6,18,25,48,-23,24
Crusaders,3211,1,15,8,7,49,38,11,53
Cliftonville,3211,2,16,4,10,57,44,13,52
Coleraine,3211,3,12,11,7,44,36,8,47
Linfield,3211,4,12,10,8,58,45,13,46
Glenavon,3211,5,11,12,7,54,37,17,45
Ballymena,3211,6,11,9,10,57,55,2,42
Dungannon,3211,7,8,14,8,45,44,1,38
Glentoran,3211,8,9,8,13,31,42,-11,35
Ballinamalla,3211,9,8,8,14,35,48,-13,32
Ards,3211,10,9,4,17,35,48,-13,31
Portadown,3211,11,6,8,16,25,53,-28,26
Cliftonville,3212,1,17,4,9,54,36,18,55
Crusaders,3212,2,15,9,6,52,32,20,54
Ballymena,3212,3,15,5,10,60,53,7,50
Linfield,3212,4,13,10,7,52,29,23,49
Coleraine,3212,5,13,10,7,45,33,12,49
Dungannon,3212,6,12,7,11,50,44,6,43
Ards,3212,7,11,7,12,32,40,-8,40
Glenavon,3212,8,9,11,10,42,45,-3,38
Glentoran,3212,9,8,9,13,28,40,-12,33
Portadown,3212,10,7,7,16,17,42,-25,28
Ballinamalla,3212,11,3,5,22,18,56,-38,14
Linfield,3213,1,17,8,5,61,28,33,59
Coleraine,3213,2,13,10,7,53,40,13,49
Cliftonville,3213,3,14,5,11,59,43,16,47
Ballymena,3213,4,13,7,10,58,60,-2,46
Glenavon,3213,5,11,12,7,46,41,5,45
Crusaders,3213,6,13,6,11,43,39,4,45
Dungannon,3213,7,10,8,12,48,48,0,38
Ards,3213,8,10,8,12,34,40,-6,38
Ballinamalla,3213,9,9,5,16,33,49,-16,32
Glentoran,3213,10,7,7,16,26,45,-19,28
Portadown,3213,11,7,6,17,22,50,-28,27
Ballymena,3214,1,16,6,8,60,57,3,54
Linfield,3214,2,14,10,6,58,30,28,52
Cliftonville,3214,3,16,3,11,51,39,12,51
Crusaders,3214,4,14,8,8,53,40,13,50
Dungannon,3214,5,11,9,10,54,44,10,42
Coleraine,3214,6,10,10,10,37,36,1,40
Glentoran,3214,7,10,8,12,28,38,-10,38
Glenavon,3214,8,9,10,11,50,54,-4,37
Ards,3214,9,8,7,15,40,50,-10,31
Portadown,3214,10,8,6,16,25,44,-19,30
Ballinamalla,3214,11,8,5,17,29,53,-24,29
Crusaders,3215,1,19,7,4,56,31,25,64
Coleraine,3215,2,13,11,6,42,31,11,50
Ballymena,3215,3,15,4,11,56,52,4,49
Linfield,3215,4,13,9,8,54,33,21,48
Cliftonville,3215,5,14,5,11,54,46,8,47
Dungannon,3215,6,11,11,8,54,39,15,44
Glenavon,3215,7,9,11,10,42,51,-9,38
Ards,3215,8,8,9,13,41,47,-6,33
Glentoran,3215,9,8,8,14,27,42,-15,32
Portadown,3215,10,6,8,16,21,44,-23,26
Ballinamalla,3215,11,6,3,21,25,56,-31,21
Crusaders,3216,1,17,8,5,59,35,24,59
Linfield,3216,2,15,11,4,59,29,30,56
Cliftonville,3216,3,16,6,8,52,32,20,54
Ballymena,3216,4,15,6,9,61,58,3,51
Glenavon,3216,5,12,9,9,51,48,3,45
Dungannon,3216,6,10,10,10,44,42,2,40
Coleraine,3216,7,9,11,10,46,48,-2,38
Glentoran,3216,8,8,8,14,31,43,-12,32
Portadown,3216,9,8,4,18,25,49,-24,28
Ards,3216,10,6,7,17,31,52,-21,25
Ballinamalla,3216,11,7,4,19,27,50,-23,25
Crusaders,3217,1,20,5,5,59,31,28,65
Linfield,3217,2,13,9,8,57,28,29,48
Dungannon,3217,3,12,10,8,48,31,17,46
Coleraine,3217,4,10,14,6,48,45,3,44
Cliftonville,3217,5,13,4,13,47,46,1,43
Glentoran,3217,6,10,12,8,30,32,-2,42
Glenavon,3217,7,9,13,8,50,50,0,40
Ballymena,3217,8,10,8,12,46,60,-14,38
Ards,3217,9,9,6,15,50,57,-7,33
Portadown,3217,10,7,5,18,27,56,-29,26
Ballinamalla,3217,11,7,4,19,27,53,-26,25
Cliftonville,3218,1,18,2,10,56,37,19,56
Linfield,3218,2,15,8,7,65,36,29,53
Crusaders,3218,3,14,9,7,54,36,18,51
Ballymena,3218,4,14,6,10,65,61,4,48
Glenavon,3218,5,11,12,7,49,40,9,45
Glentoran,3218,6,11,8,11,33,45,-12,41
Ards,3218,7,11,4,15,34,47,-13,37
Coleraine,3218,8,8,11,11,39,47,-8,35
Dungannon,3218,9,7,12,11,47,51,-4,33
Portadown,3218,10,7,6,17,26,45,-19,27
Ballinamalla,3218,11,7,6,17,27,50,-23,27
Crusaders,3219,1,20,5,5,59,30,29,65
Linfield,3219,2,14,10,6,60,28,32,52
Cliftonville,3219,3,16,2,12,55,43,12,50
Glenavon,3219,4,13,11,6,44,39,5,50
Ballymena,3219,5,13,5,12,56,62,-6,44
Coleraine,3219,6,10,11,9,39,37,2,41
Dungannon,3219,7,10,9,11,41,39,2,39
Ards,3219,8,9,6,15,39,55,-16,33
Glentoran,3219,9,8,7,15,28,46,-18,31
Ballinamalla,3219,10,7,6,17,28,51,-23,27
Portadown,3219,11,7,4,19,28,47,-19,25
Cliftonville,3220,1,18,3,9,58,40,18,57
Crusaders,3220,2,16,9,5,56,39,17,57
Linfield,3220,3,13,12,5,61,34,27,51
Ballymena,3220,4,15,6,9,54,53,1,51
Dungannon,3220,5,10,11,9,61,48,13,41
Coleraine,3220,6,9,12,9,42,40,2,39
Glentoran,3220,7,8,11,11,37,46,-9,35
Ballinamalla,3220,8,9,5,16,35,50,-15,32
Glenavon,3220,9,7,10,13,47,62,-15,31
Ards,3220,10,8,5,17,36,52,-16,29
Portadown,3220,11,7,6,17,22,45,-23,27
Crusaders,3221,1,19,6,5,56,31,25,63
Ballymena,3221,2,17,4,9,58,54,4,55
Coleraine,3221,3,11,14,5,50,38,12,47
Linfield,3221,4,12,10,8,59,36,23,46
Cliftonville,3221,5,13,5,12,51,43,8,44
Glenavon,3221,6,10,11,9,45,48,-3,41
Dungannon,3221,7,10,10,10,47,40,7,40
Glentoran,3221,8,11,6,13,31,40,-9,39
Ards,3221,9,8,6,16,37,53,-16,30
Portadown,3221,10,7,6,17,21,44,-23,27
Ballinamalla,3221,11,4,8,18,26,54,-28,20
Linfield,3222,1,19,6,5,71,31,40,63
Crusaders,3222,2,17,6,7,63,39,24,57
Ballymena,3222,3,13,7,10,57,60,-3,46
Cliftonville,3222,4,13,5,12,54,45,9,44
Glenavon,3222,5,11,10,9,48,47,1,43
Coleraine,3222,6,11,8,11,47,46,1,41
Ards,3222,7,10,5,15,32,45,-13,35
Dungannon,3222,8,8,10,12,48,44,4,34
Portadown,3222,9,9,6,15,29,47,-18,33
Ballinamalla,3222,10,10,3,17,27,49,-22,33
Glentoran,3222,11,7,8,15,26,49,-23,29
Crusaders,3223,1,18,6,6,59,34,25,60
Linfield,3223,2,12,12,6,59,35,24,48
Dungannon,3223,3,13,9,8,54,38,16,48
Coleraine,3223,4,12,11,7,45,37,8,47
Cliftonville,3223,5,12,8,10,51,41,10,44
Ballymena,3223,6,12,8,10,49,55,-6,44
Glenavon,3223,7,11,10,9,49,47,2,43
Glentoran,3223,8,11,8,11,33,38,-5,41
Ballinamalla,3223,9,6,8,16,29,49,-20,26
Ards,3223,10,5,8,17,35,61,-26,23
Portadown,3223,11,5,8,17,20,48,-28,23
Crusaders,3224,1,18,8,4,61,33,28,62
Ballymena,3224,2,15,8,7,56,50,6,53
Cliftonville,3224,3,16,4,10,55,42,13,52
Linfield,3224,4,14,8,8,62,31,31,50
Glenavon,3224,5,13,9,8,58,44,14,48
Ards,3224,6,12,4,14,45,47,-2,40
Coleraine,3224,7,10,9,11,39,44,-5,39
Dungannon,3224,8,10,7,13,49,46,3,37
Glentoran,3224,9,7,7,16,24,53,-29,28
Portadown,3224,10,8,3,19,20,51,-31,27
Ballinamalla,3224,11,6,5,19,32,60,-28,23
Crusaders,3225,1,16,8,6,59,35,24,56
Ballymena,3225,2,16,7,7,64,48,16,55
Glenavon,3225,3,13,11,6,51,44,7,50
Linfield,3225,4,13,9,8,51,30,21,48
Coleraine,3225,5,12,11,7,42,39,3,47
Cliftonville,3225,6,14,3,13,50,49,1,45
Dungannon,3225,7,9,9,12,52,45,7,36
Ards,3225,8,11,3,16,39,51,-12,36
Glentoran,3225,9,8,9,13,28,47,-19,33
Ballinamalla,3225,10,8,3,19,30,50,-20,27
Portadown,3225,11,6,5,19,22,50,-28,23
Linfield,3226,1,16,8,6,63,34,29,56
Glenavon,3226,2,15,10,5,56,39,17,55
Ballymena,3226,3,16,6,8,71,55,16,54
Cliftonville,3226,4,14,6,10,47,43,4,48
Crusaders,3226,5,13,7,10,46,36,10,46
Dungannon,3226,6,11,8,11,56,45,11,41
Coleraine,3226,7,9,13,8,36,39,-3,40
Glentoran,3226,8,9,5,16,34,61,-27,32
Ards,3226,9,8,7,15,36,51,-15,31
Portadown,3226,10,7,5,18,27,52,-25,26
Ballinamalla,3226,11,6,7,17,35,52,-17,25
Cliftonville,3227,1,16,6,8,55,38,17,54
Linfield,3227,2,14,11,5,64,34,30,53
Crusaders,3227,3,15,8,7,56,39,17,53
Ballymena,3227,4,13,6,11,52,55,-3,45
Dungannon,3227,5,12,8,10,55,44,11,44
Glenavon,3227,6,10,13,7,44,40,4,43
Coleraine,3227,7,10,11,9,44,44,0,41
Ballinamalla,3227,8,8,6,16,33,47,-14,30
Portadown,3227,9,8,6,16,27,49,-22,30
Glentoran,3227,10,7,8,15,32,56,-24,29
Ards,3227,11,7,7,16,42,58,-16,28
Crusaders,3228,1,18,7,5,61,33,28,61
Cliftonville,3228,2,15,7,8,63,40,23,52
Linfield,3228,3,14,9,7,57,36,21,51
Coleraine,3228,4,13,9,8,51,42,9,48
Glenavon,3228,5,12,8,10,55,50,5,44
Ballymena,3228,6,12,8,10,54,58,-4,44
Glentoran,3228,7,10,10,10,39,43,-4,40
Dungannon,3228,8,9,11,10,50,44,6,38
Ards,3228,9,9,6,15,34,52,-18,33
Portadown,3228,10,5,6,19,16,51,-35,21
Ballinamalla,3228,11,4,7,19,22,53,-31,19
Linfield,3229,1,19,7,4,68,24,44,64
Crusaders,3229,2,18,9,3,55,22,33,63
Glenavon,3229,3,13,12,5,45,35,10,51
Cliftonville,3229,4,15,5,10,53,39,14,50
Ballymena,3229,5,13,8,9,50,59,-9,47
Coleraine,3229,6,10,13,7,43,38,5,43
Glentoran,3229,7,8,10,12,29,42,-13,34
Dungannon,3229,8,8,9,13,45,49,-4,33
Ards,3229,9,8,5,17,35,53,-18,29
Ballinamalla,3229,10,6,3,21,27,60,-33,21
Portadown,3229,11,4,5,21,19,48,-29,17
Linfield,3230,1,15,9,6,57,30,27,54
Cliftonville,3230,2,15,8,7,54,34,20,53
Glenavon,3230,3,15,8,7,52,38,14,53
Crusaders,3230,4,15,5,10,54,41,13,50
Ballymena,3230,5,13,8,9,51,57,-6,47
Dungannon,3230,6,12,8,10,51,45,6,44
Coleraine,3230,7,10,13,7,48,41,7,43
Glentoran,3230,8,8,8,14,34,48,-14,32
Ards,3230,9,7,7,16,31,51,-20,28
Portadown,3230,10,7,6,17,21,43,-22,27
Ballinamalla,3230,11,7,2,21,26,51,-25,23
Crusaders,3231,1,19,6,5,60,33,27,63
Ballymena,3231,2,16,6,8,68,52,16,54
Cliftonville,3231,3,16,4,10,50,35,15,52
Coleraine,3231,4,13,8,9,44,37,7,47
Linfield,3231,5,11,11,8,51,34,17,44
Glenavon,3231,6,11,10,9,48,53,-5,43
Dungannon,3231,7,10,8,12,54,47,7,38
Ards,3231,8,10,5,15,36,43,-7,35
Glentoran,3231,9,8,8,14,31,50,-19,32
Ballinamalla,3231,10,7,5,18,29,57,-28,26
Portadown,3231,11,4,9,17,22,52,-30,21
Crusaders,3232,1,16,6,8,56,34,22,54
Cliftonville,3232,2,15,5,10,48,37,11,50
Ballymena,3232,3,14,8,8,58,58,0,50
Linfield,3232,4,13,10,7,58,33,25,49
Coleraine,3232,5,12,9,9,45,38,7,45
Glenavon,3232,6,12,9,9,45,45,0,45
Dungannon,3232,7,11,9,10,51,41,10,42
Ards,3232,8,9,6,15,39,52,-13,33
Ballinamalla,3232,9,9,5,16,33,47,-14,32
Glentoran,3232,10,7,7,16,28,54,-26,28
Portadown,3232,11,6,8,16,24,46,-22,26
Crusaders,3233,1,18,7,5,56,33,23,61
Linfield,3233,2,16,8,6,62,30,32,56
Cliftonville,3233,3,16,2,12,54,38,16,50
Ballymena,3233,4,15,5,10,60,60,0,50
Ballinamalla,3233,5,12,3,15,36,45,-9,39
Ards,3233,6,11,5,14,42,46,-4,38
Coleraine,3233,7,9,11,10,33,37,-4,38
Dungannon,3233,8,9,9,12,47,48,-1,36
Glenavon,3233,9,8,11,11,47,54,-7,35
Glentoran,3233,10,7,7,16,27,54,-27,28
Portadown,3233,11,7,6,17,20,39,-19,27
Crusaders,3234,1,16,6,8,64,36,28,54
Glenavon,3234,2,14,9,7,51,41,10,51
Linfield,3234,3,13,9,8,54,35,19,48
Coleraine,3234,4,12,11,7,42,32,10,47
Cliftonville,3234,5,13,7,10,48,42,6,46
Ballymena,3234,6,13,7,10,52,56,-4,46
Glentoran,3234,7,12,6,12,31,39,-8,42
Ballinamalla,3234,8,11,5,14,34,44,-10,38
Dungannon,3234,9,8,8,14,50,51,-1,32
Portadown,3234,10,9,4,17,23,47,-24,31
Ards,3234,11,6,4,20,25,51,-26,22
Crusaders,3235,1,16,8,6,58,38,20,56
Cliftonville,3235,2,17,3,10,56,39,17,54
Linfield,3235,3,13,9,8,59,36,23,48
Coleraine,3235,4,12,10,8,50,38,12,46
Ballymena,3235,5,13,6,11,54,59,-5,45
Glentoran,3235,6,12,5,13,36,41,-5,41
Dungannon,3235,7,9,13,8,56,46,10,40
Glenavon,3235,8,8,12,10,47,57,-10,36
Ballinamalla,3235,9,9,5,16,31,53,-22,32
Ards,3235,10,9,4,17,40,50,-10,31
Portadown,3235,11,7,5,18,30,60,-30,26
Crusaders,3236,1,17,9,4,63,37,26,60
Coleraine,3236,2,15,10,5,53,33,20,55
Linfield,3236,3,14,8,8,58,33,25,50
Glenavon,3236,4,13,10,7,55,54,1,49
Cliftonville,3236,5,14,6,10,49,41,8,48
Ballymena,3236,6,11,8,11,54,59,-5,41
Ards,3236,7,10,5,15,39,46,-7,35
Glentoran,3236,8,9,5,16,33,58,-25,32
Dungannon,3236,9,6,11,13,47,54,-7,29
Ballinamalla,3236,10,8,5,17,33,52,-19,29
Portadown,3236,11,7,5,18,32,49,-17,26
Linfield,3237,1,15,11,4,59,28,31,56
Glenavon,3237,2,12,11,7,50,42,8,47
Coleraine,3237,3,11,12,7,50,45,5,45
Crusaders,3237,4,12,8,10,47,38,9,44
Cliftonville,3237,5,12,8,10,48,41,7,44
Glentoran,3237,6,12,6,12,31,35,-4,42
Ballymena,3237,7,11,8,11,52,59,-7,41
Dungannon,3237,8,10,10,10,52,44,8,40
Ballinamalla,3237,9,8,6,16,27,48,-21,30
Portadown,3237,10,8,6,16,30,52,-22,30
Ards,3237,11,7,8,15,33,47,-14,29
Crusaders,3238,1,17,5,8,60,41,19,56
Ballymena,3238,2,15,5,10,56,52,4,50
Linfield,3238,3,13,9,8,57,37,20,48
Cliftonville,3238,4,15,3,12,48,38,10,48
Glenavon,3238,5,11,11,8,52,43,9,44
Coleraine,3238,6,11,10,9,42,44,-2,43
Glentoran,3238,7,11,8,11,33,42,-9,41
Portadown,3238,8,9,7,14,31,44,-13,34
Dungannon,3238,9,8,9,13,42,48,-6,33
Ballinamalla,3238,10,9,4,17,34,53,-19,31
Ards,3238,11,7,7,16,40,53,-13,28
Linfield,3239,1,16,10,4,65,27,38,58
Crusaders,3239,2,15,8,7,54,38,16,53
Coleraine,3239,3,13,13,4,44,31,13,52
Cliftonville,3239,4,12,11,7,49,34,15,47
Glenavon,3239,5,10,14,6,45,42,3,44
Ballymena,3239,6,11,11,8,53,61,-8,44
Dungannon,3239,7,11,6,13,52,44,8,39
Glentoran,3239,8,7,9,14,32,49,-17,30
Ards,3239,9,8,6,16,32,51,-19,30
Portadown,3239,10,6,6,18,23,43,-20,24
Ballinamalla,3239,11,5,8,17,27,56,-29,23
Cliftonville,3240,1,18,2,10,62,51,11,56
Coleraine,3240,2,15,10,5,61,39,22,55
Linfield,3240,3,15,9,6,54,32,22,54
Crusaders,3240,4,13,11,6,51,36,15,50
Ballymena,3240,5,12,8,10,61,66,-5,44
Glenavon,3240,6,10,12,8,51,46,5,42
Dungannon,3240,7,9,9,12,56,47,9,36
Glentoran,3240,8,9,6,15,39,53,-14,33
Ards,3240,9,9,4,17,38,55,-17,31
Portadown,3240,10,8,6,16,20,39,-19,30
Ballinamalla,3240,11,6,5,19,32,61,-29,23
Cliftonville,3241,1,17,5,8,57,41,16,56
Crusaders,3241,2,16,7,7,62,44,18,55
Linfield,3241,3,13,9,8,60,36,24,48
Coleraine,3241,4,13,8,9,43,38,5,47
Ballymena,3241,5,11,7,12,49,57,-8,40
Dungannon,3241,6,10,9,11,54,47,7,39
Ards,3241,7,11,4,15,39,42,-3,37
Glenavon,3241,8,8,12,10,42,48,-6,36
Ballinamalla,3241,9,10,4,16,35,54,-19,34
Glentoran,3241,10,7,10,13,27,43,-16,31
Portadown,3241,11,8,7,15,29,47,-18,31
Crusaders,3242,1,16,9,5,56,36,20,57
Linfield,3242,2,16,8,6,65,35,30,56
Cliftonville,3242,3,16,6,8,54,35,19,54
Glenavon,3242,4,11,12,7,52,45,7,45
Ballymena,3242,5,12,7,11,62,67,-5,43
Glentoran,3242,6,10,9,11,31,39,-8,39
Dungannon,3242,7,8,12,10,49,41,8,36
Coleraine,3242,8,7,12,11,40,49,-9,33
Ards,3242,9,7,9,14,32,45,-13,30
Portadown,3242,10,7,7,16,22,46,-24,28
Ballinamalla,3242,11,8,3,19,27,52,-25,27
Linfield,3243,1,18,8,4,61,24,37,62
Cliftonville,3243,2,17,7,6,56,34,22,58
Crusaders,3243,3,17,6,7,54,37,17,57
Coleraine,3243,4,12,10,8,49,42,7,46
Ballymena,3243,5,12,7,11,53,63,-10,43
Glenavon,3243,6,10,10,10,47,49,-2,40
Glentoran,3243,7,10,7,13,35,42,-7,37
Dungannon,3243,8,8,11,11,43,41,2,35
Ballinamalla,3243,9,8,5,17,31,55,-24,29
Portadown,3243,10,8,3,19,20,43,-23,27
Ards,3243,11,6,4,20,35,54,-19,22
Crusaders,3244,1,18,7,5,60,32,28,61
Linfield,3244,2,16,12,2,60,24,36,60
Glenavon,3244,3,15,9,6,53,38,15,54
Cliftonville,3244,4,13,8,9,55,46,9,47
Ballymena,3244,5,13,3,14,59,65,-6,42
Coleraine,3244,6,9,12,9,37,36,1,39
Dungannon,3244,7,10,7,13,49,43,6,37
Ballinamalla,3244,8,9,5,16,25,46,-21,32
Glentoran,3244,9,7,9,14,30,50,-20,30
Ards,3244,10,7,8,15,31,47,-16,29
Portadown,3244,11,6,4,20,21,53,-32,22
Crusaders,3245,1,17,7,6,53,37,16,58
Linfield,3245,2,16,8,6,60,31,29,56
Ballymena,3245,3,16,4,10,63,55,8,52
Cliftonville,3245,4,15,5,10,54,40,14,50
Coleraine,3245,5,11,12,7,44,35,9,45
Glenavon,3245,6,11,9,10,51,46,5,42
Dungannon,3245,7,9,8,13,47,48,-1,35
Glentoran,3245,8,9,7,14,28,47,-19,34
Portadown,3245,9,8,6,16,28,45,-17,30
Ards,3245,10,7,7,16,37,55,-18,28
Ballinamalla,3245,11,6,7,17,27,53,-26,25
Cliftonville,3246,1,17,5,8,53,34,19,56
Crusaders,3246,2,16,8,6,53,37,16,56
Glenavon,3246,3,15,9,6,51,40,11,54
Ballymena,3246,4,15,8,7,61,51,10,53
Linfield,3246,5,13,8,9,52,35,17,47
Ards,3246,6,13,6,11,48,46,2,45
Coleraine,3246,7,8,14,8,42,39,3,38
Glentoran,3246,8,8,8,14,31,46,-15,32
Dungannon,3246,9,7,8,15,45,47,-2,29
Portadown,3246,10,7,3,20,20,47,-27,24
Ballinamalla,3246,11,3,9,18,31,65,-34,18
Crusaders,3247,1,19,7,4,59,32,27,64
Linfield,3247,2,14,10,6,60,34,26,52
Cliftonville,3247,3,15,6,9,50,41,9,51
Glenavon,3247,4,14,8,8,56,44,12,50
Coleraine,3247,5,12,9,9,38,38,0,45
Dungannon,3247,6,12,8,10,49,37,12,44
Ballymena,3247,7,11,8,11,57,63,-6,41
Glentoran,3247,8,8,8,14,28,42,-14,32
Ards,3247,9,9,4,17,34,47,-13,31
Ballinamalla,3247,10,6,7,17,25,54,-29,25
Portadown,3247,11,6,3,21,27,51,-24,21
Glenavon,3248,1,14,11,5,54,39,15,53
Linfield,3248,2,14,9,7,58,37,21,51
Crusaders,3248,3,14,8,8,56,40,16,50
Coleraine,3248,4,13,10,7,37,32,5,49
Cliftonville,3248,5,15,3,12,53,44,9,48
Ballymena,3248,6,14,3,13,51,55,-4,45
Dungannon,3248,7,10,8,12,46,44,2,38
Ballinamalla,3248,8,10,4,16,34,49,-15,34
Glentoran,3248,9,8,9,13,35,49,-14,33
Portadown,3248,10,8,4,18,28,47,-19,28
Ards,3248,11,6,9,15,34,50,-16,27
Crusaders,3249,1,17,6,7,64,34,30,57
Glenavon,3249,2,15,9,6,59,41,18,54
Linfield,3249,3,14,10,6,52,25,27,52
Cliftonville,3249,4,13,8,9,50,44,6,47
Ballymena,3249,5,14,5,11,57,62,-5,47
Coleraine,3249,6,11,10,9,45,44,1,43
Dungannon,3249,7,11,9,10,51,37,14,42
Ards,3249,8,11,2,17,39,54,-15,35
Glentoran,3249,9,9,8,13,25,43,-18,35
Ballinamalla,3249,10,7,2,21,31,60,-29,23
Portadown,3249,11,6,5,19,22,51,-29,23
Crusaders,3250,1,17,7,6,54,31,23,58
Ballymena,3250,2,17,6,7,62,51,11,57
Cliftonville,3250,3,17,5,8,58,39,19,56
Linfield,3250,4,13,10,7,54,32,22,49
Glenavon,3250,5,12,10,8,44,43,1,46
Dungannon,3250,6,11,9,10,52,41,11,42
Coleraine,3250,7,9,9,12,40,48,-8,36
Glentoran,3250,8,9,8,13,35,47,-12,35
Ards,3250,9,9,7,14,41,47,-6,34
Ballinamalla,3250,10,6,4,20,27,60,-33,22
Portadown,3250,11,5,5,20,23,51,-28,20
Crusaders,3251,1,19,8,3,63,32,31,65
Linfield,3251,2,18,7,5,65,34,31,61
Cliftonville,3251,3,16,3,11,55,40,15,51
Ballymena,3251,4,14,4,12,61,65,-4,46
Glenavon,3251,5,12,9,9,46,40,6,45
Coleraine,3251,6,11,8,11,42,39,3,41
Dungannon,3251,7,11,8,11,48,47,1,41
Ards,3251,8,8,6,16,40,49,-9,30
Portadown,3251,9,9,3,18,33,52,-19,30
Glentoran,3251,10,5,10,15,20,47,-27,25
Ballinamalla,3251,11,7,4,19,24,52,-28,25
Linfield,3252,1,17,9,4,67,31,36,60
Crusaders,3252,2,14,9,7,55,35,20,51
Cliftonville,3252,3,14,7,9,53,39,14,49
Dungannon,3252,4,13,8,9,53,43,10,47
Ballymena,3252,5,13,6,11,57,61,-4,45
Coleraine,3252,6,10,10,10,35,40,-5,40
Ards,3252,7,12,2,16,38,45,-7,38
Glenavon,3252,8,8,13,9,41,45,-4,37
Glentoran,3252,9,8,8,14,30,47,-17,32
Portadown,3252,10,8,5,17,31,51,-20,29
Ballinamalla,3252,11,7,5,18,32,55,-23,26
Crusaders,3253,1,19,6,5,62,30,32,63
Linfield,3253,2,17,7,6,66,36,30,58
Cliftonville,3253,3,17,3,10,54,40,14,54
Coleraine,3253,4,11,13,6,43,36,7,46
Dungannon,3253,5,10,9,11,48,43,5,39
Glenavon,3253,6,10,9,11,41,47,-6,39
Ards,3253,7,11,5,14,43,46,-3,38
Ballymena,3253,8,10,8,12,54,64,-10,38
Glentoran,3253,9,6,9,15,25,46,-21,27
Portadown,3253,10,7,6,17,28,52,-24,27
Ballinamalla,3253,11,7,5,18,33,57,-24,26
Crusaders,3254,1,16,8,6,60,32,28,56
Linfield,3254,2,15,9,6,62,32,30,54
Cliftonville,3254,3,16,3,11,46,33,13,51
Glenavon,3254,4,14,9,7,52,46,6,51
Coleraine,3254,5,13,11,6,44,39,5,50
Ballymena,3254,6,11,8,11,59,63,-4,41
Ards,3254,7,11,4,15,40,48,-8,37
Dungannon,3254,8,9,9,12,52,48,4,36
Portadown,3254,9,7,6,17,23,42,-19,27
Glentoran,3254,10,6,9,15,24,47,-23,27
Ballinamalla,3254,11,7,4,19,32,64,-32,25
Linfield,3255,1,15,10,5,56,30,26,55
Crusaders,3255,2,15,9,6,56,42,14,54
Glenavon,3255,3,14,10,6,52,38,14,52
Cliftonville,3255,4,14,8,8,51,35,16,50
Ballymena,3255,5,14,6,10,64,58,6,48
Coleraine,3255,6,12,9,9,45,43,2,45
Ards,3255,7,10,6,14,36,45,-9,36
Dungannon,3255,8,8,10,12,51,51,0,34
Glentoran,3255,9,9,6,15,27,43,-16,33
Ballinamalla,3255,10,7,5,18,30,50,-20,26
Portadown,3255,11,6,3,21,19,52,-33,21
Crusaders,3256,1,17,6,7,58,36,22,57
Cliftonville,3256,2,15,9,6,52,34,18,54
Linfield,3256,3,13,9,8,66,39,27,48
Coleraine,3256,4,12,9,9,41,35,6,45
Glenavon,3256,5,10,12,8,39,45,-6,42
Dungannon,3256,6,9,12,9,50,43,7,39
Ballymena,3256,7,10,9,11,51,60,-9,39
Glentoran,3256,8,9,7,14,32,44,-12,34
Ards,3256,9,8,7,15,34,50,-16,31
Ballinamalla,3256,10,7,9,14,34,50,-16,30
Portadown,3256,11,7,7,16,23,44,-21,28
Linfield,3257,1,18,6,6,60,31,29,60
Crusaders,3257,2,17,6,7,57,36,21,57
Cliftonville,3257,3,17,4,9,55,36,19,55
Coleraine,3257,4,11,8,11,40,38,2,41
Ballymena,3257,5,11,8,11,53,60,-7,41
Glenavon,3257,6,9,12,9,41,42,-1,39
Ballinamalla,3257,7,12,2,16,31,47,-16,38
Dungannon,3257,8,10,7,13,48,45,3,37
Glentoran,3257,9,10,5,15,35,47,-12,35
Ards,3257,10,8,5,17,36,54,-18,29
Portadown,3257,11,7,7,16,23,43,-20,28
Crusaders,3258,1,18,7,5,54,30,24,61
Cliftonville,3258,2,15,5,10,49,37,12,50
Glenavon,3258,3,12,13,5,57,45,12,49
Linfield,3258,4,12,11,7,57,37,20,47
Ards,3258,5,12,7,11,47,50,-3,43
Coleraine,3258,6,9,13,8,37,34,3,40
Dungannon,3258,7,9,11,10,49,42,7,38
Ballymena,3258,8,9,8,13,48,65,-17,35
Glentoran,3258,9,7,12,11,31,42,-11,33
Portadown,3258,10,7,6,17,29,50,-21,27
Ballinamalla,3258,11,6,5,19,26,52,-26,23
Linfield,3259,1,14,11,5,61,33,28,53
Crusaders,3259,2,15,8,7,53,35,18,53
Cliftonville,3259,3,15,3,12,54,46,8,48
Glenavon,3259,4,13,9,8,51,47,4,48
Coleraine,3259,5,11,13,6,46,34,12,46
Ballymena,3259,6,13,5,12,63,73,-10,44
Glentoran,3259,7,11,7,12,37,40,-3,40
Dungannon,3259,8,9,9,12,50,51,-1,36
Ards,3259,9,10,4,16,39,46,-7,34
Ballinamalla,3259,10,9,5,16,27,47,-20,32
Portadown,3259,11,7,2,21,24,53,-29,23
Linfield,3260,1,14,12,4,58,28,30,54
Crusaders,3260,2,14,9,7,52,34,18,51
Coleraine,3260,3,14,9,7,55,42,13,51
Cliftonville,3260,4,15,5,10,56,39,17,50
Ballymena,3260,5,14,8,8,65,55,10,50
Glenavon,3260,6,9,12,9,50,48,2,39
Dungannon,3260,7,9,11,10,48,44,4,38
Ballinamalla,3260,8,11,3,16,32,52,-20,36
Ards,3260,9,8,6,16,34,53,-19,30
Glentoran,3260,10,6,10,14,30,52,-22,28
Portadown,3260,11,6,5,19,27,60,-33,23
Crusaders,3261,1,17,7,6,51,35,16,58
Linfield,3261,2,14,9,7,57,35,22,51
Coleraine,3261,3,13,11,6,45,33,12,50
Cliftonville,3261,4,14,7,9,57,40,17,49
Dungannon,3261,5,13,8,9,51,40,11,47
Glenavon,3261,6,11,9,10,37,39,-2,42
Ballymena,3261,7,10,7,13,51,58,-7,37
Glentoran,3261,8,10,7,13,29,40,-11,37
Portadown,3261,9,9,6,15,26,38,-12,33
Ards,3261,10,8,7,15,40,55,-15,31
Ballinamalla,3261,11,5,4,21,21,52,-31,19
Cliftonville,3262,1,19,3,8,52,32,20,60
Crusaders,3262,2,16,5,9,59,38,21,53
Ballymena,3262,3,14,6,10,53,52,1,48
Linfield,3262,4,12,10,8,58,38,20,46
Glenavon,3262,5,12,10,8,55,50,5,46
Dungannon,3262,6,12,8,10,51,35,16,44
Glentoran,3262,7,11,7,12,35,42,-7,40
Coleraine,3262,8,9,12,9,40,44,-4,39
Portadown,3262,9,8,8,14,27,42,-15,32
Ards,3262,10,8,5,17,32,56,-24,29
Ballinamalla,3262,11,5,4,21,24,57,-33,19
Crusaders,3263,1,20,6,4,51,24,27,66
Linfield,3263,2,16,8,6,58,31,27,56
Ballymena,3263,3,12,9,9,57,55,2,45
Coleraine,3263,4,11,9,10,45,46,-1,42
Cliftonville,3263,5,11,8,11,48,41,7,41
Glenavon,3263,6,9,14,7,49,45,4,41
Ards,3263,7,10,8,12,38,44,-6,38
Dungannon,3263,8,10,7,13,47,42,5,37
Glentoran,3263,9,7,9,14,31,49,-18,30
Ballinamalla,3263,10,8,4,18,33,55,-22,28
Portadown,3263,11,8,4,18,25,50,-25,28
Linfield,3264,1,16,8,6,61,32,29,56
Crusaders,3264,2,16,7,7,52,35,17,55
Ballymena,3264,3,15,6,9,59,56,3,51
Cliftonville,3264,4,15,3,12,55,40,15,48
Coleraine,3264,5,12,10,8,42,33,9,46
Glenavon,3264,6,10,12,8,43,42,1,42
Dungannon,3264,7,9,10,11,49,42,7,37
Ballinamalla,3264,8,9,7,14,30,42,-12,34
Ards,3264,9,9,4,17,35,51,-16,31
Glentoran,3264,10,7,8,15,26,51,-25,29
Portadown,3264,11,8,3,19,24,52,-28,27
Crusaders,3265,1,16,8,6,54,33,21,56
Cliftonville,3265,2,16,7,7,55,39,16,55
Linfield,3265,3,12,11,7,57,39,18,47
Glenavon,3265,4,12,10,8,49,41,8,46
Ballymena,3265,5,13,6,11,52,60,-8,45
Ballinamalla,3265,6,13,2,15,36,45,-9,41
Glentoran,3265,7,9,11,10,32,40,-8,38
Coleraine,3265,8,8,10,12,36,40,-4,34
Ards,3265,9,9,5,16,37,48,-11,32
Portadown,3265,10,8,8,14,32,46,-14,32
Dungannon,3265,11,6,8,16,43,52,-9,26
Crusaders,3266,1,16,9,5,64,37,27,57
Linfield,3266,2,15,8,7,54,31,23,53
Cliftonville,3266,3,14,8,8,52,37,15,50
Ballymena,3266,4,15,4,11,56,54,2,49
Coleraine,3266,5,10,13,7,50,46,4,43
Glenavon,3266,6,11,10,9,55,59,-4,43
Dungannon,3266,7,9,11,10,49,42,7,38
Ards,3266,8,11,4,15,41,46,-5,37
Glentoran,3266,9,8,6,16,26,47,-21,30
Portadown,3266,10,7,6,17,32,49,-17,27
Ballinamalla,3266,11,7,5,18,29,60,-31,26
Glenavon,3267,1,17,9,4,55,36,19,60
Cliftonville,3267,2,16,4,10,53,39,14,52
Crusaders,3267,3,15,7,8,49,36,13,52
Linfield,3267,4,11,10,9,51,36,15,43
Dungannon,3267,5,12,7,11,60,48,12,43
Coleraine,3267,6,11,8,11,40,41,-1,41
Ballymena,3267,7,11,7,12,54,63,-9,40
Ards,3267,8,11,5,14,38,49,-11,38
Ballinamalla,3267,9,9,6,15,33,46,-13,33
Glentoran,3267,10,7,10,13,28,41,-13,31
Portadown,3267,11,5,7,18,18,44,-26,22
Crusaders,3268,1,17,8,5,56,30,26,59
Cliftonville,3268,2,18,3,9,59,42,17,57
Ballymena,3268,3,16,4,10,58,55,3,52
Linfield,3268,4,14,9,7,59,34,25,51
Coleraine,3268,5,12,10,8,48,39,9,46
Dungannon,3268,6,12,9,9,48,42,6,45
Glenavon,3268,7,10,11,9,48,46,2,41
Ards,3268,8,9,6,15,35,47,-12,33
Glentoran,3268,9,8,7,15,29,41,-12,31
Ballinamalla,3268,10,8,3,19,27,51,-24,27
Portadown,3268,11,4,4,22,17,57,-40,16
Crusaders,3269,1,17,8,5,53,31,22,59
Coleraine,3269,2,14,9,7,50,37,13,51
Glenavon,3269,3,14,8,8,52,42,10,50
Ballymena,3269,4,14,7,9,54,50,4,49
Linfield,3269,5,11,10,9,54,37,17,43
Cliftonville,3269,6,12,6,12,48,48,0,42
Dungannon,3269,7,10,9,11,47,42,5,39
Glentoran,3269,8,9,8,13,32,41,-9,35
Portadown,3269,9,8,6,16,24,41,-17,30
Ards,3269,10,7,8,15,33,51,-18,29
Ballinamalla,3269,11,6,7,17,27,54,-27,25
Linfield,3270,1,17,10,3,58,23,35,61
Cliftonville,3270,2,16,6,8,59,39,20,54
Glenavon,3270,3,14,11,5,61,40,21,53
Crusaders,3270,4,14,11,5,53,38,15,53
Coleraine,3270,5,11,12,7,38,37,1,45
Dungannon,3270,6,10,8,12,57,51,6,38
Ballymena,3270,7,10,6,14,46,61,-15,36
Glentoran,3270,8,8,9,13,29,43,-14,33
Ards,3270,9,8,8,14,38,49,-11,32
Ballinamalla,3270,10,5,7,18,26,58,-32,22
Portadown,3270,11,5,6,19,25,51,-26,21
Linfield,3271,1,15,9,6,53,23,30,54
Crusaders,3271,2,16,6,8,58,37,21,54
Cliftonville,3271,3,16,6,8,51,38,13,54
Ballymena,3271,4,14,5,11,63,58,5,47
Glenavon,3271,5,12,10,8,49,45,4,46
Coleraine,3271,6,10,13,7,40,37,3,43
Dungannon,3271,7,10,7,13,52,49,3,37
Glentoran,3271,8,10,4,16,31,47,-16,34
Ballinamalla,3271,9,10,3,17,28,52,-24,33
Ards,3271,10,9,3,18,36,52,-16,30
Portadown,3271,11,7,6,17,26,49,-23,27
Crusaders,3272,1,16,11,3,56,32,24,59
Linfield,3272,2,15,8,7,61,34,27,53
Cliftonville,3272,3,16,5,9,51,42,9,53
Glenavon,3272,4,14,10,6,50,39,11,52
Ballymena,3272,5,15,5,10,63,56,7,50
Coleraine,3272,6,10,10,10,37,38,-1,40
Ards,3272,7,11,6,13,39,46,-7,39
Dungannon,3272,8,9,8,13,46,46,0,35
Glentoran,3272,9,7,8,15,31,51,-20,29
Portadown,3272,10,6,8,16,24,42,-18,26
Ballinamalla,3272,11,5,3,22,26,58,-32,18
Linfield,3273,1,17,7,6,64,28,36,58
Cliftonville,3273,2,18,4,8,59,37,22,58
Ballymena,3273,3,15,7,8,60,55,5,52
Crusaders,3273,4,14,6,10,54,47,7,48
Coleraine,3273,5,11,10,9,43,44,-1,43
Glenavon,3273,6,9,13,8,42,42,0,40
Glentoran,3273,7,10,7,13,32,45,-13,37
Dungannon,3273,8,9,7,14,50,48,2,34
Ards,3273,9,10,4,16,43,53,-10,34
Ballinamalla,3273,10,7,6,17,36,55,-19,27
Portadown,3273,11,6,7,17,22,51,-29,25
Crusaders,3274,1,18,10,2,59,22,37,64
Linfield,3274,2,16,9,5,63,33,30,57
Cliftonville,3274,3,15,5,10,47,35,12,50
Ballymena,3274,4,14,4,12,54,62,-8,46
Ards,3274,5,13,3,14,41,41,0,42
Coleraine,3274,6,11,9,10,39,40,-1,42
Glenavon,3274,7,9,10,11,47,53,-6,37
Dungannon,3274,8,8,12,10,53,48,5,36
Glentoran,3274,9,7,8,15,30,47,-17,29
Portadown,3274,10,8,3,19,21,45,-24,27
Ballinamalla,3274,11,8,3,19,30,58,-28,27
Crusaders,3275,1,17,7,6,59,34,25,58
Glenavon,3275,2,13,12,5,48,34,14,51
Cliftonville,3275,3,14,6,10,52,36,16,48
Coleraine,3275,4,13,9,8,46,38,8,48
Linfield,3275,5,12,9,9,55,40,15,45
Ballymena,3275,6,12,7,11,54,62,-8,43
Dungannon,3275,7,10,8,12,46,39,7,38
Glentoran,3275,8,9,9,12,39,54,-15,36
Ards,3275,9,9,6,15,41,52,-11,33
Portadown,3275,10,9,5,16,32,51,-19,32
Ballinamalla,3275,11,6,4,20,27,59,-32,22
Crusaders,3276,1,20,5,5,60,28,32,65
Linfield,3276,2,16,8,6,58,29,29,56
Cliftonville,3276,3,16,3,11,52,44,8,51
Glenavon,3276,4,12,11,7,50,39,11,47
Ballymena,3276,5,14,5,11,57,59,-2,47
Dungannon,3276,6,11,8,11,55,47,8,41
Coleraine,3276,7,10,11,9,46,44,2,41
Ards,3276,8,10,6,14,40,49,-9,36
Ballinamalla,3276,9,8,3,19,22,50,-28,27
Glentoran,3276,10,6,7,17,26,48,-22,25
Portadown,3276,11,5,7,18,19,48,-29,22
Crusaders,3277,1,21,4,5,60,29,31,67
Linfield,3277,2,16,9,5,59,29,30,57
Ballymena,3277,3,16,6,8,58,53,5,54
Coleraine,3277,4,12,9,9,48,38,10,45
Cliftonville,3277,5,12,5,13,47,41,6,41
Glenavon,3277,6,10,11,9,46,48,-2,41
Dungannon,3277,7,10,10,10,51,44,7,40
Ards,3277,8,10,5,15,37,43,-6,35
Glentoran,3277,9,8,7,15,26,44,-18,31
Portadown,3277,10,5,7,18,20,48,-28,22
Ballinamalla,3277,11,5,7,18,22,57,-35,22
Crusaders,3278,1,16,7,7,58,36,22,55
Cliftonville,3278,2,15,7,8,49,36,13,52
Linfield,3278,3,14,9,7,54,31,23,51
Glenavon,3278,4,12,13,5,49,38,11,49
Ballymena,3278,5,14,7,9,55,58,-3,49
Dungannon,3278,6,9,13,8,56,45,11,40
Coleraine,3278,7,10,10,10,42,38,4,40
Glentoran,3278,8,9,6,15,24,45,-21,33
Ards,3278,9,9,5,16,37,49,-12,32
Ballinamalla,3278,10,6,10,14,26,45,-19,28
Portadown,3278,11,4,7,19,17,46,-29,19
Linfield,3279,1,20,6,4,64,27,37,66
Cliftonville,3279,2,17,3,10,60,40,20,54
Coleraine,3279,3,14,10,6,46,35,11,52
Crusaders,3279,4,15,6,9,50,39,11,51
Glenavon,3279,5,11,14,5,50,43,7,47
Dungannon,3279,6,10,10,10,51,40,11,40
Ballymena,3279,7,10,7,13,51,63,-12,37
Ards,3279,8,9,5,16,35,47,-12,32
Glentoran,3279,9,8,8,14,31,43,-12,32
Ballinamalla,3279,10,7,4,19,24,53,-29,25
Portadown,3279,11,6,3,21,22,54,-32,21
Linfield,3280,1,18,8,4,61,27,34,62
Cliftonville,3280,2,16,6,8,54,37,17,54
Glenavon,3280,3,14,10,6,58,44,14,52
Crusaders,3280,4,14,6,10,52,44,8,48
Coleraine,3280,5,13,7,10,39,35,4,46
Dungannon,3280,6,12,8,10,53,40,13,44
Ballymena,3280,7,11,8,11,49,55,-6,41
Glentoran,3280,8,8,9,13,34,51,-17,33
Ards,3280,9,6,9,15,35,51,-16,27
Portadown,3280,10,8,3,19,30,55,-25,27
Ballinamalla,3280,11,5,6,19,31,57,-26,21
Crusaders,3281,1,16,6,8,61,43,18,54
Cliftonville,3281,2,15,6,9,57,44,13,51
Ballymena,3281,3,15,6,9,60,52,8,51
Linfield,3281,4,14,8,8,59,34,25,50
Glenavon,3281,5,12,10,8,57,49,8,46
Coleraine,3281,6,12,9,9,45,34,11,45
Dungannon,3281,7,10,8,12,47,48,-1,38
Portadown,3281,8,10,4,16,30,49,-19,34
Glentoran,3281,9,9,6,15,32,57,-25,33
Ballinamalla,3281,10,9,4,17,36,54,-18,31
Ards,3281,11,7,5,18,33,53,-20,26
Linfield,3282,1,16,9,5,68,33,35,57
Cliftonville,3282,2,18,2,10,50,32,18,56
Crusaders,3282,3,17,5,8,53,42,11,56
Ballymena,3282,4,13,7,10,59,65,-6,46
Coleraine,3282,5,10,12,8,36,33,3,42
Glentoran,3282,6,10,6,14,30,42,-12,36
Glenavon,3282,7,8,11,11,42,42,0,35
Ards,3282,8,8,9,13,38,53,-15,33
Dungannon,3282,9,8,8,14,51,48,3,32
Ballinamalla,3282,10,9,5,16,27,47,-20,32
Portadown,3282,11,8,6,16,22,39,-17,30
Crusaders,3283,1,16,11,3,56,31,25,59
Cliftonville,3283,2,15,6,9,61,38,23,51
Linfield,3283,3,12,12,6,68,42,26,48
Ballymena,3283,4,14,5,11,57,65,-8,47
Dungannon,3283,5,12,9,9,54,36,18,45
Coleraine,3283,6,12,9,9,46,44,2,45
Glenavon,3283,7,11,10,9,52,46,6,43
Portadown,3283,8,9,7,14,28,40,-12,34
Glentoran,3283,9,8,9,13,28,47,-19,33
Ards,3283,10,7,6,17,35,63,-28,27
Ballinamalla,3283,11,5,4,21,30,63,-33,19
Crusaders,3284,1,17,7,6,53,32,21,58
Linfield,3284,2,13,13,4,53,26,27,52
Cliftonville,3284,3,16,4,10,57,43,14,52
Ballymena,3284,4,14,6,10,54,58,-4,48
Glentoran,3284,5,12,7,11,36,39,-3,43
Coleraine,3284,6,11,9,10,40,39,1,42
Glenavon,3284,7,10,9,11,47,45,2,39
Portadown,3284,8,9,6,15,25,38,-13,33
Ballinamalla,3284,9,9,3,18,31,51,-20,30
Ards,3284,10,7,8,15,31,45,-14,29
Dungannon,3284,11,6,10,14,35,46,-11,28
Crusaders,3285,1,18,9,3,58,28,30,63
Ballymena,3285,2,17,5,8,62,52,10,56
Cliftonville,3285,3,15,8,7,53,36,17,53
Linfield,3285,4,15,7,8,59,32,27,52
Coleraine,3285,5,10,14,6,41,32,9,44
Glenavon,3285,6,7,14,9,40,45,-5,35
Dungannon,3285,7,7,12,11,45,45,0,33
Ards,3285,8,9,6,15,37,49,-12,33
Glentoran,3285,9,6,10,14,30,49,-19,28
Portadown,3285,10,6,7,17,27,51,-24,25
Ballinamalla,3285,11,5,8,17,28,61,-33,23
Linfield,3286,1,20,7,3,70,21,49,67
Crusaders,3286,2,17,6,7,53,29,24,57
Coleraine,3286,3,15,9,6,50,35,15,54
Glenavon,3286,4,12,12,6,54,45,9,48
Cliftonville,3286,5,13,5,12,47,44,3,44
Ballymena,3286,6,12,7,11,60,66,-6,43
Dungannon,3286,7,9,8,13,45,51,-6,35
Glentoran,3286,8,9,7,14,32,46,-14,34
Ballinamalla,3286,9,8,6,16,31,45,-14,30
Ards,3286,10,5,8,17,27,53,-26,23
Portadown,3286,11,5,5,20,19,53,-34,20
Crusaders,3287,1,16,7,7,49,38,11,55
Linfield,3287,2,15,7,8,58,33,25,52
Coleraine,3287,3,14,9,7,49,36,13,51
Cliftonville,3287,4,15,5,10,55,41,14,50
Ballymena,3287,5,13,5,12,58,63,-5,44
Glenavon,3287,6,10,11,9,45,45,0,41
Dungannon,3287,7,11,7,12,53,44,9,40
Glentoran,3287,8,9,9,12,32,42,-10,36
Ards,3287,9,9,5,16,35,47,-12,32
Portadown,3287,10,8,7,15,32,48,-16,31
Ballinamalla,3287,11,6,6,18,24,53,-29,24
Crusaders,3288,1,17,10,3,58,28,30,61
Ballymena,3288,2,15,5,10,61,55,6,50
Linfield,3288,3,13,10,7,57,35,22,49
Cliftonville,3288,4,15,4,11,44,37,7,49
Dungannon,3288,5,11,9,10,43,38,5,42
Glenavon,3288,6,11,9,10,49,46,3,42
Coleraine,3288,7,10,10,10,40,38,2,40
Portadown,3288,8,9,6,15,28,41,-13,33
Ballinamalla,3288,9,9,6,15,31,49,-18,33
Glentoran,3288,10,9,4,17,26,53,-27,31
Ards,3288,11,7,5,18,36,53,-17,26
Ballymena,3289,1,18,5,7,66,50,16,59
Crusaders,3289,2,16,8,6,52,36,16,56
Cliftonville,3289,3,15,7,8,46,33,13,52
Linfield,3289,4,12,10,8,50,31,19,46
Glenavon,3289,5,9,14,7,50,45,5,41
Dungannon,3289,6,9,10,11,52,50,2,37
Coleraine,3289,7,9,10,11,43,43,0,37
Ballinamalla,3289,8,9,6,15,29,46,-17,33
Ards,3289,9,9,5,16,42,53,-11,32
Glentoran,3289,10,8,7,15,31,48,-17,31
Portadown,3289,11,7,6,17,23,49,-26,27
Crusaders,3290,1,18,6,6,58,33,25,60
Linfield,3290,2,15,8,7,59,34,25,53
Ballymena,3290,3,14,7,9,64,55,9,49
Ards,3290,4,14,4,12,47,44,3,46
Glenavon,3290,5,11,10,9,45,47,-2,43
Cliftonville,3290,6,12,5,13,43,44,-1,41
Dungannon,3290,7,9,10,11,48,44,4,37
Coleraine,3290,8,9,10,11,37,44,-7,37
Glentoran,3290,9,9,8,13,36,53,-17,35
Portadown,3290,10,8,5,17,24,44,-20,29
Ballinamalla,3290,11,7,5,18,27,46,-19,26
Crusaders,3291,1,18,7,5,54,30,24,61
Cliftonville,3291,2,17,6,7,54,35,19,57
Glenavon,3291,3,13,10,7,48,41,7,49
Ballymena,3291,4,14,7,9,59,53,6,49
Linfield,3291,5,12,12,6,53,31,22,48
Ballinamalla,3291,6,11,3,16,28,44,-16,36
Coleraine,3291,7,7,13,10,38,43,-5,34
Ards,3291,8,9,7,14,36,46,-10,34
Dungannon,3291,9,8,9,13,47,47,0,33
Glentoran,3291,10,8,6,16,31,51,-20,30
Portadown,3291,11,4,8,18,17,44,-27,20
Crusaders,3292,1,16,8,6,58,37,21,56
Cliftonville,3292,2,14,6,10,54,39,15,48
Ballymena,3292,3,14,5,11,62,55,7,47
Linfield,3292,4,12,10,8,52,31,21,46
Coleraine,3292,5,12,10,8,37,37,0,46
Glenavon,3292,6,11,10,9,45,44,1,43
Ards,3292,7,11,5,14,43,52,-9,38
Dungannon,3292,8,9,8,13,52,45,7,35
Glentoran,3292,9,9,8,13,33,46,-13,35
Portadown,3292,10,8,6,16,31,53,-22,30
Ballinamalla,3292,11,8,6,16,26,54,-28,30
Crusaders,3293,1,17,8,5,52,32,20,59
Linfield,3293,2,15,11,4,64,29,35,56
Ballymena,3293,3,15,6,9,57,53,4,51
Coleraine,3293,4,13,10,7,50,36,14,49
Cliftonville,3293,5,15,4,11,51,39,12,49
Glenavon,3293,6,12,12,6,49,46,3,48
Ards,3293,7,10,7,13,45,55,-10,37
Glentoran,3293,8,7,7,16,28,42,-14,28
Ballinamalla,3293,9,7,5,18,30,55,-25,26
Portadown,3293,10,7,5,18,22,51,-29,26
Dungannon,3293,11,4,11,15,41,51,-10,23
Linfield,3294,1,16,10,4,62,30,32,58
Crusaders,3294,2,17,6,7,59,36,23,57
Cliftonville,3294,3,15,5,10,60,43,17,50
Glenavon,3294,4,12,12,6,53,42,11,48
Dungannon,3294,5,10,11,9,52,43,9,41
Ballymena,3294,6,12,5,13,66,64,2,41
Coleraine,3294,7,9,13,8,38,41,-3,40
Glentoran,3294,8,10,7,13,32,48,-16,37
Ballinamalla,3294,9,7,6,17,28,49,-21,27
Portadown,3294,10,7,6,17,24,55,-31,27
Ards,3294,11,7,5,18,32,55,-23,26
Crusaders,3295,1,16,6,8,58,35,23,54
Linfield,3295,2,15,8,7,64,33,31,53
Cliftonville,3295,3,15,7,8,52,38,14,52
Ballymena,3295,4,15,7,8,60,52,8,52
Dungannon,3295,5,12,9,9,52,42,10,45
Coleraine,3295,6,12,9,9,42,49,-7,45
Ballinamalla,3295,7,10,5,15,34,51,-17,35
Portadown,3295,8,8,7,15,29,46,-17,31
Glenavon,3295,9,6,12,12,39,48,-9,30
Glentoran,3295,10,8,6,16,34,54,-20,30
Ards,3295,11,8,4,18,38,54,-16,28
Crusaders,3296,1,19,7,4,57,29,28,64
Cliftonville,3296,2,16,3,11,56,39,17,51
Linfield,3296,3,11,12,7,56,34,22,45
Glenavon,3296,4,12,9,9,51,46,5,45
Ballymena,3296,5,13,6,11,53,56,-3,45
Dungannon,3296,6,11,11,8,48,44,4,44
Ards,3296,7,10,5,15,47,49,-2,35
Portadown,3296,8,9,7,14,26,41,-15,34
Coleraine,3296,9,8,9,13,35,43,-8,33
Glentoran,3296,10,8,9,13,35,50,-15,33
Ballinamalla,3296,11,7,4,19,22,55,-33,25
Crusaders,3297,1,20,7,3,59,28,31,67
Cliftonville,3297,2,16,5,9,56,38,18,53
Linfield,3297,3,14,8,8,52,39,13,50
Coleraine,3297,4,13,9,8,51,40,11,48
Ballymena,3297,5,13,7,10,56,56,0,46
Glenavon,3297,6,10,12,8,52,43,9,42
Dungannon,3297,7,10,8,12,52,45,7,38
Portadown,3297,8,8,9,13,29,39,-10,33
Glentoran,3297,9,8,7,15,29,49,-20,31
Ards,3297,10,8,3,19,37,60,-23,27
Ballinamalla,3297,11,5,5,20,27,63,-36,20
Crusaders,3298,1,19,7,4,59,29,30,64
Linfield,3298,2,15,8,7,58,31,27,53
Cliftonville,3298,3,13,9,8,50,40,10,48
Dungannon,3298,4,12,9,9,58,43,15,45
Ballymena,3298,5,12,6,12,56,58,-2,42
Coleraine,3298,6,9,13,8,41,35,6,40
Glenavon,3298,7,7,14,9,42,48,-6,35
Ards,3298,8,10,4,16,36,55,-19,34
Glentoran,3298,9,9,5,16,30,51,-21,32
Ballinamalla,3298,10,9,3,18,32,52,-20,30
Portadown,3298,11,8,6,16,23,43,-20,30
Linfield,3299,1,16,9,5,64,27,37,57
Ballymena,3299,2,15,7,8,60,54,6,52
Crusaders,3299,3,14,9,7,53,30,23,51
Coleraine,3299,4,12,11,7,44,37,7,47
Cliftonville,3299,5,14,4,12,52,47,5,46
Dungannon,3299,6,10,9,11,51,48,3,39
Glenavon,3299,7,9,12,9,37,45,-8,39
Glentoran,3299,8,7,12,11,32,41,-9,33
Portadown,3299,9,8,7,15,31,46,-15,31
Ards,3299,10,7,7,16,35,58,-23,28
Ballinamalla,3299,11,5,9,16,31,57,-26,24
Cliftonville,3300,1,16,5,9,48,34,14,53
Linfield,3300,2,14,9,7,54,34,20,51
Dungannon,3300,3,13,8,9,60,42,18,47
Coleraine,3300,4,11,13,6,39,32,7,46
Glenavon,3300,5,12,10,8,46,42,4,46
Crusaders,3300,6,12,9,9,46,39,7,45
Glentoran,3300,7,11,5,14,37,42,-5,38
Ballymena,3300,8,10,8,12,42,53,-11,38
Ards,3300,9,10,4,16,36,47,-11,34
Portadown,3300,10,8,6,16,24,44,-20,30
Ballinamalla,3300,11,8,3,19,29,52,-23,27
Linfield,3301,1,16,9,5,63,26,37,57
Crusaders,3301,2,16,9,5,54,27,27,57
Cliftonville,3301,3,15,6,9,51,41,10,51
Ballymena,3301,4,13,9,8,54,53,1,48
Glenavon,3301,5,11,14,5,43,35,8,47
Coleraine,3301,6,9,14,7,40,35,5,41
Dungannon,3301,7,7,14,9,42,37,5,35
Glentoran,3301,8,9,8,13,26,42,-16,35
Ards,3301,9,10,4,16,34,49,-15,34
Ballinamalla,3301,10,4,9,17,26,52,-26,21
Portadown,3301,11,5,4,21,18,54,-36,19
Crusaders,3302,1,18,5,7,57,34,23,59
Ballymena,3302,2,15,7,8,55,50,5,52
Glenavon,3302,3,13,9,8,45,37,8,48
Cliftonville,3302,4,14,5,11,49,40,9,47
Linfield,3302,5,11,11,8,49,34,15,44
Coleraine,3302,6,9,12,9,37,38,-1,39
Portadown,3302,7,11,6,13,28,38,-10,39
Ards,3302,8,9,7,14,40,49,-9,34
Dungannon,3302,9,8,9,13,42,43,-1,33
Glentoran,3302,10,8,7,15,32,45,-13,31
Ballinamalla,3302,11,7,6,17,22,48,-26,27
Crusaders,3303,1,17,6,7,56,37,19,57
Linfield,3303,2,16,7,7,58,29,29,55
Cliftonville,3303,3,16,5,9,53,39,14,53
Ballymena,3303,4,14,5,11,56,49,7,47
Glenavon,3303,5,12,9,9,50,45,5,45
Coleraine,3303,6,11,9,10,36,36,0,42
Dungannon,3303,7,9,10,11,48,42,6,37
Ballinamalla,3303,8,9,6,15,27,46,-19,33
Portadown,3303,9,7,10,13,24,41,-17,31
Glentoran,3303,10,7,8,15,27,50,-23,29
Ards,3303,11,7,5,18,29,50,-21,26
Crusaders,3304,1,17,7,6,55,32,23,58
Cliftonville,3304,2,17,6,7,49,33,16,57
Ballymena,3304,3,16,5,9,60,55,5,53
Linfield,3304,4,14,10,6,63,37,26,52
Coleraine,3304,5,12,13,5,38,29,9,49
Dungannon,3304,6,9,10,11,41,39,2,37
Glentoran,3304,7,9,7,14,29,43,-14,34
Portadown,3304,8,9,4,17,29,41,-12,31
Glenavon,3304,9,6,12,12,43,52,-9,30
Ballinamalla,3304,10,7,7,16,29,49,-20,28
Ards,3304,11,6,5,19,31,57,-26,23
Crusaders,3305,1,19,5,6,60,32,28,62
Linfield,3305,2,14,8,8,55,31,24,50
Ballymena,3305,3,14,7,9,50,54,-4,49
Glenavon,3305,4,12,10,8,55,43,12,46
Cliftonville,3305,5,13,7,10,48,41,7,46
Dungannon,3305,6,11,9,10,48,45,3,42
Coleraine,3305,7,10,10,10,37,39,-2,40
Glentoran,3305,8,9,7,14,32,44,-12,34
Ards,3305,9,9,5,16,38,51,-13,32
Ballinamalla,3305,10,8,5,17,26,47,-21,29
Portadown,3305,11,6,7,17,21,43,-22,25
Crusaders,3306,1,19,6,5,63,34,29,63
Coleraine,3306,2,16,10,4,56,31,25,58
Linfield,3306,3,14,9,7,58,36,22,51
Glenavon,3306,4,12,9,9,49,48,1,45
Cliftonville,3306,5,12,6,12,47,42,5,42
Ballymena,3306,6,11,7,12,52,61,-9,40
Dungannon,3306,7,9,11,10,54,46,8,38
Ards,3306,8,11,5,14,39,47,-8,38
Glentoran,3306,9,7,10,13,31,48,-17,31
Ballinamalla,3306,10,9,4,17,34,58,-24,31
Portadown,3306,11,4,5,21,15,47,-32,17
Cliftonville,3307,1,17,4,9,56,38,18,55
Crusaders,3307,2,16,7,7,51,36,15,55
Linfield,3307,3,13,8,9,54,30,24,47
Coleraine,3307,4,11,12,7,37,32,5,45
Dungannon,3307,5,10,11,9,51,43,8,41
Glenavon,3307,6,8,15,7,44,42,2,39
Ards,3307,7,11,6,13,43,45,-2,39
Ballymena,3307,8,11,6,13,51,65,-14,39
Glentoran,3307,9,9,8,13,30,43,-13,35
Portadown,3307,10,8,6,16,28,49,-21,30
Ballinamalla,3307,11,6,7,17,30,52,-22,25
Linfield,3308,1,17,8,5,63,31,32,59
Crusaders,3308,2,18,5,7,55,32,23,59
Cliftonville,3308,3,16,5,9,53,41,12,53
Ballymena,3308,4,14,6,10,55,55,0,48
Coleraine,3308,5,11,8,11,38,41,-3,41
Glenavon,3308,6,9,12,9,43,45,-2,39
Dungannon,3308,7,9,9,12,46,45,1,36
Ards,3308,8,9,6,15,40,48,-8,33
Glentoran,3308,9,7,9,14,30,47,-17,30
Portadown,3308,10,7,8,15,25,42,-17,29
Ballinamalla,3308,11,7,6,17,29,50,-21,27
Cliftonville,3309,1,17,4,9,57,37,20,55
Linfield,3309,2,14,12,4,53,26,27,54
Crusaders,3309,3,16,5,9,54,36,18,53
Coleraine,3309,4,11,10,9,51,45,6,43
Ballymena,3309,5,12,6,12,58,61,-3,42
Glenavon,3309,6,10,11,9,46,53,-7,41
Dungannon,3309,7,10,8,12,59,52,7,38
Glentoran,3309,8,9,9,12,33,45,-12,36
Ards,3309,9,10,5,15,39,51,-12,35
Ballinamalla,3309,10,8,6,16,33,52,-19,30
Portadown,3309,11,7,6,17,22,47,-25,27
Linfield,3310,1,16,10,4,69,32,37,58
Ballymena,3310,2,15,9,6,61,54,7,54
Cliftonville,3310,3,14,8,8,60,39,21,50
Coleraine,3310,4,12,11,7,46,40,6,47
Crusaders,3310,5,13,7,10,53,40,13,46
Glenavon,3310,6,11,13,6,47,42,5,46
Dungannon,3310,7,9,10,11,52,49,3,37
Glentoran,3310,8,9,8,13,30,49,-19,35
Ballinamalla,3310,9,8,6,16,36,54,-18,30
Ards,3310,10,6,5,19,35,61,-26,23
Portadown,3310,11,5,7,18,23,52,-29,22
Linfield,3311,1,15,10,5,61,33,28,55
Crusaders,3311,2,14,7,9,44,37,7,49
Cliftonville,3311,3,14,5,11,52,40,12,47
Glenavon,3311,4,12,9,9,52,44,8,45
Glentoran,3311,5,11,9,10,38,38,0,42
Ballymena,3311,6,11,9,10,52,57,-5,42
Coleraine,3311,7,11,8,11,35,42,-7,41
Dungannon,3311,8,10,8,12,49,44,5,38
Ards,3311,9,10,5,15,33,44,-11,35
Portadown,3311,10,10,3,17,31,47,-16,33
Ballinamalla,3311,11,8,5,17,26,47,-21,29
Crusaders,3312,1,16,7,7,55,33,22,55
Cliftonville,3312,2,14,8,8,47,36,11,50
Coleraine,3312,3,13,11,6,44,35,9,50
Glenavon,3312,4,13,10,7,48,42,6,49
Linfield,3312,5,12,11,7,53,32,21,47
Ballymena,3312,6,13,4,13,55,56,-1,43
Dungannon,3312,7,10,9,11,46,42,4,39
Glentoran,3312,8,10,7,13,31,40,-9,37
Ards,3312,9,9,6,15,34,43,-9,33
Ballinamalla,3312,10,9,4,17,29,47,-18,31
Portadown,3312,11,5,5,20,17,53,-36,20
Linfield,3313,1,15,7,8,60,30,30,52
Crusaders,3313,2,15,7,8,54,41,13,52
Glenavon,3313,3,13,11,6,56,47,9,50
Dungannon,3313,4,12,9,9,57,41,16,45
Cliftonville,3313,5,13,6,11,53,41,12,45
Coleraine,3313,6,10,13,7,40,33,7,43
Ballymena,3313,7,12,5,13,55,60,-5,41
Glentoran,3313,8,11,6,13,33,51,-18,39
Ballinamalla,3313,9,10,3,17,34,51,-17,33
Ards,3313,10,9,3,18,38,58,-20,30
Portadown,3313,11,8,4,18,24,51,-27,28
Linfield,3314,1,16,9,5,62,34,28,57
Ballymena,3314,2,16,6,8,61,53,8,54
Cliftonville,3314,3,14,5,11,55,41,14,47
Crusaders,3314,4,12,10,8,47,45,2,46
Glenavon,3314,5,10,12,8,45,45,0,42
Dungannon,3314,6,10,10,10,58,45,13,40
Coleraine,3314,7,8,14,8,40,39,1,38
Glentoran,3314,8,8,10,12,28,41,-13,34
Portadown,3314,9,9,6,15,29,43,-14,33
Ards,3314,10,7,9,14,32,48,-16,30
Ballinamalla,3314,11,7,5,18,28,51,-23,26
Crusaders,3315,1,16,10,4,57,33,24,58
Linfield,3315,2,15,8,7,58,33,25,53
Coleraine,3315,3,14,10,6,49,35,14,52
Ballymena,3315,4,13,6,11,56,59,-3,45
Glenavon,3315,5,11,11,8,43,42,1,44
Cliftonville,3315,6,12,7,11,50,43,7,43
Dungannon,3315,7,11,9,10,56,47,9,42
Glentoran,3315,8,8,11,11,28,40,-12,35
Ards,3315,9,10,3,17,38,46,-8,33
Portadown,3315,10,7,5,18,26,51,-25,26
Ballinamalla,3315,11,6,4,20,26,58,-32,22
Linfield,3316,1,16,7,7,56,28,28,55
Crusaders,3316,2,15,7,8,53,40,13,52
Cliftonville,3316,3,14,6,10,52,38,14,48
Coleraine,3316,4,11,14,5,44,31,13,47
Dungannon,3316,5,11,11,8,52,43,9,44
Ballymena,3316,6,12,5,13,54,59,-5,41
Glenavon,3316,7,10,10,10,44,46,-2,40
Ards,3316,8,10,5,15,36,45,-9,35
Portadown,3316,9,10,4,16,29,46,-17,34
Glentoran,3316,10,8,9,13,33,52,-19,33
Ballinamalla,3316,11,7,4,19,28,53,-25,25
Cliftonville,3317,1,17,4,9,56,39,17,55
Crusaders,3317,2,13,9,8,52,41,11,48
Ballymena,3317,3,14,6,10,57,54,3,48
Glenavon,3317,4,11,11,8,46,41,5,44
Linfield,3317,5,10,12,8,50,35,15,42
Coleraine,3317,6,10,12,8,40,42,-2,42
Dungannon,3317,7,10,11,9,57,48,9,41
Ballinamalla,3317,8,10,7,13,33,46,-13,37
Ards,3317,9,9,5,16,37,49,-12,32
Glentoran,3317,10,7,10,13,28,39,-11,31
Portadown,3317,11,8,5,17,25,47,-22,29
Crusaders,3318,1,17,7,6,57,35,22,58
Cliftonville,3318,2,16,5,9,55,38,17,53
Ballymena,3318,3,13,9,8,61,61,0,48
Linfield,3318,4,12,10,8,55,33,22,46
Glenavon,3318,5,13,7,10,52,46,6,46
Dungannon,3318,6,10,9,11,54,51,3,39
Coleraine,3318,7,9,12,9,41,41,0,39
Ards,3318,8,9,8,13,37,47,-10,35
Glentoran,3318,9,9,7,14,26,49,-23,34
Portadown,3318,10,9,6,15,28,38,-10,33
Ballinamalla,3318,11,6,4,20,27,54,-27,22
Crusaders,3319,1,16,8,6,52,35,17,56
Linfield,3319,2,14,10,6,55,29,26,52
Ballymena,3319,3,16,4,10,63,57,6,52
Cliftonville,3319,4,15,5,10,52,36,16,50
Coleraine,3319,5,12,10,8,37,30,7,46
Glentoran,3319,6,11,9,10,35,38,-3,42
Glenavon,3319,7,10,10,10,50,52,-2,40
Portadown,3319,8,11,4,15,32,49,-17,37
Dungannon,3319,9,8,9,13,46,51,-5,33
Ards,3319,10,8,6,16,37,47,-10,30
Ballinamalla,3319,11,4,5,21,21,56,-35,17
Crusaders,3320,1,18,6,6,57,29,28,60
Linfield,3320,2,14,7,9,51,33,18,49
Dungannon,3320,3,12,10,8,57,42,15,46
Coleraine,3320,4,11,13,6,43,31,12,46
Cliftonville,3320,5,13,7,10,53,43,10,46
Glenavon,3320,6,10,11,9,44,47,-3,41
Ballymena,3320,7,12,5,13,51,64,-13,41
Glentoran,3320,8,11,7,12,31,39,-8,40
Ballinamalla,3320,9,9,3,18,28,51,-23,30
Portadown,3320,10,7,8,15,29,44,-15,29
Ards,3320,11,7,5,18,30,51,-21,26
Crusaders,3321,1,15,10,5,55,30,25,55
Linfield,3321,2,15,9,6,63,28,35,54
Ballymena,3321,3,16,4,10,59,56,3,52
Coleraine,3321,4,13,10,7,43,31,12,49
Glenavon,3321,5,12,11,7,51,42,9,47
Cliftonville,3321,6,14,5,11,52,44,8,47
Glentoran,3321,7,10,7,13,35,51,-16,37
Dungannon,3321,8,9,9,12,44,51,-7,36
Ballinamalla,3321,9,8,6,16,31,50,-19,30
Portadown,3321,10,8,4,18,23,45,-22,28
Ards,3321,11,5,5,20,29,57,-28,20
Crusaders,3322,1,16,9,5,48,30,18,57
Linfield,3322,2,14,10,6,58,33,25,52
Cliftonville,3322,3,15,7,8,53,40,13,52
Glenavon,3322,4,13,11,6,48,41,7,50
Ballymena,3322,5,13,7,10,54,57,-3,46
Dungannon,3322,6,10,9,11,56,47,9,39
Coleraine,3322,7,8,11,11,37,40,-3,35
Portadown,3322,8,10,5,15,31,42,-11,35
Glentoran,3322,9,8,7,15,27,42,-15,31
Ards,3322,10,8,6,16,42,57,-15,30
Ballinamalla,3322,11,5,8,17,32,57,-25,23
Crusaders,3323,1,15,11,4,53,27,26,56
Linfield,3323,2,14,11,5,55,32,23,53
Cliftonville,3323,3,16,3,11,58,46,12,51
Ballymena,3323,4,13,7,10,57,57,0,46
Coleraine,3323,5,11,11,8,38,33,5,44
Glentoran,3323,6,10,8,12,36,41,-5,38
Glenavon,3323,7,9,10,11,41,46,-5,37
Dungannon,3323,8,8,12,10,50,47,3,36
Ards,3323,9,9,6,15,33,49,-16,33
Ballinamalla,3323,10,8,7,15,30,49,-19,31
Portadown,3323,11,5,8,17,23,47,-24,23
Linfield,3324,1,17,8,5,68,32,36,59
Cliftonville,3324,2,17,6,7,55,33,22,57
Glenavon,3324,3,14,9,7,50,42,8,51
Crusaders,3324,4,13,10,7,56,42,14,49
Coleraine,3324,5,10,10,10,45,46,-1,40
Ballymena,3324,6,10,10,10,50,59,-9,40
Dungannon,3324,7,9,11,10,52,42,10,38
Portadown,3324,8,8,7,15,25,48,-23,31
Ards,3324,9,7,8,15,37,51,-14,29
Glentoran,3324,10,6,10,14,27,46,-19,28
Ballinamalla,3324,11,7,5,18,28,52,-24,26
Crusaders,3325,1,16,8,6,57,40,17,56
Linfield,3325,2,15,9,6,56,25,31,54
Cliftonville,3325,3,17,3,10,51,33,18,54
Ballymena,3325,4,14,7,9,53,52,1,49
Coleraine,3325,5,12,9,9,40,36,4,45
Glenavon,3325,6,9,13,8,40,39,1,40
Ballinamalla,3325,7,11,3,16,31,49,-18,36
Ards,3325,8,10,5,15,35,43,-8,35
Glentoran,3325,9,9,8,13,26,42,-16,35
Dungannon,3325,10,7,8,15,45,44,1,29
Portadown,3325,11,6,5,19,21,52,-31,23
Cliftonville,3326,1,16,5,9,59,39,20,53
Crusaders,3326,2,15,7,8,57,37,20,52
Linfield,3326,3,14,8,8,54,32,22,50
Ballymena,3326,4,14,6,10,62,67,-5,48
Coleraine,3326,5,11,10,9,46,40,6,43
Glenavon,3326,6,11,10,9,46,47,-1,43
Dungannon,3326,7,11,8,11,46,43,3,41
Glentoran,3326,8,9,8,13,34,42,-8,35
Ards,3326,9,10,5,15,41,50,-9,35
Portadown,3326,10,8,7,15,22,45,-23,31
Ballinamalla,3326,11,7,4,19,28,53,-25,25
Crusaders,3327,1,20,5,5,59,30,29,65
Ballymena,3327,2,17,3,10,62,53,9,54
Linfield,3327,3,14,9,7,52,31,21,51
Glenavon,3327,4,12,11,7,51,40,11,47
Cliftonville,3327,5,14,4,12,47,39,8,46
Coleraine,3327,6,11,11,8,43,42,1,44
Dungannon,3327,7,9,9,12,45,42,3,36
Glentoran,3327,8,9,5,16,25,41,-16,32
Ballinamalla,3327,9,9,4,17,27,46,-19,31
Ards,3327,10,8,5,17,30,47,-17,29
Portadown,3327,11,5,8,17,20,50,-30,23
Crusaders,3328,1,17,6,7,62,36,26,57
Dungannon,3328,2,14,9,7,53,39,14,51
Cliftonville,3328,3,15,6,9,54,41,13,51
Ballymena,3328,4,14,9,7,58,52,6,51
Coleraine,3328,5,13,9,8,49,39,10,48
Linfield,3328,6,12,9,9,55,32,23,45
Glenavon,3328,7,11,12,7,48,41,7,45
Glentoran,3328,8,8,9,13,29,44,-15,33
Ballinamalla,3328,9,8,4,18,26,49,-23,28
Portadown,3328,10,6,6,18,23,48,-25,24
Ards,3328,11,5,5,20,27,63,-36,20
Crusaders,3329,1,16,6,8,56,34,22,54
Ballymena,3329,2,15,6,9,57,56,1,51
Cliftonville,3329,3,15,5,10,50,42,8,50
Coleraine,3329,4,13,8,9,42,37,5,47
Linfield,3329,5,11,10,9,55,40,15,43
Glentoran,3329,6,11,6,13,33,38,-5,39
Glenavon,3329,7,8,14,8,49,51,-2,38
Dungannon,3329,8,8,9,13,49,46,3,33
Portadown,3329,9,9,6,15,28,44,-16,33
Ards,3329,10,8,8,14,32,43,-11,32
Ballinamalla,3329,11,8,8,14,28,48,-20,32
Crusaders,3330,1,16,9,5,53,31,22,57
Linfield,3330,2,16,8,6,61,30,31,56
Ballymena,3330,3,15,5,10,58,58,0,50
Cliftonville,3330,4,14,7,9,50,41,9,49
Coleraine,3330,5,13,9,8,45,36,9,48
Dungannon,3330,6,13,8,9,52,38,14,47
Glenavon,3330,7,9,12,9,50,47,3,39
Glentoran,3330,8,8,8,14,23,45,-22,32
Ards,3330,9,9,4,17,40,48,-8,31
Portadown,3330,10,7,4,19,30,57,-27,25
Ballinamalla,3330,11,4,8,18,25,56,-31,20
Linfield,3331,1,15,11,4,57,23,34,56
Cliftonville,3331,2,15,8,7,56,34,22,53
Coleraine,3331,3,13,9,8,48,41,7,48
Crusaders,3331,4,12,11,7,47,32,15,47
Dungannon,3331,5,10,9,11,46,36,10,39
Glentoran,3331,6,11,6,13,34,47,-13,39
Ballymena,3331,7,11,5,14,49,59,-10,38
Ards,3331,8,10,6,14,39,51,-12,36
Glenavon,3331,9,9,8,13,40,54,-14,35
Ballinamalla,3331,10,10,5,15,32,49,-17,35
Portadown,3331,11,7,6,17,28,50,-22,27
Crusaders,3332,1,17,7,6,62,39,23,58
Ballymena,3332,2,18,4,8,69,52,17,58
Cliftonville,3332,3,16,3,11,49,38,11,51
Coleraine,3332,4,14,9,7,47,40,7,51
Glenavon,3332,5,12,13,5,46,38,8,49
Linfield,3332,6,12,8,10,56,36,20,44
Dungannon,3332,7,9,11,10,50,50,0,38
Ballinamalla,3332,8,11,4,15,36,46,-10,37
Ards,3332,9,6,8,16,37,56,-19,26
Glentoran,3332,10,7,5,18,32,54,-22,26
Portadown,3332,11,5,4,21,24,59,-35,19
Crusaders,3333,1,17,5,8,59,42,17,56
Cliftonville,3333,2,16,4,10,53,37,16,52
Glenavon,3333,3,13,10,7,45,38,7,49
Ballymena,3333,4,15,4,11,55,54,1,49
Linfield,3333,5,13,9,8,55,35,20,48
Dungannon,3333,6,11,8,11,49,40,9,41
Coleraine,3333,7,9,11,10,36,37,-1,38
Ards,3333,8,10,6,14,34,47,-13,36
Ballinamalla,3333,9,10,4,16,29,44,-15,34
Portadown,3333,10,9,5,16,25,44,-19,32
Glentoran,3333,11,5,8,17,33,55,-22,23
Cliftonville,3334,1,18,3,9,59,36,23,57
Linfield,3334,2,16,8,6,63,30,33,56
Ballymena,3334,3,17,4,9,59,55,4,55
Crusaders,3334,4,16,6,8,54,37,17,54
Coleraine,3334,5,13,8,9,51,42,9,47
Glenavon,3334,6,11,11,8,48,47,1,44
Dungannon,3334,7,11,8,11,47,45,2,41
Ards,3334,8,8,6,16,34,47,-13,30
Ballinamalla,3334,9,7,6,17,29,53,-24,27
Glentoran,3334,10,5,9,16,29,55,-26,24
Portadown,3334,11,6,5,19,22,48,-26,23
Ballymena,3335,1,17,5,8,60,52,8,56
Crusaders,3335,2,16,7,7,58,42,16,55
Linfield,3335,3,15,9,6,61,32,29,54
Cliftonville,3335,4,15,2,13,57,44,13,47
Coleraine,3335,5,12,9,9,41,37,4,45
Glenavon,3335,6,11,11,8,55,47,8,44
Glentoran,3335,7,10,9,11,34,45,-11,39
Ards,3335,8,10,4,16,40,45,-5,34
Dungannon,3335,9,7,9,14,40,49,-9,30
Ballinamalla,3335,10,8,6,16,32,54,-22,30
Portadown,3335,11,6,5,19,26,57,-31,23
Crusaders,3336,1,18,8,4,62,34,28,62
Cliftonville,3336,2,15,5,10,51,37,14,50
Ballymena,3336,3,13,6,11,53,62,-9,45
Coleraine,3336,4,10,14,6,47,43,4,44
Linfield,3336,5,11,10,9,47,31,16,43
Dungannon,3336,6,10,9,11,55,42,13,39
Glenavon,3336,7,9,12,9,49,50,-1,39
Ards,3336,8,10,5,15,36,50,-14,35
Glentoran,3336,9,8,8,14,31,47,-16,32
Portadown,3336,10,9,5,16,32,52,-20,32
Ballinamalla,3336,11,8,6,16,34,49,-15,30
Linfield,3337,1,16,8,6,65,30,35,56
Cliftonville,3337,2,17,4,9,52,37,15,55
Crusaders,3337,3,13,8,9,52,42,10,47
Ballymena,3337,4,14,5,11,50,55,-5,47
Ards,3337,5,13,4,13,46,48,-2,43
Glenavon,3337,6,10,12,8,43,48,-5,42
Dungannon,3337,7,10,10,10,56,43,13,40
Coleraine,3337,8,10,9,11,48,45,3,39
Ballinamalla,3337,9,10,3,17,29,53,-24,33
Glentoran,3337,10,8,8,14,29,40,-11,32
Portadown,3337,11,5,7,18,23,52,-29,22
Crusaders,3338,1,19,7,4,59,26,33,64
Cliftonville,3338,2,17,6,7,55,32,23,57
Linfield,3338,3,13,9,8,59,37,22,48
Ballymena,3338,4,13,6,11,60,63,-3,45
Coleraine,3338,5,11,11,8,46,41,5,44
Glenavon,3338,6,11,11,8,51,50,1,44
Dungannon,3338,7,11,7,12,52,46,6,40
Glentoran,3338,8,8,8,14,32,50,-18,32
Ballinamalla,3338,9,8,6,16,33,61,-28,30
Portadown,3338,10,7,6,17,32,52,-20,27
Ards,3338,11,6,5,19,34,55,-21,23
Crusaders,3339,1,18,7,5,60,35,25,61
Ballymena,3339,2,15,9,6,64,56,8,54
Linfield,3339,3,14,8,8,64,39,25,50
Cliftonville,3339,4,15,5,10,51,38,13,50
Coleraine,3339,5,12,10,8,40,39,1,46
Dungannon,3339,6,10,9,11,55,48,7,39
Glenavon,3339,7,9,12,9,48,50,-2,39
Ballinamalla,3339,8,9,5,16,33,52,-19,32
Portadown,3339,9,9,4,17,29,44,-15,31
Glentoran,3339,10,8,6,16,34,54,-20,30
Ards,3339,11,6,5,19,30,53,-23,23
Crusaders,3340,1,20,6,4,58,34,24,66
Linfield,3340,2,14,10,6,60,27,33,52
Ballymena,3340,3,13,9,8,59,56,3,48
Cliftonville,3340,4,12,9,9,46,40,6,45
Coleraine,3340,5,10,12,8,39,36,3,42
Glenavon,3340,6,9,13,8,49,47,2,40
Dungannon,3340,7,8,11,11,48,43,5,35
Portadown,3340,8,10,4,16,26,46,-20,34
Glentoran,3340,9,7,9,14,28,44,-16,30
Ballinamalla,3340,10,7,7,16,30,51,-21,28
Ards,3340,11,6,8,16,32,51,-19,26
Ballymena,3341,1,17,6,7,70,53,17,57
Crusaders,3341,2,17,4,9,56,32,24,55
Linfield,3341,3,13,12,5,55,35,20,51
Coleraine,3341,4,13,9,8,47,39,8,48
Glenavon,3341,5,11,12,7,52,45,7,45
Cliftonville,3341,6,14,2,14,45,42,3,44
Glentoran,3341,7,10,8,12,35,44,-9,38
Ards,3341,8,10,4,16,40,48,-8,34
Dungannon,3341,9,8,9,13,45,45,0,33
Ballinamalla,3341,10,9,1,20,29,56,-27,28
Portadown,3341,11,6,7,17,25,60,-35,25
Crusaders,3342,1,19,5,6,66,34,32,62
Linfield,3342,2,15,9,6,61,28,33,54
Coleraine,3342,3,15,9,6,54,45,9,54
Ballymena,3342,4,15,8,7,58,56,2,53
Cliftonville,3342,5,13,5,12,49,47,2,44
Dungannon,3342,6,9,11,10,52,44,8,38
Glentoran,3342,7,10,6,14,36,44,-8,36
Ards,3342,8,9,6,15,40,56,-16,33
Glenavon,3342,9,7,9,14,41,54,-13,30
Ballinamalla,3342,10,7,7,16,25,47,-22,28
Portadown,3342,11,6,5,19,20,47,-27,23
Linfield,3343,1,17,8,5,65,32,33,59
Cliftonville,3343,2,15,7,8,48,34,14,52
Crusaders,3343,3,13,10,7,50,36,14,49
Ballymena,3343,4,12,7,11,58,60,-2,43
Glenavon,3343,5,8,14,8,44,43,1,38
Ards,3343,6,10,8,12,41,47,-6,38
Dungannon,3343,7,9,10,11,47,45,2,37
Coleraine,3343,8,8,13,9,39,43,-4,37
Portadown,3343,9,9,5,16,27,41,-14,32
Glentoran,3343,10,7,11,12,28,44,-16,32
Ballinamalla,3343,11,9,3,18,33,55,-22,30
Ballymena,3344,1,16,7,7,55,46,9,55
Crusaders,3344,2,14,10,6,49,32,17,52
Cliftonville,3344,3,15,5,10,56,39,17,50
Glenavon,3344,4,12,14,4,44,35,9,50
Dungannon,3344,5,13,8,9,56,40,16,47
Linfield,3344,6,12,9,9,57,37,20,45
Coleraine,3344,7,11,11,8,42,38,4,44
Glentoran,3344,8,8,7,15,24,52,-28,31
Ards,3344,9,7,7,16,38,51,-13,28
Portadown,3344,10,6,6,18,22,48,-26,24
Ballinamalla,3344,11,5,8,17,25,50,-25,23
Linfield,3345,1,17,9,4,63,28,35,60
Crusaders,3345,2,17,8,5,61,33,28,59
Ballymena,3345,3,15,4,11,53,56,-3,49
Coleraine,3345,4,12,9,9,39,35,4,45
Cliftonville,3345,5,13,5,12,60,50,10,44
Dungannon,3345,6,10,10,10,50,45,5,40
Glenavon,3345,7,10,10,10,48,45,3,40
Ards,3345,8,8,7,15,36,48,-12,31
Ballinamalla,3345,9,8,6,16,30,49,-19,30
Portadown,3345,10,8,6,16,31,52,-21,30
Glentoran,3345,11,5,10,15,22,52,-30,25
Cliftonville,3346,1,15,8,7,49,35,14,53
Linfield,3346,2,13,12,5,60,32,28,51
Crusaders,3346,3,14,9,7,53,35,18,51
Ballymena,3346,4,12,10,8,54,51,3,46
Glenavon,3346,5,11,12,7,51,44,7,45
Coleraine,3346,6,11,10,9,44,39,5,43
Dungannon,3346,7,9,10,11,49,39,10,37
Ballinamalla,3346,8,9,7,14,32,49,-17,34
Ards,3346,9,10,3,17,36,53,-17,33
Portadown,3346,10,7,8,15,25,43,-18,29
Glentoran,3346,11,6,7,17,26,59,-33,25
Cliftonville,3347,1,18,3,9,55,38,17,57
Linfield,3347,2,14,10,6,61,33,28,52
Crusaders,3347,3,14,9,7,46,38,8,51
Glenavon,3347,4,13,10,7,59,45,14,49
Ballymena,3347,5,14,4,12,59,62,-3,46
Coleraine,3347,6,10,11,9,42,38,4,41
Dungannon,3347,7,9,12,9,47,41,6,39
Ballinamalla,3347,8,11,3,16,37,52,-15,36
Ards,3347,9,9,6,15,40,50,-10,33
Glentoran,3347,10,6,7,17,34,56,-22,25
Portadown,3347,11,6,7,17,19,46,-27,25
Linfield,3348,1,15,9,6,58,33,25,54
Crusaders,3348,2,15,7,8,59,44,15,52
Cliftonville,3348,3,15,4,11,56,43,13,49
Ballymena,3348,4,13,6,11,57,56,1,45
Glenavon,3348,5,11,11,8,49,40,9,44
Coleraine,3348,6,9,14,7,38,39,-1,41
Ards,3348,7,11,6,13,40,47,-7,39
Glentoran,3348,8,9,7,14,30,40,-10,34
Dungannon,3348,9,8,8,14,42,48,-6,32
Ballinamalla,3348,10,7,9,14,32,49,-17,30
Portadown,3348,11,7,9,14,22,44,-22,30
Crusaders,3349,1,16,10,4,63,34,29,58
Linfield,3349,2,14,9,7,57,34,23,51
Ballymena,3349,3,13,9,8,53,52,1,48
Cliftonville,3349,4,13,8,9,51,43,8,47
Coleraine,3349,5,11,13,6,48,37,11,46
Ballinamalla,3349,6,12,4,14,35,46,-11,40
Glentoran,3349,7,9,9,12,32,44,-12,36
Glenavon,3349,8,7,14,9,42,52,-10,35
Dungannon,3349,9,8,9,13,45,46,-1,33
Ards,3349,10,8,7,15,37,48,-11,31
Portadown,3349,11,5,6,19,26,53,-27,21
Crusaders,3350,1,16,6,8,53,40,13,54
Glenavon,3350,2,14,11,5,57,40,17,53
Linfield,3350,3,14,9,7,55,28,27,51
Cliftonville,3350,4,15,6,9,59,43,16,51
Ballymena,3350,5,15,6,9,63,57,6,51
Dungannon,3350,6,10,9,11,52,50,2,39
Coleraine,3350,7,7,13,10,39,40,-1,34
Ards,3350,8,10,4,16,35,51,-16,34
Portadown,3350,9,9,6,15,22,39,-17,33
Glentoran,3350,10,7,9,14,33,47,-14,30
Ballinamalla,3350,11,6,5,19,24,57,-33,23
Crusaders,3351,1,17,7,6,60,30,30,58
Glenavon,3351,2,15,10,5,54,40,14,55
Cliftonville,3351,3,15,4,11,53,40,13,49
Ballymena,3351,4,12,7,11,62,68,-6,43
Linfield,3351,5,11,9,10,48,33,15,42
Ards,3351,6,12,6,12,39,41,-2,42
Dungannon,3351,7,10,10,10,47,41,6,40
Coleraine,3351,8,10,10,10,35,38,-3,40
Glentoran,3351,9,9,9,12,32,42,-10,36
Ballinamalla,3351,10,7,4,19,27,56,-29,25
Portadown,3351,11,6,6,18,23,51,-28,24
Cliftonville,3352,1,18,6,6,61,36,25,60
Crusaders,3352,2,15,9,6,53,34,19,54
Linfield,3352,3,14,9,7,57,31,26,51
Ballymena,3352,4,13,6,11,56,62,-6,45
Coleraine,3352,5,11,8,11,42,38,4,41
Ards,3352,6,12,4,14,39,48,-9,40
Glenavon,3352,7,10,9,11,40,42,-2,39
Glentoran,3352,8,9,10,11,31,40,-9,37
Dungannon,3352,9,7,11,12,45,46,-1,32
Portadown,3352,10,7,7,16,24,46,-22,28
Ballinamalla,3352,11,7,5,18,22,47,-25,26
Crusaders,3353,1,16,7,7,55,36,19,55
Coleraine,3353,2,14,9,7,40,34,6,51
Ballymena,3353,3,15,5,10,55,56,-1,50
Cliftonville,3353,4,15,4,11,51,40,11,49
Linfield,3353,5,12,9,9,53,37,16,45
Glenavon,3353,6,11,11,8,45,43,2,44
Dungannon,3353,7,10,9,11,54,42,12,39
Ards,3353,8,9,5,16,35,48,-13,32
Ballinamalla,3353,9,9,4,17,33,50,-17,31
Portadown,3353,10,8,6,16,30,44,-14,30
Glentoran,3353,11,7,9,14,27,48,-21,30
Linfield,3354,1,13,10,7,63,38,25,49
Ballymena,3354,2,14,7,9,68,62,6,49
Crusaders,3354,3,13,9,8,53,41,12,48
Coleraine,3354,4,12,11,7,41,29,12,47
Cliftonville,3354,5,13,7,10,53,43,10,46
Dungannon,3354,6,12,9,9,48,41,7,45
Glenavon,3354,7,10,9,11,44,46,-2,39
Ballinamalla,3354,8,11,5,14,32,45,-13,38
Glentoran,3354,9,7,13,10,30,42,-12,34
Ards,3354,10,8,6,16,40,57,-17,30
Portadown,3354,11,6,6,18,25,53,-28,24
Crusaders,3355,1,16,9,5,65,39,26,57
Ballymena,3355,2,16,5,9,64,51,13,53
Linfield,3355,3,15,7,8,61,35,26,52
Dungannon,3355,4,13,9,8,54,41,13,48
Glenavon,3355,5,13,8,9,55,44,11,47
Coleraine,3355,6,11,11,8,47,49,-2,44
Cliftonville,3355,7,12,4,14,50,48,2,40
Glentoran,3355,8,10,8,12,36,50,-14,38
Ards,3355,9,9,6,15,41,48,-7,33
Portadown,3355,10,9,4,17,22,47,-25,31
Ballinamalla,3355,11,4,3,23,26,69,-43,15
Crusaders,3356,1,18,6,6,48,24,24,60
Linfield,3356,2,16,9,5,60,30,30,57
Cliftonville,3356,3,14,7,9,45,33,12,49
Coleraine,3356,4,10,12,8,37,31,6,42
Glenavon,3356,5,9,11,10,39,46,-7,38
Ballymena,3356,6,10,7,13,46,58,-12,37
Glentoran,3356,7,9,9,12,29,34,-5,36
Dungannon,3356,8,8,10,12,48,45,3,34
Ards,3356,9,9,7,14,38,50,-12,34
Portadown,3356,10,9,5,16,27,44,-17,32
Ballinamalla,3356,11,8,7,15,28,50,-22,31
Crusaders,3357,1,15,8,7,55,40,15,53
Linfield,3357,2,14,9,7,58,35,23,51
Cliftonville,3357,3,15,5,10,47,35,12,50
Coleraine,3357,4,13,10,7,50,38,12,49
Ballymena,3357,5,12,10,8,51,53,-2,46
Dungannon,3357,6,12,8,10,52,40,12,44
Glenavon,3357,7,9,12,9,41,42,-1,39
Glentoran,3357,8,9,8,13,33,46,-13,35
Ards,3357,9,9,4,17,35,50,-15,31
Ballinamalla,3357,10,9,3,18,29,49,-20,30
Portadown,3357,11,6,7,17,23,46,-23,25
Linfield,3358,1,15,9,6,57,34,23,54
Crusaders,3358,2,15,9,6,57,38,19,54
Ballymena,3358,3,13,7,10,57,62,-5,46
Cliftonville,3358,4,13,5,12,53,39,14,44
Glenavon,3358,5,11,11,8,44,45,-1,44
Dungannon,3358,6,11,8,11,51,42,9,41
Ards,3358,7,11,4,15,42,48,-6,37
Glentoran,3358,8,9,8,13,33,46,-13,35
Ballinamalla,3358,9,11,2,17,30,48,-18,35
Coleraine,3358,10,8,10,12,43,47,-4,34
Portadown,3358,11,8,7,15,28,46,-18,31
Crusaders,3359,1,16,9,5,53,33,20,57
Ballymena,3359,2,14,8,8,62,56,6,50
Glenavon,3359,3,13,10,7,52,40,12,49
Cliftonville,3359,4,15,4,11,47,39,8,49
Coleraine,3359,5,13,9,8,46,39,7,48
Linfield,3359,6,12,9,9,58,37,21,45
Ards,3359,7,12,3,15,44,54,-10,39
Dungannon,3359,8,8,10,12,52,48,4,34
Glentoran,3359,9,8,8,14,28,46,-18,32
Portadown,3359,10,8,6,16,25,43,-18,30
Ballinamalla,3359,11,7,2,21,22,54,-32,23
Crusaders,3360,1,17,5,8,56,36,20,56
Cliftonville,3360,2,16,5,9,48,34,14,53
Linfield,3360,3,13,9,8,58,37,21,48
Glenavon,3360,4,12,11,7,54,40,14,47
Ballymena,3360,5,13,6,11,53,59,-6,45
Dungannon,3360,6,12,8,10,53,44,9,44
Glentoran,3360,7,11,7,12,39,42,-3,40
Coleraine,3360,8,9,10,11,41,42,-1,37
Portadown,3360,9,9,5,16,28,54,-26,32
Ards,3360,10,9,4,17,44,56,-12,31
Ballinamalla,3360,11,8,2,20,29,59,-30,26
Crusaders,3361,1,18,6,6,54,32,22,60
Cliftonville,3361,2,18,2,10,62,39,23,56
Ballymena,3361,3,15,8,7,62,56,6,53
Linfield,3361,4,14,9,7,63,36,27,51
Glenavon,3361,5,11,9,10,45,46,-1,42
Coleraine,3361,6,10,10,10,42,46,-4,40
Glentoran,3361,7,10,8,12,34,46,-12,38
Dungannon,3361,8,7,10,13,49,49,0,31
Ballinamalla,3361,9,9,4,17,29,48,-19,31
Ards,3361,10,8,4,18,40,60,-20,28
Portadown,3361,11,8,4,18,32,54,-22,28
Crusaders,3362,1,19,5,6,65,36,29,62
Linfield,3362,2,14,9,7,64,35,29,51
Coleraine,3362,3,12,10,8,51,41,10,46
Ballymena,3362,4,13,6,11,58,59,-1,45
Ards,3362,5,14,3,13,40,44,-4,45
Cliftonville,3362,6,12,8,10,52,43,9,44
Glenavon,3362,7,11,11,8,48,46,2,44
Dungannon,3362,8,10,8,12,48,45,3,38
Portadown,3362,9,8,7,15,31,57,-26,31
Ballinamalla,3362,10,8,3,19,34,60,-26,27
Glentoran,3362,11,6,6,18,32,57,-25,24
Linfield,3363,1,16,10,4,63,26,37,58
Cliftonville,3363,2,18,4,8,56,36,20,58
Glenavon,3363,3,14,10,6,50,38,12,52
Crusaders,3363,4,14,9,7,56,39,17,51
Ballymena,3363,5,13,7,10,56,57,-1,46
Coleraine,3363,6,10,12,8,36,32,4,42
Dungannon,3363,7,10,7,13,47,47,0,37
Ards,3363,8,10,5,15,35,56,-21,35
Glentoran,3363,9,8,9,13,39,53,-14,33
Ballinamalla,3363,10,8,3,19,32,57,-25,27
Portadown,3363,11,3,6,21,16,45,-29,15
Crusaders,3364,1,16,10,4,61,37,24,58
Ballymena,3364,2,17,7,6,64,51,13,58
Linfield,3364,3,14,7,9,51,34,17,49
Coleraine,3364,4,11,11,8,47,39,8,44
Cliftonville,3364,5,12,8,10,46,41,5,44
Glenavon,3364,6,11,10,9,49,51,-2,43
Glentoran,3364,7,10,7,13,35,43,-8,37
Dungannon,3364,8,9,9,12,53,51,2,36
Portadown,3364,9,8,9,13,26,42,-16,33
Ards,3364,10,7,8,15,33,46,-13,29
Ballinamalla,3364,11,5,4,21,26,56,-30,19
Cliftonville,3365,1,18,4,8,59,41,18,58
Linfield,3365,2,16,7,7,61,37,24,55
Ballymena,3365,3,15,7,8,57,51,6,52
Dungannon,3365,4,14,8,8,53,37,16,50
Crusaders,3365,5,14,7,9,52,36,16,49
Glenavon,3365,6,10,13,7,48,45,3,43
Glentoran,3365,7,12,7,11,34,37,-3,43
Coleraine,3365,8,7,10,13,35,45,-10,31
Ards,3365,9,9,2,19,42,60,-18,29
Portadown,3365,10,7,6,17,21,40,-19,27
Ballinamalla,3365,11,5,5,20,23,56,-33,20
Crusaders,3366,1,18,9,3,66,30,36,63
Linfield,3366,2,16,7,7,57,35,22,55
Cliftonville,3366,3,15,6,9,54,35,19,51
Ballymena,3366,4,13,6,11,54,55,-1,45
Glenavon,3366,5,11,11,8,43,47,-4,44
Dungannon,3366,6,11,8,11,55,44,11,41
Coleraine,3366,7,10,10,10,40,40,0,40
Portadown,3366,8,10,5,15,27,43,-16,35
Ards,3366,9,8,4,18,37,57,-20,28
Glentoran,3366,10,7,7,16,30,51,-21,28
Ballinamalla,3366,11,7,5,18,27,53,-26,26
Crusaders,3367,1,18,4,8,56,36,20,58
Linfield,3367,2,16,8,6,62,37,25,56
Cliftonville,3367,3,15,4,11,52,40,12,49
Coleraine,3367,4,10,11,9,49,49,0,41
Dungannon,3367,5,11,7,12,52,44,8,40
Ballymena,3367,6,10,8,12,54,62,-8,38
Glenavon,3367,7,8,12,10,43,50,-7,36
Portadown,3367,8,10,6,14,30,42,-12,36
Glentoran,3367,9,10,6,14,38,52,-14,36
Ballinamalla,3367,10,11,3,16,42,57,-15,36
Ards,3367,11,9,5,16,47,56,-9,32
Linfield,3368,1,19,7,4,70,35,35,64
Cliftonville,3368,2,16,5,9,63,41,22,53
Crusaders,3368,3,15,5,10,51,43,8,50
Glenavon,3368,4,13,10,7,51,43,8,49
Coleraine,3368,5,11,11,8,42,34,8,44
Ballymena,3368,6,13,5,12,50,53,-3,44
Dungannon,3368,7,11,8,11,44,43,1,41
Glentoran,3368,8,11,6,13,45,50,-5,39
Ballinamalla,3368,9,8,5,17,23,45,-22,29
Ards,3368,10,7,3,20,34,53,-19,24
Portadown,3368,11,6,5,19,23,56,-33,23
Cliftonville,3369,1,17,4,9,59,37,22,55
Crusaders,3369,2,15,10,5,52,32,20,55
Linfield,3369,3,15,8,7,56,32,24,53
Glentoran,3369,4,12,8,10,38,39,-1,44
Coleraine,3369,5,11,10,9,43,43,0,43
Glenavon,3369,6,10,9,11,44,50,-6,39
Dungannon,3369,7,9,9,12,49,49,0,36
Ballymena,3369,8,10,5,15,52,63,-11,35
Ballinamalla,3369,9,10,4,16,36,54,-18,34
Portadown,3369,10,10,3,17,30,46,-16,33
Ards,3369,11,8,6,16,34,48,-14,30
Crusaders,3370,1,19,6,5,64,31,33,63
Cliftonville,3370,2,18,3,9,53,33,20,57
Glenavon,3370,3,14,7,9,53,50,3,49
Linfield,3370,4,13,6,11,52,36,16,45
Ballymena,3370,5,12,7,11,51,56,-5,43
Coleraine,3370,6,10,11,9,35,36,-1,41
Glentoran,3370,7,11,6,13,35,44,-9,39
Portadown,3370,8,9,5,16,25,46,-21,32
Dungannon,3370,9,7,10,13,47,47,0,31
Ballinamalla,3370,10,8,6,16,32,53,-21,30
Ards,3370,11,8,5,17,27,42,-15,29
Crusaders,3371,1,19,9,2,58,22,36,66
Glenavon,3371,2,14,9,7,46,37,9,51
Linfield,3371,3,13,10,7,55,30,25,49
Cliftonville,3371,4,14,7,9,47,41,6,49
Ballymena,3371,5,13,8,9,58,52,6,47
Coleraine,3371,6,9,11,10,38,42,-4,38
Glentoran,3371,7,8,8,14,32,52,-20,32
Dungannon,3371,8,7,10,13,42,48,-6,31
Ballinamalla,3371,9,8,7,15,32,52,-20,31
Ards,3371,10,8,5,17,37,48,-11,29
Portadown,3371,11,8,4,18,25,46,-21,28
Crusaders,3372,1,16,8,6,52,31,21,56
Linfield,3372,2,15,8,7,59,32,27,53
Ballymena,3372,3,15,7,8,56,52,4,52
Cliftonville,3372,4,14,4,12,50,43,7,46
Coleraine,3372,5,12,8,10,48,43,5,44
Glenavon,3372,6,10,12,8,49,38,11,42
Glentoran,3372,7,11,4,15,33,41,-8,37
Dungannon,3372,8,8,9,13,38,47,-9,33
Ards,3372,9,9,5,16,34,49,-15,32
Portadown,3372,10,8,7,15,24,41,-17,31
Ballinamalla,3372,11,8,6,16,25,51,-26,30
Crusaders,3373,1,20,7,3,67,32,35,67
Ballymena,3373,2,17,4,9,61,50,11,55
Linfield,3373,3,13,10,7,56,31,25,49
Glenavon,3373,4,10,13,7,47,43,4,43
Coleraine,3373,5,11,10,9,47,47,0,43
Dungannon,3373,6,10,12,8,47,36,11,42
Cliftonville,3373,7,12,4,14,52,55,-3,40
Portadown,3373,8,11,5,14,34,46,-12,38
Glentoran,3373,9,7,7,16,32,56,-24,28
Ards,3373,10,6,6,18,31,51,-20,24
Ballinamalla,3373,11,6,6,18,28,55,-27,24
Linfield,3374,1,16,10,4,65,31,34,58
Crusaders,3374,2,16,7,7,64,52,12,55
Coleraine,3374,3,13,10,7,46,33,13,49
Glenavon,3374,4,13,10,7,55,47,8,49
Cliftonville,3374,5,14,7,9,49,42,7,49
Ballymena,3374,6,14,6,10,60,58,2,48
Portadown,3374,7,10,6,14,30,42,-12,36
Dungannon,3374,8,8,10,12,54,52,2,34
Glentoran,3374,9,8,8,14,34,46,-12,32
Ards,3374,10,7,3,20,37,55,-18,24
Ballinamalla,3374,11,5,5,20,31,67,-36,20
Linfield,3375,1,16,8,6,67,37,30,56
Crusaders,3375,2,14,8,8,54,40,14,50
Ballymena,3375,3,14,7,9,62,61,1,49
Cliftonville,3375,4,14,6,10,53,40,13,48
Coleraine,3375,5,11,11,8,42,44,-2,44
Dungannon,3375,6,11,10,9,52,41,11,43
Glentoran,3375,7,10,9,11,29,38,-9,39
Glenavon,3375,8,9,10,11,52,53,-1,37
Ards,3375,9,10,5,15,45,50,-5,35
Ballinamalla,3375,10,7,5,18,35,59,-24,26
Portadown,3375,11,7,5,18,26,54,-28,26
Crusaders,3376,1,17,7,6,55,37,18,58
Cliftonville,3376,2,14,7,9,52,39,13,49
Linfield,3376,3,12,10,8,58,41,17,46
Coleraine,3376,4,11,13,6,45,34,11,46
Ballymena,3376,5,13,7,10,51,57,-6,46
Dungannon,3376,6,10,11,9,55,44,11,41
Glenavon,3376,7,9,12,9,47,44,3,39
Glentoran,3376,8,9,8,13,32,42,-10,35
Ards,3376,9,10,4,16,40,53,-13,34
Portadown,3376,10,7,7,16,26,47,-21,28
Ballinamalla,3376,11,7,6,17,27,50,-23,27
Crusaders,3377,1,19,6,5,60,32,28,63
Cliftonville,3377,2,17,5,8,60,38,22,56
Linfield,3377,3,14,7,9,54,39,15,49
Ballymena,3377,4,14,4,12,57,58,-1,46
Dungannon,3377,5,11,9,10,55,45,10,42
Glentoran,3377,6,10,10,10,33,38,-5,40
Coleraine,3377,7,8,12,10,36,44,-8,36
Glenavon,3377,8,7,13,10,42,49,-7,34
Ards,3377,9,9,6,15,42,57,-15,33
Ballinamalla,3377,10,8,5,17,33,50,-17,29
Portadown,3377,11,6,7,17,25,47,-22,25
Crusaders,3378,1,15,9,6,48,30,18,54
Cliftonville,3378,2,16,4,10,50,40,10,52
Linfield,3378,3,13,10,7,57,32,25,49
Ballymena,3378,4,14,7,9,54,53,1,49
Coleraine,3378,5,12,10,8,42,31,11,46
Glenavon,3378,6,11,8,11,41,43,-2,41
Glentoran,3378,7,10,9,11,29,34,-5,39
Ards,3378,8,11,5,14,38,45,-7,38
Dungannon,3378,9,7,13,10,44,43,1,34
Portadown,3378,10,9,3,18,25,50,-25,30
Ballinamalla,3378,11,6,4,20,24,51,-27,22
Crusaders,3379,1,17,7,6,59,40,19,58
Linfield,3379,2,16,8,6,67,33,34,56
Glenavon,3379,3,13,10,7,45,37,8,49
Coleraine,3379,4,12,11,7,44,36,8,47
Cliftonville,3379,5,14,4,12,48,39,9,46
Dungannon,3379,6,10,12,8,50,40,10,42
Ballymena,3379,7,12,5,13,52,59,-7,41
Ards,3379,8,11,4,15,46,51,-5,37
Ballinamalla,3379,9,9,4,17,31,51,-20,31
Glentoran,3379,10,7,5,18,23,49,-26,26
Portadown,3379,11,6,6,18,30,60,-30,24
Linfield,3380,1,14,9,7,59,31,28,51
Crusaders,3380,2,14,9,7,53,36,17,51
Cliftonville,3380,3,13,7,10,53,44,9,46
Glenavon,3380,4,11,13,6,43,40,3,46
Ballymena,3380,5,13,7,10,58,60,-2,46
Dungannon,3380,6,11,12,7,46,35,11,45
Coleraine,3380,7,12,9,9,44,41,3,45
Glentoran,3380,8,11,9,10,38,43,-5,42
Ards,3380,9,7,7,16,40,52,-12,28
Ballinamalla,3380,10,7,5,18,23,48,-25,26
Portadown,3380,11,5,7,18,18,45,-27,22
Cliftonville,3381,1,17,7,6,55,29,26,58
Glenavon,3381,2,14,8,8,55,43,12,50
Linfield,3381,3,12,11,7,55,35,20,47
Crusaders,3381,4,14,5,11,48,46,2,47
Coleraine,3381,5,11,12,7,41,39,2,45
Ballymena,3381,6,13,6,11,59,62,-3,45
Dungannon,3381,7,11,6,13,53,45,8,39
Ballinamalla,3381,8,9,9,12,31,44,-13,36
Ards,3381,9,9,6,15,33,45,-12,33
Glentoran,3381,10,7,8,15,29,48,-19,29
Portadown,3381,11,5,8,17,28,51,-23,23
Linfield,3382,1,16,11,3,64,30,34,59
Crusaders,3382,2,16,7,7,53,37,16,55
Ballymena,3382,3,16,5,9,64,56,8,53
Glenavon,3382,4,11,10,9,48,48,0,43
Cliftonville,3382,5,12,6,12,48,46,2,42
Coleraine,3382,6,9,13,8,42,41,1,40
Glentoran,3382,7,8,13,9,32,38,-6,37
Dungannon,3382,8,9,9,12,50,45,5,36
Ards,3382,9,9,7,14,39,47,-8,34
Portadown,3382,10,6,7,17,25,49,-24,25
Ballinamalla,3382,11,6,6,18,28,56,-28,24
Glenavon,3383,1,15,10,5,49,38,11,55
Cliftonville,3383,2,15,6,9,51,39,12,51
Coleraine,3383,3,12,13,5,42,32,10,49
Linfield,3383,4,14,6,10,55,34,21,48
Crusaders,3383,5,13,8,9,47,36,11,47
Dungannon,3383,6,12,10,8,59,47,12,46
Ballymena,3383,7,13,6,11,56,55,1,45
Ballinamalla,3383,8,12,3,15,33,49,-16,39
Ards,3383,9,8,3,19,42,56,-14,27
Portadown,3383,10,6,7,17,23,43,-20,25
Glentoran,3383,11,5,8,17,24,52,-28,23
Linfield,3384,1,15,11,4,55,22,33,56
Crusaders,3384,2,16,8,6,51,31,20,56
Cliftonville,3384,3,15,7,8,61,43,18,52
Glenavon,3384,4,12,12,6,50,41,9,48
Dungannon,3384,5,13,7,10,49,34,15,46
Ballymena,3384,6,11,10,9,55,58,-3,43
Coleraine,3384,7,9,10,11,42,43,-1,37
Portadown,3384,8,11,4,15,30,46,-16,37
Ards,3384,9,7,7,16,32,52,-20,28
Glentoran,3384,10,5,9,16,25,53,-28,24
Ballinamalla,3384,11,6,5,19,27,54,-27,23
Linfield,3385,1,16,9,5,60,29,31,57
Ballymena,3385,2,15,7,8,58,52,6,52
Crusaders,3385,3,14,9,7,49,34,15,51
Coleraine,3385,4,12,10,8,47,40,7,46
Dungannon,3385,5,11,12,7,55,39,16,45
Cliftonville,3385,6,12,7,11,43,37,6,43
Glenavon,3385,7,10,13,7,49,45,4,43
Glentoran,3385,8,9,7,14,28,41,-13,34
Ards,3385,9,10,3,17,40,48,-8,33
Portadown,3385,10,6,8,16,25,52,-27,26
Ballinamalla,3385,11,5,5,20,25,62,-37,20
Crusaders,3386,1,18,8,4,54,27,27,62
Linfield,3386,2,15,8,7,61,32,29,53
Ballymena,3386,3,16,4,10,58,51,7,52
Dungannon,3386,4,13,8,9,52,42,10,47
Cliftonville,3386,5,13,4,13,45,39,6,43
Glenavon,3386,6,10,11,9,48,45,3,41
Coleraine,3386,7,9,11,10,39,42,-3,38
Glentoran,3386,8,9,11,10,29,38,-9,38
Ards,3386,9,8,6,16,36,59,-23,30
Portadown,3386,10,8,4,18,28,51,-23,28
Ballinamalla,3386,11,6,5,19,30,54,-24,23
Crusaders,3387,1,18,7,5,57,31,26,61
Ballymena,3387,2,15,7,8,64,54,10,52
Cliftonville,3387,3,14,8,8,54,39,15,50
Linfield,3387,4,13,7,10,55,36,19,46
Coleraine,3387,5,12,7,11,43,44,-1,43
Ards,3387,6,12,6,12,45,43,2,42
Glenavon,3387,7,9,11,10,45,53,-8,38
Dungannon,3387,8,8,11,11,50,47,3,35
Glentoran,3387,9,8,10,12,31,44,-13,34
Ballinamalla,3387,10,7,6,17,25,52,-27,27
Portadown,3387,11,7,4,19,26,52,-26,25
Crusaders,3388,1,15,11,4,52,31,21,56
Linfield,3388,2,15,8,7,56,31,25,53
Cliftonville,3388,3,14,10,6,55,37,18,52
Glenavon,3388,4,11,10,9,49,45,4,43
Ballymena,3388,5,11,9,10,54,55,-1,42
Coleraine,3388,6,10,11,9,40,42,-2,41
Dungannon,3388,7,9,11,10,49,41,8,38
Ards,3388,8,11,5,14,42,52,-10,38
Ballinamalla,3388,9,9,5,16,32,50,-18,32
Glentoran,3388,10,5,13,12,28,47,-19,28
Portadown,3388,11,5,7,18,19,45,-26,22
Crusaders,3389,1,17,8,5,57,32,25,59
Cliftonville,3389,2,13,9,8,52,39,13,48
Linfield,3389,3,11,14,5,57,35,22,47
Ballymena,3389,4,13,7,10,55,62,-7,46
Dungannon,3389,5,11,11,8,64,43,21,44
Glenavon,3389,6,9,12,9,46,48,-2,39
Ards,3389,7,11,5,14,40,46,-6,38
Ballinamalla,3389,8,10,6,14,30,43,-13,36
Coleraine,3389,9,8,10,12,32,43,-11,34
Glentoran,3389,10,7,10,13,29,48,-19,31
Portadown,3389,11,5,8,17,22,45,-23,23
Linfield,3390,1,14,12,4,64,34,30,54
Ballymena,3390,2,15,7,8,58,52,6,52
Crusaders,3390,3,14,9,7,49,37,12,51
Glenavon,3390,4,12,12,6,51,47,4,48
Cliftonville,3390,5,14,5,11,49,41,8,47
Coleraine,3390,6,11,12,7,44,37,7,45
Dungannon,3390,7,9,9,12,51,46,5,36
Glentoran,3390,8,9,9,12,27,39,-12,36
Ards,3390,9,8,6,16,36,49,-13,30
Ballinamalla,3390,10,6,7,17,26,49,-23,25
Portadown,3390,11,6,6,18,28,52,-24,24
Crusaders,3391,1,18,5,7,56,31,25,59
Cliftonville,3391,2,16,6,8,53,39,14,54
Ballymena,3391,3,14,7,9,64,53,11,49
Glenavon,3391,4,11,12,7,53,44,9,45
Coleraine,3391,5,10,15,5,41,33,8,45
Linfield,3391,6,10,11,9,52,37,15,41
Ards,3391,7,10,6,14,38,48,-10,36
Dungannon,3391,8,8,11,11,44,46,-2,35
Glentoran,3391,9,8,9,13,24,44,-20,33
Portadown,3391,10,7,6,17,23,46,-23,27
Ballinamalla,3391,11,6,6,18,28,55,-27,24
Crusaders,3392,1,16,6,8,55,40,15,54
Cliftonville,3392,2,16,5,9,59,39,20,53
Linfield,3392,3,14,9,7,58,32,26,51
Ballymena,3392,4,14,5,11,64,56,8,47
Glenavon,3392,5,11,10,9,50,48,2,43
Dungannon,3392,6,11,8,11,50,44,6,41
Coleraine,3392,7,10,11,9,37,38,-1,41
Ballinamalla,3392,8,11,2,17,37,53,-16,35
Portadown,3392,9,9,5,16,24,46,-22,32
Ards,3392,10,9,4,17,33,47,-14,31
Glentoran,3392,11,7,9,14,28,52,-24,30
Crusaders,3393,1,18,7,5,51,27,24,61
Cliftonville,3393,2,18,6,6,56,30,26,60
Linfield,3393,3,11,11,8,60,38,22,44
Coleraine,3393,4,11,10,9,45,39,6,43
Dungannon,3393,5,11,10,9,41,37,4,43
Ballymena,3393,6,11,7,12,59,63,-4,40
Glenavon,3393,7,10,10,10,43,49,-6,40
Glentoran,3393,8,11,5,14,31,43,-12,38
Ards,3393,9,10,5,15,35,47,-12,35
Ballinamalla,3393,10,8,2,20,28,50,-22,26
Portadown,3393,11,5,9,16,25,51,-26,24
Crusaders,3394,1,19,7,4,64,31,33,64
Linfield,3394,2,17,9,4,62,28,34,60
Cliftonville,3394,3,16,4,10,55,44,11,52
Dungannon,3394,4,13,7,10,59,49,10,46
Ballymena,3394,5,13,4,13,58,57,1,43
Glenavon,3394,6,9,11,10,44,46,-2,38
Coleraine,3394,7,10,8,12,46,52,-6,38
Glentoran,3394,8,9,7,14,31,52,-21,34
Ballinamalla,3394,9,9,3,18,34,56,-22,30
Portadown,3394,10,8,5,17,24,43,-19,29
Ards,3394,11,7,5,18,37,56,-19,26
Crusaders,3395,1,16,10,4,53,33,20,58
Ballymena,3395,2,16,6,8,74,57,17,54
Cliftonville,3395,3,15,6,9,52,46,6,51
Glenavon,3395,4,11,10,9,48,48,0,43
Linfield,3395,5,9,15,6,53,36,17,42
Glentoran,3395,6,10,8,12,40,47,-7,38
Coleraine,3395,7,9,10,11,41,46,-5,37
Portadown,3395,8,9,7,14,29,44,-15,34
Ballinamalla,3395,9,8,8,14,32,46,-14,32
Dungannon,3395,10,6,13,11,46,45,1,31
Ards,3395,11,5,9,16,33,53,-20,24
Crusaders,3396,1,22,5,3,60,28,32,71
Linfield,3396,2,14,9,7,58,33,25,51
Cliftonville,3396,3,16,3,11,55,38,17,51
Coleraine,3396,4,13,12,5,45,30,15,51
Ballymena,3396,5,12,6,12,58,69,-11,42
Dungannon,3396,6,11,6,13,49,46,3,39
Glenavon,3396,7,9,10,11,52,51,1,37
Portadown,3396,8,10,3,17,32,53,-21,33
Ballinamalla,3396,9,8,7,15,36,50,-14,31
Glentoran,3396,10,8,6,16,30,54,-24,30
Ards,3396,11,6,5,19,33,56,-23,23
Linfield,3397,1,17,6,7,62,29,33,57
Cliftonville,3397,2,16,5,9,52,35,17,53
Crusaders,3397,3,15,7,8,53,37,16,52
Coleraine,3397,4,13,9,8,45,42,3,48
Dungannon,3397,5,12,7,11,53,45,8,43
Glenavon,3397,6,11,9,10,54,54,0,42
Ballymena,3397,7,12,4,14,44,58,-14,40
Glentoran,3397,8,10,6,14,33,48,-15,36
Ards,3397,9,10,3,17,43,48,-5,33
Ballinamalla,3397,10,9,4,17,36,53,-17,31
Portadown,3397,11,8,4,18,30,56,-26,28
Linfield,3398,1,15,10,5,51,24,27,55
Cliftonville,3398,2,15,7,8,51,37,14,52
Crusaders,3398,3,13,11,6,57,40,17,50
Glenavon,3398,4,13,10,7,55,47,8,49
Coleraine,3398,5,11,10,9,40,38,2,43
Ballymena,3398,6,12,5,13,56,61,-5,41
Dungannon,3398,7,9,8,13,46,49,-3,35
Portadown,3398,8,9,7,14,28,42,-14,34
Glentoran,3398,9,7,11,12,27,40,-13,32
Ards,3398,10,8,7,15,31,45,-14,31
Ballinamalla,3398,11,6,8,16,33,52,-19,26
Crusaders,3399,1,20,6,4,62,30,32,66
Cliftonville,3399,2,19,4,7,61,33,28,61
Ballymena,3399,3,15,6,9,57,50,7,51
Linfield,3399,4,12,10,8,54,36,18,46
Dungannon,3399,5,11,7,12,51,45,6,40
Coleraine,3399,6,9,13,8,37,36,1,40
Glenavon,3399,7,9,9,12,39,46,-7,36
Glentoran,3399,8,8,7,15,25,42,-17,31
Portadown,3399,9,9,4,17,26,53,-27,31
Ards,3399,10,8,5,17,32,50,-18,29
Ballinamalla,3399,11,8,3,19,24,47,-23,27
Linfield,3400,1,15,10,5,59,32,27,55
Crusaders,3400,2,16,6,8,60,40,20,54
Cliftonville,3400,3,15,6,9,51,42,9,51
Glenavon,3400,4,13,9,8,45,40,5,48
Ballymena,3400,5,11,10,9,50,52,-2,43
Coleraine,3400,6,10,12,8,41,37,4,42
Dungannon,3400,7,11,8,11,55,43,12,41
Glentoran,3400,8,8,10,12,29,43,-14,34
Ballinamalla,3400,9,9,2,19,31,50,-19,29
Portadown,3400,10,7,7,16,30,48,-18,28
Ards,3400,11,7,6,17,28,52,-24,27
Linfield,3401,1,16,9,5,68,34,34,57
Crusaders,3401,2,16,6,8,54,39,15,54
Ballymena,3401,3,15,5,10,55,51,4,50
Cliftonville,3401,4,14,4,12,49,43,6,46
Portadown,3401,5,12,5,13,36,45,-9,41
Dungannon,3401,6,10,9,11,52,46,6,39
Glenavon,3401,7,8,14,8,56,58,-2,38
Coleraine,3401,8,9,9,12,32,39,-7,36
Ballinamalla,3401,9,11,2,17,36,54,-18,35
Glentoran,3401,10,9,7,14,29,41,-12,34
Ards,3401,11,8,4,18,33,50,-17,28
Cliftonville,3402,1,17,4,9,50,35,15,55
Ballymena,3402,2,16,6,8,66,56,10,54
Linfield,3402,3,14,10,6,61,36,25,52
Crusaders,3402,4,14,6,10,54,43,11,48
Coleraine,3402,5,10,14,6,40,32,8,44
Glenavon,3402,6,11,7,12,42,51,-9,40
Dungannon,3402,7,9,10,11,47,41,6,37
Glentoran,3402,8,8,10,12,29,43,-14,34
Ards,3402,9,8,7,15,39,48,-9,31
Ballinamalla,3402,10,9,4,17,33,50,-17,31
Portadown,3402,11,8,4,18,28,54,-26,28
Crusaders,3403,1,15,10,5,60,41,19,55
Glenavon,3403,2,13,11,6,48,36,12,50
Cliftonville,3403,3,14,6,10,58,45,13,48
Linfield,3403,4,12,10,8,52,32,20,46
Coleraine,3403,5,11,12,7,47,37,10,45
Ards,3403,6,13,4,13,37,42,-5,43
Ballymena,3403,7,12,5,13,55,69,-14,41
Dungannon,3403,8,9,8,13,50,55,-5,35
Glentoran,3403,9,8,8,14,35,45,-10,32
Portadown,3403,10,9,5,16,28,46,-18,32
Ballinamalla,3403,11,7,5,18,34,56,-22,26
Crusaders,3404,1,19,4,7,67,36,31,61
Cliftonville,3404,2,15,6,9,49,36,13,51
Ballymena,3404,3,13,8,9,59,57,2,47
Linfield,3404,4,12,9,9,53,40,13,45
Glenavon,3404,5,12,9,9,46,44,2,45
Dungannon,3404,6,11,8,11,54,45,9,41
Coleraine,3404,7,10,9,11,42,38,4,39
Ards,3404,8,11,4,15,41,52,-11,37
Glentoran,3404,9,10,7,13,39,50,-11,37
Ballinamalla,3404,10,10,3,17,33,55,-22,33
Portadown,3404,11,6,5,19,28,58,-30,23
Crusaders,3405,1,19,9,2,60,28,32,66
Linfield,3405,2,17,7,6,65,25,40,58
Ballymena,3405,3,15,7,8,61,54,7,52
Dungannon,3405,4,12,8,10,51,41,10,44
Cliftonville,3405,5,12,5,13,47,43,4,41
Ards,3405,6,11,6,13,39,49,-10,39
Coleraine,3405,7,9,11,10,34,38,-4,38
Glenavon,3405,8,9,8,13,40,49,-9,35
Glentoran,3405,9,8,5,17,31,53,-22,29
Portadown,3405,10,8,5,17,24,46,-22,29
Ballinamalla,3405,11,7,5,18,25,51,-26,26
Crusaders,3406,1,20,6,4,69,40,29,66
Cliftonville,3406,2,18,2,10,58,36,22,56
Glenavon,3406,3,14,10,6,54,47,7,52
Coleraine,3406,4,15,7,8,48,41,7,52
Linfield,3406,5,12,9,9,54,38,16,45
Ballymena,3406,6,13,4,13,54,61,-7,43
Dungannon,3406,7,8,10,12,45,47,-2,34
Ards,3406,8,10,3,17,38,48,-10,33
Glentoran,3406,9,9,6,15,34,50,-16,33
Ballinamalla,3406,10,6,6,18,30,52,-22,24
Portadown,3406,11,5,7,18,23,47,-24,22
Crusaders,3407,1,17,7,6,57,34,23,58
Linfield,3407,2,14,10,6,67,34,33,52
Cliftonville,3407,3,15,6,9,54,43,11,51
Ballymena,3407,4,14,8,8,52,57,-5,50
Glenavon,3407,5,12,10,8,48,45,3,46
Coleraine,3407,6,12,10,8,39,36,3,46
Dungannon,3407,7,10,8,12,50,41,9,38
Glentoran,3407,8,7,10,13,32,50,-18,31
Ards,3407,9,9,3,18,32,44,-12,30
Portadown,3407,10,8,6,16,29,47,-18,30
Ballinamalla,3407,11,5,6,19,21,50,-29,21
Crusaders,3408,1,18,7,5,58,26,32,61
Cliftonville,3408,2,15,6,9,47,38,9,51
Linfield,3408,3,12,10,8,53,35,18,46
Ballymena,3408,4,13,7,10,56,54,2,46
Coleraine,3408,5,12,8,10,42,36,6,44
Dungannon,3408,6,10,12,8,55,46,9,42
Glenavon,3408,7,11,8,11,40,47,-7,41
Glentoran,3408,8,9,6,15,28,42,-14,33
Ards,3408,9,8,7,15,34,45,-11,31
Ballinamalla,3408,10,9,4,17,28,48,-20,31
Portadown,3408,11,7,7,16,25,49,-24,28
Crusaders,3409,1,18,8,4,60,30,30,62
Linfield,3409,2,14,10,6,56,30,26,52
Cliftonville,3409,3,15,5,10,51,38,13,50
Ballymena,3409,4,13,8,9,47,50,-3,47
Glenavon,3409,5,10,14,6,50,46,4,44
Dungannon,3409,6,10,12,8,50,38,12,42
Coleraine,3409,7,9,12,9,39,39,0,39
Glentoran,3409,8,9,7,14,32,48,-16,34
Ballinamalla,3409,9,9,4,17,27,51,-24,31
Portadown,3409,10,7,6,17,22,46,-24,27
Ards,3409,11,7,2,21,35,53,-18,23
Crusaders,3410,1,16,10,4,58,33,25,58
Linfield,3410,2,13,10,7,59,32,27,49
Cliftonville,3410,3,14,4,12,46,40,6,46
Ballymena,3410,4,13,7,10,58,55,3,46
Glenavon,3410,5,12,9,9,51,48,3,45
Coleraine,3410,6,11,10,9,51,48,3,43
Glentoran,3410,7,11,7,12,31,44,-13,40
Portadown,3410,8,12,3,15,26,36,-10,39
Dungannon,3410,9,10,7,13,49,52,-3,37
Ards,3410,10,7,6,17,33,53,-20,27
Ballinamalla,3410,11,7,5,18,26,47,-21,26
Linfield,3411,1,16,9,5,58,27,31,57
Crusaders,3411,2,17,6,7,56,34,22,57
Ballymena,3411,3,16,6,8,77,56,21,54
Cliftonville,3411,4,15,7,8,51,34,17,52
Glenavon,3411,5,10,11,9,52,51,1,41
Coleraine,3411,6,10,9,11,35,40,-5,39
Dungannon,3411,7,8,10,12,50,47,3,34
Ards,3411,8,10,3,17,44,54,-10,33
Ballinamalla,3411,9,9,4,17,32,54,-22,31
Glentoran,3411,10,8,7,15,27,53,-26,31
Portadown,3411,11,7,6,17,23,55,-32,27
Linfield,3412,1,18,8,4,64,29,35,62
Cliftonville,3412,2,18,3,9,59,38,21,57
Crusaders,3412,3,15,7,8,54,41,13,52
Coleraine,3412,4,12,10,8,46,39,7,46
Glenavon,3412,5,10,9,11,47,51,-4,39
Dungannon,3412,6,10,8,12,54,48,6,38
Ballymena,3412,7,11,5,14,51,63,-12,38
Ballinamalla,3412,8,11,3,16,30,46,-16,36
Glentoran,3412,9,9,5,16,38,56,-18,32
Portadown,3412,10,9,4,17,26,44,-18,31
Ards,3412,11,8,6,16,39,53,-14,30
Cliftonville,3413,1,19,4,7,54,34,20,61
Crusaders,3413,2,17,6,7,55,31,24,57
Glenavon,3413,3,15,10,5,59,38,21,55
Linfield,3413,4,13,8,9,55,34,21,47
Ballymena,3413,5,12,6,12,49,63,-14,42
Ards,3413,6,11,6,13,48,47,1,39
Coleraine,3413,7,10,9,11,40,41,-1,39
Dungannon,3413,8,9,9,12,53,51,2,36
Glentoran,3413,9,8,9,13,29,51,-22,33
Portadown,3413,10,9,3,18,29,45,-16,30
Ballinamalla,3413,11,4,6,20,28,64,-36,18
Crusaders,3414,1,16,9,5,52,29,23,57
Linfield,3414,2,15,10,5,62,30,32,55
Cliftonville,3414,3,17,4,9,58,38,20,55
Glenavon,3414,4,14,10,6,58,40,18,52
Coleraine,3414,5,12,10,8,46,45,1,46
Ballymena,3414,6,10,12,8,53,55,-2,42
Dungannon,3414,7,10,10,10,49,45,4,40
Glentoran,3414,8,7,10,13,24,37,-13,31
Ards,3414,9,8,4,18,32,51,-19,28
Portadown,3414,10,7,4,19,21,55,-34,25
Ballinamalla,3414,11,4,7,19,25,55,-30,19
Linfield,3415,1,16,7,7,61,30,31,55
Cliftonville,3415,2,16,5,9,60,43,17,53
Crusaders,3415,3,14,8,8,58,46,12,50
Ballymena,3415,4,15,4,11,64,59,5,49
Glenavon,3415,5,12,12,6,49,43,6,48
Coleraine,3415,6,10,11,9,43,42,1,41
Dungannon,3415,7,10,9,11,47,43,4,39
Glentoran,3415,8,10,8,12,30,41,-11,38
Portadown,3415,9,8,4,18,28,53,-25,28
Ballinamalla,3415,10,7,6,17,29,49,-20,27
Ards,3415,11,6,8,16,36,56,-20,26
Crusaders,3416,1,19,7,4,65,29,36,64
Linfield,3416,2,17,9,4,67,28,39,60
Ballymena,3416,3,16,4,10,60,60,0,52
Cliftonville,3416,4,14,7,9,56,44,12,49
Glenavon,3416,5,12,9,9,52,52,0,45
Coleraine,3416,6,11,10,9,52,46,6,43
Dungannon,3416,7,8,13,9,47,43,4,37
Glentoran,3416,8,8,7,15,28,49,-21,31
Ards,3416,9,7,4,19,31,55,-24,25
Portadown,3416,10,7,4,19,22,50,-28,25
Ballinamalla,3416,11,6,6,18,28,52,-24,24
Crusaders,3417,1,18,6,6,55,32,23,60
Ballymena,3417,2,16,6,8,72,62,10,54
Cliftonville,3417,3,16,4,10,50,39,11,52
Linfield,3417,4,13,10,7,60,38,22,49
Dungannon,3417,5,12,9,9,52,39,13,45
Glenavon,3417,6,10,12,8,44,42,2,42
Coleraine,3417,7,11,8,11,37,38,-1,41
Ards,3417,8,11,3,16,39,50,-11,36
Ballinamalla,3417,9,10,4,16,31,47,-16,34
Glentoran,3417,10,7,6,17,29,50,-21,27
Portadown,3417,11,5,4,21,18,50,-32,19
Crusaders,3418,1,16,8,6,56,37,19,56
Ballymena,3418,2,16,5,9,65,55,10,53
Cliftonville,3418,3,15,7,8,55,41,14,52
Linfield,3418,4,12,11,7,52,33,19,47
Dungannon,3418,5,11,10,9,56,44,12,43
Coleraine,3418,6,10,11,9,43,42,1,41
Glenavon,3418,7,8,12,10,45,57,-12,36
Ballinamalla,3418,8,8,8,14,27,44,-17,32
Glentoran,3418,9,7,10,13,34,49,-15,31
Ards,3418,10,8,5,17,33,47,-14,29
Portadown,3418,11,8,5,17,28,45,-17,29
Crusaders,3419,1,17,6,7,55,42,13,57
Cliftonville,3419,2,15,6,9,59,44,15,51
Glenavon,3419,3,14,9,7,56,44,12,51
Linfield,3419,4,14,8,8,57,35,22,50
Coleraine,3419,5,13,10,7,51,42,9,49
Dungannon,3419,6,13,6,11,59,47,12,45
Ballymena,3419,7,13,5,12,59,58,1,44
Glentoran,3419,8,9,6,15,27,41,-14,33
Ards,3419,9,8,6,16,32,49,-17,30
Ballinamalla,3419,10,7,5,18,25,52,-27,26
Portadown,3419,11,7,3,20,26,52,-26,24
Crusaders,3420,1,16,7,7,49,29,20,55
Linfield,3420,2,15,9,6,69,39,30,54
Cliftonville,3420,3,16,4,10,48,37,11,52
Ballymena,3420,4,14,4,12,68,67,1,46
Glentoran,3420,5,12,5,13,46,50,-4,41
Dungannon,3420,6,10,10,10,43,39,4,40
Coleraine,3420,7,10,9,11,40,42,-2,39
Ards,3420,8,12,3,15,40,48,-8,39
Glenavon,3420,9,10,8,12,44,52,-8,38
Ballinamalla,3420,10,8,5,17,28,50,-22,29
Portadown,3420,11,7,6,17,25,47,-22,27
Crusaders,3421,1,16,8,6,56,39,17,56
Linfield,3421,2,14,11,5,58,27,31,53
Cliftonville,3421,3,15,6,9,56,43,13,51
Dungannon,3421,4,11,9,10,60,49,11,42
Coleraine,3421,5,9,15,6,34,38,-4,42
Ballymena,3421,6,9,11,10,55,60,-5,38
Glenavon,3421,7,9,10,11,42,45,-3,37
Portadown,3421,8,10,5,15,28,43,-15,35
Glentoran,3421,9,7,12,11,25,38,-13,33
Ballinamalla,3421,10,10,2,18,38,52,-14,32
Ards,3421,11,7,7,16,33,51,-18,28
Linfield,3422,1,16,9,5,66,33,33,57
Crusaders,3422,2,17,6,7,48,34,14,57
Cliftonville,3422,3,17,3,10,54,34,20,54
Coleraine,3422,4,13,11,6,47,36,11,50
Ballymena,3422,5,15,5,10,59,51,8,50
Glenavon,3422,6,10,11,9,48,42,6,41
Dungannon,3422,7,11,8,11,46,47,-1,41
Glentoran,3422,8,9,8,13,29,44,-15,35
Portadown,3422,9,8,6,16,28,46,-18,30
Ballinamalla,3422,10,6,3,21,29,54,-25,21
Ards,3422,11,5,6,19,30,63,-33,21
Linfield,3423,1,16,10,4,63,30,33,58
Cliftonville,3423,2,18,3,9,54,37,17,57
Crusaders,3423,3,15,9,6,55,36,19,54
Glentoran,3423,4,13,6,11,40,41,-1,45
Ballymena,3423,5,12,7,11,56,61,-5,43
Coleraine,3423,6,9,11,10,40,38,2,38
Glenavon,3423,7,10,8,12,42,51,-9,38
Dungannon,3423,8,9,9,12,48,45,3,36
Portadown,3423,9,10,4,16,26,44,-18,34
Ards,3423,10,9,3,18,35,52,-17,30
Ballinamalla,3423,11,7,4,19,35,59,-24,25
Linfield,3424,1,15,8,7,55,32,23,53
Crusaders,3424,2,15,8,7,52,34,18,53
Cliftonville,3424,3,15,3,12,50,42,8,48
Coleraine,3424,4,12,11,7,44,33,11,47
Ballymena,3424,5,13,8,9,51,51,0,47
Dungannon,3424,6,12,7,11,53,43,10,43
Glenavon,3424,7,10,10,10,41,47,-6,40
Ards,3424,8,10,6,14,42,49,-7,36
Ballinamalla,3424,9,10,5,15,37,50,-13,35
Glentoran,3424,10,6,11,13,25,45,-20,29
Portadown,3424,11,6,5,19,24,48,-24,23
Crusaders,3425,1,17,8,5,55,26,29,59
Dungannon,3425,2,17,6,7,54,33,21,57
Linfield,3425,3,14,11,5,55,29,26,53
Glenavon,3425,4,12,10,8,44,41,3,46
Ballymena,3425,5,13,6,11,60,64,-4,45
Cliftonville,3425,6,12,8,10,40,34,6,44
Coleraine,3425,7,10,12,8,39,35,4,42
Portadown,3425,8,8,5,17,27,46,-19,29
Ards,3425,9,6,9,15,37,50,-13,27
Glentoran,3425,10,6,8,16,25,50,-25,26
Ballinamalla,3425,11,7,3,20,27,55,-28,24
Ballymena,3426,1,16,8,6,55,47,8,56
Linfield,3426,2,14,12,4,60,31,29,54
Glenavon,3426,3,15,9,6,47,36,11,54
Coleraine,3426,4,13,11,6,46,35,11,50
Crusaders,3426,5,13,10,7,54,42,12,49
Cliftonville,3426,6,13,6,11,50,41,9,45
Dungannon,3426,7,12,7,11,52,44,8,43
Ards,3426,8,7,6,17,32,50,-18,27
Portadown,3426,9,8,2,20,31,54,-23,26
Glentoran,3426,10,6,7,17,26,49,-23,25
Ballinamalla,3426,11,7,4,19,28,52,-24,25
Crusaders,3427,1,19,8,3,63,31,32,65
Linfield,3427,2,14,10,6,58,33,25,52
Coleraine,3427,3,12,11,7,47,32,15,47
Cliftonville,3427,4,13,7,10,51,40,11,46
Glenavon,3427,5,11,13,6,53,51,2,46
Glentoran,3427,6,9,11,10,34,42,-8,38
Ballymena,3427,7,10,7,13,55,65,-10,37
Dungannon,3427,8,8,10,12,47,46,1,34
Ards,3427,9,8,6,16,36,55,-19,30
Ballinamalla,3427,10,7,5,18,28,50,-22,26
Portadown,3427,11,6,8,16,24,51,-27,26
Linfield,3428,1,18,7,5,56,27,29,61
Crusaders,3428,2,16,8,6,62,40,22,56
Cliftonville,3428,3,16,4,10,60,37,23,52
Coleraine,3428,4,13,9,8,46,37,9,48
Ballymena,3428,5,13,7,10,53,59,-6,46
Glenavon,3428,6,11,12,7,50,46,4,45
Dungannon,3428,7,9,8,13,49,52,-3,35
Ards,3428,8,9,6,15,43,48,-5,33
Ballinamalla,3428,9,8,5,17,22,46,-24,29
Glentoran,3428,10,7,7,16,27,52,-25,28
Portadown,3428,11,5,7,18,22,46,-24,22
Linfield,3429,1,15,9,6,62,34,28,54
Crusaders,3429,2,15,9,6,44,25,19,54
Ballymena,3429,3,15,6,9,57,58,-1,51
Cliftonville,3429,4,14,7,9,50,35,15,49
Glenavon,3429,5,10,12,8,41,43,-2,42
Coleraine,3429,6,10,11,9,44,42,2,41
Dungannon,3429,7,10,10,10,50,43,7,40
Ards,3429,8,10,4,16,42,51,-9,34
Glentoran,3429,9,8,8,14,27,45,-18,32
Portadown,3429,10,8,5,17,27,48,-21,29
Ballinamalla,3429,11,8,3,19,26,46,-20,27
Linfield,3430,1,15,10,5,60,32,28,55
Glenavon,3430,2,15,10,5,56,39,17,55
Crusaders,3430,3,16,7,7,55,39,16,55
Cliftonville,3430,4,13,8,9,54,41,13,47
Coleraine,3430,5,11,11,8,49,45,4,44
Ballymena,3430,6,12,8,10,59,60,-1,44
Dungannon,3430,7,8,14,8,50,45,5,38
Ards,3430,8,10,6,14,46,52,-6,36
Portadown,3430,9,6,7,17,25,48,-23,25
Glentoran,3430,10,5,10,15,26,50,-24,25
Ballinamalla,3430,11,4,9,17,23,52,-29,21
Cliftonville,3431,1,20,4,6,58,30,28,64
Crusaders,3431,2,16,8,6,53,32,21,56
Glenavon,3431,3,13,10,7,53,41,12,49
Ballymena,3431,4,13,8,9,53,53,0,47
Linfield,3431,5,12,10,8,56,35,21,46
Coleraine,3431,6,11,9,10,42,38,4,42
Dungannon,3431,7,10,8,12,52,48,4,38
Ards,3431,8,8,7,15,32,49,-17,31
Glentoran,3431,9,7,8,15,26,46,-20,29
Ballinamalla,3431,10,7,6,17,25,50,-25,27
Portadown,3431,11,7,4,19,27,55,-28,25
Crusaders,3432,1,15,8,7,51,35,16,53
Glenavon,3432,2,13,12,5,50,41,9,51
Coleraine,3432,3,14,8,8,47,39,8,50
Linfield,3432,4,12,10,8,52,35,17,46
Cliftonville,3432,5,13,5,12,49,40,9,44
Ards,3432,6,12,5,13,45,44,1,41
Ballymena,3432,7,11,8,11,51,58,-7,41
Dungannon,3432,8,10,10,10,49,38,11,40
Glentoran,3432,9,7,10,13,31,47,-16,31
Portadown,3432,10,6,9,15,24,41,-17,27
Ballinamalla,3432,11,6,7,17,26,57,-31,25
Crusaders,3433,1,14,11,5,53,33,20,53
Ballymena,3433,2,16,4,10,61,56,5,52
Linfield,3433,3,14,8,8,53,34,19,50
Cliftonville,3433,4,15,4,11,49,41,8,49
Glenavon,3433,5,13,9,8,52,41,11,48
Coleraine,3433,6,12,9,9,49,46,3,45
Glentoran,3433,7,10,8,12,30,42,-12,38
Dungannon,3433,8,9,10,11,49,45,4,37
Ards,3433,9,9,3,18,37,52,-15,30
Ballinamalla,3433,10,7,7,16,34,53,-19,28
Portadown,3433,11,7,5,18,28,52,-24,26
Crusaders,3434,1,17,9,4,61,31,30,60
Linfield,3434,2,14,9,7,60,37,23,51
Cliftonville,3434,3,16,3,11,48,38,10,51
Ballymena,3434,4,14,4,12,51,60,-9,46
Glenavon,3434,5,10,14,6,47,38,9,44
Coleraine,3434,6,11,10,9,39,37,2,43
Glentoran,3434,7,10,7,13,33,46,-13,37
Dungannon,3434,8,8,10,12,47,42,5,34
Portadown,3434,9,8,8,14,29,44,-15,32
Ballinamalla,3434,10,9,3,18,26,51,-25,30
Ards,3434,11,7,5,18,31,48,-17,26
Crusaders,3435,1,17,6,7,54,34,20,57
Ballymena,3435,2,17,4,9,68,56,12,55
Glenavon,3435,3,14,11,5,51,40,11,53
Cliftonville,3435,4,14,7,9,49,35,14,49
Coleraine,3435,5,10,14,6,41,35,6,44
Linfield,3435,6,11,9,10,49,38,11,42
Dungannon,3435,7,11,9,10,51,44,7,42
Ards,3435,8,10,5,15,40,50,-10,35
Glentoran,3435,9,9,5,16,26,42,-16,32
Portadown,3435,10,7,6,17,25,49,-24,27
Ballinamalla,3435,11,4,6,20,21,52,-31,18
Crusaders,3436,1,19,7,4,59,30,29,64
Cliftonville,3436,2,18,3,9,52,37,15,57
Ballymena,3436,3,15,5,10,71,59,12,50
Linfield,3436,4,12,10,8,53,34,19,46
Ards,3436,5,13,5,12,44,43,1,44
Coleraine,3436,6,10,13,7,40,36,4,43
Glenavon,3436,7,11,10,9,49,49,0,43
Ballinamalla,3436,8,7,9,14,30,50,-20,30
Glentoran,3436,9,7,7,16,26,48,-22,28
Dungannon,3436,10,6,9,15,42,48,-6,27
Portadown,3436,11,5,6,19,22,54,-32,21
Crusaders,3437,1,17,10,3,54,28,26,61
Linfield,3437,2,14,11,5,56,28,28,53
Cliftonville,3437,3,16,5,9,57,40,17,53
Coleraine,3437,4,12,9,9,46,33,13,45
Ballymena,3437,5,13,5,12,60,61,-1,44
Glentoran,3437,6,10,8,12,28,40,-12,38
Glenavon,3437,7,8,13,9,42,45,-3,37
Dungannon,3437,8,8,11,11,51,48,3,35
Ards,3437,9,9,7,14,37,48,-11,34
Ballinamalla,3437,10,6,8,16,24,52,-28,26
Portadown,3437,11,6,5,19,18,50,-32,23
Crusaders,3438,1,18,8,4,55,25,30,62
Linfield,3438,2,18,6,6,59,26,33,60
Cliftonville,3438,3,16,5,9,49,39,10,53
Coleraine,3438,4,12,8,10,46,40,6,44
Dungannon,3438,5,11,10,9,53,43,10,43
Ballymena,3438,6,12,7,11,56,63,-7,43
Glenavon,3438,7,11,9,10,56,44,12,42
Glentoran,3438,8,9,8,13,28,39,-11,35
Ards,3438,9,7,7,16,34,53,-19,28
Ballinamalla,3438,10,7,4,19,26,58,-32,25
Portadown,3438,11,5,6,19,19,51,-32,21
Cliftonville,3439,1,18,3,9,53,37,16,57
Linfield,3439,2,15,9,6,62,32,30,54
Crusaders,3439,3,15,8,7,52,34,18,53
Glenavon,3439,4,14,9,7,58,44,14,51
Coleraine,3439,5,11,10,9,49,44,5,43
Ballymena,3439,6,11,7,12,52,58,-6,40
Dungannon,3439,7,10,9,11,47,41,6,39
Ards,3439,8,10,5,15,38,50,-12,35
Glentoran,3439,9,7,9,14,28,49,-21,30
Ballinamalla,3439,10,8,6,16,27,49,-22,30
Portadown,3439,11,6,5,19,28,56,-28,23
Crusaders,3440,1,17,7,6,51,28,23,58
Linfield,3440,2,14,11,5,64,34,30,53
Cliftonville,3440,3,16,5,9,59,45,14,53
Coleraine,3440,4,12,13,5,54,34,20,49
Glenavon,3440,5,10,10,10,44,48,-4,40
Ballymena,3440,6,10,9,11,57,64,-7,39
Dungannon,3440,7,9,11,10,51,46,5,38
Glentoran,3440,8,9,8,13,32,45,-13,35
Ballinamalla,3440,9,9,4,17,33,55,-22,31
Ards,3440,10,8,6,16,38,56,-18,30
Portadown,3440,11,6,6,18,24,52,-28,24
Crusaders,3441,1,18,8,4,61,33,28,62
Glenavon,3441,2,12,11,7,54,47,7,47
Cliftonville,3441,3,14,5,11,46,43,3,47
Linfield,3441,4,12,8,10,49,31,18,44
Coleraine,3441,5,11,11,8,41,37,4,44
Ballymena,3441,6,13,5,12,54,56,-2,44
Dungannon,3441,7,11,9,10,50,43,7,42
Glentoran,3441,8,9,9,12,31,38,-7,36
Ballinamalla,3441,9,10,3,17,28,52,-24,33
Ards,3441,10,7,9,14,31,42,-11,30
Portadown,3441,11,6,6,18,22,45,-23,24
Crusaders,3442,1,16,9,5,55,30,25,57
Glenavon,3442,2,14,10,6,54,40,14,52
Ballymena,3442,3,14,7,9,60,59,1,49
Linfield,3442,4,13,8,9,57,36,21,47
Cliftonville,3442,5,13,4,13,50,43,7,43
Portadown,3442,6,12,5,13,32,43,-11,41
Coleraine,3442,7,10,10,10,41,38,3,40
Ards,3442,8,10,5,15,44,53,-9,35
Dungannon,3442,9,8,9,13,42,44,-2,33
Ballinamalla,3442,10,9,3,18,28,51,-23,30
Glentoran,3442,11,7,8,15,30,56,-26,29
Crusaders,3443,1,17,7,6,65,45,20,58
Linfield,3443,2,16,8,6,64,28,36,56
Cliftonville,3443,3,16,5,9,56,40,16,53
Coleraine,3443,4,11,11,8,40,34,6,44
Ballymena,3443,5,12,6,12,53,61,-8,42
Dungannon,3443,6,10,11,9,55,46,9,41
Glenavon,3443,7,11,8,11,46,45,1,41
Glentoran,3443,8,11,6,13,32,40,-8,39
Ards,3443,9,8,6,16,35,52,-17,30
Ballinamalla,3443,10,8,4,18,24,51,-27,28
Portadown,3443,11,8,2,20,27,55,-28,26
Crusaders,3444,1,17,7,6,60,35,25,58
Linfield,3444,2,16,8,6,59,34,25,56
Cliftonville,3444,3,15,6,9,53,43,10,51
Ballymena,3444,4,14,6,10,60,60,0,48
Coleraine,3444,5,12,11,7,43,34,9,47
Glenavon,3444,6,11,10,9,44,39,5,43
Glentoran,3444,7,12,7,11,34,38,-4,43
Dungannon,3444,8,9,11,10,48,42,6,38
Ballinamalla,3444,9,7,4,19,30,55,-25,25
Portadown,3444,10,6,6,18,25,49,-24,24
Ards,3444,11,5,6,19,30,57,-27,21
Crusaders,3445,1,16,6,8,59,42,17,54
Linfield,3445,2,15,8,7,54,28,26,53
Ballymena,3445,3,15,5,10,60,56,4,50
Cliftonville,3445,4,13,5,12,53,46,7,44
Coleraine,3445,5,12,8,10,40,40,0,44
Glenavon,3445,6,11,11,8,44,46,-2,44
Glentoran,3445,7,11,7,12,36,41,-5,40
Ards,3445,8,10,6,14,41,48,-7,36
Dungannon,3445,9,8,11,11,48,45,3,35
Ballinamalla,3445,10,8,5,17,30,51,-21,29
Portadown,3445,11,8,4,18,27,49,-22,28
Crusaders,3446,1,18,7,5,54,27,27,61
Cliftonville,3446,2,18,6,6,56,27,29,60
Linfield,3446,3,15,9,6,56,30,26,54
Ballymena,3446,4,16,4,10,63,54,9,52
Glenavon,3446,5,10,11,9,41,41,0,41
Coleraine,3446,6,9,13,8,32,31,1,40
Dungannon,3446,7,10,9,11,49,45,4,39
Ards,3446,8,10,3,17,36,52,-16,33
Glentoran,3446,9,7,9,14,29,48,-19,30
Portadown,3446,10,6,7,17,22,51,-29,25
Ballinamalla,3446,11,4,6,20,17,49,-32,18
Dungannon,3447,1,15,8,7,61,39,22,53
Crusaders,3447,2,15,8,7,55,38,17,53
Ballymena,3447,3,15,7,8,57,54,3,52
Linfield,3447,4,12,10,8,55,34,21,46
Coleraine,3447,5,12,9,9,44,39,5,45
Cliftonville,3447,6,13,5,12,50,44,6,44
Glenavon,3447,7,10,10,10,41,43,-2,40
Portadown,3447,8,9,6,15,30,45,-15,33
Ards,3447,9,9,5,16,39,49,-10,32
Glentoran,3447,10,8,8,14,29,46,-17,32
Ballinamalla,3447,11,6,6,18,25,55,-30,24
Cliftonville,3448,1,18,4,8,57,38,19,58
Crusaders,3448,2,17,5,8,64,41,23,56
Linfield,3448,3,15,9,6,59,30,29,54
Coleraine,3448,4,12,10,8,43,38,5,46
Ballymena,3448,5,13,7,10,56,58,-2,46
Glenavon,3448,6,10,8,12,48,52,-4,38
Glentoran,3448,7,10,8,12,34,43,-9,38
Dungannon,3448,8,10,7,13,48,50,-2,37
Ards,3448,9,8,6,16,35,49,-14,30
Ballinamalla,3448,10,7,7,16,34,52,-18,28
Portadown,3448,11,8,3,19,21,48,-27,27
Crusaders,3449,1,14,10,6,56,38,18,52
Linfield,3449,2,14,9,7,53,32,21,51
Coleraine,3449,3,13,11,6,53,45,8,50
Glenavon,3449,4,12,13,5,53,40,13,49
Ballymena,3449,5,12,8,10,58,62,-4,44
Cliftonville,3449,6,12,7,11,48,44,4,43
Glentoran,3449,7,11,6,13,37,52,-15,39
Ballinamalla,3449,8,11,3,16,33,45,-12,36
Dungannon,3449,9,9,8,13,53,50,3,35
Ards,3449,10,8,7,15,40,53,-13,31
Portadown,3449,11,5,6,19,27,50,-23,21
Linfield,3450,1,16,10,4,64,28,36,58
Coleraine,3450,2,14,9,7,54,36,18,51
Glenavon,3450,3,13,11,6,53,45,8,50
Ballymena,3450,4,15,5,10,57,65,-8,50
Cliftonville,3450,5,14,5,11,53,45,8,47
Crusaders,3450,6,12,8,10,49,42,7,44
Dungannon,3450,7,10,10,10,52,43,9,40
Glentoran,3450,8,10,9,11,29,37,-8,39
Portadown,3450,9,9,4,17,29,48,-19,31
Ards,3450,10,5,9,16,33,49,-16,24
Ballinamalla,3450,11,4,6,20,23,58,-35,18
Crusaders,3451,1,17,11,2,61,34,27,62
Cliftonville,3451,2,18,5,7,57,31,26,59
Ballymena,3451,3,14,8,8,60,53,7,50
Linfield,3451,4,12,8,10,50,36,14,44
Coleraine,3451,5,10,12,8,39,37,2,42
Ards,3451,6,11,4,15,39,43,-4,37
Glenavon,3451,7,9,9,12,41,51,-10,36
Dungannon,3451,8,8,11,11,48,48,0,35
Glentoran,3451,9,8,9,13,27,46,-19,33
Ballinamalla,3451,10,8,5,17,27,48,-21,29
Portadown,3451,11,6,6,18,24,46,-22,24
Linfield,3452,1,19,7,4,66,31,35,64
Crusaders,3452,2,16,7,7,51,33,18,55
Cliftonville,3452,3,15,3,12,43,33,10,48
Glenavon,3452,4,11,12,7,48,42,6,45
Coleraine,3452,5,11,10,9,41,41,0,43
Ballymena,3452,6,11,5,14,50,60,-10,38
Dungannon,3452,7,9,10,11,46,43,3,37
Ards,3452,8,10,7,13,36,43,-7,37
Glentoran,3452,9,10,7,13,31,42,-11,37
Ballinamalla,3452,10,8,5,17,25,48,-23,29
Portadown,3452,11,6,5,19,29,50,-21,23
Crusaders,3453,1,17,9,4,63,32,31,60
Cliftonville,3453,2,17,5,8,62,44,18,56
Linfield,3453,3,14,11,5,59,31,28,53
Glenavon,3453,4,13,9,8,55,46,9,48
Ballymena,3453,5,13,9,8,58,61,-3,48
Dungannon,3453,6,11,8,11,53,41,12,41
Coleraine,3453,7,10,9,11,41,42,-1,39
Glentoran,3453,8,8,9,13,26,42,-16,33
Ballinamalla,3453,9,9,4,17,29,52,-23,31
Ards,3453,10,7,5,18,29,51,-22,26
Portadown,3453,11,4,6,20,20,53,-33,18
Cliftonville,3454,1,17,6,7,60,36,24,57
Crusaders,3454,2,15,6,9,55,43,12,51
Ballymena,3454,3,14,8,8,60,53,7,50
Glenavon,3454,4,13,9,8,44,46,-2,48
Linfield,3454,5,12,11,7,53,37,16,47
Coleraine,3454,6,12,9,9,47,39,8,45
Dungannon,3454,7,10,11,9,52,41,11,41
Portadown,3454,8,9,5,16,28,49,-21,32
Glentoran,3454,9,8,6,16,29,41,-12,30
Ballinamalla,3454,10,8,4,18,24,51,-27,28
Ards,3454,11,8,3,19,42,58,-16,27
Linfield,3455,1,15,9,6,61,30,31,54
Crusaders,3455,2,15,8,7,57,34,23,53
Ballymena,3455,3,15,5,10,65,58,7,50
Coleraine,3455,4,13,9,8,45,39,6,48
Cliftonville,3455,5,14,4,12,45,48,-3,46
Glenavon,3455,6,12,9,9,43,47,-4,45
Dungannon,3455,7,10,8,12,57,48,9,38
Ards,3455,8,9,6,15,35,46,-11,33
Ballinamalla,3455,9,9,4,17,34,51,-17,31
Glentoran,3455,10,7,9,14,32,53,-21,30
Portadown,3455,11,7,7,16,32,52,-20,28
Linfield,3456,1,18,8,4,61,27,34,62
Crusaders,3456,2,14,9,7,54,34,20,51
Cliftonville,3456,3,14,6,10,50,39,11,48
Ballymena,3456,4,14,4,12,60,64,-4,46
Coleraine,3456,5,12,9,9,41,36,5,45
Glenavon,3456,6,11,11,8,47,43,4,44
Dungannon,3456,7,9,11,10,47,40,7,38
Glentoran,3456,8,9,8,13,33,47,-14,35
Ards,3456,9,8,7,15,36,53,-17,31
Portadown,3456,10,7,8,15,31,47,-16,29
Ballinamalla,3456,11,6,5,19,22,52,-30,23
Linfield,3457,1,21,7,2,71,21,50,70
Cliftonville,3457,2,18,4,8,52,30,22,58
Crusaders,3457,3,16,9,5,59,36,23,57
Ballymena,3457,4,13,5,12,53,59,-6,44
Glenavon,3457,5,9,11,10,44,45,-1,38
Dungannon,3457,6,9,9,12,47,45,2,36
Coleraine,3457,7,7,13,10,33,40,-7,34
Glentoran,3457,8,7,12,11,32,46,-14,33
Ards,3457,9,9,5,16,33,48,-15,32
Ballinamalla,3457,10,7,7,16,28,51,-23,28
Portadown,3457,11,6,4,20,23,54,-31,22
Linfield,3458,1,15,11,4,55,26,29,56
Cliftonville,3458,2,16,6,8,57,37,20,54
Crusaders,3458,3,15,6,9,50,38,12,51
Glenavon,3458,4,13,10,7,57,49,8,49
Ballymena,3458,5,12,9,9,57,58,-1,45
Coleraine,3458,6,9,13,8,46,49,-3,40
Ballinamalla,3458,7,10,4,16,37,49,-12,34
Dungannon,3458,8,7,12,11,46,48,-2,33
Portadown,3458,9,8,7,15,31,49,-18,31
Ards,3458,10,7,7,16,34,49,-15,28
Glentoran,3458,11,6,9,15,25,43,-18,27
Linfield,3459,1,17,8,5,73,35,38,59
Cliftonville,3459,2,16,4,10,47,35,12,52
Crusaders,3459,3,14,8,8,55,39,16,50
Coleraine,3459,4,13,9,8,48,35,13,48
Glenavon,3459,5,12,11,7,44,42,2,47
Ballymena,3459,6,13,6,11,58,71,-13,45
Dungannon,3459,7,10,8,12,47,40,7,38
Ards,3459,8,11,4,15,39,50,-11,37
Glentoran,3459,9,7,9,14,36,51,-15,30
Portadown,3459,10,6,7,17,27,51,-24,25
Ballinamalla,3459,11,7,4,19,28,53,-25,25
Cliftonville,3460,1,18,4,8,56,35,21,58
Crusaders,3460,2,17,5,8,59,38,21,56
Linfield,3460,3,15,7,8,57,32,25,52
Ballymena,3460,4,15,4,11,66,62,4,49
Ards,3460,5,13,4,13,44,42,2,43
Coleraine,3460,6,11,9,10,39,44,-5,42
Glenavon,3460,7,10,11,9,50,47,3,41
Dungannon,3460,8,10,8,12,48,49,-1,38
Portadown,3460,9,9,5,16,31,51,-20,32
Ballinamalla,3460,10,8,6,16,37,55,-18,30
Glentoran,3460,11,5,5,20,22,54,-32,20
Crusaders,3461,1,19,6,5,58,36,22,63
Linfield,3461,2,14,11,5,53,25,28,53
Ballymena,3461,3,15,5,10,53,55,-2,50
Coleraine,3461,4,13,9,8,45,36,9,48
Cliftonville,3461,5,15,2,13,50,43,7,47
Glenavon,3461,6,12,11,7,51,46,5,47
Dungannon,3461,7,9,9,12,50,43,7,36
Glentoran,3461,8,8,8,14,28,41,-13,32
Ards,3461,9,8,4,18,29,44,-15,28
Ballinamalla,3461,10,6,8,16,27,50,-23,26
Portadown,3461,11,7,5,18,26,51,-25,26
Linfield,3462,1,15,10,5,61,34,27,55
Crusaders,3462,2,15,10,5,50,34,16,55
Glenavon,3462,3,15,8,7,49,41,8,53
Cliftonville,3462,4,14,7,9,54,40,14,49
Coleraine,3462,5,12,11,7,48,41,7,47
Ballymena,3462,6,11,7,12,54,64,-10,40
Dungannon,3462,7,9,10,11,44,40,4,37
Glentoran,3462,8,9,8,13,33,44,-11,35
Ards,3462,9,8,6,16,45,50,-5,30
Ballinamalla,3462,10,6,7,17,21,45,-24,25
Portadown,3462,11,7,4,19,27,53,-26,25
Crusaders,3463,1,18,6,6,60,39,21,60
Linfield,3463,2,16,10,4,72,28,44,58
Coleraine,3463,3,13,11,6,44,40,4,50
Cliftonville,3463,4,14,5,11,59,40,19,47
Ballymena,3463,5,13,7,10,54,58,-4,46
Glenavon,3463,6,9,12,9,45,40,5,39
Dungannon,3463,7,10,9,11,46,45,1,39
Portadown,3463,8,9,4,17,35,55,-20,31
Glentoran,3463,9,8,7,15,30,55,-25,31
Ards,3463,10,6,8,16,33,52,-19,26
Ballinamalla,3463,11,6,7,17,33,59,-26,25
Crusaders,3464,1,16,8,6,57,35,22,56
Ballymena,3464,2,15,6,9,57,56,1,51
Cliftonville,3464,3,14,7,9,48,36,12,49
Linfield,3464,4,11,12,7,58,38,20,45
Glenavon,3464,5,10,11,9,45,50,-5,41
Coleraine,3464,6,9,13,8,42,42,0,40
Dungannon,3464,7,9,12,9,52,42,10,39
Ards,3464,8,9,6,15,39,49,-10,33
Ballinamalla,3464,9,8,8,14,30,47,-17,32
Glentoran,3464,10,8,7,15,33,49,-16,31
Portadown,3464,11,9,4,17,30,47,-17,31
Crusaders,3465,1,16,10,4,55,28,27,58
Cliftonville,3465,2,17,3,10,48,37,11,54
Ballymena,3465,3,16,6,8,59,53,6,54
Linfield,3465,4,12,8,10,55,36,19,44
Glenavon,3465,5,10,13,7,45,38,7,43
Coleraine,3465,6,10,11,9,46,46,0,41
Portadown,3465,7,12,3,15,32,43,-11,39
Ards,3465,8,11,5,14,40,49,-9,38
Dungannon,3465,9,8,9,13,43,48,-5,33
Glentoran,3465,10,7,11,12,31,39,-8,32
Ballinamalla,3465,11,4,5,21,16,53,-37,17
Linfield,3466,1,14,11,5,56,28,28,53
Crusaders,3466,2,15,8,7,51,31,20,53
Ballymena,3466,3,16,5,9,62,57,5,53
Coleraine,3466,4,13,12,5,41,29,12,51
Cliftonville,3466,5,15,4,11,47,35,12,49
Glenavon,3466,6,9,12,9,43,49,-6,39
Dungannon,3466,7,8,12,10,48,44,4,36
Ards,3466,8,10,4,16,37,43,-6,34
Ballinamalla,3466,9,9,6,15,29,44,-15,33
Portadown,3466,10,6,11,13,27,45,-18,29
Glentoran,3466,11,4,7,19,18,54,-36,19
Crusaders,3467,1,17,5,8,53,33,20,56
Ballymena,3467,2,16,5,9,61,54,7,53
Coleraine,3467,3,13,10,7,47,39,8,49
Cliftonville,3467,4,15,4,11,48,42,6,49
Glenavon,3467,5,12,11,7,45,44,1,47
Glentoran,3467,6,12,8,10,46,40,6,44
Linfield,3467,7,11,10,9,48,35,13,43
Dungannon,3467,8,11,9,10,49,41,8,42
Ards,3467,9,6,7,17,39,59,-20,25
Portadown,3467,10,6,6,18,25,43,-18,24
Ballinamalla,3467,11,6,5,19,24,55,-31,23
Crusaders,3468,1,17,6,7,57,42,15,57
Ballymena,3468,2,17,4,9,68,58,10,55
Linfield,3468,3,15,9,6,55,27,28,54
Cliftonville,3468,4,14,4,12,62,46,16,46
Glenavon,3468,5,12,10,8,47,48,-1,46
Coleraine,3468,6,10,10,10,44,47,-3,40
Glentoran,3468,7,11,7,12,34,41,-7,40
Dungannon,3468,8,10,9,11,54,44,10,39
Ballinamalla,3468,9,9,4,17,29,52,-23,31
Portadown,3468,10,7,5,18,24,52,-28,26
Ards,3468,11,7,4,19,36,53,-17,25
Crusaders,3469,1,17,8,5,64,34,30,59
Coleraine,3469,2,15,8,7,46,32,14,53
Cliftonville,3469,3,16,3,11,48,35,13,51
Linfield,3469,4,13,11,6,57,30,27,50
Ballymena,3469,5,14,5,11,58,59,-1,47
Glenavon,3469,6,11,9,10,44,44,0,42
Glentoran,3469,7,11,7,12,29,40,-11,40
Ards,3469,8,11,3,16,45,54,-9,36
Ballinamalla,3469,9,8,4,18,32,58,-26,28
Portadown,3469,10,8,4,18,22,48,-26,28
Dungannon,3469,11,6,8,16,44,55,-11,26
Crusaders,3470,1,18,7,5,60,32,28,61
Linfield,3470,2,14,7,9,56,30,26,49
Glenavon,3470,3,14,7,9,53,43,10,49
Ballymena,3470,4,14,7,9,59,60,-1,49
Cliftonville,3470,5,12,7,11,44,39,5,43
Coleraine,3470,6,10,8,12,39,42,-3,38
Dungannon,3470,7,9,9,12,53,49,4,36
Ards,3470,8,10,6,14,37,49,-12,36
Glentoran,3470,9,10,6,14,28,46,-18,36
Ballinamalla,3470,10,11,2,17,30,48,-18,35
Portadown,3470,11,7,6,17,22,43,-21,27
Crusaders,3471,1,17,8,5,57,39,18,59
Linfield,3471,2,14,9,7,59,37,22,51
Cliftonville,3471,3,15,5,10,61,40,21,50
Coleraine,3471,4,13,10,7,40,34,6,49
Ballymena,3471,5,13,6,11,59,62,-3,45
Dungannon,3471,6,9,14,7,47,39,8,41
Glenavon,3471,7,10,11,9,46,45,1,41
Glentoran,3471,8,10,6,14,30,44,-14,36
Ballinamalla,3471,9,8,7,15,39,54,-15,31
Ards,3471,10,6,9,15,37,52,-15,27
Portadown,3471,11,5,5,20,25,54,-29,20
Cliftonville,3472,1,16,5,9,61,39,22,53
Coleraine,3472,2,14,11,5,48,33,15,53
Crusaders,3472,3,15,7,8,57,47,10,52
Linfield,3472,4,13,11,6,53,30,23,50
Glenavon,3472,5,12,10,8,54,46,8,46
Ballymena,3472,6,13,7,10,54,55,-1,46
Dungannon,3472,7,7,12,11,47,46,1,33
Ards,3472,8,8,9,13,34,51,-17,33
Ballinamalla,3472,9,7,7,16,35,53,-18,28
Glentoran,3472,10,6,10,14,26,44,-18,28
Portadown,3472,11,7,5,18,22,47,-25,26
Crusaders,3473,1,17,8,5,56,31,25,59
Ballymena,3473,2,17,6,7,54,48,6,57
Linfield,3473,3,14,9,7,54,36,18,51
Cliftonville,3473,4,15,5,10,57,39,18,50
Coleraine,3473,5,10,9,11,37,43,-6,39
Dungannon,3473,6,9,11,10,50,46,4,38
Glenavon,3473,7,8,10,12,47,48,-1,34
Glentoran,3473,8,8,10,12,26,38,-12,34
Ballinamalla,3473,9,8,9,13,32,47,-15,33
Portadown,3473,10,9,4,17,31,48,-17,31
Ards,3473,11,6,7,17,32,52,-20,25
Crusaders,3474,1,16,8,6,50,31,19,56
Linfield,3474,2,15,9,6,56,28,28,54
Ballymena,3474,3,15,8,7,58,50,8,53
Cliftonville,3474,4,14,3,13,54,44,10,45
Dungannon,3474,5,12,9,9,62,53,9,45
Coleraine,3474,6,10,9,11,49,45,4,39
Glentoran,3474,7,9,10,11,28,37,-9,37
Glenavon,3474,8,8,12,10,47,51,-4,36
Ballinamalla,3474,9,8,7,15,28,49,-21,31
Ards,3474,10,8,5,17,35,53,-18,29
Portadown,3474,11,7,6,17,24,50,-26,27
Crusaders,3475,1,17,9,4,54,33,21,60
Linfield,3475,2,14,7,9,56,38,18,49
Cliftonville,3475,3,15,4,11,46,41,5,49
Ballymena,3475,4,13,7,10,56,58,-2,46
Coleraine,3475,5,11,10,9,40,37,3,43
Glenavon,3475,6,9,14,7,45,45,0,41
Dungannon,3475,7,9,12,9,49,39,10,39
Glentoran,3475,8,9,8,13,25,35,-10,35
Portadown,3475,9,8,9,13,27,39,-12,33
Ballinamalla,3475,10,8,6,16,36,50,-14,30
Ards,3475,11,6,6,18,32,51,-19,24
Linfield,3476,1,16,8,6,64,31,33,56
Crusaders,3476,2,15,9,6,51,40,11,54
Cliftonville,3476,3,16,4,10,53,38,15,52
Glenavon,3476,4,10,14,6,47,43,4,44
Ballymena,3476,5,13,5,12,59,63,-4,44
Coleraine,3476,6,11,7,12,41,46,-5,40
Dungannon,3476,7,9,11,10,53,45,8,38
Ballinamalla,3476,8,10,3,17,31,47,-16,33
Portadown,3476,9,8,8,14,31,39,-8,32
Glentoran,3476,10,8,8,14,28,44,-16,32
Ards,3476,11,8,5,17,31,53,-22,29
Crusaders,3477,1,16,9,5,55,35,20,57
Cliftonville,3477,2,16,6,8,51,39,12,54
Linfield,3477,3,14,8,8,64,35,29,50
Ballymena,3477,4,15,5,10,60,55,5,50
Glenavon,3477,5,13,9,8,57,45,12,48
Coleraine,3477,6,11,10,9,37,44,-7,43
Glentoran,3477,7,10,6,14,31,41,-10,36
Dungannon,3477,8,9,8,13,41,44,-3,35
Portadown,3477,9,9,5,16,30,48,-18,32
Ards,3477,10,6,10,14,38,51,-13,28
Ballinamalla,3477,11,6,4,20,29,56,-27,22
Linfield,3478,1,17,8,5,60,27,33,59
Crusaders,3478,2,16,6,8,47,30,17,54
Cliftonville,3478,3,16,4,10,53,36,17,52
Ballymena,3478,4,13,7,10,50,57,-7,46
Glenavon,3478,5,10,12,8,51,45,6,42
Glentoran,3478,6,11,6,13,32,41,-9,39
Dungannon,3478,7,10,8,12,48,46,2,38
Coleraine,3478,8,8,12,10,30,38,-8,36
Ards,3478,9,9,5,16,32,46,-14,32
Ballinamalla,3478,10,9,3,18,29,50,-21,30
Portadown,3478,11,8,5,17,27,43,-16,29
Crusaders,3479,1,13,10,7,52,44,8,49
Linfield,3479,2,13,9,8,54,35,19,48
Ballymena,3479,3,13,9,8,58,54,4,48
Coleraine,3479,4,11,12,7,43,35,8,45
Cliftonville,3479,5,11,9,10,50,44,6,42
Glenavon,3479,6,10,11,9,55,47,8,41
Dungannon,3479,7,10,10,10,52,42,10,40
Ballinamalla,3479,8,11,5,14,34,44,-10,38
Glentoran,3479,9,8,11,11,29,42,-13,35
Portadown,3479,10,8,6,16,32,53,-21,30
Ards,3479,11,7,8,15,35,54,-19,29
Crusaders,3480,1,17,6,7,56,35,21,57
Linfield,3480,2,16,7,7,57,28,29,55
Ballymena,3480,3,16,6,8,62,56,6,54
Cliftonville,3480,4,14,6,10,59,47,12,48
Glenavon,3480,5,11,11,8,42,44,-2,44
Coleraine,3480,6,10,11,9,37,33,4,41
Glentoran,3480,7,10,6,14,35,49,-14,36
Ards,3480,8,10,5,15,36,44,-8,35
Dungannon,3480,9,7,10,13,40,46,-6,31
Ballinamalla,3480,10,9,4,17,35,48,-13,31
Portadown,3480,11,5,8,17,24,53,-29,23
Crusaders,3481,1,17,8,5,62,35,27,59
Ballymena,3481,2,14,9,7,66,60,6,51
Coleraine,3481,3,11,12,7,43,36,7,45
Cliftonville,3481,4,13,6,11,50,44,6,45
Linfield,3481,5,10,12,8,50,38,12,42
Dungannon,3481,6,9,11,10,51,44,7,38
Glenavon,3481,7,8,13,9,42,46,-4,37
Glentoran,3481,8,9,9,12,32,42,-10,36
Ards,3481,9,9,7,14,38,50,-12,34
Ballinamalla,3481,10,7,8,15,31,52,-21,29
Portadown,3481,11,6,9,15,24,42,-18,27
Linfield,3482,1,15,10,5,62,29,33,55
Crusaders,3482,2,16,7,7,50,32,18,55
Dungannon,3482,3,14,8,8,60,42,18,50
Cliftonville,3482,4,16,2,12,58,41,17,50
Ballymena,3482,5,15,4,11,55,59,-4,49
Glenavon,3482,6,10,12,8,39,40,-1,42
Coleraine,3482,7,9,10,11,35,37,-2,37
Ballinamalla,3482,8,10,5,15,37,53,-16,35
Glentoran,3482,9,8,9,13,32,45,-13,33
Portadown,3482,10,6,7,17,27,54,-27,25
Ards,3482,11,6,6,18,32,55,-23,24
Cliftonville,3483,1,15,7,8,50,34,16,52
Linfield,3483,2,12,13,5,62,38,24,49
Crusaders,3483,3,13,9,8,48,34,14,48
Coleraine,3483,4,12,9,9,46,43,3,45
Glenavon,3483,5,12,8,10,48,57,-9,44
Glentoran,3483,6,11,8,11,36,39,-3,41
Dungannon,3483,7,9,11,10,43,37,6,38
Ballymena,3483,8,10,6,14,53,60,-7,36
Portadown,3483,9,9,7,14,27,42,-15,34
Ards,3483,10,8,8,14,36,49,-13,32
Ballinamalla,3483,11,9,4,17,30,46,-16,31
Crusaders,3484,1,17,7,6,52,35,17,58
Coleraine,3484,2,15,9,6,49,34,15,54
Linfield,3484,3,14,9,7,54,30,24,51
Dungannon,3484,4,14,8,8,58,39,19,50
Cliftonville,3484,5,15,3,12,57,52,5,48
Ards,3484,6,10,5,15,40,48,-8,35
Glentoran,3484,7,9,8,13,26,41,-15,35
Glenavon,3484,8,8,9,13,46,50,-4,33
Ballymena,3484,9,9,6,15,46,67,-21,33
Portadown,3484,10,9,5,16,28,42,-14,32
Ballinamalla,3484,11,8,5,17,31,49,-18,29
Linfield,3485,1,16,9,5,71,38,33,57
Ballymena,3485,2,16,4,10,56,51,5,52
Glenavon,3485,3,13,12,5,58,40,18,51
Crusaders,3485,4,14,8,8,48,36,12,50
Cliftonville,3485,5,14,5,11,50,40,10,47
Coleraine,3485,6,12,11,7,44,39,5,47
Portadown,3485,7,10,6,14,28,42,-14,36
Dungannon,3485,8,8,9,13,47,46,1,33
Glentoran,3485,9,9,5,16,27,47,-20,32
Ards,3485,10,7,7,16,37,55,-18,28
Ballinamalla,3485,11,5,6,19,24,56,-32,21
Crusaders,3486,1,19,6,5,67,27,40,63
Cliftonville,3486,2,16,4,10,60,49,11,52
Linfield,3486,3,13,9,8,57,34,23,48
Coleraine,3486,4,12,10,8,39,35,4,46
Ballymena,3486,5,12,8,10,57,56,1,44
Glenavon,3486,6,11,11,8,47,50,-3,44
Ards,3486,7,12,4,14,44,50,-6,40
Dungannon,3486,8,8,10,12,45,49,-4,34
Ballinamalla,3486,9,9,6,15,37,56,-19,33
Glentoran,3486,10,6,10,14,28,47,-19,28
Portadown,3486,11,6,4,20,24,52,-28,22
Crusaders,3487,1,17,7,6,62,35,27,58
Linfield,3487,2,14,10,6,63,35,28,52
Coleraine,3487,3,12,9,9,42,36,6,45
Glenavon,3487,4,11,10,9,47,47,0,43
Ballymena,3487,5,12,7,11,56,62,-6,43
Cliftonville,3487,6,12,5,13,49,49,0,41
Glentoran,3487,7,10,9,11,38,43,-5,39
Dungannon,3487,8,10,8,12,51,46,5,38
Portadown,3487,9,11,4,15,27,44,-17,37
Ards,3487,10,9,6,15,36,52,-16,33
Ballinamalla,3487,11,6,7,17,30,52,-22,25
Crusaders,3488,1,16,10,4,62,33,29,58
Cliftonville,3488,2,14,9,7,57,42,15,51
Linfield,3488,3,14,7,9,58,33,25,49
Glenavon,3488,4,12,9,9,49,42,7,45
Coleraine,3488,5,11,10,9,37,39,-2,43
Ballymena,3488,6,11,9,10,50,55,-5,42
Dungannon,3488,7,10,11,9,49,42,7,41
Portadown,3488,8,11,6,13,27,40,-13,39
Ards,3488,9,8,6,16,37,50,-13,30
Ballinamalla,3488,10,7,6,17,24,47,-23,27
Glentoran,3488,11,5,9,16,25,52,-27,24
Crusaders,3489,1,19,7,4,60,28,32,64
Ballymena,3489,2,16,5,9,65,60,5,53
Coleraine,3489,3,13,10,7,48,35,13,49
Glenavon,3489,4,12,10,8,54,51,3,46
Linfield,3489,5,12,8,10,60,46,14,44
Cliftonville,3489,6,13,3,14,48,44,4,42
Ards,3489,7,10,4,16,42,51,-9,34
Ballinamalla,3489,8,9,6,15,32,43,-11,33
Portadown,3489,9,8,7,15,27,45,-18,31
Glentoran,3489,10,8,7,15,29,56,-27,31
Dungannon,3489,11,6,11,13,44,50,-6,29
Crusaders,3490,1,16,10,4,62,36,26,58
Ballymena,3490,2,15,7,8,59,53,6,52
Linfield,3490,3,13,11,6,58,33,25,50
Cliftonville,3490,4,10,11,9,49,41,8,41
Glenavon,3490,5,9,14,7,42,43,-1,41
Glentoran,3490,6,11,6,13,33,48,-15,39
Dungannon,3490,7,8,11,11,45,45,0,35
Coleraine,3490,8,8,11,11,37,39,-2,35
Ballinamalla,3490,9,9,6,15,36,48,-12,33
Ards,3490,10,8,8,14,34,46,-12,32
Portadown,3490,11,7,7,16,24,47,-23,28
Cliftonville,3491,1,18,5,7,59,36,23,59
Crusaders,3491,2,16,9,5,62,35,27,57
Ballymena,3491,3,15,5,10,59,61,-2,50
Linfield,3491,4,13,7,10,60,39,21,46
Glenavon,3491,5,12,9,9,50,51,-1,45
Coleraine,3491,6,10,9,11,35,36,-1,39
Dungannon,3491,7,10,8,12,48,41,7,38
Ards,3491,8,11,4,15,41,48,-7,37
Portadown,3491,9,9,4,17,29,51,-22,31
Ballinamalla,3491,10,9,4,17,23,46,-23,31
Glentoran,3491,11,7,6,17,35,57,-22,27
Crusaders,3492,1,20,7,3,60,29,31,67
Linfield,3492,2,16,8,6,55,27,28,56
Ballymena,3492,3,17,5,8,60,48,12,56
Cliftonville,3492,4,14,3,13,45,44,1,45
Coleraine,3492,5,11,8,11,44,41,3,41
Glenavon,3492,6,10,10,10,49,51,-2,40
Dungannon,3492,7,9,11,10,48,38,10,38
Ballinamalla,3492,8,10,3,17,32,51,-19,33
Glentoran,3492,9,9,5,16,30,50,-20,32
Portadown,3492,10,8,5,17,21,43,-22,29
Ards,3492,11,7,3,20,30,52,-22,24
Ballymena,3493,1,17,4,9,60,48,12,55
Linfield,3493,2,14,11,5,62,32,30,53
Crusaders,3493,3,14,10,6,49,31,18,52
Cliftonville,3493,4,15,4,11,43,36,7,49
Glenavon,3493,5,11,12,7,45,42,3,45
Dungannon,3493,6,11,10,9,51,40,11,43
Coleraine,3493,7,9,9,12,37,41,-4,36
Ballinamalla,3493,8,9,5,16,33,48,-15,32
Glentoran,3493,9,7,11,12,30,47,-17,32
Ards,3493,10,8,6,16,32,48,-16,30
Portadown,3493,11,5,8,17,31,60,-29,23
Linfield,3494,1,17,8,5,63,33,30,59
Crusaders,3494,2,17,5,8,57,31,26,56
Ballymena,3494,3,14,5,11,51,55,-4,47
Glenavon,3494,4,12,10,8,48,42,6,46
Coleraine,3494,5,11,12,7,40,35,5,45
Dungannon,3494,6,11,10,9,55,47,8,43
Cliftonville,3494,7,11,5,14,45,42,3,38
Glentoran,3494,8,10,7,13,35,43,-8,37
Ards,3494,9,11,4,15,38,47,-9,37
Portadown,3494,10,7,5,18,26,52,-26,26
Ballinamalla,3494,11,6,5,19,30,61,-31,23
Cliftonville,3495,1,18,4,8,63,41,22,58
Crusaders,3495,2,16,8,6,52,35,17,56
Linfield,3495,3,15,9,6,60,31,29,54
Glenavon,3495,4,12,13,5,51,40,11,49
Ballymena,3495,5,12,7,11,54,62,-8,43
Coleraine,3495,6,10,11,9,46,42,4,41
Ards,3495,7,9,6,15,36,47,-11,33
Portadown,3495,8,9,5,16,30,45,-15,32
Dungannon,3495,9,7,10,13,42,48,-6,31
Ballinamalla,3495,10,8,5,17,28,48,-20,29
Glentoran,3495,11,6,8,16,31,54,-23,26
Crusaders,3496,1,17,7,6,51,27,24,58
Coleraine,3496,2,15,9,6,52,34,18,54
Cliftonville,3496,3,17,2,11,52,40,12,53
Linfield,3496,4,14,8,8,58,35,23,50
Glenavon,3496,5,12,12,6,46,38,8,48
Ballymena,3496,6,14,5,11,54,56,-2,47
Dungannon,3496,7,8,10,12,46,46,0,34
Glentoran,3496,8,8,7,15,29,50,-21,31
Ards,3496,9,8,5,17,39,55,-16,29
Ballinamalla,3496,10,8,4,18,25,47,-22,28
Portadown,3496,11,6,7,17,19,43,-24,25
Crusaders,3497,1,18,8,4,63,31,32,62
Linfield,3497,2,12,13,5,52,26,26,49
Glenavon,3497,3,13,10,7,54,47,7,49
Cliftonville,3497,4,13,8,9,49,32,17,47
Dungannon,3497,5,12,9,9,52,40,12,45
Coleraine,3497,6,11,12,7,44,33,11,45
Ballymena,3497,7,12,9,9,53,56,-3,45
Glentoran,3497,8,9,7,14,33,52,-19,34
Ards,3497,9,6,6,18,35,58,-23,24
Portadown,3497,10,5,9,16,25,51,-26,24
Ballinamalla,3497,11,5,7,18,23,57,-34,22
Crusaders,3498,1,19,6,5,62,26,36,63
Linfield,3498,2,14,9,7,60,36,24,51
Ballymena,3498,3,14,6,10,63,58,5,48
Glenavon,3498,4,11,11,8,40,39,1,44
Coleraine,3498,5,10,13,7,42,41,1,43
Cliftonville,3498,6,13,3,14,50,43,7,42
Dungannon,3498,7,11,8,11,53,50,3,41
Ards,3498,8,10,6,14,34,45,-11,36
Ballinamalla,3498,9,11,2,17,38,54,-16,35
Glentoran,3498,10,7,7,16,28,50,-22,28
Portadown,3498,11,8,3,19,27,55,-28,27
Cliftonville,3499,1,18,4,8,59,33,26,58
Linfield,3499,2,15,9,6,60,28,32,54
Glenavon,3499,3,14,10,6,50,40,10,52
Crusaders,3499,4,12,8,10,55,44,11,44
Ballymena,3499,5,13,5,12,57,66,-9,44
Ballinamalla,3499,6,12,3,15,41,56,-15,39
Coleraine,3499,7,8,13,9,37,40,-3,37
Portadown,3499,8,10,5,15,29,40,-11,35
Dungannon,3499,9,8,9,13,47,49,-2,33
Glentoran,3499,10,8,8,14,37,56,-19,32
Ards,3499,11,7,6,17,35,55,-20,27
Ballymena,3500,1,19,4,7,63,48,15,61
Crusaders,3500,2,17,9,4,51,26,25,60
Cliftonville,3500,3,15,5,10,59,41,18,50
Linfield,3500,4,12,10,8,55,36,19,46
Coleraine,3500,5,10,11,9,46,45,1,41
Glenavon,3500,6,10,10,10,46,50,-4,40
Ards,3500,7,10,5,15,35,48,-13,35
Dungannon,3500,8,9,7,14,47,49,-2,34
Portadown,3500,9,10,4,16,30,45,-15,34
Ballinamalla,3500,10,7,6,17,32,53,-21,27
Glentoran,3500,11,6,9,15,26,49,-23,27
Crusaders,3501,1,20,6,4,55,29,26,66
Linfield,3501,2,14,8,8,55,31,24,50
Cliftonville,3501,3,14,6,10,48,39,9,48
Glenavon,3501,4,11,12,7,48,41,7,45
Ballymena,3501,5,13,5,12,55,58,-3,44
Dungannon,3501,6,12,7,11,46,38,8,43
Coleraine,3501,7,11,9,10,34,31,3,42
Portadown,3501,8,9,8,13,31,41,-10,35
Ards,3501,9,9,4,17,41,50,-9,31
Glentoran,3501,10,8,7,15,29,55,-26,31
Ballinamalla,3501,11,7,2,21,27,56,-29,23
Crusaders,3502,1,17,4,9,61,50,11,55
Ballymena,3502,2,15,7,8,56,49,7,52
Cliftonville,3502,3,15,6,9,52,37,15,51
Linfield,3502,4,13,9,8,56,33,23,48
Glenavon,3502,5,12,12,6,45,37,8,48
Coleraine,3502,6,11,10,9,38,34,4,43
Dungannon,3502,7,11,9,10,61,48,13,42
Glentoran,3502,8,10,8,12,37,46,-9,38
Ards,3502,9,10,5,15,39,53,-14,35
Portadown,3502,10,8,4,18,26,45,-19,28
Ballinamalla,3502,11,4,4,22,26,65,-39,16
Ballymena,3503,1,17,6,7,72,55,17,57
Crusaders,3503,2,17,5,8,55,34,21,56
Glenavon,3503,3,14,9,7,60,48,12,51
Cliftonville,3503,4,15,5,10,55,42,13,50
Coleraine,3503,5,13,9,8,42,36,6,48
Linfield,3503,6,11,12,7,49,34,15,45
Dungannon,3503,7,11,8,11,49,41,8,41
Glentoran,3503,8,11,6,13,31,40,-9,39
Ards,3503,9,9,4,17,34,54,-20,31
Ballinamalla,3503,10,6,3,21,25,57,-32,21
Portadown,3503,11,5,5,20,22,53,-31,20
Linfield,3504,1,15,9,6,60,30,30,54
Cliftonville,3504,2,17,3,10,52,38,14,54
Ballymena,3504,3,15,4,11,60,64,-4,49
Coleraine,3504,4,12,8,10,49,42,7,44
Crusaders,3504,5,13,5,12,43,39,4,44
Dungannon,3504,6,12,7,11,56,44,12,43
Glentoran,3504,7,11,6,13,36,47,-11,39
Ballinamalla,3504,8,11,5,14,35,45,-10,38
Glenavon,3504,9,8,11,11,48,55,-7,35
Ards,3504,10,9,5,16,37,49,-12,32
Portadown,3504,11,7,7,16,24,47,-23,28
Crusaders,3505,1,17,8,5,57,34,23,59
Ballymena,3505,2,17,5,8,64,50,14,56
Cliftonville,3505,3,16,4,10,53,39,14,52
Linfield,3505,4,14,9,7,60,31,29,51
Glenavon,3505,5,14,7,9,51,47,4,49
Dungannon,3505,6,10,8,12,46,45,1,38
Coleraine,3505,7,9,10,11,37,38,-1,37
Glentoran,3505,8,9,9,12,26,41,-15,36
Ballinamalla,3505,9,9,3,18,36,58,-22,30
Ards,3505,10,8,5,17,32,53,-21,29
Portadown,3505,11,6,4,20,23,49,-26,22
Crusaders,3506,1,21,7,2,64,31,33,70
Linfield,3506,2,18,9,3,63,19,44,63
Cliftonville,3506,3,15,5,10,52,36,16,50
Ballymena,3506,4,12,6,12,58,69,-11,42
Coleraine,3506,5,11,8,11,46,47,-1,41
Dungannon,3506,6,10,10,10,49,40,9,40
Glentoran,3506,7,11,4,15,33,48,-15,37
Glenavon,3506,8,8,9,13,40,51,-11,33
Ballinamalla,3506,9,9,3,18,30,52,-22,30
Portadown,3506,10,7,6,17,22,48,-26,27
Ards,3506,11,6,7,17,33,49,-16,25
Linfield,3507,1,14,12,4,55,27,28,54
Crusaders,3507,2,14,7,9,53,39,14,49
Coleraine,3507,3,12,12,6,38,32,6,48
Glenavon,3507,4,12,11,7,52,43,9,47
Cliftonville,3507,5,14,5,11,49,44,5,47
Ballymena,3507,6,11,9,10,57,60,-3,42
Dungannon,3507,7,9,10,11,46,39,7,37
Glentoran,3507,8,8,12,10,29,37,-8,36
Portadown,3507,9,9,6,15,32,48,-16,33
Ballinamalla,3507,10,9,3,18,28,53,-25,30
Ards,3507,11,6,7,17,33,50,-17,25
Coleraine,3508,1,16,9,5,53,36,17,57
Linfield,3508,2,15,9,6,56,32,24,54
Glenavon,3508,3,15,9,6,58,38,20,54
Crusaders,3508,4,14,7,9,54,45,9,49
Cliftonville,3508,5,14,5,11,54,47,7,47
Ballymena,3508,6,11,8,11,57,59,-2,41
Dungannon,3508,7,9,11,10,55,46,9,38
Glentoran,3508,8,9,5,16,28,46,-18,32
Ards,3508,9,9,3,18,36,53,-17,30
Ballinamalla,3508,10,7,8,15,30,49,-19,29
Portadown,3508,11,7,4,19,23,53,-30,25
Crusaders,3509,1,19,6,5,59,36,23,63
Coleraine,3509,2,13,10,7,43,38,5,49
Linfield,3509,3,11,13,6,50,33,17,46
Glenavon,3509,4,12,9,9,49,43,6,45
Ballymena,3509,5,13,6,11,56,55,1,45
Cliftonville,3509,6,13,3,14,42,42,0,42
Dungannon,3509,7,11,8,11,57,42,15,41
Ards,3509,8,10,7,13,37,42,-5,37
Glentoran,3509,9,9,8,13,35,48,-13,35
Ballinamalla,3509,10,7,6,17,30,58,-28,27
Portadown,3509,11,7,4,19,23,44,-21,25
Crusaders,3510,1,19,6,5,58,40,18,63
Linfield,3510,2,15,9,6,61,33,28,54
Glenavon,3510,3,12,10,8,55,47,8,46
Cliftonville,3510,4,13,6,11,47,49,-2,45
Coleraine,3510,5,11,11,8,44,41,3,44
Ballymena,3510,6,12,7,11,57,53,4,43
Dungannon,3510,7,11,7,12,52,44,8,40
Ards,3510,8,9,6,15,35,47,-12,33
Ballinamalla,3510,9,10,2,18,33,48,-15,32
Glentoran,3510,10,8,7,15,27,46,-19,31
Portadown,3510,11,5,9,16,21,42,-21,24
Ballymena,3511,1,18,4,8,66,59,7,58
Crusaders,3511,2,15,6,9,48,36,12,51
Linfield,3511,3,13,8,9,56,34,22,47
Dungannon,3511,4,12,9,9,55,39,16,45
Cliftonville,3511,5,13,5,12,53,45,8,44
Glenavon,3511,6,11,11,8,43,42,1,44
Coleraine,3511,7,9,12,9,35,37,-2,39
Ards,3511,8,11,5,14,42,47,-5,38
Ballinamalla,3511,9,10,3,17,34,52,-18,33
Glentoran,3511,10,7,8,15,29,53,-24,29
Portadown,3511,11,7,7,16,32,49,-17,28
Crusaders,3512,1,18,6,6,58,32,26,60
Cliftonville,3512,2,17,5,8,51,37,14,56
Linfield,3512,3,13,11,6,58,34,24,50
Glenavon,3512,4,13,8,9,53,48,5,47
Ballymena,3512,5,13,4,13,60,66,-6,43
Dungannon,3512,6,9,10,11,51,48,3,37
Glentoran,3512,7,10,6,14,32,41,-9,36
Coleraine,3512,8,8,10,12,35,46,-11,34
Ballinamalla,3512,9,9,7,14,32,44,-12,34
Portadown,3512,10,8,7,15,28,44,-16,31
Ards,3512,11,7,6,17,36,54,-18,27
Crusaders,3513,1,16,8,6,53,36,17,56
Linfield,3513,2,13,11,6,58,31,27,50
Ballymena,3513,3,13,8,9,56,59,-3,47
Coleraine,3513,4,12,10,8,43,33,10,46
Cliftonville,3513,5,13,5,12,47,40,7,44
Ards,3513,6,12,7,11,44,44,0,43
Glenavon,3513,7,8,13,9,41,45,-4,37
Dungannon,3513,8,8,12,10,49,45,4,36
Portadown,3513,9,9,6,15,30,43,-13,33
Ballinamalla,3513,10,9,3,18,27,49,-22,30
Glentoran,3513,11,6,9,15,25,48,-23,27
Crusaders,3514,1,21,5,4,62,35,27,68
Glenavon,3514,2,14,9,7,53,43,10,51
Coleraine,3514,3,13,10,7,52,37,15,49
Linfield,3514,4,12,10,8,64,45,19,46
Ballymena,3514,5,14,4,12,53,56,-3,46
Cliftonville,3514,6,13,5,12,53,45,8,44
Ards,3514,7,12,4,14,43,52,-9,40
Portadown,3514,8,11,3,16,32,47,-15,36
Dungannon,3514,9,8,9,13,45,43,2,33
Ballinamalla,3514,10,7,4,19,32,60,-28,25
Glentoran,3514,11,4,9,17,27,53,-26,21
Crusaders,3515,1,17,10,3,63,31,32,61
Linfield,3515,2,16,8,6,61,30,31,56
Cliftonville,3515,3,14,7,9,49,37,12,49
Coleraine,3515,4,12,12,6,47,38,9,48
Ballymena,3515,5,13,6,11,54,60,-6,45
Glenavon,3515,6,10,11,9,48,48,0,41
Dungannon,3515,7,10,7,13,54,52,2,37
Glentoran,3515,8,9,6,15,33,48,-15,33
Portadown,3515,9,8,8,14,24,42,-18,32
Ballinamalla,3515,10,8,4,18,27,48,-21,28
Ards,3515,11,7,3,20,29,55,-26,24
Linfield,3516,1,16,7,7,66,34,32,55
Cliftonville,3516,2,17,3,10,54,33,21,54
Crusaders,3516,3,15,9,6,51,34,17,54
Ballymena,3516,4,15,4,11,57,56,1,49
Dungannon,3516,5,13,8,9,54,39,15,47
Glenavon,3516,6,9,14,7,47,47,0,41
Coleraine,3516,7,10,11,9,40,43,-3,41
Glentoran,3516,8,10,8,12,31,41,-10,38
Ards,3516,9,9,4,17,38,54,-16,31
Ballinamalla,3516,10,7,5,18,28,53,-25,26
Portadown,3516,11,5,5,20,23,55,-32,20
Crusaders,3517,1,18,8,4,62,31,31,62
Linfield,3517,2,14,9,7,58,36,22,51
Glenavon,3517,3,12,11,7,48,45,3,47
Cliftonville,3517,4,13,7,10,44,35,9,46
Ballymena,3517,5,13,7,10,54,59,-5,46
Dungannon,3517,6,10,12,8,47,37,10,42
Coleraine,3517,7,10,10,10,46,45,1,40
Glentoran,3517,8,10,7,13,30,41,-11,37
Ards,3517,9,8,6,16,40,56,-16,30
Portadown,3517,10,7,6,17,26,44,-18,27
Ballinamalla,3517,11,7,3,20,26,52,-26,24
Cliftonville,3518,1,18,5,7,58,34,24,59
Crusaders,3518,2,17,8,5,56,34,22,59
Linfield,3518,3,17,6,7,66,38,28,57
Dungannon,3518,4,13,9,8,62,39,23,48
Ballymena,3518,5,14,6,10,62,64,-2,48
Glenavon,3518,6,11,9,10,48,47,1,42
Coleraine,3518,7,10,11,9,37,37,0,41
Ards,3518,8,9,4,17,39,53,-14,31
Glentoran,3518,9,8,6,16,28,52,-24,30
Ballinamalla,3518,10,7,2,21,28,58,-30,23
Portadown,3518,11,6,4,20,25,53,-28,22
Linfield,3519,1,16,11,3,58,26,32,59
Crusaders,3519,2,16,7,7,56,39,17,55
Ballymena,3519,3,14,7,9,61,61,0,49
Dungannon,3519,4,13,8,9,55,44,11,47
Coleraine,3519,5,12,11,7,46,38,8,47
Cliftonville,3519,6,13,7,10,51,41,10,46
Glenavon,3519,7,9,10,11,43,49,-6,37
Ards,3519,8,9,7,14,38,44,-6,34
Ballinamalla,3519,9,9,3,18,28,50,-22,30
Portadown,3519,10,7,5,18,23,44,-21,26
Glentoran,3519,11,6,6,18,21,44,-23,24
Linfield,3520,1,16,9,5,57,28,29,57
Crusaders,3520,2,14,8,8,50,40,10,50
Glenavon,3520,3,13,10,7,53,43,10,49
Cliftonville,3520,4,14,6,10,51,37,14,48
Dungannon,3520,5,12,11,7,63,38,25,47
Ballymena,3520,6,13,5,12,51,53,-2,44
Coleraine,3520,7,11,10,9,47,40,7,43
Glentoran,3520,8,7,11,12,27,39,-12,32
Ballinamalla,3520,9,10,2,18,34,61,-27,32
Ards,3520,10,6,9,15,33,53,-20,27
Portadown,3520,11,7,3,20,23,57,-34,24
Linfield,3521,1,14,10,6,61,31,30,52
Cliftonville,3521,2,15,7,8,54,42,12,52
Crusaders,3521,3,13,10,7,46,31,15,49
Coleraine,3521,4,12,11,7,45,40,5,47
Glenavon,3521,5,12,10,8,56,44,12,46
Ballymena,3521,6,13,7,10,52,56,-4,46
Glentoran,3521,7,10,9,11,37,45,-8,39
Ballinamalla,3521,8,12,2,16,35,48,-13,38
Dungannon,3521,9,8,10,12,47,50,-3,34
Ards,3521,10,6,7,17,30,52,-22,25
Portadown,3521,11,5,7,18,22,46,-24,22
Crusaders,3522,1,19,5,6,56,31,25,62
Cliftonville,3522,2,15,8,7,57,41,16,53
Linfield,3522,3,15,7,8,53,36,17,52
Ballymena,3522,4,12,7,11,55,58,-3,43
Dungannon,3522,5,11,8,11,46,40,6,41
Glenavon,3522,6,10,11,9,46,48,-2,41
Coleraine,3522,7,10,9,11,35,38,-3,39
Glentoran,3522,8,8,11,11,30,40,-10,35
Portadown,3522,9,8,6,16,30,43,-13,30
Ards,3522,10,8,5,17,32,46,-14,29
Ballinamalla,3522,11,8,5,17,30,49,-19,29
Crusaders,3523,1,18,5,7,59,35,24,59
Linfield,3523,2,13,10,7,58,35,23,49
Cliftonville,3523,3,14,7,9,48,36,12,49
Coleraine,3523,4,11,12,7,47,37,10,45
Dungannon,3523,5,12,8,10,57,42,15,44
Ballymena,3523,6,11,8,11,52,57,-5,41
Glenavon,3523,7,10,10,10,46,44,2,40
Ards,3523,8,11,4,15,38,55,-17,37
Glentoran,3523,9,9,9,12,35,45,-10,36
Ballinamalla,3523,10,9,4,17,30,56,-26,31
Portadown,3523,11,5,7,18,20,48,-28,22
Cliftonville,3524,1,17,5,8,61,39,22,56
Crusaders,3524,2,16,7,7,54,38,16,55
Coleraine,3524,3,14,7,9,48,41,7,49
Linfield,3524,4,12,9,9,60,41,19,45
Glenavon,3524,5,11,10,9,46,48,-2,43
Ballymena,3524,6,12,7,11,55,59,-4,43
Ards,3524,7,11,6,13,43,44,-1,39
Ballinamalla,3524,8,9,7,14,41,50,-9,34
Dungannon,3524,9,8,9,13,43,43,0,33
Glentoran,3524,10,8,8,14,27,50,-23,32
Portadown,3524,11,6,7,17,27,52,-25,25
Crusaders,3525,1,14,10,6,50,35,15,52
Cliftonville,3525,2,15,5,10,56,39,17,50
Linfield,3525,3,13,10,7,56,34,22,49
Ballymena,3525,4,14,7,9,57,51,6,49
Coleraine,3525,5,12,10,8,44,37,7,46
Glenavon,3525,6,10,12,8,45,45,0,42
Glentoran,3525,7,10,9,11,29,35,-6,39
Dungannon,3525,8,8,10,12,45,48,-3,34
Ballinamalla,3525,9,7,8,15,27,47,-20,29
Portadown,3525,10,8,5,17,26,50,-24,29
Ards,3525,11,6,10,14,32,46,-14,28
Crusaders,3526,1,19,5,6,53,29,24,62
Linfield,3526,2,15,9,6,64,35,29,54
Ballymena,3526,3,15,6,9,56,56,0,51
Cliftonville,3526,4,15,3,12,51,44,7,48
Glenavon,3526,5,12,9,9,49,50,-1,45
Coleraine,3526,6,10,11,9,42,38,4,41
Portadown,3526,7,10,5,15,32,39,-7,35
Ballinamalla,3526,8,9,7,14,30,43,-13,34
Ards,3526,9,7,8,15,38,51,-13,29
Glentoran,3526,10,6,11,13,32,50,-18,29
Dungannon,3526,11,6,8,16,43,55,-12,26
Linfield,3527,1,15,11,4,64,25,39,56
Crusaders,3527,2,15,10,5,55,31,24,55
Cliftonville,3527,3,15,6,9,52,38,14,51
Ballymena,3527,4,15,6,9,56,53,3,51
Glenavon,3527,5,12,9,9,44,46,-2,45
Dungannon,3527,6,12,8,10,47,41,6,44
Coleraine,3527,7,12,8,10,44,41,3,44
Ballinamalla,3527,8,8,4,18,28,49,-21,28
Ards,3527,9,7,6,17,37,56,-19,27
Glentoran,3527,10,6,9,15,26,50,-24,27
Portadown,3527,11,7,5,18,24,47,-23,26
Crusaders,3528,1,18,8,4,55,30,25,62
Ballymena,3528,2,17,8,5,66,53,13,59
Linfield,3528,3,15,12,3,58,27,31,57
Coleraine,3528,4,13,10,7,48,35,13,49
Cliftonville,3528,5,12,7,11,48,41,7,43
Glenavon,3528,6,8,14,8,37,44,-7,38
Dungannon,3528,7,8,11,11,46,49,-3,35
Glentoran,3528,8,9,6,15,34,44,-10,33
Ards,3528,9,8,6,16,32,46,-14,30
Portadown,3528,10,5,9,16,18,41,-23,24
Ballinamalla,3528,11,4,5,21,20,52,-32,17
Crusaders,3529,1,16,10,4,55,33,22,58
Coleraine,3529,2,14,9,7,46,35,11,51
Ballymena,3529,3,14,5,11,61,58,3,47
Linfield,3529,4,12,10,8,56,35,21,46
Cliftonville,3529,5,13,7,10,53,42,11,46
Glenavon,3529,6,9,12,9,42,43,-1,39
Dungannon,3529,7,9,10,11,48,53,-5,37
Portadown,3529,8,10,5,15,31,43,-12,35
Ballinamalla,3529,9,8,7,15,37,49,-12,31
Ards,3529,10,8,7,15,36,51,-15,31
Glentoran,3529,11,7,8,15,34,57,-23,29
Linfield,3530,1,16,9,5,64,32,32,57
Crusaders,3530,2,16,6,8,54,35,19,54
Cliftonville,3530,3,16,6,8,54,38,16,54
Glenavon,3530,4,11,14,5,50,39,11,47
Coleraine,3530,5,12,10,8,44,36,8,46
Ballinamalla,3530,6,14,4,12,37,45,-8,46
Dungannon,3530,7,7,14,9,43,42,1,35
Ballymena,3530,8,9,8,13,49,61,-12,35
Glentoran,3530,9,6,10,14,30,48,-18,28
Ards,3530,10,6,6,18,34,56,-22,24
Portadown,3530,11,6,5,19,23,50,-27,23
Crusaders,3531,1,17,7,6,55,32,23,58
Cliftonville,3531,2,14,7,9,56,43,13,49
Linfield,3531,3,12,11,7,62,38,24,47
Coleraine,3531,4,12,9,9,49,41,8,45
Glenavon,3531,5,11,12,7,39,39,0,45
Ballymena,3531,6,11,7,12,52,62,-10,40
Dungannon,3531,7,10,9,11,46,39,7,39
Ards,3531,8,11,5,14,39,47,-8,38
Portadown,3531,9,10,5,15,26,41,-15,35
Glentoran,3531,10,8,9,13,28,39,-11,33
Ballinamalla,3531,11,6,5,19,26,57,-31,23
Linfield,3532,1,18,6,6,59,33,26,60
Cliftonville,3532,2,16,5,9,55,36,19,53
Crusaders,3532,3,15,8,7,52,37,15,53
Ballymena,3532,4,16,5,9,59,52,7,53
Glenavon,3532,5,10,12,8,43,45,-2,42
Coleraine,3532,6,10,10,10,37,39,-2,40
Ards,3532,7,12,3,15,38,45,-7,39
Glentoran,3532,8,11,5,14,36,39,-3,38
Dungannon,3532,9,8,8,14,44,50,-6,32
Portadown,3532,10,7,6,17,25,45,-20,27
Ballinamalla,3532,11,6,4,20,23,50,-27,22
Crusaders,3533,1,17,9,4,57,32,25,60
Cliftonville,3533,2,15,7,8,49,34,15,52
Ballymena,3533,3,14,6,10,57,60,-3,48
Linfield,3533,4,13,8,9,56,34,22,47
Coleraine,3533,5,11,13,6,47,38,9,46
Glenavon,3533,6,10,11,9,47,44,3,41
Dungannon,3533,7,10,9,11,54,55,-1,39
Ards,3533,8,10,5,15,40,47,-7,35
Glentoran,3533,9,8,9,13,31,43,-12,33
Portadown,3533,10,8,7,15,30,47,-17,31
Ballinamalla,3533,11,5,4,21,22,56,-34,19
Crusaders,3534,1,14,12,4,59,38,21,54
Linfield,3534,2,14,11,5,60,30,30,53
Dungannon,3534,3,13,9,8,51,38,13,48
Cliftonville,3534,4,14,5,11,51,38,13,47
Glenavon,3534,5,11,13,6,53,47,6,46
Coleraine,3534,6,9,11,10,43,41,2,38
Ballymena,3534,7,11,5,14,54,66,-12,38
Glentoran,3534,8,9,9,12,37,46,-9,36
Portadown,3534,9,8,8,14,30,47,-17,32
Ballinamalla,3534,10,8,5,17,27,52,-25,29
Ards,3534,11,6,8,16,33,55,-22,26
Crusaders,3535,1,17,8,5,65,32,33,59
Ballymena,3535,2,17,7,6,60,48,12,58
Linfield,3535,3,15,9,6,57,35,22,54
Coleraine,3535,4,13,7,10,40,39,1,46
Cliftonville,3535,5,13,5,12,47,39,8,44
Glenavon,3535,6,11,10,9,49,52,-3,43
Ards,3535,7,11,5,14,44,48,-4,38
Dungannon,3535,8,8,9,13,47,46,1,33
Portadown,3535,9,7,8,15,24,43,-19,29
Ballinamalla,3535,10,8,4,18,31,60,-29,28
Glentoran,3535,11,6,6,18,26,48,-22,24
Cliftonville,3536,1,18,4,8,54,32,22,58
Linfield,3536,2,15,11,4,69,38,31,56
Crusaders,3536,3,15,7,8,45,34,11,52
Ballymena,3536,4,15,6,9,63,58,5,51
Glenavon,3536,5,12,11,7,51,46,5,47
Coleraine,3536,6,11,9,10,43,42,1,42
Dungannon,3536,7,10,11,9,54,41,13,41
Ards,3536,8,9,3,18,36,54,-18,30
Glentoran,3536,9,7,7,16,32,48,-16,28
Ballinamalla,3536,10,7,5,18,32,60,-28,26
Portadown,3536,11,6,6,18,25,51,-26,24
Crusaders,3537,1,15,10,5,54,35,19,55
Linfield,3537,2,14,12,4,55,26,29,54
Glenavon,3537,3,14,11,5,57,43,14,53
Ballymena,3537,4,15,6,9,61,56,5,51
Cliftonville,3537,5,13,8,9,46,41,5,47
Dungannon,3537,6,10,9,11,54,45,9,39
Coleraine,3537,7,10,9,11,39,38,1,39
Ards,3537,8,9,8,13,31,41,-10,35
Glentoran,3537,9,8,7,15,29,47,-18,31
Ballinamalla,3537,10,7,4,19,39,59,-20,25
Portadown,3537,11,4,8,18,24,58,-34,20
Crusaders,3538,1,20,6,4,67,30,37,66
Linfield,3538,2,17,8,5,63,28,35,59
Ballymena,3538,3,14,6,10,59,58,1,48
Cliftonville,3538,4,14,5,11,53,45,8,47
Coleraine,3538,5,9,13,8,37,38,-1,40
Glenavon,3538,6,10,8,12,44,53,-9,38
Glentoran,3538,7,10,6,14,28,40,-12,36
Portadown,3538,8,10,5,15,35,47,-12,35
Ards,3538,9,9,5,16,37,50,-13,32
Dungannon,3538,10,7,9,14,43,48,-5,30
Ballinamalla,3538,11,7,5,18,28,57,-29,26
Crusaders,3539,1,18,7,5,60,36,24,61
Linfield,3539,2,16,9,5,57,28,29,57
Ballymena,3539,3,16,6,8,64,53,11,54
Cliftonville,3539,4,15,6,9,56,43,13,51
Coleraine,3539,5,12,10,8,44,38,6,46
Glenavon,3539,6,10,8,12,48,51,-3,38
Dungannon,3539,7,10,6,14,47,51,-4,36
Glentoran,3539,8,9,8,13,35,46,-11,35
Ballinamalla,3539,9,9,5,16,36,51,-15,32
Portadown,3539,10,7,4,19,24,54,-30,25
Ards,3539,11,6,5,19,31,51,-20,23
Crusaders,3540,1,18,8,4,62,33,29,62
Linfield,3540,2,15,7,8,61,38,23,52
Ballymena,3540,3,15,6,9,61,51,10,51
Glenavon,3540,4,13,9,8,51,45,6,48
Cliftonville,3540,5,14,5,11,52,44,8,47
Coleraine,3540,6,9,11,10,37,41,-4,38
Glentoran,3540,7,10,7,13,35,50,-15,37
Ards,3540,8,9,6,15,36,48,-12,33
Portadown,3540,9,9,4,17,33,51,-18,31
Dungannon,3540,10,6,10,14,47,52,-5,28
Ballinamalla,3540,11,7,7,16,32,54,-22,28
Cliftonville,3541,1,17,5,8,62,35,27,56
Linfield,3541,2,14,10,6,61,36,25,52
Crusaders,3541,3,15,6,9,58,40,18,51
Ballymena,3541,4,14,6,10,61,61,0,48
Coleraine,3541,5,11,11,8,42,40,2,44
Glenavon,3541,6,9,11,10,46,54,-8,38
Dungannon,3541,7,9,10,11,56,50,6,37
Ballinamalla,3541,8,11,2,17,33,52,-19,35
Portadown,3541,9,9,7,14,34,47,-13,34
Glentoran,3541,10,7,9,14,28,49,-21,30
Ards,3541,11,8,5,17,34,51,-17,29
Linfield,3542,1,18,8,4,55,22,33,62
Crusaders,3542,2,16,8,6,53,36,17,56
Cliftonville,3542,3,17,4,9,62,37,25,55
Ballymena,3542,4,14,6,10,60,57,3,48
Coleraine,3542,5,10,12,8,41,39,2,42
Glenavon,3542,6,9,13,8,49,49,0,40
Glentoran,3542,7,10,5,15,35,51,-16,35
Dungannon,3542,8,8,10,12,45,50,-5,34
Portadown,3542,9,9,5,16,29,40,-11,32
Ards,3542,10,8,5,17,32,50,-18,29
Ballinamalla,3542,11,5,6,19,23,53,-30,21
Linfield,3543,1,16,9,5,65,33,32,57
Cliftonville,3543,2,15,8,7,58,38,20,53
Crusaders,3543,3,15,7,8,50,40,10,52
Coleraine,3543,4,13,9,8,48,35,13,48
Dungannon,3543,5,12,10,8,54,41,13,46
Ards,3543,6,12,3,15,41,47,-6,39
Ballymena,3543,7,10,8,12,49,61,-12,38
Glenavon,3543,8,9,10,11,48,53,-5,37
Ballinamalla,3543,9,8,6,16,37,55,-18,30
Glentoran,3543,10,8,5,17,30,46,-16,29
Portadown,3543,11,5,9,16,19,50,-31,24
Crusaders,3544,1,18,6,6,66,39,27,60
Linfield,3544,2,15,11,4,55,27,28,56
Cliftonville,3544,3,16,4,10,61,43,18,52
Coleraine,3544,4,11,12,7,42,35,7,45
Glenavon,3544,5,11,10,9,50,47,3,43
Ballymena,3544,6,13,4,13,47,61,-14,43
Dungannon,3544,7,11,9,10,48,45,3,42
Ballinamalla,3544,8,9,5,16,40,55,-15,32
Glentoran,3544,9,8,8,14,30,45,-15,32
Ards,3544,10,9,4,17,37,50,-13,31
Portadown,3544,11,6,3,21,25,54,-29,21
Linfield,3545,1,16,10,4,63,31,32,58
Crusaders,3545,2,14,8,8,51,37,14,50
Cliftonville,3545,3,15,4,11,53,41,12,49
Glenavon,3545,4,12,11,7,53,42,11,47
Dungannon,3545,5,11,10,9,56,43,13,43
Ballymena,3545,6,10,9,11,54,64,-10,39
Coleraine,3545,7,7,16,7,42,47,-5,37
Glentoran,3545,8,9,8,13,30,47,-17,35
Ards,3545,9,9,6,15,39,49,-10,33
Portadown,3545,10,7,9,14,25,37,-12,30
Ballinamalla,3545,11,8,3,19,31,59,-28,27
Linfield,3546,1,18,9,3,72,25,47,63
Crusaders,3546,2,15,8,7,59,38,21,53
Cliftonville,3546,3,15,7,8,60,40,20,52
Glenavon,3546,4,12,12,6,45,37,8,48
Ballymena,3546,5,12,4,14,51,68,-17,40
Coleraine,3546,6,10,9,11,43,45,-2,39
Ards,3546,7,10,4,16,36,53,-17,34
Glentoran,3546,8,9,7,14,30,47,-17,34
Dungannon,3546,9,8,9,13,48,43,5,33
Portadown,3546,10,9,5,16,31,46,-15,32
Ballinamalla,3546,11,9,2,19,27,60,-33,29
Crusaders,3547,1,18,8,4,57,28,29,62
Coleraine,3547,2,14,9,7,48,34,14,51
Ballymena,3547,3,15,5,10,65,60,5,50
Glenavon,3547,4,12,12,6,49,41,8,48
Linfield,3547,5,12,8,10,51,37,14,44
Glentoran,3547,6,12,6,12,34,40,-6,42
Cliftonville,3547,7,10,7,13,44,46,-2,37
Dungannon,3547,8,8,11,11,45,44,1,35
Ballinamalla,3547,9,9,4,17,28,48,-20,31
Ards,3547,10,9,2,19,34,55,-21,29
Portadown,3547,11,7,6,17,29,51,-22,27
Cliftonville,3548,1,19,3,8,57,32,25,60
Crusaders,3548,2,17,6,7,59,36,23,57
Linfield,3548,3,14,10,6,59,33,26,52
Ballymena,3548,4,14,4,12,65,66,-1,46
Glenavon,3548,5,11,10,9,44,46,-2,43
Dungannon,3548,6,10,9,11,48,43,5,39
Coleraine,3548,7,10,9,11,39,45,-6,39
Glentoran,3548,8,10,5,15,34,50,-16,35
Ards,3548,9,9,6,15,39,49,-10,33
Ballinamalla,3548,10,7,7,16,27,48,-21,28
Portadown,3548,11,8,3,19,30,53,-23,27
Linfield,3549,1,16,9,5,62,30,32,57
Crusaders,3549,2,17,5,8,54,40,14,56
Glenavon,3549,3,13,11,6,58,42,16,50
Cliftonville,3549,4,15,4,11,53,40,13,49
Coleraine,3549,5,14,7,9,47,38,9,49
Ballymena,3549,6,11,9,10,58,64,-6,42
Dungannon,3549,7,9,8,13,43,51,-8,35
Glentoran,3549,8,8,9,13,30,45,-15,33
Portadown,3549,9,9,6,15,29,45,-16,33
Ards,3549,10,8,5,17,39,49,-10,29
Ballinamalla,3549,11,6,5,19,29,58,-29,23
Crusaders,3550,1,19,6,5,61,34,27,63
Cliftonville,3550,2,17,5,8,60,35,25,56
Dungannon,3550,3,15,6,9,52,41,11,51
Linfield,3550,4,14,8,8,59,38,21,50
Ballymena,3550,5,14,6,10,58,56,2,48
Glenavon,3550,6,10,11,9,47,44,3,41
Ards,3550,7,10,4,16,44,56,-12,34
Glentoran,3550,8,9,6,15,30,46,-16,33
Coleraine,3550,9,8,8,14,31,45,-14,32
Ballinamalla,3550,10,9,1,20,29,50,-21,28
Portadown,3550,11,8,3,19,30,56,-26,27
Crusaders,3551,1,17,9,4,51,30,21,60
Cliftonville,3551,2,17,5,8,58,33,25,56
Coleraine,3551,3,13,10,7,47,36,11,49
Linfield,3551,4,13,9,8,58,32,26,48
Ballymena,3551,5,13,6,11,54,62,-8,45
Dungannon,3551,6,10,9,11,44,44,0,39
Glenavon,3551,7,7,13,10,41,50,-9,34
Glentoran,3551,8,9,7,14,32,46,-14,34
Ards,3551,9,9,5,16,37,49,-12,32
Portadown,3551,10,8,6,16,32,51,-19,30
Ballinamalla,3551,11,7,5,18,31,52,-21,26
Crusaders,3552,1,19,6,5,54,27,27,63
Linfield,3552,2,16,9,5,62,32,30,57
Ballymena,3552,3,15,5,10,57,54,3,50
Coleraine,3552,4,12,11,7,43,34,9,47
Glenavon,3552,5,11,11,8,47,42,5,44
Cliftonville,3552,6,12,5,13,47,48,-1,41
Dungannon,3552,7,10,9,11,50,42,8,39
Ballinamalla,3552,8,9,5,16,32,55,-23,32
Portadown,3552,9,7,7,16,29,48,-19,28
Ards,3552,10,7,6,17,37,52,-15,27
Glentoran,3552,11,7,6,17,28,52,-24,27
Crusaders,3553,1,19,6,5,66,30,36,63
Linfield,3553,2,14,10,6,59,38,21,52
Cliftonville,3553,3,14,6,10,51,40,11,48
Ballymena,3553,4,12,8,10,55,60,-5,44
Coleraine,3553,5,10,13,7,44,41,3,43
Glenavon,3553,6,10,11,9,42,42,0,41
Dungannon,3553,7,8,11,11,49,49,0,35
Ballinamalla,3553,8,9,5,16,35,49,-14,32
Portadown,3553,9,9,5,16,26,44,-18,32
Glentoran,3553,10,8,6,16,31,48,-17,30
Ards,3553,11,7,9,14,30,47,-17,30
Crusaders,3554,1,20,6,4,62,29,33,66
Ballymena,3554,2,16,4,10,61,57,4,52
Linfield,3554,3,14,7,9,57,36,21,49
Cliftonville,3554,4,14,6,10,54,45,9,48
Coleraine,3554,5,11,12,7,40,39,1,45
Glentoran,3554,6,10,6,14,37,46,-9,36
Glenavon,3554,7,8,11,11,38,46,-8,35
Ards,3554,8,10,4,16,39,49,-10,34
Ballinamalla,3554,9,11,1,18,31,47,-16,34
Portadown,3554,10,10,3,17,24,47,-23,33
Dungannon,3554,11,7,8,15,47,49,-2,29
Crusaders,3555,1,20,5,5,66,35,31,65
Ballymena,3555,2,16,5,9,62,57,5,53
Linfield,3555,3,14,8,8,56,37,19,50
Coleraine,3555,4,11,10,9,43,40,3,43
Glenavon,3555,5,11,9,10,46,45,1,42
Dungannon,3555,6,10,9,11,46,39,7,39
Cliftonville,3555,7,11,6,13,47,47,0,39
Glentoran,3555,8,10,7,13,36,47,-11,37
Ards,3555,9,9,6,15,38,49,-11,33
Ballinamalla,3555,10,9,5,16,39,57,-18,32
Portadown,3555,11,5,8,17,20,46,-26,23
Crusaders,3556,1,17,7,6,58,38,20,58
Cliftonville,3556,2,16,5,9,55,40,15,53
Ballymena,3556,3,15,6,9,56,54,2,51
Linfield,3556,4,11,13,6,51,31,20,46
Glenavon,3556,5,12,10,8,52,43,9,46
Coleraine,3556,6,10,12,8,42,44,-2,42
Glentoran,3556,7,8,12,10,31,36,-5,36
Ards,3556,8,9,7,14,41,47,-6,34
Dungannon,3556,9,6,13,11,44,50,-6,31
Portadown,3556,10,8,5,17,25,44,-19,29
Ballinamalla,3556,11,5,6,19,23,51,-28,21
Cliftonville,3557,1,17,7,6,62,38,24,58
Crusaders,3557,2,16,8,6,57,34,23,56
Linfield,3557,3,14,10,6,59,34,25,52
Glenavon,3557,4,11,11,8,45,44,1,44
Dungannon,3557,5,11,9,10,57,45,12,42
Ballymena,3557,6,11,7,12,58,67,-9,40
Ards,3557,7,10,7,13,40,45,-5,37
Coleraine,3557,8,9,10,11,39,45,-6,37
Glentoran,3557,9,7,9,14,25,43,-18,30
Portadown,3557,10,7,6,17,24,45,-21,27
Ballinamalla,3557,11,7,6,17,29,55,-26,27
Crusaders,3558,1,19,9,2,64,29,35,66
Cliftonville,3558,2,16,5,9,56,44,12,53
Linfield,3558,3,14,9,7,51,26,25,51
Glenavon,3558,4,13,11,6,51,41,10,50
Ballymena,3558,5,14,5,11,61,63,-2,47
Coleraine,3558,6,9,13,8,44,41,3,40
Ards,3558,7,11,3,16,39,49,-10,36
Glentoran,3558,8,7,8,15,25,47,-22,29
Ballinamalla,3558,9,8,4,18,31,51,-20,28
Dungannon,3558,10,5,12,13,39,47,-8,27
Portadown,3558,11,5,9,16,25,48,-23,24
Crusaders,3559,1,16,9,5,65,35,30,57
Cliftonville,3559,2,15,8,7,54,34,20,53
Ballymena,3559,3,14,5,11,54,66,-12,47
Linfield,3559,4,12,9,9,55,37,18,45
Glenavon,3559,5,11,12,7,47,45,2,45
Coleraine,3559,6,9,13,8,38,36,2,40
Dungannon,3559,7,9,10,11,44,43,1,37
Ards,3559,8,10,6,14,43,51,-8,36
Portadown,3559,9,9,6,15,28,41,-13,33
Ballinamalla,3559,10,8,5,17,34,54,-20,29
Glentoran,3559,11,7,7,16,29,49,-20,28
Cliftonville,3560,1,17,3,10,50,40,10,54
Crusaders,3560,2,15,6,9,54,40,14,51
Linfield,3560,3,14,8,8,54,36,18,50
Coleraine,3560,4,13,9,8,41,30,11,48
Glenavon,3560,5,12,10,8,47,40,7,46
Ballymena,3560,6,13,7,10,58,54,4,46
Dungannon,3560,7,11,9,10,53,46,7,42
Ards,3560,8,10,5,15,37,43,-6,35
Glentoran,3560,9,8,8,14,25,41,-16,32
Portadown,3560,10,8,7,15,26,42,-16,31
Ballinamalla,3560,11,7,2,21,26,59,-33,23
Linfield,3561,1,19,8,3,65,26,39,65
Crusaders,3561,2,15,8,7,53,35,18,53
Coleraine,3561,3,14,10,6,48,35,13,52
Ballymena,3561,4,14,7,9,59,52,7,49
Cliftonville,3561,5,12,6,12,56,53,3,42
Glenavon,3561,6,10,12,8,45,42,3,42
Dungannon,3561,7,8,10,12,46,46,0,34
Glentoran,3561,8,9,7,14,28,45,-17,34
Ards,3561,9,8,7,15,39,51,-12,31
Ballinamalla,3561,10,9,1,20,31,57,-26,28
Portadown,3561,11,7,4,19,25,53,-28,25
Linfield,3562,1,17,8,5,65,28,37,59
Crusaders,3562,2,15,8,7,55,36,19,53
Cliftonville,3562,3,14,7,9,49,36,13,49
Glenavon,3562,4,11,14,5,46,42,4,47
Dungannon,3562,5,13,7,10,56,40,16,46
Ballymena,3562,6,13,6,11,55,61,-6,45
Coleraine,3562,7,10,11,9,40,39,1,41
Ards,3562,8,9,7,14,34,44,-10,34
Glentoran,3562,9,7,8,15,33,53,-20,29
Ballinamalla,3562,10,8,3,19,28,54,-26,27
Portadown,3562,11,6,5,19,20,48,-28,23
Linfield,3563,1,17,7,6,62,28,34,58
Crusaders,3563,2,15,9,6,49,32,17,54
Glenavon,3563,3,13,11,6,56,38,18,50
Cliftonville,3563,4,13,7,10,46,36,10,46
Ballymena,3563,5,13,7,10,57,61,-4,46
Coleraine,3563,6,11,10,9,41,37,4,43
Dungannon,3563,7,10,10,10,45,44,1,40
Ards,3563,8,9,5,16,42,47,-5,32
Ballinamalla,3563,9,8,4,18,26,57,-31,28
Portadown,3563,10,6,9,15,19,40,-21,27
Glentoran,3563,11,6,9,15,23,46,-23,27
Crusaders,3564,1,19,7,4,61,31,30,64
Linfield,3564,2,18,6,6,65,32,33,60
Cliftonville,3564,3,17,4,9,51,35,16,55
Coleraine,3564,4,14,9,7,45,36,9,51
Glenavon,3564,5,13,9,8,55,47,8,48
Ballymena,3564,6,11,7,12,54,62,-8,40
Portadown,3564,7,9,6,15,27,43,-16,33
Dungannon,3564,8,7,11,12,52,53,-1,32
Ards,3564,9,9,4,17,37,47,-10,31
Glentoran,3564,10,5,8,17,25,53,-28,23
Ballinamalla,3564,11,5,5,20,27,60,-33,20
Crusaders,3565,1,16,8,6,54,33,21,56
Linfield,3565,2,15,9,6,61,29,32,54
Cliftonville,3565,3,16,4,10,53,41,12,52
Ballymena,3565,4,14,7,9,62,61,1,49
Coleraine,3565,5,12,11,7,45,37,8,47
Glenavon,3565,6,13,8,9,48,43,5,47
Ards,3565,7,10,5,15,37,48,-11,35
Dungannon,3565,8,7,11,12,40,44,-4,32
Glentoran,3565,9,7,9,14,23,39,-16,30
Portadown,3565,10,8,5,17,27,49,-22,29
Ballinamalla,3565,11,6,5,19,31,57,-26,23
Glenavon,3566,1,15,10,5,54,34,20,55
Cliftonville,3566,2,15,7,8,49,32,17,52
Crusaders,3566,3,15,7,8,53,38,15,52
Linfield,3566,4,14,9,7,57,34,23,51
Ballymena,3566,5,15,4,11,55,53,2,49
Coleraine,3566,6,11,8,11,43,43,0,41
Glentoran,3566,7,11,8,11,39,50,-11,41
Ballinamalla,3566,8,11,5,14,35,52,-17,38
Dungannon,3566,9,8,9,13,49,50,-1,33
Ards,3566,10,8,4,18,38,52,-14,28
Portadown,3566,11,4,5,21,18,52,-34,17
Crusaders,3567,1,18,6,6,61,36,25,60
Cliftonville,3567,2,16,5,9,48,38,10,53
Linfield,3567,3,14,10,6,59,32,27,52
Dungannon,3567,4,11,8,11,51,44,7,41
Glenavon,3567,5,10,11,9,55,50,5,41
Ballymena,3567,6,11,7,12,52,57,-5,40
Coleraine,3567,7,9,10,11,39,45,-6,37
Ards,3567,8,10,7,13,38,47,-9,37
Portadown,3567,9,10,7,13,31,40,-9,37
Glentoran,3567,10,7,9,14,28,48,-20,30
Ballinamalla,3567,11,7,4,19,22,47,-25,25
Linfield,3568,1,18,6,6,67,30,37,60
Crusaders,3568,2,16,9,5,59,34,25,57
Cliftonville,3568,3,16,7,7,54,34,20,55
Ballymena,3568,4,15,6,9,63,58,5,51
Dungannon,3568,5,9,15,6,55,42,13,42
Coleraine,3568,6,10,10,10,42,50,-8,40
Glenavon,3568,7,8,12,10,41,46,-5,36
Ards,3568,8,9,5,16,41,56,-15,32
Glentoran,3568,9,6,9,15,25,43,-18,27
Portadown,3568,10,6,8,16,26,49,-23,26
Ballinamalla,3568,11,5,7,18,31,62,-31,22
Crusaders,3569,1,16,8,6,56,34,22,56
Linfield,3569,2,14,9,7,60,31,29,51
Coleraine,3569,3,12,12,6,41,32,9,48
Cliftonville,3569,4,14,2,14,50,41,9,44
Dungannon,3569,5,11,10,9,48,41,7,43
Ballymena,3569,6,12,7,11,56,60,-4,43
Portadown,3569,7,13,4,13,33,42,-9,43
Glenavon,3569,8,11,8,11,48,52,-4,41
Glentoran,3569,9,8,9,13,27,40,-13,33
Ards,3569,10,8,6,16,36,54,-18,30
Ballinamalla,3569,11,7,3,20,34,62,-28,24
Crusaders,3570,1,14,13,3,55,33,22,55
Glenavon,3570,2,14,10,6,53,40,13,52
Ballymena,3570,3,15,6,9,67,63,4,51
Linfield,3570,4,13,11,6,55,29,26,50
Cliftonville,3570,5,15,5,10,53,40,13,50
Coleraine,3570,6,10,9,11,36,33,3,39
Ards,3570,7,9,7,14,34,49,-15,34
Dungannon,3570,8,8,9,13,46,47,-1,33
Portadown,3570,9,8,5,17,24,43,-19,29
Glentoran,3570,10,6,11,13,28,51,-23,29
Ballinamalla,3570,11,8,4,18,35,58,-23,28
Crusaders,3571,1,19,7,4,54,26,28,64
Linfield,3571,2,15,9,6,59,31,28,54
Cliftonville,3571,3,15,4,11,48,37,11,49
Glenavon,3571,4,12,12,6,46,37,9,48
Ballymena,3571,5,9,11,10,48,55,-7,38
Dungannon,3571,6,8,13,9,45,44,1,37
Glentoran,3571,7,9,10,11,35,37,-2,37
Coleraine,3571,8,8,11,11,34,35,-1,35
Ards,3571,9,9,5,16,38,52,-14,32
Ballinamalla,3571,10,8,4,18,28,53,-25,28
Portadown,3571,11,7,6,17,20,48,-28,27
Linfield,3572,1,15,11,4,60,26,34,56
Glenavon,3572,2,13,11,6,52,36,16,50
Crusaders,3572,3,13,9,8,49,38,11,48
Ballymena,3572,4,12,8,10,59,64,-5,44
Cliftonville,3572,5,14,2,14,47,52,-5,44
Coleraine,3572,6,9,13,8,44,43,1,40
Dungannon,3572,7,8,12,10,45,43,2,36
Glentoran,3572,8,8,11,11,34,44,-10,35
Ballinamalla,3572,9,8,8,14,30,48,-18,32
Portadown,3572,10,8,7,15,32,48,-16,31
Ards,3572,11,7,8,15,42,52,-10,29
Linfield,3573,1,15,9,6,60,35,25,54
Crusaders,3573,2,14,11,5,53,33,20,53
Coleraine,3573,3,12,11,7,45,41,4,47
Glenavon,3573,4,12,11,7,51,48,3,47
Ballymena,3573,5,14,4,12,60,54,6,46
Cliftonville,3573,6,12,7,11,45,43,2,43
Ards,3573,7,10,6,14,47,50,-3,36
Glentoran,3573,8,9,6,15,31,48,-17,33
Portadown,3573,9,9,6,15,28,45,-17,33
Dungannon,3573,10,7,10,13,45,48,-3,31
Ballinamalla,3573,11,9,3,18,30,50,-20,30
Linfield,3574,1,15,9,6,55,27,28,54
Cliftonville,3574,2,15,6,9,52,39,13,51
Crusaders,3574,3,13,10,7,51,34,17,49
Ballymena,3574,4,13,9,8,56,56,0,48
Glenavon,3574,5,12,11,7,52,47,5,47
Coleraine,3574,6,11,13,6,46,39,7,46
Glentoran,3574,7,10,7,13,30,43,-13,37
Dungannon,3574,8,9,9,12,47,43,4,36
Ards,3574,9,8,7,15,45,53,-8,31
Portadown,3574,10,8,4,18,24,48,-24,28
Ballinamalla,3574,11,5,7,18,32,61,-29,22
Crusaders,3575,1,17,8,5,57,37,20,59
Linfield,3575,2,16,8,6,62,28,34,56
Coleraine,3575,3,14,9,7,49,37,12,51
Ballymena,3575,4,14,6,10,63,62,1,48
Cliftonville,3575,5,13,6,11,50,43,7,45
Glenavon,3575,6,10,12,8,46,45,1,42
Dungannon,3575,7,9,11,10,52,46,6,38
Glentoran,3575,8,7,10,13,31,47,-16,31
Ballinamalla,3575,9,8,6,16,29,48,-19,30
Portadown,3575,10,7,5,18,26,58,-32,26
Ards,3575,11,5,9,16,29,43,-14,24
Linfield,3576,1,16,10,4,66,32,34,58
Crusaders,3576,2,17,5,8,56,32,24,56
Cliftonville,3576,3,15,7,8,52,37,15,52
Ballymena,3576,4,14,7,9,53,53,0,49
Dungannon,3576,5,11,10,9,50,43,7,43
Coleraine,3576,6,10,12,8,37,34,3,42
Glenavon,3576,7,10,9,11,45,53,-8,39
Glentoran,3576,8,8,7,15,30,42,-12,31
Ballinamalla,3576,9,9,3,18,31,55,-24,30
Portadown,3576,10,7,7,16,23,43,-20,28
Ards,3576,11,8,3,19,33,52,-19,27
Crusaders,3577,1,19,6,5,56,27,29,63
Ballymena,3577,2,17,5,8,60,52,8,56
Linfield,3577,3,14,8,8,60,43,17,50
Glenavon,3577,4,12,11,7,49,37,12,47
Coleraine,3577,5,10,14,6,40,36,4,44
Cliftonville,3577,6,11,7,12,48,42,6,40
Dungannon,3577,7,9,9,12,42,41,1,36
Glentoran,3577,8,9,6,15,27,42,-15,33
Portadown,3577,9,10,3,17,26,43,-17,33
Ards,3577,10,8,6,16,34,50,-16,30
Ballinamalla,3577,11,7,3,20,23,52,-29,24
Crusaders,3578,1,17,9,4,58,28,30,60
Linfield,3578,2,14,9,7,58,36,22,51
Cliftonville,3578,3,14,7,9,56,41,15,49
Ballymena,3578,4,13,9,8,58,55,3,48
Coleraine,3578,5,11,13,6,40,39,1,46
Glenavon,3578,6,10,11,9,49,43,6,41
Dungannon,3578,7,9,11,10,60,54,6,38
Glentoran,3578,8,7,10,13,28,50,-22,31
Ards,3578,9,7,8,15,35,50,-15,29
Ballinamalla,3578,10,6,9,15,33,55,-22,27
Portadown,3578,11,7,4,19,31,55,-24,25
Cliftonville,3579,1,20,3,7,63,37,26,63
Crusaders,3579,2,14,8,8,50,36,14,50
Linfield,3579,3,13,10,7,62,41,21,49
Coleraine,3579,4,10,13,7,51,41,10,43
Glenavon,3579,5,9,14,7,53,50,3,41
Dungannon,3579,6,9,13,8,46,38,8,40
Ballymena,3579,7,9,11,10,51,64,-13,38
Ards,3579,8,10,5,15,41,48,-7,35
Ballinamalla,3579,9,8,6,16,34,56,-22,30
Portadown,3579,10,8,5,17,22,39,-17,29
Glentoran,3579,11,7,8,15,31,54,-23,29
Cliftonville,3580,1,17,6,7,57,36,21,57
Ballymena,3580,2,17,6,7,70,59,11,57
Crusaders,3580,3,17,4,9,55,35,20,55
Linfield,3580,4,14,7,9,61,35,26,49
Dungannon,3580,5,11,9,10,54,47,7,42
Glenavon,3580,6,10,11,9,47,44,3,41
Ards,3580,7,9,8,13,38,47,-9,35
Coleraine,3580,8,8,11,11,37,46,-9,35
Portadown,3580,9,8,5,17,29,53,-24,29
Glentoran,3580,10,6,9,15,26,44,-18,27
Ballinamalla,3580,11,6,8,16,31,59,-28,26
Crusaders,3581,1,17,5,8,57,41,16,56
Linfield,3581,2,15,7,8,60,34,26,52
Coleraine,3581,3,12,11,7,48,34,14,47
Cliftonville,3581,4,15,2,13,52,41,11,47
Glenavon,3581,5,12,11,7,48,45,3,47
Ballymena,3581,6,11,9,10,58,71,-13,42
Dungannon,3581,7,10,10,10,57,46,11,40
Glentoran,3581,8,9,9,12,33,46,-13,36
Ballinamalla,3581,9,9,6,15,28,44,-16,33
Portadown,3581,10,7,7,16,25,43,-18,28
Ards,3581,11,7,5,18,32,53,-21,26
Crusaders,3582,1,15,8,7,59,37,22,53
Linfield,3582,2,14,9,7,57,31,26,51
Coleraine,3582,3,13,11,6,46,38,8,50
Ballymena,3582,4,15,5,10,50,51,-1,50
Glenavon,3582,5,12,11,7,52,44,8,47
Cliftonville,3582,6,13,7,10,55,40,15,46
Glentoran,3582,7,12,7,11,35,38,-3,43
Portadown,3582,8,8,7,15,23,45,-22,31
Dungannon,3582,9,6,11,13,47,50,-3,29
Ards,3582,10,8,4,18,32,54,-22,28
Ballinamalla,3582,11,6,6,18,28,56,-28,24
Crusaders,3583,1,20,5,5,59,24,35,65
Linfield,3583,2,15,7,8,61,33,28,52
Coleraine,3583,3,14,10,6,50,35,15,52
Cliftonville,3583,4,14,8,8,46,35,11,50
Ballymena,3583,5,13,7,10,59,59,0,46
Glenavon,3583,6,11,10,9,52,47,5,43
Ards,3583,7,11,4,15,37,46,-9,37
Dungannon,3583,8,8,11,11,49,51,-2,35
Glentoran,3583,9,7,7,16,28,56,-28,28
Ballinamalla,3583,10,5,8,17,26,50,-24,23
Portadown,3583,11,5,7,18,24,55,-31,22
Crusaders,3584,1,16,6,8,52,36,16,54
Linfield,3584,2,14,10,6,60,31,29,52
Coleraine,3584,3,14,9,7,55,42,13,51
Cliftonville,3584,4,15,4,11,47,38,9,49
Glenavon,3584,5,13,7,10,51,46,5,46
Ballymena,3584,6,14,3,13,60,62,-2,45
Glentoran,3584,7,12,8,10,38,35,3,44
Dungannon,3584,8,11,8,11,51,46,5,41
Ards,3584,9,9,5,16,34,56,-22,32
Portadown,3584,10,7,4,19,22,50,-28,25
Ballinamalla,3584,11,6,4,20,26,54,-28,22
Crusaders,3585,1,16,9,5,57,36,21,57
Ballymena,3585,2,15,8,7,62,55,7,53
Linfield,3585,3,14,8,8,61,40,21,50
Cliftonville,3585,4,13,5,12,56,43,13,44
Coleraine,3585,5,11,11,8,44,37,7,44
Dungannon,3585,6,8,12,10,49,45,4,36
Ards,3585,7,9,9,12,41,42,-1,36
Glenavon,3585,8,8,11,11,42,55,-13,35
Glentoran,3585,9,8,9,13,32,46,-14,33
Portadown,3585,10,7,9,14,28,50,-22,30
Ballinamalla,3585,11,6,9,15,25,48,-23,27
Crusaders,3586,1,17,8,5,53,34,19,59
Linfield,3586,2,14,9,7,53,35,18,51
Cliftonville,3586,3,15,6,9,60,45,15,51
Dungannon,3586,4,13,8,9,60,46,14,47
Ballymena,3586,5,12,6,12,58,63,-5,42
Coleraine,3586,6,10,11,9,43,44,-1,41
Glenavon,3586,7,8,13,9,47,47,0,37
Glentoran,3586,8,9,9,12,33,43,-10,36
Ballinamalla,3586,9,9,4,17,37,56,-19,31
Portadown,3586,10,8,5,17,27,46,-19,29
Ards,3586,11,6,9,15,41,53,-12,27
Crusaders,3587,1,16,7,7,56,34,22,55
Ballymena,3587,2,15,6,9,64,54,10,51
Glenavon,3587,3,12,10,8,50,45,5,46
Coleraine,3587,4,11,12,7,39,35,4,45
Linfield,3587,5,11,11,8,55,43,12,44
Ards,3587,6,13,3,14,41,45,-4,42
Dungannon,3587,7,11,8,11,55,54,1,41
Cliftonville,3587,8,11,6,13,46,47,-1,39
Portadown,3587,9,10,4,16,30,43,-13,34
Glentoran,3587,10,8,7,15,32,51,-19,31
Ballinamalla,3587,11,8,4,18,29,46,-17,28
Crusaders,3588,1,17,8,5,59,31,28,59
Cliftonville,3588,2,16,3,11,51,44,7,51
Linfield,3588,3,14,8,8,60,41,19,50
Glenavon,3588,4,13,9,8,56,42,14,48
Ballymena,3588,5,14,6,10,60,56,4,48
Dungannon,3588,6,13,8,9,58,45,13,47
Coleraine,3588,7,11,10,9,41,45,-4,43
Glentoran,3588,8,10,5,15,31,44,-13,35
Ards,3588,9,8,8,14,34,47,-13,32
Ballinamalla,3588,10,7,4,19,26,55,-29,25
Portadown,3588,11,5,5,20,20,46,-26,20
Cliftonville,3589,1,18,4,8,58,32,26,58
Crusaders,3589,2,17,7,6,61,37,24,58
Linfield,3589,3,16,6,8,56,31,25,54
Ballymena,3589,4,15,5,10,53,47,6,50
Coleraine,3589,5,13,8,9,41,41,0,47
Glenavon,3589,6,10,10,10,44,47,-3,40
Dungannon,3589,7,9,11,10,47,49,-2,38
Glentoran,3589,8,8,8,14,29,46,-17,32
Ards,3589,9,8,5,17,38,47,-9,29
Portadown,3589,10,8,5,17,26,50,-24,29
Ballinamalla,3589,11,6,5,19,26,52,-26,23
Crusaders,3590,1,15,10,5,61,35,26,55
Ballymena,3590,2,16,4,10,58,54,4,52
Cliftonville,3590,3,15,5,10,47,35,12,50
Linfield,3590,4,13,8,9,52,35,17,47
Glenavon,3590,5,10,15,5,49,49,0,45
Coleraine,3590,6,11,9,10,47,42,5,42
Dungannon,3590,7,10,11,9,51,44,7,41
Portadown,3590,8,10,6,14,30,39,-9,36
Ards,3590,9,10,3,17,40,58,-18,33
Glentoran,3590,10,8,5,17,29,46,-17,29
Ballinamalla,3590,11,7,4,19,27,54,-27,25
Crusaders,3591,1,18,7,5,57,38,19,61
Cliftonville,3591,2,17,6,7,51,34,17,57
Ballymena,3591,3,16,3,11,56,54,2,51
Linfield,3591,4,13,10,7,53,31,22,49
Coleraine,3591,5,12,12,6,44,33,11,48
Portadown,3591,6,12,3,15,32,42,-10,39
Glenavon,3591,7,8,11,11,38,42,-4,35
Dungannon,3591,8,8,10,12,48,44,4,34
Glentoran,3591,9,8,8,14,34,46,-12,32
Ballinamalla,3591,10,9,2,19,29,50,-21,29
Ards,3591,11,6,4,20,29,57,-28,22
Crusaders,3592,1,18,6,6,63,38,25,60
Ballymena,3592,2,15,6,9,65,60,5,51
Glenavon,3592,3,12,13,5,56,37,19,49
Coleraine,3592,4,12,12,6,45,39,6,48
Cliftonville,3592,5,14,5,11,57,50,7,47
Linfield,3592,6,12,10,8,55,37,18,46
Ballinamalla,3592,7,11,2,17,29,48,-19,35
Glentoran,3592,8,8,8,14,36,50,-14,32
Dungannon,3592,9,7,10,13,44,45,-1,31
Ards,3592,10,9,4,17,35,55,-20,31
Portadown,3592,11,6,6,18,19,45,-26,24
Linfield,3593,1,17,7,6,64,29,35,58
Crusaders,3593,2,16,5,9,49,38,11,53
Ballymena,3593,3,16,5,9,58,51,7,53
Cliftonville,3593,4,15,5,10,52,41,11,50
Coleraine,3593,5,12,9,9,40,37,3,45
Dungannon,3593,6,12,8,10,48,41,7,44
Glenavon,3593,7,11,10,9,41,39,2,43
Glentoran,3593,8,8,9,13,28,42,-14,33
Ballinamalla,3593,9,10,2,18,30,49,-19,32
Portadown,3593,10,7,5,18,26,47,-21,26
Ards,3593,11,6,5,19,27,49,-22,23
Crusaders,3594,1,20,7,3,62,30,32,67
Cliftonville,3594,2,19,3,8,62,40,22,60
Linfield,3594,3,14,8,8,60,33,27,50
Ballymena,3594,4,13,8,9,59,59,0,47
Glenavon,3594,5,10,12,8,49,43,6,42
Coleraine,3594,6,9,13,8,37,39,-2,40
Dungannon,3594,7,8,12,10,50,47,3,36
Ards,3594,8,10,6,14,37,41,-4,36
Portadown,3594,9,6,7,17,23,50,-27,25
Glentoran,3594,10,5,9,16,22,52,-30,24
Ballinamalla,3594,11,6,5,19,29,56,-27,23
Linfield,3595,1,18,7,5,65,33,32,61
Crusaders,3595,2,16,8,6,61,33,28,56
Cliftonville,3595,3,17,5,8,58,36,22,56
Ballymena,3595,4,13,5,12,60,63,-3,44
Dungannon,3595,5,11,9,10,53,42,11,42
Coleraine,3595,6,11,8,11,43,45,-2,41
Glenavon,3595,7,10,11,9,48,51,-3,41
Glentoran,3595,8,10,6,14,36,49,-13,36
Portadown,3595,9,8,6,16,24,43,-19,30
Ards,3595,10,8,5,17,33,54,-21,29
Ballinamalla,3595,11,5,6,19,25,57,-32,21
Ballymena,3596,1,17,6,7,65,54,11,57
Linfield,3596,2,15,8,7,53,27,26,53
Crusaders,3596,3,14,10,6,57,37,20,52
Coleraine,3596,4,13,9,8,44,33,11,48
Cliftonville,3596,5,13,7,10,51,46,5,46
Glenavon,3596,6,10,13,7,47,39,8,43
Dungannon,3596,7,9,11,10,49,42,7,38
Ballinamalla,3596,8,9,5,16,28,47,-19,32
Ards,3596,9,8,5,17,34,50,-16,29
Glentoran,3596,10,7,7,16,26,50,-24,28
Portadown,3596,11,7,5,18,25,54,-29,26
Crusaders,3597,1,19,7,4,64,35,29,64
Cliftonville,3597,2,14,10,6,57,38,19,52
Coleraine,3597,3,14,10,6,48,35,13,52
Linfield,3597,4,12,10,8,58,41,17,46
Ballymena,3597,5,12,9,9,71,68,3,45
Glenavon,3597,6,9,11,10,51,55,-4,38
Glentoran,3597,7,11,5,14,35,45,-10,38
Dungannon,3597,8,7,9,14,45,52,-7,30
Ards,3597,9,8,5,17,43,56,-13,29
Ballinamalla,3597,10,8,5,17,35,56,-21,29
Portadown,3597,11,8,5,17,30,56,-26,29
Ballymena,3598,1,19,4,7,72,50,22,61
Cliftonville,3598,2,17,5,8,59,37,22,56
Crusaders,3598,3,16,6,8,54,37,17,54
Linfield,3598,4,15,8,7,57,33,24,53
Glenavon,3598,5,12,12,6,46,41,5,48
Dungannon,3598,6,12,7,11,52,50,2,43
Coleraine,3598,7,8,10,12,34,41,-7,34
Glentoran,3598,8,8,9,13,32,44,-12,33
Ards,3598,9,7,7,16,33,54,-21,28
Ballinamalla,3598,10,5,9,16,22,45,-23,24
Portadown,3598,11,6,3,21,24,53,-29,21
Crusaders,3599,1,18,7,5,57,31,26,61
Cliftonville,3599,2,16,6,8,60,43,17,54
Linfield,3599,3,14,11,5,57,38,19,53
Ballymena,3599,4,13,9,8,62,57,5,48
Dungannon,3599,5,10,12,8,52,41,11,42
Coleraine,3599,6,11,7,12,49,49,0,40
Glenavon,3599,7,10,10,10,49,53,-4,40
Ards,3599,8,10,3,17,38,50,-12,33
Glentoran,3599,9,7,9,14,25,40,-15,30
Ballinamalla,3599,10,7,6,17,29,47,-18,27
Portadown,3599,11,6,6,18,20,49,-29,24
Cliftonville,3600,1,17,5,8,57,36,21,56
Glenavon,3600,2,15,7,8,51,40,11,52
Linfield,3600,3,13,10,7,61,36,25,49
Ballymena,3600,4,14,6,10,58,62,-4,48
Coleraine,3600,5,12,10,8,54,44,10,46
Crusaders,3600,6,12,8,10,47,39,8,44
Dungannon,3600,7,10,10,10,51,43,8,40
Glentoran,3600,8,9,8,13,28,37,-9,35
Ards,3600,9,9,4,17,33,47,-14,31
Ballinamalla,3600,10,9,3,18,30,58,-28,30
Portadown,3600,11,8,3,19,22,50,-28,27
Crusaders,3601,1,17,7,6,58,36,22,58
Ballymena,3601,2,14,10,6,57,48,9,52
Cliftonville,3601,3,15,5,10,57,44,13,50
Linfield,3601,4,12,13,5,61,34,27,49
Glenavon,3601,5,11,10,9,50,50,0,43
Dungannon,3601,6,10,10,10,46,42,4,40
Ards,3601,7,12,4,14,40,46,-6,40
Coleraine,3601,8,8,11,11,39,49,-10,35
Portadown,3601,9,9,6,15,31,45,-14,33
Ballinamalla,3601,10,8,4,18,28,48,-20,28
Glentoran,3601,11,4,10,16,20,45,-25,22
Cliftonville,3602,1,20,4,6,65,35,30,64
Crusaders,3602,2,17,7,6,58,31,27,58
Linfield,3602,3,16,9,5,61,32,29,57
Ballymena,3602,4,14,4,12,66,66,0,46
Coleraine,3602,5,11,11,8,39,34,5,44
Glenavon,3602,6,9,9,12,43,49,-6,36
Dungannon,3602,7,8,11,11,47,43,4,35
Glentoran,3602,8,7,12,11,28,45,-17,33
Ards,3602,9,9,5,16,38,52,-14,32
Ballinamalla,3602,10,9,3,18,28,54,-26,30
Portadown,3602,11,5,5,20,24,56,-32,20
Cliftonville,3603,1,17,5,8,53,40,13,56
Crusaders,3603,2,15,7,8,55,36,19,52
Dungannon,3603,3,13,9,8,58,40,18,48
Ballymena,3603,4,13,7,10,53,61,-8,46
Linfield,3603,5,11,12,7,53,29,24,45
Glenavon,3603,6,9,15,6,42,43,-1,42
Coleraine,3603,7,9,11,10,40,38,2,38
Ards,3603,8,10,7,13,40,44,-4,37
Glentoran,3603,9,7,10,13,24,36,-12,31
Portadown,3603,10,8,6,16,24,40,-16,30
Ballinamalla,3603,11,7,3,20,25,60,-35,24
Cliftonville,3604,1,19,3,8,55,35,20,60
Ballymena,3604,2,17,6,7,65,58,7,57
Crusaders,3604,3,16,8,6,56,31,25,56
Linfield,3604,4,15,10,5,58,30,28,55
Coleraine,3604,5,10,11,9,36,34,2,41
Glenavon,3604,6,10,10,10,45,51,-6,40
Portadown,3604,7,10,6,14,27,35,-8,36
Glentoran,3604,8,7,9,14,32,51,-19,30
Dungannon,3604,9,7,8,15,46,52,-6,29
Ards,3604,10,7,8,15,38,49,-11,29
Ballinamalla,3604,11,4,7,19,22,54,-32,19
Crusaders,3605,1,16,8,6,58,36,22,56
Cliftonville,3605,2,17,4,9,50,36,14,55
Linfield,3605,3,13,11,6,53,30,23,50
Glenavon,3605,4,11,14,5,48,37,11,47
Ballymena,3605,5,13,6,11,54,57,-3,45
Dungannon,3605,6,11,10,9,54,43,11,43
Coleraine,3605,7,10,9,11,37,38,-1,39
Ards,3605,8,9,6,15,38,53,-15,33
Glentoran,3605,9,7,11,12,27,38,-11,32
Ballinamalla,3605,10,7,6,17,23,46,-23,27
Portadown,3605,11,6,5,19,19,47,-28,23
Linfield,3606,1,15,9,6,56,32,24,54
Crusaders,3606,2,13,12,5,56,42,14,51
Ballymena,3606,3,14,9,7,56,48,8,51
Cliftonville,3606,4,13,8,9,51,42,9,47
Coleraine,3606,5,10,13,7,45,41,4,43
Glenavon,3606,6,11,10,9,49,49,0,43
Glentoran,3606,7,9,8,13,33,42,-9,35
Ards,3606,8,10,4,16,38,49,-11,34
Dungannon,3606,9,8,9,13,49,48,1,33
Ballinamalla,3606,10,8,7,15,34,52,-18,31
Portadown,3606,11,6,7,17,21,43,-22,25
Cliftonville,3607,1,16,6,8,62,42,20,54
Crusaders,3607,2,14,9,7,58,39,19,51
Linfield,3607,3,13,9,8,59,40,19,48
Dungannon,3607,4,12,10,8,61,43,18,46
Ballymena,3607,5,12,10,8,62,60,2,46
Coleraine,3607,6,10,12,8,50,47,3,42
Glentoran,3607,7,10,10,10,32,43,-11,40
Glenavon,3607,8,8,12,10,42,51,-9,36
Ards,3607,9,8,5,17,37,56,-19,29
Portadown,3607,10,7,7,16,27,46,-19,28
Ballinamalla,3607,11,8,4,18,33,56,-23,28
Cliftonville,3608,1,19,3,8,59,31,28,60
Linfield,3608,2,18,6,6,56,29,27,60
Crusaders,3608,3,16,8,6,53,32,21,56
Ballymena,3608,4,14,6,10,55,58,-3,48
Coleraine,3608,5,12,9,9,41,33,8,45
Glenavon,3608,6,10,9,11,47,52,-5,39
Ards,3608,7,11,5,14,36,45,-9,38
Dungannon,3608,8,7,12,11,44,39,5,33
Glentoran,3608,9,7,9,14,27,45,-18,30
Ballinamalla,3608,10,7,6,17,27,52,-25,27
Portadown,3608,11,5,5,20,19,48,-29,20
Cliftonville,3609,1,16,6,8,56,35,21,54
Crusaders,3609,2,15,6,9,51,36,15,51
Glenavon,3609,3,14,9,7,45,39,6,51
Ballymena,3609,4,15,5,10,58,59,-1,50
Linfield,3609,5,12,6,12,52,37,15,42
Coleraine,3609,6,11,9,10,37,39,-2,42
Glentoran,3609,7,11,6,13,32,47,-15,39
Portadown,3609,8,10,5,15,32,40,-8,35
Dungannon,3609,9,8,9,13,47,54,-7,33
Ards,3609,10,10,2,18,40,48,-8,32
Ballinamalla,3609,11,9,5,16,35,51,-16,32
Crusaders,3610,1,19,5,6,63,34,29,62
Linfield,3610,2,17,8,5,64,27,37,59
Glenavon,3610,3,14,10,6,58,47,11,52
Ballymena,3610,4,15,7,8,63,56,7,52
Coleraine,3610,5,12,8,10,42,43,-1,44
Glentoran,3610,6,11,8,11,38,39,-1,41
Dungannon,3610,7,9,9,12,49,50,-1,36
Cliftonville,3610,8,11,3,16,45,52,-7,36
Ards,3610,9,10,3,17,34,51,-17,33
Portadown,3610,10,9,4,17,24,42,-18,31
Ballinamalla,3610,11,3,5,22,26,65,-39,14
Crusaders,3611,1,17,8,5,57,35,22,59
Linfield,3611,2,15,10,5,63,31,32,55
Cliftonville,3611,3,14,7,9,50,37,13,49
Ballymena,3611,4,12,10,8,50,51,-1,46
Dungannon,3611,5,12,9,9,51,42,9,45
Glenavon,3611,6,11,10,9,51,52,-1,43
Coleraine,3611,7,10,11,9,45,42,3,41
Glentoran,3611,8,8,8,14,34,51,-17,32
Ards,3611,9,8,6,16,44,57,-13,30
Portadown,3611,10,7,7,16,29,47,-18,28
Ballinamalla,3611,11,5,6,19,29,58,-29,21
Crusaders,3612,1,17,8,5,56,32,24,59
Ballymena,3612,2,16,5,9,65,56,9,53
Linfield,3612,3,14,10,6,61,35,26,52
Cliftonville,3612,4,14,6,10,50,38,12,48
Ards,3612,5,13,4,13,42,46,-4,43
Coleraine,3612,6,11,8,11,38,40,-2,41
Dungannon,3612,7,9,9,12,52,48,4,36
Glenavon,3612,8,7,12,11,44,53,-9,33
Ballinamalla,3612,9,9,4,17,28,46,-18,31
Portadown,3612,10,7,8,15,26,45,-19,29
Glentoran,3612,11,7,8,15,28,51,-23,29
Cliftonville,3613,1,20,5,5,59,30,29,65
Crusaders,3613,2,16,7,7,60,37,23,55
Ballymena,3613,3,14,6,10,64,62,2,48
Glenavon,3613,4,11,12,7,45,46,-1,45
Linfield,3613,5,10,13,7,52,33,19,43
Glentoran,3613,6,9,9,12,34,49,-15,36
Coleraine,3613,7,7,13,10,32,39,-7,34
Dungannon,3613,8,7,12,11,42,43,-1,33
Ards,3613,9,9,5,16,36,49,-13,32
Ballinamalla,3613,10,9,5,16,38,52,-14,32
Portadown,3613,11,7,5,18,25,47,-22,26
Linfield,3614,1,15,9,6,59,33,26,54
Crusaders,3614,2,14,11,5,48,23,25,53
Coleraine,3614,3,12,12,6,40,32,8,48
Cliftonville,3614,4,13,7,10,50,40,10,46
Dungannon,3614,5,11,11,8,50,36,14,44
Glenavon,3614,6,11,11,8,50,42,8,44
Ballymena,3614,7,11,6,13,47,59,-12,39
Glentoran,3614,8,9,7,14,26,41,-15,34
Ballinamalla,3614,9,8,7,15,31,52,-21,31
Ards,3614,10,4,14,12,34,48,-14,26
Portadown,3614,11,7,5,18,16,45,-29,26
Crusaders,3615,1,16,9,5,53,33,20,57
Cliftonville,3615,2,16,5,9,53,37,16,53
Linfield,3615,3,14,8,8,61,38,23,50
Ballymena,3615,4,14,6,10,54,55,-1,48
Glenavon,3615,5,10,12,8,43,43,0,42
Coleraine,3615,6,11,9,10,38,40,-2,42
Dungannon,3615,7,9,11,10,45,39,6,38
Ballinamalla,3615,8,10,5,15,42,51,-9,35
Glentoran,3615,9,8,8,14,34,49,-15,32
Ards,3615,10,9,4,17,36,52,-16,31
Portadown,3615,11,7,5,18,24,46,-22,26
Linfield,3616,1,17,8,5,73,30,43,59
Glenavon,3616,2,16,10,4,54,31,23,58
Crusaders,3616,3,15,9,6,61,39,22,54
Cliftonville,3616,4,15,7,8,53,36,17,52
Dungannon,3616,5,12,8,10,49,38,11,44
Ballymena,3616,6,11,8,11,51,68,-17,41
Coleraine,3616,7,10,9,11,39,49,-10,39
Ards,3616,8,11,4,15,41,51,-10,37
Glentoran,3616,9,9,6,15,27,44,-17,33
Portadown,3616,10,4,8,18,20,51,-31,20
Ballinamalla,3616,11,5,3,22,27,58,-31,18
Crusaders,3617,1,20,8,2,61,28,33,68
Ballymena,3617,2,16,6,8,62,53,9,54
Linfield,3617,3,14,10,6,65,34,31,52
Glenavon,3617,4,13,11,6,54,42,12,50
Cliftonville,3617,5,13,4,13,46,43,3,43
Coleraine,3617,6,10,10,10,43,45,-2,40
Dungannon,3617,7,10,9,11,46,46,0,39
Glentoran,3617,8,11,6,13,32,42,-10,39
Ards,3617,9,6,8,16,33,50,-17,26
Portadown,3617,10,6,5,19,21,53,-32,23
Ballinamalla,3617,11,6,3,21,34,61,-27,21
Ballymena,3618,1,19,4,7,66,46,20,61
Crusaders,3618,2,17,6,7,58,35,23,57
Cliftonville,3618,3,17,4,9,54,36,18,55
Linfield,3618,4,12,8,10,55,35,20,44
Coleraine,3618,5,11,11,8,42,35,7,44
Dungannon,3618,6,10,10,10,57,51,6,40
Glenavon,3618,7,9,12,9,38,41,-3,39
Portadown,3618,8,8,8,14,24,43,-19,32
Glentoran,3618,9,8,7,15,31,50,-19,31
Ards,3618,10,7,6,17,36,57,-21,27
Ballinamalla,3618,11,6,6,18,29,61,-32,24
Crusaders,3619,1,16,8,6,55,34,21,56
Ballymena,3619,2,16,8,6,70,51,19,56
Cliftonville,3619,3,16,4,10,52,42,10,52
Linfield,3619,4,14,9,7,65,38,27,51
Glenavon,3619,5,11,10,9,46,45,1,43
Coleraine,3619,6,9,12,9,40,39,1,39
Dungannon,3619,7,8,12,10,51,49,2,36
Ards,3619,8,9,8,13,40,51,-11,35
Glentoran,3619,9,8,7,15,31,52,-21,31
Ballinamalla,3619,10,6,8,16,32,54,-22,26
Portadown,3619,11,7,4,19,28,55,-27,25
Crusaders,3620,1,19,6,5,56,27,29,63
Linfield,3620,2,14,10,6,65,29,36,52
Cliftonville,3620,3,16,3,11,61,46,15,51
Glenavon,3620,4,13,11,6,50,38,12,50
Ballymena,3620,5,14,7,9,60,64,-4,49
Coleraine,3620,6,10,12,8,39,39,0,42
Dungannon,3620,7,10,10,10,51,44,7,40
Glentoran,3620,8,8,8,14,28,49,-21,32
Ballinamalla,3620,9,9,3,18,32,51,-19,30
Portadown,3620,10,7,5,18,27,52,-25,26
Ards,3620,11,5,5,20,30,60,-30,20
Crusaders,3621,1,15,9,6,65,46,19,54
Coleraine,3621,2,13,11,6,47,33,14,50
Cliftonville,3621,3,13,9,8,54,43,11,48
Glentoran,3621,4,12,6,12,34,38,-4,42
Linfield,3621,5,9,14,7,55,39,16,41
Ballymena,3621,6,11,8,11,59,64,-5,41
Ards,3621,7,10,9,11,40,46,-6,39
Glenavon,3621,8,8,12,10,49,52,-3,36
Dungannon,3621,9,7,13,10,48,46,2,34
Ballinamalla,3621,10,8,5,17,35,55,-20,29
Portadown,3621,11,7,8,15,22,46,-24,29
Linfield,3622,1,14,11,5,58,30,28,53
Crusaders,3622,2,14,11,5,53,34,19,53
Ballymena,3622,3,15,5,10,58,62,-4,50
Cliftonville,3622,4,14,4,12,49,41,8,46
Glenavon,3622,5,9,15,6,47,43,4,42
Coleraine,3622,6,8,15,7,39,34,5,39
Glentoran,3622,7,8,12,10,27,39,-12,36
Dungannon,3622,8,8,11,11,48,48,0,35
Ballinamalla,3622,9,9,6,15,25,42,-17,33
Portadown,3622,10,8,5,17,32,47,-15,29
Ards,3622,11,5,11,14,34,50,-16,26
Crusaders,3623,1,17,10,3,55,28,27,61
Cliftonville,3623,2,15,7,8,49,37,12,52
Coleraine,3623,3,13,12,5,48,34,14,51
Ballymena,3623,4,15,4,11,61,59,2,49
Linfield,3623,5,13,8,9,67,40,27,47
Glenavon,3623,6,8,15,7,44,48,-4,39
Dungannon,3623,7,6,13,11,49,49,0,31
Ballinamalla,3623,8,7,9,14,34,52,-18,30
Glentoran,3623,9,7,9,14,31,51,-20,30
Portadown,3623,10,7,7,16,27,45,-18,28
Ards,3623,11,8,4,18,32,54,-22,28
Crusaders,3624,1,17,8,5,59,29,30,59
Linfield,3624,2,15,10,5,66,30,36,55
Ballymena,3624,3,17,4,9,68,57,11,55
Cliftonville,3624,4,13,7,10,53,49,4,46
Coleraine,3624,5,11,10,9,39,39,0,43
Dungannon,3624,6,9,10,11,47,43,4,37
Ards,3624,7,10,7,13,43,45,-2,37
Glenavon,3624,8,8,13,9,44,47,-3,37
Ballinamalla,3624,9,7,8,15,26,44,-18,29
Portadown,3624,10,8,3,19,30,58,-28,27
Glentoran,3624,11,6,8,16,27,61,-34,26
Crusaders,3625,1,15,9,6,57,37,20,54
Coleraine,3625,2,14,9,7,51,39,12,51
Ballymena,3625,3,12,11,7,61,62,-1,47
Glenavon,3625,4,12,10,8,49,47,2,46
Cliftonville,3625,5,13,6,11,51,44,7,45
Linfield,3625,6,11,10,9,55,38,17,43
Dungannon,3625,7,9,11,10,47,40,7,38
Ballinamalla,3625,8,9,7,14,34,52,-18,34
Ards,3625,9,8,7,15,38,51,-13,31
Portadown,3625,10,7,8,15,27,44,-17,29
Glentoran,3625,11,6,10,14,33,49,-16,28
Crusaders,3626,1,19,8,3,56,30,26,65
Ballymena,3626,2,14,7,9,47,50,-3,49
Dungannon,3626,3,13,9,8,55,42,13,48
Linfield,3626,4,12,11,7,54,32,22,47
Coleraine,3626,5,12,11,7,44,36,8,47
Cliftonville,3626,6,13,6,11,52,41,11,45
Glentoran,3626,7,11,6,13,33,42,-9,39
Glenavon,3626,8,9,10,11,45,50,-5,37
Ballinamalla,3626,9,9,4,17,36,53,-17,31
Ards,3626,10,7,6,17,32,46,-14,27
Portadown,3626,11,4,6,20,18,50,-32,18
Ballymena,3627,1,17,5,8,70,56,14,56
Crusaders,3627,2,15,8,7,53,37,16,53
Glenavon,3627,3,14,10,6,48,34,14,52
Linfield,3627,4,14,9,7,55,31,24,51
Cliftonville,3627,5,15,4,11,48,43,5,49
Dungannon,3627,6,9,12,9,51,42,9,39
Coleraine,3627,7,9,12,9,42,39,3,39
Ards,3627,8,10,5,15,37,48,-11,35
Portadown,3627,9,8,6,16,35,50,-15,30
Glentoran,3627,10,7,9,14,28,49,-21,30
Ballinamalla,3627,11,4,6,20,24,62,-38,18
Crusaders,3628,1,16,8,6,56,32,24,56
Linfield,3628,2,15,9,6,63,31,32,54
Ballymena,3628,3,16,5,9,55,55,0,53
Coleraine,3628,4,14,8,8,45,30,15,50
Cliftonville,3628,5,14,5,11,48,42,6,47
Dungannon,3628,6,10,10,10,52,47,5,40
Ards,3628,7,11,4,15,41,46,-5,37
Glenavon,3628,8,8,10,12,39,50,-11,34
Glentoran,3628,9,9,6,15,30,44,-14,33
Ballinamalla,3628,10,7,6,17,23,48,-25,27
Portadown,3628,11,8,3,19,26,53,-27,27
Linfield,3629,1,16,9,5,58,30,28,57
Cliftonville,3629,2,17,5,8,57,38,19,56
Crusaders,3629,3,16,6,8,59,38,21,54
Ballymena,3629,4,13,6,11,63,63,0,45
Coleraine,3629,5,9,12,9,41,39,2,39
Glenavon,3629,6,9,11,10,46,49,-3,38
Ballinamalla,3629,7,12,1,17,39,54,-15,37
Dungannon,3629,8,9,9,12,43,43,0,36
Ards,3629,9,11,3,16,44,55,-11,36
Glentoran,3629,10,10,6,14,34,48,-14,36
Portadown,3629,11,6,6,18,24,51,-27,24
Ballymena,3630,1,16,7,7,66,57,9,55
Crusaders,3630,2,15,9,6,58,43,15,54
Linfield,3630,3,14,9,7,64,36,28,51
Glenavon,3630,4,12,12,6,49,43,6,48
Cliftonville,3630,5,14,5,11,52,41,11,47
Coleraine,3630,6,11,10,9,46,44,2,43
Ards,3630,7,12,5,13,40,44,-4,41
Dungannon,3630,8,8,10,12,48,46,2,34
Glentoran,3630,9,6,9,15,27,47,-20,27
Ballinamalla,3630,10,7,6,17,27,52,-25,27
Portadown,3630,11,7,4,19,29,53,-24,25
Linfield,3631,1,14,12,4,65,30,35,54
Cliftonville,3631,2,16,5,9,53,38,15,53
Crusaders,3631,3,13,9,8,56,35,21,48
Coleraine,3631,4,12,11,7,43,40,3,47
Ballymena,3631,5,13,8,9,54,54,0,47
Glenavon,3631,6,12,10,8,51,42,9,46
Dungannon,3631,7,11,11,8,45,36,9,44
Ards,3631,8,10,5,15,38,46,-8,35
Portadown,3631,9,7,6,17,24,46,-22,27
Ballinamalla,3631,10,7,5,18,27,60,-33,26
Glentoran,3631,11,6,6,18,26,55,-29,24
Linfield,3632,1,13,13,4,61,31,30,52
Crusaders,3632,2,14,9,7,56,39,17,51
Cliftonville,3632,3,14,7,9,56,42,14,49
Ballymena,3632,4,14,5,11,61,63,-2,47
Coleraine,3632,5,11,9,10,40,39,1,42
Dungannon,3632,6,10,11,9,53,44,9,41
Glentoran,3632,7,11,6,13,35,43,-8,39
Ballinamalla,3632,8,10,5,15,32,49,-17,35
Glenavon,3632,9,6,15,9,40,47,-7,33
Ards,3632,10,9,6,15,39,56,-17,33
Portadown,3632,11,5,10,15,22,42,-20,25
Linfield,3633,1,18,8,4,66,34,32,62
Crusaders,3633,2,17,6,7,61,40,21,57
Cliftonville,3633,3,17,4,9,48,37,11,55
Glenavon,3633,4,12,10,8,52,44,8,46
Dungannon,3633,5,12,7,11,49,40,9,43
Coleraine,3633,6,12,7,11,39,40,-1,43
Ballymena,3633,7,12,6,12,56,63,-7,42
Glentoran,3633,8,11,6,13,37,43,-6,39
Ards,3633,9,10,3,17,37,48,-11,33
Ballinamalla,3633,10,7,2,21,31,61,-30,23
Portadown,3633,11,5,5,20,19,45,-26,20
Linfield,3634,1,18,8,4,63,33,30,62
Cliftonville,3634,2,18,4,8,62,36,26,58
Crusaders,3634,3,14,7,9,54,38,16,49
Glenavon,3634,4,13,9,8,56,48,8,48
Ballymena,3634,5,13,7,10,61,55,6,46
Coleraine,3634,6,11,12,7,38,35,3,45
Ards,3634,7,11,2,17,36,48,-12,35
Glentoran,3634,8,8,9,13,33,46,-13,33
Dungannon,3634,9,6,13,11,46,46,0,31
Ballinamalla,3634,10,7,4,19,25,59,-34,25
Portadown,3634,11,6,5,19,27,57,-30,23
Linfield,3635,1,15,10,5,58,29,29,55
Crusaders,3635,2,16,6,8,52,30,22,54
Ballymena,3635,3,14,6,10,55,59,-4,48
Dungannon,3635,4,11,12,7,52,41,11,45
Cliftonville,3635,5,13,4,13,49,42,7,43
Coleraine,3635,6,11,9,10,40,39,1,42
Glenavon,3635,7,10,11,9,40,43,-3,41
Glentoran,3635,8,10,7,13,29,40,-11,37
Ards,3635,9,9,5,16,42,53,-11,32
Portadown,3635,10,9,4,17,27,43,-16,31
Ballinamalla,3635,11,7,6,17,31,56,-25,27
Linfield,3636,1,19,7,4,59,22,37,64
Crusaders,3636,2,18,9,3,58,29,29,63
Cliftonville,3636,3,19,4,7,57,30,27,61
Ballymena,3636,4,13,6,11,54,57,-3,45
Glenavon,3636,5,9,11,10,45,46,-1,38
Dungannon,3636,6,10,7,13,46,43,3,37
Coleraine,3636,7,9,9,12,36,38,-2,36
Glentoran,3636,8,9,6,15,27,51,-24,33
Portadown,3636,9,8,5,17,25,48,-23,29
Ards,3636,10,8,4,18,32,51,-19,28
Ballinamalla,3636,11,7,4,19,26,50,-24,25
Crusaders,3637,1,17,6,7,51,35,16,57
Linfield,3637,2,13,11,6,58,33,25,50
Ballymena,3637,3,14,8,8,63,59,4,50
Dungannon,3637,4,13,9,8,55,39,16,48
Glenavon,3637,5,12,10,8,54,49,5,46
Cliftonville,3637,6,13,6,11,45,39,6,45
Ards,3637,7,12,4,14,42,46,-4,40
Coleraine,3637,8,10,10,10,39,45,-6,40
Ballinamalla,3637,9,8,6,16,31,49,-18,30
Glentoran,3637,10,6,6,18,29,49,-20,24
Portadown,3637,11,5,8,17,28,52,-24,23
Linfield,3638,1,17,8,5,68,30,38,59
Cliftonville,3638,2,14,7,9,53,37,16,49
Ballymena,3638,3,14,5,11,57,57,0,47
Crusaders,3638,4,13,7,10,51,40,11,46
Coleraine,3638,5,12,7,11,45,42,3,43
Glenavon,3638,6,11,10,9,49,48,1,43
Dungannon,3638,7,11,9,10,46,41,5,42
Glentoran,3638,8,9,8,13,26,42,-16,35
Portadown,3638,9,9,5,16,25,44,-19,32
Ballinamalla,3638,10,8,7,15,32,50,-18,31
Ards,3638,11,8,5,17,35,56,-21,29
Linfield,3639,1,16,10,4,58,24,34,58
Crusaders,3639,2,17,6,7,56,34,22,57
Glenavon,3639,3,15,9,6,57,38,19,54
Ballymena,3639,4,15,7,8,52,50,2,52
Cliftonville,3639,5,14,4,12,50,41,9,46
Coleraine,3639,6,11,11,8,44,36,8,44
Dungannon,3639,7,9,10,11,49,42,7,37
Ards,3639,8,10,5,15,38,49,-11,35
Ballinamalla,3639,9,8,3,19,27,53,-26,27
Glentoran,3639,10,7,6,17,23,52,-29,27
Portadown,3639,11,6,3,21,20,55,-35,21
Crusaders,3640,1,17,9,4,56,30,26,60
Linfield,3640,2,14,10,6,60,34,26,52
Cliftonville,3640,3,15,7,8,56,40,16,52
Glenavon,3640,4,12,12,6,54,41,13,48
Ballymena,3640,5,14,6,10,61,60,1,48
Dungannon,3640,6,9,12,9,54,44,10,39
Coleraine,3640,7,9,11,10,44,45,-1,38
Glentoran,3640,8,7,11,12,29,44,-15,32
Ards,3640,9,7,7,16,32,50,-18,28
Ballinamalla,3640,10,8,3,19,30,56,-26,27
Portadown,3640,11,5,8,17,23,55,-32,23
Crusaders,3641,1,16,9,5,54,36,18,57
Linfield,3641,2,15,6,9,61,39,22,51
Cliftonville,3641,3,15,6,9,51,42,9,51
Coleraine,3641,4,11,10,9,37,34,3,43
Ballymena,3641,5,12,6,12,53,60,-7,42
Dungannon,3641,6,11,8,11,55,46,9,41
Glentoran,3641,7,11,8,11,32,39,-7,41
Glenavon,3641,8,8,14,8,46,48,-2,38
Ards,3641,9,11,5,14,39,42,-3,38
Portadown,3641,10,8,4,18,29,46,-17,28
Ballinamalla,3641,11,6,6,18,27,52,-25,24
Crusaders,3642,1,19,5,6,65,36,29,62
Linfield,3642,2,15,8,7,59,33,26,53
Ballymena,3642,3,14,7,9,60,51,9,49
Cliftonville,3642,4,14,7,9,55,48,7,49
Coleraine,3642,5,10,12,8,43,40,3,42
Glenavon,3642,6,8,15,7,44,43,1,39
Ards,3642,7,12,3,15,40,47,-7,39
Glentoran,3642,8,8,9,13,32,50,-18,33
Dungannon,3642,9,6,12,12,41,43,-2,30
Portadown,3642,10,6,9,15,29,47,-18,27
Ballinamalla,3642,11,5,9,16,23,53,-30,24
Linfield,3643,1,20,7,3,74,27,47,67
Crusaders,3643,2,18,8,4,59,30,29,62
Coleraine,3643,3,16,7,7,52,36,16,55
Cliftonville,3643,4,15,4,11,53,42,11,49
Ballymena,3643,5,14,4,12,56,59,-3,46
Glenavon,3643,6,11,12,7,50,40,10,45
Dungannon,3643,7,11,8,11,46,47,-1,41
Glentoran,3643,8,7,5,18,29,50,-21,26
Ards,3643,9,7,3,20,35,56,-21,24
Ballinamalla,3643,10,6,6,18,26,61,-35,24
Portadown,3643,11,5,6,19,18,50,-32,21
Linfield,3644,1,16,9,5,62,31,31,57
Cliftonville,3644,2,16,7,7,54,36,18,55
Crusaders,3644,3,14,9,7,54,36,18,51
Coleraine,3644,4,13,9,8,50,40,10,48
Glenavon,3644,5,12,12,6,44,37,7,48
Dungannon,3644,6,12,9,9,55,43,12,45
Ballymena,3644,7,10,9,11,49,58,-9,39
Ballinamalla,3644,8,10,2,18,31,46,-15,32
Glentoran,3644,9,7,9,14,34,49,-15,30
Ards,3644,10,8,5,17,37,58,-21,29
Portadown,3644,11,6,2,22,28,64,-36,20
Cliftonville,3645,1,16,5,9,55,40,15,53
Linfield,3645,2,13,10,7,54,33,21,49
Crusaders,3645,3,13,9,8,50,36,14,48
Glenavon,3645,4,13,9,8,43,35,8,48
Dungannon,3645,5,11,10,9,46,36,10,43
Coleraine,3645,6,10,12,8,44,40,4,42
Ballymena,3645,7,11,9,10,53,56,-3,42
Glentoran,3645,8,11,9,10,31,41,-10,42
Ballinamalla,3645,9,10,3,17,34,49,-15,33
Ards,3645,10,6,7,17,32,53,-21,25
Portadown,3645,11,6,7,17,23,46,-23,25
Crusaders,3646,1,19,8,3,61,29,32,65
Linfield,3646,2,17,7,6,60,24,36,58
Cliftonville,3646,3,15,6,9,51,36,15,51
Glenavon,3646,4,12,12,6,49,39,10,48
Ballymena,3646,5,12,6,12,49,62,-13,42
Dungannon,3646,6,10,10,10,58,46,12,40
Coleraine,3646,7,8,13,9,41,41,0,37
Ards,3646,8,9,6,15,38,48,-10,33
Portadown,3646,9,7,5,18,24,55,-31,26
Ballinamalla,3646,10,6,7,17,27,52,-25,25
Glentoran,3646,11,5,10,15,24,50,-26,25
Crusaders,3647,1,15,8,7,61,39,22,53
Ballymena,3647,2,15,5,10,61,61,0,50
Linfield,3647,3,13,10,7,55,31,24,49
Cliftonville,3647,4,13,8,9,54,46,8,47
Dungannon,3647,5,11,10,9,51,40,11,43
Coleraine,3647,6,10,12,8,50,41,9,42
Glenavon,3647,7,9,10,11,43,52,-9,37
Ballinamalla,3647,8,11,4,15,37,50,-13,37
Portadown,3647,9,9,7,14,28,45,-17,34
Glentoran,3647,10,8,9,13,32,46,-14,33
Ards,3647,11,6,7,17,34,55,-21,25
Cliftonville,3648,1,19,4,7,60,38,22,61
Crusaders,3648,2,17,6,7,61,36,25,57
Ballymena,3648,3,17,5,8,72,58,14,56
Linfield,3648,4,15,8,7,61,29,32,53
Dungannon,3648,5,12,9,9,51,41,10,45
Glenavon,3648,6,11,11,8,46,45,1,44
Coleraine,3648,7,9,9,12,38,42,-4,36
Glentoran,3648,8,7,8,15,23,45,-22,29
Ards,3648,9,7,6,17,30,49,-19,27
Portadown,3648,10,6,7,17,26,54,-28,25
Ballinamalla,3648,11,5,7,18,26,57,-31,22
Crusaders,3649,1,17,8,5,64,36,28,59
Linfield,3649,2,12,12,6,61,39,22,48
Glenavon,3649,3,12,11,7,44,43,1,47
Coleraine,3649,4,12,9,9,43,43,0,45
Ballymena,3649,5,12,7,11,50,55,-5,43
Cliftonville,3649,6,12,6,12,52,46,6,42
Dungannon,3649,7,9,11,10,49,42,7,38
Glentoran,3649,8,10,7,13,40,48,-8,37
Ballinamalla,3649,9,9,5,16,34,49,-15,32
Portadown,3649,10,9,5,16,26,47,-21,32
Ards,3649,11,8,5,17,40,55,-15,29
Crusaders,3650,1,15,8,7,56,34,22,53
Linfield,3650,2,14,10,6,61,33,28,52
Cliftonville,3650,3,15,4,11,51,42,9,49
Glenavon,3650,4,13,10,7,53,50,3,49
Ballymena,3650,5,12,12,6,57,55,2,48
Dungannon,3650,6,11,9,10,47,39,8,42
Coleraine,3650,7,11,9,10,42,34,8,42
Ards,3650,8,9,7,14,34,46,-12,34
Glentoran,3650,9,7,11,12,29,42,-13,32
Ballinamalla,3650,10,8,4,18,29,54,-25,28
Portadown,3650,11,5,6,19,21,51,-30,21
Crusaders,3651,1,18,8,4,60,31,29,62
Linfield,3651,2,16,9,5,60,25,35,57
Cliftonville,3651,3,17,5,8,57,41,16,56
Glenavon,3651,4,14,9,7,54,42,12,51
Ballymena,3651,5,13,7,10,59,62,-3,46
Coleraine,3651,6,9,12,9,35,38,-3,39
Dungannon,3651,7,10,8,12,45,48,-3,38
Glentoran,3651,8,8,7,15,33,44,-11,31
Ards,3651,9,7,7,16,36,55,-19,28
Ballinamalla,3651,10,7,4,19,27,52,-25,25
Portadown,3651,11,6,4,20,27,55,-28,22
Crusaders,3652,1,18,8,4,58,29,29,62
Ballymena,3652,2,17,5,8,60,48,12,56
Cliftonville,3652,3,13,7,10,50,44,6,46
Linfield,3652,4,13,6,11,56,35,21,45
Coleraine,3652,5,10,12,8,43,43,0,42
Dungannon,3652,6,8,12,10,53,46,7,36
Glenavon,3652,7,8,11,11,46,57,-11,35
Glentoran,3652,8,9,8,13,27,38,-11,35
Ards,3652,9,9,5,16,35,52,-17,32
Portadown,3652,10,9,5,16,32,49,-17,32
Ballinamalla,3652,11,9,5,16,32,51,-19,32
Ballymena,3653,1,19,4,7,69,52,17,61
Linfield,3653,2,15,9,6,61,31,30,54
Crusaders,3653,3,14,9,7,54,38,16,51
Cliftonville,3653,4,14,5,11,45,39,6,47
Ballinamalla,3653,5,11,6,13,34,44,-10,39
Glenavon,3653,6,9,10,11,45,52,-7,37
Dungannon,3653,7,9,9,12,53,53,0,36
Coleraine,3653,8,8,12,10,45,45,0,36
Glentoran,3653,9,9,8,13,32,48,-16,35
Ards,3653,10,9,6,15,47,55,-8,33
Portadown,3653,11,6,6,18,28,56,-28,24
Crusaders,3654,1,17,7,6,52,30,22,58
Ballymena,3654,2,17,5,8,60,56,4,56
Linfield,3654,3,13,9,8,60,37,23,48
Cliftonville,3654,4,14,6,10,51,36,15,48
Coleraine,3654,5,12,10,8,43,39,4,46
Glenavon,3654,6,11,12,7,47,40,7,45
Glentoran,3654,7,10,6,14,28,38,-10,36
Dungannon,3654,8,7,10,13,47,50,-3,31
Portadown,3654,9,8,7,15,28,41,-13,31
Ards,3654,10,8,4,18,33,58,-25,28
Ballinamalla,3654,11,7,6,17,28,52,-24,27
Crusaders,3655,1,18,6,6,50,29,21,60
Linfield,3655,2,14,11,5,57,27,30,53
Glenavon,3655,3,12,11,7,45,40,5,47
Ballymena,3655,4,14,5,11,56,53,3,47
Cliftonville,3655,5,12,6,12,43,42,1,42
Coleraine,3655,6,9,14,7,40,36,4,41
Ballinamalla,3655,7,11,6,13,37,46,-9,39
Portadown,3655,8,11,5,14,24,34,-10,38
Dungannon,3655,9,6,12,12,36,43,-7,30
Ards,3655,10,8,5,17,35,53,-18,29
Glentoran,3655,11,6,7,17,24,44,-20,25
Linfield,3656,1,17,7,6,69,30,39,58
Crusaders,3656,2,17,7,6,50,29,21,58
Coleraine,3656,3,14,10,6,47,34,13,52
Cliftonville,3656,4,14,8,8,51,38,13,50
Glenavon,3656,5,10,11,9,49,51,-2,41
Dungannon,3656,6,11,7,12,57,48,9,40
Portadown,3656,7,10,6,14,32,42,-10,36
Ballymena,3656,8,9,7,14,56,71,-15,34
Ards,3656,9,9,6,15,37,47,-10,33
Glentoran,3656,10,7,8,15,29,55,-26,29
Ballinamalla,3656,11,6,5,19,30,62,-32,23
Linfield,3657,1,18,7,5,63,32,31,61
Coleraine,3657,2,17,7,6,54,25,29,58
Crusaders,3657,3,16,7,7,58,41,17,55
Ballymena,3657,4,15,5,10,64,59,5,50
Cliftonville,3657,5,14,4,12,54,51,3,46
Glenavon,3657,6,12,7,11,43,46,-3,43
Glentoran,3657,7,10,6,14,40,47,-7,36
Dungannon,3657,8,9,8,13,40,44,-4,35
Portadown,3657,9,8,5,17,27,46,-19,29
Ards,3657,10,8,4,18,37,60,-23,28
Ballinamalla,3657,11,6,4,20,25,54,-29,22
Crusaders,3658,1,18,7,5,62,43,19,61
Linfield,3658,2,13,11,6,53,28,25,50
Cliftonville,3658,3,14,5,11,51,39,12,47
Ballymena,3658,4,13,8,9,63,61,2,47
Glenavon,3658,5,12,8,10,44,49,-5,44
Coleraine,3658,6,9,14,7,44,42,2,41
Dungannon,3658,7,9,13,8,50,39,11,40
Ards,3658,8,9,6,15,40,49,-9,33
Ballinamalla,3658,9,9,4,17,30,49,-19,31
Glentoran,3658,10,8,5,17,37,53,-16,29
Portadown,3658,11,8,5,17,23,45,-22,29
Linfield,3659,1,19,8,3,66,32,34,65
Crusaders,3659,2,19,7,4,60,32,28,64
Cliftonville,3659,3,16,4,10,56,39,17,52
Glenavon,3659,4,12,8,10,54,57,-3,44
Ballymena,3659,5,12,6,12,62,64,-2,42
Coleraine,3659,6,10,11,9,43,45,-2,41
Dungannon,3659,7,8,10,12,52,53,-1,34
Ards,3659,8,10,4,16,41,46,-5,34
Glentoran,3659,9,6,11,13,32,51,-19,29
Ballinamalla,3659,10,7,6,17,29,48,-19,27
Portadown,3659,11,5,7,18,24,52,-28,22
Cliftonville,3660,1,18,3,9,54,31,23,57
Crusaders,3660,2,16,7,7,60,41,19,55
Linfield,3660,3,14,10,6,58,29,29,52
Ballymena,3660,4,15,5,10,63,56,7,50
Coleraine,3660,5,13,10,7,41,35,6,49
Dungannon,3660,6,10,9,11,48,48,0,39
Glenavon,3660,7,9,11,10,42,45,-3,38
Ballinamalla,3660,8,11,3,16,37,50,-13,36
Ards,3660,9,10,4,16,41,50,-9,34
Glentoran,3660,10,6,7,17,25,50,-25,25
Portadown,3660,11,5,7,18,21,55,-34,22
Crusaders,3661,1,17,6,7,50,24,26,57
Linfield,3661,2,15,7,8,59,35,24,52
Dungannon,3661,3,13,10,7,53,38,15,49
Cliftonville,3661,4,13,6,11,48,39,9,45
Ballymena,3661,5,12,6,12,49,62,-13,42
Glenavon,3661,6,9,11,10,47,44,3,38
Coleraine,3661,7,9,10,11,39,47,-8,37
Portadown,3661,8,10,6,14,30,40,-10,36
Ards,3661,9,10,4,16,32,44,-12,34
Glentoran,3661,10,9,7,14,31,45,-14,34
Ballinamalla,3661,11,8,7,15,26,46,-20,31
Crusaders,3662,1,20,5,5,60,31,29,65
Linfield,3662,2,14,11,5,56,27,29,53
Cliftonville,3662,3,15,3,12,51,39,12,48
Ballymena,3662,4,14,5,11,56,58,-2,47
Dungannon,3662,5,12,9,9,51,38,13,45
Glenavon,3662,6,10,11,9,47,46,1,41
Coleraine,3662,7,10,10,10,36,40,-4,40
Glentoran,3662,8,10,7,13,29,42,-13,37
Ards,3662,9,9,5,16,40,52,-12,32
Portadown,3662,10,7,5,18,24,51,-27,26
Ballinamalla,3662,11,7,3,20,34,60,-26,24
Linfield,3663,1,17,7,6,60,29,31,58
Ballymena,3663,2,17,5,8,65,57,8,56
Crusaders,3663,3,16,7,7,56,39,17,55
Cliftonville,3663,4,14,3,13,43,39,4,45
Dungannon,3663,5,10,10,10,53,41,12,40
Coleraine,3663,6,9,12,9,39,37,2,39
Glenavon,3663,7,8,13,9,41,50,-9,37
Glentoran,3663,8,9,8,13,32,42,-10,35
Ards,3663,9,10,4,16,38,51,-13,34
Portadown,3663,10,9,5,16,25,42,-17,32
Ballinamalla,3663,11,5,8,17,28,53,-25,23
Cliftonville,3664,1,21,2,7,66,37,29,65
Glenavon,3664,2,13,10,7,55,46,9,49
Linfield,3664,3,13,8,9,62,39,23,47
Ballymena,3664,4,14,4,12,58,59,-1,46
Coleraine,3664,5,12,9,9,40,34,6,45
Crusaders,3664,6,13,4,13,47,47,0,43
Dungannon,3664,7,10,10,10,52,47,5,40
Glentoran,3664,8,9,8,13,29,45,-16,35
Portadown,3664,9,10,4,16,27,42,-15,34
Ballinamalla,3664,10,8,5,17,31,54,-23,29
Ards,3664,11,8,4,18,40,57,-17,28
Ballymena,3665,1,16,6,8,60,51,9,54
Crusaders,3665,2,14,9,7,52,37,15,51
Linfield,3665,3,14,8,8,57,37,20,50
Cliftonville,3665,4,15,4,11,49,32,17,49
Coleraine,3665,5,11,10,9,38,38,0,43
Glenavon,3665,6,11,10,9,42,43,-1,43
Dungannon,3665,7,9,10,11,52,52,0,37
Ballinamalla,3665,8,11,4,15,32,43,-11,37
Portadown,3665,9,9,6,15,35,47,-12,33
Ards,3665,10,9,4,17,39,56,-17,31
Glentoran,3665,11,7,7,16,27,47,-20,28
Linfield,3666,1,15,9,6,58,37,21,54
Crusaders,3666,2,15,7,8,58,38,20,52
Cliftonville,3666,3,16,4,10,54,40,14,52
Glentoran,3666,4,13,8,9,39,42,-3,47
Glenavon,3666,5,12,10,8,62,51,11,46
Ballymena,3666,6,13,7,10,58,57,1,46
Coleraine,3666,7,10,11,9,38,38,0,41
Dungannon,3666,8,10,9,11,47,41,6,39
Ards,3666,9,9,2,19,38,60,-22,29
Portadown,3666,10,7,5,18,25,47,-22,26
Ballinamalla,3666,11,7,4,19,30,56,-26,25
Linfield,3667,1,16,10,4,56,23,33,58
Crusaders,3667,2,16,10,4,53,28,25,58
Glenavon,3667,3,12,11,7,48,42,6,47
Cliftonville,3667,4,13,6,11,57,47,10,45
Ballymena,3667,5,12,9,9,53,56,-3,45
Glentoran,3667,6,12,7,11,32,40,-8,43
Dungannon,3667,7,10,9,11,51,45,6,39
Ards,3667,8,11,6,13,41,43,-2,39
Coleraine,3667,9,8,10,12,42,49,-7,34
Ballinamalla,3667,10,5,7,18,25,55,-30,22
Portadown,3667,11,4,7,19,25,55,-30,19
Crusaders,3668,1,17,7,6,58,35,23,58
Linfield,3668,2,15,10,5,58,26,32,55
Dungannon,3668,3,12,9,9,53,47,6,45
Glenavon,3668,4,11,9,10,54,53,1,42
Cliftonville,3668,5,12,5,13,52,47,5,41
Coleraine,3668,6,10,11,9,42,45,-3,41
Ballymena,3668,7,10,10,10,52,61,-9,40
Ards,3668,8,11,5,14,37,43,-6,38
Glentoran,3668,9,8,10,12,34,44,-10,34
Portadown,3668,10,8,7,15,29,45,-16,31
Ballinamalla,3668,11,7,5,18,24,47,-23,26
Linfield,3669,1,17,10,3,60,22,38,61
Cliftonville,3669,2,16,7,7,59,36,23,55
Crusaders,3669,3,13,7,10,53,36,17,46
Glenavon,3669,4,11,11,8,48,42,6,44
Ballymena,3669,5,12,8,10,57,60,-3,44
Coleraine,3669,6,11,10,9,44,39,5,43
Glentoran,3669,7,10,6,14,31,46,-15,36
Ards,3669,8,10,4,16,37,53,-16,34
Portadown,3669,9,9,6,15,24,44,-20,33
Dungannon,3669,10,6,12,12,47,49,-2,30
Ballinamalla,3669,11,7,5,18,25,58,-33,26
Crusaders,3670,1,18,7,5,58,32,26,61
Linfield,3670,2,16,9,5,59,25,34,57
Cliftonville,3670,3,15,5,10,51,34,17,50
Coleraine,3670,4,12,9,9,44,40,4,45
Ballymena,3670,5,13,5,12,53,60,-7,44
Glenavon,3670,6,11,9,10,44,44,0,42
Dungannon,3670,7,9,12,9,46,39,7,39
Portadown,3670,8,10,5,15,26,42,-16,35
Glentoran,3670,9,8,9,13,29,47,-18,33
Ards,3670,10,9,3,18,40,55,-15,30
Ballinamalla,3670,11,6,3,21,22,54,-32,21
Crusaders,3671,1,15,11,4,58,35,23,56
Cliftonville,3671,2,14,6,10,48,41,7,48
Ballymena,3671,3,14,6,10,55,54,1,48
Linfield,3671,4,11,12,7,52,36,16,45
Coleraine,3671,5,11,10,9,41,40,1,43
Glenavon,3671,6,11,10,9,44,48,-4,43
Dungannon,3671,7,9,11,10,49,41,8,38
Glentoran,3671,8,9,11,10,35,39,-4,38
Ballinamalla,3671,9,8,7,15,40,55,-15,31
Portadown,3671,10,7,7,16,29,47,-18,28
Ards,3671,11,6,9,15,37,52,-15,27
Linfield,3672,1,16,9,5,64,32,32,57
Crusaders,3672,2,17,6,7,57,35,22,57
Cliftonville,3672,3,16,7,7,54,35,19,55
Coleraine,3672,4,11,11,8,39,35,4,44
Ballymena,3672,5,13,5,12,54,56,-2,44
Dungannon,3672,6,11,10,9,58,41,17,43
Glenavon,3672,7,10,12,8,46,45,1,42
Glentoran,3672,8,10,8,12,37,48,-11,38
Ballinamalla,3672,9,8,3,19,28,59,-31,27
Ards,3672,10,7,5,18,32,54,-22,26
Portadown,3672,11,5,6,19,24,53,-29,21
Cliftonville,3673,1,17,6,7,51,31,20,57
Crusaders,3673,2,16,6,8,56,38,18,54
Linfield,3673,3,14,9,7,60,31,29,51
Coleraine,3673,4,13,12,5,42,31,11,51
Glenavon,3673,5,13,10,7,49,40,9,49
Ballymena,3673,6,12,5,13,49,62,-13,41
Dungannon,3673,7,7,13,10,51,47,4,34
Glentoran,3673,8,8,10,12,28,45,-17,34
Portadown,3673,9,9,3,18,29,46,-17,30
Ards,3673,10,8,4,18,35,51,-16,28
Ballinamalla,3673,11,7,4,19,27,55,-28,25
Crusaders,3674,1,20,4,6,53,34,19,64
Linfield,3674,2,15,10,5,61,31,30,55
Cliftonville,3674,3,17,2,11,48,36,12,53
Glenavon,3674,4,14,10,6,51,38,13,52
Coleraine,3674,5,14,9,7,47,30,17,51
Ballymena,3674,6,9,10,11,49,58,-9,37
Glentoran,3674,7,9,6,15,33,51,-18,33
Dungannon,3674,8,7,9,14,50,51,-1,30
Ballinamalla,3674,9,8,5,17,29,51,-22,29
Portadown,3674,10,8,4,18,25,48,-23,28
Ards,3674,11,7,5,18,34,52,-18,26
Crusaders,3675,1,17,6,7,55,34,21,57
Ballymena,3675,2,16,5,9,59,58,1,53
Cliftonville,3675,3,16,4,10,53,37,16,52
Linfield,3675,4,13,10,7,63,38,25,49
Dungannon,3675,5,12,8,10,55,45,10,44
Glenavon,3675,6,10,12,8,49,49,0,42
Coleraine,3675,7,10,11,9,40,37,3,41
Ards,3675,8,11,4,15,43,51,-8,37
Glentoran,3675,9,8,6,16,32,50,-18,30
Ballinamalla,3675,10,6,8,16,25,51,-26,26
Portadown,3675,11,7,4,19,32,56,-24,25
Cliftonville,3676,1,20,3,7,61,29,32,63
Linfield,3676,2,14,10,6,59,30,29,52
Coleraine,3676,3,12,12,6,42,38,4,48
Crusaders,3676,4,12,10,8,53,37,16,46
Glenavon,3676,5,12,10,8,48,45,3,46
Ballymena,3676,6,12,8,10,60,65,-5,44
Glentoran,3676,7,11,7,12,31,39,-8,40
Ards,3676,8,8,8,14,36,45,-9,32
Dungannon,3676,9,7,9,14,46,52,-6,30
Ballinamalla,3676,10,8,3,19,24,52,-28,27
Portadown,3676,11,7,4,19,22,50,-28,25
Cliftonville,3677,1,16,5,9,59,39,20,53
Linfield,3677,2,14,9,7,60,35,25,51
Glenavon,3677,3,12,14,4,52,40,12,50
Coleraine,3677,4,13,10,7,45,40,5,49
Ballymena,3677,5,13,8,9,52,52,0,47
Dungannon,3677,6,11,10,9,59,47,12,43
Crusaders,3677,7,11,10,9,54,46,8,43
Glentoran,3677,8,9,7,14,32,46,-14,34
Ballinamalla,3677,9,8,5,17,33,57,-24,29
Ards,3677,10,7,7,16,36,55,-19,28
Portadown,3677,11,5,7,18,19,44,-25,22
Crusaders,3678,1,16,7,7,59,37,22,55
Cliftonville,3678,2,17,4,9,63,47,16,55
Glenavon,3678,3,14,9,7,49,42,7,51
Ballymena,3678,4,14,5,11,58,62,-4,47
Linfield,3678,5,12,8,10,54,43,11,44
Dungannon,3678,6,11,10,9,54,41,13,43
Coleraine,3678,7,11,9,10,42,36,6,42
Ballinamalla,3678,8,10,4,16,39,48,-9,34
Ards,3678,9,9,3,18,37,56,-19,30
Glentoran,3678,10,8,6,16,32,51,-19,30
Portadown,3678,11,8,5,17,23,47,-24,29
Linfield,3679,1,15,9,6,59,32,27,54
Crusaders,3679,2,15,7,8,52,37,15,52
Coleraine,3679,3,13,10,7,49,39,10,49
Ballymena,3679,4,13,9,8,59,57,2,48
Dungannon,3679,5,13,7,10,57,50,7,46
Cliftonville,3679,6,13,5,12,50,41,9,44
Glentoran,3679,7,11,8,11,31,42,-11,41
Glenavon,3679,8,9,12,9,41,41,0,39
Ards,3679,9,9,3,18,40,54,-14,30
Portadown,3679,10,7,8,15,30,47,-17,29
Ballinamalla,3679,11,5,6,19,24,52,-28,21
Ballymena,3680,1,16,7,7,59,54,5,55
Crusaders,3680,2,15,9,6,52,29,23,54
Cliftonville,3680,3,14,7,9,50,38,12,49
Linfield,3680,4,12,10,8,58,35,23,46
Coleraine,3680,5,11,13,6,50,37,13,46
Glentoran,3680,6,10,8,12,34,47,-13,38
Glenavon,3680,7,9,10,11,41,46,-5,37
Ballinamalla,3680,8,10,5,15,38,53,-15,35
Dungannon,3680,9,8,10,12,48,49,-1,34
Ards,3680,10,8,4,18,36,54,-18,28
Portadown,3680,11,7,7,16,29,53,-24,28
Linfield,3681,1,16,9,5,59,29,30,57
Crusaders,3681,2,15,11,4,59,40,19,56
Cliftonville,3681,3,17,3,10,50,38,12,54
Ballymena,3681,4,14,4,12,50,56,-6,46
Glenavon,3681,5,11,10,9,46,49,-3,43
Coleraine,3681,6,11,9,10,45,40,5,42
Dungannon,3681,7,9,9,12,48,48,0,36
Portadown,3681,8,10,4,16,24,40,-16,34
Ards,3681,9,8,6,16,38,49,-11,30
Glentoran,3681,10,6,11,13,28,40,-12,29
Ballinamalla,3681,11,7,6,17,31,49,-18,27
Crusaders,3682,1,16,8,6,55,33,22,56
Linfield,3682,2,14,9,7,58,32,26,51
Cliftonville,3682,3,15,5,10,50,40,10,50
Glenavon,3682,4,12,10,8,39,40,-1,46
Coleraine,3682,5,11,12,7,42,37,5,45
Ballymena,3682,6,12,8,10,60,57,3,44
Dungannon,3682,7,10,11,9,49,42,7,41
Ards,3682,8,10,7,13,41,49,-8,37
Glentoran,3682,9,9,10,11,37,48,-11,37
Portadown,3682,10,6,5,19,26,52,-26,23
Ballinamalla,3682,11,5,5,20,25,52,-27,20
Crusaders,3683,1,18,7,5,52,28,24,61
Linfield,3683,2,15,11,4,62,31,31,56
Ballymena,3683,3,14,8,8,58,49,9,50
Cliftonville,3683,4,12,8,10,44,37,7,44
Coleraine,3683,5,11,11,8,42,35,7,44
Dungannon,3683,6,10,10,10,47,45,2,40
Glenavon,3683,7,8,14,8,38,39,-1,38
Ards,3683,8,11,4,15,43,50,-7,37
Portadown,3683,9,8,5,17,24,46,-22,29
Glentoran,3683,10,6,10,14,27,46,-19,28
Ballinamalla,3683,11,5,6,19,21,52,-31,21
Linfield,3684,1,16,9,5,59,33,26,57
Crusaders,3684,2,15,9,6,56,34,22,54
Ballymena,3684,3,15,5,10,65,59,6,50
Cliftonville,3684,4,14,6,10,56,40,16,48
Glenavon,3684,5,10,12,8,48,47,1,42
Coleraine,3684,6,9,12,9,39,44,-5,39
Dungannon,3684,7,9,10,11,50,47,3,37
Glentoran,3684,8,8,10,12,37,43,-6,34
Portadown,3684,9,8,9,13,23,41,-18,33
Ards,3684,10,7,6,17,36,53,-17,27
Ballinamalla,3684,11,7,6,17,25,53,-28,27
Linfield,3685,1,14,11,5,59,30,29,53
Crusaders,3685,2,14,8,8,57,41,16,50
Ballymena,3685,3,13,9,8,57,58,-1,48
Cliftonville,3685,4,14,5,11,51,40,11,47
Coleraine,3685,5,10,14,6,42,38,4,44
Glentoran,3685,6,11,7,12,36,45,-9,40
Dungannon,3685,7,9,11,10,44,41,3,38
Ards,3685,8,10,7,13,36,41,-5,37
Glenavon,3685,9,8,12,10,39,50,-11,36
Portadown,3685,10,7,9,14,32,42,-10,30
Ballinamalla,3685,11,6,5,19,23,50,-27,23
Crusaders,3686,1,20,7,3,64,29,35,67
Linfield,3686,2,16,8,6,58,37,21,56
Dungannon,3686,3,13,9,8,56,40,16,48
Cliftonville,3686,4,14,4,12,48,36,12,46
Glenavon,3686,5,11,11,8,44,42,2,44
Ballymena,3686,6,11,9,10,52,53,-1,42
Glentoran,3686,7,10,7,13,31,38,-7,37
Ards,3686,8,10,6,14,36,46,-10,36
Coleraine,3686,9,8,9,13,33,43,-10,33
Portadown,3686,10,6,6,18,23,47,-24,24
Ballinamalla,3686,11,7,2,21,24,58,-34,23
Crusaders,3687,1,15,11,4,54,32,22,56
Linfield,3687,2,15,8,7,62,33,29,53
Cliftonville,3687,3,15,5,10,53,44,9,50
Ballymena,3687,4,12,7,11,58,65,-7,43
Dungannon,3687,5,10,11,9,46,39,7,41
Glentoran,3687,6,11,8,11,35,46,-11,41
Portadown,3687,7,11,5,14,32,40,-8,38
Coleraine,3687,8,9,10,11,40,39,1,37
Glenavon,3687,9,8,13,9,45,50,-5,37
Ards,3687,10,8,7,15,33,45,-12,31
Ballinamalla,3687,11,7,3,20,29,54,-25,24
Crusaders,3688,1,15,9,6,52,31,21,54
Ballymena,3688,2,14,8,8,55,52,3,50
Linfield,3688,3,13,10,7,60,32,28,49
Dungannon,3688,4,11,9,10,53,41,12,42
Coleraine,3688,5,11,9,10,38,41,-3,42
Cliftonville,3688,6,12,5,13,42,47,-5,41
Glenavon,3688,7,9,12,9,51,51,0,39
Glentoran,3688,8,9,10,11,32,44,-12,37
Ards,3688,9,10,6,14,35,42,-7,36
Portadown,3688,10,9,7,14,29,45,-16,34
Ballinamalla,3688,11,7,5,18,33,54,-21,26
Crusaders,3689,1,17,6,7,61,37,24,57
Cliftonville,3689,2,17,4,9,53,37,16,55
Linfield,3689,3,13,9,8,58,35,23,48
Coleraine,3689,4,12,11,7,45,34,11,47
Ballymena,3689,5,12,7,11,59,61,-2,43
Dungannon,3689,6,11,8,11,46,42,4,41
Glenavon,3689,7,10,10,10,44,56,-12,40
Glentoran,3689,8,7,11,12,32,49,-17,32
Ballinamalla,3689,9,8,7,15,33,52,-19,31
Portadown,3689,10,8,6,16,31,45,-14,30
Ards,3689,11,8,5,17,34,48,-14,29
Crusaders,3690,1,18,7,5,57,28,29,61
Linfield,3690,2,16,9,5,70,28,42,57
Cliftonville,3690,3,16,5,9,61,38,23,53
Ballymena,3690,4,12,8,10,52,63,-11,44
Dungannon,3690,5,11,10,9,50,40,10,43
Coleraine,3690,6,11,9,10,45,50,-5,42
Glenavon,3690,7,9,11,10,43,43,0,38
Glentoran,3690,8,9,8,13,32,46,-14,35
Ballinamalla,3690,9,8,6,16,29,55,-26,30
Portadown,3690,10,7,7,16,28,51,-23,28
Ards,3690,11,5,6,19,38,63,-25,21
Cliftonville,3691,1,19,5,6,59,31,28,62
Linfield,3691,2,16,8,6,58,23,35,56
Glenavon,3691,3,13,10,7,49,39,10,49
Crusaders,3691,4,13,7,10,44,37,7,46
Ballymena,3691,5,13,7,10,55,61,-6,46
Coleraine,3691,6,10,9,11,43,41,2,39
Glentoran,3691,7,10,7,13,30,40,-10,37
Ards,3691,8,9,7,14,36,52,-16,34
Dungannon,3691,9,6,14,10,45,46,-1,32
Ballinamalla,3691,10,8,6,16,34,52,-18,30
Portadown,3691,11,5,6,19,23,54,-31,21
Crusaders,3692,1,17,5,8,59,39,20,56
Linfield,3692,2,15,8,7,67,36,31,53
Cliftonville,3692,3,15,6,9,55,45,10,51
Glenavon,3692,4,13,8,9,47,41,6,47
Ballymena,3692,5,12,5,13,59,76,-17,41
Dungannon,3692,6,10,10,10,47,36,11,40
Coleraine,3692,7,9,13,8,39,37,2,40
Ards,3692,8,12,4,14,42,49,-7,40
Glentoran,3692,9,11,6,13,36,48,-12,39
Ballinamalla,3692,10,8,4,18,36,53,-17,28
Portadown,3692,11,5,7,18,23,50,-27,22
Crusaders,3693,1,17,7,6,53,31,22,58
Linfield,3693,2,15,10,5,65,31,34,55
Cliftonville,3693,3,15,7,8,62,46,16,52
Glenavon,3693,4,12,9,9,48,43,5,45
Dungannon,3693,5,11,10,9,50,43,7,43
Glentoran,3693,6,11,9,10,38,41,-3,42
Ballymena,3693,7,12,5,13,61,69,-8,41
Coleraine,3693,8,9,12,9,39,45,-6,39
Portadown,3693,9,8,8,14,28,45,-17,32
Ards,3693,10,6,5,19,36,62,-26,23
Ballinamalla,3693,11,6,4,20,33,57,-24,22
Crusaders,3694,1,20,6,4,63,30,33,66
Linfield,3694,2,17,7,6,56,31,25,58
Ballymena,3694,3,16,6,8,65,58,7,54
Cliftonville,3694,4,15,6,9,58,43,15,51
Glenavon,3694,5,10,9,11,40,51,-11,39
Coleraine,3694,6,9,10,11,42,42,0,37
Glentoran,3694,7,8,9,13,33,43,-10,33
Ards,3694,8,8,7,15,35,47,-12,31
Dungannon,3694,9,6,12,12,40,45,-5,30
Portadown,3694,10,7,7,16,25,44,-19,28
Ballinamalla,3694,11,7,5,18,24,47,-23,26
Crusaders,3695,1,16,8,6,60,37,23,56
Dungannon,3695,2,16,7,7,64,40,24,55
Linfield,3695,3,16,6,8,60,30,30,54
Cliftonville,3695,4,15,4,11,56,40,16,49
Coleraine,3695,5,12,11,7,42,31,11,47
Ballymena,3695,6,13,7,10,56,61,-5,46
Glenavon,3695,7,10,12,8,49,46,3,42
Ards,3695,8,9,3,18,33,52,-19,30
Ballinamalla,3695,9,8,5,17,30,55,-25,29
Portadown,3695,10,8,3,19,28,51,-23,27
Glentoran,3695,11,5,8,17,20,55,-35,23
Crusaders,3696,1,18,6,6,54,27,27,60
Cliftonville,3696,2,16,5,9,60,38,22,53
Linfield,3696,3,14,10,6,60,33,27,52
Coleraine,3696,4,11,13,6,47,39,8,46
Ballymena,3696,5,11,8,11,55,65,-10,41
Dungannon,3696,6,10,9,11,51,45,6,39
Glenavon,3696,7,10,9,11,44,49,-5,39
Glentoran,3696,8,7,10,13,34,51,-17,31
Ards,3696,9,8,6,16,37,49,-12,30
Portadown,3696,10,8,6,16,27,48,-21,30
Ballinamalla,3696,11,8,6,16,27,52,-25,30
Crusaders,3697,1,19,7,4,49,26,23,64
Cliftonville,3697,2,17,5,8,56,38,18,56
Ballymena,3697,3,14,6,10,53,55,-2,48
Linfield,3697,4,13,8,9,58,35,23,47
Coleraine,3697,5,11,11,8,43,35,8,44
Dungannon,3697,6,9,11,10,51,41,10,38
Glenavon,3697,7,8,11,11,40,43,-3,35
Ards,3697,8,9,7,14,35,47,-12,34
Ballinamalla,3697,9,10,3,17,27,49,-22,33
Glentoran,3697,10,9,5,16,29,47,-18,32
Portadown,3697,11,6,6,18,28,53,-25,24
Crusaders,3698,1,18,8,4,65,37,28,62
Coleraine,3698,2,14,9,7,53,39,14,51
Linfield,3698,3,14,8,8,50,32,18,50
Cliftonville,3698,4,15,5,10,51,37,14,50
Ballymena,3698,5,11,9,10,54,64,-10,42
Dungannon,3698,6,10,8,12,48,42,6,38
Glentoran,3698,7,8,12,10,33,43,-10,36
Portadown,3698,8,10,4,16,30,47,-17,34
Glenavon,3698,9,8,7,15,42,52,-10,31
Ards,3698,10,9,4,17,38,51,-13,31
Ballinamalla,3698,11,9,4,17,34,54,-20,31
Crusaders,3699,1,19,8,3,54,25,29,65
Linfield,3699,2,14,9,7,55,32,23,51
Cliftonville,3699,3,14,8,8,54,35,19,50
Coleraine,3699,4,12,10,8,40,37,3,46
Glenavon,3699,5,10,12,8,49,47,2,42
Ballymena,3699,6,12,5,13,58,59,-1,41
Glentoran,3699,7,10,7,13,31,42,-11,37
Ards,3699,8,9,9,12,35,42,-7,36
Dungannon,3699,9,7,9,14,42,49,-7,30
Portadown,3699,10,8,5,17,25,46,-21,29
Ballinamalla,3699,11,6,6,18,23,52,-29,24
Crusaders,3700,1,17,6,7,61,36,25,57
Linfield,3700,2,16,7,7,68,38,30,55
Glenavon,3700,3,15,7,8,54,43,11,52
Ballymena,3700,4,16,3,11,61,57,4,51
Cliftonville,3700,5,15,5,10,55,38,17,50
Dungannon,3700,6,11,6,13,62,47,15,39
Portadown,3700,7,11,3,16,30,49,-19,36
Coleraine,3700,8,9,8,13,37,51,-14,35
Ards,3700,9,10,3,17,35,47,-12,33
Ballinamalla,3700,10,9,3,18,25,53,-28,30
Glentoran,3700,11,8,5,17,25,54,-29,29
Cliftonville,3701,1,16,4,10,51,38,13,52
Ballymena,3701,2,14,9,7,62,55,7,51
Glenavon,3701,3,13,11,6,53,46,7,50
Linfield,3701,4,13,9,8,58,36,22,48
Crusaders,3701,5,13,8,9,50,37,13,47
Coleraine,3701,6,12,9,9,43,41,2,45
Dungannon,3701,7,9,12,9,46,39,7,39
Ards,3701,8,9,7,14,36,47,-11,34
Glentoran,3701,9,9,4,17,32,50,-18,31
Portadown,3701,10,8,6,16,29,48,-19,30
Ballinamalla,3701,11,7,5,18,28,51,-23,26
Crusaders,3702,1,17,7,6,58,34,24,58
Linfield,3702,2,13,9,8,55,37,18,48
Cliftonville,3702,3,14,4,12,46,39,7,46
Coleraine,3702,4,13,7,10,44,40,4,46
Dungannon,3702,5,12,9,9,54,40,14,45
Ballymena,3702,6,13,5,12,53,56,-3,44
Ards,3702,7,12,4,14,36,44,-8,40
Glenavon,3702,8,9,10,11,44,52,-8,37
Glentoran,3702,9,10,7,13,34,46,-12,37
Portadown,3702,10,8,6,16,25,43,-18,30
Ballinamalla,3702,11,9,2,19,31,49,-18,29
Crusaders,3703,1,15,8,7,44,32,12,53
Linfield,3703,2,13,12,5,57,25,32,51
Cliftonville,3703,3,15,5,10,54,38,16,50
Ballymena,3703,4,14,5,11,55,57,-2,47
Glenavon,3703,5,10,13,7,42,41,1,43
Dungannon,3703,6,10,10,10,53,46,7,40
Coleraine,3703,7,10,9,11,35,38,-3,39
Ards,3703,8,10,7,13,35,40,-5,37
Ballinamalla,3703,9,10,4,16,30,45,-15,34
Glentoran,3703,10,7,9,14,21,36,-15,30
Portadown,3703,11,8,4,18,23,51,-28,28
Linfield,3704,1,15,8,7,58,34,24,53
Crusaders,3704,2,14,11,5,51,34,17,53
Ballymena,3704,3,16,4,10,60,57,3,52
Coleraine,3704,4,12,11,7,42,36,6,47
Cliftonville,3704,5,13,4,13,48,42,6,43
Dungannon,3704,6,10,12,8,46,38,8,42
Glenavon,3704,7,10,11,9,43,45,-2,41
Ards,3704,8,10,4,16,37,45,-8,34
Glentoran,3704,9,8,8,14,32,48,-16,32
Portadown,3704,10,9,5,16,22,39,-17,32
Ballinamalla,3704,11,7,4,19,31,52,-21,25
Linfield,3705,1,16,9,5,67,33,34,57
Ballymena,3705,2,16,6,8,54,47,7,54
Crusaders,3705,3,14,7,9,43,28,15,49
Cliftonville,3705,4,14,4,12,44,40,4,46
Glenavon,3705,5,11,12,7,44,44,0,45
Glentoran,3705,6,12,6,12,36,42,-6,42
Dungannon,3705,7,10,10,10,51,46,5,40
Coleraine,3705,8,10,10,10,33,38,-5,40
Ards,3705,9,8,4,18,36,46,-10,28
Ballinamalla,3705,10,7,7,16,27,47,-20,28
Portadown,3705,11,7,5,18,19,43,-24,26
Cliftonville,3706,1,17,6,7,49,28,21,57
Crusaders,3706,2,16,7,7,50,31,19,55
Ballymena,3706,3,13,9,8,53,53,0,48
Linfield,3706,4,12,11,7,50,30,20,47
Dungannon,3706,5,12,8,10,54,41,13,44
Coleraine,3706,6,11,11,8,43,39,4,44
Glenavon,3706,7,8,11,11,45,54,-9,35
Glentoran,3706,8,9,7,14,26,39,-13,34
Ballinamalla,3706,9,9,5,16,26,49,-23,32
Ards,3706,10,7,9,14,31,40,-9,30
Portadown,3706,11,5,8,17,20,43,-23,23
Crusaders,3707,1,19,5,6,62,36,26,62
Cliftonville,3707,2,18,4,8,59,38,21,58
Ballymena,3707,3,16,7,7,62,56,6,55
Linfield,3707,4,14,9,7,54,29,25,51
Dungannon,3707,5,11,10,9,52,42,10,43
Glenavon,3707,6,10,10,10,45,44,1,40
Coleraine,3707,7,10,9,11,38,43,-5,39
Glentoran,3707,8,10,7,13,30,43,-13,37
Ards,3707,9,9,4,17,36,48,-12,31
Ballinamalla,3707,10,7,3,20,26,53,-27,24
Portadown,3707,11,5,4,21,26,58,-32,19
Crusaders,3708,1,16,9,5,57,37,20,57
Linfield,3708,2,12,14,4,54,32,22,50
Dungannon,3708,3,14,8,8,55,38,17,50
Cliftonville,3708,4,15,4,11,53,34,19,49
Ballymena,3708,5,11,10,9,60,59,1,43
Coleraine,3708,6,9,14,7,44,46,-2,41
Glenavon,3708,7,10,10,10,47,49,-2,40
Glentoran,3708,8,8,11,11,30,41,-11,35
Ballinamalla,3708,9,8,6,16,25,45,-20,30
Ards,3708,10,7,7,16,35,53,-18,28
Portadown,3708,11,6,5,19,28,54,-26,23
Ballymena,3709,1,18,5,7,71,53,18,59
Crusaders,3709,2,16,8,6,60,31,29,56
Linfield,3709,3,15,9,6,53,26,27,54
Glenavon,3709,4,11,11,8,53,58,-5,44
Cliftonville,3709,5,13,4,13,46,38,8,43
Ballinamalla,3709,6,11,4,15,29,43,-14,37
Glentoran,3709,7,10,7,13,30,48,-18,37
Dungannon,3709,8,8,10,12,41,41,0,34
Coleraine,3709,9,8,10,12,34,40,-6,34
Portadown,3709,10,9,5,16,22,41,-19,32
Ards,3709,11,7,5,18,33,53,-20,26
Crusaders,3710,1,19,5,6,55,33,22,62
Linfield,3710,2,15,7,8,64,42,22,52
Cliftonville,3710,3,15,7,8,53,36,17,52
Glenavon,3710,4,12,11,7,49,43,6,47
Dungannon,3710,5,11,8,11,49,42,7,41
Ballymena,3710,6,11,7,12,51,62,-11,40
Coleraine,3710,7,8,13,9,38,38,0,37
Glentoran,3710,8,10,7,13,38,46,-8,37
Ballinamalla,3710,9,7,8,15,27,47,-20,29
Portadown,3710,10,7,7,16,23,43,-20,28
Ards,3710,11,7,6,17,33,48,-15,27
Cliftonville,3711,1,16,3,11,52,42,10,51
Ballymena,3711,2,15,6,9,55,54,1,51
Linfield,3711,3,14,8,8,60,33,27,50
Glenavon,3711,4,13,7,10,50,47,3,46
Coleraine,3711,5,12,10,8,47,44,3,46
Crusaders,3711,6,12,8,10,50,40,10,44
Dungannon,3711,7,11,11,8,50,43,7,44
Glentoran,3711,8,10,7,13,31,39,-8,37
Ballinamalla,3711,9,9,7,14,31,43,-12,34
Ards,3711,10,7,6,17,31,49,-18,27
Portadown,3711,11,8,3,19,29,52,-23,27
Crusaders,3712,1,21,6,3,67,25,42,69
Linfield,3712,2,15,9,6,56,29,27,54
Cliftonville,3712,3,17,2,11,58,42,16,53
Coleraine,3712,4,12,8,10,45,45,0,44
Glenavon,3712,5,9,11,10,41,51,-10,38
Dungannon,3712,6,9,10,11,44,42,2,37
Ballymena,3712,7,10,7,13,51,64,-13,37
Glentoran,3712,8,9,6,15,32,49,-17,33
Ards,3712,9,9,5,16,41,51,-10,32
Portadown,3712,10,8,7,15,28,45,-17,31
Ballinamalla,3712,11,5,11,14,31,51,-20,26
Crusaders,3713,1,17,5,8,53,32,21,56
Linfield,3713,2,15,8,7,53,28,25,53
Cliftonville,3713,3,15,6,9,55,42,13,51
Glenavon,3713,4,11,10,9,52,43,9,43
Ballymena,3713,5,11,9,10,54,57,-3,42
Coleraine,3713,6,9,14,7,38,36,2,41
Ards,3713,7,10,8,12,41,47,-6,38
Glentoran,3713,8,9,11,10,33,39,-6,38
Dungannon,3713,9,9,9,12,45,47,-2,36
Portadown,3713,10,10,5,15,30,47,-17,35
Ballinamalla,3713,11,3,7,20,19,55,-36,16
Linfield,3714,1,18,8,4,61,29,32,62
Crusaders,3714,2,17,9,4,66,39,27,60
Cliftonville,3714,3,17,6,7,59,38,21,57
Ballymena,3714,4,14,5,11,55,57,-2,47
Coleraine,3714,5,10,10,10,43,43,0,40
Glenavon,3714,6,10,9,11,49,49,0,39
Dungannon,3714,7,9,11,10,61,54,7,38
Ards,3714,8,11,4,15,44,54,-10,37
Glentoran,3714,9,9,6,15,34,46,-12,33
Portadown,3714,10,6,7,17,32,55,-23,25
Ballinamalla,3714,11,4,5,21,29,69,-40,17
Crusaders,3715,1,15,11,4,57,33,24,56
Linfield,3715,2,14,10,6,57,33,24,52
Cliftonville,3715,3,15,6,9,51,38,13,51
Coleraine,3715,4,13,9,8,41,31,10,48
Ballymena,3715,5,14,6,10,60,55,5,48
Dungannon,3715,6,11,10,9,51,38,13,43
Glenavon,3715,7,10,10,10,42,46,-4,40
Glentoran,3715,8,8,9,13,32,45,-13,33
Ballinamalla,3715,9,9,6,15,27,47,-20,33
Portadown,3715,10,7,4,19,25,52,-27,25
Ards,3715,11,5,7,18,26,51,-25,22
Linfield,3716,1,15,7,8,58,37,21,52
Crusaders,3716,2,15,7,8,53,42,11,52
Dungannon,3716,3,14,8,8,55,37,18,50
Coleraine,3716,4,13,11,6,50,39,11,50
Cliftonville,3716,5,15,3,12,54,37,17,48
Ballymena,3716,6,13,6,11,53,53,0,45
Glentoran,3716,7,11,8,11,34,41,-7,41
Glenavon,3716,8,10,9,11,49,55,-6,39
Ballinamalla,3716,9,9,4,17,33,51,-18,31
Ards,3716,10,8,5,17,39,58,-19,29
Portadown,3716,11,6,4,20,22,50,-28,22
Crusaders,3717,1,19,6,5,61,33,28,63
Linfield,3717,2,13,11,6,59,32,27,50
Dungannon,3717,3,13,9,8,51,39,12,48
Ballymena,3717,4,14,5,11,56,57,-1,47
Cliftonville,3717,5,13,7,10,49,41,8,46
Coleraine,3717,6,12,10,8,44,40,4,46
Glentoran,3717,7,8,9,13,32,47,-15,33
Glenavon,3717,8,6,14,10,42,47,-5,32
Portadown,3717,9,9,5,16,24,44,-20,32
Ards,3717,10,8,5,17,32,47,-15,29
Ballinamalla,3717,11,8,3,19,30,53,-23,27
Coleraine,3718,1,15,12,3,49,32,17,57
Crusaders,3718,2,15,10,5,52,32,20,55
Cliftonville,3718,3,14,8,8,54,40,14,50
Linfield,3718,4,14,7,9,61,42,19,49
Ballymena,3718,5,12,6,12,57,54,3,42
Glenavon,3718,6,9,13,8,44,44,0,40
Glentoran,3718,7,8,9,13,31,45,-14,33
Dungannon,3718,8,7,11,12,48,51,-3,32
Ballinamalla,3718,9,8,8,14,30,50,-20,32
Portadown,3718,10,7,8,15,28,45,-17,29
Ards,3718,11,7,6,17,33,52,-19,27
Linfield,3719,1,17,8,5,60,28,32,59
Cliftonville,3719,2,18,3,9,60,37,23,57
Crusaders,3719,3,15,5,10,52,41,11,50
Ballymena,3719,4,14,8,8,67,61,6,50
Glenavon,3719,5,11,12,7,47,43,4,45
Coleraine,3719,6,10,10,10,45,48,-3,40
Ards,3719,7,11,5,14,51,53,-2,38
Dungannon,3719,8,9,8,13,47,47,0,35
Glentoran,3719,9,8,10,12,34,43,-9,34
Portadown,3719,10,8,3,19,25,56,-31,27
Ballinamalla,3719,11,6,4,20,27,58,-31,22
Crusaders,3720,1,17,6,7,55,35,20,57
Cliftonville,3720,2,17,5,8,57,37,20,56
Glenavon,3720,3,12,10,8,47,42,5,46
Glentoran,3720,4,13,7,10,38,40,-2,46
Ballymena,3720,5,12,7,11,53,55,-2,43
Linfield,3720,6,11,9,10,49,39,10,42
Coleraine,3720,7,10,11,9,38,35,3,41
Ards,3720,8,12,3,15,44,45,-1,39
Dungannon,3720,9,9,10,11,44,43,1,37
Ballinamalla,3720,10,6,6,18,28,58,-30,24
Portadown,3720,11,5,8,17,22,46,-24,23
Cliftonville,3721,1,17,5,8,51,35,16,56
Crusaders,3721,2,15,8,7,52,32,20,53
Linfield,3721,3,14,10,6,62,31,31,52
Coleraine,3721,4,13,12,5,45,31,14,51
Ballymena,3721,5,13,7,10,61,63,-2,46
Glenavon,3721,6,11,10,9,46,45,1,43
Dungannon,3721,7,8,11,11,48,47,1,35
Ards,3721,8,9,7,14,35,47,-12,34
Glentoran,3721,9,6,12,12,26,43,-17,30
Ballinamalla,3721,10,7,4,19,31,58,-27,25
Portadown,3721,11,5,8,17,26,51,-25,23
Crusaders,3722,1,16,6,8,56,34,22,54
Coleraine,3722,2,15,9,6,46,33,13,54
Linfield,3722,3,15,8,7,56,27,29,53
Dungannon,3722,4,11,10,9,48,39,9,43
Cliftonville,3722,5,12,6,12,51,52,-1,42
Ballymena,3722,6,11,8,11,51,59,-8,41
Glenavon,3722,7,10,9,11,44,44,0,39
Glentoran,3722,8,9,8,13,27,36,-9,35
Ards,3722,9,10,4,16,34,45,-11,34
Ballinamalla,3722,10,10,3,17,33,56,-23,33
Portadown,3722,11,8,5,17,22,43,-21,29
Linfield,3723,1,15,11,4,65,28,37,56
Crusaders,3723,2,16,8,6,56,32,24,56
Cliftonville,3723,3,16,7,7,60,43,17,55
Glenavon,3723,4,13,14,3,57,37,20,53
Ballymena,3723,5,14,7,9,62,60,2,49
Dungannon,3723,6,10,9,11,42,42,0,39
Coleraine,3723,7,8,11,11,35,40,-5,35
Ards,3723,8,9,3,18,38,56,-18,30
Glentoran,3723,9,8,6,16,27,54,-27,30
Ballinamalla,3723,10,6,6,18,25,51,-26,24
Portadown,3723,11,5,8,17,24,48,-24,23
Crusaders,3724,1,15,7,8,50,35,15,52
Linfield,3724,2,13,12,5,54,32,22,51
Cliftonville,3724,3,15,5,10,50,36,14,50
Ballymena,3724,4,14,6,10,57,59,-2,48
Dungannon,3724,5,12,10,8,56,46,10,46
Coleraine,3724,6,11,10,9,46,40,6,43
Glenavon,3724,7,11,10,9,51,49,2,43
Glentoran,3724,8,11,6,13,33,42,-9,39
Ballinamalla,3724,9,9,5,16,32,49,-17,32
Ards,3724,10,8,4,18,33,54,-21,28
Portadown,3724,11,6,5,19,28,48,-20,23
Crusaders,3725,1,18,4,8,56,35,21,58
Linfield,3725,2,15,10,5,53,26,27,55
Ballymena,3725,3,15,8,7,55,48,7,53
Cliftonville,3725,4,15,4,11,48,38,10,49
Coleraine,3725,5,11,10,9,48,36,12,43
Glenavon,3725,6,10,12,8,43,44,-1,42
Portadown,3725,7,10,4,16,29,43,-14,34
Dungannon,3725,8,8,9,13,51,56,-5,33
Ballinamalla,3725,9,9,4,17,30,48,-18,31
Ards,3725,10,8,5,17,35,51,-16,29
Glentoran,3725,11,7,8,15,22,45,-23,29
Crusaders,3726,1,17,6,7,61,33,28,57
Cliftonville,3726,2,17,5,8,56,39,17,56
Linfield,3726,3,13,11,6,57,37,20,50
Ballymena,3726,4,15,4,11,57,62,-5,49
Glenavon,3726,5,10,10,10,49,47,2,40
Ards,3726,6,11,6,13,41,46,-5,39
Glentoran,3726,7,11,6,13,33,46,-13,39
Coleraine,3726,8,9,11,10,49,52,-3,38
Dungannon,3726,9,10,6,14,48,50,-2,36
Ballinamalla,3726,10,7,7,16,36,55,-19,28
Portadown,3726,11,7,4,19,26,46,-20,25
Cliftonville,3727,1,16,3,11,51,37,14,51
Glenavon,3727,2,14,9,7,47,39,8,51
Crusaders,3727,3,14,6,10,49,40,9,48
Linfield,3727,4,13,8,9,55,34,21,47
Dungannon,3727,5,12,9,9,50,40,10,45
Ballymena,3727,6,13,6,11,53,58,-5,45
Glentoran,3727,7,12,6,12,31,38,-7,42
Coleraine,3727,8,10,10,10,48,46,2,40
Ballinamalla,3727,9,10,4,16,29,46,-17,34
Portadown,3727,10,8,6,16,25,44,-19,30
Ards,3727,11,8,3,19,33,49,-16,27
Crusaders,3728,1,18,7,5,61,36,25,61
Cliftonville,3728,2,16,7,7,56,35,21,55
Glenavon,3728,3,15,10,5,53,44,9,55
Linfield,3728,4,14,11,5,60,34,26,53
Ballymena,3728,5,13,4,13,51,63,-12,43
Coleraine,3728,6,11,9,10,39,36,3,42
Dungannon,3728,7,10,8,12,49,43,6,38
Ballinamalla,3728,8,9,6,15,34,48,-14,33
Portadown,3728,9,7,6,17,20,41,-21,27
Glentoran,3728,10,6,7,17,29,48,-19,25
Ards,3728,11,6,5,19,36,60,-24,23
Crusaders,3729,1,17,6,7,58,32,26,57
Cliftonville,3729,2,15,7,8,50,36,14,52
Linfield,3729,3,13,10,7,52,33,19,49
Glenavon,3729,4,13,9,8,57,49,8,48
Coleraine,3729,5,10,13,7,41,38,3,43
Ballymena,3729,6,9,9,12,51,60,-9,36
Ards,3729,7,10,6,14,34,44,-10,36
Glentoran,3729,8,8,11,11,37,47,-10,35
Dungannon,3729,9,8,10,12,45,48,-3,34
Ballinamalla,3729,10,9,4,17,34,51,-17,31
Portadown,3729,11,7,7,16,27,48,-21,28
Linfield,3730,1,15,9,6,55,31,24,54
Cliftonville,3730,2,16,5,9,54,38,16,53
Crusaders,3730,3,15,7,8,54,41,13,52
Glenavon,3730,4,14,8,8,57,52,5,50
Coleraine,3730,5,13,10,7,44,35,9,49
Ballymena,3730,6,13,5,12,53,54,-1,44
Dungannon,3730,7,11,7,12,55,48,7,40
Glentoran,3730,8,10,8,12,26,33,-7,38
Ballinamalla,3730,9,6,9,15,29,50,-21,27
Portadown,3730,10,8,3,19,23,48,-25,27
Ards,3730,11,7,3,20,31,51,-20,24
Crusaders,3731,1,18,4,8,55,34,21,58
Ballymena,3731,2,14,6,10,57,58,-1,48
Linfield,3731,3,12,11,7,56,34,22,47
Cliftonville,3731,4,13,7,10,48,42,6,46
Glenavon,3731,5,11,11,8,46,39,7,44
Coleraine,3731,6,11,10,9,38,36,2,43
Dungannon,3731,7,9,9,12,44,42,2,36
Glentoran,3731,8,10,6,14,31,43,-12,36
Ballinamalla,3731,9,11,3,16,32,47,-15,36
Ards,3731,10,10,4,16,41,55,-14,34
Portadown,3731,11,6,9,15,26,44,-18,27
Crusaders,3732,1,15,11,4,58,37,21,56
Cliftonville,3732,2,16,4,10,49,34,15,52
Ballymena,3732,3,13,8,9,57,54,3,47
Coleraine,3732,4,11,12,7,40,36,4,45
Linfield,3732,5,12,8,10,55,37,18,44
Glenavon,3732,6,8,14,8,47,44,3,38
Dungannon,3732,7,10,8,12,50,52,-2,38
Glentoran,3732,8,9,8,13,34,44,-10,35
Portadown,3732,9,9,8,13,28,42,-14,35
Ards,3732,10,9,7,14,35,43,-8,34
Ballinamalla,3732,11,6,6,18,27,57,-30,24
Crusaders,3733,1,16,10,4,55,30,25,58
Ballymena,3733,2,17,6,7,63,49,14,57
Cliftonville,3733,3,17,5,8,56,33,23,56
Linfield,3733,4,13,11,6,54,31,23,50
Dungannon,3733,5,12,7,11,50,51,-1,43
Glenavon,3733,6,10,11,9,46,42,4,41
Coleraine,3733,7,10,10,10,48,43,5,40
Glentoran,3733,8,10,7,13,28,44,-16,37
Ballinamalla,3733,9,10,3,17,33,50,-17,33
Ards,3733,10,5,5,20,33,63,-30,20
Portadown,3733,11,5,5,20,19,49,-30,20
Crusaders,3734,1,18,7,5,52,32,20,61
Linfield,3734,2,16,8,6,61,31,30,56
Ballymena,3734,3,13,9,8,58,55,3,48
Glenavon,3734,4,13,8,9,50,45,5,47
Dungannon,3734,5,11,12,7,50,37,13,45
Cliftonville,3734,6,14,3,13,50,44,6,45
Coleraine,3734,7,12,9,9,39,33,6,45
Ballinamalla,3734,8,10,5,15,31,44,-13,35
Glentoran,3734,9,6,7,17,27,46,-19,25
Portadown,3734,10,7,4,19,25,48,-23,25
Ards,3734,11,6,6,18,30,58,-28,24
Linfield,3735,1,14,9,7,56,30,26,51
Crusaders,3735,2,15,6,9,57,44,13,51
Glenavon,3735,3,14,9,7,59,47,12,51
Cliftonville,3735,4,14,7,9,50,37,13,49
Ballymena,3735,5,13,7,10,60,59,1,46
Coleraine,3735,6,10,11,9,47,40,7,41
Glentoran,3735,7,12,4,14,30,40,-10,40
Ards,3735,8,10,8,12,40,47,-7,38
Dungannon,3735,9,8,11,11,42,46,-4,35
Portadown,3735,10,8,5,17,25,48,-23,29
Ballinamalla,3735,11,7,3,20,23,51,-28,24
Cliftonville,3736,1,16,5,9,62,41,21,53
Crusaders,3736,2,14,8,8,54,47,7,50
Dungannon,3736,3,13,9,8,55,38,17,48
Ballymena,3736,4,13,9,8,63,58,5,48
Linfield,3736,5,12,9,9,59,40,19,45
Coleraine,3736,6,11,10,9,46,41,5,43
Glenavon,3736,7,11,8,11,47,55,-8,41
Ballinamalla,3736,8,12,3,15,38,48,-10,39
Glentoran,3736,8,10,9,11,38,48,-10,39
Portadown,3736,10,6,7,17,24,47,-23,25
Ards,3736,11,6,5,19,35,58,-23,23
Crusaders,3737,1,17,6,7,56,35,21,57
Cliftonville,3737,2,15,6,9,51,38,13,51
Ballymena,3737,3,14,7,9,57,54,3,49
Coleraine,3737,4,12,9,9,45,38,7,45
Glenavon,3737,5,11,11,8,48,47,1,44
Linfield,3737,6,10,13,7,49,34,15,43
Glentoran,3737,7,11,7,12,30,40,-10,40
Ards,3737,8,9,5,16,41,49,-8,32
Ballinamalla,3737,9,9,5,16,32,50,-18,32
Dungannon,3737,10,7,10,13,40,48,-8,31
Portadown,3737,11,8,5,17,34,50,-16,29
Crusaders,3738,1,19,6,5,51,27,24,63
Linfield,3738,2,15,7,8,58,34,24,52
Ballymena,3738,3,15,7,8,67,58,9,52
Cliftonville,3738,4,15,5,10,54,41,13,50
Coleraine,3738,5,10,10,10,39,42,-3,40
Ards,3738,6,11,6,13,40,48,-8,39
Dungannon,3738,7,10,7,13,45,42,3,37
Glenavon,3738,8,9,10,11,41,44,-3,37
Glentoran,3738,9,9,8,13,31,45,-14,35
Portadown,3738,10,8,5,17,28,46,-18,29
Ballinamalla,3738,11,6,5,19,22,49,-27,23
Crusaders,3739,1,16,8,6,57,36,21,56
Linfield,3739,2,15,9,6,62,38,24,54
Cliftonville,3739,3,16,6,8,56,36,20,54
Ballymena,3739,4,15,6,9,57,53,4,51
Glenavon,3739,5,11,11,8,48,46,2,44
Coleraine,3739,6,11,9,10,37,37,0,42
Ards,3739,7,10,6,14,34,44,-10,36
Ballinamalla,3739,8,10,5,15,31,48,-17,35
Glentoran,3739,9,7,8,15,26,43,-17,29
Dungannon,3739,10,7,7,16,43,48,-5,28
Portadown,3739,11,6,7,17,27,49,-22,25
Glenavon,3740,1,15,11,4,50,38,12,56
Crusaders,3740,2,15,10,5,56,35,21,55
Coleraine,3740,3,13,8,9,44,38,6,47
Linfield,3740,4,12,10,8,59,41,18,46
Cliftonville,3740,5,13,7,10,53,48,5,46
Ballymena,3740,6,13,7,10,58,61,-3,46
Dungannon,3740,7,10,10,10,57,48,9,40
Ards,3740,8,10,5,15,40,46,-6,35
Portadown,3740,9,9,7,14,36,44,-8,34
Glentoran,3740,10,5,8,17,23,48,-25,23
Ballinamalla,3740,11,5,7,18,23,52,-29,22
Linfield,3741,1,17,11,2,67,28,39,62
Cliftonville,3741,2,16,6,8,54,40,14,54
Crusaders,3741,3,14,9,7,53,41,12,51
Dungannon,3741,4,13,9,8,55,38,17,48
Coleraine,3741,5,12,8,10,44,46,-2,44
Ballymena,3741,6,13,5,12,55,61,-6,44
Glenavon,3741,7,10,10,10,51,51,0,40
Glentoran,3741,8,8,9,13,30,49,-19,33
Ards,3741,9,8,4,18,35,50,-15,28
Portadown,3741,10,7,5,18,31,52,-21,26
Ballinamalla,3741,11,7,4,19,28,47,-19,25
Crusaders,3742,1,18,5,7,60,35,25,59
Coleraine,3742,2,12,12,6,52,40,12,48
Cliftonville,3742,3,14,6,10,54,45,9,48
Linfield,3742,4,12,10,8,53,37,16,46
Dungannon,3742,5,10,10,10,55,49,6,40
Ballymena,3742,6,11,6,13,49,57,-8,39
Glentoran,3742,7,10,7,13,32,37,-5,37
Glenavon,3742,8,8,12,10,44,53,-9,36
Ards,3742,9,10,6,14,38,48,-10,36
Portadown,3742,10,9,7,14,26,37,-11,34
Ballinamalla,3742,11,8,5,17,32,57,-25,29
Linfield,3743,1,15,7,8,58,34,24,52
Crusaders,3743,2,15,6,9,52,38,14,51
Glenavon,3743,3,13,10,7,54,40,14,49
Cliftonville,3743,4,15,4,11,49,40,9,49
Coleraine,3743,5,13,9,8,44,39,5,48
Dungannon,3743,6,11,11,8,51,39,12,44
Ballymena,3743,7,12,5,13,57,66,-9,41
Glentoran,3743,8,9,8,13,28,42,-14,35
Ballinamalla,3743,9,8,6,16,28,51,-23,30
Ards,3743,10,8,5,17,32,45,-13,29
Portadown,3743,11,8,5,17,27,46,-19,29
Crusaders,3744,1,17,5,8,59,38,21,56
Linfield,3744,2,16,6,8,60,34,26,54
Cliftonville,3744,3,15,5,10,60,40,20,50
Coleraine,3744,4,11,12,7,48,44,4,45
Ballymena,3744,5,13,6,11,66,66,0,45
Dungannon,3744,6,11,10,9,50,39,11,43
Glenavon,3744,7,10,10,10,45,52,-7,40
Ards,3744,8,10,3,17,39,54,-15,33
Glentoran,3744,9,9,6,15,31,53,-22,33
Portadown,3744,10,9,5,16,36,50,-14,32
Ballinamalla,3744,11,8,4,18,30,54,-24,28
Cliftonville,3745,1,18,5,7,56,31,25,59
Linfield,3745,2,16,9,5,57,27,30,57
Ballymena,3745,3,15,7,8,59,56,3,52
Crusaders,3745,4,14,9,7,47,29,18,51
Glenavon,3745,5,11,10,9,47,42,5,43
Coleraine,3745,6,10,11,9,38,35,3,41
Glentoran,3745,7,8,10,12,32,43,-11,34
Dungannon,3745,8,7,11,12,39,40,-1,32
Portadown,3745,9,9,3,18,25,47,-22,30
Ards,3745,10,7,8,15,33,54,-21,29
Ballinamalla,3745,11,6,5,19,25,54,-29,23
Crusaders,3746,1,19,6,5,65,36,29,63
Linfield,3746,2,15,11,4,56,27,29,56
Cliftonville,3746,3,15,5,10,56,43,13,50
Coleraine,3746,4,13,10,7,45,37,8,49
Glentoran,3746,5,12,8,10,38,45,-7,44
Glenavon,3746,6,10,11,9,47,47,0,41
Ballymena,3746,7,12,4,14,49,61,-12,40
Dungannon,3746,8,8,11,11,48,46,2,35
Ards,3746,9,8,7,15,36,47,-11,31
Portadown,3746,10,5,10,15,21,43,-22,25
Ballinamalla,3746,11,5,3,22,27,56,-29,18
Crusaders,3747,1,17,9,4,57,27,30,60
Linfield,3747,2,16,9,5,54,24,30,57
Cliftonville,3747,3,18,3,9,56,39,17,57
Ballymena,3747,4,14,7,9,57,57,0,49
Glenavon,3747,5,12,10,8,47,48,-1,46
Coleraine,3747,6,10,11,9,42,38,4,41
Dungannon,3747,7,8,9,13,45,45,0,33
Ballinamalla,3747,8,9,5,16,30,47,-17,32
Glentoran,3747,9,7,8,15,25,41,-16,29
Portadown,3747,10,8,4,18,26,51,-25,28
Ards,3747,11,7,3,20,33,55,-22,24
Coleraine,3748,1,15,10,5,55,34,21,55
Crusaders,3748,2,15,8,7,47,33,14,53
Linfield,3748,3,13,12,5,62,36,26,51
Dungannon,3748,4,11,12,7,55,40,15,45
Cliftonville,3748,5,13,6,11,53,41,12,45
Glenavon,3748,6,11,11,8,46,47,-1,44
Ballymena,3748,7,10,8,12,57,71,-14,38
Glentoran,3748,8,7,13,10,34,45,-11,34
Portadown,3748,9,7,8,15,29,44,-15,29
Ards,3748,10,8,4,18,35,59,-24,28
Ballinamalla,3748,11,5,8,17,33,56,-23,23
Crusaders,3749,1,16,10,4,57,31,26,58
Ballymena,3749,2,15,5,10,56,55,1,50
Coleraine,3749,3,12,11,7,40,34,6,47
Cliftonville,3749,4,13,6,11,50,46,4,45
Linfield,3749,5,11,11,8,49,29,20,44
Glenavon,3749,6,11,11,8,42,41,1,44
Dungannon,3749,7,10,11,9,50,42,8,41
Glentoran,3749,8,11,7,12,40,47,-7,40
Ards,3749,9,8,8,14,33,44,-11,32
Ballinamalla,3749,10,7,6,17,31,55,-24,27
Portadown,3749,11,5,6,19,21,45,-24,21
Crusaders,3750,1,16,9,5,54,32,22,57
Linfield,3750,2,11,13,6,49,29,20,46
Cliftonville,3750,3,14,4,12,56,48,8,46
Ballymena,3750,4,12,8,10,48,58,-10,44
Coleraine,3750,5,11,10,9,41,30,11,43
Glenavon,3750,6,11,9,10,41,40,1,42
Ards,3750,7,12,5,13,41,43,-2,41
Portadown,3750,8,10,7,13,31,42,-11,37
Glentoran,3750,9,9,8,13,36,48,-12,35
Dungannon,3750,10,7,12,11,47,50,-3,33
Ballinamalla,3750,11,7,5,18,30,54,-24,26
Crusaders,3751,1,15,10,5,52,35,17,55
Cliftonville,3751,2,16,4,10,54,42,12,52
Linfield,3751,3,12,13,5,53,29,24,49
Ballymena,3751,4,14,7,9,63,54,9,49
Dungannon,3751,5,12,9,9,50,41,9,45
Glenavon,3751,6,11,12,7,50,45,5,45
Coleraine,3751,7,9,11,10,40,36,4,38
Ards,3751,8,8,10,12,37,44,-7,34
Glentoran,3751,9,8,10,12,32,41,-9,34
Portadown,3751,10,5,8,17,24,54,-30,23
Ballinamalla,3751,11,5,6,19,26,60,-34,21
Linfield,3752,1,16,10,4,70,31,39,58
Cliftonville,3752,2,16,4,10,49,43,6,52
Ballymena,3752,3,16,4,10,54,56,-2,52
Crusaders,3752,4,13,10,7,49,35,14,49
Dungannon,3752,5,13,7,10,49,36,13,46
Glenavon,3752,6,11,10,9,48,43,5,43
Coleraine,3752,7,10,12,8,36,31,5,42
Glentoran,3752,8,10,7,13,28,38,-10,37
Ballinamalla,3752,9,7,6,17,26,47,-21,27
Portadown,3752,10,6,6,18,24,51,-27,24
Ards,3752,11,5,8,17,36,58,-22,23
Ballymena,3753,1,17,6,7,66,56,10,57
Crusaders,3753,2,15,9,6,55,39,16,54
Linfield,3753,3,14,8,8,60,40,20,50
Cliftonville,3753,4,15,5,10,52,42,10,50
Dungannon,3753,5,12,9,9,58,40,18,45
Coleraine,3753,6,11,9,10,41,40,1,42
Glenavon,3753,7,9,12,9,41,43,-2,39
Ards,3753,8,10,6,14,41,49,-8,36
Portadown,3753,9,8,5,17,28,48,-20,29
Glentoran,3753,10,6,10,14,30,47,-17,28
Ballinamalla,3753,11,5,7,18,28,56,-28,22
Linfield,3754,1,15,10,5,58,32,26,55
Crusaders,3754,2,15,10,5,59,36,23,55
Cliftonville,3754,3,14,6,10,50,39,11,48
Glenavon,3754,4,12,11,7,44,44,0,47
Ballymena,3754,5,12,8,10,50,52,-2,44
Coleraine,3754,6,10,13,7,45,37,8,43
Dungannon,3754,7,10,10,10,53,49,4,40
Glentoran,3754,8,10,6,14,34,42,-8,36
Ards,3754,9,7,10,13,34,45,-11,31
Portadown,3754,10,7,5,18,24,50,-26,26
Ballinamalla,3754,11,7,3,20,24,49,-25,24
Glenavon,3755,1,17,8,5,57,36,21,59
Crusaders,3755,2,16,7,7,46,31,15,55
Cliftonville,3755,3,15,5,10,61,40,21,50
Ballymena,3755,4,14,6,10,63,58,5,48
Linfield,3755,5,12,9,9,52,31,21,45
Dungannon,3755,6,11,9,10,53,39,14,42
Coleraine,3755,7,10,9,11,37,41,-4,39
Ballinamalla,3755,8,11,3,16,31,47,-16,36
Glentoran,3755,9,7,9,14,23,44,-21,30
Ards,3755,10,8,3,19,29,58,-29,27
Portadown,3755,11,6,8,16,22,49,-27,26
Linfield,3756,1,15,8,7,57,32,25,53
Crusaders,3756,2,14,9,7,48,34,14,51
Cliftonville,3756,3,15,5,10,50,38,12,50
Coleraine,3756,4,11,11,8,42,39,3,44
Ballymena,3756,5,12,7,11,56,56,0,43
Glenavon,3756,6,11,9,10,44,48,-4,42
Dungannon,3756,7,10,9,11,46,39,7,39
Ballinamalla,3756,8,11,5,14,33,45,-12,38
Ards,3756,9,9,6,15,39,50,-11,33
Portadown,3756,10,9,5,16,24,39,-15,32
Glentoran,3756,11,5,12,13,31,50,-19,27
Crusaders,3757,1,18,8,4,57,31,26,62
Ballymena,3757,2,17,7,6,64,50,14,58
Cliftonville,3757,3,15,5,10,52,37,15,50
Coleraine,3757,4,13,8,9,49,44,5,47
Linfield,3757,5,12,10,8,49,36,13,46
Glenavon,3757,6,10,9,11,41,42,-1,39
Dungannon,3757,7,10,8,12,46,40,6,38
Ards,3757,8,9,6,15,40,51,-11,33
Glentoran,3757,9,8,9,13,30,42,-12,33
Portadown,3757,10,7,5,18,22,47,-25,26
Ballinamalla,3757,11,6,5,19,27,57,-30,23
Crusaders,3758,1,17,7,6,62,40,22,58
Linfield,3758,2,14,9,7,61,33,28,51
Cliftonville,3758,3,14,7,9,54,42,12,49
Coleraine,3758,4,12,11,7,45,40,5,47
Glentoran,3758,5,13,5,12,37,43,-6,44
Dungannon,3758,6,10,11,9,52,46,6,41
Glenavon,3758,7,10,11,9,51,47,4,41
Ballymena,3758,8,10,9,11,55,60,-5,39
Ards,3758,9,9,5,16,32,51,-19,32
Ballinamalla,3758,10,7,5,18,37,59,-22,26
Portadown,3758,11,5,8,17,23,48,-25,23
Linfield,3759,1,19,7,4,76,27,49,64
Crusaders,3759,2,15,8,7,55,38,17,53
Cliftonville,3759,3,16,5,9,54,42,12,53
Ballymena,3759,4,13,8,9,56,54,2,47
Dungannon,3759,5,11,8,11,52,44,8,41
Glenavon,3759,6,10,9,11,50,51,-1,39
Coleraine,3759,7,9,10,11,43,39,4,37
Ards,3759,8,9,6,15,34,50,-16,33
Portadown,3759,9,9,4,17,32,59,-27,31
Ballinamalla,3759,10,9,3,18,37,61,-24,30
Glentoran,3759,11,8,6,16,27,51,-24,30
Cliftonville,3760,1,16,6,8,62,43,19,54
Crusaders,3760,2,14,11,5,53,36,17,53
Linfield,3760,3,13,10,7,50,27,23,49
Ballymena,3760,4,15,4,11,58,56,2,49
Glenavon,3760,5,11,11,8,50,44,6,44
Coleraine,3760,6,10,12,8,43,40,3,42
Dungannon,3760,7,10,11,9,49,43,6,41
Ards,3760,8,10,5,15,38,47,-9,35
Ballinamalla,3760,9,8,7,15,35,55,-20,31
Glentoran,3760,10,7,7,16,27,50,-23,28
Portadown,3760,11,6,6,18,27,51,-24,24
Crusaders,3761,1,17,8,5,58,34,24,59
Linfield,3761,2,16,9,5,67,35,32,57
Cliftonville,3761,3,13,8,9,51,45,6,47
Ballymena,3761,4,13,6,11,54,58,-4,45
Coleraine,3761,5,10,13,7,42,32,10,43
Glenavon,3761,6,10,10,10,48,44,4,40
Ards,3761,7,10,8,12,38,41,-3,38
Glentoran,3761,8,10,8,12,33,45,-12,38
Dungannon,3761,9,8,12,10,60,53,7,36
Ballinamalla,3761,10,7,4,19,27,60,-33,25
Portadown,3761,11,6,4,20,25,56,-31,22
Crusaders,3762,1,20,8,2,58,24,34,68
Cliftonville,3762,2,17,5,8,54,40,14,56
Linfield,3762,3,13,14,3,60,32,28,53
Ballymena,3762,4,15,7,8,56,53,3,52
Dungannon,3762,5,12,9,9,56,44,12,45
Glenavon,3762,6,10,10,10,50,49,1,40
Coleraine,3762,7,9,8,13,46,46,0,35
Ards,3762,8,9,6,15,42,55,-13,33
Glentoran,3762,9,6,8,16,23,47,-24,26
Ballinamalla,3762,10,7,4,19,27,56,-29,25
Portadown,3762,11,4,7,19,25,51,-26,19
Crusaders,3763,1,18,7,5,61,32,29,61
Linfield,3763,2,14,10,6,62,38,24,52
Cliftonville,3763,3,14,7,9,52,37,15,49
Ballymena,3763,4,15,4,11,61,60,1,49
Glenavon,3763,5,11,11,8,50,46,4,44
Dungannon,3763,6,11,9,10,50,41,9,42
Coleraine,3763,7,10,11,9,44,44,0,41
Glentoran,3763,8,10,10,10,38,41,-3,40
Ards,3763,9,9,8,13,36,44,-8,35
Portadown,3763,10,6,4,20,18,55,-37,22
Ballinamalla,3763,11,4,5,21,29,63,-34,17
Crusaders,3764,1,20,5,5,68,32,36,65
Linfield,3764,2,14,9,7,63,40,23,51
Glenavon,3764,3,14,9,7,54,43,11,51
Cliftonville,3764,4,15,4,11,46,41,5,49
Ballymena,3764,5,15,4,11,59,59,0,49
Coleraine,3764,6,10,10,10,40,41,-1,40
Ards,3764,7,10,6,14,36,44,-8,36
Dungannon,3764,8,8,10,12,45,48,-3,34
Glentoran,3764,9,8,8,14,30,49,-19,32
Portadown,3764,10,8,5,17,27,44,-17,29
Ballinamalla,3764,11,7,2,21,25,52,-27,23
Crusaders,3765,1,18,6,6,54,31,23,60
Cliftonville,3765,2,15,6,9,52,34,18,51
Linfield,3765,3,13,10,7,53,30,23,49
Ballymena,3765,4,14,7,9,59,61,-2,49
Coleraine,3765,5,13,9,8,47,38,9,48
Glenavon,3765,6,12,9,9,44,43,1,45
Dungannon,3765,7,9,7,14,45,43,2,34
Glentoran,3765,8,8,9,13,34,50,-16,33
Ards,3765,9,8,7,15,39,49,-10,31
Ballinamalla,3765,10,8,4,18,31,55,-24,28
Portadown,3765,10,8,4,18,31,55,-24,28
Crusaders,3766,1,21,6,3,56,20,36,69
Linfield,3766,2,14,9,7,59,36,23,51
Ballymena,3766,3,15,5,10,57,55,2,50
Glenavon,3766,4,11,9,10,43,43,0,42
Dungannon,3766,5,11,8,11,44,35,9,41
Coleraine,3766,6,10,11,9,41,39,2,41
Cliftonville,3766,7,12,3,15,46,46,0,39
Glentoran,3766,8,10,9,11,35,41,-6,39
Portadown,3766,9,8,6,16,22,45,-23,30
Ards,3766,10,7,7,16,35,53,-18,28
Ballinamalla,3766,11,7,5,18,30,55,-25,26
Crusaders,3767,1,18,8,4,55,25,30,62
Ballymena,3767,2,17,5,8,64,55,9,56
Linfield,3767,3,14,13,3,58,29,29,55
Cliftonville,3767,4,15,6,9,59,38,21,51
Coleraine,3767,5,12,7,11,36,38,-2,43
Dungannon,3767,6,9,9,12,48,50,-2,36
Glenavon,3767,7,8,12,10,45,49,-4,36
Glentoran,3767,8,8,8,14,30,46,-16,32
Portadown,3767,9,9,5,16,24,42,-18,32
Ards,3767,10,7,6,17,35,54,-19,27
Ballinamalla,3767,11,6,5,19,25,53,-28,23
Linfield,3768,1,16,10,4,62,27,35,58
Cliftonville,3768,2,17,6,7,55,35,20,57
Crusaders,3768,3,15,7,8,50,36,14,52
Ballymena,3768,4,15,5,10,62,52,10,50
Glenavon,3768,5,13,9,8,50,40,10,48
Coleraine,3768,6,10,11,9,46,45,1,41
Dungannon,3768,7,10,9,11,54,50,4,39
Ballinamalla,3768,8,9,6,15,38,54,-16,33
Ards,3768,9,8,6,16,40,55,-15,30
Glentoran,3768,10,7,8,15,23,47,-24,29
Portadown,3768,11,5,3,22,17,56,-39,18
Ballymena,3769,1,18,4,8,63,54,9,58
Crusaders,3769,2,15,7,8,51,41,10,52
Linfield,3769,3,14,8,8,72,41,31,50
Glenavon,3769,4,12,12,6,47,47,0,48
Coleraine,3769,5,11,12,7,44,40,4,45
Dungannon,3769,6,12,7,11,56,40,16,43
Cliftonville,3769,7,11,7,12,49,46,3,40
Portadown,3769,8,11,4,15,33,44,-11,37
Ards,3769,9,10,4,16,41,52,-11,34
Glentoran,3769,10,7,9,14,30,50,-20,30
Ballinamalla,3769,11,5,4,21,23,54,-31,19
Crusaders,3770,1,17,10,3,61,30,31,61
Linfield,3770,2,15,9,6,56,28,28,54
Coleraine,3770,3,14,8,8,51,34,17,50
Glenavon,3770,4,12,11,7,49,38,11,47
Cliftonville,3770,5,13,4,13,49,49,0,43
Dungannon,3770,6,11,9,10,47,40,7,42
Ballymena,3770,7,12,6,12,59,67,-8,42
Ards,3770,8,10,8,12,44,49,-5,38
Glentoran,3770,9,9,6,15,31,46,-15,33
Portadown,3770,10,8,3,19,21,53,-32,27
Ballinamalla,3770,11,5,4,21,24,58,-34,19
Cliftonville,3771,1,18,4,8,55,34,21,58
Linfield,3771,2,15,8,7,49,25,24,53
Crusaders,3771,3,14,7,9,47,33,14,49
Coleraine,3771,4,13,9,8,45,36,9,48
Ballymena,3771,5,12,5,13,51,57,-6,41
Glenavon,3771,6,10,10,10,46,46,0,40
Glentoran,3771,7,11,7,12,32,42,-10,40
Dungannon,3771,8,9,10,11,49,47,2,37
Ards,3771,9,8,8,14,34,41,-7,32
Portadown,3771,10,8,5,17,23,45,-22,29
Ballinamalla,3771,11,7,7,16,26,51,-25,28
Crusaders,3772,1,16,9,5,57,33,24,57
Linfield,3772,2,14,11,5,56,29,27,53
Cliftonville,3772,3,15,4,11,59,46,13,49
Ballymena,3772,4,13,10,7,60,53,7,49
Glenavon,3772,5,10,13,7,45,46,-1,43
Coleraine,3772,6,10,11,9,40,41,-1,41
Glentoran,3772,7,9,11,10,33,41,-8,38
Dungannon,3772,8,7,14,9,54,49,5,35
Portadown,3772,9,8,5,17,28,50,-22,29
Ballinamalla,3772,10,7,7,16,29,48,-19,28
Ards,3772,11,5,7,18,29,54,-25,22
Crusaders,3773,1,15,9,6,48,36,12,54
Linfield,3773,2,15,8,7,63,33,30,53
Cliftonville,3773,3,16,4,10,58,39,19,52
Ballymena,3773,4,13,8,9,65,63,2,47
Dungannon,3773,5,11,11,8,51,38,13,44
Glentoran,3773,6,11,8,11,34,44,-10,41
Glenavon,3773,7,10,10,10,40,41,-1,40
Coleraine,3773,8,9,12,9,37,42,-5,39
Portadown,3773,9,9,4,17,26,44,-18,31
Ballinamalla,3773,10,5,10,15,25,45,-20,25
Ards,3773,11,6,6,18,28,50,-22,24
Crusaders,3774,1,19,7,4,59,29,30,64
Linfield,3774,2,14,11,5,63,31,32,53
Cliftonville,3774,3,14,7,9,59,42,17,49
Ballymena,3774,4,12,10,8,59,60,-1,46
Glenavon,3774,5,10,12,8,51,48,3,42
Dungannon,3774,6,11,8,11,51,51,0,41
Coleraine,3774,7,10,9,11,47,56,-9,39
Ards,3774,8,10,7,13,45,49,-4,37
Glentoran,3774,9,6,10,14,34,56,-22,28
Portadown,3774,10,6,8,16,30,51,-21,26
Ballinamalla,3774,11,6,5,19,29,54,-25,23
Crusaders,3775,1,17,8,5,57,29,28,59
Ballymena,3775,2,15,5,10,59,56,3,50
Linfield,3775,3,13,8,9,55,39,16,47
Cliftonville,3775,4,14,4,12,58,45,13,46
Glenavon,3775,5,11,11,8,46,40,6,44
Dungannon,3775,6,11,10,9,58,44,14,43
Coleraine,3775,7,11,10,9,38,38,0,43
Ards,3775,8,11,4,15,40,47,-7,37
Glentoran,3775,9,9,5,16,29,42,-13,32
Portadown,3775,10,8,5,17,25,52,-27,29
Ballinamalla,3775,11,9,2,19,30,63,-33,29
Crusaders,3776,1,19,7,4,58,26,32,64
Ballymena,3776,2,16,7,7,59,56,3,55
Linfield,3776,3,14,8,8,60,41,19,50
Glenavon,3776,4,13,10,7,46,39,7,49
Coleraine,3776,5,12,10,8,46,38,8,46
Cliftonville,3776,6,13,6,11,46,39,7,45
Dungannon,3776,7,10,7,13,48,48,0,37
Ards,3776,8,10,4,16,39,48,-9,34
Ballinamalla,3776,9,8,7,15,31,47,-16,31
Glentoran,3776,10,8,6,16,28,44,-16,30
Portadown,3776,11,4,4,22,22,57,-35,16
Crusaders,3777,1,18,5,7,56,32,24,59
Cliftonville,3777,2,16,4,10,47,33,14,52
Coleraine,3777,3,13,11,6,44,32,12,50
Linfield,3777,4,13,9,8,52,32,20,48
Ballymena,3777,5,12,8,10,55,58,-3,44
Dungannon,3777,6,12,6,12,56,47,9,42
Glentoran,3777,7,12,5,13,34,42,-8,41
Ards,3777,8,12,4,14,40,46,-6,40
Glenavon,3777,9,9,11,10,44,45,-1,38
Portadown,3777,10,7,5,18,21,49,-28,26
Ballinamalla,3777,11,5,4,21,19,52,-33,19
Linfield,3778,1,18,8,4,62,31,31,62
Cliftonville,3778,2,16,7,7,59,33,26,55
Coleraine,3778,3,13,9,8,41,34,7,48
Glenavon,3778,4,12,9,9,50,44,6,45
Crusaders,3778,5,12,9,9,47,42,5,45
Ballymena,3778,6,12,5,13,59,64,-5,41
Dungannon,3778,7,11,6,13,45,45,0,39
Glentoran,3778,8,9,6,15,31,45,-14,33
Portadown,3778,9,10,3,17,27,48,-21,33
Ards,3778,10,9,4,17,36,49,-13,31
Ballinamalla,3778,11,9,2,19,30,52,-22,29
Crusaders,3779,1,19,6,5,63,34,29,63
Cliftonville,3779,2,15,4,11,53,41,12,49
Dungannon,3779,3,14,7,9,52,40,12,49
Coleraine,3779,4,13,10,7,48,37,11,49
Linfield,3779,5,13,9,8,57,40,17,48
Glenavon,3779,6,11,10,9,47,45,2,43
Ballymena,3779,7,13,4,13,54,59,-5,43
Glentoran,3779,8,9,6,15,27,49,-22,33
Ards,3779,9,9,5,16,36,50,-14,32
Ballinamalla,3779,10,7,5,18,33,52,-19,26
Portadown,3779,11,7,4,19,23,46,-23,25
Cliftonville,3780,1,17,4,9,58,45,13,55
Ballymena,3780,2,15,7,8,64,52,12,52
Crusaders,3780,3,14,9,7,56,41,15,51
Linfield,3780,4,13,11,6,50,32,18,50
Coleraine,3780,5,13,9,8,40,36,4,48
Dungannon,3780,6,12,9,9,62,45,17,45
Glenavon,3780,7,11,12,7,52,47,5,45
Ballinamalla,3780,8,8,5,17,29,51,-22,29
Glentoran,3780,9,7,8,15,25,47,-22,29
Ards,3780,10,7,5,18,39,54,-15,26
Portadown,3780,11,6,5,19,26,51,-25,23
Crusaders,3781,1,17,10,3,55,31,24,61
Coleraine,3781,2,14,10,6,49,34,15,52
Cliftonville,3781,3,16,3,11,56,38,18,51
Linfield,3781,4,13,10,7,55,38,17,49
Glenavon,3781,5,11,12,7,51,47,4,45
Ballymena,3781,6,11,8,11,49,57,-8,41
Glentoran,3781,7,9,9,12,33,42,-9,36
Dungannon,3781,8,8,9,13,51,55,-4,33
Ballinamalla,3781,9,9,5,16,36,50,-14,32
Ards,3781,10,8,5,17,32,48,-16,29
Portadown,3781,11,6,5,19,25,52,-27,23
Linfield,3782,1,16,10,4,60,27,33,58
Crusaders,3782,2,15,6,9,55,43,12,51
Cliftonville,3782,3,14,8,8,53,35,18,50
Glenavon,3782,4,13,10,7,51,41,10,49
Ballymena,3782,5,13,8,9,57,54,3,47
Coleraine,3782,6,9,11,10,37,43,-6,38
Dungannon,3782,7,9,10,11,51,42,9,37
Glentoran,3782,8,10,7,13,37,54,-17,37
Ballinamalla,3782,9,9,7,14,32,51,-19,34
Ards,3782,10,6,10,14,35,48,-13,28
Portadown,3782,11,4,7,19,18,48,-30,19
Ballymena,3783,1,17,6,7,73,55,18,57
Cliftonville,3783,2,17,4,9,63,42,21,55
Crusaders,3783,3,15,9,6,61,37,24,54
Glenavon,3783,4,12,11,7,45,42,3,47
Linfield,3783,5,12,9,9,53,31,22,45
Coleraine,3783,6,10,9,11,42,41,1,39
Ballinamalla,3783,7,11,3,16,33,47,-14,36
Dungannon,3783,8,8,10,12,52,56,-4,34
Glentoran,3783,9,9,6,15,31,53,-22,33
Ards,3783,10,7,7,16,34,53,-19,28
Portadown,3783,11,8,4,18,23,53,-30,28
Crusaders,3784,1,17,10,3,54,30,24,61
Coleraine,3784,2,15,8,7,44,28,16,53
Linfield,3784,3,14,7,9,67,38,29,49
Cliftonville,3784,4,15,4,11,59,45,14,49
Ballymena,3784,5,14,6,10,54,55,-1,48
Glenavon,3784,6,10,12,8,41,45,-4,42
Dungannon,3784,7,8,11,11,43,44,-1,35
Ards,3784,8,9,5,16,35,47,-12,32
Glentoran,3784,9,7,10,13,28,47,-19,31
Ballinamalla,3784,10,8,4,18,31,56,-25,28
Portadown,3784,11,7,5,18,24,45,-21,26
Crusaders,3785,1,14,12,4,59,40,19,54
Coleraine,3785,2,14,9,7,46,31,15,51
Linfield,3785,3,13,11,6,56,30,26,50
Ballymena,3785,4,13,8,9,60,63,-3,47
Cliftonville,3785,5,13,6,11,47,44,3,45
Dungannon,3785,6,10,10,10,53,43,10,40
Ards,3785,7,11,6,13,44,45,-1,39
Glenavon,3785,8,9,8,13,43,53,-10,35
Portadown,3785,9,9,7,14,24,38,-14,34
Glentoran,3785,10,6,11,13,32,52,-20,29
Ballinamalla,3785,11,7,4,19,31,56,-25,25
Linfield,3786,1,15,9,6,58,28,30,54
Cliftonville,3786,2,17,3,10,61,40,21,54
Crusaders,3786,3,14,7,9,47,34,13,49
Coleraine,3786,4,13,10,7,48,36,12,49
Ballymena,3786,5,14,6,10,63,60,3,48
Glenavon,3786,6,11,10,9,50,53,-3,43
Glentoran,3786,7,8,12,10,31,43,-12,36
Dungannon,3786,8,9,7,14,46,49,-3,34
Ballinamalla,3786,9,9,4,17,35,60,-25,31
Ards,3786,10,8,5,17,39,49,-10,29
Portadown,3786,11,8,5,17,27,53,-26,29
Crusaders,3787,1,17,7,6,66,37,29,58
Cliftonville,3787,2,16,5,9,56,38,18,53
Ballymena,3787,3,15,7,8,63,58,5,52
Linfield,3787,4,11,13,6,54,33,21,46
Coleraine,3787,5,9,13,8,37,37,0,40
Glenavon,3787,6,10,9,11,43,44,-1,39
Dungannon,3787,7,10,8,12,49,48,1,38
Ards,3787,8,10,6,14,40,44,-4,36
Glentoran,3787,9,8,10,12,31,43,-12,34
Portadown,3787,10,9,5,16,23,43,-20,32
Ballinamalla,3787,11,7,3,20,27,64,-37,24
Linfield,3788,1,16,9,5,64,30,34,57
Ballymena,3788,2,16,6,8,60,55,5,54
Crusaders,3788,3,15,8,7,57,43,14,53
Coleraine,3788,4,12,10,8,42,37,5,46
Glenavon,3788,5,12,9,9,50,48,2,45
Cliftonville,3788,6,13,5,12,54,48,6,44
Portadown,3788,7,9,8,13,26,37,-11,35
Glentoran,3788,8,9,6,15,28,43,-15,33
Ballinamalla,3788,9,9,5,16,32,48,-16,32
Dungannon,3788,10,7,9,14,47,50,-3,30
Ards,3788,11,7,5,18,27,48,-21,26
Linfield,3789,1,15,9,6,65,39,26,54
Cliftonville,3789,2,16,6,8,53,39,14,54
Crusaders,3789,3,15,6,9,56,41,15,51
Coleraine,3789,4,13,11,6,52,34,18,50
Ballymena,3789,5,14,6,10,54,54,0,48
Glenavon,3789,6,9,12,9,44,46,-2,39
Glentoran,3789,7,11,6,13,35,44,-9,39
Dungannon,3789,8,9,10,11,53,49,4,37
Ards,3789,9,8,5,17,42,57,-15,29
Portadown,3789,10,7,7,16,24,50,-26,28
Ballinamalla,3789,11,7,4,19,34,59,-25,25
Linfield,3790,1,16,8,6,64,29,35,56
Cliftonville,3790,2,17,3,10,51,37,14,54
Crusaders,3790,3,16,5,9,60,48,12,53
Ballymena,3790,4,16,5,9,57,54,3,53
Glenavon,3790,5,10,12,8,51,48,3,42
Dungannon,3790,6,10,10,10,57,47,10,40
Glentoran,3790,7,10,7,13,42,45,-3,37
Coleraine,3790,8,9,10,11,38,43,-5,37
Ards,3790,9,10,6,14,40,50,-10,36
Portadown,3790,10,6,7,17,25,50,-25,25
Ballinamalla,3790,11,6,5,19,25,59,-34,23
Crusaders,3791,1,16,8,6,55,33,22,56
Ballymena,3791,2,17,5,8,61,53,8,56
Linfield,3791,3,14,9,7,62,40,22,51
Cliftonville,3791,4,16,3,11,52,44,8,51
Coleraine,3791,5,12,11,7,47,38,9,47
Dungannon,3791,6,12,8,10,45,47,-2,44
Glenavon,3791,7,9,10,11,45,43,2,37
Ards,3791,8,8,4,18,35,49,-14,28
Ballinamalla,3791,9,7,7,16,30,48,-18,28
Glentoran,3791,10,6,10,14,26,46,-20,28
Portadown,3791,11,6,9,15,28,45,-17,27
Linfield,3792,1,18,8,4,63,28,35,62
Crusaders,3792,2,19,4,7,59,37,22,61
Cliftonville,3792,3,17,4,9,56,34,22,55
Ballymena,3792,4,15,5,10,61,56,5,50
Coleraine,3792,5,12,9,9,42,35,7,45
Dungannon,3792,6,11,9,10,52,44,8,42
Glenavon,3792,7,9,10,11,42,51,-9,37
Glentoran,3792,8,10,6,14,35,46,-11,36
Ards,3792,9,9,6,15,32,46,-14,33
Ballinamalla,3792,10,5,6,19,29,58,-29,21
Portadown,3792,11,4,5,21,17,53,-36,17
Crusaders,3793,1,16,8,6,52,29,23,56
Cliftonville,3793,2,16,4,10,45,33,12,52
Linfield,3793,3,13,10,7,59,38,21,49
Coleraine,3793,4,13,10,7,46,32,14,49
Dungannon,3793,5,11,9,10,52,42,10,42
Ards,3793,6,12,5,13,44,49,-5,41
Glenavon,3793,7,10,10,10,44,52,-8,40
Ballymena,3793,8,10,6,14,45,61,-16,36
Portadown,3793,9,9,6,15,36,44,-8,33
Ballinamalla,3793,10,9,5,16,36,52,-16,32
Glentoran,3793,11,5,9,16,20,47,-27,24
Linfield,3794,1,17,9,4,69,29,40,60
Crusaders,3794,2,16,8,6,57,32,25,56
Cliftonville,3794,3,16,5,9,51,35,16,53
Ballymena,3794,4,13,7,10,48,57,-9,46
Coleraine,3794,5,11,11,8,38,36,2,44
Glenavon,3794,6,11,9,10,46,39,7,42
Portadown,3794,7,11,5,14,28,40,-12,38
Glentoran,3794,8,8,11,11,25,34,-9,35
Dungannon,3794,9,6,11,13,42,53,-11,29
Ards,3794,10,8,5,17,30,47,-17,29
Ballinamalla,3794,11,6,3,21,22,54,-32,21
Cliftonville,3795,1,19,3,8,62,34,28,60
Linfield,3795,2,17,8,5,60,24,36,59
Crusaders,3795,3,14,8,8,48,37,11,50
Ballymena,3795,4,13,6,11,54,53,1,45
Dungannon,3795,5,10,10,10,42,36,6,40
Glenavon,3795,6,10,10,10,40,44,-4,40
Ards,3795,7,11,5,14,39,47,-8,38
Coleraine,3795,8,9,9,12,36,45,-9,36
Glentoran,3795,9,9,6,15,31,47,-16,33
Portadown,3795,10,10,2,18,26,51,-25,32
Ballinamalla,3795,11,7,5,18,25,45,-20,26
Linfield,3796,1,16,11,3,63,30,33,59
Crusaders,3796,2,16,8,6,57,34,23,56
Cliftonville,3796,3,14,6,10,53,41,12,48
Glentoran,3796,4,13,6,11,38,44,-6,45
Coleraine,3796,5,11,10,9,43,37,6,43
Glenavon,3796,6,10,11,9,48,46,2,41
Ballymena,3796,7,11,8,11,56,63,-7,41
Portadown,3796,8,11,4,15,28,38,-10,37
Dungannon,3796,9,7,9,14,46,57,-11,30
Ballinamalla,3796,10,9,2,19,36,58,-22,29
Ards,3796,11,7,5,18,37,57,-20,26
Dungannon,3797,1,16,7,7,59,40,19,55
Cliftonville,3797,2,17,3,10,53,38,15,54
Crusaders,3797,3,16,5,9,50,35,15,53
Ballymena,3797,4,15,4,11,67,71,-4,49
Linfield,3797,5,13,9,8,53,29,24,48
Coleraine,3797,6,12,10,8,41,34,7,46
Glenavon,3797,7,10,11,9,43,44,-1,41
Portadown,3797,8,11,3,16,36,46,-10,36
Glentoran,3797,9,8,9,13,36,47,-11,33
Ards,3797,10,8,2,20,32,53,-21,26
Ballinamalla,3797,11,6,3,21,24,57,-33,21
Crusaders,3798,1,17,8,5,56,35,21,59
Ballymena,3798,2,16,6,8,65,54,11,54
Cliftonville,3798,3,16,3,11,49,38,11,51
Linfield,3798,4,14,7,9,62,41,21,49
Glenavon,3798,5,12,11,7,51,43,8,47
Coleraine,3798,6,11,9,10,40,44,-4,42
Glentoran,3798,7,11,8,11,36,39,-3,41
Dungannon,3798,8,9,8,13,43,40,3,35
Ballinamalla,3798,9,9,4,17,35,51,-16,31
Portadown,3798,10,8,2,20,24,47,-23,26
Ards,3798,11,7,4,19,30,59,-29,25
Crusaders,3799,1,18,6,6,57,32,25,60
Ballymena,3799,2,14,8,8,62,55,7,50
Linfield,3799,3,13,10,7,58,42,16,49
Dungannon,3799,4,13,8,9,62,47,15,47
Cliftonville,3799,5,13,6,11,51,41,10,45
Glenavon,3799,6,11,9,10,50,55,-5,42
Coleraine,3799,7,10,9,11,42,40,2,39
Glentoran,3799,8,7,11,12,40,51,-11,32
Portadown,3799,9,9,5,16,35,52,-17,32
Ballinamalla,3799,10,8,5,17,30,52,-22,29
Ards,3799,11,7,7,16,36,56,-20,28
Ballymena,3800,1,18,3,9,67,54,13,57
Crusaders,3800,2,17,5,8,59,39,20,56
Cliftonville,3800,3,16,5,9,59,46,13,53
Linfield,3800,4,13,9,8,58,34,24,48
Coleraine,3800,5,13,9,8,41,32,9,48
Glenavon,3800,6,13,9,8,43,46,-3,48
Dungannon,3800,7,8,11,11,49,45,4,35
Glentoran,3800,8,7,8,15,30,46,-16,29
Portadown,3800,9,8,5,17,33,60,-27,29
Ards,3800,10,7,7,16,39,54,-15,28
Ballinamalla,3800,11,6,7,17,26,48,-22,25
Crusaders,3801,1,14,11,5,57,35,22,53
Ballymena,3801,2,15,8,7,62,56,6,53
Linfield,3801,3,14,9,7,63,38,25,51
Coleraine,3801,4,13,10,7,49,41,8,49
Cliftonville,3801,5,13,6,11,51,45,6,45
Dungannon,3801,6,11,10,9,50,38,12,43
Glenavon,3801,7,9,13,8,47,45,2,40
Ards,3801,8,11,3,16,37,51,-14,36
Glentoran,3801,9,7,8,15,30,50,-20,29
Portadown,3801,10,6,9,15,25,43,-18,27
Ballinamalla,3801,11,5,7,18,27,56,-29,22
Linfield,3802,1,15,8,7,51,30,21,53
Cliftonville,3802,2,16,5,9,49,36,13,53
Ballymena,3802,3,15,7,8,66,57,9,52
Crusaders,3802,4,14,8,8,58,37,21,50
Glenavon,3802,5,11,10,9,48,49,-1,43
Coleraine,3802,6,9,11,10,41,42,-1,38
Ballinamalla,3802,7,11,4,15,34,48,-14,37
Ards,3802,8,9,8,13,35,44,-9,35
Portadown,3802,9,8,8,14,23,43,-20,32
Glentoran,3802,10,7,10,13,26,39,-13,31
Dungannon,3802,11,6,9,15,42,48,-6,27
Cliftonville,3803,1,17,5,8,51,36,15,56
Crusaders,3803,2,15,9,6,60,37,23,54
Coleraine,3803,3,13,12,5,47,32,15,51
Linfield,3803,4,10,12,8,47,36,11,42
Ballinamalla,3803,5,13,3,14,40,45,-5,42
Dungannon,3803,6,10,11,9,52,42,10,41
Glenavon,3803,7,9,13,8,44,43,1,40
Ballymena,3803,8,10,8,12,51,56,-5,38
Glentoran,3803,9,9,7,14,32,49,-17,34
Ards,3803,10,8,5,17,32,47,-15,29
Portadown,3803,11,6,5,19,16,49,-33,23
Crusaders,3804,1,19,7,4,61,32,29,64
Linfield,3804,2,15,9,6,55,26,29,54
Cliftonville,3804,3,14,6,10,48,38,10,48
Ballymena,3804,4,13,8,9,57,57,0,47
Coleraine,3804,5,11,11,8,41,37,4,44
Dungannon,3804,6,10,10,10,50,40,10,40
Ards,3804,7,12,3,15,39,43,-4,39
Glentoran,3804,8,10,8,12,32,42,-10,38
Glenavon,3804,9,7,12,11,40,49,-9,33
Portadown,3804,10,5,8,17,24,48,-24,23
Ballinamalla,3804,11,7,2,21,24,59,-35,23
Linfield,3805,1,16,8,6,60,35,25,56
Ballymena,3805,2,16,7,7,63,53,10,55
Cliftonville,3805,3,14,4,12,53,43,10,46
Dungannon,3805,4,12,9,9,56,42,14,45
Crusaders,3805,5,12,9,9,50,37,13,45
Glenavon,3805,6,11,11,8,45,46,-1,44
Coleraine,3805,7,10,12,8,42,36,6,42
Ballinamalla,3805,8,12,4,14,38,50,-12,40
Glentoran,3805,9,8,11,11,38,44,-6,35
Ards,3805,10,8,5,17,36,49,-13,29
Portadown,3805,11,4,4,22,22,68,-46,16
Linfield,3806,1,13,12,5,57,30,27,51
Cliftonville,3806,2,16,3,11,53,40,13,51
Glenavon,3806,3,12,11,7,47,38,9,47
Coleraine,3806,4,12,10,8,41,39,2,46
Crusaders,3806,5,13,6,11,50,41,9,45
Dungannon,3806,6,12,8,10,51,43,8,44
Ballymena,3806,7,13,4,13,57,63,-6,43
Glentoran,3806,8,12,5,13,32,40,-8,41
Ards,3806,9,11,7,12,43,43,0,40
Portadown,3806,10,9,6,15,32,48,-16,33
Ballinamalla,3806,11,4,4,22,23,61,-38,16
Crusaders,3807,1,16,10,4,60,37,23,58
Linfield,3807,2,14,13,3,68,36,32,55
Cliftonville,3807,3,14,5,11,52,43,9,47
Ballymena,3807,4,12,8,10,49,59,-10,44
Coleraine,3807,5,11,10,9,44,42,2,43
Glenavon,3807,6,11,8,11,43,45,-2,41
Dungannon,3807,7,11,7,12,55,47,8,40
Ards,3807,8,10,7,13,43,52,-9,37
Ballinamalla,3807,9,11,3,16,42,53,-11,36
Glentoran,3807,10,8,7,15,25,43,-18,31
Portadown,3807,11,6,4,20,24,48,-24,22
Crusaders,3808,1,18,9,3,60,28,32,63
Linfield,3808,2,15,10,5,57,27,30,55
Cliftonville,3808,3,13,8,9,48,44,4,47
Coleraine,3808,4,11,11,8,48,44,4,44
Glenavon,3808,5,10,12,8,48,45,3,42
Ballymena,3808,6,11,8,11,53,58,-5,41
Glentoran,3808,7,11,8,11,33,40,-7,41
Portadown,3808,8,11,3,16,29,47,-18,36
Dungannon,3808,9,7,9,14,45,46,-1,30
Ards,3808,10,8,6,16,44,58,-14,30
Ballinamalla,3808,11,5,6,19,33,61,-28,21
Linfield,3809,1,15,11,4,62,28,34,56
Crusaders,3809,2,14,8,8,47,29,18,50
Ballymena,3809,3,14,7,9,58,60,-2,49
Glenavon,3809,4,11,11,8,50,40,10,44
Coleraine,3809,5,11,10,9,46,37,9,43
Cliftonville,3809,6,11,7,12,45,42,3,40
Portadown,3809,7,10,7,13,28,41,-13,37
Glentoran,3809,8,9,9,12,28,42,-14,36
Dungannon,3809,9,8,9,13,42,48,-6,33
Ballinamalla,3809,10,10,3,17,29,49,-20,33
Ards,3809,11,9,4,17,35,54,-19,31
Crusaders,3810,1,15,11,4,56,33,23,56
Cliftonville,3810,2,15,5,10,58,42,16,50
Linfield,3810,3,12,10,8,64,39,25,46
Glenavon,3810,4,12,10,8,46,42,4,46
Ballymena,3810,5,13,7,10,61,58,3,46
Dungannon,3810,6,11,10,9,49,44,5,43
Portadown,3810,7,10,8,12,31,42,-11,38
Glentoran,3810,8,10,8,12,33,45,-12,38
Ards,3810,9,8,10,12,36,43,-7,34
Coleraine,3810,10,8,9,13,37,49,-12,33
Ballinamalla,3810,11,5,4,21,21,55,-34,19
Crusaders,3811,1,20,5,5,59,32,27,65
Coleraine,3811,2,15,9,6,53,39,14,54
Ballymena,3811,3,16,5,9,54,49,5,53
Linfield,3811,4,12,9,9,55,39,16,45
Glenavon,3811,5,11,10,9,49,45,4,43
Glentoran,3811,6,13,4,13,29,43,-14,43
Dungannon,3811,7,10,8,12,48,44,4,38
Ards,3811,8,11,5,14,41,43,-2,38
Cliftonville,3811,9,9,8,13,41,40,1,35
Portadown,3811,10,8,5,17,31,48,-17,29
Ballinamalla,3811,11,4,4,22,20,58,-38,16
Crusaders,3812,1,16,10,4,56,30,26,58
Cliftonville,3812,2,17,4,9,57,45,12,55
Ballymena,3812,3,15,7,8,62,54,8,52
Linfield,3812,4,13,10,7,54,28,26,49
Dungannon,3812,5,12,9,9,54,41,13,45
Glenavon,3812,6,10,10,10,45,46,-1,40
Coleraine,3812,7,9,11,10,36,41,-5,38
Glentoran,3812,8,9,8,13,30,41,-11,35
Ards,3812,9,8,6,16,37,56,-19,30
Ballinamalla,3812,10,8,4,18,30,50,-20,28
Portadown,3812,11,6,5,19,22,51,-29,23
Crusaders,3813,1,19,5,6,61,30,31,62
Coleraine,3813,2,14,10,6,47,30,17,52
Linfield,3813,3,13,8,9,61,37,24,47
Ballymena,3813,4,14,5,11,58,59,-1,47
Cliftonville,3813,5,14,4,12,44,44,0,46
Dungannon,3813,6,12,8,10,52,40,12,44
Glenavon,3813,7,12,7,11,42,44,-2,43
Glentoran,3813,8,9,6,15,29,41,-12,33
Portadown,3813,9,10,3,17,31,52,-21,33
Ards,3813,10,7,9,14,32,48,-16,30
Ballinamalla,3813,11,6,5,19,23,55,-32,23
Crusaders,3814,1,17,7,6,61,40,21,58
Cliftonville,3814,2,16,6,8,50,42,8,54
Linfield,3814,3,14,8,8,61,34,27,50
Glenavon,3814,4,12,11,7,53,42,11,47
Coleraine,3814,5,12,9,9,48,39,9,45
Dungannon,3814,6,11,9,10,54,41,13,42
Ballymena,3814,7,12,4,14,50,63,-13,40
Glentoran,3814,8,10,7,13,25,35,-10,37
Ards,3814,9,9,5,16,39,53,-14,32
Ballinamalla,3814,10,8,5,17,33,57,-24,29
Portadown,3814,11,6,5,19,23,51,-28,23
Cliftonville,3815,1,16,5,9,54,33,21,53
Glenavon,3815,2,13,12,5,52,42,10,51
Linfield,3815,3,14,8,8,53,34,19,50
Ballymena,3815,4,15,4,11,60,60,0,49
Crusaders,3815,5,13,9,8,58,45,13,48
Coleraine,3815,6,11,12,7,41,36,5,45
Dungannon,3815,7,8,11,11,49,46,3,35
Ballinamalla,3815,8,10,4,16,39,51,-12,34
Glentoran,3815,9,8,8,14,31,52,-21,32
Ards,3815,10,8,7,15,32,47,-15,31
Portadown,3815,11,6,6,18,28,51,-23,24
Crusaders,3816,1,18,5,7,57,34,23,59
Linfield,3816,2,14,11,5,66,37,29,53
Ballymena,3816,3,16,5,9,56,51,5,53
Cliftonville,3816,4,14,5,11,46,35,11,47
Glenavon,3816,5,13,8,9,51,48,3,47
Ards,3816,6,10,7,13,42,47,-5,37
Coleraine,3816,7,9,10,11,38,44,-6,37
Glentoran,3816,8,10,6,14,35,50,-15,36
Dungannon,3816,9,8,9,13,44,48,-4,33
Ballinamalla,3816,10,8,6,16,24,42,-18,30
Portadown,3816,11,6,6,18,25,48,-23,24
Ballymena,3817,1,16,4,10,57,55,2,52
Cliftonville,3817,2,15,5,10,50,39,11,50
Ballinamalla,3817,3,15,2,13,34,42,-8,47
Crusaders,3817,4,13,7,10,47,37,10,46
Linfield,3817,5,12,9,9,50,37,13,45
Glenavon,3817,6,11,11,8,49,49,0,44
Dungannon,3817,7,11,9,10,46,38,8,42
Coleraine,3817,8,9,12,9,38,34,4,39
Ards,3817,9,9,5,16,36,47,-11,32
Portadown,3817,10,8,6,16,26,39,-13,30
Glentoran,3817,11,8,6,16,28,44,-16,30
Crusaders,3818,1,16,7,7,53,40,13,55
Linfield,3818,2,14,9,7,60,29,31,51
Cliftonville,3818,3,15,5,10,52,36,16,50
Glenavon,3818,4,13,11,6,53,45,8,50
Ballymena,3818,5,14,5,11,59,60,-1,47
Coleraine,3818,6,11,11,8,43,37,6,44
Dungannon,3818,7,10,11,9,49,37,12,41
Glentoran,3818,8,8,10,12,33,50,-17,34
Ards,3818,9,8,5,17,33,48,-15,29
Portadown,3818,10,7,5,18,25,50,-25,26
Ballinamalla,3818,11,7,5,18,27,55,-28,26
Linfield,3819,1,14,10,6,59,33,26,52
Cliftonville,3819,2,15,6,9,52,38,14,51
Crusaders,3819,3,14,8,8,47,32,15,50
Ballymena,3819,4,14,8,8,57,58,-1,50
Coleraine,3819,5,12,11,7,40,32,8,47
Dungannon,3819,6,11,9,10,55,43,12,42
Glenavon,3819,7,10,10,10,40,40,0,40
Glentoran,3819,8,10,5,15,28,41,-13,35
Ards,3819,9,7,8,15,37,49,-12,29
Ballinamalla,3819,10,8,5,17,26,49,-23,29
Portadown,3819,11,8,4,18,26,52,-26,28
Cliftonville,3820,1,16,5,9,50,37,13,53
Crusaders,3820,2,14,10,6,50,34,16,52
Ballymena,3820,3,15,6,9,61,58,3,51
Linfield,3820,4,13,10,7,55,35,20,49
Dungannon,3820,5,10,12,8,52,37,15,42
Glenavon,3820,6,10,12,8,47,46,1,42
Coleraine,3820,7,9,12,9,42,40,2,39
Ards,3820,8,10,7,13,42,49,-7,37
Glentoran,3820,9,8,10,12,33,43,-10,34
Ballinamalla,3820,10,8,3,19,30,51,-21,27
Portadown,3820,11,6,5,19,17,49,-32,23
Cliftonville,3821,1,19,4,7,55,35,20,61
Crusaders,3821,2,17,6,7,58,32,26,57
Ballymena,3821,3,14,7,9,55,52,3,49
Linfield,3821,4,13,9,8,52,31,21,48
Coleraine,3821,5,13,7,10,37,36,1,46
Glenavon,3821,6,12,9,9,51,47,4,45
Dungannon,3821,7,10,9,11,47,44,3,39
Ards,3821,8,10,4,16,41,49,-8,34
Glentoran,3821,9,8,8,14,32,43,-11,32
Portadown,3821,10,8,7,15,26,43,-17,31
Ballinamalla,3821,11,5,2,23,22,64,-42,17
Ballymena,3822,1,17,6,7,69,55,14,57
Crusaders,3822,2,13,11,6,51,37,14,50
Glenavon,3822,3,13,10,7,56,48,8,49
Cliftonville,3822,4,14,6,10,58,40,18,48
Coleraine,3822,5,12,10,8,48,40,8,46
Linfield,3822,6,10,11,9,49,36,13,41
Dungannon,3822,7,10,8,12,51,56,-5,38
Glentoran,3822,8,10,6,14,32,42,-10,36
Ards,3822,9,10,3,17,39,50,-11,33
Ballinamalla,3822,10,8,6,16,35,51,-16,30
Portadown,3822,11,6,7,17,28,61,-33,25
Crusaders,3823,1,18,6,6,61,38,23,60
Linfield,3823,2,15,7,8,59,35,24,52
Ballymena,3823,3,14,6,10,57,57,0,48
Cliftonville,3823,4,14,5,11,51,41,10,47
Glenavon,3823,5,12,10,8,43,42,1,46
Coleraine,3823,6,11,11,8,45,44,1,44
Glentoran,3823,7,12,7,11,34,39,-5,43
Dungannon,3823,8,8,7,15,48,54,-6,31
Ards,3823,9,8,6,16,39,50,-11,30
Portadown,3823,10,7,9,14,27,42,-15,30
Ballinamalla,3823,11,7,4,19,32,54,-22,25
Linfield,3824,1,16,8,6,56,27,29,56
Crusaders,3824,2,16,8,6,56,34,22,56
Cliftonville,3824,3,17,2,11,56,37,19,53
Ballymena,3824,4,14,6,10,58,59,-1,48
Glenavon,3824,5,12,11,7,46,40,6,47
Dungannon,3824,6,11,8,11,48,42,6,41
Coleraine,3824,7,10,11,9,42,37,5,41
Glentoran,3824,8,8,10,12,32,45,-13,34
Ards,3824,9,10,3,17,37,52,-15,33
Portadown,3824,10,8,4,18,26,54,-28,28
Ballinamalla,3824,11,5,5,20,25,55,-30,20
Crusaders,3825,1,18,8,4,54,29,25,62
Linfield,3825,2,13,10,7,56,35,21,49
Coleraine,3825,3,13,10,7,40,32,8,49
Cliftonville,3825,4,13,5,12,44,43,1,44
Dungannon,3825,5,11,10,9,56,44,12,43
Ballymena,3825,6,12,7,11,54,62,-8,43
Glenavon,3825,7,9,13,8,52,47,5,40
Glentoran,3825,8,8,9,13,30,42,-12,33
Ards,3825,9,7,8,15,34,47,-13,29
Portadown,3825,10,8,5,17,28,45,-17,29
Ballinamalla,3825,11,6,9,15,26,48,-22,27
Crusaders,3826,1,17,8,5,53,27,26,59
Cliftonville,3826,2,14,8,8,53,36,17,50
Ballymena,3826,3,14,7,9,52,54,-2,49
Linfield,3826,4,12,10,8,48,37,11,46
Glenavon,3826,5,10,12,8,50,47,3,42
Glentoran,3826,6,11,6,13,36,42,-6,39
Dungannon,3826,7,8,12,10,47,44,3,36
Ards,3826,8,10,5,15,40,43,-3,35
Coleraine,3826,9,8,11,11,35,39,-4,35
Ballinamalla,3826,10,8,6,16,32,53,-21,30
Portadown,3826,11,6,9,15,23,47,-24,27
Crusaders,3827,1,18,8,4,55,26,29,62
Ballymena,3827,2,19,4,7,64,47,17,61
Linfield,3827,3,13,11,6,55,32,23,50
Cliftonville,3827,4,13,7,10,50,42,8,46
Glenavon,3827,5,11,12,7,44,45,-1,45
Coleraine,3827,6,10,12,8,34,32,2,42
Dungannon,3827,7,9,9,12,48,48,0,36
Portadown,3827,8,8,6,16,27,47,-20,30
Ballinamalla,3827,9,8,5,17,28,49,-21,29
Ards,3827,10,7,5,18,35,51,-16,26
Glentoran,3827,11,7,5,18,24,45,-21,26
Crusaders,3828,1,14,10,6,56,40,16,52
Cliftonville,3828,2,15,6,9,51,34,17,51
Ballymena,3828,3,15,5,10,68,63,5,50
Dungannon,3828,4,13,9,8,57,38,19,48
Linfield,3828,5,12,10,8,55,36,19,46
Coleraine,3828,6,11,8,11,39,40,-1,41
Glenavon,3828,7,9,13,8,45,47,-2,40
Ards,3828,8,10,7,13,43,47,-4,37
Glentoran,3828,9,9,8,13,36,48,-12,35
Portadown,3828,10,7,6,17,21,48,-27,27
Ballinamalla,3828,11,6,6,18,32,62,-30,24
Crusaders,3829,1,18,6,6,73,38,35,60
Linfield,3829,2,13,14,3,62,29,33,53
Glenavon,3829,3,13,10,7,45,38,7,49
Ballymena,3829,4,13,9,8,55,55,0,48
Cliftonville,3829,5,14,5,11,56,46,10,47
Coleraine,3829,6,12,9,9,39,37,2,45
Glentoran,3829,7,11,8,11,38,48,-10,41
Dungannon,3829,8,7,10,13,47,52,-5,31
Ards,3829,9,7,6,17,31,53,-22,27
Portadown,3829,10,8,2,20,26,47,-21,26
Ballinamalla,3829,11,7,5,18,25,54,-29,26
Linfield,3830,1,18,8,4,63,26,37,62
Crusaders,3830,2,16,7,7,57,37,20,55
Cliftonville,3830,3,17,4,9,59,47,12,55
Ballymena,3830,4,14,6,10,56,56,0,48
Coleraine,3830,5,12,9,9,43,36,7,45
Glentoran,3830,6,11,6,13,33,43,-10,39
Dungannon,3830,7,9,9,12,46,45,1,36
Glenavon,3830,8,9,9,12,38,46,-8,36
Ards,3830,9,10,3,17,38,46,-8,33
Portadown,3830,10,8,5,17,24,42,-18,29
Ballinamalla,3830,11,6,4,20,23,56,-33,22
Cliftonville,3831,1,16,6,8,56,40,16,54
Linfield,3831,2,14,11,5,57,26,31,53
Glenavon,3831,3,13,11,6,55,48,7,50
Ballymena,3831,4,14,7,9,60,60,0,49
Crusaders,3831,5,13,6,11,53,50,3,45
Coleraine,3831,6,10,10,10,44,45,-1,40
Dungannon,3831,7,9,9,12,49,50,-1,36
Ballinamalla,3831,8,8,7,15,32,48,-16,31
Glentoran,3831,9,7,10,13,30,48,-18,31
Ards,3831,10,7,9,14,38,48,-10,30
Portadown,3831,11,8,6,16,30,41,-11,30
Cliftonville,3832,1,20,4,6,62,34,28,64
Crusaders,3832,2,16,8,6,58,39,19,56
Linfield,3832,3,13,11,6,55,29,26,50
Coleraine,3832,4,14,8,8,41,39,2,50
Ballymena,3832,5,12,7,11,65,63,2,43
Dungannon,3832,6,11,9,10,45,40,5,42
Glenavon,3832,7,10,10,10,46,42,4,40
Ballinamalla,3832,8,12,4,14,39,50,-11,40
Glentoran,3832,9,7,7,16,30,48,-18,28
Ards,3832,10,7,5,18,35,52,-17,26
Portadown,3832,11,5,3,22,16,56,-40,18
Crusaders,3833,1,16,8,6,55,33,22,56
Cliftonville,3833,2,16,7,7,53,34,19,55
Linfield,3833,3,13,11,6,60,32,28,50
Coleraine,3833,4,13,11,6,48,36,12,50
Ballymena,3833,5,14,7,9,53,56,-3,49
Glenavon,3833,6,12,8,10,46,42,4,44
Dungannon,3833,7,10,10,10,46,43,3,40
Glentoran,3833,8,9,7,14,30,45,-15,34
Ards,3833,9,8,5,17,32,47,-15,29
Portadown,3833,10,6,6,18,20,46,-26,24
Ballinamalla,3833,11,5,6,19,24,53,-29,21
Cliftonville,3834,1,17,6,7,56,37,19,57
Ballymena,3834,2,18,3,9,60,55,5,57
Crusaders,3834,3,16,6,8,57,35,22,54
Linfield,3834,4,15,8,7,59,36,23,53
Coleraine,3834,5,8,13,9,34,37,-3,37
Glenavon,3834,6,8,12,10,42,50,-8,36
Ards,3834,7,10,5,15,36,43,-7,35
Portadown,3834,8,9,8,13,30,40,-10,35
Dungannon,3834,9,8,7,15,51,49,2,31
Ballinamalla,3834,10,9,4,17,29,51,-22,31
Glentoran,3834,11,7,8,15,28,49,-21,29
Crusaders,3835,1,21,6,3,65,33,32,69
Coleraine,3835,2,14,7,9,51,40,11,49
Linfield,3835,3,13,6,11,60,42,18,45
Cliftonville,3835,4,13,6,11,47,43,4,45
Ballymena,3835,5,13,4,13,61,67,-6,43
Glenavon,3835,6,10,11,9,46,49,-3,41
Dungannon,3835,7,10,10,10,52,48,4,40
Glentoran,3835,8,11,7,12,35,41,-6,40
Ards,3835,9,9,5,16,39,52,-13,32
Ballinamalla,3835,10,10,2,18,38,55,-17,32
Portadown,3835,11,5,8,17,23,47,-24,23
Linfield,3836,1,16,8,6,57,26,31,56
Ballymena,3836,2,16,5,9,65,55,10,53
Crusaders,3836,3,14,10,6,50,33,17,52
Cliftonville,3836,4,15,6,9,48,36,12,51
Dungannon,3836,5,11,9,10,54,43,11,42
Glenavon,3836,6,9,13,8,41,43,-2,40
Coleraine,3836,7,8,14,8,34,39,-5,38
Glentoran,3836,8,9,9,12,32,41,-9,36
Portadown,3836,9,9,3,18,27,51,-24,30
Ards,3836,10,6,8,16,34,47,-13,26
Ballinamalla,3836,11,5,9,16,29,57,-28,24
Crusaders,3837,1,16,9,5,62,38,24,57
Glenavon,3837,2,13,12,5,50,42,8,51
Linfield,3837,3,13,11,6,55,29,26,50
Coleraine,3837,4,12,10,8,45,40,5,46
Ballymena,3837,5,13,7,10,61,60,1,46
Cliftonville,3837,6,13,6,11,53,45,8,45
Dungannon,3837,7,9,10,11,52,45,7,37
Ballinamalla,3837,8,9,7,14,33,47,-14,34
Glentoran,3837,9,7,10,13,27,45,-18,31
Ards,3837,10,7,7,16,34,55,-21,28
Portadown,3837,11,7,3,20,32,58,-26,24
Linfield,3838,1,16,10,4,60,27,33,58
Crusaders,3838,2,16,8,6,57,35,22,56
Ballymena,3838,3,15,7,8,63,59,4,52
Cliftonville,3838,4,15,6,9,49,33,16,51
Coleraine,3838,5,12,10,8,44,40,4,46
Glenavon,3838,6,8,15,7,44,46,-2,39
Dungannon,3838,7,9,9,12,51,48,3,36
Portadown,3838,8,8,6,16,29,48,-19,30
Ards,3838,9,8,5,17,35,49,-14,29
Ballinamalla,3838,10,8,4,18,30,53,-23,28
Glentoran,3838,11,7,6,17,25,49,-24,27
Crusaders,3839,1,18,8,4,60,28,32,62
Linfield,3839,2,13,10,7,55,34,21,49
Cliftonville,3839,3,14,7,9,51,34,17,49
Coleraine,3839,4,12,9,9,40,43,-3,45
Dungannon,3839,5,11,11,8,49,38,11,44
Glenavon,3839,6,11,10,9,45,41,4,43
Ballymena,3839,7,12,7,11,45,53,-8,43
Glentoran,3839,8,10,11,9,35,39,-4,41
Ards,3839,9,8,3,19,34,53,-19,27
Portadown,3839,10,6,7,17,20,40,-20,25
Ballinamalla,3839,11,7,3,20,29,60,-31,24
Crusaders,3840,1,17,10,3,61,32,29,61
Coleraine,3840,2,14,8,8,43,33,10,50
Linfield,3840,3,13,8,9,57,33,24,47
Ballymena,3840,4,14,5,11,54,54,0,47
Cliftonville,3840,5,14,4,12,51,44,7,46
Glentoran,3840,6,11,9,10,31,36,-5,42
Dungannon,3840,7,10,9,11,53,49,4,39
Portadown,3840,8,10,4,16,27,45,-18,34
Glenavon,3840,9,8,9,13,36,45,-9,33
Ballinamalla,3840,10,9,6,15,33,51,-18,33
Ards,3840,11,7,4,19,33,57,-24,25
Crusaders,3841,1,18,7,5,60,36,24,61
Cliftonville,3841,2,16,5,9,55,39,16,53
Linfield,3841,3,14,7,9,56,34,22,49
Glenavon,3841,4,12,10,8,57,54,3,46
Ballymena,3841,5,13,7,10,59,59,0,46
Coleraine,3841,6,10,9,11,42,45,-3,39
Glentoran,3841,7,10,8,12,30,42,-12,38
Dungannon,3841,8,8,9,13,48,46,2,33
Ards,3841,9,9,5,16,42,50,-8,32
Ballinamalla,3841,10,9,5,16,34,54,-20,32
Portadown,3841,11,7,6,17,25,49,-24,27
Crusaders,3842,1,18,6,6,55,29,26,60
Ballymena,3842,2,18,5,7,71,57,14,59
Linfield,3842,3,14,11,5,58,29,29,53
Cliftonville,3842,4,15,3,12,49,42,7,48
Ards,3842,5,13,5,12,50,51,-1,44
Glenavon,3842,6,10,9,11,44,45,-1,39
Glentoran,3842,7,11,5,14,32,42,-10,38
Coleraine,3842,8,9,10,11,43,48,-5,37
Dungannon,3842,9,8,10,12,49,48,1,34
Ballinamalla,3842,10,7,5,18,29,59,-30,26
Portadown,3842,11,4,7,19,20,50,-30,19
Linfield,3843,1,16,8,6,57,27,30,56
Crusaders,3843,2,15,7,8,52,34,18,52
Ballymena,3843,3,15,5,10,53,56,-3,50
Cliftonville,3843,4,14,5,11,48,40,8,47
Glenavon,3843,5,11,10,9,45,42,3,43
Coleraine,3843,6,10,12,8,39,35,4,42
Ards,3843,7,12,4,14,34,42,-8,40
Portadown,3843,8,11,4,15,29,44,-15,37
Glentoran,3843,9,9,8,13,33,40,-7,35
Dungannon,3843,10,6,10,14,41,46,-5,28
Ballinamalla,3843,11,7,5,18,25,50,-25,26
Crusaders,3844,1,17,7,6,55,34,21,58
Ballymena,3844,2,17,5,8,60,53,7,56
Linfield,3844,3,15,9,6,60,33,27,54
Cliftonville,3844,4,15,4,11,54,41,13,49
Glenavon,3844,5,11,13,6,43,35,8,46
Dungannon,3844,6,10,9,11,53,39,14,39
Portadown,3844,7,11,3,16,28,41,-13,36
Coleraine,3844,8,7,12,11,38,46,-8,33
Ards,3844,9,9,5,16,39,54,-15,32
Ballinamalla,3844,10,8,4,18,30,56,-26,28
Glentoran,3844,11,6,7,17,25,53,-28,25
Crusaders,3845,1,17,8,5,59,33,26,59
Linfield,3845,2,14,11,5,57,27,30,53
Cliftonville,3845,3,16,4,10,47,35,12,52
Ballymena,3845,4,13,6,11,56,57,-1,45
Dungannon,3845,5,12,7,11,51,38,13,43
Glentoran,3845,6,11,8,11,29,38,-9,41
Glenavon,3845,7,9,13,8,42,44,-2,40
Coleraine,3845,8,9,8,13,39,48,-9,35
Ballinamalla,3845,9,9,2,19,26,51,-25,29
Ards,3845,10,7,7,16,33,47,-14,28
Portadown,3845,11,6,10,14,20,41,-21,28
Crusaders,3846,1,19,5,6,53,28,25,62
Linfield,3846,2,17,10,3,61,22,39,61
Coleraine,3846,3,14,11,5,49,35,14,53
Cliftonville,3846,4,15,5,10,53,39,14,50
Glenavon,3846,5,12,12,6,42,32,10,48
Ballymena,3846,6,15,3,12,57,62,-5,48
Dungannon,3846,7,9,9,12,50,47,3,36
Ballinamalla,3846,8,9,2,19,28,51,-23,29
Ards,3846,9,7,5,18,35,53,-18,26
Glentoran,3846,10,6,8,16,25,51,-26,26
Portadown,3846,11,4,6,20,16,49,-33,18
Linfield,3847,1,16,9,5,63,33,30,57
Crusaders,3847,2,15,8,7,58,38,20,53
Cliftonville,3847,3,14,7,9,53,40,13,49
Dungannon,3847,4,11,11,8,55,39,16,44
Ballymena,3847,5,12,7,11,55,60,-5,43
Glenavon,3847,6,9,14,7,47,50,-3,41
Glentoran,3847,7,11,8,11,35,41,-6,41
Coleraine,3847,8,9,12,9,44,47,-3,39
Ards,3847,9,9,3,18,33,50,-17,30
Portadown,3847,10,8,6,16,28,48,-20,30
Ballinamalla,3847,11,7,3,20,30,55,-25,24
Crusaders,3848,1,17,9,4,64,37,27,60
Linfield,3848,2,16,7,7,61,35,26,55
Coleraine,3848,3,13,9,8,50,39,11,48
Ballymena,3848,4,14,6,10,56,55,1,48
Cliftonville,3848,5,14,4,12,55,46,9,46
Glenavon,3848,6,11,10,9,55,48,7,43
Ballinamalla,3848,7,12,3,15,32,49,-17,39
Dungannon,3848,8,9,8,13,48,49,-1,35
Ards,3848,9,8,8,14,31,45,-14,32
Glentoran,3848,10,7,7,16,33,54,-21,28
Portadown,3848,11,6,5,19,22,50,-28,23
Linfield,3849,1,16,10,4,65,29,36,58
Cliftonville,3849,2,16,6,8,54,35,19,54
Ballymena,3849,3,15,8,7,54,51,3,53
Crusaders,3849,4,13,10,7,46,35,11,49
Coleraine,3849,5,12,9,9,37,37,0,45
Glenavon,3849,6,10,9,11,38,46,-8,39
Dungannon,3849,7,8,11,11,42,39,3,35
Glentoran,3849,8,8,10,12,34,42,-8,34
Portadown,3849,9,8,7,15,31,40,-9,31
Ballinamalla,3849,10,8,3,19,33,56,-23,27
Ards,3849,11,8,3,19,29,53,-24,27
Crusaders,3850,1,16,7,7,61,41,20,55
Coleraine,3850,2,14,10,6,43,31,12,52
Cliftonville,3850,3,15,5,10,51,43,8,50
Ards,3850,4,14,3,13,48,47,1,45
Ballymena,3850,5,13,6,11,57,63,-6,45
Glenavon,3850,6,11,10,9,57,50,7,43
Linfield,3850,7,10,11,9,53,36,17,41
Dungannon,3850,8,10,8,12,48,43,5,38
Glentoran,3850,9,8,9,13,30,47,-17,33
Portadown,3850,10,9,3,18,28,48,-20,30
Ballinamalla,3850,11,7,4,19,28,55,-27,25
Crusaders,3851,1,16,8,6,52,32,20,56
Ballymena,3851,2,15,5,10,53,54,-1,50
Linfield,3851,3,13,9,8,58,32,26,48
Cliftonville,3851,4,14,5,11,49,41,8,47
Dungannon,3851,5,11,8,11,57,41,16,41
Glenavon,3851,6,10,10,10,44,49,-5,40
Portadown,3851,7,12,4,14,32,41,-9,40
Coleraine,3851,8,9,11,10,37,35,2,38
Ards,3851,9,10,4,16,39,50,-11,34
Glentoran,3851,10,7,10,13,28,45,-17,31
Ballinamalla,3851,11,9,4,17,26,55,-29,31
Crusaders,3852,1,20,7,3,69,29,40,67
Linfield,3852,2,13,11,6,57,34,23,50
Cliftonville,3852,3,15,4,11,46,35,11,49
Ballymena,3852,4,14,7,9,53,51,2,49
Glenavon,3852,5,12,12,6,50,45,5,48
Dungannon,3852,6,10,10,10,49,47,2,40
Coleraine,3852,7,8,12,10,42,46,-4,36
Ards,3852,8,8,7,15,34,43,-9,31
Portadown,3852,9,7,6,17,18,39,-21,27
Ballinamalla,3852,10,6,9,15,31,55,-24,27
Glentoran,3852,11,6,7,17,27,52,-25,25
Crusaders,3853,1,17,7,6,59,37,22,58
Cliftonville,3853,2,17,4,9,60,43,17,55
Linfield,3853,3,15,9,6,65,33,32,54
Glenavon,3853,4,14,10,6,51,39,12,52
Ballymena,3853,5,12,7,11,58,62,-4,43
Ards,3853,6,10,6,14,33,42,-9,36
Dungannon,3853,7,9,7,14,49,53,-4,34
Coleraine,3853,8,8,10,12,34,43,-9,34
Glentoran,3853,9,8,10,12,26,36,-10,34
Portadown,3853,10,7,7,16,23,50,-27,28
Ballinamalla,3853,11,8,3,19,33,53,-20,27
Crusaders,3854,1,15,9,6,50,28,22,54
Linfield,3854,2,14,11,5,62,29,33,53
Cliftonville,3854,3,14,8,8,51,33,18,50
Ballymena,3854,4,13,7,10,55,58,-3,46
Glenavon,3854,5,11,10,9,50,46,4,43
Coleraine,3854,6,10,11,9,35,37,-2,41
Dungannon,3854,7,10,9,11,42,41,1,39
Ballinamalla,3854,8,12,1,17,35,51,-16,37
Ards,3854,9,9,4,17,33,50,-17,31
Glentoran,3854,10,8,6,16,27,47,-20,30
Portadown,3854,11,8,6,16,26,46,-20,30
Linfield,3855,1,19,8,3,62,23,39,65
Cliftonville,3855,2,15,6,9,55,43,12,51
Crusaders,3855,3,13,9,8,44,36,8,48
Ballymena,3855,4,13,7,10,60,63,-3,46
Coleraine,3855,5,11,12,7,41,34,7,45
Glenavon,3855,6,12,8,10,42,41,1,44
Dungannon,3855,7,11,8,11,49,38,11,41
Ards,3855,8,10,5,15,37,46,-9,35
Glentoran,3855,9,7,8,15,32,46,-14,29
Ballinamalla,3855,10,6,7,17,26,52,-26,25
Portadown,3855,11,6,6,18,19,45,-26,24
Linfield,3856,1,15,9,6,56,31,25,54
Cliftonville,3856,2,16,5,9,55,40,15,53
Glenavon,3856,3,13,12,5,51,40,11,51
Crusaders,3856,4,14,8,8,49,39,10,50
Ballymena,3856,5,12,8,10,58,60,-2,44
Coleraine,3856,6,10,13,7,42,30,12,43
Dungannon,3856,7,9,11,10,48,43,5,38
Ballinamalla,3856,8,12,2,16,34,50,-16,38
Ards,3856,9,8,6,16,36,51,-15,30
Glentoran,3856,10,7,7,16,26,44,-18,28
Portadown,3856,11,7,3,20,22,49,-27,24
Crusaders,3857,1,19,8,3,58,28,30,65
Linfield,3857,2,15,10,5,63,32,31,55
Coleraine,3857,3,12,12,6,38,32,6,48
Cliftonville,3857,4,14,4,12,51,48,3,46
Ballymena,3857,5,12,7,11,57,63,-6,43
Glenavon,3857,6,11,9,10,41,42,-1,42
Ards,3857,7,11,3,16,38,51,-13,36
Portadown,3857,8,11,2,17,36,43,-7,35
Dungannon,3857,9,7,11,12,46,45,1,32
Ballinamalla,3857,10,9,5,16,29,45,-16,32
Glentoran,3857,11,4,9,17,19,47,-28,21
Crusaders,3858,1,18,6,6,65,42,23,60
Cliftonville,3858,2,15,7,8,60,34,26,52
Linfield,3858,3,14,9,7,69,40,29,51
Glenavon,3858,4,14,9,7,53,42,11,51
Ballymena,3858,5,13,7,10,58,61,-3,46
Coleraine,3858,6,10,14,6,40,30,10,44
Dungannon,3858,7,10,10,10,54,46,8,40
Ballinamalla,3858,8,9,3,18,29,53,-24,30
Glentoran,3858,9,7,6,17,28,60,-32,27
Ards,3858,10,6,8,16,40,62,-22,26
Portadown,3858,11,6,7,17,25,51,-26,25
Crusaders,3859,1,17,8,5,54,33,21,59
Glenavon,3859,2,13,13,4,52,42,10,52
Ballymena,3859,3,14,9,7,57,50,7,51
Linfield,3859,4,13,8,9,65,43,22,47
Cliftonville,3859,5,14,5,11,49,42,7,47
Ballinamalla,3859,6,11,7,12,35,45,-10,40
Dungannon,3859,7,9,8,13,47,48,-1,35
Coleraine,3859,8,8,11,11,31,38,-7,35
Glentoran,3859,9,7,10,13,38,51,-13,31
Ards,3859,10,7,7,16,40,54,-14,28
Portadown,3859,11,6,6,18,25,47,-22,24
Crusaders,3860,1,18,4,8,64,39,25,58
Ballymena,3860,2,15,6,9,61,54,7,51
Cliftonville,3860,3,14,6,10,46,40,6,48
Dungannon,3860,4,12,9,9,57,42,15,45
Coleraine,3860,5,12,9,9,49,43,6,45
Glenavon,3860,6,11,11,8,46,45,1,44
Linfield,3860,7,11,10,9,57,38,19,43
Glentoran,3860,8,9,8,13,30,46,-16,35
Ards,3860,9,10,3,17,41,54,-13,33
Portadown,3860,10,8,7,15,30,48,-18,31
Ballinamalla,3860,11,6,5,19,27,59,-32,23
Crusaders,3861,1,18,7,5,66,38,28,61
Ballymena,3861,2,16,5,9,59,56,3,53
Linfield,3861,3,11,11,8,52,35,17,44
Glenavon,3861,4,10,13,7,49,47,2,43
Cliftonville,3861,5,11,7,12,48,45,3,40
Coleraine,3861,6,10,10,10,45,45,0,40
Glentoran,3861,7,11,7,12,37,42,-5,40
Ballinamalla,3861,8,11,6,13,28,40,-12,39
Dungannon,3861,9,8,11,11,48,46,2,35
Ards,3861,10,9,3,18,34,49,-15,30
Portadown,3861,11,6,8,16,23,46,-23,26
Crusaders,3862,1,14,11,5,56,37,19,53
Linfield,3862,2,14,10,6,61,29,32,52
Coleraine,3862,3,14,10,6,54,38,16,52
Cliftonville,3862,4,14,6,10,50,42,8,48
Glenavon,3862,5,10,12,8,44,43,1,42
Dungannon,3862,6,11,8,11,53,46,7,41
Ballymena,3862,7,11,7,12,52,62,-10,40
Glentoran,3862,8,8,11,11,29,38,-9,35
Ards,3862,9,9,5,16,30,49,-19,32
Portadown,3862,10,7,8,15,32,47,-15,29
Ballinamalla,3862,11,7,4,19,29,59,-30,25
Linfield,3863,1,16,8,6,66,35,31,56
Cliftonville,3863,2,16,7,7,57,40,17,55
Crusaders,3863,3,14,10,6,48,30,18,52
Ballymena,3863,4,13,7,10,55,57,-2,46
Dungannon,3863,5,11,9,10,54,44,10,42
Coleraine,3863,6,9,11,10,45,47,-2,38
Glenavon,3863,7,9,10,11,41,47,-6,37
Glentoran,3863,8,10,7,13,33,48,-15,37
Ards,3863,9,8,7,15,39,56,-17,31
Portadown,3863,10,7,8,15,25,38,-13,29
Ballinamalla,3863,11,6,8,16,33,54,-21,26
Ballymena,3864,1,17,4,9,66,60,6,55
Cliftonville,3864,2,15,5,10,58,40,18,50
Glenavon,3864,3,13,11,6,50,36,14,50
Crusaders,3864,4,14,7,9,44,38,6,49
Linfield,3864,5,13,8,9,55,38,17,47
Ards,3864,6,13,3,14,48,45,3,42
Coleraine,3864,7,11,8,11,44,48,-4,41
Dungannon,3864,8,10,9,11,55,45,10,39
Glentoran,3864,9,9,7,14,31,47,-16,34
Ballinamalla,3864,10,8,5,17,30,50,-20,29
Portadown,3864,11,7,3,20,25,59,-34,24
Ballymena,3865,1,17,5,8,65,52,13,56
Cliftonville,3865,2,16,6,8,50,39,11,54
Linfield,3865,3,14,9,7,56,32,24,51
Crusaders,3865,4,14,6,10,52,36,16,48
Coleraine,3865,5,11,12,7,48,45,3,45
Glentoran,3865,6,12,8,10,35,35,0,44
Glenavon,3865,7,9,13,8,44,50,-6,40
Dungannon,3865,8,9,9,12,53,49,4,36
Portadown,3865,9,9,3,18,30,47,-17,30
Ballinamalla,3865,10,7,4,19,27,55,-28,25
Ards,3865,11,5,9,16,30,50,-20,24
Crusaders,3866,1,17,7,6,64,41,23,58
Linfield,3866,2,16,9,5,63,29,34,57
Cliftonville,3866,3,15,5,10,63,46,17,50
Glenavon,3866,4,12,11,7,39,42,-3,47
Coleraine,3866,5,10,11,9,39,36,3,41
Ballymena,3866,6,12,3,15,57,70,-13,39
Dungannon,3866,7,8,12,10,49,43,6,36
Ards,3866,8,9,6,15,35,49,-14,33
Glentoran,3866,9,8,8,14,31,48,-17,32
Portadown,3866,10,8,7,15,25,41,-16,31
Ballinamalla,3866,11,8,5,17,29,49,-20,29
Linfield,3867,1,15,10,5,63,27,36,55
Cliftonville,3867,2,15,6,9,49,36,13,51
Crusaders,3867,3,13,7,10,52,47,5,46
Ballymena,3867,4,12,10,8,57,58,-1,46
Coleraine,3867,5,11,9,10,48,39,9,42
Dungannon,3867,6,11,8,11,47,36,11,41
Glenavon,3867,7,9,12,9,45,48,-3,39
Ards,3867,8,10,6,14,36,49,-13,36
Glentoran,3867,9,9,8,13,36,48,-12,35
Ballinamalla,3867,10,9,4,17,33,56,-23,31
Portadown,3867,11,7,8,15,20,42,-22,29
Cliftonville,3868,1,19,3,8,62,43,19,60
Crusaders,3868,2,16,8,6,58,37,21,56
Glenavon,3868,3,14,9,7,56,43,13,51
Linfield,3868,4,11,9,10,50,36,14,42
Ballymena,3868,5,11,7,12,60,65,-5,40
Glentoran,3868,6,11,7,12,34,43,-9,40
Coleraine,3868,7,9,10,11,36,42,-6,37
Dungannon,3868,8,9,9,12,43,42,1,36
Ards,3868,9,10,4,16,36,49,-13,34
Portadown,3868,10,8,7,15,27,44,-17,31
Ballinamalla,3868,11,8,5,17,31,49,-18,29
Crusaders,3869,1,18,10,2,59,27,32,64
Linfield,3869,2,14,10,6,56,28,28,52
Cliftonville,3869,3,16,4,10,49,39,10,52
Ballymena,3869,4,13,7,10,60,64,-4,46
Dungannon,3869,5,11,11,8,55,39,16,44
Glenavon,3869,6,10,10,10,44,46,-2,40
Coleraine,3869,7,9,10,11,43,42,1,37
Glentoran,3869,8,8,8,14,28,48,-20,32
Ards,3869,9,8,7,15,41,53,-12,31
Ballinamalla,3869,10,8,5,17,34,58,-24,29
Portadown,3869,11,6,6,18,20,45,-25,24
Crusaders,3870,1,19,7,4,61,29,32,64
Ballymena,3870,2,15,5,10,53,53,0,50
Linfield,3870,3,13,10,7,63,37,26,49
Glenavon,3870,4,13,9,8,47,45,2,48
Cliftonville,3870,5,11,6,13,49,49,0,39
Coleraine,3870,6,10,9,11,44,45,-1,39
Ards,3870,7,10,8,12,42,47,-5,38
Glentoran,3870,8,10,8,12,33,42,-9,38
Dungannon,3870,9,9,10,11,47,43,4,37
Portadown,3870,10,7,5,18,25,48,-23,26
Ballinamalla,3870,11,7,5,18,28,54,-26,26
Crusaders,3871,1,18,5,7,59,37,22,59
Ballymena,3871,2,17,4,9,59,56,3,55
Linfield,3871,3,16,6,8,72,37,35,54
Cliftonville,3871,4,15,6,9,55,40,15,51
Glenavon,3871,5,13,9,8,48,47,1,48
Coleraine,3871,6,11,11,8,48,38,10,44
Ards,3871,7,9,6,15,42,55,-13,33
Glentoran,3871,8,8,7,15,31,50,-19,31
Portadown,3871,9,9,3,18,23,47,-24,30
Ballinamalla,3871,10,8,4,18,28,51,-23,28
Dungannon,3871,11,6,9,15,45,52,-7,27
Crusaders,3872,1,17,7,6,60,32,28,58
Ballymena,3872,2,16,6,8,64,57,7,54
Linfield,3872,3,14,7,9,55,34,21,49
Cliftonville,3872,4,15,4,11,46,37,9,49
Glenavon,3872,5,12,12,6,49,41,8,48
Coleraine,3872,6,12,9,9,37,37,0,45
Dungannon,3872,7,8,11,11,48,49,-1,35
Glentoran,3872,8,8,8,14,29,45,-16,32
Ballinamalla,3872,9,8,6,16,28,47,-19,30
Portadown,3872,10,6,9,15,24,44,-20,27
Ards,3872,11,7,5,18,34,51,-17,26
Crusaders,3873,1,16,8,6,55,32,23,56
Ballymena,3873,2,14,6,10,56,57,-1,48
Linfield,3873,3,13,8,9,54,31,23,47
Cliftonville,3873,4,13,5,12,47,41,6,44
Dungannon,3873,5,11,9,10,56,41,15,42
Coleraine,3873,6,10,12,8,44,39,5,42
Glentoran,3873,7,11,5,14,30,50,-20,38
Glenavon,3873,8,9,10,11,42,44,-2,37
Portadown,3873,9,10,7,13,32,47,-15,37
Ards,3873,10,10,5,15,36,45,-9,35
Ballinamalla,3873,11,9,3,18,32,57,-25,30
Linfield,3874,1,15,11,4,59,28,31,56
Crusaders,3874,2,14,8,8,49,33,16,50
Cliftonville,3874,3,15,5,10,54,41,13,50
Glenavon,3874,4,12,11,7,53,42,11,47
Dungannon,3874,5,12,10,8,51,43,8,46
Ballymena,3874,6,11,8,11,52,58,-6,41
Coleraine,3874,7,9,9,12,39,41,-2,36
Glentoran,3874,8,9,7,14,30,45,-15,34
Ards,3874,9,9,6,15,39,52,-13,33
Ballinamalla,3874,10,9,5,16,30,50,-20,32
Portadown,3874,11,8,4,18,27,50,-23,28
Crusaders,3875,1,15,8,7,61,37,24,53
Ballymena,3875,2,16,5,9,64,59,5,53
Linfield,3875,3,13,7,10,58,42,16,46
Cliftonville,3875,4,13,5,12,45,43,2,44
Glentoran,3875,5,12,6,12,36,45,-9,42
Dungannon,3875,6,9,13,8,50,41,9,40
Coleraine,3875,7,9,13,8,36,35,1,40
Glenavon,3875,8,9,12,9,46,47,-1,39
Ards,3875,9,10,5,15,43,54,-11,35
Portadown,3875,10,8,6,16,27,43,-16,30
Ballinamalla,3875,11,8,6,16,26,46,-20,30
Crusaders,3876,1,21,6,3,66,25,41,69
Linfield,3876,2,15,9,6,63,32,31,54
Glenavon,3876,3,13,12,5,50,40,10,51
Coleraine,3876,4,12,11,7,49,38,11,47
Cliftonville,3876,5,14,4,12,53,57,-4,46
Ballymena,3876,6,12,7,11,56,68,-12,43
Glentoran,3876,7,11,8,11,39,47,-8,41
Dungannon,3876,8,9,8,13,48,45,3,35
Ards,3876,9,6,7,17,37,55,-18,25
Ballinamalla,3876,10,6,5,19,23,49,-26,23
Portadown,3876,11,5,5,20,23,51,-28,20
Crusaders,3877,1,18,6,6,60,35,25,60
Linfield,3877,2,16,9,5,60,29,31,57
Ballymena,3877,3,17,4,9,59,55,4,55
Glenavon,3877,4,12,10,8,48,42,6,46
Coleraine,3877,5,11,12,7,44,38,6,45
Cliftonville,3877,6,12,8,10,46,38,8,44
Portadown,3877,7,10,6,14,26,41,-15,36
Dungannon,3877,8,8,8,14,50,51,-1,32
Ards,3877,9,8,5,17,31,48,-17,29
Glentoran,3877,10,6,8,16,24,45,-21,26
Ballinamalla,3877,11,6,6,18,25,51,-26,24
Linfield,3878,1,16,7,7,57,29,28,55
Crusaders,3878,2,16,6,8,47,32,15,54
Ballymena,3878,3,15,6,9,54,50,4,51
Cliftonville,3878,4,14,8,8,48,35,13,50
Glenavon,3878,5,12,8,10,50,45,5,44
Coleraine,3878,6,11,8,11,40,40,0,41
Dungannon,3878,7,10,8,12,45,43,2,38
Ards,3878,8,11,5,14,36,47,-11,38
Ballinamalla,3878,9,10,3,17,30,48,-18,33
Glentoran,3878,10,8,6,16,27,43,-16,30
Portadown,3878,11,6,7,17,23,45,-22,25
Crusaders,3879,1,19,7,4,58,30,28,64
Linfield,3879,2,15,8,7,65,36,29,53
Coleraine,3879,3,13,10,7,41,36,5,49
Dungannon,3879,4,12,9,9,50,39,11,45
Glenavon,3879,5,11,11,8,55,42,13,44
Cliftonville,3879,6,13,4,13,45,42,3,43
Ballymena,3879,7,12,7,11,52,57,-5,43
Glentoran,3879,8,8,11,11,31,40,-9,35
Ards,3879,9,9,7,14,34,45,-11,34
Ballinamalla,3879,10,6,4,20,28,56,-28,22
Portadown,3879,11,5,6,19,19,55,-36,21
Crusaders,3880,1,17,7,6,56,37,19,58
Linfield,3880,2,13,10,7,51,27,24,49
Ballymena,3880,3,14,6,10,58,52,6,48
Coleraine,3880,4,12,10,8,42,34,8,46
Glentoran,3880,5,13,6,11,40,43,-3,45
Cliftonville,3880,6,12,8,10,44,36,8,44
Dungannon,3880,7,11,10,9,48,38,10,43
Ards,3880,8,11,5,14,42,51,-9,38
Glenavon,3880,9,9,9,12,38,49,-11,36
Portadown,3880,10,5,8,17,30,54,-24,23
Ballinamalla,3880,11,6,5,19,25,53,-28,23
Linfield,3881,1,17,8,5,63,33,30,59
Crusaders,3881,2,15,8,7,49,34,15,53
Cliftonville,3881,3,15,4,11,55,42,13,49
Coleraine,3881,4,13,8,9,42,35,7,47
Portadown,3881,5,13,4,13,39,42,-3,43
Glenavon,3881,6,10,11,9,44,44,0,41
Dungannon,3881,7,10,10,10,49,38,11,40
Ballymena,3881,8,11,5,14,52,65,-13,38
Ards,3881,9,9,5,16,37,55,-18,32
Glentoran,3881,10,7,7,16,25,45,-20,28
Ballinamalla,3881,11,8,4,18,24,46,-22,28
Crusaders,3882,1,14,11,5,52,36,16,53
Ballymena,3882,2,16,5,9,62,51,11,53
Linfield,3882,3,15,7,8,56,29,27,52
Cliftonville,3882,4,13,10,7,46,32,14,49
Coleraine,3882,5,12,10,8,40,36,4,46
Glenavon,3882,6,10,12,8,45,42,3,42
Dungannon,3882,7,10,11,9,44,39,5,41
Glentoran,3882,8,10,6,14,29,43,-14,36
Portadown,3882,9,8,5,17,24,48,-24,29
Ards,3882,10,6,8,16,34,50,-16,26
Ballinamalla,3882,11,7,3,20,29,55,-26,24
Crusaders,3883,1,18,6,6,56,30,26,60
Cliftonville,3883,2,18,3,9,56,37,19,57
Dungannon,3883,3,14,9,7,52,36,16,51
Ballymena,3883,4,14,7,9,62,56,6,49
Linfield,3883,5,12,12,6,53,30,23,48
Coleraine,3883,6,10,9,11,42,48,-6,39
Glenavon,3883,7,9,10,11,46,50,-4,37
Glentoran,3883,8,10,6,14,34,48,-14,36
Ards,3883,9,9,5,16,42,53,-11,32
Ballinamalla,3883,10,7,5,18,27,52,-25,26
Portadown,3883,11,5,6,19,22,52,-30,21
Ballymena,3884,1,16,7,7,58,54,4,55
Linfield,3884,2,15,8,7,63,37,26,53
Coleraine,3884,3,13,11,6,43,31,12,50
Cliftonville,3884,4,15,5,10,54,43,11,50
Crusaders,3884,5,14,7,9,53,41,12,49
Glenavon,3884,6,12,12,6,50,41,9,48
Dungannon,3884,7,12,8,10,57,40,17,44
Glentoran,3884,8,8,7,15,26,46,-20,31
Ards,3884,9,9,2,19,37,54,-17,29
Ballinamalla,3884,10,6,8,16,31,51,-20,26
Portadown,3884,11,5,5,20,20,54,-34,20
Crusaders,3885,1,18,8,4,61,33,28,62
Cliftonville,3885,2,15,5,10,49,37,12,50
Linfield,3885,3,12,13,5,54,32,22,49
Ballymena,3885,4,14,6,10,55,52,3,48
Coleraine,3885,5,10,14,6,38,33,5,44
Glenavon,3885,6,9,14,7,42,43,-1,41
Dungannon,3885,7,8,11,11,44,41,3,35
Ards,3885,8,9,6,15,40,48,-8,33
Glentoran,3885,9,9,6,15,34,53,-19,33
Ballinamalla,3885,10,9,3,18,29,53,-24,30
Portadown,3885,11,7,4,19,24,45,-21,25
Ballymena,3886,1,18,5,7,68,53,15,59
Cliftonville,3886,2,17,4,9,58,41,17,55
Crusaders,3886,3,14,9,7,51,35,16,51
Coleraine,3886,4,13,9,8,48,39,9,48
Ards,3886,5,14,5,11,42,40,2,47
Linfield,3886,6,11,10,9,56,35,21,43
Glenavon,3886,7,10,11,9,45,45,0,41
Dungannon,3886,8,9,10,11,45,44,1,37
Glentoran,3886,9,8,10,12,25,39,-14,34
Ballinamalla,3886,10,5,5,20,29,62,-33,20
Portadown,3886,11,3,8,19,17,51,-34,17
Crusaders,3887,1,18,7,5,62,33,29,61
Cliftonville,3887,2,18,3,9,57,38,19,57
Glenavon,3887,3,14,13,3,49,34,15,55
Linfield,3887,4,14,12,4,67,40,27,54
Ballymena,3887,5,12,7,11,55,65,-10,43
Glentoran,3887,6,9,9,12,36,47,-11,36
Dungannon,3887,7,7,13,10,51,48,3,34
Coleraine,3887,8,6,12,12,35,44,-9,30
Portadown,3887,9,7,7,16,31,52,-21,28
Ballinamalla,3887,10,5,10,15,26,50,-24,25
Ards,3887,11,4,9,17,28,46,-18,21
Linfield,3888,1,16,9,5,66,29,37,57
Crusaders,3888,2,15,8,7,57,38,19,53
Ballymena,3888,3,15,5,10,67,59,8,50
Cliftonville,3888,4,14,4,12,56,45,11,46
Coleraine,3888,5,12,9,9,45,44,1,45
Glenavon,3888,6,11,11,8,43,40,3,44
Dungannon,3888,7,11,7,12,56,51,5,40
Glentoran,3888,8,8,10,12,29,44,-15,34
Ards,3888,9,9,6,15,37,59,-22,33
Ballinamalla,3888,10,8,4,18,35,57,-22,28
Portadown,3888,11,6,7,17,26,51,-25,25
Linfield,3889,1,16,9,5,60,26,34,57
Crusaders,3889,2,14,6,10,47,37,10,48
Cliftonville,3889,3,14,5,11,45,37,8,47
Coleraine,3889,4,9,15,6,37,31,6,42
Ballymena,3889,5,11,9,10,44,52,-8,42
Glenavon,3889,6,9,12,9,43,43,0,39
Glentoran,3889,7,10,9,11,30,36,-6,39
Portadown,3889,8,11,5,14,24,37,-13,38
Dungannon,3889,9,9,9,12,53,46,7,36
Ballinamalla,3889,10,10,2,18,30,51,-21,32
Ards,3889,11,8,7,15,28,45,-17,31
Coleraine,3890,1,15,12,3,53,27,26,57
Linfield,3890,2,15,9,6,63,35,28,54
Crusaders,3890,3,15,8,7,54,39,15,53
Cliftonville,3890,4,15,5,10,55,40,15,50
Ballymena,3890,5,13,8,9,58,59,-1,47
Glenavon,3890,6,11,12,7,46,42,4,45
Glentoran,3890,7,9,6,15,34,46,-12,33
Dungannon,3890,8,7,10,13,42,48,-6,31
Ards,3890,9,8,6,16,37,52,-15,30
Ballinamalla,3890,10,6,8,16,29,53,-24,26
Portadown,3890,11,6,6,18,18,48,-30,24
Crusaders,3891,1,17,7,6,58,38,20,58
Linfield,3891,2,13,12,5,60,32,28,51
Cliftonville,3891,3,15,6,9,53,39,14,51
Ballymena,3891,4,13,6,11,57,60,-3,45
Glenavon,3891,5,10,13,7,51,46,5,43
Coleraine,3891,6,11,8,11,49,47,2,41
Dungannon,3891,7,9,12,9,55,47,8,39
Ards,3891,8,11,5,14,47,50,-3,38
Glentoran,3891,9,10,7,13,37,53,-16,37
Portadown,3891,10,8,4,18,23,50,-27,28
Ballinamalla,3891,11,4,8,18,29,57,-28,20
Crusaders,3892,1,16,7,7,51,33,18,55
Cliftonville,3892,2,16,5,9,51,41,10,53
Linfield,3892,3,14,9,7,55,31,24,51
Ballymena,3892,4,14,7,9,62,55,7,49
Glenavon,3892,5,13,8,9,46,45,1,47
Dungannon,3892,6,10,9,11,49,41,8,39
Coleraine,3892,7,10,9,11,39,34,5,39
Glentoran,3892,8,11,5,14,25,41,-16,38
Ards,3892,9,10,4,16,32,43,-11,34
Portadown,3892,10,7,7,16,25,45,-20,28
Ballinamalla,3892,11,6,6,18,28,54,-26,24
Linfield,3893,1,16,12,2,69,25,44,60
Crusaders,3893,2,14,9,7,52,40,12,51
Ballymena,3893,3,14,4,12,53,59,-6,46
Cliftonville,3893,4,12,7,11,49,45,4,43
Glenavon,3893,5,11,10,9,44,48,-4,43
Dungannon,3893,6,10,11,9,52,40,12,41
Coleraine,3893,7,10,9,11,33,31,2,39
Ballinamalla,3893,8,11,5,14,31,42,-11,38
Ards,3893,9,10,5,15,38,50,-12,35
Glentoran,3893,10,6,11,13,29,51,-22,29
Portadown,3893,11,6,7,17,26,45,-19,25
Crusaders,3894,1,19,7,4,55,26,29,64
Linfield,3894,2,14,9,7,50,30,20,51
Cliftonville,3894,3,16,3,11,51,45,6,51
Glentoran,3894,4,13,7,10,43,40,3,46
Ballymena,3894,5,12,7,11,50,55,-5,43
Dungannon,3894,6,11,7,12,50,39,11,40
Glenavon,3894,7,10,10,10,44,48,-4,40
Coleraine,3894,8,9,12,9,45,42,3,39
Ards,3894,9,8,7,15,43,52,-9,31
Portadown,3894,10,6,7,17,17,45,-28,25
Ballinamalla,3894,11,6,6,18,29,55,-26,24
Linfield,3895,1,17,9,4,66,33,33,60
Crusaders,3895,2,16,8,6,56,29,27,56
Cliftonville,3895,3,14,6,10,56,42,14,48
Glenavon,3895,4,10,14,6,43,42,1,44
Dungannon,3895,5,10,12,8,52,45,7,42
Coleraine,3895,6,10,10,10,35,38,-3,40
Ballymena,3895,7,11,5,14,57,65,-8,38
Glentoran,3895,8,10,7,13,31,44,-13,37
Ards,3895,9,10,6,14,43,47,-4,36
Ballinamalla,3895,10,6,7,17,22,51,-29,25
Portadown,3895,11,6,6,18,28,53,-25,24
Crusaders,3896,1,15,10,5,60,34,26,55
Ballymena,3896,2,15,6,9,59,56,3,51
Glenavon,3896,3,13,11,6,52,40,12,50
Linfield,3896,4,11,11,8,62,39,23,44
Cliftonville,3896,5,13,4,13,54,50,4,43
Dungannon,3896,6,10,10,10,53,46,7,40
Coleraine,3896,7,10,10,10,42,51,-9,40
Glentoran,3896,8,9,8,13,29,40,-11,35
Ballinamalla,3896,9,9,8,13,29,45,-16,35
Ards,3896,10,7,9,14,35,49,-14,30
Portadown,3896,11,5,9,16,29,54,-25,24
Crusaders,3897,1,16,9,5,62,37,25,57
Linfield,3897,2,15,8,7,71,36,35,53
Cliftonville,3897,3,13,8,9,49,43,6,47
Dungannon,3897,4,13,7,10,54,42,12,46
Glenavon,3897,5,11,11,8,47,45,2,44
Ballymena,3897,6,11,8,11,55,62,-7,41
Coleraine,3897,7,9,11,10,40,44,-4,38
Ards,3897,8,11,5,14,40,46,-6,38
Portadown,3897,9,10,5,15,40,54,-14,35
Glentoran,3897,10,8,9,13,36,51,-15,33
Ballinamalla,3897,11,5,5,20,27,61,-34,20
Crusaders,3898,1,17,9,4,59,37,22,60
Glenavon,3898,2,13,13,4,55,37,18,52
Linfield,3898,3,13,11,6,57,32,25,50
Cliftonville,3898,4,15,5,10,46,35,11,50
Coleraine,3898,5,11,12,7,47,39,8,45
Ballymena,3898,6,11,9,10,54,62,-8,42
Dungannon,3898,7,8,10,12,44,43,1,34
Ards,3898,8,10,3,17,36,51,-15,33
Ballinamalla,3898,9,9,5,16,28,43,-15,32
Glentoran,3898,10,6,8,16,31,55,-24,26
Portadown,3898,11,6,7,17,25,48,-23,25
Crusaders,3899,1,17,8,5,61,39,22,59
Linfield,3899,2,16,8,6,58,27,31,56
Cliftonville,3899,3,13,5,12,48,41,7,44
Coleraine,3899,4,10,14,6,44,41,3,44
Ballymena,3899,5,13,5,12,66,67,-1,44
Glenavon,3899,6,10,12,8,54,50,4,42
Glentoran,3899,7,11,8,11,32,40,-8,41
Dungannon,3899,8,9,8,13,46,49,-3,35
Ballinamalla,3899,9,10,3,17,34,47,-13,33
Portadown,3899,10,10,3,17,29,50,-21,33
Ards,3899,11,6,6,18,31,52,-21,24
Linfield,3900,1,16,9,5,59,30,29,57
Crusaders,3900,2,16,7,7,55,38,17,55
Coleraine,3900,3,14,12,4,46,31,15,54
Ballymena,3900,4,16,4,10,64,60,4,52
Cliftonville,3900,5,12,9,9,46,37,9,45
Glenavon,3900,6,10,12,8,47,49,-2,42
Glentoran,3900,7,9,10,11,32,39,-7,37
Dungannon,3900,8,8,10,12,42,44,-2,34
Ards,3900,9,7,6,17,32,49,-17,27
Portadown,3900,10,6,7,17,20,45,-25,25
Ballinamalla,3900,11,6,4,20,29,50,-21,22
Cliftonville,3901,1,17,5,8,54,38,16,56
Crusaders,3901,2,15,6,9,51,35,16,51
Glenavon,3901,3,13,10,7,46,37,9,49
Ballymena,3901,4,14,7,9,58,54,4,49
Linfield,3901,5,13,9,8,58,37,21,48
Coleraine,3901,6,11,10,9,39,38,1,43
Dungannon,3901,7,10,8,12,47,41,6,38
Glentoran,3901,8,9,8,13,31,40,-9,35
Ards,3901,9,9,6,15,41,57,-16,33
Portadown,3901,10,7,7,16,28,49,-21,28
Ballinamalla,3901,11,7,4,19,24,51,-27,25
Crusaders,3902,1,18,6,6,56,28,28,60
Cliftonville,3902,2,17,4,9,54,34,20,55
Ballymena,3902,3,16,4,10,56,51,5,52
Linfield,3902,4,14,8,8,58,34,24,50
Glenavon,3902,5,10,10,10,47,51,-4,40
Dungannon,3902,6,10,9,11,52,41,11,39
Coleraine,3902,7,10,8,12,36,44,-8,38
Glentoran,3902,8,9,8,13,31,46,-15,35
Ballinamalla,3902,9,9,5,16,30,47,-17,32
Portadown,3902,10,9,3,18,26,51,-25,30
Ards,3902,11,7,7,16,36,55,-19,28
Crusaders,3903,1,17,9,4,59,33,26,60
Linfield,3903,2,15,9,6,60,36,24,54
Cliftonville,3903,3,16,6,8,49,32,17,54
Coleraine,3903,4,11,11,8,37,35,2,44
Dungannon,3903,5,11,9,10,50,45,5,42
Ballymena,3903,6,12,6,12,48,52,-4,42
Glenavon,3903,7,8,12,10,42,49,-7,36
Glentoran,3903,8,9,7,14,35,42,-7,34
Portadown,3903,9,9,7,14,32,44,-12,34
Ballinamalla,3903,10,7,5,18,30,55,-25,26
Ards,3903,11,6,7,17,31,50,-19,25
Crusaders,3904,1,18,5,7,53,29,24,59
Linfield,3904,2,15,6,9,58,36,22,51
Ballymena,3904,3,15,4,11,60,61,-1,49
Cliftonville,3904,4,13,7,10,48,38,10,46
Coleraine,3904,5,10,12,8,42,44,-2,42
Dungannon,3904,6,11,8,11,57,48,9,41
Portadown,3904,7,11,4,15,34,46,-12,37
Glentoran,3904,8,10,6,14,28,40,-12,36
Glenavon,3904,9,8,9,13,41,51,-10,33
Ards,3904,10,9,6,15,36,46,-10,33
Ballinamalla,3904,11,9,5,16,33,51,-18,32
Crusaders,3905,1,16,8,6,53,31,22,56
Cliftonville,3905,2,16,7,7,52,33,19,55
Glenavon,3905,3,12,11,7,54,43,11,47
Linfield,3905,4,12,8,10,55,36,19,44
Coleraine,3905,5,11,10,9,45,40,5,43
Ballymena,3905,6,11,7,12,55,64,-9,40
Portadown,3905,7,12,4,14,34,45,-11,40
Glentoran,3905,8,8,10,12,28,40,-12,34
Dungannon,3905,9,7,12,11,40,44,-4,33
Ards,3905,10,8,7,15,42,61,-19,31
Ballinamalla,3905,11,8,4,18,29,50,-21,28
Glenavon,3906,1,16,8,6,53,37,16,56
Cliftonville,3906,2,17,4,9,58,39,19,55
Crusaders,3906,3,15,9,6,51,32,19,54
Linfield,3906,4,15,8,7,61,33,28,53
Ballymena,3906,5,14,4,12,57,58,-1,46
Dungannon,3906,6,12,8,10,52,41,11,44
Coleraine,3906,7,8,12,10,37,48,-11,36
Glentoran,3906,8,8,8,14,35,55,-20,32
Portadown,3906,9,8,5,17,28,45,-17,29
Ards,3906,10,6,10,14,39,54,-15,28
Ballinamalla,3906,11,7,2,21,27,56,-29,23
Linfield,3907,1,16,10,4,62,27,35,58
Crusaders,3907,2,15,10,5,54,32,22,55
Ballymena,3907,3,14,7,9,59,54,5,49
Coleraine,3907,4,12,11,7,47,36,11,47
Glenavon,3907,5,11,14,5,53,44,9,47
Cliftonville,3907,6,13,6,11,43,39,4,45
Glentoran,3907,7,8,11,11,30,40,-10,35
Dungannon,3907,8,7,13,10,45,43,2,34
Ards,3907,9,9,5,16,37,53,-16,32
Ballinamalla,3907,10,5,7,18,28,58,-30,22
Portadown,3907,11,6,4,20,20,52,-32,22
Ballymena,3908,1,16,6,8,63,55,8,54
Linfield,3908,2,15,7,8,65,42,23,52
Crusaders,3908,3,14,9,7,55,37,18,51
Cliftonville,3908,4,15,5,10,57,41,16,50
Glenavon,3908,5,10,11,9,49,47,2,41
Coleraine,3908,6,9,12,9,38,37,1,39
Dungannon,3908,7,10,9,11,45,49,-4,39
Ards,3908,8,11,5,14,39,45,-6,38
Portadown,3908,9,9,5,16,30,45,-15,32
Glentoran,3908,10,8,7,15,31,49,-18,31
Ballinamalla,3908,11,8,4,18,34,59,-25,28
Linfield,3909,1,17,8,5,67,34,33,59
Cliftonville,3909,2,14,7,9,48,35,13,49
Crusaders,3909,3,12,9,9,47,45,2,45
Coleraine,3909,4,11,11,8,46,42,4,44
Glenavon,3909,5,11,10,9,46,45,1,43
Dungannon,3909,6,11,8,11,45,39,6,41
Ards,3909,7,12,4,14,44,44,0,40
Glentoran,3909,8,11,7,12,31,42,-11,40
Ballymena,3909,9,10,7,13,52,57,-5,37
Portadown,3909,10,9,8,13,35,48,-13,35
Ballinamalla,3909,11,6,3,21,29,59,-30,21
Cliftonville,3910,1,21,2,7,66,32,34,65
Linfield,3910,2,18,6,6,61,25,36,60
Crusaders,3910,3,18,6,6,61,37,24,60
Ballymena,3910,4,13,5,12,58,69,-11,44
Coleraine,3910,5,10,13,7,42,39,3,43
Glenavon,3910,6,9,13,8,40,40,0,40
Glentoran,3910,7,10,8,12,35,45,-10,38
Dungannon,3910,8,7,13,10,46,43,3,34
Portadown,3910,9,9,2,19,22,50,-28,29
Ards,3910,10,6,5,19,28,54,-26,23
Ballinamalla,3910,11,5,5,20,24,49,-25,20
Linfield,3911,1,17,8,5,62,27,35,59
Crusaders,3911,2,17,8,5,56,29,27,59
Cliftonville,3911,3,16,8,6,60,35,25,56
Coleraine,3911,4,12,10,8,41,38,3,46
Ballymena,3911,5,13,7,10,62,64,-2,46
Glenavon,3911,6,11,10,9,51,47,4,43
Glentoran,3911,7,8,8,14,27,49,-22,32
Ards,3911,8,9,4,17,35,51,-16,31
Dungannon,3911,9,5,15,10,41,43,-2,30
Ballinamalla,3911,10,7,7,16,27,49,-22,28
Portadown,3911,11,4,7,19,22,52,-30,19
Crusaders,3912,1,17,7,6,63,31,32,58
Linfield,3912,2,15,8,7,53,30,23,53
Cliftonville,3912,3,16,3,11,54,34,20,51
Glenavon,3912,4,13,11,6,55,49,6,50
Ballymena,3912,5,15,5,10,54,64,-10,50
Coleraine,3912,6,12,11,7,44,35,9,47
Dungannon,3912,7,13,6,11,57,44,13,45
Ards,3912,8,9,5,16,34,47,-13,32
Portadown,3912,9,8,5,17,27,48,-21,29
Glentoran,3912,10,6,5,19,28,57,-29,23
Ballinamalla,3912,11,6,4,20,23,53,-30,22
Linfield,3913,1,16,9,5,67,30,37,57
Coleraine,3913,2,13,14,3,50,33,17,53
Crusaders,3913,3,14,9,7,55,36,19,51
Ballymena,3913,4,15,5,10,66,68,-2,50
Cliftonville,3913,5,15,4,11,48,37,11,49
Glenavon,3913,6,12,12,6,50,42,8,48
Dungannon,3913,7,8,9,13,42,47,-5,33
Ballinamalla,3913,8,9,4,17,38,59,-21,31
Ards,3913,9,6,9,15,34,51,-17,27
Glentoran,3913,10,6,9,15,26,51,-25,27
Portadown,3913,11,5,8,17,23,45,-22,23
Crusaders,3914,1,16,10,4,56,34,22,58
Ballymena,3914,2,16,4,10,65,55,10,52
Linfield,3914,3,13,11,6,57,32,25,50
Cliftonville,3914,4,14,6,10,54,44,10,48
Coleraine,3914,5,11,9,10,41,43,-2,42
Dungannon,3914,6,10,10,10,53,45,8,40
Glenavon,3914,7,9,11,10,42,47,-5,38
Ards,3914,8,10,6,14,38,44,-6,36
Glentoran,3914,9,8,10,12,37,53,-16,34
Portadown,3914,10,8,7,15,27,43,-16,31
Ballinamalla,3914,11,5,6,19,24,54,-30,21
Crusaders,3915,1,17,9,4,59,34,25,60
Cliftonville,3915,2,18,5,7,49,32,17,59
Linfield,3915,3,12,12,6,57,34,23,48
Ballymena,3915,4,13,9,8,50,48,2,48
Coleraine,3915,5,10,13,7,44,37,7,43
Glenavon,3915,6,10,12,8,49,46,3,42
Glentoran,3915,7,10,10,10,34,38,-4,40
Dungannon,3915,8,9,9,12,54,49,5,36
Ards,3915,9,9,7,14,42,52,-10,34
Ballinamalla,3915,10,5,7,18,28,58,-30,22
Portadown,3915,11,3,5,22,24,62,-38,14
Crusaders,3916,1,17,4,9,59,38,21,55
Linfield,3916,2,16,6,8,64,33,31,54
Ballymena,3916,3,15,6,9,66,63,3,51
Cliftonville,3916,4,12,8,10,50,43,7,44
Dungannon,3916,5,10,10,10,50,44,6,40
Coleraine,3916,6,9,13,8,36,34,2,40
Glenavon,3916,7,9,11,10,39,42,-3,38
Ards,3916,8,9,8,13,44,49,-5,35
Glentoran,3916,9,9,7,14,33,51,-18,34
Ballinamalla,3916,10,9,5,16,36,56,-20,32
Portadown,3916,11,8,6,16,26,50,-24,30
Crusaders,3917,1,20,5,5,55,22,33,65
Linfield,3917,2,17,10,3,55,18,37,61
Cliftonville,3917,3,15,7,8,45,33,12,52
Ballymena,3917,4,15,5,10,52,56,-4,50
Glenavon,3917,5,10,10,10,43,46,-3,40
Dungannon,3917,6,9,8,13,40,43,-3,35
Coleraine,3917,7,9,7,14,35,40,-5,34
Ards,3917,8,10,4,16,37,49,-12,34
Portadown,3917,9,8,6,16,27,49,-22,30
Glentoran,3917,10,8,5,17,26,39,-13,29
Ballinamalla,3917,11,8,5,17,30,50,-20,29
Crusaders,3918,1,16,7,7,60,37,23,55
Linfield,3918,2,14,8,8,56,28,28,50
Cliftonville,3918,3,14,8,8,50,42,8,50
Ballymena,3918,4,14,6,10,58,54,4,48
Coleraine,3918,5,10,12,8,42,38,4,42
Glenavon,3918,6,11,8,11,46,47,-1,41
Dungannon,3918,7,10,7,13,51,46,5,37
Ards,3918,8,10,5,15,34,42,-8,35
Glentoran,3918,9,9,7,14,35,51,-16,34
Ballinamalla,3918,10,9,6,15,33,53,-20,33
Portadown,3918,11,7,8,15,25,52,-27,29
Cliftonville,3919,1,16,4,10,61,39,22,52
Linfield,3919,2,13,10,7,51,31,20,49
Crusaders,3919,3,14,7,9,50,32,18,49
Coleraine,3919,4,12,12,6,37,29,8,48
Glenavon,3919,5,11,12,7,46,43,3,45
Ballymena,3919,6,12,8,10,50,58,-8,44
Dungannon,3919,7,9,12,9,52,44,8,39
Glentoran,3919,8,9,11,10,33,41,-8,38
Ballinamalla,3919,9,10,5,15,32,52,-20,35
Portadown,3919,10,7,8,15,26,43,-17,29
Ards,3919,11,5,5,20,30,56,-26,20
Ballymena,3920,1,17,5,8,61,56,5,56
Linfield,3920,2,15,9,6,63,31,32,54
Cliftonville,3920,3,16,4,10,57,41,16,52
Crusaders,3920,4,14,7,9,52,44,8,49
Coleraine,3920,5,13,9,8,44,40,4,48
Portadown,3920,6,9,8,13,33,39,-6,35
Dungannon,3920,7,9,8,13,47,54,-7,35
Glentoran,3920,8,9,8,13,35,44,-9,35
Ballinamalla,3920,9,9,6,15,35,54,-19,33
Glenavon,3920,10,7,10,13,40,47,-7,31
Ards,3920,11,8,4,18,34,51,-17,28
Crusaders,3921,1,16,9,5,54,31,23,57
Linfield,3921,2,14,11,5,58,31,27,53
Cliftonville,3921,3,15,5,10,56,40,16,50
Ballymena,3921,4,15,5,10,60,62,-2,50
Coleraine,3921,5,11,11,8,42,35,7,44
Glenavon,3921,6,9,10,11,42,51,-9,37
Dungannon,3921,7,8,11,11,45,42,3,35
Portadown,3921,8,10,5,15,32,48,-16,35
Ards,3921,9,9,7,14,39,51,-12,34
Ballinamalla,3921,10,10,3,17,36,49,-13,33
Glentoran,3921,11,6,7,17,26,50,-24,25
Crusaders,3922,1,17,8,5,62,30,32,59
Linfield,3922,2,16,8,6,58,31,27,56
Cliftonville,3922,3,14,6,10,55,42,13,48
Ballymena,3922,4,14,6,10,54,60,-6,48
Coleraine,3922,5,12,11,7,41,35,6,47
Glenavon,3922,6,9,11,10,36,44,-8,38
Glentoran,3922,7,10,7,13,37,43,-6,37
Ards,3922,8,10,5,15,36,45,-9,35
Dungannon,3922,9,8,9,13,50,50,0,33
Portadown,3922,10,8,6,16,24,43,-19,30
Ballinamalla,3922,11,5,7,18,28,58,-30,22
Crusaders,3923,1,18,7,5,53,26,27,61
Cliftonville,3923,2,18,3,9,58,38,20,57
Linfield,3923,3,14,8,8,54,33,21,50
Coleraine,3923,4,13,9,8,47,38,9,48
Ballymena,3923,5,11,12,7,51,51,0,45
Dungannon,3923,6,11,9,10,50,41,9,42
Portadown,3923,7,11,4,15,42,48,-6,37
Glenavon,3923,8,9,8,13,41,57,-16,35
Ards,3923,9,9,5,16,35,50,-15,32
Glentoran,3923,10,7,7,16,29,52,-23,28
Ballinamalla,3923,11,6,4,20,30,56,-26,22
Crusaders,3924,1,18,7,5,56,29,27,61
Cliftonville,3924,2,17,5,8,52,28,24,56
Linfield,3924,3,16,6,8,54,33,21,54
Glenavon,3924,4,15,9,6,47,38,9,54
Coleraine,3924,5,11,12,7,43,34,9,45
Dungannon,3924,6,12,8,10,59,41,18,44
Ballymena,3924,7,10,8,12,53,61,-8,38
Portadown,3924,8,9,4,17,25,49,-24,31
Ballinamalla,3924,9,8,3,19,24,50,-26,27
Glentoran,3924,10,6,7,17,24,49,-25,25
Ards,3924,11,7,3,20,36,61,-25,24
Cliftonville,3925,1,18,5,7,66,40,26,59
Crusaders,3925,2,16,7,7,54,35,19,55
Ballymena,3925,3,16,5,9,60,56,4,53
Linfield,3925,4,15,7,8,59,32,27,52
Coleraine,3925,5,12,11,7,46,42,4,47
Glenavon,3925,6,11,11,8,54,47,7,44
Dungannon,3925,7,8,9,13,49,47,2,33
Ards,3925,8,8,7,15,37,52,-15,31
Glentoran,3925,9,8,5,17,31,51,-20,29
Ballinamalla,3925,10,8,5,17,31,54,-23,29
Portadown,3925,11,7,4,19,23,54,-31,25
Crusaders,3926,1,15,8,7,59,35,24,53
Cliftonville,3926,2,16,4,10,61,42,19,52
Linfield,3926,3,14,9,7,67,39,28,51
Coleraine,3926,4,14,9,7,40,32,8,51
Ballymena,3926,5,15,5,10,61,65,-4,50
Dungannon,3926,6,9,10,11,50,51,-1,37
Glenavon,3926,7,9,10,11,39,48,-9,37
Glentoran,3926,8,10,7,13,33,45,-12,37
Portadown,3926,9,10,4,16,35,44,-9,34
Ballinamalla,3926,10,8,5,17,35,57,-22,29
Ards,3926,11,8,3,19,40,62,-22,27
Crusaders,3927,1,18,4,8,56,33,23,58
Cliftonville,3927,2,16,4,10,50,39,11,52
Glenavon,3927,3,13,10,7,51,47,4,49
Ballymena,3927,4,13,6,11,56,57,-1,45
Linfield,3927,5,11,11,8,54,38,16,44
Dungannon,3927,6,11,9,10,49,39,10,42
Coleraine,3927,7,8,13,9,36,39,-3,37
Ballinamalla,3927,8,11,2,17,31,44,-13,35
Ards,3927,9,9,6,15,37,47,-10,33
Glentoran,3927,10,8,8,14,25,43,-18,32
Portadown,3927,11,8,5,17,29,48,-19,29
Cliftonville,3928,1,15,7,8,50,35,15,52
Crusaders,3928,2,14,10,6,50,37,13,52
Linfield,3928,3,14,9,7,53,29,24,51
Glenavon,3928,4,11,12,7,47,43,4,45
Ballymena,3928,5,12,9,9,61,59,2,45
Coleraine,3928,6,11,11,8,48,41,7,44
Ards,3928,7,11,5,14,45,47,-2,38
Glentoran,3928,8,11,5,14,29,38,-9,38
Dungannon,3928,9,8,10,12,48,53,-5,34
Ballinamalla,3928,10,8,7,15,29,48,-19,31
Portadown,3928,11,6,3,21,23,53,-30,21
Crusaders,3929,1,16,9,5,53,34,19,57
Cliftonville,3929,2,17,3,10,52,37,15,54
Ballymena,3929,3,14,8,8,60,56,4,50
Linfield,3929,4,12,10,8,56,43,13,46
Coleraine,3929,5,12,8,10,44,43,1,44
Glenavon,3929,6,11,8,11,48,50,-2,41
Glentoran,3929,7,11,7,12,43,47,-4,40
Dungannon,3929,8,10,8,12,58,50,8,38
Ards,3929,9,10,5,15,36,51,-15,35
Ballinamalla,3929,10,8,6,16,36,52,-16,30
Portadown,3929,11,5,6,19,26,49,-23,21
Crusaders,3930,1,19,7,4,60,30,30,64
Cliftonville,3930,2,16,5,9,53,41,12,53
Linfield,3930,3,13,12,5,56,31,25,51
Coleraine,3930,4,11,10,9,39,33,6,43
Ballymena,3930,5,11,7,12,54,59,-5,40
Glenavon,3930,6,9,12,9,45,46,-1,39
Ards,3930,7,9,9,12,42,49,-7,36
Dungannon,3930,8,9,7,14,44,51,-7,34
Glentoran,3930,9,8,9,13,26,40,-14,33
Ballinamalla,3930,10,8,7,15,34,51,-17,31
Portadown,3930,11,7,5,18,23,45,-22,26
Crusaders,3931,1,18,7,5,55,31,24,61
Glenavon,3931,2,13,11,6,50,43,7,50
Linfield,3931,3,12,12,6,60,35,25,48
Cliftonville,3931,4,14,5,11,48,36,12,47
Ballymena,3931,5,13,5,12,55,58,-3,44
Coleraine,3931,6,9,11,10,41,46,-5,38
Dungannon,3931,7,9,10,11,44,41,3,37
Glentoran,3931,8,9,7,14,30,41,-11,34
Ballinamalla,3931,9,10,4,16,28,48,-20,34
Ards,3931,10,9,5,16,40,53,-13,32
Portadown,3931,11,8,5,17,31,50,-19,29
Crusaders,3932,1,18,9,3,64,36,28,63
Cliftonville,3932,2,16,5,9,56,41,15,53
Linfield,3932,3,11,13,6,62,37,25,46
Ballymena,3932,4,13,7,10,56,55,1,46
Glenavon,3932,5,10,12,8,50,46,4,42
Coleraine,3932,6,9,11,10,39,40,-1,38
Ballinamalla,3932,7,11,4,15,35,49,-14,37
Dungannon,3932,8,9,9,12,48,48,0,36
Ards,3932,9,7,8,15,35,50,-15,29
Glentoran,3932,10,6,11,13,26,46,-20,29
Portadown,3932,11,8,5,17,26,49,-23,29
Crusaders,3933,1,16,7,7,59,42,17,55
Linfield,3933,2,14,12,4,63,32,31,54
Glenavon,3933,3,12,12,6,51,49,2,48
Ballymena,3933,4,13,8,9,58,56,2,47
Dungannon,3933,5,11,12,7,49,38,11,45
Cliftonville,3933,6,12,7,11,44,40,4,43
Coleraine,3933,7,10,10,10,45,43,2,40
Ards,3933,8,12,2,16,45,51,-6,38
Glentoran,3933,9,7,9,14,32,51,-19,30
Ballinamalla,3933,10,8,4,18,30,47,-17,28
Portadown,3933,11,5,7,18,21,48,-27,22
Crusaders,3934,1,17,8,5,60,38,22,59
Linfield,3934,2,15,8,7,59,32,27,53
Cliftonville,3934,3,16,5,9,51,43,8,53
Coleraine,3934,4,12,11,7,45,37,8,47
Ballymena,3934,5,13,5,12,52,56,-4,44
Dungannon,3934,6,11,10,9,50,40,10,43
Glentoran,3934,7,12,6,12,39,41,-2,42
Glenavon,3934,8,10,10,10,49,44,5,40
Ards,3934,9,10,7,13,34,45,-11,37
Ballinamalla,3934,10,6,4,20,29,55,-26,22
Portadown,3934,11,4,4,22,20,57,-37,16
Linfield,3935,1,18,7,5,65,26,39,61
Cliftonville,3935,2,17,5,8,60,39,21,56
Crusaders,3935,3,16,6,8,47,36,11,54
Glenavon,3935,4,13,10,7,49,41,8,49
Ballymena,3935,5,13,8,9,57,53,4,47
Coleraine,3935,6,11,12,7,46,41,5,45
Dungannon,3935,7,10,9,11,50,45,5,39
Glentoran,3935,8,8,5,17,25,42,-17,29
Ballinamalla,3935,9,8,5,17,26,50,-24,29
Ards,3935,10,7,4,19,32,55,-23,25
Portadown,3935,11,6,5,19,20,49,-29,23
Crusaders,3936,1,16,7,7,60,40,20,55
Linfield,3936,2,15,8,7,58,31,27,53
Ballymena,3936,3,13,7,10,59,61,-2,46
Dungannon,3936,4,12,9,9,57,44,13,45
Coleraine,3936,5,12,9,9,52,41,11,45
Cliftonville,3936,6,13,6,11,51,43,8,45
Glenavon,3936,7,12,9,9,48,47,1,45
Glentoran,3936,8,9,7,14,28,48,-20,34
Portadown,3936,9,10,3,17,37,54,-17,33
Ards,3936,10,9,4,17,35,50,-15,31
Ballinamalla,3936,11,7,5,18,28,54,-26,26
Linfield,3937,1,17,7,6,63,32,31,58
Crusaders,3937,2,16,8,6,59,34,25,56
Cliftonville,3937,3,16,6,8,51,38,13,54
Glenavon,3937,4,14,8,8,50,46,4,50
Coleraine,3937,5,10,12,8,47,41,6,42
Ballymena,3937,6,11,7,12,62,63,-1,40
Ards,3937,7,12,3,15,36,50,-14,39
Dungannon,3937,8,9,9,12,53,51,2,36
Glentoran,3937,9,8,9,13,32,45,-13,33
Portadown,3937,10,7,6,17,25,47,-22,27
Ballinamalla,3937,11,5,5,20,22,53,-31,20
Crusaders,3938,1,17,8,5,65,40,25,59
Linfield,3938,2,15,8,7,52,28,24,53
Dungannon,3938,3,14,7,9,59,38,21,49
Cliftonville,3938,4,14,6,10,55,41,14,48
Glenavon,3938,5,12,9,9,47,46,1,45
Ballymena,3938,6,11,9,10,61,62,-1,42
Coleraine,3938,7,8,14,8,39,39,0,38
Glentoran,3938,8,11,5,14,30,43,-13,38
Ards,3938,9,9,6,15,37,55,-18,33
Ballinamalla,3938,10,8,4,18,28,53,-25,28
Portadown,3938,11,6,4,20,24,52,-28,22
Crusaders,3939,1,16,9,5,54,34,20,57
Linfield,3939,2,15,9,6,60,30,30,54
Ballymena,3939,3,13,8,9,52,53,-1,47
Glenavon,3939,4,9,16,5,46,40,6,43
Portadown,3939,5,11,7,12,35,38,-3,40
Cliftonville,3939,6,12,3,15,48,48,0,39
Dungannon,3939,7,10,8,12,52,49,3,38
Ards,3939,8,11,4,15,41,53,-12,37
Coleraine,3939,9,9,9,12,41,46,-5,36
Ballinamalla,3939,10,8,7,15,30,48,-18,31
Glentoran,3939,11,6,10,14,26,46,-20,28
Linfield,3940,1,17,8,5,64,27,37,59
Crusaders,3940,2,14,10,6,51,33,18,52
Cliftonville,3940,3,15,7,8,53,39,14,52
Glenavon,3940,4,13,11,6,48,41,7,50
Ballymena,3940,5,14,4,12,57,60,-3,46
Coleraine,3940,6,11,8,11,42,38,4,41
Dungannon,3940,7,8,12,10,46,43,3,36
Portadown,3940,8,9,7,14,29,46,-17,34
Glentoran,3940,9,6,10,14,31,50,-19,28
Ards,3940,10,7,6,17,36,51,-15,27
Ballinamalla,3940,11,7,5,18,35,64,-29,26
Linfield,3941,1,19,8,3,67,26,41,65
Crusaders,3941,2,14,11,5,55,34,21,53
Ballymena,3941,3,15,6,9,59,55,4,51
Dungannon,3941,4,12,9,9,52,43,9,45
Glenavon,3941,5,11,10,9,50,50,0,43
Cliftonville,3941,6,12,5,13,47,42,5,41
Ards,3941,7,11,6,13,45,49,-4,39
Glentoran,3941,8,10,8,12,28,42,-14,38
Coleraine,3941,9,9,7,14,35,46,-11,34
Ballinamalla,3941,10,6,6,18,28,50,-22,24
Portadown,3941,11,4,8,18,15,44,-29,20
Linfield,3942,1,17,9,4,59,24,35,60
Ballymena,3942,2,16,7,7,59,52,7,55
Crusaders,3942,3,14,7,9,51,38,13,49
Cliftonville,3942,4,14,4,12,50,43,7,46
Coleraine,3942,5,12,10,8,40,37,3,46
Glenavon,3942,6,12,8,10,49,46,3,44
Dungannon,3942,7,10,9,11,45,43,2,39
Ards,3942,8,10,4,16,39,52,-13,34
Portadown,3942,9,8,6,16,27,42,-15,30
Glentoran,3942,10,8,6,16,26,44,-18,30
Ballinamalla,3942,11,5,8,17,22,46,-24,23
Crusaders,3943,1,16,7,7,49,33,16,55
Cliftonville,3943,2,16,4,10,53,37,16,52
Glenavon,3943,3,13,11,6,48,41,7,50
Ballymena,3943,4,14,6,10,58,62,-4,48
Linfield,3943,5,13,8,9,59,32,27,47
Dungannon,3943,6,12,9,9,51,42,9,45
Coleraine,3943,7,11,9,10,45,41,4,42
Ards,3943,8,9,6,15,40,50,-10,33
Glentoran,3943,9,8,7,15,28,46,-18,31
Ballinamalla,3943,10,8,5,17,33,49,-16,29
Portadown,3943,11,7,4,19,19,50,-31,25
Linfield,3944,1,16,11,3,63,27,36,59
Crusaders,3944,2,16,9,5,63,36,27,57
Cliftonville,3944,3,16,8,6,60,37,23,56
Ballymena,3944,4,13,6,11,52,60,-8,45
Dungannon,3944,5,9,12,9,45,38,7,39
Glenavon,3944,6,9,10,11,46,49,-3,37
Coleraine,3944,7,8,11,11,35,45,-10,35
Portadown,3944,8,10,4,16,26,44,-18,34
Glentoran,3944,9,7,10,13,32,43,-11,31
Ards,3944,10,7,9,14,35,49,-14,30
Ballinamalla,3944,11,6,6,18,26,55,-29,24
Cliftonville,3945,1,18,4,8,53,31,22,58
Crusaders,3945,2,16,7,7,61,37,24,55
Coleraine,3945,3,13,9,8,42,35,7,48
Linfield,3945,4,12,10,8,51,40,11,46
Ballymena,3945,5,13,6,11,60,61,-1,45
Glenavon,3945,6,10,10,10,44,45,-1,40
Ards,3945,7,11,5,14,41,47,-6,38
Glentoran,3945,8,6,13,11,29,42,-13,31
Ballinamalla,3945,9,8,7,15,28,45,-17,31
Dungannon,3945,10,6,12,12,45,53,-8,30
Portadown,3945,11,8,5,17,28,46,-18,29
Crusaders,3946,1,15,8,7,51,30,21,53
Ballymena,3946,2,16,4,10,53,51,2,52
Coleraine,3946,3,14,8,8,45,36,9,50
Glenavon,3946,4,13,9,8,51,41,10,48
Linfield,3946,5,12,11,7,46,28,18,47
Cliftonville,3946,6,13,7,10,44,37,7,46
Dungannon,3946,7,10,7,13,45,47,-2,37
Glentoran,3946,8,10,6,14,31,46,-15,36
Ards,3946,9,10,4,16,40,46,-6,34
Portadown,3946,10,8,6,16,26,45,-19,30
Ballinamalla,3946,11,7,4,19,24,49,-25,25
Cliftonville,3947,1,18,2,10,56,35,21,56
Crusaders,3947,2,16,6,8,55,39,16,54
Coleraine,3947,3,14,10,6,51,40,11,52
Ballymena,3947,4,15,6,9,58,56,2,51
Glenavon,3947,5,13,10,7,61,42,19,49
Linfield,3947,6,14,6,10,58,40,18,48
Dungannon,3947,7,11,9,10,49,47,2,42
Glentoran,3947,8,8,8,14,32,47,-15,32
Portadown,3947,9,9,3,18,26,52,-26,30
Ballinamalla,3947,10,7,4,19,26,53,-27,25
Ards,3947,11,5,6,19,34,55,-21,21
Crusaders,3948,1,17,7,6,59,35,24,58
Linfield,3948,2,15,8,7,60,33,27,53
Ballymena,3948,3,16,4,10,61,56,5,52
Coleraine,3948,4,14,9,7,47,32,15,51
Cliftonville,3948,5,13,5,12,43,38,5,44
Dungannon,3948,6,11,7,12,47,44,3,40
Glenavon,3948,7,10,9,11,45,50,-5,39
Glentoran,3948,8,10,5,15,34,51,-17,35
Ards,3948,9,8,8,14,38,53,-15,32
Ballinamalla,3948,10,6,8,16,33,53,-20,26
Portadown,3948,11,6,8,16,28,50,-22,26
Crusaders,3949,1,17,8,5,56,36,20,59
Coleraine,3949,2,15,9,6,60,33,27,54
Linfield,3949,3,15,8,7,58,33,25,53
Cliftonville,3949,4,15,6,9,52,39,13,51
Glenavon,3949,5,12,7,11,46,45,1,43
Ballymena,3949,6,12,6,12,54,66,-12,42
Ards,3949,7,10,7,13,41,50,-9,37
Ballinamalla,3949,8,10,4,16,38,51,-13,34
Glentoran,3949,9,7,8,15,26,46,-20,29
Dungannon,3949,10,7,7,16,40,50,-10,28
Portadown,3949,11,7,6,17,31,53,-22,27
Linfield,3950,1,16,10,4,64,30,34,58
Crusaders,3950,2,16,8,6,60,34,26,56
Cliftonville,3950,3,16,4,10,49,39,10,52
Ballymena,3950,4,14,8,8,66,62,4,50
Glenavon,3950,5,11,14,5,40,34,6,47
Coleraine,3950,6,11,10,9,40,39,1,43
Dungannon,3950,7,11,8,11,54,45,9,41
Ards,3950,8,9,7,14,41,51,-10,34
Portadown,3950,9,7,5,18,25,49,-24,26
Glentoran,3950,10,5,8,17,23,46,-23,23
Ballinamalla,3950,11,6,4,20,27,60,-33,22
Linfield,3951,1,16,7,7,60,32,28,55
Crusaders,3951,2,13,11,6,52,32,20,50
Cliftonville,3951,3,15,5,10,60,48,12,50
Ballymena,3951,4,12,9,9,62,62,0,45
Glenavon,3951,5,11,12,7,48,48,0,45
Dungannon,3951,6,11,11,8,55,38,17,44
Coleraine,3951,7,10,13,7,42,40,2,43
Ballinamalla,3951,8,9,6,15,35,49,-14,33
Ards,3951,9,8,7,15,43,57,-14,31
Glentoran,3951,10,7,7,16,34,53,-19,28
Portadown,3951,11,7,4,19,30,62,-32,25
Crusaders,3952,1,18,8,4,60,31,29,62
Coleraine,3952,2,13,11,6,48,38,10,50
Ballymena,3952,3,14,8,8,67,59,8,50
Linfield,3952,4,13,7,10,53,34,19,46
Cliftonville,3952,5,14,4,12,54,47,7,46
Dungannon,3952,6,11,8,11,52,45,7,41
Glenavon,3952,7,9,13,8,45,50,-5,40
Ards,3952,8,10,5,15,43,53,-10,35
Glentoran,3952,9,9,6,15,32,44,-12,33
Ballinamalla,3952,10,7,5,18,27,55,-28,26
Portadown,3952,11,6,7,17,21,46,-25,25
Crusaders,3953,1,19,5,6,54,28,26,62
Cliftonville,3953,2,17,4,9,52,35,17,55
Ballymena,3953,3,14,8,8,60,53,7,50
Linfield,3953,4,12,10,8,53,33,20,46
Dungannon,3953,5,12,9,9,52,42,10,45
Glenavon,3953,6,12,8,10,44,45,-1,44
Coleraine,3953,7,9,10,11,38,44,-6,37
Ards,3953,8,10,6,14,41,50,-9,36
Glentoran,3953,9,7,10,13,28,42,-14,31
Portadown,3953,10,7,7,16,29,50,-21,28
Ballinamalla,3953,11,5,5,20,29,58,-29,20
Linfield,3954,1,17,9,4,69,28,41,60
Cliftonville,3954,2,18,4,8,54,37,17,58
Crusaders,3954,3,16,8,6,60,41,19,56
Ballymena,3954,4,13,10,7,57,51,6,49
Glenavon,3954,5,12,12,6,50,45,5,48
Coleraine,3954,6,13,8,9,48,38,10,47
Dungannon,3954,7,9,9,12,48,43,5,36
Glentoran,3954,8,9,8,13,33,52,-19,35
Ards,3954,9,7,3,20,34,56,-22,24
Portadown,3954,10,5,6,19,22,49,-27,21
Ballinamalla,3954,11,5,5,20,28,63,-35,20
Crusaders,3955,1,15,8,7,47,36,11,53
Linfield,3955,2,13,11,6,62,40,22,50
Cliftonville,3955,3,15,5,10,60,47,13,50
Ballymena,3955,4,14,5,11,61,60,1,47
Coleraine,3955,5,12,9,9,52,43,9,45
Glentoran,3955,6,11,9,10,41,44,-3,42
Dungannon,3955,7,10,9,11,53,45,8,39
Glenavon,3955,8,9,11,10,50,49,1,38
Ards,3955,9,9,6,15,34,49,-15,33
Portadown,3955,10,9,6,15,25,44,-19,33
Ballinamalla,3955,11,6,5,19,25,53,-28,23
Crusaders,3956,1,16,7,7,57,32,25,55
Cliftonville,3956,2,16,3,11,53,40,13,51
Linfield,3956,3,12,11,7,56,37,19,47
Glenavon,3956,4,11,11,8,47,42,5,44
Ballymena,3956,5,12,7,11,55,65,-10,43
Glentoran,3956,6,12,6,12,42,44,-2,42
Coleraine,3956,7,9,13,8,39,41,-2,40
Portadown,3956,8,11,3,16,32,46,-14,36
Ballinamalla,3956,9,9,7,14,36,51,-15,34
Dungannon,3956,10,7,10,13,44,46,-2,31
Ards,3956,11,7,8,15,35,52,-17,29
Ballymena,3957,1,16,6,8,63,51,12,54
Glenavon,3957,2,14,9,7,54,47,7,51
Crusaders,3957,3,13,11,6,53,40,13,50
Linfield,3957,4,12,13,5,56,32,24,49
Dungannon,3957,5,13,9,8,54,38,16,48
Cliftonville,3957,6,14,6,10,57,43,14,48
Coleraine,3957,7,13,8,9,47,42,5,47
Ards,3957,8,8,5,17,35,53,-18,29
Glentoran,3957,9,6,10,14,24,42,-18,28
Portadown,3957,10,6,9,15,22,44,-22,27
Ballinamalla,3957,11,5,4,21,23,56,-33,19
Linfield,3958,1,16,8,6,58,28,30,56
Crusaders,3958,2,13,9,8,53,40,13,48
Ballymena,3958,3,13,7,10,60,55,5,46
Cliftonville,3958,4,13,5,12,47,46,1,44
Dungannon,3958,5,11,10,9,57,47,10,43
Ards,3958,6,13,4,13,43,45,-2,43
Glenavon,3958,7,10,12,8,46,40,6,42
Glentoran,3958,8,11,7,12,34,41,-7,40
Coleraine,3958,9,10,9,11,38,44,-6,39
Portadown,3958,10,8,6,16,28,46,-18,30
Ballinamalla,3958,11,6,5,19,24,56,-32,23
Crusaders,3959,1,15,10,5,56,36,20,55
Cliftonville,3959,2,17,4,9,53,37,16,55
Linfield,3959,3,14,11,5,61,36,25,53
Ballymena,3959,4,15,6,9,60,57,3,51
Coleraine,3959,5,10,11,9,43,39,4,41
Ards,3959,6,10,9,11,40,48,-8,39
Glenavon,3959,7,8,11,11,40,47,-7,35
Dungannon,3959,8,9,7,14,46,47,-1,34
Ballinamalla,3959,9,9,4,17,26,45,-19,31
Glentoran,3959,10,7,9,14,31,44,-13,30
Portadown,3959,11,7,6,17,27,47,-20,27
Linfield,3960,1,15,9,6,67,35,32,54
Cliftonville,3960,2,15,5,10,54,37,17,50
Ballymena,3960,3,14,5,11,60,54,6,47
Crusaders,3960,4,13,8,9,46,40,6,47
Glenavon,3960,5,12,10,8,51,45,6,46
Dungannon,3960,6,10,11,9,48,39,9,41
Glentoran,3960,7,11,8,11,33,42,-9,41
Coleraine,3960,8,9,10,11,35,45,-10,37
Ballinamalla,3960,9,9,5,16,31,50,-19,32
Portadown,3960,10,9,4,17,27,49,-22,31
Ards,3960,11,8,5,17,36,52,-16,29
Crusaders,3961,1,20,6,4,57,22,35,66
Linfield,3961,2,13,12,5,55,32,23,51
Coleraine,3961,3,12,11,7,41,36,5,47
Ballymena,3961,4,13,7,10,56,54,2,46
Glenavon,3961,5,11,12,7,44,37,7,45
Cliftonville,3961,6,13,5,12,42,42,0,44
Dungannon,3961,7,10,11,9,53,40,13,41
Glentoran,3961,8,8,10,12,36,45,-9,34
Ards,3961,9,7,7,16,35,58,-23,28
Ballinamalla,3961,10,5,8,17,26,52,-26,23
Portadown,3961,11,5,7,18,19,46,-27,22
Crusaders,3962,1,15,10,5,56,34,22,55
Linfield,3962,2,15,8,7,59,35,24,53
Glenavon,3962,3,14,9,7,49,39,10,51
Cliftonville,3962,4,15,5,10,56,46,10,50
Ballymena,3962,5,15,4,11,58,52,6,49
Coleraine,3962,6,10,11,9,36,31,5,41
Dungannon,3962,7,8,11,11,43,43,0,35
Ballinamalla,3962,8,10,4,16,32,50,-18,34
Ards,3962,9,8,6,16,39,53,-14,30
Glentoran,3962,10,8,6,16,29,50,-21,30
Portadown,3962,11,7,6,17,21,45,-24,27
Crusaders,3963,1,17,6,7,54,35,19,57
Coleraine,3963,2,15,10,5,50,34,16,55
Cliftonville,3963,3,15,6,9,55,36,19,51
Linfield,3963,4,12,12,6,51,30,21,48
Ballymena,3963,5,12,7,11,56,62,-6,43
Glentoran,3963,6,11,8,11,33,42,-9,41
Dungannon,3963,7,9,12,9,45,40,5,39
Glenavon,3963,8,7,14,9,41,43,-2,35
Ards,3963,9,9,4,17,39,54,-15,31
Ballinamalla,3963,10,7,5,18,34,55,-21,26
Portadown,3963,11,6,6,18,28,55,-27,24
Crusaders,3964,1,17,6,7,60,34,26,57
Ballymena,3964,2,15,7,8,54,50,4,52
Cliftonville,3964,3,15,6,9,50,39,11,51
Linfield,3964,4,12,10,8,58,42,16,46
Glenavon,3964,5,11,12,7,53,47,6,45
Dungannon,3964,6,10,12,8,53,43,10,42
Coleraine,3964,7,10,11,9,48,45,3,41
Ballinamalla,3964,8,11,2,17,32,46,-14,35
Ards,3964,9,9,6,15,36,48,-12,33
Glentoran,3964,10,7,8,15,24,45,-21,29
Portadown,3964,11,5,6,19,26,55,-29,21
Linfield,3965,1,16,10,4,64,27,37,58
Crusaders,3965,2,14,8,8,49,35,14,50
Cliftonville,3965,3,14,5,11,50,43,7,47
Coleraine,3965,4,12,9,9,49,46,3,45
Glenavon,3965,5,11,11,8,47,50,-3,44
Ballymena,3965,6,11,9,10,49,56,-7,42
Dungannon,3965,7,10,8,12,54,50,4,38
Glentoran,3965,8,10,7,13,35,41,-6,37
Ards,3965,9,9,6,15,35,45,-10,33
Portadown,3965,10,8,7,15,27,43,-16,31
Ballinamalla,3965,11,8,4,18,32,55,-23,28
Linfield,3966,1,15,10,5,56,29,27,55
Ballymena,3966,2,16,6,8,60,53,7,54
Crusaders,3966,3,15,6,9,54,36,18,51
Cliftonville,3966,4,15,6,9,49,35,14,51
Glenavon,3966,5,13,10,7,52,44,8,49
Coleraine,3966,6,12,11,7,48,42,6,47
Ards,3966,7,10,5,15,43,53,-10,35
Dungannon,3966,8,8,10,12,50,49,1,34
Glentoran,3966,9,9,6,15,33,46,-13,33
Ballinamalla,3966,10,6,8,16,28,51,-23,26
Portadown,3966,11,4,6,20,24,59,-35,18
Crusaders,3967,1,20,6,4,54,23,31,66
Cliftonville,3967,2,17,3,10,53,36,17,54
Linfield,3967,3,13,11,6,52,26,26,50
Dungannon,3967,4,14,7,9,52,40,12,49
Ballymena,3967,5,14,6,10,56,55,1,48
Glenavon,3967,6,9,11,10,42,44,-2,38
Glentoran,3967,7,10,7,13,34,43,-9,37
Coleraine,3967,8,7,12,11,38,46,-8,33
Portadown,3967,9,7,6,17,20,40,-20,27
Ballinamalla,3967,10,7,6,17,26,52,-26,27
Ards,3967,11,7,5,18,31,53,-22,26
Linfield,3968,1,16,7,7,55,29,26,55
Crusaders,3968,2,15,10,5,58,35,23,55
Ballymena,3968,3,15,4,11,56,49,7,49
Glenavon,3968,4,11,12,7,53,48,5,45
Dungannon,3968,5,12,7,11,57,45,12,43
Cliftonville,3968,6,12,7,11,50,50,0,43
Ards,3968,7,13,3,14,39,47,-8,42
Coleraine,3968,8,9,11,10,45,46,-1,38
Ballinamalla,3968,9,9,4,17,35,52,-17,31
Glentoran,3968,10,8,7,15,24,41,-17,31
Portadown,3968,11,6,6,18,22,52,-30,24
Crusaders,3969,1,16,8,6,58,38,20,56
Linfield,3969,2,15,9,6,68,38,30,54
Cliftonville,3969,3,15,8,7,61,36,25,53
Coleraine,3969,4,12,11,7,48,37,11,47
Glenavon,3969,5,10,13,7,51,45,6,43
Dungannon,3969,6,10,9,11,51,46,5,39
Ballymena,3969,7,10,9,11,52,65,-13,39
Glentoran,3969,8,10,7,13,30,40,-10,37
Ards,3969,9,8,6,16,36,53,-17,30
Portadown,3969,10,6,9,15,25,53,-28,27
Ballinamalla,3969,11,6,5,19,26,55,-29,23
Crusaders,3970,1,17,5,8,53,34,19,56
Coleraine,3970,2,14,11,5,59,37,22,53
Cliftonville,3970,3,14,8,8,51,37,14,50
Linfield,3970,4,14,7,9,54,33,21,49
Glenavon,3970,5,12,9,9,42,43,-1,45
Ballymena,3970,6,12,8,10,57,60,-3,44
Dungannon,3970,7,12,7,11,60,47,13,43
Glentoran,3970,8,12,6,12,34,44,-10,42
Ards,3970,9,8,5,17,37,54,-17,29
Portadown,3970,10,6,6,18,22,52,-30,24
Ballinamalla,3970,11,7,2,21,30,58,-28,23
Crusaders,3971,1,18,7,5,56,34,22,61
Cliftonville,3971,2,19,4,7,56,36,20,61
Ballymena,3971,3,15,4,11,58,59,-1,49
Linfield,3971,4,12,9,9,57,35,22,45
Glenavon,3971,5,12,8,10,56,48,8,44
Coleraine,3971,6,10,11,9,41,43,-2,41
Portadown,3971,7,10,7,13,29,38,-9,37
Dungannon,3971,8,8,9,13,43,50,-7,33
Ballinamalla,3971,9,9,4,17,28,44,-16,31
Ards,3971,10,9,2,19,41,55,-14,29
Glentoran,3971,11,6,9,15,27,50,-23,27
Crusaders,3972,1,19,8,3,62,32,30,65
Linfield,3972,2,15,12,3,59,29,30,57
Cliftonville,3972,3,18,3,9,52,37,15,57
Ballymena,3972,4,14,6,10,56,57,-1,48
Glenavon,3972,5,12,10,8,53,42,11,46
Coleraine,3972,6,9,12,9,42,46,-4,39
Glentoran,3972,7,8,9,13,39,52,-13,33
Dungannon,3972,8,7,8,15,44,53,-9,29
Ballinamalla,3972,9,7,8,15,30,48,-18,29
Ards,3972,10,7,7,16,38,52,-14,28
Portadown,3972,11,5,5,20,18,45,-27,20
Linfield,3973,1,16,9,5,65,26,39,57
Cliftonville,3973,2,17,5,8,63,39,24,56
Crusaders,3973,3,16,5,9,60,44,16,53
Ballymena,3973,4,16,4,10,69,60,9,52
Glenavon,3973,5,11,12,7,46,42,4,45
Glentoran,3973,6,13,5,12,29,38,-9,44
Coleraine,3973,7,11,9,10,42,42,0,42
Dungannon,3973,8,10,7,13,45,47,-2,37
Portadown,3973,9,7,7,16,22,50,-28,28
Ards,3973,10,5,8,17,29,47,-18,23
Ballinamalla,3973,11,5,5,20,26,61,-35,20
Crusaders,3974,1,16,8,6,60,39,21,56
Cliftonville,3974,2,17,3,10,58,44,14,54
Glenavon,3974,3,14,8,8,57,41,16,50
Linfield,3974,4,12,11,7,55,32,23,47
Ballymena,3974,5,13,7,10,60,60,0,46
Coleraine,3974,6,11,12,7,40,34,6,45
Dungannon,3974,7,11,10,9,55,44,11,43
Glentoran,3974,8,9,8,13,26,44,-18,35
Ards,3974,9,9,4,17,34,53,-19,31
Ballinamalla,3974,10,6,6,18,29,52,-23,24
Portadown,3974,11,5,7,18,21,52,-31,22
Crusaders,3975,1,18,7,5,60,35,25,61
Coleraine,3975,2,14,9,7,50,41,9,51
Glenavon,3975,3,13,11,6,56,47,9,50
Linfield,3975,4,12,11,7,53,31,22,47
Cliftonville,3975,5,12,9,9,52,43,9,45
Dungannon,3975,6,12,6,12,54,47,7,42
Ballymena,3975,7,11,9,10,55,58,-3,42
Glentoran,3975,8,9,8,13,27,43,-16,35
Ards,3975,9,6,8,16,30,47,-17,26
Ballinamalla,3975,10,6,7,17,28,49,-21,25
Portadown,3975,11,5,9,16,22,46,-24,24
Cliftonville,3976,1,18,5,7,59,37,22,59
Crusaders,3976,2,15,5,10,50,35,15,50
Linfield,3976,3,13,10,7,62,37,25,49
Ballymena,3976,4,14,4,12,60,66,-6,46
Coleraine,3976,5,12,9,9,38,33,5,45
Glenavon,3976,6,10,12,8,46,46,0,42
Dungannon,3976,7,10,10,10,47,43,4,40
Portadown,3976,8,10,6,14,33,45,-12,36
Glentoran,3976,9,10,5,15,37,48,-11,35
Ards,3976,10,8,6,16,39,54,-15,30
Ballinamalla,3976,11,8,2,20,32,59,-27,26
Glenavon,3977,1,17,9,4,58,31,27,60
Crusaders,3977,2,17,6,7,56,33,23,57
Cliftonville,3977,3,13,5,12,50,44,6,44
Coleraine,3977,4,12,8,10,38,35,3,44
Linfield,3977,5,11,10,9,57,44,13,43
Ballymena,3977,6,12,6,12,55,56,-1,42
Dungannon,3977,7,10,10,10,50,40,10,40
Ards,3977,8,11,6,13,36,43,-7,39
Portadown,3977,9,8,7,15,24,43,-19,31
Ballinamalla,3977,10,8,5,17,26,50,-24,29
Glentoran,3977,11,8,4,18,34,65,-31,28
Cliftonville,3978,1,21,3,6,64,35,29,66
Crusaders,3978,2,15,9,6,57,37,20,54
Glentoran,3978,3,13,9,8,40,40,0,48
Glenavon,3978,4,13,8,9,50,39,11,47
Linfield,3978,5,12,9,9,50,32,18,45
Dungannon,3978,6,10,11,9,45,39,6,41
Ballymena,3978,7,11,5,14,46,59,-13,38
Coleraine,3978,8,8,11,11,41,46,-5,35
Ards,3978,9,9,6,15,34,47,-13,33
Portadown,3978,10,8,5,17,26,46,-20,29
Ballinamalla,3978,11,5,4,21,28,61,-33,19
Crusaders,3979,1,16,9,5,63,32,31,57
Glenavon,3979,2,15,9,6,44,36,8,54
Linfield,3979,3,13,11,6,58,35,23,50
Cliftonville,3979,4,14,8,8,51,35,16,50
Dungannon,3979,5,13,8,9,56,40,16,47
Ballymena,3979,6,13,7,10,55,62,-7,46
Ards,3979,7,12,5,13,48,47,1,41
Coleraine,3979,8,9,8,13,34,44,-10,35
Glentoran,3979,9,9,7,14,31,45,-14,34
Portadown,3979,10,5,6,19,25,50,-25,21
Ballinamalla,3979,11,5,4,21,25,64,-39,19
Crusaders,3980,1,17,6,7,62,37,25,57
Ballymena,3980,2,16,4,10,59,55,4,52
Linfield,3980,3,14,8,8,59,36,23,50
Cliftonville,3980,4,16,2,12,50,42,8,50
Coleraine,3980,5,12,10,8,43,35,8,46
Glenavon,3980,6,12,10,8,47,44,3,46
Ballinamalla,3980,7,10,7,13,34,49,-15,37
Ards,3980,8,9,5,16,33,44,-11,32
Dungannon,3980,9,6,12,12,42,46,-4,30
Glentoran,3980,10,8,6,16,33,50,-17,30
Portadown,3980,11,7,6,17,22,46,-24,27
Crusaders,3981,1,18,7,5,55,27,28,61
Linfield,3981,2,16,8,6,62,31,31,56
Cliftonville,3981,3,17,3,10,54,43,11,54
Ballymena,3981,4,13,6,11,58,57,1,45
Dungannon,3981,5,10,10,10,46,40,6,40
Coleraine,3981,6,10,10,10,40,40,0,40
Ards,3981,7,12,4,14,41,47,-6,40
Glenavon,3981,8,9,10,11,44,46,-2,37
Ballinamalla,3981,9,10,6,14,29,47,-18,36
Glentoran,3981,10,7,8,15,27,45,-18,29
Portadown,3981,11,4,6,20,19,52,-33,18
Cliftonville,3982,1,18,4,8,55,37,18,58
Linfield,3982,2,16,8,6,61,33,28,56
Crusaders,3982,3,16,6,8,54,45,9,54
Glenavon,3982,4,14,7,9,55,43,12,49
Ballymena,3982,5,13,5,12,55,59,-4,44
Coleraine,3982,6,11,9,10,41,38,3,42
Dungannon,3982,7,11,8,11,63,45,18,41
Glentoran,3982,8,9,6,15,29,45,-16,33
Ards,3982,9,9,4,17,40,59,-19,31
Ballinamalla,3982,10,8,5,17,33,53,-20,29
Portadown,3982,11,6,6,18,18,47,-29,24
Crusaders,3983,1,17,8,5,58,30,28,59
Cliftonville,3983,2,17,4,9,53,39,14,55
Linfield,3983,3,14,10,6,61,36,25,52
Coleraine,3983,4,13,10,7,49,37,12,49
Glenavon,3983,5,11,12,7,50,45,5,45
Ballymena,3983,6,10,9,11,51,60,-9,39
Ards,3983,7,11,2,17,43,55,-12,35
Ballinamalla,3983,8,9,5,16,34,55,-21,32
Dungannon,3983,9,7,9,14,42,50,-8,30
Portadown,3983,10,8,6,16,29,44,-15,30
Glentoran,3983,11,7,7,16,34,53,-19,28
Ballymena,3984,1,18,4,8,65,55,10,58
Crusaders,3984,2,15,8,7,58,37,21,53
Linfield,3984,3,14,9,7,59,33,26,51
Glenavon,3984,4,12,11,7,49,44,5,47
Cliftonville,3984,5,14,5,11,48,44,4,47
Coleraine,3984,6,9,13,8,43,38,5,40
Dungannon,3984,7,11,6,13,50,46,4,39
Ards,3984,8,11,6,13,41,43,-2,39
Glentoran,3984,9,8,6,16,33,56,-23,30
Portadown,3984,10,7,7,16,27,46,-19,28
Ballinamalla,3984,11,7,3,20,22,53,-31,24
Crusaders,3985,1,16,6,8,59,37,22,54
Cliftonville,3985,2,16,5,9,49,31,18,53
Coleraine,3985,3,14,10,6,42,34,8,52
Linfield,3985,4,14,7,9,58,35,23,49
Ballymena,3985,5,12,9,9,55,55,0,45
Glenavon,3985,6,11,10,9,47,40,7,43
Dungannon,3985,7,9,9,12,50,46,4,36
Ards,3985,8,10,5,15,34,43,-9,35
Glentoran,3985,9,9,7,14,30,52,-22,34
Portadown,3985,10,8,6,16,23,43,-20,30
Ballinamalla,3985,11,8,2,20,23,54,-31,26
Linfield,3986,1,16,8,6,66,35,31,56
Ballymena,3986,2,16,5,9,68,61,7,53
Crusaders,3986,3,13,11,6,54,38,16,50
Cliftonville,3986,4,14,6,10,46,35,11,48
Dungannon,3986,5,11,9,10,58,50,8,42
Coleraine,3986,6,10,11,9,41,43,-2,41
Glenavon,3986,7,9,12,9,48,49,-1,39
Portadown,3986,8,10,6,14,37,49,-12,36
Ards,3986,9,9,5,16,39,54,-15,32
Glentoran,3986,10,7,8,15,31,54,-23,29
Ballinamalla,3986,11,8,3,19,29,49,-20,27
Linfield,3987,1,19,7,4,67,27,40,64
Crusaders,3987,2,18,9,3,58,29,29,63
Cliftonville,3987,3,14,5,11,56,45,11,47
Ballymena,3987,4,14,5,11,56,54,2,47
Glenavon,3987,5,9,13,8,41,45,-4,40
Glentoran,3987,6,10,8,12,38,47,-9,38
Coleraine,3987,7,9,10,11,43,44,-1,37
Portadown,3987,8,9,6,15,24,44,-20,33
Dungannon,3987,9,6,13,11,49,56,-7,31
Ards,3987,10,8,5,17,32,49,-17,29
Ballinamalla,3987,11,4,9,17,24,48,-24,21
Linfield,3988,1,16,8,6,62,28,34,56
Cliftonville,3988,2,16,4,10,53,37,16,52
Crusaders,3988,3,15,6,9,46,37,9,51
Coleraine,3988,4,13,11,6,46,35,11,50
Dungannon,3988,5,13,9,8,60,42,18,48
Ballymena,3988,6,13,7,10,53,54,-1,46
Glenavon,3988,7,9,13,8,46,46,0,40
Glentoran,3988,8,9,7,14,32,45,-13,34
Ballinamalla,3988,9,9,4,17,25,51,-26,31
Portadown,3988,10,7,4,19,26,52,-26,25
Ards,3988,11,7,3,20,36,58,-22,24
Crusaders,3989,1,17,7,6,57,33,24,58
Linfield,3989,2,13,10,7,52,31,21,49
Coleraine,3989,3,12,11,7,44,32,12,47
Glenavon,3989,4,12,9,9,57,50,7,45
Cliftonville,3989,5,12,7,11,46,45,1,43
Ballymena,3989,6,12,6,12,49,56,-7,42
Portadown,3989,7,12,3,15,32,41,-9,39
Dungannon,3989,8,9,10,11,46,46,0,37
Glentoran,3989,9,9,9,12,31,41,-10,36
Ballinamalla,3989,10,9,5,16,27,46,-19,32
Ards,3989,11,7,5,18,29,49,-20,26
Cliftonville,3990,1,16,7,7,51,32,19,55
Crusaders,3990,2,15,10,5,56,38,18,55
Linfield,3990,3,13,12,5,55,33,22,51
Coleraine,3990,4,13,11,6,53,36,17,50
Glenavon,3990,5,13,8,9,50,42,8,47
Ballymena,3990,6,11,9,10,50,58,-8,42
Portadown,3990,7,9,6,15,27,42,-15,33
Ards,3990,8,9,5,16,36,51,-15,32
Glentoran,3990,9,6,11,13,36,51,-15,29
Dungannon,3990,10,6,10,14,40,47,-7,28
Ballinamalla,3990,11,5,9,16,24,48,-24,24
Linfield,3991,1,16,8,6,62,33,29,56
Ballymena,3991,2,14,7,9,54,51,3,49
Dungannon,3991,3,13,7,10,59,45,14,46
Coleraine,3991,4,12,10,8,52,42,10,46
Glenavon,3991,5,12,10,8,44,40,4,46
Cliftonville,3991,6,13,6,11,45,39,6,45
Crusaders,3991,7,13,5,12,45,39,6,44
Glentoran,3991,8,11,7,12,34,47,-13,40
Ballinamalla,3991,9,10,1,19,29,52,-23,31
Ards,3991,10,9,3,18,37,52,-15,30
Portadown,3991,11,8,4,18,30,51,-21,28
Cliftonville,3992,1,18,3,9,53,39,14,57
Crusaders,3992,2,15,8,7,53,35,18,53
Linfield,3992,3,13,11,6,56,30,26,50
Ballymena,3992,4,14,7,9,61,57,4,49
Dungannon,3992,5,10,12,8,53,40,13,42
Coleraine,3992,6,10,9,11,35,44,-9,39
Glenavon,3992,7,9,11,10,50,49,1,38
Ards,3992,8,9,5,16,41,52,-11,32
Glentoran,3992,9,7,10,13,32,50,-18,31
Portadown,3992,10,7,9,14,28,44,-16,30
Ballinamalla,3992,11,7,7,16,31,53,-22,28
Linfield,3993,1,17,8,5,61,30,31,59
Crusaders,3993,2,17,6,7,55,35,20,57
Cliftonville,3993,3,15,5,10,47,35,12,50
Glenavon,3993,4,13,8,9,49,42,7,47
Ballymena,3993,5,14,5,11,58,56,2,47
Dungannon,3993,6,11,11,8,57,44,13,44
Ards,3993,7,10,6,14,47,48,-1,36
Coleraine,3993,8,8,12,10,40,44,-4,36
Glentoran,3993,9,7,9,14,25,48,-23,30
Ballinamalla,3993,10,7,5,18,29,54,-25,26
Portadown,3993,11,6,5,19,26,58,-32,23
Crusaders,3994,1,16,8,6,52,35,17,56
Ballymena,3994,2,15,6,9,65,60,5,51
Linfield,3994,3,13,10,7,68,39,29,49
Cliftonville,3994,4,13,9,8,48,39,9,48
Coleraine,3994,5,10,14,6,42,39,3,44
Dungannon,3994,6,12,7,11,55,41,14,43
Glenavon,3994,7,9,14,7,47,45,2,41
Ards,3994,8,8,7,15,38,52,-14,31
Glentoran,3994,9,7,10,13,34,52,-18,31
Ballinamalla,3994,10,7,7,16,23,43,-20,28
Portadown,3994,11,6,6,18,23,50,-27,24
Crusaders,3995,1,19,10,1,64,26,38,67
Linfield,3995,2,15,10,5,60,31,29,55
Cliftonville,3995,3,14,5,11,54,40,14,47
Glenavon,3995,4,10,12,8,56,48,8,42
Ballymena,3995,5,11,9,10,53,63,-10,42
Dungannon,3995,6,11,7,12,59,53,6,40
Coleraine,3995,7,9,11,10,37,47,-10,38
Glentoran,3995,8,8,10,12,27,42,-15,34
Portadown,3995,9,8,6,16,21,46,-25,30
Ballinamalla,3995,10,7,7,16,28,48,-20,28
Ards,3995,11,7,5,18,36,51,-15,26
Linfield,3996,1,17,6,7,61,31,30,57
Crusaders,3996,2,15,7,8,56,36,20,52
Coleraine,3996,3,14,8,8,46,35,11,50
Glenavon,3996,4,13,9,8,50,46,4,48
Cliftonville,3996,5,14,5,11,45,39,6,47
Dungannon,3996,6,12,8,10,48,38,10,44
Ballymena,3996,7,13,4,13,60,65,-5,43
Ards,3996,8,9,5,16,37,52,-15,32
Ballinamalla,3996,9,9,4,17,30,46,-16,31
Portadown,3996,10,8,5,17,26,49,-23,29
Glentoran,3996,11,7,7,16,23,45,-22,28
Crusaders,3997,1,16,8,6,53,35,18,56
Cliftonville,3997,2,15,6,9,53,44,9,51
Ballymena,3997,3,15,6,9,53,54,-1,51
Coleraine,3997,4,13,11,6,48,35,13,50
Linfield,3997,5,13,10,7,60,35,25,49
Dungannon,3997,6,10,10,10,53,41,12,40
Glenavon,3997,7,9,12,9,52,51,1,39
Portadown,3997,8,8,8,14,29,38,-9,32
Ballinamalla,3997,9,9,4,17,31,50,-19,31
Glentoran,3997,10,7,6,17,24,51,-27,27
Ards,3997,11,6,7,17,34,56,-22,25
Crusaders,3998,1,19,9,2,64,28,36,66
Linfield,3998,2,15,9,6,59,31,28,54
Cliftonville,3998,3,15,5,10,54,46,8,50
Coleraine,3998,4,13,9,8,45,41,4,48
Glenavon,3998,5,11,11,8,43,39,4,44
Ballymena,3998,6,11,9,10,54,62,-8,42
Dungannon,3998,7,8,11,11,52,47,5,35
Glentoran,3998,8,6,13,11,31,44,-13,31
Ards,3998,9,7,6,17,35,53,-18,27
Ballinamalla,3998,10,6,9,15,25,47,-22,27
Portadown,3998,11,5,7,18,23,47,-24,22
Crusaders,3999,1,17,5,8,62,42,20,56
Cliftonville,3999,2,16,5,9,54,41,13,53
Ballymena,3999,3,15,6,9,69,59,10,51
Linfield,3999,4,11,12,7,55,37,18,45
Coleraine,3999,5,11,10,9,43,36,7,43
Dungannon,3999,6,10,11,9,51,45,6,41
Glenavon,3999,7,9,10,11,39,44,-5,37
Ballinamalla,3999,8,10,6,14,34,49,-15,36
Ards,3999,9,9,5,16,35,49,-14,32
Glentoran,3999,10,6,12,12,25,45,-20,30
Portadown,3999,11,7,6,17,28,48,-20,27
Crusaders,4000,1,16,10,4,54,29,25,58
Linfield,4000,2,16,8,6,57,29,28,56
Cliftonville,4000,3,15,6,9,50,36,14,51
Ballymena,4000,4,15,6,9,59,52,7,51
Glenavon,4000,5,11,10,9,45,46,-1,43
Coleraine,4000,6,11,8,11,41,41,0,41
Dungannon,4000,7,10,10,10,51,45,6,40
Ards,4000,8,10,4,16,41,59,-18,34
Glentoran,4000,9,8,5,17,33,46,-13,29
Portadown,4000,10,7,6,17,25,51,-26,27
Ballinamalla,4000,11,7,5,18,30,52,-22,26
Linfield,4001,1,17,7,6,57,28,29,58
Cliftonville,4001,2,17,3,10,50,32,18,54
Glenavon,4001,3,15,9,6,43,34,9,54
Crusaders,4001,4,15,5,10,55,42,13,50
Ballymena,4001,5,15,4,11,58,59,-1,49
Coleraine,4001,6,9,9,12,38,40,-2,36
Ballinamalla,4001,7,10,4,16,43,60,-17,34
Ards,4001,8,10,3,17,34,46,-12,33
Portadown,4001,9,10,3,17,25,38,-13,33
Dungannon,4001,10,8,8,14,45,51,-6,32
Glentoran,4001,11,8,7,15,26,44,-18,31
Crusaders,4002,1,17,11,2,53,32,21,62
Linfield,4002,2,14,8,8,63,37,26,50
Cliftonville,4002,3,14,7,9,55,38,17,49
Ballymena,4002,4,14,7,9,65,60,5,49
Coleraine,4002,5,10,14,6,41,31,10,44
Glenavon,4002,6,10,11,9,45,41,4,41
Glentoran,4002,7,11,6,13,33,47,-14,39
Ards,4002,8,10,5,15,41,52,-11,35
Dungannon,4002,9,7,10,13,49,56,-7,31
Portadown,4002,10,7,6,17,31,55,-24,27
Ballinamalla,4002,11,5,7,18,29,56,-27,22
Linfield,4003,1,17,8,5,75,38,37,59
Crusaders,4003,2,16,8,6,52,36,16,56
Ballymena,4003,3,14,6,10,60,65,-5,48
Cliftonville,4003,4,13,6,11,53,42,11,45
Coleraine,4003,5,10,12,8,39,35,4,42
Glenavon,4003,6,11,9,10,46,47,-1,42
Ballinamalla,4003,7,12,5,13,38,43,-5,41
Dungannon,4003,8,9,10,11,49,44,5,37
Ards,4003,9,8,7,15,35,48,-13,31
Glentoran,4003,10,6,9,15,28,52,-24,27
Portadown,4003,11,6,6,18,27,52,-25,24
Crusaders,4004,1,17,8,5,54,29,25,59
Ballymena,4004,2,17,5,8,59,51,8,56
Linfield,4004,3,15,8,7,64,28,36,53
Coleraine,4004,4,12,10,8,41,31,10,46
Glenavon,4004,5,10,14,6,50,46,4,44
Cliftonville,4004,6,12,8,10,42,38,4,44
Ards,4004,7,8,10,12,32,41,-9,34
Dungannon,4004,8,8,9,13,51,51,0,33
Portadown,4004,9,9,4,17,24,51,-27,31
Glentoran,4004,10,7,7,16,27,52,-25,28
Ballinamalla,4004,11,7,3,20,31,57,-26,24
Ballymena,4005,1,16,7,7,58,54,4,55
Crusaders,4005,2,15,9,6,51,33,18,54
Coleraine,4005,3,13,11,6,47,32,15,50
Linfield,4005,4,12,12,6,59,35,24,48
Cliftonville,4005,5,14,5,11,53,46,7,47
Glenavon,4005,6,13,8,9,49,44,5,47
Dungannon,4005,7,10,8,12,51,45,6,38
Ards,4005,8,8,6,16,38,47,-9,30
Glentoran,4005,9,6,11,13,31,45,-14,29
Portadown,4005,10,7,6,17,22,46,-24,27
Ballinamalla,4005,11,7,5,18,29,61,-32,26
Crusaders,4006,1,17,7,6,59,36,23,58
Linfield,4006,2,15,8,7,60,31,29,53
Ballymena,4006,3,14,7,9,65,62,3,49
Coleraine,4006,4,10,13,7,43,38,5,43
Cliftonville,4006,5,11,8,11,58,51,7,41
Glenavon,4006,6,11,8,11,55,51,4,41
Dungannon,4006,7,8,13,9,46,46,0,37
Ards,4006,8,9,6,15,35,47,-12,33
Glentoran,4006,9,9,6,15,30,47,-17,33
Ballinamalla,4006,10,10,3,17,31,55,-24,33
Portadown,4006,11,8,7,15,24,42,-18,31
Linfield,4007,1,16,11,3,62,31,31,59
Glenavon,4007,2,14,11,5,55,42,13,53
Crusaders,4007,3,15,7,8,55,40,15,52
Cliftonville,4007,4,14,5,11,47,37,10,47
Dungannon,4007,5,13,7,10,53,37,16,46
Coleraine,4007,6,12,10,8,45,43,2,46
Ballymena,4007,7,13,7,10,54,54,0,46
Ards,4007,8,9,5,16,37,51,-14,32
Glentoran,4007,9,8,8,14,32,50,-18,32
Ballinamalla,4007,10,5,7,18,26,51,-25,22
Portadown,4007,11,4,6,20,18,48,-30,18
Crusaders,4008,1,14,9,7,55,42,13,51
Cliftonville,4008,2,15,5,10,58,46,12,50
Ballymena,4008,3,15,3,12,52,57,-5,48
Dungannon,4008,4,11,10,9,59,51,8,43
Coleraine,4008,5,11,10,9,43,41,2,43
Glentoran,4008,6,11,9,10,41,36,5,42
Glenavon,4008,7,10,12,8,51,47,4,42
Linfield,4008,8,10,10,10,50,38,12,40
Ards,4008,9,10,6,14,34,43,-9,36
Portadown,4008,10,9,6,15,25,39,-14,33
Ballinamalla,4008,11,6,6,18,28,56,-28,24
Glenavon,4009,1,16,7,7,56,42,14,55
Ballymena,4009,2,16,5,9,61,56,5,53
Coleraine,4009,3,13,10,7,44,32,12,49
Cliftonville,4009,4,15,4,11,51,41,10,49
Crusaders,4009,5,13,9,8,47,35,12,48
Linfield,4009,6,12,9,9,48,32,16,45
Dungannon,4009,7,11,8,11,47,41,6,41
Glentoran,4009,8,10,5,15,27,44,-17,35
Ards,4009,9,9,6,15,39,47,-8,33
Portadown,4009,10,7,6,17,25,46,-21,27
Ballinamalla,4009,11,7,3,20,22,51,-29,24
Crusaders,4010,1,15,9,6,62,39,23,54
Linfield,4010,2,14,11,5,57,29,28,53
Cliftonville,4010,3,14,6,10,52,45,7,48
Glenavon,4010,4,11,12,7,50,43,7,45
Ballymena,4010,5,11,10,9,54,66,-12,43
Dungannon,4010,6,11,9,10,52,43,9,42
Coleraine,4010,7,9,12,9,42,39,3,39
Ards,4010,8,10,6,14,41,46,-5,36
Glentoran,4010,9,8,9,13,31,44,-13,33
Portadown,4010,10,7,7,16,25,45,-20,28
Ballinamalla,4010,11,6,7,17,29,56,-27,25
Cliftonville,4011,1,16,5,9,53,38,15,53
Linfield,4011,2,13,11,6,61,33,28,50
Crusaders,4011,3,13,10,7,53,36,17,49
Coleraine,4011,4,13,9,8,41,33,8,48
Ballymena,4011,5,11,11,8,54,61,-7,44
Glenavon,4011,6,10,13,7,48,44,4,43
Glentoran,4011,7,10,10,10,38,46,-8,40
Dungannon,4011,8,9,10,11,50,46,4,37
Ards,4011,9,8,5,17,40,58,-18,29
Ballinamalla,4011,10,7,7,16,25,48,-23,28
Portadown,4011,11,6,7,17,32,52,-20,25
Ballymena,4012,1,17,4,9,59,52,7,55
Crusaders,4012,2,15,7,8,57,35,22,52
Linfield,4012,3,14,8,8,56,32,24,50
Coleraine,4012,4,12,9,9,43,37,6,45
Cliftonville,4012,5,13,5,12,43,40,3,44
Glenavon,4012,6,10,10,10,43,43,0,40
Dungannon,4012,7,9,12,9,55,48,7,39
Glentoran,4012,8,10,6,14,31,48,-17,36
Ards,4012,9,10,5,15,33,45,-12,35
Portadown,4012,10,10,4,16,27,43,-16,34
Ballinamalla,4012,11,8,4,18,25,49,-24,28
Crusaders,4013,1,16,7,7,51,29,22,55
Cliftonville,4013,2,17,4,9,52,37,15,55
Linfield,4013,3,14,12,4,57,28,29,54
Coleraine,4013,4,11,13,6,43,36,7,46
Ballymena,4013,5,13,4,13,53,53,0,43
Glentoran,4013,6,11,8,11,34,42,-8,41
Dungannon,4013,7,10,10,10,46,41,5,40
Glenavon,4013,8,7,11,12,40,52,-12,32
Ards,4013,9,8,6,16,32,46,-14,30
Ballinamalla,4013,10,9,3,18,30,51,-21,30
Portadown,4013,11,8,4,18,28,51,-23,28
Cliftonville,4014,1,17,6,7,61,40,21,57
Crusaders,4014,2,16,7,7,52,34,18,55
Linfield,4014,3,14,10,6,65,46,19,52
Coleraine,4014,4,14,9,7,44,33,11,51
Ballymena,4014,5,12,6,12,57,65,-8,42
Glenavon,4014,6,11,8,11,42,47,-5,41
Ballinamalla,4014,7,11,3,16,39,52,-13,36
Dungannon,4014,8,8,11,11,41,38,3,35
Ards,4014,9,10,3,17,46,56,-10,33
Portadown,4014,10,8,6,16,32,48,-16,30
Glentoran,4014,11,6,7,17,33,53,-20,25
Cliftonville,4015,1,17,6,7,62,42,20,57
Linfield,4015,2,16,8,6,62,33,29,56
Crusaders,4015,3,16,7,7,58,33,25,55
Ballymena,4015,4,13,8,9,60,59,1,47
Glenavon,4015,5,12,9,9,47,45,2,45
Coleraine,4015,6,10,11,9,43,41,2,41
Dungannon,4015,7,10,8,12,42,40,2,38
Glentoran,4015,8,8,9,13,31,43,-12,33
Ards,4015,9,9,3,18,40,55,-15,30
Ballinamalla,4015,10,8,4,18,27,51,-24,28
Portadown,4015,11,7,5,18,23,53,-30,26
Crusaders,4016,1,15,9,6,55,31,24,54
Cliftonville,4016,2,15,7,8,51,32,19,52
Linfield,4016,3,14,9,7,54,29,25,51
Coleraine,4016,4,13,10,7,42,34,8,49
Glenavon,4016,5,11,11,8,46,46,0,44
Ballymena,4016,6,13,5,12,52,60,-8,44
Glentoran,4016,7,11,5,14,34,44,-10,38
Ards,4016,8,9,7,14,39,49,-10,34
Dungannon,4016,9,7,10,13,46,52,-6,31
Ballinamalla,4016,10,7,7,16,35,55,-20,28
Portadown,4016,11,6,8,16,25,47,-22,26
Crusaders,4017,1,16,10,4,59,31,28,58
Linfield,4017,2,15,9,6,59,33,26,54
Ballymena,4017,3,14,9,7,67,57,10,51
Glenavon,4017,4,12,11,7,49,46,3,47
Cliftonville,4017,5,12,7,11,47,43,4,43
Coleraine,4017,6,11,9,10,42,41,1,42
Dungannon,4017,7,10,9,11,51,45,6,39
Glentoran,4017,8,8,8,14,33,54,-21,32
Ballinamalla,4017,9,8,7,15,34,47,-13,31
Ards,4017,10,7,7,16,32,49,-17,28
Portadown,4017,11,8,2,20,25,52,-27,26
Crusaders,4018,1,17,7,6,57,36,21,58
Cliftonville,4018,2,18,3,9,61,36,25,57
Ballymena,4018,3,16,5,9,66,58,8,53
Coleraine,4018,4,13,9,8,43,41,2,48
Linfield,4018,5,13,6,11,55,34,21,45
Dungannon,4018,6,11,7,12,45,43,2,40
Glenavon,4018,7,10,9,11,47,46,1,39
Glentoran,4018,8,10,7,13,30,43,-13,37
Ballinamalla,4018,9,10,2,18,35,53,-18,32
Portadown,4018,10,7,7,16,20,44,-24,28
Ards,4018,11,7,4,19,33,58,-25,25
Cliftonville,4019,1,16,7,7,59,40,19,55
Crusaders,4019,2,16,7,7,55,37,18,55
Coleraine,4019,3,13,8,9,45,38,7,47
Linfield,4019,4,12,9,9,53,35,18,45
Glenavon,4019,5,11,10,9,53,54,-1,43
Ballymena,4019,6,11,6,13,53,62,-9,39
Dungannon,4019,7,9,10,11,46,42,4,37
Ballinamalla,4019,8,10,5,15,36,46,-10,35
Glentoran,4019,9,9,8,13,29,43,-14,35
Ards,4019,10,9,6,15,39,50,-11,33
Portadown,4019,11,8,6,16,28,49,-21,30
Linfield,4020,1,19,7,4,66,28,38,64
Crusaders,4020,2,17,7,6,60,34,26,58
Cliftonville,4020,3,15,7,8,53,36,17,52
Ballymena,4020,4,15,7,8,58,53,5,52
Glenavon,4020,5,11,10,9,42,46,-4,43
Dungannon,4020,6,10,9,11,47,43,4,39
Glentoran,4020,7,10,6,14,33,46,-13,36
Coleraine,4020,8,8,10,12,36,43,-7,34
Ballinamalla,4020,9,8,5,17,25,48,-23,29
Portadown,4020,10,7,6,17,25,48,-23,27
Ards,4020,11,6,4,20,34,54,-20,22
Glenavon,4021,1,14,12,4,50,35,15,54
Cliftonville,4021,2,16,4,10,55,42,13,52
Linfield,4021,3,14,9,7,55,28,27,51
Ballymena,4021,4,15,4,11,58,56,2,49
Crusaders,4021,5,13,6,11,50,40,10,45
Dungannon,4021,6,11,9,10,50,41,9,42
Coleraine,4021,7,11,9,10,46,43,3,42
Ards,4021,8,10,4,16,32,51,-19,34
Ballinamalla,4021,9,8,7,15,30,48,-18,31
Glentoran,4021,10,7,8,15,24,43,-19,29
Portadown,4021,11,6,8,16,27,50,-23,26
Linfield,4022,1,17,8,5,57,25,32,59
Crusaders,4022,2,17,7,6,58,33,25,58
Glenavon,4022,3,14,9,7,47,43,4,51
Ballymena,4022,4,15,5,10,55,54,1,50
Cliftonville,4022,5,14,6,10,54,43,11,48
Coleraine,4022,6,11,8,11,34,42,-8,41
Glentoran,4022,7,10,6,14,33,45,-12,36
Dungannon,4022,8,9,8,13,49,48,1,35
Ards,4022,9,9,6,15,38,47,-9,33
Ballinamalla,4022,10,7,4,19,27,52,-25,25
Portadown,4022,11,6,5,19,25,45,-20,23
Crusaders,4023,1,19,6,5,60,32,28,63
Cliftonville,4023,2,19,4,7,61,38,23,61
Linfield,4023,3,14,8,8,51,31,20,50
Coleraine,4023,4,12,9,9,39,35,4,45
Glentoran,4023,5,12,6,12,32,41,-9,42
Dungannon,4023,6,11,7,12,48,48,0,40
Ballymena,4023,7,11,6,13,53,63,-10,39
Glenavon,4023,8,8,10,12,45,49,-4,34
Ards,4023,9,10,4,16,40,47,-7,34
Portadown,4023,10,8,3,19,25,48,-23,27
Ballinamalla,4023,11,7,5,18,28,50,-22,26
Crusaders,4024,1,18,5,7,63,38,25,59
Ballymena,4024,2,17,6,7,66,53,13,57
Cliftonville,4024,3,17,3,10,54,36,18,54
Glenavon,4024,4,13,9,8,57,47,10,48
Linfield,4024,5,12,11,7,58,38,20,47
Portadown,4024,6,12,2,16,27,41,-14,38
Coleraine,4024,7,10,7,13,34,44,-10,37
Glentoran,4024,8,10,7,13,34,47,-13,37
Dungannon,4024,9,9,9,12,46,44,2,36
Ballinamalla,4024,10,6,6,18,25,56,-31,24
Ards,4024,11,6,5,19,36,56,-20,23
Crusaders,4025,1,16,9,5,55,30,25,57
Cliftonville,4025,2,16,5,9,53,34,19,53
Linfield,4025,3,13,10,7,58,34,24,49
Glenavon,4025,4,13,10,7,44,39,5,49
Ballymena,4025,5,13,7,10,49,56,-7,46
Dungannon,4025,6,9,12,9,49,42,7,39
Coleraine,4025,7,9,11,10,37,40,-3,38
Ards,4025,8,9,7,14,38,48,-10,34
Glentoran,4025,9,8,9,13,29,43,-14,33
Ballinamalla,4025,10,8,4,18,42,61,-19,28
Portadown,4025,11,6,6,18,23,50,-27,24
Crusaders,4026,1,17,8,5,56,32,24,59
Linfield,4026,2,16,9,5,59,28,31,57
Ballymena,4026,3,16,5,9,65,60,5,53
Cliftonville,4026,4,16,4,10,54,41,13,52
Glenavon,4026,5,12,8,10,44,44,0,44
Coleraine,4026,6,11,9,10,42,41,1,42
Glentoran,4026,7,10,7,13,28,36,-8,37
Ards,4026,8,10,5,15,33,43,-10,35
Dungannon,4026,9,8,10,12,46,46,0,34
Portadown,4026,10,6,6,18,25,49,-24,24
Ballinamalla,4026,11,4,7,19,24,56,-32,19
Coleraine,4027,1,15,11,4,44,29,15,56
Linfield,4027,2,16,7,7,56,29,27,55
Cliftonville,4027,3,17,3,10,57,42,15,54
Ballymena,4027,4,14,5,11,57,57,0,47
Crusaders,4027,5,12,10,8,49,41,8,46
Glenavon,4027,6,11,10,9,46,48,-2,43
Dungannon,4027,7,10,10,10,49,44,5,40
Ballinamalla,4027,8,9,3,18,30,47,-17,30
Ards,4027,9,7,8,15,32,45,-13,29
Glentoran,4027,10,6,10,14,24,41,-17,28
Portadown,4027,11,6,7,17,25,46,-21,25
Cliftonville,4028,1,18,3,9,61,39,22,57
Crusaders,4028,2,16,7,7,52,33,19,55
Linfield,4028,3,15,8,7,61,33,28,53
Coleraine,4028,4,12,10,8,43,48,-5,46
Dungannon,4028,5,12,9,9,59,42,17,45
Ballymena,4028,6,13,5,12,60,58,2,44
Glenavon,4028,7,10,11,9,47,49,-2,41
Glentoran,4028,8,12,5,13,30,40,-10,41
Ballinamalla,4028,9,11,2,17,32,46,-14,35
Ards,4028,10,5,6,19,32,57,-25,21
Portadown,4028,11,5,6,19,17,49,-32,21
Crusaders,4029,1,17,8,5,55,31,24,59
Cliftonville,4029,2,14,7,9,47,40,7,49
Ballymena,4029,3,14,7,9,59,53,6,49
Linfield,4029,4,13,9,8,53,32,21,48
Dungannon,4029,5,12,8,10,53,43,10,44
Glenavon,4029,6,11,11,8,46,41,5,44
Glentoran,4029,7,11,5,14,36,46,-10,38
Ballinamalla,4029,8,9,6,15,31,49,-18,33
Coleraine,4029,9,7,11,12,37,44,-7,32
Portadown,4029,10,7,9,14,27,43,-16,30
Ards,4029,11,7,5,18,38,60,-22,26
Crusaders,4030,1,16,8,6,57,31,26,56
Cliftonville,4030,2,17,4,9,55,37,18,55
Ballymena,4030,3,16,6,8,62,50,12,54
Glenavon,4030,4,13,10,7,59,49,10,49
Coleraine,4030,5,12,9,9,43,44,-1,45
Linfield,4030,6,10,11,9,48,38,10,41
Dungannon,4030,7,9,8,13,53,57,-4,35
Ards,4030,8,9,7,14,44,52,-8,34
Ballinamalla,4030,9,10,4,16,32,52,-20,34
Glentoran,4030,10,8,5,17,35,53,-18,29
Portadown,4030,11,7,4,19,26,51,-25,25
Linfield,4031,1,16,10,4,62,28,34,58
Cliftonville,4031,2,17,4,9,59,41,18,55
Glenavon,4031,3,13,10,7,46,37,9,49
Crusaders,4031,4,13,8,9,48,37,11,47
Ballymena,4031,5,14,5,11,52,55,-3,47
Coleraine,4031,6,12,10,8,40,34,6,46
Dungannon,4031,7,9,10,11,45,42,3,37
Ballinamalla,4031,8,10,4,16,28,46,-18,34
Ards,4031,9,9,3,18,36,52,-16,30
Glentoran,4031,10,6,9,15,33,50,-17,27
Portadown,4031,11,5,9,16,28,55,-27,24
Crusaders,4032,1,16,9,5,54,32,22,57
Cliftonville,4032,2,17,5,8,57,35,22,56
Linfield,4032,3,15,9,6,63,33,30,54
Ballymena,4032,4,14,7,9,52,58,-6,49
Glenavon,4032,5,12,11,7,51,42,9,47
Coleraine,4032,6,10,9,11,41,36,5,39
Dungannon,4032,7,9,8,13,46,47,-1,35
Glentoran,4032,8,8,7,15,26,46,-20,31
Ards,4032,9,9,4,17,35,58,-23,31
Ballinamalla,4032,10,9,3,18,29,49,-20,30
Portadown,4032,11,7,6,17,31,49,-18,27
Crusaders,4033,1,16,10,4,60,33,27,58
Linfield,4033,2,14,11,5,56,29,27,53
Cliftonville,4033,3,14,6,10,50,41,9,48
Ballymena,4033,4,13,5,12,51,57,-6,44
Glenavon,4033,5,11,9,10,45,48,-3,42
Ards,4033,6,12,6,12,41,47,-6,42
Dungannon,4033,7,11,8,11,51,44,7,41
Coleraine,4033,8,10,11,9,40,36,4,41
Portadown,4033,9,9,3,18,33,48,-15,30
Ballinamalla,4033,10,9,3,18,28,49,-21,30
Glentoran,4033,11,7,6,17,29,52,-23,27
Crusaders,4034,1,17,8,5,57,34,23,59
Cliftonville,4034,2,18,4,8,60,44,16,58
Linfield,4034,3,16,9,5,67,31,36,57
Coleraine,4034,4,11,12,7,38,33,5,45
Glenavon,4034,5,9,14,7,48,50,-2,41
Ballymena,4034,6,11,5,14,50,65,-15,38
Dungannon,4034,7,8,11,11,45,41,4,35
Glentoran,4034,8,9,7,14,35,44,-9,34
Ards,4034,9,8,5,17,37,49,-12,29
Portadown,4034,10,8,5,17,24,45,-21,29
Ballinamalla,4034,11,7,6,17,25,50,-25,27
Crusaders,4035,1,16,9,5,57,30,27,57
Ballymena,4035,2,15,7,8,58,56,2,52
Cliftonville,4035,3,15,5,10,57,38,19,50
Coleraine,4035,4,11,13,6,40,34,6,46
Linfield,4035,5,12,9,9,56,39,17,45
Dungannon,4035,6,12,8,10,53,41,12,44
Glenavon,4035,7,9,14,7,41,43,-2,41
Glentoran,4035,8,8,7,15,30,44,-14,31
Portadown,4035,9,8,6,16,27,47,-20,30
Ballinamalla,4035,10,8,5,17,23,48,-25,29
Ards,4035,11,6,7,17,28,50,-22,25
Crusaders,4036,1,16,9,5,53,30,23,57
Linfield,4036,2,13,11,6,64,37,27,50
Dungannon,4036,3,12,11,7,53,38,15,47
Cliftonville,4036,4,14,5,11,50,41,9,47
Glenavon,4036,5,11,11,8,46,45,1,44
Coleraine,4036,6,11,10,9,41,39,2,43
Ballymena,4036,7,12,6,12,59,71,-12,42
Glentoran,4036,8,11,7,12,32,41,-9,40
Portadown,4036,9,8,7,15,24,37,-13,31
Ards,4036,10,8,4,18,35,56,-21,28
Ballinamalla,4036,11,7,3,20,35,57,-22,24
Linfield,4037,1,15,8,7,56,25,31,53
Crusaders,4037,2,15,6,9,50,32,18,51
Coleraine,4037,3,11,11,8,43,36,7,44
Cliftonville,4037,4,12,8,10,42,38,4,44
Glenavon,4037,5,11,11,8,49,48,1,44
Dungannon,4037,6,11,9,10,51,42,9,42
Ballymena,4037,7,10,12,8,45,50,-5,42
Ards,4037,8,12,5,13,49,45,4,41
Portadown,4037,9,7,9,14,23,43,-20,30
Glentoran,4037,10,7,9,14,23,48,-25,30
Ballinamalla,4037,11,7,6,17,27,51,-24,27
Crusaders,4038,1,19,6,5,59,34,25,63
Linfield,4038,2,16,8,6,61,28,33,56
Ballymena,4038,3,15,6,9,59,56,3,51
Cliftonville,4038,4,14,5,11,51,41,10,47
Glenavon,4038,5,12,9,9,44,44,0,45
Glentoran,4038,6,12,9,9,35,35,0,45
Coleraine,4038,7,10,11,9,37,34,3,41
Portadown,4038,8,9,5,16,34,51,-17,32
Dungannon,4038,9,6,11,13,39,45,-6,29
Ards,4038,10,7,7,16,34,51,-17,28
Ballinamalla,4038,11,4,5,21,21,55,-34,17
Crusaders,4039,1,15,9,6,63,36,27,54
Linfield,4039,2,14,10,6,59,29,30,52
Ballymena,4039,3,14,7,9,64,60,4,49
Cliftonville,4039,4,15,3,12,59,47,12,48
Glenavon,4039,5,10,15,5,56,50,6,45
Coleraine,4039,6,11,11,8,52,48,4,44
Ballinamalla,4039,7,10,5,15,34,48,-14,35
Portadown,4039,8,9,7,14,30,46,-16,34
Ards,4039,9,8,7,15,34,52,-18,31
Dungannon,4039,10,6,12,12,43,51,-8,30
Glentoran,4039,11,7,6,17,27,54,-27,27
Crusaders,4040,1,16,10,4,53,31,22,58
Linfield,4040,2,16,8,6,60,27,33,56
Cliftonville,4040,3,14,6,10,55,41,14,48
Ballymena,4040,4,12,9,9,59,61,-2,45
Coleraine,4040,5,10,13,7,48,41,7,43
Dungannon,4040,6,10,11,9,51,41,10,41
Glenavon,4040,7,8,13,9,41,45,-4,37
Glentoran,4040,8,9,8,13,31,46,-15,35
Ballinamalla,4040,9,8,6,16,31,51,-20,30
Portadown,4040,10,8,4,18,31,52,-21,28
Ards,4040,11,7,6,17,30,54,-24,27
Crusaders,4041,1,18,6,6,53,30,23,60
Coleraine,4041,2,13,11,6,41,29,12,50
Linfield,4041,3,13,10,7,59,37,22,49
Cliftonville,4041,4,15,4,11,52,43,9,49
Ballymena,4041,5,13,7,10,66,62,4,46
Glenavon,4041,6,12,10,8,47,44,3,46
Dungannon,4041,7,9,8,13,55,52,3,35
Ards,4041,8,8,8,14,40,52,-12,32
Glentoran,4041,9,6,11,13,31,49,-18,29
Portadown,4041,10,8,5,17,30,55,-25,29
Ballinamalla,4041,11,8,4,18,36,57,-21,28
Cliftonville,4042,1,17,6,7,55,32,23,57
Crusaders,4042,2,15,9,6,56,37,19,54
Linfield,4042,3,14,9,7,51,27,24,51
Coleraine,4042,4,14,8,8,48,38,10,50
Ballymena,4042,5,14,7,9,67,61,6,49
Glenavon,4042,6,12,9,9,45,43,2,45
Dungannon,4042,7,9,12,9,50,46,4,39
Glentoran,4042,8,10,6,14,29,43,-14,36
Ards,4042,9,9,5,16,32,46,-14,32
Ballinamalla,4042,10,8,3,19,35,56,-21,27
Portadown,4042,11,3,6,21,19,58,-39,15
Crusaders,4043,1,18,5,7,59,33,26,59
Cliftonville,4043,2,16,5,9,52,35,17,53
Linfield,4043,3,15,7,8,55,34,21,52
Ballymena,4043,4,14,7,9,69,61,8,49
Coleraine,4043,5,12,9,9,42,41,1,45
Dungannon,4043,6,11,6,13,51,50,1,39
Glenavon,4043,7,9,10,11,53,50,3,37
Ards,4043,8,9,7,14,39,49,-10,34
Portadown,4043,9,10,3,17,27,50,-23,33
Ballinamalla,4043,10,7,8,15,32,53,-21,29
Glentoran,4043,11,6,9,15,28,51,-23,27
Cliftonville,4044,1,18,5,7,61,36,25,59
Crusaders,4044,2,17,7,6,59,38,21,58
Glenavon,4044,3,14,12,4,54,36,18,54
Linfield,4044,4,12,10,8,59,45,14,46
Ballymena,4044,5,12,5,13,56,67,-11,41
Coleraine,4044,6,8,14,8,43,45,-2,38
Glentoran,4044,7,9,8,13,29,41,-12,35
Portadown,4044,8,8,8,14,30,43,-13,32
Ards,4044,9,7,8,15,34,45,-11,29
Dungannon,4044,10,6,10,14,44,53,-9,28
Ballinamalla,4044,11,6,9,15,29,49,-20,27
Crusaders,4045,1,17,9,4,60,31,29,60
Ballymena,4045,2,15,6,9,61,59,2,51
Linfield,4045,3,12,11,7,52,31,21,47
Dungannon,4045,4,13,7,10,57,47,10,46
Coleraine,4045,5,12,10,8,40,35,5,46
Glenavon,4045,6,12,9,9,49,41,8,45
Cliftonville,4045,7,12,5,13,46,41,5,41
Ards,4045,8,10,5,15,32,44,-12,35
Glentoran,4045,9,7,11,12,30,47,-17,32
Portadown,4045,10,8,4,18,23,45,-22,28
Ballinamalla,4045,11,6,5,19,31,60,-29,23
Crusaders,4046,1,20,4,6,53,23,30,64
Cliftonville,4046,2,16,4,10,56,38,18,52
Coleraine,4046,3,14,10,6,47,39,8,52
Linfield,4046,4,14,8,8,58,35,23,50
Glenavon,4046,5,11,8,11,45,45,0,41
Ballymena,4046,6,12,5,13,57,64,-7,41
Glentoran,4046,7,12,4,14,31,44,-13,40
Dungannon,4046,8,10,7,13,47,45,2,37
Ards,4046,9,9,7,14,38,48,-10,34
Portadown,4046,10,9,4,17,30,45,-15,31
Ballinamalla,4046,11,6,3,21,25,61,-36,21
Crusaders,4047,1,17,6,7,54,33,21,57
Cliftonville,4047,2,18,3,9,58,42,16,57
Linfield,4047,3,13,9,8,57,35,22,48
Glenavon,4047,4,13,9,8,51,46,5,48
Ballymena,4047,5,12,7,11,62,58,4,43
Dungannon,4047,6,11,9,10,51,41,10,42
Ards,4047,7,11,5,14,44,49,-5,38
Coleraine,4047,8,10,7,13,41,50,-9,37
Portadown,4047,9,9,7,14,35,51,-16,34
Ballinamalla,4047,10,8,4,18,31,56,-25,28
Glentoran,4047,11,7,6,17,28,51,-23,27
Linfield,4048,1,15,10,5,58,29,29,55
Cliftonville,4048,2,16,4,10,49,33,16,52
Crusaders,4048,3,15,6,9,46,37,9,51
Ballymena,4048,4,13,5,12,53,60,-7,44
Dungannon,4048,5,11,10,9,59,39,20,43
Coleraine,4048,6,11,10,9,42,37,5,43
Glenavon,4048,7,11,10,9,48,49,-1,43
Glentoran,4048,8,11,6,13,29,40,-11,39
Ards,4048,9,8,6,16,32,47,-15,30
Ballinamalla,4048,10,7,9,14,26,47,-21,30
Portadown,4048,11,5,8,17,24,48,-24,23
Crusaders,4049,1,17,7,6,55,36,19,58
Glenavon,4049,2,15,9,6,66,46,20,54
Cliftonville,4049,3,15,5,10,59,52,7,50
Linfield,4049,4,13,9,8,54,38,16,48
Ballymena,4049,5,13,7,10,56,60,-4,46
Dungannon,4049,6,10,11,9,61,45,16,41
Glentoran,4049,7,10,6,14,38,56,-18,36
Coleraine,4049,8,7,13,10,41,48,-7,34
Ards,4049,9,9,6,15,47,55,-8,33
Ballinamalla,4049,10,9,5,16,39,52,-13,32
Portadown,4049,11,6,4,20,24,52,-28,22
Crusaders,4050,1,20,7,3,69,30,39,67
Linfield,4050,2,16,7,7,62,34,28,55
Cliftonville,4050,3,15,4,11,47,39,8,49
Coleraine,4050,4,12,11,7,49,32,17,47
Ballymena,4050,5,13,6,11,52,66,-14,45
Glenavon,4050,6,12,8,10,44,45,-1,44
Dungannon,4050,7,11,9,10,47,43,4,42
Glentoran,4050,8,8,7,15,33,48,-15,31
Ards,4050,9,9,3,18,33,45,-12,30
Ballinamalla,4050,10,8,3,19,26,54,-28,27
Portadown,4050,11,5,7,18,25,51,-26,22
Cliftonville,4051,1,19,4,7,60,33,27,61
Linfield,4051,2,16,8,6,57,27,30,56
Crusaders,4051,3,16,8,6,55,34,21,56
Ballymena,4051,4,15,3,12,51,56,-5,48
Glenavon,4051,5,10,11,9,49,49,0,41
Dungannon,4051,6,11,7,12,50,42,8,40
Coleraine,4051,7,10,10,10,40,43,-3,40
Glentoran,4051,8,10,8,12,37,49,-12,38
Ards,4051,9,8,5,17,40,56,-16,29
Portadown,4051,10,8,4,18,23,45,-22,28
Ballinamalla,4051,11,6,4,20,26,54,-28,22
Crusaders,4052,1,17,10,3,59,29,30,61
Cliftonville,4052,2,15,7,8,53,38,15,52
Linfield,4052,3,13,10,7,53,32,21,49
Coleraine,4052,4,11,12,7,46,36,10,45
Ballymena,4052,5,11,10,9,51,53,-2,43
Glenavon,4052,6,9,12,9,48,51,-3,39
Dungannon,4052,7,8,12,10,57,52,5,36
Glentoran,4052,8,8,8,14,28,49,-21,32
Portadown,4052,9,8,7,15,28,44,-16,31
Ards,4052,10,9,3,18,37,57,-20,30
Ballinamalla,4052,11,8,5,17,30,49,-19,29
Glenavon,4053,1,16,9,5,61,42,19,57
Linfield,4053,2,15,11,4,59,28,31,56
Crusaders,4053,3,15,9,6,52,33,19,54
Ballymena,4053,4,15,7,8,60,55,5,52
Cliftonville,4053,5,15,4,11,55,43,12,49
Dungannon,4053,6,9,11,10,46,44,2,38
Coleraine,4053,7,8,12,10,42,43,-1,36
Glentoran,4053,8,9,8,13,29,45,-16,35
Ballinamalla,4053,9,8,3,19,32,55,-23,27
Ards,4053,10,7,4,19,32,60,-28,25
Portadown,4053,11,6,6,18,26,46,-20,24
Crusaders,4054,1,17,5,8,65,44,21,56
Cliftonville,4054,2,14,8,8,57,40,17,50
Linfield,4054,3,14,7,9,60,37,23,49
Coleraine,4054,4,12,11,7,47,42,5,47
Ballymena,4054,5,13,4,13,59,67,-8,43
Glentoran,4054,6,12,6,12,36,43,-7,42
Glenavon,4054,7,9,13,8,47,45,2,40
Dungannon,4054,8,9,10,11,47,45,2,37
Ballinamalla,4054,9,9,5,16,29,48,-19,32
Ards,4054,10,9,4,17,38,52,-14,31
Portadown,4054,11,8,5,17,25,47,-22,29
Cliftonville,4055,1,17,6,7,56,40,16,57
Linfield,4055,2,15,9,6,61,28,33,54
Crusaders,4055,3,13,10,7,52,36,16,49
Coleraine,4055,4,11,12,7,43,35,8,45
Glenavon,4055,5,11,12,7,44,42,2,45
Ballymena,4055,6,12,8,10,52,65,-13,44
Dungannon,4055,7,10,9,11,51,43,8,39
Glentoran,4055,8,10,6,14,32,45,-13,36
Ards,4055,9,8,7,15,36,44,-8,31
Ballinamalla,4055,10,9,4,17,33,53,-20,31
Portadown,4055,11,5,5,20,21,50,-29,20
Linfield,4056,1,17,9,4,63,26,37,60
Crusaders,4056,2,16,10,4,60,33,27,58
Ballymena,4056,3,14,9,7,56,53,3,51
Ards,4056,4,14,4,12,44,45,-1,46
Coleraine,4056,5,11,9,10,39,39,0,42
Cliftonville,4056,6,11,6,13,52,47,5,39
Glenavon,4056,7,10,8,12,47,52,-5,38
Dungannon,4056,8,9,9,12,48,47,1,36
Glentoran,4056,9,8,7,15,32,49,-17,31
Portadown,4056,10,8,6,16,27,50,-23,30
Ballinamalla,4056,11,7,3,20,26,53,-27,24
Linfield,4057,1,15,9,6,58,31,27,54
Cliftonville,4057,2,16,5,9,54,37,17,53
Coleraine,4057,3,12,11,7,44,38,6,47
Ballymena,4057,4,12,10,8,57,52,5,46
Crusaders,4057,5,12,9,9,52,44,8,45
Glenavon,4057,6,11,12,7,50,47,3,45
Glentoran,4057,7,11,7,12,41,46,-5,40
Dungannon,4057,8,10,8,12,50,46,4,38
Ards,4057,9,8,8,14,34,48,-14,32
Ballinamalla,4057,10,7,6,17,28,51,-23,27
Portadown,4057,11,5,7,18,24,52,-28,22
Crusaders,4058,1,17,9,4,53,32,21,60
Ballymena,4058,2,16,6,8,54,48,6,54
Linfield,4058,3,14,11,5,51,25,26,53
Cliftonville,4058,4,13,7,10,42,38,4,46
Glenavon,4058,5,10,12,8,44,42,2,42
Coleraine,4058,6,10,11,9,37,36,1,41
Dungannon,4058,7,9,12,9,55,43,12,39
Ballinamalla,4058,8,9,5,16,32,45,-13,32
Portadown,4058,9,7,7,16,23,39,-16,28
Glentoran,4058,10,6,9,15,21,44,-23,27
Ards,4058,11,6,7,17,27,47,-20,25
Crusaders,4059,1,18,7,5,59,34,25,61
Cliftonville,4059,2,18,4,8,54,31,23,58
Linfield,4059,3,14,7,9,59,43,16,49
Ballymena,4059,4,12,10,8,56,57,-1,46
Glenavon,4059,5,11,12,7,52,43,9,45
Coleraine,4059,6,11,9,10,38,32,6,42
Dungannon,4059,7,9,10,11,54,50,4,37
Glentoran,4059,8,8,9,13,30,43,-13,33
Ards,4059,9,8,5,17,31,52,-21,29
Ballinamalla,4059,10,8,4,18,27,50,-23,28
Portadown,4059,11,6,7,17,24,49,-25,25
Cliftonville,4060,1,17,4,9,48,39,9,55
Glenavon,4060,2,13,11,6,52,40,12,50
Crusaders,4060,3,13,10,7,47,35,12,49
Ballymena,4060,4,14,7,9,54,57,-3,49
Linfield,4060,5,12,9,9,55,36,19,45
Dungannon,4060,6,9,11,10,51,48,3,38
Coleraine,4060,7,9,11,10,37,39,-2,38
Ballinamalla,4060,8,10,4,16,39,47,-8,34
Ards,4060,9,10,3,17,40,46,-6,33
Portadown,4060,10,8,7,15,26,40,-14,31
Glentoran,4060,11,8,7,15,28,50,-22,31
Linfield,4061,1,18,7,5,58,28,30,61
Crusaders,4061,2,17,7,6,60,38,22,58
Ballymena,4061,3,15,7,8,61,54,7,52
Cliftonville,4061,4,14,8,8,59,42,17,50
Glenavon,4061,5,13,9,8,56,55,1,48
Coleraine,4061,6,12,9,9,44,39,5,45
Dungannon,4061,7,8,9,13,43,50,-7,33
Ards,4061,8,9,4,17,35,47,-12,31
Ballinamalla,4061,9,9,4,17,33,51,-18,31
Glentoran,4061,10,7,5,18,27,47,-20,26
Portadown,4061,11,5,7,18,20,45,-25,22
Crusaders,4062,1,16,8,6,55,40,15,56
Linfield,4062,2,13,10,7,60,42,18,49
Ballymena,4062,3,13,9,8,51,53,-2,48
Ballinamalla,4062,4,13,5,12,33,41,-8,44
Glenavon,4062,5,11,10,9,47,42,5,43
Cliftonville,4062,6,12,5,13,45,41,4,41
Coleraine,4062,7,10,11,9,43,41,2,41
Dungannon,4062,8,8,11,11,45,39,6,35
Portadown,4062,9,8,8,14,29,45,-16,32
Glentoran,4062,10,7,9,14,31,45,-14,30
Ards,4062,11,7,8,15,36,46,-10,29
Linfield,4063,1,14,10,6,58,31,27,52
Cliftonville,4063,2,14,8,8,52,36,16,50
Ballymena,4063,3,14,8,8,64,55,9,50
Crusaders,4063,4,14,7,9,50,38,12,49
Coleraine,4063,5,10,11,9,41,39,2,41
Glenavon,4063,6,10,10,10,41,46,-5,40
Dungannon,4063,7,10,8,12,45,51,-6,38
Portadown,4063,8,10,4,16,29,44,-15,34
Glentoran,4063,9,9,7,14,32,50,-18,34
Ballinamalla,4063,10,9,6,15,39,48,-9,33
Ards,4063,11,10,3,17,34,47,-13,33
Crusaders,4064,1,16,7,7,60,42,18,55
Glenavon,4064,2,15,9,6,52,35,17,54
Linfield,4064,3,14,10,6,62,31,31,52
Cliftonville,4064,4,14,8,8,46,32,14,50
Ballymena,4064,5,14,6,10,61,57,4,48
Coleraine,4064,6,10,11,9,36,40,-4,41
Dungannon,4064,7,8,10,12,47,47,0,34
Portadown,4064,8,9,7,14,26,46,-20,34
Glentoran,4064,9,8,7,15,34,53,-19,31
Ballinamalla,4064,10,8,4,18,32,53,-21,28
Ards,4064,11,7,5,18,35,55,-20,26
Crusaders,4065,1,20,5,5,58,28,30,65
Linfield,4065,2,18,6,6,68,31,37,60
Cliftonville,4065,3,15,4,11,58,40,18,49
Glenavon,4065,4,12,9,9,46,44,2,45
Dungannon,4065,5,11,9,10,44,37,7,42
Ballymena,4065,6,10,11,9,46,55,-9,41
Coleraine,4065,7,9,11,10,35,40,-5,38
Ballinamalla,4065,8,11,3,16,30,43,-13,36
Glentoran,4065,9,9,7,14,28,48,-20,34
Ards,4065,10,7,5,18,32,51,-19,26
Portadown,4065,11,6,4,20,23,51,-28,22
Linfield,4066,1,15,11,4,67,29,38,56
Cliftonville,4066,2,15,8,7,56,36,20,53
Crusaders,4066,3,14,10,6,49,34,15,52
Ballymena,4066,4,14,8,8,59,58,1,50
Coleraine,4066,5,10,13,7,43,38,5,43
Glenavon,4066,6,10,12,8,48,44,4,42
Dungannon,4066,7,10,8,12,46,39,7,38
Ards,4066,8,8,6,16,36,51,-15,30
Portadown,4066,9,8,6,16,26,48,-22,30
Ballinamalla,4066,10,6,9,15,29,52,-23,27
Glentoran,4066,11,5,9,16,27,57,-30,24
Linfield,4067,1,17,8,5,71,33,38,59
Crusaders,4067,2,16,6,8,54,36,18,54
Cliftonville,4067,3,14,8,8,48,33,15,50
Glenavon,4067,4,12,10,8,49,49,0,46
Coleraine,4067,5,11,9,10,36,39,-3,42
Ballymena,4067,6,11,8,11,56,64,-8,41
Dungannon,4067,7,9,10,11,47,44,3,37
Glentoran,4067,8,9,7,14,35,48,-13,34
Ballinamalla,4067,9,9,5,16,29,48,-19,32
Ards,4067,10,8,6,16,37,47,-10,30
Portadown,4067,11,7,7,16,26,47,-21,28
Crusaders,4068,1,17,8,5,60,33,27,59
Linfield,4068,2,13,11,6,55,32,23,50
Coleraine,4068,3,13,10,7,46,29,17,49
Ballymena,4068,4,14,4,12,54,57,-3,46
Dungannon,4068,5,11,10,9,57,45,12,43
Cliftonville,4068,6,13,4,13,55,51,4,43
Glenavon,4068,7,11,9,10,50,52,-2,42
Ards,4068,8,9,9,12,36,46,-10,36
Glentoran,4068,9,9,7,14,36,53,-17,34
Ballinamalla,4068,10,8,3,19,30,56,-26,27
Portadown,4068,11,6,7,17,28,53,-25,25
Crusaders,4069,1,18,7,5,58,32,26,61
Linfield,4069,2,14,11,5,65,28,37,53
Cliftonville,4069,3,15,5,10,52,41,11,50
Glenavon,4069,4,12,10,8,43,40,3,46
Ballymena,4069,5,11,8,11,48,62,-14,41
Dungannon,4069,6,10,10,10,50,42,8,40
Glentoran,4069,7,8,12,10,31,41,-10,36
Ards,4069,8,9,7,14,37,46,-9,34
Coleraine,4069,9,7,12,11,37,49,-12,33
Ballinamalla,4069,10,8,4,18,31,48,-17,28
Portadown,4069,11,6,8,16,26,49,-23,26
Crusaders,4070,1,16,6,8,61,38,23,54
Ballymena,4070,2,15,6,9,67,56,11,51
Linfield,4070,3,14,8,8,57,31,26,50
Coleraine,4070,4,13,10,7,41,34,7,49
Cliftonville,4070,5,14,6,10,46,31,15,48
Dungannon,4070,6,10,11,9,58,50,8,41
Glenavon,4070,7,9,12,9,42,51,-9,39
Ards,4070,8,11,5,14,42,52,-10,38
Glentoran,4070,9,8,9,13,34,49,-15,33
Ballinamalla,4070,10,8,5,17,35,53,-18,29
Portadown,4070,11,5,6,19,19,57,-38,21
Crusaders,4071,1,17,7,6,58,35,23,58
Linfield,4071,2,15,10,5,60,28,32,55
Cliftonville,4071,3,14,6,10,61,45,16,48
Coleraine,4071,4,12,11,7,46,39,7,47
Glenavon,4071,5,12,11,7,52,46,6,47
Ballymena,4071,6,13,6,11,53,53,0,45
Dungannon,4071,7,9,9,12,46,50,-4,36
Glentoran,4071,8,8,10,12,29,43,-14,34
Ards,4071,9,8,6,16,38,56,-18,30
Ballinamalla,4071,10,8,5,17,32,50,-18,29
Portadown,4071,11,6,5,19,22,52,-30,23
Crusaders,4072,1,16,9,5,52,28,24,57
Linfield,4072,2,16,7,7,61,36,25,55
Cliftonville,4072,3,17,2,11,57,40,17,53
Ballymena,4072,4,12,5,13,55,63,-8,41
Glenavon,4072,5,10,10,10,47,45,2,40
Coleraine,4072,6,9,11,10,35,37,-2,38
Ballinamalla,4072,7,10,6,14,27,43,-16,36
Dungannon,4072,8,9,8,13,45,47,-2,35
Ards,4072,9,10,5,15,34,51,-17,35
Glentoran,4072,10,8,9,13,32,38,-6,33
Portadown,4072,11,9,6,15,34,51,-17,33
Linfield,4073,1,15,9,6,57,32,25,54
Crusaders,4073,2,15,9,6,54,35,19,54
Glenavon,4073,3,13,11,6,42,33,9,50
Cliftonville,4073,4,15,5,10,48,41,7,50
Glentoran,4073,5,10,10,10,31,35,-4,40
Dungannon,4073,6,8,12,10,47,45,2,36
Coleraine,4073,7,9,9,12,34,41,-7,36
Ballymena,4073,8,9,9,12,52,60,-8,36
Ards,4073,9,9,5,16,39,50,-11,32
Ballinamalla,4073,10,9,4,17,33,50,-17,31
Portadown,4073,11,7,9,14,25,40,-15,30
Crusaders,4074,1,16,10,4,58,28,30,58
Ballymena,4074,2,16,5,9,70,57,13,53
Linfield,4074,3,13,10,7,59,26,33,49
Glenavon,4074,4,13,9,8,46,42,4,48
Cliftonville,4074,5,14,3,13,46,49,-3,45
Coleraine,4074,6,12,9,9,40,43,-3,45
Dungannon,4074,7,11,7,12,50,47,3,40
Glentoran,4074,8,10,7,13,33,45,-12,37
Ards,4074,9,9,4,17,36,47,-11,31
Portadown,4074,10,8,4,18,23,45,-22,28
Ballinamalla,4074,11,8,2,20,26,58,-32,26
Ballymena,4075,1,19,4,7,60,49,11,61
Linfield,4075,2,15,10,5,64,26,38,55
Crusaders,4075,3,16,7,7,60,41,19,55
Cliftonville,4075,4,15,3,12,50,40,10,48
Glenavon,4075,5,11,12,7,54,51,3,45
Coleraine,4075,6,9,11,10,37,42,-5,38
Dungannon,4075,7,8,11,11,46,47,-1,35
Glentoran,4075,8,9,7,14,35,48,-13,34
Ards,4075,9,9,5,16,40,55,-15,32
Portadown,4075,10,9,4,17,30,46,-16,31
Ballinamalla,4075,11,5,6,19,27,58,-31,21
Linfield,4076,1,16,8,6,59,37,22,56
Crusaders,4076,2,15,8,7,50,34,16,53
Dungannon,4076,3,14,8,8,55,37,18,50
Coleraine,4076,4,13,9,8,43,34,9,48
Cliftonville,4076,5,14,5,11,51,38,13,47
Ballymena,4076,6,13,7,10,58,60,-2,46
Glenavon,4076,7,11,12,7,53,44,9,45
Ballinamalla,4076,8,8,8,14,35,51,-16,32
Ards,4076,9,8,5,17,38,57,-19,29
Portadown,4076,10,6,6,18,26,56,-30,24
Glentoran,4076,11,5,8,17,28,48,-20,23
Linfield,4077,1,15,11,4,60,26,34,56
Crusaders,4077,2,16,6,8,52,35,17,54
Ballymena,4077,3,16,4,10,61,51,10,52
Cliftonville,4077,4,15,5,10,54,45,9,50
Dungannon,4077,5,10,10,10,60,48,12,40
Glenavon,4077,6,10,9,11,51,53,-2,39
Coleraine,4077,7,9,11,10,37,45,-8,38
Portadown,4077,8,11,5,14,27,42,-15,38
Ballinamalla,4077,9,9,5,16,33,52,-19,32
Ards,4077,10,7,7,16,34,47,-13,28
Glentoran,4077,11,6,9,15,25,50,-25,27
Cliftonville,4078,1,18,4,8,58,40,18,58
Crusaders,4078,2,16,9,5,52,28,24,57
Linfield,4078,3,14,11,5,63,35,28,53
Ballymena,4078,4,13,7,10,56,59,-3,46
Glenavon,4078,5,8,14,8,41,44,-3,38
Coleraine,4078,6,8,13,9,41,44,-3,37
Dungannon,4078,7,8,12,10,46,46,0,36
Ards,4078,8,9,7,14,41,48,-7,34
Glentoran,4078,9,8,9,13,31,43,-12,33
Portadown,4078,10,7,6,17,26,47,-21,27
Ballinamalla,4078,11,6,8,16,31,52,-21,26
Crusaders,4079,1,15,10,5,59,41,18,55
Ballymena,4079,2,15,6,9,56,56,0,51
Linfield,4079,3,14,8,8,55,31,24,50
Cliftonville,4079,4,15,4,11,54,38,16,49
Glenavon,4079,5,12,9,9,47,45,2,45
Dungannon,4079,6,12,8,10,51,39,12,44
Coleraine,4079,7,11,9,10,49,46,3,42
Ards,4079,8,12,5,13,41,45,-4,41
Portadown,4079,9,8,6,16,23,40,-17,30
Glentoran,4079,10,7,8,15,25,45,-20,29
Ballinamalla,4079,11,5,5,20,23,57,-34,20
Crusaders,4080,1,17,9,4,57,29,28,60
Linfield,4080,2,14,10,6,62,35,27,52
Cliftonville,4080,3,14,6,10,48,37,11,48
Glenavon,4080,4,12,9,9,48,46,2,45
Coleraine,4080,5,11,10,9,43,35,8,43
Ballymena,4080,6,12,6,12,52,63,-11,42
Glentoran,4080,7,11,7,12,32,39,-7,40
Ards,4080,8,10,7,13,40,44,-4,37
Dungannon,4080,9,8,12,10,52,46,6,36
Ballinamalla,4080,10,7,4,19,32,60,-28,25
Portadown,4080,11,7,4,19,26,58,-32,25
Cliftonville,4081,1,19,4,7,61,31,30,61
Crusaders,4081,2,16,6,8,50,37,13,54
Ballymena,4081,3,16,5,9,58,56,2,53
Linfield,4081,4,13,7,10,55,38,17,46
Coleraine,4081,5,11,10,9,40,34,6,43
Dungannon,4081,6,11,9,10,51,41,10,42
Glenavon,4081,7,10,9,11,41,47,-6,39
Ballinamalla,4081,8,10,4,16,34,49,-15,34
Glentoran,4081,9,8,7,15,32,46,-14,31
Portadown,4081,10,8,5,17,21,45,-24,29
Ards,4081,11,5,10,15,29,48,-19,25
Linfield,4082,1,15,9,6,59,30,29,54
Cliftonville,4082,2,15,7,8,58,42,16,52
Crusaders,4082,3,14,9,7,54,37,17,51
Coleraine,4082,4,14,9,7,52,38,14,51
Glenavon,4082,5,12,11,7,51,45,6,47
Dungannon,4082,6,11,8,11,51,46,5,41
Ballymena,4082,7,11,7,12,52,66,-14,40
Glentoran,4082,8,9,9,12,30,41,-11,36
Ards,4082,9,11,2,17,35,51,-16,35
Portadown,4082,10,8,4,18,27,42,-15,28
Ballinamalla,4082,11,5,5,20,22,53,-31,20
Crusaders,4083,1,16,10,4,60,32,28,58
Linfield,4083,2,15,10,5,56,28,28,55
Cliftonville,4083,3,14,7,9,48,36,12,49
Coleraine,4083,4,11,12,7,38,35,3,45
Ballymena,4083,5,12,7,11,54,57,-3,43
Glenavon,4083,6,9,13,8,43,42,1,40
Dungannon,4083,7,11,7,12,51,53,-2,40
Ards,4083,8,9,8,13,45,52,-7,35
Glentoran,4083,9,7,8,15,35,54,-19,29
Ballinamalla,4083,10,7,6,17,30,51,-21,27
Portadown,4083,11,5,10,15,21,41,-20,25
Crusaders,4084,1,19,8,3,61,27,34,65
Linfield,4084,2,18,6,6,65,25,40,60
Ballymena,4084,3,14,8,8,50,49,1,50
Coleraine,4084,4,12,9,9,47,41,6,45
Cliftonville,4084,5,12,5,13,47,45,2,41
Glentoran,4084,6,11,7,12,31,42,-11,40
Glenavon,4084,7,9,10,11,39,47,-8,37
Dungannon,4084,8,9,7,14,37,43,-6,34
Ballinamalla,4084,9,10,3,17,27,44,-17,33
Ards,4084,10,9,5,16,32,44,-12,32
Portadown,4084,11,5,6,19,20,49,-29,21
Linfield,4085,1,19,7,4,65,26,39,64
Crusaders,4085,2,19,6,5,59,32,27,63
Cliftonville,4085,3,14,6,10,54,49,5,48
Coleraine,4085,4,12,10,8,41,38,3,46
Ballymena,4085,5,13,5,12,61,59,2,44
Dungannon,4085,6,10,9,11,52,44,8,39
Glenavon,4085,7,9,12,9,46,46,0,39
Ards,4085,8,10,4,16,41,53,-12,34
Glentoran,4085,9,9,6,15,31,48,-17,33
Ballinamalla,4085,10,6,6,18,31,58,-27,24
Portadown,4085,11,5,7,18,27,55,-28,22
Crusaders,4086,1,16,9,5,54,37,17,57
Linfield,4086,2,14,9,7,66,33,33,51
Cliftonville,4086,3,15,6,9,47,36,11,51
Ballymena,4086,4,15,5,10,61,59,2,50
Dungannon,4086,5,13,6,11,53,36,17,45
Glenavon,4086,6,11,9,10,44,48,-4,42
Coleraine,4086,7,9,9,12,36,46,-10,36
Ards,4086,8,9,6,15,40,48,-8,33
Ballinamalla,4086,9,9,4,17,30,48,-18,31
Glentoran,4086,10,8,7,15,27,47,-20,31
Portadown,4086,11,8,6,16,24,44,-20,30
Crusaders,4087,1,15,8,7,53,33,20,53
Glenavon,4087,2,15,8,7,58,41,17,53
Linfield,4087,3,13,8,9,58,35,23,47
Cliftonville,4087,4,12,10,8,52,45,7,46
Coleraine,4087,5,12,10,8,48,42,6,46
Ballymena,4087,6,11,9,10,53,57,-4,42
Glentoran,4087,7,11,4,15,32,48,-16,37
Dungannon,4087,8,9,9,12,46,45,1,36
Ballinamalla,4087,9,10,5,15,30,47,-17,35
Portadown,4087,10,9,6,15,21,41,-20,33
Ards,4087,11,7,5,18,35,52,-17,26
Crusaders,4088,1,17,9,4,60,36,24,60
Linfield,4088,2,16,8,6,60,30,30,56
Cliftonville,4088,3,16,3,11,51,38,13,51
Glenavon,4088,4,12,11,7,49,38,11,47
Ballymena,4088,5,13,5,12,66,62,4,44
Dungannon,4088,6,12,7,11,53,44,9,43
Coleraine,4088,7,10,9,11,39,50,-11,39
Glentoran,4088,8,10,6,14,36,48,-12,36
Ards,4088,9,10,5,15,43,48,-5,35
Ballinamalla,4088,10,7,5,18,27,58,-31,26
Portadown,4088,11,4,8,18,22,54,-32,20
Crusaders,4089,1,21,6,3,63,31,32,69
Linfield,4089,2,14,11,5,58,32,26,53
Ballymena,4089,3,15,7,8,56,53,3,52
Glenavon,4089,4,12,7,11,47,49,-2,43
Cliftonville,4089,5,12,6,12,51,47,4,42
Dungannon,4089,6,10,10,10,54,45,9,40
Coleraine,4089,7,8,12,10,37,41,-4,36
Glentoran,4089,8,7,12,11,36,46,-10,33
Ards,4089,9,9,6,15,38,52,-14,33
Ballinamalla,4089,10,7,6,17,33,55,-22,27
Portadown,4089,11,6,5,19,22,44,-22,23
Crusaders,4090,1,17,6,7,59,37,22,57
Cliftonville,4090,2,16,5,9,53,41,12,53
Linfield,4090,3,14,10,6,60,32,28,52
Dungannon,4090,4,13,10,7,53,36,17,49
Ballymena,4090,5,15,4,11,60,62,-2,49
Glenavon,4090,6,12,9,9,58,54,4,45
Ards,4090,7,11,6,13,40,42,-2,39
Coleraine,4090,8,7,15,8,37,38,-1,36
Portadown,4090,9,8,5,17,26,44,-18,29
Glentoran,4090,10,6,7,17,25,52,-27,25
Ballinamalla,4090,11,5,5,20,29,62,-33,20
Crusaders,4091,1,17,9,4,62,35,27,60
Cliftonville,4091,2,16,4,10,63,43,20,52
Ballymena,4091,3,14,7,9,58,62,-4,49
Coleraine,4091,4,11,14,5,42,32,10,47
Linfield,4091,5,10,14,6,60,40,20,44
Glenavon,4091,6,9,14,7,44,43,1,41
Dungannon,4091,7,10,8,12,50,45,5,38
Glentoran,4091,8,10,7,13,35,43,-8,37
Ards,4091,9,10,5,15,42,54,-12,35
Ballinamalla,4091,10,6,6,18,28,54,-26,24
Portadown,4091,11,5,6,19,21,54,-33,21
Crusaders,4092,1,15,9,6,52,36,16,54
Ballymena,4092,2,16,6,8,57,52,5,54
Linfield,4092,3,14,8,8,62,37,25,50
Cliftonville,4092,4,15,5,10,59,47,12,50
Dungannon,4092,5,13,7,10,56,39,17,46
Coleraine,4092,6,11,11,8,43,34,9,44
Glenavon,4092,7,9,12,9,43,44,-1,39
Glentoran,4092,8,9,10,11,32,42,-10,37
Ballinamalla,4092,9,10,3,17,34,53,-19,33
Ards,4092,10,8,5,17,34,53,-19,29
Portadown,4092,11,5,4,21,19,54,-35,19
Linfield,4093,1,17,8,5,67,28,39,59
Crusaders,4093,2,17,6,7,55,32,23,57
Ballymena,4093,3,15,5,10,56,55,1,50
Cliftonville,4093,4,13,6,11,43,36,7,45
Dungannon,4093,5,12,8,10,50,41,9,44
Coleraine,4093,6,10,12,8,40,35,5,42
Glenavon,4093,7,8,12,10,40,47,-7,36
Glentoran,4093,8,9,8,13,31,43,-12,35
Ards,4093,9,9,5,16,34,51,-17,32
Portadown,4093,10,9,3,18,28,49,-21,30
Ballinamalla,4093,11,7,5,18,25,52,-27,26
Crusaders,4094,1,17,6,7,57,34,23,57
Linfield,4094,2,15,9,6,62,35,27,54
Coleraine,4094,3,15,8,7,49,32,17,53
Ballymena,4094,4,13,9,8,60,56,4,48
Dungannon,4094,5,12,8,10,53,40,13,44
Cliftonville,4094,6,12,6,12,50,53,-3,42
Glenavon,4094,7,10,10,10,41,48,-7,40
Ards,4094,8,9,5,16,32,48,-16,32
Portadown,4094,9,9,4,17,30,42,-12,31
Ballinamalla,4094,10,8,5,17,26,51,-25,29
Glentoran,4094,11,7,6,17,27,48,-21,27
Crusaders,4095,1,20,7,3,62,32,30,67
Ballymena,4095,2,15,6,9,63,53,10,51
Coleraine,4095,3,12,11,7,44,35,9,47
Linfield,4095,4,12,10,8,56,35,21,46
Cliftonville,4095,5,13,5,12,47,45,2,44
Dungannon,4095,6,9,9,12,49,52,-3,36
Glenavon,4095,7,8,11,11,49,56,-7,35
Ards,4095,8,9,7,14,34,48,-14,34
Glentoran,4095,9,8,8,14,28,41,-13,32
Portadown,4095,10,7,9,14,30,47,-17,30
Ballinamalla,4095,11,9,3,18,28,46,-18,30
Crusaders,4096,1,17,8,5,50,34,16,59
Linfield,4096,2,16,7,7,58,29,29,55
Cliftonville,4096,3,14,6,10,51,39,12,48
Ballymena,4096,4,14,6,10,57,53,4,48
Glenavon,4096,5,11,12,7,48,46,2,45
Coleraine,4096,6,11,11,8,40,33,7,44
Ballinamalla,4096,7,11,3,16,37,50,-13,36
Dungannon,4096,8,8,9,13,50,48,2,33
Ards,4096,9,8,7,15,36,49,-13,31
Glentoran,4096,10,8,7,15,27,44,-17,31
Portadown,4096,11,6,6,18,20,49,-29,24
Crusaders,4097,1,16,7,7,53,29,24,55
Ballymena,4097,2,16,5,9,58,54,4,53
Linfield,4097,3,13,12,5,55,30,25,51
Cliftonville,4097,4,14,6,10,52,41,11,48
Glenavon,4097,5,12,10,8,54,47,7,46
Dungannon,4097,6,12,9,9,49,43,6,45
Coleraine,4097,7,11,9,10,49,44,5,42
Ards,4097,8,10,7,13,38,45,-7,37
Glentoran,4097,9,8,9,13,29,48,-19,33
Ballinamalla,4097,10,4,9,17,28,57,-29,21
Portadown,4097,11,5,5,20,23,50,-27,20
Linfield,4098,1,16,10,4,64,33,31,58
Ballymena,4098,2,16,8,6,63,52,11,56
Cliftonville,4098,3,16,6,8,49,37,12,54
Crusaders,4098,4,14,10,6,53,34,19,52
Glenavon,4098,5,11,11,8,50,44,6,44
Coleraine,4098,6,8,12,10,42,42,0,36
Dungannon,4098,7,7,12,11,51,50,1,33
Glentoran,4098,8,7,9,14,34,52,-18,30
Ballinamalla,4098,9,7,8,15,36,52,-16,29
Ards,4098,10,7,8,15,33,52,-19,29
Portadown,4098,11,6,6,18,22,49,-27,24
Linfield,4099,1,18,8,4,64,24,40,62
Crusaders,4099,2,16,6,8,53,34,19,54
Cliftonville,4099,3,14,5,11,52,42,10,47
Glenavon,4099,4,13,8,9,51,50,1,47
Ballymena,4099,5,14,4,12,55,66,-11,46
Coleraine,4099,6,10,11,9,45,42,3,41
Dungannon,4099,7,9,9,12,51,47,4,36
Ards,4099,8,10,4,16,42,45,-3,34
Ballinamalla,4099,9,10,3,17,31,51,-20,33
Glentoran,4099,10,8,7,15,34,54,-20,31
Portadown,4099,11,7,7,16,32,55,-23,28
Crusaders,4100,1,18,7,5,59,30,29,61
Linfield,4100,2,16,11,3,65,29,36,59
Cliftonville,4100,3,16,4,10,48,33,15,52
Ballymena,4100,4,15,4,11,55,50,5,49
Glenavon,4100,5,10,14,6,45,43,2,44
Coleraine,4100,6,9,10,11,32,38,-6,37
Glentoran,4100,7,9,9,12,25,38,-13,36
Dungannon,4100,8,6,11,13,43,49,-6,29
Ards,4100,9,9,2,19,42,59,-17,29
Portadown,4100,10,7,8,15,25,47,-22,29
Ballinamalla,4100,11,8,4,18,30,53,-23,28
Crusaders,4101,1,18,8,4,67,39,28,62
Cliftonville,4101,2,15,6,9,59,43,16,51
Linfield,4101,3,14,8,8,66,36,30,50
Glenavon,4101,4,11,11,8,48,42,6,44
Ballymena,4101,5,12,7,11,50,56,-6,43
Coleraine,4101,6,10,10,10,41,43,-2,40
Glentoran,4101,7,11,5,14,31,47,-16,38
Ballinamalla,4101,8,10,6,14,28,47,-19,36
Dungannon,4101,9,8,10,12,54,49,5,34
Portadown,4101,10,8,8,14,29,45,-16,32
Ards,4101,11,6,5,19,35,61,-26,23
Linfield,4102,1,18,8,4,66,24,42,62
Crusaders,4102,2,18,7,5,67,35,32,61
Cliftonville,4102,3,14,5,11,49,43,6,47
Dungannon,4102,4,11,11,8,50,37,13,44
Glenavon,4102,5,10,13,7,44,45,-1,43
Ballymena,4102,6,13,4,13,56,64,-8,43
Glentoran,4102,7,10,9,11,32,42,-10,39
Coleraine,4102,8,8,11,11,36,44,-8,35
Ards,4102,9,6,10,14,36,50,-14,28
Ballinamalla,4102,10,7,6,17,32,53,-21,27
Portadown,4102,11,6,4,20,22,53,-31,22
Crusaders,4103,1,17,8,5,56,31,25,59
Linfield,4103,2,16,9,5,63,32,31,57
Cliftonville,4103,3,14,7,9,52,37,15,49
Ballymena,4103,4,13,10,7,58,49,9,49
Glenavon,4103,5,12,11,7,47,47,0,47
Coleraine,4103,6,11,11,8,44,37,7,44
Glentoran,4103,7,9,8,13,30,44,-14,35
Dungannon,4103,8,7,10,13,42,45,-3,31
Ards,4103,9,8,5,17,40,55,-15,29
Portadown,4103,10,8,5,17,23,43,-20,29
Ballinamalla,4103,11,6,4,20,30,65,-35,22
Crusaders,4104,1,16,7,7,54,33,21,55
Linfield,4104,2,14,10,6,56,31,25,52
Ballymena,4104,3,15,5,10,61,53,8,50
Cliftonville,4104,4,13,8,9,47,38,9,47
Glenavon,4104,5,11,11,8,50,44,6,44
Dungannon,4104,6,10,11,9,52,47,5,41
Coleraine,4104,7,8,13,9,36,40,-4,37
Ards,4104,8,9,9,12,35,43,-8,36
Glentoran,4104,9,8,7,15,30,42,-12,31
Portadown,4104,10,8,7,15,25,47,-22,31
Ballinamalla,4104,11,6,6,18,28,56,-28,24
Cliftonville,4105,1,16,6,8,50,33,17,54
Crusaders,4105,2,14,7,9,49,41,8,49
Linfield,4105,3,11,12,7,57,34,23,45
Ballymena,4105,4,13,6,11,56,62,-6,45
Glenavon,4105,5,11,11,8,56,53,3,44
Coleraine,4105,6,10,12,8,41,37,4,42
Glentoran,4105,7,10,8,12,29,42,-13,38
Dungannon,4105,8,9,10,11,50,47,3,37
Portadown,4105,9,9,6,15,27,40,-13,33
Ards,4105,10,8,7,15,35,46,-11,31
Ballinamalla,4105,11,8,7,15,34,49,-15,31
Ballymena,4106,1,17,5,8,60,51,9,56
Linfield,4106,2,15,9,6,63,33,30,54
Crusaders,4106,3,15,7,8,62,39,23,52
Coleraine,4106,4,12,11,7,42,33,9,47
Glenavon,4106,5,12,11,7,47,44,3,47
Cliftonville,4106,6,13,6,11,47,41,6,45
Dungannon,4106,7,10,8,12,51,44,7,38
Ards,4106,8,11,4,15,39,46,-7,37
Glentoran,4106,9,8,9,13,30,46,-16,33
Portadown,4106,10,7,5,18,20,48,-28,26
Ballinamalla,4106,11,6,3,21,26,62,-36,21
Crusaders,4107,1,16,11,3,67,34,33,59
Linfield,4107,2,14,10,6,55,29,26,52
Coleraine,4107,3,12,11,7,41,35,6,47
Cliftonville,4107,4,13,7,10,51,41,10,46
Ballymena,4107,5,12,7,11,51,57,-6,43
Glenavon,4107,6,10,11,9,49,46,3,41
Dungannon,4107,7,9,13,8,44,38,6,40
Ards,4107,8,8,7,15,35,53,-18,31
Ballinamalla,4107,9,9,3,18,31,46,-15,30
Glentoran,4107,10,7,9,14,29,53,-24,30
Portadown,4107,11,6,9,15,25,46,-21,27
Cliftonville,4108,1,19,3,8,67,37,30,60
Crusaders,4108,2,18,5,7,54,36,18,59
Linfield,4108,3,16,7,7,60,34,26,55
Glenavon,4108,4,12,8,10,52,45,7,44
Coleraine,4108,5,11,11,8,46,46,0,44
Dungannon,4108,6,11,8,11,53,49,4,41
Ballymena,4108,7,11,5,14,55,66,-11,38
Ards,4108,8,10,6,14,40,53,-13,36
Portadown,4108,9,8,5,17,29,50,-21,29
Glentoran,4108,10,6,8,16,22,40,-18,26
Ballinamalla,4108,11,6,8,16,29,51,-22,26
Crusaders,4109,1,17,8,5,57,30,27,59
Linfield,4109,2,16,8,6,62,31,31,56
Ballymena,4109,3,17,5,8,61,53,8,56
Cliftonville,4109,4,13,9,8,53,37,16,48
Glenavon,4109,5,11,8,11,44,47,-3,41
Coleraine,4109,6,9,12,9,42,42,0,39
Glentoran,4109,7,10,5,15,28,47,-19,35
Ballinamalla,4109,8,10,4,16,34,53,-19,34
Dungannon,4109,9,7,12,11,44,43,1,33
Portadown,4109,10,9,4,17,29,45,-16,31
Ards,4109,11,4,9,17,30,56,-26,21
Dungannon,4110,1,13,10,7,59,36,23,49
Linfield,4110,2,13,10,7,55,32,23,49
Crusaders,4110,3,12,13,5,54,37,17,49
Ballymena,4110,4,14,6,10,69,59,10,48
Cliftonville,4110,5,14,6,10,54,50,4,48
Glenavon,4110,6,11,13,6,49,44,5,46
Coleraine,4110,7,10,11,9,47,43,4,41
Ballinamalla,4110,8,11,3,16,35,50,-15,36
Ards,4110,9,8,7,15,40,51,-11,31
Glentoran,4110,10,6,8,16,23,55,-32,26
Portadown,4110,11,5,9,16,23,51,-28,24
Linfield,4111,1,15,9,6,56,30,26,54
Cliftonville,4111,2,15,5,10,52,37,15,50
Coleraine,4111,3,13,9,8,49,36,13,48
Crusaders,4111,4,13,7,10,53,44,9,46
Glenavon,4111,5,12,10,8,48,40,8,46
Ballymena,4111,6,14,4,12,49,54,-5,46
Dungannon,4111,7,11,10,9,50,40,10,43
Portadown,4111,8,9,5,16,23,41,-18,32
Glentoran,4111,9,8,7,15,33,51,-18,31
Ballinamalla,4111,10,8,7,15,25,44,-19,31
Ards,4111,11,7,7,16,31,52,-21,28
Crusaders,4112,1,17,8,5,59,33,26,59
Linfield,4112,2,16,9,5,60,31,29,57
Cliftonville,4112,3,16,4,10,53,41,12,52
Ballymena,4112,4,14,6,10,55,54,1,48
Coleraine,4112,5,10,12,8,40,36,4,42
Glenavon,4112,6,11,9,10,46,49,-3,42
Glentoran,4112,7,9,7,14,26,41,-15,34
Ballinamalla,4112,8,10,4,16,34,54,-20,34
Dungannon,4112,9,7,10,13,46,46,0,31
Ards,4112,10,7,8,15,37,47,-10,29
Portadown,4112,11,7,5,18,23,47,-24,26
Crusaders,4113,1,17,6,7,56,44,12,57
Cliftonville,4113,2,15,4,11,53,46,7,49
Linfield,4113,3,13,8,9,52,33,19,47
Dungannon,4113,4,13,8,9,55,37,18,47
Ballymena,4113,5,13,7,10,52,52,0,46
Glenavon,4113,6,12,9,9,50,42,8,45
Coleraine,4113,7,11,10,9,45,41,4,43
Ards,4113,8,10,8,12,46,48,-2,38
Glentoran,4113,9,10,5,15,33,52,-19,35
Portadown,4113,10,8,6,16,26,42,-16,30
Ballinamalla,4113,11,6,3,21,25,56,-31,21
Ballymena,4114,1,17,6,7,60,52,8,57
Crusaders,4114,2,14,9,7,53,35,18,51
Linfield,4114,3,14,8,8,54,32,22,50
Glenavon,4114,4,13,9,8,38,35,3,48
Cliftonville,4114,5,12,5,13,46,42,4,41
Coleraine,4114,6,9,12,9,38,39,-1,39
Ards,4114,7,11,6,13,33,39,-6,39
Glentoran,4114,8,10,9,11,28,37,-9,39
Dungannon,4114,9,10,8,12,55,46,9,38
Ballinamalla,4114,10,7,7,16,36,58,-22,28
Portadown,4114,11,5,7,18,23,49,-26,22
Linfield,4115,1,18,9,3,67,19,48,63
Crusaders,4115,2,13,11,6,57,40,17,50
Cliftonville,4115,3,14,7,9,54,45,9,49
Ballymena,4115,4,14,4,12,58,59,-1,46
Coleraine,4115,5,10,13,7,48,42,6,43
Glenavon,4115,6,11,10,9,48,49,-1,43
Glentoran,4115,7,10,9,11,26,33,-7,39
Dungannon,4115,8,9,11,10,45,43,2,38
Ards,4115,9,8,6,16,35,54,-19,30
Portadown,4115,10,7,6,17,27,53,-26,27
Ballinamalla,4115,11,4,8,18,17,45,-28,20
Crusaders,4116,1,17,8,5,59,32,27,59
Cliftonville,4116,2,17,4,9,56,38,18,55
Linfield,4116,3,13,14,3,60,29,31,53
Ballymena,4116,4,13,8,9,58,59,-1,47
Coleraine,4116,5,11,11,8,46,37,9,44
Dungannon,4116,6,10,11,9,58,49,9,41
Glenavon,4116,7,9,11,10,39,44,-5,38
Glentoran,4116,8,9,10,11,28,42,-14,37
Ballinamalla,4116,9,8,3,19,35,59,-24,27
Portadown,4116,10,6,8,16,21,42,-21,26
Ards,4116,11,7,2,21,37,66,-29,23
Linfield,4117,1,16,9,5,70,33,37,57
Crusaders,4117,2,15,11,4,59,33,26,56
Cliftonville,4117,3,14,6,10,50,39,11,48
Ballymena,4117,4,13,8,9,55,58,-3,47
Dungannon,4117,5,9,13,8,47,39,8,40
Coleraine,4117,6,9,11,10,35,35,0,38
Glenavon,4117,7,8,13,9,41,44,-3,37
Ards,4117,8,11,3,16,41,51,-10,36
Portadown,4117,9,8,9,13,29,43,-14,33
Glentoran,4117,10,8,7,15,26,54,-28,31
Ballinamalla,4117,11,7,4,19,29,53,-24,25
Crusaders,4118,1,17,8,5,60,30,30,59
Cliftonville,4118,2,18,4,8,54,37,17,58
Ballymena,4118,3,15,5,10,64,65,-1,50
Linfield,4118,4,13,8,9,60,40,20,47
Coleraine,4118,5,11,12,7,46,41,5,45
Glenavon,4118,6,11,11,8,43,41,2,44
Dungannon,4118,7,10,9,11,52,46,6,39
Portadown,4118,8,11,5,14,28,37,-9,38
Glentoran,4118,9,7,9,14,27,49,-22,30
Ards,4118,10,8,2,20,34,56,-22,26
Ballinamalla,4118,11,6,3,21,32,58,-26,21
Crusaders,4119,1,17,9,4,61,35,26,60
Linfield,4119,2,14,9,7,59,37,22,51
Cliftonville,4119,3,16,3,11,48,42,6,51
Ballymena,4119,4,13,7,10,46,50,-4,46
Glenavon,4119,5,11,11,8,49,45,4,44
Coleraine,4119,6,11,11,8,45,41,4,44
Ballinamalla,4119,7,10,5,15,38,49,-11,35
Dungannon,4119,8,8,10,12,50,45,5,34
Glentoran,4119,9,9,7,14,28,41,-13,34
Portadown,4119,10,8,5,17,24,43,-19,29
Ards,4119,11,8,3,19,34,54,-20,27
Ballymena,4120,1,16,7,7,59,50,9,55
Linfield,4120,2,13,11,6,63,31,32,50
Crusaders,4120,3,14,8,8,51,36,15,50
Glenavon,4120,4,12,11,7,48,42,6,47
Dungannon,4120,5,12,8,10,58,46,12,44
Coleraine,4120,6,11,11,8,41,39,2,44
Cliftonville,4120,7,12,4,14,47,46,1,40
Ards,4120,8,11,4,15,38,48,-10,37
Glentoran,4120,9,6,11,13,24,44,-20,29
Ballinamalla,4120,10,7,7,16,27,48,-21,28
Portadown,4120,11,8,4,18,25,51,-26,28
Crusaders,4121,1,15,8,7,59,39,20,53
Ballymena,4121,2,15,6,9,61,61,0,51
Coleraine,4121,3,13,11,6,47,34,13,50
Linfield,4121,4,14,7,9,58,38,20,49
Cliftonville,4121,5,14,3,13,53,49,4,45
Dungannon,4121,6,11,10,9,57,40,17,43
Glenavon,4121,7,10,12,8,45,40,5,42
Ards,4121,8,11,4,15,42,47,-5,37
Glentoran,4121,9,9,7,14,37,52,-15,34
Ballinamalla,4121,10,8,5,17,31,63,-32,29
Portadown,4121,11,5,7,18,25,52,-27,22
Linfield,4122,1,16,10,4,61,27,34,58
Cliftonville,4122,2,16,5,9,52,33,19,53
Ballymena,4122,3,14,8,8,63,60,3,50
Crusaders,4122,4,13,9,8,50,36,14,48
Dungannon,4122,5,12,10,8,50,36,14,46
Glenavon,4122,6,12,10,8,47,42,5,46
Coleraine,4122,7,8,12,10,35,39,-4,36
Glentoran,4122,8,7,9,14,29,47,-18,30
Ballinamalla,4122,9,8,6,16,31,53,-22,30
Ards,4122,10,8,4,18,34,51,-17,28
Portadown,4122,11,6,7,17,23,51,-28,25
Linfield,4123,1,15,10,5,63,36,27,55
Coleraine,4123,2,13,10,7,41,33,8,49
Crusaders,4123,3,14,7,9,44,40,4,49
Cliftonville,4123,4,13,5,12,45,42,3,44
Ballymena,4123,5,12,7,11,54,53,1,43
Dungannon,4123,6,9,11,10,53,44,9,38
Glenavon,4123,7,9,11,10,40,39,1,38
Glentoran,4123,8,9,10,11,32,39,-7,37
Ards,4123,9,9,8,13,36,46,-10,35
Portadown,4123,10,8,8,14,28,45,-17,32
Ballinamalla,4123,11,7,7,16,27,46,-19,28
Crusaders,4124,1,15,8,7,47,31,16,53
Dungannon,4124,2,14,7,9,57,41,16,49
Cliftonville,4124,3,14,6,10,51,41,10,48
Glenavon,4124,4,11,13,6,47,42,5,46
Ballymena,4124,5,13,7,10,61,60,1,46
Linfield,4124,6,12,9,9,59,40,19,45
Coleraine,4124,7,9,11,10,38,34,4,38
Glentoran,4124,8,10,8,12,35,51,-16,38
Ards,4124,9,9,8,13,41,49,-8,35
Ballinamalla,4124,10,6,8,16,28,50,-22,26
Portadown,4124,11,6,7,17,23,48,-25,25
Crusaders,4125,1,15,6,9,57,42,15,51
Ballymena,4125,2,15,6,9,56,52,4,51
Cliftonville,4125,3,14,7,9,50,35,15,49
Linfield,4125,4,11,11,8,55,40,15,44
Dungannon,4125,5,12,8,10,55,42,13,44
Coleraine,4125,6,10,13,7,53,39,14,43
Portadown,4125,7,11,6,13,33,43,-10,39
Glenavon,4125,8,10,8,12,45,58,-13,38
Glentoran,4125,9,8,8,14,33,49,-16,32
Ards,4125,10,8,7,15,42,59,-17,31
Ballinamalla,4125,11,7,8,15,32,52,-20,29
Cliftonville,4126,1,18,3,9,55,36,19,57
Linfield,4126,2,16,8,6,57,24,33,56
Crusaders,4126,3,15,5,10,45,38,7,50
Ballymena,4126,4,15,5,10,57,54,3,50
Dungannon,4126,5,11,9,10,50,44,6,42
Coleraine,4126,6,10,11,9,36,37,-1,41
Glenavon,4126,7,8,11,11,43,47,-4,35
Glentoran,4126,8,9,7,14,28,43,-15,34
Ards,4126,9,9,5,16,41,53,-12,32
Portadown,4126,10,9,4,17,25,43,-18,31
Ballinamalla,4126,11,8,6,16,30,48,-18,30
Linfield,4127,1,18,6,6,59,26,33,60
Crusaders,4127,2,16,10,4,57,35,22,58
Cliftonville,4127,3,15,6,9,58,40,18,51
Ballymena,4127,4,15,5,10,55,53,2,50
Dungannon,4127,5,11,9,10,55,41,14,42
Coleraine,4127,6,10,12,8,38,36,2,42
Glenavon,4127,7,11,8,11,46,41,5,41
Ards,4127,8,10,7,13,36,47,-11,37
Glentoran,4127,9,6,10,14,24,43,-19,28
Ballinamalla,4127,10,6,5,19,25,55,-30,23
Portadown,4127,11,6,4,20,18,54,-36,22
Crusaders,4128,1,18,9,3,56,26,30,63
Linfield,4128,2,17,11,2,65,31,34,62
Cliftonville,4128,3,12,9,9,50,41,9,45
Coleraine,4128,4,11,11,8,45,39,6,44
Glentoran,4128,5,11,9,10,37,41,-4,42
Glenavon,4128,6,9,14,7,48,44,4,41
Ballymena,4128,7,10,10,10,55,60,-5,40
Ards,4128,8,11,3,16,39,47,-8,36
Dungannon,4128,9,8,11,11,43,44,-1,35
Portadown,4128,10,6,6,18,29,55,-26,24
Ballinamalla,4128,11,4,3,23,21,60,-39,15
Crusaders,4129,1,17,9,4,58,33,25,60
Cliftonville,4129,2,15,7,8,51,35,16,52
Glenavon,4129,3,14,9,7,59,45,14,51
Linfield,4129,4,14,8,8,62,31,31,50
Ballymena,4129,5,14,7,9,57,60,-3,49
Coleraine,4129,6,9,13,8,46,44,2,40
Ards,4129,7,9,8,13,36,48,-12,35
Dungannon,4129,8,8,8,14,44,52,-8,32
Glentoran,4129,9,7,10,13,30,49,-19,31
Portadown,4129,10,7,5,18,22,45,-23,26
Ballinamalla,4129,11,6,6,18,30,53,-23,24
Cliftonville,4130,1,16,5,9,57,41,16,53
Crusaders,4130,2,14,9,7,60,43,17,51
Ballymena,4130,3,14,6,10,53,51,2,48
Linfield,4130,4,13,8,9,60,38,22,47
Coleraine,4130,5,12,11,7,51,42,9,47
Glenavon,4130,6,11,10,9,52,48,4,43
Glentoran,4130,7,10,9,11,37,46,-9,39
Dungannon,4130,8,9,8,13,48,45,3,35
Ards,4130,9,8,8,14,36,48,-12,32
Ballinamalla,4130,10,9,5,16,29,53,-24,32
Portadown,4130,11,6,7,17,20,48,-28,25
Crusaders,4131,1,16,8,6,57,32,25,56
Linfield,4131,2,16,7,7,57,28,29,55
Glenavon,4131,3,13,11,6,44,42,2,50
Ballymena,4131,4,13,7,10,61,59,2,46
Cliftonville,4131,5,13,5,12,48,45,3,44
Coleraine,4131,6,11,9,10,44,39,5,42
Dungannon,4131,7,10,10,10,52,44,8,40
Ards,4131,8,11,5,14,34,46,-12,38
Glentoran,4131,9,7,11,12,30,42,-12,32
Portadown,4131,10,6,9,15,24,44,-20,27
Ballinamalla,4131,11,5,6,19,25,55,-30,21
Linfield,4132,1,15,11,4,55,27,28,56
Crusaders,4132,2,16,8,6,51,32,19,56
Cliftonville,4132,3,15,3,12,49,40,9,48
Coleraine,4132,4,12,12,6,42,35,7,48
Ballymena,4132,5,12,8,10,61,60,1,44
Dungannon,4132,6,11,9,10,52,47,5,42
Glenavon,4132,7,11,9,10,39,39,0,42
Ards,4132,8,7,10,13,34,44,-10,31
Glentoran,4132,9,8,7,15,32,49,-17,31
Ballinamalla,4132,10,8,5,17,27,46,-19,29
Portadown,4132,11,5,8,17,21,44,-23,23
Crusaders,4133,1,18,4,8,53,37,16,58
Linfield,4133,2,16,8,6,65,33,32,56
Ballymena,4133,3,16,4,10,64,60,4,52
Cliftonville,4133,4,13,6,11,43,39,4,45
Glenavon,4133,5,11,10,9,55,48,7,43
Coleraine,4133,6,11,9,10,40,47,-7,42
Dungannon,4133,7,9,9,12,47,42,5,36
Glentoran,4133,8,9,7,14,33,42,-9,34
Ballinamalla,4133,9,10,4,16,39,55,-16,34
Ards,4133,10,9,4,17,38,56,-18,31
Portadown,4133,11,7,7,16,29,47,-18,28
Crusaders,4134,1,16,8,6,57,31,26,56
Linfield,4134,2,14,8,8,61,36,25,50
Cliftonville,4134,3,14,7,9,45,35,10,49
Glenavon,4134,4,11,12,7,43,40,3,45
Ballymena,4134,5,12,8,10,51,58,-7,44
Coleraine,4134,6,10,12,8,43,35,8,42
Dungannon,4134,7,9,11,10,47,44,3,38
Glentoran,4134,8,10,8,12,37,44,-7,38
Portadown,4134,9,9,6,15,26,45,-19,33
Ballinamalla,4134,10,8,6,16,29,49,-20,30
Ards,4134,11,7,4,19,29,51,-22,25
Linfield,4135,1,16,9,5,66,28,38,57
Cliftonville,4135,2,17,6,7,55,33,22,57
Crusaders,4135,3,16,8,6,50,32,18,56
Dungannon,4135,4,13,11,6,56,36,20,50
Ballymena,4135,5,12,9,9,54,58,-4,45
Coleraine,4135,6,11,8,11,47,47,0,41
Glenavon,4135,7,9,12,9,49,51,-2,39
Glentoran,4135,8,8,7,15,27,50,-23,31
Ards,4135,9,8,5,17,32,49,-17,29
Ballinamalla,4135,10,6,8,16,27,49,-22,26
Portadown,4135,11,4,7,19,29,59,-30,19
Crusaders,4136,1,18,8,4,60,30,30,62
Glenavon,4136,2,14,10,6,49,39,10,52
Linfield,4136,3,14,9,7,55,33,22,51
Ballymena,4136,4,14,5,11,58,62,-4,47
Cliftonville,4136,5,13,4,13,45,43,2,43
Dungannon,4136,6,11,9,10,55,43,12,42
Coleraine,4136,7,8,13,9,41,42,-1,37
Ards,4136,8,9,5,16,40,48,-8,32
Portadown,4136,9,8,8,14,25,40,-15,32
Glentoran,4136,10,8,7,15,28,52,-24,31
Ballinamalla,4136,11,5,8,17,32,56,-24,23
Crusaders,4137,1,16,8,6,53,32,21,56
Linfield,4137,2,15,9,6,63,31,32,54
Cliftonville,4137,3,17,3,10,53,35,18,54
Ballymena,4137,4,15,7,8,56,55,1,52
Coleraine,4137,5,13,9,8,45,37,8,48
Glenavon,4137,6,11,10,9,45,44,1,43
Dungannon,4137,7,11,7,12,47,47,0,40
Ards,4137,8,12,3,15,40,46,-6,39
Glentoran,4137,9,7,5,18,30,50,-20,26
Portadown,4137,10,6,6,18,26,48,-22,24
Ballinamalla,4137,11,7,3,20,28,61,-33,24
Crusaders,4138,1,19,5,6,60,30,30,62
Ballymena,4138,2,15,5,10,65,60,5,50
Cliftonville,4138,3,15,3,12,49,35,14,48
Coleraine,4138,4,11,11,8,40,35,5,44
Linfield,4138,5,12,7,11,51,40,11,43
Glenavon,4138,6,10,12,8,48,51,-3,42
Ards,4138,7,11,7,12,46,45,1,40
Glentoran,4138,8,11,5,14,34,48,-14,38
Dungannon,4138,9,9,7,14,42,44,-2,34
Ballinamalla,4138,10,10,4,16,29,45,-16,34
Portadown,4138,11,6,6,18,17,48,-31,24
Crusaders,4139,1,17,8,5,65,34,31,59
Cliftonville,4139,2,16,6,8,56,39,17,54
Linfield,4139,3,14,8,8,59,34,25,50
Ballymena,4139,4,13,9,8,58,51,7,48
Glenavon,4139,5,10,10,10,49,52,-3,40
Glentoran,4139,6,11,7,12,38,47,-9,40
Coleraine,4139,7,8,14,8,45,41,4,38
Portadown,4139,8,10,6,14,26,45,-19,36
Dungannon,4139,9,7,11,12,45,50,-5,32
Ballinamalla,4139,10,8,4,18,32,60,-28,28
Ards,4139,11,7,5,18,35,55,-20,26
Linfield,4140,1,16,10,4,58,24,34,58
Crusaders,4140,2,17,6,7,51,33,18,57
Ballymena,4140,3,15,6,9,61,50,11,51
Coleraine,4140,4,11,13,6,37,34,3,46
Cliftonville,4140,5,13,6,11,49,38,11,45
Dungannon,4140,6,11,10,9,57,43,14,43
Glenavon,4140,7,10,11,9,43,46,-3,41
Ards,4140,8,11,5,14,36,46,-10,38
Glentoran,4140,9,7,8,15,26,42,-16,29
Ballinamalla,4140,10,6,5,19,23,57,-34,23
Portadown,4140,11,3,10,17,21,49,-28,19
Crusaders,4141,1,19,7,4,65,33,32,64
Linfield,4141,2,16,9,5,63,35,28,57
Cliftonville,4141,3,16,5,9,58,34,24,53
Glenavon,4141,4,12,10,8,44,42,2,46
Ballymena,4141,5,14,4,12,55,56,-1,46
Coleraine,4141,6,12,9,9,39,35,4,45
Portadown,4141,7,11,6,13,33,44,-11,39
Dungannon,4141,8,6,12,12,46,47,-1,30
Ballinamalla,4141,9,7,5,18,32,59,-27,26
Ards,4141,10,6,7,17,39,65,-26,25
Glentoran,4141,11,6,6,18,28,52,-24,24
Crusaders,4142,1,16,5,9,52,36,16,53
Linfield,4142,2,14,9,7,60,33,27,51
Cliftonville,4142,3,15,6,9,55,42,13,51
Ballymena,4142,4,14,8,8,58,54,4,50
Dungannon,4142,5,12,9,9,52,38,14,45
Glenavon,4142,6,11,10,9,47,47,0,43
Coleraine,4142,7,11,7,12,36,39,-3,40
Ballinamalla,4142,8,9,8,13,29,43,-14,35
Glentoran,4142,9,7,9,14,29,48,-19,30
Ards,4142,10,8,5,17,39,55,-16,29
Portadown,4142,11,8,4,18,26,48,-22,28
Crusaders,4143,1,15,9,6,57,40,17,54
Linfield,4143,2,13,11,6,62,33,29,50
Cliftonville,4143,3,15,4,11,54,42,12,49
Coleraine,4143,4,13,10,7,45,37,8,49
Glenavon,4143,5,12,11,7,50,36,14,47
Dungannon,4143,6,13,7,10,49,41,8,46
Ballymena,4143,7,13,7,10,55,57,-2,46
Glentoran,4143,8,8,10,12,35,51,-16,34
Portadown,4143,9,8,6,16,26,46,-20,30
Ards,4143,10,7,4,19,34,55,-21,25
Ballinamalla,4143,11,6,5,19,28,57,-29,23
Ballymena,4144,1,16,6,8,57,54,3,54
Crusaders,4144,2,15,7,8,56,43,13,52
Cliftonville,4144,3,14,7,9,58,45,13,49
Linfield,4144,4,12,9,9,54,37,17,45
Glenavon,4144,5,10,12,8,50,45,5,42
Coleraine,4144,6,10,11,9,43,37,6,41
Glentoran,4144,7,11,7,12,30,38,-8,40
Dungannon,4144,8,9,10,11,49,45,4,37
Ards,4144,9,10,6,14,37,44,-7,36
Ballinamalla,4144,10,9,2,19,26,53,-27,29
Portadown,4144,11,5,11,14,24,43,-19,26
Crusaders,4145,1,16,10,4,58,34,24,58
Cliftonville,4145,2,15,7,8,55,41,14,52
Linfield,4145,3,13,10,7,60,37,23,49
Glenavon,4145,4,12,12,6,50,41,9,48
Ballymena,4145,5,14,6,10,57,59,-2,48
Dungannon,4145,6,8,13,9,53,36,17,37
Coleraine,4145,7,7,14,9,36,39,-3,35
Glentoran,4145,8,8,10,12,34,50,-16,34
Ards,4145,9,8,7,15,35,48,-13,31
Ballinamalla,4145,10,8,3,19,27,56,-29,27
Portadown,4145,11,5,10,15,27,51,-24,25
Linfield,4146,1,17,8,5,58,26,32,59
Crusaders,4146,2,15,8,7,53,37,16,53
Cliftonville,4146,3,15,4,11,47,41,6,49
Glenavon,4146,4,13,9,8,46,43,3,48
Coleraine,4146,5,12,10,8,48,36,12,46
Ballymena,4146,6,14,4,12,52,55,-3,46
Glentoran,4146,7,10,7,13,36,45,-9,37
Ballinamalla,4146,8,10,3,17,30,51,-21,33
Dungannon,4146,9,8,8,14,50,48,2,32
Ards,4146,10,9,4,17,33,54,-21,31
Portadown,4146,11,6,7,17,29,46,-17,25
Crusaders,4147,1,18,5,7,56,31,25,59
Coleraine,4147,2,16,10,4,47,28,19,58
Cliftonville,4147,3,16,2,12,57,41,16,50
Glenavon,4147,4,11,12,7,43,46,-3,45
Ballymena,4147,5,13,4,13,53,56,-3,43
Linfield,4147,6,10,12,8,51,35,16,42
Ards,4147,7,11,4,15,38,50,-12,37
Dungannon,4147,8,9,9,12,51,47,4,36
Glentoran,4147,9,9,6,15,33,49,-16,33
Portadown,4147,10,9,3,18,28,52,-24,30
Ballinamalla,4147,11,7,5,18,35,57,-22,26
Cliftonville,4148,1,17,6,7,53,33,20,57
Ballymena,4148,2,16,6,8,58,52,6,54
Linfield,4148,3,14,9,7,59,31,28,51
Glenavon,4148,4,12,11,7,50,43,7,47
Crusaders,4148,5,12,9,9,47,36,11,45
Dungannon,4148,6,11,7,12,53,50,3,40
Portadown,4148,7,10,6,14,33,38,-5,36
Coleraine,4148,8,9,9,12,33,43,-10,36
Glentoran,4148,9,10,6,14,33,48,-15,36
Ards,4148,10,8,4,18,33,53,-20,28
Ballinamalla,4148,11,7,5,18,20,45,-25,26
Crusaders,4149,1,15,8,7,55,37,18,53
Coleraine,4149,2,12,12,6,41,31,10,48
Glenavon,4149,3,13,9,8,52,46,6,48
Ballymena,4149,4,14,5,11,59,57,2,47
Linfield,4149,5,13,7,10,51,31,20,46
Cliftonville,4149,6,13,7,10,46,38,8,46
Glentoran,4149,7,11,7,12,35,43,-8,40
Dungannon,4149,8,6,15,9,46,43,3,33
Ballinamalla,4149,9,9,6,15,30,48,-18,33
Ards,4149,10,7,7,16,31,51,-20,28
Portadown,4149,11,6,9,15,30,51,-21,27
Linfield,4150,1,15,8,7,63,34,29,53
Crusaders,4150,2,14,10,6,54,34,20,52
Cliftonville,4150,3,15,3,12,54,41,13,48
Ballymena,4150,4,14,6,10,54,58,-4,48
Coleraine,4150,5,11,10,9,46,41,5,43
Dungannon,4150,6,10,8,12,49,42,7,38
Glenavon,4150,7,7,17,6,41,41,0,38
Glentoran,4150,8,11,5,14,30,44,-14,38
Ards,4150,9,11,3,16,48,55,-7,36
Ballinamalla,4150,10,11,2,17,32,49,-17,35
Portadown,4150,11,8,4,18,21,53,-32,28
Crusaders,4151,1,16,9,5,57,33,24,57
Cliftonville,4151,2,16,5,9,56,38,18,53
Ballymena,4151,3,13,7,10,58,63,-5,46
Linfield,4151,4,10,12,8,58,41,17,42
Dungannon,4151,5,10,11,9,48,40,8,41
Ards,4151,6,12,5,13,46,46,0,41
Glentoran,4151,7,9,12,9,27,33,-6,39
Glenavon,4151,8,6,16,8,41,47,-6,34
Ballinamalla,4151,9,10,3,17,33,49,-16,33
Coleraine,4151,10,7,11,12,36,47,-11,32
Portadown,4151,11,8,5,17,36,59,-23,29
Crusaders,4152,1,15,7,8,51,37,14,52
Linfield,4152,2,13,12,5,52,25,27,51
Ballymena,4152,3,14,9,7,53,52,1,51
Cliftonville,4152,4,14,6,10,51,39,12,48
Coleraine,4152,5,11,13,6,47,36,11,46
Glenavon,4152,6,10,9,11,51,53,-2,39
Glentoran,4152,7,10,9,11,37,44,-7,39
Dungannon,4152,8,9,10,11,45,44,1,37
Portadown,4152,9,8,8,14,25,42,-17,32
Ards,4152,10,7,7,16,36,50,-14,28
Ballinamalla,4152,11,7,4,19,28,54,-26,25
Crusaders,4153,1,18,5,7,59,37,22,59
Linfield,4153,2,15,9,6,65,34,31,54
Cliftonville,4153,3,14,7,9,55,41,14,49
Glenavon,4153,4,11,11,8,47,45,2,44
Ballymena,4153,5,12,8,10,57,59,-2,44
Dungannon,4153,6,11,9,10,50,41,9,42
Coleraine,4153,7,10,12,8,40,38,2,42
Glentoran,4153,8,8,9,13,29,52,-23,33
Ards,4153,9,9,5,16,37,49,-12,32
Portadown,4153,10,8,5,17,25,45,-20,29
Ballinamalla,4153,11,7,4,19,30,53,-23,25
Crusaders,4154,1,16,7,7,53,37,16,55
Cliftonville,4154,2,15,8,7,50,31,19,53
Linfield,4154,3,12,12,6,56,31,25,48
Ballymena,4154,4,12,9,9,57,49,8,45
Glenavon,4154,5,11,11,8,44,48,-4,44
Ards,4154,6,12,6,12,45,46,-1,42
Dungannon,4154,7,11,8,11,47,42,5,41
Glentoran,4154,8,10,7,13,31,41,-10,37
Coleraine,4154,9,8,10,12,35,42,-7,34
Portadown,4154,10,8,5,17,26,47,-21,29
Ballinamalla,4154,11,6,5,19,28,58,-30,23
Crusaders,4155,1,16,9,5,61,40,21,57
Cliftonville,4155,2,14,8,8,51,39,12,50
Linfield,4155,3,12,9,9,55,31,24,45
Coleraine,4155,4,11,11,8,41,39,2,44
Ards,4155,5,11,7,12,37,40,-3,40
Ballymena,4155,6,11,7,12,54,63,-9,40
Dungannon,4155,7,9,12,9,46,37,9,39
Glenavon,4155,8,9,10,11,40,47,-7,37
Glentoran,4155,9,10,7,13,34,43,-9,37
Ballinamalla,4155,10,9,4,17,32,51,-19,31
Portadown,4155,11,8,6,16,27,48,-21,30
Linfield,4156,1,14,12,4,64,32,32,54
Coleraine,4156,2,13,14,3,46,32,14,53
Crusaders,4156,3,14,7,9,51,39,12,49
Ballymena,4156,4,13,9,8,63,59,4,48
Dungannon,4156,5,10,11,9,52,45,7,41
Cliftonville,4156,6,12,5,13,51,47,4,41
Glenavon,4156,7,9,14,7,50,48,2,41
Glentoran,4156,8,8,12,10,31,39,-8,36
Ards,4156,9,7,8,15,39,50,-11,29
Portadown,4156,10,7,5,18,24,46,-22,26
Ballinamalla,4156,11,6,7,17,28,62,-34,25
Cliftonville,4157,1,18,2,10,52,37,15,56
Linfield,4157,2,16,7,7,63,34,29,55
Glenavon,4157,3,13,10,7,53,48,5,49
Dungannon,4157,4,12,9,9,57,46,11,45
Crusaders,4157,5,13,6,11,49,42,7,45
Coleraine,4157,6,12,9,9,44,41,3,45
Ballymena,4157,7,12,7,11,55,60,-5,43
Glentoran,4157,8,11,6,13,36,42,-6,39
Ards,4157,9,7,7,16,31,45,-14,28
Portadown,4157,10,6,10,14,33,53,-20,28
Ballinamalla,4157,11,7,3,20,27,52,-25,24
Linfield,4158,1,16,9,5,65,33,32,57
Crusaders,4158,2,16,6,8,47,36,11,54
Cliftonville,4158,3,13,6,11,47,41,6,45
Ballymena,4158,4,12,9,9,56,56,0,45
Coleraine,4158,5,10,12,8,44,36,8,42
Dungannon,4158,6,10,8,12,52,51,1,38
Glenavon,4158,7,8,14,8,40,43,-3,38
Glentoran,4158,8,9,10,11,35,42,-7,37
Ards,4158,9,9,6,15,37,52,-15,33
Ballinamalla,4158,10,10,3,17,30,46,-16,33
Portadown,4158,11,7,7,16,24,41,-17,28
Crusaders,4159,1,19,7,4,61,32,29,64
Linfield,4159,2,13,10,7,59,33,26,49
Cliftonville,4159,3,14,6,10,54,45,9,48
Coleraine,4159,4,11,10,9,41,39,2,43
Ballymena,4159,5,12,6,12,54,56,-2,42
Glenavon,4159,6,10,11,9,43,46,-3,41
Glentoran,4159,7,11,8,11,34,38,-4,41
Dungannon,4159,8,8,10,12,47,45,2,34
Ards,4159,9,9,7,14,32,44,-12,34
Ballinamalla,4159,10,8,6,16,30,52,-22,30
Portadown,4159,11,7,5,18,19,44,-25,26
Crusaders,4160,1,17,6,7,53,33,20,57
Linfield,4160,2,15,8,7,61,32,29,53
Ballymena,4160,3,15,7,8,56,53,3,52
Cliftonville,4160,4,15,5,10,57,42,15,50
Glenavon,4160,5,10,13,7,43,40,3,43
Glentoran,4160,6,13,4,13,33,41,-8,43
Coleraine,4160,7,10,11,9,40,39,1,41
Dungannon,4160,8,10,8,12,45,41,4,38
Ards,4160,9,10,2,18,41,52,-11,32
Portadown,4160,10,6,8,16,19,43,-24,26
Ballinamalla,4160,11,6,4,20,25,57,-32,22
Cliftonville,4161,1,18,4,8,62,36,26,58
Crusaders,4161,2,16,8,6,55,31,24,56
Ballymena,4161,3,17,5,8,64,55,9,56
Linfield,4161,4,14,8,8,53,35,18,50
Coleraine,4161,5,13,9,8,46,39,7,48
Glenavon,4161,6,10,12,8,49,46,3,42
Dungannon,4161,7,9,11,10,53,46,7,38
Glentoran,4161,8,7,11,12,29,42,-13,32
Ards,4161,9,7,5,18,34,56,-22,26
Ballinamalla,4161,10,6,7,17,32,56,-24,25
Portadown,4161,11,4,8,18,26,61,-35,20
Crusaders,4162,1,18,4,8,60,36,24,58
Linfield,4162,2,13,13,4,58,30,28,52
Cliftonville,4162,3,15,4,11,49,39,10,49
Coleraine,4162,4,11,11,8,41,37,4,44
Glenavon,4162,5,10,11,9,47,45,2,41
Ballymena,4162,6,10,10,10,55,60,-5,40
Dungannon,4162,7,10,8,12,47,46,1,38
Ards,4162,8,10,5,15,38,47,-9,35
Glentoran,4162,9,9,8,13,30,44,-14,35
Portadown,4162,10,10,5,15,30,48,-18,35
Ballinamalla,4162,11,8,3,19,28,51,-23,27
Crusaders,4163,1,19,6,5,66,33,33,63
Linfield,4163,2,16,8,6,61,30,31,56
Ballymena,4163,3,13,9,8,52,52,0,48
Ards,4163,4,13,5,12,43,43,0,44
Glenavon,4163,5,11,9,10,45,45,0,42
Cliftonville,4163,6,11,8,11,47,46,1,41
Coleraine,4163,7,9,12,9,44,47,-3,39
Glentoran,4163,8,9,9,12,40,48,-8,36
Dungannon,4163,9,9,7,14,42,42,0,34
Ballinamalla,4163,10,7,5,18,27,52,-25,26
Portadown,4163,11,6,6,18,21,50,-29,24
Ballymena,4164,1,16,5,9,64,60,4,53
Linfield,4164,2,13,13,4,61,35,26,52
Crusaders,4164,3,15,5,10,60,44,16,50
Cliftonville,4164,4,13,7,10,53,43,10,46
Glenavon,4164,5,12,10,8,43,40,3,46
Coleraine,4164,6,11,12,7,42,34,8,45
Dungannon,4164,7,12,6,12,50,45,5,42
Ards,4164,8,9,8,13,39,47,-8,35
Ballinamalla,4164,9,11,2,17,33,47,-14,35
Glentoran,4164,10,6,8,16,25,49,-24,26
Portadown,4164,11,6,6,18,22,48,-26,24
Crusaders,4165,1,16,7,7,57,33,24,55
Linfield,4165,2,14,11,5,55,29,26,53
Ballymena,4165,3,14,7,9,61,57,4,49
Glenavon,4165,4,12,12,6,55,47,8,48
Cliftonville,4165,5,14,4,12,54,47,7,46
Coleraine,4165,6,11,10,9,43,40,3,43
Glentoran,4165,7,11,8,11,34,41,-7,41
Dungannon,4165,8,8,14,8,49,43,6,38
Ballinamalla,4165,9,7,5,18,31,55,-24,26
Ards,4165,10,5,9,16,35,56,-21,24
Portadown,4165,11,4,11,15,22,48,-26,23
Linfield,4166,1,20,7,3,70,24,46,67
Cliftonville,4166,2,16,5,9,56,43,13,53
Ballymena,4166,3,16,5,9,55,52,3,53
Crusaders,4166,4,12,13,5,54,37,17,49
Coleraine,4166,5,10,9,11,36,41,-5,39
Dungannon,4166,6,10,8,12,54,53,1,38
Glenavon,4166,7,9,11,10,46,48,-2,38
Ballinamalla,4166,8,9,8,13,35,48,-13,35
Ards,4166,9,8,7,15,36,53,-17,31
Glentoran,4166,10,7,7,16,34,54,-20,28
Portadown,4166,11,6,4,20,28,51,-23,22
Crusaders,4167,1,16,6,8,50,31,19,54
Linfield,4167,2,12,13,5,59,31,28,49
Glenavon,4167,3,13,9,8,46,42,4,48
Coleraine,4167,4,12,11,7,49,36,13,47
Ballymena,4167,5,13,8,9,52,51,1,47
Cliftonville,4167,6,12,10,8,49,44,5,46
Dungannon,4167,7,11,10,9,56,42,14,43
Ards,4167,8,9,6,15,38,53,-15,33
Glentoran,4167,9,8,7,15,31,44,-13,31
Portadown,4167,10,8,5,17,33,60,-27,29
Ballinamalla,4167,11,7,3,20,31,60,-29,24
Crusaders,4168,1,17,9,4,55,26,29,60
Cliftonville,4168,2,18,3,9,62,37,25,57
Coleraine,4168,3,16,7,7,47,40,7,55
Linfield,4168,4,11,10,9,54,37,17,43
Ballymena,4168,5,11,9,10,51,56,-5,42
Glenavon,4168,6,9,14,7,45,40,5,41
Dungannon,4168,7,8,9,13,38,38,0,33
Glentoran,4168,8,8,8,14,29,43,-14,32
Ballinamalla,4168,9,9,5,16,29,52,-23,32
Ards,4168,10,8,5,17,39,56,-17,29
Portadown,4168,11,8,5,17,21,45,-24,29
Crusaders,4169,1,15,9,6,59,37,22,54
Cliftonville,4169,2,16,5,9,55,42,13,53
Ballymena,4169,3,14,9,7,68,51,17,51
Linfield,4169,4,12,10,8,57,40,17,46
Coleraine,4169,5,11,10,9,42,38,4,43
Dungannon,4169,6,11,8,11,52,49,3,41
Glenavon,4169,7,9,10,11,51,57,-6,37
Glentoran,4169,8,8,10,12,29,39,-10,34
Ballinamalla,4169,9,10,4,16,38,53,-15,34
Ards,4169,10,9,5,16,31,50,-19,32
Portadown,4169,11,8,4,18,26,52,-26,28
Crusaders,4170,1,17,7,6,52,31,21,58
Linfield,4170,2,15,9,6,57,29,28,54
Coleraine,4170,3,13,8,9,41,35,6,47
Cliftonville,4170,4,14,4,12,50,41,9,46
Glenavon,4170,5,11,12,7,50,47,3,45
Ballymena,4170,6,12,8,10,56,55,1,44
Glentoran,4170,7,10,8,12,32,43,-11,38
Ards,4170,8,10,3,17,44,55,-11,33
Ballinamalla,4170,9,9,6,15,29,49,-20,33
Dungannon,4170,10,6,11,13,46,49,-3,29
Portadown,4170,11,6,8,16,22,45,-23,26
Crusaders,4171,1,18,6,6,59,37,22,60
Coleraine,4171,2,17,8,5,52,28,24,59
Linfield,4171,3,16,9,5,56,26,30,57
Glenavon,4171,4,12,11,7,50,43,7,47
Cliftonville,4171,5,14,4,12,49,45,4,46
Ballymena,4171,6,12,6,12,55,58,-3,42
Dungannon,4171,7,11,7,12,47,44,3,40
Glentoran,4171,8,8,10,12,37,49,-12,34
Ards,4171,9,7,5,18,34,56,-22,26
Ballinamalla,4171,10,7,4,19,25,50,-25,25
Portadown,4171,11,5,6,19,26,54,-28,21
Linfield,4172,1,16,9,5,63,30,33,57
Crusaders,4172,2,16,8,6,52,37,15,56
Cliftonville,4172,3,15,4,11,57,43,14,49
Coleraine,4172,4,11,12,7,39,35,4,45
Glenavon,4172,5,10,12,8,50,49,1,42
Ballymena,4172,6,12,6,12,56,66,-10,42
Glentoran,4172,7,10,8,12,45,54,-9,38
Dungannon,4172,8,9,10,11,45,43,2,37
Ards,4172,9,9,6,15,44,46,-2,33
Portadown,4172,10,7,7,16,27,44,-17,28
Ballinamalla,4172,11,6,6,18,28,59,-31,24
Crusaders,4173,1,17,7,6,53,37,16,58
Linfield,4173,2,14,9,7,53,26,27,51
Cliftonville,4173,3,14,8,8,62,43,19,50
Coleraine,4173,4,13,11,6,48,40,8,50
Ballymena,4173,5,15,5,10,60,58,2,50
Glenavon,4173,6,10,11,9,48,47,1,41
Dungannon,4173,7,10,9,11,49,45,4,39
Glentoran,4173,8,9,10,11,38,42,-4,37
Ballinamalla,4173,9,10,3,17,32,48,-16,33
Portadown,4173,10,6,5,19,22,54,-32,23
Ards,4173,11,5,6,19,31,56,-25,21
Crusaders,4174,1,17,10,3,64,35,29,61
Cliftonville,4174,2,14,9,7,56,44,12,51
Linfield,4174,3,14,8,8,58,36,22,50
Glenavon,4174,4,12,11,7,46,39,7,47
Ballymena,4174,5,12,6,12,54,59,-5,42
Coleraine,4174,6,10,10,10,38,40,-2,40
Portadown,4174,7,10,7,13,31,41,-10,37
Dungannon,4174,8,9,9,12,51,45,6,36
Glentoran,4174,9,10,4,16,35,52,-17,34
Ards,4174,10,9,4,17,40,53,-13,31
Ballinamalla,4174,11,6,6,18,34,63,-29,24
Ballymena,4175,1,15,7,8,63,56,7,52
Cliftonville,4175,2,15,6,9,47,35,12,51
Linfield,4175,3,12,12,6,63,32,31,48
Glenavon,4175,4,11,13,6,45,42,3,46
Crusaders,4175,5,13,6,11,49,40,9,45
Coleraine,4175,6,10,12,8,42,41,1,42
Ballinamalla,4175,7,12,4,14,39,48,-9,40
Dungannon,4175,8,8,11,11,50,47,3,35
Glentoran,4175,9,8,7,15,27,55,-28,31
Ards,4175,10,7,9,14,43,54,-11,30
Portadown,4175,11,7,7,16,30,48,-18,28
Cliftonville,4176,1,17,4,9,56,37,19,55
Crusaders,4176,2,16,6,8,50,38,12,54
Dungannon,4176,3,13,11,6,55,36,19,50
Ballymena,4176,4,12,11,7,58,59,-1,47
Linfield,4176,5,11,12,7,62,35,27,45
Coleraine,4176,6,9,14,7,39,34,5,41
Glenavon,4176,7,8,15,7,43,44,-1,39
Ards,4176,8,11,5,14,40,46,-6,38
Glentoran,4176,9,8,9,13,28,41,-13,33
Portadown,4176,10,6,5,19,21,52,-31,23
Ballinamalla,4176,11,6,4,20,27,57,-30,22
Linfield,4177,1,16,10,4,70,29,41,58
Crusaders,4177,2,18,4,8,57,40,17,58
Ballymena,4177,3,16,4,10,65,57,8,52
Glenavon,4177,4,13,9,8,47,43,4,48
Cliftonville,4177,5,12,6,12,46,41,5,42
Coleraine,4177,6,10,10,10,35,40,-5,40
Ards,4177,7,11,5,14,38,42,-4,38
Portadown,4177,8,10,3,17,28,45,-17,33
Glentoran,4177,9,8,7,15,28,47,-19,31
Ballinamalla,4177,10,9,4,17,26,50,-24,31
Dungannon,4177,11,7,8,15,45,51,-6,29
Crusaders,4178,1,19,6,5,60,37,23,63
Linfield,4178,2,17,9,4,65,29,36,60
Cliftonville,4178,3,16,6,8,57,38,19,54
Coleraine,4178,4,11,11,8,34,31,3,44
Dungannon,4178,5,11,8,11,54,47,7,41
Glenavon,4178,6,10,9,11,45,46,-1,39
Glentoran,4178,7,10,8,12,32,43,-11,38
Ballymena,4178,8,10,7,13,49,58,-9,37
Ards,4178,9,8,5,17,33,51,-18,29
Ballinamalla,4178,10,6,8,16,34,57,-23,26
Portadown,4178,11,6,5,19,25,51,-26,23
Crusaders,4179,1,15,10,5,52,37,15,55
Cliftonville,4179,2,16,4,10,51,35,16,52
Linfield,4179,3,14,9,7,56,26,30,51
Glenavon,4179,4,13,8,9,53,49,4,47
Ballymena,4179,5,13,7,10,57,59,-2,46
Coleraine,4179,6,11,10,9,40,38,2,43
Ards,4179,7,12,4,14,43,48,-5,40
Dungannon,4179,8,7,11,12,40,42,-2,32
Ballinamalla,4179,9,9,4,17,32,53,-21,31
Glentoran,4179,10,7,8,15,24,42,-18,29
Portadown,4179,11,8,5,17,23,42,-19,29
Linfield,4180,1,16,8,6,59,27,32,56
Crusaders,4180,2,16,6,8,54,39,15,54
Cliftonville,4180,3,16,5,9,48,32,16,53
Glenavon,4180,4,13,10,7,56,46,10,49
Ballymena,4180,5,13,6,11,54,56,-2,45
Dungannon,4180,6,12,8,10,53,40,13,44
Coleraine,4180,7,11,9,10,41,39,2,42
Glentoran,4180,8,9,12,9,30,35,-5,39
Ards,4180,9,7,7,16,34,56,-22,28
Ballinamalla,4180,10,6,7,17,29,55,-26,25
Portadown,4180,11,5,4,21,20,53,-33,19
Glenavon,4181,1,15,10,5,58,37,21,55
Linfield,4181,2,15,9,6,58,30,28,54
Cliftonville,4181,3,15,6,9,49,39,10,51
Crusaders,4181,4,14,8,8,53,41,12,50
Ballymena,4181,5,13,7,10,51,50,1,46
Dungannon,4181,6,11,10,9,52,43,9,43
Coleraine,4181,7,10,10,10,38,39,-1,40
Glentoran,4181,8,8,8,14,30,45,-15,32
Portadown,4181,9,8,6,16,24,45,-21,30
Ballinamalla,4181,10,6,8,16,30,52,-22,26
Ards,4181,11,7,4,19,33,55,-22,25
Crusaders,4182,1,19,6,5,59,28,31,63
Ballymena,4182,2,16,6,8,64,56,8,54
Linfield,4182,3,14,9,7,61,35,26,51
Cliftonville,4182,4,13,6,11,49,45,4,45
Coleraine,4182,5,12,9,9,43,39,4,45
Glenavon,4182,6,10,12,8,52,51,1,42
Dungannon,4182,7,10,10,10,51,46,5,40
Glentoran,4182,8,11,7,12,36,46,-10,40
Ards,4182,9,8,4,18,38,54,-16,28
Ballinamalla,4182,10,7,6,17,30,50,-20,27
Portadown,4182,11,5,5,20,23,56,-33,20
Cliftonville,4183,1,17,5,8,65,40,25,56
Crusaders,4183,2,15,8,7,63,39,24,53
Glenavon,4183,3,13,11,6,50,40,10,50
Coleraine,4183,4,13,9,8,47,42,5,48
Linfield,4183,5,11,11,8,55,41,14,44
Ballymena,4183,6,9,11,10,52,62,-10,38
Dungannon,4183,7,8,11,11,41,43,-2,35
Glentoran,4183,8,8,11,11,35,51,-16,35
Ballinamalla,4183,9,9,6,15,35,48,-13,33
Portadown,4183,10,9,6,15,28,43,-15,33
Ards,4183,11,6,5,19,34,56,-22,23
Crusaders,4184,1,18,8,4,61,29,32,62
Cliftonville,4184,2,17,7,6,57,38,19,58
Linfield,4184,3,13,14,3,58,30,28,53
Ballymena,4184,4,13,6,11,56,54,2,45
Coleraine,4184,5,11,10,9,45,44,1,43
Glenavon,4184,6,10,11,9,43,49,-6,41
Dungannon,4184,7,9,10,11,55,49,6,37
Portadown,4184,8,7,8,15,29,43,-14,29
Ards,4184,9,7,7,16,30,49,-19,28
Glentoran,4184,10,7,6,17,27,51,-24,27
Ballinamalla,4184,11,6,7,17,29,54,-25,25
Crusaders,4185,1,17,5,8,54,34,20,56
Linfield,4185,2,14,11,5,59,28,31,53
Cliftonville,4185,3,14,6,10,50,37,13,48
Coleraine,4185,4,13,8,9,53,41,12,47
Ballymena,4185,5,14,5,11,49,50,-1,47
Glenavon,4185,6,12,10,8,48,49,-1,46
Dungannon,4185,7,9,11,10,51,46,5,38
Ballinamalla,4185,8,11,3,16,31,48,-17,36
Glentoran,4185,9,9,5,16,28,46,-18,32
Portadown,4185,10,7,7,16,29,51,-22,28
Ards,4185,11,8,3,19,37,59,-22,27
Crusaders,4186,1,19,6,5,57,34,23,63
Ballymena,4186,2,17,4,9,55,51,4,55
Linfield,4186,3,14,9,7,54,26,28,51
Cliftonville,4186,4,13,5,12,47,46,1,44
Dungannon,4186,5,11,10,9,58,44,14,43
Glenavon,4186,6,11,9,10,45,43,2,42
Coleraine,4186,7,8,13,9,41,41,0,37
Glentoran,4186,8,9,8,13,28,41,-13,35
Ards,4186,9,9,6,15,36,48,-12,33
Portadown,4186,10,7,7,16,24,48,-24,28
Ballinamalla,4186,11,6,5,19,29,52,-23,23
Ballymena,4187,1,17,5,8,65,52,13,56
Crusaders,4187,2,16,5,9,49,31,18,53
Cliftonville,4187,3,16,5,9,50,40,10,53
Dungannon,4187,4,15,7,8,56,37,19,52
Coleraine,4187,5,13,10,7,44,34,10,49
Linfield,4187,6,13,7,10,54,32,22,46
Ballinamalla,4187,7,12,5,13,38,48,-10,41
Glenavon,4187,8,8,11,11,47,55,-8,35
Glentoran,4187,9,8,5,17,24,45,-21,29
Ards,4187,10,6,5,19,30,53,-23,23
Portadown,4187,11,6,5,19,24,54,-30,23
Crusaders,4188,1,15,10,5,59,38,21,55
Linfield,4188,2,15,8,7,60,35,25,53
Cliftonville,4188,3,15,5,10,52,42,10,50
Glenavon,4188,4,11,12,7,49,47,2,45
Coleraine,4188,5,10,14,6,45,41,4,44
Ballymena,4188,6,10,10,10,47,56,-9,40
Glentoran,4188,7,10,8,12,36,41,-5,38
Ballinamalla,4188,8,12,2,16,35,50,-15,38
Dungannon,4188,9,8,10,12,49,43,6,34
Portadown,4188,10,8,5,17,24,45,-21,29
Ards,4188,11,7,4,19,36,54,-18,25
Crusaders,4189,1,17,9,4,55,32,23,60
Linfield,4189,2,14,10,6,63,31,32,52
Cliftonville,4189,3,16,4,10,50,40,10,52
Ballinamalla,4189,4,14,3,13,48,46,2,45
Coleraine,4189,5,11,12,7,45,44,1,45
Ballymena,4189,6,13,6,11,57,59,-2,45
Dungannon,4189,7,9,12,9,44,39,5,39
Glenavon,4189,8,8,11,11,42,49,-7,35
Glentoran,4189,9,8,7,15,30,43,-13,31
Ards,4189,10,6,8,16,34,57,-23,26
Portadown,4189,11,5,6,19,20,48,-28,21
Linfield,4190,1,16,8,6,62,31,31,56
Crusaders,4190,2,16,8,6,54,34,20,56
Cliftonville,4190,3,15,6,9,54,43,11,51
Ballymena,4190,4,13,5,12,55,61,-6,44
Coleraine,4190,5,11,10,9,43,39,4,43
Glentoran,4190,6,11,8,11,42,47,-5,41
Glenavon,4190,7,9,13,8,45,49,-4,40
Dungannon,4190,8,9,10,11,50,48,2,37
Ballinamalla,4190,9,10,3,17,33,50,-17,33
Ards,4190,10,9,5,16,39,50,-11,32
Portadown,4190,11,4,8,18,21,46,-25,20
Crusaders,4191,1,17,7,6,51,27,24,58
Cliftonville,4191,2,16,3,11,49,38,11,51
Ballymena,4191,3,14,7,9,60,58,2,49
Linfield,4191,4,12,10,8,51,34,17,46
Glenavon,4191,5,11,9,10,47,45,2,42
Coleraine,4191,6,10,11,9,41,37,4,41
Dungannon,4191,7,10,9,11,50,45,5,39
Glentoran,4191,8,10,9,11,31,38,-7,39
Ards,4191,9,10,5,15,38,51,-13,35
Portadown,4191,10,8,5,17,29,47,-18,29
Ballinamalla,4191,11,8,3,19,29,56,-27,27
Linfield,4192,1,16,8,6,55,27,28,56
Cliftonville,4192,2,16,5,9,52,35,17,53
Crusaders,4192,3,14,10,6,55,33,22,52
Coleraine,4192,4,10,11,9,44,39,5,41
Ballymena,4192,5,11,7,12,50,56,-6,40
Dungannon,4192,6,10,9,11,50,48,2,39
Glenavon,4192,7,9,11,10,45,46,-1,38
Ballinamalla,4192,8,10,5,15,32,47,-15,35
Glentoran,4192,9,8,11,11,30,47,-17,35
Ards,4192,10,8,7,15,37,54,-17,31
Portadown,4192,11,9,4,17,22,40,-18,31
Crusaders,4193,1,16,8,6,52,22,30,56
Linfield,4193,2,16,8,6,60,31,29,56
Ballymena,4193,3,14,7,9,60,60,0,49
Glenavon,4193,4,12,10,8,51,46,5,46
Cliftonville,4193,5,13,5,12,51,43,8,44
Dungannon,4193,6,10,11,9,50,44,6,41
Coleraine,4193,7,10,9,11,43,44,-1,39
Ards,4193,8,11,4,15,39,46,-7,37
Ballinamalla,4193,9,8,5,17,28,48,-20,29
Glentoran,4193,10,7,8,15,23,49,-26,29
Portadown,4193,11,7,7,16,22,46,-24,28
Crusaders,4194,1,23,4,3,67,37,30,73
Coleraine,4194,2,14,10,6,49,37,12,52
Cliftonville,4194,3,13,6,11,50,40,10,45
Linfield,4194,4,11,11,8,51,35,16,44
Ballymena,4194,5,12,8,10,53,57,-4,44
Ards,4194,6,13,4,13,44,41,3,43
Dungannon,4194,7,9,9,12,43,45,-2,36
Glenavon,4194,8,8,11,11,49,51,-2,35
Glentoran,4194,9,10,4,16,39,55,-16,34
Portadown,4194,10,7,5,18,22,43,-21,26
Ballinamalla,4194,11,8,2,20,28,54,-26,26
Crusaders,4195,1,15,9,6,53,41,12,54
Ballymena,4195,2,15,7,8,75,64,11,52
Linfield,4195,3,13,9,8,49,34,15,48
Cliftonville,4195,4,13,6,11,56,49,7,45
Dungannon,4195,5,12,7,11,56,46,10,43
Glenavon,4195,6,10,10,10,45,47,-2,40
Glentoran,4195,7,10,9,11,37,41,-4,39
Portadown,4195,8,11,4,15,33,46,-13,37
Coleraine,4195,9,8,11,11,38,39,-1,35
Ballinamalla,4195,10,10,4,16,32,48,-16,34
Ards,4195,11,7,6,17,33,52,-19,27
Cliftonville,4196,1,18,5,7,57,35,22,59
Glenavon,4196,2,15,9,6,49,38,11,54
Linfield,4196,3,15,8,7,62,32,30,53
Crusaders,4196,4,15,8,7,52,37,15,53
Coleraine,4196,5,12,10,8,51,42,9,46
Dungannon,4196,6,11,11,8,52,38,14,44
Ballymena,4196,7,12,7,11,52,59,-7,43
Ards,4196,8,8,6,16,36,48,-12,30
Ballinamalla,4196,9,9,3,18,33,56,-23,30
Glentoran,4196,10,5,7,18,23,49,-26,22
Portadown,4196,11,5,6,19,22,55,-33,21
Crusaders,4197,1,18,9,3,54,21,33,63
Linfield,4197,2,16,7,7,58,30,28,55
Glenavon,4197,3,15,10,5,54,36,18,55
Cliftonville,4197,4,16,6,8,50,33,17,54
Ballymena,4197,5,16,6,8,61,50,11,54
Dungannon,4197,6,9,9,12,45,46,-1,36
Coleraine,4197,7,9,9,12,35,45,-10,36
Glentoran,4197,8,9,7,14,26,40,-14,34
Ards,4197,9,7,5,18,31,54,-23,26
Portadown,4197,10,6,4,20,24,52,-28,22
Ballinamalla,4197,11,6,4,20,22,53,-31,22
Crusaders,4198,1,16,9,5,57,38,19,57
Glenavon,4198,2,14,8,8,57,47,10,50
Ballymena,4198,3,14,6,10,60,63,-3,48
Coleraine,4198,4,12,10,8,49,44,5,46
Linfield,4198,5,12,9,9,49,34,15,45
Cliftonville,4198,6,13,6,11,51,38,13,45
Dungannon,4198,7,10,10,10,52,48,4,40
Glentoran,4198,8,9,7,14,31,43,-12,34
Ards,4198,9,9,5,16,40,53,-13,32
Ballinamalla,4198,10,9,3,18,31,51,-20,30
Portadown,4198,11,6,9,15,19,37,-18,27
Linfield,4199,1,17,8,5,62,33,29,59
Crusaders,4199,2,16,8,6,52,33,19,56
Cliftonville,4199,3,14,7,9,53,40,13,49
Glenavon,4199,4,12,11,7,51,44,7,47
Coleraine,4199,5,11,11,8,35,32,3,44
Ballymena,4199,6,11,9,10,54,58,-4,42
Dungannon,4199,7,11,7,12,46,40,6,40
Ards,4199,8,10,6,14,40,45,-5,36
Portadown,4199,9,9,4,17,32,48,-16,31
Glentoran,4199,10,7,6,17,25,48,-23,27
Ballinamalla,4199,11,5,7,18,22,51,-29,22
Crusaders,4200,1,16,10,4,60,35,25,58
Cliftonville,4200,2,15,6,9,54,37,17,51
Linfield,4200,3,12,12,6,55,34,21,48
Glenavon,4200,4,12,11,7,54,45,9,47
Ballymena,4200,5,13,7,10,57,66,-9,46
Dungannon,4200,6,11,10,9,56,43,13,43
Coleraine,4200,7,10,11,9,36,34,2,41
Ards,4200,8,10,4,16,40,51,-11,34
Ballinamalla,4200,9,8,5,17,32,57,-25,29
Glentoran,4200,10,7,7,16,27,45,-18,28
Portadown,4200,11,6,7,17,25,49,-24,25
Cliftonville,4201,1,19,5,6,66,36,30,62
Linfield,4201,2,15,11,4,61,32,29,56
Crusaders,4201,3,15,6,9,51,40,11,51
Glenavon,4201,4,12,9,9,47,45,2,45
Coleraine,4201,5,11,10,9,42,36,6,43
Ballymena,4201,6,11,8,11,55,60,-5,41
Portadown,4201,7,10,5,15,28,48,-20,35
Glentoran,4201,8,8,8,14,33,49,-16,32
Dungannon,4201,9,7,10,13,47,51,-4,31
Ards,4201,10,7,8,15,41,54,-13,29
Ballinamalla,4201,11,8,4,18,29,49,-20,28
Linfield,4202,1,15,9,6,65,39,26,54
Glenavon,4202,2,15,9,6,49,34,15,54
Crusaders,4202,3,15,8,7,55,37,18,53
Cliftonville,4202,4,14,6,10,49,41,8,48
Coleraine,4202,5,11,12,7,38,32,6,45
Ballymena,4202,6,13,6,11,55,64,-9,45
Dungannon,4202,7,8,10,12,48,47,1,34
Ballinamalla,4202,8,8,8,14,32,50,-18,32
Ards,4202,9,8,7,15,43,53,-10,31
Glentoran,4202,10,8,4,18,30,48,-18,28
Portadown,4202,11,7,7,16,31,50,-19,28
Linfield,4203,1,15,9,6,52,27,25,54
Ballymena,4203,2,16,6,8,66,56,10,54
Crusaders,4203,3,15,5,10,52,41,11,50
Glenavon,4203,4,13,9,8,48,39,9,48
Cliftonville,4203,5,13,6,11,51,44,7,45
Glentoran,4203,6,11,7,12,33,42,-9,40
Dungannon,4203,7,10,8,12,49,43,6,38
Coleraine,4203,8,8,14,8,35,41,-6,38
Ards,4203,9,8,7,15,35,48,-13,31
Ballinamalla,4203,10,9,4,17,31,50,-19,31
Portadown,4203,11,7,5,18,29,50,-21,26
Crusaders,4204,1,16,7,7,63,38,25,55
Ballymena,4204,2,17,4,9,56,57,-1,55
Linfield,4204,3,15,9,6,64,33,31,54
Dungannon,4204,4,13,8,9,62,45,17,47
Glenavon,4204,5,11,10,9,54,48,6,43
Coleraine,4204,6,10,12,8,44,43,1,42
Cliftonville,4204,7,12,6,12,50,52,-2,42
Ballinamalla,4204,8,10,4,16,40,55,-15,34
Ards,4204,9,9,4,17,40,55,-15,31
Glentoran,4204,10,8,7,15,28,46,-18,31
Portadown,4204,11,6,5,19,26,55,-29,23
Crusaders,4205,1,16,9,5,54,31,23,57
Linfield,4205,2,13,11,6,56,34,22,50
Glenavon,4205,3,12,12,6,51,38,13,48
Cliftonville,4205,4,14,6,10,51,42,9,48
Coleraine,4205,5,11,13,6,42,33,9,46
Ballymena,4205,6,12,9,9,49,51,-2,45
Dungannon,4205,7,10,10,10,55,48,7,40
Portadown,4205,8,9,5,16,27,43,-16,32
Ards,4205,9,7,6,17,37,53,-16,27
Ballinamalla,4205,10,7,6,17,35,58,-23,27
Glentoran,4205,11,6,9,15,26,52,-26,27
Crusaders,4206,1,17,7,6,54,35,19,58
Ballymena,4206,2,15,4,11,65,61,4,49
Linfield,4206,3,11,11,8,53,36,17,44
Glenavon,4206,4,11,11,8,42,40,2,44
Cliftonville,4206,5,12,7,11,49,46,3,43
Coleraine,4206,6,10,12,8,43,40,3,42
Glentoran,4206,7,10,11,9,37,41,-4,41
Dungannon,4206,8,9,10,11,48,43,5,37
Ards,4206,9,9,8,13,36,44,-8,35
Portadown,4206,10,8,6,16,29,50,-21,30
Ballinamalla,4206,11,8,3,19,29,49,-20,27
Crusaders,4207,1,17,6,7,54,31,23,57
Linfield,4207,2,14,10,6,57,32,25,52
Cliftonville,4207,3,15,4,11,55,37,18,49
Glenavon,4207,4,12,12,6,40,39,1,48
Ballymena,4207,5,14,5,11,57,54,3,47
Coleraine,4207,6,10,12,8,34,33,1,42
Glentoran,4207,7,12,6,12,41,49,-8,42
Dungannon,4207,8,10,10,10,55,42,13,40
Ards,4207,9,10,5,15,36,49,-13,35
Portadown,4207,10,6,8,16,26,50,-24,26
Ballinamalla,4207,11,4,4,22,23,62,-39,16
Linfield,4208,1,16,8,6,65,31,34,56
Cliftonville,4208,2,15,6,9,55,38,17,51
Crusaders,4208,3,14,8,8,53,38,15,50
Coleraine,4208,4,13,11,6,47,34,13,50
Ballymena,4208,5,14,6,10,57,60,-3,48
Glentoran,4208,6,12,6,12,34,42,-8,42
Glenavon,4208,7,10,11,9,44,48,-4,41
Dungannon,4208,8,7,11,12,44,49,-5,32
Portadown,4208,9,9,5,16,21,42,-21,32
Ards,4208,10,8,6,16,36,51,-15,30
Ballinamalla,4208,11,6,4,20,29,52,-23,22
Cliftonville,4209,1,20,3,7,63,39,24,63
Linfield,4209,2,14,11,5,60,28,32,53
Crusaders,4209,3,15,8,7,57,37,20,53
Ballymena,4209,4,15,5,10,58,60,-2,50
Dungannon,4209,5,11,10,9,51,42,9,43
Glenavon,4209,6,9,12,9,42,44,-2,39
Coleraine,4209,7,8,12,10,40,43,-3,36
Glentoran,4209,8,9,7,14,32,49,-17,34
Ards,4209,9,9,3,18,35,54,-19,30
Ballinamalla,4209,10,7,6,17,31,51,-20,27
Portadown,4209,11,6,7,17,25,47,-22,25
Crusaders,4210,1,16,11,3,58,33,25,59
Ballymena,4210,2,14,9,7,60,50,10,51
Linfield,4210,3,13,8,9,56,38,18,47
Glenavon,4210,4,12,10,8,50,39,11,46
Cliftonville,4210,5,13,7,10,51,45,6,46
Coleraine,4210,6,9,14,7,39,37,2,41
Glentoran,4210,7,11,8,11,34,37,-3,41
Dungannon,4210,8,7,10,13,42,51,-9,31
Ards,4210,9,8,7,15,29,45,-16,31
Portadown,4210,10,9,4,17,32,49,-17,31
Ballinamalla,4210,11,6,6,18,24,51,-27,24
Crusaders,4211,1,18,9,3,59,29,30,63
Ballymena,4211,2,17,6,7,61,50,11,57
Linfield,4211,3,14,11,5,54,24,30,53
Glenavon,4211,4,12,9,9,50,46,4,45
Cliftonville,4211,5,13,5,12,50,45,5,44
Coleraine,4211,6,10,12,8,36,32,4,42
Dungannon,4211,7,9,10,11,47,43,4,37
Ballinamalla,4211,8,9,5,16,27,47,-20,32
Portadown,4211,9,7,9,14,26,46,-20,30
Glentoran,4211,10,6,7,17,29,47,-18,25
Ards,4211,11,6,5,19,29,59,-30,23
Coleraine,4212,1,14,11,5,48,34,14,53
Linfield,4212,2,14,10,6,62,35,27,52
Crusaders,4212,3,14,10,6,60,34,26,52
Glenavon,4212,4,12,13,5,49,42,7,49
Dungannon,4212,5,12,8,10,56,44,12,44
Cliftonville,4212,6,12,7,11,45,40,5,43
Ballymena,4212,7,10,7,13,49,65,-16,37
Ards,4212,8,9,7,14,38,51,-13,34
Glentoran,4212,9,8,9,13,31,46,-15,33
Portadown,4212,10,7,5,18,26,50,-24,26
Ballinamalla,4212,11,6,7,17,29,52,-23,25
Cliftonville,4213,1,17,5,8,53,35,18,56
Linfield,4213,2,14,11,5,55,27,28,53
Crusaders,4213,3,13,8,9,46,35,11,47
Coleraine,4213,4,13,8,9,46,37,9,47
Ballymena,4213,5,13,8,9,55,52,3,47
Glenavon,4213,6,11,9,10,41,43,-2,42
Dungannon,4213,7,10,7,13,49,56,-7,37
Portadown,4213,8,8,9,13,30,43,-13,33
Ards,4213,9,9,4,17,36,51,-15,31
Glentoran,4213,10,8,7,15,30,50,-20,31
Ballinamalla,4213,11,8,6,16,32,44,-12,30
Crusaders,4214,1,17,5,8,58,35,23,56
Linfield,4214,2,14,8,8,62,40,22,50
Ballymena,4214,3,13,8,9,60,58,2,47
Cliftonville,4214,4,14,4,12,53,45,8,46
Coleraine,4214,5,11,10,9,41,43,-2,43
Dungannon,4214,6,11,9,10,53,46,7,42
Glentoran,4214,7,12,6,12,39,45,-6,42
Ards,4214,8,11,6,13,45,48,-3,39
Glenavon,4214,9,9,11,10,48,46,2,38
Portadown,4214,10,7,6,17,26,50,-24,27
Ballinamalla,4214,11,8,3,19,28,57,-29,27
Crusaders,4215,1,16,7,7,54,37,17,55
Cliftonville,4215,2,16,6,8,56,34,22,54
Linfield,4215,3,15,7,8,60,39,21,52
Ballymena,4215,4,15,5,10,56,54,2,50
Coleraine,4215,5,13,9,8,45,37,8,48
Glenavon,4215,6,11,11,8,52,43,9,44
Dungannon,4215,7,8,10,12,47,47,0,34
Ards,4215,8,9,6,15,35,44,-9,33
Ballinamalla,4215,9,10,3,17,31,53,-22,33
Glentoran,4215,10,8,7,15,23,40,-17,31
Portadown,4215,11,6,5,19,21,52,-31,23
Crusaders,4216,1,15,9,6,58,33,25,54
Linfield,4216,2,15,8,7,56,30,26,53
Cliftonville,4216,3,13,7,10,55,45,10,46
Dungannon,4216,4,12,9,9,53,43,10,45
Glenavon,4216,5,11,12,7,47,43,4,45
Ballinamalla,4216,6,13,4,13,42,48,-6,43
Coleraine,4216,7,9,9,12,38,42,-4,36
Glentoran,4216,8,9,8,13,34,44,-10,35
Portadown,4216,9,11,2,17,32,44,-12,35
Ballymena,4216,10,9,7,14,46,68,-22,34
Ards,4216,11,9,3,18,37,58,-21,30
Linfield,4217,1,15,9,6,59,29,30,54
Cliftonville,4217,2,16,5,9,55,40,15,53
Crusaders,4217,3,15,6,9,55,40,15,51
Glenavon,4217,4,13,11,6,55,45,10,50
Ballymena,4217,5,12,8,10,61,63,-2,44
Coleraine,4217,6,10,12,8,45,45,0,42
Dungannon,4217,7,10,10,10,54,42,12,40
Glentoran,4217,8,10,5,15,34,48,-14,35
Ards,4217,9,8,6,16,37,53,-16,30
Ballinamalla,4217,10,7,8,15,33,52,-19,29
Portadown,4217,11,7,4,19,23,54,-31,25
Linfield,4218,1,16,9,5,58,26,32,57
Ballymena,4218,2,15,5,10,61,65,-4,50
Dungannon,4218,3,12,9,9,53,42,11,45
Crusaders,4218,4,11,11,8,50,41,9,44
Glenavon,4218,5,10,14,6,46,42,4,44
Coleraine,4218,6,12,8,10,39,38,1,44
Cliftonville,4218,7,13,4,13,48,41,7,43
Portadown,4218,8,11,4,15,32,37,-5,37
Glentoran,4218,9,10,7,13,35,46,-11,37
Ards,4218,10,9,6,15,35,50,-15,33
Ballinamalla,4218,11,4,7,19,25,54,-29,19
Ballymena,4219,1,17,5,8,58,52,6,56
Cliftonville,4219,2,16,5,9,51,39,12,53
Crusaders,4219,3,15,5,10,57,44,13,50
Linfield,4219,4,11,13,6,51,31,20,46
Coleraine,4219,5,12,9,9,44,38,6,45
Glenavon,4219,6,10,10,10,44,42,2,40
Portadown,4219,7,11,5,14,28,37,-9,38
Ards,4219,8,9,8,13,44,50,-6,35
Dungannon,4219,9,9,7,14,50,49,1,34
Glentoran,4219,10,8,7,15,28,52,-24,31
Ballinamalla,4219,11,7,6,17,26,47,-21,27
Crusaders,4220,1,19,8,3,68,29,39,65
Linfield,4220,2,16,9,5,60,28,32,57
Cliftonville,4220,3,15,4,11,51,39,12,49
Coleraine,4220,4,13,9,8,48,45,3,48
Dungannon,4220,5,12,8,10,59,52,7,44
Ballymena,4220,6,12,8,10,57,60,-3,44
Glenavon,4220,7,9,12,9,44,47,-3,39
Ards,4220,8,9,3,18,35,51,-16,30
Ballinamalla,4220,9,9,2,19,30,54,-24,29
Portadown,4220,10,7,6,17,24,47,-23,27
Glentoran,4220,11,5,9,16,24,48,-24,24
Linfield,4221,1,16,7,7,56,28,28,55
Crusaders,4221,2,16,6,8,56,39,17,54
Cliftonville,4221,3,16,5,9,54,34,20,53
Glenavon,4221,4,13,10,7,58,46,12,49
Ballymena,4221,5,14,6,10,56,54,2,48
Coleraine,4221,6,12,9,9,46,43,3,45
Dungannon,4221,7,10,6,14,50,53,-3,36
Ards,4221,8,9,5,16,39,52,-13,32
Ballinamalla,4221,9,8,6,16,30,49,-19,30
Glentoran,4221,10,7,8,15,25,46,-21,29
Portadown,4221,11,8,4,18,27,53,-26,28
Linfield,4222,1,17,8,5,65,29,36,59
Crusaders,4222,2,14,10,6,53,33,20,52
Cliftonville,4222,3,15,6,9,55,41,14,51
Ballymena,4222,4,14,6,10,70,65,5,48
Coleraine,4222,5,11,11,8,43,41,2,44
Dungannon,4222,6,11,8,11,51,43,8,41
Glenavon,4222,7,8,12,10,41,47,-6,36
Ballinamalla,4222,8,11,1,18,34,51,-17,34
Glentoran,4222,9,8,8,14,27,43,-16,32
Ards,4222,10,9,4,17,38,60,-22,31
Portadown,4222,11,7,6,17,30,54,-24,27
Linfield,4223,1,17,9,4,59,25,34,60
Crusaders,4223,2,17,7,6,55,34,21,58
Glenavon,4223,3,13,11,6,53,38,15,50
Cliftonville,4223,4,15,4,11,51,41,10,49
Coleraine,4223,5,10,11,9,42,38,4,41
Dungannon,4223,6,11,8,11,46,43,3,41
Ballymena,4223,7,11,8,11,51,59,-8,41
Glentoran,4223,8,9,6,15,26,43,-17,33
Ballinamalla,4223,9,8,5,17,32,53,-21,29
Ards,4223,10,7,6,17,36,56,-20,27
Portadown,4223,11,6,7,17,18,39,-21,25
Crusaders,4224,1,20,6,4,57,27,30,66
Linfield,4224,2,14,9,7,52,31,21,51
Cliftonville,4224,3,15,5,10,61,41,20,50
Dungannon,4224,4,14,7,9,57,42,15,49
Glenavon,4224,5,14,7,9,58,47,11,49
Coleraine,4224,6,12,9,9,48,43,5,45
Ballymena,4224,7,13,6,11,60,64,-4,45
Ballinamalla,4224,8,10,3,17,34,57,-23,33
Ards,4224,9,8,4,18,44,54,-10,28
Glentoran,4224,10,7,7,16,24,48,-24,28
Portadown,4224,11,5,3,22,18,59,-41,18
Linfield,4225,1,16,9,5,57,26,31,57
Crusaders,4225,2,15,8,7,50,35,15,53
Cliftonville,4225,3,15,4,11,51,38,13,49
Ballymena,4225,4,15,4,11,65,67,-2,49
Glenavon,4225,5,11,11,8,47,42,5,44
Coleraine,4225,6,11,10,9,45,43,2,43
Dungannon,4225,7,10,8,12,45,42,3,38
Ards,4225,8,10,4,16,41,50,-9,34
Glentoran,4225,9,9,6,15,32,52,-20,33
Ballinamalla,4225,10,8,5,17,33,51,-18,29
Portadown,4225,11,8,5,17,27,47,-20,29
Coleraine,4226,1,14,12,4,40,28,12,54
Linfield,4226,2,14,11,5,61,32,29,53
Crusaders,4226,3,15,7,8,49,29,20,52
Cliftonville,4226,4,14,7,9,52,43,9,49
Ballymena,4226,5,14,6,10,61,62,-1,48
Glenavon,4226,6,11,11,8,49,42,7,44
Dungannon,4226,7,11,9,10,52,41,11,42
Glentoran,4226,8,8,7,15,34,51,-17,31
Portadown,4226,9,5,11,14,28,50,-22,26
Ballinamalla,4226,10,6,7,17,33,60,-27,25
Ards,4226,11,6,6,18,35,56,-21,24
Cliftonville,4227,1,17,5,8,59,40,19,56
Ballymena,4227,2,17,4,9,68,60,8,55
Linfield,4227,3,15,8,7,59,35,24,53
Crusaders,4227,4,15,8,7,55,34,21,53
Coleraine,4227,5,11,10,9,41,40,1,43
Glenavon,4227,6,9,11,10,42,48,-6,38
Glentoran,4227,7,11,5,14,30,41,-11,38
Dungannon,4227,8,8,10,12,44,43,1,34
Portadown,4227,9,8,6,16,27,46,-19,30
Ards,4227,10,8,5,17,38,54,-16,29
Ballinamalla,4227,11,8,4,18,36,58,-22,28
Linfield,4228,1,17,8,5,56,26,30,59
Crusaders,4228,2,15,10,5,49,27,22,55
Coleraine,4228,3,14,11,5,46,34,12,53
Cliftonville,4228,4,13,4,13,49,41,8,43
Ballymena,4228,5,11,10,9,56,55,1,43
Dungannon,4228,6,8,10,12,46,47,-1,34
Glenavon,4228,7,8,10,12,44,53,-9,34
Portadown,4228,8,10,4,16,28,45,-17,34
Glentoran,4228,9,8,9,13,31,43,-12,33
Ballinamalla,4228,10,9,6,15,34,51,-17,33
Ards,4228,11,8,6,16,32,49,-17,30
Crusaders,4229,1,17,7,6,55,39,16,58
Ballymena,4229,2,15,7,8,56,50,6,52
Linfield,4229,3,13,11,6,53,29,24,50
Coleraine,4229,4,13,10,7,43,34,9,49
Glenavon,4229,5,11,11,8,44,38,6,44
Cliftonville,4229,6,12,6,12,41,40,1,42
Dungannon,4229,7,10,10,10,53,42,11,40
Glentoran,4229,8,10,5,15,35,49,-14,35
Ards,4229,9,8,6,16,35,51,-16,30
Portadown,4229,10,7,6,17,29,50,-21,27
Ballinamalla,4229,11,7,5,18,29,51,-22,26
Crusaders,4230,1,16,7,7,55,36,19,55
Linfield,4230,2,15,9,6,62,36,26,54
Cliftonville,4230,3,15,6,9,52,40,12,51
Ballymena,4230,4,15,6,9,66,64,2,51
Glenavon,4230,5,13,10,7,50,43,7,49
Coleraine,4230,6,11,9,10,40,43,-3,42
Dungannon,4230,7,8,10,12,47,45,2,34
Ards,4230,8,10,3,17,43,49,-6,33
Portadown,4230,9,7,8,15,27,43,-16,29
Glentoran,4230,10,7,8,15,35,59,-24,29
Ballinamalla,4230,11,8,4,18,32,51,-19,28
Crusaders,4231,1,19,7,4,56,30,26,64
Linfield,4231,2,16,8,6,67,35,32,56
Ballymena,4231,3,12,10,8,51,55,-4,46
Glenavon,4231,4,11,11,8,51,50,1,44
Dungannon,4231,5,11,10,9,52,41,11,43
Cliftonville,4231,6,11,7,12,44,40,4,40
Coleraine,4231,7,8,12,10,38,46,-8,36
Ballinamalla,4231,8,10,5,15,44,56,-12,35
Ards,4231,9,8,6,16,37,53,-16,30
Portadown,4231,10,7,7,16,22,40,-18,28
Glentoran,4231,11,6,9,15,26,42,-16,27
Crusaders,4232,1,17,9,4,68,37,31,60
Linfield,4232,2,12,11,7,59,35,24,47
Coleraine,4232,3,11,13,6,45,35,10,46
Dungannon,4232,4,12,9,9,56,42,14,45
Ballymena,4232,5,12,9,9,59,60,-1,45
Cliftonville,4232,6,12,8,10,51,45,6,44
Glentoran,4232,7,10,8,12,36,48,-12,38
Glenavon,4232,8,9,10,11,48,57,-9,37
Ards,4232,9,10,7,13,38,47,-9,37
Portadown,4232,10,6,6,18,28,51,-23,24
Ballinamalla,4232,11,6,6,18,31,62,-31,24
Cliftonville,4233,1,18,4,8,57,32,25,58
Crusaders,4233,2,16,7,7,60,31,29,55
Linfield,4233,3,14,10,6,57,35,22,52
Ballymena,4233,4,14,6,10,57,55,2,48
Glenavon,4233,5,11,11,8,44,42,2,44
Coleraine,4233,6,9,13,8,41,41,0,40
Dungannon,4233,7,9,9,12,42,51,-9,36
Ards,4233,8,9,6,15,37,49,-12,33
Glentoran,4233,9,9,6,15,28,43,-15,33
Ballinamalla,4233,10,8,3,19,28,50,-22,27
Portadown,4233,11,6,9,15,27,49,-22,27
Crusaders,4234,1,19,6,5,54,29,25,63
Cliftonville,4234,2,17,4,9,56,39,17,55
Linfield,4234,3,15,8,7,63,36,27,53
Ballymena,4234,4,14,7,9,63,58,5,49
Dungannon,4234,5,13,8,9,50,42,8,47
Coleraine,4234,6,11,12,7,46,39,7,45
Glenavon,4234,7,9,9,12,46,52,-6,36
Ards,4234,8,9,5,16,36,49,-13,32
Glentoran,4234,9,8,7,15,29,49,-20,31
Ballinamalla,4234,10,9,3,18,37,50,-13,30
Portadown,4234,11,4,5,21,22,59,-37,17
Crusaders,4235,1,18,9,3,63,33,30,63
Linfield,4235,2,16,9,5,58,27,31,57
Ballymena,4235,3,16,8,6,64,49,15,56
Cliftonville,4235,4,14,5,11,53,48,5,47
Glenavon,4235,5,11,10,9,46,47,-1,43
Dungannon,4235,6,9,10,11,49,44,5,37
Coleraine,4235,7,8,11,11,36,42,-6,35
Ards,4235,8,9,7,14,45,48,-3,34
Portadown,4235,9,7,6,17,29,52,-23,27
Ballinamalla,4235,10,7,5,18,29,55,-26,26
Glentoran,4235,11,6,8,16,31,58,-27,26
Crusaders,4236,1,17,11,2,62,29,33,62
Linfield,4236,2,15,11,4,60,31,29,56
Glenavon,4236,3,13,10,7,51,43,8,49
Cliftonville,4236,4,13,6,11,49,45,4,45
Coleraine,4236,5,10,13,7,34,31,3,43
Ballymena,4236,6,11,9,10,53,52,1,42
Dungannon,4236,7,8,14,8,46,41,5,38
Glentoran,4236,8,8,8,14,23,43,-20,32
Ballinamalla,4236,9,6,8,16,28,53,-25,26
Ards,4236,10,6,7,17,40,56,-16,25
Portadown,4236,11,5,9,16,27,49,-22,24
Crusaders,4237,1,17,8,5,60,29,31,59
Cliftonville,4237,2,16,5,9,52,38,14,53
Linfield,4237,3,14,8,8,55,36,19,50
Dungannon,4237,4,14,8,8,61,45,16,50
Coleraine,4237,5,12,10,8,43,35,8,46
Ballymena,4237,6,14,4,12,57,60,-3,46
Glenavon,4237,7,11,10,9,49,45,4,43
Ards,4237,8,9,3,18,32,56,-24,30
Glentoran,4237,9,7,7,16,30,49,-19,28
Portadown,4237,10,8,4,18,34,55,-21,28
Ballinamalla,4237,11,7,5,18,25,50,-25,26
Crusaders,4238,1,19,5,6,58,29,29,62
Linfield,4238,2,17,9,4,61,25,36,60
Cliftonville,4238,3,15,6,9,50,37,13,51
Glenavon,4238,4,12,10,8,55,42,13,46
Ballymena,4238,5,12,7,11,50,54,-4,43
Ards,4238,6,11,5,14,38,46,-8,38
Portadown,4238,7,11,4,15,33,42,-9,37
Coleraine,4238,8,8,11,11,34,46,-12,35
Dungannon,4238,9,7,11,12,49,55,-6,32
Glentoran,4238,10,8,8,14,31,50,-19,32
Ballinamalla,4238,11,6,2,22,23,56,-33,20
Crusaders,4239,1,15,10,5,55,31,24,55
Glenavon,4239,2,13,14,3,45,34,11,53
Linfield,4239,3,14,9,7,52,27,25,51
Coleraine,4239,4,11,11,8,47,37,10,44
Cliftonville,4239,5,13,5,12,53,44,9,44
Dungannon,4239,6,10,10,10,51,48,3,40
Ballymena,4239,7,11,6,13,47,60,-13,39
Ards,4239,8,9,7,14,37,49,-12,34
Ballinamalla,4239,9,8,6,16,32,51,-19,30
Glentoran,4239,10,6,11,13,21,38,-17,29
Portadown,4239,11,7,7,16,23,44,-21,28
Cliftonville,4240,1,17,5,8,58,41,17,56
Crusaders,4240,2,14,10,6,53,38,15,52
Ballymena,4240,3,13,10,7,58,55,3,49
Linfield,4240,4,12,9,9,57,45,12,45
Dungannon,4240,5,12,9,9,50,38,12,45
Coleraine,4240,6,11,12,7,47,38,9,45
Glenavon,4240,7,11,9,10,50,46,4,42
Ards,4240,8,8,7,15,36,51,-15,31
Glentoran,4240,9,6,11,13,28,46,-18,29
Ballinamalla,4240,10,7,7,16,28,46,-18,28
Portadown,4240,11,7,5,18,18,39,-21,26
Crusaders,4241,1,19,8,3,64,35,29,65
Linfield,4241,2,12,12,6,59,38,21,48
Ballymena,4241,3,13,9,8,55,53,2,48
Cliftonville,4241,4,14,4,12,50,44,6,46
Dungannon,4241,5,10,9,11,44,39,5,39
Glenavon,4241,6,9,12,9,51,47,4,39
Coleraine,4241,7,8,12,10,45,51,-6,36
Glentoran,4241,8,9,9,12,35,47,-12,36
Ards,4241,9,8,8,14,34,48,-14,32
Portadown,4241,10,7,8,15,29,47,-18,29
Ballinamalla,4241,11,7,7,16,33,50,-17,28
Crusaders,4242,1,17,6,7,64,40,24,57
Coleraine,4242,2,12,13,5,43,33,10,49
Linfield,4242,3,11,10,9,56,43,13,43
Cliftonville,4242,4,11,10,9,48,40,8,43
Ballymena,4242,5,11,10,9,56,55,1,43
Glenavon,4242,6,11,10,9,42,44,-2,43
Portadown,4242,7,12,4,14,35,46,-11,40
Glentoran,4242,8,10,8,12,36,41,-5,38
Dungannon,4242,9,8,11,11,49,50,-1,35
Ards,4242,10,9,4,17,34,47,-13,31
Ballinamalla,4242,11,8,4,18,32,56,-24,28
Coleraine,4243,1,16,9,5,50,30,20,57
Cliftonville,4243,2,16,6,8,55,37,18,54
Crusaders,4243,3,14,7,9,54,37,17,49
Linfield,4243,4,12,10,8,52,33,19,46
Ballymena,4243,5,14,4,12,54,63,-9,46
Dungannon,4243,6,12,8,10,55,42,13,44
Glenavon,4243,7,11,11,8,45,43,2,44
Ards,4243,8,13,4,13,41,40,1,43
Glentoran,4243,9,7,9,14,33,52,-19,30
Portadown,4243,10,6,6,18,24,53,-29,24
Ballinamalla,4243,11,5,4,21,25,58,-33,19
Linfield,4244,1,14,10,6,55,32,23,52
Crusaders,4244,2,15,7,8,52,36,16,52
Coleraine,4244,3,13,11,6,54,37,17,50
Cliftonville,4244,4,14,7,9,50,38,12,49
Ballymena,4244,5,14,4,12,56,57,-1,46
Dungannon,4244,6,12,8,10,51,44,7,44
Glentoran,4244,7,12,5,13,36,41,-5,41
Glenavon,4244,8,8,13,9,45,46,-1,37
Ards,4244,9,9,8,13,44,49,-5,35
Ballinamalla,4244,10,7,4,19,27,58,-31,25
Portadown,4244,11,5,7,18,23,55,-32,22
Crusaders,4245,1,18,8,4,55,28,27,62
Linfield,4245,2,14,11,5,67,39,28,53
Ballymena,4245,3,16,5,9,60,54,6,53
Cliftonville,4245,4,16,4,10,56,37,19,52
Glenavon,4245,5,13,10,7,52,41,11,49
Coleraine,4245,6,13,9,8,42,35,7,48
Dungannon,4245,7,9,10,11,49,47,2,37
Glentoran,4245,8,7,8,15,35,52,-17,29
Ards,4245,9,7,5,18,34,55,-21,26
Ballinamalla,4245,10,7,4,19,28,61,-33,25
Portadown,4245,11,7,2,21,22,51,-29,23
Cliftonville,4246,1,17,3,10,56,39,17,54
Crusaders,4246,2,16,4,10,53,39,14,52
Coleraine,4246,3,13,10,7,42,32,10,49
Linfield,4246,4,13,8,9,52,34,18,47
Glenavon,4246,5,13,8,9,50,41,9,47
Ballymena,4246,6,14,5,11,51,58,-7,47
Dungannon,4246,7,10,9,11,58,49,9,39
Portadown,4246,8,10,4,16,27,43,-16,34
Ballinamalla,4246,9,10,3,17,34,51,-17,33
Ards,4246,10,8,6,16,31,45,-14,30
Glentoran,4246,11,8,6,16,28,51,-23,30
Cliftonville,4247,1,17,5,8,57,32,25,56
Crusaders,4247,2,16,7,7,56,47,9,55
Linfield,4247,3,15,9,6,57,27,30,54
Ballymena,4247,4,14,7,9,52,51,1,49
Coleraine,4247,5,11,11,8,42,37,5,44
Dungannon,4247,6,10,10,10,54,44,10,40
Portadown,4247,7,11,6,13,36,46,-10,39
Glenavon,4247,8,10,8,12,46,49,-3,38
Ards,4247,9,9,4,17,39,56,-17,31
Ballinamalla,4247,10,8,5,17,28,53,-25,29
Glentoran,4247,11,5,6,19,26,51,-25,21
Crusaders,4248,1,18,8,4,55,31,24,62
Cliftonville,4248,2,18,4,8,60,42,18,58
Ballymena,4248,3,16,5,9,64,53,11,53
Linfield,4248,4,14,7,9,58,36,22,49
Glenavon,4248,5,10,13,7,47,43,4,43
Coleraine,4248,6,10,12,8,43,37,6,42
Dungannon,4248,7,9,10,11,48,50,-2,37
Glentoran,4248,8,9,8,13,29,41,-12,35
Ards,4248,9,8,6,16,33,50,-17,30
Ballinamalla,4248,10,7,4,19,35,57,-22,25
Portadown,4248,11,6,3,21,24,56,-32,21
Crusaders,4249,1,15,10,5,60,35,25,55
Cliftonville,4249,2,17,4,9,52,35,17,55
Ballymena,4249,3,15,7,8,61,51,10,52
Glenavon,4249,4,12,12,6,51,44,7,48
Dungannon,4249,5,12,8,10,49,44,5,44
Linfield,4249,6,11,10,9,49,34,15,43
Coleraine,4249,7,10,11,9,35,39,-4,41
Ards,4249,8,10,5,15,48,52,-4,35
Ballinamalla,4249,9,6,9,15,32,51,-19,27
Portadown,4249,10,7,6,17,26,48,-22,27
Glentoran,4249,11,5,8,17,25,55,-30,23
Crusaders,4250,1,16,8,6,68,45,23,56
Linfield,4250,2,14,9,7,64,37,27,51
Ballymena,4250,3,13,9,8,58,61,-3,48
Cliftonville,4250,4,14,5,11,52,42,10,47
Coleraine,4250,5,11,10,9,37,39,-2,43
Dungannon,4250,6,11,9,10,54,47,7,42
Ballinamalla,4250,7,11,5,14,41,52,-11,38
Glenavon,4250,8,9,9,12,44,49,-5,36
Glentoran,4250,9,10,5,15,35,51,-16,35
Portadown,4250,10,9,4,17,35,49,-14,31
Ards,4250,11,8,5,17,34,50,-16,29
Crusaders,4251,1,16,8,6,62,39,23,56
Ballymena,4251,2,15,8,7,63,55,8,53
Cliftonville,4251,3,14,7,9,51,41,10,49
Coleraine,4251,4,11,14,5,43,36,7,47
Linfield,4251,5,12,10,8,61,41,20,46
Glenavon,4251,6,10,15,5,49,45,4,45
Glentoran,4251,7,11,9,10,33,33,0,42
Dungannon,4251,8,9,9,12,57,52,5,36
Ards,4251,9,8,7,15,38,50,-12,31
Ballinamalla,4251,10,5,7,18,29,58,-29,22
Portadown,4251,11,3,8,19,19,55,-36,17
Crusaders,4252,1,16,10,4,61,31,30,58
Linfield,4252,2,15,10,5,61,37,24,55
Ballymena,4252,3,16,7,7,65,61,4,55
Glenavon,4252,4,13,11,6,50,37,13,50
Coleraine,4252,5,10,11,9,43,41,2,41
Cliftonville,4252,6,11,6,13,50,47,3,39
Dungannon,4252,7,8,11,11,46,45,1,35
Glentoran,4252,8,9,6,15,31,48,-17,33
Ballinamalla,4252,9,8,7,15,26,45,-19,31
Ards,4252,10,7,7,16,40,57,-17,28
Portadown,4252,11,6,6,18,23,47,-24,24
Ballymena,4253,1,17,7,6,66,53,13,58
Cliftonville,4253,2,17,4,9,58,37,21,55
Linfield,4253,3,16,6,8,62,35,27,54
Crusaders,4253,4,16,5,9,55,41,14,53
Coleraine,4253,5,13,10,7,45,44,1,49
Dungannon,4253,6,10,10,10,54,48,6,40
Glenavon,4253,7,9,9,12,41,49,-8,36
Ards,4253,8,9,6,15,42,49,-7,33
Glentoran,4253,9,9,6,15,32,47,-15,33
Portadown,4253,10,7,4,19,30,51,-21,25
Ballinamalla,4253,11,7,3,20,26,57,-31,24
Crusaders,4254,1,16,10,4,58,32,26,58
Linfield,4254,2,15,9,6,58,34,24,54
Cliftonville,4254,3,16,5,9,56,38,18,53
Glenavon,4254,4,13,10,7,49,42,7,49
Coleraine,4254,5,13,10,7,42,35,7,49
Ballymena,4254,6,12,7,11,55,54,1,43
Glentoran,4254,7,9,7,14,33,49,-16,34
Dungannon,4254,8,7,12,11,42,39,3,33
Ballinamalla,4254,9,9,5,16,32,48,-16,32
Ards,4254,10,7,4,19,34,59,-25,25
Portadown,4254,11,5,7,18,28,57,-29,22
Crusaders,4255,1,17,6,7,53,35,18,57
Ballymena,4255,2,17,5,8,59,52,7,56
Cliftonville,4255,3,17,3,10,55,38,17,54
Linfield,4255,4,13,11,6,44,23,21,50
Glenavon,4255,5,12,11,7,43,38,5,47
Coleraine,4255,6,10,9,11,46,41,5,39
Dungannon,4255,7,9,9,12,45,43,2,36
Ards,4255,8,10,5,15,41,49,-8,35
Glentoran,4255,9,9,7,14,29,45,-16,34
Ballinamalla,4255,10,9,4,17,28,49,-21,31
Portadown,4255,11,6,2,22,21,51,-30,20
Cliftonville,4256,1,17,6,7,63,37,26,57
Linfield,4256,2,16,8,6,68,33,35,56
Crusaders,4256,3,14,9,7,43,36,7,51
Glenavon,4256,4,12,10,8,47,41,6,46
Coleraine,4256,5,12,8,10,43,38,5,44
Ballymena,4256,6,12,7,11,53,61,-8,43
Glentoran,4256,7,11,8,11,35,39,-4,41
Dungannon,4256,8,10,10,10,52,44,8,40
Ballinamalla,4256,9,8,4,18,30,53,-23,28
Portadown,4256,10,8,3,19,31,50,-19,27
Ards,4256,11,4,9,17,28,61,-33,21
Cliftonville,4257,1,16,8,6,63,37,26,56
Linfield,4257,2,15,10,5,63,35,28,55
Crusaders,4257,3,15,10,5,57,37,20,55
Ballymena,4257,4,14,8,8,55,56,-1,50
Glenavon,4257,5,9,13,8,50,49,1,40
Coleraine,4257,6,10,10,10,48,47,1,40
Dungannon,4257,7,9,12,9,50,46,4,39
Glentoran,4257,8,10,6,14,33,45,-12,36
Ards,4257,9,8,5,17,37,49,-12,29
Portadown,4257,10,6,8,16,26,51,-25,26
Ballinamalla,4257,11,6,4,20,27,57,-30,22
Crusaders,4258,1,16,7,7,58,33,25,55
Cliftonville,4258,2,16,4,10,57,42,15,52
Linfield,4258,3,13,8,9,65,43,22,47
Ballymena,4258,4,14,5,11,60,60,0,47
Dungannon,4258,5,12,9,9,59,47,12,45
Glenavon,4258,6,11,11,8,48,48,0,44
Ards,4258,7,11,7,12,38,44,-6,40
Coleraine,4258,8,8,13,9,43,45,-2,37
Glentoran,4258,9,10,7,13,33,45,-12,37
Ballinamalla,4258,10,8,3,19,34,64,-30,27
Portadown,4258,11,5,8,17,26,50,-24,23
Crusaders,4259,1,14,11,5,56,41,15,53
Linfield,4259,2,13,11,6,61,37,24,50
Ballymena,4259,3,14,7,9,64,52,12,49
Coleraine,4259,4,13,8,9,45,44,1,47
Cliftonville,4259,5,13,6,11,52,47,5,45
Dungannon,4259,6,11,8,11,48,39,9,41
Ards,4259,7,13,2,15,49,54,-5,41
Glenavon,4259,8,8,14,8,43,43,0,38
Glentoran,4259,9,7,8,15,30,53,-23,29
Ballinamalla,4259,10,7,7,16,32,50,-18,28
Portadown,4259,11,6,10,14,29,49,-20,28
Crusaders,4260,1,18,7,5,58,31,27,61
Linfield,4260,2,14,11,5,60,33,27,53
Ballymena,4260,3,14,8,8,64,62,2,50
Coleraine,4260,4,10,13,7,45,38,7,43
Glenavon,4260,5,10,12,8,46,45,1,42
Dungannon,4260,6,9,10,11,48,42,6,37
Cliftonville,4260,7,9,9,12,42,41,1,36
Ards,4260,8,10,6,14,43,49,-6,36
Glentoran,4260,9,8,9,13,30,45,-15,33
Portadown,4260,10,7,7,16,24,44,-20,28
Ballinamalla,4260,11,8,4,18,28,58,-30,28
Linfield,4261,1,16,9,5,59,33,26,57
Glenavon,4261,2,16,8,6,57,41,16,56
Cliftonville,4261,3,17,2,11,53,41,12,53
Crusaders,4261,4,15,6,9,54,40,14,51
Ballymena,4261,5,15,6,9,60,56,4,51
Dungannon,4261,6,11,9,10,48,39,9,42
Coleraine,4261,7,11,8,11,43,39,4,41
Ards,4261,8,11,4,15,45,49,-4,37
Glentoran,4261,9,9,6,15,29,45,-16,33
Portadown,4261,10,4,8,18,16,45,-29,20
Ballinamalla,4261,11,5,4,21,24,60,-36,19
Crusaders,4262,1,19,4,7,61,34,27,61
Cliftonville,4262,2,16,4,10,62,44,18,52
Linfield,4262,3,12,11,7,52,32,20,47
Coleraine,4262,4,12,10,8,41,36,5,46
Dungannon,4262,5,11,9,10,57,48,9,42
Ballymena,4262,6,12,6,12,50,61,-11,42
Glenavon,4262,7,9,11,10,46,49,-3,38
Ards,4262,8,10,5,15,43,52,-9,35
Ballinamalla,4262,9,9,7,14,31,50,-19,34
Glentoran,4262,10,7,9,14,30,47,-17,30
Portadown,4262,11,6,8,16,22,42,-20,26
Linfield,4263,1,16,9,5,71,38,33,57
Crusaders,4263,2,16,9,5,61,36,25,57
Cliftonville,4263,3,17,3,10,51,40,11,54
Coleraine,4263,4,11,12,7,39,32,7,45
Ballymena,4263,5,12,8,10,54,56,-2,44
Glenavon,4263,6,10,11,9,53,50,3,41
Glentoran,4263,7,10,8,12,32,41,-9,38
Dungannon,4263,8,8,10,12,47,50,-3,34
Portadown,4263,9,9,4,17,25,45,-20,31
Ballinamalla,4263,10,8,5,17,27,51,-24,29
Ards,4263,11,6,5,19,33,54,-21,23
Crusaders,4264,1,18,8,4,58,26,32,62
Cliftonville,4264,2,15,5,10,53,42,11,50
Ballymena,4264,3,15,5,10,59,56,3,50
Linfield,4264,4,13,10,7,56,35,21,49
Coleraine,4264,5,11,10,9,43,42,1,43
Glenavon,4264,6,10,13,7,44,45,-1,43
Dungannon,4264,7,9,9,12,46,47,-1,36
Ards,4264,8,8,10,12,35,41,-6,34
Ballinamalla,4264,9,8,7,15,29,46,-17,31
Glentoran,4264,10,6,8,16,28,51,-23,26
Portadown,4264,11,5,9,16,24,44,-20,24
Linfield,4265,1,15,10,5,59,31,28,55
Glenavon,4265,2,13,11,6,54,42,12,50
Ballymena,4265,3,14,6,10,57,58,-1,48
Cliftonville,4265,4,15,2,13,51,51,0,47
Dungannon,4265,5,12,10,8,53,39,14,46
Crusaders,4265,6,13,7,10,48,36,12,46
Ards,4265,7,12,5,13,39,41,-2,41
Coleraine,4265,8,10,9,11,41,49,-8,39
Ballinamalla,4265,9,10,3,17,37,50,-13,33
Glentoran,4265,10,7,6,17,24,47,-23,27
Portadown,4265,11,7,5,18,29,48,-19,26
Glenavon,4266,1,15,9,6,59,44,15,54
Ballymena,4266,2,16,6,8,56,50,6,54
Crusaders,4266,3,14,10,6,56,36,20,52
Cliftonville,4266,4,15,6,9,50,39,11,51
Coleraine,4266,5,11,10,9,40,39,1,43
Linfield,4266,6,11,9,10,53,39,14,42
Dungannon,4266,7,10,8,12,55,46,9,38
Glentoran,4266,8,9,7,14,25,48,-23,34
Ards,4266,9,9,5,16,33,44,-11,32
Portadown,4266,10,7,8,15,23,42,-19,29
Ballinamalla,4266,11,6,6,18,27,50,-23,24
Linfield,4267,1,16,7,7,62,31,31,55
Crusaders,4267,2,16,7,7,55,37,18,55
Cliftonville,4267,3,16,5,9,59,41,18,53
Coleraine,4267,4,12,11,7,46,34,12,47
Ballymena,4267,5,13,8,9,54,54,0,47
Dungannon,4267,6,12,9,9,54,44,10,45
Glenavon,4267,7,11,11,8,48,48,0,44
Glentoran,4267,8,9,6,15,31,52,-21,33
Ballinamalla,4267,9,8,5,17,32,47,-15,29
Ards,4267,10,8,4,18,39,56,-17,28
Portadown,4267,11,6,3,21,17,53,-36,21
Linfield,4268,1,18,7,5,67,30,37,61
Ballymena,4268,2,18,7,5,65,48,17,61
Crusaders,4268,3,18,6,6,56,29,27,60
Glenavon,4268,4,13,9,8,48,42,6,48
Coleraine,4268,5,12,8,10,42,47,-5,44
Cliftonville,4268,6,12,5,13,50,45,5,41
Dungannon,4268,7,8,11,11,50,49,1,35
Glentoran,4268,8,7,8,15,30,50,-20,29
Ards,4268,9,7,5,18,33,53,-20,26
Portadown,4268,10,7,5,18,23,45,-22,26
Ballinamalla,4268,11,6,7,17,33,59,-26,25
Crusaders,4269,1,17,9,4,62,34,28,60
Linfield,4269,2,14,10,6,52,24,28,52
Coleraine,4269,3,12,13,5,46,32,14,49
Ballymena,4269,4,14,4,12,52,59,-7,46
Glenavon,4269,5,11,12,7,52,44,8,45
Cliftonville,4269,6,13,6,11,47,42,5,45
Glentoran,4269,7,12,8,10,31,38,-7,44
Dungannon,4269,8,7,10,13,46,50,-4,31
Portadown,4269,9,8,6,16,24,47,-23,30
Ards,4269,10,7,8,15,40,53,-13,29
Ballinamalla,4269,11,5,4,21,31,60,-29,19
Crusaders,4270,1,16,7,7,57,38,19,55
Glenavon,4270,2,14,11,5,55,38,17,53
Cliftonville,4270,3,16,4,10,53,35,18,52
Linfield,4270,4,14,6,10,52,35,17,48
Dungannon,4270,5,12,8,10,54,45,9,44
Ballymena,4270,6,12,7,11,55,63,-8,43
Glentoran,4270,7,11,8,11,32,37,-5,41
Coleraine,4270,8,10,8,12,36,44,-8,38
Ballinamalla,4270,9,9,5,16,37,50,-13,32
Portadown,4270,10,7,5,18,21,43,-22,26
Ards,4270,11,7,5,18,31,55,-24,26
Crusaders,4271,1,19,6,5,60,32,28,63
Linfield,4271,2,17,8,5,66,35,31,59
Cliftonville,4271,3,15,6,9,51,37,14,51
Coleraine,4271,4,12,10,8,49,43,6,46
Ballymena,4271,5,13,6,11,55,68,-13,45
Glenavon,4271,6,11,8,11,43,46,-3,41
Dungannon,4271,7,9,9,12,48,43,5,36
Glentoran,4271,8,9,5,16,34,38,-4,32
Ards,4271,9,8,6,16,35,52,-17,30
Ballinamalla,4271,10,9,2,19,28,52,-24,29
Portadown,4271,11,7,6,17,23,46,-23,27
Linfield,4272,1,17,6,7,67,32,35,57
Crusaders,4272,2,15,9,6,49,37,12,54
Cliftonville,4272,3,16,4,10,54,38,16,52
Ballymena,4272,4,16,4,10,62,55,7,52
Glenavon,4272,5,14,8,8,52,40,12,50
Coleraine,4272,6,11,9,10,47,48,-1,42
Ards,4272,7,12,6,12,42,43,-1,42
Dungannon,4272,8,9,12,9,49,44,5,39
Ballinamalla,4272,9,7,4,19,28,53,-25,25
Portadown,4272,10,7,3,20,24,53,-29,24
Glentoran,4272,11,5,7,18,23,54,-31,22
Cliftonville,4273,1,17,6,7,52,33,19,57
Crusaders,4273,2,16,8,6,54,32,22,56
Linfield,4273,3,13,12,5,63,33,30,51
Glenavon,4273,4,11,11,8,46,43,3,44
Coleraine,4273,5,10,10,10,40,41,-1,40
Ballinamalla,4273,6,11,6,13,40,49,-9,39
Glentoran,4273,7,9,11,10,28,39,-11,38
Ballymena,4273,8,10,7,13,47,59,-12,37
Ards,4273,9,9,5,16,35,49,-14,32
Dungannon,4273,10,7,10,13,42,44,-2,31
Portadown,4273,11,4,10,16,21,46,-25,22
Crusaders,4274,1,17,9,4,63,33,30,60
Linfield,4274,2,15,8,7,63,33,30,53
Glenavon,4274,3,13,11,6,60,46,14,50
Cliftonville,4274,4,13,5,12,52,51,1,44
Dungannon,4274,5,11,8,11,54,46,8,41
Ballymena,4274,6,11,8,11,52,64,-12,41
Coleraine,4274,7,9,11,10,44,52,-8,38
Glentoran,4274,8,8,11,11,34,42,-8,35
Portadown,4274,9,9,6,15,32,48,-16,33
Ards,4274,10,9,5,16,38,50,-12,32
Ballinamalla,4274,11,6,6,18,23,50,-27,24
Crusaders,4275,1,19,5,6,61,32,29,62
Linfield,4275,2,16,8,6,69,34,35,56
Cliftonville,4275,3,15,3,12,59,46,13,48
Coleraine,4275,4,12,12,6,53,47,6,48
Glenavon,4275,5,12,10,8,53,50,3,46
Ballymena,4275,6,12,6,12,51,61,-10,42
Dungannon,4275,7,10,8,12,54,47,7,38
Ballinamalla,4275,8,9,5,16,32,52,-20,32
Glentoran,4275,9,8,6,16,31,51,-20,30
Portadown,4275,10,8,5,17,29,46,-17,29
Ards,4275,11,8,4,18,30,56,-26,28
Crusaders,4276,1,16,7,7,56,34,22,55
Linfield,4276,2,15,9,6,59,34,25,54
Cliftonville,4276,3,17,3,10,57,38,19,54
Coleraine,4276,4,13,10,7,45,36,9,49
Ballymena,4276,5,13,8,9,56,55,1,47
Glenavon,4276,6,10,11,9,40,39,1,41
Dungannon,4276,7,10,9,11,44,39,5,39
Glentoran,4276,8,11,5,14,31,45,-14,38
Ards,4276,9,8,4,18,34,51,-17,28
Ballinamalla,4276,10,8,4,18,25,47,-22,28
Portadown,4276,11,4,10,16,19,48,-29,22
Crusaders,4277,1,19,6,5,64,40,24,63
Ballymena,4277,2,15,6,9,54,53,1,51
Linfield,4277,3,14,8,8,57,29,28,50
Cliftonville,4277,4,14,5,11,51,41,10,47
Coleraine,4277,5,12,10,8,46,38,8,46
Dungannon,4277,6,10,9,11,53,44,9,39
Glenavon,4277,7,8,12,10,42,50,-8,36
Ballinamalla,4277,8,10,4,16,34,51,-17,34
Glentoran,4277,9,9,6,15,32,47,-15,33
Portadown,4277,10,8,7,15,33,51,-18,31
Ards,4277,11,8,3,19,35,57,-22,27
Crusaders,4278,1,17,5,8,58,36,22,56
Cliftonville,4278,2,14,8,8,54,40,14,50
Ballymena,4278,3,15,5,10,63,63,0,50
Coleraine,4278,4,13,9,8,49,39,10,48
Dungannon,4278,5,12,10,8,54,36,18,46
Linfield,4278,6,11,11,8,53,36,17,44
Glenavon,4278,7,9,11,10,45,47,-2,38
Glentoran,4278,8,8,9,13,26,44,-18,33
Portadown,4278,9,7,9,14,25,44,-19,30
Ards,4278,10,8,5,17,38,54,-16,29
Ballinamalla,4278,11,8,4,18,23,49,-26,28
Crusaders,4279,1,18,7,5,57,34,23,61
Ballymena,4279,2,16,5,9,57,49,8,53
Linfield,4279,3,15,6,9,53,30,23,51
Cliftonville,4279,4,14,7,9,47,34,13,49
Coleraine,4279,5,13,9,8,41,38,3,48
Dungannon,4279,6,13,8,9,59,43,16,47
Glenavon,4279,7,9,10,11,50,55,-5,37
Ards,4279,8,9,5,16,42,50,-8,32
Glentoran,4279,9,8,5,17,29,48,-19,29
Ballinamalla,4279,10,8,4,18,27,56,-29,28
Portadown,4279,11,6,6,18,22,47,-25,24
Crusaders,4280,1,17,7,6,53,33,20,58
Cliftonville,4280,2,16,4,10,48,38,10,52
Linfield,4280,3,14,8,8,58,35,23,50
Glenavon,4280,4,13,11,6,49,39,10,50
Ballymena,4280,5,15,5,10,56,59,-3,50
Coleraine,4280,6,9,14,7,47,41,6,41
Glentoran,4280,7,10,8,12,37,43,-6,38
Dungannon,4280,8,9,9,12,49,45,4,36
Ards,4280,9,7,8,15,30,43,-13,29
Portadown,4280,10,8,4,18,29,52,-23,28
Ballinamalla,4280,11,6,4,20,28,56,-28,22
Crusaders,4281,1,18,5,7,61,37,24,59
Glenavon,4281,2,15,11,4,59,46,13,56
Cliftonville,4281,3,16,5,9,59,39,20,53
Linfield,4281,4,13,11,6,54,29,25,50
Coleraine,4281,5,12,9,9,40,36,4,45
Ballymena,4281,6,12,9,9,59,59,0,45
Dungannon,4281,7,8,10,12,45,47,-2,34
Glentoran,4281,8,6,11,13,27,46,-19,29
Ards,4281,9,7,6,17,36,55,-19,27
Ballinamalla,4281,10,6,8,16,31,49,-18,26
Portadown,4281,11,6,7,17,21,49,-28,25
Crusaders,4282,1,18,6,6,57,31,26,60
Cliftonville,4282,2,14,7,9,50,42,8,49
Coleraine,4282,3,13,9,8,47,32,15,48
Linfield,4282,4,13,8,9,53,36,17,47
Glenavon,4282,5,11,10,9,53,52,1,43
Ballymena,4282,6,11,8,11,51,56,-5,41
Dungannon,4282,7,10,8,12,55,51,4,38
Ards,4282,8,11,3,16,40,57,-17,36
Portadown,4282,9,10,5,15,29,42,-13,35
Glentoran,4282,10,7,10,13,31,42,-11,31
Ballinamalla,4282,11,8,4,18,31,56,-25,28
Cliftonville,4283,1,20,3,7,61,36,25,63
Crusaders,4283,2,15,5,10,47,34,13,50
Ballymena,4283,3,14,6,10,54,57,-3,48
Linfield,4283,4,11,12,7,57,40,17,45
Dungannon,4283,5,10,12,8,52,39,13,42
Glenavon,4283,6,11,9,10,44,44,0,42
Ards,4283,7,12,4,14,41,46,-5,40
Coleraine,4283,8,10,8,12,40,44,-4,38
Glentoran,4283,9,10,4,16,35,49,-14,34
Ballinamalla,4283,10,9,4,17,32,53,-21,31
Portadown,4283,11,7,5,18,24,45,-21,26
Linfield,4284,1,16,8,6,59,34,25,56
Cliftonville,4284,2,16,4,10,55,37,18,52
Crusaders,4284,3,14,5,11,49,41,8,47
Glenavon,4284,4,11,11,8,48,44,4,44
Dungannon,4284,5,11,10,9,49,41,8,43
Coleraine,4284,6,9,13,8,39,36,3,40
Ballymena,4284,7,10,10,10,55,60,-5,40
Portadown,4284,8,11,5,14,35,47,-12,38
Glentoran,4284,9,9,9,12,30,39,-9,36
Ards,4284,10,9,5,16,37,50,-13,32
Ballinamalla,4284,11,8,2,20,27,54,-27,26
Linfield,4285,1,15,10,5,69,42,27,55
Crusaders,4285,2,16,6,8,53,33,20,54
Coleraine,4285,3,15,8,7,57,38,19,53
Ballymena,4285,4,15,7,8,57,54,3,52
Glenavon,4285,5,10,13,7,47,49,-2,43
Glentoran,4285,6,12,7,11,34,38,-4,43
Cliftonville,4285,7,13,2,15,47,48,-1,41
Dungannon,4285,8,7,11,12,53,55,-2,32
Ards,4285,9,8,5,17,41,55,-14,29
Ballinamalla,4285,10,8,4,18,35,60,-25,28
Portadown,4285,11,5,9,16,27,48,-21,24
Crusaders,4286,1,18,6,6,56,32,24,60
Linfield,4286,2,15,8,7,63,42,21,53
Glenavon,4286,3,10,15,5,45,36,9,45
Coleraine,4286,4,12,9,9,42,40,2,45
Ballymena,4286,5,12,8,10,63,65,-2,44
Cliftonville,4286,6,13,3,14,53,47,6,42
Dungannon,4286,7,10,9,11,50,46,4,39
Ards,4286,8,11,4,15,47,46,1,37
Glentoran,4286,9,9,9,12,32,45,-13,36
Ballinamalla,4286,10,7,6,17,29,54,-25,27
Portadown,4286,11,7,5,18,24,51,-27,26
Crusaders,4287,1,16,8,6,53,30,23,56
Linfield,4287,2,14,11,5,61,30,31,53
Cliftonville,4287,3,14,8,8,52,39,13,50
Ballymena,4287,4,14,7,9,60,58,2,49
Coleraine,4287,5,10,13,7,42,37,5,43
Dungannon,4287,6,11,9,10,55,45,10,42
Glentoran,4287,7,12,4,14,31,39,-8,40
Glenavon,4287,8,9,11,10,40,47,-7,38
Ards,4287,9,10,5,15,41,48,-7,35
Portadown,4287,10,8,3,19,28,58,-30,27
Ballinamalla,4287,11,5,5,20,25,57,-32,20
Crusaders,4288,1,17,7,6,55,38,17,58
Ballymena,4288,2,16,8,6,61,51,10,56
Linfield,4288,3,14,10,6,61,35,26,52
Coleraine,4288,4,14,8,8,52,39,13,50
Cliftonville,4288,5,13,6,11,52,43,9,45
Glenavon,4288,6,10,10,10,42,48,-6,40
Dungannon,4288,7,10,9,11,47,46,1,39
Ballinamalla,4288,8,10,4,16,33,48,-15,34
Glentoran,4288,9,6,10,14,26,48,-22,28
Portadown,4288,10,7,6,17,25,42,-17,27
Ards,4288,11,6,6,18,37,53,-16,24
Linfield,4289,1,15,9,6,63,35,28,54
Crusaders,4289,2,16,5,9,52,38,14,53
Glenavon,4289,3,14,9,7,57,43,14,51
Cliftonville,4289,4,15,4,11,61,45,16,49
Ballymena,4289,5,14,6,10,50,56,-6,48
Coleraine,4289,6,11,9,10,41,40,1,42
Dungannon,4289,7,9,10,11,47,45,2,37
Glentoran,4289,8,10,7,13,34,47,-13,37
Portadown,4289,9,9,4,17,28,42,-14,31
Ballinamalla,4289,10,9,4,17,29,52,-23,31
Ards,4289,11,7,5,18,31,50,-19,26
Crusaders,4290,1,17,8,5,54,29,25,59
Ballymena,4290,2,17,4,9,53,55,-2,55
Linfield,4290,3,15,8,7,64,38,26,53
Cliftonville,4290,4,16,3,11,53,39,14,51
Glenavon,4290,5,11,13,6,43,39,4,46
Glentoran,4290,6,12,6,12,28,35,-7,42
Dungannon,4290,7,10,11,9,49,39,10,41
Coleraine,4290,8,10,9,11,40,41,-1,39
Ards,4290,9,9,5,16,40,51,-11,32
Ballinamalla,4290,10,4,7,19,28,55,-27,19
Portadown,4290,11,4,6,20,16,47,-31,18
Cliftonville,4291,1,19,3,8,61,35,26,60
Ballymena,4291,2,16,4,10,54,51,3,52
Linfield,4291,3,14,8,8,53,33,20,50
Crusaders,4291,4,13,8,9,51,40,11,47
Coleraine,4291,5,12,10,8,41,39,2,46
Ballinamalla,4291,6,11,7,12,35,43,-8,40
Glenavon,4291,7,7,13,10,42,46,-4,34
Dungannon,4291,8,8,9,13,45,47,-2,33
Glentoran,4291,9,8,9,13,26,39,-13,33
Portadown,4291,10,9,5,16,27,48,-21,32
Ards,4291,11,7,6,17,35,49,-14,27
Crusaders,4292,1,16,8,6,51,31,20,56
Linfield,4292,2,15,9,6,61,27,34,54
Ballymena,4292,3,14,5,11,55,61,-6,47
Cliftonville,4292,4,13,6,11,44,37,7,45
Glenavon,4292,5,9,12,9,45,43,2,39
Portadown,4292,6,11,5,14,35,45,-10,38
Dungannon,4292,7,8,13,9,53,52,1,37
Coleraine,4292,8,8,12,10,36,40,-4,36
Ballinamalla,4292,9,10,4,16,33,52,-19,34
Ards,4292,10,9,6,15,40,49,-9,33
Glentoran,4292,11,8,8,14,28,44,-16,32
Crusaders,4293,1,16,9,5,55,37,18,57
Ballymena,4293,2,16,3,11,62,55,7,51
Coleraine,4293,3,12,12,6,45,33,12,48
Glenavon,4293,4,12,10,8,48,44,4,46
Linfield,4293,5,12,9,9,59,36,23,45
Cliftonville,4293,6,12,8,10,47,46,1,44
Dungannon,4293,7,11,10,9,48,39,9,43
Ards,4293,8,11,3,16,36,46,-10,36
Glentoran,4293,9,9,8,13,30,41,-11,35
Ballinamalla,4293,10,7,6,17,22,49,-27,27
Portadown,4293,11,4,8,18,16,42,-26,20
Crusaders,4294,1,17,6,7,59,37,22,57
Glenavon,4294,2,13,12,5,51,36,15,51
Cliftonville,4294,3,14,7,9,51,35,16,49
Linfield,4294,4,12,12,6,52,32,20,48
Ballymena,4294,5,14,6,10,54,53,1,48
Coleraine,4294,6,11,9,10,44,45,-1,42
Glentoran,4294,7,8,11,11,34,41,-7,35
Ards,4294,8,10,5,15,39,52,-13,35
Dungannon,4294,9,8,9,13,44,45,-1,33
Portadown,4294,10,7,6,17,23,52,-29,27
Ballinamalla,4294,11,7,5,18,29,52,-23,26
Linfield,4295,1,14,11,5,61,30,31,53
Crusaders,4295,2,14,11,5,47,34,13,53
Glenavon,4295,3,14,9,7,55,50,5,51
Cliftonville,4295,4,15,5,10,51,36,15,50
Ballymena,4295,5,15,4,11,60,62,-2,49
Coleraine,4295,6,9,13,8,43,40,3,40
Glentoran,4295,7,10,9,11,30,36,-6,39
Ballinamalla,4295,8,10,4,16,35,52,-17,34
Dungannon,4295,9,8,9,13,53,47,6,33
Portadown,4295,10,6,7,17,19,44,-25,25
Ards,4295,11,6,6,18,28,51,-23,24
Crusaders,4296,1,19,6,5,62,31,31,63
Linfield,4296,2,16,9,5,62,34,28,57
Coleraine,4296,3,13,10,7,53,41,12,49
Cliftonville,4296,4,14,7,9,52,40,12,49
Ballymena,4296,5,14,7,9,64,57,7,49
Glenavon,4296,6,10,12,8,44,42,2,42
Portadown,4296,7,10,6,14,32,42,-10,36
Dungannon,4296,8,8,7,15,45,53,-8,31
Glentoran,4296,9,7,7,16,27,50,-23,28
Ballinamalla,4296,10,8,3,19,24,57,-33,27
Ards,4296,11,6,6,18,31,49,-18,24
Crusaders,4297,1,15,10,5,50,34,16,55
Linfield,4297,2,14,11,5,61,30,31,53
Ballymena,4297,3,14,7,9,58,57,1,49
Coleraine,4297,4,12,10,8,52,44,8,46
Cliftonville,4297,5,13,6,11,51,49,2,45
Glentoran,4297,6,12,6,12,39,41,-2,42
Dungannon,4297,7,11,7,12,47,42,5,40
Ards,4297,8,10,6,14,43,52,-9,36
Glenavon,4297,9,7,10,13,41,51,-10,31
Portadown,4297,10,8,6,16,17,39,-22,30
Ballinamalla,4297,11,6,7,17,30,50,-20,25
Linfield,4298,1,20,7,3,69,27,42,67
Crusaders,4298,2,15,9,6,54,38,16,54
Cliftonville,4298,3,15,6,9,52,40,12,51
Coleraine,4298,4,12,12,6,46,36,10,48
Glenavon,4298,5,12,12,6,45,40,5,48
Dungannon,4298,6,10,10,10,51,42,9,40
Ballymena,4298,7,10,9,11,55,61,-6,39
Glentoran,4298,8,9,8,13,37,44,-7,35
Ards,4298,9,7,5,18,31,52,-21,26
Ballinamalla,4298,10,7,4,19,28,52,-24,25
Portadown,4298,11,4,6,20,18,54,-36,18
Crusaders,4299,1,16,9,5,54,29,25,57
Linfield,4299,2,14,8,8,58,33,25,50
Ballymena,4299,3,14,8,8,57,54,3,50
Cliftonville,4299,4,12,9,9,46,39,7,45
Coleraine,4299,5,11,12,7,41,37,4,45
Dungannon,4299,6,10,11,9,48,40,8,41
Glentoran,4299,7,9,8,13,33,42,-9,35
Glenavon,4299,8,8,10,12,40,48,-8,34
Ards,4299,9,9,6,15,35,46,-11,33
Portadown,4299,10,9,6,15,30,44,-14,33
Ballinamalla,4299,11,8,3,19,22,52,-30,27
Crusaders,4300,1,18,7,5,62,34,28,61
Linfield,4300,2,13,12,5,53,26,27,51
Ballymena,4300,3,13,9,8,54,50,4,48
Cliftonville,4300,4,12,7,11,46,41,5,43
Coleraine,4300,5,10,13,7,43,41,2,43
Glenavon,4300,6,9,15,6,46,44,2,42
Dungannon,4300,7,8,11,11,47,47,0,35
Glentoran,4300,8,9,6,15,30,45,-15,33
Ards,4300,9,8,8,14,36,47,-11,32
Ballinamalla,4300,10,9,4,17,31,49,-18,31
Portadown,4300,11,7,6,17,22,46,-24,27
Cliftonville,4301,1,18,4,8,60,35,25,58
Linfield,4301,2,16,8,6,67,34,33,56
Crusaders,4301,3,14,10,6,57,38,19,52
Dungannon,4301,4,11,11,8,52,45,7,44
Ballymena,4301,5,11,10,9,57,62,-5,43
Glenavon,4301,6,10,12,8,46,43,3,42
Coleraine,4301,7,9,12,9,44,41,3,39
Ards,4301,8,10,6,14,37,46,-9,36
Glentoran,4301,9,8,9,13,36,49,-13,33
Ballinamalla,4301,10,7,5,18,28,53,-25,26
Portadown,4301,11,5,5,20,22,60,-38,20
Cliftonville,4302,1,15,10,5,55,33,22,55
Crusaders,4302,2,14,10,6,50,33,17,52
Linfield,4302,3,14,8,8,57,37,20,50
Glenavon,4302,4,13,10,7,49,37,12,49
Coleraine,4302,5,11,12,7,45,35,10,45
Ballymena,4302,6,12,7,11,51,55,-4,43
Ards,4302,7,10,5,15,46,62,-16,35
Dungannon,4302,8,6,14,10,46,43,3,32
Glentoran,4302,9,7,11,12,21,41,-20,32
Portadown,4302,10,7,6,17,27,46,-19,27
Ballinamalla,4302,11,7,5,18,28,53,-25,26
Linfield,4303,1,15,9,6,58,29,29,54
Crusaders,4303,2,15,6,9,54,39,15,51
Coleraine,4303,3,13,8,9,41,32,9,47
Cliftonville,4303,4,14,5,11,48,44,4,47
Glentoran,4303,5,12,7,11,42,41,1,43
Dungannon,4303,6,10,9,11,48,44,4,39
Glenavon,4303,7,10,9,11,45,49,-4,39
Ballymena,4303,8,11,5,14,51,61,-10,38
Ards,4303,9,10,6,14,38,47,-9,36
Portadown,4303,10,10,3,17,25,43,-18,33
Ballinamalla,4303,11,9,5,16,35,56,-21,32
Coleraine,4304,1,14,11,5,43,30,13,53
Cliftonville,4304,2,16,4,10,57,43,14,52
Crusaders,4304,3,13,8,9,52,42,10,47
Glenavon,4304,4,12,11,7,45,38,7,47
Linfield,4304,5,12,10,8,56,36,20,46
Ards,4304,6,12,5,13,37,41,-4,41
Ballymena,4304,7,10,6,14,51,65,-14,36
Dungannon,4304,8,8,11,11,48,46,2,35
Glentoran,4304,9,8,9,13,29,41,-12,33
Portadown,4304,10,9,5,16,29,50,-21,32
Ballinamalla,4304,11,9,4,17,32,47,-15,31
Crusaders,4305,1,17,7,6,59,35,24,58
Linfield,4305,2,16,9,5,67,39,28,57
Ballymena,4305,3,17,3,10,69,60,9,54
Cliftonville,4305,4,12,6,12,52,46,6,42
Glenavon,4305,5,10,11,9,44,48,-4,41
Coleraine,4305,6,10,10,10,40,42,-2,40
Dungannon,4305,7,8,12,10,47,44,3,36
Glentoran,4305,8,9,9,12,35,45,-10,36
Ards,4305,9,9,7,14,39,52,-13,34
Ballinamalla,4305,10,10,3,17,33,49,-16,33
Portadown,4305,11,6,5,19,28,53,-25,23
Crusaders,4306,1,19,7,4,69,34,35,64
Cliftonville,4306,2,17,4,9,59,41,18,55
Linfield,4306,3,15,8,7,66,31,35,53
Ballymena,4306,4,14,5,11,62,56,6,47
Glenavon,4306,5,11,9,10,53,49,4,42
Dungannon,4306,6,11,8,11,55,46,9,41
Glentoran,4306,7,12,5,13,36,48,-12,41
Coleraine,4306,8,8,11,11,43,52,-9,35
Ards,4306,9,8,7,15,35,53,-18,31
Portadown,4306,10,9,4,17,23,48,-25,31
Ballinamalla,4306,11,6,2,22,26,69,-43,20
Linfield,4307,1,18,7,5,65,27,38,61
Cliftonville,4307,2,18,3,9,62,39,23,57
Crusaders,4307,3,16,9,5,56,33,23,57
Coleraine,4307,4,11,13,6,42,34,8,46
Glenavon,4307,5,11,10,9,46,51,-5,43
Ballymena,4307,6,11,6,13,44,62,-18,39
Glentoran,4307,7,11,5,14,27,38,-11,38
Dungannon,4307,8,8,10,12,41,43,-2,34
Ards,4307,9,9,6,15,38,49,-11,33
Ballinamalla,4307,10,8,3,19,31,54,-23,27
Portadown,4307,11,6,4,20,26,48,-22,22
Crusaders,4308,1,16,6,8,54,31,23,54
Ballymena,4308,2,16,4,10,66,64,2,52
Coleraine,4308,3,13,10,7,50,37,13,49
Linfield,4308,4,13,9,8,58,38,20,48
Glentoran,4308,5,12,10,8,35,36,-1,46
Glenavon,4308,6,11,10,9,45,49,-4,43
Cliftonville,4308,7,12,4,14,49,47,2,40
Dungannon,4308,8,9,8,13,49,51,-2,35
Ards,4308,9,9,6,15,35,52,-17,33
Portadown,4308,10,8,6,16,32,48,-16,30
Ballinamalla,4308,11,8,3,19,37,57,-20,27
Linfield,4309,1,16,10,4,55,22,33,58
Glenavon,4309,2,14,11,5,51,44,7,53
Crusaders,4309,3,15,7,8,52,32,20,52
Cliftonville,4309,4,16,3,11,51,38,13,51
Coleraine,4309,5,11,10,9,41,44,-3,43
Ballymena,4309,6,12,7,11,51,57,-6,43
Glentoran,4309,7,11,7,12,27,35,-8,40
Ballinamalla,4309,8,12,2,16,37,45,-8,38
Dungannon,4309,9,8,12,10,47,43,4,36
Ards,4309,10,4,9,17,28,50,-22,21
Portadown,4309,11,4,6,20,17,47,-30,18
Cliftonville,4310,1,17,3,10,51,43,8,54
Crusaders,4310,2,14,10,6,52,33,19,52
Linfield,4310,3,13,11,6,56,35,21,50
Coleraine,4310,4,13,9,8,52,43,9,48
Glenavon,4310,5,12,12,6,52,50,2,48
Ballymena,4310,6,14,5,11,62,53,9,47
Dungannon,4310,7,8,14,8,49,40,9,38
Portadown,4310,8,7,8,15,24,42,-18,29
Ards,4310,9,7,8,15,32,51,-19,29
Glentoran,4310,10,5,12,13,21,36,-15,27
Ballinamalla,4310,11,6,6,18,26,51,-25,24
Crusaders,4311,1,19,7,4,65,33,32,64
Linfield,4311,2,16,10,4,59,28,31,58
Cliftonville,4311,3,17,6,7,54,35,19,57
Coleraine,4311,4,12,10,8,41,34,7,46
Ballymena,4311,5,13,6,11,54,57,-3,45
Glenavon,4311,6,10,11,9,39,40,-1,41
Dungannon,4311,7,7,10,13,44,48,-4,31
Ards,4311,8,8,5,17,35,48,-13,29
Glentoran,4311,9,7,8,15,28,43,-15,29
Ballinamalla,4311,10,8,4,18,31,57,-26,28
Portadown,4311,11,7,5,18,23,50,-27,26
Linfield,4312,1,17,7,6,54,29,25,58
Cliftonville,4312,2,17,4,9,53,33,20,55
Ballymena,4312,3,16,4,10,61,56,5,52
Crusaders,4312,4,15,6,9,54,36,18,51
Coleraine,4312,5,14,9,7,49,36,13,51
Dungannon,4312,6,12,10,8,53,42,11,46
Glenavon,4312,7,8,11,11,41,50,-9,35
Ards,4312,8,10,3,17,35,51,-16,33
Ballinamalla,4312,9,7,6,17,33,54,-21,27
Portadown,4312,10,7,6,17,26,49,-23,27
Glentoran,4312,11,6,6,18,23,46,-23,24
Linfield,4313,1,16,9,5,61,26,35,57
Crusaders,4313,2,14,10,6,55,38,17,52
Cliftonville,4313,3,14,7,9,54,41,13,49
Ballymena,4313,4,14,7,9,67,59,8,49
Glenavon,4313,5,11,12,7,50,49,1,45
Coleraine,4313,6,10,12,8,44,41,3,42
Dungannon,4313,7,10,8,12,48,47,1,38
Ards,4313,8,10,6,14,38,45,-7,36
Glentoran,4313,9,6,10,14,29,49,-20,28
Ballinamalla,4313,10,7,7,16,29,53,-24,28
Portadown,4313,11,7,4,19,27,54,-27,25
Crusaders,4314,1,17,8,5,59,27,32,59
Linfield,4314,2,15,8,7,57,29,28,53
Ballymena,4314,3,16,4,10,57,55,2,52
Dungannon,4314,4,13,9,8,49,42,7,48
Cliftonville,4314,5,12,8,10,46,39,7,44
Coleraine,4314,6,9,13,8,37,38,-1,40
Glenavon,4314,7,8,14,8,40,37,3,38
Glentoran,4314,8,9,6,15,27,42,-15,33
Portadown,4314,9,9,5,16,26,45,-19,32
Ards,4314,10,8,4,18,34,56,-22,28
Ballinamalla,4314,11,7,5,18,30,52,-22,26
Linfield,4315,1,16,10,4,73,26,47,58
Cliftonville,4315,2,16,4,10,49,39,10,52
Crusaders,4315,3,15,6,9,53,38,15,51
Ballymena,4315,4,14,5,11,58,59,-1,47
Glenavon,4315,5,12,9,9,50,49,1,45
Coleraine,4315,6,11,11,8,46,44,2,44
Dungannon,4315,7,10,7,13,49,48,1,37
Portadown,4315,8,11,4,15,26,42,-16,37
Ballinamalla,4315,9,10,3,17,30,48,-18,33
Glentoran,4315,10,8,6,16,33,52,-19,30
Ards,4315,11,7,5,18,34,56,-22,26
Ballymena,4316,1,17,5,8,64,53,11,56
Crusaders,4316,2,15,6,9,53,39,14,51
Cliftonville,4316,3,15,5,10,55,44,11,50
Linfield,4316,4,13,10,7,61,36,25,49
Glenavon,4316,5,11,10,9,59,49,10,43
Coleraine,4316,6,11,10,9,42,42,0,43
Dungannon,4316,7,11,8,11,47,43,4,41
Ards,4316,8,11,4,15,40,47,-7,37
Glentoran,4316,9,10,5,15,30,46,-16,35
Portadown,4316,10,9,5,16,29,49,-20,32
Ballinamalla,4316,11,7,2,21,23,55,-32,23
Linfield,4317,1,19,6,5,68,28,40,63
Cliftonville,4317,2,18,2,10,54,35,19,56
Ballymena,4317,3,13,6,11,58,61,-3,45
Dungannon,4317,4,11,9,10,52,43,9,42
Crusaders,4317,5,12,6,12,46,41,5,42
Coleraine,4317,6,10,11,9,39,38,1,41
Glenavon,4317,7,9,12,9,47,47,0,39
Glentoran,4317,8,9,8,13,29,48,-19,35
Ards,4317,9,9,5,16,38,52,-14,32
Ballinamalla,4317,10,9,5,16,26,50,-24,32
Portadown,4317,11,9,4,17,32,46,-14,31
Crusaders,4318,1,18,7,5,58,29,29,61
Linfield,4318,2,17,8,5,67,31,36,59
Cliftonville,4318,3,14,8,8,45,36,9,50
Ballymena,4318,4,14,5,11,54,55,-1,47
Coleraine,4318,5,11,12,7,45,37,8,45
Dungannon,4318,6,11,10,9,54,44,10,43
Glenavon,4318,7,11,8,11,42,47,-5,41
Glentoran,4318,8,10,8,12,30,38,-8,38
Ards,4318,9,8,4,18,38,54,-16,28
Portadown,4318,10,7,5,18,23,47,-24,26
Ballinamalla,4318,11,5,3,22,24,62,-38,18
Cliftonville,4319,1,18,4,8,56,36,20,58
Linfield,4319,2,16,9,5,59,31,28,57
Crusaders,4319,3,16,8,6,57,36,21,56
Glenavon,4319,4,11,9,10,54,48,6,42
Ballymena,4319,5,11,6,13,51,60,-9,39
Glentoran,4319,6,9,9,12,32,41,-9,36
Portadown,4319,7,11,3,16,27,38,-11,36
Ards,4319,8,10,4,16,34,54,-20,34
Dungannon,4319,9,8,9,13,44,46,-2,33
Coleraine,4319,10,7,12,11,34,41,-7,33
Ballinamalla,4319,11,9,5,16,41,58,-17,32
Linfield,4320,1,16,9,5,55,29,26,57
Crusaders,4320,2,17,6,7,56,38,18,57
Ballymena,4320,3,17,5,8,65,53,12,56
Cliftonville,4320,4,12,7,11,49,35,14,43
Glenavon,4320,5,10,11,9,43,42,1,41
Coleraine,4320,6,9,14,7,38,40,-2,41
Dungannon,4320,7,9,10,11,48,43,5,37
Glentoran,4320,8,8,8,14,32,47,-15,32
Ards,4320,9,8,7,15,39,50,-11,31
Ballinamalla,4320,10,10,1,19,33,52,-19,31
Portadown,4320,11,8,4,18,24,53,-29,28
Crusaders,4321,1,17,9,4,53,27,26,60
Linfield,4321,2,15,10,5,61,31,30,55
Cliftonville,4321,3,16,3,11,49,39,10,51
Ballymena,4321,4,15,6,9,59,54,5,51
Coleraine,4321,5,10,14,6,43,37,6,44
Glenavon,4321,6,9,13,8,44,48,-4,40
Dungannon,4321,7,8,11,11,44,42,2,35
Glentoran,4321,8,8,9,13,32,45,-13,33
Ards,4321,9,6,10,14,37,52,-15,28
Portadown,4321,10,4,11,15,24,47,-23,23
Ballinamalla,4321,11,5,8,17,27,51,-24,23
Linfield,4322,1,18,8,4,79,31,48,62
Crusaders,4322,2,17,9,4,56,26,30,60
Cliftonville,4322,3,16,3,11,49,37,12,51
Coleraine,4322,4,11,10,9,40,41,-1,43
Glenavon,4322,5,10,12,8,39,41,-2,42
Ballymena,4322,6,11,7,12,54,65,-11,40
Dungannon,4322,7,8,12,10,48,43,5,36
Portadown,4322,8,10,3,17,25,49,-24,33
Glentoran,4322,9,8,7,15,28,50,-22,31
Ards,4322,10,7,7,16,37,50,-13,28
Ballinamalla,4322,11,6,8,16,25,47,-22,26
Crusaders,4323,1,17,7,6,56,30,26,58
Glenavon,4323,2,15,8,7,57,43,14,53
Cliftonville,4323,3,16,5,9,56,42,14,53
Linfield,4323,4,13,12,5,51,29,22,51
Ballymena,4323,5,14,7,9,52,57,-5,49
Dungannon,4323,6,9,10,11,52,44,8,37
Coleraine,4323,7,8,13,9,41,41,0,37
Glentoran,4323,8,10,7,13,31,42,-11,37
Ards,4323,9,7,8,15,33,52,-19,29
Ballinamalla,4323,10,7,5,18,33,55,-22,26
Portadown,4323,11,5,6,19,23,50,-27,21
Linfield,4324,1,16,7,7,56,28,28,55
Cliftonville,4324,2,16,5,9,56,37,19,53
Crusaders,4324,3,13,12,5,52,34,18,51
Glenavon,4324,4,13,11,6,47,40,7,50
Ballymena,4324,5,12,8,10,56,58,-2,44
Dungannon,4324,6,10,10,10,45,43,2,40
Coleraine,4324,7,10,10,10,40,40,0,40
Ards,4324,8,9,8,13,39,49,-10,35
Glentoran,4324,9,9,8,13,30,43,-13,35
Portadown,4324,10,5,8,17,20,45,-25,23
Ballinamalla,4324,11,5,7,18,23,47,-24,22
Linfield,4325,1,15,10,5,62,29,33,55
Cliftonville,4325,2,15,4,11,57,41,16,49
Crusaders,4325,3,14,6,10,50,39,11,48
Dungannon,4325,4,12,9,9,55,45,10,45
Ballymena,4325,5,13,6,11,60,62,-2,45
Coleraine,4325,6,11,10,9,39,41,-2,43
Glentoran,4325,7,12,7,11,38,41,-3,43
Glenavon,4325,8,9,12,9,43,44,-1,39
Ballinamalla,4325,9,9,4,17,35,54,-19,31
Ards,4325,10,9,4,17,34,53,-19,31
Portadown,4325,11,6,8,16,25,49,-24,26
Crusaders,4326,1,15,8,7,57,46,11,53
Linfield,4326,2,15,7,8,64,38,26,52
Glenavon,4326,3,13,12,5,55,47,8,51
Coleraine,4326,4,13,10,7,42,34,8,49
Cliftonville,4326,5,13,8,9,53,39,14,47
Ballymena,4326,6,14,4,12,57,59,-2,46
Dungannon,4326,7,10,9,11,55,46,9,39
Ballinamalla,4326,8,9,6,15,43,54,-11,33
Ards,4326,9,9,3,18,35,56,-21,30
Glentoran,4326,10,7,7,16,26,45,-19,28
Portadown,4326,11,6,8,16,25,48,-23,26
Ballymena,4327,1,18,5,7,61,50,11,59
Linfield,4327,2,15,12,3,57,23,34,57
Crusaders,4327,3,17,5,8,54,39,15,56
Coleraine,4327,4,13,9,8,42,35,7,48
Dungannon,4327,5,13,8,9,46,36,10,47
Cliftonville,4327,6,12,6,12,44,42,2,42
Glenavon,4327,7,7,10,13,39,53,-14,31
Glentoran,4327,8,8,7,15,33,47,-14,31
Portadown,4327,9,9,4,17,30,46,-16,31
Ards,4327,10,8,5,17,40,47,-7,29
Ballinamalla,4327,11,7,5,18,28,56,-28,26
Linfield,4328,1,16,8,6,58,25,33,56
Crusaders,4328,2,14,8,8,53,35,18,50
Glenavon,4328,3,13,10,7,50,41,9,49
Ballymena,4328,4,14,7,9,69,61,8,49
Cliftonville,4328,5,15,3,12,57,47,10,48
Coleraine,4328,6,10,10,10,36,41,-5,40
Dungannon,4328,7,8,12,10,46,42,4,36
Glentoran,4328,8,10,6,14,32,43,-11,36
Ards,4328,9,10,4,16,39,54,-15,34
Portadown,4328,10,9,6,15,29,49,-20,33
Ballinamalla,4328,11,5,8,17,22,53,-31,23
Linfield,4329,1,16,9,5,68,29,39,57
Crusaders,4329,2,16,8,6,51,30,21,56
Ballymena,4329,3,15,7,8,55,58,-3,52
Glenavon,4329,4,12,11,7,51,46,5,47
Cliftonville,4329,5,13,4,13,45,44,1,43
Coleraine,4329,6,11,10,9,41,40,1,43
Dungannon,4329,7,10,9,11,47,49,-2,39
Glentoran,4329,8,9,7,14,36,46,-10,34
Ballinamalla,4329,9,9,4,17,33,51,-18,31
Ards,4329,10,8,5,17,39,50,-11,29
Portadown,4329,11,6,6,18,26,49,-23,24
Ballymena,4330,1,17,5,8,59,53,6,56
Crusaders,4330,2,14,10,6,55,36,19,52
Dungannon,4330,3,14,6,10,52,41,11,48
Cliftonville,4330,4,14,5,11,50,46,4,47
Glenavon,4330,5,13,8,9,43,42,1,47
Linfield,4330,6,13,7,10,58,39,19,46
Coleraine,4330,7,11,10,9,45,43,2,43
Glentoran,4330,8,11,7,12,31,39,-8,40
Portadown,4330,9,8,6,16,28,43,-15,30
Ards,4330,10,7,5,18,30,50,-20,26
Ballinamalla,4330,11,6,5,19,34,53,-19,23
Glenavon,4331,1,15,9,6,55,37,18,54
Crusaders,4331,2,14,8,8,51,35,16,50
Cliftonville,4331,3,14,7,9,56,36,20,49
Coleraine,4331,4,12,13,5,56,40,16,49
Linfield,4331,5,13,9,8,58,42,16,48
Ballymena,4331,6,13,8,9,55,54,1,47
Ards,4331,7,10,9,11,39,46,-7,39
Dungannon,4331,8,7,11,12,41,49,-8,32
Glentoran,4331,9,8,8,14,26,44,-18,32
Ballinamalla,4331,10,8,2,20,28,55,-27,26
Portadown,4331,11,5,8,17,20,47,-27,23
Crusaders,4332,1,17,8,5,53,33,20,59
Ballymena,4332,2,17,6,7,67,49,18,57
Coleraine,4332,3,14,10,6,50,32,18,52
Linfield,4332,4,13,11,6,59,37,22,50
Cliftonville,4332,5,15,5,10,55,40,15,50
Glenavon,4332,6,10,10,10,43,46,-3,40
Dungannon,4332,7,10,8,12,48,46,2,38
Ards,4332,8,8,7,15,38,49,-11,31
Glentoran,4332,9,7,8,15,34,48,-14,29
Portadown,4332,10,7,4,19,22,62,-40,25
Ballinamalla,4332,11,6,5,19,29,56,-27,23
Crusaders,4333,1,18,6,6,58,35,23,60
Coleraine,4333,2,15,9,6,49,33,16,54
Linfield,4333,3,15,7,8,62,37,25,52
Cliftonville,4333,4,16,4,10,56,46,10,52
Dungannon,4333,5,12,9,9,56,44,12,45
Glenavon,4333,6,11,11,8,54,46,8,44
Ballymena,4333,7,10,9,11,53,62,-9,39
Ards,4333,8,9,8,13,39,49,-10,35
Glentoran,4333,9,8,11,11,29,43,-14,35
Portadown,4333,10,6,6,18,25,47,-22,24
Ballinamalla,4333,11,4,2,24,28,67,-39,14
Cliftonville,4334,1,18,3,9,60,44,16,57
Linfield,4334,2,16,8,6,56,28,28,56
Crusaders,4334,3,16,7,7,57,39,18,55
Ballymena,4334,4,14,6,10,57,61,-4,48
Glenavon,4334,5,11,10,9,47,42,5,43
Coleraine,4334,6,10,10,10,46,41,5,40
Ards,4334,7,10,5,15,42,50,-8,35
Dungannon,4334,8,7,12,11,44,42,2,33
Ballinamalla,4334,9,9,6,15,33,49,-16,33
Glentoran,4334,10,6,12,12,29,44,-15,30
Portadown,4334,11,6,5,19,20,51,-31,23
Crusaders,4335,1,15,8,7,51,33,18,53
Ballymena,4335,2,15,6,9,63,60,3,51
Linfield,4335,3,12,10,8,58,32,26,46
Glenavon,4335,4,11,12,7,51,46,5,45
Dungannon,4335,5,11,10,9,52,40,12,43
Coleraine,4335,6,11,10,9,39,39,0,43
Cliftonville,4335,7,12,4,14,41,43,-2,40
Glentoran,4335,8,10,10,10,30,39,-9,40
Portadown,4335,9,9,6,15,32,46,-14,33
Ballinamalla,4335,10,10,3,17,25,45,-20,33
Ards,4335,11,8,3,19,34,53,-19,27
Linfield,4336,1,16,10,4,57,22,35,58
Cliftonville,4336,2,16,5,9,49,33,16,53
Ballymena,4336,3,16,5,9,59,54,5,53
Crusaders,4336,4,15,6,9,53,33,20,51
Dungannon,4336,5,11,10,9,56,46,10,43
Coleraine,4336,6,10,11,9,40,45,-5,41
Glenavon,4336,7,9,12,9,46,48,-2,39
Glentoran,4336,8,11,6,13,31,43,-12,39
Ards,4336,9,9,7,14,39,48,-9,34
Ballinamalla,4336,10,6,5,19,26,55,-29,23
Portadown,4336,11,4,7,19,25,54,-29,19
Crusaders,4337,1,16,10,4,54,32,22,58
Linfield,4337,2,13,9,8,56,36,20,48
Coleraine,4337,3,12,10,8,51,38,13,46
Glenavon,4337,4,10,13,7,47,47,0,43
Cliftonville,4337,5,11,9,10,50,44,6,42
Dungannon,4337,6,10,10,10,58,52,6,40
Glentoran,4337,7,10,10,10,32,37,-5,40
Ballymena,4337,8,11,7,12,64,72,-8,40
Ards,4337,9,10,6,14,49,52,-3,36
Portadown,4337,10,9,6,15,31,46,-15,33
Ballinamalla,4337,11,6,4,20,29,65,-36,22
Crusaders,4338,1,16,10,4,51,27,24,58
Cliftonville,4338,2,17,5,8,58,35,23,56
Ballymena,4338,3,12,11,7,58,53,5,47
Linfield,4338,4,11,13,6,55,38,17,46
Coleraine,4338,5,11,12,7,47,41,6,45
Glentoran,4338,6,11,7,12,38,45,-7,40
Glenavon,4338,7,8,14,8,43,46,-3,38
Dungannon,4338,8,7,11,12,44,47,-3,32
Ards,4338,9,7,9,14,34,44,-10,30
Ballinamalla,4338,10,7,7,16,28,47,-19,28
Portadown,4338,11,5,7,18,20,53,-33,22
Linfield,4339,1,17,8,5,70,32,38,59
Crusaders,4339,2,17,5,8,55,38,17,56
Glenavon,4339,3,13,10,7,47,40,7,49
Ballymena,4339,4,14,6,10,62,59,3,48
Coleraine,4339,5,12,9,9,35,32,3,45
Cliftonville,4339,6,13,5,12,42,36,6,44
Dungannon,4339,7,11,9,10,50,40,10,42
Glentoran,4339,8,8,12,10,32,37,-5,36
Ards,4339,9,7,8,15,32,51,-19,29
Portadown,4339,10,7,7,16,24,48,-24,28
Ballinamalla,4339,11,5,3,22,22,58,-36,18
Crusaders,4340,1,18,6,6,61,31,30,60
Cliftonville,4340,2,17,4,9,48,33,15,55
Linfield,4340,3,15,7,8,52,31,21,52
Ballymena,4340,4,13,6,11,55,51,4,45
Coleraine,4340,5,11,9,10,36,35,1,42
Glenavon,4340,6,10,12,8,41,41,0,42
Glentoran,4340,7,12,6,12,31,36,-5,42
Dungannon,4340,8,9,10,11,46,43,3,37
Ballinamalla,4340,9,11,1,18,32,53,-21,34
Ards,4340,10,9,6,15,33,45,-12,33
Portadown,4340,11,4,5,21,14,50,-36,17
Crusaders,4341,1,18,6,6,63,33,30,60
Linfield,4341,2,15,11,4,60,26,34,56
Glenavon,4341,3,14,10,6,47,42,5,52
Cliftonville,4341,4,13,7,10,54,44,10,46
Ballymena,4341,5,13,6,11,60,62,-2,45
Coleraine,4341,6,9,13,8,36,36,0,40
Dungannon,4341,7,11,6,13,44,44,0,39
Ballinamalla,4341,8,10,3,17,31,46,-15,33
Ards,4341,9,8,7,15,35,45,-10,31
Glentoran,4341,10,6,9,15,29,54,-25,27
Portadown,4341,11,5,8,17,22,49,-27,23
Crusaders,4342,1,16,8,6,55,36,19,56
Linfield,4342,2,15,10,5,55,27,28,55
Glenavon,4342,3,12,12,6,46,41,5,48
Ballymena,4342,4,12,8,10,51,53,-2,44
Cliftonville,4342,5,12,6,12,50,44,6,42
Coleraine,4342,6,8,17,5,35,26,9,41
Dungannon,4342,7,10,11,9,53,45,8,41
Ards,4342,8,12,4,14,41,46,-5,40
Glentoran,4342,9,8,9,13,29,44,-15,33
Ballinamalla,4342,10,7,5,18,34,59,-25,26
Portadown,4342,11,5,6,19,18,46,-28,21
Crusaders,4343,1,18,8,4,61,34,27,62
Ballymena,4343,2,16,5,9,61,56,5,53
Linfield,4343,3,14,10,6,59,38,21,52
Cliftonville,4343,4,13,4,13,51,42,9,43
Ballinamalla,4343,5,13,4,13,38,47,-9,43
Coleraine,4343,6,10,11,9,41,42,-1,41
Glenavon,4343,7,7,16,7,46,46,0,37
Glentoran,4343,8,9,6,15,33,51,-18,33
Dungannon,4343,9,7,11,12,47,49,-2,32
Ards,4343,10,8,7,15,39,49,-10,31
Portadown,4343,11,4,10,16,24,46,-22,22
Linfield,4344,1,17,8,5,67,30,37,59
Crusaders,4344,2,16,8,6,49,30,19,56
Ballymena,4344,3,16,3,11,53,51,2,51
Cliftonville,4344,4,15,5,10,58,41,17,50
Coleraine,4344,5,11,11,8,42,35,7,44
Dungannon,4344,6,10,11,9,56,46,10,41
Glenavon,4344,7,10,11,9,43,44,-1,41
Glentoran,4344,8,7,9,14,32,52,-20,30
Ballinamalla,4344,9,8,6,16,28,53,-25,30
Ards,4344,10,8,4,18,31,53,-22,28
Portadown,4344,11,6,6,18,26,50,-24,24
Linfield,4345,1,15,10,5,55,24,31,55
Crusaders,4345,2,16,6,8,54,34,20,54
Ballymena,4345,3,15,7,8,59,51,8,52
Cliftonville,4345,4,14,7,9,52,41,11,49
Glenavon,4345,5,11,11,8,44,43,1,44
Coleraine,4345,6,10,10,10,48,46,2,40
Dungannon,4345,7,10,7,13,46,44,2,37
Portadown,4345,8,8,8,14,27,41,-14,32
Ards,4345,9,9,5,16,35,51,-16,32
Glentoran,4345,10,8,6,16,25,48,-23,30
Ballinamalla,4345,11,8,5,17,27,49,-22,29
Cliftonville,4346,1,17,7,6,66,33,33,58
Crusaders,4346,2,16,10,4,55,31,24,58
Linfield,4346,3,14,8,8,59,37,22,50
Ballymena,4346,4,14,6,10,59,60,-1,48
Glenavon,4346,5,10,11,9,47,50,-3,41
Ards,4346,6,10,7,13,43,48,-5,37
Coleraine,4346,7,8,11,11,42,54,-12,35
Dungannon,4346,8,8,9,13,52,50,2,33
Ballinamalla,4346,9,9,5,16,32,51,-19,32
Glentoran,4346,10,7,10,13,34,47,-13,31
Portadown,4346,11,7,6,17,23,51,-28,27
Crusaders,4347,1,16,9,5,62,38,24,57
Linfield,4347,2,15,11,4,65,34,31,56
Ballymena,4347,3,13,9,8,53,50,3,48
Cliftonville,4347,4,13,5,12,50,45,5,44
Glenavon,4347,5,9,11,10,46,48,-2,38
Glentoran,4347,6,10,8,12,34,49,-15,38
Coleraine,4347,7,8,13,9,38,41,-3,37
Ballinamalla,4347,8,11,4,15,34,48,-14,37
Dungannon,4347,9,9,9,12,43,40,3,36
Ards,4347,10,9,8,13,41,46,-5,35
Portadown,4347,11,6,5,19,24,51,-27,23
Crusaders,4348,1,17,7,6,50,28,22,58
Linfield,4348,2,15,11,4,62,30,32,56
Ballymena,4348,3,16,6,8,68,59,9,54
Cliftonville,4348,4,16,4,10,60,44,16,52
Coleraine,4348,5,12,8,10,45,42,3,44
Glenavon,4348,6,10,11,9,49,47,2,41
Dungannon,4348,7,11,7,12,48,43,5,40
Ards,4348,8,9,6,15,35,47,-12,33
Ballinamalla,4348,9,9,4,17,34,57,-23,31
Glentoran,4348,10,6,8,16,25,49,-24,26
Portadown,4348,11,6,4,20,20,50,-30,22
Crusaders,4349,1,16,8,6,51,38,13,56
Cliftonville,4349,2,17,4,9,55,38,17,55
Ballymena,4349,3,15,6,9,56,51,5,51
Linfield,4349,4,14,8,8,65,36,29,50
Glenavon,4349,5,10,13,7,49,46,3,43
Dungannon,4349,6,11,9,10,52,43,9,42
Ards,4349,7,11,4,15,40,47,-7,37
Coleraine,4349,8,6,13,11,38,48,-10,31
Ballinamalla,4349,9,8,7,15,30,44,-14,31
Glentoran,4349,10,7,8,15,29,51,-22,29
Portadown,4349,11,8,4,18,22,45,-23,28
Crusaders,4350,1,18,7,5,62,32,30,61
Linfield,4350,2,15,8,7,55,30,25,53
Cliftonville,4350,3,15,6,9,52,37,15,51
Ballymena,4350,4,15,4,11,54,53,1,49
Coleraine,4350,5,10,10,10,36,35,1,40
Dungannon,4350,6,9,11,10,49,42,7,38
Glenavon,4350,7,8,14,8,44,47,-3,38
Ards,4350,8,9,6,15,40,47,-7,33
Glentoran,4350,9,8,8,14,28,55,-27,32
Portadown,4350,10,8,7,15,28,43,-15,31
Ballinamalla,4350,11,6,7,17,23,50,-27,25
Crusaders,4351,1,16,8,6,58,39,19,56
Coleraine,4351,2,14,12,4,54,33,21,54
Linfield,4351,3,14,8,8,52,32,20,50
Ballymena,4351,4,14,6,10,59,58,1,48
Cliftonville,4351,5,12,9,9,46,43,3,45
Portadown,4351,6,11,4,15,26,44,-18,37
Ards,4351,7,10,6,14,39,46,-7,36
Dungannon,4351,8,8,10,12,52,48,4,34
Glentoran,4351,9,8,9,13,35,44,-9,33
Glenavon,4351,10,7,10,13,43,52,-9,31
Ballinamalla,4351,11,8,4,18,29,54,-25,28
Cliftonville,4352,1,17,5,8,55,35,20,56
Crusaders,4352,2,15,7,8,59,40,19,52
Linfield,4352,3,13,9,8,51,31,20,48
Ballymena,4352,4,13,7,10,55,57,-2,46
Glenavon,4352,5,12,9,9,41,42,-1,45
Coleraine,4352,6,11,10,9,42,42,0,43
Dungannon,4352,7,10,11,9,47,37,10,41
Glentoran,4352,8,11,7,12,34,37,-3,40
Ards,4352,9,9,5,16,34,45,-11,32
Portadown,4352,10,8,8,14,27,43,-16,32
Ballinamalla,4352,11,5,4,21,23,59,-36,19
Crusaders,4353,1,18,7,5,57,35,22,61
Cliftonville,4353,2,15,6,9,55,38,17,51
Ballymena,4353,3,14,7,9,58,57,1,49
Linfield,4353,4,13,9,8,55,33,22,48
Coleraine,4353,5,10,12,8,44,36,8,42
Glentoran,4353,6,11,8,11,32,42,-10,41
Dungannon,4353,7,10,10,10,54,48,6,40
Glenavon,4353,8,9,11,10,47,52,-5,38
Ards,4353,9,9,5,16,44,58,-14,32
Ballinamalla,4353,10,7,6,17,31,53,-22,27
Portadown,4353,11,6,5,19,24,49,-25,23
Linfield,4354,1,19,7,4,68,26,42,64
Crusaders,4354,2,18,6,6,55,34,21,60
Cliftonville,4354,3,17,3,10,54,37,17,54
Ballymena,4354,4,14,5,11,52,54,-2,47
Glenavon,4354,5,11,12,7,49,44,5,45
Coleraine,4354,6,11,12,7,39,36,3,45
Dungannon,4354,7,9,7,14,50,44,6,34
Glentoran,4354,8,8,9,13,33,42,-9,33
Ballinamalla,4354,9,9,5,16,24,50,-26,32
Ards,4354,10,6,5,19,27,53,-26,23
Portadown,4354,11,5,5,20,18,49,-31,20
Crusaders,4355,1,17,7,6,60,33,27,58
Linfield,4355,2,16,9,5,68,29,39,57
Ballymena,4355,3,15,4,11,63,61,2,49
Coleraine,4355,4,12,9,9,44,40,4,45
Glenavon,4355,5,11,11,8,48,53,-5,44
Cliftonville,4355,6,12,6,12,43,43,0,42
Ballinamalla,4355,7,10,4,16,36,49,-13,34
Dungannon,4355,8,8,9,13,43,46,-3,33
Glentoran,4355,9,8,9,13,29,46,-17,33
Ards,4355,10,8,6,16,36,49,-13,30
Portadown,4355,11,8,6,16,23,44,-21,30
Crusaders,4356,1,18,8,4,67,38,29,62
Linfield,4356,2,17,8,5,65,29,36,59
Cliftonville,4356,3,15,5,10,57,45,12,50
Dungannon,4356,4,12,9,9,58,49,9,45
Coleraine,4356,5,10,12,8,36,37,-1,42
Ards,4356,6,11,5,14,47,51,-4,38
Glenavon,4356,7,9,9,12,37,48,-11,36
Ballymena,4356,8,10,5,15,46,59,-13,35
Portadown,4356,9,10,5,15,28,41,-13,35
Glentoran,4356,10,8,7,15,31,50,-19,31
Ballinamalla,4356,11,5,7,18,29,54,-25,22
Crusaders,4357,1,18,5,7,59,33,26,59
Linfield,4357,2,15,10,5,57,27,30,55
Cliftonville,4357,3,17,3,10,58,41,17,54
Glenavon,4357,4,12,11,7,52,46,6,47
Ballymena,4357,5,13,6,11,54,63,-9,45
Coleraine,4357,6,11,10,9,40,36,4,43
Ards,4357,7,9,6,15,34,47,-13,33
Ballinamalla,4357,8,10,2,18,30,55,-25,32
Dungannon,4357,9,6,13,11,45,43,2,31
Portadown,4357,10,9,3,18,31,47,-16,30
Glentoran,4357,11,8,5,17,26,48,-22,29
Cliftonville,4358,1,17,4,9,53,35,18,55
Linfield,4358,2,13,11,6,56,29,27,50
Crusaders,4358,3,14,8,8,58,47,11,50
Coleraine,4358,4,13,10,7,50,43,7,49
Ballymena,4358,5,14,5,11,47,51,-4,47
Glenavon,4358,6,12,10,8,47,40,7,46
Dungannon,4358,7,11,9,10,56,42,14,42
Ards,4358,8,9,6,15,36,45,-9,33
Glentoran,4358,9,8,8,14,33,52,-19,32
Ballinamalla,4358,10,9,4,17,31,52,-21,31
Portadown,4358,11,6,3,21,22,53,-31,21
Crusaders,4359,1,17,7,6,62,35,27,58
Linfield,4359,2,15,8,7,63,35,28,53
Cliftonville,4359,3,15,7,8,48,33,15,52
Ballymena,4359,4,14,6,10,58,58,0,48
Dungannon,4359,5,13,8,9,54,40,14,47
Coleraine,4359,6,10,11,9,42,44,-2,41
Glenavon,4359,7,10,10,10,48,47,1,40
Glentoran,4359,8,9,9,12,30,44,-14,36
Portadown,4359,9,9,4,17,28,44,-16,31
Ballinamalla,4359,10,8,2,20,29,54,-25,26
Ards,4359,11,6,6,18,32,60,-28,24
Crusaders,4360,1,18,8,4,54,26,28,62
Coleraine,4360,2,13,11,6,49,36,13,50
Dungannon,4360,3,13,8,9,52,39,13,47
Linfield,4360,4,13,8,9,54,43,11,47
Cliftonville,4360,5,14,3,13,49,42,7,45
Ballymena,4360,6,11,9,10,46,51,-5,42
Glenavon,4360,7,9,13,8,45,42,3,40
Glentoran,4360,8,11,6,13,39,46,-7,39
Ards,4360,9,10,7,13,40,42,-2,37
Ballinamalla,4360,10,7,3,20,31,58,-27,24
Portadown,4360,11,4,8,18,23,57,-34,20
Crusaders,4361,1,16,9,5,53,29,24,57
Linfield,4361,2,15,8,7,56,32,24,53
Ballymena,4361,3,13,9,8,61,60,1,48
Cliftonville,4361,4,14,3,13,52,40,12,45
Dungannon,4361,5,11,11,8,48,38,10,44
Glenavon,4361,6,8,15,7,48,47,1,39
Coleraine,4361,7,6,17,7,36,38,-2,35
Ards,4361,8,9,8,13,41,53,-12,35
Glentoran,4361,9,7,10,13,28,43,-15,31
Portadown,4361,10,8,6,16,27,47,-20,30
Ballinamalla,4361,11,6,8,16,29,52,-23,26
Crusaders,4362,1,18,8,4,56,30,26,62
Linfield,4362,2,17,8,5,69,33,36,59
Cliftonville,4362,3,17,4,9,51,37,14,55
Ballymena,4362,4,12,6,12,52,63,-11,42
Glenavon,4362,5,10,11,9,44,44,0,41
Dungannon,4362,6,9,9,12,48,47,1,36
Ards,4362,7,10,6,14,42,44,-2,36
Coleraine,4362,8,9,9,12,39,44,-5,36
Ballinamalla,4362,9,10,3,17,27,46,-19,33
Portadown,4362,10,8,5,17,25,44,-19,29
Glentoran,4362,11,8,5,17,29,50,-21,29
Cliftonville,4363,1,17,6,7,57,34,23,57
Linfield,4363,2,16,8,6,65,28,37,56
Crusaders,4363,3,14,5,11,54,47,7,47
Ballymena,4363,4,13,8,9,52,55,-3,47
Glenavon,4363,5,12,10,8,46,37,9,46
Dungannon,4363,6,10,9,11,51,47,4,39
Coleraine,4363,7,10,9,11,44,50,-6,39
Glentoran,4363,8,10,7,13,28,42,-14,37
Ballinamalla,4363,9,9,4,17,31,52,-21,31
Portadown,4363,10,8,6,16,27,43,-16,30
Ards,4363,11,6,8,16,29,49,-20,26
Linfield,4364,1,15,10,5,70,29,41,55
Cliftonville,4364,2,16,3,11,56,45,11,51
Crusaders,4364,3,15,5,10,52,38,14,50
Glenavon,4364,4,13,9,8,56,52,4,48
Dungannon,4364,5,12,8,10,57,45,12,44
Coleraine,4364,6,10,11,9,41,38,3,41
Glentoran,4364,7,10,9,11,39,45,-6,39
Ballymena,4364,8,11,6,13,51,68,-17,39
Ballinamalla,4364,9,8,7,15,31,51,-20,31
Ards,4364,10,7,8,15,34,50,-16,29
Portadown,4364,11,8,4,18,28,54,-26,28
Cliftonville,4365,1,19,3,8,72,48,24,60
Ballymena,4365,2,14,8,8,69,69,0,50
Crusaders,4365,3,14,6,10,53,42,11,48
Linfield,4365,4,13,8,9,60,33,27,47
Glentoran,4365,5,13,7,10,39,43,-4,46
Glenavon,4365,6,12,8,10,55,56,-1,44
Coleraine,4365,7,12,7,11,46,42,4,43
Dungannon,4365,8,8,9,13,45,47,-2,33
Portadown,4365,9,9,5,16,31,52,-21,32
Ballinamalla,4365,10,8,5,17,31,54,-23,29
Ards,4365,11,8,4,18,36,51,-15,28
Ballymena,4366,1,17,5,8,68,59,9,56
Linfield,4366,2,13,10,7,54,34,20,49
Cliftonville,4366,3,15,4,11,55,42,13,49
Crusaders,4366,4,13,7,10,46,37,9,46
Dungannon,4366,5,11,9,10,51,46,5,42
Ards,4366,6,12,4,14,44,51,-7,40
Glenavon,4366,7,9,11,10,47,49,-2,38
Coleraine,4366,8,10,8,12,39,45,-6,38
Glentoran,4366,9,10,7,13,27,40,-13,37
Portadown,4366,10,11,3,16,32,43,-11,36
Ballinamalla,4366,11,7,6,17,30,47,-17,27
Crusaders,4367,1,21,6,3,67,32,35,69
Linfield,4367,2,15,10,5,54,29,25,55
Ballymena,4367,3,16,5,9,56,54,2,53
Cliftonville,4367,4,12,7,11,50,43,7,43
Coleraine,4367,5,10,10,10,37,36,1,40
Dungannon,4367,6,9,11,10,53,46,7,38
Glenavon,4367,7,9,11,10,47,47,0,38
Glentoran,4367,8,10,7,13,28,39,-11,37
Portadown,4367,9,8,8,14,32,48,-16,32
Ards,4367,10,6,6,18,35,55,-20,24
Ballinamalla,4367,11,5,7,18,24,54,-30,22
Crusaders,4368,1,15,7,8,52,41,11,52
Cliftonville,4368,2,14,8,8,51,36,15,50
Linfield,4368,3,13,10,7,60,35,25,49
Glenavon,4368,4,11,12,7,51,43,8,45
Coleraine,4368,5,11,11,8,45,42,3,44
Portadown,4368,6,12,4,14,37,44,-7,40
Ballymena,4368,7,11,6,13,52,61,-9,39
Dungannon,4368,8,9,9,12,48,49,-1,36
Ards,4368,9,10,6,14,39,49,-10,36
Glentoran,4368,10,8,8,14,35,49,-14,32
Ballinamalla,4368,11,8,5,17,27,48,-21,29
Crusaders,4369,1,19,7,4,59,30,29,64
Cliftonville,4369,2,18,4,8,57,38,19,58
Ballymena,4369,3,16,4,10,65,61,4,52
Linfield,4369,4,13,8,9,57,40,17,47
Dungannon,4369,5,10,10,10,51,42,9,40
Glenavon,4369,6,9,11,10,44,48,-4,38
Glentoran,4369,7,9,8,13,34,45,-11,35
Coleraine,4369,8,7,12,11,38,42,-4,33
Ards,4369,9,8,7,15,38,53,-15,31
Portadown,4369,10,7,7,16,22,43,-21,28
Ballinamalla,4369,11,8,4,18,28,51,-23,28
Crusaders,4370,1,17,8,5,56,32,24,59
Ballymena,4370,2,17,6,7,61,54,7,57
Linfield,4370,3,15,9,6,62,30,32,54
Glenavon,4370,4,14,9,7,46,41,5,51
Coleraine,4370,5,11,11,8,44,40,4,44
Cliftonville,4370,6,12,4,14,46,46,0,40
Glentoran,4370,7,9,9,12,35,41,-6,36
Ards,4370,8,8,9,13,34,45,-11,33
Dungannon,4370,9,6,12,12,45,46,-1,30
Ballinamalla,4370,10,7,5,18,25,53,-28,26
Portadown,4370,11,4,8,18,21,47,-26,20
Crusaders,4371,1,17,5,8,54,35,19,56
Linfield,4371,2,14,9,7,55,32,23,51
Cliftonville,4371,3,15,5,10,53,41,12,50
Coleraine,4371,4,12,13,5,44,36,8,49
Dungannon,4371,5,11,11,8,53,44,9,44
Ballymena,4371,6,12,7,11,51,54,-3,43
Glenavon,4371,7,9,9,12,46,49,-3,36
Ballinamalla,4371,8,10,4,16,36,47,-11,34
Ards,4371,9,10,4,16,35,48,-13,34
Portadown,4371,10,8,7,15,28,48,-20,31
Glentoran,4371,11,7,6,17,28,49,-21,27
Crusaders,4372,1,16,8,6,56,36,20,56
Linfield,4372,2,15,9,6,59,35,24,54
Coleraine,4372,3,12,12,6,45,38,7,48
Ballymena,4372,4,14,6,10,64,61,3,48
Cliftonville,4372,5,12,6,12,53,54,-1,42
Glenavon,4372,6,9,12,9,44,48,-4,39
Glentoran,4372,7,10,8,12,34,39,-5,38
Dungannon,4372,8,9,10,11,47,41,6,37
Portadown,4372,9,10,5,15,30,40,-10,35
Ards,4372,10,8,5,17,36,53,-17,29
Ballinamalla,4372,11,6,7,17,32,55,-23,25
Linfield,4373,1,16,8,6,68,32,36,56
Crusaders,4373,2,15,9,6,52,33,19,54
Cliftonville,4373,3,16,5,9,56,40,16,53
Ballymena,4373,4,13,8,9,61,60,1,47
Dungannon,4373,5,12,10,8,57,42,15,46
Glenavon,4373,6,11,12,7,48,46,2,45
Coleraine,4373,7,9,12,9,45,43,2,39
Ards,4373,8,9,8,13,38,50,-12,35
Glentoran,4373,9,7,6,17,28,57,-29,27
Ballinamalla,4373,10,7,4,19,31,59,-28,25
Portadown,4373,11,5,8,17,26,48,-22,23
Crusaders,4374,1,17,5,8,60,36,24,56
Cliftonville,4374,2,17,4,9,61,43,18,55
Linfield,4374,3,15,9,6,65,28,37,54
Ballymena,4374,4,14,6,10,50,55,-5,48
Glenavon,4374,5,12,11,7,55,48,7,47
Coleraine,4374,6,12,8,10,46,40,6,44
Glentoran,4374,7,10,4,16,36,49,-13,34
Dungannon,4374,8,8,9,13,45,53,-8,33
Portadown,4374,9,9,5,16,24,47,-23,32
Ballinamalla,4374,10,10,1,19,41,64,-23,31
Ards,4374,11,6,8,16,35,55,-20,26
Linfield,4375,1,16,8,6,67,33,34,56
Ballymena,4375,2,17,4,9,58,54,4,55
Cliftonville,4375,3,15,5,10,53,43,10,50
Crusaders,4375,4,12,11,7,51,38,13,47
Coleraine,4375,5,11,10,9,38,39,-1,43
Glenavon,4375,6,10,11,9,44,42,2,41
Dungannon,4375,7,10,10,10,58,47,11,40
Glentoran,4375,8,9,9,12,32,44,-12,36
Ards,4375,9,7,8,15,39,52,-13,29
Portadown,4375,10,6,9,15,26,45,-19,27
Ballinamalla,4375,11,6,7,17,26,55,-29,25
Crusaders,4376,1,15,9,6,56,35,21,54
Cliftonville,4376,2,14,8,8,51,40,11,50
Linfield,4376,3,12,11,7,58,30,28,47
Ballymena,4376,4,14,5,11,59,59,0,47
Coleraine,4376,5,12,10,8,40,36,4,46
Glenavon,4376,6,11,11,8,47,45,2,44
Dungannon,4376,7,12,7,11,55,45,10,43
Glentoran,4376,8,8,10,12,33,47,-14,34
Ballinamalla,4376,9,9,4,17,33,56,-23,31
Ards,4376,10,8,6,16,35,50,-15,30
Portadown,4376,11,7,5,18,28,52,-24,26
Coleraine,4377,1,17,8,5,49,27,22,59
Crusaders,4377,2,16,10,4,56,34,22,58
Ballymena,4377,3,15,6,9,61,54,7,51
Cliftonville,4377,4,14,5,11,54,43,11,47
Linfield,4377,5,12,8,10,54,36,18,44
Glenavon,4377,6,9,11,10,43,52,-9,38
Dungannon,4377,7,9,9,12,47,48,-1,36
Ards,4377,8,9,7,14,39,51,-12,34
Glentoran,4377,9,8,8,14,29,42,-13,32
Ballinamalla,4377,10,8,4,18,29,50,-21,28
Portadown,4377,11,7,6,17,21,45,-24,27
Crusaders,4378,1,19,8,3,65,32,33,65
Linfield,4378,2,14,10,6,60,34,26,52
Glenavon,4378,3,14,10,6,56,43,13,52
Cliftonville,4378,4,15,3,12,54,47,7,48
Ballymena,4378,5,13,8,9,61,62,-1,47
Coleraine,4378,6,10,11,9,39,41,-2,41
Dungannon,4378,7,7,12,11,48,50,-2,33
Glentoran,4378,8,8,7,15,31,42,-11,31
Ballinamalla,4378,9,9,4,17,30,53,-23,31
Portadown,4378,10,6,8,16,26,48,-22,26
Ards,4378,11,6,7,17,35,53,-18,25
Linfield,4379,1,17,9,4,69,32,37,60
Cliftonville,4379,2,16,6,8,50,35,15,54
Crusaders,4379,3,15,7,8,56,41,15,52
Ballymena,4379,4,13,7,10,54,57,-3,46
Glenavon,4379,5,10,12,8,44,43,1,42
Coleraine,4379,6,11,8,11,42,39,3,41
Dungannon,4379,7,10,10,10,54,47,7,40
Ards,4379,8,11,5,14,36,45,-9,38
Portadown,4379,9,8,5,17,30,52,-22,29
Ballinamalla,4379,10,8,4,18,33,56,-23,28
Glentoran,4379,11,6,7,17,24,45,-21,25
Linfield,4380,1,17,7,6,71,33,38,58
Crusaders,4380,2,17,6,7,58,33,25,57
Cliftonville,4380,3,16,5,9,56,42,14,53
Ballymena,4380,4,15,5,10,54,63,-9,50
Dungannon,4380,5,12,10,8,63,39,24,46
Coleraine,4380,6,11,10,9,39,42,-3,43
Glenavon,4380,7,10,11,9,43,49,-6,41
Glentoran,4380,8,8,10,12,33,43,-10,34
Portadown,4380,9,8,6,16,29,44,-15,30
Ards,4380,10,7,4,19,32,57,-25,25
Ballinamalla,4380,11,5,4,21,28,61,-33,19
Linfield,4381,1,15,9,6,61,30,31,54
Dungannon,4381,2,14,9,7,57,43,14,51
Crusaders,4381,3,15,5,10,59,40,19,50
Cliftonville,4381,4,13,8,9,55,47,8,47
Ballymena,4381,5,14,5,11,66,69,-3,47
Glenavon,4381,6,12,10,8,52,52,0,46
Coleraine,4381,7,12,9,9,52,47,5,45
Glentoran,4381,8,8,9,13,27,42,-15,33
Ards,4381,9,8,6,16,36,52,-16,30
Portadown,4381,10,7,6,17,31,49,-18,27
Ballinamalla,4381,11,7,4,19,32,57,-25,25
Linfield,4382,1,19,7,4,65,28,37,64
Ballymena,4382,2,16,4,10,61,58,3,52
Cliftonville,4382,3,15,6,9,53,42,11,51
Crusaders,4382,4,14,8,8,54,37,17,50
Coleraine,4382,5,11,10,9,42,36,6,43
Dungannon,4382,6,10,11,9,49,43,6,41
Glenavon,4382,7,7,15,8,37,38,-1,36
Glentoran,4382,8,8,7,15,29,46,-17,31
Ards,4382,9,7,9,14,32,48,-16,30
Ballinamalla,4382,10,7,8,15,26,47,-21,29
Portadown,4382,11,5,7,18,17,42,-25,22
Crusaders,4383,1,19,5,6,65,36,29,62
Linfield,4383,2,18,6,6,67,34,33,60
Cliftonville,4383,3,18,2,10,54,36,18,56
Ballymena,4383,4,17,3,10,58,54,4,54
Glenavon,4383,5,13,9,8,54,52,2,48
Coleraine,4383,6,10,11,9,34,32,2,41
Glentoran,4383,7,10,6,14,39,49,-10,36
Ards,4383,8,8,5,17,38,55,-17,29
Portadown,4383,9,8,3,19,26,51,-25,27
Dungannon,4383,10,6,8,16,48,54,-6,26
Ballinamalla,4383,11,7,4,19,32,62,-30,25
Crusaders,4384,1,16,9,5,51,32,19,57
Coleraine,4384,2,14,10,6,50,32,18,52
Linfield,4384,3,14,9,7,52,30,22,51
Ballymena,4384,4,15,5,10,67,60,7,50
Cliftonville,4384,5,15,4,11,52,43,9,49
Dungannon,4384,6,12,9,9,53,42,11,45
Glenavon,4384,7,11,8,11,46,52,-6,41
Ballinamalla,4384,8,9,4,17,31,51,-20,31
Ards,4384,9,8,6,16,36,49,-13,30
Portadown,4384,10,7,5,18,23,48,-25,26
Glentoran,4384,11,6,7,17,25,47,-22,25
Cliftonville,4385,1,18,4,8,59,37,22,58
Ballymena,4385,2,17,4,9,67,56,11,55
Crusaders,4385,3,14,8,8,54,44,10,50
Glenavon,4385,4,13,9,8,42,44,-2,48
Linfield,4385,5,12,10,8,54,34,20,46
Coleraine,4385,6,11,10,9,48,43,5,43
Dungannon,4385,7,11,9,10,56,39,17,42
Ards,4385,8,9,6,15,37,53,-16,33
Glentoran,4385,9,9,6,15,27,46,-19,33
Portadown,4385,10,8,3,19,26,46,-20,27
Ballinamalla,4385,11,7,3,20,26,54,-28,24
Crusaders,4386,1,15,10,5,54,33,21,55
Ballymena,4386,2,16,5,9,55,48,7,53
Linfield,4386,3,12,12,6,60,33,27,48
Dungannon,4386,4,11,10,9,48,39,9,43
Cliftonville,4386,5,12,7,11,47,39,8,43
Coleraine,4386,6,10,11,9,34,37,-3,41
Ards,4386,7,12,3,15,39,48,-9,39
Glenavon,4386,8,9,11,10,38,42,-4,38
Glentoran,4386,9,9,9,12,28,39,-11,36
Ballinamalla,4386,10,9,4,17,25,45,-20,31
Portadown,4386,11,6,6,18,25,50,-25,24
Crusaders,4387,1,18,7,5,55,32,23,61
Cliftonville,4387,2,17,3,10,49,39,10,54
Linfield,4387,3,15,8,7,62,26,36,53
Coleraine,4387,4,13,8,9,47,40,7,47
Glenavon,4387,5,12,10,8,44,41,3,46
Ballymena,4387,6,13,6,11,52,54,-2,45
Dungannon,4387,7,11,6,13,48,44,4,39
Glentoran,4387,8,10,8,12,31,41,-10,38
Ballinamalla,4387,9,10,5,15,36,50,-14,35
Ards,4387,10,7,3,20,31,54,-23,24
Portadown,4387,11,5,4,21,19,53,-34,19
Crusaders,4388,1,17,6,7,54,35,19,57
Ballymena,4388,2,15,8,7,62,58,4,53
Cliftonville,4388,3,15,5,10,58,45,13,50
Linfield,4388,4,12,10,8,56,34,22,46
Dungannon,4388,5,12,7,11,52,44,8,43
Glenavon,4388,6,9,11,10,48,51,-3,38
Coleraine,4388,7,9,10,11,38,41,-3,37
Portadown,4388,8,11,4,15,26,38,-12,37
Ards,4388,9,10,5,15,38,52,-14,35
Glentoran,4388,10,8,8,14,30,40,-10,32
Ballinamalla,4388,11,8,4,18,32,56,-24,28
Linfield,4389,1,16,8,6,70,37,33,56
Cliftonville,4389,2,17,4,9,55,38,17,55
Crusaders,4389,3,15,7,8,53,37,16,52
Coleraine,4389,4,12,10,8,49,40,9,46
Ballymena,4389,5,13,7,10,55,58,-3,46
Glenavon,4389,6,10,12,8,51,49,2,42
Dungannon,4389,7,11,8,11,57,42,15,41
Ards,4389,8,12,3,15,45,53,-8,39
Glentoran,4389,9,8,9,13,32,49,-17,33
Ballinamalla,4389,10,6,6,18,30,62,-32,24
Portadown,4389,11,5,6,19,26,58,-32,21
Linfield,4390,1,16,9,5,61,27,34,57
Crusaders,4390,2,16,9,5,52,30,22,57
Coleraine,4390,3,13,10,7,43,40,3,49
Ballymena,4390,4,13,9,8,54,51,3,48
Glenavon,4390,5,11,12,7,43,41,2,45
Cliftonville,4390,6,12,8,10,52,42,10,44
Portadown,4390,7,10,4,16,28,42,-14,34
Glentoran,4390,8,8,9,13,26,42,-16,33
Dungannon,4390,9,8,8,14,41,40,1,32
Ballinamalla,4390,10,8,4,18,31,54,-23,28
Ards,4390,11,7,4,19,32,54,-22,25
Ballymena,4391,1,16,6,8,60,54,6,54
Linfield,4391,2,13,11,6,59,31,28,50
Crusaders,4391,3,13,11,6,54,38,16,50
Cliftonville,4391,4,15,4,11,52,39,13,49
Glenavon,4391,5,12,10,8,56,44,12,46
Coleraine,4391,6,11,9,10,39,42,-3,42
Dungannon,4391,7,9,12,9,43,38,5,39
Glentoran,4391,8,9,8,13,35,45,-10,35
Ards,4391,9,10,5,15,40,59,-19,35
Portadown,4391,10,7,5,18,20,45,-25,26
Ballinamalla,4391,11,6,7,17,31,54,-23,25
Crusaders,4392,1,18,8,4,56,27,29,62
Linfield,4392,2,15,11,4,60,29,31,56
Coleraine,4392,3,14,10,6,42,30,12,52
Ballymena,4392,4,15,7,8,60,57,3,52
Glenavon,4392,5,11,11,8,46,46,0,44
Cliftonville,4392,6,12,3,15,44,44,0,39
Dungannon,4392,7,9,10,11,48,41,7,37
Glentoran,4392,8,9,8,13,34,47,-13,35
Ards,4392,9,9,3,18,36,50,-14,30
Ballinamalla,4392,10,7,3,20,24,51,-27,24
Portadown,4392,11,5,8,17,18,46,-28,23
Crusaders,4393,1,16,8,6,49,29,20,56
Cliftonville,4393,2,16,4,10,49,39,10,52
Linfield,4393,3,13,11,6,52,32,20,50
Dungannon,4393,4,14,8,8,57,38,19,50
Coleraine,4393,5,13,10,7,50,39,11,49
Ballymena,4393,6,12,7,11,56,60,-4,43
Glenavon,4393,7,10,9,11,52,52,0,39
Glentoran,4393,8,10,8,12,29,43,-14,38
Ballinamalla,4393,9,9,3,18,28,47,-19,30
Ards,4393,10,7,4,19,35,52,-17,25
Portadown,4393,11,6,6,18,23,49,-26,24
Crusaders,4394,1,16,7,7,50,34,16,55
Linfield,4394,2,14,10,6,53,27,26,52
Cliftonville,4394,3,14,4,12,49,43,6,46
Ballymena,4394,4,14,4,12,60,64,-4,46
Glenavon,4394,5,12,9,9,49,44,5,45
Coleraine,4394,6,11,8,11,41,40,1,41
Ards,4394,7,12,4,14,42,47,-5,40
Dungannon,4394,8,10,9,11,50,46,4,39
Ballinamalla,4394,9,12,2,16,38,49,-11,38
Portadown,4394,10,10,5,15,27,43,-16,35
Glentoran,4394,11,5,8,17,29,51,-22,23
Cliftonville,4395,1,17,2,11,49,38,11,53
Linfield,4395,2,14,10,6,58,26,32,52
Coleraine,4395,3,13,13,4,47,33,14,52
Crusaders,4395,4,13,9,8,48,34,14,48
Ballymena,4395,5,14,6,10,57,58,-1,48
Glenavon,4395,6,11,11,8,43,42,1,44
Dungannon,4395,7,9,11,10,49,42,7,38
Ards,4395,8,9,8,13,37,52,-15,35
Ballinamalla,4395,9,9,3,18,31,49,-18,30
Glentoran,4395,10,7,7,16,30,46,-16,28
Portadown,4395,11,6,6,18,18,47,-29,24
Cliftonville,4396,1,18,4,8,63,34,29,58
Linfield,4396,2,15,10,5,62,31,31,55
Crusaders,4396,3,15,5,10,48,36,12,50
Dungannon,4396,4,13,10,7,62,40,22,49
Ballymena,4396,5,14,5,11,59,63,-4,47
Glenavon,4396,6,11,10,9,42,41,1,43
Coleraine,4396,7,11,9,10,43,39,4,42
Ards,4396,8,10,4,16,37,53,-16,34
Glentoran,4396,9,8,8,14,27,43,-16,32
Ballinamalla,4396,10,8,3,19,33,62,-29,27
Portadown,4396,11,5,6,19,20,54,-34,21
Crusaders,4397,1,19,7,4,57,29,28,64
Linfield,4397,2,17,8,5,69,35,34,59
Cliftonville,4397,3,17,5,8,53,37,16,56
Ballymena,4397,4,14,6,10,58,59,-1,48
Dungannon,4397,5,11,10,9,48,39,9,43
Glenavon,4397,6,10,11,9,48,44,4,41
Coleraine,4397,7,9,9,12,33,38,-5,36
Ballinamalla,4397,8,9,5,16,29,52,-23,32
Glentoran,4397,9,8,5,17,33,50,-17,29
Ards,4397,10,8,4,18,34,51,-17,28
Portadown,4397,11,5,6,19,25,53,-28,21
Glenavon,4398,1,14,11,5,59,43,16,53
Ballymena,4398,2,16,5,9,61,55,6,53
Cliftonville,4398,3,15,7,8,54,41,13,52
Linfield,4398,4,13,10,7,56,40,16,49
Crusaders,4398,5,13,9,8,54,40,14,48
Dungannon,4398,6,11,8,11,53,43,10,41
Coleraine,4398,7,10,9,11,42,42,0,39
Glentoran,4398,8,7,10,13,36,46,-10,31
Ards,4398,9,9,4,17,41,59,-18,31
Ballinamalla,4398,10,7,7,16,27,52,-25,28
Portadown,4398,11,7,6,17,25,47,-22,27
Crusaders,4399,1,17,9,4,59,33,26,60
Linfield,4399,2,14,11,5,61,34,27,53
Coleraine,4399,3,13,10,7,52,38,14,49
Cliftonville,4399,4,14,6,10,61,47,14,48
Ballymena,4399,5,12,9,9,57,63,-6,45
Glenavon,4399,6,9,12,9,41,45,-4,39
Dungannon,4399,7,9,9,12,48,46,2,36
Ards,4399,8,10,5,15,38,48,-10,35
Glentoran,4399,9,7,8,15,33,54,-21,29
Ballinamalla,4399,10,6,9,15,32,51,-19,27
Portadown,4399,11,6,8,16,26,49,-23,26
Crusaders,4400,1,17,7,6,59,35,24,58
Linfield,4400,2,16,9,5,66,31,35,57
Glenavon,4400,3,13,12,5,55,41,14,51
Cliftonville,4400,4,15,3,12,48,42,6,48
Ballymena,4400,5,12,9,9,53,55,-2,45
Coleraine,4400,6,10,11,9,37,37,0,41
Dungannon,4400,7,8,11,11,49,49,0,35
Portadown,4400,8,9,4,17,23,43,-20,31
Glentoran,4400,9,7,9,14,33,49,-16,30
Ards,4400,10,7,7,16,43,55,-12,28
Ballinamalla,4400,11,8,4,18,27,56,-29,28
Linfield,4401,1,16,8,6,64,33,31,56
Crusaders,4401,2,16,8,6,53,28,25,56
Cliftonville,4401,3,16,5,9,50,34,16,53
Coleraine,4401,4,12,12,6,40,32,8,48
Ballymena,4401,5,14,6,10,53,55,-2,48
Ards,4401,6,12,5,13,39,45,-6,41
Dungannon,4401,7,9,9,12,46,43,3,36
Glenavon,4401,8,6,15,9,37,43,-6,33
Glentoran,4401,9,8,8,14,28,44,-16,32
Portadown,4401,10,8,7,15,25,46,-21,31
Ballinamalla,4401,11,4,5,21,27,59,-32,17
Cliftonville,4402,1,18,5,7,55,30,25,59
Ballymena,4402,2,14,8,8,62,62,0,50
Crusaders,4402,3,12,12,6,44,33,11,48
Glentoran,4402,4,13,7,10,35,34,1,46
Dungannon,4402,5,12,9,9,56,40,16,45
Linfield,4402,6,11,11,8,52,37,15,44
Coleraine,4402,7,10,10,10,39,40,-1,40
Glenavon,4402,8,8,11,11,41,47,-6,35
Ards,4402,9,10,4,16,42,51,-9,34
Ballinamalla,4402,10,8,3,19,26,53,-27,27
Portadown,4402,11,7,4,19,25,50,-25,25
Linfield,4403,1,15,9,6,57,25,32,54
Cliftonville,4403,2,15,7,8,50,37,13,52
Crusaders,4403,3,14,8,8,51,34,17,50
Ballymena,4403,4,12,7,11,55,61,-6,43
Glenavon,4403,5,10,12,8,52,45,7,42
Portadown,4403,6,13,3,14,36,50,-14,42
Coleraine,4403,7,8,14,8,43,41,2,38
Ards,4403,8,10,5,15,34,48,-14,35
Dungannon,4403,9,8,9,13,46,48,-2,33
Glentoran,4403,10,8,9,13,31,42,-11,33
Ballinamalla,4403,11,10,1,19,27,51,-24,31
Crusaders,4404,1,16,8,6,52,32,20,56
Ballymena,4404,2,16,5,9,62,52,10,53
Coleraine,4404,3,14,9,7,47,33,14,51
Cliftonville,4404,4,14,5,11,49,41,8,47
Linfield,4404,5,11,12,7,52,33,19,45
Portadown,4404,6,14,3,13,31,33,-2,45
Glenavon,4404,7,9,12,9,41,42,-1,39
Dungannon,4404,8,9,8,13,45,47,-2,35
Ards,4404,9,9,5,16,37,51,-14,32
Ballinamalla,4404,10,9,3,18,34,57,-23,30
Glentoran,4404,11,6,6,18,23,52,-29,24
Crusaders,4405,1,16,7,7,53,38,15,55
Linfield,4405,2,15,9,6,53,31,22,54
Cliftonville,4405,3,16,5,9,54,33,21,53
Ballymena,4405,4,13,7,10,53,52,1,46
Glenavon,4405,5,11,11,8,46,42,4,44
Dungannon,4405,6,11,7,12,53,48,5,40
Coleraine,4405,7,9,11,10,44,46,-2,38
Portadown,4405,8,10,8,12,32,37,-5,38
Ards,4405,9,10,4,16,42,49,-7,34
Glentoran,4405,10,7,7,16,30,58,-28,28
Ballinamalla,4405,11,7,4,19,27,53,-26,25
Crusaders,4406,1,18,8,4,64,33,31,62
Linfield,4406,2,15,9,6,56,32,24,54
Cliftonville,4406,3,15,8,7,50,37,13,53
Ballymena,4406,4,13,7,10,59,59,0,46
Glenavon,4406,5,10,9,11,42,50,-8,39
Dungannon,4406,6,9,9,12,48,46,2,36
Glentoran,4406,7,9,9,12,37,47,-10,36
Ballinamalla,4406,8,11,2,17,36,50,-14,35
Coleraine,4406,9,7,13,10,40,43,-3,34
Ards,4406,10,8,5,17,35,52,-17,29
Portadown,4406,11,8,5,17,28,46,-18,29
Linfield,4407,1,13,13,4,59,31,28,52
Crusaders,4407,2,14,10,6,54,35,19,52
Ballymena,4407,3,14,8,8,57,48,9,50
Glenavon,4407,4,12,12,6,51,40,11,48
Coleraine,4407,5,11,11,8,40,41,-1,44
Cliftonville,4407,6,12,4,14,48,53,-5,40
Ards,4407,7,10,7,13,44,45,-1,37
Dungannon,4407,8,8,12,10,53,52,1,36
Portadown,4407,9,9,6,15,29,40,-11,33
Glentoran,4407,10,9,4,17,27,54,-27,31
Ballinamalla,4407,11,7,5,18,34,57,-23,26
Glenavon,4408,1,15,9,6,61,42,19,54
Crusaders,4408,2,14,9,7,45,34,11,51
Cliftonville,4408,3,14,8,8,53,38,15,50
Linfield,4408,4,12,11,7,56,36,20,47
Ballymena,4408,5,12,9,9,55,54,1,45
Coleraine,4408,6,11,11,8,39,36,3,44
Dungannon,4408,7,10,9,11,45,39,6,39
Ards,4408,8,9,6,15,40,50,-10,33
Glentoran,4408,9,6,11,13,33,52,-19,29
Ballinamalla,4408,10,8,4,18,29,50,-21,28
Portadown,4408,11,7,7,16,22,47,-25,28
Crusaders,4409,1,17,7,6,62,34,28,58
Linfield,4409,2,15,10,5,69,37,32,55
Cliftonville,4409,3,16,5,9,53,44,9,53
Ballymena,4409,4,14,7,9,64,56,8,49
Glenavon,4409,5,12,11,7,50,41,9,47
Coleraine,4409,6,11,9,10,39,43,-4,42
Glentoran,4409,7,11,6,13,34,49,-15,39
Dungannon,4409,8,8,8,14,48,53,-5,32
Ards,4409,9,8,6,16,38,49,-11,30
Ballinamalla,4409,10,7,4,19,28,52,-24,25
Portadown,4409,11,5,9,16,26,53,-27,24
Linfield,4410,1,18,7,5,65,33,32,61
Ballymena,4410,2,15,6,9,62,60,2,51
Cliftonville,4410,3,15,5,10,52,34,18,50
Coleraine,4410,4,13,11,6,38,31,7,50
Crusaders,4410,5,13,9,8,52,38,14,48
Glenavon,4410,6,12,12,6,50,45,5,48
Dungannon,4410,7,11,10,9,51,41,10,43
Glentoran,4410,8,8,9,13,36,48,-12,33
Ards,4410,9,8,4,18,33,54,-21,28
Portadown,4410,10,6,6,18,25,50,-25,24
Ballinamalla,4410,11,5,3,22,20,50,-30,18
Linfield,4411,1,15,9,6,58,32,26,54
Crusaders,4411,2,13,10,7,54,38,16,49
Ballymena,4411,3,13,8,9,59,55,4,47
Cliftonville,4411,4,13,6,11,43,38,5,45
Glenavon,4411,5,10,13,7,42,36,6,43
Dungannon,4411,6,9,13,8,43,36,7,40
Coleraine,4411,7,10,10,10,37,40,-3,40
Glentoran,4411,8,9,8,13,26,42,-16,35
Ballinamalla,4411,9,9,6,15,33,48,-15,33
Ards,4411,10,8,8,14,36,47,-11,32
Portadown,4411,11,7,7,16,26,45,-19,28
Cliftonville,4412,1,19,2,9,54,35,19,59
Linfield,4412,2,15,8,7,65,36,29,53
Crusaders,4412,3,14,8,8,49,30,19,50
Ballymena,4412,4,14,5,11,55,60,-5,47
Glenavon,4412,5,10,12,8,45,44,1,42
Dungannon,4412,6,10,10,10,48,39,9,40
Glentoran,4412,7,10,8,12,29,41,-12,38
Coleraine,4412,8,9,10,11,38,48,-10,37
Ards,4412,9,8,8,14,47,56,-9,32
Portadown,4412,10,8,5,17,31,47,-16,29
Ballinamalla,4412,11,7,6,17,33,58,-25,27
Ballymena,4413,1,16,8,6,69,53,16,56
Crusaders,4413,2,14,11,5,50,29,21,53
Cliftonville,4413,3,14,7,9,56,41,15,49
Linfield,4413,4,12,10,8,60,44,16,46
Glenavon,4413,5,11,9,10,46,43,3,42
Coleraine,4413,6,8,13,9,36,45,-9,37
Dungannon,4413,7,9,9,12,48,46,2,36
Glentoran,4413,8,8,10,12,32,44,-12,34
Ballinamalla,4413,9,10,4,16,29,46,-17,34
Ards,4413,10,8,9,13,38,48,-10,33
Portadown,4413,11,6,8,16,26,51,-25,26
Crusaders,4414,1,21,5,4,66,31,35,68
Glenavon,4414,2,15,9,6,52,42,10,54
Ballymena,4414,3,15,8,7,69,56,13,53
Linfield,4414,4,13,11,6,57,32,25,50
Cliftonville,4414,5,15,5,10,50,39,11,50
Coleraine,4414,6,10,10,10,39,38,1,40
Dungannon,4414,7,9,8,13,52,56,-4,35
Glentoran,4414,8,9,7,14,39,45,-6,34
Ards,4414,9,8,6,16,34,50,-16,30
Portadown,4414,10,6,6,18,28,54,-26,24
Ballinamalla,4414,11,5,3,22,23,66,-43,18
Crusaders,4415,1,21,6,3,67,26,41,69
Cliftonville,4415,2,16,4,10,56,40,16,52
Linfield,4415,3,13,10,7,63,47,16,49
Coleraine,4415,4,13,9,8,44,38,6,48
Ballymena,4415,5,14,5,11,67,61,6,47
Dungannon,4415,6,11,9,10,48,40,8,42
Glenavon,4415,7,10,9,11,44,51,-7,39
Ballinamalla,4415,8,11,2,17,29,50,-21,35
Glentoran,4415,9,8,6,16,31,54,-23,30
Ards,4415,10,8,3,19,32,48,-16,27
Portadown,4415,11,6,5,19,25,51,-26,23
Crusaders,4416,1,15,8,7,54,39,15,53
Ballymena,4416,2,15,7,8,61,50,11,52
Linfield,4416,3,15,6,9,58,38,20,51
Cliftonville,4416,4,15,5,10,49,34,15,50
Dungannon,4416,5,12,9,9,55,40,15,45
Coleraine,4416,6,10,11,9,37,43,-6,41
Glentoran,4416,7,11,8,11,32,38,-6,41
Glenavon,4416,8,10,9,11,48,51,-3,39
Ards,4416,9,10,7,13,48,49,-1,37
Ballinamalla,4416,10,6,6,18,25,55,-30,24
Portadown,4416,11,4,8,18,22,52,-30,20
Crusaders,4417,1,16,7,7,51,33,18,55
Glenavon,4417,2,14,9,7,53,42,11,51
Cliftonville,4417,3,14,8,8,48,35,13,50
Linfield,4417,4,13,10,7,57,36,21,49
Coleraine,4417,5,11,11,8,36,33,3,44
Ballymena,4417,6,12,7,11,53,56,-3,43
Ballinamalla,4417,7,10,5,15,34,47,-13,35
Dungannon,4417,8,8,9,13,52,52,0,33
Portadown,4417,9,9,5,16,27,46,-19,32
Ards,4417,10,8,7,15,37,50,-13,31
Glentoran,4417,11,7,8,15,25,43,-18,29
Crusaders,4418,1,20,5,5,61,29,32,65
Linfield,4418,2,18,7,5,64,28,36,61
Cliftonville,4418,3,17,5,8,51,36,15,56
Coleraine,4418,4,12,8,10,42,43,-1,44
Dungannon,4418,5,11,8,11,51,48,3,41
Glenavon,4418,6,10,11,9,47,44,3,41
Ballymena,4418,7,12,5,13,55,63,-8,41
Glentoran,4418,8,10,5,15,28,41,-13,35
Ards,4418,9,10,3,17,41,51,-10,33
Ballinamalla,4418,10,8,3,19,29,53,-24,27
Portadown,4418,11,5,4,21,27,60,-33,19
Crusaders,4419,1,16,6,8,52,33,19,54
Linfield,4419,2,15,6,9,66,38,28,51
Coleraine,4419,3,14,9,7,48,36,12,51
Cliftonville,4419,4,15,3,12,53,48,5,48
Ballymena,4419,5,14,6,10,52,60,-8,48
Dungannon,4419,6,12,8,10,53,43,10,44
Glenavon,4419,7,9,10,11,43,49,-6,37
Portadown,4419,8,10,5,15,30,42,-12,35
Ards,4419,9,10,3,17,40,47,-7,33
Glentoran,4419,10,8,8,14,28,44,-16,32
Ballinamalla,4419,11,8,4,18,23,48,-25,28
Crusaders,4420,1,15,9,6,60,37,23,54
Linfield,4420,2,14,10,6,58,33,25,52
Cliftonville,4420,3,15,6,9,49,32,17,51
Coleraine,4420,4,13,10,7,49,36,13,49
Dungannon,4420,5,13,7,10,56,40,16,46
Ballymena,4420,6,12,6,12,62,62,0,42
Glentoran,4420,7,10,10,10,36,42,-6,40
Glenavon,4420,8,9,12,9,45,58,-13,39
Portadown,4420,9,8,7,15,23,46,-23,31
Ards,4420,10,8,5,17,34,49,-15,29
Ballinamalla,4420,11,3,8,19,28,65,-37,17
Crusaders,4421,1,19,6,5,61,28,33,63
Linfield,4421,2,14,9,7,63,35,28,51
Coleraine,4421,3,14,9,7,49,39,10,51
Cliftonville,4421,4,12,8,10,44,38,6,44
Glenavon,4421,5,11,10,9,54,46,8,43
Ballymena,4421,6,11,5,14,48,63,-15,38
Dungannon,4421,7,10,7,13,42,44,-2,37
Ards,4421,8,9,9,12,40,49,-9,36
Glentoran,4421,9,8,9,13,29,41,-12,33
Ballinamalla,4421,10,8,6,16,30,52,-22,30
Portadown,4421,11,5,10,15,21,46,-25,25
Crusaders,4422,1,16,7,7,57,28,29,55
Ards,4422,2,15,4,11,38,37,1,49
Glenavon,4422,3,13,8,9,50,44,6,47
Linfield,4422,4,10,13,7,53,32,21,43
Cliftonville,4422,5,12,7,11,50,39,11,43
Ballymena,4422,6,12,7,11,53,65,-12,43
Coleraine,4422,7,10,12,8,41,36,5,42
Dungannon,4422,8,9,9,12,45,49,-4,36
Glentoran,4422,9,8,10,12,24,40,-16,34
Portadown,4422,10,7,10,13,28,41,-13,31
Ballinamalla,4422,11,7,5,18,28,56,-28,26
Linfield,4423,1,21,7,2,63,20,43,70
Crusaders,4423,2,17,6,7,58,34,24,57
Cliftonville,4423,3,16,4,10,56,41,15,52
Ballymena,4423,4,14,7,9,58,61,-3,49
Coleraine,4423,5,13,9,8,44,37,7,48
Dungannon,4423,6,9,9,12,48,47,1,36
Ards,4423,7,10,4,16,34,46,-12,34
Glenavon,4423,8,6,13,11,46,53,-7,31
Glentoran,4423,9,7,8,15,33,51,-18,29
Ballinamalla,4423,10,7,5,18,32,54,-22,26
Portadown,4423,11,6,6,18,22,50,-28,24
Crusaders,4424,1,18,6,6,63,43,20,60
Linfield,4424,2,15,9,6,63,33,30,54
Cliftonville,4424,3,16,3,11,57,49,8,51
Dungannon,4424,4,13,8,9,56,39,17,47
Glenavon,4424,5,11,10,9,55,49,6,43
Coleraine,4424,6,9,13,8,42,39,3,40
Ards,4424,7,11,6,13,35,40,-5,39
Ballymena,4424,8,10,7,13,50,64,-14,37
Glentoran,4424,9,9,9,12,29,41,-12,36
Portadown,4424,10,7,8,15,26,45,-19,29
Ballinamalla,4424,11,5,3,22,22,56,-34,18
Crusaders,4425,1,18,8,4,56,31,25,62
Cliftonville,4425,2,17,4,9,62,39,23,55
Linfield,4425,3,15,8,7,59,27,32,53
Ballymena,4425,4,14,5,11,53,57,-4,47
Glenavon,4425,5,10,13,7,53,48,5,43
Coleraine,4425,6,11,10,9,41,36,5,43
Dungannon,4425,7,11,9,10,50,43,7,42
Glentoran,4425,8,9,10,11,31,39,-8,37
Ards,4425,9,8,6,16,29,44,-15,30
Ballinamalla,4425,10,6,5,19,24,57,-33,23
Portadown,4425,11,4,6,20,19,56,-37,18
Crusaders,4426,1,16,8,6,60,33,27,56
Linfield,4426,2,14,11,5,58,33,25,53
Cliftonville,4426,3,15,7,8,54,35,19,52
Glentoran,4426,4,12,8,10,37,42,-5,44
Glenavon,4426,5,10,13,7,47,43,4,43
Ballymena,4426,6,12,6,12,55,71,-16,42
Dungannon,4426,7,9,11,10,49,43,6,38
Coleraine,4426,8,8,13,9,34,36,-2,37
Portadown,4426,9,9,6,15,33,43,-10,33
Ards,4426,10,6,7,17,31,50,-19,25
Ballinamalla,4426,11,7,4,19,29,58,-29,25
Cliftonville,4427,1,17,3,10,58,47,11,54
Crusaders,4427,2,15,7,8,50,33,17,52
Linfield,4427,3,14,9,7,62,38,24,51
Ballymena,4427,4,15,5,10,57,56,1,50
Glenavon,4427,5,12,10,8,48,44,4,46
Coleraine,4427,6,12,8,10,45,40,5,44
Glentoran,4427,7,11,8,11,36,42,-6,41
Dungannon,4427,8,8,10,12,48,47,1,34
Ballinamalla,4427,9,6,11,13,26,44,-18,29
Ards,4427,10,7,6,17,36,52,-16,27
Portadown,4427,11,8,3,19,23,46,-23,27
Crusaders,4428,1,18,5,7,54,32,22,59
Linfield,4428,2,15,9,6,63,32,31,54
Cliftonville,4428,3,15,6,9,51,38,13,51
Dungannon,4428,4,14,7,9,55,36,19,49
Ballymena,4428,5,14,6,10,55,62,-7,48
Coleraine,4428,6,11,11,8,44,40,4,44
Glenavon,4428,7,10,9,11,46,50,-4,39
Ballinamalla,4428,8,10,4,16,34,51,-17,34
Glentoran,4428,9,7,9,14,29,44,-15,30
Ards,4428,10,8,5,17,32,51,-19,29
Portadown,4428,11,6,3,21,23,50,-27,21
Crusaders,4429,1,17,7,6,61,38,23,58
Cliftonville,4429,2,15,4,11,49,43,6,49
Dungannon,4429,3,13,9,8,56,40,16,48
Coleraine,4429,4,12,8,10,45,43,2,44
Glenavon,4429,5,11,10,9,52,51,1,43
Linfield,4429,6,11,9,10,55,39,16,42
Ballinamalla,4429,7,12,4,14,38,47,-9,40
Glentoran,4429,8,11,6,13,33,45,-12,39
Ballymena,4429,9,11,5,14,58,63,-5,38
Ards,4429,10,9,4,17,39,54,-15,31
Portadown,4429,11,7,6,17,27,50,-23,27
Crusaders,4430,1,17,7,6,64,37,27,58
Linfield,4430,2,16,9,5,55,27,28,57
Cliftonville,4430,3,18,3,9,59,38,21,57
Glenavon,4430,4,16,7,7,52,42,10,55
Coleraine,4430,5,12,10,8,45,38,7,46
Ballymena,4430,6,10,11,9,44,53,-9,41
Dungannon,4430,7,10,10,10,49,43,6,40
Glentoran,4430,8,7,9,14,32,54,-22,30
Ards,4430,9,8,4,18,39,52,-13,28
Ballinamalla,4430,10,6,5,19,27,52,-25,23
Portadown,4430,11,5,5,20,25,55,-30,20
Linfield,4431,1,16,9,5,69,34,35,57
Crusaders,4431,2,15,7,8,50,40,10,52
Glenavon,4431,3,13,12,5,56,40,16,51
Cliftonville,4431,4,14,6,10,52,42,10,48
Ballymena,4431,5,14,4,12,55,58,-3,46
Dungannon,4431,6,12,8,10,56,46,10,44
Glentoran,4431,7,9,9,12,34,38,-4,36
Coleraine,4431,8,8,12,10,33,40,-7,36
Ards,4431,9,10,4,16,38,53,-15,34
Portadown,4431,10,7,7,16,22,47,-25,28
Ballinamalla,4431,11,6,4,20,30,57,-27,22
Crusaders,4432,1,17,7,6,50,30,20,58
Linfield,4432,2,15,11,4,60,25,35,56
Cliftonville,4432,3,16,4,10,53,40,13,52
Glenavon,4432,4,13,8,9,51,50,1,47
Ballymena,4432,5,12,8,10,58,56,2,44
Glentoran,4432,6,11,7,12,33,43,-10,40
Coleraine,4432,7,9,8,13,38,42,-4,35
Dungannon,4432,8,8,10,12,48,49,-1,34
Portadown,4432,9,8,7,15,30,48,-18,31
Ards,4432,10,9,3,18,38,56,-18,30
Ballinamalla,4432,11,8,5,17,31,51,-20,29
Crusaders,4433,1,15,10,5,49,28,21,55
Linfield,4433,2,15,7,8,66,34,32,52
Ballymena,4433,3,15,4,11,56,60,-4,49
Cliftonville,4433,4,14,5,11,56,39,17,47
Glenavon,4433,5,11,9,10,46,49,-3,42
Coleraine,4433,6,10,11,9,44,45,-1,41
Glentoran,4433,7,9,9,12,34,44,-10,36
Dungannon,4433,8,9,8,13,42,45,-3,35
Ballinamalla,4433,9,10,5,15,33,48,-15,35
Ards,4433,10,9,6,15,34,45,-11,33
Portadown,4433,11,9,4,17,26,49,-23,31
Cliftonville,4434,1,17,6,7,58,37,21,57
Glenavon,4434,2,16,8,6,50,40,10,56
Linfield,4434,3,14,9,7,54,32,22,51
Coleraine,4434,4,14,8,8,45,32,13,50
Crusaders,4434,5,13,10,7,51,37,14,49
Ballymena,4434,6,12,8,10,56,56,0,44
Dungannon,4434,7,9,8,13,49,46,3,35
Ards,4434,8,8,5,17,34,51,-17,29
Portadown,4434,9,8,5,17,27,48,-21,29
Glentoran,4434,10,6,10,14,25,44,-19,28
Ballinamalla,4434,11,8,3,19,25,51,-26,27
Crusaders,4435,1,18,5,7,57,32,25,59
Ballymena,4435,2,17,4,9,65,56,9,55
Glenavon,4435,3,13,9,8,51,43,8,48
Linfield,4435,4,12,9,9,60,48,12,45
Cliftonville,4435,5,13,6,11,52,43,9,45
Dungannon,4435,6,12,7,11,56,48,8,43
Glentoran,4435,7,12,6,12,38,43,-5,42
Coleraine,4435,8,10,9,11,47,54,-7,39
Ards,4435,9,9,7,14,41,47,-6,34
Portadown,4435,10,8,5,17,26,46,-20,29
Ballinamalla,4435,11,4,7,19,23,56,-33,19
Crusaders,4436,1,17,8,5,55,28,27,59
Cliftonville,4436,2,18,5,7,53,34,19,59
Coleraine,4436,3,13,9,8,46,38,8,48
Linfield,4436,4,12,10,8,57,34,23,46
Ballymena,4436,5,13,7,10,60,65,-5,46
Glenavon,4436,6,9,12,9,42,46,-4,39
Dungannon,4436,7,8,13,9,46,44,2,37
Ballinamalla,4436,8,10,4,16,29,44,-15,34
Ards,4436,9,9,3,18,37,48,-11,30
Glentoran,4436,10,7,7,16,30,49,-19,28
Portadown,4436,11,7,6,17,27,52,-25,27
Crusaders,4437,1,20,7,3,63,32,31,67
Cliftonville,4437,2,17,5,8,56,32,24,56
Linfield,4437,3,14,9,7,53,28,25,51
Ballymena,4437,4,12,8,10,54,59,-5,44
Glenavon,4437,5,10,10,10,48,48,0,40
Coleraine,4437,6,10,10,10,36,38,-2,40
Portadown,4437,7,11,6,13,30,41,-11,39
Glentoran,4437,8,8,9,13,34,43,-9,33
Ards,4437,9,9,4,17,38,53,-15,31
Dungannon,4437,10,7,9,14,42,48,-6,30
Ballinamalla,4437,11,6,5,19,24,56,-32,23
Coleraine,4438,1,18,7,5,55,34,21,61
Crusaders,4438,2,17,6,7,64,40,24,57
Cliftonville,4438,3,15,5,10,52,38,14,50
Dungannon,4438,4,11,11,8,52,41,11,44
Glenavon,4438,5,11,10,9,50,44,6,43
Linfield,4438,6,10,12,8,49,38,11,42
Ballymena,4438,7,11,6,13,53,65,-12,39
Ards,4438,8,11,5,14,35,45,-10,38
Glentoran,4438,9,9,6,15,30,49,-19,33
Ballinamalla,4438,10,8,4,18,27,49,-22,28
Portadown,4438,11,6,4,20,22,46,-24,22
Crusaders,4439,1,18,9,3,60,36,24,63
Cliftonville,4439,2,16,5,9,55,41,14,53
Linfield,4439,3,14,7,9,60,41,19,49
Ballymena,4439,4,14,6,10,57,60,-3,48
Glenavon,4439,5,13,8,9,53,51,2,47
Coleraine,4439,6,12,7,11,46,39,7,43
Dungannon,4439,7,9,10,11,55,51,4,37
Glentoran,4439,8,8,10,12,43,54,-11,34
Ards,4439,9,9,6,15,38,50,-12,33
Ballinamalla,4439,10,8,5,17,38,54,-16,29
Portadown,4439,11,6,3,21,28,56,-28,21
Crusaders,4440,1,17,9,4,62,35,27,60
Ballymena,4440,2,16,5,9,62,59,3,53
Glenavon,4440,3,13,11,6,48,40,8,50
Linfield,4440,4,13,9,8,60,37,23,48
Cliftonville,4440,5,13,7,10,49,38,11,46
Glentoran,4440,6,13,7,10,32,32,0,46
Dungannon,4440,7,10,9,11,54,45,9,39
Coleraine,4440,8,9,11,10,40,42,-2,38
Ards,4440,9,9,3,18,41,58,-17,30
Ballinamalla,4440,10,7,5,18,29,57,-28,26
Portadown,4440,11,4,6,20,22,56,-34,18
Crusaders,4441,1,16,7,7,64,39,25,55
Ballymena,4441,2,16,5,9,67,56,11,53
Linfield,4441,3,13,12,5,57,27,30,51
Cliftonville,4441,4,13,8,9,50,47,3,47
Coleraine,4441,5,11,11,8,39,33,6,44
Dungannon,4441,6,10,9,11,53,50,3,39
Glenavon,4441,7,9,12,9,43,46,-3,39
Glentoran,4441,8,10,7,13,37,50,-13,37
Ards,4441,9,9,5,16,38,49,-11,32
Ballinamalla,4441,10,8,4,18,36,65,-29,28
Portadown,4441,11,7,6,17,25,47,-22,27
Linfield,4442,1,16,10,4,67,25,42,58
Glenavon,4442,2,15,12,3,54,34,20,57
Cliftonville,4442,3,16,6,8,61,36,25,54
Crusaders,4442,4,14,9,7,60,44,16,51
Coleraine,4442,5,11,11,8,40,37,3,44
Ballymena,4442,6,13,5,12,51,62,-11,44
Dungannon,4442,7,8,11,11,49,49,0,35
Glentoran,4442,8,9,8,13,35,52,-17,35
Ards,4442,9,7,6,17,29,48,-19,27
Ballinamalla,4442,10,7,5,18,28,51,-23,26
Portadown,4442,11,6,3,21,20,56,-36,21
Crusaders,4443,1,18,8,4,53,24,29,62
Linfield,4443,2,14,11,5,61,34,27,53
Coleraine,4443,3,14,10,6,53,32,21,52
Ballymena,4443,4,15,6,9,60,59,1,51
Cliftonville,4443,5,14,3,13,53,48,5,45
Glenavon,4443,6,9,11,10,40,44,-4,38
Ballinamalla,4443,7,9,6,15,34,49,-15,33
Ards,4443,8,9,5,16,36,50,-14,32
Glentoran,4443,9,8,8,14,23,40,-17,32
Dungannon,4443,10,7,10,13,46,53,-7,31
Portadown,4443,11,7,4,19,25,51,-26,25
Linfield,4444,1,17,6,7,64,32,32,57
Cliftonville,4444,2,16,6,8,57,38,19,54
Crusaders,4444,3,15,8,7,51,33,18,53
Glenavon,4444,4,12,12,6,50,43,7,48
Ballymena,4444,5,13,9,8,57,57,0,48
Coleraine,4444,6,10,15,5,45,41,4,45
Glentoran,4444,7,9,8,13,27,44,-17,35
Ards,4444,8,10,4,16,39,46,-7,34
Dungannon,4444,9,6,12,12,46,53,-7,30
Portadown,4444,10,6,5,19,35,59,-24,23
Ballinamalla,4444,11,5,7,18,24,49,-25,22
Crusaders,4445,1,19,5,6,54,23,31,62
Linfield,4445,2,15,8,7,58,33,25,53
Glenavon,4445,3,12,12,6,50,40,10,48
Ballymena,4445,4,13,8,9,53,56,-3,47
Cliftonville,4445,5,13,5,12,49,42,7,44
Coleraine,4445,6,11,9,10,38,37,1,42
Dungannon,4445,7,10,11,9,47,42,5,41
Ards,4445,8,10,4,16,36,51,-15,34
Glentoran,4445,9,9,6,15,29,46,-17,33
Ballinamalla,4445,10,8,3,19,37,58,-21,27
Portadown,4445,11,6,7,17,22,45,-23,25
Crusaders,4446,1,18,8,4,64,36,28,62
Glenavon,4446,2,14,10,6,55,42,13,52
Linfield,4446,3,13,12,5,57,31,26,51
Cliftonville,4446,4,15,6,9,54,39,15,51
Ballymena,4446,5,13,6,11,63,59,4,45
Dungannon,4446,6,10,11,9,54,42,12,41
Coleraine,4446,7,9,11,10,40,45,-5,38
Ards,4446,8,9,5,16,32,50,-18,32
Portadown,4446,9,8,6,16,27,43,-16,30
Glentoran,4446,10,7,7,16,29,54,-25,28
Ballinamalla,4446,11,6,4,20,29,63,-34,22
Crusaders,4447,1,17,7,6,59,38,21,58
Cliftonville,4447,2,16,4,10,53,38,15,52
Linfield,4447,3,14,8,8,58,32,26,50
Ballymena,4447,4,14,7,9,61,56,5,49
Coleraine,4447,5,10,12,8,40,33,7,42
Ballinamalla,4447,6,12,4,14,36,44,-8,40
Dungannon,4447,7,10,8,12,48,47,1,38
Glenavon,4447,8,9,11,10,43,53,-10,38
Ards,4447,9,8,7,15,34,50,-16,31
Portadown,4447,10,8,5,17,22,40,-18,29
Glentoran,4447,11,7,7,16,28,51,-23,28
Crusaders,4448,1,17,7,6,56,31,25,58
Glenavon,4448,2,14,12,4,60,39,21,54
Linfield,4448,3,14,9,7,61,35,26,51
Ballymena,4448,4,14,8,8,62,62,0,50
Cliftonville,4448,5,14,5,11,54,48,6,47
Dungannon,4448,6,11,10,9,53,42,11,43
Coleraine,4448,7,10,11,9,43,40,3,41
Glentoran,4448,8,9,6,15,34,52,-18,33
Ballinamalla,4448,9,8,4,18,28,53,-25,28
Ards,4448,10,7,4,19,39,56,-17,25
Portadown,4448,11,5,8,17,27,59,-32,23
Cliftonville,4449,1,16,5,9,53,51,2,53
Crusaders,4449,2,15,7,8,55,35,20,52
Ballymena,4449,3,15,4,11,63,56,7,49
Coleraine,4449,4,13,9,8,42,34,8,48
Glenavon,4449,5,13,8,9,56,50,6,47
Linfield,4449,6,12,8,10,55,36,19,44
Glentoran,4449,7,12,6,12,33,39,-6,42
Dungannon,4449,8,8,11,11,47,44,3,35
Ards,4449,9,10,4,16,42,59,-17,34
Portadown,4449,10,8,5,17,30,52,-22,29
Ballinamalla,4449,11,7,5,18,32,52,-20,26
Linfield,4450,1,16,10,4,69,30,39,58
Glenavon,4450,2,14,12,4,51,38,13,54
Ballymena,4450,3,16,5,9,66,57,9,53
Cliftonville,4450,4,15,5,10,55,47,8,50
Crusaders,4450,5,13,10,7,52,39,13,49
Coleraine,4450,6,11,13,6,44,34,10,46
Dungannon,4450,7,10,8,12,48,46,2,38
Ballinamalla,4450,8,9,4,17,32,55,-23,31
Glentoran,4450,9,6,9,15,23,44,-21,27
Ards,4450,10,6,6,18,30,51,-21,24
Portadown,4450,11,5,6,19,19,48,-29,21
Crusaders,4451,1,19,8,3,55,26,29,65
Linfield,4451,2,16,9,5,68,39,29,57
Cliftonville,4451,3,15,5,10,50,41,9,50
Ballymena,4451,4,13,8,9,62,57,5,47
Glenavon,4451,5,10,13,7,46,46,0,43
Coleraine,4451,6,10,11,9,46,44,2,41
Dungannon,4451,7,10,9,11,46,41,5,39
Ards,4451,8,9,3,18,39,45,-6,30
Ballinamalla,4451,9,8,5,17,28,53,-25,29
Glentoran,4451,10,7,6,17,30,53,-23,27
Portadown,4451,11,7,5,18,22,47,-25,26
Crusaders,4452,1,17,7,6,53,37,16,58
Linfield,4452,2,16,9,5,65,36,29,57
Ballymena,4452,3,15,3,12,65,64,1,48
Glenavon,4452,4,12,11,7,49,37,12,47
Coleraine,4452,5,12,10,8,39,42,-3,46
Cliftonville,4452,6,13,5,12,51,41,10,44
Dungannon,4452,7,11,7,12,48,41,7,40
Ards,4452,8,11,4,15,40,48,-8,37
Ballinamalla,4452,9,8,5,17,32,51,-19,29
Glentoran,4452,10,7,7,16,31,51,-20,28
Portadown,4452,11,7,4,19,25,50,-25,25
Crusaders,4453,1,16,7,7,52,32,20,55
Linfield,4453,2,15,8,7,61,33,28,53
Cliftonville,4453,3,16,4,10,52,37,15,52
Ballymena,4453,4,15,6,9,62,59,3,51
Coleraine,4453,5,9,12,9,36,33,3,39
Ballinamalla,4453,6,12,3,15,35,50,-15,39
Dungannon,4453,7,8,13,9,48,47,1,37
Glenavon,4453,8,8,12,10,42,50,-8,36
Glentoran,4453,9,9,8,13,38,46,-8,35
Portadown,4453,10,8,8,14,26,41,-15,32
Ards,4453,11,7,3,20,32,56,-24,24
Linfield,4454,1,15,11,4,56,24,32,56
Coleraine,4454,2,13,10,7,44,35,9,49
Cliftonville,4454,3,14,6,10,52,39,13,48
Ballymena,4454,4,13,8,9,51,55,-4,47
Crusaders,4454,5,12,10,8,47,37,10,46
Glenavon,4454,6,10,14,6,50,43,7,44
Ards,4454,7,10,8,12,36,37,-1,38
Glentoran,4454,8,9,9,12,30,44,-14,36
Dungannon,4454,9,8,9,13,40,42,-2,33
Portadown,4454,10,7,5,18,22,50,-28,26
Ballinamalla,4454,11,7,4,19,24,46,-22,25
Crusaders,4455,1,16,9,5,54,34,20,57
Cliftonville,4455,2,15,8,7,57,37,20,53
Linfield,4455,3,13,10,7,54,32,22,49
Coleraine,4455,4,12,12,6,47,38,9,48
Ballymena,4455,5,13,4,13,59,62,-3,43
Dungannon,4455,6,10,10,10,49,42,7,40
Glenavon,4455,7,8,14,8,42,44,-2,38
Ballinamalla,4455,8,10,5,15,34,48,-14,35
Glentoran,4455,9,8,9,13,27,43,-16,33
Ards,4455,10,8,8,14,38,50,-12,32
Portadown,4455,11,4,7,19,20,51,-31,19
Crusaders,4456,1,16,7,7,54,32,22,55
Linfield,4456,2,15,8,7,64,35,29,53
Ballymena,4456,3,16,4,10,59,58,1,52
Cliftonville,4456,4,15,5,10,45,35,10,50
Dungannon,4456,5,11,8,11,53,47,6,41
Coleraine,4456,6,9,13,8,38,38,0,40
Glenavon,4456,7,10,10,10,39,48,-9,40
Ards,4456,8,11,5,14,45,46,-1,38
Glentoran,4456,9,9,8,13,29,43,-14,35
Portadown,4456,10,9,5,16,32,45,-13,32
Ballinamalla,4456,11,5,5,20,25,56,-31,20
Linfield,4457,1,15,9,6,58,29,29,54
Crusaders,4457,2,14,9,7,56,39,17,51
Coleraine,4457,3,13,11,6,50,39,11,50
Ballymena,4457,4,15,5,10,57,56,1,50
Glenavon,4457,5,11,13,6,59,53,6,46
Cliftonville,4457,6,13,6,11,50,43,7,45
Glentoran,4457,7,10,10,10,37,47,-10,40
Dungannon,4457,8,8,11,11,48,43,5,35
Ards,4457,9,8,6,16,36,51,-15,30
Portadown,4457,10,7,5,18,24,47,-23,26
Ballinamalla,4457,11,6,5,19,29,57,-28,23
Crusaders,4458,1,18,7,5,57,30,27,61
Cliftonville,4458,2,17,6,7,58,37,21,57
Ballymena,4458,3,16,7,7,62,56,6,55
Linfield,4458,4,14,9,7,55,30,25,51
Glenavon,4458,5,10,11,9,48,45,3,41
Dungannon,4458,6,9,9,12,44,46,-2,36
Glentoran,4458,7,10,6,14,40,53,-13,36
Coleraine,4458,8,8,10,12,45,49,-4,34
Portadown,4458,9,8,6,16,25,42,-17,30
Ards,4458,10,9,3,18,35,57,-22,30
Ballinamalla,4458,11,7,4,19,31,55,-24,25
Linfield,4459,1,16,10,4,63,27,36,58
Crusaders,4459,2,17,7,6,60,38,22,58
Glenavon,4459,3,15,10,5,50,37,13,55
Ballymena,4459,4,15,6,9,62,59,3,51
Cliftonville,4459,5,13,4,13,50,44,6,43
Dungannon,4459,6,10,9,11,53,42,11,39
Glentoran,4459,7,10,7,13,31,41,-10,37
Ards,4459,8,10,5,15,32,44,-12,35
Coleraine,4459,9,8,8,14,34,46,-12,32
Portadown,4459,10,8,7,15,28,49,-21,31
Ballinamalla,4459,11,4,5,21,25,61,-36,17
Linfield,4460,1,16,9,5,61,32,29,57
Crusaders,4460,2,16,9,5,57,33,24,57
Ballymena,4460,3,14,8,8,64,60,4,50
Glenavon,4460,4,12,11,7,51,44,7,47
Coleraine,4460,5,11,11,8,50,46,4,44
Glentoran,4460,6,13,5,12,42,46,-4,44
Cliftonville,4460,7,13,4,13,45,41,4,43
Dungannon,4460,8,11,8,11,51,41,10,41
Ards,4460,9,9,7,14,34,45,-11,34
Ballinamalla,4460,10,6,3,21,25,61,-36,21
Portadown,4460,11,5,3,22,22,53,-31,18
Linfield,4461,1,17,8,5,76,33,43,59
Crusaders,4461,2,17,7,6,53,35,18,58
Ballymena,4461,3,15,6,9,54,56,-2,51
Dungannon,4461,4,14,7,9,56,39,17,49
Cliftonville,4461,5,15,4,11,58,43,15,49
Glenavon,4461,6,12,10,8,46,42,4,46
Coleraine,4461,7,11,10,9,46,41,5,43
Glentoran,4461,8,10,5,15,31,49,-18,35
Portadown,4461,9,7,5,18,24,50,-26,26
Ballinamalla,4461,10,7,3,20,29,56,-27,24
Ards,4461,11,4,7,19,29,58,-29,19
Crusaders,4462,1,15,8,7,52,34,18,53
Cliftonville,4462,2,15,7,8,51,38,13,52
Ballymena,4462,3,15,5,10,59,58,1,50
Linfield,4462,4,13,8,9,55,31,24,47
Coleraine,4462,5,12,11,7,44,36,8,47
Dungannon,4462,6,12,9,9,51,38,13,45
Ards,4462,7,12,6,12,38,42,-4,42
Glenavon,4462,8,10,9,11,41,50,-9,39
Ballinamalla,4462,9,8,7,15,36,47,-11,31
Glentoran,4462,10,5,9,16,29,56,-27,24
Portadown,4462,11,6,5,19,23,49,-26,23
Crusaders,4463,1,17,4,9,54,34,20,55
Glenavon,4463,2,15,8,7,50,43,7,53
Coleraine,4463,3,14,8,8,47,36,11,50
Ballymena,4463,4,14,5,11,65,60,5,47
Cliftonville,4463,5,14,4,12,47,40,7,46
Linfield,4463,6,11,10,9,50,32,18,43
Glentoran,4463,7,12,7,11,29,37,-8,43
Dungannon,4463,8,11,7,12,49,48,1,40
Ards,4463,9,11,3,16,39,45,-6,36
Portadown,4463,10,8,6,16,25,47,-22,30
Ballinamalla,4463,11,5,4,21,24,57,-33,19
Crusaders,4464,1,16,6,8,61,40,21,54
Linfield,4464,2,15,8,7,59,34,25,53
Coleraine,4464,3,14,8,8,44,33,11,50
Cliftonville,4464,4,13,7,10,51,44,7,46
Ballymena,4464,5,13,5,12,59,56,3,44
Ballinamalla,4464,6,13,4,13,33,45,-12,43
Dungannon,4464,7,8,12,10,47,43,4,36
Glenavon,4464,8,9,9,12,40,50,-10,36
Ards,4464,9,11,3,16,37,47,-10,36
Portadown,4464,10,9,5,16,24,40,-16,32
Glentoran,4464,11,8,5,17,30,53,-23,29
Crusaders,4465,1,19,6,5,60,31,29,63
Linfield,4465,2,16,9,5,70,33,37,57
Cliftonville,4465,3,17,3,10,50,37,13,54
Ballymena,4465,4,15,5,10,58,53,5,50
Dungannon,4465,5,10,10,10,44,46,-2,40
Glenavon,4465,6,10,10,10,49,52,-3,40
Coleraine,4465,7,8,13,9,34,34,0,37
Glentoran,4465,8,9,9,12,25,40,-15,36
Ards,4465,9,7,7,16,37,52,-15,28
Ballinamalla,4465,10,7,6,17,32,49,-17,27
Portadown,4465,11,6,4,20,25,57,-32,22
Glenavon,4466,1,13,12,5,56,37,19,51
Ballymena,4466,2,15,6,9,55,60,-5,51
Linfield,4466,3,13,10,7,63,34,29,49
Cliftonville,4466,4,14,6,10,58,41,17,48
Crusaders,4466,5,13,8,9,51,41,10,47
Glentoran,4466,6,13,6,11,35,38,-3,45
Coleraine,4466,7,10,9,11,41,47,-6,39
Dungannon,4466,8,8,11,11,46,44,2,35
Ards,4466,9,10,5,15,36,48,-12,35
Portadown,4466,10,8,5,17,28,49,-21,29
Ballinamalla,4466,11,5,8,17,26,56,-30,23
Linfield,4467,1,15,11,4,62,24,38,56
Cliftonville,4467,2,16,5,9,59,41,18,53
Crusaders,4467,3,14,8,8,47,33,14,50
Ballymena,4467,4,13,8,9,52,59,-7,47
Coleraine,4467,5,12,10,8,42,35,7,46
Glenavon,4467,6,11,10,9,54,49,5,43
Dungannon,4467,7,10,11,9,51,41,10,41
Glentoran,4467,8,8,10,12,30,40,-10,34
Ards,4467,9,7,9,14,34,47,-13,30
Ballinamalla,4467,10,8,4,18,25,52,-27,28
Portadown,4467,11,5,6,19,23,58,-35,21
Crusaders,4468,1,16,10,4,56,34,22,58
Linfield,4468,2,14,8,8,59,37,22,50
Glenavon,4468,3,13,9,8,52,47,5,48
Coleraine,4468,4,12,11,7,45,38,7,47
Ballymena,4468,5,14,5,11,63,61,2,47
Cliftonville,4468,6,13,6,11,50,44,6,45
Ards,4468,7,11,6,13,43,47,-4,39
Dungannon,4468,8,9,10,11,53,51,2,37
Glentoran,4468,9,9,8,13,31,46,-15,35
Ballinamalla,4468,10,8,5,17,26,43,-17,29
Portadown,4468,11,5,4,21,20,50,-30,19
Crusaders,4469,1,16,8,6,57,34,23,56
Glenavon,4469,2,15,10,5,52,35,17,55
Ballymena,4469,3,16,5,9,61,54,7,53
Coleraine,4469,4,13,10,7,44,38,6,49
Cliftonville,4469,5,13,7,10,51,39,12,46
Linfield,4469,6,12,8,10,54,42,12,44
Ards,4469,7,11,4,15,33,46,-13,37
Dungannon,4469,8,8,9,13,45,50,-5,33
Glentoran,4469,9,7,8,15,27,41,-14,29
Ballinamalla,4469,10,6,8,16,33,51,-18,26
Portadown,4469,11,6,7,17,24,51,-27,25
Linfield,4470,1,17,8,5,61,32,29,59
Crusaders,4470,2,16,8,6,51,28,23,56
Cliftonville,4470,3,15,6,9,55,42,13,51
Ballymena,4470,4,14,7,9,58,53,5,49
Coleraine,4470,5,12,11,7,39,33,6,47
Portadown,4470,6,12,6,12,36,41,-5,42
Glenavon,4470,7,10,11,9,45,47,-2,41
Dungannon,4470,8,9,8,13,47,47,0,35
Glentoran,4470,9,6,8,16,26,48,-22,26
Ards,4470,10,6,7,17,33,54,-21,25
Ballinamalla,4470,11,4,8,18,26,52,-26,20
Crusaders,4471,1,16,9,5,53,30,23,57
Glenavon,4471,2,14,12,4,54,38,16,54
Linfield,4471,3,15,8,7,62,39,23,53
Cliftonville,4471,4,15,6,9,56,38,18,51
Dungannon,4471,5,13,8,9,51,41,10,47
Ballymena,4471,6,11,6,13,60,66,-6,39
Glentoran,4471,7,10,8,12,35,45,-10,38
Coleraine,4471,8,9,10,11,44,49,-5,37
Ballinamalla,4471,9,8,6,16,25,45,-20,30
Portadown,4471,10,8,3,19,24,46,-22,27
Ards,4471,11,6,4,20,29,56,-27,22
Ballymena,4472,1,18,5,7,65,50,15,59
Linfield,4472,2,15,10,5,57,28,29,55
Crusaders,4472,3,15,7,8,52,35,17,52
Coleraine,4472,4,13,9,8,46,38,8,48
Cliftonville,4472,5,13,6,11,50,45,5,45
Glenavon,4472,6,11,9,10,46,47,-1,42
Dungannon,4472,7,10,11,9,51,41,10,41
Glentoran,4472,8,10,7,13,28,43,-15,37
Ballinamalla,4472,9,7,8,15,30,48,-18,29
Ards,4472,10,7,5,18,32,50,-18,26
Portadown,4472,11,6,3,21,24,56,-32,21
Crusaders,4473,1,16,6,8,61,42,19,54
Linfield,4473,2,15,8,7,57,33,24,53
Cliftonville,4473,3,15,6,9,52,37,15,51
Ballymena,4473,4,15,6,9,57,56,1,51
Coleraine,4473,5,13,10,7,43,35,8,49
Glenavon,4473,6,12,10,8,52,48,4,46
Glentoran,4473,7,10,9,11,32,41,-9,39
Dungannon,4473,8,9,9,12,47,44,3,36
Ards,4473,9,8,4,18,33,45,-12,28
Portadown,4473,10,8,3,19,27,54,-27,27
Ballinamalla,4473,11,6,5,19,26,52,-26,23
Crusaders,4474,1,17,5,8,60,35,25,56
Ballymena,4474,2,16,4,10,51,53,-2,52
Cliftonville,4474,3,15,5,10,50,37,13,50
Linfield,4474,4,13,9,8,59,37,22,48
Glenavon,4474,5,12,12,6,41,34,7,48
Coleraine,4474,6,12,10,8,38,32,6,46
Ards,4474,7,12,3,15,39,42,-3,39
Dungannon,4474,8,9,10,11,47,45,2,37
Glentoran,4474,9,8,7,15,29,50,-21,31
Portadown,4474,10,7,7,16,26,44,-18,28
Ballinamalla,4474,11,5,6,19,24,55,-31,21
Crusaders,4475,1,19,6,5,63,34,29,63
Linfield,4475,2,18,7,5,63,32,31,61
Cliftonville,4475,3,16,4,10,52,43,9,52
Glenavon,4475,4,13,10,7,57,50,7,49
Coleraine,4475,5,12,12,6,47,37,10,48
Ballymena,4475,6,12,8,10,57,56,1,44
Dungannon,4475,7,10,10,10,54,47,7,40
Ards,4475,8,8,4,18,34,54,-20,28
Glentoran,4475,9,6,7,17,24,45,-21,25
Ballinamalla,4475,10,7,4,19,30,56,-26,25
Portadown,4475,11,5,6,19,23,50,-27,21
Crusaders,4476,1,16,6,8,57,32,25,54
Linfield,4476,2,15,8,7,65,36,29,53
Cliftonville,4476,3,16,4,10,55,43,12,52
Ballymena,4476,4,13,7,10,57,59,-2,46
Coleraine,4476,5,11,10,9,39,39,0,43
Glenavon,4476,6,11,9,10,45,47,-2,42
Glentoran,4476,7,12,5,13,34,48,-14,41
Dungannon,4476,8,9,9,12,43,40,3,36
Portadown,4476,9,8,7,15,28,46,-18,31
Ards,4476,10,7,9,14,43,54,-11,30
Ballinamalla,4476,11,8,4,18,27,49,-22,28
Cliftonville,4477,1,19,5,6,71,38,33,62
Linfield,4477,2,16,11,3,63,27,36,59
Crusaders,4477,3,17,5,8,55,37,18,56
Glenavon,4477,4,13,13,4,52,38,14,52
Ballymena,4477,5,14,3,13,61,66,-5,45
Coleraine,4477,6,9,12,9,41,43,-2,39
Dungannon,4477,7,10,7,13,49,51,-2,37
Glentoran,4477,8,9,6,15,32,52,-20,33
Ards,4477,9,7,7,16,38,52,-14,28
Portadown,4477,10,6,6,18,26,53,-27,24
Ballinamalla,4477,11,5,5,20,24,55,-31,20
Cliftonville,4478,1,19,2,9,57,37,20,59
Linfield,4478,2,15,8,7,63,38,25,53
Crusaders,4478,3,14,10,6,52,35,17,52
Coleraine,4478,4,13,10,7,43,34,9,49
Ballymena,4478,5,14,5,11,57,61,-4,47
Glenavon,4478,6,10,12,8,45,43,2,42
Ards,4478,7,10,6,14,44,51,-7,36
Glentoran,4478,8,9,7,14,35,42,-7,34
Dungannon,4478,9,7,7,16,48,56,-8,28
Portadown,4478,10,8,4,18,26,43,-17,28
Ballinamalla,4478,11,7,7,16,31,61,-30,28
Crusaders,4479,1,16,10,4,52,27,25,58
Ballymena,4479,2,15,6,9,56,56,0,51
Cliftonville,4479,3,15,5,10,50,38,12,50
Linfield,4479,4,12,10,8,47,31,16,46
Coleraine,4479,5,11,10,9,44,38,6,43
Dungannon,4479,6,11,8,11,48,39,9,41
Glenavon,4479,7,9,11,10,40,46,-6,38
Glentoran,4479,8,9,9,12,32,44,-12,36
Ards,4479,9,9,6,15,37,48,-11,33
Ballinamalla,4479,10,8,7,15,31,46,-15,31
Portadown,4479,11,5,8,17,23,47,-24,23
Crusaders,4480,1,16,8,6,55,33,22,56
Linfield,4480,2,14,11,5,57,29,28,53
Coleraine,4480,3,14,10,6,54,37,17,52
Cliftonville,4480,4,15,6,9,48,36,12,51
Dungannon,4480,5,11,10,9,49,37,12,43
Glenavon,4480,6,10,12,8,46,42,4,42
Ballymena,4480,7,11,7,12,50,60,-10,40
Glentoran,4480,8,6,12,12,23,39,-16,30
Ballinamalla,4480,9,7,8,15,27,46,-19,29
Ards,4480,10,8,5,17,34,55,-21,29
Portadown,4480,11,5,7,18,23,52,-29,22
Crusaders,4481,1,15,8,7,49,32,17,53
Ballymena,4481,2,14,9,7,57,50,7,51
Glenavon,4481,3,13,11,6,52,45,7,50
Coleraine,4481,4,13,10,7,40,34,6,49
Linfield,4481,5,11,12,7,51,35,16,45
Cliftonville,4481,6,13,5,12,49,45,4,44
Portadown,4481,7,11,4,15,33,43,-10,37
Dungannon,4481,8,8,10,12,46,38,8,34
Glentoran,4481,9,7,10,13,26,42,-16,31
Ballinamalla,4481,10,8,5,17,27,50,-23,29
Ards,4481,11,8,4,18,28,44,-16,28
Cliftonville,4482,1,17,7,6,55,33,22,58
Crusaders,4482,2,13,10,7,48,34,14,49
Glentoran,4482,3,14,7,9,39,46,-7,49
Dungannon,4482,4,12,12,6,54,38,16,48
Ballymena,4482,5,13,6,11,57,58,-1,45
Linfield,4482,6,10,12,8,51,30,21,42
Coleraine,4482,7,11,9,10,38,34,4,42
Glenavon,4482,8,10,11,9,42,36,6,41
Ballinamalla,4482,9,8,3,19,29,58,-29,27
Portadown,4482,10,5,10,15,24,43,-19,25
Ards,4482,11,7,3,20,30,57,-27,24
Crusaders,4483,1,17,7,6,53,29,24,58
Cliftonville,4483,2,16,4,10,59,43,16,52
Linfield,4483,3,12,12,6,59,31,28,48
Glenavon,4483,4,13,9,8,49,49,0,48
Coleraine,4483,5,12,7,11,44,41,3,43
Ballymena,4483,6,12,7,11,57,62,-5,43
Ballinamalla,4483,7,11,6,13,37,48,-11,39
Dungannon,4483,8,7,13,10,40,40,0,34
Ards,4483,9,9,5,16,34,46,-12,32
Glentoran,4483,10,6,10,14,28,50,-22,28
Portadown,4483,11,7,6,17,22,43,-21,27
Crusaders,4484,1,17,8,5,58,36,22,59
Glenavon,4484,2,14,11,5,50,41,9,53
Cliftonville,4484,3,16,4,10,52,34,18,52
Linfield,4484,4,12,13,5,53,26,27,49
Ballymena,4484,5,14,6,10,61,53,8,48
Glentoran,4484,6,12,6,12,36,44,-8,42
Coleraine,4484,7,10,10,10,32,35,-3,40
Dungannon,4484,8,8,9,13,53,56,-3,33
Ards,4484,9,8,4,18,30,47,-17,28
Portadown,4484,10,5,9,16,30,54,-24,24
Ballinamalla,4484,11,6,6,18,27,56,-29,24
Linfield,4485,1,15,9,6,62,34,28,54
Glenavon,4485,2,14,10,6,48,35,13,52
Coleraine,4485,3,13,12,5,43,32,11,51
Crusaders,4485,4,14,8,8,51,36,15,50
Cliftonville,4485,5,13,6,11,52,42,10,45
Ballymena,4485,6,10,11,9,55,58,-3,41
Dungannon,4485,7,10,10,10,45,44,1,40
Glentoran,4485,8,8,8,14,29,46,-17,32
Ards,4485,9,6,10,14,35,51,-16,28
Portadown,4485,10,7,6,17,26,46,-20,27
Ballinamalla,4485,11,6,8,16,29,51,-22,26
Linfield,4486,1,14,9,7,57,31,26,51
Ballymena,4486,2,15,6,9,62,61,1,51
Cliftonville,4486,3,16,2,12,52,41,11,50
Crusaders,4486,4,15,4,11,51,40,11,49
Coleraine,4486,5,13,8,9,52,44,8,47
Glenavon,4486,6,12,10,8,49,44,5,46
Dungannon,4486,7,9,11,10,48,46,2,38
Glentoran,4486,8,10,8,12,24,32,-8,38
Portadown,4486,9,11,4,15,35,46,-11,37
Ards,4486,10,9,5,16,35,51,-16,32
Ballinamalla,4486,11,6,3,21,25,54,-29,21
Cliftonville,4487,1,16,8,6,59,33,26,56
Crusaders,4487,2,16,5,9,56,38,18,53
Coleraine,4487,3,14,11,5,47,29,18,53
Linfield,4487,4,13,13,4,55,30,25,52
Ballymena,4487,5,11,8,11,52,62,-10,41
Glenavon,4487,6,9,12,9,43,48,-5,39
Dungannon,4487,7,8,10,12,48,44,4,34
Ballinamalla,4487,8,10,4,16,36,54,-18,34
Ards,4487,9,8,8,14,32,45,-13,32
Glentoran,4487,10,7,7,16,30,52,-22,28
Portadown,4487,11,7,6,17,25,48,-23,27
Linfield,4488,1,16,11,3,62,26,36,59
Crusaders,4488,2,15,9,6,53,34,19,54
Cliftonville,4488,3,15,5,10,59,44,15,50
Ballymena,4488,4,15,5,10,55,55,0,50
Glenavon,4488,5,10,13,7,47,44,3,43
Dungannon,4488,6,10,12,8,54,42,12,42
Coleraine,4488,7,11,8,11,43,43,0,41
Ards,4488,8,11,6,13,35,43,-8,39
Glentoran,4488,9,7,9,14,27,40,-13,30
Portadown,4488,10,7,6,17,27,48,-21,27
Ballinamalla,4488,11,5,2,23,25,68,-43,17
Cliftonville,4489,1,17,3,10,56,41,15,54
Crusaders,4489,2,15,8,7,53,35,18,53
Linfield,4489,3,14,10,6,54,27,27,52
Dungannon,4489,4,13,8,9,51,39,12,47
Ballymena,4489,5,13,8,9,62,59,3,47
Coleraine,4489,6,12,9,9,47,42,5,45
Glenavon,4489,7,10,10,10,43,49,-6,40
Ards,4489,8,9,6,15,35,46,-11,33
Glentoran,4489,9,8,8,14,28,45,-17,32
Portadown,4489,10,8,4,18,27,47,-20,28
Ballinamalla,4489,11,7,4,19,27,53,-26,25
Linfield,4490,1,16,10,4,61,24,37,58
Cliftonville,4490,2,18,4,8,59,37,22,58
Ballymena,4490,3,15,7,8,58,53,5,52
Crusaders,4490,4,13,5,12,45,40,5,44
Coleraine,4490,5,11,11,8,39,36,3,44
Dungannon,4490,6,11,7,12,51,43,8,40
Glenavon,4490,7,8,14,8,41,43,-2,38
Glentoran,4490,8,9,9,12,35,47,-12,36
Portadown,4490,9,7,8,15,25,52,-27,29
Ards,4490,10,7,6,17,32,48,-16,27
Ballinamalla,4490,11,8,3,19,31,54,-23,27
Linfield,4491,1,16,9,5,60,32,28,57
Ballymena,4491,2,16,5,9,71,57,14,53
Cliftonville,4491,3,16,3,11,56,36,20,51
Crusaders,4491,4,15,6,9,51,37,14,51
Coleraine,4491,5,13,9,8,48,40,8,48
Glenavon,4491,6,11,11,8,46,37,9,44
Dungannon,4491,7,10,9,11,46,44,2,39
Ballinamalla,4491,8,12,2,16,32,51,-19,38
Ards,4491,9,8,5,17,35,55,-20,29
Portadown,4491,10,7,6,17,24,57,-33,27
Glentoran,4491,11,6,5,19,29,52,-23,23
Cliftonville,4492,1,17,4,9,52,35,17,55
Crusaders,4492,2,14,9,7,52,38,14,51
Linfield,4492,3,14,8,8,55,36,19,50
Ballymena,4492,4,13,7,10,56,61,-5,46
Ards,4492,5,13,2,15,45,49,-4,41
Coleraine,4492,6,9,12,9,42,42,0,39
Glenavon,4492,7,8,14,8,50,48,2,38
Glentoran,4492,8,10,8,12,31,37,-6,38
Dungannon,4492,9,8,13,9,46,41,5,37
Portadown,4492,10,7,8,15,19,39,-20,29
Ballinamalla,4492,11,7,5,18,27,49,-22,26
Crusaders,4493,1,17,8,5,50,26,24,59
Cliftonville,4493,2,18,4,8,54,30,24,58
Coleraine,4493,3,14,10,6,46,31,15,52
Linfield,4493,4,14,8,8,54,32,22,50
Ballymena,4493,5,13,6,11,50,59,-9,45
Glenavon,4493,6,11,10,9,45,45,0,43
Ards,4493,7,10,3,17,37,48,-11,33
Glentoran,4493,8,7,10,13,27,42,-15,31
Portadown,4493,9,8,5,17,27,45,-18,29
Ballinamalla,4493,10,8,4,18,28,52,-24,28
Dungannon,4493,11,5,12,13,42,50,-8,27
Linfield,4494,1,16,9,5,59,27,32,57
Ballymena,4494,2,15,5,10,58,55,3,50
Cliftonville,4494,3,14,6,10,63,50,13,48
Glenavon,4494,4,12,11,7,44,41,3,47
Crusaders,4494,5,13,6,11,49,43,6,45
Coleraine,4494,6,10,10,10,43,44,-1,40
Ballinamalla,4494,7,11,5,14,32,49,-17,38
Dungannon,4494,8,10,7,13,46,42,4,37
Ards,4494,9,10,6,14,41,44,-3,36
Glentoran,4494,10,9,5,16,29,48,-19,32
Portadown,4494,11,7,6,17,27,48,-21,27
Crusaders,4495,1,19,4,7,68,36,32,61
Linfield,4495,2,14,10,6,51,25,26,52
Glenavon,4495,3,13,11,6,60,48,12,50
Cliftonville,4495,4,14,5,11,55,47,8,47
Coleraine,4495,5,11,11,8,40,37,3,44
Dungannon,4495,6,11,10,9,47,35,12,43
Ballymena,4495,7,11,6,13,57,64,-7,39
Portadown,4495,8,10,5,15,28,44,-16,35
Ards,4495,9,9,5,16,44,62,-18,32
Glentoran,4495,10,7,9,14,27,47,-20,30
Ballinamalla,4495,11,5,6,19,25,57,-32,21
Linfield,4496,1,17,9,4,64,29,35,60
Crusaders,4496,2,14,9,7,53,35,18,51
Cliftonville,4496,3,15,6,9,49,35,14,51
Ballymena,4496,4,11,10,9,49,53,-4,43
Coleraine,4496,5,10,12,8,40,42,-2,42
Dungannon,4496,6,10,9,11,51,46,5,39
Glenavon,4496,7,9,10,11,42,44,-2,37
Glentoran,4496,8,9,9,12,32,47,-15,36
Ards,4496,9,9,5,16,38,47,-9,32
Portadown,4496,10,8,7,15,26,48,-22,31
Ballinamalla,4496,11,8,4,18,35,53,-18,28
Linfield,4497,1,14,11,5,67,34,33,53
Crusaders,4497,2,15,7,8,57,44,13,52
Cliftonville,4497,3,16,4,10,56,44,12,52
Ballymena,4497,4,14,8,8,54,54,0,50
Glenavon,4497,5,13,10,7,62,49,13,49
Coleraine,4497,6,10,10,10,38,38,0,40
Glentoran,4497,7,10,9,11,39,40,-1,39
Ards,4497,8,11,2,17,41,58,-17,35
Dungannon,4497,9,8,10,12,53,52,1,34
Portadown,4497,10,6,7,17,23,51,-28,25
Ballinamalla,4497,11,5,8,17,24,50,-26,23
Linfield,4498,1,17,8,5,68,34,34,59
Crusaders,4498,2,14,8,8,52,42,10,50
Ballymena,4498,3,15,5,10,50,56,-6,50
Cliftonville,4498,4,15,4,11,58,41,17,49
Glenavon,4498,5,13,10,7,50,37,13,49
Coleraine,4498,6,12,10,8,39,33,6,46
Dungannon,4498,7,9,10,11,45,44,1,37
Glentoran,4498,8,10,7,13,36,48,-12,37
Ballinamalla,4498,9,8,6,16,33,49,-16,30
Ards,4498,10,7,8,15,32,50,-18,29
Portadown,4498,11,5,4,21,21,50,-29,19
Crusaders,4499,1,17,4,9,53,30,23,55
Ballymena,4499,2,16,6,8,58,53,5,54
Cliftonville,4499,3,16,2,12,50,35,15,50
Glenavon,4499,4,13,8,9,46,41,5,47
Coleraine,4499,5,12,10,8,35,34,1,46
Linfield,4499,6,12,7,11,53,35,18,43
Dungannon,4499,7,9,11,10,48,43,5,38
Ards,4499,8,11,5,14,45,50,-5,38
Ballinamalla,4499,9,10,2,18,30,49,-19,32
Portadown,4499,10,9,5,16,25,48,-23,32
Glentoran,4499,11,7,6,17,26,51,-25,27
Crusaders,4500,1,16,8,6,60,32,28,56
Linfield,4500,2,16,7,7,68,33,35,55
Ballymena,4500,3,16,4,10,61,57,4,52
Coleraine,4500,4,12,10,8,43,41,2,46
Cliftonville,4500,5,12,7,11,53,43,10,43
Glentoran,4500,6,11,7,12,36,42,-6,40
Dungannon,4500,7,10,8,12,48,49,-1,38
Glenavon,4500,8,9,11,10,46,54,-8,38
Ards,4500,9,10,3,17,37,51,-14,33
Ballinamalla,4500,10,9,4,17,39,58,-19,31
Portadown,4500,11,7,5,18,28,59,-31,26
Cliftonville,4501,1,17,4,9,50,34,16,55
Crusaders,4501,2,15,9,6,53,30,23,54
Linfield,4501,3,15,8,7,64,36,28,53
Ballymena,4501,4,16,5,9,62,53,9,53
Dungannon,4501,5,12,7,11,53,40,13,43
Glenavon,4501,6,11,8,11,43,47,-4,41
Coleraine,4501,7,10,9,11,37,40,-3,39
Glentoran,4501,8,8,9,13,32,53,-21,33
Portadown,4501,9,8,6,16,25,48,-23,30
Ballinamalla,4501,10,6,9,15,31,53,-22,27
Ards,4501,11,6,8,16,33,49,-16,26
Linfield,4502,1,17,7,6,68,37,31,58
Crusaders,4502,2,17,5,8,62,46,16,56
Cliftonville,4502,3,14,6,10,52,41,11,48
Ballymena,4502,4,14,6,10,64,60,4,48
Coleraine,4502,5,12,10,8,47,39,8,46
Dungannon,4502,6,11,10,9,51,44,7,43
Glenavon,4502,7,11,10,9,42,45,-3,43
Glentoran,4502,8,9,11,10,39,46,-7,38
Ards,4502,9,9,5,16,37,48,-11,32
Portadown,4502,10,6,6,18,25,53,-28,24
Ballinamalla,4502,11,5,4,21,26,54,-28,19
Linfield,4503,1,16,7,7,70,33,37,55
Crusaders,4503,2,15,10,5,52,32,20,55
Cliftonville,4503,3,15,6,9,55,41,14,51
Coleraine,4503,4,12,10,8,44,36,8,46
Dungannon,4503,5,11,10,9,58,47,11,43
Ballymena,4503,6,12,6,12,52,62,-10,42
Glenavon,4503,7,9,12,9,46,45,1,39
Portadown,4503,8,11,4,15,32,47,-15,37
Ballinamalla,4503,9,9,6,15,35,52,-17,33
Ards,4503,10,7,7,16,36,53,-17,28
Glentoran,4503,11,6,6,18,26,58,-32,24
Cliftonville,4504,1,18,5,7,53,29,24,59
Crusaders,4504,2,16,8,6,55,33,22,56
Linfield,4504,3,14,10,6,55,34,21,52
Coleraine,4504,4,11,13,6,43,38,5,46
Glenavon,4504,5,10,13,7,45,43,2,43
Ballymena,4504,6,10,8,12,50,59,-9,38
Glentoran,4504,7,9,9,12,32,44,-12,36
Ballinamalla,4504,8,10,5,15,40,50,-10,35
Portadown,4504,9,9,3,18,21,46,-25,30
Dungannon,4504,10,6,9,15,43,50,-7,27
Ards,4504,11,6,9,15,36,47,-11,27
Crusaders,4505,1,15,10,5,57,31,26,55
Cliftonville,4505,2,17,2,11,50,40,10,53
Linfield,4505,3,12,12,6,54,35,19,48
Coleraine,4505,4,13,9,8,48,36,12,48
Ballymena,4505,5,13,7,10,59,66,-7,46
Dungannon,4505,6,10,12,8,51,38,13,42
Glenavon,4505,7,8,13,9,47,44,3,37
Glentoran,4505,8,8,9,13,35,47,-12,33
Ballinamalla,4505,9,9,5,16,31,52,-21,32
Ards,4505,10,9,4,17,36,58,-22,31
Portadown,4505,11,6,7,17,19,40,-21,25
Cliftonville,4506,1,17,6,7,59,38,21,57
Linfield,4506,2,14,9,7,58,29,29,51
Coleraine,4506,3,14,8,8,51,39,12,50
Crusaders,4506,4,13,8,9,55,39,16,47
Ballymena,4506,5,14,3,13,64,63,1,45
Glenavon,4506,6,10,12,8,42,41,1,42
Dungannon,4506,7,9,11,10,48,47,1,38
Ballinamalla,4506,8,10,7,13,33,45,-12,37
Ards,4506,9,10,6,14,43,55,-12,36
Glentoran,4506,10,7,9,14,27,50,-23,30
Portadown,4506,11,4,7,19,21,55,-34,19
Coleraine,4507,1,17,9,4,52,27,25,60
Crusaders,4507,2,17,7,6,54,29,25,58
Glenavon,4507,3,14,10,6,49,38,11,52
Cliftonville,4507,4,15,4,11,51,43,8,49
Linfield,4507,5,13,8,9,57,35,22,47
Dungannon,4507,6,11,11,8,47,34,13,44
Ballymena,4507,7,10,6,14,49,58,-9,36
Glentoran,4507,8,9,7,14,34,48,-14,34
Ards,4507,9,7,7,16,38,58,-20,28
Portadown,4507,10,7,3,20,21,48,-27,24
Ballinamalla,4507,11,6,6,18,26,60,-34,24
Crusaders,4508,1,18,8,4,61,28,33,62
Linfield,4508,2,14,11,5,55,25,30,53
Ballymena,4508,3,14,6,10,56,53,3,48
Cliftonville,4508,4,14,5,11,50,39,11,47
Glenavon,4508,5,10,16,4,44,38,6,46
Coleraine,4508,6,10,9,11,39,45,-6,39
Dungannon,4508,7,10,7,13,49,48,1,37
Ballinamalla,4508,8,10,4,16,33,53,-20,34
Glentoran,4508,9,8,9,13,32,46,-14,33
Ards,4508,10,10,3,17,31,46,-15,33
Portadown,4508,11,5,6,19,20,49,-29,21
Crusaders,4509,1,18,6,6,61,38,23,60
Linfield,4509,2,17,7,6,67,28,39,58
Ballymena,4509,3,16,4,10,63,58,5,52
Glenavon,4509,4,13,11,6,54,41,13,50
Cliftonville,4509,5,14,5,11,43,37,6,47
Glentoran,4509,6,11,6,13,32,43,-11,39
Coleraine,4509,7,9,11,10,39,41,-2,38
Dungannon,4509,8,9,8,13,52,44,8,35
Portadown,4509,9,9,6,15,28,44,-16,33
Ards,4509,10,7,4,19,28,55,-27,25
Ballinamalla,4509,11,6,4,20,27,65,-38,22
Ballymena,4510,1,16,8,6,61,49,12,56
Crusaders,4510,2,16,7,7,54,34,20,55
Linfield,4510,3,14,10,6,52,24,28,52
Cliftonville,4510,4,14,8,8,52,38,14,50
Glenavon,4510,5,12,11,7,49,40,9,47
Coleraine,4510,6,10,11,9,41,41,0,41
Dungannon,4510,7,7,13,10,42,41,1,34
Ards,4510,8,10,4,16,38,51,-13,34
Glentoran,4510,9,9,5,16,31,49,-18,32
Portadown,4510,10,7,7,16,24,46,-22,28
Ballinamalla,4510,11,5,6,19,22,53,-31,21
Linfield,4511,1,17,7,6,64,34,30,58
Cliftonville,4511,2,16,4,10,57,45,12,52
Dungannon,4511,3,14,9,7,55,36,19,51
Crusaders,4511,4,15,6,9,55,46,9,51
Glenavon,4511,5,12,10,8,48,43,5,46
Ballymena,4511,6,11,6,13,55,68,-13,39
Coleraine,4511,7,9,11,10,42,43,-1,38
Glentoran,4511,8,9,9,12,37,42,-5,36
Ards,4511,9,10,5,15,38,47,-9,35
Ballinamalla,4511,10,9,4,17,40,53,-13,31
Portadown,4511,11,5,5,20,17,51,-34,20
Crusaders,4512,1,19,6,5,69,39,30,63
Coleraine,4512,2,12,13,5,51,33,18,49
Ballymena,4512,3,14,7,9,58,58,0,49
Linfield,4512,4,13,9,8,52,34,18,48
Cliftonville,4512,5,13,5,12,47,42,5,44
Dungannon,4512,6,11,10,9,58,44,14,43
Glenavon,4512,7,9,11,10,48,51,-3,38
Portadown,4512,8,10,6,14,30,44,-14,36
Glentoran,4512,9,8,8,14,31,46,-15,32
Ballinamalla,4512,10,9,3,18,30,58,-28,30
Ards,4512,11,5,6,19,34,59,-25,21
Linfield,4513,1,12,16,2,58,28,30,52
Glenavon,4513,2,13,13,4,51,34,17,52
Cliftonville,4513,3,14,7,9,51,37,14,49
Coleraine,4513,4,11,14,5,45,32,13,47
Crusaders,4513,5,12,10,8,47,37,10,46
Ballymena,4513,6,13,7,10,54,59,-5,46
Dungannon,4513,7,8,11,11,42,43,-1,35
Ballinamalla,4513,8,9,7,14,29,45,-16,34
Glentoran,4513,9,7,9,14,33,53,-20,30
Portadown,4513,10,7,6,17,29,50,-21,27
Ards,4513,11,6,6,18,31,52,-21,24
Crusaders,4514,1,17,7,6,57,31,26,58
Linfield,4514,2,14,8,8,57,37,20,50
Ballymena,4514,3,14,7,9,61,53,8,49
Glenavon,4514,4,10,14,6,47,44,3,44
Coleraine,4514,5,11,11,8,42,40,2,44
Dungannon,4514,6,10,12,8,49,39,10,42
Cliftonville,4514,7,12,4,14,48,47,1,40
Glentoran,4514,8,9,9,12,36,52,-16,36
Ballinamalla,4514,9,10,4,16,33,47,-14,34
Portadown,4514,10,9,7,14,27,41,-14,34
Ards,4514,11,5,5,20,30,56,-26,20
Crusaders,4515,1,18,9,3,56,27,29,63
Linfield,4515,2,15,10,5,60,33,27,55
Cliftonville,4515,3,13,6,11,50,39,11,45
Coleraine,4515,4,11,12,7,41,32,9,45
Ballymena,4515,5,12,9,9,57,58,-1,45
Glentoran,4515,6,10,9,11,35,39,-4,39
Glenavon,4515,7,8,12,10,45,56,-11,36
Dungannon,4515,8,7,12,11,46,49,-3,33
Portadown,4515,9,7,8,15,19,38,-19,29
Ards,4515,10,7,7,16,34,46,-12,28
Ballinamalla,4515,11,7,6,17,30,56,-26,27
Crusaders,4516,1,15,9,6,48,33,15,54
Linfield,4516,2,15,7,8,59,35,24,52
Dungannon,4516,3,13,9,8,54,41,13,48
Cliftonville,4516,4,14,5,11,45,40,5,47
Coleraine,4516,5,12,10,8,41,29,12,46
Ballymena,4516,6,13,7,10,53,53,0,46
Glenavon,4516,7,11,12,7,47,41,6,45
Ballinamalla,4516,8,9,6,15,36,53,-17,33
Glentoran,4516,9,8,7,15,25,43,-18,31
Ards,4516,10,7,7,16,35,50,-15,28
Portadown,4516,11,6,5,19,26,51,-25,23
Cliftonville,4517,1,17,4,9,60,42,18,55
Linfield,4517,2,14,11,5,62,33,29,53
Crusaders,4517,3,14,8,8,47,35,12,50
Glenavon,4517,4,10,15,5,51,42,9,45
Coleraine,4517,5,11,12,7,47,39,8,45
Dungannon,4517,6,10,10,10,51,44,7,40
Ballymena,4517,7,10,9,11,54,62,-8,39
Portadown,4517,8,9,6,15,29,49,-20,33
Ards,4517,9,8,7,15,40,54,-14,31
Ballinamalla,4517,10,9,4,17,42,57,-15,31
Glentoran,4517,11,6,8,16,27,53,-26,26
Crusaders,4518,1,18,6,6,60,35,25,60
Linfield,4518,2,15,10,5,60,32,28,55
Glenavon,4518,3,13,10,7,55,46,9,49
Coleraine,4518,4,12,10,8,45,35,10,46
Ballymena,4518,5,13,6,11,59,61,-2,45
Cliftonville,4518,6,13,5,12,47,42,5,44
Dungannon,4518,7,9,9,12,53,55,-2,36
Ards,4518,8,9,5,16,44,56,-12,32
Portadown,4518,9,9,5,16,28,48,-20,32
Glentoran,4518,10,7,9,14,31,43,-12,30
Ballinamalla,4518,11,7,5,18,33,62,-29,26
Ballymena,4519,1,19,3,8,69,56,13,60
Linfield,4519,2,14,9,7,61,36,25,51
Coleraine,4519,3,14,9,7,47,34,13,51
Crusaders,4519,4,14,8,8,53,31,22,50
Cliftonville,4519,5,14,6,10,45,33,12,48
Dungannon,4519,6,12,8,10,47,41,6,44
Ards,4519,7,11,4,15,37,47,-10,37
Glenavon,4519,8,8,12,10,43,52,-9,36
Ballinamalla,4519,9,9,4,17,29,46,-17,31
Portadown,4519,10,7,4,19,25,49,-24,25
Glentoran,4519,11,5,9,16,19,50,-31,24
Linfield,4520,1,17,9,4,67,31,36,60
Crusaders,4520,2,17,6,7,56,33,23,57
Ballymena,4520,3,16,3,11,65,62,3,51
Cliftonville,4520,4,15,3,12,47,37,10,48
Glenavon,4520,5,13,9,8,46,48,-2,48
Coleraine,4520,6,11,9,10,42,40,2,42
Dungannon,4520,7,10,6,14,47,49,-2,36
Ards,4520,8,10,5,15,38,50,-12,35
Glentoran,4520,9,8,6,16,26,45,-19,30
Portadown,4520,10,8,5,17,30,47,-17,29
Ballinamalla,4520,11,8,3,19,37,59,-22,27
Linfield,4521,1,16,10,4,59,28,31,58
Cliftonville,4521,2,18,4,8,55,41,14,58
Ballymena,4521,3,14,5,11,68,64,4,47
Crusaders,4521,4,13,7,10,50,38,12,46
Coleraine,4521,5,12,9,9,51,48,3,45
Glenavon,4521,6,11,10,9,47,41,6,43
Glentoran,4521,7,10,6,14,27,40,-13,36
Portadown,4521,8,10,4,16,35,52,-17,34
Dungannon,4521,9,7,12,11,43,46,-3,33
Ards,4521,10,8,5,17,36,53,-17,29
Ballinamalla,4521,11,8,4,18,31,51,-20,28
Ballymena,4522,1,17,5,8,62,54,8,56
Crusaders,4522,2,16,5,9,56,34,22,53
Linfield,4522,3,13,10,7,57,34,23,49
Cliftonville,4522,4,14,6,10,51,43,8,48
Glenavon,4522,5,13,9,8,49,48,1,48
Dungannon,4522,6,9,10,11,51,49,2,37
Coleraine,4522,7,9,10,11,36,38,-2,37
Portadown,4522,8,9,6,15,35,50,-15,33
Ards,4522,9,8,7,15,34,45,-11,31
Glentoran,4522,10,7,9,14,30,44,-14,30
Ballinamalla,4522,11,7,9,14,31,53,-22,30
Crusaders,4523,1,17,8,5,64,35,29,59
Linfield,4523,2,15,6,9,60,37,23,51
Cliftonville,4523,3,14,6,10,50,45,5,48
Glenavon,4523,4,11,14,5,60,51,9,47
Coleraine,4523,5,11,11,8,44,38,6,44
Dungannon,4523,6,11,10,9,53,48,5,43
Ballymena,4523,7,11,7,12,51,58,-7,40
Ards,4523,8,11,6,13,44,48,-4,39
Glentoran,4523,9,9,7,14,34,51,-17,34
Portadown,4523,10,5,9,16,23,43,-20,24
Ballinamalla,4523,11,6,4,20,28,57,-29,22
Linfield,4524,1,13,11,6,55,33,22,50
Cliftonville,4524,2,14,7,9,51,40,11,49
Crusaders,4524,3,13,8,9,51,36,15,47
Glenavon,4524,4,11,13,6,51,43,8,46
Coleraine,4524,5,12,10,8,46,38,8,46
Ballymena,4524,6,12,8,10,53,56,-3,44
Dungannon,4524,7,9,10,11,44,48,-4,37
Ards,4524,8,10,6,14,38,47,-9,36
Glentoran,4524,9,8,11,11,32,44,-12,35
Portadown,4524,10,9,3,18,29,47,-18,30
Ballinamalla,4524,11,8,5,17,37,55,-18,29
Crusaders,4525,1,18,8,4,62,32,30,62
Linfield,4525,2,13,10,7,60,34,26,49
Ballymena,4525,3,14,7,9,64,59,5,49
Glenavon,4525,4,10,12,8,47,49,-2,42
Cliftonville,4525,5,11,6,13,46,45,1,39
Coleraine,4525,6,9,12,9,42,46,-4,39
Dungannon,4525,7,8,13,9,45,41,4,37
Ballinamalla,4525,8,10,7,13,33,48,-15,37
Ards,4525,9,9,5,16,39,51,-12,32
Portadown,4525,10,8,8,14,24,38,-14,32
Glentoran,4525,11,5,12,13,25,44,-19,27
Ballymena,4526,1,17,7,6,63,50,13,58
Crusaders,4526,2,16,9,5,56,30,26,57
Glenavon,4526,3,15,10,5,58,41,17,55
Cliftonville,4526,4,16,3,11,56,44,12,51
Dungannon,4526,5,10,10,10,53,50,3,40
Linfield,4526,6,11,6,13,58,46,12,39
Glentoran,4526,7,9,12,9,33,38,-5,39
Ards,4526,8,10,7,13,35,44,-9,37
Coleraine,4526,9,7,10,13,37,51,-14,31
Ballinamalla,4526,10,7,4,19,24,54,-30,25
Portadown,4526,11,5,6,19,20,45,-25,21
Crusaders,4527,1,14,10,6,56,38,18,52
Ballymena,4527,2,16,4,10,57,53,4,52
Cliftonville,4527,3,15,5,10,61,43,18,50
Coleraine,4527,4,13,9,8,43,35,8,48
Linfield,4527,5,12,10,8,53,35,18,46
Glenavon,4527,6,12,8,10,49,46,3,44
Glentoran,4527,7,10,9,11,32,41,-9,39
Dungannon,4527,8,10,8,12,53,47,6,38
Ards,4527,9,11,4,15,34,50,-16,37
Portadown,4527,10,9,3,18,23,43,-20,30
Ballinamalla,4527,11,6,4,20,25,55,-30,22
Cliftonville,4528,1,20,2,8,60,32,28,62
Crusaders,4528,2,18,5,7,52,32,20,59
Ballymena,4528,3,15,8,7,54,49,5,53
Linfield,4528,4,14,8,8,54,30,24,50
Coleraine,4528,5,12,10,8,39,35,4,46
Dungannon,4528,6,11,7,12,52,48,4,40
Ards,4528,7,11,4,15,42,50,-8,37
Glenavon,4528,8,9,9,12,41,41,0,36
Glentoran,4528,9,8,6,16,30,48,-18,30
Ballinamalla,4528,10,8,4,18,32,59,-27,28
Portadown,4528,11,6,3,21,19,51,-32,21
Crusaders,4529,1,14,8,8,48,39,9,50
Ballymena,4529,2,15,4,11,53,58,-5,49
Dungannon,4529,3,13,9,8,56,42,14,48
Cliftonville,4529,4,14,5,11,53,40,13,47
Glenavon,4529,5,11,12,7,46,46,0,45
Linfield,4529,6,11,11,8,53,37,16,44
Ards,4529,7,10,8,12,43,44,-1,38
Coleraine,4529,8,9,11,10,39,41,-2,38
Glentoran,4529,9,10,6,14,31,38,-7,36
Ballinamalla,4529,10,9,6,15,28,47,-19,33
Portadown,4529,11,7,4,19,27,45,-18,25
Cliftonville,4530,1,18,5,7,61,30,31,59
Linfield,4530,2,13,11,6,56,31,25,50
Crusaders,4530,3,14,7,9,50,39,11,49
Ballymena,4530,4,13,10,7,58,56,2,49
Coleraine,4530,5,10,11,9,38,39,-1,41
Dungannon,4530,6,9,10,11,50,47,3,37
Ballinamalla,4530,7,11,4,15,39,47,-8,37
Glenavon,4530,8,9,9,12,39,49,-10,36
Glentoran,4530,9,8,10,12,33,48,-15,34
Ards,4530,10,9,5,16,32,47,-15,32
Portadown,4530,11,6,8,16,26,49,-23,26
Linfield,4531,1,14,12,4,60,30,30,54
Crusaders,4531,2,15,7,8,54,34,20,52
Cliftonville,4531,3,13,8,9,47,36,11,47
Glenavon,4531,4,12,11,7,46,45,1,47
Ballymena,4531,5,12,9,9,57,64,-7,45
Dungannon,4531,6,11,9,10,50,41,9,42
Ards,4531,7,9,9,12,40,46,-6,36
Glentoran,4531,8,8,9,13,34,46,-12,33
Coleraine,4531,9,7,11,12,37,44,-7,32
Ballinamalla,4531,10,9,5,16,32,50,-18,32
Portadown,4531,11,6,8,16,24,45,-21,26
Crusaders,4532,1,18,8,4,56,29,27,62
Cliftonville,4532,2,18,4,8,52,31,21,58
Linfield,4532,3,14,8,8,58,36,22,50
Glenavon,4532,4,13,11,6,49,41,8,50
Ballymena,4532,5,14,6,10,58,58,0,48
Coleraine,4532,6,13,8,9,45,37,8,47
Glentoran,4532,7,10,5,15,34,47,-13,35
Ards,4532,8,8,8,14,36,49,-13,32
Dungannon,4532,9,6,10,14,41,49,-8,28
Ballinamalla,4532,10,7,3,20,25,49,-24,24
Portadown,4532,11,4,9,17,23,51,-28,21
Crusaders,4533,1,21,5,4,65,33,32,68
Cliftonville,4533,2,14,6,10,52,40,12,48
Linfield,4533,3,11,14,5,61,41,20,47
Ballymena,4533,4,13,6,11,61,66,-5,45
Dungannon,4533,5,12,8,10,55,48,7,44
Coleraine,4533,6,11,10,9,40,35,5,43
Glenavon,4533,7,10,11,9,50,50,0,41
Portadown,4533,8,8,8,14,26,45,-19,32
Ballinamalla,4533,9,9,4,17,34,53,-19,31
Glentoran,4533,10,7,8,15,33,50,-17,29
Ards,4533,11,8,2,20,35,51,-16,26
Glenavon,4534,1,14,10,6,51,40,11,52
Ballymena,4534,2,14,9,7,59,58,1,51
Coleraine,4534,3,13,10,7,50,37,13,49
Linfield,4534,4,12,12,6,57,32,25,48
Cliftonville,4534,5,15,3,12,55,44,11,48
Crusaders,4534,6,13,7,10,49,44,5,46
Dungannon,4534,7,10,9,11,56,44,12,39
Portadown,4534,8,9,6,15,30,44,-14,33
Glentoran,4534,9,8,6,16,30,48,-18,30
Ards,4534,10,8,5,17,33,56,-23,29
Ballinamalla,4534,11,8,5,17,27,50,-23,29
Linfield,4535,1,15,12,3,66,28,38,57
Crusaders,4535,2,16,5,9,55,37,18,53
Dungannon,4535,3,13,9,8,60,41,19,48
Coleraine,4535,4,13,9,8,55,43,12,48
Ballymena,4535,5,13,9,8,57,59,-2,48
Cliftonville,4535,6,12,9,9,48,40,8,45
Glenavon,4535,7,9,10,11,44,50,-6,37
Ards,4535,8,9,6,15,37,52,-15,33
Glentoran,4535,9,8,8,14,33,48,-15,32
Portadown,4535,10,7,7,16,25,46,-21,28
Ballinamalla,4535,11,7,2,21,20,56,-36,23
Ballymena,4536,1,17,4,9,66,56,10,55
Crusaders,4536,2,15,8,7,56,39,17,53
Linfield,4536,3,15,7,8,60,38,22,52
Glenavon,4536,4,14,9,7,50,41,9,51
Coleraine,4536,5,12,7,11,42,42,0,43
Dungannon,4536,6,12,6,12,51,43,8,42
Cliftonville,4536,7,13,3,14,58,51,7,42
Ards,4536,8,12,3,15,39,49,-10,39
Glentoran,4536,9,10,6,14,36,49,-13,36
Portadown,4536,10,9,3,18,30,53,-23,30
Ballinamalla,4536,11,7,2,21,26,53,-27,23
Linfield,4537,1,16,10,4,66,30,36,58
Cliftonville,4537,2,17,7,6,60,39,21,58
Glenavon,4537,3,12,12,6,48,42,6,48
Crusaders,4537,4,13,8,9,57,46,11,47
Coleraine,4537,5,10,13,7,38,36,2,43
Ballymena,4537,6,11,8,11,58,63,-5,41
Dungannon,4537,7,10,10,10,48,47,1,40
Portadown,4537,8,9,4,17,25,38,-13,31
Glentoran,4537,9,7,10,13,30,47,-17,31
Ards,4537,10,6,8,16,36,55,-19,26
Ballinamalla,4537,11,6,6,18,33,56,-23,24
Crusaders,4538,1,17,7,6,56,32,24,58
Linfield,4538,2,14,11,5,67,34,33,53
Ballymena,4538,3,14,8,8,63,62,1,50
Cliftonville,4538,4,14,6,10,55,45,10,48
Dungannon,4538,5,12,9,9,52,41,11,45
Glenavon,4538,6,10,11,9,43,46,-3,41
Ards,4538,7,10,5,15,44,50,-6,35
Glentoran,4538,8,9,7,14,32,49,-17,34
Ballinamalla,4538,9,10,4,16,32,51,-19,34
Coleraine,4538,10,7,12,11,32,41,-9,33
Portadown,4538,11,5,6,19,20,45,-25,21
Crusaders,4539,1,15,9,6,49,33,16,54
Cliftonville,4539,2,16,5,9,55,40,15,53
Linfield,4539,3,13,10,7,53,28,25,49
Dungannon,4539,4,13,9,8,63,39,24,48
Glenavon,4539,5,13,9,8,44,36,8,48
Ballymena,4539,6,13,8,9,57,57,0,47
Glentoran,4539,7,10,7,13,26,39,-13,37
Coleraine,4539,8,9,9,12,36,44,-8,36
Ards,4539,9,11,3,16,36,47,-11,36
Portadown,4539,10,8,4,18,22,50,-28,28
Ballinamalla,4539,11,5,5,20,29,57,-28,20
Crusaders,4540,1,18,7,5,71,38,33,61
Linfield,4540,2,16,9,5,60,30,30,57
Cliftonville,4540,3,14,7,9,50,36,14,49
Ballymena,4540,4,13,7,10,53,57,-4,46
Glenavon,4540,5,11,11,8,50,47,3,44
Coleraine,4540,6,10,12,8,40,39,1,42
Glentoran,4540,7,10,8,12,34,43,-9,38
Dungannon,4540,8,7,11,12,52,53,-1,32
Ards,4540,9,8,7,15,36,48,-12,31
Portadown,4540,10,8,4,18,23,46,-23,28
Ballinamalla,4540,11,6,5,19,28,60,-32,23
Crusaders,4541,1,17,6,7,51,33,18,57
Coleraine,4541,2,15,9,6,47,34,13,54
Cliftonville,4541,3,16,4,10,50,35,15,52
Linfield,4541,4,13,7,10,58,40,18,46
Dungannon,4541,5,12,9,9,54,41,13,45
Ballymena,4541,6,12,8,10,52,55,-3,44
Glenavon,4541,7,11,10,9,52,50,2,43
Ards,4541,8,10,5,15,42,48,-6,35
Ballinamalla,4541,9,8,5,17,26,48,-22,29
Glentoran,4541,10,6,9,15,22,45,-23,27
Portadown,4541,11,6,6,18,21,46,-25,24
Crusaders,4542,1,17,7,6,50,35,15,58
Linfield,4542,2,14,11,5,53,26,27,53
Glenavon,4542,3,12,13,5,49,37,12,49
Ballymena,4542,4,14,5,11,63,56,7,47
Cliftonville,4542,5,14,3,13,54,46,8,45
Coleraine,4542,6,11,11,8,42,37,5,44
Ards,4542,7,11,5,14,37,45,-8,38
Portadown,4542,8,10,7,13,36,41,-5,37
Dungannon,4542,9,7,9,14,45,54,-9,30
Glentoran,4542,10,5,11,14,26,49,-23,26
Ballinamalla,4542,11,6,6,18,30,59,-29,24
Cliftonville,4543,1,18,3,9,58,32,26,57
Linfield,4543,2,15,10,5,60,29,31,55
Crusaders,4543,3,15,7,8,51,40,11,52
Coleraine,4543,4,13,10,7,42,32,10,49
Dungannon,4543,5,11,9,10,52,44,8,42
Ballymena,4543,6,12,5,13,49,57,-8,41
Glenavon,4543,7,9,10,11,46,49,-3,37
Ards,4543,8,9,6,15,39,50,-11,33
Glentoran,4543,9,8,7,15,31,49,-18,31
Ballinamalla,4543,10,9,4,17,30,54,-24,31
Portadown,4543,11,8,5,17,26,48,-22,29
Coleraine,4544,1,15,10,5,39,27,12,55
Crusaders,4544,2,15,9,6,56,39,17,54
Cliftonville,4544,3,15,6,9,53,37,16,51
Linfield,4544,4,14,8,8,58,37,21,50
Glenavon,4544,5,12,11,7,49,42,7,47
Dungannon,4544,6,8,11,11,53,47,6,35
Ballymena,4544,7,9,8,13,56,68,-12,35
Glentoran,4544,8,8,9,13,34,50,-16,33
Ballinamalla,4544,9,9,6,15,29,48,-19,33
Portadown,4544,10,5,12,13,24,41,-17,27
Ards,4544,11,5,10,15,30,45,-15,25
Crusaders,4545,1,17,7,6,53,30,23,58
Cliftonville,4545,2,16,6,8,59,40,19,54
Coleraine,4545,3,13,9,8,49,43,6,48
Ballymena,4545,4,13,5,12,50,51,-1,44
Linfield,4545,5,11,8,11,49,36,13,41
Glenavon,4545,6,11,7,12,48,52,-4,40
Portadown,4545,7,11,5,14,33,45,-12,38
Glentoran,4545,8,10,7,13,31,42,-11,37
Dungannon,4545,9,9,7,14,45,49,-4,34
Ards,4545,10,10,4,16,35,45,-10,34
Ballinamalla,4545,11,10,3,17,31,50,-19,33
Crusaders,4546,1,16,9,5,61,39,22,57
Ballymena,4546,2,16,9,5,59,47,12,57
Linfield,4546,3,14,9,7,60,36,24,51
Coleraine,4546,4,11,12,7,47,36,11,45
Cliftonville,4546,5,13,5,12,44,49,-5,44
Glenavon,4546,6,10,10,10,50,49,1,40
Glentoran,4546,7,8,12,10,34,38,-4,36
Ards,4546,8,9,7,14,38,49,-11,34
Portadown,4546,9,9,5,16,28,44,-16,32
Dungannon,4546,10,7,10,13,43,48,-5,31
Ballinamalla,4546,11,5,6,19,31,60,-29,21
Linfield,4547,1,16,11,3,66,33,33,59
Cliftonville,4547,2,17,5,8,59,33,26,56
Crusaders,4547,3,15,10,5,55,37,18,55
Coleraine,4547,4,9,14,7,42,39,3,41
Glenavon,4547,5,10,11,9,44,48,-4,41
Dungannon,4547,6,9,9,12,48,45,3,36
Glentoran,4547,7,9,9,12,30,40,-10,36
Ballymena,4547,8,9,8,13,56,63,-7,35
Ards,4547,9,9,6,15,34,46,-12,33
Ballinamalla,4547,10,8,7,15,28,46,-18,31
Portadown,4547,11,7,4,19,18,50,-32,25
Linfield,4548,1,16,9,5,61,28,33,57
Crusaders,4548,2,15,8,7,48,33,15,53
Glenavon,4548,3,13,12,5,47,38,9,51
Cliftonville,4548,4,13,8,9,52,40,12,47
Coleraine,4548,5,11,11,8,40,33,7,44
Portadown,4548,6,11,4,15,30,47,-17,37
Ards,4548,7,9,8,13,36,44,-8,35
Ballymena,4548,8,9,7,14,46,58,-12,34
Dungannon,4548,9,7,10,13,43,46,-3,31
Glentoran,4548,10,6,12,12,27,42,-15,30
Ballinamalla,4548,11,7,7,16,30,51,-21,28
Glenavon,4549,1,14,11,5,50,37,13,53
Cliftonville,4549,2,15,7,8,59,43,16,52
Ballymena,4549,3,15,6,9,61,57,4,51
Linfield,4549,4,13,9,8,59,37,22,48
Dungannon,4549,5,13,7,10,52,38,14,46
Crusaders,4549,6,12,9,9,50,39,11,45
Coleraine,4549,7,11,10,9,43,39,4,43
Glentoran,4549,8,9,8,13,36,49,-13,35
Portadown,4549,9,8,6,16,30,48,-18,30
Ards,4549,10,7,5,18,41,59,-18,26
Ballinamalla,4549,11,8,2,20,23,58,-35,26
Crusaders,4550,1,18,7,5,52,31,21,61
Linfield,4550,2,16,10,4,70,27,43,58
Cliftonville,4550,3,14,8,8,53,37,16,50
Dungannon,4550,4,11,11,8,55,42,13,44
Glenavon,4550,5,10,11,9,52,49,3,41
Coleraine,4550,6,10,11,9,36,35,1,41
Ballymena,4550,7,10,11,9,58,60,-2,41
Ballinamalla,4550,8,9,5,16,35,58,-23,32
Glentoran,4550,9,7,7,16,31,55,-24,28
Ards,4550,10,7,6,17,34,49,-15,27
Portadown,4550,11,6,7,17,22,55,-33,25
Crusaders,4551,1,19,7,4,66,37,29,64
Linfield,4551,2,13,10,7,54,34,20,49
Coleraine,4551,3,12,13,5,46,35,11,49
Cliftonville,4551,4,14,6,10,52,39,13,48
Ballymena,4551,5,14,5,11,61,61,0,47
Glenavon,4551,6,10,12,8,50,49,1,42
Dungannon,4551,7,8,13,9,48,41,7,37
Ards,4551,8,10,6,14,35,46,-11,36
Glentoran,4551,9,6,9,15,28,46,-18,27
Ballinamalla,4551,10,7,6,17,26,48,-22,27
Portadown,4551,11,5,7,18,21,51,-30,22
Linfield,4552,1,17,7,6,66,32,34,58
Crusaders,4552,2,14,10,6,52,34,18,52
Dungannon,4552,3,14,7,9,53,37,16,49
Glenavon,4552,4,13,10,7,47,41,6,49
Coleraine,4552,5,12,10,8,49,35,14,46
Ballymena,4552,6,13,4,13,53,65,-12,43
Cliftonville,4552,7,12,6,12,50,55,-5,42
Portadown,4552,8,8,7,15,21,35,-14,31
Ards,4552,9,8,6,16,40,53,-13,30
Glentoran,4552,10,8,6,16,29,50,-21,30
Ballinamalla,4552,11,8,3,19,27,50,-23,27
Cliftonville,4553,1,18,5,7,55,36,19,59
Crusaders,4553,2,16,9,5,57,36,21,57
Linfield,4553,3,15,9,6,60,33,27,54
Glenavon,4553,4,12,12,6,46,37,9,48
Dungannon,4553,5,11,9,10,52,40,12,42
Ballymena,4553,6,11,8,11,46,56,-10,41
Coleraine,4553,7,8,14,8,35,35,0,38
Glentoran,4553,8,8,11,11,32,42,-10,35
Ards,4553,9,8,5,17,35,49,-14,29
Portadown,4553,10,4,10,16,24,50,-26,22
Ballinamalla,4553,11,5,6,19,32,60,-28,21
Linfield,4554,1,16,10,4,54,25,29,58
Cliftonville,4554,2,18,4,8,55,37,18,58
Crusaders,4554,3,15,7,8,48,36,12,52
Dungannon,4554,4,11,9,10,51,41,10,42
Coleraine,4554,5,10,11,9,36,30,6,41
Glenavon,4554,6,11,7,12,40,44,-4,40
Ballymena,4554,7,11,4,15,48,57,-9,37
Ards,4554,8,10,5,15,35,45,-10,35
Glentoran,4554,9,9,6,15,23,37,-14,33
Ballinamalla,4554,10,9,5,16,28,47,-19,32
Portadown,4554,11,7,8,15,28,47,-19,29
Crusaders,4555,1,17,9,4,67,32,35,60
Coleraine,4555,2,14,9,7,45,37,8,51
Cliftonville,4555,3,15,5,10,51,38,13,50
Linfield,4555,4,13,10,7,54,37,17,49
Ballymena,4555,5,13,7,10,61,54,7,46
Glenavon,4555,6,11,12,7,51,48,3,45
Glentoran,4555,7,10,7,13,35,51,-16,37
Dungannon,4555,8,8,9,13,46,49,-3,33
Ards,4555,9,9,5,16,37,50,-13,32
Portadown,4555,10,7,5,18,24,52,-28,26
Ballinamalla,4555,11,5,8,17,29,52,-23,23
Crusaders,4556,1,17,9,4,54,30,24,60
Linfield,4556,2,17,8,5,52,29,23,59
Ballymena,4556,3,16,6,8,66,50,16,54
Cliftonville,4556,4,14,4,12,48,37,11,46
Dungannon,4556,5,11,7,12,53,46,7,40
Ards,4556,6,12,4,14,42,49,-7,40
Coleraine,4556,7,9,10,11,33,38,-5,37
Portadown,4556,8,9,5,16,27,52,-25,32
Glenavon,4556,9,6,13,11,37,45,-8,31
Ballinamalla,4556,10,8,6,16,34,48,-14,30
Glentoran,4556,11,6,8,16,24,46,-22,26
Crusaders,4557,1,16,7,7,52,33,19,55
Cliftonville,4557,2,16,7,7,50,34,16,55
Linfield,4557,3,15,8,7,56,30,26,53
Glenavon,4557,4,12,10,8,54,45,9,46
Coleraine,4557,5,11,10,9,40,41,-1,43
Dungannon,4557,6,10,10,10,51,42,9,40
Glentoran,4557,7,11,7,12,30,38,-8,40
Ballymena,4557,8,10,10,10,47,56,-9,40
Ards,4557,9,11,4,15,40,45,-5,37
Portadown,4557,10,5,7,18,22,46,-24,22
Ballinamalla,4557,11,6,4,20,22,54,-32,22
Crusaders,4558,1,17,8,5,55,32,23,59
Glenavon,4558,2,15,9,6,52,43,9,54
Linfield,4558,3,15,8,7,60,32,28,53
Coleraine,4558,4,13,8,9,43,36,7,47
Cliftonville,4558,5,13,6,11,48,40,8,45
Ballymena,4558,6,12,9,9,49,53,-4,45
Dungannon,4558,7,8,11,11,51,44,7,35
Ballinamalla,4558,8,10,4,16,34,45,-11,34
Glentoran,4558,9,7,9,14,26,47,-21,30
Portadown,4558,10,7,7,16,22,44,-22,28
Ards,4558,11,6,5,19,32,56,-24,23
Crusaders,4559,1,18,8,4,56,30,26,62
Linfield,4559,2,14,10,6,56,29,27,52
Glenavon,4559,3,13,11,6,45,38,7,50
Cliftonville,4559,4,13,8,9,49,40,9,47
Coleraine,4559,5,11,12,7,50,33,17,45
Ballymena,4559,6,10,10,10,54,59,-5,40
Dungannon,4559,7,10,8,12,49,49,0,38
Ards,4559,8,10,3,17,34,54,-20,33
Glentoran,4559,9,8,7,15,27,44,-17,31
Ballinamalla,4559,10,8,5,17,31,51,-20,29
Portadown,4559,11,5,8,17,19,43,-24,23
Crusaders,4560,1,17,7,6,62,40,22,58
Linfield,4560,2,15,8,7,58,33,25,53
Ballymena,4560,3,15,8,7,62,55,7,53
Cliftonville,4560,4,16,4,10,53,41,12,52
Coleraine,4560,5,12,10,8,46,40,6,46
Glenavon,4560,6,11,11,8,43,40,3,44
Dungannon,4560,7,9,11,10,49,46,3,38
Ards,4560,8,11,3,16,43,53,-10,36
Ballinamalla,4560,9,8,4,18,27,49,-22,28
Glentoran,4560,10,5,9,16,27,49,-22,24
Portadown,4560,11,7,3,20,22,46,-24,24
Coleraine,4561,1,14,9,7,44,30,14,51
Crusaders,4561,2,14,8,8,52,32,20,50
Cliftonville,4561,3,14,7,9,54,41,13,49
Linfield,4561,4,13,9,8,56,33,23,48
Glenavon,4561,5,10,11,9,42,42,0,41
Ards,4561,6,12,4,14,35,43,-8,40
Glentoran,4561,7,10,9,11,34,39,-5,39
Dungannon,4561,8,9,11,10,45,43,2,38
Ballymena,4561,9,11,5,14,47,66,-19,38
Portadown,4561,10,9,6,15,29,47,-18,33
Ballinamalla,4561,11,8,3,19,28,50,-22,27
Crusaders,4562,1,15,8,7,56,46,10,53
Cliftonville,4562,2,15,7,8,48,38,10,52
Ballymena,4562,3,15,5,10,58,51,7,50
Linfield,4562,4,13,8,9,52,34,18,47
Glentoran,4562,5,13,7,10,46,46,0,46
Coleraine,4562,6,11,8,11,40,35,5,41
Dungannon,4562,7,9,10,11,50,41,9,37
Glenavon,4562,8,8,12,10,47,53,-6,36
Ards,4562,9,9,5,16,35,50,-15,32
Ballinamalla,4562,10,8,7,15,31,49,-18,31
Portadown,4562,11,9,3,18,30,50,-20,30
Crusaders,4563,1,18,6,6,61,38,23,60
Cliftonville,4563,2,16,6,8,57,37,20,54
Ballymena,4563,3,16,5,9,66,63,3,53
Linfield,4563,4,14,8,8,54,30,24,50
Glenavon,4563,5,10,9,11,42,50,-8,39
Ards,4563,6,10,8,12,36,41,-5,38
Ballinamalla,4563,7,11,4,15,36,47,-11,37
Dungannon,4563,8,9,9,12,44,40,4,36
Coleraine,4563,9,8,12,10,44,51,-7,36
Glentoran,4563,10,7,7,16,33,52,-19,28
Portadown,4563,11,6,6,18,25,49,-24,24
Ballymena,4564,1,16,4,10,61,59,2,52
Linfield,4564,2,13,12,5,57,26,31,51
Crusaders,4564,3,14,9,7,52,36,16,51
Dungannon,4564,4,13,9,8,54,39,15,48
Glenavon,4564,5,13,9,8,49,43,6,48
Coleraine,4564,6,12,9,9,42,43,-1,45
Cliftonville,4564,7,13,3,14,53,48,5,42
Ards,4564,8,10,6,14,38,47,-9,36
Ballinamalla,4564,9,11,2,17,36,56,-20,35
Glentoran,4564,10,7,8,15,27,41,-14,29
Portadown,4564,11,6,3,21,24,55,-31,21
Crusaders,4565,1,17,8,5,70,44,26,59
Ballymena,4565,2,16,7,7,56,46,10,55
Linfield,4565,3,15,8,7,64,33,31,53
Glenavon,4565,4,12,13,5,52,38,14,49
Dungannon,4565,5,13,7,10,50,40,10,46
Coleraine,4565,6,11,9,10,38,41,-3,42
Cliftonville,4565,7,12,5,13,41,42,-1,41
Glentoran,4565,8,9,4,17,27,49,-22,31
Ards,4565,9,8,5,17,34,49,-15,29
Portadown,4565,10,8,4,18,26,50,-24,28
Ballinamalla,4565,11,7,4,19,31,57,-26,25
Crusaders,4566,1,15,8,7,52,36,16,53
Ballymena,4566,2,14,10,6,57,59,-2,52
Linfield,4566,3,14,9,7,63,33,30,51
Cliftonville,4566,4,14,8,8,53,37,16,50
Coleraine,4566,5,12,11,7,46,37,9,47
Glenavon,4566,6,12,8,10,46,42,4,44
Glentoran,4566,7,8,11,11,29,40,-11,35
Dungannon,4566,8,8,10,12,46,46,0,34
Ards,4566,9,8,6,16,34,51,-17,30
Portadown,4566,10,7,7,16,21,41,-20,28
Ballinamalla,4566,11,6,6,18,30,55,-25,24
Linfield,4567,1,15,10,5,70,35,35,55
Crusaders,4567,2,15,6,9,52,39,13,51
Coleraine,4567,3,12,12,6,47,36,11,48
Cliftonville,4567,4,14,4,12,50,49,1,46
Ballymena,4567,5,13,7,10,54,54,0,46
Glenavon,4567,6,11,11,8,45,38,7,44
Ballinamalla,4567,7,12,3,15,33,44,-11,39
Dungannon,4567,8,8,11,11,41,42,-1,35
Ards,4567,9,9,6,15,41,52,-11,33
Portadown,4567,10,8,7,15,37,52,-15,31
Glentoran,4567,11,6,7,17,18,47,-29,25
Linfield,4568,1,17,7,6,62,37,25,58
Glenavon,4568,2,15,10,5,48,33,15,55
Crusaders,4568,3,16,6,8,56,31,25,54
Cliftonville,4568,4,15,4,11,50,41,9,49
Ballymena,4568,5,13,7,10,60,60,0,46
Glentoran,4568,6,11,8,11,39,44,-5,41
Dungannon,4568,7,9,11,10,50,47,3,38
Coleraine,4568,8,8,10,12,33,42,-9,34
Ards,4568,9,8,5,17,39,53,-14,29
Ballinamalla,4568,10,8,4,18,31,53,-22,28
Portadown,4568,11,6,6,18,21,48,-27,24
Crusaders,4569,1,17,5,8,59,43,16,56
Cliftonville,4569,2,17,3,10,55,41,14,54
Dungannon,4569,3,14,9,7,57,34,23,51
Ballymena,4569,4,14,5,11,57,54,3,47
Linfield,4569,5,11,11,8,55,34,21,44
Coleraine,4569,6,11,10,9,40,34,6,43
Glenavon,4569,7,10,11,9,42,47,-5,41
Glentoran,4569,8,11,7,12,36,51,-15,40
Ards,4569,9,10,6,14,39,47,-8,36
Portadown,4569,10,6,5,19,27,52,-25,23
Ballinamalla,4569,11,7,2,21,24,54,-30,23
Cliftonville,4570,1,18,6,6,65,37,28,60
Coleraine,4570,2,16,10,4,46,29,17,58
Crusaders,4570,3,16,8,6,52,31,21,56
Linfield,4570,4,15,8,7,60,32,28,53
Glentoran,4570,5,11,6,13,35,49,-14,39
Glenavon,4570,6,9,11,10,47,51,-4,38
Ballymena,4570,7,10,7,13,49,61,-12,37
Ards,4570,8,10,5,15,37,49,-12,35
Dungannon,4570,9,7,11,12,52,57,-5,32
Portadown,4570,10,7,6,17,32,48,-16,27
Ballinamalla,4570,11,5,4,21,24,55,-31,19
Crusaders,4571,1,17,6,7,61,38,23,57
Linfield,4571,2,14,8,8,58,31,27,50
Cliftonville,4571,3,15,3,12,59,51,8,48
Ballymena,4571,4,14,5,11,50,61,-11,47
Coleraine,4571,5,11,11,8,43,35,8,44
Glenavon,4571,6,11,10,9,46,45,1,43
Dungannon,4571,7,10,9,11,54,44,10,39
Portadown,4571,8,12,3,15,30,41,-11,39
Glentoran,4571,9,9,8,13,29,48,-19,35
Ards,4571,10,8,6,16,39,51,-12,30
Ballinamalla,4571,11,7,5,18,29,53,-24,26
Crusaders,4572,1,18,6,6,58,36,22,60
Ballymena,4572,2,16,6,8,60,58,2,54
Linfield,4572,3,13,9,8,60,33,27,48
Cliftonville,4572,4,13,6,11,49,40,9,45
Coleraine,4572,5,11,11,8,47,39,8,44
Ards,4572,6,12,4,14,43,49,-6,40
Dungannon,4572,7,10,8,12,51,47,4,38
Glenavon,4572,8,9,11,10,42,48,-6,38
Glentoran,4572,9,9,6,15,30,46,-16,33
Portadown,4572,10,8,4,18,21,43,-22,28
Ballinamalla,4572,11,6,9,15,33,55,-22,27
Crusaders,4573,1,16,7,7,54,36,18,55
Cliftonville,4573,2,15,4,11,52,40,12,49
Coleraine,4573,3,12,11,7,43,40,3,47
Ballymena,4573,4,13,7,10,59,55,4,46
Linfield,4573,5,12,7,11,51,45,6,43
Portadown,4573,6,12,5,13,32,41,-9,41
Glenavon,4573,7,10,10,10,52,48,4,40
Glentoran,4573,8,10,7,13,38,46,-8,37
Ards,4573,9,11,3,16,38,47,-9,36
Dungannon,4573,10,8,9,13,45,51,-6,33
Ballinamalla,4573,11,7,8,15,35,50,-15,29
Crusaders,4574,1,19,5,6,65,40,25,62
Cliftonville,4574,2,16,6,8,52,39,13,54
Linfield,4574,3,14,10,6,55,33,22,52
Coleraine,4574,4,14,10,6,52,36,16,52
Glenavon,4574,5,11,11,8,54,52,2,44
Dungannon,4574,6,10,9,11,51,46,5,39
Ballymena,4574,7,10,6,14,52,65,-13,36
Glentoran,4574,8,9,7,14,33,44,-11,34
Ards,4574,9,9,5,16,41,51,-10,32
Portadown,4574,10,7,6,17,22,42,-20,27
Ballinamalla,4574,11,6,5,19,29,58,-29,23
Crusaders,4575,1,18,5,7,61,31,30,59
Cliftonville,4575,2,16,7,7,55,38,17,55
Linfield,4575,3,15,9,6,60,28,32,54
Glenavon,4575,4,14,10,6,50,43,7,52
Ballymena,4575,5,12,9,9,51,54,-3,45
Coleraine,4575,6,10,13,7,36,34,2,43
Dungannon,4575,7,9,7,14,45,48,-3,34
Portadown,4575,8,8,6,16,25,42,-17,30
Ballinamalla,4575,9,8,5,17,24,48,-24,29
Ards,4575,10,6,8,16,32,51,-19,26
Glentoran,4575,11,6,7,17,26,48,-22,25
Crusaders,4576,1,16,6,8,58,41,17,54
Glenavon,4576,2,14,10,6,47,37,10,52
Linfield,4576,3,14,7,9,56,33,23,49
Cliftonville,4576,4,14,6,10,53,42,11,48
Ballymena,4576,5,14,4,12,55,61,-6,46
Coleraine,4576,6,9,12,9,38,39,-1,39
Dungannon,4576,7,8,12,10,52,45,7,36
Glentoran,4576,8,8,10,12,36,52,-16,34
Ballinamalla,4576,9,9,7,14,29,47,-18,34
Ards,4576,10,9,6,15,44,50,-6,33
Portadown,4576,11,8,4,18,29,50,-21,28
Linfield,4577,1,18,9,3,69,32,37,63
Crusaders,4577,2,15,9,6,59,41,18,54
Cliftonville,4577,3,14,6,10,50,34,16,48
Ballymena,4577,4,14,6,10,65,61,4,48
Coleraine,4577,5,10,13,7,41,37,4,43
Glenavon,4577,6,10,13,7,43,42,1,43
Dungannon,4577,7,9,13,8,48,40,8,40
Glentoran,4577,8,12,4,14,33,44,-11,40
Ballinamalla,4577,9,7,5,18,27,52,-25,26
Ards,4577,10,7,4,19,34,56,-22,25
Portadown,4577,11,5,6,19,25,55,-30,21
Crusaders,4578,1,18,7,5,49,27,22,61
Linfield,4578,2,15,7,8,54,31,23,52
Coleraine,4578,3,14,8,8,48,37,11,50
Glenavon,4578,4,13,10,7,49,42,7,49
Cliftonville,4578,5,15,3,12,53,40,13,48
Ballymena,4578,6,13,5,12,56,64,-8,44
Glentoran,4578,7,12,5,13,35,38,-3,41
Dungannon,4578,8,8,11,11,42,39,3,35
Ballinamalla,4578,9,8,5,17,29,50,-21,29
Ards,4578,10,7,5,18,31,51,-20,26
Portadown,4578,11,6,6,18,21,48,-27,24
Linfield,4579,1,17,7,6,64,27,37,58
Crusaders,4579,2,17,6,7,57,36,21,57
Cliftonville,4579,3,15,5,10,57,41,16,50
Glenavon,4579,4,14,8,8,48,45,3,50
Ballymena,4579,5,14,5,11,56,57,-1,47
Coleraine,4579,6,11,10,9,43,38,5,43
Ards,4579,7,10,5,15,36,50,-14,35
Portadown,4579,8,9,7,14,23,42,-19,34
Dungannon,4579,9,8,8,14,41,44,-3,32
Glentoran,4579,10,6,10,14,26,44,-18,28
Ballinamalla,4579,11,6,5,19,22,49,-27,23
Cliftonville,4580,1,17,3,10,56,38,18,54
Linfield,4580,2,15,7,8,55,29,26,52
Glenavon,4580,3,14,8,8,57,49,8,50
Crusaders,4580,4,13,10,7,55,38,17,49
Ballymena,4580,5,14,7,9,58,57,1,49
Glentoran,4580,6,12,5,13,31,42,-11,41
Coleraine,4580,7,10,8,12,41,46,-5,38
Ards,4580,8,10,5,15,40,47,-7,35
Dungannon,4580,9,7,11,12,43,48,-5,32
Portadown,4580,10,8,8,14,25,38,-13,32
Ballinamalla,4580,11,6,6,18,32,61,-29,24
Crusaders,4581,1,20,6,4,55,21,34,66
Cliftonville,4581,2,16,5,9,55,46,9,53
Glenavon,4581,3,13,11,6,55,38,17,50
Linfield,4581,4,12,10,8,58,35,23,46
Coleraine,4581,5,11,10,9,47,47,0,43
Ballymena,4581,6,12,6,12,56,62,-6,42
Dungannon,4581,7,10,10,10,53,45,8,40
Portadown,4581,8,9,6,15,27,47,-20,33
Ballinamalla,4581,9,8,7,15,26,48,-22,31
Ards,4581,10,8,3,19,34,54,-20,27
Glentoran,4581,11,5,8,17,29,52,-23,23
Linfield,4582,1,16,8,6,56,25,31,56
Crusaders,4582,2,16,7,7,53,31,22,55
Cliftonville,4582,3,15,7,8,56,38,18,52
Coleraine,4582,4,12,11,7,44,37,7,47
Ballymena,4582,5,13,7,10,53,54,-1,46
Glenavon,4582,6,10,11,9,47,50,-3,41
Dungannon,4582,7,11,7,12,51,44,7,40
Portadown,4582,8,11,4,15,28,42,-14,37
Ards,4582,9,8,5,17,34,49,-15,29
Glentoran,4582,10,7,8,15,28,47,-19,29
Ballinamalla,4582,11,7,3,20,26,59,-33,24
Crusaders,4583,1,18,9,3,64,29,35,63
Ballymena,4583,2,16,7,7,62,48,14,55
Coleraine,4583,3,15,7,8,47,45,2,52
Cliftonville,4583,4,16,3,11,52,39,13,51
Linfield,4583,5,13,9,8,55,38,17,48
Dungannon,4583,6,12,10,8,52,40,12,46
Glenavon,4583,7,11,9,10,46,49,-3,42
Ards,4583,8,7,5,18,34,55,-21,26
Glentoran,4583,9,6,8,16,30,51,-21,26
Portadown,4583,10,6,6,18,29,50,-21,24
Ballinamalla,4583,11,7,3,20,30,57,-27,24
Crusaders,4584,1,15,8,7,53,35,18,53
Cliftonville,4584,2,15,5,10,55,41,14,50
Linfield,4584,3,13,9,8,61,39,22,48
Ballymena,4584,4,13,7,10,61,58,3,46
Glenavon,4584,5,11,12,7,48,47,1,45
Coleraine,4584,6,11,10,9,44,43,1,43
Dungannon,4584,7,10,12,8,55,45,10,42
Ards,4584,8,9,6,15,39,48,-9,33
Glentoran,4584,9,8,9,13,27,39,-12,33
Portadown,4584,10,8,7,15,26,47,-21,31
Ballinamalla,4584,11,7,5,18,27,54,-27,26
Crusaders,4585,1,16,6,8,55,41,14,54
Linfield,4585,2,14,10,6,62,32,30,52
Glenavon,4585,3,14,9,7,51,42,9,51
Cliftonville,4585,4,15,5,10,55,40,15,50
Coleraine,4585,5,12,10,8,38,37,1,46
Dungannon,4585,6,10,13,7,58,43,15,43
Ballymena,4585,7,11,8,11,51,58,-7,41
Ballinamalla,4585,8,11,2,17,36,52,-16,35
Glentoran,4585,9,8,10,12,29,42,-13,34
Ards,4585,10,8,3,19,35,52,-17,27
Portadown,4585,11,5,6,19,23,54,-31,21
Cliftonville,4586,1,17,6,7,61,40,21,57
Crusaders,4586,2,15,10,5,61,36,25,55
Linfield,4586,3,15,10,5,55,32,23,55
Ballymena,4586,4,14,6,10,58,63,-5,48
Glenavon,4586,5,12,11,7,50,45,5,47
Coleraine,4586,6,11,9,10,39,42,-3,42
Ballinamalla,4586,7,11,5,14,39,49,-10,38
Dungannon,4586,8,8,9,13,50,47,3,33
Glentoran,4586,9,8,6,16,29,48,-19,30
Portadown,4586,10,6,7,17,27,51,-24,25
Ards,4586,11,6,5,19,39,55,-16,23
Linfield,4587,1,18,8,4,69,26,43,62
Crusaders,4587,2,17,8,5,56,30,26,59
Cliftonville,4587,3,15,3,12,46,34,12,48
Ballymena,4587,4,13,6,11,53,57,-4,45
Coleraine,4587,5,9,11,10,33,36,-3,38
Glenavon,4587,6,8,14,8,41,45,-4,38
Dungannon,4587,7,8,11,11,47,43,4,35
Ards,4587,8,10,5,15,43,53,-10,35
Glentoran,4587,9,9,8,13,31,47,-16,35
Portadown,4587,10,8,7,15,25,43,-18,31
Ballinamalla,4587,11,7,5,18,27,57,-30,26
Crusaders,4588,1,20,5,5,71,36,35,65
Cliftonville,4588,2,18,3,9,56,36,20,57
Ballymena,4588,3,16,3,11,58,56,2,51
Glenavon,4588,4,12,13,5,50,42,8,49
Linfield,4588,5,11,10,9,50,37,13,43
Coleraine,4588,6,11,8,11,38,38,0,41
Dungannon,4588,7,11,7,12,55,54,1,40
Ards,4588,8,11,5,14,45,45,0,38
Portadown,4588,9,8,5,17,31,50,-19,29
Glentoran,4588,10,7,5,18,23,55,-32,26
Ballinamalla,4588,11,6,4,20,29,57,-28,22
Linfield,4589,1,16,11,3,53,21,32,59
Cliftonville,4589,2,15,6,9,54,42,12,51
Glenavon,4589,3,13,9,8,50,46,4,48
Ballymena,4589,4,14,5,11,58,57,1,47
Crusaders,4589,5,13,7,10,51,44,7,46
Dungannon,4589,6,13,6,11,50,43,7,45
Ards,4589,7,11,7,12,43,46,-3,40
Coleraine,4589,8,8,11,11,38,42,-4,35
Glentoran,4589,9,8,10,12,27,44,-17,34
Ballinamalla,4589,10,6,7,17,26,45,-19,25
Portadown,4589,11,7,3,20,26,46,-20,24
Crusaders,4590,1,17,5,8,58,42,16,56
Linfield,4590,2,15,10,5,51,25,26,55
Cliftonville,4590,3,15,6,9,50,35,15,51
Coleraine,4590,4,13,9,8,52,43,9,48
Dungannon,4590,5,12,10,8,57,42,15,46
Glenavon,4590,6,10,9,11,48,56,-8,39
Ballymena,4590,7,11,5,14,56,64,-8,38
Glentoran,4590,8,9,10,11,38,44,-6,37
Ards,4590,9,10,5,15,41,53,-12,35
Portadown,4590,10,9,2,19,31,51,-20,29
Ballinamalla,4590,11,7,3,20,31,58,-27,24
Crusaders,4591,1,19,6,5,61,36,25,63
Ballymena,4591,2,17,4,9,61,59,2,55
Cliftonville,4591,3,15,4,11,50,42,8,49
Linfield,4591,4,12,10,8,53,31,22,46
Coleraine,4591,5,11,10,9,45,39,6,43
Glenavon,4591,6,9,12,9,42,43,-1,39
Dungannon,4591,7,8,13,9,52,46,6,37
Glentoran,4591,8,9,8,13,35,43,-8,35
Ards,4591,9,10,4,16,38,49,-11,34
Portadown,4591,10,8,6,16,28,47,-19,30
Ballinamalla,4591,11,5,7,18,25,55,-30,22
Crusaders,4592,1,17,6,7,63,37,26,57
Ballymena,4592,2,15,6,9,56,54,2,51
Cliftonville,4592,3,15,5,10,52,41,11,50
Glenavon,4592,4,13,10,7,49,45,4,49
Linfield,4592,5,13,9,8,57,40,17,48
Coleraine,4592,6,10,14,6,44,30,14,44
Glentoran,4592,7,10,5,15,30,44,-14,35
Dungannon,4592,8,8,10,12,46,46,0,34
Ards,4592,9,8,8,14,40,53,-13,32
Ballinamalla,4592,10,8,5,17,31,55,-24,29
Portadown,4592,11,6,6,18,26,49,-23,24
Crusaders,4593,1,19,7,4,58,25,33,64
Cliftonville,4593,2,17,4,9,55,44,11,55
Ballymena,4593,3,16,4,10,62,53,9,52
Linfield,4593,4,14,7,9,57,36,21,49
Glenavon,4593,5,10,11,9,47,47,0,41
Dungannon,4593,6,10,9,11,45,39,6,39
Coleraine,4593,7,10,9,11,44,45,-1,39
Ards,4593,8,9,4,17,37,53,-16,31
Portadown,4593,9,7,8,15,25,43,-18,29
Glentoran,4593,10,7,8,15,30,52,-22,29
Ballinamalla,4593,11,8,5,17,28,51,-23,29
Crusaders,4594,1,17,9,4,56,37,19,60
Ballymena,4594,2,16,6,8,58,56,2,54
Glenavon,4594,3,14,10,6,54,43,11,52
Linfield,4594,4,12,10,8,57,30,27,46
Cliftonville,4594,5,13,6,11,54,45,9,45
Glentoran,4594,6,12,5,13,44,47,-3,41
Coleraine,4594,7,9,9,12,40,42,-2,36
Ards,4594,8,10,6,14,40,51,-11,36
Dungannon,4594,9,7,12,11,49,49,0,33
Portadown,4594,10,7,7,16,22,45,-23,28
Ballinamalla,4594,11,6,4,20,26,55,-29,22
Crusaders,4595,1,15,11,4,55,36,19,56
Ballymena,4595,2,16,5,9,64,57,7,53
Linfield,4595,3,13,10,7,55,34,21,49
Cliftonville,4595,4,14,7,9,50,37,13,49
Coleraine,4595,5,13,10,7,47,38,9,49
Dungannon,4595,6,9,12,9,53,42,11,39
Glenavon,4595,7,8,15,7,45,47,-2,39
Glentoran,4595,8,6,13,11,28,40,-12,31
Portadown,4595,9,7,9,14,29,46,-17,30
Ards,4595,10,8,4,18,35,55,-20,28
Ballinamalla,4595,11,4,8,18,27,56,-29,20
Cliftonville,4596,1,16,6,8,59,35,24,54
Crusaders,4596,2,16,6,8,53,37,16,54
Ballymena,4596,3,14,8,8,61,60,1,50
Coleraine,4596,4,12,10,8,42,38,4,46
Linfield,4596,5,12,9,9,52,35,17,45
Glentoran,4596,6,11,8,11,40,44,-4,41
Glenavon,4596,7,10,10,10,47,50,-3,40
Dungannon,4596,8,10,8,12,50,47,3,38
Ards,4596,9,8,6,16,40,53,-13,30
Portadown,4596,10,9,3,18,27,47,-20,30
Ballinamalla,4596,11,7,6,17,36,61,-25,27
Crusaders,4597,1,16,9,5,56,42,14,57
Linfield,4597,2,13,12,5,58,27,31,51
Glenavon,4597,3,14,8,8,49,41,8,50
Ballymena,4597,4,13,9,8,65,60,5,48
Cliftonville,4597,5,13,5,12,51,45,6,44
Coleraine,4597,6,9,11,10,46,44,2,38
Dungannon,4597,7,8,10,12,48,46,2,34
Ballinamalla,4597,8,9,5,16,37,53,-16,32
Portadown,4597,9,8,8,14,29,47,-18,32
Glentoran,4597,10,8,8,14,31,52,-21,32
Ards,4597,11,8,7,15,39,52,-13,31
Crusaders,4598,1,19,6,5,60,34,26,63
Ballymena,4598,2,17,5,8,69,55,14,56
Cliftonville,4598,3,15,2,13,55,47,8,47
Dungannon,4598,4,12,9,9,52,40,12,45
Linfield,4598,5,11,10,9,55,41,14,43
Coleraine,4598,6,10,11,9,41,40,1,41
Glenavon,4598,7,9,12,9,39,41,-2,39
Ballinamalla,4598,8,11,4,15,30,46,-16,37
Ards,4598,9,9,7,14,38,46,-8,34
Glentoran,4598,10,6,10,14,28,47,-19,28
Portadown,4598,11,6,4,20,19,49,-30,22
Crusaders,4599,1,16,7,7,52,32,20,55
Ballymena,4599,2,16,5,9,62,56,6,53
Cliftonville,4599,3,15,7,8,53,43,10,52
Coleraine,4599,4,13,9,8,51,43,8,48
Linfield,4599,5,13,8,9,53,31,22,47
Glenavon,4599,6,12,10,8,47,42,5,46
Dungannon,4599,7,11,8,11,51,45,6,41
Ballinamalla,4599,8,9,4,17,31,53,-22,31
Glentoran,4599,9,7,9,14,30,45,-15,30
Ards,4599,10,8,5,17,39,54,-15,29
Portadown,4599,11,6,6,18,25,50,-25,24
Linfield,4600,1,16,8,6,63,31,32,56
Crusaders,4600,2,16,6,8,53,40,13,54
Cliftonville,4600,3,15,4,11,51,36,15,49
Coleraine,4600,4,13,8,9,51,38,13,47
Dungannon,4600,5,13,6,11,52,39,13,45
Ballymena,4600,6,13,4,13,52,64,-12,43
Glenavon,4600,7,11,8,11,51,48,3,41
Ballinamalla,4600,8,12,4,14,35,49,-14,40
Glentoran,4600,9,9,7,14,27,44,-17,34
Ards,4600,10,7,6,17,31,53,-22,27
Portadown,4600,11,6,7,17,23,47,-24,25
Ballymena,4601,1,16,6,8,65,55,10,54
Coleraine,4601,2,15,8,7,49,33,16,53
Linfield,4601,3,12,10,8,54,39,15,46
Cliftonville,4601,4,13,7,10,56,44,12,46
Crusaders,4601,5,12,6,12,44,42,2,42
Dungannon,4601,6,11,8,11,53,43,10,41
Glenavon,4601,7,10,10,10,40,49,-9,40
Ards,4601,8,11,6,13,39,47,-8,39
Glentoran,4601,9,10,8,12,33,41,-8,38
Portadown,4601,10,7,6,17,30,50,-20,27
Ballinamalla,4601,11,6,9,15,28,48,-20,27
Crusaders,4602,1,17,7,6,56,35,21,58
Linfield,4602,2,14,10,6,61,34,27,52
Coleraine,4602,3,13,9,8,49,37,12,48
Ballymena,4602,4,13,7,10,58,62,-4,46
Cliftonville,4602,5,13,6,11,46,40,6,45
Glenavon,4602,6,9,11,10,43,48,-5,38
Glentoran,4602,7,9,10,11,32,45,-13,37
Ards,4602,8,9,8,13,37,45,-8,35
Portadown,4602,9,8,7,15,28,43,-15,31
Dungannon,4602,10,6,12,12,49,53,-4,30
Ballinamalla,4602,11,8,5,17,31,48,-17,29
Linfield,4603,1,16,10,4,59,27,32,58
Crusaders,4603,2,15,7,8,57,37,20,52
Glenavon,4603,3,13,11,6,50,38,12,50
Dungannon,4603,4,13,8,9,55,44,11,47
Cliftonville,4603,5,12,8,10,54,45,9,44
Ballymena,4603,6,11,8,11,45,55,-10,41
Coleraine,4603,7,8,14,8,39,41,-2,38
Ards,4603,8,9,8,13,36,42,-6,35
Glentoran,4603,9,7,9,14,27,45,-18,30
Portadown,4603,10,7,8,15,24,46,-22,29
Ballinamalla,4603,11,6,5,19,27,53,-26,23
Linfield,4604,1,17,7,6,59,31,28,58
Crusaders,4604,2,16,7,7,56,34,22,55
Cliftonville,4604,3,16,5,9,54,40,14,53
Glenavon,4604,4,12,11,7,44,40,4,47
Coleraine,4604,5,11,11,8,43,42,1,44
Dungannon,4604,6,10,11,9,51,37,14,41
Ballymena,4604,7,11,7,12,59,68,-9,40
Glentoran,4604,8,10,9,11,32,39,-7,39
Portadown,4604,9,8,6,16,23,41,-18,30
Ards,4604,10,6,5,19,35,55,-20,23
Ballinamalla,4604,11,6,5,19,24,53,-29,23
Crusaders,4605,1,18,8,4,61,33,28,62
Linfield,4605,2,13,10,7,57,34,23,49
Cliftonville,4605,3,14,7,9,53,39,14,49
Glenavon,4605,4,11,12,7,51,46,5,45
Coleraine,4605,5,11,9,10,44,42,2,42
Ballymena,4605,6,11,6,13,48,57,-9,39
Ards,4605,7,11,5,14,37,48,-11,38
Dungannon,4605,8,9,10,11,50,42,8,37
Portadown,4605,9,8,9,13,33,47,-14,33
Glentoran,4605,10,7,11,12,26,40,-14,32
Ballinamalla,4605,11,7,3,20,22,54,-32,24
Cliftonville,4606,1,17,7,6,63,35,28,58
Linfield,4606,2,15,9,6,58,36,22,54
Crusaders,4606,3,14,8,8,61,42,19,50
Coleraine,4606,4,12,11,7,45,38,7,47
Glenavon,4606,5,11,13,6,47,44,3,46
Ballymena,4606,6,13,6,11,62,63,-1,45
Dungannon,4606,7,11,9,10,55,51,4,42
Ards,4606,8,9,6,15,38,52,-14,33
Glentoran,4606,9,8,6,16,33,50,-17,30
Ballinamalla,4606,10,6,6,18,30,57,-27,24
Portadown,4606,11,5,7,18,22,46,-24,22
Coleraine,4607,1,16,10,4,48,28,20,58
Crusaders,4607,2,15,9,6,53,39,14,54
Linfield,4607,3,13,11,6,51,29,22,50
Ballymena,4607,4,12,9,9,54,57,-3,45
Cliftonville,4607,5,11,8,11,48,43,5,41
Dungannon,4607,6,10,10,10,48,41,7,40
Glentoran,4607,7,11,7,12,36,42,-6,40
Glenavon,4607,8,9,12,9,46,45,1,39
Portadown,4607,9,8,7,15,23,43,-20,31
Ards,4607,10,7,5,18,40,54,-14,26
Ballinamalla,4607,11,7,4,19,28,54,-26,25
Cliftonville,4608,1,17,5,8,57,37,20,56
Crusaders,4608,2,15,10,5,61,33,28,55
Linfield,4608,3,12,9,9,56,42,14,45
Glenavon,4608,4,11,12,7,42,35,7,45
Ballymena,4608,5,13,6,11,56,62,-6,45
Dungannon,4608,6,10,10,10,54,44,10,40
Coleraine,4608,7,10,10,10,38,42,-4,40
Portadown,4608,8,9,8,13,33,39,-6,35
Ards,4608,9,8,7,15,34,46,-12,31
Glentoran,4608,10,8,7,15,28,54,-26,31
Ballinamalla,4608,11,8,4,18,24,49,-25,28
Cliftonville,4609,1,18,4,8,56,32,24,58
Crusaders,4609,2,15,10,5,48,26,22,55
Linfield,4609,3,14,10,6,55,26,29,52
Ballymena,4609,4,16,4,10,52,53,-1,52
Glenavon,4609,5,11,9,10,44,44,0,42
Coleraine,4609,6,10,8,12,38,41,-3,38
Glentoran,4609,7,8,9,13,29,43,-14,33
Ballinamalla,4609,8,8,8,14,28,45,-17,32
Dungannon,4609,9,6,13,11,40,49,-9,31
Portadown,4609,10,9,3,18,24,42,-18,30
Ards,4609,11,7,8,15,30,43,-13,29
Crusaders,4610,1,15,10,5,51,30,21,55
Linfield,4610,2,14,12,4,61,30,31,54
Ballymena,4610,3,16,6,8,56,50,6,54
Cliftonville,4610,4,14,4,12,50,42,8,46
Coleraine,4610,5,10,13,7,37,33,4,43
Glenavon,4610,6,11,8,11,45,46,-1,41
Dungannon,4610,7,11,7,12,53,43,10,40
Glentoran,4610,8,11,6,13,35,43,-8,39
Ards,4610,9,9,6,15,40,50,-10,33
Portadown,4610,10,7,5,18,25,50,-25,26
Ballinamalla,4610,11,6,5,19,23,59,-36,23
Linfield,4611,1,15,9,6,60,31,29,54
Crusaders,4611,2,15,8,7,50,32,18,53
Cliftonville,4611,3,15,6,9,49,38,11,51
Ballymena,4611,4,14,8,8,58,55,3,50
Dungannon,4611,5,11,10,9,52,43,9,43
Coleraine,4611,6,10,12,8,34,31,3,42
Glenavon,4611,7,9,9,12,41,52,-11,36
Ards,4611,8,10,5,15,39,47,-8,35
Glentoran,4611,9,7,10,13,28,42,-14,31
Ballinamalla,4611,10,8,4,18,29,52,-23,28
Portadown,4611,11,6,9,15,28,45,-17,27
Cliftonville,4612,1,18,4,8,64,40,24,58
Ballymena,4612,2,17,6,7,63,55,8,57
Crusaders,4612,3,16,8,6,55,37,18,56
Linfield,4612,4,15,8,7,60,29,31,53
Coleraine,4612,5,12,10,8,44,38,6,46
Glenavon,4612,6,11,9,10,44,45,-1,42
Dungannon,4612,7,9,10,11,49,46,3,37
Glentoran,4612,8,10,7,13,33,41,-8,37
Ards,4612,9,9,5,16,38,50,-12,32
Portadown,4612,10,6,5,19,31,62,-31,23
Ballinamalla,4612,11,5,2,23,27,65,-38,17
Linfield,4613,1,15,11,4,58,32,26,56
Cliftonville,4613,2,16,5,9,62,43,19,53
Ballymena,4613,3,14,7,9,63,56,7,49
Dungannon,4613,4,13,8,9,54,40,14,47
Crusaders,4613,5,13,6,11,44,37,7,45
Glenavon,4613,6,10,11,9,44,45,-1,41
Glentoran,4613,7,11,8,11,35,39,-4,41
Coleraine,4613,8,9,12,9,39,40,-1,39
Ards,4613,9,8,7,15,39,52,-13,31
Portadown,4613,10,8,3,19,24,53,-29,27
Ballinamalla,4613,11,6,6,18,35,60,-25,24
Crusaders,4614,1,20,7,3,57,25,32,67
Linfield,4614,2,17,9,4,60,29,31,60
Cliftonville,4614,3,18,4,8,53,36,17,58
Ballymena,4614,4,12,8,10,61,59,2,44
Glenavon,4614,5,11,9,10,56,53,3,42
Coleraine,4614,6,8,12,10,36,41,-5,36
Ballinamalla,4614,7,9,7,14,29,44,-15,34
Ards,4614,8,9,6,15,39,51,-12,33
Dungannon,4614,9,6,10,14,45,53,-8,28
Glentoran,4614,10,6,7,17,29,51,-22,25
Portadown,4614,11,6,7,17,18,41,-23,25
Crusaders,4615,1,16,8,6,50,34,16,56
Linfield,4615,2,15,9,6,59,35,24,54
Cliftonville,4615,3,15,7,8,52,37,15,52
Glenavon,4615,4,12,8,10,49,47,2,44
Coleraine,4615,5,11,9,10,43,40,3,42
Dungannon,4615,6,11,8,11,50,42,8,41
Ballymena,4615,7,11,5,14,56,68,-12,38
Glentoran,4615,8,10,6,14,33,42,-9,36
Ards,4615,9,9,7,14,38,43,-5,34
Portadown,4615,10,9,6,15,27,42,-15,33
Ballinamalla,4615,11,7,5,18,27,54,-27,26
Crusaders,4616,1,20,6,4,60,29,31,66
Linfield,4616,2,15,8,7,58,31,27,53
Glenavon,4616,3,14,10,6,51,37,14,52
Cliftonville,4616,4,14,4,12,50,39,11,46
Coleraine,4616,5,10,12,8,45,40,5,42
Ballymena,4616,6,11,6,13,52,63,-11,39
Glentoran,4616,7,9,9,12,30,43,-13,36
Portadown,4616,8,10,5,15,34,47,-13,35
Dungannon,4616,9,7,11,12,43,46,-3,32
Ards,4616,10,8,5,17,35,55,-20,29
Ballinamalla,4616,11,7,4,19,28,56,-28,25
Ballymena,4617,1,15,6,9,62,61,1,51
Cliftonville,4617,2,16,2,12,53,38,15,50
Coleraine,4617,3,14,8,8,45,40,5,50
Crusaders,4617,4,14,6,10,49,40,9,48
Linfield,4617,5,11,14,5,55,30,25,47
Glenavon,4617,6,10,11,9,49,49,0,41
Ards,4617,7,12,5,13,41,46,-5,41
Glentoran,4617,8,10,10,10,35,41,-6,40
Dungannon,4617,9,9,10,11,47,43,4,37
Portadown,4617,10,7,5,18,21,48,-27,26
Ballinamalla,4617,11,7,3,20,28,49,-21,24
Crusaders,4618,1,17,7,6,62,37,25,58
Ballymena,4618,2,18,4,8,66,53,13,58
Linfield,4618,3,15,8,7,58,27,31,53
Cliftonville,4618,4,16,4,10,57,46,11,52
Coleraine,4618,5,10,13,7,39,34,5,43
Dungannon,4618,6,10,10,10,51,42,9,40
Glenavon,4618,7,9,11,10,42,45,-3,38
Ballinamalla,4618,8,9,6,15,33,58,-25,33
Portadown,4618,9,9,2,19,28,51,-23,29
Glentoran,4618,10,6,10,14,24,40,-16,28
Ards,4618,11,6,5,19,37,64,-27,23
Crusaders,4619,1,16,6,8,57,35,22,54
Linfield,4619,2,14,7,9,54,35,19,49
Glenavon,4619,3,13,9,8,56,44,12,48
Coleraine,4619,4,13,9,8,45,39,6,48
Ballymena,4619,5,14,6,10,59,59,0,48
Cliftonville,4619,6,14,5,11,56,49,7,47
Dungannon,4619,7,10,9,11,47,43,4,39
Glentoran,4619,8,11,6,13,32,42,-10,39
Ballinamalla,4619,9,10,4,16,32,50,-18,34
Ards,4619,10,7,8,15,37,54,-17,29
Portadown,4619,11,6,5,19,27,52,-25,23
Crusaders,4620,1,19,8,3,62,34,28,65
Linfield,4620,2,17,7,6,53,25,28,58
Cliftonville,4620,3,16,6,8,55,37,18,54
Ballymena,4620,4,14,4,12,52,58,-6,46
Coleraine,4620,5,11,10,9,45,42,3,43
Dungannon,4620,6,10,11,9,48,39,9,41
Ballinamalla,4620,7,10,7,13,35,49,-14,37
Glenavon,4620,8,8,9,13,38,48,-10,33
Glentoran,4620,9,8,8,14,29,41,-12,32
Ards,4620,10,7,4,19,31,49,-18,25
Portadown,4620,11,5,6,19,20,46,-26,21
Crusaders,4621,1,16,10,4,58,28,30,58
Linfield,4621,2,16,8,6,60,24,36,56
Cliftonville,4621,3,16,7,7,50,33,17,55
Coleraine,4621,4,12,13,5,47,33,14,49
Ballymena,4621,5,12,8,10,58,64,-6,44
Dungannon,4621,6,9,11,10,49,44,5,38
Glenavon,4621,7,7,13,10,43,53,-10,34
Ballinamalla,4621,8,9,6,15,34,48,-14,33
Ards,4621,9,7,7,16,31,50,-19,28
Glentoran,4621,10,7,7,16,25,50,-25,28
Portadown,4621,11,7,4,19,26,54,-28,25
Linfield,4622,1,16,8,6,59,30,29,56
Ballymena,4622,2,17,5,8,58,51,7,56
Cliftonville,4622,3,16,5,9,61,45,16,53
Crusaders,4622,4,15,6,9,46,33,13,51
Glenavon,4622,5,11,11,8,49,43,6,44
Coleraine,4622,6,11,10,9,40,43,-3,43
Dungannon,4622,7,10,10,10,53,41,12,40
Glentoran,4622,8,9,5,16,25,43,-18,32
Ards,4622,9,8,7,15,28,44,-16,31
Ballinamalla,4622,10,7,5,18,31,52,-21,26
Portadown,4622,11,6,6,18,24,49,-25,24
Cliftonville,4623,1,18,5,7,59,37,22,59
Linfield,4623,2,15,11,4,59,29,30,56
Crusaders,4623,3,14,7,9,56,42,14,49
Ballymena,4623,4,12,8,10,47,55,-8,44
Coleraine,4623,5,11,10,9,36,31,5,43
Dungannon,4623,6,10,11,9,54,44,10,41
Glentoran,4623,7,10,8,12,31,37,-6,38
Glenavon,4623,8,8,11,11,42,48,-6,35
Ards,4623,9,7,7,16,31,47,-16,28
Portadown,4623,10,7,7,16,24,46,-22,28
Ballinamalla,4623,11,6,9,15,28,51,-23,27
Crusaders,4624,1,17,9,4,59,25,34,60
Cliftonville,4624,2,16,4,10,51,39,12,52
Ballymena,4624,3,15,6,9,58,53,5,51
Linfield,4624,4,12,8,10,52,34,18,44
Coleraine,4624,5,12,8,10,43,49,-6,44
Glentoran,4624,6,11,6,13,38,38,0,39
Dungannon,4624,7,10,8,12,50,48,2,38
Glenavon,4624,8,10,8,12,51,56,-5,38
Ards,4624,9,11,3,16,38,51,-13,36
Ballinamalla,4624,10,10,2,18,29,55,-26,32
Portadown,4624,11,7,6,17,23,44,-21,27
Crusaders,4625,1,16,9,5,55,31,24,57
Linfield,4625,2,15,8,7,57,30,27,53
Ballymena,4625,3,15,6,9,53,54,-1,51
Cliftonville,4625,4,14,6,10,49,33,16,48
Coleraine,4625,5,12,11,7,44,39,5,47
Glenavon,4625,6,10,9,11,46,52,-6,39
Glentoran,4625,7,10,8,12,30,39,-9,38
Dungannon,4625,8,9,9,12,49,42,7,36
Ards,4625,9,10,5,15,39,49,-10,35
Portadown,4625,10,7,5,18,24,47,-23,26
Ballinamalla,4625,11,8,2,20,27,57,-30,26
Linfield,4626,1,15,10,5,60,33,27,55
Glenavon,4626,2,14,9,7,52,38,14,51
Crusaders,4626,3,13,10,7,55,41,14,49
Cliftonville,4626,4,14,6,10,60,50,10,48
Coleraine,4626,5,12,11,7,50,40,10,47
Ballymena,4626,6,13,5,12,53,63,-10,44
Ards,4626,7,10,4,16,39,48,-9,34
Glentoran,4626,8,8,9,13,32,44,-12,33
Portadown,4626,9,9,5,16,30,46,-16,32
Dungannon,4626,10,7,10,13,45,48,-3,31
Ballinamalla,4626,11,9,3,18,29,54,-25,30
Linfield,4627,1,16,11,3,54,21,33,59
Cliftonville,4627,2,18,4,8,59,35,24,58
Crusaders,4627,3,14,9,7,55,32,23,51
Ballymena,4627,4,14,6,10,56,54,2,48
Glenavon,4627,5,12,10,8,52,46,6,46
Coleraine,4627,6,8,13,9,39,47,-8,37
Glentoran,4627,7,9,8,13,30,48,-18,35
Dungannon,4627,8,7,11,12,43,48,-5,32
Ards,4627,9,9,5,16,35,45,-10,32
Portadown,4627,10,7,6,17,27,47,-20,27
Ballinamalla,4627,11,5,9,16,31,58,-27,24
Crusaders,4628,1,16,8,6,57,36,21,56
Ballymena,4628,2,15,8,7,56,52,4,53
Linfield,4628,3,13,12,5,56,31,25,51
Coleraine,4628,4,12,12,6,47,38,9,48
Glenavon,4628,5,11,12,7,52,40,12,45
Cliftonville,4628,6,12,8,10,50,44,6,44
Dungannon,4628,7,7,14,9,45,45,0,35
Ards,4628,8,9,7,14,38,51,-13,34
Glentoran,4628,9,6,9,15,26,43,-17,27
Ballinamalla,4628,10,6,8,16,32,54,-22,26
Portadown,4628,11,6,6,18,24,49,-25,24
Crusaders,4629,1,16,7,7,54,35,19,55
Linfield,4629,2,14,12,4,57,27,30,54
Glenavon,4629,3,14,11,5,48,38,10,53
Cliftonville,4629,4,14,7,9,50,36,14,49
Coleraine,4629,5,10,15,5,45,37,8,45
Ballymena,4629,6,9,8,13,54,65,-11,35
Ards,4629,7,9,6,15,38,48,-10,33
Glentoran,4629,8,7,11,12,31,40,-9,32
Portadown,4629,9,9,5,16,23,44,-21,32
Dungannon,4629,10,6,12,12,45,45,0,30
Ballinamalla,4629,11,8,4,18,31,61,-30,28
Crusaders,4630,1,19,5,6,61,30,31,62
Linfield,4630,2,15,8,7,55,33,22,53
Cliftonville,4630,3,15,6,9,50,37,13,51
Ballymena,4630,4,12,8,10,53,57,-4,44
Glenavon,4630,5,11,10,9,46,46,0,43
Dungannon,4630,6,11,9,10,48,42,6,42
Coleraine,4630,7,10,9,11,39,37,2,39
Ards,4630,8,9,5,16,38,49,-11,32
Glentoran,4630,9,8,8,14,30,50,-20,32
Portadown,4630,10,8,6,16,27,43,-16,30
Ballinamalla,4630,11,7,6,17,23,46,-23,27
Crusaders,4631,1,18,6,6,56,34,22,60
Coleraine,4631,2,15,9,6,50,33,17,54
Linfield,4631,3,14,7,9,57,38,19,49
Glenavon,4631,4,12,9,9,52,38,14,45
Cliftonville,4631,5,13,4,13,50,46,4,43
Ballymena,4631,6,12,5,13,57,66,-9,41
Glentoran,4631,7,10,7,13,39,44,-5,37
Portadown,4631,8,11,4,15,26,45,-19,37
Ballinamalla,4631,9,9,5,16,30,50,-20,32
Dungannon,4631,10,7,10,13,44,48,-4,31
Ards,4631,11,8,6,16,37,56,-19,30
Ballymena,4632,1,16,5,9,56,51,5,53
Linfield,4632,2,14,9,7,57,26,31,51
Crusaders,4632,3,13,9,8,47,37,10,48
Coleraine,4632,4,13,8,9,40,40,0,47
Portadown,4632,5,13,5,12,27,34,-7,44
Cliftonville,4632,6,13,4,13,53,44,9,43
Glenavon,4632,7,10,12,8,44,42,2,42
Dungannon,4632,8,10,10,10,54,41,13,40
Ballinamalla,4632,9,9,4,17,26,48,-22,31
Ards,4632,10,7,7,16,31,50,-19,28
Glentoran,4632,11,7,7,16,25,47,-22,28
Linfield,4633,1,16,8,6,55,27,28,56
Glenavon,4633,2,15,11,4,52,38,14,56
Crusaders,4633,3,14,9,7,57,47,10,51
Coleraine,4633,4,14,8,8,48,40,8,50
Cliftonville,4633,5,14,6,10,55,43,12,48
Dungannon,4633,6,11,8,11,57,43,14,41
Glentoran,4633,7,10,7,13,38,45,-7,37
Ballymena,4633,8,9,10,11,53,63,-10,37
Ballinamalla,4633,9,8,5,17,33,54,-21,29
Portadown,4633,10,6,8,16,26,48,-22,26
Ards,4633,11,6,4,20,32,58,-26,22
Crusaders,4634,1,18,8,4,64,39,25,62
Ballymena,4634,2,15,6,9,59,60,-1,51
Linfield,4634,3,13,8,9,61,41,20,47
Cliftonville,4634,4,13,6,11,51,41,10,45
Coleraine,4634,5,11,9,10,45,42,3,42
Glenavon,4634,6,10,11,9,46,44,2,41
Glentoran,4634,7,10,9,11,34,36,-2,39
Dungannon,4634,8,8,9,13,48,50,-2,33
Portadown,4634,9,9,6,15,30,45,-15,33
Ballinamalla,4634,10,8,7,15,30,52,-22,31
Ards,4634,11,8,5,17,38,56,-18,29
Crusaders,4635,1,17,7,6,57,36,21,58
Cliftonville,4635,2,18,4,8,56,35,21,58
Linfield,4635,3,15,9,6,61,30,31,54
Ballymena,4635,4,16,6,8,68,58,10,54
Coleraine,4635,5,10,10,10,37,37,0,40
Dungannon,4635,6,9,12,9,53,43,10,39
Glenavon,4635,7,8,13,9,41,47,-6,37
Ards,4635,8,10,4,16,37,53,-16,34
Portadown,4635,9,9,4,17,26,48,-22,31
Glentoran,4635,10,6,10,14,34,52,-18,28
Ballinamalla,4635,11,4,7,19,26,57,-31,19
Cliftonville,4636,1,19,2,9,58,35,23,59
Crusaders,4636,2,16,7,7,60,33,27,55
Linfield,4636,3,13,9,8,54,37,17,48
Ballymena,4636,4,14,5,11,61,58,3,47
Glenavon,4636,5,12,9,9,50,45,5,45
Dungannon,4636,6,11,9,10,50,43,7,42
Glentoran,4636,7,12,5,13,31,42,-11,41
Coleraine,4636,8,10,8,12,39,47,-8,38
Ballinamalla,4636,9,11,2,17,36,58,-22,35
Portadown,4636,10,7,7,16,29,47,-18,28
Ards,4636,11,7,3,20,31,54,-23,24
Crusaders,4637,1,18,6,6,56,35,21,60
Linfield,4637,2,16,10,4,62,30,32,58
Cliftonville,4637,3,17,4,9,59,36,23,55
Glenavon,4637,4,11,11,8,47,45,2,44
Ballymena,4637,5,13,5,12,56,59,-3,44
Dungannon,4637,6,10,8,12,53,44,9,38
Coleraine,4637,7,9,11,10,37,39,-2,38
Portadown,4637,8,9,4,17,28,50,-22,31
Ards,4637,9,8,6,16,33,50,-17,30
Glentoran,4637,10,7,9,14,28,46,-18,30
Ballinamalla,4637,11,7,6,17,27,52,-25,27
Linfield,4638,1,16,10,4,69,26,43,58
Crusaders,4638,2,15,10,5,55,33,22,55
Cliftonville,4638,3,17,4,9,59,44,15,55
Ballymena,4638,4,15,5,10,60,61,-1,50
Glenavon,4638,5,11,11,8,48,45,3,44
Dungannon,4638,6,10,10,10,48,45,3,40
Ards,4638,7,11,5,14,49,52,-3,38
Coleraine,4638,8,8,12,10,42,45,-3,36
Glentoran,4638,9,8,7,15,32,51,-19,31
Ballinamalla,4638,10,8,5,17,31,50,-19,29
Portadown,4638,11,5,3,22,21,62,-41,18
Crusaders,4639,1,16,8,6,63,37,26,56
Cliftonville,4639,2,17,5,8,51,33,18,56
Glenavon,4639,3,14,11,5,52,40,12,53
Linfield,4639,4,14,7,9,58,37,21,49
Dungannon,4639,5,13,10,7,54,39,15,49
Ballymena,4639,6,13,3,14,57,60,-3,42
Coleraine,4639,7,9,10,11,37,41,-4,37
Ards,4639,8,10,6,14,40,46,-6,36
Glentoran,4639,9,8,6,16,35,59,-24,30
Ballinamalla,4639,10,8,5,17,31,55,-24,29
Portadown,4639,11,5,5,20,22,53,-31,20
Crusaders,4640,1,19,6,5,62,28,34,63
Linfield,4640,2,14,10,6,52,31,21,52
Cliftonville,4640,3,15,4,11,48,39,9,49
Ballymena,4640,4,13,7,10,59,58,1,46
Dungannon,4640,5,11,8,11,49,43,6,41
Glenavon,4640,6,10,11,9,48,45,3,41
Coleraine,4640,7,8,12,10,36,39,-3,36
Glentoran,4640,8,9,8,13,32,45,-13,35
Ards,4640,9,9,6,15,36,49,-13,33
Ballinamalla,4640,10,9,3,18,29,57,-28,30
Portadown,4640,11,8,5,17,26,43,-17,29
Ballymena,4641,1,19,5,6,65,47,18,62
Crusaders,4641,2,18,5,7,54,27,27,59
Cliftonville,4641,3,15,4,11,52,43,9,49
Linfield,4641,4,12,10,8,59,41,18,46
Coleraine,4641,5,12,8,10,46,42,4,44
Glenavon,4641,6,11,10,9,52,49,3,43
Dungannon,4641,7,9,11,10,49,44,5,38
Ards,4641,8,10,6,14,40,51,-11,36
Glentoran,4641,9,8,6,16,33,50,-17,30
Portadown,4641,10,6,8,16,25,50,-25,26
Ballinamalla,4641,11,6,5,19,27,58,-31,23
Crusaders,4642,1,16,9,5,55,37,18,57
Ballymena,4642,2,16,6,8,61,53,8,54
Linfield,4642,3,15,8,7,65,27,38,53
Cliftonville,4642,4,13,7,10,52,46,6,46
Coleraine,4642,5,11,10,9,43,43,0,43
Glenavon,4642,6,9,13,8,44,41,3,40
Ards,4642,7,11,6,13,44,49,-5,39
Glentoran,4642,8,10,5,15,33,50,-17,35
Dungannon,4642,9,7,11,12,46,47,-1,32
Ballinamalla,4642,10,7,7,16,32,53,-21,28
Portadown,4642,11,6,6,18,26,55,-29,24
Crusaders,4643,1,16,6,8,56,38,18,54
Ballymena,4643,2,15,5,10,65,62,3,50
Linfield,4643,3,13,9,8,57,41,16,48
Coleraine,4643,4,12,11,7,48,39,9,47
Cliftonville,4643,5,13,6,11,49,39,10,45
Glenavon,4643,6,12,9,9,49,50,-1,45
Dungannon,4643,7,9,11,10,47,44,3,38
Glentoran,4643,8,9,8,13,38,47,-9,35
Portadown,4643,9,9,7,14,32,43,-11,34
Ards,4643,10,9,6,15,36,48,-12,33
Ballinamalla,4643,11,7,4,19,30,56,-26,25
Crusaders,4644,1,17,8,5,56,31,25,59
Cliftonville,4644,2,17,4,9,57,35,22,55
Linfield,4644,3,13,9,8,53,32,21,48
Ballymena,4644,4,13,7,10,52,56,-4,46
Coleraine,4644,5,11,12,7,42,35,7,45
Dungannon,4644,6,11,9,10,49,39,10,42
Glenavon,4644,7,10,10,10,49,48,1,40
Glentoran,4644,8,9,7,14,28,46,-18,34
Portadown,4644,9,7,9,14,34,53,-19,30
Ards,4644,10,8,4,18,36,51,-15,28
Ballinamalla,4644,11,7,5,18,25,55,-30,26
Linfield,4645,1,14,11,5,56,31,25,53
Crusaders,4645,2,15,8,7,53,37,16,53
Ballymena,4645,3,15,6,9,62,60,2,51
Glenavon,4645,4,12,12,6,50,43,7,48
Cliftonville,4645,5,13,6,11,53,44,9,45
Coleraine,4645,6,10,13,7,35,34,1,43
Dungannon,4645,7,9,8,13,52,50,2,35
Ballinamalla,4645,8,9,5,16,34,48,-14,32
Glentoran,4645,9,7,10,13,24,37,-13,31
Portadown,4645,10,8,7,15,28,44,-16,31
Ards,4645,11,7,6,17,36,55,-19,27
Linfield,4646,1,16,8,6,63,35,28,56
Crusaders,4646,2,15,10,5,56,33,23,55
Cliftonville,4646,3,15,6,9,51,42,9,51
Ballymena,4646,4,12,10,8,55,57,-2,46
Glenavon,4646,5,10,13,7,45,42,3,43
Dungannon,4646,6,11,9,10,64,50,14,42
Coleraine,4646,7,10,11,9,42,39,3,41
Ards,4646,8,10,3,17,43,53,-10,33
Glentoran,4646,9,8,8,14,30,45,-15,32
Ballinamalla,4646,10,8,4,18,31,62,-31,28
Portadown,4646,11,6,6,18,29,51,-22,24
Crusaders,4647,1,16,8,6,56,36,20,56
Glenavon,4647,2,15,8,7,49,42,7,53
Cliftonville,4647,3,15,6,9,52,39,13,51
Ballymena,4647,4,14,6,10,63,60,3,48
Linfield,4647,5,12,10,8,49,31,18,46
Dungannon,4647,6,13,7,10,47,41,6,46
Coleraine,4647,7,8,12,10,42,42,0,36
Ards,4647,8,10,5,15,43,49,-6,35
Glentoran,4647,9,8,7,15,35,48,-13,31
Portadown,4647,10,8,4,18,29,53,-24,28
Ballinamalla,4647,11,8,3,19,37,61,-24,27
Linfield,4648,1,19,8,3,64,21,43,65
Cliftonville,4648,2,15,6,9,51,36,15,51
Crusaders,4648,3,15,6,9,54,41,13,51
Ballymena,4648,4,13,6,11,54,56,-2,45
Coleraine,4648,5,11,9,10,43,42,1,42
Glenavon,4648,6,9,12,9,45,44,1,39
Portadown,4648,7,11,5,14,35,49,-14,38
Dungannon,4648,8,9,9,12,44,41,3,36
Ards,4648,9,8,6,16,32,51,-19,30
Glentoran,4648,10,8,6,16,27,46,-19,30
Ballinamalla,4648,11,8,5,17,26,48,-22,29
Cliftonville,4649,1,18,6,6,55,34,21,60
Crusaders,4649,2,15,7,8,53,32,21,52
Linfield,4649,3,14,8,8,58,33,25,50
Glenavon,4649,4,12,8,10,49,53,-4,44
Coleraine,4649,5,10,13,7,42,36,6,43
Dungannon,4649,6,11,9,10,52,44,8,42
Ballymena,4649,7,10,9,11,52,54,-2,39
Ards,4649,8,10,5,15,34,52,-18,35
Glentoran,4649,9,8,8,14,28,45,-17,32
Ballinamalla,4649,10,8,5,17,33,49,-16,29
Portadown,4649,11,9,2,19,25,49,-24,29
Crusaders,4650,1,16,10,4,61,32,29,58
Linfield,4650,2,15,10,5,64,32,32,55
Coleraine,4650,3,14,9,7,42,34,8,51
Ballymena,4650,4,13,8,9,55,58,-3,47
Cliftonville,4650,5,12,9,9,46,38,8,45
Glenavon,4650,6,11,11,8,46,41,5,44
Dungannon,4650,7,10,9,11,52,47,5,39
Ards,4650,8,9,5,16,40,50,-10,32
Glentoran,4650,9,7,7,16,39,56,-17,28
Ballinamalla,4650,10,8,4,18,28,55,-27,28
Portadown,4650,11,7,4,19,24,54,-30,25
Linfield,4651,1,17,8,5,64,32,32,59
Crusaders,4651,2,17,6,7,54,30,24,57
Coleraine,4651,3,13,10,7,46,34,12,49
Cliftonville,4651,4,14,7,9,47,38,9,49
Ballymena,4651,5,12,6,12,51,59,-8,42
Dungannon,4651,6,10,11,9,54,43,11,41
Portadown,4651,7,11,6,13,37,48,-11,39
Glenavon,4651,8,9,9,12,42,53,-11,36
Ards,4651,9,8,6,16,34,48,-14,30
Ballinamalla,4651,10,8,4,18,32,52,-20,28
Glentoran,4651,11,6,7,17,28,52,-24,25
Crusaders,4652,1,17,8,5,54,31,23,59
Linfield,4652,2,16,9,5,67,31,36,57
Cliftonville,4652,3,15,7,8,53,35,18,52
Coleraine,4652,4,13,10,7,42,35,7,49
Ballymena,4652,5,14,5,11,57,61,-4,47
Dungannon,4652,6,12,9,9,51,44,7,45
Glenavon,4652,7,10,9,11,43,46,-3,39
Ards,4652,8,9,6,15,38,48,-10,33
Portadown,4652,9,8,2,20,26,47,-21,26
Glentoran,4652,10,6,8,16,21,45,-24,26
Ballinamalla,4652,11,7,3,20,25,54,-29,24
Ballymena,4653,1,16,8,6,59,52,7,56
Cliftonville,4653,2,15,6,9,55,38,17,51
Crusaders,4653,3,13,8,9,54,44,10,47
Linfield,4653,4,12,9,9,62,37,25,45
Dungannon,4653,5,11,11,8,51,41,10,44
Glenavon,4653,6,10,13,7,49,48,1,43
Coleraine,4653,7,10,11,9,42,39,3,41
Ards,4653,8,12,5,13,41,43,-2,41
Glentoran,4653,9,10,7,13,40,48,-8,37
Ballinamalla,4653,10,7,5,18,25,52,-27,26
Portadown,4653,11,5,5,20,19,55,-36,20
Cliftonville,4654,1,21,3,6,69,35,34,66
Crusaders,4654,2,18,5,7,55,33,22,59
Coleraine,4654,3,15,8,7,43,33,10,53
Linfield,4654,4,13,9,8,55,34,21,48
Ballymena,4654,5,13,5,12,53,55,-2,44
Glenavon,4654,6,10,9,11,39,44,-5,39
Glentoran,4654,7,10,9,11,33,40,-7,39
Dungannon,4654,8,8,9,13,46,45,1,33
Portadown,4654,9,9,3,18,24,50,-26,30
Ards,4654,10,8,3,19,31,52,-21,27
Ballinamalla,4654,11,6,5,19,25,52,-27,23
Linfield,4655,1,14,12,4,56,29,27,54
Ballymena,4655,2,16,6,8,62,54,8,54
Crusaders,4655,3,14,10,6,59,47,12,52
Cliftonville,4655,4,16,3,11,55,40,15,51
Dungannon,4655,5,12,8,10,55,44,11,44
Coleraine,4655,6,11,9,10,45,42,3,42
Glenavon,4655,7,11,9,10,52,51,1,42
Glentoran,4655,8,9,10,11,34,50,-16,37
Portadown,4655,9,7,6,17,25,46,-21,27
Ards,4655,10,7,5,18,35,52,-17,26
Ballinamalla,4655,11,7,4,19,26,49,-23,25
Crusaders,4656,1,18,7,5,63,34,29,61
Ballymena,4656,2,16,6,8,64,56,8,54
Glenavon,4656,3,15,8,7,52,39,13,53
Linfield,4656,4,12,11,7,56,34,22,47
Cliftonville,4656,5,14,3,13,54,42,12,45
Coleraine,4656,6,11,10,9,40,35,5,43
Dungannon,4656,7,10,9,11,44,42,2,39
Glentoran,4656,8,9,8,13,30,45,-15,35
Ballinamalla,4656,9,8,6,16,34,54,-20,30
Ards,4656,10,7,7,16,34,54,-20,28
Portadown,4656,11,6,3,21,19,55,-36,21
Crusaders,4657,1,16,10,4,53,30,23,58
Linfield,4657,2,14,8,8,58,39,19,50
Ballymena,4657,3,14,5,11,61,61,0,47
Glenavon,4657,4,11,11,8,52,47,5,44
Cliftonville,4657,5,13,5,12,48,44,4,44
Coleraine,4657,6,11,9,10,40,39,1,42
Ards,4657,7,12,4,14,42,46,-4,40
Glentoran,4657,8,10,10,10,38,42,-4,40
Dungannon,4657,9,7,10,13,42,42,0,31
Ballinamalla,4657,10,9,3,18,27,50,-23,30
Portadown,4657,11,8,5,17,21,42,-21,29
Ballymena,4658,1,17,5,8,68,53,15,56
Crusaders,4658,2,15,9,6,54,31,23,54
Glenavon,4658,3,14,11,5,55,39,16,53
Cliftonville,4658,4,14,5,11,57,48,9,47
Linfield,4658,5,12,9,9,47,33,14,45
Coleraine,4658,6,11,9,10,45,52,-7,42
Ballinamalla,4658,7,11,3,16,32,49,-17,36
Portadown,4658,8,8,8,14,27,41,-14,32
Dungannon,4658,9,7,10,13,42,49,-7,31
Ards,4658,10,8,5,17,38,53,-15,29
Glentoran,4658,11,6,10,14,28,45,-17,28
Crusaders,4659,1,16,7,7,56,44,12,55
Ballymena,4659,2,17,4,9,63,56,7,55
Cliftonville,4659,3,14,9,7,51,37,14,51
Glenavon,4659,4,13,10,7,54,42,12,49
Coleraine,4659,5,10,12,8,37,32,5,42
Linfield,4659,6,10,9,11,49,37,12,39
Dungannon,4659,7,10,9,11,49,43,6,39
Glentoran,4659,8,9,8,13,26,37,-11,35
Ards,4659,9,9,6,15,37,50,-13,33
Ballinamalla,4659,10,8,4,18,25,48,-23,28
Portadown,4659,11,7,6,17,25,46,-21,27
Crusaders,4660,1,19,6,5,62,29,33,63
Ballymena,4660,2,18,4,8,75,57,18,58
Cliftonville,4660,3,15,6,9,48,35,13,51
Linfield,4660,4,14,7,9,55,36,19,49
Ards,4660,5,13,3,14,46,47,-1,42
Coleraine,4660,6,11,8,11,44,52,-8,41
Glenavon,4660,7,9,10,11,43,49,-6,37
Glentoran,4660,8,10,5,15,32,46,-14,35
Ballinamalla,4660,9,10,3,17,34,53,-19,33
Dungannon,4660,10,7,9,14,40,49,-9,30
Portadown,4660,11,7,3,20,21,47,-26,24
Crusaders,4661,1,16,8,6,55,31,24,56
Linfield,4661,2,15,9,6,60,32,28,54
Cliftonville,4661,3,16,5,9,52,40,12,53
Glenavon,4661,4,13,11,6,54,41,13,50
Ballymena,4661,5,15,5,10,54,54,0,50
Dungannon,4661,6,13,7,10,53,45,8,46
Coleraine,4661,7,9,8,13,39,44,-5,35
Ards,4661,8,9,4,17,38,52,-14,31
Glentoran,4661,9,7,9,14,34,53,-19,30
Portadown,4661,10,8,4,18,23,43,-20,28
Ballinamalla,4661,11,7,4,19,26,53,-27,25
Crusaders,4662,1,17,5,8,55,33,22,56
Ballymena,4662,2,14,7,9,60,51,9,49
Ards,4662,3,15,3,12,42,41,1,48
Glenavon,4662,4,12,11,7,46,42,4,47
Linfield,4662,5,13,7,10,60,43,17,46
Cliftonville,4662,6,13,7,10,56,45,11,46
Dungannon,4662,7,12,8,10,52,39,13,44
Coleraine,4662,8,9,9,12,39,41,-2,36
Ballinamalla,4662,9,8,6,16,34,55,-21,30
Portadown,4662,10,8,5,17,20,43,-23,29
Glentoran,4662,11,6,8,16,22,53,-31,26
Linfield,4663,1,16,9,5,63,29,34,57
Crusaders,4663,2,16,7,7,54,30,24,55
Cliftonville,4663,3,17,4,9,53,36,17,55
Glenavon,4663,4,14,10,6,56,44,12,52
Ballymena,4663,5,15,7,8,60,55,5,52
Coleraine,4663,6,9,10,11,42,46,-4,37
Dungannon,4663,7,10,7,13,43,48,-5,37
Ballinamalla,4663,8,10,5,15,33,48,-15,35
Glentoran,4663,9,9,7,14,30,47,-17,34
Portadown,4663,10,7,3,20,26,52,-26,24
Ards,4663,11,4,7,19,32,57,-25,19
Linfield,4664,1,19,8,3,66,22,44,65
Crusaders,4664,2,15,9,6,52,31,21,54
Cliftonville,4664,3,13,8,9,47,37,10,47
Coleraine,4664,4,12,10,8,44,35,9,46
Glenavon,4664,5,12,10,8,42,40,2,46
Ballymena,4664,6,10,7,13,50,60,-10,37
Ards,4664,7,10,6,14,36,47,-11,36
Portadown,4664,8,10,5,15,35,46,-11,35
Dungannon,4664,9,7,9,14,37,46,-9,30
Ballinamalla,4664,10,8,5,17,27,49,-22,29
Glentoran,4664,11,7,7,16,28,51,-23,28
Crusaders,4665,1,16,8,6,56,38,18,56
Ballymena,4665,2,15,8,7,55,49,6,53
Linfield,4665,3,13,10,7,61,33,28,49
Glenavon,4665,4,12,11,7,53,44,9,47
Cliftonville,4665,5,14,4,12,47,41,6,46
Coleraine,4665,6,12,10,8,52,47,5,46
Dungannon,4665,7,9,9,12,44,42,2,36
Glentoran,4665,8,9,9,12,29,41,-12,36
Ballinamalla,4665,9,9,3,18,29,54,-25,30
Portadown,4665,10,7,7,16,26,44,-18,28
Ards,4665,11,7,5,18,37,56,-19,26
Crusaders,4666,1,16,7,7,49,32,17,55
Linfield,4666,2,16,6,8,55,31,24,54
Glenavon,4666,3,14,8,8,51,37,14,50
Cliftonville,4666,4,13,6,11,54,45,9,45
Coleraine,4666,5,12,9,9,43,42,1,45
Ballymena,4666,6,13,6,11,57,61,-4,45
Glentoran,4666,7,10,8,12,30,39,-9,38
Portadown,4666,8,10,6,14,28,43,-15,36
Dungannon,4666,9,6,12,12,46,48,-2,30
Ards,4666,10,7,8,15,33,45,-12,29
Ballinamalla,4666,11,9,2,19,30,53,-23,29
Cliftonville,4667,1,16,5,9,62,45,17,53
Coleraine,4667,2,14,10,6,48,35,13,52
Ballymena,4667,3,14,7,9,59,57,2,49
Crusaders,4667,4,13,9,8,61,42,19,48
Linfield,4667,5,11,11,8,51,34,17,44
Dungannon,4667,6,10,9,11,47,42,5,39
Glenavon,4667,7,9,11,10,42,50,-8,38
Ballinamalla,4667,8,11,5,14,34,46,-12,38
Glentoran,4667,9,7,10,13,26,40,-14,31
Ards,4667,10,6,11,13,38,48,-10,29
Portadown,4667,11,8,4,18,24,53,-29,28
Linfield,4668,1,13,12,5,56,27,29,51
Glenavon,4668,2,13,10,7,45,34,11,49
Crusaders,4668,3,12,12,6,48,31,17,48
Cliftonville,4668,4,13,7,10,51,40,11,46
Coleraine,4668,5,12,10,8,40,34,6,46
Ballymena,4668,6,13,6,11,55,54,1,45
Ards,4668,7,9,9,12,46,52,-6,36
Glentoran,4668,8,8,10,12,30,45,-15,34
Dungannon,4668,9,6,13,11,40,45,-5,31
Ballinamalla,4668,10,7,8,15,27,50,-23,29
Portadown,4668,11,7,7,16,25,51,-26,28
Cliftonville,4669,1,18,5,7,57,34,23,59
Crusaders,4669,2,17,7,6,55,32,23,58
Ballymena,4669,3,15,6,9,64,56,8,51
Linfield,4669,4,13,9,8,55,36,19,48
Coleraine,4669,5,12,11,7,46,31,15,47
Glentoran,4669,6,11,8,11,35,38,-3,41
Glenavon,4669,7,10,8,12,42,46,-4,38
Dungannon,4669,8,7,10,13,41,48,-7,31
Ballinamalla,4669,9,9,4,17,30,51,-21,31
Ards,4669,10,7,7,16,35,56,-21,28
Portadown,4669,11,5,7,18,28,60,-32,22
Crusaders,4670,1,21,5,4,60,29,31,68
Linfield,4670,2,16,8,6,65,34,31,56
Cliftonville,4670,3,17,5,8,52,34,18,56
Coleraine,4670,4,12,10,8,40,36,4,46
Ballymena,4670,5,13,6,11,56,56,0,45
Dungannon,4670,6,10,6,14,44,50,-6,36
Glentoran,4670,7,9,8,13,29,38,-9,35
Glenavon,4670,8,7,13,10,46,49,-3,34
Portadown,4670,9,10,4,16,26,46,-20,34
Ards,4670,10,7,8,15,35,49,-14,29
Ballinamalla,4670,11,4,5,21,18,50,-32,17
Cliftonville,4671,1,16,6,8,57,42,15,54
Crusaders,4671,2,15,9,6,48,33,15,54
Linfield,4671,3,15,7,8,62,34,28,52
Ballymena,4671,4,16,4,10,68,63,5,52
Coleraine,4671,5,13,9,8,40,31,9,48
Glenavon,4671,6,8,14,8,41,42,-1,38
Ards,4671,7,10,6,14,38,50,-12,36
Glentoran,4671,8,8,9,13,35,46,-11,33
Dungannon,4671,9,6,11,13,49,53,-4,29
Portadown,4671,10,8,5,17,22,41,-19,29
Ballinamalla,4671,11,8,4,18,31,56,-25,28
Linfield,4672,1,17,8,5,65,29,36,59
Crusaders,4672,2,16,8,6,56,35,21,56
Cliftonville,4672,3,15,4,11,49,42,7,49
Coleraine,4672,4,12,10,8,45,41,4,46
Ballymena,4672,5,13,7,10,58,56,2,46
Dungannon,4672,6,11,9,10,54,48,6,42
Glenavon,4672,7,10,10,10,48,52,-4,40
Glentoran,4672,8,10,7,13,33,43,-10,37
Ards,4672,9,11,2,17,44,54,-10,35
Ballinamalla,4672,10,7,4,19,25,50,-25,25
Portadown,4672,11,6,5,19,23,50,-27,23
Linfield,4673,1,16,9,5,60,33,27,57
Cliftonville,4673,2,16,6,8,52,38,14,54
Ballymena,4673,3,16,5,9,60,49,11,53
Crusaders,4673,4,14,9,7,50,31,19,51
Glenavon,4673,5,10,14,6,48,44,4,44
Coleraine,4673,6,9,11,10,38,41,-3,38
Dungannon,4673,7,9,7,14,47,54,-7,34
Portadown,4673,8,9,6,15,24,38,-14,33
Glentoran,4673,9,9,6,15,30,52,-22,33
Ards,4673,10,8,5,17,36,47,-11,29
Ballinamalla,4673,11,7,6,17,36,54,-18,27
Crusaders,4674,1,15,10,5,67,37,30,55
Cliftonville,4674,2,17,4,9,51,39,12,55
Ballymena,4674,3,15,7,8,63,56,7,52
Linfield,4674,4,14,8,8,59,33,26,50
Coleraine,4674,5,11,13,6,45,35,10,46
Glenavon,4674,6,12,9,9,53,54,-1,45
Dungannon,4674,7,11,8,11,53,48,5,41
Ards,4674,8,11,4,15,40,46,-6,37
Glentoran,4674,9,7,9,14,32,49,-17,30
Ballinamalla,4674,10,7,4,19,25,55,-30,25
Portadown,4674,11,5,4,21,21,57,-36,19
Crusaders,4675,1,18,6,6,58,34,24,60
Linfield,4675,2,15,7,8,63,32,31,52
Ballymena,4675,3,16,4,10,65,59,6,52
Glenavon,4675,4,14,7,9,54,48,6,49
Cliftonville,4675,5,13,5,12,52,47,5,44
Dungannon,4675,6,11,10,9,54,42,12,43
Ards,4675,7,12,5,13,40,41,-1,41
Coleraine,4675,8,11,8,11,40,44,-4,41
Glentoran,4675,9,7,9,14,33,55,-22,30
Ballinamalla,4675,10,9,2,19,33,58,-25,29
Portadown,4675,11,6,3,21,22,54,-32,21
Linfield,4676,1,16,9,5,64,32,32,57
Crusaders,4676,2,14,9,7,51,33,18,51
Cliftonville,4676,3,13,6,11,51,44,7,45
Glenavon,4676,4,11,11,8,43,43,0,44
Coleraine,4676,5,11,10,9,36,38,-2,43
Ballymena,4676,6,12,6,12,61,61,0,42
Glentoran,4676,7,11,6,13,35,44,-9,39
Dungannon,4676,8,9,11,10,51,45,6,38
Ards,4676,9,9,6,15,36,50,-14,33
Ballinamalla,4676,10,9,6,15,33,53,-20,33
Portadown,4676,11,7,6,17,30,48,-18,27
Crusaders,4677,1,20,7,3,65,34,31,67
Linfield,4677,2,14,9,7,54,32,22,51
Coleraine,4677,3,13,9,8,45,42,3,48
Ballymena,4677,4,12,8,10,56,61,-5,44
Cliftonville,4677,5,12,7,11,48,39,9,43
Dungannon,4677,6,10,10,10,54,44,10,40
Glenavon,4677,7,9,10,11,46,51,-5,37
Glentoran,4677,8,9,6,15,26,41,-15,33
Portadown,4677,9,9,5,16,28,42,-14,32
Ballinamalla,4677,10,8,6,16,33,52,-19,30
Ards,4677,11,7,7,16,36,53,-17,28
Crusaders,4678,1,16,9,5,53,33,20,57
Ballymena,4678,2,14,7,9,50,50,0,49
Linfield,4678,3,13,8,9,58,35,23,47
Dungannon,4678,4,13,8,9,51,34,17,47
Coleraine,4678,5,11,13,6,40,36,4,46
Glenavon,4678,6,12,9,9,46,39,7,45
Cliftonville,4678,7,12,6,12,43,41,2,42
Glentoran,4678,8,9,9,12,31,43,-12,36
Ards,4678,9,8,7,15,32,47,-15,31
Portadown,4678,10,7,5,18,22,44,-22,26
Ballinamalla,4678,11,7,5,18,29,53,-24,26
Crusaders,4679,1,18,9,3,67,34,33,63
Cliftonville,4679,2,13,8,9,48,40,8,47
Linfield,4679,3,12,9,9,58,37,21,45
Glenavon,4679,4,11,11,8,41,43,-2,44
Ballymena,4679,5,12,7,11,51,58,-7,43
Coleraine,4679,6,9,13,8,37,36,1,40
Glentoran,4679,7,10,7,13,31,44,-13,37
Dungannon,4679,8,8,10,12,51,51,0,34
Ballinamalla,4679,9,10,4,16,32,49,-17,34
Ards,4679,10,9,5,16,37,45,-8,32
Portadown,4679,11,9,5,16,27,43,-16,32
Linfield,4680,1,17,9,4,69,34,35,60
Ballymena,4680,2,15,9,6,62,57,5,54
Crusaders,4680,3,15,7,8,54,34,20,52
Glenavon,4680,4,13,13,4,50,38,12,52
Cliftonville,4680,5,14,8,8,57,43,14,50
Coleraine,4680,6,10,12,8,38,39,-1,42
Dungannon,4680,7,8,9,13,41,43,-2,33
Glentoran,4680,8,7,9,14,31,45,-14,30
Ards,4680,9,8,5,17,38,53,-15,29
Portadown,4680,10,7,4,19,31,55,-24,25
Ballinamalla,4680,11,5,7,18,21,51,-30,22
Linfield,4681,1,15,8,7,63,37,26,53
Ballymena,4681,2,15,7,8,65,61,4,52
Glenavon,4681,3,13,10,7,48,39,9,49
Crusaders,4681,4,13,10,7,47,39,8,49
Coleraine,4681,5,12,11,7,45,35,10,47
Dungannon,4681,6,12,10,8,56,38,18,46
Cliftonville,4681,7,13,7,10,50,45,5,46
Ards,4681,8,11,4,15,37,49,-12,37
Glentoran,4681,9,6,9,15,26,43,-17,27
Portadown,4681,10,7,6,17,22,42,-20,27
Ballinamalla,4681,11,6,2,22,29,60,-31,20
Cliftonville,4682,1,15,7,8,50,34,16,52
Crusaders,4682,2,14,8,8,51,41,10,50
Ballymena,4682,3,13,11,6,58,53,5,50
Linfield,4682,4,13,9,8,53,33,20,48
Coleraine,4682,5,10,16,4,40,32,8,46
Dungannon,4682,6,11,10,9,61,39,22,43
Glenavon,4682,7,10,13,7,47,42,5,43
Ballinamalla,4682,8,8,5,17,32,57,-25,29
Glentoran,4682,9,6,10,14,22,41,-19,28
Portadown,4682,10,7,7,16,27,51,-24,28
Ards,4682,11,6,8,16,33,51,-18,26
Cliftonville,4683,1,19,2,9,59,34,25,59
Crusaders,4683,2,15,8,7,51,41,10,53
Dungannon,4683,3,14,8,8,61,39,22,50
Linfield,4683,4,13,9,8,62,40,22,48
Coleraine,4683,5,11,12,7,37,34,3,45
Ballymena,4683,6,12,7,11,63,60,3,43
Glenavon,4683,7,9,11,10,44,49,-5,38
Glentoran,4683,8,8,8,14,34,56,-22,32
Portadown,4683,9,8,6,16,28,49,-21,30
Ballinamalla,4683,10,7,7,16,27,48,-21,28
Ards,4683,11,7,6,17,35,51,-16,27
Crusaders,4684,1,16,8,6,59,32,27,56
Cliftonville,4684,2,17,3,10,56,35,21,54
Linfield,4684,3,12,13,5,53,25,28,49
Coleraine,4684,4,11,11,8,46,41,5,44
Glenavon,4684,5,11,8,11,47,51,-4,41
Ballymena,4684,6,11,6,13,53,66,-13,39
Ards,4684,7,10,7,13,39,45,-6,37
Ballinamalla,4684,8,10,5,15,32,51,-19,35
Portadown,4684,9,9,7,14,29,43,-14,34
Dungannon,4684,10,7,11,12,44,47,-3,32
Glentoran,4684,11,7,9,14,25,47,-22,30
Crusaders,4685,1,17,9,4,63,34,29,60
Cliftonville,4685,2,15,6,9,53,43,10,51
Ballymena,4685,3,14,9,7,63,56,7,51
Linfield,4685,4,12,11,7,61,41,20,47
Glenavon,4685,5,11,10,9,47,45,2,43
Coleraine,4685,6,10,9,11,40,46,-6,39
Dungannon,4685,7,8,10,12,46,49,-3,34
Ards,4685,8,10,3,17,40,52,-12,33
Glentoran,4685,9,9,6,15,28,42,-14,33
Ballinamalla,4685,10,9,5,16,35,55,-20,32
Portadown,4685,11,7,8,15,28,41,-13,29
Crusaders,4686,1,16,10,4,56,32,24,58
Linfield,4686,2,15,11,4,55,26,29,56
Cliftonville,4686,3,16,7,7,53,35,18,55
Coleraine,4686,4,12,10,8,45,38,7,46
Ballymena,4686,5,13,6,11,56,64,-8,45
Glenavon,4686,6,12,8,10,43,45,-2,44
Dungannon,4686,7,8,10,12,46,48,-2,34
Ards,4686,8,9,6,15,38,46,-8,33
Glentoran,4686,9,6,11,13,29,41,-12,29
Portadown,4686,10,6,7,17,31,50,-19,25
Ballinamalla,4686,11,4,10,16,31,58,-27,22
Crusaders,4687,1,20,6,4,64,33,31,66
Linfield,4687,2,13,12,5,56,27,29,51
Ballymena,4687,3,13,9,8,51,50,1,48
Cliftonville,4687,4,14,5,11,44,38,6,47
Dungannon,4687,5,12,7,11,53,46,7,43
Coleraine,4687,6,10,10,10,43,41,2,40
Glenavon,4687,7,10,9,11,46,44,2,39
Ards,4687,8,10,7,13,39,51,-12,37
Ballinamalla,4687,9,9,4,17,33,50,-17,31
Portadown,4687,10,7,5,18,24,50,-26,26
Glentoran,4687,11,5,10,15,26,49,-23,25
Cliftonville,4688,1,17,8,5,65,38,27,59
Ballymena,4688,2,17,6,7,61,51,10,57
Crusaders,4688,3,15,11,4,57,42,15,56
Linfield,4688,4,13,11,6,52,28,24,50
Coleraine,4688,5,10,11,9,43,37,6,41
Glenavon,4688,6,10,9,11,45,44,1,39
Glentoran,4688,7,9,6,15,36,47,-11,33
Ards,4688,8,9,5,16,33,53,-20,32
Dungannon,4688,9,7,9,14,49,52,-3,30
Ballinamalla,4688,10,8,4,18,30,55,-25,28
Portadown,4688,11,7,6,17,27,51,-24,27
Crusaders,4689,1,17,8,5,55,30,25,59
Linfield,4689,2,15,11,4,64,31,33,56
Coleraine,4689,3,12,11,7,46,38,8,47
Dungannon,4689,4,12,9,9,50,40,10,45
Cliftonville,4689,5,13,4,13,53,50,3,43
Ballymena,4689,6,11,9,10,57,62,-5,42
Glenavon,4689,7,9,10,11,41,46,-5,37
Ards,4689,8,11,4,15,43,50,-7,37
Portadown,4689,9,10,6,14,32,45,-13,36
Glentoran,4689,10,6,8,16,24,47,-23,26
Ballinamalla,4689,11,6,6,18,23,49,-26,24
Linfield,4690,1,18,6,6,67,31,36,60
Crusaders,4690,2,16,6,8,53,32,21,54
Glenavon,4690,3,15,8,7,41,37,4,53
Cliftonville,4690,4,14,4,12,53,51,2,46
Dungannon,4690,5,12,9,9,52,38,14,45
Coleraine,4690,6,11,10,9,45,47,-2,43
Ballymena,4690,7,11,9,10,56,56,0,42
Glentoran,4690,8,11,4,15,31,44,-13,37
Ards,4690,9,9,6,15,39,44,-5,33
Ballinamalla,4690,10,7,4,19,29,57,-28,25
Portadown,4690,11,5,6,19,25,54,-29,21
Crusaders,4691,1,13,11,6,57,32,25,50
Glenavon,4691,2,13,11,6,50,38,12,50
Ballymena,4691,3,14,8,8,59,59,0,50
Cliftonville,4691,4,14,7,9,43,32,11,49
Linfield,4691,5,12,11,7,54,38,16,47
Coleraine,4691,6,11,9,10,46,43,3,42
Dungannon,4691,7,11,7,12,51,56,-5,40
Glentoran,4691,8,9,10,11,40,43,-3,37
Ards,4691,9,8,8,14,38,47,-9,32
Ballinamalla,4691,10,8,6,16,31,49,-18,30
Portadown,4691,11,6,4,20,19,51,-32,22
Crusaders,4692,1,18,6,6,61,34,27,60
Cliftonville,4692,2,17,4,9,61,45,16,55
Coleraine,4692,3,13,13,4,43,29,14,52
Linfield,4692,4,11,14,5,57,35,22,47
Glenavon,4692,5,12,10,8,52,47,5,46
Ballymena,4692,6,14,3,13,55,59,-4,45
Dungannon,4692,7,9,13,8,53,43,10,40
Ards,4692,8,7,8,15,38,56,-18,29
Glentoran,4692,9,6,9,15,31,51,-20,27
Ballinamalla,4692,10,7,6,17,33,58,-25,27
Portadown,4692,11,6,4,20,25,52,-27,22
Ballymena,4693,1,19,4,7,62,55,7,61
Crusaders,4693,2,17,7,6,59,34,25,58
Glenavon,4693,3,13,12,5,51,40,11,51
Cliftonville,4693,4,13,9,8,52,36,16,48
Linfield,4693,5,12,8,10,59,38,21,44
Coleraine,4693,6,11,11,8,43,36,7,44
Dungannon,4693,7,9,8,13,49,46,3,35
Portadown,4693,8,9,7,14,23,36,-13,34
Ards,4693,9,8,5,17,36,52,-16,29
Glentoran,4693,10,6,7,17,25,55,-30,25
Ballinamalla,4693,11,7,4,19,31,62,-31,25
Crusaders,4694,1,18,7,5,58,30,28,61
Cliftonville,4694,2,17,5,8,53,34,19,56
Linfield,4694,3,14,10,6,61,36,25,52
Ballymena,4694,4,16,4,10,64,58,6,52
Coleraine,4694,5,13,8,9,43,35,8,47
Glenavon,4694,6,11,8,11,46,60,-14,41
Ards,4694,7,11,5,14,38,48,-10,38
Dungannon,4694,8,9,9,12,51,50,1,36
Glentoran,4694,9,8,9,13,34,45,-11,33
Portadown,4694,10,5,7,18,25,49,-24,22
Ballinamalla,4694,11,4,6,20,24,52,-28,18
Linfield,4695,1,15,8,7,60,32,28,53
Crusaders,4695,2,15,8,7,48,35,13,53
Cliftonville,4695,3,17,2,11,51,41,10,53
Glenavon,4695,4,14,10,6,48,38,10,52
Dungannon,4695,5,13,9,8,55,39,16,48
Coleraine,4695,6,12,7,11,50,42,8,43
Ballymena,4695,7,12,7,11,51,57,-6,43
Glentoran,4695,8,9,9,12,31,40,-9,36
Ards,4695,9,10,4,16,41,47,-6,34
Portadown,4695,10,6,7,17,23,47,-24,25
Ballinamalla,4695,11,4,5,21,21,61,-40,17
Crusaders,4696,1,18,7,5,60,33,27,61
Glenavon,4696,2,13,12,5,49,38,11,51
Ballymena,4696,3,14,7,9,54,51,3,49
Dungannon,4696,4,13,8,9,61,49,12,47
Cliftonville,4696,5,12,7,11,49,42,7,43
Linfield,4696,6,10,12,8,52,32,20,42
Coleraine,4696,7,11,9,10,38,41,-3,42
Glentoran,4696,8,11,6,13,32,44,-12,39
Ards,4696,9,8,6,16,39,52,-13,30
Portadown,4696,10,7,5,18,24,49,-25,26
Ballinamalla,4696,11,7,3,20,27,54,-27,24
Crusaders,4697,1,15,8,7,55,36,19,53
Ballymena,4697,2,14,8,8,58,56,2,50
Linfield,4697,3,13,10,7,55,27,28,49
Cliftonville,4697,4,14,7,9,51,43,8,49
Coleraine,4697,5,11,10,9,40,38,2,43
Glenavon,4697,6,11,10,9,43,43,0,43
Ards,4697,7,11,7,12,39,45,-6,40
Dungannon,4697,8,9,8,13,45,43,2,35
Ballinamalla,4697,9,11,1,18,31,53,-22,34
Glentoran,4697,10,9,6,15,29,42,-13,33
Portadown,4697,11,7,5,18,26,46,-20,26
Crusaders,4698,1,15,8,7,50,33,17,53
Cliftonville,4698,2,16,3,11,51,38,13,51
Glenavon,4698,3,14,8,8,46,40,6,50
Linfield,4698,4,13,10,7,58,33,25,49
Coleraine,4698,5,13,9,8,42,39,3,48
Ballymena,4698,6,13,8,9,56,52,4,47
Dungannon,4698,7,8,12,10,44,45,-1,36
Ards,4698,8,10,4,16,41,47,-6,34
Glentoran,4698,9,7,10,13,26,40,-14,31
Ballinamalla,4698,10,8,4,18,24,50,-26,28
Portadown,4698,11,6,8,16,24,45,-21,26
Linfield,4699,1,17,7,6,65,30,35,58
Cliftonville,4699,2,17,4,9,51,36,15,55
Crusaders,4699,3,14,9,7,51,35,16,51
Ballymena,4699,4,15,6,9,63,56,7,51
Glenavon,4699,5,11,11,8,46,45,1,44
Coleraine,4699,6,10,12,8,46,42,4,42
Ards,4699,7,11,5,14,37,50,-13,38
Glentoran,4699,8,9,8,13,30,43,-13,35
Ballinamalla,4699,9,10,5,15,33,48,-15,35
Dungannon,4699,10,8,9,13,46,45,1,33
Portadown,4699,11,3,4,23,17,55,-38,13
Crusaders,4700,1,16,9,5,57,32,25,57
Linfield,4700,2,16,8,6,61,32,29,56
Cliftonville,4700,3,14,9,7,57,42,15,51
Coleraine,4700,4,14,8,8,47,34,13,50
Glenavon,4700,5,11,14,5,49,43,6,47
Ballymena,4700,6,13,6,11,57,57,0,45
Dungannon,4700,7,10,10,10,50,46,4,40
Glentoran,4700,8,9,6,15,32,51,-19,33
Ards,4700,9,6,8,16,33,51,-18,26
Ballinamalla,4700,10,6,7,17,28,53,-25,25
Portadown,4700,11,5,5,20,25,55,-30,20
Cliftonville,4701,1,15,8,7,56,40,16,53
Crusaders,4701,2,13,8,9,52,39,13,47
Dungannon,4701,3,12,8,10,49,43,6,44
Ballymena,4701,4,13,5,12,55,59,-4,44
Linfield,4701,5,12,7,11,59,40,19,43
Glentoran,4701,6,11,8,11,37,43,-6,41
Coleraine,4701,7,10,9,11,39,40,-1,39
Ards,4701,8,11,5,14,40,49,-9,38
Ballinamalla,4701,9,10,7,13,36,48,-12,37
Portadown,4701,10,9,8,13,26,37,-11,35
Glenavon,4701,11,6,13,11,36,47,-11,31
Linfield,4702,1,17,8,5,63,27,36,59
Cliftonville,4702,2,16,4,10,53,44,9,52
Crusaders,4702,3,13,10,7,51,38,13,49
Dungannon,4702,4,12,8,10,62,52,10,44
Ballymena,4702,5,13,5,12,61,61,0,44
Coleraine,4702,6,11,9,10,52,51,1,42
Glenavon,4702,7,10,11,9,40,40,0,41
Portadown,4702,8,10,6,14,26,41,-15,36
Glentoran,4702,9,9,6,15,37,46,-9,33
Ards,4702,10,8,8,14,39,55,-16,32
Ballinamalla,4702,11,6,5,19,28,57,-29,23
Ballymena,4703,1,15,9,6,62,53,9,54
Cliftonville,4703,2,15,8,7,64,45,19,53
Crusaders,4703,3,14,10,6,58,38,20,52
Linfield,4703,4,12,13,5,60,31,29,49
Coleraine,4703,5,12,10,8,42,37,5,46
Dungannon,4703,6,8,14,8,50,43,7,38
Glenavon,4703,7,9,11,10,45,51,-6,38
Glentoran,4703,8,9,8,13,33,50,-17,35
Portadown,4703,9,7,6,17,26,49,-23,27
Ballinamalla,4703,10,6,8,16,30,50,-20,26
Ards,4703,11,6,7,17,28,51,-23,25
Crusaders,4704,1,15,11,4,54,31,23,56
Ballymena,4704,2,16,5,9,56,51,5,53
Linfield,4704,3,13,12,5,57,32,25,51
Coleraine,4704,4,12,10,8,49,42,7,46
Cliftonville,4704,5,13,7,10,51,46,5,46
Dungannon,4704,6,12,7,11,51,44,7,43
Glenavon,4704,7,11,9,10,49,45,4,42
Ards,4704,8,8,7,15,34,48,-14,31
Glentoran,4704,9,7,8,15,29,48,-19,29
Ballinamalla,4704,10,7,6,17,23,44,-21,27
Portadown,4704,11,7,6,17,26,48,-22,27
Linfield,4705,1,17,8,5,62,31,31,59
Glenavon,4705,2,15,8,7,50,43,7,53
Crusaders,4705,3,14,9,7,57,37,20,51
Cliftonville,4705,4,14,7,9,49,38,11,49
Ballymena,4705,5,12,5,13,48,60,-12,41
Glentoran,4705,6,11,7,12,30,43,-13,40
Dungannon,4705,7,10,9,11,52,42,10,39
Coleraine,4705,8,9,11,10,40,39,1,38
Ards,4705,9,10,7,13,42,44,-2,37
Ballinamalla,4705,10,7,5,18,29,52,-23,26
Portadown,4705,11,6,4,20,22,52,-30,22
Crusaders,4706,1,18,9,3,56,27,29,63
Linfield,4706,2,15,11,4,66,33,33,56
Ballymena,4706,3,16,7,7,63,54,9,55
Glenavon,4706,4,11,14,5,50,42,8,47
Coleraine,4706,5,11,10,9,39,40,-1,43
Dungannon,4706,6,12,6,12,53,43,10,42
Cliftonville,4706,7,12,6,12,41,37,4,42
Glentoran,4706,8,6,9,15,28,46,-18,27
Portadown,4706,9,7,6,17,19,47,-28,27
Ards,4706,10,7,5,18,34,54,-20,26
Ballinamalla,4706,11,6,5,19,27,53,-26,23
Glenavon,4707,1,15,9,6,54,36,18,54
Crusaders,4707,2,15,9,6,50,32,18,54
Cliftonville,4707,3,14,7,9,50,37,13,49
Linfield,4707,4,12,12,6,54,34,20,48
Ballymena,4707,5,13,9,8,59,55,4,48
Coleraine,4707,6,9,13,8,40,40,0,40
Dungannon,4707,7,8,13,9,45,39,6,37
Glentoran,4707,8,9,9,12,32,41,-9,36
Ards,4707,9,7,8,15,41,59,-18,29
Ballinamalla,4707,10,6,7,17,26,55,-29,25
Portadown,4707,11,5,8,17,20,43,-23,23
Ballymena,4708,1,16,7,7,67,51,16,55
Cliftonville,4708,2,15,3,12,48,40,8,48
Crusaders,4708,3,14,5,11,48,39,9,47
Linfield,4708,4,12,9,9,55,31,24,45
Glenavon,4708,5,11,12,7,48,48,0,45
Dungannon,4708,6,11,10,9,47,41,6,43
Coleraine,4708,7,9,11,10,41,38,3,38
Ards,4708,8,11,4,15,35,48,-13,37
Glentoran,4708,9,9,7,14,30,47,-17,34
Portadown,4708,10,9,6,15,22,45,-23,33
Ballinamalla,4708,11,10,2,18,31,44,-13,32
Linfield,4709,1,19,6,5,63,23,40,63
Crusaders,4709,2,16,6,8,51,32,19,54
Cliftonville,4709,3,14,6,10,49,44,5,48
Ballymena,4709,4,13,4,13,56,62,-6,43
Glenavon,4709,5,11,9,10,45,43,2,42
Coleraine,4709,6,11,8,11,39,39,0,41
Portadown,4709,7,11,5,14,33,41,-8,38
Dungannon,4709,8,9,9,12,42,45,-3,36
Ards,4709,9,10,4,16,35,47,-12,34
Ballinamalla,4709,10,10,2,18,31,50,-19,32
Glentoran,4709,11,8,7,15,27,45,-18,31
Crusaders,4710,1,16,9,5,54,31,23,57
Cliftonville,4710,2,15,7,8,59,40,19,52
Glenavon,4710,3,14,10,6,53,40,13,52
Linfield,4710,4,11,13,6,55,36,19,46
Coleraine,4710,5,12,8,10,45,40,5,44
Ballymena,4710,6,11,9,10,48,58,-10,42
Portadown,4710,7,10,5,15,31,47,-16,35
Glentoran,4710,8,7,11,12,34,49,-15,32
Ballinamalla,4710,9,8,7,15,29,46,-17,31
Dungannon,4710,10,7,9,14,45,47,-2,30
Ards,4710,11,7,6,17,31,50,-19,27
Ballymena,4711,1,18,4,8,61,49,12,58
Crusaders,4711,2,16,8,6,50,29,21,56
Linfield,4711,3,15,10,5,63,33,30,55
Cliftonville,4711,4,17,4,9,55,39,16,55
Coleraine,4711,5,11,11,8,37,34,3,44
Glenavon,4711,6,10,11,9,42,43,-1,41
Dungannon,4711,7,10,8,12,49,46,3,38
Ards,4711,8,9,6,15,34,46,-12,33
Glentoran,4711,9,7,10,13,27,38,-11,31
Ballinamalla,4711,10,5,6,19,17,46,-29,21
Portadown,4711,11,3,10,17,12,44,-32,19
Cliftonville,4712,1,17,7,6,62,41,21,58
Ballymena,4712,2,16,7,7,71,58,13,55
Crusaders,4712,3,15,8,7,60,39,21,53
Linfield,4712,4,14,10,6,55,29,26,52
Glenavon,4712,5,10,10,10,42,43,-1,40
Dungannon,4712,6,10,9,11,47,41,6,39
Ards,4712,7,11,4,15,36,51,-15,37
Coleraine,4712,8,8,11,11,37,42,-5,35
Glentoran,4712,9,8,8,14,37,51,-14,32
Portadown,4712,10,8,5,17,30,51,-21,29
Ballinamalla,4712,11,8,1,21,25,56,-31,25
Crusaders,4713,1,18,10,2,66,30,36,64
Ballymena,4713,2,15,7,8,53,56,-3,52
Linfield,4713,3,13,10,7,58,35,23,49
Cliftonville,4713,4,12,7,11,53,39,14,43
Glenavon,4713,5,10,12,8,47,42,5,42
Coleraine,4713,6,10,10,10,42,44,-2,40
Glentoran,4713,7,9,8,13,30,44,-14,35
Dungannon,4713,8,8,10,12,42,43,-1,34
Ards,4713,9,10,4,16,40,49,-9,34
Portadown,4713,10,8,9,13,24,43,-19,33
Ballinamalla,4713,11,6,5,19,24,54,-30,23
Linfield,4714,1,16,7,7,65,37,28,55
Crusaders,4714,2,15,8,7,53,40,13,53
Ballymena,4714,3,15,5,10,60,58,2,50
Dungannon,4714,4,12,9,9,51,38,13,45
Cliftonville,4714,5,12,9,9,49,37,12,45
Glenavon,4714,6,11,10,9,49,50,-1,43
Glentoran,4714,7,10,8,12,38,46,-8,38
Coleraine,4714,8,8,12,10,46,45,1,36
Ards,4714,9,10,6,14,39,47,-8,36
Ballinamalla,4714,10,7,6,17,31,54,-23,27
Portadown,4714,11,7,4,19,26,55,-29,25
Crusaders,4715,1,16,6,8,55,36,19,54
Cliftonville,4715,2,15,5,10,55,42,13,50
Glenavon,4715,3,14,8,8,49,45,4,50
Ballymena,4715,4,14,7,9,58,54,4,49
Linfield,4715,5,13,7,10,50,33,17,46
Coleraine,4715,6,11,13,6,44,33,11,46
Dungannon,4715,7,12,9,9,49,42,7,45
Glentoran,4715,8,10,9,11,38,43,-5,39
Ballinamalla,4715,9,10,2,18,35,55,-20,32
Ards,4715,10,7,7,16,42,60,-18,28
Portadown,4715,11,4,5,21,21,53,-32,17
Linfield,4716,1,15,12,3,62,26,36,57
Crusaders,4716,2,17,5,8,52,37,15,56
Ballymena,4716,3,17,5,8,63,52,11,56
Cliftonville,4716,4,15,3,12,51,36,15,48
Coleraine,4716,5,13,9,8,47,39,8,48
Glenavon,4716,6,10,8,12,39,42,-3,38
Dungannon,4716,7,9,10,11,47,43,4,37
Glentoran,4716,8,10,7,13,25,42,-17,37
Ards,4716,9,10,4,16,37,52,-15,34
Portadown,4716,10,8,3,19,24,49,-25,27
Ballinamalla,4716,11,6,4,20,23,52,-29,22
Cliftonville,4717,1,17,6,7,56,37,19,57
Linfield,4717,2,15,8,7,55,31,24,53
Crusaders,4717,3,16,5,9,55,36,19,53
Glenavon,4717,4,14,9,7,56,48,8,51
Ballymena,4717,5,14,8,8,59,57,2,50
Coleraine,4717,6,12,9,9,45,41,4,45
Ards,4717,7,11,3,16,38,45,-7,36
Dungannon,4717,8,7,12,11,46,42,4,33
Glentoran,4717,9,8,8,14,31,44,-13,32
Portadown,4717,10,6,8,16,24,49,-25,26
Ballinamalla,4717,11,4,6,20,27,62,-35,18
Linfield,4718,1,17,7,6,63,36,27,58
Crusaders,4718,2,16,7,7,58,34,24,55
Cliftonville,4718,3,16,6,8,54,38,16,54
Glenavon,4718,4,13,9,8,54,40,14,48
Ballymena,4718,5,11,11,8,54,55,-1,44
Coleraine,4718,6,10,10,10,40,43,-3,40
Dungannon,4718,7,11,6,13,53,50,3,39
Ards,4718,8,10,5,15,44,50,-6,35
Glentoran,4718,9,7,9,14,29,53,-24,30
Portadown,4718,10,8,3,19,29,55,-26,27
Ballinamalla,4718,11,6,7,17,29,53,-24,25
Crusaders,4719,1,19,5,6,64,31,33,62
Linfield,4719,2,15,9,6,59,27,32,54
Ballymena,4719,3,13,9,8,59,60,-1,48
Cliftonville,4719,4,13,6,11,46,44,2,45
Glenavon,4719,5,11,9,10,43,50,-7,42
Dungannon,4719,6,9,10,11,51,46,5,37
Coleraine,4719,7,9,10,11,36,36,0,37
Glentoran,4719,8,9,8,13,30,42,-12,35
Ards,4719,9,9,6,15,36,49,-13,33
Ballinamalla,4719,10,9,5,16,30,48,-18,32
Portadown,4719,11,8,5,17,32,53,-21,29
Crusaders,4720,1,15,13,2,55,28,27,58
Ballymena,4720,2,15,7,8,53,54,-1,52
Linfield,4720,3,14,9,7,55,29,26,51
Cliftonville,4720,4,14,7,9,52,39,13,49
Coleraine,4720,5,10,12,8,39,36,3,42
Glenavon,4720,6,9,15,6,52,52,0,42
Glentoran,4720,7,10,9,11,33,38,-5,39
Dungannon,4720,8,8,10,12,47,52,-5,34
Portadown,4720,9,7,8,15,32,46,-14,29
Ards,4720,10,7,7,16,34,50,-16,28
Ballinamalla,4720,11,6,3,21,34,62,-28,21
Cliftonville,4721,1,18,5,7,56,30,26,59
Crusaders,4721,2,17,7,6,51,31,20,58
Linfield,4721,3,14,12,4,51,23,28,54
Ballymena,4721,4,14,5,11,59,61,-2,47
Glenavon,4721,5,12,8,10,44,42,2,44
Coleraine,4721,6,11,9,10,36,36,0,42
Glentoran,4721,7,12,6,12,36,44,-8,42
Dungannon,4721,8,10,7,13,49,42,7,37
Portadown,4721,9,8,5,17,25,45,-20,29
Ards,4721,10,6,6,18,30,52,-22,24
Ballinamalla,4721,11,6,4,20,25,56,-31,22
Cliftonville,4722,1,18,4,8,59,36,23,58
Crusaders,4722,2,17,5,8,51,29,22,56
Linfield,4722,3,13,9,8,52,35,17,48
Ballymena,4722,4,14,6,10,60,60,0,48
Glenavon,4722,5,12,11,7,47,39,8,47
Coleraine,4722,6,12,10,8,47,40,7,46
Glentoran,4722,7,10,9,11,31,44,-13,39
Dungannon,4722,8,9,8,13,48,49,-1,35
Ards,4722,9,10,5,15,38,45,-7,35
Ballinamalla,4722,10,7,2,21,27,56,-29,23
Portadown,4722,11,5,7,18,26,53,-27,22
Cliftonville,4723,1,17,3,10,55,39,16,54
Linfield,4723,2,15,8,7,58,30,28,53
Crusaders,4723,3,13,10,7,55,40,15,49
Coleraine,4723,4,13,9,8,43,44,-1,48
Ballymena,4723,5,12,8,10,63,65,-2,44
Glenavon,4723,6,10,12,8,54,51,3,42
Dungannon,4723,7,8,13,9,52,45,7,37
Glentoran,4723,8,8,9,13,37,47,-10,33
Portadown,4723,9,9,6,15,35,46,-11,33
Ards,4723,10,8,6,16,36,49,-13,30
Ballinamalla,4723,11,7,6,17,28,60,-32,27
Crusaders,4724,1,19,9,2,64,30,34,66
Ballymena,4724,2,15,6,9,56,51,5,51
Linfield,4724,3,13,10,7,57,36,21,49
Cliftonville,4724,4,14,5,11,47,38,9,47
Glenavon,4724,5,11,9,10,42,47,-5,42
Dungannon,4724,6,10,10,10,53,40,13,40
Coleraine,4724,7,9,11,10,41,38,3,38
Glentoran,4724,8,7,10,13,31,46,-15,31
Ards,4724,9,8,7,15,36,52,-16,31
Portadown,4724,10,7,8,15,21,42,-21,29
Ballinamalla,4724,11,6,7,17,26,54,-28,25
Crusaders,4725,1,19,6,5,58,33,25,63
Cliftonville,4725,2,19,3,8,62,34,28,60
Glenavon,4725,3,14,10,6,48,33,15,52
Ballymena,4725,4,16,4,10,61,57,4,52
Linfield,4725,5,13,10,7,57,36,21,49
Coleraine,4725,6,10,8,12,45,43,2,38
Dungannon,4725,7,9,9,12,51,47,4,36
Ards,4725,8,10,5,15,38,52,-14,35
Glentoran,4725,9,7,8,15,32,53,-21,29
Ballinamalla,4725,10,6,7,17,31,63,-32,25
Portadown,4725,11,4,6,20,19,51,-32,18
Crusaders,4726,1,18,7,5,58,35,23,61
Linfield,4726,2,16,10,4,63,28,35,58
Cliftonville,4726,3,16,5,9,56,42,14,53
Ballymena,4726,4,14,6,10,57,62,-5,48
Dungannon,4726,5,12,9,9,52,37,15,45
Coleraine,4726,6,11,11,8,45,38,7,44
Glenavon,4726,7,9,12,9,54,53,1,39
Glentoran,4726,8,9,6,15,25,41,-16,33
Ards,4726,9,8,5,17,38,56,-18,29
Portadown,4726,10,6,6,18,17,40,-23,24
Ballinamalla,4726,11,6,3,21,24,57,-33,21
Linfield,4727,1,16,8,6,60,28,32,56
Crusaders,4727,2,16,7,7,56,40,16,55
Ballymena,4727,3,15,6,9,60,57,3,51
Coleraine,4727,4,13,8,9,42,36,6,47
Glenavon,4727,5,11,11,8,51,49,2,44
Cliftonville,4727,6,12,5,13,49,45,4,41
Dungannon,4727,7,10,10,10,49,42,7,40
Ards,4727,8,12,4,14,41,43,-2,40
Glentoran,4727,9,10,6,14,25,42,-17,36
Ballinamalla,4727,10,8,3,19,33,58,-25,27
Portadown,4727,11,3,10,17,23,49,-26,19
Crusaders,4728,1,19,7,4,63,27,36,64
Ballymena,4728,2,17,5,8,59,53,6,56
Linfield,4728,3,15,9,6,64,35,29,54
Glenavon,4728,4,11,14,5,52,43,9,47
Coleraine,4728,5,10,10,10,44,47,-3,40
Cliftonville,4728,6,11,5,14,44,52,-8,38
Ards,4728,7,10,6,14,43,50,-7,36
Dungannon,4728,8,8,10,12,46,44,2,34
Glentoran,4728,9,7,9,14,30,48,-18,30
Portadown,4728,10,7,6,17,28,51,-23,27
Ballinamalla,4728,11,6,7,17,25,48,-23,25
Crusaders,4729,1,15,11,4,49,28,21,56
Cliftonville,4729,2,17,2,11,54,44,10,53
Linfield,4729,3,14,9,7,57,28,29,51
Ballymena,4729,4,15,6,9,62,57,5,51
Coleraine,4729,5,12,10,8,42,35,7,46
Glenavon,4729,6,13,7,10,47,46,1,46
Dungannon,4729,7,10,9,11,54,49,5,39
Glentoran,4729,8,8,8,14,31,51,-20,32
Ards,4729,9,9,4,17,33,49,-16,31
Portadown,4729,10,8,6,16,28,47,-19,30
Ballinamalla,4729,11,5,6,19,30,53,-23,21
Crusaders,4730,1,14,11,5,51,37,14,53
Cliftonville,4730,2,16,4,10,52,37,15,52
Coleraine,4730,3,14,9,7,47,37,10,51
Linfield,4730,4,13,9,8,62,40,22,48
Glenavon,4730,5,13,9,8,59,41,18,48
Ballymena,4730,6,14,4,12,56,59,-3,46
Dungannon,4730,7,10,8,12,49,45,4,38
Ards,4730,8,10,5,15,39,53,-14,35
Ballinamalla,4730,9,11,2,17,38,54,-16,35
Glentoran,4730,10,6,9,15,24,46,-22,27
Portadown,4730,11,7,4,19,21,49,-28,25
Crusaders,4731,1,17,6,7,50,32,18,57
Cliftonville,4731,2,16,8,6,53,32,21,56
Linfield,4731,3,16,7,7,65,37,28,55
Ballymena,4731,4,14,5,11,54,58,-4,47
Glenavon,4731,5,11,11,8,48,48,0,44
Glentoran,4731,6,12,7,11,38,42,-4,43
Coleraine,4731,7,9,10,11,37,40,-3,37
Dungannon,4731,8,8,10,12,49,48,1,34
Ballinamalla,4731,9,8,5,17,36,52,-16,29
Ards,4731,10,7,6,17,33,53,-20,27
Portadown,4731,11,6,7,17,28,49,-21,25
Cliftonville,4732,1,18,4,8,52,34,18,58
Linfield,4732,2,15,9,6,58,28,30,54
Ballymena,4732,3,14,8,8,53,49,4,50
Crusaders,4732,4,13,8,9,53,39,14,47
Dungannon,4732,5,11,9,10,48,39,9,42
Glenavon,4732,6,11,9,10,42,47,-5,42
Ballinamalla,4732,7,11,4,15,31,45,-14,37
Coleraine,4732,8,9,9,12,34,41,-7,36
Ards,4732,9,9,5,16,36,50,-14,32
Glentoran,4732,10,8,8,14,28,46,-18,32
Portadown,4732,11,6,7,17,24,41,-17,25
Linfield,4733,1,15,11,4,58,29,29,56
Ballymena,4733,2,16,8,6,59,49,10,56
Cliftonville,4733,3,16,5,9,56,40,16,53
Crusaders,4733,4,15,7,8,56,38,18,52
Glenavon,4733,5,13,10,7,45,38,7,49
Coleraine,4733,6,12,9,9,42,35,7,45
Glentoran,4733,7,10,10,10,39,39,0,40
Dungannon,4733,8,8,9,13,46,49,-3,33
Ards,4733,9,7,5,18,32,54,-22,26
Ballinamalla,4733,10,6,5,19,24,56,-32,23
Portadown,4733,11,5,5,20,21,51,-30,20
Linfield,4734,1,17,8,5,60,29,31,59
Crusaders,4734,2,16,8,6,56,38,18,56
Ballymena,4734,3,16,5,9,56,54,2,53
Cliftonville,4734,4,15,7,8,55,38,17,52
Coleraine,4734,5,11,9,10,40,41,-1,42
Glenavon,4734,6,10,9,11,43,48,-5,39
Glentoran,4734,7,8,11,11,35,44,-9,35
Dungannon,4734,8,7,10,13,43,44,-1,31
Ards,4734,9,7,8,15,36,51,-15,29
Portadown,4734,10,7,6,17,25,40,-15,27
Ballinamalla,4734,11,6,9,15,26,48,-22,27
Crusaders,4735,1,17,8,5,56,35,21,59
Cliftonville,4735,2,15,5,10,47,32,15,50
Dungannon,4735,3,13,10,7,54,37,17,49
Ballymena,4735,4,13,6,11,56,61,-5,45
Linfield,4735,5,10,10,10,52,38,14,40
Ballinamalla,4735,6,12,4,14,38,46,-8,40
Glenavon,4735,7,10,9,11,45,48,-3,39
Coleraine,4735,8,8,12,10,36,40,-4,36
Portadown,4735,9,10,4,16,26,43,-17,34
Ards,4735,10,9,5,16,42,53,-11,32
Glentoran,4735,11,8,7,15,27,46,-19,31
Crusaders,4736,1,18,9,3,53,27,26,63
Linfield,4736,2,14,9,7,68,36,32,51
Cliftonville,4736,3,16,3,11,56,38,18,51
Glenavon,4736,4,13,9,8,49,42,7,48
Ballymena,4736,5,14,6,10,57,60,-3,48
Dungannon,4736,6,10,11,9,45,38,7,41
Coleraine,4736,7,10,9,11,35,40,-5,39
Ards,4736,8,11,4,15,35,47,-12,37
Glentoran,4736,9,7,10,13,22,42,-20,31
Portadown,4736,10,6,6,18,26,50,-24,24
Ballinamalla,4736,11,6,4,20,29,55,-26,22
Crusaders,4737,1,19,7,4,67,40,27,64
Linfield,4737,2,13,9,8,56,34,22,48
Glenavon,4737,3,12,12,6,52,40,12,48
Cliftonville,4737,4,13,7,10,49,39,10,46
Ballymena,4737,5,13,6,11,55,61,-6,45
Coleraine,4737,6,10,13,7,43,36,7,43
Dungannon,4737,7,9,11,10,48,42,6,38
Glentoran,4737,8,9,10,11,40,45,-5,37
Ards,4737,9,9,3,18,33,55,-22,30
Portadown,4737,10,7,7,16,24,50,-26,28
Ballinamalla,4737,11,6,5,19,32,57,-25,23
Crusaders,4738,1,16,8,6,55,38,17,56
Cliftonville,4738,2,15,8,7,56,36,20,53
Glenavon,4738,3,13,11,6,51,37,14,50
Linfield,4738,4,13,9,8,55,36,19,48
Ballymena,4738,5,12,9,9,60,63,-3,45
Coleraine,4738,6,10,13,7,41,34,7,43
Dungannon,4738,7,9,9,12,45,47,-2,36
Glentoran,4738,8,9,6,15,32,53,-21,33
Ards,4738,9,9,5,16,41,49,-8,32
Ballinamalla,4738,10,9,4,17,32,51,-19,31
Portadown,4738,11,7,4,19,27,51,-24,25
Ballymena,4739,1,17,5,8,62,49,13,56
Cliftonville,4739,2,17,4,9,59,44,15,55
Crusaders,4739,3,16,6,8,55,43,12,54
Linfield,4739,4,14,8,8,55,35,20,50
Coleraine,4739,5,14,7,9,47,36,11,49
Dungannon,4739,6,12,8,10,57,40,17,44
Glenavon,4739,7,12,8,10,53,49,4,44
Glentoran,4739,8,10,8,12,37,44,-7,38
Ards,4739,9,8,5,17,39,56,-17,29
Ballinamalla,4739,10,7,6,17,28,54,-26,27
Portadown,4739,11,4,3,23,21,63,-42,15
Cliftonville,4740,1,18,3,9,52,33,19,57
Crusaders,4740,2,15,8,7,54,35,19,53
Linfield,4740,3,15,7,8,63,35,28,52
Ballymena,4740,4,15,5,10,54,59,-5,50
Glenavon,4740,5,10,12,8,49,44,5,42
Dungannon,4740,6,10,10,10,48,45,3,40
Coleraine,4740,7,10,10,10,45,47,-2,40
Ards,4740,8,11,4,15,42,54,-12,37
Ballinamalla,4740,9,9,6,15,36,51,-15,33
Glentoran,4740,10,8,7,15,32,46,-14,31
Portadown,4740,11,5,6,19,22,48,-26,21
Linfield,4741,1,15,8,7,58,33,25,53
Crusaders,4741,2,15,7,8,47,36,11,52
Coleraine,4741,3,13,10,7,47,33,14,49
Ballymena,4741,4,14,7,9,53,54,-1,49
Cliftonville,4741,5,14,6,10,45,37,8,48
Glenavon,4741,6,10,13,7,49,42,7,43
Glentoran,4741,7,10,7,13,32,42,-10,37
Dungannon,4741,8,7,12,11,47,45,2,33
Ards,4741,9,9,4,17,38,53,-15,31
Ballinamalla,4741,10,9,4,17,29,49,-20,31
Portadown,4741,11,7,6,17,25,46,-21,27
Crusaders,4742,1,15,8,7,55,35,20,53
Glenavon,4742,2,14,11,5,55,39,16,53
Cliftonville,4742,3,15,7,8,55,40,15,52
Linfield,4742,4,14,9,7,60,33,27,51
Coleraine,4742,5,12,10,8,53,37,16,46
Ballymena,4742,6,12,6,12,53,66,-13,42
Dungannon,4742,7,10,10,10,47,42,5,40
Glentoran,4742,8,9,8,13,27,38,-11,35
Ards,4742,9,9,5,16,40,53,-13,32
Portadown,4742,10,6,7,17,25,54,-29,25
Ballinamalla,4742,11,5,7,18,32,65,-33,22
Crusaders,4743,1,16,8,6,53,31,22,56
Cliftonville,4743,2,16,6,8,52,39,13,54
Linfield,4743,3,12,10,8,58,39,19,46
Coleraine,4743,4,10,14,6,42,35,7,44
Ards,4743,5,12,5,13,41,42,-1,41
Glenavon,4743,6,9,13,8,44,47,-3,40
Dungannon,4743,7,8,14,8,49,45,4,38
Ballymena,4743,8,9,10,11,52,61,-9,37
Glentoran,4743,9,9,9,12,41,50,-9,36
Ballinamalla,4743,10,6,8,16,28,48,-20,26
Portadown,4743,11,7,5,18,27,50,-23,26
Coleraine,4744,1,14,10,6,51,39,12,52
Dungannon,4744,2,13,9,8,53,36,17,48
Crusaders,4744,3,13,8,9,52,40,12,47
Linfield,4744,4,12,9,9,57,43,14,45
Glenavon,4744,5,11,12,7,44,46,-2,45
Glentoran,4744,6,12,6,12,32,37,-5,42
Cliftonville,4744,7,11,8,11,47,46,1,41
Ballymena,4744,8,11,8,11,54,57,-3,41
Ards,4744,9,9,9,12,37,45,-8,36
Portadown,4744,10,9,5,16,33,43,-10,32
Ballinamalla,4744,11,5,6,19,25,53,-28,21
Crusaders,4745,1,16,9,5,55,28,27,57
Ballymena,4745,2,15,6,9,56,54,2,51
Linfield,4745,3,14,8,8,59,37,22,50
Coleraine,4745,4,13,10,7,45,37,8,49
Cliftonville,4745,5,13,9,8,54,40,14,48
Glentoran,4745,6,10,9,11,38,49,-11,39
Dungannon,4745,7,8,13,9,49,42,7,37
Glenavon,4745,8,8,12,10,48,58,-10,36
Ards,4745,9,9,5,16,33,48,-15,32
Ballinamalla,4745,10,8,2,20,30,55,-25,26
Portadown,4745,11,5,9,16,24,43,-19,24
Crusaders,4746,1,17,6,7,55,39,16,57
Cliftonville,4746,2,16,3,11,53,39,14,51
Linfield,4746,3,12,14,4,63,34,29,50
Coleraine,4746,4,11,13,6,39,31,8,46
Glenavon,4746,5,12,10,8,53,47,6,46
Ballymena,4746,6,13,7,10,59,63,-4,46
Dungannon,4746,7,12,9,9,54,42,12,45
Glentoran,4746,8,10,8,12,36,47,-11,38
Ards,4746,9,8,5,17,36,50,-14,29
Portadown,4746,10,6,7,17,23,49,-26,25
Ballinamalla,4746,11,5,4,21,29,59,-30,19
Crusaders,4747,1,18,7,5,61,35,26,61
Ballymena,4747,2,16,3,11,54,55,-1,51
Cliftonville,4747,3,14,7,9,54,37,17,49
Glenavon,4747,4,11,13,6,49,39,10,46
Linfield,4747,5,12,9,9,55,38,17,45
Coleraine,4747,6,10,11,9,46,40,6,41
Dungannon,4747,7,9,9,12,46,48,-2,36
Portadown,4747,8,8,9,13,32,45,-13,33
Ballinamalla,4747,9,9,5,16,35,50,-15,32
Glentoran,4747,10,8,7,15,28,52,-24,31
Ards,4747,11,7,6,17,36,57,-21,27
Crusaders,4748,1,15,9,6,51,31,20,54
Cliftonville,4748,2,15,5,10,49,43,6,50
Linfield,4748,3,13,10,7,52,33,19,49
Glenavon,4748,4,13,9,8,54,45,9,48
Dungannon,4748,5,11,9,10,48,41,7,42
Coleraine,4748,6,9,15,6,43,38,5,42
Ballymena,4748,7,11,8,11,57,62,-5,41
Glentoran,4748,8,10,9,11,41,44,-3,39
Portadown,4748,9,9,7,14,31,45,-14,34
Ballinamalla,4748,10,8,4,18,27,52,-25,28
Ards,4748,11,6,5,19,34,53,-19,23
Crusaders,4749,1,18,6,6,53,33,20,60
Glenavon,4749,2,13,11,6,51,36,15,50
Linfield,4749,3,12,11,7,54,33,21,47
Cliftonville,4749,4,14,5,11,53,38,15,47
Coleraine,4749,5,13,8,9,48,42,6,47
Ballymena,4749,6,12,8,10,61,64,-3,44
Dungannon,4749,7,11,9,10,52,45,7,42
Ards,4749,8,7,9,14,35,50,-15,30
Glentoran,4749,9,7,9,14,26,41,-15,30
Ballinamalla,4749,10,8,5,17,31,59,-28,29
Portadown,4749,11,6,7,17,25,48,-23,25
Linfield,4750,1,16,9,5,62,28,34,57
Crusaders,4750,2,16,6,8,55,41,14,54
Cliftonville,4750,3,15,5,10,46,36,10,50
Glenavon,4750,4,13,9,8,48,39,9,48
Dungannon,4750,5,13,7,10,57,43,14,46
Ballymena,4750,6,12,7,11,53,54,-1,43
Coleraine,4750,7,10,10,10,33,39,-6,40
Glentoran,4750,8,9,9,12,36,50,-14,36
Ards,4750,9,9,5,16,43,54,-11,32
Portadown,4750,10,8,5,17,33,52,-19,29
Ballinamalla,4750,11,6,4,20,29,59,-30,22
Crusaders,4751,1,18,7,5,62,41,21,61
Coleraine,4751,2,15,9,6,52,35,17,54
Ballymena,4751,3,15,8,7,61,53,8,53
Linfield,4751,4,13,10,7,59,41,18,49
Dungannon,4751,5,12,9,9,54,45,9,45
Cliftonville,4751,6,12,6,12,50,42,8,42
Glenavon,4751,7,10,12,8,43,40,3,42
Ards,4751,8,8,5,17,33,54,-21,29
Glentoran,4751,9,7,7,16,26,41,-15,28
Portadown,4751,10,6,7,17,30,52,-22,25
Ballinamalla,4751,11,6,6,18,26,52,-26,24
Linfield,4752,1,17,6,7,62,34,28,57
Crusaders,4752,2,16,7,7,61,40,21,55
Cliftonville,4752,3,14,6,10,52,41,11,48
Ballymena,4752,4,12,8,10,62,66,-4,44
Glenavon,4752,5,11,10,9,55,51,4,43
Glentoran,4752,6,11,9,10,39,46,-7,42
Ballinamalla,4752,7,13,3,14,36,46,-10,42
Dungannon,4752,8,10,7,13,50,46,4,37
Coleraine,4752,9,8,11,11,43,48,-5,35
Ards,4752,10,8,5,17,35,50,-15,29
Portadown,4752,11,7,4,19,23,50,-27,25
Crusaders,4753,1,17,6,7,52,36,16,57
Cliftonville,4753,2,17,4,9,54,37,17,55
Ballymena,4753,3,16,5,9,56,56,0,53
Linfield,4753,4,15,7,8,61,29,32,52
Glenavon,4753,5,11,10,9,44,42,2,43
Dungannon,4753,6,11,9,10,60,53,7,42
Coleraine,4753,7,10,11,9,49,41,8,41
Ards,4753,8,8,7,15,34,49,-15,31
Glentoran,4753,9,6,10,14,28,45,-17,28
Portadown,4753,10,7,7,16,23,49,-26,28
Ballinamalla,4753,11,5,8,17,25,49,-24,23
Crusaders,4754,1,15,9,6,53,35,18,54
Ballymena,4754,2,14,9,7,62,59,3,51
Linfield,4754,3,13,10,7,57,29,28,49
Cliftonville,4754,4,15,4,11,57,55,2,49
Dungannon,4754,5,12,9,9,54,43,11,45
Glenavon,4754,6,12,9,9,49,48,1,45
Coleraine,4754,7,10,12,8,47,35,12,42
Glentoran,4754,8,9,7,14,29,46,-17,34
Ards,4754,9,9,6,15,31,46,-15,33
Portadown,4754,10,9,5,16,29,45,-16,32
Ballinamalla,4754,11,6,2,22,25,52,-27,20
Crusaders,4755,1,17,6,7,54,36,18,57
Cliftonville,4755,2,15,6,9,61,46,15,51
Dungannon,4755,3,14,8,8,61,40,21,50
Ballymena,4755,4,15,5,10,56,55,1,50
Linfield,4755,5,12,9,9,64,48,16,45
Ards,4755,6,14,3,13,45,46,-1,45
Coleraine,4755,7,11,10,9,45,37,8,43
Glentoran,4755,8,9,8,13,38,49,-11,35
Glenavon,4755,9,8,10,12,40,46,-6,34
Ballinamalla,4755,10,8,3,19,31,64,-33,27
Portadown,4755,11,6,4,20,23,51,-28,22
Crusaders,4756,1,19,7,4,59,28,31,64
Cliftonville,4756,2,15,7,8,60,42,18,52
Glenavon,4756,3,14,10,6,49,42,7,52
Coleraine,4756,4,15,7,8,43,36,7,52
Linfield,4756,5,12,10,8,52,35,17,46
Ballymena,4756,6,12,6,12,61,58,3,42
Dungannon,4756,7,9,11,10,55,45,10,38
Ballinamalla,4756,8,7,7,16,31,52,-21,28
Ards,4756,9,6,8,16,32,52,-20,26
Glentoran,4756,10,4,13,13,27,49,-22,25
Portadown,4756,11,5,8,17,28,58,-30,23
Cliftonville,4757,1,18,5,7,58,35,23,59
Crusaders,4757,2,17,7,6,52,29,23,58
Linfield,4757,3,13,10,7,54,35,19,49
Coleraine,4757,4,12,8,10,51,46,5,44
Glentoran,4757,5,13,5,12,41,44,-3,44
Dungannon,4757,6,10,12,8,48,40,8,42
Ballymena,4757,7,11,9,10,51,56,-5,42
Ards,4757,8,10,6,14,41,46,-5,36
Glenavon,4757,9,7,10,13,35,51,-16,31
Portadown,4757,10,8,5,17,27,44,-17,29
Ballinamalla,4757,11,5,5,20,27,59,-32,20
Crusaders,4758,1,18,5,7,60,36,24,59
Ballymena,4758,2,17,5,8,59,52,7,56
Linfield,4758,3,15,9,6,59,34,25,54
Cliftonville,4758,4,13,8,9,57,44,13,47
Glenavon,4758,5,12,11,7,48,41,7,47
Coleraine,4758,6,12,11,7,45,38,7,47
Ards,4758,7,10,5,15,41,45,-4,35
Dungannon,4758,8,8,7,15,45,46,-1,31
Ballinamalla,4758,9,9,2,19,28,50,-22,29
Glentoran,4758,10,6,8,16,28,54,-26,26
Portadown,4758,11,7,5,18,22,52,-30,26
Crusaders,4759,1,17,7,6,54,31,23,58
Cliftonville,4759,2,17,4,9,53,38,15,55
Glenavon,4759,3,13,10,7,54,42,12,49
Ballymena,4759,4,14,5,11,60,56,4,47
Linfield,4759,5,12,10,8,56,40,16,46
Coleraine,4759,6,10,11,9,41,42,-1,41
Dungannon,4759,7,10,8,12,49,49,0,38
Ballinamalla,4759,8,9,7,14,35,48,-13,34
Glentoran,4759,9,8,9,13,35,46,-11,33
Ards,4759,10,8,3,19,36,57,-21,27
Portadown,4759,11,7,6,17,23,47,-24,27
Crusaders,4760,1,15,10,5,49,29,20,55
Linfield,4760,2,15,8,7,61,30,31,53
Cliftonville,4760,3,15,6,9,54,39,15,51
Coleraine,4760,4,12,10,8,48,47,1,46
Ballymena,4760,5,13,6,11,63,63,0,45
Dungannon,4760,6,11,10,9,48,37,11,43
Glenavon,4760,7,10,10,10,42,46,-4,40
Glentoran,4760,8,9,8,13,27,36,-9,35
Ards,4760,9,11,2,17,40,55,-15,35
Ballinamalla,4760,10,9,4,17,31,51,-20,31
Portadown,4760,11,6,4,20,17,47,-30,22
Cliftonville,4761,1,18,4,8,52,36,16,58
Crusaders,4761,2,17,6,7,61,37,24,57
Glenavon,4761,3,14,12,4,60,46,14,54
Linfield,4761,4,13,12,5,60,36,24,51
Coleraine,4761,5,11,7,12,44,46,-2,40
Ballymena,4761,6,11,6,13,55,61,-6,39
Dungannon,4761,7,9,10,11,49,47,2,37
Glentoran,4761,8,9,8,13,34,42,-8,35
Ards,4761,9,8,7,15,34,51,-17,31
Ballinamalla,4761,10,7,6,17,28,50,-22,27
Portadown,4761,11,4,10,16,19,44,-25,22
Crusaders,4762,1,16,6,8,49,34,15,54
Linfield,4762,2,14,10,6,63,41,22,52
Coleraine,4762,3,13,10,7,42,34,8,49
Glenavon,4762,4,12,12,6,46,42,4,48
Cliftonville,4762,5,13,7,10,50,39,11,46
Ballymena,4762,6,12,7,11,60,62,-2,43
Ards,4762,7,12,5,13,44,44,0,41
Dungannon,4762,8,7,14,9,46,40,6,35
Glentoran,4762,9,9,7,14,31,49,-18,34
Portadown,4762,10,7,5,18,30,52,-22,26
Ballinamalla,4762,11,5,7,18,27,51,-24,22
Crusaders,4763,1,15,8,7,55,40,15,53
Cliftonville,4763,2,16,4,10,53,37,16,52
Linfield,4763,3,14,9,7,59,33,26,51
Coleraine,4763,4,13,9,8,45,34,11,48
Glenavon,4763,5,11,11,8,45,45,0,44
Dungannon,4763,6,12,7,11,50,42,8,43
Ballinamalla,4763,7,11,3,16,34,45,-11,36
Ballymena,4763,8,9,8,13,48,64,-16,35
Ards,4763,9,9,7,14,36,44,-8,34
Glentoran,4763,10,9,7,14,30,44,-14,34
Portadown,4763,11,8,3,19,26,53,-27,27
Cliftonville,4764,1,17,6,7,55,35,20,57
Linfield,4764,2,13,10,7,54,34,20,49
Glenavon,4764,3,11,16,3,44,37,7,49
Crusaders,4764,4,12,11,7,53,41,12,47
Coleraine,4764,5,11,10,9,44,36,8,43
Glentoran,4764,6,12,7,11,42,45,-3,43
Dungannon,4764,7,9,9,12,45,45,0,36
Ards,4764,8,10,6,14,48,54,-6,36
Ballymena,4764,9,9,7,14,48,65,-17,34
Portadown,4764,10,6,9,15,26,40,-14,27
Ballinamalla,4764,11,6,7,17,30,57,-27,25
Linfield,4765,1,16,9,5,62,30,32,57
Ballymena,4765,2,15,7,8,62,59,3,52
Crusaders,4765,3,14,7,9,53,37,16,49
Cliftonville,4765,4,13,4,13,49,45,4,43
Dungannon,4765,5,11,9,10,53,46,7,42
Glenavon,4765,6,10,11,9,47,45,2,41
Portadown,4765,7,12,4,14,36,38,-2,40
Coleraine,4765,8,9,10,11,38,41,-3,37
Ballinamalla,4765,9,10,5,15,27,46,-19,35
Glentoran,4765,10,8,7,15,25,42,-17,31
Ards,4765,11,8,5,17,36,59,-23,29
Cliftonville,4766,1,15,6,9,56,44,12,51
Ballymena,4766,2,13,11,6,60,55,5,50
Linfield,4766,3,13,8,9,65,46,19,47
Coleraine,4766,4,12,11,7,51,41,10,47
Crusaders,4766,5,12,8,10,45,39,6,44
Glenavon,4766,6,11,10,9,44,40,4,43
Dungannon,4766,7,9,12,9,44,40,4,39
Ards,4766,8,10,5,15,42,52,-10,35
Portadown,4766,9,9,6,15,28,39,-11,33
Ballinamalla,4766,10,8,7,15,37,54,-17,31
Glentoran,4766,11,7,8,15,27,49,-22,29
Cliftonville,4767,1,17,6,7,62,34,28,57
Crusaders,4767,2,17,5,8,59,43,16,56
Linfield,4767,3,13,11,6,57,33,24,50
Ballymena,4767,4,15,5,10,66,63,3,50
Dungannon,4767,5,12,9,9,53,44,9,45
Coleraine,4767,6,10,11,9,40,42,-2,41
Glenavon,4767,7,9,11,10,43,47,-4,38
Ards,4767,8,9,8,13,38,42,-4,35
Glentoran,4767,9,8,10,12,29,46,-17,34
Ballinamalla,4767,10,7,4,19,27,51,-24,25
Portadown,4767,11,5,6,19,23,52,-29,21
Cliftonville,4768,1,18,4,8,57,38,19,58
Crusaders,4768,2,16,8,6,52,33,19,56
Linfield,4768,3,14,8,8,54,28,26,50
Coleraine,4768,4,12,10,8,42,37,5,46
Glenavon,4768,5,10,14,6,44,39,5,44
Glentoran,4768,6,12,7,11,39,42,-3,43
Ballymena,4768,7,13,4,13,54,60,-6,43
Dungannon,4768,8,8,11,11,48,47,1,35
Ards,4768,9,10,4,16,45,50,-5,34
Ballinamalla,4768,10,6,5,19,29,59,-30,23
Portadown,4768,11,6,5,19,20,51,-31,23
Crusaders,4769,1,17,8,5,60,35,25,59
Linfield,4769,2,15,10,5,62,32,30,55
Cliftonville,4769,3,16,4,10,57,44,13,52
Glenavon,4769,4,13,12,5,48,38,10,51
Ballymena,4769,5,14,5,11,59,54,5,47
Coleraine,4769,6,12,8,10,39,40,-1,44
Dungannon,4769,7,10,9,11,49,44,5,39
Glentoran,4769,8,9,5,16,33,50,-17,32
Ards,4769,9,8,4,18,40,60,-20,28
Portadown,4769,10,6,7,17,26,49,-23,25
Ballinamalla,4769,11,5,8,17,28,55,-27,23
Crusaders,4770,1,17,7,6,56,34,22,58
Linfield,4770,2,14,10,6,52,28,24,52
Cliftonville,4770,3,14,5,11,58,47,11,47
Glenavon,4770,4,12,10,8,50,41,9,46
Ballymena,4770,5,12,6,12,54,67,-13,42
Coleraine,4770,6,10,10,10,39,45,-6,40
Ballinamalla,4770,7,11,5,14,38,47,-9,38
Portadown,4770,8,10,6,14,31,41,-10,36
Ards,4770,9,9,6,15,38,44,-6,33
Dungannon,4770,10,7,10,13,41,42,-1,31
Glentoran,4770,11,8,7,15,22,43,-21,31
Linfield,4771,1,15,8,7,54,29,25,53
Cliftonville,4771,2,15,6,9,47,34,13,51
Glenavon,4771,3,13,9,8,46,44,2,48
Dungannon,4771,4,13,8,9,57,39,18,47
Crusaders,4771,5,13,8,9,48,40,8,47
Ballymena,4771,6,13,5,12,56,59,-3,44
Coleraine,4771,7,10,10,10,37,37,0,40
Glentoran,4771,8,11,7,12,39,44,-5,40
Portadown,4771,9,10,3,17,26,43,-17,33
Ballinamalla,4771,10,9,3,18,30,54,-24,30
Ards,4771,11,7,5,18,34,51,-17,26
Linfield,4772,1,17,8,5,69,32,37,59
Cliftonville,4772,2,18,3,9,60,42,18,57
Glenavon,4772,3,14,12,4,51,38,13,54
Crusaders,4772,4,15,6,9,54,41,13,51
Coleraine,4772,5,12,10,8,52,39,13,46
Dungannon,4772,6,11,9,10,51,47,4,42
Glentoran,4772,7,11,6,13,36,44,-8,39
Ballymena,4772,8,10,7,13,54,68,-14,37
Ards,4772,9,6,6,18,33,55,-22,24
Portadown,4772,10,6,6,18,22,48,-26,24
Ballinamalla,4772,11,6,5,19,25,53,-28,23
Glenavon,4773,1,14,10,6,56,41,15,52
Ballymena,4773,2,15,7,8,59,56,3,52
Linfield,4773,3,13,12,5,57,35,22,51
Cliftonville,4773,4,15,5,10,56,42,14,50
Crusaders,4773,5,12,11,7,51,42,9,47
Dungannon,4773,6,10,9,11,54,45,9,39
Coleraine,4773,7,9,11,10,35,39,-4,38
Ballinamalla,4773,8,11,5,14,34,46,-12,38
Glentoran,4773,9,6,11,13,30,43,-13,29
Portadown,4773,10,7,6,17,26,48,-22,27
Ards,4773,11,6,7,17,30,51,-21,25
Crusaders,4774,1,18,7,5,58,36,22,61
Linfield,4774,2,13,11,6,58,35,23,50
Ballymena,4774,3,14,6,10,63,68,-5,48
Cliftonville,4774,4,13,6,11,56,43,13,45
Dungannon,4774,5,12,8,10,53,42,11,44
Coleraine,4774,6,9,12,9,44,44,0,39
Ards,4774,7,11,5,14,46,51,-5,38
Glentoran,4774,8,10,7,13,37,42,-5,37
Glenavon,4774,9,7,13,10,41,48,-7,34
Portadown,4774,10,7,9,14,26,47,-21,30
Ballinamalla,4774,11,6,6,18,22,48,-26,24
Crusaders,4775,1,17,10,3,54,26,28,61
Linfield,4775,2,17,8,5,63,31,32,59
Ballymena,4775,3,14,6,10,59,59,0,48
Cliftonville,4775,4,13,5,12,50,42,8,44
Glenavon,4775,5,11,10,9,48,53,-5,43
Dungannon,4775,6,11,9,10,51,40,11,42
Coleraine,4775,7,11,7,12,44,43,1,40
Glentoran,4775,8,8,10,12,26,37,-11,34
Ards,4775,9,9,5,16,38,51,-13,32
Portadown,4775,10,7,6,17,28,51,-23,27
Ballinamalla,4775,11,5,8,17,23,51,-28,23
Crusaders,4776,1,16,11,3,63,29,34,59
Ballymena,4776,2,17,4,9,60,52,8,55
Glenavon,4776,3,13,12,5,52,39,13,51
Cliftonville,4776,4,15,4,11,55,42,13,49
Linfield,4776,5,14,6,10,55,34,21,48
Coleraine,4776,6,12,8,10,44,42,2,44
Dungannon,4776,7,9,9,12,50,50,0,36
Ards,4776,8,10,3,17,39,52,-13,33
Glentoran,4776,9,7,9,14,29,50,-21,30
Ballinamalla,4776,10,7,5,18,24,52,-28,26
Portadown,4776,11,6,7,17,23,52,-29,25
Crusaders,4777,1,17,8,5,59,33,26,59
Linfield,4777,2,14,9,7,55,35,20,51
Cliftonville,4777,3,15,5,10,49,35,14,50
Ballymena,4777,4,14,5,11,61,57,4,47
Glenavon,4777,5,11,10,9,47,48,-1,43
Glentoran,4777,6,10,9,11,37,40,-3,39
Dungannon,4777,7,8,12,10,47,45,2,36
Ballinamalla,4777,8,10,6,14,32,47,-15,36
Coleraine,4777,9,8,10,12,37,45,-8,34
Ards,4777,10,9,7,14,36,46,-10,34
Portadown,4777,11,6,5,19,21,50,-29,23
Cliftonville,4778,1,17,4,9,53,37,16,55
Linfield,4778,2,14,8,8,56,28,28,50
Coleraine,4778,3,13,9,8,54,39,15,48
Crusaders,4778,4,13,9,8,51,40,11,48
Dungannon,4778,5,12,10,8,49,36,13,46
Ballymena,4778,6,13,6,11,56,59,-3,45
Ballinamalla,4778,7,10,6,14,32,45,-13,36
Glenavon,4778,8,7,14,9,40,48,-8,35
Portadown,4778,9,8,8,14,25,40,-15,32
Ards,4778,10,7,7,16,28,54,-26,28
Glentoran,4778,11,6,9,15,27,45,-18,27
Crusaders,4779,1,19,5,6,56,38,18,62
Cliftonville,4779,2,17,3,10,51,43,8,54
Linfield,4779,3,13,9,8,54,36,18,48
Coleraine,4779,4,12,9,9,51,38,13,45
Glentoran,4779,5,11,9,10,37,39,-2,42
Dungannon,4779,6,10,9,11,49,43,6,39
Glenavon,4779,7,10,9,11,50,46,4,39
Ballymena,4779,8,11,6,13,47,56,-9,39
Ballinamalla,4779,9,9,6,15,32,46,-14,33
Ards,4779,10,8,7,15,35,49,-14,31
Portadown,4779,11,6,6,18,24,52,-28,24
Crusaders,4780,1,17,7,6,56,31,25,58
Linfield,4780,2,15,10,5,56,30,26,55
Cliftonville,4780,3,17,4,9,56,42,14,55
Coleraine,4780,4,13,9,8,45,34,11,48
Glenavon,4780,5,11,12,7,49,46,3,45
Ballymena,4780,6,13,4,13,63,64,-1,43
Ards,4780,7,11,5,14,42,48,-6,38
Glentoran,4780,8,10,4,16,30,44,-14,34
Dungannon,4780,9,8,7,15,44,56,-12,31
Ballinamalla,4780,10,8,5,17,28,48,-20,29
Portadown,4780,11,6,5,19,21,47,-26,23
Crusaders,4781,1,17,8,5,53,28,25,59
Linfield,4781,2,13,11,6,56,31,25,50
Cliftonville,4781,3,15,5,10,56,45,11,50
Coleraine,4781,4,11,13,6,50,39,11,46
Glenavon,4781,5,10,12,8,48,44,4,42
Ballymena,4781,6,12,5,13,51,60,-9,41
Glentoran,4781,7,11,7,12,33,42,-9,40
Dungannon,4781,8,7,12,11,46,46,0,33
Portadown,4781,9,9,6,15,32,43,-11,33
Ards,4781,10,9,4,17,35,52,-17,31
Ballinamalla,4781,11,8,3,19,28,58,-30,27
Crusaders,4782,1,16,9,5,59,37,22,57
Glenavon,4782,2,14,10,6,55,39,16,52
Cliftonville,4782,3,16,4,10,51,42,9,52
Linfield,4782,4,14,9,7,60,36,24,51
Coleraine,4782,5,12,9,9,47,36,11,45
Ballymena,4782,6,13,6,11,55,56,-1,45
Dungannon,4782,7,11,9,10,49,39,10,42
Ards,4782,8,11,3,16,35,50,-15,36
Ballinamalla,4782,9,9,4,17,27,49,-22,31
Glentoran,4782,10,7,4,19,25,52,-27,25
Portadown,4782,11,5,7,18,22,49,-27,22
Crusaders,4783,1,17,9,4,57,31,26,60
Linfield,4783,2,15,10,5,58,27,31,55
Ballymena,4783,3,14,6,10,57,59,-2,48
Cliftonville,4783,4,13,8,9,58,47,11,47
Glenavon,4783,5,12,10,8,43,42,1,46
Coleraine,4783,6,12,8,10,42,34,8,44
Ards,4783,7,13,3,14,43,44,-1,42
Glentoran,4783,8,10,8,12,29,39,-10,38
Dungannon,4783,9,7,10,13,42,44,-2,31
Portadown,4783,10,6,5,19,15,42,-27,23
Ballinamalla,4783,11,6,3,21,28,63,-35,21
Crusaders,4784,1,19,5,6,66,37,29,62
Linfield,4784,2,16,9,5,57,26,31,57
Glenavon,4784,3,12,10,8,58,45,13,46
Cliftonville,4784,4,13,6,11,49,43,6,45
Ballymena,4784,5,13,6,11,59,68,-9,45
Dungannon,4784,6,12,8,10,57,48,9,44
Coleraine,4784,7,10,10,10,41,45,-4,40
Ballinamalla,4784,8,9,6,15,28,45,-17,33
Ards,4784,9,7,7,16,34,51,-17,28
Glentoran,4784,10,6,9,15,29,45,-16,27
Portadown,4784,11,6,8,16,24,49,-25,26
Linfield,4785,1,14,11,5,53,30,23,53
Crusaders,4785,2,15,8,7,54,36,18,53
Cliftonville,4785,3,15,6,9,55,41,14,51
Glenavon,4785,4,10,15,5,43,37,6,45
Dungannon,4785,5,11,9,10,50,42,8,42
Ballymena,4785,6,10,11,9,58,60,-2,41
Coleraine,4785,7,10,10,10,43,51,-8,40
Ards,4785,8,10,7,13,47,49,-2,37
Ballinamalla,4785,9,8,6,16,30,48,-18,30
Portadown,4785,10,8,5,17,25,42,-17,29
Glentoran,4785,11,6,8,16,26,48,-22,26
Crusaders,4786,1,20,6,4,61,31,30,66
Ballymena,4786,2,15,8,7,58,54,4,53
Linfield,4786,3,13,10,7,50,29,21,49
Coleraine,4786,4,13,10,7,46,37,9,49
Cliftonville,4786,5,15,3,12,52,45,7,48
Glenavon,4786,6,10,13,7,44,40,4,43
Dungannon,4786,7,10,11,9,57,46,11,41
Ards,4786,8,8,7,15,38,48,-10,31
Glentoran,4786,9,8,5,17,33,49,-16,29
Ballinamalla,4786,10,8,3,19,30,56,-26,27
Portadown,4786,11,4,6,20,20,54,-34,18
Crusaders,4787,1,17,5,8,62,39,23,56
Linfield,4787,2,15,10,5,59,28,31,55
Glenavon,4787,3,14,9,7,50,41,9,51
Coleraine,4787,4,13,11,6,42,32,10,50
Ballymena,4787,5,14,5,11,61,59,2,47
Dungannon,4787,6,12,7,11,55,50,5,43
Cliftonville,4787,7,12,7,11,47,45,2,43
Glentoran,4787,8,7,11,12,30,42,-12,32
Ards,4787,9,8,4,18,33,55,-22,28
Portadown,4787,10,7,5,18,28,46,-18,26
Ballinamalla,4787,11,7,4,19,27,57,-30,25
Coleraine,4788,1,15,10,5,50,31,19,55
Linfield,4788,2,15,9,6,60,28,32,54
Cliftonville,4788,3,15,4,11,48,35,13,49
Crusaders,4788,4,13,8,9,47,39,8,47
Ballymena,4788,5,12,9,9,55,61,-6,45
Glenavon,4788,6,11,10,9,47,45,2,43
Glentoran,4788,7,9,9,12,35,46,-11,36
Dungannon,4788,8,8,11,11,46,47,-1,35
Ballinamalla,4788,9,9,7,14,32,46,-14,34
Portadown,4788,10,8,5,17,30,51,-21,29
Ards,4788,11,7,4,19,32,53,-21,25
Linfield,4789,1,15,12,3,64,31,33,57
Ballymena,4789,2,15,7,8,60,57,3,52
Crusaders,4789,3,15,6,9,57,43,14,51
Cliftonville,4789,4,14,6,10,53,40,13,48
Coleraine,4789,5,12,11,7,45,34,11,47
Glenavon,4789,6,10,12,8,45,47,-2,42
Glentoran,4789,7,12,5,13,37,43,-6,41
Dungannon,4789,8,8,8,14,47,52,-5,32
Ards,4789,9,8,4,18,34,51,-17,28
Portadown,4789,10,7,7,16,26,46,-20,28
Ballinamalla,4789,11,8,4,18,35,59,-24,28
Crusaders,4790,1,15,9,6,56,34,22,54
Cliftonville,4790,2,15,5,10,50,39,11,50
Coleraine,4790,3,13,10,7,42,32,10,49
Glenavon,4790,4,12,12,6,52,42,10,48
Linfield,4790,5,12,9,9,55,39,16,45
Ballymena,4790,6,13,4,13,60,70,-10,43
Glentoran,4790,7,10,10,10,36,42,-6,40
Dungannon,4790,8,9,11,10,53,46,7,38
Ards,4790,9,9,5,16,32,44,-12,32
Portadown,4790,10,8,8,14,25,40,-15,32
Ballinamalla,4790,11,5,5,20,21,54,-33,20
Linfield,4791,1,15,11,4,59,30,29,56
Crusaders,4791,2,14,9,7,58,38,20,51
Cliftonville,4791,3,15,5,10,51,37,14,50
Ballymena,4791,4,13,7,10,56,56,0,46
Coleraine,4791,5,11,12,7,42,35,7,45
Glenavon,4791,6,11,10,9,43,42,1,43
Dungannon,4791,7,11,7,12,53,48,5,40
Glentoran,4791,8,9,10,11,28,40,-12,37
Ards,4791,9,9,8,13,35,46,-11,35
Portadown,4791,10,7,8,15,22,43,-21,29
Ballinamalla,4791,11,3,7,20,21,53,-32,16
Crusaders,4792,1,18,6,6,56,29,27,60
Linfield,4792,2,14,11,5,62,31,31,53
Cliftonville,4792,3,15,6,9,52,35,17,51
Ballymena,4792,4,15,4,11,65,63,2,49
Glenavon,4792,5,11,11,8,54,51,3,44
Dungannon,4792,6,11,9,10,50,43,7,42
Coleraine,4792,7,10,9,11,45,46,-1,39
Glentoran,4792,8,10,8,12,33,43,-10,38
Ards,4792,9,9,4,17,32,50,-18,31
Ballinamalla,4792,10,7,5,18,30,55,-25,26
Portadown,4792,11,5,7,18,26,59,-33,22
Cliftonville,4793,1,17,5,8,65,44,21,56
Crusaders,4793,2,15,10,5,55,31,24,55
Linfield,4793,3,14,8,8,56,31,25,50
Glentoran,4793,4,14,8,8,39,37,2,50
Coleraine,4793,5,12,12,6,45,36,9,48
Ballymena,4793,6,12,5,13,55,64,-9,41
Dungannon,4793,7,8,11,11,51,49,2,35
Glenavon,4793,8,8,10,12,43,52,-9,34
Ards,4793,9,8,6,16,35,49,-14,30
Ballinamalla,4793,10,9,3,18,29,56,-27,30
Portadown,4793,11,6,6,18,30,54,-24,24
Cliftonville,4794,1,18,4,8,55,38,17,58
Crusaders,4794,2,15,8,7,55,35,20,53
Ballymena,4794,3,15,5,10,57,57,0,50
Dungannon,4794,4,13,9,8,55,40,15,48
Glenavon,4794,5,11,12,7,44,43,1,45
Coleraine,4794,6,11,11,8,44,40,4,44
Linfield,4794,7,10,9,11,47,36,11,39
Ards,4794,8,10,6,14,42,50,-8,36
Ballinamalla,4794,9,9,3,18,33,51,-18,30
Portadown,4794,10,7,6,17,24,45,-21,27
Glentoran,4794,11,6,7,17,25,46,-21,25
Crusaders,4795,1,17,9,4,56,29,27,60
Linfield,4795,2,14,10,6,62,27,35,52
Ballymena,4795,3,15,6,9,66,54,12,51
Coleraine,4795,4,14,8,8,47,37,10,50
Cliftonville,4795,5,13,8,9,54,44,10,47
Dungannon,4795,6,9,10,11,45,45,0,37
Glenavon,4795,7,9,10,11,37,43,-6,37
Ards,4795,8,9,6,15,41,58,-17,33
Glentoran,4795,9,8,8,14,25,46,-21,32
Ballinamalla,4795,10,8,4,18,31,50,-19,28
Portadown,4795,11,6,7,17,20,51,-31,25
Crusaders,4796,1,16,8,6,54,38,16,56
Ballymena,4796,2,15,8,7,60,54,6,53
Linfield,4796,3,13,11,6,58,36,22,50
Glenavon,4796,4,12,12,6,57,52,5,48
Coleraine,4796,5,10,12,8,46,37,9,42
Dungannon,4796,6,10,10,10,54,43,11,40
Cliftonville,4796,7,11,6,13,41,44,-3,39
Glentoran,4796,8,9,12,9,29,33,-4,39
Ards,4796,9,8,5,17,40,58,-18,29
Portadown,4796,10,6,9,15,31,48,-17,27
Ballinamalla,4796,11,5,7,18,23,50,-27,22
Linfield,4797,1,17,8,5,61,24,37,59
Crusaders,4797,2,18,5,7,54,35,19,59
Ballymena,4797,3,14,5,11,50,51,-1,47
Cliftonville,4797,4,13,6,11,48,38,10,45
Glenavon,4797,5,11,12,7,50,46,4,45
Coleraine,4797,6,11,10,9,42,37,5,43
Dungannon,4797,7,9,9,12,45,45,0,36
Glentoran,4797,8,9,8,13,35,48,-13,35
Portadown,4797,9,9,4,17,23,44,-21,31
Ards,4797,10,8,6,16,36,49,-13,30
Ballinamalla,4797,11,7,5,18,23,50,-27,26
Linfield,4798,1,16,11,3,68,27,41,59
Crusaders,4798,2,15,9,6,51,30,21,54
Coleraine,4798,3,13,10,7,44,39,5,49
Glenavon,4798,4,12,12,6,44,35,9,48
Ballymena,4798,5,14,6,10,57,49,8,48
Cliftonville,4798,6,14,4,12,52,48,4,46
Dungannon,4798,7,9,11,10,51,46,5,38
Portadown,4798,8,11,4,15,27,51,-24,37
Glentoran,4798,9,7,8,15,25,43,-18,29
Ards,4798,10,6,5,19,35,56,-21,23
Ballinamalla,4798,11,6,4,20,23,53,-30,22
Linfield,4799,1,19,7,4,58,25,33,64
Ballymena,4799,2,18,5,7,62,52,10,59
Cliftonville,4799,3,17,3,10,56,39,17,54
Crusaders,4799,4,13,6,11,53,45,8,45
Coleraine,4799,5,12,9,9,47,39,8,45
Glenavon,4799,6,11,10,9,42,42,0,43
Dungannon,4799,7,9,8,13,50,47,3,35
Ards,4799,8,9,8,13,41,50,-9,35
Ballinamalla,4799,9,8,4,18,36,56,-20,28
Glentoran,4799,10,6,8,16,27,51,-24,26
Portadown,4799,11,7,4,19,23,49,-26,25
Crusaders,4800,1,17,7,6,55,35,20,58
Cliftonville,4800,2,16,6,8,53,34,19,54
Linfield,4800,3,14,9,7,61,36,25,51
Ballymena,4800,4,12,7,11,58,62,-4,43
Glentoran,4800,5,11,8,11,39,41,-2,41
Glenavon,4800,6,9,11,10,47,49,-2,38
Ards,4800,7,10,8,12,42,51,-9,38
Coleraine,4800,8,9,10,11,38,47,-9,37
Portadown,4800,9,11,4,15,34,50,-16,37
Dungannon,4800,10,9,7,14,48,46,2,34
Ballinamalla,4800,11,6,5,19,25,49,-24,23
Crusaders,4801,1,17,5,8,52,34,18,56
Linfield,4801,2,15,9,6,63,29,34,54
Cliftonville,4801,3,15,5,10,50,40,10,50
Coleraine,4801,4,12,11,7,45,37,8,47
Portadown,4801,5,13,4,13,33,37,-4,43
Glenavon,4801,6,10,10,10,41,44,-3,40
Ards,4801,7,11,6,13,40,43,-3,39
Ballymena,4801,8,10,7,13,46,68,-22,37
Dungannon,4801,9,8,11,11,41,43,-2,35
Glentoran,4801,10,7,7,16,28,45,-17,28
Ballinamalla,4801,11,7,5,18,30,49,-19,26
Crusaders,4802,1,17,9,4,58,29,29,60
Cliftonville,4802,2,17,5,8,57,40,17,56
Ballymena,4802,3,15,5,10,58,56,2,50
Glenavon,4802,4,12,12,6,52,43,9,48
Linfield,4802,5,12,11,7,56,33,23,47
Coleraine,4802,6,10,9,11,36,38,-2,39
Glentoran,4802,7,9,8,13,30,42,-12,35
Dungannon,4802,8,9,7,14,44,47,-3,34
Ards,4802,9,10,3,17,39,55,-16,33
Ballinamalla,4802,10,9,5,16,32,51,-19,32
Portadown,4802,11,6,4,20,23,51,-28,22
Crusaders,4803,1,17,8,5,62,33,29,59
Linfield,4803,2,16,10,4,67,32,35,58
Cliftonville,4803,3,14,8,8,50,37,13,50
Glenavon,4803,4,13,10,7,47,42,5,49
Ballymena,4803,5,12,6,12,53,60,-7,42
Dungannon,4803,6,10,10,10,46,40,6,40
Glentoran,4803,7,10,9,11,31,39,-8,39
Coleraine,4803,8,9,11,10,42,44,-2,38
Ballinamalla,4803,9,9,5,16,33,47,-14,32
Ards,4803,10,6,6,18,29,53,-24,24
Portadown,4803,11,5,5,20,23,56,-33,20
Cliftonville,4804,1,16,7,7,61,36,25,55
Crusaders,4804,2,15,7,8,59,43,16,52
Linfield,4804,3,13,10,7,62,37,25,49
Ballymena,4804,4,13,7,10,61,62,-1,46
Glenavon,4804,5,10,13,7,46,44,2,43
Coleraine,4804,6,9,11,10,37,37,0,38
Dungannon,4804,7,9,10,11,43,45,-2,37
Glentoran,4804,8,8,11,11,37,43,-6,35
Ards,4804,9,9,5,16,37,54,-17,32
Portadown,4804,10,8,8,14,28,49,-21,32
Ballinamalla,4804,11,7,7,16,28,49,-21,28
Crusaders,4805,1,16,7,7,55,36,19,55
Ballymena,4805,2,14,9,7,60,49,11,51
Linfield,4805,3,13,10,7,53,27,26,49
Coleraine,4805,4,12,11,7,45,39,6,47
Glenavon,4805,5,10,12,8,48,55,-7,42
Cliftonville,4805,6,12,5,13,42,41,1,41
Dungannon,4805,7,9,10,11,45,43,2,37
Glentoran,4805,8,8,12,10,29,38,-9,36
Portadown,4805,9,8,7,15,26,42,-16,31
Ballinamalla,4805,10,9,4,17,24,44,-20,31
Ards,4805,11,6,9,15,32,45,-13,27
Crusaders,4806,1,17,6,7,56,32,24,57
Cliftonville,4806,2,16,8,6,53,32,21,56
Linfield,4806,3,12,11,7,56,32,24,47
Dungannon,4806,4,13,8,9,49,36,13,47
Glenavon,4806,5,12,10,8,45,43,2,46
Coleraine,4806,6,11,11,8,42,35,7,44
Ballymena,4806,7,12,8,10,55,58,-3,44
Glentoran,4806,8,10,7,13,31,41,-10,37
Ards,4806,9,11,3,16,37,52,-15,36
Ballinamalla,4806,10,6,3,21,28,56,-28,21
Portadown,4806,11,5,5,20,20,55,-35,20
Crusaders,4807,1,17,8,5,50,27,23,59
Coleraine,4807,2,15,9,6,48,34,14,54
Linfield,4807,3,15,8,7,60,33,27,53
Cliftonville,4807,4,14,6,10,53,41,12,48
Ballymena,4807,5,12,8,10,55,57,-2,44
Glenavon,4807,6,10,12,8,49,49,0,42
Dungannon,4807,7,8,12,10,49,47,2,36
Ards,4807,8,8,7,15,45,55,-10,31
Glentoran,4807,9,7,10,13,34,51,-17,31
Portadown,4807,10,8,3,19,25,53,-28,27
Ballinamalla,4807,11,6,7,17,29,50,-21,25
Linfield,4808,1,15,8,7,54,28,26,53
Crusaders,4808,2,15,7,8,56,34,22,52
Ballymena,4808,3,15,5,10,50,52,-2,50
Glenavon,4808,4,13,10,7,48,43,5,49
Dungannon,4808,5,13,8,9,54,35,19,47
Coleraine,4808,6,11,13,6,40,32,8,46
Cliftonville,4808,7,13,7,10,43,38,5,46
Ards,4808,8,10,4,16,34,46,-12,34
Portadown,4808,9,9,7,14,32,44,-12,34
Glentoran,4808,10,6,11,13,24,42,-18,29
Ballinamalla,4808,11,3,4,23,24,65,-41,13
Crusaders,4809,1,15,9,6,54,35,19,54
Glenavon,4809,2,14,10,6,54,43,11,52
Cliftonville,4809,3,15,5,10,49,36,13,50
Coleraine,4809,4,12,12,6,41,34,7,48
Linfield,4809,5,12,8,10,57,45,12,44
Dungannon,4809,6,10,10,10,52,42,10,40
Ards,4809,7,12,4,14,42,45,-3,40
Ballymena,4809,8,11,6,13,56,62,-6,39
Glentoran,4809,9,9,7,14,29,45,-16,34
Portadown,4809,10,8,5,17,26,44,-18,29
Ballinamalla,4809,11,6,6,18,28,57,-29,24
Linfield,4810,1,16,8,6,64,34,30,56
Crusaders,4810,2,16,6,8,56,34,22,54
Coleraine,4810,3,15,8,7,53,36,17,53
Ballymena,4810,4,15,6,9,54,56,-2,51
Glenavon,4810,5,12,10,8,53,47,6,46
Cliftonville,4810,6,13,4,13,45,44,1,43
Dungannon,4810,7,11,6,13,46,41,5,39
Ards,4810,8,9,6,15,40,51,-11,33
Glentoran,4810,9,9,6,15,28,43,-15,33
Portadown,4810,10,7,5,18,23,45,-22,26
Ballinamalla,4810,11,6,7,17,29,60,-31,25
Linfield,4811,1,17,9,4,62,27,35,60
Cliftonville,4811,2,16,5,9,49,40,9,53
Crusaders,4811,3,15,7,8,55,36,19,52
Glenavon,4811,4,13,10,7,48,41,7,49
Ballymena,4811,5,14,4,12,64,60,4,46
Coleraine,4811,6,12,8,10,48,45,3,44
Glentoran,4811,7,11,6,13,35,43,-8,39
Dungannon,4811,8,8,12,10,48,45,3,36
Ballinamalla,4811,9,8,3,19,30,59,-29,27
Ards,4811,10,7,5,18,37,53,-16,26
Portadown,4811,11,6,7,17,23,50,-27,25
Cliftonville,4812,1,17,4,9,58,39,19,55
Linfield,4812,2,14,11,5,63,34,29,53
Crusaders,4812,3,13,8,9,53,47,6,47
Glenavon,4812,4,12,10,8,50,39,11,46
Coleraine,4812,5,12,10,8,41,34,7,46
Ballymena,4812,6,13,6,11,52,52,0,45
Dungannon,4812,7,11,9,10,51,46,5,42
Ballinamalla,4812,8,10,3,17,28,48,-20,33
Glentoran,4812,9,8,7,15,29,49,-20,31
Ards,4812,10,8,6,16,38,53,-15,30
Portadown,4812,11,8,4,18,25,47,-22,28
Linfield,4813,1,17,8,5,63,29,34,59
Cliftonville,4813,2,18,4,8,58,43,15,58
Crusaders,4813,3,16,7,7,54,35,19,55
Coleraine,4813,4,14,8,8,53,37,16,50
Glenavon,4813,5,13,10,7,51,42,9,49
Ballymena,4813,6,15,4,11,63,66,-3,49
Dungannon,4813,7,8,9,13,50,48,2,33
Ards,4813,8,9,5,16,39,50,-11,32
Glentoran,4813,9,8,6,16,42,56,-14,30
Portadown,4813,10,8,5,17,24,48,-24,29
Ballinamalla,4813,11,5,2,23,22,65,-43,17
Linfield,4814,1,15,10,5,56,24,32,55
Cliftonville,4814,2,16,6,8,55,32,23,54
Crusaders,4814,3,15,9,6,56,45,11,54
Glenavon,4814,4,13,10,7,55,47,8,49
Ballymena,4814,5,14,7,9,57,54,3,49
Dungannon,4814,6,11,7,12,51,44,7,40
Ards,4814,7,11,6,13,39,43,-4,39
Coleraine,4814,8,8,10,12,36,44,-8,34
Portadown,4814,9,8,7,15,26,44,-18,31
Glentoran,4814,10,8,6,16,30,47,-17,30
Ballinamalla,4814,11,6,2,22,31,68,-37,20
Crusaders,4815,1,17,10,3,68,32,36,61
Cliftonville,4815,2,15,5,10,57,41,16,50
Glenavon,4815,3,12,11,7,44,42,2,47
Linfield,4815,4,10,14,6,52,32,20,44
Ballymena,4815,5,12,8,10,51,59,-8,44
Coleraine,4815,6,10,11,9,42,43,-1,41
Dungannon,4815,7,10,9,11,45,45,0,39
Ards,4815,8,9,7,14,36,43,-7,34
Ballinamalla,4815,9,10,3,17,29,48,-19,33
Glentoran,4815,10,8,7,15,33,47,-14,31
Portadown,4815,11,6,7,17,23,48,-25,25
Crusaders,4816,1,16,9,5,56,36,20,57
Ballymena,4816,2,14,8,8,60,58,2,50
Coleraine,4816,3,12,11,7,50,37,13,47
Linfield,4816,4,11,10,9,54,41,13,43
Cliftonville,4816,5,12,7,11,55,46,9,43
Glenavon,4816,6,10,11,9,47,49,-2,41
Ards,4816,7,12,5,13,46,50,-4,41
Dungannon,4816,8,9,9,12,44,38,6,36
Ballinamalla,4816,9,9,7,14,38,51,-13,34
Portadown,4816,10,8,8,14,26,45,-19,32
Glentoran,4816,11,7,5,18,23,48,-25,26
Crusaders,4817,1,19,6,5,58,29,29,63
Linfield,4817,2,13,10,7,58,32,26,49
Cliftonville,4817,3,14,7,9,48,38,10,49
Ballymena,4817,4,12,7,11,50,53,-3,43
Coleraine,4817,5,10,12,8,45,41,4,42
Dungannon,4817,6,9,11,10,43,43,0,38
Glentoran,4817,7,10,8,12,32,46,-14,38
Glenavon,4817,8,8,13,9,44,47,-3,37
Portadown,4817,9,9,7,14,31,42,-11,34
Ards,4817,10,7,7,16,32,52,-20,28
Ballinamalla,4817,11,7,6,17,32,50,-18,27
Linfield,4818,1,15,11,4,67,32,35,56
Cliftonville,4818,2,17,2,11,57,41,16,53
Crusaders,4818,3,14,8,8,56,36,20,50
Ballymena,4818,4,14,7,9,59,56,3,49
Glenavon,4818,5,10,13,7,46,45,1,43
Dungannon,4818,6,11,8,11,48,43,5,41
Coleraine,4818,7,11,8,11,40,43,-3,41
Ards,4818,8,11,3,16,42,48,-6,36
Portadown,4818,9,9,5,16,27,44,-17,32
Glentoran,4818,10,7,9,14,31,54,-23,30
Ballinamalla,4818,11,5,8,17,26,57,-31,23
Linfield,4819,1,15,9,6,58,36,22,54
Cliftonville,4819,2,15,6,9,56,37,19,51
Crusaders,4819,3,13,9,8,55,38,17,48
Coleraine,4819,4,12,10,8,45,41,4,46
Glenavon,4819,5,12,9,9,50,46,4,45
Dungannon,4819,6,12,8,10,56,50,6,44
Ballymena,4819,7,12,6,12,60,68,-8,42
Glentoran,4819,8,8,8,14,32,45,-13,32
Portadown,4819,9,9,5,16,31,48,-17,32
Ards,4819,10,9,4,17,33,49,-16,31
Ballinamalla,4819,11,9,4,17,32,50,-18,31
Crusaders,4820,1,15,9,6,52,32,20,54
Cliftonville,4820,2,16,4,10,60,42,18,52
Linfield,4820,3,14,8,8,53,32,21,50
Coleraine,4820,4,12,11,7,47,40,7,47
Ballymena,4820,5,13,8,9,59,53,6,47
Glenavon,4820,6,11,11,8,52,54,-2,44
Dungannon,4820,7,10,11,9,55,46,9,41
Ballinamalla,4820,8,13,2,15,39,51,-12,41
Ards,4820,9,8,8,14,42,50,-8,32
Glentoran,4820,10,6,8,16,29,50,-21,26
Portadown,4820,11,4,6,20,18,56,-38,18
Crusaders,4821,1,21,5,4,59,25,34,68
Ballymena,4821,2,17,5,8,67,59,8,56
Linfield,4821,3,13,7,10,59,37,22,46
Coleraine,4821,4,12,8,10,40,38,2,44
Cliftonville,4821,5,12,6,12,44,37,7,42
Glenavon,4821,6,9,13,8,46,51,-5,40
Dungannon,4821,7,8,10,12,42,44,-2,34
Glentoran,4821,8,9,7,14,31,48,-17,34
Ards,4821,9,10,3,17,38,51,-13,33
Portadown,4821,10,9,5,16,27,41,-14,32
Ballinamalla,4821,11,8,5,17,28,50,-22,29
Linfield,4822,1,15,13,2,61,27,34,58
Crusaders,4822,2,15,8,7,49,31,18,53
Cliftonville,4822,3,15,8,7,52,37,15,53
Ballymena,4822,4,14,7,9,57,54,3,49
Dungannon,4822,5,11,10,9,53,40,13,43
Coleraine,4822,6,11,9,10,41,38,3,42
Glenavon,4822,7,9,11,10,50,56,-6,38
Ards,4822,8,9,5,16,38,52,-14,32
Glentoran,4822,9,8,7,15,32,50,-18,31
Portadown,4822,10,5,10,15,22,45,-23,25
Ballinamalla,4822,11,5,8,17,29,54,-25,23
Linfield,4823,1,14,10,6,61,32,29,52
Cliftonville,4823,2,16,3,11,44,33,11,51
Glenavon,4823,3,13,10,7,50,38,12,49
Dungannon,4823,4,12,10,8,56,42,14,46
Ballymena,4823,5,13,7,10,54,56,-2,46
Coleraine,4823,6,11,11,8,47,42,5,44
Crusaders,4823,7,12,6,12,48,40,8,42
Ards,4823,8,10,6,14,47,55,-8,36
Glentoran,4823,9,9,6,15,31,48,-17,33
Ballinamalla,4823,10,9,4,17,28,54,-26,31
Portadown,4823,11,7,5,18,23,49,-26,26
Linfield,4824,1,16,10,4,63,23,40,58
Ballymena,4824,2,15,9,6,65,53,12,54
Crusaders,4824,3,15,8,7,52,37,15,53
Cliftonville,4824,4,15,6,9,53,34,19,51
Glenavon,4824,5,14,7,9,48,42,6,49
Coleraine,4824,6,12,8,10,41,41,0,44
Dungannon,4824,7,9,7,14,44,47,-3,34
Ards,4824,8,8,9,13,38,50,-12,33
Glentoran,4824,9,9,6,15,27,47,-20,33
Ballinamalla,4824,10,6,6,18,32,60,-28,24
Portadown,4824,11,6,4,20,20,49,-29,22
Crusaders,4825,1,18,6,6,62,39,23,60
Linfield,4825,2,16,8,6,65,32,33,56
Cliftonville,4825,3,15,5,10,58,43,15,50
Coleraine,4825,4,13,9,8,40,34,6,48
Ballymena,4825,5,13,7,10,56,53,3,46
Glenavon,4825,6,11,13,6,44,42,2,46
Dungannon,4825,7,8,10,12,54,48,6,34
Glentoran,4825,8,8,9,13,29,47,-18,33
Ballinamalla,4825,9,8,7,15,33,51,-18,31
Ards,4825,10,7,4,19,33,56,-23,25
Portadown,4825,11,5,8,17,22,51,-29,23
Crusaders,4826,1,16,4,10,47,32,15,52
Linfield,4826,2,14,9,7,58,31,27,51
Ballymena,4826,3,13,7,10,65,58,7,46
Cliftonville,4826,4,14,4,12,47,42,5,46
Coleraine,4826,5,11,9,10,41,42,-1,42
Glenavon,4826,6,10,11,9,45,40,5,41
Glentoran,4826,7,10,9,11,30,39,-9,39
Portadown,4826,8,11,5,14,35,46,-11,38
Ballinamalla,4826,9,10,6,14,35,43,-8,36
Dungannon,4826,10,7,11,12,45,58,-13,32
Ards,4826,11,9,5,16,39,56,-17,32
Linfield,4827,1,16,9,5,61,31,30,57
Crusaders,4827,2,16,9,5,50,29,21,57
Glenavon,4827,3,13,13,4,50,37,13,52
Cliftonville,4827,4,14,7,9,53,37,16,49
Coleraine,4827,5,12,11,7,49,43,6,47
Dungannon,4827,6,12,6,12,50,41,9,42
Ballymena,4827,7,12,5,13,54,61,-7,41
Ards,4827,8,10,4,16,38,49,-11,34
Portadown,4827,9,7,8,15,30,45,-15,29
Ballinamalla,4827,10,6,5,19,26,57,-31,23
Glentoran,4827,11,5,7,18,22,53,-31,22
Linfield,4828,1,15,12,3,62,31,31,57
Ballymena,4828,2,15,5,10,59,60,-1,50
Cliftonville,4828,3,15,4,11,51,39,12,49
Glenavon,4828,4,12,12,6,52,42,10,48
Crusaders,4828,5,13,8,9,44,36,8,47
Coleraine,4828,6,12,9,9,53,40,13,45
Dungannon,4828,7,11,9,10,52,46,6,42
Glentoran,4828,8,11,9,10,34,38,-4,42
Ballinamalla,4828,9,9,4,17,31,49,-18,31
Ards,4828,10,5,7,18,35,62,-27,22
Portadown,4828,11,4,7,19,20,50,-30,19
Linfield,4829,1,15,9,6,60,34,26,54
Coleraine,4829,2,14,11,5,45,30,15,53
Crusaders,4829,3,14,10,6,50,33,17,52
Cliftonville,4829,4,14,8,8,50,40,10,50
Ballymena,4829,5,14,7,9,68,60,8,49
Glenavon,4829,6,11,9,10,51,48,3,42
Dungannon,4829,7,7,13,10,49,49,0,34
Glentoran,4829,8,9,6,15,28,50,-22,33
Portadown,4829,9,8,7,15,29,44,-15,31
Ards,4829,10,7,7,16,34,51,-17,28
Ballinamalla,4829,11,7,3,20,31,56,-25,24
Crusaders,4830,1,20,4,6,59,29,30,64
Cliftonville,4830,2,16,5,9,52,32,20,53
Ballymena,4830,3,15,5,10,54,56,-2,50
Coleraine,4830,4,13,9,8,48,33,15,48
Glenavon,4830,5,11,9,10,49,52,-3,42
Linfield,4830,6,10,10,10,50,38,12,40
Dungannon,4830,7,10,9,11,47,49,-2,39
Glentoran,4830,8,10,7,13,27,40,-13,37
Portadown,4830,9,9,3,18,33,50,-17,30
Ards,4830,10,9,3,18,34,54,-20,30
Ballinamalla,4830,11,8,4,18,30,50,-20,28
Glenavon,4831,1,16,9,5,61,36,25,57
Crusaders,4831,2,16,7,7,56,38,18,55
Linfield,4831,3,13,10,7,62,44,18,49
Ballymena,4831,4,14,6,10,59,61,-2,48
Cliftonville,4831,5,14,4,12,52,43,9,46
Coleraine,4831,6,10,11,9,45,41,4,41
Dungannon,4831,7,10,8,12,51,45,6,38
Glentoran,4831,8,9,7,14,23,39,-16,34
Ards,4831,9,9,6,15,34,50,-16,33
Ballinamalla,4831,10,8,6,16,30,44,-14,30
Portadown,4831,11,4,10,16,17,49,-32,22
Crusaders,4832,1,19,8,3,65,35,30,65
Cliftonville,4832,2,16,4,10,63,47,16,52
Ballymena,4832,3,14,7,9,56,55,1,49
Linfield,4832,4,13,9,8,52,42,10,48
Coleraine,4832,5,10,11,9,47,46,1,41
Glentoran,4832,6,11,7,12,39,47,-8,40
Glenavon,4832,7,10,9,11,55,46,9,39
Dungannon,4832,8,8,13,9,55,51,4,37
Ards,4832,9,8,5,17,37,53,-16,29
Portadown,4832,10,8,5,17,26,45,-19,29
Ballinamalla,4832,11,7,4,19,29,57,-28,25
Crusaders,4833,1,17,6,7,52,35,17,57
Linfield,4833,2,16,8,6,65,31,34,56
Coleraine,4833,3,14,8,8,45,34,11,50
Cliftonville,4833,4,15,3,12,52,40,12,48
Glenavon,4833,5,12,11,7,44,41,3,47
Ballymena,4833,6,14,5,11,58,58,0,47
Dungannon,4833,7,11,7,12,43,38,5,40
Ballinamalla,4833,8,11,4,15,38,46,-8,37
Glentoran,4833,9,6,8,16,27,57,-30,26
Ards,4833,10,6,7,17,29,47,-18,25
Portadown,4833,11,6,7,17,25,51,-26,25
Crusaders,4834,1,19,5,6,60,37,23,62
Linfield,4834,2,14,11,5,58,32,26,53
Cliftonville,4834,3,15,4,11,53,33,20,49
Coleraine,4834,4,13,10,7,44,36,8,49
Ballymena,4834,5,13,6,11,58,59,-1,45
Glenavon,4834,6,11,11,8,40,44,-4,44
Ards,4834,7,12,6,12,39,42,-3,42
Dungannon,4834,8,8,8,14,48,46,2,32
Ballinamalla,4834,9,9,3,18,31,54,-23,30
Glentoran,4834,10,7,7,16,28,44,-16,28
Portadown,4834,11,7,3,20,20,52,-32,24
Crusaders,4835,1,17,6,7,52,31,21,57
Linfield,4835,2,14,12,4,63,30,33,54
Dungannon,4835,3,14,8,8,56,42,14,50
Cliftonville,4835,4,15,5,10,47,35,12,50
Glenavon,4835,5,13,10,7,54,45,9,49
Coleraine,4835,6,10,10,10,46,49,-3,40
Ballymena,4835,7,10,6,14,49,68,-19,36
Portadown,4835,8,9,6,15,26,44,-18,33
Glentoran,4835,9,8,7,15,28,42,-14,31
Ards,4835,10,7,7,16,40,56,-16,28
Ballinamalla,4835,11,7,5,18,33,52,-19,26
Linfield,4836,1,16,8,6,58,33,25,56
Crusaders,4836,2,15,7,8,64,35,29,52
Glenavon,4836,3,13,12,5,52,39,13,51
Cliftonville,4836,4,15,6,9,54,44,10,51
Coleraine,4836,5,13,9,8,36,31,5,48
Dungannon,4836,6,10,10,10,58,51,7,40
Glentoran,4836,7,11,6,13,42,54,-12,39
Ballymena,4836,8,10,7,13,51,62,-11,37
Ards,4836,9,9,4,17,38,50,-12,31
Portadown,4836,10,8,5,17,25,42,-17,29
Ballinamalla,4836,11,6,4,20,23,60,-37,22
Crusaders,4837,1,17,7,6,55,38,17,58
Ballymena,4837,2,16,7,7,63,52,11,55
Cliftonville,4837,3,15,4,11,54,43,11,49
Linfield,4837,4,12,9,9,55,40,15,45
Dungannon,4837,5,11,8,11,55,43,12,41
Coleraine,4837,6,8,16,6,43,42,1,40
Glenavon,4837,7,8,14,8,44,44,0,38
Ards,4837,8,10,8,12,44,49,-5,38
Glentoran,4837,9,8,9,13,30,45,-15,33
Portadown,4837,10,7,6,17,24,46,-22,27
Ballinamalla,4837,11,8,2,20,33,58,-25,26
Crusaders,4838,1,17,9,4,63,33,30,60
Linfield,4838,2,15,9,6,58,31,27,54
Cliftonville,4838,3,14,7,9,52,38,14,49
Ballymena,4838,4,14,4,12,61,66,-5,46
Dungannon,4838,5,11,9,10,49,44,5,42
Glenavon,4838,6,8,16,6,46,42,4,40
Coleraine,4838,7,9,12,9,41,43,-2,39
Ballinamalla,4838,8,9,5,16,32,54,-22,32
Ards,4838,9,8,6,16,38,52,-14,30
Glentoran,4838,10,7,8,15,29,47,-18,29
Portadown,4838,11,7,7,16,25,44,-19,28
Glenavon,4839,1,16,8,6,48,37,11,56
Crusaders,4839,2,15,9,6,51,30,21,54
Cliftonville,4839,3,16,6,8,56,36,20,54
Linfield,4839,4,13,11,6,58,36,22,50
Ballymena,4839,5,12,6,12,47,54,-7,42
Coleraine,4839,6,10,11,9,36,38,-2,41
Glentoran,4839,7,10,6,14,32,46,-14,36
Ards,4839,8,8,7,15,41,52,-11,31
Dungannon,4839,9,6,12,12,48,55,-7,30
Portadown,4839,10,7,7,16,30,44,-14,28
Ballinamalla,4839,11,7,7,16,30,49,-19,28
Crusaders,4840,1,16,10,4,62,33,29,58
Linfield,4840,2,15,8,7,64,40,24,53
Cliftonville,4840,3,13,8,9,45,35,10,47
Ballymena,4840,4,13,6,11,64,61,3,45
Dungannon,4840,5,12,8,10,56,45,11,44
Glenavon,4840,6,11,10,9,46,40,6,43
Coleraine,4840,7,9,9,12,36,40,-4,36
Portadown,4840,8,11,3,16,31,49,-18,36
Ballinamalla,4840,9,11,2,17,31,52,-21,35
Ards,4840,10,9,4,17,40,54,-14,31
Glentoran,4840,11,8,6,16,29,55,-26,30
Crusaders,4841,1,17,6,7,59,35,24,57
Linfield,4841,2,15,8,7,61,35,26,53
Dungannon,4841,3,14,8,8,53,35,18,50
Cliftonville,4841,4,14,4,12,56,47,9,46
Ballymena,4841,5,14,4,12,56,60,-4,46
Glenavon,4841,6,10,11,9,45,44,1,41
Coleraine,4841,7,10,11,9,42,42,0,41
Ards,4841,8,11,5,14,39,43,-4,38
Ballinamalla,4841,9,9,6,15,29,52,-23,33
Glentoran,4841,10,8,7,15,31,49,-18,31
Portadown,4841,11,5,6,19,22,51,-29,21
Linfield,4842,1,16,10,4,64,27,37,58
Crusaders,4842,2,17,5,8,68,40,28,56
Cliftonville,4842,3,15,5,10,52,45,7,50
Coleraine,4842,4,11,11,8,43,44,-1,44
Glentoran,4842,5,10,9,11,31,43,-12,39
Glenavon,4842,6,9,11,10,46,48,-2,38
Ballymena,4842,7,11,5,14,47,66,-19,38
Ballinamalla,4842,8,10,6,14,35,44,-9,36
Ards,4842,9,9,7,14,38,55,-17,34
Dungannon,4842,10,7,12,11,44,37,7,33
Portadown,4842,11,6,7,17,27,46,-19,25
Cliftonville,4843,1,17,6,7,64,37,27,57
Linfield,4843,2,15,9,6,59,29,30,54
Dungannon,4843,3,14,9,7,55,37,18,51
Crusaders,4843,4,14,9,7,51,34,17,51
Ballymena,4843,5,12,10,8,56,61,-5,46
Glenavon,4843,6,11,10,9,52,48,4,43
Coleraine,4843,7,10,10,10,42,44,-2,40
Glentoran,4843,8,8,9,13,33,51,-18,33
Ards,4843,9,8,4,18,37,56,-19,28
Portadown,4843,10,7,7,16,25,46,-21,28
Ballinamalla,4843,11,5,5,20,27,58,-31,20
Crusaders,4844,1,17,9,4,62,37,25,60
Linfield,4844,2,13,10,7,61,37,24,49
Glenavon,4844,3,12,10,8,48,45,3,46
Cliftonville,4844,4,14,3,13,60,51,9,45
Coleraine,4844,5,11,9,10,45,39,6,42
Dungannon,4844,6,11,8,11,55,42,13,41
Ballymena,4844,7,11,8,11,54,60,-6,41
Glentoran,4844,8,11,8,11,29,40,-11,41
Ards,4844,9,11,5,14,37,46,-9,38
Portadown,4844,10,6,8,16,25,50,-25,26
Ballinamalla,4844,11,7,4,19,27,56,-29,25
Crusaders,4845,1,17,8,5,62,36,26,59
Cliftonville,4845,2,16,5,9,54,40,14,53
Linfield,4845,3,15,6,9,57,27,30,51
Glenavon,4845,4,12,11,7,47,44,3,47
Ballymena,4845,5,13,6,11,61,58,3,45
Dungannon,4845,6,11,9,10,47,39,8,42
Coleraine,4845,7,9,10,11,42,47,-5,37
Glentoran,4845,8,10,6,14,35,50,-15,36
Ards,4845,9,10,4,16,38,50,-12,34
Ballinamalla,4845,10,9,3,18,33,57,-24,30
Portadown,4845,11,7,4,19,21,49,-28,25
Linfield,4846,1,17,7,6,63,26,37,58
Crusaders,4846,2,15,6,9,49,45,4,51
Cliftonville,4846,3,14,7,9,49,41,8,49
Ballymena,4846,4,12,9,9,59,58,1,45
Glenavon,4846,5,12,8,10,56,53,3,44
Coleraine,4846,6,9,13,8,45,42,3,40
Dungannon,4846,7,9,11,10,40,34,6,38
Glentoran,4846,8,10,6,14,33,46,-13,36
Ballinamalla,4846,9,10,4,16,30,44,-14,34
Ards,4846,10,10,2,18,38,52,-14,32
Portadown,4846,11,7,7,16,23,44,-21,28
Linfield,4847,1,19,8,3,65,28,37,65
Coleraine,4847,2,16,7,7,51,31,20,55
Crusaders,4847,3,15,9,6,47,31,16,54
Cliftonville,4847,4,16,4,10,53,41,12,52
Ballymena,4847,5,14,7,9,57,59,-2,49
Glenavon,4847,6,10,8,12,46,49,-3,38
Dungannon,4847,7,9,7,14,54,53,1,34
Glentoran,4847,8,8,7,15,28,46,-18,31
Ards,4847,9,7,7,16,42,58,-16,28
Ballinamalla,4847,10,7,6,17,30,50,-20,27
Portadown,4847,11,7,4,19,25,52,-27,25
Linfield,4848,1,14,13,3,63,27,36,55
Crusaders,4848,2,14,10,6,54,33,21,52
Cliftonville,4848,3,15,5,10,59,48,11,50
Coleraine,4848,4,11,14,5,50,40,10,47
Glenavon,4848,5,12,11,7,49,44,5,47
Glentoran,4848,6,13,6,11,33,36,-3,45
Ballymena,4848,7,10,8,12,54,65,-11,38
Dungannon,4848,8,7,11,12,44,46,-2,32
Ards,4848,9,9,5,16,38,49,-11,32
Ballinamalla,4848,10,8,3,19,30,54,-24,27
Portadown,4848,11,6,6,18,27,59,-32,24
Cliftonville,4849,1,17,4,9,58,38,20,55
Linfield,4849,2,15,8,7,59,34,25,53
Crusaders,4849,3,15,7,8,47,34,13,52
Ballymena,4849,4,13,8,9,56,56,0,47
Coleraine,4849,5,11,10,9,49,37,12,43
Ballinamalla,4849,6,11,6,13,40,48,-8,39
Ards,4849,7,10,7,13,37,50,-13,37
Glenavon,4849,8,8,11,11,40,46,-6,35
Dungannon,4849,9,8,8,14,41,48,-7,32
Glentoran,4849,10,7,11,12,35,51,-16,32
Portadown,4849,11,7,6,17,28,48,-20,27
Crusaders,4850,1,17,6,7,64,41,23,57
Coleraine,4850,2,16,8,6,49,34,15,56
Linfield,4850,3,14,10,6,60,34,26,52
Ballymena,4850,4,14,7,9,62,57,5,49
Cliftonville,4850,5,15,3,12,50,40,10,48
Dungannon,4850,6,12,8,10,50,42,8,44
Glenavon,4850,7,10,8,12,48,56,-8,38
Glentoran,4850,8,9,7,14,32,48,-16,34
Ards,4850,9,9,3,18,35,50,-15,30
Portadown,4850,10,8,4,18,29,53,-24,28
Ballinamalla,4850,11,7,4,19,25,49,-24,25
Crusaders,4851,1,19,6,5,57,24,33,63
Linfield,4851,2,15,8,7,68,35,33,53
Cliftonville,4851,3,15,4,11,48,40,8,49
Ballymena,4851,4,13,8,9,56,52,4,47
Coleraine,4851,5,12,10,8,43,39,4,46
Dungannon,4851,6,11,9,10,57,45,12,42
Glenavon,4851,7,10,10,10,41,43,-2,40
Glentoran,4851,8,10,5,15,25,47,-22,35
Ards,4851,9,7,6,17,34,52,-18,27
Ballinamalla,4851,10,7,6,17,29,55,-26,27
Portadown,4851,11,7,6,17,28,54,-26,27
Crusaders,4852,1,16,8,6,56,35,21,56
Linfield,4852,2,14,9,7,55,30,25,51
Cliftonville,4852,3,15,4,11,52,39,13,49
Ballymena,4852,4,14,6,10,61,59,2,48
Dungannon,4852,5,13,8,9,51,39,12,47
Coleraine,4852,6,12,10,8,48,36,12,46
Glenavon,4852,7,10,11,9,45,45,0,41
Portadown,4852,8,9,6,15,31,43,-12,33
Ards,4852,9,9,4,17,36,58,-22,31
Glentoran,4852,10,7,7,16,31,52,-21,28
Ballinamalla,4852,11,7,5,18,25,55,-30,26
Crusaders,4853,1,19,5,6,64,38,26,62
Ballymena,4853,2,16,4,10,65,56,9,52
Cliftonville,4853,3,15,4,11,52,39,13,49
Glenavon,4853,4,13,10,7,50,40,10,49
Coleraine,4853,5,11,11,8,40,39,1,44
Glentoran,4853,6,12,5,13,25,38,-13,41
Linfield,4853,7,10,10,10,52,36,16,40
Ballinamalla,4853,8,11,1,18,30,51,-21,34
Dungannon,4853,9,8,8,14,43,43,0,32
Portadown,4853,10,8,6,16,25,44,-19,30
Ards,4853,11,7,6,17,29,51,-22,27
Ballymena,4854,1,16,5,9,57,59,-2,53
Cliftonville,4854,2,16,4,10,54,47,7,52
Linfield,4854,3,13,9,8,53,33,20,48
Crusaders,4854,4,14,6,10,62,44,18,48
Glenavon,4854,5,11,11,8,49,41,8,44
Dungannon,4854,6,10,9,11,48,43,5,39
Coleraine,4854,7,9,10,11,41,45,-4,37
Glentoran,4854,8,9,9,12,34,44,-10,36
Ards,4854,9,9,6,15,37,46,-9,33
Portadown,4854,10,9,6,15,26,42,-16,33
Ballinamalla,4854,11,8,7,15,34,51,-17,31
Ballymena,4855,1,17,6,7,58,52,6,57
Cliftonville,4855,2,16,6,8,53,34,19,54
Crusaders,4855,3,15,9,6,54,37,17,54
Glenavon,4855,4,12,12,6,52,42,10,48
Linfield,4855,5,12,11,7,56,29,27,47
Glentoran,4855,6,10,9,11,37,45,-8,39
Dungannon,4855,7,9,11,10,48,43,5,38
Coleraine,4855,8,8,10,12,36,45,-9,34
Ards,4855,9,8,8,14,35,47,-12,32
Ballinamalla,4855,10,6,6,18,28,57,-29,24
Portadown,4855,11,5,6,19,24,50,-26,21
Cliftonville,4856,1,17,5,8,58,39,19,56
Crusaders,4856,2,14,10,6,56,35,21,52
Ballymena,4856,3,14,8,8,54,51,3,50
Linfield,4856,4,12,7,11,42,30,12,43
Dungannon,4856,5,10,11,9,49,43,6,41
Coleraine,4856,6,11,8,11,45,44,1,41
Glentoran,4856,7,11,8,11,40,42,-2,41
Glenavon,4856,8,10,9,11,43,43,0,39
Ards,4856,9,8,7,15,38,51,-13,31
Ballinamalla,4856,10,8,6,16,28,49,-21,30
Portadown,4856,11,7,7,16,26,52,-26,28
Crusaders,4857,1,17,9,4,59,35,24,60
Linfield,4857,2,16,8,6,66,32,34,56
Cliftonville,4857,3,13,8,9,52,39,13,47
Coleraine,4857,4,11,10,9,49,45,4,43
Glenavon,4857,5,10,13,7,54,51,3,43
Ballymena,4857,6,11,8,11,56,62,-6,41
Dungannon,4857,7,11,7,12,52,47,5,40
Glentoran,4857,8,9,10,11,32,45,-13,37
Ards,4857,9,8,7,15,36,48,-12,31
Ballinamalla,4857,10,6,7,17,29,54,-25,25
Portadown,4857,11,6,7,17,28,55,-27,25
Ballymena,4858,1,17,6,7,69,54,15,57
Cliftonville,4858,2,16,5,9,60,40,20,53
Crusaders,4858,3,15,8,7,55,36,19,53
Linfield,4858,4,14,8,8,54,30,24,50
Glenavon,4858,5,13,10,7,56,47,9,49
Coleraine,4858,6,12,10,8,41,38,3,46
Dungannon,4858,7,11,11,8,50,39,11,44
Glentoran,4858,8,9,8,13,29,45,-16,35
Ards,4858,9,9,4,17,38,51,-13,31
Ballinamalla,4858,10,6,3,21,27,61,-34,21
Portadown,4858,11,4,5,21,13,51,-38,17
Linfield,4859,1,17,8,5,66,28,38,59
Crusaders,4859,2,17,7,6,54,36,18,58
Cliftonville,4859,3,15,5,10,51,35,16,50
Glenavon,4859,4,11,13,6,45,39,6,46
Ballymena,4859,5,14,4,12,59,55,4,46
Coleraine,4859,6,9,12,9,40,47,-7,39
Dungannon,4859,7,9,9,12,48,47,1,36
Ards,4859,8,9,7,14,43,52,-9,34
Glentoran,4859,9,7,10,13,28,47,-19,31
Portadown,4859,10,8,4,18,23,49,-26,28
Ballinamalla,4859,11,7,5,18,31,53,-22,26
Linfield,4860,1,18,7,5,65,28,37,61
Crusaders,4860,2,16,9,5,59,31,28,57
Cliftonville,4860,3,13,8,9,46,35,11,47
Ballymena,4860,4,13,7,10,55,65,-10,46
Coleraine,4860,5,11,10,9,43,40,3,43
Dungannon,4860,6,11,8,11,50,41,9,41
Glentoran,4860,7,10,9,11,32,42,-10,39
Glenavon,4860,8,8,13,9,38,43,-5,37
Ards,4860,9,9,5,16,44,51,-7,32
Portadown,4860,10,6,7,17,25,50,-25,25
Ballinamalla,4860,11,6,5,19,25,56,-31,23
Linfield,4861,1,19,7,4,66,32,34,64
Crusaders,4861,2,16,8,6,56,34,22,56
Ballymena,4861,3,16,6,8,64,50,14,54
Cliftonville,4861,4,13,6,11,49,46,3,45
Coleraine,4861,5,11,9,10,44,39,5,42
Glenavon,4861,6,10,11,9,43,44,-1,41
Ards,4861,7,12,2,16,40,44,-4,38
Glentoran,4861,8,11,4,15,29,42,-13,37
Dungannon,4861,9,9,8,13,46,49,-3,35
Ballinamalla,4861,10,7,5,18,27,54,-27,26
Portadown,4861,11,5,6,19,21,51,-30,21
Linfield,4862,1,15,9,6,57,31,26,54
Crusaders,4862,2,14,11,5,53,37,16,53
Cliftonville,4862,3,15,4,11,54,38,16,49
Coleraine,4862,4,13,9,8,42,42,0,48
Ballymena,4862,5,12,8,10,55,56,-1,44
Glenavon,4862,6,11,9,10,50,41,9,42
Ards,4862,7,10,4,16,39,53,-14,34
Portadown,4862,8,9,7,14,24,39,-15,34
Ballinamalla,4862,9,9,6,15,29,46,-17,33
Dungannon,4862,10,7,11,12,40,45,-5,32
Glentoran,4862,11,7,8,15,28,43,-15,29
Cliftonville,4863,1,17,4,9,61,43,18,55
Linfield,4863,2,15,9,6,58,28,30,54
Crusaders,4863,3,14,8,8,48,34,14,50
Coleraine,4863,4,13,9,8,45,41,4,48
Ballymena,4863,5,13,8,9,55,57,-2,47
Dungannon,4863,6,12,8,10,51,42,9,44
Glenavon,4863,7,9,9,12,42,45,-3,36
Ballinamalla,4863,8,10,5,15,30,48,-18,35
Glentoran,4863,9,8,9,13,30,42,-12,33
Portadown,4863,10,8,7,15,27,44,-17,31
Ards,4863,11,6,4,20,32,55,-23,22
Crusaders,4864,1,19,7,4,66,33,33,64
Linfield,4864,2,15,7,8,53,32,21,52
Cliftonville,4864,3,15,3,12,54,46,8,48
Ballymena,4864,4,13,5,12,59,64,-5,44
Glenavon,4864,5,10,13,7,56,53,3,43
Dungannon,4864,6,10,10,10,55,46,9,40
Coleraine,4864,7,9,12,9,46,44,2,39
Ards,4864,8,10,6,14,37,45,-8,36
Glentoran,4864,9,8,10,12,33,46,-13,34
Ballinamalla,4864,10,8,4,18,32,58,-26,28
Portadown,4864,11,6,7,17,30,54,-24,25
Linfield,4865,1,17,8,5,60,23,37,59
Crusaders,4865,2,16,5,9,57,41,16,53
Glenavon,4865,3,12,11,7,56,47,9,47
Ballymena,4865,4,14,5,11,59,60,-1,47
Cliftonville,4865,5,13,5,12,48,37,11,44
Coleraine,4865,6,11,11,8,43,44,-1,44
Ards,4865,7,12,3,15,43,48,-5,39
Dungannon,4865,8,8,11,11,44,41,3,35
Glentoran,4865,9,9,7,14,30,44,-14,34
Ballinamalla,4865,10,10,3,17,33,55,-22,33
Portadown,4865,11,7,3,20,24,57,-33,24
Linfield,4866,1,16,8,6,64,25,39,56
Glenavon,4866,2,14,9,7,48,39,9,51
Cliftonville,4866,3,15,6,9,45,37,8,51
Ballymena,4866,4,15,6,9,60,55,5,51
Crusaders,4866,5,13,9,8,51,42,9,48
Coleraine,4866,6,11,10,9,39,36,3,43
Glentoran,4866,7,9,9,12,38,43,-5,36
Dungannon,4866,8,9,8,13,47,53,-6,35
Ards,4866,9,8,6,16,35,52,-17,30
Ballinamalla,4866,10,8,5,17,26,48,-22,29
Portadown,4866,11,7,4,19,25,48,-23,25
Linfield,4867,1,16,9,5,61,32,29,57
Crusaders,4867,2,15,9,6,53,31,22,54
Cliftonville,4867,3,17,3,10,58,38,20,54
Glenavon,4867,4,13,9,8,51,44,7,48
Coleraine,4867,5,12,11,7,43,38,5,47
Ballymena,4867,6,14,5,11,58,58,0,47
Glentoran,4867,7,9,8,13,36,50,-14,35
Dungannon,4867,8,8,10,12,50,48,2,34
Ards,4867,9,9,4,17,35,49,-14,31
Portadown,4867,10,7,5,18,25,54,-29,26
Ballinamalla,4867,11,7,3,20,28,56,-28,24
Crusaders,4868,1,17,7,6,62,41,21,58
Cliftonville,4868,2,14,7,9,56,38,18,49
Ballymena,4868,3,14,7,9,60,56,4,49
Glenavon,4868,4,11,13,6,48,46,2,46
Dungannon,4868,5,12,9,9,52,41,11,45
Coleraine,4868,6,10,10,10,42,42,0,40
Linfield,4868,7,9,12,9,55,42,13,39
Glentoran,4868,8,9,8,13,32,44,-12,35
Portadown,4868,9,9,7,14,26,43,-17,34
Ballinamalla,4868,10,7,7,16,34,54,-20,28
Ards,4868,11,7,5,18,35,55,-20,26
Linfield,4869,1,15,10,5,70,34,36,55
Cliftonville,4869,2,15,6,9,48,33,15,51
Crusaders,4869,3,14,9,7,45,35,10,51
Coleraine,4869,4,13,10,7,42,35,7,49
Ballymena,4869,5,12,7,11,51,53,-2,43
Glenavon,4869,6,11,9,10,50,46,4,42
Dungannon,4869,7,10,11,9,43,38,5,41
Glentoran,4869,8,8,11,11,33,45,-12,35
Ballinamalla,4869,9,8,7,15,25,44,-19,31
Ards,4869,10,7,6,17,35,54,-19,27
Portadown,4869,11,6,6,18,27,52,-25,24
Linfield,4870,1,16,10,4,63,24,39,58
Crusaders,4870,2,16,7,7,53,36,17,55
Coleraine,4870,3,12,9,9,43,35,8,45
Cliftonville,4870,4,13,6,11,51,46,5,45
Ballymena,4870,5,12,9,9,56,60,-4,45
Glenavon,4870,6,10,11,9,41,43,-2,41
Dungannon,4870,7,9,11,10,45,40,5,38
Ballinamalla,4870,8,8,8,14,30,47,-17,32
Glentoran,4870,9,8,8,14,28,46,-18,32
Ards,4870,10,8,7,15,37,47,-10,31
Portadown,4870,11,6,8,16,20,43,-23,26
Linfield,4871,1,15,9,6,60,32,28,54
Cliftonville,4871,2,15,5,10,48,40,8,50
Ballymena,4871,3,14,7,9,62,57,5,49
Crusaders,4871,4,13,8,9,52,38,14,47
Coleraine,4871,5,12,10,8,51,41,10,46
Glenavon,4871,6,12,10,8,47,47,0,46
Glentoran,4871,7,12,7,11,35,46,-11,43
Dungannon,4871,8,10,8,12,57,54,3,38
Ballinamalla,4871,9,8,5,17,34,59,-25,29
Ards,4871,10,7,7,16,41,57,-16,28
Portadown,4871,11,6,6,18,27,43,-16,24
Cliftonville,4872,1,17,7,6,64,36,28,58
Crusaders,4872,2,16,9,5,56,31,25,57
Coleraine,4872,3,12,10,8,44,38,6,46
Linfield,4872,4,12,9,9,55,46,9,45
Ballymena,4872,5,12,9,9,56,53,3,45
Dungannon,4872,6,11,8,11,45,39,6,41
Glenavon,4872,7,10,10,10,39,46,-7,40
Ballinamalla,4872,8,11,3,16,36,45,-9,36
Ards,4872,9,10,3,17,40,55,-15,33
Portadown,4872,10,8,5,17,21,41,-20,29
Glentoran,4872,11,6,7,17,19,45,-26,25
Crusaders,4873,1,16,8,6,60,36,24,56
Linfield,4873,2,15,9,6,66,35,31,54
Ballymena,4873,3,16,5,9,59,55,4,53
Cliftonville,4873,4,15,6,9,54,38,16,51
Glenavon,4873,5,9,12,9,44,47,-3,39
Glentoran,4873,6,10,8,12,40,49,-9,38
Coleraine,4873,7,9,10,11,38,43,-5,37
Dungannon,4873,8,8,8,14,48,50,-2,32
Ballinamalla,4873,9,8,8,14,25,43,-18,32
Portadown,4873,10,8,7,15,32,51,-19,31
Ards,4873,11,8,5,17,35,54,-19,29
Crusaders,4874,1,19,5,6,60,37,23,62
Cliftonville,4874,2,15,7,8,56,35,21,52
Glenavon,4874,3,12,13,5,57,45,12,49
Ballymena,4874,4,14,7,9,59,59,0,49
Coleraine,4874,5,11,12,7,39,33,6,45
Linfield,4874,6,11,10,9,53,41,12,43
Dungannon,4874,7,10,9,11,51,45,6,39
Glentoran,4874,8,7,8,15,27,43,-16,29
Ards,4874,9,7,7,16,32,52,-20,28
Ballinamalla,4874,10,7,7,16,30,54,-24,28
Portadown,4874,11,6,7,17,25,45,-20,25
Crusaders,4875,1,17,7,6,51,33,18,58
Linfield,4875,2,15,8,7,57,29,28,53
Coleraine,4875,3,14,11,5,46,31,15,53
Ballymena,4875,4,13,6,11,57,55,2,45
Cliftonville,4875,5,12,6,12,43,44,-1,42
Glenavon,4875,6,9,12,9,42,44,-2,39
Ards,4875,7,10,7,13,47,47,0,37
Dungannon,4875,8,8,10,12,47,49,-2,34
Ballinamalla,4875,9,10,3,17,38,53,-15,33
Glentoran,4875,10,7,9,14,25,50,-25,30
Portadown,4875,11,6,9,15,25,43,-18,27
Linfield,4876,1,16,8,6,59,29,30,56
Crusaders,4876,2,14,9,7,48,30,18,51
Cliftonville,4876,3,15,6,9,51,37,14,51
Dungannon,4876,4,13,9,8,49,39,10,48
Ballymena,4876,5,13,8,9,56,56,0,47
Glenavon,4876,6,9,13,8,50,45,5,40
Coleraine,4876,7,10,10,10,40,42,-2,40
Glentoran,4876,8,8,10,12,31,41,-10,34
Ards,4876,9,8,5,17,34,52,-18,29
Portadown,4876,10,7,6,17,29,52,-23,27
Ballinamalla,4876,11,6,8,16,26,50,-24,26
Linfield,4877,1,16,9,5,58,27,31,57
Coleraine,4877,2,14,10,6,46,31,15,52
Crusaders,4877,3,13,11,6,55,39,16,50
Ballymena,4877,4,15,4,11,60,57,3,49
Glenavon,4877,5,10,13,7,46,42,4,43
Dungannon,4877,6,11,8,11,50,49,1,41
Cliftonville,4877,7,10,7,13,45,43,2,37
Portadown,4877,8,11,4,15,31,41,-10,37
Glentoran,4877,9,9,6,15,29,43,-14,33
Ards,4877,10,8,6,16,34,51,-17,30
Ballinamalla,4877,11,8,2,20,27,58,-31,26
Coleraine,4878,1,14,11,5,51,34,17,53
Crusaders,4878,2,15,7,8,54,37,17,52
Cliftonville,4878,3,14,9,7,59,39,20,51
Dungannon,4878,4,12,9,9,51,40,11,45
Ballymena,4878,5,11,10,9,51,57,-6,43
Linfield,4878,6,11,8,11,61,46,15,41
Glenavon,4878,7,10,10,10,47,48,-1,40
Portadown,4878,8,11,5,14,29,49,-20,38
Ards,4878,9,10,3,17,40,49,-9,33
Glentoran,4878,10,9,4,17,31,48,-17,31
Ballinamalla,4878,11,8,4,18,29,56,-27,28
Crusaders,4879,1,18,8,4,62,31,31,62
Cliftonville,4879,2,18,5,7,55,33,22,59
Linfield,4879,3,15,9,6,63,28,35,54
Ballymena,4879,4,12,9,9,56,59,-3,45
Coleraine,4879,5,11,9,10,39,43,-4,42
Dungannon,4879,6,10,10,10,51,45,6,40
Glenavon,4879,7,10,10,10,44,48,-4,40
Ards,4879,8,10,5,15,38,48,-10,35
Portadown,4879,9,8,3,19,23,44,-21,27
Glentoran,4879,10,6,8,16,28,56,-28,26
Ballinamalla,4879,11,6,6,18,30,54,-24,24
Crusaders,4880,1,17,7,6,66,39,27,58
Cliftonville,4880,2,15,5,10,53,40,13,50
Dungannon,4880,3,13,9,8,66,38,28,48
Linfield,4880,4,13,9,8,54,39,15,48
Glenavon,4880,5,12,11,7,57,48,9,47
Coleraine,4880,6,12,10,8,46,43,3,46
Ballymena,4880,7,12,6,12,52,60,-8,42
Glentoran,4880,8,9,8,13,30,43,-13,35
Ards,4880,9,10,3,17,32,47,-15,33
Ballinamalla,4880,10,6,6,18,27,54,-27,24
Portadown,4880,11,6,6,18,25,57,-32,24
Crusaders,4881,1,18,8,4,66,33,33,62
Glenavon,4881,2,13,12,5,49,38,11,51
Ballymena,4881,3,14,7,9,59,55,4,49
Linfield,4881,4,14,6,10,55,37,18,48
Cliftonville,4881,5,13,5,12,47,43,4,44
Coleraine,4881,6,10,12,8,39,37,2,42
Ballinamalla,4881,7,10,5,15,29,45,-16,35
Glentoran,4881,8,7,9,14,33,51,-18,30
Dungannon,4881,9,5,14,11,46,47,-1,29
Ards,4881,10,7,8,15,38,52,-14,29
Portadown,4881,11,7,8,15,22,45,-23,29
Linfield,4882,1,15,8,7,63,34,29,53
Cliftonville,4882,2,16,5,9,54,35,19,53
Crusaders,4882,3,15,7,8,55,39,16,52
Ballymena,4882,4,15,6,9,60,56,4,51
Coleraine,4882,5,12,9,9,42,37,5,45
Glenavon,4882,6,10,11,9,40,46,-6,41
Ards,4882,7,11,4,15,40,50,-10,37
Dungannon,4882,8,8,9,13,46,42,4,33
Glentoran,4882,9,7,11,12,32,46,-14,32
Ballinamalla,4882,10,8,7,15,24,46,-22,31
Portadown,4882,11,7,5,18,22,47,-25,26
Crusaders,4883,1,17,7,6,62,34,28,58
Linfield,4883,2,17,6,7,65,31,34,57
Cliftonville,4883,3,16,5,9,55,35,20,53
Coleraine,4883,4,14,8,8,43,37,6,50
Ballymena,4883,5,14,3,13,56,60,-4,45
Dungannon,4883,6,11,9,10,50,47,3,42
Glentoran,4883,7,11,6,13,33,38,-5,39
Glenavon,4883,8,8,10,12,41,53,-12,34
Portadown,4883,9,10,4,16,31,50,-19,34
Ards,4883,10,8,3,19,40,65,-25,27
Ballinamalla,4883,11,7,3,20,28,54,-26,24
Crusaders,4884,1,18,8,4,63,36,27,62
Linfield,4884,2,16,8,6,63,32,31,56
Coleraine,4884,3,14,10,6,43,34,9,52
Cliftonville,4884,4,15,5,10,48,38,10,50
Ballymena,4884,5,14,7,9,63,58,5,49
Ards,4884,6,12,4,14,37,43,-6,40
Glenavon,4884,7,9,11,10,42,46,-4,38
Dungannon,4884,8,9,8,13,47,50,-3,35
Ballinamalla,4884,9,8,6,16,31,47,-16,30
Portadown,4884,10,6,6,18,25,47,-22,24
Glentoran,4884,11,5,5,20,24,55,-31,20
Ballymena,4885,1,17,7,6,62,48,14,58
Linfield,4885,2,14,11,5,56,33,23,53
Crusaders,4885,3,15,8,7,53,33,20,53
Cliftonville,4885,4,14,4,12,47,42,5,46
Glenavon,4885,5,11,12,7,49,44,5,45
Coleraine,4885,6,11,11,8,47,34,13,44
Dungannon,4885,7,11,9,10,54,43,11,42
Ards,4885,8,8,6,16,36,48,-12,30
Portadown,4885,9,7,7,16,24,48,-24,28
Ballinamalla,4885,10,6,8,16,25,51,-26,26
Glentoran,4885,11,6,7,17,27,56,-29,25
Linfield,4886,1,16,10,4,62,33,29,58
Crusaders,4886,2,16,8,6,49,31,18,56
Cliftonville,4886,3,16,3,11,53,39,14,51
Coleraine,4886,4,13,9,8,42,34,8,48
Glenavon,4886,5,11,10,9,45,43,2,43
Dungannon,4886,6,9,10,11,58,51,7,37
Ballinamalla,4886,7,11,3,16,32,47,-15,36
Ards,4886,8,10,4,16,37,50,-13,34
Ballymena,4886,9,9,6,15,50,64,-14,33
Glentoran,4886,10,9,6,15,30,47,-17,33
Portadown,4886,11,7,7,16,29,48,-19,28
Crusaders,4887,1,16,7,7,57,38,19,55
Linfield,4887,2,14,9,7,56,33,23,51
Cliftonville,4887,3,16,3,11,61,39,22,51
Ballymena,4887,4,15,6,9,56,54,2,51
Glenavon,4887,5,10,14,6,49,41,8,44
Dungannon,4887,6,10,11,9,51,43,8,41
Coleraine,4887,7,10,10,10,38,40,-2,40
Ards,4887,8,9,7,14,37,47,-10,34
Ballinamalla,4887,9,8,7,15,41,57,-16,31
Portadown,4887,10,7,6,17,25,46,-21,27
Glentoran,4887,11,5,10,15,28,61,-33,25
Linfield,4888,1,16,9,5,57,29,28,57
Cliftonville,4888,2,17,5,8,52,36,16,56
Crusaders,4888,3,14,9,7,52,38,14,51
Coleraine,4888,4,12,11,7,42,37,5,47
Glenavon,4888,5,11,11,8,52,46,6,44
Ballymena,4888,6,11,10,9,57,60,-3,43
Ards,4888,7,12,4,14,42,43,-1,40
Dungannon,4888,8,9,8,13,46,45,1,35
Glentoran,4888,9,7,8,15,29,45,-16,29
Portadown,4888,10,8,5,17,21,41,-20,29
Ballinamalla,4888,11,5,6,19,22,52,-30,21
Crusaders,4889,1,17,5,8,53,38,15,56
Cliftonville,4889,2,16,6,8,60,41,19,54
Linfield,4889,3,14,8,8,58,30,28,50
Dungannon,4889,4,14,7,9,54,37,17,49
Coleraine,4889,5,11,11,8,43,40,3,44
Glenavon,4889,6,12,8,10,50,50,0,44
Ballymena,4889,7,12,7,11,59,63,-4,43
Glentoran,4889,8,10,8,12,34,43,-9,38
Ards,4889,9,10,4,16,38,53,-15,34
Portadown,4889,10,6,6,18,26,50,-24,24
Ballinamalla,4889,11,6,4,20,31,61,-30,22
Crusaders,4890,1,18,8,4,58,29,29,62
Cliftonville,4890,2,15,7,8,50,34,16,52
Linfield,4890,3,13,10,7,53,35,18,49
Ballymena,4890,4,14,5,11,57,60,-3,47
Glenavon,4890,5,11,11,8,47,40,7,44
Coleraine,4890,6,10,13,7,38,33,5,43
Ards,4890,7,11,5,14,35,46,-11,38
Dungannon,4890,8,9,9,12,43,46,-3,36
Ballinamalla,4890,9,9,4,17,31,45,-14,31
Glentoran,4890,10,7,8,15,32,47,-15,29
Portadown,4890,11,6,4,20,23,52,-29,22
Crusaders,4891,1,18,8,4,54,24,30,62
Ballymena,4891,2,19,4,7,63,53,10,61
Linfield,4891,3,15,8,7,60,37,23,53
Coleraine,4891,4,15,7,8,53,36,17,52
Cliftonville,4891,5,14,4,12,47,38,9,46
Dungannon,4891,6,11,7,12,50,43,7,40
Glenavon,4891,7,10,8,12,48,51,-3,38
Glentoran,4891,8,10,5,15,30,42,-12,35
Ballinamalla,4891,9,9,4,17,30,53,-23,31
Ards,4891,10,6,5,19,33,57,-24,23
Portadown,4891,11,6,4,20,20,54,-34,22
Linfield,4892,1,18,7,5,61,29,32,61
Crusaders,4892,2,16,9,5,56,35,21,57
Cliftonville,4892,3,15,7,8,46,34,12,52
Glenavon,4892,4,13,11,6,55,44,11,50
Coleraine,4892,5,13,10,7,36,27,9,49
Ballymena,4892,6,13,6,11,59,59,0,45
Dungannon,4892,7,8,13,9,45,39,6,37
Ballinamalla,4892,8,7,7,16,30,49,-19,28
Portadown,4892,9,7,5,18,22,46,-24,26
Glentoran,4892,10,6,6,18,23,50,-27,24
Ards,4892,11,6,5,19,32,53,-21,23
Cliftonville,4893,1,16,5,9,56,39,17,53
Ballymena,4893,2,15,8,7,67,57,10,53
Crusaders,4893,3,15,7,8,58,36,22,52
Linfield,4893,4,14,7,9,55,32,23,49
Glenavon,4893,5,12,11,7,47,43,4,47
Coleraine,4893,6,11,10,9,41,38,3,43
Dungannon,4893,7,10,9,11,48,42,6,39
Ards,4893,8,11,5,14,42,48,-6,38
Glentoran,4893,9,8,6,16,37,56,-19,30
Portadown,4893,10,8,3,19,27,58,-31,27
Ballinamalla,4893,11,5,9,16,22,51,-29,24
Crusaders,4894,1,18,10,2,60,27,33,64
Ballymena,4894,2,15,7,8,63,59,4,52
Glenavon,4894,3,14,9,7,58,47,11,51
Cliftonville,4894,4,15,4,11,46,40,6,49
Coleraine,4894,5,11,9,10,45,39,6,42
Dungannon,4894,6,11,7,12,49,47,2,40
Linfield,4894,7,10,9,11,49,41,8,39
Glentoran,4894,8,9,7,14,35,46,-11,34
Ards,4894,9,8,6,16,40,54,-14,30
Portadown,4894,10,8,5,17,24,45,-21,29
Ballinamalla,4894,11,8,3,19,30,54,-24,27
Crusaders,4895,1,21,5,4,64,31,33,68
Cliftonville,4895,2,15,7,8,56,34,22,52
Linfield,4895,3,13,10,7,54,30,24,49
Ballymena,4895,4,13,7,10,48,53,-5,46
Coleraine,4895,5,10,11,9,39,37,2,41
Glenavon,4895,6,10,11,9,43,49,-6,41
Dungannon,4895,7,9,11,10,43,39,4,38
Ards,4895,8,10,5,15,39,45,-6,35
Glentoran,4895,9,9,4,17,26,47,-21,31
Portadown,4895,10,7,7,16,25,44,-19,28
Ballinamalla,4895,11,7,4,19,24,52,-28,25
Cliftonville,4896,1,17,6,7,57,35,22,57
Crusaders,4896,2,15,9,6,52,33,19,54
Linfield,4896,3,14,10,6,53,32,21,52
Ballymena,4896,4,13,6,11,58,56,2,45
Glenavon,4896,5,9,13,8,46,49,-3,40
Coleraine,4896,6,10,10,10,38,41,-3,40
Glentoran,4896,7,10,9,11,28,38,-10,39
Dungannon,4896,8,8,14,8,54,45,9,38
Ards,4896,9,7,8,15,34,47,-13,29
Ballinamalla,4896,10,7,6,17,29,52,-23,27
Portadown,4896,11,6,7,17,20,41,-21,25
Crusaders,4897,1,17,9,4,54,28,26,60
Cliftonville,4897,2,15,4,11,46,43,3,49
Linfield,4897,3,13,9,8,51,33,18,48
Glenavon,4897,4,13,8,9,49,46,3,47
Ballymena,4897,5,13,7,10,60,58,2,46
Coleraine,4897,6,9,14,7,40,36,4,41
Ards,4897,7,12,4,14,45,49,-4,40
Portadown,4897,8,10,5,15,29,42,-13,35
Dungannon,4897,9,8,7,15,45,50,-5,31
Glentoran,4897,10,8,6,16,28,42,-14,30
Ballinamalla,4897,11,7,7,16,30,50,-20,28
Crusaders,4898,1,19,8,3,64,28,36,65
Linfield,4898,2,17,8,5,63,28,35,59
Cliftonville,4898,3,15,5,10,50,40,10,50
Coleraine,4898,4,13,10,7,50,37,13,49
Ballymena,4898,5,11,8,11,49,56,-7,41
Glenavon,4898,6,10,10,10,45,54,-9,40
Dungannon,4898,7,7,13,10,52,52,0,34
Ards,4898,8,10,4,16,37,49,-12,34
Ballinamalla,4898,9,8,5,17,34,52,-18,29
Glentoran,4898,10,6,11,13,29,52,-23,29
Portadown,4898,11,6,4,20,20,45,-25,22
Crusaders,4899,1,17,7,6,58,33,25,58
Cliftonville,4899,2,17,5,8,53,36,17,56
Ballymena,4899,3,15,5,10,52,53,-1,50
Linfield,4899,4,12,10,8,49,30,19,46
Glentoran,4899,5,12,9,9,32,33,-1,45
Coleraine,4899,6,10,9,11,36,39,-3,39
Glenavon,4899,7,9,11,10,41,42,-1,38
Dungannon,4899,8,9,9,12,47,42,5,36
Ards,4899,9,8,8,14,35,47,-12,32
Ballinamalla,4899,10,7,8,15,29,50,-21,29
Portadown,4899,11,3,11,16,15,42,-27,20
Cliftonville,4900,1,18,4,8,57,35,22,58
Crusaders,4900,2,17,6,7,55,30,25,57
Linfield,4900,3,13,9,8,49,32,17,48
Ballymena,4900,4,14,5,11,53,56,-3,47
Ards,4900,5,12,4,14,40,41,-1,40
Coleraine,4900,6,9,11,10,34,36,-2,38
Dungannon,4900,7,8,11,11,49,42,7,35
Glenavon,4900,8,8,11,11,38,50,-12,35
Ballinamalla,4900,9,10,5,15,34,52,-18,35
Portadown,4900,10,9,5,16,26,46,-20,32
Glentoran,4900,11,8,7,15,34,49,-15,31
Crusaders,4901,1,18,8,4,62,31,31,62
Ballymena,4901,2,16,4,10,60,52,8,52
Cliftonville,4901,3,14,6,10,51,42,9,48
Glenavon,4901,4,12,10,8,46,40,6,46
Linfield,4901,5,10,14,6,48,32,16,44
Coleraine,4901,6,9,12,9,44,43,1,39
Dungannon,4901,7,10,8,12,48,44,4,38
Glentoran,4901,8,9,10,11,29,40,-11,37
Ards,4901,9,8,6,16,35,46,-11,30
Portadown,4901,10,8,5,17,26,46,-20,29
Ballinamalla,4901,11,7,5,18,25,58,-33,26
Cliftonville,4902,1,18,4,8,62,37,25,58
Crusaders,4902,2,15,8,7,53,33,20,53
Coleraine,4902,3,13,10,7,42,37,5,49
Linfield,4902,4,13,8,9,55,32,23,47
Ballymena,4902,5,13,7,10,53,60,-7,46
Glenavon,4902,6,10,12,8,49,47,2,42
Dungannon,4902,7,8,11,11,43,44,-1,35
Glentoran,4902,8,8,11,11,28,39,-11,35
Portadown,4902,9,9,6,15,31,47,-16,33
Ballinamalla,4902,10,8,5,17,32,52,-20,29
Ards,4902,11,7,4,19,35,55,-20,25
Cliftonville,4903,1,18,4,8,62,33,29,58
Linfield,4903,2,15,8,7,58,35,23,53
Crusaders,4903,3,15,8,7,49,37,12,53
Ballymena,4903,4,15,6,9,64,60,4,51
Coleraine,4903,5,13,8,9,44,44,0,47
Glentoran,4903,6,12,8,10,34,36,-2,44
Glenavon,4903,7,10,10,10,47,46,1,40
Dungannon,4903,8,9,8,13,48,46,2,35
Ards,4903,9,10,4,16,35,47,-12,34
Ballinamalla,4903,10,7,4,19,24,48,-24,25
Portadown,4903,11,4,6,20,20,53,-33,18
Crusaders,4904,1,16,10,4,50,24,26,58
Linfield,4904,2,16,9,5,59,23,36,57
Cliftonville,4904,3,14,7,9,46,35,11,49
Ballymena,4904,4,13,7,10,55,57,-2,46
Coleraine,4904,5,12,10,8,37,39,-2,46
Glenavon,4904,6,10,13,7,45,43,2,43
Portadown,4904,7,9,7,14,31,43,-12,34
Glentoran,4904,8,7,11,12,28,43,-15,32
Ballinamalla,4904,9,10,2,18,32,49,-17,32
Dungannon,4904,10,7,8,15,42,51,-9,29
Ards,4904,11,6,6,18,36,54,-18,24
Linfield,4905,1,18,6,6,61,30,31,60
Cliftonville,4905,2,18,5,7,63,35,28,59
Ballymena,4905,3,15,5,10,53,59,-6,50
Crusaders,4905,4,13,10,7,51,36,15,49
Glenavon,4905,5,12,9,9,48,46,2,45
Glentoran,4905,6,9,7,14,23,42,-19,34
Ards,4905,7,9,6,15,35,47,-12,33
Dungannon,4905,8,7,11,12,49,51,-2,32
Coleraine,4905,9,7,11,12,41,46,-5,32
Portadown,4905,10,9,5,16,34,42,-8,32
Ballinamalla,4905,11,8,5,17,32,56,-24,29
Crusaders,4906,1,15,9,6,56,33,23,54
Cliftonville,4906,2,15,7,8,49,34,15,52
Linfield,4906,3,14,7,9,54,33,21,49
Coleraine,4906,4,13,10,7,41,31,10,49
Glenavon,4906,5,13,10,7,45,43,2,49
Ballymena,4906,6,12,7,11,53,54,-1,43
Dungannon,4906,7,10,8,12,53,47,6,38
Glentoran,4906,8,9,6,15,31,45,-14,33
Ballinamalla,4906,9,10,2,18,28,51,-23,32
Ards,4906,10,9,4,17,35,50,-15,31
Portadown,4906,11,8,4,18,25,49,-24,28
Cliftonville,4907,1,17,4,9,52,32,20,55
Linfield,4907,2,14,10,6,59,34,25,52
Ballymena,4907,3,16,4,10,61,51,10,52
Glenavon,4907,4,13,11,6,50,41,9,50
Crusaders,4907,5,14,6,10,55,46,9,48
Coleraine,4907,6,11,9,10,39,38,1,42
Ards,4907,7,11,5,14,39,49,-10,38
Glentoran,4907,8,8,10,12,27,39,-12,34
Ballinamalla,4907,9,9,5,16,35,49,-14,32
Dungannon,4907,10,8,7,15,45,50,-5,31
Portadown,4907,11,6,5,19,20,53,-33,23
Crusaders,4908,1,18,7,5,56,29,27,61
Linfield,4908,2,16,7,7,59,30,29,55
Cliftonville,4908,3,15,6,9,49,38,11,51
Ballymena,4908,4,13,6,11,55,61,-6,45
Coleraine,4908,5,11,8,11,44,47,-3,41
Glenavon,4908,6,11,7,12,48,53,-5,40
Dungannon,4908,7,10,9,11,53,48,5,39
Glentoran,4908,8,9,9,12,29,38,-9,36
Ballinamalla,4908,9,8,8,14,27,42,-15,32
Portadown,4908,10,8,5,17,31,52,-21,29
Ards,4908,11,7,6,17,37,50,-13,27
Linfield,4909,1,19,7,4,60,24,36,64
Crusaders,4909,2,19,6,5,63,31,32,63
Cliftonville,4909,3,15,4,11,48,37,11,49
Dungannon,4909,4,12,9,9,57,47,10,45
Coleraine,4909,5,11,10,9,40,34,6,43
Ballymena,4909,6,9,11,10,51,64,-13,38
Glenavon,4909,7,8,11,11,55,62,-7,35
Ards,4909,8,10,4,16,38,47,-9,34
Glentoran,4909,9,7,8,15,25,45,-20,29
Ballinamalla,4909,10,8,4,18,30,55,-25,28
Portadown,4909,11,6,8,16,25,46,-21,26
Crusaders,4910,1,17,9,4,55,29,26,60
Ballymena,4910,2,14,9,7,57,53,4,51
Linfield,4910,3,12,12,6,52,26,26,48
Coleraine,4910,4,11,13,6,43,39,4,46
Glenavon,4910,5,12,10,8,49,49,0,46
Cliftonville,4910,6,13,6,11,47,41,6,45
Dungannon,4910,7,10,9,11,56,44,12,39
Glentoran,4910,8,7,10,13,28,40,-12,31
Portadown,4910,9,8,6,16,31,48,-17,30
Ballinamalla,4910,10,7,7,16,31,54,-23,28
Ards,4910,11,6,5,19,32,58,-26,23
Crusaders,4911,1,21,6,3,65,31,34,69
Glenavon,4911,2,15,10,5,59,43,16,55
Linfield,4911,3,15,9,6,60,33,27,54
Cliftonville,4911,4,13,7,10,54,42,12,46
Dungannon,4911,5,10,11,9,54,43,11,41
Ballymena,4911,6,11,6,13,50,63,-13,39
Coleraine,4911,7,8,12,10,33,41,-8,36
Glentoran,4911,8,9,7,14,34,43,-9,34
Ards,4911,9,8,7,15,32,45,-13,31
Ballinamalla,4911,10,8,3,19,26,52,-26,27
Portadown,4911,11,6,4,20,21,52,-31,22
Crusaders,4912,1,17,9,4,56,28,28,60
Cliftonville,4912,2,17,4,9,51,33,18,55
Coleraine,4912,3,13,10,7,42,34,8,49
Linfield,4912,4,12,11,7,60,40,20,47
Glenavon,4912,5,12,9,9,47,43,4,45
Ballymena,4912,6,13,4,13,60,63,-3,43
Dungannon,4912,7,10,12,8,48,35,13,42
Glentoran,4912,8,8,7,15,32,49,-17,31
Portadown,4912,9,5,12,13,16,38,-22,27
Ards,4912,10,6,8,16,29,52,-23,26
Ballinamalla,4912,11,7,4,19,24,50,-26,25
Cliftonville,4913,1,17,4,9,57,41,16,55
Linfield,4913,2,14,9,7,58,33,25,51
Crusaders,4913,3,15,6,9,54,41,13,51
Ballymena,4913,4,15,6,9,58,54,4,51
Dungannon,4913,5,12,11,7,52,37,15,47
Coleraine,4913,6,11,10,9,42,36,6,43
Glenavon,4913,7,11,8,11,46,50,-4,41
Glentoran,4913,8,11,5,14,35,47,-12,38
Ards,4913,9,7,8,15,32,46,-14,29
Portadown,4913,10,7,5,18,24,48,-24,26
Ballinamalla,4913,11,8,2,20,33,58,-25,26
Linfield,4914,1,17,8,5,63,28,35,59
Crusaders,4914,2,17,7,6,55,34,21,58
Cliftonville,4914,3,17,2,11,64,44,20,53
Coleraine,4914,4,11,10,9,44,39,5,43
Glenavon,4914,5,11,10,9,51,52,-1,43
Glentoran,4914,6,12,5,13,40,46,-6,41
Ballymena,4914,7,12,3,15,58,69,-11,39
Dungannon,4914,8,10,8,12,44,45,-1,38
Ards,4914,9,10,7,13,37,49,-12,37
Ballinamalla,4914,10,8,3,19,25,52,-27,27
Portadown,4914,11,6,5,19,28,51,-23,23
Linfield,4915,1,16,8,6,66,32,34,56
Crusaders,4915,2,16,7,7,57,38,19,55
Cliftonville,4915,3,16,6,8,61,37,24,54
Ballymena,4915,4,15,4,11,60,63,-3,49
Coleraine,4915,5,10,10,10,38,39,-1,40
Glenavon,4915,6,8,14,8,42,45,-3,38
Glentoran,4915,7,11,5,14,38,48,-10,38
Ards,4915,8,11,4,15,43,54,-11,37
Portadown,4915,9,10,4,16,28,45,-17,34
Ballinamalla,4915,10,7,6,17,32,55,-23,27
Dungannon,4915,11,4,14,12,41,50,-9,26
Crusaders,4916,1,17,8,5,57,38,19,59
Glenavon,4916,2,15,10,5,51,40,11,55
Linfield,4916,3,14,11,5,55,27,28,53
Cliftonville,4916,4,15,6,9,54,36,18,51
Ballymena,4916,5,13,6,11,61,62,-1,45
Dungannon,4916,6,10,9,11,50,42,8,39
Coleraine,4916,7,9,11,10,42,44,-2,38
Ards,4916,8,10,5,15,41,44,-3,35
Glentoran,4916,9,9,6,15,31,51,-20,33
Ballinamalla,4916,10,7,5,18,29,53,-24,26
Portadown,4916,11,5,5,20,24,58,-34,20
Crusaders,4917,1,17,9,4,59,32,27,60
Linfield,4917,2,17,6,7,61,30,31,57
Cliftonville,4917,3,17,4,9,50,31,19,55
Glenavon,4917,4,12,9,9,48,48,0,45
Ballymena,4917,5,12,6,12,58,61,-3,42
Glentoran,4917,6,11,8,11,30,38,-8,41
Dungannon,4917,7,10,10,10,51,40,11,40
Coleraine,4917,8,9,13,8,36,35,1,40
Ards,4917,9,8,6,16,33,55,-22,30
Ballinamalla,4917,10,7,3,20,25,53,-28,24
Portadown,4917,11,5,6,19,21,49,-28,21
Crusaders,4918,1,15,9,6,54,34,20,54
Cliftonville,4918,2,15,5,10,50,38,12,50
Coleraine,4918,3,12,12,6,45,36,9,48
Glenavon,4918,4,13,8,9,50,45,5,47
Linfield,4918,5,11,12,7,56,37,19,45
Ballymena,4918,6,12,6,12,54,64,-10,42
Portadown,4918,7,12,3,15,29,41,-12,39
Dungannon,4918,8,9,10,11,49,46,3,37
Glentoran,4918,9,10,6,14,32,46,-14,36
Ards,4918,10,7,7,16,34,46,-12,28
Ballinamalla,4918,11,7,6,17,31,51,-20,27
Cliftonville,4919,1,18,3,9,49,34,15,57
Crusaders,4919,2,17,5,8,53,33,20,56
Linfield,4919,3,15,9,6,60,30,30,54
Ballymena,4919,4,15,6,9,64,60,4,51
Coleraine,4919,5,13,10,7,47,34,13,49
Dungannon,4919,6,11,8,11,53,48,5,41
Glenavon,4919,7,10,9,11,43,47,-4,39
Ballinamalla,4919,8,9,6,15,38,55,-17,33
Portadown,4919,9,7,6,17,25,47,-22,27
Glentoran,4919,10,6,8,16,30,52,-22,26
Ards,4919,11,6,6,18,34,56,-22,24
Crusaders,4920,1,16,7,7,55,40,15,55
Cliftonville,4920,2,16,4,10,53,39,14,52
Linfield,4920,3,14,8,8,60,33,27,50
Glenavon,4920,4,13,10,7,49,38,11,49
Coleraine,4920,5,12,11,7,46,34,12,47
Dungannon,4920,6,11,10,9,54,41,13,43
Ballymena,4920,7,11,6,13,53,70,-17,39
Ards,4920,8,8,7,15,38,54,-16,31
Portadown,4920,9,9,4,17,29,49,-20,31
Ballinamalla,4920,10,9,3,18,33,53,-20,30
Glentoran,4920,11,6,10,14,24,43,-19,28
Crusaders,4921,1,16,11,3,57,33,24,59
Linfield,4921,2,13,9,8,64,43,21,48
Cliftonville,4921,3,13,8,9,53,40,13,47
Coleraine,4921,4,11,12,7,47,41,6,45
Ballymena,4921,5,10,11,9,55,59,-4,41
Glenavon,4921,6,9,11,10,41,43,-2,38
Glentoran,4921,7,9,10,11,34,42,-8,37
Ards,4921,8,10,5,15,41,54,-13,35
Dungannon,4921,9,7,13,10,48,44,4,34
Portadown,4921,10,7,10,13,24,39,-15,31
Ballinamalla,4921,11,6,8,16,30,56,-26,26
Crusaders,4922,1,17,7,6,64,34,30,58
Ballymena,4922,2,16,4,10,62,62,0,52
Linfield,4922,3,14,9,7,58,38,20,51
Cliftonville,4922,4,16,3,11,59,46,13,51
Glenavon,4922,5,12,11,7,49,43,6,47
Coleraine,4922,6,12,7,11,43,39,4,43
Dungannon,4922,7,10,9,11,47,41,6,39
Glentoran,4922,8,8,9,13,33,47,-14,33
Portadown,4922,9,9,4,17,31,51,-20,31
Ballinamalla,4922,10,9,4,17,27,53,-26,31
Ards,4922,11,7,3,20,37,56,-19,24
Crusaders,4923,1,17,7,6,61,35,26,58
Coleraine,4923,2,14,9,7,45,31,14,51
Ballymena,4923,3,14,8,8,55,55,0,50
Cliftonville,4923,4,14,5,11,51,41,10,47
Linfield,4923,5,11,12,7,53,38,15,45
Dungannon,4923,6,11,11,8,59,44,15,44
Glenavon,4923,7,10,9,11,39,45,-6,39
Glentoran,4923,8,10,8,12,33,42,-9,38
Ballinamalla,4923,9,10,1,19,29,53,-24,31
Ards,4923,10,9,3,18,33,51,-18,30
Portadown,4923,11,5,7,18,24,47,-23,22
Linfield,4924,1,16,9,5,63,32,31,57
Crusaders,4924,2,16,8,6,57,29,28,56
Glenavon,4924,3,13,10,7,50,39,11,49
Ballymena,4924,4,14,7,9,58,53,5,49
Cliftonville,4924,5,13,8,9,48,37,11,47
Coleraine,4924,6,11,11,8,39,37,2,44
Dungannon,4924,7,10,9,11,46,44,2,39
Ballinamalla,4924,8,10,3,17,28,54,-26,33
Portadown,4924,9,7,7,16,27,47,-20,28
Glentoran,4924,10,6,9,15,29,45,-16,27
Ards,4924,11,7,3,20,31,59,-28,24
Crusaders,4925,1,17,8,5,55,36,19,59
Linfield,4925,2,16,10,4,64,25,39,58
Glenavon,4925,3,12,14,4,50,31,19,50
Cliftonville,4925,4,14,4,12,46,47,-1,46
Coleraine,4925,5,9,11,10,37,40,-3,38
Ballymena,4925,6,11,5,14,58,63,-5,38
Glentoran,4925,7,9,10,11,32,44,-12,37
Dungannon,4925,8,8,11,11,49,48,1,35
Ards,4925,9,8,8,14,33,46,-13,32
Portadown,4925,10,7,9,14,32,51,-19,30
Ballinamalla,4925,11,6,6,18,24,49,-25,24
Crusaders,4926,1,16,10,4,59,32,27,58
Linfield,4926,2,13,11,6,55,34,21,50
Ballymena,4926,3,13,6,11,58,57,1,45
Glenavon,4926,4,12,9,9,50,49,1,45
Cliftonville,4926,5,12,8,10,45,40,5,44
Glentoran,4926,6,11,9,10,35,39,-4,42
Dungannon,4926,7,11,8,11,53,47,6,41
Coleraine,4926,8,9,12,9,36,38,-2,39
Ards,4926,9,9,7,14,40,53,-13,34
Ballinamalla,4926,10,7,5,18,26,49,-23,26
Portadown,4926,11,6,7,17,25,44,-19,25
Crusaders,4927,1,21,6,3,61,27,34,69
Linfield,4927,2,14,9,7,59,35,24,51
Ballymena,4927,3,15,4,11,62,59,3,49
Dungannon,4927,4,12,7,11,53,50,3,43
Cliftonville,4927,5,12,6,12,50,46,4,42
Glenavon,4927,6,10,11,9,46,44,2,41
Ards,4927,7,12,3,15,39,47,-8,39
Glentoran,4927,8,10,8,12,33,39,-6,38
Coleraine,4927,9,8,12,10,29,35,-6,36
Portadown,4927,10,9,2,19,22,51,-29,29
Ballinamalla,4927,11,7,2,21,30,51,-21,23
Crusaders,4928,1,17,7,6,59,33,26,58
Cliftonville,4928,2,17,4,9,49,32,17,55
Linfield,4928,3,15,9,6,58,34,24,54
Coleraine,4928,4,13,11,6,44,32,12,50
Glenavon,4928,5,12,12,6,51,41,10,48
Ballymena,4928,6,14,5,11,63,57,6,47
Dungannon,4928,7,8,10,12,48,46,2,34
Glentoran,4928,8,8,8,14,28,51,-23,32
Ballinamalla,4928,9,8,4,18,28,53,-25,28
Ards,4928,10,6,7,17,35,56,-21,25
Portadown,4928,11,7,3,20,24,52,-28,24
Linfield,4929,1,16,10,4,68,35,33,58
Cliftonville,4929,2,16,5,9,58,40,18,53
Crusaders,4929,3,14,10,6,56,38,18,52
Ballymena,4929,4,12,9,9,64,66,-2,45
Dungannon,4929,5,10,11,9,55,47,8,41
Coleraine,4929,6,9,13,8,44,44,0,40
Glenavon,4929,7,10,9,11,49,48,1,39
Glentoran,4929,8,10,8,12,30,41,-11,38
Ballinamalla,4929,9,8,6,16,31,49,-18,30
Portadown,4929,10,7,6,17,32,55,-23,27
Ards,4929,11,5,9,16,29,53,-24,24
Crusaders,4930,1,18,7,5,57,30,27,61
Cliftonville,4930,2,15,4,11,50,39,11,49
Linfield,4930,3,13,9,8,57,34,23,48
Ballymena,4930,4,14,6,10,54,54,0,48
Coleraine,4930,5,12,11,7,43,33,10,47
Glenavon,4930,6,12,8,10,50,50,0,44
Dungannon,4930,7,10,9,11,46,45,1,39
Glentoran,4930,8,10,6,14,32,48,-16,36
Ards,4930,9,9,6,15,40,50,-10,33
Ballinamalla,4930,10,7,5,18,30,47,-17,26
Portadown,4930,11,7,5,18,28,57,-29,26
Crusaders,4931,1,16,8,6,56,42,14,56
Linfield,4931,2,14,9,7,59,33,26,51
Glenavon,4931,3,14,8,8,54,43,11,50
Ballymena,4931,4,14,7,9,66,63,3,49
Dungannon,4931,5,13,7,10,48,44,4,46
Coleraine,4931,6,11,12,7,44,37,7,45
Ards,4931,7,12,5,13,47,48,-1,41
Cliftonville,4931,8,12,4,14,47,44,3,40
Glentoran,4931,9,10,6,14,35,48,-13,36
Portadown,4931,10,6,5,19,26,53,-27,23
Ballinamalla,4931,11,6,3,21,23,50,-27,21
Cliftonville,4932,1,15,4,11,52,39,13,49
Crusaders,4932,2,13,9,8,54,43,11,48
Linfield,4932,3,13,8,9,58,39,19,47
Ballymena,4932,4,14,5,11,57,59,-2,47
Ards,4932,5,12,7,11,41,42,-1,43
Glenavon,4932,6,9,14,7,47,51,-4,41
Glentoran,4932,7,11,7,12,35,42,-7,40
Ballinamalla,4932,8,11,4,15,40,47,-7,37
Coleraine,4932,9,8,11,11,38,44,-6,35
Dungannon,4932,10,7,12,11,44,44,0,33
Portadown,4932,11,9,5,16,28,44,-16,32
Cliftonville,4933,1,18,3,9,54,38,16,57
Linfield,4933,2,14,10,6,55,28,27,52
Ballymena,4933,3,15,4,11,59,59,0,49
Crusaders,4933,4,14,6,10,52,40,12,48
Coleraine,4933,5,12,11,7,41,36,5,47
Glenavon,4933,6,10,10,10,49,47,2,40
Dungannon,4933,7,10,9,11,49,45,4,39
Ards,4933,8,11,4,15,40,47,-7,37
Ballinamalla,4933,9,11,3,16,33,51,-18,36
Portadown,4933,10,8,5,17,27,44,-17,29
Glentoran,4933,11,5,9,16,21,45,-24,24
Crusaders,4934,1,18,8,4,65,27,38,62
Linfield,4934,2,16,8,6,67,34,33,56
Cliftonville,4934,3,16,6,8,59,43,16,54
Coleraine,4934,4,12,10,8,47,35,12,46
Glenavon,4934,5,10,10,10,45,57,-12,40
Dungannon,4934,6,9,12,9,52,46,6,39
Glentoran,4934,7,11,6,13,32,44,-12,39
Ballymena,4934,8,10,8,12,53,60,-7,38
Ards,4934,9,9,6,15,38,57,-19,33
Ballinamalla,4934,10,6,7,17,26,55,-29,25
Portadown,4934,11,6,3,21,28,54,-26,21
Linfield,4935,1,14,11,5,62,33,29,53
Crusaders,4935,2,15,8,7,49,40,9,53
Cliftonville,4935,3,14,5,11,57,42,15,47
Coleraine,4935,4,13,8,9,52,44,8,47
Ballymena,4935,5,13,6,11,54,62,-8,45
Glenavon,4935,6,10,13,7,46,44,2,43
Glentoran,4935,7,10,5,15,40,48,-8,35
Ballinamalla,4935,8,10,5,15,34,49,-15,35
Dungannon,4935,9,8,9,13,47,47,0,33
Ards,4935,10,10,3,17,36,52,-16,33
Portadown,4935,11,9,5,16,27,43,-16,32
Crusaders,4936,1,17,5,8,51,31,20,56
Cliftonville,4936,2,16,7,7,56,37,19,55
Linfield,4936,3,14,12,4,59,32,27,54
Ballymena,4936,4,16,5,9,65,56,9,53
Coleraine,4936,5,13,10,7,48,40,8,49
Glenavon,4936,6,11,9,10,50,52,-2,42
Ards,4936,7,11,4,15,44,44,0,37
Dungannon,4936,8,8,8,14,47,52,-5,32
Glentoran,4936,9,7,8,15,25,45,-20,29
Portadown,4936,10,6,6,18,28,54,-26,24
Ballinamalla,4936,11,6,6,18,24,54,-30,24
Linfield,4937,1,17,9,4,68,31,37,60
Crusaders,4937,2,15,7,8,54,37,17,52
Cliftonville,4937,3,16,3,11,59,46,13,51
Ballymena,4937,4,13,9,8,59,56,3,48
Glenavon,4937,5,10,13,7,47,42,5,43
Coleraine,4937,6,10,12,8,45,40,5,42
Dungannon,4937,7,9,9,12,46,42,4,36
Portadown,4937,8,10,5,15,27,44,-17,35
Ards,4937,9,9,6,15,35,46,-11,33
Ballinamalla,4937,10,8,4,18,30,56,-26,28
Glentoran,4937,11,6,7,17,22,52,-30,25
Cliftonville,4938,1,15,7,8,51,35,16,52
Crusaders,4938,2,14,8,8,49,37,12,50
Linfield,4938,3,13,9,8,58,35,23,48
Coleraine,4938,4,12,12,6,47,35,12,48
Glenavon,4938,5,11,13,6,50,42,8,46
Ards,4938,6,13,5,12,47,45,2,44
Ballymena,4938,7,12,6,12,54,64,-10,42
Dungannon,4938,8,10,10,10,50,47,3,40
Glentoran,4938,9,8,9,13,28,40,-12,33
Ballinamalla,4938,10,8,4,18,33,59,-26,28
Portadown,4938,11,4,7,19,18,46,-28,19
Linfield,4939,1,15,8,7,57,30,27,53
Glenavon,4939,2,14,11,5,51,38,13,53
Crusaders,4939,3,14,7,9,50,37,13,49
Coleraine,4939,4,12,12,6,39,28,11,48
Ballymena,4939,5,13,8,9,48,52,-4,47
Cliftonville,4939,6,13,7,10,50,37,13,46
Dungannon,4939,7,8,13,9,49,41,8,37
Ballinamalla,4939,8,10,5,15,35,52,-17,35
Ards,4939,9,9,6,15,41,49,-8,33
Glentoran,4939,10,7,8,15,23,47,-24,29
Portadown,4939,11,3,9,18,20,52,-32,18
Cliftonville,4940,1,16,5,9,51,42,9,53
Linfield,4940,2,14,9,7,59,32,27,51
Coleraine,4940,3,13,10,7,50,40,10,49
Dungannon,4940,4,12,9,9,62,43,19,45
Glenavon,4940,5,11,10,9,54,48,6,43
Crusaders,4940,6,12,6,12,51,45,6,42
Ballymena,4940,7,11,9,10,46,52,-6,42
Glentoran,4940,8,10,8,12,33,45,-12,38
Ards,4940,9,8,7,15,37,53,-16,31
Portadown,4940,10,8,7,15,28,45,-17,31
Ballinamalla,4940,11,8,4,18,34,60,-26,28
Crusaders,4941,1,18,5,7,61,32,29,59
Glenavon,4941,2,14,9,7,53,42,11,51
Cliftonville,4941,3,15,5,10,53,37,16,50
Ballymena,4941,4,14,8,8,59,58,1,50
Linfield,4941,5,10,12,8,54,42,12,42
Coleraine,4941,6,10,11,9,37,41,-4,41
Ards,4941,7,11,3,16,41,48,-7,36
Glentoran,4941,8,9,7,14,35,45,-10,34
Dungannon,4941,9,8,9,13,43,47,-4,33
Ballinamalla,4941,10,9,5,16,31,47,-16,32
Portadown,4941,11,7,6,17,23,51,-28,27
Crusaders,4942,1,17,8,5,59,33,26,59
Linfield,4942,2,13,11,6,51,31,20,50
Cliftonville,4942,3,15,5,10,57,44,13,50
Glenavon,4942,4,12,12,6,57,40,17,48
Coleraine,4942,5,13,8,9,45,36,9,47
Ballymena,4942,6,10,8,12,49,60,-11,38
Dungannon,4942,7,8,11,11,48,51,-3,35
Ards,4942,8,9,6,15,33,46,-13,33
Glentoran,4942,9,8,8,14,28,38,-10,32
Ballinamalla,4942,10,9,5,16,26,48,-22,32
Portadown,4942,11,6,8,16,25,51,-26,26
Cliftonville,4943,1,18,4,8,58,34,24,58
Crusaders,4943,2,16,6,8,57,38,19,54
Linfield,4943,3,13,10,7,63,37,26,49
Glenavon,4943,4,13,10,7,50,41,9,49
Ballymena,4943,5,13,6,11,53,65,-12,45
Coleraine,4943,6,10,10,10,41,43,-2,40
Ballinamalla,4943,7,10,5,15,36,47,-11,35
Dungannon,4943,8,9,7,14,46,55,-9,34
Ards,4943,9,8,8,14,43,51,-8,32
Glentoran,4943,10,7,9,14,30,47,-17,30
Portadown,4943,11,7,7,16,22,41,-19,28
Linfield,4944,1,16,9,5,61,27,34,57
Ballymena,4944,2,17,5,8,73,58,15,56
Crusaders,4944,3,15,8,7,55,33,22,53
Cliftonville,4944,4,14,5,11,46,42,4,47
Glenavon,4944,5,12,11,7,51,48,3,47
Coleraine,4944,6,11,10,9,48,45,3,43
Ballinamalla,4944,7,12,2,16,30,45,-15,38
Dungannon,4944,8,9,8,13,48,46,2,35
Glentoran,4944,9,8,8,14,22,39,-17,32
Portadown,4944,10,8,3,19,30,57,-27,27
Ards,4944,11,6,5,19,29,53,-24,23
Linfield,4945,1,20,6,4,72,23,49,66
Crusaders,4945,2,14,8,8,49,37,12,50
Ballymena,4945,3,15,4,11,58,56,2,49
Cliftonville,4945,4,14,6,10,54,46,8,48
Dungannon,4945,5,12,11,7,55,38,17,47
Glenavon,4945,6,10,13,7,45,43,2,43
Coleraine,4945,7,12,7,11,49,51,-2,43
Glentoran,4945,8,9,8,13,33,47,-14,35
Ards,4945,9,9,5,16,39,54,-15,32
Ballinamalla,4945,10,5,7,18,26,51,-25,22
Portadown,4945,11,5,5,20,22,56,-34,20
Crusaders,4946,1,18,6,6,65,33,32,60
Linfield,4946,2,16,8,6,56,27,29,56
Cliftonville,4946,3,15,6,9,53,40,13,51
Glenavon,4946,4,11,10,9,45,46,-1,43
Ballymena,4946,5,12,7,11,54,59,-5,43
Dungannon,4946,6,11,9,10,46,39,7,42
Coleraine,4946,7,10,8,12,40,38,2,38
Glentoran,4946,8,8,9,13,29,47,-18,33
Portadown,4946,9,9,4,17,27,49,-22,31
Ballinamalla,4946,10,8,6,16,34,52,-18,30
Ards,4946,11,6,9,15,35,54,-19,27
Crusaders,4947,1,19,6,5,59,31,28,63
Linfield,4947,2,17,9,4,61,29,32,60
Cliftonville,4947,3,15,7,8,52,31,21,52
Glenavon,4947,4,14,8,8,56,44,12,50
Ballymena,4947,5,14,6,10,60,56,4,48
Coleraine,4947,6,10,9,11,42,51,-9,39
Dungannon,4947,7,9,7,14,48,49,-1,34
Ballinamalla,4947,8,9,4,17,32,52,-20,31
Ards,4947,9,9,3,18,36,56,-20,30
Glentoran,4947,10,6,9,15,25,48,-23,27
Portadown,4947,11,7,4,19,29,53,-24,25
Crusaders,4948,1,16,5,9,51,40,11,53
Linfield,4948,2,14,10,6,63,37,26,52
Ballymena,4948,3,15,5,10,67,60,7,50
Glenavon,4948,4,13,9,8,50,40,10,48
Coleraine,4948,5,13,9,8,44,34,10,48
Cliftonville,4948,6,14,3,13,46,40,6,45
Dungannon,4948,7,11,6,13,48,44,4,39
Glentoran,4948,8,10,9,11,38,44,-6,39
Ards,4948,9,9,4,17,37,57,-20,31
Ballinamalla,4948,10,10,1,19,32,54,-22,31
Portadown,4948,11,8,3,19,23,49,-26,27
Crusaders,4949,1,16,6,8,48,36,12,54
Linfield,4949,2,14,9,7,59,34,25,51
Ballymena,4949,3,15,6,9,48,48,0,51
Cliftonville,4949,4,13,6,11,48,38,10,45
Glenavon,4949,5,10,13,7,42,42,0,43
Portadown,4949,6,12,5,13,30,35,-5,41
Coleraine,4949,7,9,9,12,38,45,-7,36
Dungannon,4949,8,8,11,11,45,41,4,35
Glentoran,4949,9,9,8,13,32,42,-10,35
Ards,4949,10,8,8,14,36,47,-11,32
Ballinamalla,4949,11,8,5,17,30,48,-18,29
Coleraine,4950,1,15,9,6,47,34,13,54
Cliftonville,4950,2,16,5,9,54,38,16,53
Crusaders,4950,3,15,8,7,58,43,15,53
Ballymena,4950,4,13,8,9,50,49,1,47
Linfield,4950,5,11,11,8,52,36,16,44
Dungannon,4950,6,12,8,10,59,44,15,44
Glenavon,4950,7,11,10,9,45,44,1,43
Glentoran,4950,8,11,8,11,36,45,-9,41
Ards,4950,9,10,2,18,43,58,-15,32
Portadown,4950,10,6,6,18,23,45,-22,24
Ballinamalla,4950,11,5,5,20,28,59,-31,20
Crusaders,4951,1,19,6,5,64,33,31,63
Linfield,4951,2,15,8,7,59,31,28,53
Ballymena,4951,3,16,5,9,65,56,9,53
Cliftonville,4951,4,16,4,10,51,38,13,52
Dungannon,4951,5,13,8,9,52,44,8,47
Coleraine,4951,6,12,8,10,43,37,6,44
Glenavon,4951,7,8,10,12,39,51,-12,34
Ballinamalla,4951,8,9,6,15,34,47,-13,33
Glentoran,4951,9,8,8,14,26,42,-16,32
Ards,4951,10,7,4,19,30,58,-28,25
Portadown,4951,11,6,5,19,23,49,-26,23
Linfield,4952,1,15,8,7,57,34,23,53
Cliftonville,4952,2,16,3,11,48,39,9,51
Crusaders,4952,3,15,5,10,51,41,10,50
Ballymena,4952,4,15,5,10,63,54,9,50
Glenavon,4952,5,13,10,7,50,40,10,49
Dungannon,4952,6,11,10,9,58,42,16,43
Coleraine,4952,7,11,10,9,37,38,-1,43
Portadown,4952,8,10,4,16,30,46,-16,34
Glentoran,4952,9,8,6,16,28,47,-19,30
Ballinamalla,4952,10,8,6,16,30,52,-22,30
Ards,4952,11,7,5,18,32,51,-19,26
Crusaders,4953,1,17,7,6,55,31,24,58
Ballymena,4953,2,16,8,6,58,49,9,56
Coleraine,4953,3,13,9,8,52,40,12,48
Linfield,4953,4,12,11,7,56,36,20,47
Cliftonville,4953,5,13,6,11,49,44,5,45
Glenavon,4953,6,10,13,7,41,37,4,43
Ards,4953,7,9,7,14,43,53,-10,34
Dungannon,4953,8,7,12,11,44,44,0,33
Glentoran,4953,9,7,9,14,27,45,-18,30
Ballinamalla,4953,10,9,3,18,34,57,-23,30
Portadown,4953,11,6,7,17,20,43,-23,25
Crusaders,4954,1,17,7,6,60,34,26,58
Cliftonville,4954,2,17,6,7,52,34,18,57
Linfield,4954,3,16,7,7,61,31,30,55
Glenavon,4954,4,13,8,9,52,48,4,47
Coleraine,4954,5,12,9,9,45,38,7,45
Ballymena,4954,6,11,9,10,55,58,-3,42
Dungannon,4954,7,10,9,11,46,47,-1,39
Ards,4954,8,10,3,17,39,56,-17,33
Glentoran,4954,9,7,8,15,32,51,-19,29
Ballinamalla,4954,10,8,4,18,28,50,-22,28
Portadown,4954,11,6,6,18,26,49,-23,24
Crusaders,4955,1,17,7,6,51,34,17,58
Coleraine,4955,2,14,10,6,42,33,9,52
Ballymena,4955,3,15,5,10,66,54,12,50
Linfield,4955,4,12,10,8,53,35,18,46
Glenavon,4955,5,11,10,9,47,45,2,43
Cliftonville,4955,6,12,6,12,48,41,7,42
Glentoran,4955,7,9,7,14,30,46,-16,34
Ballinamalla,4955,8,9,6,15,35,49,-14,33
Portadown,4955,9,9,6,15,26,44,-18,33
Dungannon,4955,10,7,10,13,43,51,-8,31
Ards,4955,11,8,7,15,37,46,-9,31
Cliftonville,4956,1,16,6,8,52,38,14,54
Ballymena,4956,2,15,6,9,55,56,-1,51
Crusaders,4956,3,14,8,8,53,36,17,50
Linfield,4956,4,12,12,6,52,32,20,48
Coleraine,4956,5,13,9,8,45,35,10,48
Glenavon,4956,6,12,10,8,61,50,11,46
Dungannon,4956,7,10,9,11,53,49,4,39
Glentoran,4956,8,11,5,14,39,44,-5,38
Portadown,4956,9,8,7,15,25,43,-18,31
Ards,4956,10,6,7,17,34,54,-20,25
Ballinamalla,4956,11,6,5,19,30,62,-32,23
Crusaders,4957,1,17,5,8,55,33,22,56
Linfield,4957,2,14,11,5,56,28,28,53
Glenavon,4957,3,14,9,7,49,40,9,51
Coleraine,4957,4,14,7,9,51,39,12,49
Cliftonville,4957,5,15,4,11,46,44,2,49
Ards,4957,6,13,4,13,42,46,-4,43
Ballymena,4957,7,11,6,13,46,54,-8,39
Ballinamalla,4957,8,12,2,16,35,50,-15,38
Dungannon,4957,9,8,11,11,46,44,2,35
Glentoran,4957,10,7,6,17,26,43,-17,27
Portadown,4957,11,4,7,19,23,54,-31,19
Linfield,4958,1,16,7,7,61,30,31,55
Coleraine,4958,2,15,9,6,49,32,17,54
Crusaders,4958,3,16,5,9,58,41,17,53
Cliftonville,4958,4,15,6,9,52,39,13,51
Ballymena,4958,5,13,5,12,52,65,-13,44
Glenavon,4958,6,11,9,10,47,45,2,42
Dungannon,4958,7,11,8,11,56,51,5,41
Ards,4958,8,11,4,15,33,42,-9,37
Ballinamalla,4958,9,9,6,15,34,49,-15,33
Glentoran,4958,10,7,6,17,27,51,-24,27
Portadown,4958,11,7,3,20,22,46,-24,24
Crusaders,4959,1,20,6,4,59,31,28,66
Cliftonville,4959,2,16,5,9,49,35,14,53
Linfield,4959,3,14,10,6,54,27,27,52
Glenavon,4959,4,12,10,8,55,45,10,46
Ballymena,4959,5,13,7,10,55,56,-1,46
Coleraine,4959,6,10,11,9,40,33,7,41
Glentoran,4959,7,9,7,14,28,46,-18,34
Dungannon,4959,8,7,10,13,49,51,-2,31
Ballinamalla,4959,9,8,5,17,30,49,-19,29
Ards,4959,10,7,7,16,33,51,-18,28
Portadown,4959,11,8,4,18,24,52,-28,28
Crusaders,4960,1,16,8,6,57,39,18,56
Linfield,4960,2,15,10,5,59,32,27,55
Ballymena,4960,3,15,7,8,59,55,4,52
Cliftonville,4960,4,15,5,10,55,39,16,50
Glenavon,4960,5,11,12,7,44,40,4,45
Coleraine,4960,6,11,10,9,41,38,3,43
Dungannon,4960,7,9,7,14,48,44,4,34
Ballinamalla,4960,8,10,4,16,34,50,-16,34
Glentoran,4960,9,8,9,13,30,44,-14,33
Ards,4960,10,7,5,18,29,51,-22,26
Portadown,4960,11,7,5,18,31,55,-24,26
Crusaders,4961,1,17,7,6,64,38,26,58
Linfield,4961,2,14,12,4,67,34,33,54
Cliftonville,4961,3,14,7,9,48,36,12,49
Glenavon,4961,4,13,10,7,48,43,5,49
Glentoran,4961,5,11,9,10,34,39,-5,42
Ballymena,4961,6,12,6,12,49,59,-10,42
Coleraine,4961,7,9,13,8,43,37,6,40
Dungannon,4961,8,9,8,13,53,54,-1,35
Ards,4961,9,8,7,15,33,52,-19,31
Portadown,4961,10,7,6,17,26,47,-21,27
Ballinamalla,4961,11,6,5,19,22,48,-26,23
Crusaders,4962,1,18,7,5,55,24,31,61
Linfield,4962,2,17,8,5,59,28,31,59
Ballymena,4962,3,17,7,6,58,47,11,58
Cliftonville,4962,4,14,7,9,48,41,7,49
Glenavon,4962,5,11,10,9,48,51,-3,43
Coleraine,4962,6,10,9,11,38,40,-2,39
Glentoran,4962,7,9,8,13,28,42,-14,35
Ards,4962,8,10,4,16,35,47,-12,34
Dungannon,4962,9,8,8,14,48,50,-2,32
Ballinamalla,4962,10,7,4,19,28,50,-22,25
Portadown,4962,11,5,6,19,19,44,-25,21
Crusaders,4963,1,17,7,6,64,35,29,58
Glenavon,4963,2,15,10,5,45,31,14,55
Linfield,4963,3,15,8,7,70,39,31,53
Ballymena,4963,4,14,8,8,63,58,5,50
Cliftonville,4963,5,13,6,11,52,51,1,45
Coleraine,4963,6,9,13,8,35,33,2,40
Dungannon,4963,7,9,8,13,52,52,0,35
Portadown,4963,8,9,5,16,28,47,-19,32
Glentoran,4963,9,7,10,13,37,54,-17,31
Ards,4963,10,7,7,16,39,55,-16,28
Ballinamalla,4963,11,6,6,18,34,64,-30,24
Crusaders,4964,1,16,7,7,55,39,16,55
Ballymena,4964,2,15,6,9,59,55,4,51
Linfield,4964,3,14,8,8,58,35,23,50
Dungannon,4964,4,12,9,9,51,38,13,45
Cliftonville,4964,5,12,7,11,42,39,3,43
Glenavon,4964,6,10,13,7,49,51,-2,43
Coleraine,4964,7,9,13,8,40,36,4,40
Ards,4964,8,10,6,14,37,46,-9,36
Glentoran,4964,9,9,9,12,29,41,-12,36
Ballinamalla,4964,10,8,3,19,31,51,-20,27
Portadown,4964,11,7,5,18,26,46,-20,26
Crusaders,4965,1,17,8,5,63,31,32,59
Cliftonville,4965,2,17,7,6,55,32,23,58
Linfield,4965,3,15,9,6,65,41,24,54
Glenavon,4965,4,13,8,9,51,44,7,47
Ballymena,4965,5,12,8,10,53,54,-1,44
Dungannon,4965,6,10,9,11,51,46,5,39
Coleraine,4965,7,9,10,11,39,46,-7,37
Ards,4965,8,9,7,14,35,52,-17,34
Glentoran,4965,9,7,8,15,27,46,-19,29
Ballinamalla,4965,10,7,6,17,28,49,-21,27
Portadown,4965,11,5,8,17,19,45,-26,23
Crusaders,4966,1,18,7,5,54,30,24,61
Ballymena,4966,2,15,7,8,63,51,12,52
Linfield,4966,3,13,11,6,66,44,22,50
Glenavon,4966,4,12,9,9,52,49,3,45
Dungannon,4966,5,12,8,10,51,41,10,44
Cliftonville,4966,6,13,4,13,46,44,2,43
Coleraine,4966,7,10,9,11,42,43,-1,39
Ards,4966,8,10,5,15,41,49,-8,35
Portadown,4966,9,8,6,16,26,46,-20,30
Ballinamalla,4966,10,9,2,19,37,59,-22,29
Glentoran,4966,11,7,8,15,34,56,-22,29
Cliftonville,4967,1,17,4,9,59,36,23,55
Ballymena,4967,2,15,6,9,51,57,-6,51
Crusaders,4967,3,14,7,9,51,36,15,49
Glenavon,4967,4,13,10,7,47,42,5,49
Coleraine,4967,5,12,9,9,45,39,6,45
Linfield,4967,6,12,8,10,55,34,21,44
Dungannon,4967,7,9,11,10,47,42,5,38
Portadown,4967,8,11,4,15,31,41,-10,37
Glentoran,4967,9,7,11,12,27,43,-16,32
Ballinamalla,4967,10,8,5,17,24,49,-25,29
Ards,4967,11,6,7,17,37,55,-18,25
Crusaders,4968,1,17,7,6,54,31,23,58
Cliftonville,4968,2,16,3,11,55,38,17,51
Ballymena,4968,3,15,6,9,62,57,5,51
Linfield,4968,4,13,10,7,55,29,26,49
Dungannon,4968,5,13,9,8,56,40,16,48
Ards,4968,6,12,6,12,41,39,2,42
Coleraine,4968,7,10,11,9,35,36,-1,41
Glenavon,4968,8,8,12,10,42,48,-6,36
Portadown,4968,9,9,3,18,29,55,-26,30
Ballinamalla,4968,10,6,6,18,25,53,-28,24
Glentoran,4968,11,5,9,16,23,51,-28,24
Cliftonville,4969,1,18,5,7,59,34,25,59
Crusaders,4969,2,16,8,6,57,36,21,56
Linfield,4969,3,15,9,6,62,33,29,54
Ballymena,4969,4,15,7,8,69,51,18,52
Glentoran,4969,5,12,6,12,38,42,-4,42
Dungannon,4969,6,10,10,10,45,39,6,40
Glenavon,4969,7,9,11,10,47,52,-5,38
Coleraine,4969,8,9,11,10,36,45,-9,38
Ards,4969,9,10,4,16,40,51,-11,34
Portadown,4969,10,5,6,19,22,63,-41,21
Ballinamalla,4969,11,4,7,19,20,49,-29,19
Cliftonville,4970,1,19,3,8,49,35,14,60
Linfield,4970,2,14,10,6,60,30,30,52
Coleraine,4970,3,14,9,7,48,35,13,51
Crusaders,4970,4,13,9,8,45,31,14,48
Ballymena,4970,5,14,4,12,61,57,4,46
Portadown,4970,6,12,4,14,31,40,-9,40
Dungannon,4970,7,8,12,10,45,48,-3,36
Ballinamalla,4970,8,9,7,14,29,43,-14,34
Glenavon,4970,9,7,11,12,40,50,-10,32
Ards,4970,10,6,9,15,34,51,-17,27
Glentoran,4970,11,6,8,16,29,51,-22,26
Linfield,4971,1,14,10,6,56,35,21,52
Crusaders,4971,2,14,9,7,55,32,23,51
Ballymena,4971,3,15,4,11,65,57,8,49
Coleraine,4971,4,13,10,7,43,37,6,49
Dungannon,4971,5,13,9,8,55,40,15,48
Cliftonville,4971,6,14,5,11,53,42,11,47
Glenavon,4971,7,10,11,9,39,41,-2,41
Ballinamalla,4971,8,10,5,15,33,51,-18,35
Glentoran,4971,9,10,4,16,36,51,-15,34
Ards,4971,10,8,5,17,34,52,-18,29
Portadown,4971,11,6,4,20,18,49,-31,22
Cliftonville,4972,1,21,3,6,66,31,35,66
Linfield,4972,2,16,12,2,68,29,39,60
Crusaders,4972,3,16,6,8,55,41,14,54
Coleraine,4972,4,12,9,9,43,44,-1,45
Ballymena,4972,5,11,8,11,56,61,-5,41
Dungannon,4972,6,9,10,11,49,45,4,37
Glenavon,4972,7,7,13,10,47,50,-3,34
Ards,4972,8,9,7,14,36,51,-15,34
Ballinamalla,4972,9,8,5,17,33,53,-20,29
Glentoran,4972,10,7,7,16,22,43,-21,28
Portadown,4972,11,6,6,18,23,50,-27,24
Crusaders,4973,1,16,9,5,60,36,24,57
Linfield,4973,2,15,9,6,61,32,29,54
Cliftonville,4973,3,13,8,9,50,41,9,47
Coleraine,4973,4,12,11,7,42,33,9,47
Dungannon,4973,5,12,9,9,53,42,11,45
Glenavon,4973,6,12,8,10,50,50,0,44
Glentoran,4973,7,12,6,12,29,34,-5,42
Ballymena,4973,8,10,8,12,53,61,-8,38
Ballinamalla,4973,9,8,3,19,33,58,-25,27
Ards,4973,10,6,8,16,35,51,-16,26
Portadown,4973,11,7,5,18,26,54,-28,26
Crusaders,4974,1,17,7,6,54,31,23,58
Cliftonville,4974,2,18,4,8,56,34,22,58
Linfield,4974,3,14,12,4,59,29,30,54
Glenavon,4974,4,12,13,5,51,38,13,49
Ballymena,4974,5,12,6,12,52,55,-3,42
Ards,4974,6,10,8,12,38,41,-3,38
Coleraine,4974,7,9,10,11,36,41,-5,37
Dungannon,4974,8,7,11,12,47,52,-5,32
Glentoran,4974,9,7,7,16,24,49,-25,28
Ballinamalla,4974,10,7,6,17,27,50,-23,27
Portadown,4974,11,6,8,16,21,45,-24,26
Crusaders,4975,1,17,6,7,51,28,23,57
Ballymena,4975,2,15,6,9,54,58,-4,51
Cliftonville,4975,3,15,5,10,55,38,17,50
Linfield,4975,4,14,7,9,59,40,19,49
Glenavon,4975,5,12,9,9,52,47,5,45
Coleraine,4975,6,10,13,7,41,36,5,43
Dungannon,4975,7,11,7,12,50,46,4,40
Ards,4975,8,11,7,12,44,48,-4,40
Glentoran,4975,9,7,8,15,27,44,-17,29
Ballinamalla,4975,10,7,6,17,23,47,-24,27
Portadown,4975,11,6,6,18,24,48,-24,24
Crusaders,4976,1,18,9,3,63,34,29,63
Coleraine,4976,2,15,11,4,49,33,16,56
Cliftonville,4976,3,16,4,10,55,35,20,52
Ballymena,4976,4,16,4,10,63,64,-1,52
Linfield,4976,5,11,9,10,52,41,11,42
Glentoran,4976,6,10,9,11,40,47,-7,39
Dungannon,4976,7,9,8,13,48,47,1,35
Ards,4976,8,9,5,16,38,48,-10,32
Glenavon,4976,9,6,13,11,41,51,-10,31
Portadown,4976,10,8,5,17,30,48,-18,29
Ballinamalla,4976,11,7,3,20,26,57,-31,24
Cliftonville,4977,1,17,5,8,56,39,17,56
Crusaders,4977,2,15,7,8,59,40,19,52
Coleraine,4977,3,12,15,3,50,34,16,51
Ballymena,4977,4,13,7,10,59,58,1,46
Dungannon,4977,5,11,11,8,53,39,14,44
Linfield,4977,6,11,9,10,55,46,9,42
Glenavon,4977,7,11,9,10,47,42,5,42
Glentoran,4977,8,9,8,13,34,47,-13,35
Ards,4977,9,7,7,16,34,54,-20,28
Portadown,4977,10,6,9,15,23,44,-21,27
Ballinamalla,4977,11,8,3,19,30,57,-27,27
Crusaders,4978,1,19,7,4,62,28,34,64
Linfield,4978,2,15,9,6,58,27,31,54
Cliftonville,4978,3,16,2,12,51,36,15,50
Coleraine,4978,4,13,11,6,43,34,9,50
Ballymena,4978,5,14,5,11,58,57,1,47
Glenavon,4978,6,9,11,10,45,51,-6,38
Ards,4978,7,9,9,12,40,48,-8,36
Dungannon,4978,8,8,8,14,40,47,-7,32
Glentoran,4978,9,8,8,14,24,44,-20,32
Portadown,4978,10,8,5,17,32,51,-19,29
Ballinamalla,4978,11,6,5,19,23,53,-30,23
Crusaders,4979,1,17,9,4,62,31,31,60
Glenavon,4979,2,15,10,5,60,41,19,55
Cliftonville,4979,3,16,5,9,55,35,20,53
Linfield,4979,4,14,7,9,55,41,14,49
Coleraine,4979,5,10,11,9,43,44,-1,41
Ballymena,4979,6,10,11,9,50,56,-6,41
Glentoran,4979,7,10,6,14,34,47,-13,36
Ballinamalla,4979,8,8,7,15,28,53,-25,31
Dungannon,4979,9,7,9,14,50,56,-6,30
Ards,4979,10,8,5,17,39,50,-11,29
Portadown,4979,11,7,6,17,20,42,-22,27
Crusaders,4980,1,13,12,5,51,34,17,51
Glenavon,4980,2,14,9,7,52,39,13,51
Cliftonville,4980,3,14,6,10,54,39,15,48
Linfield,4980,4,11,12,7,57,40,17,45
Ballymena,4980,5,12,9,9,61,58,3,45
Dungannon,4980,6,9,12,9,48,46,2,39
Coleraine,4980,7,9,12,9,44,45,-1,39
Glentoran,4980,8,9,7,14,32,43,-11,34
Portadown,4980,9,8,8,14,31,48,-17,32
Ballinamalla,4980,10,8,7,15,30,52,-22,31
Ards,4980,11,7,8,15,33,49,-16,29
Cliftonville,4981,1,17,6,7,57,33,24,57
Crusaders,4981,2,17,5,8,50,35,15,56
Ballymena,4981,3,14,6,10,52,55,-3,48
Linfield,4981,4,13,8,9,56,34,22,47
Glenavon,4981,5,9,13,8,45,41,4,40
Glentoran,4981,6,10,9,11,32,38,-6,39
Ballinamalla,4981,7,11,5,14,30,44,-14,38
Coleraine,4981,8,9,10,11,37,45,-8,37
Dungannon,4981,9,9,8,13,45,42,3,35
Ards,4981,10,9,5,16,36,48,-12,32
Portadown,4981,11,7,5,18,23,48,-25,26
Crusaders,4982,1,17,7,6,61,36,25,58
Linfield,4982,2,14,10,6,57,30,27,52
Ballymena,4982,3,14,7,9,57,51,6,49
Ards,4982,4,13,5,12,44,40,4,44
Dungannon,4982,5,10,13,7,53,41,12,43
Glenavon,4982,6,10,13,7,50,46,4,43
Cliftonville,4982,7,13,4,13,47,44,3,43
Coleraine,4982,8,9,12,9,38,38,0,39
Glentoran,4982,9,10,7,13,31,41,-10,37
Ballinamalla,4982,10,7,7,16,33,58,-25,28
Portadown,4982,11,3,5,22,18,64,-46,14
Crusaders,4983,1,18,10,2,61,31,30,64
Ballymena,4983,2,16,5,9,62,58,4,53
Linfield,4983,3,14,10,6,60,32,28,52
Cliftonville,4983,4,16,3,11,57,39,18,51
Coleraine,4983,5,11,13,6,43,32,11,46
Dungannon,4983,6,11,9,10,52,47,5,42
Glenavon,4983,7,10,9,11,46,51,-5,39
Glentoran,4983,8,9,7,14,28,44,-16,34
Ballinamalla,4983,9,8,4,18,33,55,-22,28
Portadown,4983,10,6,7,17,24,49,-25,25
Ards,4983,11,5,5,20,30,58,-28,20
Cliftonville,4984,1,16,6,8,56,39,17,54
Crusaders,4984,2,15,9,6,53,37,16,54
Linfield,4984,3,14,10,6,57,29,28,52
Coleraine,4984,4,12,13,5,39,27,12,49
Dungannon,4984,5,13,7,10,56,43,13,46
Ballymena,4984,6,12,6,12,50,63,-13,42
Glenavon,4984,7,9,10,11,45,51,-6,37
Ards,4984,8,11,4,15,39,48,-9,37
Glentoran,4984,9,7,7,16,33,51,-18,28
Portadown,4984,10,7,6,17,28,47,-19,27
Ballinamalla,4984,11,7,6,17,28,49,-21,27
Ballymena,4985,1,16,7,7,62,52,10,55
Cliftonville,4985,2,16,5,9,51,34,17,53
Glenavon,4985,3,15,8,7,52,46,6,53
Crusaders,4985,4,14,7,9,49,36,13,49
Coleraine,4985,5,13,9,8,37,29,8,48
Ards,4985,6,12,4,14,45,48,-3,40
Linfield,4985,7,9,8,13,47,43,4,35
Dungannon,4985,8,9,8,13,44,44,0,35
Ballinamalla,4985,9,10,5,15,30,46,-16,35
Portadown,4985,10,8,6,16,23,42,-19,30
Glentoran,4985,11,6,7,17,22,42,-20,25
Linfield,4986,1,16,10,4,62,28,34,58
Cliftonville,4986,2,17,6,7,54,33,21,57
Ballymena,4986,3,14,7,9,55,56,-1,49
Coleraine,4986,4,12,9,9,44,37,7,45
Dungannon,4986,5,11,9,10,49,42,7,42
Crusaders,4986,6,11,9,10,46,39,7,42
Glenavon,4986,7,9,12,9,34,38,-4,39
Glentoran,4986,8,10,8,12,36,45,-9,38
Portadown,4986,9,7,8,15,28,48,-20,29
Ards,4986,10,7,7,16,34,47,-13,28
Ballinamalla,4986,11,5,7,18,19,48,-29,22
Linfield,4987,1,16,11,3,64,25,39,59
Crusaders,4987,2,15,9,6,52,32,20,54
Cliftonville,4987,3,15,5,10,53,40,13,50
Ballymena,4987,4,13,9,8,54,49,5,48
Dungannon,4987,5,12,9,9,48,36,12,45
Coleraine,4987,6,11,9,10,39,40,-1,42
Glenavon,4987,7,11,8,11,49,49,0,41
Ards,4987,8,10,7,13,36,39,-3,37
Glentoran,4987,9,6,9,15,27,49,-22,27
Portadown,4987,10,6,6,18,22,52,-30,24
Ballinamalla,4987,11,5,8,17,25,58,-33,23
Crusaders,4988,1,16,8,6,59,32,27,56
Cliftonville,4988,2,16,4,10,54,39,15,52
Linfield,4988,3,14,9,7,60,31,29,51
Coleraine,4988,4,12,10,8,42,43,-1,46
Ballymena,4988,5,12,8,10,54,56,-2,44
Glenavon,4988,6,11,9,10,43,45,-2,42
Glentoran,4988,7,10,9,11,25,37,-12,39
Dungannon,4988,8,9,10,11,54,49,5,37
Ballinamalla,4988,9,10,3,17,28,45,-17,33
Ards,4988,10,8,7,15,37,52,-15,31
Portadown,4988,11,5,7,18,25,52,-27,22
Crusaders,4989,1,16,9,5,55,37,18,57
Ballymena,4989,2,17,6,7,60,52,8,57
Linfield,4989,3,13,10,7,58,33,25,49
Dungannon,4989,4,12,10,8,58,44,14,46
Coleraine,4989,5,12,9,9,46,42,4,45
Glenavon,4989,6,9,12,9,45,44,1,39
Cliftonville,4989,7,12,2,16,47,54,-7,38
Glentoran,4989,8,10,6,14,35,48,-13,36
Ballinamalla,4989,9,9,4,17,32,47,-15,31
Portadown,4989,10,9,4,17,28,46,-18,31
Ards,4989,11,8,4,18,37,54,-17,28
Crusaders,4990,1,18,5,7,52,35,17,59
Cliftonville,4990,2,16,5,9,57,41,16,53
Glenavon,4990,3,13,8,9,48,46,2,47
Linfield,4990,4,13,7,10,55,38,17,46
Ballymena,4990,5,13,6,11,45,50,-5,45
Coleraine,4990,6,12,8,10,43,40,3,44
Dungannon,4990,7,10,10,10,50,45,5,40
Glentoran,4990,8,10,7,13,39,45,-6,37
Ards,4990,9,9,6,15,37,46,-9,33
Portadown,4990,10,8,5,17,28,43,-15,29
Ballinamalla,4990,11,8,3,19,26,51,-25,27
Linfield,4991,1,17,7,6,58,31,27,58
Cliftonville,4991,2,15,7,8,59,41,18,52
Coleraine,4991,3,14,10,6,52,38,14,52
Crusaders,4991,4,15,6,9,49,38,11,51
Glenavon,4991,5,12,12,6,54,45,9,48
Ballymena,4991,6,10,8,12,52,63,-11,38
Dungannon,4991,7,9,10,11,56,51,5,37
Glentoran,4991,8,10,7,13,32,39,-7,37
Ballinamalla,4991,9,8,4,18,31,54,-23,28
Portadown,4991,10,7,6,17,28,50,-22,27
Ards,4991,11,7,5,18,30,51,-21,26
Crusaders,4992,1,17,7,6,60,36,24,58
Cliftonville,4992,2,16,6,8,53,36,17,54
Glenavon,4992,3,14,10,6,52,37,15,52
Ballymena,4992,4,14,7,9,57,59,-2,49
Linfield,4992,5,12,8,10,50,34,16,44
Coleraine,4992,6,11,10,9,41,42,-1,43
Dungannon,4992,7,11,9,10,53,39,14,42
Ards,4992,8,10,4,16,34,50,-16,34
Portadown,4992,9,8,5,17,17,41,-24,29
Glentoran,4992,10,7,6,17,34,53,-19,27
Ballinamalla,4992,11,6,6,18,26,50,-24,24
Ballymena,4993,1,18,5,7,65,48,17,59
Cliftonville,4993,2,16,7,7,57,34,23,55
Crusaders,4993,3,15,7,8,53,38,15,52
Linfield,4993,4,12,11,7,53,33,20,47
Glenavon,4993,5,12,11,7,54,48,6,47
Coleraine,4993,6,10,8,12,36,43,-7,38
Dungannon,4993,7,9,10,11,47,45,2,37
Ards,4993,8,10,5,15,34,49,-15,35
Glentoran,4993,9,8,10,12,27,39,-12,34
Portadown,4993,10,10,3,17,29,49,-20,33
Ballinamalla,4993,11,4,5,21,23,52,-29,17
Linfield,4994,1,16,9,5,62,34,28,57
Crusaders,4994,2,16,8,6,58,41,17,56
Ballymena,4994,3,15,7,8,60,55,5,52
Coleraine,4994,4,14,9,7,48,35,13,51
Dungannon,4994,5,13,7,10,50,40,10,46
Cliftonville,4994,6,12,3,15,51,54,-3,39
Glenavon,4994,7,8,12,10,43,48,-5,36
Ballinamalla,4994,8,11,3,16,32,40,-8,36
Glentoran,4994,9,9,5,16,32,52,-20,32
Ards,4994,10,7,5,18,35,52,-17,26
Portadown,4994,11,6,8,16,25,45,-20,26
Linfield,4995,1,14,11,5,65,36,29,53
Crusaders,4995,2,15,6,9,56,47,9,51
Coleraine,4995,3,14,7,9,50,34,16,49
Ards,4995,4,14,5,11,51,42,9,47
Ballymena,4995,5,13,7,10,54,59,-5,46
Cliftonville,4995,6,14,3,13,53,46,7,45
Dungannon,4995,7,11,7,12,43,40,3,40
Glenavon,4995,8,10,10,10,45,46,-1,40
Portadown,4995,9,9,6,15,23,41,-18,33
Glentoran,4995,10,8,8,14,27,47,-20,32
Ballinamalla,4995,11,7,2,21,33,62,-29,23
Cliftonville,4996,1,16,4,10,58,41,17,52
Crusaders,4996,2,15,7,8,46,34,12,52
Linfield,4996,3,13,10,7,51,33,18,49
Ballymena,4996,4,13,7,10,61,58,3,46
Glenavon,4996,5,13,7,10,47,46,1,46
Dungannon,4996,6,11,9,10,55,42,13,42
Coleraine,4996,7,11,9,10,37,36,1,42
Glentoran,4996,8,10,5,15,32,49,-17,35
Ards,4996,9,9,6,15,33,43,-10,33
Portadown,4996,10,9,5,16,26,43,-17,32
Ballinamalla,4996,11,8,5,17,33,54,-21,29
Linfield,4997,1,15,10,5,54,27,27,55
Cliftonville,4997,2,16,4,10,47,34,13,52
Glenavon,4997,3,14,8,8,52,42,10,50
Crusaders,4997,4,14,7,9,51,39,12,49
Ballymena,4997,5,14,6,10,57,54,3,48
Dungannon,4997,6,12,6,12,53,47,6,42
Coleraine,4997,7,10,11,9,40,40,0,41
Ards,4997,8,11,5,14,39,44,-5,38
Ballinamalla,4997,9,8,7,15,26,46,-20,31
Glentoran,4997,10,6,9,15,27,49,-22,27
Portadown,4997,11,6,5,19,30,54,-24,23
Linfield,4998,1,16,10,4,59,27,32,58
Crusaders,4998,2,16,7,7,54,34,20,55
Cliftonville,4998,3,15,6,9,59,40,19,51
Ballymena,4998,4,13,8,9,56,58,-2,47
Coleraine,4998,5,12,10,8,44,36,8,46
Dungannon,4998,6,10,9,11,52,45,7,39
Glenavon,4998,7,9,11,10,46,53,-7,38
Portadown,4998,8,11,4,15,30,38,-8,37
Ards,4998,9,10,3,17,37,53,-16,33
Ballinamalla,4998,10,7,5,18,24,53,-29,26
Glentoran,4998,11,6,7,17,22,46,-24,25
Crusaders,4999,1,18,10,2,58,32,26,64
Linfield,4999,2,13,12,5,60,36,24,51
Glentoran,4999,3,13,8,9,42,43,-1,47
Glenavon,4999,4,12,9,9,54,47,7,45
Coleraine,4999,5,12,8,10,43,39,4,44
Ballymena,4999,6,13,4,13,51,59,-8,43
Cliftonville,4999,7,12,6,12,47,38,9,42
Dungannon,4999,8,7,12,11,46,47,-1,33
Ballinamalla,4999,9,9,3,18,28,52,-24,30
Ards,4999,10,8,4,18,35,51,-16,28
Portadown,4999,11,7,6,17,23,43,-20,27
Crusaders,5000,1,18,7,5,61,32,29,61
Linfield,5000,2,14,9,7,65,36,29,51
Cliftonville,5000,3,16,3,11,56,37,19,51
Coleraine,5000,4,12,9,9,49,48,1,45
Glenavon,5000,5,11,10,9,42,43,-1,43
Ballinamalla,5000,6,12,4,14,40,51,-11,40
Ballymena,5000,7,11,7,12,52,66,-14,40
Dungannon,5000,8,8,10,12,50,53,-3,34
Ards,5000,9,9,7,14,43,51,-8,34
Portadown,5000,10,8,5,17,24,46,-22,29
Glentoran,5000,11,6,9,15,30,49,-19,27
Cliftonville,5001,1,17,7,6,63,38,25,58
Linfield,5001,2,16,8,6,62,33,29,56
Glenavon,5001,3,14,10,6,54,36,18,52
Crusaders,5001,4,14,8,8,60,40,20,50
Dungannon,5001,5,11,9,10,46,46,0,42
Coleraine,5001,6,9,13,8,43,43,0,40
Ballymena,5001,7,11,7,12,50,63,-13,40
Ards,5001,8,11,5,14,44,49,-5,38
Glentoran,5001,9,7,10,13,30,44,-14,31
Portadown,5001,10,8,6,16,26,46,-20,30
Ballinamalla,5001,11,3,5,22,23,63,-40,14
Crusaders,5002,1,16,7,7,59,36,23,55
Linfield,5002,2,15,7,8,57,30,27,52
Ballymena,5002,3,15,7,8,56,54,2,52
Glenavon,5002,4,12,13,5,48,38,10,49
Cliftonville,5002,5,14,5,11,46,38,8,47
Coleraine,5002,6,11,9,10,43,41,2,42
Glentoran,5002,7,10,6,14,31,45,-14,36
Dungannon,5002,8,9,8,13,46,54,-8,35
Ards,5002,9,10,5,15,39,48,-9,35
Ballinamalla,5002,10,8,3,19,25,45,-20,27
Portadown,5002,11,7,6,17,25,46,-21,27
Cliftonville,5003,1,17,5,8,54,32,22,56
Ballymena,5003,2,15,7,8,54,53,1,52
Crusaders,5003,3,14,8,8,51,38,13,50
Linfield,5003,4,14,7,9,51,37,14,49
Coleraine,5003,5,13,9,8,47,38,9,48
Glentoran,5003,6,13,7,10,36,36,0,46
Dungannon,5003,7,11,10,9,52,44,8,43
Glenavon,5003,8,10,11,9,50,44,6,41
Ards,5003,9,8,7,15,37,52,-15,31
Ballinamalla,5003,10,6,4,20,30,57,-27,22
Portadown,5003,11,5,3,22,16,47,-31,18
Linfield,5004,1,15,11,4,62,28,34,56
Cliftonville,5004,2,17,5,8,53,30,23,56
Crusaders,5004,3,14,9,7,56,43,13,51
Ballymena,5004,4,14,6,10,59,55,4,48
Glenavon,5004,5,11,11,8,45,44,1,44
Coleraine,5004,6,10,9,11,39,39,0,39
Dungannon,5004,7,9,9,12,46,45,1,36
Ards,5004,8,10,3,17,37,51,-14,33
Portadown,5004,9,9,5,16,24,45,-21,32
Glentoran,5004,10,8,7,15,30,47,-17,31
Ballinamalla,5004,11,8,5,17,30,54,-24,29
Glenavon,5005,1,14,12,4,56,41,15,54
Linfield,5005,2,14,11,5,57,26,31,53
Cliftonville,5005,3,15,7,8,49,37,12,52
Crusaders,5005,4,14,9,7,60,36,24,51
Ballymena,5005,5,13,6,11,52,62,-10,45
Dungannon,5005,6,8,11,11,48,45,3,35
Coleraine,5005,7,8,11,11,40,48,-8,35
Glentoran,5005,8,9,8,13,29,44,-15,35
Ballinamalla,5005,9,10,3,17,29,43,-14,33
Ards,5005,10,9,4,17,37,56,-19,31
Portadown,5005,11,6,8,16,24,43,-19,26
Linfield,5006,1,16,12,2,58,26,32,60
Cliftonville,5006,2,17,5,8,61,46,15,56
Coleraine,5006,3,13,11,6,53,40,13,50
Ballymena,5006,4,14,8,8,65,58,7,50
Dungannon,5006,5,12,8,10,50,37,13,44
Crusaders,5006,6,12,8,10,49,42,7,44
Glenavon,5006,7,8,11,11,37,44,-7,35
Ards,5006,8,10,4,16,40,52,-12,34
Glentoran,5006,9,8,6,16,30,54,-24,30
Portadown,5006,10,7,5,18,29,49,-20,26
Ballinamalla,5006,11,5,8,17,27,51,-24,23
Cliftonville,5007,1,19,2,9,54,38,16,59
Linfield,5007,2,13,12,5,60,35,25,51
Ballymena,5007,3,14,8,8,57,48,9,50
Crusaders,5007,4,13,10,7,56,41,15,49
Glenavon,5007,5,12,10,8,45,44,1,46
Coleraine,5007,6,11,10,9,42,37,5,43
Dungannon,5007,7,11,9,10,46,39,7,42
Ards,5007,8,8,8,14,45,55,-10,32
Ballinamalla,5007,9,7,6,17,31,53,-22,27
Glentoran,5007,10,6,9,15,29,52,-23,27
Portadown,5007,11,7,4,19,28,51,-23,25
Crusaders,5008,1,18,6,6,60,31,29,60
Cliftonville,5008,2,15,5,10,51,38,13,50
Glenavon,5008,3,13,11,6,50,47,3,50
Coleraine,5008,4,13,10,7,51,40,11,49
Linfield,5008,5,13,7,10,63,40,23,46
Ballymena,5008,6,12,10,8,64,60,4,46
Dungannon,5008,7,12,8,10,51,40,11,44
Portadown,5008,8,6,11,13,23,42,-19,29
Glentoran,5008,9,7,8,15,25,46,-21,29
Ards,5008,10,7,6,17,41,62,-21,27
Ballinamalla,5008,11,6,4,20,28,61,-33,22
Crusaders,5009,1,18,7,5,58,28,30,61
Cliftonville,5009,2,18,3,9,57,37,20,57
Coleraine,5009,3,13,9,8,51,38,13,48
Linfield,5009,4,11,11,8,56,39,17,44
Glenavon,5009,5,11,9,10,42,38,4,42
Ballymena,5009,6,12,6,12,52,63,-11,42
Ballinamalla,5009,7,11,3,16,36,53,-17,36
Glentoran,5009,8,8,10,12,39,50,-11,34
Portadown,5009,9,9,7,14,31,44,-13,34
Dungannon,5009,10,7,10,13,43,52,-9,31
Ards,5009,11,7,5,18,36,59,-23,26
Linfield,5010,1,16,11,3,57,26,31,59
Ballymena,5010,2,15,6,9,58,55,3,51
Cliftonville,5010,3,15,5,10,48,34,14,50
Crusaders,5010,4,13,9,8,51,42,9,48
Coleraine,5010,5,12,12,6,41,34,7,48
Glenavon,5010,6,10,13,7,44,39,5,43
Ards,5010,7,11,6,13,42,46,-4,39
Glentoran,5010,8,10,8,12,30,36,-6,38
Dungannon,5010,9,7,8,15,44,53,-9,29
Portadown,5010,10,5,9,16,23,44,-21,24
Ballinamalla,5010,11,6,3,21,28,57,-29,21
Crusaders,5011,1,16,9,5,60,36,24,57
Linfield,5011,2,16,8,6,58,31,27,56
Ballymena,5011,3,17,4,9,65,58,7,55
Cliftonville,5011,4,14,7,9,47,36,11,49
Coleraine,5011,5,13,8,9,46,40,6,47
Glenavon,5011,6,12,8,10,41,42,-1,44
Glentoran,5011,7,12,5,13,35,41,-6,41
Ballinamalla,5011,8,8,5,17,30,50,-20,29
Dungannon,5011,9,6,10,14,40,52,-12,28
Ards,5011,10,7,7,16,36,54,-18,28
Portadown,5011,11,7,3,20,29,47,-18,24
Crusaders,5012,1,18,7,5,58,30,28,61
Linfield,5012,2,16,6,8,66,38,28,54
Ballymena,5012,3,16,6,8,60,53,7,54
Coleraine,5012,4,14,10,6,41,30,11,52
Cliftonville,5012,5,13,7,10,43,40,3,46
Glentoran,5012,6,11,7,12,32,42,-10,40
Dungannon,5012,7,9,10,11,47,43,4,37
Glenavon,5012,8,7,14,9,41,43,-2,35
Ards,5012,9,7,6,17,40,52,-12,27
Portadown,5012,10,6,7,17,25,50,-25,25
Ballinamalla,5012,11,5,6,19,30,62,-32,21
Linfield,5013,1,16,7,7,62,35,27,55
Crusaders,5013,2,15,8,7,55,42,13,53
Cliftonville,5013,3,15,6,9,50,33,17,51
Ballymena,5013,4,12,10,8,61,58,3,46
Dungannon,5013,5,11,9,10,54,46,8,42
Glentoran,5013,6,10,9,11,31,34,-3,39
Glenavon,5013,7,8,11,11,48,56,-8,35
Ards,5013,8,10,5,15,36,44,-8,35
Portadown,5013,9,10,5,15,28,44,-16,35
Coleraine,5013,10,7,11,12,37,45,-8,32
Ballinamalla,5013,11,9,3,18,35,60,-25,30
Crusaders,5014,1,15,10,5,53,35,18,55
Coleraine,5014,2,14,10,6,50,38,12,52
Linfield,5014,3,14,8,8,61,39,22,50
Ballymena,5014,4,14,8,8,61,57,4,50
Glenavon,5014,5,13,10,7,52,41,11,49
Cliftonville,5014,6,14,6,10,51,43,8,48
Dungannon,5014,7,12,9,9,54,39,15,45
Glentoran,5014,8,8,8,14,32,51,-19,32
Ards,5014,9,8,5,17,34,50,-16,29
Ballinamalla,5014,10,6,5,19,28,53,-25,23
Portadown,5014,11,4,7,19,19,49,-30,19
Crusaders,5015,1,21,6,3,68,32,36,69
Linfield,5015,2,17,7,6,69,33,36,58
Cliftonville,5015,3,15,7,8,55,43,12,52
Ballymena,5015,4,12,9,9,50,54,-4,45
Glenavon,5015,5,10,12,8,45,43,2,42
Glentoran,5015,6,11,7,12,26,41,-15,40
Coleraine,5015,7,9,11,10,39,37,2,38
Dungannon,5015,8,8,8,14,43,49,-6,32
Ards,5015,9,7,6,17,30,47,-17,27
Ballinamalla,5015,10,7,5,18,31,54,-23,26
Portadown,5015,11,5,8,17,18,41,-23,23
Linfield,5016,1,14,11,5,57,28,29,53
Cliftonville,5016,2,16,2,12,50,45,5,50
Crusaders,5016,3,13,10,7,49,33,16,49
Ballymena,5016,4,15,4,11,53,53,0,49
Coleraine,5016,5,12,10,8,44,35,9,46
Dungannon,5016,6,11,8,11,45,36,9,41
Ards,5016,7,11,4,15,37,39,-2,37
Glenavon,5016,8,9,10,11,42,47,-5,37
Portadown,5016,9,11,4,15,30,41,-11,37
Glentoran,5016,10,10,6,14,33,59,-26,36
Ballinamalla,5016,11,6,5,19,23,47,-24,23
Crusaders,5017,1,16,6,8,60,42,18,54
Ballymena,5017,2,16,5,9,56,50,6,53
Cliftonville,5017,3,14,7,9,55,41,14,49
Coleraine,5017,4,13,9,8,46,42,4,48
Linfield,5017,5,12,11,7,55,37,18,47
Dungannon,5017,6,11,9,10,52,45,7,42
Glenavon,5017,7,9,12,9,42,41,1,39
Ards,5017,8,8,7,15,40,49,-9,31
Glentoran,5017,9,6,12,12,21,37,-16,30
Ballinamalla,5017,10,8,6,16,27,49,-22,30
Portadown,5017,11,7,6,17,26,47,-21,27
Crusaders,5018,1,16,8,6,50,31,19,56
Linfield,5018,2,15,8,7,49,25,24,53
Cliftonville,5018,3,15,8,7,57,36,21,53
Ballymena,5018,4,13,6,11,61,55,6,45
Glenavon,5018,5,10,13,7,48,47,1,43
Dungannon,5018,6,11,8,11,54,45,9,41
Coleraine,5018,7,8,12,10,41,47,-6,36
Portadown,5018,8,10,6,14,32,48,-16,36
Ards,5018,9,9,6,15,35,46,-11,33
Glentoran,5018,10,7,9,14,25,43,-18,30
Ballinamalla,5018,11,6,6,18,26,55,-29,24
Crusaders,5019,1,15,8,7,56,38,18,53
Linfield,5019,2,14,9,7,56,35,21,51
Cliftonville,5019,3,14,5,11,51,42,9,47
Glenavon,5019,4,12,10,8,51,49,2,46
Coleraine,5019,5,12,9,9,40,34,6,45
Ballymena,5019,6,13,6,11,59,61,-2,45
Dungannon,5019,7,10,9,11,54,49,5,39
Ards,5019,8,11,3,16,39,51,-12,36
Portadown,5019,9,10,4,16,32,41,-9,34
Glentoran,5019,10,7,10,13,30,47,-17,31
Ballinamalla,5019,11,8,5,17,29,50,-21,29
Cliftonville,5020,1,19,4,7,63,35,28,61
Crusaders,5020,2,18,7,5,59,37,22,61
Ballymena,5020,3,16,6,8,59,55,4,54
Glenavon,5020,4,11,12,7,51,44,7,45
Linfield,5020,5,11,10,9,55,42,13,43
Coleraine,5020,6,10,10,10,42,42,0,40
Ards,5020,7,10,7,13,39,46,-7,37
Glentoran,5020,8,9,8,13,39,48,-9,35
Ballinamalla,5020,9,8,5,17,32,52,-20,29
Dungannon,5020,10,6,10,14,52,59,-7,28
Portadown,5020,11,6,3,21,23,54,-31,21
Cliftonville,5021,1,17,8,5,63,34,29,59
Crusaders,5021,2,16,5,9,58,44,14,53
Ballymena,5021,3,15,7,8,61,57,4,52
Dungannon,5021,4,12,12,6,56,38,18,48
Linfield,5021,5,14,6,10,56,40,16,48
Glenavon,5021,6,10,10,10,46,48,-2,40
Coleraine,5021,7,10,8,12,35,39,-4,38
Glentoran,5021,8,9,8,13,24,37,-13,35
Ards,5021,9,9,3,18,32,48,-16,30
Portadown,5021,10,8,6,16,29,47,-18,30
Ballinamalla,5021,11,7,3,20,29,57,-28,24
Linfield,5022,1,14,10,6,60,34,26,52
Crusaders,5022,2,14,9,7,55,38,17,51
Glenavon,5022,3,13,11,6,56,44,12,50
Ballymena,5022,4,14,5,11,52,57,-5,47
Cliftonville,5022,5,14,4,12,51,41,10,46
Dungannon,5022,6,12,8,10,55,46,9,44
Coleraine,5022,7,12,8,10,45,42,3,44
Ards,5022,8,11,3,16,43,49,-6,36
Glentoran,5022,9,8,9,13,29,44,-15,33
Ballinamalla,5022,10,7,6,17,23,47,-24,27
Portadown,5022,11,8,3,19,24,51,-27,27
Crusaders,5023,1,18,5,7,57,33,24,59
Cliftonville,5023,2,17,4,9,50,31,19,55
Linfield,5023,3,15,8,7,56,34,22,53
Ballymena,5023,4,16,5,9,61,51,10,53
Dungannon,5023,5,12,10,8,51,42,9,46
Glentoran,5023,6,10,8,12,34,44,-10,38
Coleraine,5023,7,7,14,9,38,42,-4,35
Ards,5023,8,9,6,15,42,48,-6,33
Glenavon,5023,9,7,11,12,39,54,-15,32
Portadown,5023,10,6,8,16,27,45,-18,26
Ballinamalla,5023,11,6,5,19,27,58,-31,23
Cliftonville,5024,1,17,6,7,53,32,21,57
Ballymena,5024,2,16,4,10,55,57,-2,52
Glenavon,5024,3,13,10,7,57,41,16,49
Linfield,5024,4,12,10,8,60,42,18,46
Crusaders,5024,5,11,8,11,45,40,5,41
Dungannon,5024,6,10,10,10,48,40,8,40
Coleraine,5024,7,9,10,11,43,44,-1,37
Ards,5024,8,10,6,14,39,45,-6,36
Glentoran,5024,9,9,6,15,26,48,-22,33
Portadown,5024,10,10,3,17,22,45,-23,33
Ballinamalla,5024,11,9,5,16,30,44,-14,32
Crusaders,5025,1,17,8,5,56,32,24,59
Cliftonville,5025,2,15,7,8,49,33,16,52
Linfield,5025,3,13,11,6,56,30,26,50
Glenavon,5025,4,13,7,10,53,54,-1,46
Ballymena,5025,5,13,7,10,60,63,-3,46
Coleraine,5025,6,10,13,7,46,37,9,43
Dungannon,5025,7,8,11,11,51,47,4,35
Glentoran,5025,8,7,11,12,39,50,-11,32
Portadown,5025,9,7,9,14,32,53,-21,30
Ards,5025,10,7,6,17,35,53,-18,27
Ballinamalla,5025,11,6,8,16,30,55,-25,26
Linfield,5026,1,16,9,5,59,29,30,57
Crusaders,5026,2,14,10,6,48,36,12,52
Cliftonville,5026,3,15,5,10,49,42,7,50
Ballymena,5026,4,15,5,10,62,56,6,50
Coleraine,5026,5,12,11,7,52,35,17,47
Glenavon,5026,6,11,9,10,46,42,4,42
Dungannon,5026,7,8,9,13,42,46,-4,33
Ballinamalla,5026,8,10,3,17,30,47,-17,33
Glentoran,5026,9,9,6,15,28,50,-22,33
Ards,5026,10,9,4,17,36,50,-14,31
Portadown,5026,11,7,7,16,29,48,-19,28
Crusaders,5027,1,18,7,5,57,34,23,61
Cliftonville,5027,2,17,6,7,53,32,21,57
Ballymena,5027,3,16,7,7,69,54,15,55
Coleraine,5027,4,13,9,8,42,34,8,48
Linfield,5027,5,12,9,9,56,31,25,45
Glenavon,5027,6,12,9,9,46,45,1,45
Dungannon,5027,7,11,10,9,56,47,9,43
Glentoran,5027,8,8,7,15,35,51,-16,31
Ards,5027,9,8,4,18,32,54,-22,28
Ballinamalla,5027,10,6,4,20,28,55,-27,22
Portadown,5027,11,6,4,20,19,56,-37,22
Coleraine,5028,1,16,10,4,48,24,24,58
Crusaders,5028,2,16,10,4,53,32,21,58
Cliftonville,5028,3,16,5,9,56,42,14,53
Linfield,5028,4,12,9,9,56,41,15,45
Glenavon,5028,5,11,12,7,47,47,0,45
Ballymena,5028,6,13,6,11,54,63,-9,45
Dungannon,5028,7,10,11,9,53,42,11,41
Glentoran,5028,8,10,6,14,29,37,-8,36
Ards,5028,9,9,5,16,35,44,-9,32
Portadown,5028,10,5,5,20,19,45,-26,20
Ballinamalla,5028,11,5,5,20,25,58,-33,20
Crusaders,5029,1,19,7,4,59,29,30,64
Cliftonville,5029,2,18,3,9,59,38,21,57
Linfield,5029,3,15,7,8,65,38,27,52
Coleraine,5029,4,14,8,8,44,34,10,50
Dungannon,5029,5,9,11,10,51,47,4,38
Ards,5029,6,11,5,14,46,45,1,38
Ballymena,5029,7,10,5,15,51,70,-19,35
Glenavon,5029,8,8,10,12,40,52,-12,34
Glentoran,5029,9,9,7,14,27,39,-12,34
Ballinamalla,5029,10,9,4,17,28,55,-27,31
Portadown,5029,11,8,3,19,27,50,-23,27
Crusaders,5030,1,17,7,6,52,28,24,58
Cliftonville,5030,2,15,8,7,56,36,20,53
Linfield,5030,3,13,10,7,64,43,21,49
Ballymena,5030,4,13,8,9,58,57,1,47
Coleraine,5030,5,11,13,6,47,38,9,46
Dungannon,5030,6,12,9,9,53,40,13,45
Glenavon,5030,7,9,10,11,45,53,-8,37
Ards,5030,8,9,5,16,37,48,-11,32
Glentoran,5030,9,7,10,13,33,47,-14,31
Portadown,5030,10,7,6,17,24,54,-30,27
Ballinamalla,5030,11,5,8,17,25,50,-25,23
Crusaders,5031,1,20,8,2,67,30,37,68
Linfield,5031,2,15,8,7,54,30,24,53
Ballymena,5031,3,14,7,9,55,58,-3,49
Cliftonville,5031,4,13,8,9,53,42,11,47
Coleraine,5031,5,12,11,7,46,37,9,47
Glentoran,5031,6,11,8,11,34,47,-13,41
Glenavon,5031,7,9,8,13,45,47,-2,35
Ards,5031,8,11,2,17,38,46,-8,35
Portadown,5031,9,8,7,15,31,45,-14,31
Dungannon,5031,10,6,7,17,38,51,-13,25
Ballinamalla,5031,11,6,6,18,27,55,-28,24
Crusaders,5032,1,17,8,5,56,30,26,59
Linfield,5032,2,15,9,6,56,31,25,54
Cliftonville,5032,3,14,7,9,47,34,13,49
Coleraine,5032,4,13,9,8,46,33,13,48
Dungannon,5032,5,10,12,8,45,34,11,42
Ballymena,5032,6,12,6,12,51,60,-9,42
Glenavon,5032,7,9,11,10,41,43,-2,38
Glentoran,5032,8,8,9,13,30,45,-15,33
Ards,5032,9,9,5,16,39,52,-13,32
Portadown,5032,10,7,8,15,26,49,-23,29
Ballinamalla,5032,11,6,6,18,24,50,-26,24
Crusaders,5033,1,17,8,5,54,25,29,59
Cliftonville,5033,2,15,5,10,54,41,13,50
Glenavon,5033,3,12,12,6,48,45,3,48
Linfield,5033,4,12,11,7,51,29,22,47
Coleraine,5033,5,12,11,7,50,38,12,47
Dungannon,5033,6,9,13,8,52,45,7,40
Ballymena,5033,7,10,8,12,50,55,-5,38
Ards,5033,8,10,5,15,44,52,-8,35
Glentoran,5033,9,8,9,13,27,46,-19,33
Ballinamalla,5033,10,8,5,17,29,52,-23,29
Portadown,5033,11,5,7,18,27,58,-31,22
Crusaders,5034,1,21,6,3,59,31,28,69
Ballymena,5034,2,13,9,8,63,58,5,48
Cliftonville,5034,3,12,11,7,57,46,11,47
Coleraine,5034,4,12,10,8,49,46,3,46
Linfield,5034,5,10,12,8,58,40,18,42
Glenavon,5034,6,8,14,8,47,49,-2,38
Dungannon,5034,7,8,11,11,43,42,1,35
Glentoran,5034,8,7,11,12,35,49,-14,32
Portadown,5034,9,8,8,14,31,45,-14,32
Ballinamalla,5034,10,7,6,17,29,48,-19,27
Ards,5034,11,6,8,16,30,47,-17,26
Linfield,5035,1,16,10,4,60,27,33,58
Crusaders,5035,2,15,7,8,50,32,18,52
Glenavon,5035,3,12,10,8,46,46,0,46
Ballymena,5035,4,12,10,8,51,52,-1,46
Cliftonville,5035,5,13,6,11,51,41,10,45
Dungannon,5035,6,11,10,9,45,36,9,43
Coleraine,5035,7,10,13,7,40,33,7,43
Ards,5035,8,9,6,15,35,49,-14,33
Ballinamalla,5035,9,9,6,15,29,47,-18,33
Glentoran,5035,10,7,9,14,26,43,-17,30
Portadown,5035,11,5,5,20,24,51,-27,20
Crusaders,5036,1,15,9,6,63,41,22,54
Linfield,5036,2,13,10,7,56,38,18,49
Coleraine,5036,3,10,14,6,39,31,8,44
Glentoran,5036,4,12,8,10,37,37,0,44
Cliftonville,5036,5,12,7,11,42,41,1,43
Ballymena,5036,6,13,4,13,55,59,-4,43
Dungannon,5036,7,9,12,9,47,43,4,39
Ards,5036,8,11,5,14,37,46,-9,38
Glenavon,5036,9,8,11,11,43,53,-10,35
Portadown,5036,10,9,7,14,30,37,-7,34
Ballinamalla,5036,11,7,5,18,31,54,-23,26
Cliftonville,5037,1,18,4,8,57,33,24,58
Crusaders,5037,2,14,11,5,53,33,20,53
Linfield,5037,3,14,10,6,58,33,25,52
Glenavon,5037,4,12,12,6,48,40,8,48
Coleraine,5037,5,11,12,7,44,37,7,45
Ballymena,5037,6,12,8,10,59,58,1,44
Dungannon,5037,7,7,11,12,48,45,3,32
Portadown,5037,8,8,6,16,25,48,-23,30
Ards,5037,9,8,5,17,34,58,-24,29
Glentoran,5037,10,5,13,12,29,45,-16,28
Ballinamalla,5037,11,8,4,18,35,60,-25,28
Crusaders,5038,1,17,7,6,63,37,26,58
Cliftonville,5038,2,18,4,8,53,39,14,58
Linfield,5038,3,14,10,6,62,31,31,52
Glenavon,5038,4,11,10,9,50,49,1,43
Dungannon,5038,5,11,8,11,49,42,7,41
Ballymena,5038,6,12,4,14,58,70,-12,40
Coleraine,5038,7,8,13,9,34,34,0,37
Glentoran,5038,8,10,6,14,32,43,-11,36
Ards,5038,9,8,10,12,27,37,-10,34
Ballinamalla,5038,10,7,7,16,31,52,-21,28
Portadown,5038,11,7,5,18,24,49,-25,26
Crusaders,5039,1,20,7,3,60,32,28,67
Ballymena,5039,2,17,6,7,69,54,15,57
Linfield,5039,3,14,9,7,65,36,29,51
Cliftonville,5039,4,14,5,11,54,44,10,47
Coleraine,5039,5,10,11,9,39,40,-1,41
Dungannon,5039,6,10,10,10,54,45,9,40
Glenavon,5039,7,7,12,11,45,55,-10,33
Ballinamalla,5039,8,10,3,17,39,60,-21,33
Glentoran,5039,9,8,7,15,30,46,-16,31
Ards,5039,10,8,4,18,35,52,-17,28
Portadown,5039,11,7,6,17,28,54,-26,27
Cliftonville,5040,1,17,3,10,61,40,21,54
Crusaders,5040,2,16,5,9,55,44,11,53
Glenavon,5040,3,14,9,7,47,38,9,51
Ballymena,5040,4,13,8,9,51,55,-4,47
Linfield,5040,5,12,9,9,49,39,10,45
Coleraine,5040,6,11,11,8,56,42,14,44
Portadown,5040,7,10,7,13,37,45,-8,37
Dungannon,5040,8,9,9,12,47,40,7,36
Ards,5040,9,10,6,14,39,48,-9,36
Glentoran,5040,10,8,9,13,28,43,-15,33
Ballinamalla,5040,11,5,4,21,23,59,-36,19
Crusaders,5041,1,18,7,5,61,34,27,61
Linfield,5041,2,14,10,6,63,33,30,52
Glenavon,5041,3,12,13,5,50,42,8,49
Dungannon,5041,4,12,10,8,55,43,12,46
Cliftonville,5041,5,13,7,10,49,41,8,46
Ballymena,5041,6,12,7,11,54,57,-3,43
Coleraine,5041,7,11,8,11,47,49,-2,41
Glentoran,5041,8,8,7,15,31,47,-16,31
Ards,5041,9,8,6,16,34,49,-15,30
Ballinamalla,5041,10,7,6,17,30,53,-23,27
Portadown,5041,11,8,3,19,27,53,-26,27
Ballymena,5042,1,17,5,8,63,57,6,56
Linfield,5042,2,14,12,4,65,35,30,54
Crusaders,5042,3,15,8,7,49,32,17,53
Dungannon,5042,4,13,6,11,51,38,13,45
Coleraine,5042,5,12,9,9,45,41,4,45
Ards,5042,6,12,5,13,43,47,-4,41
Cliftonville,5042,7,11,6,13,45,50,-5,39
Glentoran,5042,8,9,9,12,37,44,-7,36
Glenavon,5042,9,7,12,11,46,57,-11,33
Portadown,5042,10,6,8,16,27,46,-19,26
Ballinamalla,5042,11,8,2,20,32,56,-24,26
Crusaders,5043,1,16,7,7,52,31,21,55
Ballymena,5043,2,17,3,10,63,53,10,54
Linfield,5043,3,15,8,7,58,34,24,53
Cliftonville,5043,4,15,3,12,56,50,6,48
Coleraine,5043,5,11,11,8,46,42,4,44
Glenavon,5043,6,8,17,5,43,39,4,41
Dungannon,5043,7,8,13,9,48,44,4,37
Glentoran,5043,8,8,9,13,23,37,-14,33
Ards,5043,9,7,11,12,42,51,-9,32
Ballinamalla,5043,10,7,7,16,25,45,-20,28
Portadown,5043,11,5,7,18,20,50,-30,22
Linfield,5044,1,16,7,7,56,32,24,55
Cliftonville,5044,2,15,5,10,53,43,10,50
Crusaders,5044,3,13,10,7,50,41,9,49
Ballymena,5044,4,14,6,10,59,58,1,48
Dungannon,5044,5,12,9,9,53,41,12,45
Coleraine,5044,6,10,11,9,42,39,3,41
Glenavon,5044,7,9,11,10,47,51,-4,38
Ballinamalla,5044,8,12,1,17,42,49,-7,37
Ards,5044,9,10,6,14,41,44,-3,36
Glentoran,5044,10,8,8,14,27,46,-19,32
Portadown,5044,11,6,6,18,21,47,-26,24
Crusaders,5045,1,18,7,5,56,30,26,61
Linfield,5045,2,16,9,5,62,26,36,57
Cliftonville,5045,3,15,6,9,53,39,14,51
Glenavon,5045,4,12,10,8,46,39,7,46
Dungannon,5045,5,11,9,10,50,45,5,42
Coleraine,5045,6,11,9,10,36,33,3,42
Ballymena,5045,7,12,6,12,49,57,-8,42
Ards,5045,8,9,5,16,36,49,-13,32
Ballinamalla,5045,9,9,3,18,31,51,-20,30
Glentoran,5045,10,6,9,15,26,49,-23,27
Portadown,5045,11,8,3,19,27,54,-27,27
Crusaders,5046,1,17,7,6,58,31,27,58
Linfield,5046,2,13,9,8,52,25,27,48
Coleraine,5046,3,13,8,9,46,35,11,47
Glenavon,5046,4,12,10,8,45,45,0,46
Ballymena,5046,5,13,7,10,52,58,-6,46
Cliftonville,5046,6,13,5,12,49,43,6,44
Dungannon,5046,7,11,9,10,50,41,9,42
Glentoran,5046,8,10,8,12,38,47,-9,38
Portadown,5046,9,9,7,14,24,39,-15,34
Ards,5046,10,7,7,16,42,62,-20,28
Ballinamalla,5046,11,6,5,19,27,57,-30,23
Crusaders,5047,1,18,7,5,57,29,28,61
Cliftonville,5047,2,18,4,8,62,38,24,58
Linfield,5047,3,13,10,7,55,34,21,49
Ballymena,5047,4,15,4,11,59,58,1,49
Glenavon,5047,5,11,12,7,45,39,6,45
Coleraine,5047,6,12,9,9,39,34,5,45
Dungannon,5047,7,10,8,12,51,49,2,38
Glentoran,5047,8,9,6,15,28,40,-12,33
Portadown,5047,9,7,7,16,28,50,-22,28
Ards,5047,10,8,4,18,34,57,-23,28
Ballinamalla,5047,11,5,7,18,29,59,-30,22
Ballymena,5048,1,17,6,7,56,50,6,57
Crusaders,5048,2,15,10,5,57,30,27,55
Cliftonville,5048,3,16,7,7,51,38,13,55
Linfield,5048,4,13,11,6,61,35,26,50
Coleraine,5048,5,12,10,8,46,33,13,46
Ards,5048,6,9,7,14,38,48,-10,34
Dungannon,5048,7,7,12,11,49,53,-4,33
Ballinamalla,5048,8,9,5,16,30,49,-19,32
Glenavon,5048,9,7,9,14,42,56,-14,30
Glentoran,5048,10,7,8,15,28,46,-18,29
Portadown,5048,11,6,9,15,29,49,-20,27
Linfield,5049,1,17,7,6,64,28,36,58
Crusaders,5049,2,15,9,6,59,34,25,54
Coleraine,5049,3,14,7,9,50,37,13,49
Cliftonville,5049,4,15,4,11,59,49,10,49
Ballymena,5049,5,14,5,11,55,62,-7,47
Glenavon,5049,6,12,10,8,53,45,8,46
Ards,5049,7,11,4,15,39,50,-11,37
Dungannon,5049,8,9,7,14,45,50,-5,34
Portadown,5049,9,9,4,17,25,49,-24,31
Ballinamalla,5049,10,8,6,16,27,45,-18,30
Glentoran,5049,11,7,5,18,23,50,-27,26
Crusaders,5050,1,19,8,3,62,33,29,65
Linfield,5050,2,15,11,4,54,26,28,56
Coleraine,5050,3,12,10,8,40,35,5,46
Ballymena,5050,4,13,6,11,51,56,-5,45
Glenavon,5050,5,11,10,9,47,42,5,43
Cliftonville,5050,6,13,3,14,47,49,-2,42
Glentoran,5050,7,10,8,12,42,48,-6,38
Dungannon,5050,8,7,9,14,42,43,-1,30
Ballinamalla,5050,9,7,8,15,30,47,-17,29
Portadown,5050,10,6,10,14,26,43,-17,28
Ards,5050,11,7,7,16,36,55,-19,28
Crusaders,5051,1,17,7,6,51,28,23,58
Linfield,5051,2,16,9,5,55,28,27,57
Cliftonville,5051,3,15,5,10,56,42,14,50
Glenavon,5051,4,12,11,7,40,36,4,47
Ballymena,5051,5,13,6,11,59,59,0,45
Coleraine,5051,6,11,10,9,46,42,4,43
Dungannon,5051,7,9,9,12,49,52,-3,36
Glentoran,5051,8,9,7,14,40,51,-11,34
Ballinamalla,5051,9,8,6,16,33,57,-24,30
Portadown,5051,10,9,3,18,22,48,-26,30
Ards,5051,11,7,5,18,39,47,-8,26
Ballymena,5052,1,16,7,7,65,53,12,55
Cliftonville,5052,2,16,3,11,50,39,11,51
Crusaders,5052,3,14,6,10,51,39,12,48
Coleraine,5052,4,12,11,7,38,36,2,47
Linfield,5052,5,11,11,8,57,38,19,44
Glentoran,5052,6,12,8,10,31,35,-4,44
Glenavon,5052,7,10,13,7,47,43,4,43
Dungannon,5052,8,9,10,11,40,37,3,37
Portadown,5052,9,7,8,15,23,40,-17,29
Ballinamalla,5052,10,7,6,17,31,58,-27,27
Ards,5052,11,7,5,18,39,54,-15,26
Crusaders,5053,1,20,6,4,58,25,33,66
Linfield,5053,2,15,8,7,57,34,23,53
Cliftonville,5053,3,16,4,10,52,38,14,52
Ballymena,5053,4,14,7,9,56,50,6,49
Glenavon,5053,5,10,12,8,43,40,3,42
Dungannon,5053,6,11,8,11,51,43,8,41
Coleraine,5053,7,10,10,10,40,44,-4,40
Ards,5053,8,9,7,14,34,42,-8,34
Glentoran,5053,9,8,6,16,27,43,-16,30
Portadown,5053,10,8,5,17,28,53,-25,29
Ballinamalla,5053,11,6,3,21,22,56,-34,21
Crusaders,5054,1,16,8,6,52,33,19,56
Ballymena,5054,2,14,8,8,59,60,-1,50
Cliftonville,5054,3,14,5,11,56,48,8,47
Glenavon,5054,4,10,15,5,56,46,10,45
Coleraine,5054,5,11,12,7,45,36,9,45
Linfield,5054,6,10,12,8,53,42,11,42
Dungannon,5054,7,10,10,10,48,44,4,40
Ards,5054,8,11,5,14,43,47,-4,38
Glentoran,5054,9,8,6,16,35,51,-16,30
Portadown,5054,10,7,7,16,30,48,-18,28
Ballinamalla,5054,11,8,4,18,26,48,-22,28
Crusaders,5055,1,19,5,6,57,28,29,62
Cliftonville,5055,2,17,5,8,57,41,16,56
Linfield,5055,3,12,12,6,50,32,18,48
Coleraine,5055,4,12,10,8,47,42,5,46
Ballymena,5055,5,12,7,11,58,62,-4,43
Glenavon,5055,6,9,12,9,46,45,1,39
Glentoran,5055,7,11,6,13,30,39,-9,39
Ards,5055,8,11,5,14,43,45,-2,38
Dungannon,5055,9,8,8,14,43,49,-6,32
Portadown,5055,10,9,5,16,28,45,-17,32
Ballinamalla,5055,11,4,7,19,30,61,-31,19
Crusaders,5056,1,16,9,5,61,34,27,57
Ballymena,5056,2,15,8,7,62,51,11,53
Cliftonville,5056,3,16,3,11,59,46,13,51
Linfield,5056,4,12,10,8,53,32,21,46
Glenavon,5056,5,11,11,8,49,48,1,44
Coleraine,5056,6,11,9,10,44,44,0,42
Dungannon,5056,7,10,10,10,49,45,4,40
Glentoran,5056,8,10,7,13,33,43,-10,37
Ards,5056,9,9,4,17,36,51,-15,31
Ballinamalla,5056,10,9,4,17,31,56,-25,31
Portadown,5056,11,5,7,18,22,49,-27,22
Linfield,5057,1,15,9,6,63,36,27,54
Cliftonville,5057,2,16,5,9,65,42,23,53
Glenavon,5057,3,12,12,6,60,45,15,48
Coleraine,5057,4,13,8,9,45,40,5,47
Crusaders,5057,5,12,10,8,49,43,6,46
Ballymena,5057,6,11,6,13,52,69,-17,39
Ards,5057,7,10,8,12,42,44,-2,38
Dungannon,5057,8,8,11,11,50,47,3,35
Ballinamalla,5057,9,9,7,14,31,54,-23,34
Glentoran,5057,10,7,9,14,35,47,-12,30
Portadown,5057,11,7,5,18,24,49,-25,26
Crusaders,5058,1,17,8,5,57,30,27,59
Linfield,5058,2,16,8,6,62,31,31,56
Coleraine,5058,3,13,8,9,49,37,12,47
Cliftonville,5058,4,13,7,10,48,39,9,46
Ballymena,5058,5,13,7,10,52,58,-6,46
Glenavon,5058,6,11,11,8,45,43,2,44
Dungannon,5058,7,11,10,9,49,36,13,43
Glentoran,5058,8,9,6,15,30,43,-13,33
Portadown,5058,9,8,7,15,21,44,-23,31
Ards,5058,10,8,5,17,32,53,-21,29
Ballinamalla,5058,11,6,3,21,31,62,-31,21
Crusaders,5059,1,18,5,7,59,34,25,59
Linfield,5059,2,16,8,6,55,24,31,56
Cliftonville,5059,3,15,5,10,48,41,7,50
Dungannon,5059,4,13,7,10,52,38,14,46
Glenavon,5059,5,10,11,9,46,47,-1,41
Glentoran,5059,6,12,5,13,39,43,-4,41
Ballymena,5059,7,12,5,13,51,62,-11,41
Coleraine,5059,8,10,9,11,39,41,-2,39
Ards,5059,9,9,6,15,49,58,-9,33
Ballinamalla,5059,10,9,2,19,30,55,-25,29
Portadown,5059,11,6,7,17,24,49,-25,25
Linfield,5060,1,17,9,4,62,28,34,60
Crusaders,5060,2,17,9,4,51,22,29,60
Ballymena,5060,3,14,6,10,63,64,-1,48
Cliftonville,5060,4,14,4,12,48,41,7,46
Glenavon,5060,5,9,15,6,48,42,6,42
Coleraine,5060,6,10,9,11,41,39,2,39
Dungannon,5060,7,8,11,11,45,42,3,35
Ards,5060,8,10,5,15,38,54,-16,35
Ballinamalla,5060,9,9,4,17,29,53,-24,31
Glentoran,5060,10,6,11,13,27,44,-17,29
Portadown,5060,11,6,7,17,24,47,-23,25
Cliftonville,5061,1,18,4,8,59,33,26,58
Linfield,5061,2,14,10,6,47,26,21,52
Crusaders,5061,3,15,6,9,52,38,14,51
Ballymena,5061,4,15,4,11,59,59,0,49
Glenavon,5061,5,13,7,10,51,49,2,46
Dungannon,5061,6,11,10,9,51,38,13,43
Coleraine,5061,7,11,8,11,44,41,3,41
Ards,5061,8,11,4,15,37,45,-8,37
Glentoran,5061,9,7,9,14,27,42,-15,30
Portadown,5061,10,7,6,17,27,53,-26,27
Ballinamalla,5061,11,8,2,20,31,61,-30,26
Crusaders,5062,1,17,12,1,61,27,34,63
Cliftonville,5062,2,19,2,9,53,34,19,59
Coleraine,5062,3,12,10,8,51,44,7,46
Linfield,5062,4,11,11,8,55,37,18,44
Ballymena,5062,5,11,10,9,48,54,-6,43
Glenavon,5062,6,10,12,8,44,42,2,42
Dungannon,5062,7,9,11,10,57,51,6,38
Glentoran,5062,8,8,8,14,29,44,-15,32
Ballinamalla,5062,9,8,6,16,32,50,-18,30
Ards,5062,10,7,7,16,36,51,-15,28
Portadown,5062,11,7,3,20,21,53,-32,24
Crusaders,5063,1,18,6,6,60,34,26,60
Cliftonville,5063,2,16,5,9,47,36,11,53
Linfield,5063,3,14,9,7,53,32,21,51
Glenavon,5063,4,14,8,8,58,46,12,50
Coleraine,5063,5,11,9,10,45,42,3,42
Dungannon,5063,6,10,11,9,51,41,10,41
Ballymena,5063,7,12,4,14,56,62,-6,40
Glentoran,5063,8,10,7,13,33,43,-10,37
Ballinamalla,5063,9,8,6,16,29,53,-24,30
Ards,5063,10,8,5,17,37,60,-23,29
Portadown,5063,11,7,4,19,27,47,-20,25
Cliftonville,5064,1,19,5,6,60,33,27,62
Crusaders,5064,2,16,9,5,52,29,23,57
Linfield,5064,3,16,7,7,61,29,32,55
Ballymena,5064,4,13,5,12,53,64,-11,44
Dungannon,5064,5,11,10,9,52,44,8,43
Coleraine,5064,6,10,11,9,36,34,2,41
Glenavon,5064,7,9,9,12,36,41,-5,36
Glentoran,5064,8,9,8,13,33,42,-9,35
Ards,5064,9,10,4,16,41,55,-14,34
Ballinamalla,5064,10,8,5,17,25,47,-22,29
Portadown,5064,11,5,5,20,20,51,-31,20
Linfield,5065,1,14,11,5,53,29,24,53
Crusaders,5065,2,15,7,8,53,32,21,52
Glenavon,5065,3,13,11,6,51,45,6,50
Cliftonville,5065,4,13,9,8,49,33,16,48
Coleraine,5065,5,11,12,7,42,33,9,45
Ballymena,5065,6,13,6,11,57,56,1,45
Dungannon,5065,7,10,10,10,46,36,10,40
Glentoran,5065,8,8,11,11,27,39,-12,35
Ballinamalla,5065,9,9,3,18,26,51,-25,30
Ards,5065,10,8,3,19,32,59,-27,27
Portadown,5065,11,7,5,18,21,44,-23,26
Cliftonville,5066,1,18,4,8,56,33,23,58
Crusaders,5066,2,16,6,8,48,30,18,54
Linfield,5066,3,13,12,5,56,31,25,51
Ballymena,5066,4,13,6,11,62,62,0,45
Glenavon,5066,5,11,10,9,50,51,-1,43
Coleraine,5066,6,11,10,9,43,48,-5,43
Dungannon,5066,7,11,8,11,51,43,8,41
Ards,5066,8,9,7,14,45,54,-9,34
Portadown,5066,9,10,3,17,27,46,-19,33
Glentoran,5066,10,7,10,13,36,50,-14,31
Ballinamalla,5066,11,5,6,19,28,54,-26,21
Linfield,5067,1,16,9,5,66,28,38,57
Cliftonville,5067,2,18,2,10,59,44,15,56
Crusaders,5067,3,16,7,7,55,35,20,55
Coleraine,5067,4,14,10,6,52,35,17,52
Glenavon,5067,5,12,10,8,50,43,7,46
Dungannon,5067,6,10,10,10,53,46,7,40
Ballymena,5067,7,11,5,14,49,68,-19,38
Ards,5067,8,10,4,16,41,51,-10,34
Glentoran,5067,9,8,5,17,30,55,-25,29
Portadown,5067,10,7,5,18,21,45,-24,26
Ballinamalla,5067,11,6,7,17,25,51,-26,25
Cliftonville,5068,1,19,6,5,61,31,30,63
Crusaders,5068,2,15,10,5,61,40,21,55
Ballymena,5068,3,12,9,9,54,54,0,45
Linfield,5068,4,11,11,8,50,33,17,44
Coleraine,5068,5,10,14,6,48,38,10,44
Dungannon,5068,6,11,10,9,54,43,11,43
Glenavon,5068,7,10,10,10,46,53,-7,40
Glentoran,5068,8,10,7,13,32,45,-13,37
Ards,5068,9,10,4,16,35,49,-14,34
Ballinamalla,5068,10,7,2,21,37,62,-25,23
Portadown,5068,11,6,5,19,22,52,-30,23
Cliftonville,5069,1,17,3,10,54,39,15,54
Ballymena,5069,2,17,3,10,67,61,6,54
Crusaders,5069,3,14,8,8,46,37,9,50
Linfield,5069,4,13,10,7,58,33,25,49
Glenavon,5069,5,12,11,7,43,40,3,47
Coleraine,5069,6,11,10,9,45,35,10,43
Ards,5069,7,11,5,14,41,51,-10,38
Glentoran,5069,8,9,8,13,28,39,-11,35
Dungannon,5069,9,9,7,14,43,44,-1,34
Portadown,5069,10,8,4,18,29,51,-22,28
Ballinamalla,5069,11,8,3,19,31,55,-24,27
Crusaders,5070,1,18,6,6,54,28,26,60
Ballymena,5070,2,17,5,8,62,55,7,56
Cliftonville,5070,3,16,5,9,51,40,11,53
Glenavon,5070,4,14,9,7,49,40,9,51
Linfield,5070,5,14,7,9,57,30,27,49
Coleraine,5070,6,11,11,8,43,38,5,44
Dungannon,5070,7,9,9,12,50,47,3,36
Ards,5070,8,8,5,17,35,53,-18,29
Ballinamalla,5070,9,8,5,17,31,54,-23,29
Portadown,5070,10,7,6,17,23,47,-24,27
Glentoran,5070,11,6,6,18,26,49,-23,24
Cliftonville,5071,1,17,8,5,51,29,22,59
Linfield,5071,2,16,9,5,66,28,38,57
Ballymena,5071,3,14,9,7,60,54,6,51
Dungannon,5071,4,12,10,8,48,39,9,46
Crusaders,5071,5,11,11,8,45,36,9,44
Coleraine,5071,6,10,12,8,40,33,7,42
Glenavon,5071,7,8,12,10,40,47,-7,36
Ards,5071,8,8,6,16,40,60,-20,30
Ballinamalla,5071,9,7,7,16,30,51,-21,28
Glentoran,5071,10,6,9,15,26,44,-18,27
Portadown,5071,11,6,7,17,24,49,-25,25
Crusaders,5072,1,16,8,6,60,30,30,56
Linfield,5072,2,15,8,7,64,39,25,53
Ballymena,5072,3,15,8,7,60,57,3,53
Cliftonville,5072,4,13,7,10,48,38,10,46
Dungannon,5072,5,11,10,9,61,43,18,43
Coleraine,5072,6,11,10,9,44,39,5,43
Glenavon,5072,7,10,11,9,49,48,1,41
Portadown,5072,8,11,3,16,31,49,-18,36
Glentoran,5072,9,9,5,16,27,49,-22,32
Ards,5072,10,9,3,18,34,56,-22,30
Ballinamalla,5072,11,7,3,20,26,56,-30,24
Crusaders,5073,1,19,4,7,60,40,20,61
Linfield,5073,2,15,9,6,58,30,28,54
Ballymena,5073,3,15,6,9,60,49,11,51
Coleraine,5073,4,13,9,8,38,35,3,48
Cliftonville,5073,5,14,5,11,49,37,12,47
Glenavon,5073,6,12,9,9,45,47,-2,45
Dungannon,5073,7,11,6,13,50,46,4,39
Glentoran,5073,8,11,6,13,36,46,-10,39
Ards,5073,9,10,3,17,36,50,-14,33
Portadown,5073,10,6,6,18,20,41,-21,24
Ballinamalla,5073,11,6,3,21,34,65,-31,21
Crusaders,5074,1,16,8,6,51,33,18,56
Cliftonville,5074,2,17,4,9,56,40,16,55
Linfield,5074,3,13,12,5,55,29,26,51
Ballymena,5074,4,15,6,9,62,61,1,51
Dungannon,5074,5,12,9,9,53,40,13,45
Coleraine,5074,6,10,12,8,41,37,4,42
Glenavon,5074,7,9,11,10,43,46,-3,38
Glentoran,5074,8,10,7,13,32,45,-13,37
Ballinamalla,5074,9,7,7,16,33,52,-19,28
Ards,5074,10,6,8,16,33,50,-17,26
Portadown,5074,11,5,6,19,20,46,-26,21
Linfield,5075,1,15,10,5,63,35,28,55
Crusaders,5075,2,16,6,8,50,34,16,54
Coleraine,5075,3,14,9,7,43,34,9,51
Cliftonville,5075,4,14,7,9,54,41,13,49
Glenavon,5075,5,12,9,9,46,40,6,45
Ballymena,5075,6,13,5,12,60,57,3,44
Portadown,5075,7,10,5,15,36,49,-13,35
Glentoran,5075,8,8,8,14,31,45,-14,32
Ards,5075,9,8,7,15,33,49,-16,31
Ballinamalla,5075,10,9,4,17,29,49,-20,31
Dungannon,5075,11,6,10,14,35,47,-12,28
Cliftonville,5076,1,17,5,8,53,33,20,56
Linfield,5076,2,14,12,4,59,27,32,54
Crusaders,5076,3,14,9,7,65,47,18,51
Glenavon,5076,4,12,13,5,53,44,9,49
Ballymena,5076,5,13,8,9,58,53,5,47
Coleraine,5076,6,9,12,9,36,36,0,39
Glentoran,5076,7,10,8,12,31,43,-12,38
Dungannon,5076,8,9,7,14,51,48,3,34
Ballinamalla,5076,9,8,5,17,32,57,-25,29
Ards,5076,10,7,7,16,35,50,-15,28
Portadown,5076,11,7,4,19,22,57,-35,25
Cliftonville,5077,1,18,4,8,48,36,12,58
Linfield,5077,2,17,6,7,60,29,31,57
Crusaders,5077,3,16,5,9,61,41,20,53
Coleraine,5077,4,13,10,7,42,35,7,49
Ballymena,5077,5,13,6,11,52,55,-3,45
Glenavon,5077,6,11,9,10,41,38,3,42
Dungannon,5077,7,11,7,12,49,41,8,40
Ards,5077,8,10,4,16,41,47,-6,34
Ballinamalla,5077,9,9,4,17,28,51,-23,31
Glentoran,5077,10,8,6,16,23,47,-24,30
Portadown,5077,11,7,3,20,27,52,-25,24
Crusaders,5078,1,21,5,4,59,26,33,68
Linfield,5078,2,15,8,7,53,31,22,53
Coleraine,5078,3,14,8,8,49,37,12,50
Cliftonville,5078,4,14,5,11,48,40,8,47
Glenavon,5078,5,13,8,9,47,40,7,47
Ballymena,5078,6,12,5,13,57,63,-6,41
Glentoran,5078,7,11,5,14,32,42,-10,38
Dungannon,5078,8,9,8,13,50,52,-2,35
Ards,5078,9,9,6,15,37,45,-8,33
Ballinamalla,5078,10,7,4,19,24,57,-33,25
Portadown,5078,11,6,6,18,25,48,-23,24
Ballymena,5079,1,16,6,8,63,50,13,54
Coleraine,5079,2,13,11,6,57,42,15,50
Crusaders,5079,3,14,8,8,49,36,13,50
Glenavon,5079,4,13,10,7,48,43,5,49
Linfield,5079,5,13,9,8,57,34,23,48
Cliftonville,5079,6,14,4,12,48,44,4,46
Dungannon,5079,7,12,8,10,52,46,6,44
Glentoran,5079,8,10,6,14,29,44,-15,36
Ards,5079,9,9,5,16,36,46,-10,32
Ballinamalla,5079,10,9,2,19,38,61,-23,29
Portadown,5079,11,5,5,20,21,52,-31,20
Crusaders,5080,1,18,6,6,60,29,31,60
Linfield,5080,2,14,12,4,60,30,30,54
Coleraine,5080,3,12,12,6,42,31,11,48
Cliftonville,5080,4,14,6,10,48,39,9,48
Ballymena,5080,5,13,8,9,53,59,-6,47
Dungannon,5080,6,11,8,11,49,43,6,41
Glenavon,5080,7,9,12,9,41,41,0,39
Ards,5080,8,10,6,14,45,49,-4,36
Glentoran,5080,9,6,9,15,24,47,-23,27
Ballinamalla,5080,10,6,7,17,28,55,-27,25
Portadown,5080,11,6,6,18,26,53,-27,24
Linfield,5081,1,16,8,6,58,30,28,56
Crusaders,5081,2,16,7,7,54,32,22,55
Cliftonville,5081,3,14,6,10,48,42,6,48
Coleraine,5081,4,12,10,8,47,38,9,46
Ballymena,5081,5,14,4,12,56,57,-1,46
Glenavon,5081,6,10,13,7,47,45,2,43
Dungannon,5081,7,9,9,12,54,53,1,36
Portadown,5081,8,10,6,14,29,40,-11,36
Ards,5081,9,10,5,15,42,51,-9,35
Ballinamalla,5081,10,7,7,16,32,53,-21,28
Glentoran,5081,11,7,5,18,29,55,-26,26
Crusaders,5082,1,19,6,5,61,36,25,63
Cliftonville,5082,2,17,4,9,51,35,16,55
Linfield,5082,3,14,11,5,56,30,26,53
Ballymena,5082,4,14,8,8,57,53,4,50
Coleraine,5082,5,12,9,9,43,36,7,45
Glenavon,5082,6,10,14,6,46,42,4,44
Dungannon,5082,7,9,10,11,48,45,3,37
Ballinamalla,5082,8,9,4,17,35,51,-16,31
Glentoran,5082,9,8,7,15,28,46,-18,31
Ards,5082,10,7,5,18,34,53,-19,26
Portadown,5082,11,4,6,20,23,55,-32,18
Crusaders,5083,1,19,5,6,56,33,23,62
Linfield,5083,2,14,9,7,56,28,28,51
Cliftonville,5083,3,14,6,10,47,42,5,48
Glenavon,5083,4,12,9,9,44,41,3,45
Coleraine,5083,5,10,14,6,42,36,6,44
Ballymena,5083,6,12,7,11,50,52,-2,43
Glentoran,5083,7,12,5,13,33,43,-10,41
Portadown,5083,8,10,6,14,30,37,-7,36
Dungannon,5083,9,8,11,11,50,50,0,35
Ards,5083,10,7,5,18,33,55,-22,26
Ballinamalla,5083,11,6,5,19,29,53,-24,23
Crusaders,5084,1,19,7,4,53,25,28,64
Cliftonville,5084,2,18,5,7,53,35,18,59
Linfield,5084,3,14,7,9,61,35,26,49
Dungannon,5084,4,14,7,9,60,46,14,49
Coleraine,5084,5,13,10,7,47,37,10,49
Ballymena,5084,6,12,6,12,54,60,-6,42
Glenavon,5084,7,9,8,13,44,51,-7,35
Glentoran,5084,8,9,7,14,31,46,-15,34
Ards,5084,9,8,6,16,35,50,-15,30
Ballinamalla,5084,10,8,4,18,33,57,-24,28
Portadown,5084,11,5,5,20,23,52,-29,20
Crusaders,5085,1,18,7,5,56,34,22,61
Linfield,5085,2,16,9,5,67,31,36,57
Coleraine,5085,3,12,13,5,42,32,10,49
Ballymena,5085,4,13,8,9,62,55,7,47
Cliftonville,5085,5,13,7,10,48,42,6,46
Glenavon,5085,6,12,10,8,46,42,4,46
Dungannon,5085,7,8,12,10,46,41,5,36
Glentoran,5085,8,8,9,13,28,46,-18,33
Portadown,5085,9,7,7,16,23,44,-21,28
Ballinamalla,5085,10,6,7,17,26,54,-28,25
Ards,5085,11,5,5,20,30,53,-23,20
Cliftonville,5086,1,18,5,7,62,34,28,59
Linfield,5086,2,15,9,6,64,30,34,54
Crusaders,5086,3,14,7,9,48,37,11,49
Glenavon,5086,4,12,11,7,49,44,5,47
Ballymena,5086,5,13,7,10,55,59,-4,46
Dungannon,5086,6,10,9,11,54,45,9,39
Ards,5086,7,12,3,15,39,50,-11,39
Glentoran,5086,8,10,7,13,34,44,-10,37
Coleraine,5086,9,8,10,12,36,46,-10,34
Portadown,5086,10,8,7,15,32,51,-19,31
Ballinamalla,5086,11,6,3,21,26,59,-33,21
Linfield,5087,1,17,10,3,61,23,38,61
Crusaders,5087,2,16,6,8,47,31,16,54
Glenavon,5087,3,14,11,5,50,36,14,53
Coleraine,5087,4,13,10,7,45,35,10,49
Cliftonville,5087,5,13,9,8,47,36,11,48
Ballymena,5087,6,12,8,10,51,57,-6,44
Dungannon,5087,7,8,9,13,45,48,-3,33
Ards,5087,8,7,7,16,34,51,-17,28
Portadown,5087,9,6,8,16,26,46,-20,26
Glentoran,5087,10,6,8,16,26,47,-21,26
Ballinamalla,5087,11,6,8,16,26,48,-22,26
Cliftonville,5088,1,19,3,8,57,35,22,60
Linfield,5088,2,14,12,4,60,34,26,54
Crusaders,5088,3,14,6,10,50,39,11,48
Dungannon,5088,4,11,13,6,61,47,14,46
Coleraine,5088,5,11,9,10,45,46,-1,42
Ballymena,5088,6,11,8,11,49,62,-13,41
Glenavon,5088,7,8,12,10,45,49,-4,36
Glentoran,5088,8,9,9,12,36,41,-5,36
Ballinamalla,5088,9,11,3,16,34,46,-12,36
Ards,5088,10,6,8,16,36,54,-18,26
Portadown,5088,11,5,9,16,28,48,-20,24
Linfield,5089,1,18,7,5,64,28,36,61
Crusaders,5089,2,17,9,4,64,36,28,60
Cliftonville,5089,3,16,6,8,56,36,20,54
Ballymena,5089,4,14,8,8,58,55,3,50
Coleraine,5089,5,9,12,9,38,39,-1,39
Glenavon,5089,6,9,12,9,45,47,-2,39
Glentoran,5089,7,9,7,14,33,48,-15,34
Ballinamalla,5089,8,11,1,18,37,55,-18,34
Dungannon,5089,9,6,13,11,47,48,-1,31
Ards,5089,10,7,6,17,32,54,-22,27
Portadown,5089,11,5,7,18,21,49,-28,22
Linfield,5090,1,14,11,5,53,25,28,53
Coleraine,5090,2,14,11,5,48,34,14,53
Crusaders,5090,3,14,8,8,57,41,16,50
Ballymena,5090,4,14,7,9,57,53,4,49
Cliftonville,5090,5,14,5,11,47,37,10,47
Glenavon,5090,6,9,12,9,43,45,-2,39
Glentoran,5090,7,9,12,9,38,45,-7,39
Dungannon,5090,8,10,8,12,48,44,4,38
Ards,5090,9,9,7,14,35,44,-9,34
Portadown,5090,10,7,6,17,24,47,-23,27
Ballinamalla,5090,11,6,3,21,30,65,-35,21
Cliftonville,5091,1,15,5,10,52,37,15,50
Linfield,5091,2,12,13,5,58,30,28,49
Crusaders,5091,3,13,10,7,48,34,14,49
Coleraine,5091,4,12,13,5,42,31,11,49
Ballymena,5091,5,13,9,8,62,61,1,48
Glenavon,5091,6,11,12,7,49,48,1,45
Dungannon,5091,7,10,11,9,53,43,10,41
Ards,5091,8,11,3,16,40,54,-14,36
Portadown,5091,9,8,6,16,31,49,-18,30
Glentoran,5091,10,7,7,16,27,48,-21,28
Ballinamalla,5091,11,5,7,18,29,56,-27,22
Crusaders,5092,1,20,6,4,66,33,33,66
Linfield,5092,2,16,9,5,59,26,33,57
Glenavon,5092,3,13,10,7,52,39,13,49
Cliftonville,5092,4,14,5,11,50,40,10,47
Coleraine,5092,5,11,10,9,36,39,-3,43
Ballymena,5092,6,12,6,12,50,62,-12,42
Glentoran,5092,7,8,10,12,31,39,-8,34
Ards,5092,8,10,3,17,33,45,-12,33
Ballinamalla,5092,9,8,6,16,35,50,-15,30
Dungannon,5092,10,7,7,16,42,53,-11,28
Portadown,5092,11,6,8,16,25,53,-28,26
Crusaders,5093,1,17,7,6,52,33,19,58
Coleraine,5093,2,14,11,5,39,27,12,53
Linfield,5093,3,14,9,7,61,38,23,51
Cliftonville,5093,4,14,5,11,50,50,0,47
Dungannon,5093,5,12,8,10,49,39,10,44
Glenavon,5093,6,10,8,12,40,42,-2,38
Ballymena,5093,7,9,9,12,48,56,-8,36
Portadown,5093,8,10,5,15,33,43,-10,35
Glentoran,5093,9,9,8,13,30,43,-13,35
Ards,5093,10,8,6,16,39,49,-10,30
Ballinamalla,5093,11,7,6,17,35,56,-21,27
Cliftonville,5094,1,16,6,8,54,41,13,54
Crusaders,5094,2,15,7,8,51,33,18,52
Linfield,5094,3,15,6,9,46,26,20,51
Coleraine,5094,4,13,11,6,47,29,18,50
Glenavon,5094,5,12,11,7,49,45,4,47
Ballymena,5094,6,12,7,11,52,52,0,43
Dungannon,5094,7,10,10,10,45,41,4,40
Ballinamalla,5094,8,12,3,15,37,44,-7,39
Portadown,5094,9,8,5,17,23,48,-25,29
Glentoran,5094,10,7,7,16,25,47,-22,28
Ards,5094,11,6,5,19,29,52,-23,23
Ballymena,5095,1,18,5,7,61,53,8,59
Crusaders,5095,2,16,8,6,54,33,21,56
Cliftonville,5095,3,16,6,8,53,33,20,54
Linfield,5095,4,14,10,6,56,27,29,52
Coleraine,5095,5,12,8,10,42,39,3,44
Glenavon,5095,6,8,11,11,41,51,-10,35
Dungannon,5095,7,8,9,13,42,42,0,33
Glentoran,5095,8,8,8,14,33,47,-14,32
Ballinamalla,5095,9,9,5,16,33,49,-16,32
Portadown,5095,10,8,8,14,29,46,-17,32
Ards,5095,11,7,4,19,32,56,-24,25
Crusaders,5096,1,15,10,5,54,37,17,55
Ballymena,5096,2,15,6,9,58,58,0,51
Coleraine,5096,3,14,8,8,48,36,12,50
Dungannon,5096,4,13,10,7,51,37,14,49
Cliftonville,5096,5,14,5,11,50,41,9,47
Linfield,5096,6,12,10,8,56,36,20,46
Glenavon,5096,7,8,12,10,37,44,-7,36
Ballinamalla,5096,8,11,3,16,30,45,-15,36
Ards,5096,9,9,5,16,35,44,-9,32
Glentoran,5096,10,8,5,17,34,50,-16,29
Portadown,5096,11,5,8,17,24,49,-25,23
Cliftonville,5097,1,18,5,7,60,36,24,59
Crusaders,5097,2,16,8,6,55,36,19,56
Linfield,5097,3,16,7,7,64,30,34,55
Dungannon,5097,4,13,8,9,53,40,13,47
Glenavon,5097,5,11,12,7,49,46,3,45
Ballymena,5097,6,13,4,13,54,61,-7,43
Ards,5097,7,12,5,13,45,49,-4,41
Coleraine,5097,8,10,9,11,37,38,-1,39
Glentoran,5097,9,6,9,15,34,52,-18,27
Portadown,5097,10,7,3,20,24,58,-34,24
Ballinamalla,5097,11,6,4,20,31,60,-29,22
Cliftonville,5098,1,17,4,9,50,38,12,55
Linfield,5098,2,15,9,6,56,29,27,54
Crusaders,5098,3,16,6,8,52,33,19,54
Ballymena,5098,4,14,7,9,59,58,1,49
Coleraine,5098,5,13,7,10,50,42,8,46
Dungannon,5098,6,10,10,10,56,43,13,40
Glenavon,5098,7,9,13,8,40,41,-1,40
Glentoran,5098,8,9,6,15,34,50,-16,33
Ards,5098,9,8,7,15,35,48,-13,31
Portadown,5098,10,8,4,18,27,49,-22,28
Ballinamalla,5098,11,8,3,19,26,54,-28,27
Crusaders,5099,1,19,5,6,71,33,38,62
Linfield,5099,2,14,11,5,58,32,26,53
Glenavon,5099,3,14,9,7,47,45,2,51
Cliftonville,5099,4,14,6,10,49,37,12,48
Dungannon,5099,5,11,10,9,54,42,12,43
Ballymena,5099,6,12,7,11,50,57,-7,43
Coleraine,5099,7,11,9,10,41,37,4,42
Glentoran,5099,8,9,11,10,28,35,-7,38
Portadown,5099,9,6,9,15,30,50,-20,27
Ards,5099,10,7,6,17,38,60,-22,27
Ballinamalla,5099,11,5,3,22,24,62,-38,18
Linfield,5100,1,16,9,5,56,27,29,57
Ballymena,5100,2,17,6,7,67,55,12,57
Crusaders,5100,3,14,7,9,56,43,13,49
Glenavon,5100,4,12,11,7,48,40,8,47
Glentoran,5100,5,12,10,8,36,34,2,46
Cliftonville,5100,6,13,5,12,50,39,11,44
Coleraine,5100,7,11,8,11,38,44,-6,41
Ards,5100,8,8,7,15,40,50,-10,31
Ballinamalla,5100,9,7,7,16,26,48,-22,28
Dungannon,5100,10,5,12,13,39,49,-10,27
Portadown,5100,11,6,6,18,23,50,-27,24
Linfield,5101,1,16,7,7,57,28,29,55
Crusaders,5101,2,16,7,7,53,36,17,55
Glenavon,5101,3,14,10,6,53,38,15,52
Ballymena,5101,4,14,8,8,52,52,0,50
Cliftonville,5101,5,13,9,8,52,38,14,48
Coleraine,5101,6,10,12,8,46,40,6,42
Dungannon,5101,7,9,8,13,47,46,1,35
Portadown,5101,8,9,6,15,25,41,-16,33
Ards,5101,9,9,5,16,34,49,-15,32
Glentoran,5101,10,6,8,16,24,48,-24,26
Ballinamalla,5101,11,7,4,19,28,55,-27,25
Crusaders,5102,1,15,8,7,51,33,18,53
Linfield,5102,2,13,13,4,58,27,31,52
Ballymena,5102,3,14,8,8,59,57,2,50
Cliftonville,5102,4,13,9,8,50,41,9,48
Coleraine,5102,5,10,13,7,43,39,4,43
Glenavon,5102,6,8,15,7,43,42,1,39
Dungannon,5102,7,10,8,12,43,40,3,38
Ballinamalla,5102,8,9,8,13,29,43,-14,35
Ards,5102,9,8,6,16,34,47,-13,30
Portadown,5102,10,7,8,15,25,44,-19,29
Glentoran,5102,11,4,12,14,32,54,-22,24
Crusaders,5103,1,16,8,6,62,42,20,56
Linfield,5103,2,15,10,5,63,34,29,55
Cliftonville,5103,3,15,2,13,51,47,4,47
Dungannon,5103,4,11,11,8,54,43,11,44
Ards,5103,5,12,4,14,42,42,0,40
Coleraine,5103,6,10,10,10,40,41,-1,40
Portadown,5103,7,10,6,14,26,36,-10,36
Ballinamalla,5103,8,10,6,14,39,52,-13,36
Glenavon,5103,9,8,10,12,43,55,-12,34
Glentoran,5103,10,8,9,13,32,45,-13,33
Ballymena,5103,11,9,6,15,53,68,-15,33
Crusaders,5104,1,17,8,5,59,35,24,59
Linfield,5104,2,14,8,8,57,31,26,50
Cliftonville,5104,3,14,6,10,50,35,15,48
Glenavon,5104,4,13,9,8,43,38,5,48
Ballymena,5104,5,13,5,12,53,59,-6,44
Coleraine,5104,6,11,10,9,37,41,-4,43
Dungannon,5104,7,10,11,9,51,39,12,41
Ards,5104,8,11,4,15,38,47,-9,37
Portadown,5104,9,9,5,16,25,44,-19,32
Glentoran,5104,10,7,9,14,30,47,-17,30
Ballinamalla,5104,11,6,5,19,24,51,-27,23
Linfield,5105,1,16,9,5,57,27,30,57
Cliftonville,5105,2,17,4,9,62,43,19,55
Coleraine,5105,3,14,10,6,45,35,10,52
Crusaders,5105,4,14,7,9,55,44,11,49
Ballymena,5105,5,14,5,11,51,53,-2,47
Glenavon,5105,6,11,11,8,54,45,9,44
Dungannon,5105,7,9,13,8,53,42,11,40
Ballinamalla,5105,8,10,4,16,34,56,-22,34
Glentoran,5105,9,8,7,15,31,49,-18,31
Portadown,5105,10,5,8,17,21,48,-27,23
Ards,5105,11,6,4,20,28,49,-21,22
Linfield,5106,1,15,8,7,65,38,27,53
Cliftonville,5106,2,16,5,9,55,39,16,53
Coleraine,5106,3,15,7,8,50,35,15,52
Crusaders,5106,4,15,5,10,49,35,14,50
Dungannon,5106,5,12,9,9,55,41,14,45
Glenavon,5106,6,12,9,9,48,46,2,45
Ballymena,5106,7,12,6,12,59,64,-5,42
Ards,5106,8,9,5,16,39,53,-14,32
Glentoran,5106,9,8,7,15,26,48,-22,31
Ballinamalla,5106,10,9,4,17,30,55,-25,31
Portadown,5106,11,7,5,18,26,48,-22,26
Linfield,5107,1,17,7,6,60,30,30,58
Crusaders,5107,2,16,9,5,51,34,17,57
Ballymena,5107,3,14,8,8,56,55,1,50
Cliftonville,5107,4,14,7,9,53,37,16,49
Glenavon,5107,5,12,10,8,53,48,5,46
Dungannon,5107,6,11,10,9,57,41,16,43
Coleraine,5107,7,10,12,8,42,37,5,42
Ards,5107,8,9,6,15,36,45,-9,33
Glentoran,5107,9,8,8,14,24,37,-13,32
Ballinamalla,5107,10,7,2,21,26,58,-32,23
Portadown,5107,11,4,7,19,23,59,-36,19
Crusaders,5108,1,18,5,7,61,39,22,59
Linfield,5108,2,16,9,5,66,29,37,57
Cliftonville,5108,3,17,4,9,61,42,19,55
Ballymena,5108,4,16,5,9,66,58,8,53
Glenavon,5108,5,12,8,10,45,50,-5,44
Dungannon,5108,6,10,9,11,48,39,9,39
Coleraine,5108,7,9,10,11,36,42,-6,37
Glentoran,5108,8,9,5,16,31,50,-19,32
Ards,5108,9,8,6,16,32,47,-15,30
Ballinamalla,5108,10,8,6,16,32,48,-16,30
Portadown,5108,11,7,3,20,25,59,-34,24
Linfield,5109,1,16,10,4,63,33,30,58
Crusaders,5109,2,15,7,8,54,36,18,52
Cliftonville,5109,3,15,3,12,52,44,8,48
Ballymena,5109,4,14,4,12,64,60,4,46
Glenavon,5109,5,11,12,7,46,42,4,45
Dungannon,5109,6,12,7,11,44,43,1,43
Coleraine,5109,7,10,12,8,41,38,3,42
Glentoran,5109,8,10,7,13,32,44,-12,37
Ards,5109,9,9,6,15,37,47,-10,33
Ballinamalla,5109,10,7,5,18,34,55,-21,26
Portadown,5109,11,6,7,17,28,53,-25,25
Crusaders,5110,1,18,7,5,62,32,30,61
Linfield,5110,2,17,8,5,60,28,32,59
Cliftonville,5110,3,16,4,10,52,41,11,52
Glenavon,5110,4,12,8,10,47,45,2,44
Ballymena,5110,5,12,6,12,60,59,1,42
Dungannon,5110,6,9,10,11,52,48,4,37
Coleraine,5110,7,7,13,10,33,39,-6,34
Glentoran,5110,8,8,10,12,24,41,-17,34
Ards,5110,9,9,4,17,36,47,-11,31
Ballinamalla,5110,10,9,4,17,29,53,-24,31
Portadown,5110,11,8,6,16,23,45,-22,30
Crusaders,5111,1,16,7,7,54,36,18,55
Ballymena,5111,2,16,6,8,70,59,11,54
Glenavon,5111,3,12,12,6,50,38,12,48
Linfield,5111,4,12,10,8,48,38,10,46
Cliftonville,5111,5,12,8,10,49,44,5,44
Dungannon,5111,6,11,10,9,58,46,12,43
Coleraine,5111,7,10,11,9,39,35,4,41
Glentoran,5111,8,11,7,12,32,39,-7,40
Ards,5111,9,6,11,13,35,47,-12,29
Portadown,5111,10,7,4,19,25,48,-23,25
Ballinamalla,5111,11,7,4,19,32,62,-30,25
Linfield,5112,1,15,8,7,62,35,27,53
Cliftonville,5112,2,16,4,10,48,32,16,52
Crusaders,5112,3,14,8,8,57,35,22,50
Ballymena,5112,4,14,6,10,55,57,-2,48
Coleraine,5112,5,12,11,7,43,34,9,47
Glentoran,5112,6,12,7,11,40,42,-2,43
Glenavon,5112,7,11,9,10,43,45,-2,42
Ards,5112,8,12,5,13,43,46,-3,41
Dungannon,5112,9,6,12,12,42,50,-8,30
Ballinamalla,5112,10,8,4,18,26,57,-31,28
Portadown,5112,11,4,8,18,20,46,-26,20
Cliftonville,5113,1,17,3,10,57,41,16,54
Crusaders,5113,2,16,4,10,58,44,14,52
Ballymena,5113,3,16,3,11,57,55,2,51
Coleraine,5113,4,14,8,8,50,38,12,50
Linfield,5113,5,13,9,8,55,35,20,48
Ards,5113,6,13,4,13,47,51,-4,43
Dungannon,5113,7,11,8,11,58,45,13,41
Glenavon,5113,8,10,8,12,42,46,-4,38
Glentoran,5113,9,10,7,13,28,41,-13,37
Ballinamalla,5113,10,7,4,19,28,55,-27,25
Portadown,5113,11,7,4,19,29,58,-29,25
Linfield,5114,1,15,9,6,51,25,26,54
Crusaders,5114,2,14,9,7,52,34,18,51
Cliftonville,5114,3,16,2,12,51,42,9,50
Coleraine,5114,4,13,10,7,41,31,10,49
Ballymena,5114,5,13,6,11,54,57,-3,45
Glenavon,5114,6,10,13,7,43,40,3,43
Glentoran,5114,7,9,10,11,29,34,-5,37
Ards,5114,8,9,7,14,33,44,-11,34
Dungannon,5114,9,7,11,12,46,49,-3,32
Ballinamalla,5114,10,8,5,17,28,49,-21,29
Portadown,5114,11,7,6,17,20,43,-23,27
Linfield,5115,1,17,8,5,70,34,36,59
Cliftonville,5115,2,17,5,8,55,39,16,56
Crusaders,5115,3,15,7,8,60,42,18,52
Ballymena,5115,4,15,5,10,60,63,-3,50
Coleraine,5115,5,10,10,10,39,42,-3,40
Glentoran,5115,6,11,6,13,38,47,-9,39
Dungannon,5115,7,9,9,12,54,46,8,36
Ballinamalla,5115,8,10,5,15,32,46,-14,35
Ards,5115,9,9,5,16,40,53,-13,32
Glenavon,5115,10,6,12,12,42,56,-14,30
Portadown,5115,11,8,4,18,28,50,-22,28
Crusaders,5116,1,18,6,6,58,34,24,60
Cliftonville,5116,2,16,4,10,53,39,14,52
Dungannon,5116,3,14,7,9,57,37,20,49
Ballymena,5116,4,15,3,12,58,61,-3,48
Coleraine,5116,5,12,10,8,43,42,1,46
Linfield,5116,6,12,9,9,50,32,18,45
Glenavon,5116,7,10,12,8,43,43,0,42
Glentoran,5116,8,10,6,14,29,40,-11,36
Ards,5116,9,9,5,16,36,46,-10,32
Portadown,5116,10,7,5,18,30,54,-24,26
Ballinamalla,5116,11,7,3,20,32,61,-29,24
Linfield,5117,1,16,9,5,62,31,31,57
Cliftonville,5117,2,17,3,10,52,37,15,54
Dungannon,5117,3,15,7,8,58,42,16,52
Glenavon,5117,4,12,10,8,57,48,9,46
Crusaders,5117,5,12,9,9,52,49,3,45
Ballymena,5117,6,12,5,13,52,60,-8,41
Coleraine,5117,7,10,10,10,42,46,-4,40
Glentoran,5117,8,9,8,13,32,41,-9,35
Ards,5117,9,8,9,13,41,46,-5,33
Ballinamalla,5117,10,8,3,19,37,58,-21,27
Portadown,5117,11,7,5,18,25,52,-27,26
Crusaders,5118,1,19,8,3,60,30,30,65
Cliftonville,5118,2,17,4,9,55,38,17,55
Linfield,5118,3,15,9,6,54,25,29,54
Coleraine,5118,4,13,9,8,44,36,8,48
Ballymena,5118,5,12,6,12,49,57,-8,42
Glenavon,5118,6,11,8,11,46,46,0,41
Ards,5118,7,11,6,13,45,46,-1,39
Dungannon,5118,8,8,10,12,49,47,2,34
Ballinamalla,5118,9,8,4,18,30,54,-24,28
Glentoran,5118,10,6,9,15,22,47,-25,27
Portadown,5118,11,6,5,19,20,48,-28,23
Cliftonville,5119,1,18,5,7,55,28,27,59
Crusaders,5119,2,17,7,6,55,33,22,58
Linfield,5119,3,15,10,5,56,31,25,55
Glenavon,5119,4,12,9,9,49,45,4,45
Ballymena,5119,5,13,6,11,52,52,0,45
Coleraine,5119,6,11,9,10,40,35,5,42
Dungannon,5119,7,10,10,10,49,46,3,40
Ards,5119,8,10,3,17,35,47,-12,33
Glentoran,5119,9,8,8,14,28,45,-17,32
Ballinamalla,5119,10,7,6,17,29,54,-25,27
Portadown,5119,11,3,9,18,17,49,-32,18
Ballymena,5120,1,17,4,9,63,51,12,55
Coleraine,5120,2,15,9,6,49,39,10,54
Linfield,5120,3,15,8,7,66,36,30,53
Cliftonville,5120,4,16,5,9,57,39,18,53
Crusaders,5120,5,15,7,8,54,36,18,52
Glenavon,5120,6,12,10,8,42,36,6,46
Dungannon,5120,7,8,12,10,52,47,5,36
Glentoran,5120,8,9,7,14,30,52,-22,34
Ards,5120,9,9,4,17,37,52,-15,31
Portadown,5120,10,6,7,17,20,45,-25,25
Ballinamalla,5120,11,4,5,21,17,54,-37,17
Linfield,5121,1,18,7,5,64,27,37,61
Crusaders,5121,2,17,8,5,55,28,27,59
Ballymena,5121,3,14,6,10,56,63,-7,48
Cliftonville,5121,4,14,3,13,46,35,11,45
Glenavon,5121,5,10,10,10,44,48,-4,40
Coleraine,5121,6,10,9,11,39,45,-6,39
Glentoran,5121,7,11,6,13,32,44,-12,39
Ballinamalla,5121,8,10,8,12,33,43,-10,38
Dungannon,5121,9,9,9,12,47,40,7,36
Ards,5121,10,7,7,16,38,55,-17,28
Portadown,5121,11,5,7,18,22,48,-26,22
Crusaders,5122,1,15,8,7,60,40,20,53
Cliftonville,5122,2,15,8,7,55,40,15,53
Ballymena,5122,3,16,5,9,62,56,6,53
Linfield,5122,4,14,9,7,53,32,21,51
Glenavon,5122,5,12,11,7,51,47,4,47
Dungannon,5122,6,11,9,10,55,48,7,42
Coleraine,5122,7,10,11,9,39,39,0,41
Ards,5122,8,10,6,14,40,47,-7,36
Glentoran,5122,9,10,6,14,33,44,-11,36
Ballinamalla,5122,10,6,4,20,25,56,-31,22
Portadown,5122,11,3,9,18,20,44,-24,18
Linfield,5123,1,16,9,5,58,32,26,57
Crusaders,5123,2,14,8,8,57,40,17,50
Coleraine,5123,3,12,10,8,52,47,5,46
Cliftonville,5123,4,14,3,13,50,42,8,45
Ballymena,5123,5,12,8,10,56,60,-4,44
Glenavon,5123,6,11,9,10,51,48,3,42
Dungannon,5123,7,10,9,11,57,46,11,39
Glentoran,5123,8,10,8,12,28,36,-8,38
Ards,5123,9,9,6,15,38,54,-16,33
Portadown,5123,10,9,6,15,28,45,-17,33
Ballinamalla,5123,11,7,6,17,31,56,-25,27
Crusaders,5124,1,15,7,8,50,41,9,52
Ballymena,5124,2,15,7,8,58,55,3,52
Coleraine,5124,3,13,11,6,47,30,17,50
Cliftonville,5124,4,14,8,8,52,40,12,50
Linfield,5124,5,13,10,7,57,41,16,49
Glenavon,5124,6,10,9,11,46,47,-1,39
Dungannon,5124,7,9,11,10,49,41,8,38
Ards,5124,8,12,2,16,46,48,-2,38
Glentoran,5124,9,7,9,14,30,48,-18,30
Portadown,5124,10,7,6,17,33,53,-20,27
Ballinamalla,5124,11,7,6,17,34,58,-24,27
Linfield,5125,1,16,9,5,60,23,37,57
Cliftonville,5125,2,17,4,9,52,35,17,55
Ballymena,5125,3,17,3,10,62,60,2,54
Coleraine,5125,4,12,10,8,46,40,6,46
Crusaders,5125,5,13,5,12,52,43,9,44
Glenavon,5125,6,11,10,9,43,43,0,43
Dungannon,5125,7,9,9,12,54,51,3,36
Glentoran,5125,8,7,12,11,26,40,-14,33
Ballinamalla,5125,9,8,7,15,29,47,-18,31
Ards,5125,10,8,6,16,33,51,-18,30
Portadown,5125,11,7,5,18,28,52,-24,26
Linfield,5126,1,17,7,6,69,36,33,58
Crusaders,5126,2,16,7,7,55,34,21,55
Coleraine,5126,3,15,10,5,51,34,17,55
Ballymena,5126,4,15,7,8,68,62,6,52
Cliftonville,5126,5,14,5,11,55,48,7,47
Dungannon,5126,6,11,10,9,52,43,9,43
Glenavon,5126,7,11,10,9,47,51,-4,43
Ards,5126,8,9,5,16,37,51,-14,32
Glentoran,5126,9,7,9,14,31,47,-16,30
Ballinamalla,5126,10,6,6,18,24,48,-24,24
Portadown,5126,11,4,4,22,17,52,-35,16
Cliftonville,5127,1,19,4,7,64,39,25,61
Linfield,5127,2,16,8,6,55,23,32,56
Crusaders,5127,3,14,10,6,60,37,23,52
Ballymena,5127,4,15,6,9,53,46,7,51
Glenavon,5127,5,11,12,7,46,42,4,45
Coleraine,5127,6,11,10,9,44,40,4,43
Dungannon,5127,7,9,8,13,45,54,-9,35
Ballinamalla,5127,8,10,3,17,33,52,-19,33
Glentoran,5127,9,8,7,15,28,46,-18,31
Ards,5127,10,7,5,18,33,55,-22,26
Portadown,5127,11,7,3,20,23,50,-27,24
Crusaders,5128,1,17,6,7,55,35,20,57
Linfield,5128,2,12,12,6,55,35,20,48
Glenavon,5128,3,13,9,8,56,42,14,48
Cliftonville,5128,4,14,6,10,51,42,9,48
Ballymena,5128,5,12,10,8,56,57,-1,46
Dungannon,5128,6,11,8,11,52,45,7,41
Coleraine,5128,7,10,11,9,40,38,2,41
Ards,5128,8,10,4,16,43,49,-6,34
Glentoran,5128,9,8,8,14,24,44,-20,32
Ballinamalla,5128,10,8,6,16,28,52,-24,30
Portadown,5128,11,7,6,17,29,50,-21,27
Crusaders,5129,1,16,13,1,57,23,34,61
Linfield,5129,2,15,11,4,56,23,33,56
Cliftonville,5129,3,15,8,7,46,31,15,53
Dungannon,5129,4,11,11,8,58,47,11,44
Coleraine,5129,5,11,11,8,37,36,1,44
Ballymena,5129,6,12,4,14,49,59,-10,40
Glenavon,5129,7,9,12,9,44,47,-3,39
Glentoran,5129,8,10,9,11,30,37,-7,39
Ards,5129,9,7,7,16,30,44,-14,28
Portadown,5129,10,6,8,16,25,47,-22,26
Ballinamalla,5129,11,4,4,22,21,59,-38,16
Crusaders,5130,1,17,8,5,53,34,19,59
Cliftonville,5130,2,15,6,9,61,44,17,51
Linfield,5130,3,13,8,9,55,33,22,47
Glenavon,5130,4,12,11,7,46,40,6,47
Ballymena,5130,5,13,7,10,59,63,-4,46
Dungannon,5130,6,11,9,10,57,43,14,42
Coleraine,5130,7,10,12,8,44,44,0,42
Ards,5130,8,11,5,14,41,46,-5,38
Portadown,5130,9,7,8,15,27,46,-19,29
Glentoran,5130,10,5,11,14,25,45,-20,26
Ballinamalla,5130,11,5,7,18,23,53,-30,22
Crusaders,5131,1,14,9,7,55,35,20,51
Linfield,5131,2,12,13,5,55,27,28,49
Coleraine,5131,3,11,15,4,38,28,10,48
Ballymena,5131,4,14,5,11,61,62,-1,47
Cliftonville,5131,5,13,7,10,49,39,10,46
Glenavon,5131,6,11,10,9,41,45,-4,43
Dungannon,5131,7,11,9,10,55,50,5,42
Glentoran,5131,8,9,7,14,29,46,-17,34
Ards,5131,9,8,7,15,41,51,-10,31
Portadown,5131,10,7,8,15,26,41,-15,29
Ballinamalla,5131,11,8,4,18,29,55,-26,28
Crusaders,5132,1,18,8,4,56,32,24,62
Linfield,5132,2,17,9,4,59,22,37,60
Cliftonville,5132,3,15,5,10,51,39,12,50
Ballymena,5132,4,13,9,8,53,55,-2,48
Coleraine,5132,5,11,11,8,48,39,9,44
Dungannon,5132,6,11,6,13,48,43,5,39
Glenavon,5132,7,9,9,12,40,50,-10,36
Portadown,5132,8,9,5,16,29,46,-17,32
Ards,5132,9,8,5,17,37,54,-17,29
Glentoran,5132,10,7,8,15,23,43,-20,29
Ballinamalla,5132,11,7,5,18,32,53,-21,26
Cliftonville,5133,1,16,6,8,60,43,17,54
Crusaders,5133,2,16,6,8,59,48,11,54
Dungannon,5133,3,15,7,8,54,40,14,52
Linfield,5133,4,14,9,7,61,37,24,51
Coleraine,5133,5,11,11,8,45,41,4,44
Ballymena,5133,6,11,8,11,60,61,-1,41
Glentoran,5133,7,10,8,12,31,43,-12,38
Glenavon,5133,8,8,11,11,42,47,-5,35
Ards,5133,9,8,7,15,46,56,-10,31
Ballinamalla,5133,10,8,4,18,28,50,-22,28
Portadown,5133,11,7,5,18,30,50,-20,26
Cliftonville,5134,1,18,5,7,55,35,20,59
Crusaders,5134,2,17,7,6,51,30,21,58
Linfield,5134,3,15,9,6,60,31,29,54
Dungannon,5134,4,15,7,8,60,42,18,52
Coleraine,5134,5,12,12,6,44,36,8,48
Ballymena,5134,6,11,8,11,57,56,1,41
Glentoran,5134,7,11,7,12,40,46,-6,40
Glenavon,5134,8,7,10,13,39,57,-18,31
Ards,5134,9,7,8,15,33,49,-16,29
Ballinamalla,5134,10,7,5,18,32,53,-21,26
Portadown,5134,11,3,6,21,15,51,-36,15
Crusaders,5135,1,18,8,4,56,29,27,62
Coleraine,5135,2,13,11,6,43,30,13,50
Cliftonville,5135,3,14,6,10,49,36,13,48
Ballymena,5135,4,13,8,9,51,53,-2,47
Glenavon,5135,5,10,15,5,47,41,6,45
Linfield,5135,6,11,11,8,57,40,17,44
Dungannon,5135,7,10,9,11,47,44,3,39
Ballinamalla,5135,8,8,7,15,37,52,-15,31
Portadown,5135,9,8,5,17,24,40,-16,29
Ards,5135,10,6,8,16,30,51,-21,26
Glentoran,5135,11,6,8,16,28,53,-25,26
Crusaders,5136,1,18,6,6,52,31,21,60
Linfield,5136,2,16,10,4,55,26,29,58
Cliftonville,5136,3,16,6,8,59,37,22,54
Ballymena,5136,4,12,8,10,49,53,-4,44
Dungannon,5136,5,11,8,11,42,36,6,41
Glenavon,5136,6,9,13,8,41,42,-1,40
Coleraine,5136,7,9,11,10,33,35,-2,38
Ballinamalla,5136,8,9,5,16,31,48,-17,32
Glentoran,5136,9,8,7,15,29,49,-20,31
Ards,5136,10,7,8,15,34,48,-14,29
Portadown,5136,11,6,6,18,27,47,-20,24
Linfield,5137,1,16,8,6,57,33,24,56
Crusaders,5137,2,15,6,9,49,40,9,51
Cliftonville,5137,3,13,8,9,49,37,12,47
Dungannon,5137,4,12,9,9,55,40,15,45
Glenavon,5137,5,10,13,7,44,39,5,43
Ballymena,5137,6,10,9,11,57,61,-4,39
Coleraine,5137,7,8,14,8,42,38,4,38
Ards,5137,8,10,5,15,34,45,-11,35
Glentoran,5137,9,9,8,13,27,44,-17,35
Ballinamalla,5137,10,10,3,17,34,52,-18,33
Portadown,5137,11,7,7,16,23,42,-19,28
Crusaders,5138,1,17,8,5,58,32,26,59
Cliftonville,5138,2,16,6,8,56,40,16,54
Linfield,5138,3,14,9,7,61,32,29,51
Coleraine,5138,4,14,9,7,48,34,14,51
Glenavon,5138,5,12,11,7,47,37,10,47
Ballymena,5138,6,11,8,11,50,60,-10,41
Dungannon,5138,7,9,12,9,45,41,4,39
Glentoran,5138,8,8,9,13,33,47,-14,33
Ballinamalla,5138,9,8,3,19,30,60,-30,27
Ards,5138,10,6,8,16,30,48,-18,26
Portadown,5138,11,5,7,18,23,50,-27,22
Crusaders,5139,1,17,4,9,58,43,15,55
Coleraine,5139,2,13,11,6,41,32,9,50
Ballymena,5139,3,15,5,10,58,61,-3,50
Cliftonville,5139,4,14,6,10,52,39,13,48
Linfield,5139,5,13,8,9,58,39,19,47
Glenavon,5139,6,11,10,9,42,41,1,43
Dungannon,5139,7,9,9,12,52,49,3,36
Ards,5139,8,11,3,16,39,45,-6,36
Glentoran,5139,9,9,8,13,33,47,-14,35
Portadown,5139,10,9,4,17,26,42,-16,31
Ballinamalla,5139,11,7,6,17,33,54,-21,27
Linfield,5140,1,17,8,5,62,25,37,59
Crusaders,5140,2,17,7,6,54,31,23,58
Ballymena,5140,3,15,7,8,59,52,7,52
Cliftonville,5140,4,15,4,11,43,40,3,49
Glenavon,5140,5,12,12,6,52,40,12,48
Coleraine,5140,6,9,11,10,38,38,0,38
Dungannon,5140,7,10,7,13,50,51,-1,37
Portadown,5140,8,10,4,16,24,43,-19,34
Ards,5140,9,10,3,17,38,52,-14,33
Glentoran,5140,10,6,8,16,27,48,-21,26
Ballinamalla,5140,11,7,3,20,36,63,-27,24
Crusaders,5141,1,16,7,7,59,43,16,55
Coleraine,5141,2,15,8,7,50,33,17,53
Cliftonville,5141,3,15,5,10,58,44,14,50
Glenavon,5141,4,12,11,7,53,42,11,47
Ballymena,5141,5,11,10,9,49,52,-3,43
Linfield,5141,6,11,9,10,46,37,9,42
Ards,5141,7,11,5,14,38,50,-12,38
Glentoran,5141,8,10,7,13,32,42,-10,37
Dungannon,5141,9,9,9,12,48,44,4,36
Ballinamalla,5141,10,9,3,18,32,51,-19,30
Portadown,5141,11,5,8,17,24,51,-27,23
Crusaders,5142,1,16,7,7,52,31,21,55
Glenavon,5142,2,13,11,6,48,39,9,50
Linfield,5142,3,12,13,5,60,31,29,49
Ballymena,5142,4,15,4,11,57,56,1,49
Coleraine,5142,5,11,15,4,44,33,11,48
Cliftonville,5142,6,13,8,9,49,41,8,47
Dungannon,5142,7,8,10,12,36,37,-1,34
Glentoran,5142,8,8,9,13,30,42,-12,33
Ballinamalla,5142,9,7,7,16,24,50,-26,28
Portadown,5142,10,6,9,15,27,47,-20,27
Ards,5142,11,7,5,18,35,55,-20,26
Linfield,5143,1,15,9,6,63,33,30,54
Crusaders,5143,2,15,8,7,52,39,13,53
Coleraine,5143,3,13,9,8,46,34,12,48
Ballymena,5143,4,13,7,10,60,62,-2,46
Cliftonville,5143,5,12,9,9,47,38,9,45
Glenavon,5143,6,10,11,9,44,45,-1,41
Dungannon,5143,7,10,9,11,49,49,0,39
Glentoran,5143,8,9,8,13,32,40,-8,35
Ards,5143,9,9,4,17,33,47,-14,31
Ballinamalla,5143,10,9,4,17,28,51,-23,31
Portadown,5143,11,8,6,16,32,48,-16,30
Crusaders,5144,1,17,5,8,52,33,19,56
Ballymena,5144,2,16,4,10,68,56,12,52
Cliftonville,5144,3,15,5,10,56,40,16,50
Dungannon,5144,4,13,9,8,53,42,11,48
Linfield,5144,5,12,11,7,55,34,21,47
Glenavon,5144,6,11,10,9,48,45,3,43
Coleraine,5144,7,9,13,8,40,37,3,40
Glentoran,5144,8,8,10,12,30,49,-19,34
Portadown,5144,9,10,3,17,30,49,-19,33
Ards,5144,10,8,7,15,39,48,-9,31
Ballinamalla,5144,11,5,5,20,20,58,-38,20
Linfield,5145,1,16,8,6,59,34,25,56
Cliftonville,5145,2,17,4,9,58,47,11,55
Crusaders,5145,3,16,5,9,60,39,21,53
Glenavon,5145,4,11,11,8,56,53,3,44
Ballymena,5145,5,13,5,12,58,62,-4,44
Coleraine,5145,6,12,7,11,46,42,4,43
Glentoran,5145,7,11,6,13,31,44,-13,39
Portadown,5145,8,9,7,14,29,39,-10,34
Dungannon,5145,9,7,10,13,45,47,-2,31
Ballinamalla,5145,10,8,7,15,28,44,-16,31
Ards,5145,11,8,4,18,35,54,-19,28
Crusaders,5146,1,17,8,5,63,36,27,59
Cliftonville,5146,2,16,5,9,59,41,18,53
Linfield,5146,3,13,8,9,59,43,16,47
Coleraine,5146,4,13,8,9,49,38,11,47
Ballymena,5146,5,12,7,11,49,58,-9,43
Ards,5146,6,11,6,13,39,47,-8,39
Glenavon,5146,7,10,8,12,44,51,-7,38
Ballinamalla,5146,8,11,4,15,34,43,-9,37
Glentoran,5146,9,9,7,14,30,41,-11,34
Dungannon,5146,10,8,9,13,44,47,-3,33
Portadown,5146,11,8,4,18,23,48,-25,28
Crusaders,5147,1,20,8,2,62,26,36,68
Linfield,5147,2,14,9,7,55,28,27,51
Cliftonville,5147,3,13,6,11,53,49,4,45
Glenavon,5147,4,11,12,7,48,46,2,45
Ballymena,5147,5,11,10,9,50,57,-7,43
Coleraine,5147,6,11,9,10,38,36,2,42
Ards,5147,7,12,5,13,37,41,-4,41
Dungannon,5147,8,9,12,9,52,43,9,39
Glentoran,5147,9,6,9,15,26,47,-21,27
Portadown,5147,10,5,10,15,22,43,-21,25
Ballinamalla,5147,11,6,4,20,28,55,-27,22
Ballymena,5148,1,16,7,7,62,54,8,55
Crusaders,5148,2,15,7,8,52,37,15,52
Cliftonville,5148,3,15,5,10,61,48,13,50
Glenavon,5148,4,13,11,6,49,41,8,50
Linfield,5148,5,13,10,7,52,29,23,49
Coleraine,5148,6,11,10,9,39,38,1,43
Dungannon,5148,7,9,8,13,47,46,1,35
Glentoran,5148,8,9,6,15,28,42,-14,33
Portadown,5148,9,8,7,15,26,44,-18,31
Ards,5148,10,7,6,17,36,52,-16,27
Ballinamalla,5148,11,6,9,15,25,46,-21,27
Linfield,5149,1,16,9,5,61,32,29,57
Cliftonville,5149,2,17,4,9,60,33,27,55
Crusaders,5149,3,15,8,7,61,38,23,53
Ballymena,5149,4,15,4,11,55,66,-11,49
Glenavon,5149,5,12,9,9,48,49,-1,45
Coleraine,5149,6,10,10,10,39,39,0,40
Dungannon,5149,7,8,13,9,47,44,3,37
Ards,5149,8,10,4,16,34,44,-10,34
Portadown,5149,9,9,6,15,33,46,-13,33
Glentoran,5149,10,8,8,14,28,49,-21,32
Ballinamalla,5149,11,6,3,21,26,52,-26,21
Crusaders,5150,1,18,9,3,64,35,29,63
Cliftonville,5150,2,15,5,10,57,39,18,50
Glenavon,5150,3,13,9,8,50,43,7,48
Ballymena,5150,4,14,6,10,60,58,2,48
Linfield,5150,5,12,10,8,50,36,14,46
Coleraine,5150,6,12,8,10,46,42,4,44
Dungannon,5150,7,10,10,10,50,42,8,40
Portadown,5150,8,9,6,15,35,53,-18,33
Glentoran,5150,9,7,11,12,28,40,-12,32
Ballinamalla,5150,10,7,4,19,32,54,-22,25
Ards,5150,11,6,6,18,33,63,-30,24
Cliftonville,5151,1,17,4,9,65,39,26,55
Linfield,5151,2,15,9,6,64,37,27,54
Crusaders,5151,3,14,8,8,54,39,15,50
Ballymena,5151,4,15,5,10,65,58,7,50
Glenavon,5151,5,13,11,6,47,41,6,50
Coleraine,5151,6,13,10,7,44,43,1,49
Ards,5151,7,11,4,15,40,52,-12,37
Dungannon,5151,8,7,9,14,37,48,-11,30
Ballinamalla,5151,9,9,3,18,32,47,-15,30
Glentoran,5151,10,7,6,17,28,43,-15,27
Portadown,5151,11,6,7,17,31,60,-29,25
Crusaders,5152,1,17,7,6,57,34,23,58
Linfield,5152,2,14,11,5,59,36,23,53
Ballymena,5152,3,14,8,8,56,55,1,50
Glenavon,5152,4,13,10,7,54,43,11,49
Cliftonville,5152,5,12,9,9,46,34,12,45
Coleraine,5152,6,10,10,10,44,42,2,40
Dungannon,5152,7,10,9,11,50,46,4,39
Portadown,5152,8,9,9,12,28,40,-12,36
Ards,5152,9,8,5,17,30,50,-20,29
Glentoran,5152,10,6,9,15,27,46,-19,27
Ballinamalla,5152,11,7,3,20,31,56,-25,24
Linfield,5153,1,17,7,6,64,31,33,58
Crusaders,5153,2,17,5,8,55,42,13,56
Cliftonville,5153,3,16,4,10,53,36,17,52
Coleraine,5153,4,14,9,7,46,34,12,51
Glenavon,5153,5,11,9,10,49,45,4,42
Ballymena,5153,6,12,6,12,51,61,-10,42
Dungannon,5153,7,9,8,13,57,56,1,35
Ards,5153,8,9,7,14,40,48,-8,34
Ballinamalla,5153,9,10,2,18,34,54,-20,32
Glentoran,5153,10,7,8,15,30,49,-19,29
Portadown,5153,11,8,5,17,22,45,-23,29
Crusaders,5154,1,16,9,5,57,32,25,57
Linfield,5154,2,15,9,6,61,26,35,54
Cliftonville,5154,3,15,5,10,51,38,13,50
Glenavon,5154,4,11,12,7,46,45,1,45
Coleraine,5154,5,10,13,7,40,34,6,43
Ards,5154,6,11,8,11,37,41,-4,41
Ballymena,5154,7,11,7,12,52,56,-4,40
Glentoran,5154,8,8,9,13,27,43,-16,33
Dungannon,5154,9,6,11,13,43,51,-8,29
Ballinamalla,5154,10,7,7,16,26,52,-26,28
Portadown,5154,11,5,10,15,20,42,-22,25
Linfield,5155,1,17,8,5,67,29,38,59
Crusaders,5155,2,13,10,7,48,31,17,49
Coleraine,5155,3,12,12,6,42,38,4,48
Cliftonville,5155,4,13,8,9,48,36,12,47
Glenavon,5155,5,11,11,8,46,38,8,44
Ballymena,5155,6,11,9,10,55,63,-8,42
Ards,5155,7,11,4,15,38,47,-9,37
Dungannon,5155,8,7,13,10,45,46,-1,34
Glentoran,5155,9,8,9,13,33,50,-17,33
Ballinamalla,5155,10,9,6,15,32,49,-17,33
Portadown,5155,11,6,4,20,19,46,-27,22
Linfield,5156,1,14,9,7,56,34,22,51
Crusaders,5156,2,14,8,8,50,39,11,50
Cliftonville,5156,3,13,6,11,49,39,10,45
Glenavon,5156,4,11,12,7,52,44,8,45
Ballymena,5156,5,13,6,11,53,55,-2,45
Coleraine,5156,6,11,10,9,39,40,-1,43
Glentoran,5156,7,10,9,11,32,37,-5,39
Dungannon,5156,8,9,10,11,55,45,10,37
Portadown,5156,9,10,6,14,34,49,-15,36
Ballinamalla,5156,10,8,9,13,34,46,-12,33
Ards,5156,11,5,9,16,31,57,-26,24
Linfield,5157,1,16,10,4,66,33,33,58
Ballymena,5157,2,17,4,9,63,54,9,55
Cliftonville,5157,3,15,4,11,47,43,4,49
Crusaders,5157,4,13,7,10,49,38,11,46
Glenavon,5157,5,12,10,8,50,47,3,46
Dungannon,5157,6,10,7,13,46,47,-1,37
Ballinamalla,5157,7,11,4,15,35,47,-12,37
Coleraine,5157,8,8,11,11,35,39,-4,35
Ards,5157,9,10,5,15,41,48,-7,35
Glentoran,5157,10,9,8,13,29,43,-14,35
Portadown,5157,11,7,4,19,27,49,-22,25
Crusaders,5158,1,16,7,7,61,42,19,55
Linfield,5158,2,15,8,7,58,32,26,53
Cliftonville,5158,3,15,5,10,50,41,9,50
Ballymena,5158,4,13,7,10,63,57,6,46
Glenavon,5158,5,10,12,8,46,48,-2,42
Coleraine,5158,6,10,11,9,43,41,2,41
Dungannon,5158,7,9,11,10,50,45,5,38
Portadown,5158,8,10,6,14,33,46,-13,36
Ards,5158,9,8,9,13,32,44,-12,33
Glentoran,5158,10,7,9,14,29,45,-16,30
Ballinamalla,5158,11,6,7,17,25,49,-24,25
Crusaders,5159,1,17,8,5,52,30,22,59
Ballymena,5159,2,14,8,8,57,49,8,50
Cliftonville,5159,3,14,6,10,46,34,12,48
Coleraine,5159,4,13,9,8,49,41,8,48
Glenavon,5159,5,13,9,8,46,42,4,48
Linfield,5159,6,11,11,8,55,36,19,44
Glentoran,5159,7,10,9,11,37,46,-9,39
Dungannon,5159,8,8,11,11,49,47,2,35
Portadown,5159,9,8,7,15,27,46,-19,31
Ards,5159,10,7,7,16,36,53,-17,28
Ballinamalla,5159,11,5,5,20,25,55,-30,20
Cliftonville,5160,1,18,5,7,54,36,18,59
Linfield,5160,2,16,8,6,72,40,32,56
Dungannon,5160,3,14,7,9,54,41,13,49
Ballymena,5160,4,14,6,10,52,55,-3,48
Crusaders,5160,5,13,7,10,52,39,13,46
Coleraine,5160,6,11,10,9,43,35,8,43
Glenavon,5160,7,10,13,7,40,36,4,43
Glentoran,5160,8,9,9,12,32,46,-14,36
Ards,5160,9,9,5,16,39,55,-16,32
Ballinamalla,5160,10,6,4,20,29,55,-26,22
Portadown,5160,11,5,6,19,21,50,-29,21
Linfield,5161,1,17,8,5,63,22,41,59
Cliftonville,5161,2,15,6,9,65,40,25,51
Coleraine,5161,3,12,13,5,49,37,12,49
Crusaders,5161,4,13,8,9,52,50,2,47
Ballymena,5161,5,13,7,10,53,51,2,46
Glenavon,5161,6,10,13,7,44,41,3,43
Ards,5161,7,11,4,15,41,52,-11,37
Dungannon,5161,8,8,11,11,48,49,-1,35
Glentoran,5161,9,8,6,16,27,47,-20,30
Ballinamalla,5161,10,9,2,19,25,52,-27,29
Portadown,5161,11,8,4,18,23,49,-26,28
Crusaders,5162,1,16,9,5,54,29,25,57
Linfield,5162,2,15,8,7,54,32,22,53
Cliftonville,5162,3,15,7,8,53,37,16,52
Ballymena,5162,4,14,8,8,55,50,5,50
Glenavon,5162,5,10,12,8,40,42,-2,42
Coleraine,5162,6,9,11,10,37,36,1,38
Dungannon,5162,7,9,9,12,52,42,10,36
Portadown,5162,8,9,7,14,25,42,-17,34
Ards,5162,9,9,6,15,33,51,-18,33
Glentoran,5162,10,7,9,14,22,41,-19,30
Ballinamalla,5162,11,6,6,18,26,49,-23,24
Linfield,5163,1,17,8,5,63,33,30,59
Crusaders,5163,2,16,6,8,56,41,15,54
Cliftonville,5163,3,14,6,10,49,39,10,48
Glenavon,5163,4,12,10,8,45,45,0,46
Coleraine,5163,5,12,9,9,48,39,9,45
Ballymena,5163,6,13,6,11,57,62,-5,45
Dungannon,5163,7,11,10,9,55,37,18,43
Ards,5163,8,10,4,16,36,50,-14,34
Portadown,5163,9,9,6,15,29,42,-13,33
Glentoran,5163,10,9,6,15,34,48,-14,33
Ballinamalla,5163,11,4,5,21,25,61,-36,17
Crusaders,5164,1,18,6,6,60,35,25,60
Cliftonville,5164,2,17,3,10,49,30,19,54
Linfield,5164,3,13,11,6,60,39,21,50
Coleraine,5164,4,12,12,6,46,37,9,48
Ballymena,5164,5,12,8,10,61,62,-1,44
Glenavon,5164,6,10,10,10,44,48,-4,40
Ards,5164,7,11,5,14,43,45,-2,38
Dungannon,5164,8,9,9,12,51,53,-2,36
Glentoran,5164,9,9,8,13,36,51,-15,35
Ballinamalla,5164,10,6,7,17,33,59,-26,25
Portadown,5164,11,6,5,19,23,47,-24,23
Crusaders,5165,1,17,6,7,56,39,17,57
Cliftonville,5165,2,16,6,8,56,42,14,54
Linfield,5165,3,14,7,9,60,37,23,49
Ballymena,5165,4,13,10,7,59,53,6,49
Coleraine,5165,5,11,13,6,45,38,7,46
Glenavon,5165,6,9,11,10,44,45,-1,38
Glentoran,5165,7,9,9,12,28,38,-10,36
Dungannon,5165,8,9,8,13,51,51,0,35
Ards,5165,9,9,6,15,37,52,-15,33
Ballinamalla,5165,10,8,6,16,27,45,-18,30
Portadown,5165,11,6,6,18,23,46,-23,24
Linfield,5166,1,17,10,3,61,26,35,61
Cliftonville,5166,2,16,4,10,53,38,15,52
Ballymena,5166,3,15,6,9,57,51,6,51
Crusaders,5166,4,14,8,8,47,33,14,50
Glenavon,5166,5,9,13,8,44,42,2,40
Ards,5166,6,11,7,12,41,46,-5,40
Coleraine,5166,7,8,14,8,34,34,0,38
Glentoran,5166,8,9,10,11,34,44,-10,37
Dungannon,5166,9,7,9,14,44,52,-8,30
Portadown,5166,10,8,4,18,25,47,-22,28
Ballinamalla,5166,11,6,5,19,29,56,-27,23
Crusaders,5167,1,18,8,4,60,30,30,62
Cliftonville,5167,2,17,6,7,61,36,25,57
Linfield,5167,3,12,13,5,60,39,21,49
Ballymena,5167,4,14,6,10,63,62,1,48
Glenavon,5167,5,10,12,8,51,47,4,42
Coleraine,5167,6,7,15,8,38,43,-5,36
Glentoran,5167,7,9,8,13,35,43,-8,35
Ards,5167,8,10,5,15,37,49,-12,35
Dungannon,5167,9,6,10,14,39,52,-13,28
Ballinamalla,5167,10,7,7,16,29,46,-17,28
Portadown,5167,11,6,8,16,26,52,-26,26
Linfield,5168,1,16,10,4,56,24,32,58
Cliftonville,5168,2,18,4,8,61,38,23,58
Crusaders,5168,3,15,8,7,50,36,14,53
Ballymena,5168,4,14,7,9,50,50,0,49
Glenavon,5168,5,12,10,8,49,43,6,46
Coleraine,5168,6,10,10,10,42,42,0,40
Dungannon,5168,7,7,12,11,45,41,4,33
Ards,5168,8,9,6,15,32,45,-13,33
Portadown,5168,9,8,5,17,23,46,-23,29
Glentoran,5168,10,7,7,16,26,48,-22,28
Ballinamalla,5168,11,7,5,18,28,49,-21,26
Linfield,5169,1,16,7,7,69,42,27,55
Cliftonville,5169,2,16,7,7,52,31,21,55
Ballymena,5169,3,14,5,11,53,59,-6,47
Coleraine,5169,4,12,10,8,45,37,8,46
Crusaders,5169,5,11,12,7,46,30,16,45
Dungannon,5169,6,12,8,10,58,44,14,44
Glenavon,5169,7,9,13,8,42,44,-2,40
Ards,5169,8,10,2,18,44,64,-20,32
Glentoran,5169,9,8,7,15,40,51,-11,31
Ballinamalla,5169,10,9,4,17,33,56,-23,31
Portadown,5169,11,8,5,17,26,50,-24,29
Linfield,5170,1,17,8,5,62,32,30,59
Crusaders,5170,2,14,7,9,50,34,16,49
Ballymena,5170,3,14,6,10,60,56,4,48
Cliftonville,5170,4,14,4,12,50,45,5,46
Dungannon,5170,5,12,8,10,55,43,12,44
Coleraine,5170,6,11,11,8,45,41,4,44
Glenavon,5170,7,9,13,8,46,48,-2,40
Ards,5170,8,8,8,14,42,53,-11,32
Portadown,5170,9,9,5,16,30,47,-17,32
Glentoran,5170,10,8,6,16,28,47,-19,30
Ballinamalla,5170,11,8,6,16,31,53,-22,30
Linfield,5171,1,16,8,6,66,34,32,56
Crusaders,5171,2,15,5,10,60,43,17,50
Glenavon,5171,3,13,10,7,49,43,6,49
Ballymena,5171,4,14,7,9,63,59,4,49
Cliftonville,5171,5,13,5,12,51,46,5,44
Coleraine,5171,6,11,10,9,46,40,6,43
Dungannon,5171,7,11,7,12,47,47,0,40
Ards,5171,8,12,3,15,44,47,-3,39
Glentoran,5171,9,10,6,14,30,46,-16,36
Ballinamalla,5171,10,9,3,18,38,63,-25,30
Portadown,5171,11,7,4,19,26,52,-26,25
Crusaders,5172,1,20,6,4,57,23,34,66
Linfield,5172,2,14,9,7,56,32,24,51
Ballymena,5172,3,15,6,9,58,55,3,51
Cliftonville,5172,4,14,4,12,53,46,7,46
Glenavon,5172,5,11,11,8,51,43,8,44
Coleraine,5172,6,11,11,8,42,39,3,44
Dungannon,5172,7,10,8,12,49,45,4,38
Ards,5172,8,10,5,15,36,44,-8,35
Glentoran,5172,9,8,8,14,24,43,-19,32
Ballinamalla,5172,10,9,2,19,30,51,-21,29
Portadown,5172,11,6,4,20,23,58,-35,22
Crusaders,5173,1,16,7,7,60,40,20,55
Glenavon,5173,2,14,9,7,52,44,8,51
Coleraine,5173,3,13,11,6,46,31,15,50
Cliftonville,5173,4,15,5,10,53,40,13,50
Ballymena,5173,5,15,5,10,50,48,2,50
Linfield,5173,6,12,9,9,50,41,9,45
Dungannon,5173,7,11,11,8,52,38,14,44
Glentoran,5173,8,9,8,13,32,44,-12,35
Ballinamalla,5173,9,10,2,18,31,51,-20,32
Ards,5173,10,8,4,18,35,52,-17,28
Portadown,5173,11,3,7,20,19,51,-32,16
Ballymena,5174,1,16,5,9,62,56,6,53
Linfield,5174,2,14,9,7,59,35,24,51
Crusaders,5174,3,15,5,10,52,40,12,50
Cliftonville,5174,4,14,3,13,49,41,8,45
Glenavon,5174,5,11,12,7,39,39,0,45
Coleraine,5174,6,9,13,8,34,34,0,40
Ards,5174,7,12,4,14,40,41,-1,40
Dungannon,5174,8,9,9,12,49,47,2,36
Glentoran,5174,9,9,9,12,30,44,-14,36
Ballinamalla,5174,10,8,6,16,27,45,-18,30
Portadown,5174,11,7,7,16,25,44,-19,28
Crusaders,5175,1,16,7,7,62,47,15,55
Cliftonville,5175,2,16,5,9,63,38,25,53
Linfield,5175,3,14,9,7,65,38,27,51
Glenavon,5175,4,11,11,8,55,49,6,44
Ballymena,5175,5,12,7,11,57,63,-6,43
Dungannon,5175,6,11,9,10,52,46,6,42
Ards,5175,7,13,3,14,44,46,-2,42
Coleraine,5175,8,11,8,11,47,41,6,41
Ballinamalla,5175,9,10,4,16,45,61,-16,34
Glentoran,5175,10,7,9,14,24,46,-22,30
Portadown,5175,11,6,4,20,22,61,-39,22
Cliftonville,5176,1,17,5,8,50,33,17,56
Linfield,5176,2,15,9,6,56,28,28,54
Crusaders,5176,3,16,6,8,52,34,18,54
Ballymena,5176,4,15,6,9,56,54,2,51
Glenavon,5176,5,12,12,6,49,40,9,48
Coleraine,5176,6,11,11,8,45,37,8,44
Dungannon,5176,7,8,11,11,47,45,2,35
Glentoran,5176,8,9,8,13,33,46,-13,35
Ards,5176,9,9,4,17,38,57,-19,31
Portadown,5176,10,6,7,17,23,44,-21,25
Ballinamalla,5176,11,5,5,20,24,55,-31,20
Crusaders,5177,1,22,6,2,63,25,38,72
Cliftonville,5177,2,17,3,10,56,38,18,54
Linfield,5177,3,14,9,7,66,38,28,51
Glenavon,5177,4,13,9,8,56,48,8,48
Ballymena,5177,5,13,8,9,61,64,-3,47
Coleraine,5177,6,9,10,11,39,46,-7,37
Dungannon,5177,7,9,7,14,47,48,-1,34
Ards,5177,8,9,7,14,41,50,-9,34
Glentoran,5177,9,8,9,13,31,42,-11,33
Ballinamalla,5177,10,6,6,18,23,54,-31,24
Portadown,5177,11,5,6,19,21,51,-30,21
Coleraine,5178,1,14,10,6,57,39,18,52
Linfield,5178,2,14,9,7,55,29,26,51
Ballymena,5178,3,15,6,9,61,57,4,51
Crusaders,5178,4,14,8,8,54,40,14,50
Glenavon,5178,5,13,11,6,55,44,11,50
Cliftonville,5178,6,15,4,11,59,51,8,49
Dungannon,5178,7,10,11,9,54,43,11,41
Ards,5178,8,11,4,15,42,47,-5,37
Ballinamalla,5178,9,6,8,16,24,52,-28,26
Glentoran,5178,10,5,9,16,23,49,-26,24
Portadown,5178,11,6,4,20,27,60,-33,22
Crusaders,5179,1,16,8,6,55,33,22,56
Linfield,5179,2,13,10,7,52,37,15,49
Ballymena,5179,3,14,7,9,62,56,6,49
Glenavon,5179,4,12,10,8,51,49,2,46
Cliftonville,5179,5,13,6,11,45,37,8,45
Coleraine,5179,6,10,12,8,42,40,2,42
Ballinamalla,5179,7,10,6,14,35,50,-15,36
Portadown,5179,8,10,5,15,29,39,-10,35
Dungannon,5179,9,9,6,15,49,47,2,33
Ards,5179,10,8,9,13,34,45,-11,33
Glentoran,5179,11,5,11,14,27,48,-21,26
Cliftonville,5180,1,18,6,6,65,38,27,60
Crusaders,5180,2,18,5,7,58,34,24,59
Ballymena,5180,3,16,4,10,68,60,8,52
Linfield,5180,4,12,9,9,49,36,13,45
Glenavon,5180,5,12,8,10,45,44,1,44
Dungannon,5180,6,10,10,10,51,40,11,40
Coleraine,5180,7,10,10,10,37,43,-6,40
Glentoran,5180,8,10,8,12,31,40,-9,38
Portadown,5180,9,9,3,18,28,50,-22,30
Ards,5180,10,7,5,18,32,52,-20,26
Ballinamalla,5180,11,7,4,19,31,58,-27,25
Linfield,5181,1,15,8,7,63,30,33,53
Cliftonville,5181,2,16,5,9,59,39,20,53
Crusaders,5181,3,15,5,10,51,40,11,50
Ballymena,5181,4,15,5,10,58,59,-1,50
Dungannon,5181,5,12,9,9,53,43,10,45
Coleraine,5181,6,9,13,8,41,42,-1,40
Glenavon,5181,7,8,11,11,43,52,-9,35
Ballinamalla,5181,8,10,5,15,40,54,-14,35
Glentoran,5181,9,8,10,12,31,51,-20,34
Ards,5181,10,9,5,16,40,52,-12,32
Portadown,5181,11,7,6,17,31,48,-17,27
Linfield,5182,1,14,10,6,58,34,24,52
Ballymena,5182,2,15,6,9,55,50,5,51
Crusaders,5182,3,14,7,9,52,38,14,49
Glenavon,5182,4,12,13,5,50,40,10,49
Cliftonville,5182,5,15,4,11,52,43,9,49
Dungannon,5182,6,11,9,10,49,43,6,42
Ards,5182,7,11,5,14,40,47,-7,38
Coleraine,5182,8,9,10,11,38,40,-2,37
Glentoran,5182,9,10,7,13,33,40,-7,37
Portadown,5182,10,8,5,17,25,47,-22,29
Ballinamalla,5182,11,5,6,19,27,57,-30,21
Crusaders,5183,1,18,8,4,64,31,33,62
Linfield,5183,2,16,7,7,55,36,19,55
Cliftonville,5183,3,14,4,12,48,42,6,46
Ballymena,5183,4,13,6,11,55,60,-5,45
Dungannon,5183,5,12,7,11,52,39,13,43
Glentoran,5183,6,11,8,11,42,47,-5,41
Coleraine,5183,7,10,10,10,39,37,2,40
Glenavon,5183,8,9,11,10,41,46,-5,38
Ards,5183,9,9,3,18,34,51,-17,30
Ballinamalla,5183,10,9,3,18,30,50,-20,30
Portadown,5183,11,9,3,18,26,47,-21,30
Crusaders,5184,1,17,7,6,52,30,22,58
Coleraine,5184,2,13,12,5,48,30,18,51
Linfield,5184,3,13,11,6,60,33,27,50
Cliftonville,5184,4,14,8,8,56,41,15,50
Ballymena,5184,5,13,8,9,55,57,-2,47
Glentoran,5184,6,10,8,12,31,42,-11,38
Portadown,5184,7,10,5,15,30,46,-16,35
Glenavon,5184,8,7,11,12,37,46,-9,32
Ballinamalla,5184,9,9,5,16,26,47,-21,32
Ards,5184,10,7,8,15,31,44,-13,29
Dungannon,5184,11,6,9,15,37,47,-10,27
Ballymena,5185,1,17,7,6,67,50,17,58
Crusaders,5185,2,16,8,6,57,36,21,56
Linfield,5185,3,13,10,7,56,34,22,49
Cliftonville,5185,4,14,7,9,55,39,16,49
Dungannon,5185,5,13,7,10,58,42,16,46
Coleraine,5185,6,12,8,10,45,38,7,44
Glenavon,5185,7,12,8,10,43,56,-13,44
Glentoran,5185,8,10,7,13,36,50,-14,37
Portadown,5185,9,7,5,18,26,44,-18,26
Ards,5185,10,7,4,19,33,59,-26,25
Ballinamalla,5185,11,7,3,20,35,63,-28,24
Linfield,5186,1,14,9,7,61,35,26,51
Crusaders,5186,2,15,6,9,60,45,15,51
Ballymena,5186,3,14,7,9,60,56,4,49
Cliftonville,5186,4,15,3,12,46,47,-1,48
Coleraine,5186,5,12,9,9,51,44,7,45
Glenavon,5186,6,11,11,8,52,50,2,44
Dungannon,5186,7,10,9,11,46,43,3,39
Ards,5186,8,12,2,16,42,45,-3,38
Portadown,5186,9,10,5,15,30,43,-13,35
Glentoran,5186,10,9,7,14,28,44,-16,34
Ballinamalla,5186,11,8,2,20,30,54,-24,26
Cliftonville,5187,1,19,3,8,54,35,19,60
Linfield,5187,2,16,8,6,57,24,33,56
Ballymena,5187,3,15,4,11,57,66,-9,49
Crusaders,5187,4,14,6,10,52,41,11,48
Glenavon,5187,5,12,10,8,55,46,9,46
Coleraine,5187,6,12,7,11,44,42,2,43
Dungannon,5187,7,10,9,11,52,50,2,39
Glentoran,5187,8,9,9,12,35,45,-10,36
Ards,5187,9,9,4,17,38,50,-12,31
Portadown,5187,10,8,4,18,25,43,-18,28
Ballinamalla,5187,11,7,4,19,25,52,-27,25
Crusaders,5188,1,20,5,5,63,31,32,65
Linfield,5188,2,17,9,4,62,28,34,60
Cliftonville,5188,3,15,5,10,57,43,14,50
Ballymena,5188,4,13,8,9,58,57,1,47
Coleraine,5188,5,11,11,8,42,35,7,44
Dungannon,5188,6,10,9,11,45,44,1,39
Glenavon,5188,7,9,10,11,45,49,-4,37
Ballinamalla,5188,8,10,2,18,41,58,-17,32
Glentoran,5188,9,8,7,15,32,53,-21,31
Ards,5188,10,9,3,18,38,59,-21,30
Portadown,5188,11,7,3,20,22,48,-26,24
Crusaders,5189,1,18,7,5,56,27,29,61
Linfield,5189,2,14,9,7,57,33,24,51
Coleraine,5189,3,13,9,8,39,38,1,48
Cliftonville,5189,4,13,6,11,57,42,15,45
Ballymena,5189,5,13,5,12,56,67,-11,44
Dungannon,5189,6,10,9,11,50,41,9,39
Glenavon,5189,7,8,14,8,42,43,-1,38
Glentoran,5189,8,9,8,13,27,39,-12,35
Ballinamalla,5189,9,9,6,15,33,48,-15,33
Ards,5189,10,7,8,15,34,48,-14,29
Portadown,5189,11,7,7,16,22,47,-25,28
Crusaders,5190,1,16,10,4,54,33,21,58
Linfield,5190,2,14,8,8,59,33,26,50
Cliftonville,5190,3,14,7,9,53,40,13,49
Dungannon,5190,4,13,7,10,58,43,15,46
Ballymena,5190,5,14,3,13,57,61,-4,45
Glenavon,5190,6,10,13,7,52,51,1,43
Coleraine,5190,7,10,12,8,44,37,7,42
Ards,5190,8,11,3,16,34,50,-16,36
Glentoran,5190,9,8,8,14,28,46,-18,32
Portadown,5190,10,7,6,17,26,50,-24,27
Ballinamalla,5190,11,7,5,18,30,51,-21,26
Linfield,5191,1,14,10,6,58,33,25,52
Cliftonville,5191,2,15,5,10,49,37,12,50
Glentoran,5191,3,14,7,9,41,35,6,49
Crusaders,5191,4,14,5,11,48,40,8,47
Glenavon,5191,5,11,11,8,45,43,2,44
Ballymena,5191,6,12,7,11,53,60,-7,43
Ards,5191,7,11,7,12,35,38,-3,40
Coleraine,5191,8,10,9,11,38,41,-3,39
Dungannon,5191,9,7,11,12,48,47,1,32
Portadown,5191,10,8,8,14,32,50,-18,32
Ballinamalla,5191,11,6,6,18,26,49,-23,24
Crusaders,5192,1,16,9,5,54,32,22,57
Linfield,5192,2,15,9,6,63,36,27,54
Cliftonville,5192,3,16,6,8,49,33,16,54
Ballymena,5192,4,13,6,11,59,60,-1,45
Glenavon,5192,5,10,14,6,45,41,4,44
Coleraine,5192,6,9,11,10,37,43,-6,38
Dungannon,5192,7,8,10,12,43,42,1,34
Ballinamalla,5192,8,10,4,16,33,52,-19,34
Glentoran,5192,9,7,12,11,32,45,-13,33
Ards,5192,10,10,2,18,45,53,-8,32
Portadown,5192,11,5,9,16,24,47,-23,24
Crusaders,5193,1,15,9,6,53,34,19,54
Cliftonville,5193,2,16,4,10,56,40,16,52
Coleraine,5193,3,13,11,6,46,38,8,50
Linfield,5193,4,12,10,8,53,32,21,46
Ballymena,5193,5,13,7,10,51,56,-5,46
Glenavon,5193,6,11,11,8,46,46,0,44
Glentoran,5193,7,11,7,12,35,41,-6,40
Dungannon,5193,8,9,11,10,57,48,9,38
Ballinamalla,5193,9,9,5,16,26,49,-23,32
Portadown,5193,10,7,5,18,25,45,-20,26
Ards,5193,11,6,6,18,33,52,-19,24
Coleraine,5194,1,15,10,5,50,33,17,55
Cliftonville,5194,2,16,6,8,52,35,17,54
Linfield,5194,3,14,8,8,58,34,24,50
Crusaders,5194,4,14,6,10,53,40,13,48
Ballymena,5194,5,14,6,10,58,60,-2,48
Glenavon,5194,6,10,12,8,43,45,-2,42
Glentoran,5194,7,9,8,13,31,47,-16,35
Dungannon,5194,8,8,8,14,43,44,-1,32
Portadown,5194,9,7,10,13,28,45,-17,31
Ards,5194,10,8,6,16,41,52,-11,30
Ballinamalla,5194,11,7,6,17,34,56,-22,27
Cliftonville,5195,1,16,4,10,51,40,11,52
Linfield,5195,2,13,11,6,55,37,18,50
Crusaders,5195,3,13,10,7,53,35,18,49
Glenavon,5195,4,12,12,6,55,43,12,48
Dungannon,5195,5,13,8,9,58,50,8,47
Ballymena,5195,6,13,7,10,54,58,-4,46
Glentoran,5195,7,11,6,13,39,46,-7,39
Ards,5195,8,10,8,12,51,50,1,38
Coleraine,5195,9,9,11,10,45,46,-1,38
Ballinamalla,5195,10,6,5,19,29,56,-27,23
Portadown,5195,11,6,4,20,19,48,-29,22
Linfield,5196,1,16,7,7,54,28,26,55
Crusaders,5196,2,16,7,7,59,38,21,55
Ballymena,5196,3,13,9,8,51,53,-2,48
Cliftonville,5196,4,14,5,11,50,39,11,47
Glenavon,5196,5,12,11,7,48,41,7,47
Coleraine,5196,6,11,11,8,40,33,7,44
Dungannon,5196,7,9,9,12,44,42,2,36
Glentoran,5196,8,8,8,14,33,47,-14,32
Portadown,5196,9,8,7,15,28,45,-17,31
Ards,5196,10,7,7,16,32,49,-17,28
Ballinamalla,5196,11,7,7,16,34,58,-24,28
Linfield,5197,1,18,7,5,66,27,39,61
Cliftonville,5197,2,17,6,7,59,35,24,57
Crusaders,5197,3,14,9,7,49,34,15,51
Glenavon,5197,4,13,10,7,51,41,10,49
Coleraine,5197,5,11,13,6,49,35,14,46
Ballymena,5197,6,12,4,14,49,63,-14,40
Glentoran,5197,7,10,7,13,33,49,-16,37
Dungannon,5197,8,9,9,12,43,43,0,36
Ards,5197,9,7,7,16,35,53,-18,28
Ballinamalla,5197,10,8,4,18,25,52,-27,28
Portadown,5197,11,5,6,19,18,45,-27,21
Cliftonville,5198,1,18,5,7,55,34,21,59
Linfield,5198,2,15,11,4,62,30,32,56
Crusaders,5198,3,16,6,8,50,32,18,54
Ballymena,5198,4,15,4,11,58,58,0,49
Coleraine,5198,5,12,9,9,50,39,11,45
Glenavon,5198,6,10,12,8,41,45,-4,42
Dungannon,5198,7,10,7,13,47,47,0,37
Ards,5198,8,10,5,15,45,56,-11,35
Ballinamalla,5198,9,9,5,16,35,50,-15,32
Glentoran,5198,10,8,7,15,25,41,-16,31
Portadown,5198,11,5,3,22,19,55,-36,18
Linfield,5199,1,17,9,4,68,34,34,60
Cliftonville,5199,2,17,6,7,53,39,14,57
Ballymena,5199,3,16,8,6,70,54,16,56
Crusaders,5199,4,16,6,8,55,36,19,54
Glenavon,5199,5,14,10,6,50,41,9,52
Dungannon,5199,6,10,11,9,55,45,10,41
Coleraine,5199,7,9,12,9,38,40,-2,39
Glentoran,5199,8,8,6,16,34,56,-22,30
Ards,5199,9,7,5,18,35,50,-15,26
Portadown,5199,10,6,6,18,23,50,-27,24
Ballinamalla,5199,11,4,3,23,20,56,-36,15
Crusaders,5200,1,18,7,5,57,33,24,61
Linfield,5200,2,13,10,7,58,35,23,49
Cliftonville,5200,3,14,7,9,55,36,19,49
Ballymena,5200,4,13,9,8,61,54,7,48
Glenavon,5200,5,11,13,6,48,42,6,46
Coleraine,5200,6,9,13,8,40,38,2,40
Dungannon,5200,7,10,9,11,46,43,3,39
Glentoran,5200,8,8,8,14,26,48,-22,32
Ards,5200,9,8,6,16,40,56,-16,30
Ballinamalla,5200,10,8,4,18,25,49,-24,28
Portadown,5200,11,6,8,16,21,43,-22,26
Linfield,5201,1,16,8,6,58,30,28,56
Cliftonville,5201,2,16,6,8,55,32,23,54
Crusaders,5201,3,15,8,7,52,30,22,53
Coleraine,5201,4,13,10,7,38,29,9,49
Ballymena,5201,5,14,7,9,54,58,-4,49
Dungannon,5201,6,9,8,13,45,44,1,35
Glenavon,5201,7,8,11,11,43,50,-7,35
Ards,5201,8,10,5,15,35,47,-12,35
Ballinamalla,5201,9,9,4,17,30,55,-25,31
Portadown,5201,10,8,5,17,22,42,-20,29
Glentoran,5201,11,6,10,14,22,37,-15,28
Crusaders,5202,1,17,9,4,56,31,25,60
Ballymena,5202,2,17,6,7,63,48,15,57
Coleraine,5202,3,13,11,6,45,33,12,50
Cliftonville,5202,4,14,7,9,48,33,15,49
Linfield,5202,5,12,9,9,57,40,17,45
Glenavon,5202,6,11,11,8,43,41,2,44
Dungannon,5202,7,9,12,9,50,43,7,39
Glentoran,5202,8,11,5,14,25,43,-18,38
Ards,5202,9,8,4,18,35,55,-20,28
Portadown,5202,10,7,4,19,26,51,-25,25
Ballinamalla,5202,11,5,4,21,22,52,-30,19
Cliftonville,5203,1,18,4,8,65,40,25,58
Linfield,5203,2,15,9,6,56,31,25,54
Crusaders,5203,3,14,9,7,54,35,19,51
Glenavon,5203,4,13,9,8,55,41,14,48
Coleraine,5203,5,12,8,10,43,37,6,44
Ballymena,5203,6,12,7,11,49,56,-7,43
Glentoran,5203,7,9,10,11,36,47,-11,37
Ballinamalla,5203,8,9,6,15,28,50,-22,33
Dungannon,5203,9,6,13,11,48,50,-2,31
Ards,5203,10,8,6,16,30,50,-20,30
Portadown,5203,11,6,5,19,28,55,-27,23
Crusaders,5204,1,17,5,8,65,45,20,56
Cliftonville,5204,2,16,4,10,53,38,15,52
Linfield,5204,3,14,9,7,60,32,28,51
Ballymena,5204,4,15,5,10,57,57,0,50
Glenavon,5204,5,13,10,7,54,47,7,49
Coleraine,5204,6,11,10,9,46,44,2,43
Glentoran,5204,7,11,6,13,32,43,-11,39
Dungannon,5204,8,9,9,12,55,51,4,36
Ards,5204,9,10,4,16,40,51,-11,34
Ballinamalla,5204,10,7,4,19,26,54,-28,25
Portadown,5204,11,5,8,17,30,56,-26,23
Linfield,5205,1,14,12,4,52,24,28,54
Cliftonville,5205,2,16,5,9,53,41,12,53
Crusaders,5205,3,14,7,9,60,39,21,49
Glenavon,5205,4,12,12,6,57,46,11,48
Ballymena,5205,5,13,5,12,51,58,-7,44
Dungannon,5205,6,10,9,11,45,39,6,39
Glentoran,5205,7,9,10,11,31,45,-14,37
Ards,5205,8,9,7,14,38,47,-9,34
Coleraine,5205,9,8,10,12,34,43,-9,34
Portadown,5205,10,8,7,15,23,39,-16,31
Ballinamalla,5205,11,8,4,18,25,48,-23,28
Cliftonville,5206,1,18,4,8,55,36,19,58
Crusaders,5206,2,16,7,7,57,35,22,55
Linfield,5206,3,14,11,5,57,27,30,53
Coleraine,5206,4,12,12,6,43,38,5,48
Ballymena,5206,5,15,3,12,54,57,-3,48
Glenavon,5206,6,13,8,9,57,44,13,47
Glentoran,5206,7,12,6,12,33,38,-5,42
Dungannon,5206,8,8,11,11,45,46,-1,35
Ards,5206,9,8,4,18,38,54,-16,28
Portadown,5206,10,5,8,17,21,50,-29,23
Ballinamalla,5206,11,5,4,21,22,57,-35,19
Crusaders,5207,1,17,9,4,59,33,26,60
Linfield,5207,2,15,9,6,60,30,30,54
Ballymena,5207,3,16,6,8,69,55,14,54
Cliftonville,5207,4,13,6,11,45,40,5,45
Coleraine,5207,5,11,10,9,41,36,5,43
Dungannon,5207,6,8,11,11,46,51,-5,35
Ards,5207,7,9,8,13,35,45,-10,35
Glentoran,5207,8,9,8,13,33,53,-20,35
Glenavon,5207,9,7,13,10,47,53,-6,34
Portadown,5207,10,8,5,17,24,43,-19,29
Ballinamalla,5207,11,7,5,18,29,49,-20,26
Coleraine,5208,1,16,8,6,54,32,22,56
Crusaders,5208,2,14,8,8,49,36,13,50
Ballymena,5208,3,15,5,10,60,60,0,50
Cliftonville,5208,4,14,6,10,57,50,7,48
Glentoran,5208,5,11,9,10,38,45,-7,42
Dungannon,5208,6,11,8,11,51,42,9,41
Linfield,5208,7,10,10,10,53,42,11,40
Glenavon,5208,8,9,12,9,40,41,-1,39
Ards,5208,9,9,7,14,41,48,-7,34
Ballinamalla,5208,10,7,6,17,25,48,-23,27
Portadown,5208,11,7,5,18,23,47,-24,26
Linfield,5209,1,16,6,8,56,34,22,54
Ballymena,5209,2,16,6,8,59,54,5,54
Crusaders,5209,3,14,10,6,51,36,15,52
Glenavon,5209,4,12,10,8,45,41,4,46
Cliftonville,5209,5,13,6,11,48,41,7,45
Coleraine,5209,6,10,11,9,38,32,6,41
Dungannon,5209,7,8,9,13,43,48,-5,33
Ards,5209,8,9,6,15,40,49,-9,33
Ballinamalla,5209,9,8,7,15,33,46,-13,31
Portadown,5209,10,7,9,14,23,35,-12,30
Glentoran,5209,11,6,12,12,23,43,-20,30
Crusaders,5210,1,18,7,5,54,29,25,61
Linfield,5210,2,14,10,6,61,37,24,52
Cliftonville,5210,3,15,7,8,55,37,18,52
Glenavon,5210,4,13,9,8,58,49,9,48
Ballymena,5210,5,13,7,10,52,58,-6,46
Dungannon,5210,6,11,8,11,52,45,7,41
Coleraine,5210,7,11,8,11,38,37,1,41
Glentoran,5210,8,8,10,12,31,45,-14,34
Ards,5210,9,7,7,16,40,50,-10,28
Ballinamalla,5210,10,7,5,18,32,59,-27,26
Portadown,5210,11,5,8,17,25,52,-27,23
Linfield,5211,1,18,7,5,63,29,34,61
Crusaders,5211,2,17,7,6,59,34,25,58
Cliftonville,5211,3,17,4,9,55,37,18,55
Coleraine,5211,4,12,13,5,46,29,17,49
Dungannon,5211,5,10,10,10,48,45,3,40
Glenavon,5211,6,10,10,10,40,46,-6,40
Ballinamalla,5211,7,11,4,15,32,46,-14,37
Ballymena,5211,8,9,7,14,51,65,-14,34
Glentoran,5211,9,9,5,16,28,43,-15,32
Ards,5211,10,8,2,20,37,63,-26,26
Portadown,5211,11,6,7,17,28,50,-22,25
Linfield,5212,1,15,12,3,63,32,31,57
Glenavon,5212,2,15,9,6,58,43,15,54
Crusaders,5212,3,15,8,7,59,36,23,53
Cliftonville,5212,4,15,7,8,49,36,13,52
Dungannon,5212,5,12,10,8,63,47,16,46
Ballymena,5212,6,12,7,11,56,64,-8,43
Coleraine,5212,7,10,12,8,40,36,4,42
Ards,5212,8,10,5,15,41,54,-13,35
Glentoran,5212,9,6,9,15,28,46,-18,27
Portadown,5212,10,5,8,17,24,46,-22,23
Ballinamalla,5212,11,4,5,21,25,66,-41,17
Linfield,5213,1,16,11,3,65,26,39,59
Glenavon,5213,2,13,11,6,46,39,7,50
Crusaders,5213,3,13,10,7,50,39,11,49
Cliftonville,5213,4,12,10,8,47,37,10,46
Ards,5213,5,11,8,11,48,44,4,41
Coleraine,5213,6,10,9,11,40,46,-6,39
Ballymena,5213,7,10,8,12,52,68,-16,38
Dungannon,5213,8,8,9,13,42,41,1,33
Ballinamalla,5213,9,9,5,16,32,50,-18,32
Glentoran,5213,10,7,9,14,29,43,-14,30
Portadown,5213,11,8,6,16,25,43,-18,30
Ballymena,5214,1,17,4,9,55,49,6,55
Cliftonville,5214,2,14,6,10,53,39,14,48
Glenavon,5214,3,13,9,8,51,42,9,48
Linfield,5214,4,12,10,8,53,31,22,46
Crusaders,5214,5,13,6,11,47,39,8,45
Dungannon,5214,6,11,10,9,52,39,13,43
Ballinamalla,5214,7,12,4,14,38,54,-16,40
Coleraine,5214,8,9,12,9,36,36,0,39
Glentoran,5214,9,9,9,12,28,45,-17,36
Ards,5214,10,9,6,15,34,47,-13,33
Portadown,5214,11,5,6,19,19,45,-26,21
Crusaders,5215,1,14,11,5,52,32,20,53
Ballymena,5215,2,16,5,9,58,55,3,53
Cliftonville,5215,3,14,8,8,49,34,15,50
Linfield,5215,4,13,8,9,52,34,18,47
Glenavon,5215,5,10,13,7,48,44,4,43
Coleraine,5215,6,10,12,8,41,36,5,42
Dungannon,5215,7,10,11,9,54,45,9,41
Glentoran,5215,8,8,9,13,34,45,-11,33
Ards,5215,9,9,5,16,30,44,-14,32
Ballinamalla,5215,10,7,6,17,24,50,-26,27
Portadown,5215,11,6,8,16,26,49,-23,26
Cliftonville,5216,1,19,4,7,62,34,28,61
Glenavon,5216,2,13,12,5,49,40,9,51
Crusaders,5216,3,13,9,8,49,34,15,48
Linfield,5216,4,13,8,9,58,40,18,47
Coleraine,5216,5,12,11,7,45,38,7,47
Ballymena,5216,6,13,7,10,64,61,3,46
Ards,5216,7,11,6,13,42,49,-7,39
Dungannon,5216,8,8,9,13,43,49,-6,33
Glentoran,5216,9,8,9,13,34,51,-17,33
Ballinamalla,5216,10,7,4,19,31,55,-24,25
Portadown,5216,11,5,7,18,20,46,-26,22
Cliftonville,5217,1,17,5,8,54,35,19,56
Crusaders,5217,2,16,8,6,52,35,17,56
Ballymena,5217,3,14,6,10,56,57,-1,48
Linfield,5217,4,12,10,8,57,33,24,46
Glenavon,5217,5,12,8,10,52,46,6,44
Coleraine,5217,6,10,12,8,38,38,0,42
Dungannon,5217,7,9,9,12,43,43,0,36
Glentoran,5217,8,8,10,12,32,45,-13,34
Ards,5217,9,8,8,14,36,46,-10,32
Portadown,5217,10,6,10,14,25,43,-18,28
Ballinamalla,5217,11,6,8,16,30,54,-24,26
Cliftonville,5218,1,18,7,5,53,28,25,61
Linfield,5218,2,16,8,6,62,29,33,56
Crusaders,5218,3,14,9,7,48,33,15,51
Ballymena,5218,4,13,7,10,53,52,1,46
Dungannon,5218,5,12,7,11,47,40,7,43
Coleraine,5218,6,10,13,7,43,39,4,43
Glenavon,5218,7,9,8,13,48,56,-8,35
Ards,5218,8,9,5,16,34,51,-17,32
Ballinamalla,5218,9,10,2,18,30,47,-17,32
Glentoran,5218,10,9,4,17,34,49,-15,31
Portadown,5218,11,7,6,17,23,51,-28,27
Linfield,5219,1,17,8,5,69,36,33,59
Coleraine,5219,2,13,12,5,41,29,12,51
Cliftonville,5219,3,14,7,9,58,44,14,49
Crusaders,5219,4,14,6,10,53,42,11,48
Glenavon,5219,5,12,11,7,52,41,11,47
Glentoran,5219,6,12,7,11,42,50,-8,43
Dungannon,5219,7,11,9,10,58,39,19,42
Ballymena,5219,8,11,7,12,53,65,-12,40
Ballinamalla,5219,9,8,3,19,33,61,-28,27
Portadown,5219,10,7,5,18,27,53,-26,26
Ards,5219,11,5,7,18,33,59,-26,22
Linfield,5220,1,14,10,6,59,32,27,52
Glenavon,5220,2,14,8,8,58,45,13,50
Crusaders,5220,3,14,7,9,50,42,8,49
Ballymena,5220,4,13,7,10,57,59,-2,46
Cliftonville,5220,5,12,8,10,50,40,10,44
Coleraine,5220,6,11,9,10,36,34,2,42
Ards,5220,7,12,4,14,42,49,-7,40
Dungannon,5220,8,9,10,11,47,46,1,37
Glentoran,5220,9,9,9,12,33,40,-7,36
Portadown,5220,10,8,6,16,32,50,-18,30
Ballinamalla,5220,11,7,6,17,32,59,-27,27
Crusaders,5221,1,19,4,7,60,33,27,61
Cliftonville,5221,2,18,4,8,57,40,17,58
Coleraine,5221,3,14,8,8,41,33,8,50
Ballymena,5221,4,14,6,10,59,58,1,48
Linfield,5221,5,12,7,11,58,41,17,43
Dungannon,5221,6,9,10,11,41,39,2,37
Glenavon,5221,7,8,13,9,41,46,-5,37
Portadown,5221,8,10,5,15,34,47,-13,35
Ards,5221,9,9,5,16,36,52,-16,32
Glentoran,5221,10,7,8,15,30,52,-22,29
Ballinamalla,5221,11,8,4,18,34,50,-16,28
Crusaders,5222,1,17,5,8,55,37,18,56
Glenavon,5222,2,14,10,6,49,35,14,52
Ballymena,5222,3,15,7,8,63,55,8,52
Linfield,5222,4,13,9,8,60,38,22,48
Cliftonville,5222,5,14,2,14,45,45,0,44
Ards,5222,6,12,5,13,47,49,-2,41
Coleraine,5222,7,9,12,9,40,37,3,39
Dungannon,5222,8,10,8,12,46,43,3,38
Glentoran,5222,9,9,9,12,29,46,-17,36
Ballinamalla,5222,10,10,3,17,36,52,-16,33
Portadown,5222,11,6,2,22,21,54,-33,20
Ballymena,5223,1,18,3,9,68,49,19,57
Crusaders,5223,2,14,12,4,53,30,23,54
Linfield,5223,3,15,7,8,65,35,30,52
Glenavon,5223,4,13,8,9,48,47,1,47
Cliftonville,5223,5,12,8,10,48,39,9,44
Coleraine,5223,6,11,7,12,41,49,-8,40
Ards,5223,7,12,3,15,40,47,-7,39
Dungannon,5223,8,10,8,12,44,44,0,38
Glentoran,5223,9,10,8,12,35,46,-11,38
Portadown,5223,10,6,7,17,28,57,-29,25
Ballinamalla,5223,11,7,3,20,27,54,-27,24
Crusaders,5224,1,18,8,4,57,28,29,62
Cliftonville,5224,2,16,4,10,54,39,15,52
Linfield,5224,3,14,9,7,61,34,27,51
Ballymena,5224,4,15,5,10,62,56,6,50
Glenavon,5224,5,12,11,7,48,42,6,47
Dungannon,5224,6,11,9,10,53,43,10,42
Coleraine,5224,7,10,12,8,42,39,3,42
Glentoran,5224,8,7,9,14,28,47,-19,30
Ballinamalla,5224,9,8,4,18,28,57,-29,28
Ards,5224,10,5,9,16,31,54,-23,24
Portadown,5224,11,6,6,18,24,49,-25,24
Cliftonville,5225,1,19,2,9,61,37,24,59
Crusaders,5225,2,17,5,8,62,42,20,56
Linfield,5225,3,15,8,7,61,32,29,53
Ballymena,5225,4,15,4,11,58,60,-2,49
Glenavon,5225,5,12,11,7,49,40,9,47
Coleraine,5225,6,12,8,10,43,42,1,44
Dungannon,5225,7,10,9,11,57,54,3,39
Ards,5225,8,9,5,16,40,51,-11,32
Ballinamalla,5225,9,9,4,17,32,51,-19,31
Glentoran,5225,10,7,9,14,29,50,-21,30
Portadown,5225,11,5,5,20,20,53,-33,20
Crusaders,5226,1,17,8,5,59,37,22,59
Ballymena,5226,2,16,5,9,77,58,19,53
Linfield,5226,3,14,10,6,59,38,21,52
Coleraine,5226,4,14,9,7,48,39,9,51
Cliftonville,5226,5,14,6,10,60,48,12,48
Glenavon,5226,6,10,11,9,44,50,-6,41
Dungannon,5226,7,9,13,8,48,40,8,40
Ballinamalla,5226,8,11,4,15,40,52,-12,37
Glentoran,5226,9,7,8,15,25,47,-22,29
Ards,5226,10,7,7,16,36,52,-16,28
Portadown,5226,11,4,3,23,20,55,-35,15
Crusaders,5227,1,18,5,7,62,34,28,59
Glenavon,5227,2,16,9,5,50,34,16,57
Cliftonville,5227,3,16,5,9,58,40,18,53
Linfield,5227,4,13,11,6,55,34,21,50
Ballymena,5227,5,14,6,10,56,57,-1,48
Coleraine,5227,6,9,10,11,35,38,-3,37
Glentoran,5227,7,8,8,14,33,49,-16,32
Dungannon,5227,8,7,10,13,48,50,-2,31
Ards,5227,9,8,7,15,28,43,-15,31
Portadown,5227,10,8,6,16,26,49,-23,30
Ballinamalla,5227,11,7,5,18,29,52,-23,26
Linfield,5228,1,14,10,6,60,33,27,52
Coleraine,5228,2,14,10,6,47,32,15,52
Crusaders,5228,3,14,9,7,52,36,16,51
Cliftonville,5228,4,14,7,9,46,39,7,49
Ballymena,5228,5,13,5,12,62,59,3,44
Glenavon,5228,6,11,10,9,44,42,2,43
Dungannon,5228,7,10,8,12,46,42,4,38
Glentoran,5228,8,10,7,13,31,44,-13,37
Ards,5228,9,8,6,16,38,53,-15,30
Portadown,5228,10,8,6,16,27,50,-23,30
Ballinamalla,5228,11,7,6,17,27,50,-23,27
Cliftonville,5229,1,17,7,6,59,35,24,58
Linfield,5229,2,15,8,7,53,27,26,53
Crusaders,5229,3,13,10,7,50,31,19,49
Ballymena,5229,4,14,6,10,63,58,5,48
Coleraine,5229,5,12,9,9,38,42,-4,45
Glenavon,5229,6,10,14,6,45,37,8,44
Dungannon,5229,7,11,9,10,50,43,7,42
Ballinamalla,5229,8,9,5,16,29,50,-21,32
Ards,5229,9,9,3,18,31,46,-15,30
Glentoran,5229,10,7,9,14,25,45,-20,30
Portadown,5229,11,4,8,18,21,50,-29,20
Cliftonville,5230,1,18,5,7,57,34,23,59
Crusaders,5230,2,17,7,6,58,38,20,58
Linfield,5230,3,16,9,5,53,25,28,57
Ballymena,5230,4,14,5,11,51,54,-3,47
Coleraine,5230,5,10,14,6,41,33,8,44
Glenavon,5230,6,8,14,8,45,48,-3,38
Ards,5230,7,10,5,15,37,47,-10,35
Portadown,5230,8,9,5,16,24,41,-17,32
Dungannon,5230,9,7,8,15,45,51,-6,29
Ballinamalla,5230,10,7,6,17,30,49,-19,27
Glentoran,5230,11,7,6,17,29,50,-21,27
Cliftonville,5231,1,18,3,9,50,36,14,57
Crusaders,5231,2,16,7,7,59,34,25,55
Linfield,5231,3,15,9,6,56,27,29,54
Dungannon,5231,4,11,12,7,54,39,15,45
Coleraine,5231,5,11,10,9,43,38,5,43
Ballymena,5231,6,11,7,12,55,62,-7,40
Ards,5231,7,10,8,12,38,50,-12,38
Glenavon,5231,8,9,8,13,44,58,-14,35
Glentoran,5231,9,9,4,17,31,44,-13,31
Ballinamalla,5231,10,8,7,15,32,48,-16,31
Portadown,5231,11,5,9,16,24,50,-26,24
Crusaders,5232,1,15,6,9,52,38,14,51
Linfield,5232,2,14,8,8,54,34,20,50
Cliftonville,5232,3,15,5,10,59,47,12,50
Glenavon,5232,4,13,11,6,54,46,8,50
Ballymena,5232,5,13,7,10,63,57,6,46
Coleraine,5232,6,9,11,10,36,37,-1,38
Glentoran,5232,7,9,9,12,33,44,-11,36
Dungannon,5232,8,8,10,12,49,50,-1,34
Portadown,5232,9,8,9,13,24,39,-15,33
Ards,5232,10,9,5,16,38,50,-12,32
Ballinamalla,5232,11,9,5,16,35,55,-20,32
Crusaders,5233,1,19,6,5,60,34,26,63
Ballymena,5233,2,15,5,10,57,58,-1,50
Dungannon,5233,3,13,9,8,57,39,18,48
Cliftonville,5233,4,13,7,10,49,44,5,46
Coleraine,5233,5,12,10,8,42,40,2,46
Linfield,5233,6,11,12,7,52,34,18,45
Glenavon,5233,7,7,14,9,44,47,-3,35
Ards,5233,8,10,4,16,42,53,-11,34
Glentoran,5233,9,8,8,14,35,48,-13,32
Ballinamalla,5233,10,8,4,18,28,51,-23,28
Portadown,5233,11,6,7,17,28,46,-18,25
Crusaders,5234,1,16,9,5,54,28,26,57
Linfield,5234,2,15,8,7,59,36,23,53
Coleraine,5234,3,13,9,8,38,31,7,48
Cliftonville,5234,4,14,4,12,45,39,6,46
Glenavon,5234,5,11,11,8,42,42,0,44
Ballymena,5234,6,10,12,8,53,54,-1,42
Dungannon,5234,7,10,9,11,53,47,6,39
Glentoran,5234,8,9,9,12,24,36,-12,36
Ballinamalla,5234,9,9,5,16,35,53,-18,32
Ards,5234,10,8,7,15,34,49,-15,31
Portadown,5234,11,4,9,17,22,44,-22,21
Crusaders,5235,1,19,7,4,67,29,38,64
Linfield,5235,2,16,9,5,68,45,23,57
Cliftonville,5235,3,17,3,10,62,48,14,54
Ballymena,5235,4,14,5,11,60,63,-3,47
Coleraine,5235,5,10,11,9,45,43,2,41
Dungannon,5235,6,9,13,8,51,43,8,40
Glenavon,5235,7,8,13,9,40,45,-5,37
Ards,5235,8,9,3,18,35,49,-14,30
Glentoran,5235,9,8,6,16,30,50,-20,30
Ballinamalla,5235,10,7,8,15,28,48,-20,29
Portadown,5235,11,7,4,19,28,51,-23,25
Crusaders,5236,1,17,8,5,56,30,26,59
Ballymena,5236,2,17,3,10,57,60,-3,54
Cliftonville,5236,3,16,5,9,61,40,21,53
Coleraine,5236,4,13,9,8,50,39,11,48
Linfield,5236,5,12,11,7,60,32,28,47
Dungannon,5236,6,10,10,10,47,42,5,40
Glenavon,5236,7,9,10,11,44,48,-4,37
Ards,5236,8,9,5,16,41,56,-15,32
Portadown,5236,9,9,4,17,25,53,-28,31
Glentoran,5236,10,7,7,16,25,44,-19,28
Ballinamalla,5236,11,7,6,17,27,49,-22,27
Crusaders,5237,1,18,7,5,59,33,26,61
Linfield,5237,2,13,10,7,54,34,20,49
Coleraine,5237,3,14,7,9,51,40,11,49
Ballymena,5237,4,13,9,8,62,55,7,48
Cliftonville,5237,5,14,4,12,52,47,5,46
Dungannon,5237,6,10,11,9,51,40,11,41
Ards,5237,7,12,5,13,35,42,-7,41
Glenavon,5237,8,8,15,7,43,47,-4,39
Glentoran,5237,9,7,9,14,25,44,-19,30
Portadown,5237,10,7,5,18,24,45,-21,26
Ballinamalla,5237,11,6,4,20,32,61,-29,22
Crusaders,5238,1,18,8,4,61,29,32,62
Linfield,5238,2,16,10,4,60,27,33,58
Ballymena,5238,3,14,6,10,58,60,-2,48
Cliftonville,5238,4,13,7,10,44,38,6,46
Dungannon,5238,5,9,12,9,44,36,8,39
Portadown,5238,6,11,6,13,28,34,-6,39
Coleraine,5238,7,8,12,10,37,43,-6,36
Glenavon,5238,8,8,12,10,42,49,-7,36
Glentoran,5238,9,7,9,14,28,42,-14,30
Ballinamalla,5238,10,6,10,14,28,47,-19,28
Ards,5238,11,6,6,18,26,51,-25,24
Crusaders,5239,1,17,7,6,55,29,26,58
Cliftonville,5239,2,17,3,10,47,34,13,54
Linfield,5239,3,14,10,6,54,30,24,52
Dungannon,5239,4,14,8,8,52,41,11,50
Coleraine,5239,5,13,10,7,44,38,6,49
Ballymena,5239,6,14,7,9,61,56,5,49
Ballinamalla,5239,7,10,4,16,34,51,-17,34
Ards,5239,8,9,3,18,42,55,-13,30
Glentoran,5239,9,7,9,14,33,48,-15,30
Glenavon,5239,10,6,9,15,37,53,-16,27
Portadown,5239,11,7,4,19,27,51,-24,25
Crusaders,5240,1,16,7,7,58,33,25,55
Glenavon,5240,2,15,10,5,57,46,11,55
Cliftonville,5240,3,15,7,8,53,39,14,52
Linfield,5240,4,13,11,6,62,36,26,50
Ballymena,5240,5,13,5,12,63,64,-1,44
Dungannon,5240,6,11,10,9,50,43,7,43
Coleraine,5240,7,9,14,7,42,40,2,41
Ards,5240,8,8,5,17,35,49,-14,29
Ballinamalla,5240,9,8,5,17,32,51,-19,29
Glentoran,5240,10,6,11,13,24,49,-25,29
Portadown,5240,11,5,7,18,21,47,-26,22
Crusaders,5241,1,18,8,4,59,29,30,62
Linfield,5241,2,15,9,6,61,32,29,54
Cliftonville,5241,3,14,6,10,47,36,11,48
Glenavon,5241,4,13,9,8,46,45,1,48
Ballymena,5241,5,11,8,11,52,57,-5,41
Coleraine,5241,6,9,12,9,39,38,1,39
Ards,5241,7,11,6,13,39,44,-5,39
Dungannon,5241,8,10,8,12,49,48,1,38
Portadown,5241,9,7,8,15,24,48,-24,29
Glentoran,5241,10,6,9,15,30,47,-17,27
Ballinamalla,5241,11,6,7,17,30,52,-22,25
Linfield,5242,1,15,9,6,55,26,29,54
Crusaders,5242,2,14,9,7,55,35,20,51
Ballymena,5242,3,14,7,9,55,53,2,49
Dungannon,5242,4,12,10,8,51,40,11,46
Coleraine,5242,5,12,10,8,43,35,8,46
Cliftonville,5242,6,13,5,12,48,46,2,44
Glenavon,5242,7,10,11,9,43,47,-4,41
Glentoran,5242,8,10,6,14,36,48,-12,36
Portadown,5242,9,10,4,16,27,47,-20,34
Ballinamalla,5242,10,7,7,16,30,49,-19,28
Ards,5242,11,6,6,18,31,48,-17,24
Crusaders,5243,1,17,8,5,59,35,24,59
Linfield,5243,2,16,9,5,65,31,34,57
Cliftonville,5243,3,16,4,10,52,38,14,52
Ballymena,5243,4,15,5,10,61,55,6,50
Dungannon,5243,5,11,9,10,48,43,5,42
Coleraine,5243,6,10,11,9,36,37,-1,41
Glenavon,5243,7,9,10,11,46,53,-7,37
Glentoran,5243,8,10,7,13,39,47,-8,37
Ballinamalla,5243,9,10,6,14,34,46,-12,36
Ards,5243,10,7,5,18,30,51,-21,26
Portadown,5243,11,4,6,20,17,51,-34,18
Linfield,5244,1,15,12,3,63,26,37,57
Cliftonville,5244,2,17,6,7,59,43,16,57
Crusaders,5244,3,13,8,9,51,40,11,47
Ballymena,5244,4,13,8,9,58,61,-3,47
Coleraine,5244,5,12,8,10,47,39,8,44
Glenavon,5244,6,11,11,8,45,41,4,44
Dungannon,5244,7,11,8,11,58,48,10,41
Ballinamalla,5244,8,9,4,17,27,50,-23,31
Ards,5244,9,7,9,14,37,50,-13,30
Glentoran,5244,10,5,10,15,27,47,-20,25
Portadown,5244,11,5,10,15,22,49,-27,25
Linfield,5245,1,18,7,5,63,26,37,61
Crusaders,5245,2,17,6,7,54,33,21,57
Glenavon,5245,3,15,9,6,50,38,12,54
Ballymena,5245,4,14,6,10,61,64,-3,48
Cliftonville,5245,5,13,4,13,49,40,9,43
Coleraine,5245,6,10,10,10,44,41,3,40
Dungannon,5245,7,9,11,10,44,41,3,38
Ards,5245,8,10,8,12,40,44,-4,38
Ballinamalla,5245,9,8,5,17,32,56,-24,29
Glentoran,5245,10,6,9,15,29,50,-21,27
Portadown,5245,11,4,7,19,22,55,-33,19
Crusaders,5246,1,18,7,5,63,32,31,61
Linfield,5246,2,14,9,7,54,30,24,51
Ballymena,5246,3,15,5,10,60,58,2,50
Cliftonville,5246,4,14,5,11,54,43,11,47
Glenavon,5246,5,11,9,10,50,46,4,42
Coleraine,5246,6,11,9,10,42,43,-1,42
Dungannon,5246,7,10,10,10,47,42,5,40
Glentoran,5246,8,8,14,8,31,35,-4,38
Ards,5246,9,9,6,15,43,57,-14,33
Portadown,5246,10,8,3,19,26,54,-28,27
Ballinamalla,5246,11,5,7,18,23,53,-30,22
Crusaders,5247,1,19,6,5,53,32,21,63
Linfield,5247,2,13,12,5,67,41,26,51
Coleraine,5247,3,13,11,6,44,34,10,50
Cliftonville,5247,4,14,4,12,45,39,6,46
Glenavon,5247,5,10,12,8,45,43,2,42
Ballymena,5247,6,12,5,13,55,62,-7,41
Glentoran,5247,7,10,9,11,34,38,-4,39
Dungannon,5247,8,9,7,14,49,45,4,34
Portadown,5247,9,10,3,17,37,54,-17,33
Ards,5247,10,8,6,16,37,51,-14,30
Ballinamalla,5247,11,7,5,18,26,53,-27,26
Crusaders,5248,1,15,7,8,55,36,19,52
Ballymena,5248,2,15,6,9,64,53,11,51
Coleraine,5248,3,12,14,4,42,28,14,50
Glenavon,5248,4,11,14,5,54,42,12,47
Cliftonville,5248,5,14,5,11,49,42,7,47
Linfield,5248,6,13,7,10,57,43,14,46
Dungannon,5248,7,10,9,11,47,44,3,39
Glentoran,5248,8,10,9,11,31,40,-9,39
Ards,5248,9,9,5,16,38,51,-13,32
Portadown,5248,10,8,4,18,32,58,-26,28
Ballinamalla,5248,11,5,6,19,24,56,-32,21
Glenavon,5249,1,14,11,5,49,37,12,53
Cliftonville,5249,2,15,6,9,54,40,14,51
Linfield,5249,3,12,12,6,61,36,25,48
Crusaders,5249,4,13,9,8,49,39,10,48
Coleraine,5249,5,12,11,7,43,31,12,47
Ballymena,5249,6,13,7,10,58,57,1,46
Ards,5249,7,10,6,14,34,43,-9,36
Glentoran,5249,8,7,11,12,25,43,-18,32
Portadown,5249,9,8,7,15,32,50,-18,31
Dungannon,5249,10,7,9,14,44,50,-6,30
Ballinamalla,5249,11,6,7,17,31,54,-23,25
Crusaders,5250,1,18,8,4,55,28,27,62
Ballymena,5250,2,15,4,11,59,53,6,49
Linfield,5250,3,13,8,9,53,35,18,47
Cliftonville,5250,4,14,4,12,52,40,12,46
Glenavon,5250,5,10,12,8,45,39,6,42
Coleraine,5250,6,10,11,9,36,40,-4,41
Dungannon,5250,7,8,12,10,42,40,2,36
Portadown,5250,8,10,5,15,24,41,-17,35
Glentoran,5250,9,8,9,13,31,47,-16,33
Ards,5250,10,8,8,14,36,47,-11,32
Ballinamalla,5250,11,7,7,16,29,52,-23,28
Linfield,5251,1,15,8,7,58,30,28,53
Crusaders,5251,2,13,10,7,48,33,15,49
Cliftonville,5251,3,14,6,10,49,40,9,48
Ballymena,5251,4,14,6,10,53,55,-2,48
Coleraine,5251,5,12,11,7,45,40,5,47
Glenavon,5251,6,11,12,7,49,43,6,45
Dungannon,5251,7,9,10,11,51,46,5,37
Glentoran,5251,8,9,10,11,36,41,-5,37
Ballinamalla,5251,9,9,5,16,31,50,-19,32
Ards,5251,10,9,4,17,36,56,-20,31
Portadown,5251,11,5,8,17,28,50,-22,23
Linfield,5252,1,16,9,5,60,30,30,57
Cliftonville,5252,2,17,4,9,61,46,15,55
Ballymena,5252,3,15,5,10,68,55,13,50
Glenavon,5252,4,14,8,8,54,45,9,50
Crusaders,5252,5,14,5,11,55,44,11,47
Coleraine,5252,6,12,9,9,45,36,9,45
Dungannon,5252,7,11,7,12,44,43,1,40
Ards,5252,8,9,5,16,38,50,-12,32
Glentoran,5252,9,8,6,16,34,56,-22,30
Portadown,5252,10,8,5,17,25,50,-25,29
Ballinamalla,5252,11,8,3,19,28,57,-29,27
Cliftonville,5253,1,18,6,6,57,33,24,60
Linfield,5253,2,15,10,5,53,27,26,55
Crusaders,5253,3,15,7,8,54,36,18,52
Glenavon,5253,4,11,14,5,50,42,8,47
Ballymena,5253,5,13,8,9,61,55,6,47
Coleraine,5253,6,8,15,7,38,45,-7,39
Ards,5253,7,10,6,14,41,46,-5,36
Dungannon,5253,8,7,11,12,45,41,4,32
Ballinamalla,5253,9,8,5,17,28,53,-25,29
Portadown,5253,10,7,5,18,24,49,-25,26
Glentoran,5253,11,5,9,16,24,48,-24,24
Cliftonville,5254,1,18,5,7,62,35,27,59
Crusaders,5254,2,18,5,7,54,33,21,59
Linfield,5254,3,16,7,7,58,31,27,55
Glenavon,5254,4,14,10,6,56,42,14,52
Ballymena,5254,5,12,7,11,57,64,-7,43
Dungannon,5254,6,10,10,10,45,39,6,40
Coleraine,5254,7,9,11,10,39,45,-6,38
Glentoran,5254,8,9,6,15,27,43,-16,33
Ballinamalla,5254,9,9,3,18,32,54,-22,30
Ards,5254,10,7,6,17,35,54,-19,27
Portadown,5254,11,5,6,19,22,47,-25,21
Crusaders,5255,1,17,9,4,49,26,23,60
Ballymena,5255,2,18,5,7,66,52,14,59
Linfield,5255,3,13,11,6,55,31,24,50
Coleraine,5255,4,12,9,9,46,36,10,45
Cliftonville,5255,5,12,8,10,44,38,6,44
Glenavon,5255,6,10,12,8,44,40,4,42
Dungannon,5255,7,10,8,12,44,43,1,38
Glentoran,5255,8,10,7,13,29,45,-16,37
Portadown,5255,9,7,8,15,23,41,-18,29
Ballinamalla,5255,10,6,6,18,25,47,-22,24
Ards,5255,11,6,5,19,29,55,-26,23
Crusaders,5256,1,18,7,5,59,26,33,61
Cliftonville,5256,2,17,5,8,59,42,17,56
Linfield,5256,3,15,9,6,62,34,28,54
Ballymena,5256,4,12,9,9,48,49,-1,45
Dungannon,5256,5,11,11,8,52,39,13,44
Coleraine,5256,6,10,12,8,41,34,7,42
Glenavon,5256,7,9,13,8,47,44,3,40
Ards,5256,8,9,6,15,38,53,-15,33
Glentoran,5256,9,8,7,15,27,48,-21,31
Ballinamalla,5256,10,5,7,18,28,57,-29,22
Portadown,5256,11,5,6,19,18,53,-35,21
Crusaders,5257,1,19,8,3,60,33,27,65
Linfield,5257,2,15,11,4,69,31,38,56
Coleraine,5257,3,13,10,7,45,37,8,49
Glenavon,5257,4,11,11,8,51,42,9,44
Cliftonville,5257,5,12,6,12,56,49,7,42
Glentoran,5257,6,10,9,11,39,49,-10,39
Ballymena,5257,7,10,7,13,55,65,-10,37
Dungannon,5257,8,8,10,12,55,51,4,34
Ards,5257,9,9,5,16,38,52,-14,32
Ballinamalla,5257,10,7,6,17,28,61,-33,27
Portadown,5257,11,7,5,18,25,51,-26,26
Crusaders,5258,1,19,7,4,56,26,30,64
Ballymena,5258,2,15,7,8,64,58,6,52
Cliftonville,5258,3,15,6,9,51,36,15,51
Linfield,5258,4,14,8,8,52,35,17,50
Glenavon,5258,5,13,11,6,51,39,12,50
Coleraine,5258,6,11,11,8,40,38,2,44
Glentoran,5258,7,8,7,15,29,44,-15,31
Portadown,5258,8,8,6,16,30,56,-26,30
Ballinamalla,5258,9,8,5,17,30,46,-16,29
Dungannon,5258,10,6,10,14,44,48,-4,28
Ards,5258,11,6,6,18,35,56,-21,24
Linfield,5259,1,14,12,4,56,30,26,54
Ballymena,5259,2,15,6,9,65,61,4,51
Crusaders,5259,3,13,9,8,56,40,16,48
Coleraine,5259,4,11,13,6,53,43,10,46
Cliftonville,5259,5,12,9,9,53,42,11,45
Glenavon,5259,6,11,9,10,48,43,5,42
Glentoran,5259,7,10,8,12,31,40,-9,38
Dungannon,5259,8,7,13,10,52,52,0,34
Ards,5259,9,9,6,15,40,51,-11,33
Portadown,5259,10,8,7,15,26,49,-23,31
Ballinamalla,5259,11,6,6,18,29,58,-29,24
Cliftonville,5260,1,17,5,8,49,30,19,56
Linfield,5260,2,14,9,7,60,35,25,51
Crusaders,5260,3,15,4,11,54,45,9,49
Ballymena,5260,4,14,6,10,62,62,0,48
Glenavon,5260,5,10,12,8,41,41,0,42
Ballinamalla,5260,6,12,4,14,37,47,-10,40
Dungannon,5260,7,9,11,10,55,50,5,38
Ards,5260,8,11,4,15,47,50,-3,37
Coleraine,5260,9,8,12,10,35,40,-5,36
Glentoran,5260,10,10,6,14,28,41,-13,36
Portadown,5260,11,7,3,20,20,47,-27,24
Linfield,5261,1,16,10,4,59,24,35,58
Crusaders,5261,2,15,7,8,53,32,21,52
Cliftonville,5261,3,16,4,10,56,38,18,52
Ballymena,5261,4,15,7,8,59,56,3,52
Glenavon,5261,5,13,9,8,48,41,7,48
Coleraine,5261,6,11,11,8,41,40,1,44
Dungannon,5261,7,9,11,10,49,47,2,38
Ards,5261,8,9,3,18,36,49,-13,30
Portadown,5261,9,8,6,16,25,47,-22,30
Ballinamalla,5261,10,8,3,19,26,48,-22,27
Glentoran,5261,11,7,5,18,28,58,-30,26
Crusaders,5262,1,17,5,8,54,33,21,56
Linfield,5262,2,16,6,8,66,35,31,54
Cliftonville,5262,3,15,5,10,52,37,15,50
Glenavon,5262,4,13,9,8,48,46,2,48
Ballymena,5262,5,14,5,11,63,66,-3,47
Coleraine,5262,6,12,10,8,43,35,8,46
Dungannon,5262,7,9,9,12,51,46,5,36
Ards,5262,8,11,3,16,41,60,-19,36
Ballinamalla,5262,9,10,2,18,36,59,-23,32
Portadown,5262,10,9,4,17,35,52,-17,31
Glentoran,5262,11,6,8,16,25,45,-20,26
Linfield,5263,1,16,7,7,58,33,25,55
Coleraine,5263,2,14,10,6,49,34,15,52
Ballymena,5263,3,15,5,10,52,50,2,50
Crusaders,5263,4,13,8,9,48,32,16,47
Cliftonville,5263,5,14,5,11,46,42,4,47
Glenavon,5263,6,11,13,6,50,44,6,46
Dungannon,5263,7,11,9,10,49,42,7,42
Glentoran,5263,8,11,8,11,32,36,-4,41
Portadown,5263,9,10,6,14,26,36,-10,36
Ards,5263,10,6,4,20,30,56,-26,22
Ballinamalla,5263,11,4,5,21,19,54,-35,17
Crusaders,5264,1,19,4,7,51,32,19,61
Cliftonville,5264,2,16,3,11,49,35,14,51
Ballymena,5264,3,15,4,11,59,56,3,49
Linfield,5264,4,13,9,8,64,34,30,48
Coleraine,5264,5,12,9,9,38,37,1,45
Glentoran,5264,6,11,8,11,28,38,-10,41
Dungannon,5264,7,9,10,11,47,49,-2,37
Glenavon,5264,8,8,13,9,46,48,-2,37
Ards,5264,9,8,7,15,39,51,-12,31
Portadown,5264,10,8,6,16,25,44,-19,30
Ballinamalla,5264,11,7,5,18,32,54,-22,26
Crusaders,5265,1,15,9,6,53,35,18,54
Linfield,5265,2,13,11,6,60,33,27,50
Dungannon,5265,3,14,8,8,52,32,20,50
Coleraine,5265,4,11,12,7,48,40,8,45
Glenavon,5265,5,11,12,7,44,43,1,45
Ballymena,5265,6,13,4,13,62,59,3,43
Cliftonville,5265,7,11,7,12,50,49,1,40
Ards,5265,8,9,7,14,36,49,-13,34
Glentoran,5265,9,8,9,13,27,42,-15,33
Ballinamalla,5265,10,9,3,18,32,54,-22,30
Portadown,5265,11,8,4,18,27,55,-28,28
Crusaders,5266,1,18,7,5,55,26,29,61
Glenavon,5266,2,13,10,7,52,47,5,49
Cliftonville,5266,3,15,3,12,53,42,11,48
Coleraine,5266,4,11,12,7,44,37,7,45
Glentoran,5266,5,12,6,12,40,38,2,42
Ballymena,5266,6,12,6,12,52,58,-6,42
Dungannon,5266,7,11,8,11,50,44,6,41
Linfield,5266,8,11,6,13,54,46,8,39
Portadown,5266,9,10,6,14,26,38,-12,36
Ards,5266,10,9,5,16,36,50,-14,32
Ballinamalla,5266,11,8,1,21,28,64,-36,25
Crusaders,5267,1,18,7,5,54,31,23,61
Coleraine,5267,2,16,11,3,47,25,22,59
Cliftonville,5267,3,14,7,9,48,40,8,49
Linfield,5267,4,11,11,8,51,39,12,44
Ards,5267,5,12,8,10,49,40,9,44
Ballymena,5267,6,12,7,11,51,52,-1,43
Glenavon,5267,7,8,12,10,41,48,-7,36
Glentoran,5267,8,9,8,13,29,38,-9,35
Dungannon,5267,9,7,10,13,43,46,-3,31
Portadown,5267,10,6,8,16,24,47,-23,26
Ballinamalla,5267,11,6,3,21,29,60,-31,21
Crusaders,5268,1,17,6,7,54,32,22,57
Cliftonville,5268,2,15,7,8,47,35,12,52
Dungannon,5268,3,13,9,8,58,38,20,48
Ballymena,5268,4,13,9,8,60,54,6,48
Linfield,5268,5,12,9,9,52,36,16,45
Glenavon,5268,6,11,9,10,47,45,2,42
Coleraine,5268,7,11,8,11,38,42,-4,41
Ards,5268,8,12,4,14,44,44,0,40
Glentoran,5268,9,8,9,13,32,45,-13,33
Portadown,5268,10,8,5,17,26,47,-21,29
Ballinamalla,5268,11,6,3,21,25,65,-40,21
Linfield,5269,1,17,8,5,69,35,34,59
Crusaders,5269,2,17,7,6,57,31,26,58
Cliftonville,5269,3,17,5,8,57,39,18,56
Ballymena,5269,4,15,6,9,64,61,3,51
Glenavon,5269,5,14,8,8,56,48,8,50
Coleraine,5269,6,10,12,8,38,37,1,42
Ards,5269,7,10,6,14,45,52,-7,36
Dungannon,5269,8,7,10,13,46,48,-2,31
Glentoran,5269,9,6,10,14,35,49,-14,28
Portadown,5269,10,7,4,19,20,51,-31,25
Ballinamalla,5269,11,5,4,21,29,65,-36,19
Crusaders,5270,1,18,8,4,59,37,22,62
Cliftonville,5270,2,16,5,9,56,39,17,53
Linfield,5270,3,14,10,6,64,33,31,52
Ballymena,5270,4,13,7,10,60,58,2,46
Coleraine,5270,5,11,11,8,45,42,3,44
Glentoran,5270,6,12,6,12,39,41,-2,42
Glenavon,5270,7,8,14,8,44,43,1,38
Ards,5270,8,11,4,15,42,51,-9,37
Dungannon,5270,9,6,12,12,46,54,-8,30
Portadown,5270,10,8,4,18,26,47,-21,28
Ballinamalla,5270,11,5,5,20,31,67,-36,20
Ballymena,5271,1,17,6,7,67,52,15,57
Linfield,5271,2,15,9,6,51,26,25,54
Glenavon,5271,3,13,10,7,52,44,8,49
Cliftonville,5271,4,13,6,11,54,40,14,45
Crusaders,5271,5,12,9,9,51,46,5,45
Coleraine,5271,6,11,10,9,43,45,-2,43
Dungannon,5271,7,10,9,11,54,48,6,39
Glentoran,5271,8,9,6,15,28,43,-15,33
Ards,5271,9,9,4,17,40,52,-12,31
Ballinamalla,5271,10,8,7,15,32,51,-19,31
Portadown,5271,11,8,4,18,24,49,-25,28
Crusaders,5272,1,16,6,8,56,40,16,54
Cliftonville,5272,2,16,4,10,56,38,18,52
Linfield,5272,3,14,9,7,61,32,29,51
Ballymena,5272,4,13,8,9,56,53,3,47
Dungannon,5272,5,12,9,9,46,38,8,45
Coleraine,5272,6,12,8,10,41,40,1,44
Ards,5272,7,10,5,15,37,45,-8,35
Portadown,5272,8,10,5,15,29,48,-19,35
Glentoran,5272,9,8,10,12,31,44,-13,34
Glenavon,5272,10,8,9,13,42,45,-3,33
Ballinamalla,5272,11,7,5,18,24,56,-32,26
Crusaders,5273,1,16,7,7,58,39,19,55
Glenavon,5273,2,15,9,6,55,43,12,54
Linfield,5273,3,15,8,7,62,30,32,53
Cliftonville,5273,4,12,7,11,49,45,4,43
Ballymena,5273,5,12,7,11,55,62,-7,43
Dungannon,5273,6,11,9,10,56,47,9,42
Glentoran,5273,7,11,8,11,32,43,-11,41
Ards,5273,8,10,9,11,40,44,-4,39
Coleraine,5273,9,9,10,11,37,43,-6,37
Portadown,5273,10,8,3,19,25,46,-21,27
Ballinamalla,5273,11,6,3,21,29,56,-27,21
Crusaders,5274,1,19,6,5,59,30,29,63
Linfield,5274,2,18,7,5,62,30,32,61
Ballymena,5274,3,15,6,9,62,54,8,51
Cliftonville,5274,4,15,4,11,57,46,11,49
Coleraine,5274,5,11,11,8,47,38,9,44
Dungannon,5274,6,12,7,11,58,47,11,43
Glenavon,5274,7,9,8,13,40,50,-10,35
Ards,5274,8,10,3,17,38,56,-18,33
Glentoran,5274,9,8,6,16,27,47,-20,30
Portadown,5274,10,7,6,17,25,48,-23,27
Ballinamalla,5274,11,7,4,19,30,59,-29,25
Linfield,5275,1,16,8,6,63,34,29,56
Crusaders,5275,2,13,12,5,54,36,18,51
Cliftonville,5275,3,14,8,8,50,37,13,50
Ballymena,5275,4,14,8,8,58,52,6,50
Coleraine,5275,5,12,12,6,41,30,11,48
Dungannon,5275,6,11,8,11,48,44,4,41
Glenavon,5275,7,8,13,9,50,50,0,37
Ards,5275,8,10,3,17,40,55,-15,33
Glentoran,5275,9,7,9,14,25,43,-18,30
Ballinamalla,5275,10,8,6,16,34,53,-19,30
Portadown,5275,11,6,5,19,20,49,-29,23
Crusaders,5276,1,17,6,7,53,33,20,57
Linfield,5276,2,15,8,7,60,31,29,53
Glenavon,5276,3,13,12,5,45,37,8,51
Cliftonville,5276,4,14,5,11,48,42,6,47
Dungannon,5276,5,11,9,10,44,35,9,42
Coleraine,5276,6,10,12,8,37,30,7,42
Ballymena,5276,7,11,7,12,53,59,-6,40
Ards,5276,8,9,7,14,33,44,-11,34
Glentoran,5276,9,7,10,13,30,40,-10,31
Ballinamalla,5276,10,7,6,17,27,51,-24,27
Portadown,5276,11,6,8,16,23,51,-28,26
Linfield,5277,1,16,10,4,62,28,34,58
Crusaders,5277,2,16,7,7,59,43,16,55
Cliftonville,5277,3,15,7,8,54,34,20,52
Ballymena,5277,4,15,5,10,61,58,3,50
Glenavon,5277,5,13,10,7,48,43,5,49
Ards,5277,6,12,4,14,36,45,-9,40
Coleraine,5277,7,9,9,12,36,40,-4,36
Dungannon,5277,8,8,8,14,45,48,-3,32
Glentoran,5277,9,8,8,14,31,43,-12,32
Ballinamalla,5277,10,9,2,19,30,53,-23,29
Portadown,5277,11,7,4,19,24,51,-27,25
Crusaders,5278,1,18,6,6,59,36,23,60
Linfield,5278,2,15,7,8,56,33,23,52
Cliftonville,5278,3,14,6,10,57,42,15,48
Ballymena,5278,4,14,4,12,54,62,-8,46
Coleraine,5278,5,11,11,8,46,45,1,44
Glenavon,5278,6,9,13,8,50,43,7,40
Dungannon,5278,7,9,10,11,49,45,4,37
Glentoran,5278,8,10,7,13,38,51,-13,37
Ballinamalla,5278,9,11,2,17,34,52,-18,35
Ards,5278,10,9,6,15,32,40,-8,33
Portadown,5278,11,7,4,19,26,52,-26,25
Crusaders,5279,1,19,6,5,53,27,26,63
Cliftonville,5279,2,16,3,11,54,43,11,51
Linfield,5279,3,14,8,8,54,31,23,50
Coleraine,5279,4,12,10,8,41,35,6,46
Ballymena,5279,5,13,4,13,54,57,-3,43
Glenavon,5279,6,11,9,10,45,41,4,42
Dungannon,5279,7,9,10,11,51,49,2,37
Ballinamalla,5279,8,11,4,15,32,46,-14,37
Glentoran,5279,9,8,7,15,27,44,-17,31
Ards,5279,10,7,9,14,33,46,-13,30
Portadown,5279,11,7,6,17,24,49,-25,27
Linfield,5280,1,15,9,6,62,29,33,54
Crusaders,5280,2,15,8,7,58,34,24,53
Ballymena,5280,3,15,8,7,57,52,5,53
Coleraine,5280,4,13,10,7,51,35,16,49
Glentoran,5280,5,12,8,10,38,40,-2,44
Glenavon,5280,6,12,8,10,47,51,-4,44
Cliftonville,5280,7,12,6,12,46,45,1,42
Dungannon,5280,8,7,12,11,42,47,-5,33
Ards,5280,9,9,4,17,39,51,-12,31
Portadown,5280,10,6,7,17,24,55,-31,25
Ballinamalla,5280,11,6,6,18,26,51,-25,24
Crusaders,5281,1,17,9,4,58,31,27,60
Linfield,5281,2,14,10,6,58,31,27,52
Cliftonville,5281,3,15,6,9,53,40,13,51
Ballymena,5281,4,14,8,8,66,55,11,50
Glenavon,5281,5,11,11,8,46,49,-3,44
Coleraine,5281,6,8,13,9,40,43,-3,37
Dungannon,5281,7,9,9,12,44,43,1,36
Ards,5281,8,9,6,15,47,51,-4,33
Glentoran,5281,9,8,8,14,42,54,-12,32
Portadown,5281,10,8,6,16,30,46,-16,30
Ballinamalla,5281,11,8,2,20,24,65,-41,26
Glenavon,5282,1,15,9,6,59,40,19,54
Crusaders,5282,2,15,7,8,48,41,7,52
Linfield,5282,3,12,12,6,55,33,22,48
Cliftonville,5282,4,13,7,10,58,41,17,46
Ballymena,5282,5,12,9,9,56,56,0,45
Coleraine,5282,6,11,11,8,35,38,-3,44
Dungannon,5282,7,11,8,11,53,41,12,41
Ards,5282,8,9,7,14,34,44,-10,34
Glentoran,5282,9,9,7,14,25,42,-17,34
Ballinamalla,5282,10,8,4,18,30,54,-24,28
Portadown,5282,11,7,5,18,25,48,-23,26
Crusaders,5283,1,18,7,5,68,40,28,61
Cliftonville,5283,2,17,5,8,60,41,19,56
Linfield,5283,3,14,9,7,61,34,27,51
Glenavon,5283,4,14,8,8,53,42,11,50
Dungannon,5283,5,13,8,9,62,42,20,47
Ballymena,5283,6,12,8,10,56,65,-9,44
Coleraine,5283,7,11,8,11,41,37,4,41
Ards,5283,8,9,4,17,37,60,-23,31
Glentoran,5283,9,9,4,17,25,50,-25,31
Ballinamalla,5283,10,8,3,19,33,55,-22,27
Portadown,5283,11,5,6,19,23,53,-30,21
Crusaders,5284,1,18,8,4,55,30,25,62
Linfield,5284,2,15,10,5,65,33,32,55
Coleraine,5284,3,13,10,7,47,40,7,49
Cliftonville,5284,4,14,6,10,50,42,8,48
Ballymena,5284,5,13,5,12,58,56,2,44
Glenavon,5284,6,11,10,9,43,41,2,43
Dungannon,5284,7,8,11,11,43,44,-1,35
Ards,5284,8,9,7,14,37,47,-10,34
Glentoran,5284,9,8,5,17,30,52,-22,29
Ballinamalla,5284,10,7,6,17,28,49,-21,27
Portadown,5284,11,7,6,17,30,52,-22,27
Crusaders,5285,1,16,10,4,62,39,23,58
Ballymena,5285,2,16,6,8,57,52,5,54
Cliftonville,5285,3,16,5,9,60,43,17,53
Linfield,5285,4,12,10,8,54,37,17,46
Coleraine,5285,5,11,12,7,41,35,6,45
Dungannon,5285,6,10,9,11,52,46,6,39
Ards,5285,7,10,7,13,39,45,-6,37
Glenavon,5285,8,8,12,10,41,51,-10,36
Ballinamalla,5285,9,9,6,15,29,42,-13,33
Glentoran,5285,10,7,8,15,28,47,-19,29
Portadown,5285,11,5,5,20,25,51,-26,20
Linfield,5286,1,17,7,6,63,28,35,58
Cliftonville,5286,2,16,6,8,55,40,15,54
Crusaders,5286,3,14,8,8,51,33,18,50
Coleraine,5286,4,13,9,8,43,38,5,48
Ballymena,5286,5,13,6,11,61,52,9,45
Glenavon,5286,6,11,9,10,45,47,-2,42
Ballinamalla,5286,7,11,4,15,33,52,-19,37
Dungannon,5286,8,9,8,13,46,47,-1,35
Ards,5286,9,10,5,15,41,50,-9,35
Glentoran,5286,10,9,8,13,25,43,-18,35
Portadown,5286,11,4,6,20,19,52,-33,18
Crusaders,5287,1,17,8,5,53,31,22,59
Ballymena,5287,2,16,7,7,68,55,13,55
Linfield,5287,3,13,9,8,59,37,22,48
Coleraine,5287,4,12,9,9,46,39,7,45
Cliftonville,5287,5,12,7,11,50,45,5,43
Glenavon,5287,6,10,13,7,46,41,5,43
Glentoran,5287,7,10,7,13,37,43,-6,37
Dungannon,5287,8,9,9,12,43,45,-2,36
Ards,5287,9,9,5,16,32,48,-16,32
Portadown,5287,10,9,5,16,28,48,-20,32
Ballinamalla,5287,11,7,3,20,22,52,-30,24
Crusaders,5288,1,17,8,5,57,34,23,59
Ballymena,5288,2,18,5,7,62,54,8,59
Cliftonville,5288,3,15,6,9,51,36,15,51
Coleraine,5288,4,14,9,7,39,33,6,51
Linfield,5288,5,12,8,10,47,38,9,44
Ards,5288,6,11,6,13,43,45,-2,39
Dungannon,5288,7,9,9,12,45,44,1,36
Glenavon,5288,8,8,12,10,39,40,-1,36
Glentoran,5288,9,8,8,14,29,42,-13,32
Ballinamalla,5288,10,7,4,19,29,51,-22,25
Portadown,5288,11,6,5,19,29,53,-24,23
Crusaders,5289,1,18,7,5,61,32,29,61
Cliftonville,5289,2,18,3,9,50,32,18,57
Linfield,5289,3,13,8,9,54,39,15,47
Coleraine,5289,4,12,10,8,47,37,10,46
Glenavon,5289,5,11,13,6,46,39,7,46
Ballymena,5289,6,12,7,11,50,55,-5,43
Dungannon,5289,7,10,10,10,45,41,4,40
Ballinamalla,5289,8,11,4,15,31,46,-15,37
Glentoran,5289,9,8,6,16,26,50,-24,30
Ards,5289,10,7,7,16,35,51,-16,28
Portadown,5289,11,6,3,21,25,48,-23,21
Cliftonville,5290,1,17,5,8,62,35,27,56
Ballymena,5290,2,15,8,7,66,54,12,53
Crusaders,5290,3,15,7,8,50,32,18,52
Glenavon,5290,4,12,11,7,50,43,7,47
Linfield,5290,5,11,11,8,53,35,18,44
Coleraine,5290,6,12,8,10,40,39,1,44
Dungannon,5290,7,8,12,10,46,43,3,36
Portadown,5290,8,8,7,15,28,47,-19,31
Ballinamalla,5290,9,9,4,17,30,50,-20,31
Ards,5290,10,8,5,17,30,56,-26,29
Glentoran,5290,11,6,10,14,31,52,-21,28
Ballymena,5291,1,16,5,9,65,56,9,53
Linfield,5291,2,14,10,6,58,30,28,52
Dungannon,5291,3,14,9,7,57,35,22,51
Cliftonville,5291,4,15,3,12,58,46,12,48
Crusaders,5291,5,13,8,9,47,40,7,47
Coleraine,5291,6,11,9,10,41,41,0,42
Ards,5291,7,12,4,14,45,55,-10,40
Glenavon,5291,8,10,8,12,46,49,-3,38
Glentoran,5291,9,8,7,15,31,47,-16,31
Portadown,5291,10,9,3,18,27,49,-22,30
Ballinamalla,5291,11,7,6,17,31,58,-27,27
Linfield,5292,1,16,7,7,62,32,30,55
Cliftonville,5292,2,16,7,7,50,29,21,55
Crusaders,5292,3,14,11,5,57,37,20,53
Glenavon,5292,4,9,15,6,44,42,2,42
Coleraine,5292,5,10,12,8,42,41,1,42
Glentoran,5292,6,11,7,12,39,49,-10,40
Ballymena,5292,7,11,6,13,50,59,-9,39
Ballinamalla,5292,8,10,4,16,33,53,-20,34
Dungannon,5292,9,7,12,11,50,47,3,33
Ards,5292,10,7,7,16,39,52,-13,28
Portadown,5292,11,7,6,17,21,46,-25,27
Coleraine,5293,1,15,11,4,54,30,24,56
Cliftonville,5293,2,17,5,8,53,34,19,56
Crusaders,5293,3,15,8,7,55,38,17,53
Ballymena,5293,4,16,5,9,59,59,0,53
Linfield,5293,5,11,7,12,53,43,10,40
Dungannon,5293,6,10,10,10,53,49,4,40
Ards,5293,7,10,4,16,44,48,-4,34
Glenavon,5293,8,8,10,12,41,46,-5,34
Glentoran,5293,9,8,8,14,33,46,-13,32
Ballinamalla,5293,10,9,3,18,28,59,-31,30
Portadown,5293,11,8,5,17,23,44,-21,29
Linfield,5294,1,16,9,5,62,28,34,57
Crusaders,5294,2,16,8,6,58,31,27,56
Cliftonville,5294,3,16,5,9,53,38,15,53
Ballymena,5294,4,13,8,9,56,55,1,47
Coleraine,5294,5,11,11,8,40,32,8,44
Dungannon,5294,6,9,13,8,50,46,4,40
Glenavon,5294,7,8,13,9,41,51,-10,37
Ballinamalla,5294,8,9,5,16,33,52,-19,32
Ards,5294,9,8,6,16,39,54,-15,30
Glentoran,5294,10,6,10,14,25,45,-20,28
Portadown,5294,11,5,8,17,25,50,-25,23
Cliftonville,5295,1,18,3,9,60,32,28,57
Crusaders,5295,2,16,8,6,50,35,15,56
Linfield,5295,3,14,9,7,61,34,27,51
Coleraine,5295,4,11,14,5,45,36,9,47
Glenavon,5295,5,11,12,7,47,41,6,45
Ballymena,5295,6,11,8,11,54,61,-7,41
Dungannon,5295,7,8,11,11,42,43,-1,35
Glentoran,5295,8,8,7,15,30,46,-16,31
Portadown,5295,9,8,6,16,25,44,-19,30
Ballinamalla,5295,10,7,7,16,30,49,-19,28
Ards,5295,11,6,9,15,30,53,-23,27
Cliftonville,5296,1,18,6,6,56,31,25,60
Linfield,5296,2,16,9,5,61,33,28,57
Crusaders,5296,3,14,7,9,51,37,14,49
Coleraine,5296,4,11,12,7,39,35,4,45
Glenavon,5296,5,10,14,6,53,46,7,44
Ballinamalla,5296,6,12,4,14,40,49,-9,40
Ballymena,5296,7,11,7,12,51,62,-11,40
Dungannon,5296,8,8,13,9,47,45,2,37
Glentoran,5296,9,6,9,15,23,42,-19,27
Ards,5296,10,7,5,18,31,46,-15,26
Portadown,5296,11,6,6,18,23,49,-26,24
Linfield,5297,1,16,10,4,69,35,34,58
Crusaders,5297,2,15,9,6,52,32,20,54
Cliftonville,5297,3,15,5,10,50,37,13,50
Dungannon,5297,4,13,7,10,54,43,11,46
Ballymena,5297,5,11,9,10,50,51,-1,42
Coleraine,5297,6,9,11,10,41,43,-2,38
Glenavon,5297,7,7,14,9,41,46,-5,35
Glentoran,5297,8,9,7,14,25,44,-19,34
Portadown,5297,9,8,7,15,31,47,-16,31
Ards,5297,10,7,9,14,39,51,-12,30
Ballinamalla,5297,11,8,6,16,26,49,-23,30
Crusaders,5298,1,17,9,4,53,27,26,60
Linfield,5298,2,15,8,7,60,26,34,53
Cliftonville,5298,3,14,7,9,44,36,8,49
Coleraine,5298,4,12,10,8,40,36,4,46
Ballymena,5298,5,12,9,9,54,55,-1,45
Glenavon,5298,6,10,12,8,43,40,3,42
Glentoran,5298,7,9,8,13,29,44,-15,35
Ards,5298,8,10,4,16,39,44,-5,34
Portadown,5298,9,9,6,15,35,54,-19,33
Dungannon,5298,10,7,8,15,42,51,-9,29
Ballinamalla,5298,11,7,5,18,27,53,-26,26
Linfield,5299,1,15,9,6,65,34,31,54
Cliftonville,5299,2,16,6,8,61,40,21,54
Crusaders,5299,3,15,8,7,55,37,18,53
Ballymena,5299,4,14,5,11,51,59,-8,47
Glenavon,5299,5,12,10,8,45,39,6,46
Coleraine,5299,6,12,8,10,46,40,6,44
Ards,5299,7,10,5,15,35,45,-10,35
Dungannon,5299,8,9,7,14,49,56,-7,34
Portadown,5299,9,9,6,15,31,46,-15,33
Glentoran,5299,10,8,7,15,37,51,-14,31
Ballinamalla,5299,11,7,5,18,23,51,-28,26
Cliftonville,5300,1,15,7,8,58,45,13,52
Linfield,5300,2,13,9,8,52,29,23,48
Crusaders,5300,3,13,7,10,52,43,9,46
Coleraine,5300,4,11,13,6,43,38,5,46
Ballymena,5300,5,13,6,11,60,57,3,45
Ards,5300,6,11,7,12,41,41,0,40
Dungannon,5300,7,9,11,10,48,43,5,38
Glentoran,5300,8,11,5,14,31,47,-16,38
Glenavon,5300,9,9,10,11,42,44,-2,37
Ballinamalla,5300,10,9,5,16,29,50,-21,32
Portadown,5300,11,7,8,15,27,46,-19,29
Glenavon,5301,1,17,9,4,57,34,23,60
Crusaders,5301,2,16,6,8,59,39,20,54
Linfield,5301,3,14,11,5,60,31,29,53
Cliftonville,5301,4,16,5,9,58,39,19,53
Glentoran,5301,5,13,6,11,37,39,-2,45
Dungannon,5301,6,12,6,12,53,42,11,42
Coleraine,5301,7,11,9,10,42,41,1,42
Ballymena,5301,8,12,5,13,47,58,-11,41
Portadown,5301,9,7,4,19,21,57,-36,25
Ards,5301,10,6,5,19,28,55,-27,23
Ballinamalla,5301,11,6,4,20,27,54,-27,22
Crusaders,5302,1,18,5,7,58,40,18,59
Linfield,5302,2,14,9,7,55,28,27,51
Ballymena,5302,3,13,11,6,64,55,9,50
Cliftonville,5302,4,14,6,10,54,38,16,48
Glenavon,5302,5,13,8,9,43,46,-3,47
Dungannon,5302,6,10,11,9,52,41,11,41
Coleraine,5302,7,10,10,10,37,34,3,40
Glentoran,5302,8,8,9,13,34,43,-9,33
Portadown,5302,9,8,5,17,22,47,-25,29
Ards,5302,10,7,7,16,33,53,-20,28
Ballinamalla,5302,11,7,5,18,28,55,-27,26
Coleraine,5303,1,16,10,4,55,34,21,58
Crusaders,5303,2,17,6,7,55,37,18,57
Linfield,5303,3,15,9,6,62,33,29,54
Cliftonville,5303,4,15,5,10,54,37,17,50
Dungannon,5303,5,10,10,10,57,50,7,40
Glentoran,5303,6,11,6,13,29,41,-12,39
Ballymena,5303,7,10,8,12,56,64,-8,38
Glenavon,5303,8,8,11,11,39,46,-7,35
Ards,5303,9,9,5,16,36,50,-14,32
Portadown,5303,10,6,8,16,27,52,-25,26
Ballinamalla,5303,11,7,4,19,26,52,-26,25
Crusaders,5304,1,15,8,7,52,36,16,53
Cliftonville,5304,2,15,7,8,46,31,15,52
Ballymena,5304,3,15,6,9,55,53,2,51
Linfield,5304,4,13,10,7,56,36,20,49
Glenavon,5304,5,11,11,8,41,39,2,44
Coleraine,5304,6,9,12,9,41,38,3,39
Dungannon,5304,7,8,13,9,45,34,11,37
Portadown,5304,8,8,7,15,30,44,-14,31
Glentoran,5304,9,8,7,15,29,47,-18,31
Ards,5304,10,7,9,14,38,51,-13,30
Ballinamalla,5304,11,7,8,15,30,54,-24,29
Crusaders,5305,1,16,9,5,61,38,23,57
Linfield,5305,2,15,9,6,60,36,24,54
Cliftonville,5305,3,15,7,8,55,41,14,52
Ballymena,5305,4,16,4,10,55,49,6,52
Glenavon,5305,5,12,11,7,46,45,1,47
Coleraine,5305,6,9,11,10,37,35,2,38
Ards,5305,7,11,3,16,35,47,-12,36
Dungannon,5305,8,9,8,13,49,45,4,35
Portadown,5305,9,8,6,16,27,44,-17,30
Glentoran,5305,10,6,9,15,26,45,-19,27
Ballinamalla,5305,11,8,3,19,28,54,-26,27
Crusaders,5306,1,17,6,7,56,29,27,57
Linfield,5306,2,16,8,6,61,31,30,56
Ballymena,5306,3,17,3,10,65,61,4,54
Cliftonville,5306,4,15,6,9,52,40,12,51
Glenavon,5306,5,9,15,6,43,44,-1,42
Dungannon,5306,6,10,10,10,52,43,9,40
Ards,5306,7,11,4,15,38,45,-7,37
Coleraine,5306,8,8,12,10,37,43,-6,36
Glentoran,5306,9,8,5,17,29,50,-21,29
Ballinamalla,5306,10,7,6,17,25,50,-25,27
Portadown,5306,11,6,7,17,27,49,-22,25
Cliftonville,5307,1,17,4,9,50,38,12,55
Ballymena,5307,2,16,6,8,58,51,7,54
Crusaders,5307,3,13,8,9,49,35,14,47
Linfield,5307,4,13,8,9,49,36,13,47
Glenavon,5307,5,13,8,9,56,45,11,47
Coleraine,5307,6,11,10,9,41,41,0,43
Dungannon,5307,7,10,12,8,51,36,15,42
Ards,5307,8,11,3,16,40,47,-7,36
Glentoran,5307,9,8,8,14,28,43,-15,32
Portadown,5307,10,8,6,16,23,40,-17,30
Ballinamalla,5307,11,7,3,20,28,61,-33,24
Linfield,5308,1,16,9,5,67,35,32,57
Cliftonville,5308,2,17,6,7,59,40,19,57
Ballymena,5308,3,15,8,7,62,56,6,53
Crusaders,5308,4,14,8,8,47,30,17,50
Glenavon,5308,5,11,9,10,43,43,0,42
Coleraine,5308,6,11,8,11,47,44,3,41
Dungannon,5308,7,8,11,11,50,49,1,35
Glentoran,5308,8,9,8,13,31,45,-14,35
Ards,5308,9,7,9,14,38,54,-16,30
Ballinamalla,5308,10,7,6,17,26,48,-22,27
Portadown,5308,11,5,8,17,24,50,-26,23
Crusaders,5309,1,18,7,5,65,39,26,61
Linfield,5309,2,16,8,6,59,28,31,56
Cliftonville,5309,3,16,8,6,57,36,21,56
Glenavon,5309,4,12,11,7,52,47,5,47
Ballymena,5309,5,13,7,10,57,56,1,46
Dungannon,5309,6,10,8,12,55,51,4,38
Coleraine,5309,7,9,10,11,36,44,-8,37
Ards,5309,8,9,5,16,34,47,-13,32
Glentoran,5309,9,7,8,15,31,49,-18,29
Ballinamalla,5309,10,8,3,19,35,58,-23,27
Portadown,5309,11,7,5,18,19,45,-26,26
Crusaders,5310,1,16,10,4,53,31,22,58
Coleraine,5310,2,14,9,7,52,36,16,51
Cliftonville,5310,3,14,7,9,58,40,18,49
Dungannon,5310,4,12,10,8,47,34,13,46
Ballymena,5310,5,12,9,9,54,55,-1,45
Linfield,5310,6,11,10,9,46,30,16,43
Ards,5310,7,11,7,12,40,44,-4,40
Glenavon,5310,8,9,10,11,43,52,-9,37
Glentoran,5310,9,9,9,12,31,45,-14,36
Portadown,5310,10,6,8,16,24,45,-21,26
Ballinamalla,5310,11,4,5,21,30,66,-36,17
Cliftonville,5311,1,20,3,7,60,32,28,63
Linfield,5311,2,16,9,5,67,28,39,57
Ballymena,5311,3,15,5,10,58,51,7,50
Glenavon,5311,4,14,8,8,50,44,6,50
Crusaders,5311,5,14,7,9,49,38,11,49
Coleraine,5311,6,11,10,9,40,38,2,43
Dungannon,5311,7,7,12,11,44,42,2,33
Glentoran,5311,8,8,9,13,30,45,-15,33
Ards,5311,9,7,6,17,27,49,-22,27
Ballinamalla,5311,10,7,5,18,26,55,-29,26
Portadown,5311,11,6,6,18,20,49,-29,24
Crusaders,5312,1,16,6,8,57,40,17,54
Linfield,5312,2,14,11,5,54,28,26,53
Glenavon,5312,3,14,11,5,58,45,13,53
Ballymena,5312,4,15,6,9,61,53,8,51
Cliftonville,5312,5,15,3,12,54,43,11,48
Coleraine,5312,6,12,7,11,43,41,2,43
Dungannon,5312,7,11,8,11,51,46,5,41
Glentoran,5312,8,9,7,14,29,46,-17,34
Ballinamalla,5312,9,9,4,17,33,54,-21,31
Portadown,5312,10,8,6,16,25,46,-21,30
Ards,5312,11,6,3,21,31,54,-23,21
Crusaders,5313,1,17,7,6,71,43,28,58
Linfield,5313,2,16,9,5,59,32,27,57
Glenavon,5313,3,15,9,6,50,42,8,54
Ballymena,5313,4,14,9,7,57,53,4,51
Cliftonville,5313,5,14,7,9,59,41,18,49
Dungannon,5313,6,11,8,11,50,43,7,41
Coleraine,5313,7,8,12,10,40,47,-7,36
Ards,5313,8,8,7,15,32,46,-14,31
Glentoran,5313,9,6,11,13,28,48,-20,29
Portadown,5313,10,6,7,17,22,47,-25,25
Ballinamalla,5313,11,5,4,21,23,49,-26,19
Crusaders,5314,1,17,8,5,58,32,26,59
Linfield,5314,2,16,7,7,56,36,20,55
Cliftonville,5314,3,15,7,8,55,37,18,52
Coleraine,5314,4,13,11,6,50,33,17,50
Ards,5314,5,14,3,13,39,39,0,45
Ballymena,5314,6,12,5,13,63,68,-5,41
Glenavon,5314,7,8,11,11,41,49,-8,35
Portadown,5314,8,10,4,16,32,44,-12,34
Dungannon,5314,9,8,7,15,48,56,-8,31
Glentoran,5314,10,7,9,14,25,44,-19,30
Ballinamalla,5314,11,7,4,19,26,55,-29,25
Crusaders,5315,1,17,10,3,56,29,27,61
Ballymena,5315,2,15,7,8,60,59,1,52
Coleraine,5315,3,13,11,6,49,34,15,50
Linfield,5315,4,12,12,6,55,33,22,48
Cliftonville,5315,5,12,5,13,47,49,-2,41
Dungannon,5315,6,9,10,11,54,45,9,37
Glentoran,5315,7,9,10,11,32,43,-11,37
Glenavon,5315,8,8,10,12,45,50,-5,34
Portadown,5315,9,9,4,17,26,41,-15,31
Ballinamalla,5315,10,8,6,16,29,51,-22,30
Ards,5315,11,7,7,16,39,58,-19,28
Linfield,5316,1,15,11,4,68,30,38,56
Crusaders,5316,2,16,5,9,59,44,15,53
Cliftonville,5316,3,14,6,10,47,43,4,48
Coleraine,5316,4,10,13,7,45,38,7,43
Glenavon,5316,5,11,10,9,46,46,0,43
Ballymena,5316,6,10,9,11,53,63,-10,39
Dungannon,5316,7,10,8,12,56,50,6,38
Glentoran,5316,8,9,10,11,33,40,-7,37
Ards,5316,9,9,7,14,37,50,-13,34
Ballinamalla,5316,10,9,3,18,31,52,-21,30
Portadown,5316,11,7,8,15,30,49,-19,29
Crusaders,5317,1,19,6,5,64,31,33,63
Linfield,5317,2,17,9,4,67,35,32,60
Cliftonville,5317,3,13,7,10,50,40,10,46
Glenavon,5317,4,11,10,9,49,49,0,43
Coleraine,5317,5,9,11,10,43,47,-4,38
Ballymena,5317,6,10,8,12,52,60,-8,38
Ards,5317,7,12,2,16,43,53,-10,38
Dungannon,5317,8,8,11,11,41,47,-6,35
Ballinamalla,5317,9,10,4,16,39,51,-12,34
Glentoran,5317,10,7,10,13,35,49,-14,31
Portadown,5317,11,8,4,18,30,51,-21,28
Crusaders,5318,1,19,5,6,58,32,26,62
Linfield,5318,2,16,10,4,65,27,38,58
Ballymena,5318,3,13,9,8,60,57,3,48
Cliftonville,5318,4,14,4,12,55,41,14,46
Coleraine,5318,5,11,11,8,37,33,4,44
Ards,5318,6,13,2,15,41,52,-11,41
Glenavon,5318,7,10,7,13,38,48,-10,37
Dungannon,5318,8,10,6,14,42,42,0,36
Ballinamalla,5318,9,10,4,16,33,47,-14,34
Glentoran,5318,10,8,8,14,32,49,-17,32
Portadown,5318,11,4,8,18,17,50,-33,20
Crusaders,5319,1,18,9,3,61,29,32,63
Linfield,5319,2,12,11,7,57,33,24,47
Cliftonville,5319,3,14,5,11,52,44,8,47
Ballymena,5319,4,14,5,11,63,59,4,47
Glenavon,5319,5,12,9,9,49,51,-2,45
Dungannon,5319,6,9,11,10,52,42,10,38
Glentoran,5319,7,10,8,12,33,43,-10,38
Coleraine,5319,8,9,9,12,38,53,-15,36
Ards,5319,9,10,5,15,39,49,-10,35
Ballinamalla,5319,10,9,5,16,34,51,-17,32
Portadown,5319,11,6,7,17,26,50,-24,25
Crusaders,5320,1,16,8,6,52,29,23,56
Ballymena,5320,2,16,5,9,64,53,11,53
Glenavon,5320,3,15,8,7,56,48,8,53
Cliftonville,5320,4,14,7,9,50,41,9,49
Linfield,5320,5,11,12,7,50,32,18,45
Coleraine,5320,6,10,9,11,42,43,-1,39
Glentoran,5320,7,10,8,12,32,41,-9,38
Ballinamalla,5320,8,9,5,16,33,52,-19,32
Dungannon,5320,9,7,10,13,41,46,-5,31
Portadown,5320,10,7,8,15,27,45,-18,29
Ards,5320,11,7,6,17,33,50,-17,27
Cliftonville,5321,1,18,4,8,66,36,30,58
Linfield,5321,2,15,10,5,61,32,29,55
Coleraine,5321,3,15,9,6,47,35,12,54
Crusaders,5321,4,12,9,9,51,44,7,45
Ballymena,5321,5,12,7,11,53,60,-7,43
Glenavon,5321,6,9,13,8,41,41,0,40
Dungannon,5321,7,10,9,11,47,45,2,39
Ards,5321,8,11,4,15,45,56,-11,37
Ballinamalla,5321,9,10,3,17,28,46,-18,33
Glentoran,5321,10,8,5,17,30,45,-15,29
Portadown,5321,11,5,7,18,25,54,-29,22
Crusaders,5322,1,18,6,6,50,29,21,60
Cliftonville,5322,2,16,4,10,52,38,14,52
Linfield,5322,3,13,11,6,59,34,25,50
Ballymena,5322,4,15,4,11,51,53,-2,49
Coleraine,5322,5,12,10,8,41,38,3,46
Glenavon,5322,6,10,11,9,58,52,6,41
Ballinamalla,5322,7,12,2,16,31,49,-18,38
Dungannon,5322,8,8,11,11,50,45,5,35
Portadown,5322,9,9,5,16,26,41,-15,32
Glentoran,5322,10,7,7,16,31,53,-22,28
Ards,5322,11,7,5,18,35,52,-17,26
Crusaders,5323,1,19,4,7,57,40,17,61
Coleraine,5323,2,14,8,8,49,35,14,50
Glenavon,5323,3,13,10,7,52,37,15,49
Cliftonville,5323,4,15,4,11,50,40,10,49
Dungannon,5323,5,14,6,10,50,37,13,48
Ballymena,5323,6,14,6,10,55,57,-2,48
Linfield,5323,7,13,7,10,54,35,19,46
Ballinamalla,5323,8,9,4,17,29,49,-20,31
Glentoran,5323,9,7,8,15,30,44,-14,29
Portadown,5323,10,7,6,17,24,45,-21,27
Ards,5323,11,6,5,19,31,62,-31,23
Crusaders,5324,1,15,10,5,58,35,23,55
Ballymena,5324,2,13,10,7,58,52,6,49
Glenavon,5324,3,12,11,7,45,35,10,47
Linfield,5324,4,12,10,8,64,39,25,46
Coleraine,5324,5,12,10,8,39,39,0,46
Cliftonville,5324,6,12,7,11,51,46,5,43
Glentoran,5324,7,9,11,10,31,43,-12,38
Dungannon,5324,8,9,9,12,44,42,2,36
Ards,5324,9,9,6,15,40,57,-17,33
Portadown,5324,10,8,8,14,30,46,-16,32
Ballinamalla,5324,11,5,6,19,28,54,-26,21
Crusaders,5325,1,17,6,7,58,44,14,57
Glenavon,5325,2,15,10,5,56,39,17,55
Cliftonville,5325,3,16,4,10,58,44,14,52
Linfield,5325,4,13,11,6,62,36,26,50
Coleraine,5325,5,14,8,8,49,43,6,50
Dungannon,5325,6,9,12,9,58,47,11,39
Glentoran,5325,7,10,7,13,38,47,-9,37
Ballymena,5325,8,9,8,13,57,71,-14,35
Ards,5325,9,9,3,18,41,54,-13,30
Portadown,5325,10,6,8,16,26,51,-25,26
Ballinamalla,5325,11,6,5,19,26,53,-27,23
Crusaders,5326,1,20,6,4,57,29,28,66
Linfield,5326,2,16,10,4,61,35,26,58
Cliftonville,5326,3,16,3,11,49,39,10,51
Coleraine,5326,4,14,9,7,43,33,10,51
Glenavon,5326,5,11,12,7,51,45,6,45
Dungannon,5326,6,10,9,11,54,44,10,39
Ballymena,5326,7,11,6,13,59,69,-10,39
Glentoran,5326,8,9,9,12,30,39,-9,36
Ards,5326,9,7,7,16,33,46,-13,28
Ballinamalla,5326,10,7,3,20,25,56,-31,24
Portadown,5326,11,5,4,21,22,49,-27,19
Crusaders,5327,1,19,9,2,57,26,31,66
Linfield,5327,2,15,10,5,60,26,34,55
Coleraine,5327,3,12,13,5,48,37,11,49
Cliftonville,5327,4,14,5,11,46,39,7,47
Ballymena,5327,5,11,8,11,54,63,-9,41
Glenavon,5327,6,10,10,10,45,51,-6,40
Portadown,5327,7,9,7,14,28,41,-13,34
Glentoran,5327,8,9,6,15,40,50,-10,33
Dungannon,5327,9,7,11,12,45,46,-1,32
Ards,5327,10,8,7,15,36,48,-12,31
Ballinamalla,5327,11,7,2,21,28,60,-32,23
Crusaders,5328,1,17,7,6,61,41,20,58
Coleraine,5328,2,14,8,8,41,35,6,50
Linfield,5328,3,13,10,7,61,39,22,49
Cliftonville,5328,4,12,8,10,49,42,7,44
Ballymena,5328,5,12,8,10,56,58,-2,44
Ards,5328,6,10,7,13,38,45,-7,37
Dungannon,5328,7,9,9,12,46,44,2,36
Glenavon,5328,8,8,12,10,46,49,-3,36
Portadown,5328,9,10,6,14,30,40,-10,36
Glentoran,5328,10,10,6,14,29,42,-13,36
Ballinamalla,5328,11,7,5,18,30,52,-22,26
Cliftonville,5329,1,20,4,6,66,34,32,64
Crusaders,5329,2,17,7,6,59,38,21,58
Glenavon,5329,3,14,9,7,52,45,7,51
Linfield,5329,4,13,9,8,54,33,21,48
Coleraine,5329,5,10,11,9,37,40,-3,41
Ballymena,5329,6,11,8,11,52,59,-7,41
Dungannon,5329,7,11,7,12,54,46,8,40
Glentoran,5329,8,7,8,15,27,43,-16,29
Ballinamalla,5329,9,8,5,17,30,55,-25,29
Ards,5329,10,6,9,15,40,52,-12,27
Portadown,5329,11,7,5,18,26,52,-26,26
Crusaders,5330,1,14,12,4,51,34,17,54
Linfield,5330,2,14,9,7,59,36,23,51
Ballymena,5330,3,14,7,9,51,52,-1,49
Cliftonville,5330,4,14,6,10,51,42,9,48
Coleraine,5330,5,11,13,6,46,33,13,46
Glenavon,5330,6,8,14,8,45,48,-3,38
Glentoran,5330,7,10,8,12,33,41,-8,38
Ballinamalla,5330,8,9,8,13,32,44,-12,35
Portadown,5330,9,8,5,17,25,44,-19,29
Dungannon,5330,10,5,13,12,43,48,-5,28
Ards,5330,11,6,9,15,40,54,-14,27
Crusaders,5331,1,15,8,7,48,34,14,53
Linfield,5331,2,13,12,5,56,29,27,51
Ballymena,5331,3,16,3,11,54,50,4,51
Cliftonville,5331,4,14,6,10,47,36,11,48
Coleraine,5331,5,12,9,9,46,39,7,45
Glenavon,5331,6,10,13,7,45,41,4,43
Dungannon,5331,7,9,10,11,47,44,3,37
Ballinamalla,5331,8,9,8,13,34,47,-13,35
Ards,5331,9,8,7,15,33,48,-15,31
Glentoran,5331,10,6,10,14,27,47,-20,28
Portadown,5331,11,6,8,16,23,45,-22,26
Crusaders,5332,1,21,6,3,69,29,40,69
Ballymena,5332,2,15,5,10,58,55,3,50
Cliftonville,5332,3,14,6,10,49,41,8,48
Linfield,5332,4,13,8,9,60,36,24,47
Coleraine,5332,5,10,14,6,48,42,6,44
Glenavon,5332,6,11,11,8,46,41,5,44
Dungannon,5332,7,9,9,12,47,46,1,36
Portadown,5332,8,9,6,15,25,43,-18,33
Glentoran,5332,9,8,7,15,26,49,-23,31
Ards,5332,10,8,6,16,34,49,-15,30
Ballinamalla,5332,11,6,4,20,26,57,-31,22
Crusaders,5333,1,20,6,4,53,27,26,66
Linfield,5333,2,15,9,6,56,34,22,54
Coleraine,5333,3,12,11,7,38,30,8,47
Cliftonville,5333,4,14,4,12,48,35,13,46
Ballymena,5333,5,13,7,10,56,56,0,46
Glenavon,5333,6,11,10,9,44,41,3,43
Portadown,5333,7,9,8,13,25,36,-11,35
Dungannon,5333,8,8,8,14,45,46,-1,32
Ards,5333,9,9,5,16,33,51,-18,32
Glentoran,5333,10,8,7,15,25,45,-20,31
Ballinamalla,5333,11,7,3,20,29,51,-22,24
Crusaders,5334,1,17,8,5,56,33,23,59
Linfield,5334,2,16,9,5,59,26,33,57
Cliftonville,5334,3,16,5,9,52,34,18,53
Coleraine,5334,4,11,11,8,48,41,7,44
Ballymena,5334,5,13,4,13,60,68,-8,43
Glenavon,5334,6,8,12,10,41,50,-9,36
Glentoran,5334,7,10,6,14,29,40,-11,36
Dungannon,5334,8,8,11,11,43,46,-3,35
Ards,5334,9,9,7,14,36,45,-9,34
Portadown,5334,10,8,4,18,24,43,-19,28
Ballinamalla,5334,11,7,7,16,31,53,-22,28
Crusaders,5335,1,17,6,7,55,35,20,57
Linfield,5335,2,15,10,5,61,32,29,55
Cliftonville,5335,3,16,5,9,58,40,18,53
Dungannon,5335,4,13,9,8,54,42,12,48
Coleraine,5335,5,11,11,8,41,35,6,44
Glenavon,5335,6,11,9,10,48,48,0,42
Ballymena,5335,7,10,7,13,50,59,-9,37
Portadown,5335,8,10,5,15,28,45,-17,35
Glentoran,5335,9,9,6,15,28,44,-16,33
Ards,5335,10,7,7,16,33,51,-18,28
Ballinamalla,5335,11,7,3,20,28,53,-25,24
Linfield,5336,1,16,9,5,62,34,28,57
Cliftonville,5336,2,16,6,8,59,36,23,54
Crusaders,5336,3,13,12,5,48,31,17,51
Ballymena,5336,4,12,10,8,56,49,7,46
Coleraine,5336,5,11,11,8,43,35,8,44
Glentoran,5336,6,11,7,12,34,44,-10,40
Glenavon,5336,7,8,14,8,43,49,-6,38
Dungannon,5336,8,7,10,13,45,50,-5,31
Ballinamalla,5336,9,8,7,15,36,54,-18,31
Ards,5336,10,7,7,16,35,57,-22,28
Portadown,5336,11,6,7,17,27,49,-22,25
Ballymena,5337,1,18,7,5,62,45,17,61
Crusaders,5337,2,16,8,6,49,28,21,56
Linfield,5337,3,13,12,5,66,33,33,51
Coleraine,5337,4,13,9,8,35,30,5,48
Cliftonville,5337,5,13,7,10,48,38,10,46
Glenavon,5337,6,10,12,8,42,41,1,42
Dungannon,5337,7,8,14,8,44,34,10,38
Glentoran,5337,8,9,7,14,31,49,-18,34
Ards,5337,9,5,11,14,36,51,-15,26
Portadown,5337,10,5,8,17,21,47,-26,23
Ballinamalla,5337,11,5,5,20,21,59,-38,20
Crusaders,5338,1,18,8,4,67,36,31,62
Linfield,5338,2,17,7,6,60,28,32,58
Cliftonville,5338,3,17,4,9,55,41,14,55
Glenavon,5338,4,13,10,7,50,38,12,49
Coleraine,5338,5,12,9,9,44,37,7,45
Ballymena,5338,6,12,7,11,52,56,-4,43
Dungannon,5338,7,8,14,8,52,43,9,38
Ards,5338,8,9,3,18,35,54,-19,30
Ballinamalla,5338,9,9,3,18,26,54,-28,30
Glentoran,5338,10,7,8,15,26,47,-21,29
Portadown,5338,11,4,5,21,16,49,-33,17
Crusaders,5339,1,18,6,6,63,39,24,60
Linfield,5339,2,17,7,6,69,36,33,58
Cliftonville,5339,3,18,3,9,65,40,25,57
Dungannon,5339,4,13,9,8,60,43,17,48
Ballymena,5339,5,15,3,12,62,61,1,48
Coleraine,5339,6,11,9,10,44,44,0,42
Glenavon,5339,7,9,11,10,47,54,-7,38
Glentoran,5339,8,10,6,14,32,43,-11,36
Ards,5339,9,9,4,17,38,55,-17,31
Ballinamalla,5339,10,8,3,19,28,57,-29,27
Portadown,5339,11,5,3,22,24,60,-36,18
Linfield,5340,1,18,7,5,71,28,43,61
Crusaders,5340,2,16,9,5,53,32,21,57
Ballymena,5340,3,15,5,10,56,59,-3,50
Cliftonville,5340,4,14,5,11,54,43,11,47
Coleraine,5340,5,12,8,10,46,44,2,44
Glenavon,5340,6,11,9,10,44,45,-1,42
Ards,5340,7,10,6,14,41,50,-9,36
Portadown,5340,8,8,8,14,24,41,-17,32
Dungannon,5340,9,6,12,12,40,44,-4,30
Ballinamalla,5340,10,7,6,17,30,51,-21,27
Glentoran,5340,11,6,9,15,32,54,-22,27
Crusaders,5341,1,15,7,8,54,38,16,52
Linfield,5341,2,13,11,6,59,33,26,50
Glenavon,5341,3,13,9,8,54,40,14,48
Ballymena,5341,4,13,7,10,57,54,3,46
Cliftonville,5341,5,13,5,12,49,44,5,44
Coleraine,5341,6,10,14,6,39,34,5,44
Glentoran,5341,7,11,8,11,29,39,-10,41
Ards,5341,8,9,6,15,36,50,-14,33
Dungannon,5341,9,6,14,10,47,49,-2,32
Portadown,5341,10,8,6,16,28,47,-19,30
Ballinamalla,5341,11,7,7,16,26,50,-24,28
Ballymena,5342,1,16,5,9,54,50,4,53
Crusaders,5342,2,14,9,7,54,38,16,51
Glenavon,5342,3,14,9,7,45,35,10,51
Linfield,5342,4,12,10,8,53,35,18,46
Dungannon,5342,5,13,7,10,55,45,10,46
Cliftonville,5342,6,13,7,10,50,42,8,46
Coleraine,5342,7,11,9,10,46,45,1,42
Ards,5342,8,12,4,14,37,42,-5,40
Glentoran,5342,9,9,7,14,35,45,-10,34
Portadown,5342,10,7,6,17,19,41,-22,27
Ballinamalla,5342,11,5,5,20,26,56,-30,20
Linfield,5343,1,16,9,5,62,29,33,57
Cliftonville,5343,2,16,6,8,59,40,19,54
Crusaders,5343,3,15,7,8,54,39,15,52
Coleraine,5343,4,13,10,7,40,34,6,49
Glenavon,5343,5,12,12,6,53,40,13,48
Glentoran,5343,6,11,6,13,29,37,-8,39
Ballymena,5343,7,9,10,11,52,63,-11,37
Dungannon,5343,8,8,10,12,45,48,-3,34
Ballinamalla,5343,9,9,5,16,31,52,-21,32
Portadown,5343,10,7,10,13,26,42,-16,31
Ards,5343,11,5,3,22,34,61,-27,18
Crusaders,5344,1,17,10,3,54,32,22,61
Linfield,5344,2,14,9,7,58,35,23,51
Cliftonville,5344,3,13,8,9,48,41,7,47
Glenavon,5344,4,12,10,8,44,40,4,46
Ballymena,5344,5,11,10,9,49,48,1,43
Dungannon,5344,6,11,9,10,49,43,6,42
Coleraine,5344,7,9,13,8,43,36,7,40
Glentoran,5344,8,9,11,10,27,36,-9,38
Ballinamalla,5344,9,8,6,16,30,49,-19,30
Ards,5344,10,7,5,18,38,56,-18,26
Portadown,5344,11,6,5,19,24,48,-24,23
Crusaders,5345,1,19,7,4,60,26,34,64
Ballymena,5345,2,17,5,8,58,50,8,56
Linfield,5345,3,14,10,6,63,35,28,52
Cliftonville,5345,4,14,6,10,50,40,10,48
Coleraine,5345,5,11,11,8,50,46,4,44
Glentoran,5345,6,10,6,14,33,42,-9,36
Glenavon,5345,7,7,12,11,41,47,-6,33
Ballinamalla,5345,8,10,3,17,33,55,-22,33
Dungannon,5345,9,7,11,12,41,49,-8,32
Portadown,5345,10,8,7,15,25,38,-13,31
Ards,5345,11,6,6,18,31,57,-26,24
Linfield,5346,1,15,11,4,58,29,29,56
Crusaders,5346,2,16,7,7,50,30,20,55
Glenavon,5346,3,13,12,5,51,40,11,51
Cliftonville,5346,4,14,6,10,53,39,14,48
Ballymena,5346,5,14,6,10,60,56,4,48
Coleraine,5346,6,10,9,11,42,44,-2,39
Glentoran,5346,7,11,6,13,36,42,-6,39
Dungannon,5346,8,8,10,12,46,47,-1,34
Ards,5346,9,9,4,17,36,52,-16,31
Ballinamalla,5346,10,8,4,18,27,51,-24,28
Portadown,5346,11,7,5,18,28,57,-29,26
Ballymena,5347,1,17,5,8,57,49,8,56
Crusaders,5347,2,14,13,3,61,40,21,55
Coleraine,5347,3,13,10,7,42,34,8,49
Linfield,5347,4,13,9,8,52,31,21,48
Cliftonville,5347,5,12,10,8,49,41,8,46
Glenavon,5347,6,10,12,8,42,40,2,42
Ballinamalla,5347,7,11,3,16,34,53,-19,36
Dungannon,5347,8,9,8,13,48,47,1,35
Glentoran,5347,9,9,6,15,27,41,-14,33
Ards,5347,10,9,3,18,41,51,-10,30
Portadown,5347,11,6,5,19,22,48,-26,23
Crusaders,5348,1,15,10,5,49,30,19,55
Linfield,5348,2,13,12,5,60,34,26,51
Cliftonville,5348,3,15,6,9,53,37,16,51
Coleraine,5348,4,13,8,9,43,43,0,47
Ballymena,5348,5,12,7,11,56,55,1,43
Dungannon,5348,6,10,10,10,50,45,5,40
Ards,5348,7,11,7,12,37,41,-4,40
Glenavon,5348,8,8,11,11,39,46,-7,35
Glentoran,5348,9,8,8,14,30,42,-12,32
Ballinamalla,5348,10,7,7,16,29,53,-24,28
Portadown,5348,11,6,8,16,23,43,-20,26
Cliftonville,5349,1,17,6,7,58,39,19,57
Linfield,5349,2,15,10,5,61,30,31,55
Crusaders,5349,3,14,9,7,56,39,17,51
Ballymena,5349,4,13,6,11,54,59,-5,45
Glenavon,5349,5,9,13,8,46,42,4,40
Coleraine,5349,6,9,13,8,40,43,-3,40
Dungannon,5349,7,10,9,11,45,43,2,39
Glentoran,5349,8,8,9,13,34,43,-9,33
Ards,5349,9,9,5,16,40,53,-13,32
Portadown,5349,10,8,6,16,29,45,-16,30
Ballinamalla,5349,11,8,4,18,29,56,-27,28
Crusaders,5350,1,15,11,4,56,33,23,56
Ballymena,5350,2,14,7,9,61,61,0,49
Linfield,5350,3,13,9,8,51,30,21,48
Glenavon,5350,4,11,13,6,54,42,12,46
Cliftonville,5350,5,13,5,12,45,43,2,44
Coleraine,5350,6,10,11,9,46,45,1,41
Glentoran,5350,7,10,9,11,28,39,-11,39
Dungannon,5350,8,9,10,11,52,42,10,37
Portadown,5350,9,9,4,17,25,44,-19,31
Ards,5350,10,7,8,15,40,52,-12,29
Ballinamalla,5350,11,8,5,17,27,54,-27,29
Crusaders,5351,1,17,9,4,61,38,23,60
Cliftonville,5351,2,16,5,9,61,36,25,53
Linfield,5351,3,11,13,6,53,39,14,46
Ballymena,5351,4,13,5,12,51,60,-9,44
Ards,5351,5,11,9,10,38,38,0,42
Glentoran,5351,6,10,10,10,34,35,-1,40
Glenavon,5351,7,9,11,10,49,52,-3,38
Coleraine,5351,8,8,11,11,39,44,-5,35
Dungannon,5351,9,7,10,13,45,56,-11,31
Portadown,5351,10,7,9,14,25,38,-13,30
Ballinamalla,5351,11,7,6,17,31,51,-20,27
Crusaders,5352,1,18,9,3,60,29,31,63
Coleraine,5352,2,13,10,7,42,36,6,49
Linfield,5352,3,12,12,6,56,33,23,48
Cliftonville,5352,4,15,3,12,56,46,10,48
Ballymena,5352,5,13,9,8,57,53,4,48
Ards,5352,6,12,3,15,39,45,-6,39
Glenavon,5352,7,8,13,9,47,54,-7,37
Dungannon,5352,8,9,9,12,45,45,0,36
Ballinamalla,5352,9,9,3,18,32,55,-23,30
Glentoran,5352,10,7,8,15,30,46,-16,29
Portadown,5352,11,6,7,17,27,49,-22,25
Ballymena,5353,1,18,3,9,59,56,3,57
Cliftonville,5353,2,17,4,9,56,37,19,55
Linfield,5353,3,14,10,6,59,26,33,52
Crusaders,5353,4,14,10,6,50,36,14,52
Coleraine,5353,5,12,10,8,44,35,9,46
Glenavon,5353,6,12,9,9,48,47,1,45
Dungannon,5353,7,8,10,12,52,47,5,34
Glentoran,5353,8,9,7,14,35,50,-15,34
Ballinamalla,5353,9,8,5,17,30,52,-22,29
Ards,5353,10,8,3,19,39,58,-19,27
Portadown,5353,11,8,3,19,23,51,-28,27
Crusaders,5354,1,17,9,4,63,34,29,60
Linfield,5354,2,16,10,4,68,28,40,58
Coleraine,5354,3,12,11,7,49,41,8,47
Ballymena,5354,4,12,11,7,54,55,-1,47
Glenavon,5354,5,12,10,8,48,43,5,46
Cliftonville,5354,6,12,8,10,54,46,8,44
Dungannon,5354,7,9,10,11,46,43,3,37
Ards,5354,8,8,5,17,40,61,-21,29
Portadown,5354,9,8,4,18,27,41,-14,28
Glentoran,5354,10,7,7,16,25,46,-21,28
Ballinamalla,5354,11,9,1,20,28,64,-36,28
Crusaders,5355,1,18,6,6,58,36,22,60
Linfield,5355,2,16,10,4,60,30,30,58
Cliftonville,5355,3,15,3,12,57,43,14,48
Ballymena,5355,4,13,8,9,55,56,-1,47
Coleraine,5355,5,12,9,9,47,40,7,45
Glenavon,5355,6,10,10,10,40,47,-7,40
Glentoran,5355,7,9,8,13,29,45,-16,35
Dungannon,5355,8,8,10,12,50,46,4,34
Ards,5355,9,10,3,17,40,54,-14,33
Portadown,5355,10,9,4,17,28,46,-18,31
Ballinamalla,5355,11,8,3,19,27,48,-21,27
Coleraine,5356,1,16,10,4,50,29,21,58
Cliftonville,5356,2,17,3,10,56,42,14,54
Crusaders,5356,3,15,7,8,56,40,16,52
Ballymena,5356,4,14,7,9,52,51,1,49
Linfield,5356,5,13,9,8,55,34,21,48
Dungannon,5356,6,12,7,11,56,43,13,43
Glenavon,5356,7,10,11,9,48,46,2,41
Glentoran,5356,8,10,5,15,33,46,-13,35
Portadown,5356,9,8,6,16,24,48,-24,30
Ards,5356,10,7,5,18,35,56,-21,26
Ballinamalla,5356,11,5,6,19,25,55,-30,21
Crusaders,5357,1,18,7,5,62,38,24,61
Cliftonville,5357,2,18,4,8,54,36,18,58
Linfield,5357,3,16,7,7,67,36,31,55
Coleraine,5357,4,12,10,8,46,37,9,46
Ballymena,5357,5,13,5,12,54,65,-11,44
Dungannon,5357,6,10,10,10,52,42,10,40
Ards,5357,7,12,3,15,48,48,0,39
Glentoran,5357,8,11,4,15,34,47,-13,37
Glenavon,5357,9,8,10,12,41,55,-14,34
Portadown,5357,10,8,5,17,35,54,-19,29
Ballinamalla,5357,11,4,5,21,22,57,-35,17
Cliftonville,5358,1,21,4,5,63,34,29,67
Ballymena,5358,2,15,6,9,64,58,6,51
Linfield,5358,3,13,9,8,52,33,19,48
Glenavon,5358,4,12,11,7,45,39,6,47
Crusaders,5358,5,14,4,12,45,35,10,46
Coleraine,5358,6,10,11,9,40,40,0,41
Glentoran,5358,7,12,4,14,33,41,-8,40
Ards,5358,8,10,4,16,35,46,-11,34
Ballinamalla,5358,9,9,3,18,27,47,-20,30
Dungannon,5358,10,7,8,15,42,52,-10,29
Portadown,5358,11,8,4,18,23,44,-21,28
Crusaders,5359,1,18,7,5,59,35,24,61
Ballymena,5359,2,16,5,9,59,55,4,53
Dungannon,5359,3,13,8,9,62,41,21,47
Linfield,5359,4,13,6,11,61,45,16,45
Cliftonville,5359,5,13,6,11,57,52,5,45
Coleraine,5359,6,11,10,9,52,44,8,43
Portadown,5359,7,11,6,13,35,47,-12,39
Glenavon,5359,8,8,12,10,42,47,-5,36
Glentoran,5359,9,9,6,15,34,46,-12,33
Ards,5359,10,6,10,14,40,54,-14,28
Ballinamalla,5359,11,8,2,20,30,65,-35,26
Linfield,5360,1,14,12,4,60,28,32,54
Cliftonville,5360,2,16,5,9,52,34,18,53
Crusaders,5360,3,14,5,11,50,40,10,47
Coleraine,5360,4,12,11,7,44,38,6,47
Glenavon,5360,5,12,10,8,50,49,1,46
Ballymena,5360,6,12,5,13,55,64,-9,41
Glentoran,5360,7,11,7,12,38,51,-13,40
Dungannon,5360,8,10,9,11,49,41,8,39
Ards,5360,9,9,6,15,38,50,-12,33
Portadown,5360,10,9,4,17,23,40,-17,31
Ballinamalla,5360,11,8,2,20,28,52,-24,26
Crusaders,5361,1,16,7,7,60,38,22,55
Ballymena,5361,2,16,5,9,61,57,4,53
Linfield,5361,3,14,10,6,60,32,28,52
Cliftonville,5361,4,14,5,11,52,43,9,47
Coleraine,5361,5,12,10,8,47,42,5,46
Glenavon,5361,6,10,12,8,47,47,0,42
Dungannon,5361,7,11,6,13,59,52,7,39
Ards,5361,8,11,5,14,35,47,-12,38
Glentoran,5361,9,9,5,16,30,48,-18,32
Ballinamalla,5361,10,9,3,18,33,54,-21,30
Portadown,5361,11,6,6,18,26,50,-24,24
Crusaders,5362,1,21,5,4,64,31,33,68
Linfield,5362,2,15,9,6,61,31,30,54
Coleraine,5362,3,12,10,8,44,37,7,46
Dungannon,5362,4,13,6,11,53,43,10,45
Cliftonville,5362,5,13,5,12,47,40,7,44
Ballymena,5362,6,12,5,13,53,64,-11,41
Glenavon,5362,7,9,10,11,42,48,-6,37
Glentoran,5362,8,9,9,12,27,40,-13,36
Ballinamalla,5362,9,10,3,17,31,47,-16,33
Ards,5362,10,8,6,16,35,50,-15,30
Portadown,5362,11,6,6,18,23,49,-26,24
Crusaders,5363,1,17,6,7,54,32,22,57
Cliftonville,5363,2,16,6,8,59,39,20,54
Linfield,5363,3,14,9,7,59,38,21,51
Ballymena,5363,4,12,9,9,53,57,-4,45
Coleraine,5363,5,11,11,8,44,39,5,44
Glenavon,5363,6,10,11,9,51,48,3,41
Dungannon,5363,7,10,10,10,53,44,9,40
Ards,5363,8,11,4,15,44,47,-3,37
Ballinamalla,5363,9,10,6,14,34,52,-18,36
Glentoran,5363,10,7,7,16,32,53,-21,28
Portadown,5363,11,4,7,19,24,58,-34,19
Linfield,5364,1,15,12,3,64,26,38,57
Ballymena,5364,2,15,6,9,59,59,0,51
Crusaders,5364,3,14,7,9,57,41,16,49
Cliftonville,5364,4,15,4,11,51,44,7,49
Glenavon,5364,5,11,10,9,46,44,2,43
Coleraine,5364,6,12,7,11,39,42,-3,43
Dungannon,5364,7,10,9,11,48,44,4,39
Portadown,5364,8,11,5,14,33,46,-13,38
Ballinamalla,5364,9,9,4,17,28,46,-18,31
Glentoran,5364,10,6,12,12,28,42,-14,30
Ards,5364,11,7,4,19,29,48,-19,25
Linfield,5365,1,17,9,4,60,25,35,60
Crusaders,5365,2,15,7,8,52,33,19,52
Cliftonville,5365,3,14,8,8,55,39,16,50
Ballymena,5365,4,14,7,9,63,60,3,49
Coleraine,5365,5,11,13,6,46,40,6,46
Glenavon,5365,6,10,12,8,46,48,-2,42
Portadown,5365,7,11,4,15,34,44,-10,37
Glentoran,5365,8,9,7,14,31,46,-15,34
Ards,5365,9,9,5,16,39,54,-15,32
Dungannon,5365,10,6,10,14,44,52,-8,28
Ballinamalla,5365,11,6,4,20,25,54,-29,22
Crusaders,5366,1,18,6,6,55,31,24,60
Cliftonville,5366,2,17,4,9,55,34,21,55
Ballymena,5366,3,16,5,9,60,59,1,53
Linfield,5366,4,13,9,8,56,39,17,48
Glenavon,5366,5,11,10,9,46,44,2,43
Coleraine,5366,6,10,11,9,40,41,-1,41
Dungannon,5366,7,11,7,12,48,48,0,40
Glentoran,5366,8,10,8,12,37,42,-5,38
Ards,5366,9,7,9,14,39,47,-8,30
Portadown,5366,10,8,5,17,23,45,-22,29
Ballinamalla,5366,11,5,4,21,27,56,-29,19
Crusaders,5367,1,18,7,5,54,24,30,61
Linfield,5367,2,15,8,7,61,34,27,53
Glenavon,5367,3,14,9,7,51,39,12,51
Coleraine,5367,4,12,9,9,42,46,-4,45
Ballymena,5367,5,12,8,10,60,64,-4,44
Glentoran,5367,6,11,7,12,35,42,-7,40
Cliftonville,5367,7,11,5,14,42,47,-5,38
Dungannon,5367,8,7,11,12,45,48,-3,32
Ards,5367,9,8,7,15,34,45,-11,31
Ballinamalla,5367,10,8,5,17,28,45,-17,29
Portadown,5367,11,7,8,15,21,39,-18,29
Cliftonville,5368,1,17,6,7,64,36,28,57
Linfield,5368,2,16,6,8,59,34,25,54
Glenavon,5368,3,14,9,7,47,41,6,51
Crusaders,5368,4,14,8,8,51,36,15,50
Coleraine,5368,5,11,10,9,42,38,4,43
Glentoran,5368,6,11,7,12,36,46,-10,40
Ballymena,5368,7,12,4,14,54,69,-15,40
Dungannon,5368,8,9,9,12,45,45,0,36
Ards,5368,9,9,4,17,42,54,-12,31
Ballinamalla,5368,10,8,6,16,26,45,-19,30
Portadown,5368,11,8,3,19,24,46,-22,27
Cliftonville,5369,1,14,11,5,57,41,16,53
Crusaders,5369,2,15,8,7,48,39,9,53
Linfield,5369,3,12,15,3,50,27,23,51
Glenavon,5369,4,10,12,8,43,42,1,42
Coleraine,5369,5,10,11,9,45,38,7,41
Dungannon,5369,6,10,9,11,48,40,8,39
Ballymena,5369,7,10,7,13,54,65,-11,37
Ards,5369,8,11,3,16,42,47,-5,36
Portadown,5369,9,9,9,12,29,39,-10,36
Glentoran,5369,10,8,10,12,34,44,-10,34
Ballinamalla,5369,11,7,3,20,25,53,-28,24
Crusaders,5370,1,16,6,8,57,39,18,54
Cliftonville,5370,2,16,4,10,53,37,16,52
Ballymena,5370,3,15,4,11,48,55,-7,49
Linfield,5370,4,13,6,11,56,38,18,45
Dungannon,5370,5,12,9,9,52,45,7,45
Glenavon,5370,6,11,10,9,50,47,3,43
Coleraine,5370,7,11,8,11,43,42,1,41
Portadown,5370,8,10,5,15,33,43,-10,35
Glentoran,5370,9,9,8,13,38,52,-14,35
Ballinamalla,5370,10,10,3,17,38,58,-20,33
Ards,5370,11,9,3,18,51,63,-12,30
Crusaders,5371,1,16,7,7,55,35,20,55
Cliftonville,5371,2,15,8,7,53,36,17,53
Linfield,5371,3,14,9,7,56,32,24,51
Glenavon,5371,4,13,10,7,54,43,11,49
Ballymena,5371,5,14,4,12,62,67,-5,46
Coleraine,5371,6,11,11,8,39,35,4,44
Dungannon,5371,7,10,10,10,53,50,3,40
Ballinamalla,5371,8,10,5,15,36,54,-18,35
Glentoran,5371,9,8,10,12,28,40,-12,34
Ards,5371,10,7,4,19,33,50,-17,25
Portadown,5371,11,5,6,19,22,49,-27,21
Ballymena,5372,1,16,6,8,60,62,-2,54
Cliftonville,5372,2,16,4,10,54,38,16,52
Linfield,5372,3,14,8,8,63,38,25,50
Crusaders,5372,4,14,8,8,51,40,11,50
Coleraine,5372,5,13,9,8,48,40,8,48
Glenavon,5372,6,12,10,8,49,39,10,46
Dungannon,5372,7,9,8,13,46,46,0,35
Glentoran,5372,8,9,7,14,29,40,-11,34
Ards,5372,9,9,5,16,35,48,-13,32
Ballinamalla,5372,10,8,4,18,31,53,-22,28
Portadown,5372,11,7,7,16,22,44,-22,28
Crusaders,5373,1,18,6,6,60,36,24,60
Cliftonville,5373,2,18,2,10,62,43,19,56
Glenavon,5373,3,15,8,7,62,41,21,53
Linfield,5373,4,15,7,8,56,42,14,52
Ballymena,5373,5,15,5,10,61,60,1,50
Coleraine,5373,6,11,9,10,42,42,0,42
Glentoran,5373,7,9,7,14,37,50,-13,34
Ards,5373,8,10,4,16,41,56,-15,34
Dungannon,5373,9,7,10,13,48,47,1,31
Ballinamalla,5373,10,8,3,19,32,58,-26,27
Portadown,5373,11,5,7,18,23,49,-26,22
Cliftonville,5374,1,18,3,9,54,32,22,57
Crusaders,5374,2,17,5,8,57,40,17,56
Linfield,5374,3,15,8,7,56,33,23,53
Coleraine,5374,4,14,10,6,50,35,15,52
Ballymena,5374,5,15,7,8,65,58,7,52
Glenavon,5374,6,11,10,9,51,48,3,43
Dungannon,5374,7,11,8,11,54,45,9,41
Ballinamalla,5374,8,8,6,16,32,53,-21,30
Ards,5374,9,7,5,18,33,54,-21,26
Glentoran,5374,10,6,7,17,27,55,-28,25
Portadown,5374,11,6,5,19,28,54,-26,23
Crusaders,5375,1,16,10,4,60,32,28,58
Linfield,5375,2,15,8,7,61,27,34,53
Cliftonville,5375,3,17,2,11,49,37,12,53
Glenavon,5375,4,13,12,5,46,34,12,51
Coleraine,5375,5,11,12,7,41,31,10,45
Ballymena,5375,6,14,3,13,55,68,-13,45
Dungannon,5375,7,9,12,9,50,43,7,39
Glentoran,5375,8,10,8,12,31,42,-11,38
Ards,5375,9,8,4,18,33,53,-20,28
Portadown,5375,10,7,6,17,23,44,-21,27
Ballinamalla,5375,11,5,3,22,25,63,-38,18
Ballymena,5376,1,19,4,7,66,55,11,61
Linfield,5376,2,16,7,7,58,30,28,55
Cliftonville,5376,3,17,4,9,57,38,19,55
Crusaders,5376,4,15,5,10,55,51,4,50
Dungannon,5376,5,13,7,10,54,42,12,46
Coleraine,5376,6,11,10,9,46,36,10,43
Glenavon,5376,7,8,12,10,38,46,-8,36
Glentoran,5376,8,7,8,15,32,49,-17,29
Portadown,5376,9,8,5,17,21,42,-21,29
Ballinamalla,5376,10,9,2,19,33,57,-24,29
Ards,5376,11,6,8,16,35,49,-14,26
Linfield,5377,1,18,7,5,59,30,29,61
Crusaders,5377,2,16,8,6,53,34,19,56
Cliftonville,5377,3,16,3,11,49,38,11,51
Glenavon,5377,4,14,8,8,54,44,10,50
Ballymena,5377,5,14,5,11,67,60,7,47
Coleraine,5377,6,10,11,9,46,44,2,41
Dungannon,5377,7,8,11,11,42,42,0,35
Ballinamalla,5377,8,10,3,17,29,49,-20,33
Ards,5377,9,8,6,16,38,48,-10,30
Portadown,5377,10,7,6,17,29,51,-22,27
Glentoran,5377,11,6,8,16,25,51,-26,26
Linfield,5378,1,17,8,5,66,32,34,59
Crusaders,5378,2,17,6,7,58,37,21,57
Cliftonville,5378,3,17,3,10,56,37,19,54
Coleraine,5378,4,13,11,6,49,33,16,50
Ballymena,5378,5,13,7,10,59,59,0,46
Glenavon,5378,6,10,13,7,47,43,4,43
Dungannon,5378,7,10,7,13,51,51,0,37
Ards,5378,8,9,6,15,36,49,-13,33
Glentoran,5378,9,8,9,13,30,53,-23,33
Ballinamalla,5378,10,6,5,19,31,60,-29,23
Portadown,5378,11,5,5,20,22,51,-29,20
Crusaders,5379,1,16,8,6,54,34,20,56
Linfield,5379,2,16,7,7,57,28,29,55
Glenavon,5379,3,12,13,5,53,38,15,49
Ballymena,5379,4,14,5,11,57,57,0,47
Coleraine,5379,5,12,10,8,41,38,3,46
Cliftonville,5379,6,12,5,13,47,44,3,41
Glentoran,5379,7,9,10,11,30,39,-9,37
Dungannon,5379,8,8,11,11,46,44,2,35
Ards,5379,9,9,6,15,38,50,-12,33
Ballinamalla,5379,10,8,3,19,27,59,-32,27
Portadown,5379,11,5,10,15,21,40,-19,25
Linfield,5380,1,17,8,5,67,29,38,59
Crusaders,5380,2,16,10,4,56,32,24,58
Cliftonville,5380,3,16,3,11,54,39,15,51
Ballymena,5380,4,15,5,10,61,56,5,50
Glenavon,5380,5,13,10,7,56,49,7,49
Coleraine,5380,6,11,10,9,42,40,2,43
Dungannon,5380,7,9,7,14,49,51,-2,34
Ards,5380,8,10,3,17,44,53,-9,33
Ballinamalla,5380,9,9,6,15,26,44,-18,33
Glentoran,5380,10,7,7,16,25,49,-24,28
Portadown,5380,11,5,5,20,21,59,-38,20
Crusaders,5381,1,20,7,3,67,33,34,67
Glenavon,5381,2,14,11,5,54,38,16,53
Linfield,5381,3,13,11,6,69,39,30,50
Cliftonville,5381,4,15,4,11,55,50,5,49
Ballymena,5381,5,14,6,10,55,59,-4,48
Coleraine,5381,6,9,12,9,47,44,3,39
Ards,5381,7,11,5,14,48,50,-2,38
Dungannon,5381,8,7,11,12,44,49,-5,32
Portadown,5381,9,8,5,17,32,53,-21,29
Glentoran,5381,10,6,7,17,27,50,-23,25
Ballinamalla,5381,11,7,3,20,24,57,-33,24
Ballymena,5382,1,17,5,8,59,51,8,56
Linfield,5382,2,14,12,4,63,27,36,54
Crusaders,5382,3,13,9,8,51,40,11,48
Coleraine,5382,4,13,7,10,46,36,10,46
Cliftonville,5382,5,14,4,12,50,44,6,46
Glenavon,5382,6,12,10,8,51,47,4,46
Dungannon,5382,7,12,8,10,58,48,10,44
Ballinamalla,5382,8,9,4,17,35,54,-19,31
Glentoran,5382,9,8,7,15,26,46,-20,31
Ards,5382,10,9,3,18,37,55,-18,30
Portadown,5382,11,5,9,16,21,49,-28,24
Crusaders,5383,1,17,8,5,56,32,24,59
Linfield,5383,2,14,10,6,63,39,24,52
Glenavon,5383,3,13,10,7,51,47,4,49
Cliftonville,5383,4,15,3,12,55,44,11,48
Coleraine,5383,5,12,10,8,46,37,9,46
Ballymena,5383,6,13,6,11,52,58,-6,45
Ballinamalla,5383,7,11,2,17,33,52,-19,35
Dungannon,5383,8,8,10,12,49,46,3,34
Ards,5383,9,8,8,14,34,44,-10,32
Portadown,5383,10,7,7,16,24,46,-22,28
Glentoran,5383,11,6,8,16,29,47,-18,26
Linfield,5384,1,18,7,5,63,27,36,61
Crusaders,5384,2,18,6,6,56,34,22,60
Cliftonville,5384,3,17,5,8,53,33,20,56
Dungannon,5384,4,14,8,8,63,41,22,50
Glenavon,5384,5,10,11,9,52,51,1,41
Coleraine,5384,6,10,11,9,42,45,-3,41
Ballymena,5384,7,12,5,13,56,66,-10,41
Ballinamalla,5384,8,9,5,16,33,54,-21,32
Glentoran,5384,9,8,5,17,31,52,-21,29
Ards,5384,10,7,6,17,34,50,-16,27
Portadown,5384,11,5,5,20,21,51,-30,20
Glenavon,5385,1,16,10,4,55,34,21,58
Crusaders,5385,2,16,9,5,52,33,19,57
Cliftonville,5385,3,15,6,9,47,36,11,51
Linfield,5385,4,13,10,7,58,30,28,49
Ballymena,5385,5,13,7,10,64,58,6,46
Dungannon,5385,6,12,9,9,57,44,13,45
Coleraine,5385,7,11,9,10,40,40,0,42
Glentoran,5385,8,6,11,13,24,46,-22,29
Ards,5385,9,7,5,18,35,58,-23,26
Ballinamalla,5385,10,6,7,17,22,48,-26,25
Portadown,5385,11,6,5,19,23,50,-27,23
Cliftonville,5386,1,16,6,8,61,46,15,54
Crusaders,5386,2,15,7,8,53,37,16,52
Coleraine,5386,3,12,12,6,46,30,16,48
Ballymena,5386,4,14,4,12,58,64,-6,46
Linfield,5386,5,12,9,9,54,39,15,45
Dungannon,5386,6,10,11,9,53,44,9,41
Ballinamalla,5386,7,12,3,15,34,46,-12,39
Glenavon,5386,8,9,11,10,40,44,-4,38
Portadown,5386,9,10,4,16,33,48,-15,34
Glentoran,5386,10,8,7,15,31,48,-17,31
Ards,5386,11,7,6,17,31,48,-17,27
Crusaders,5387,1,17,8,5,58,36,22,59
Coleraine,5387,2,14,12,4,47,30,17,54
Glenavon,5387,3,15,8,7,56,42,14,53
Linfield,5387,4,14,8,8,64,40,24,50
Ballymena,5387,5,14,8,8,58,58,0,50
Cliftonville,5387,6,14,4,12,53,38,15,46
Glentoran,5387,7,9,6,15,30,47,-17,33
Ballinamalla,5387,8,9,4,17,30,47,-17,31
Ards,5387,9,8,6,16,40,58,-18,30
Dungannon,5387,10,7,8,15,46,51,-5,29
Portadown,5387,11,6,4,20,19,54,-35,22
Crusaders,5388,1,18,6,6,59,35,24,60
Cliftonville,5388,2,18,3,9,58,48,10,57
Linfield,5388,3,15,11,4,70,33,37,56
Ballymena,5388,4,15,4,11,63,62,1,49
Coleraine,5388,5,12,9,9,55,42,13,45
Dungannon,5388,6,10,10,10,54,50,4,40
Glenavon,5388,7,11,7,12,50,50,0,40
Glentoran,5388,8,8,8,14,28,46,-18,32
Ards,5388,9,7,6,17,40,56,-16,27
Ballinamalla,5388,10,8,3,19,30,57,-27,27
Portadown,5388,11,8,3,19,31,59,-28,27
Crusaders,5389,1,16,5,9,57,41,16,53
Linfield,5389,2,13,10,7,60,37,23,49
Glenavon,5389,3,13,10,7,54,38,16,49
Cliftonville,5389,4,14,5,11,47,36,11,47
Ballymena,5389,5,14,5,11,48,54,-6,47
Glentoran,5389,6,13,7,10,35,35,0,46
Dungannon,5389,7,11,8,11,48,46,2,41
Coleraine,5389,8,9,10,11,36,40,-4,37
Portadown,5389,9,9,6,15,24,42,-18,33
Ards,5389,10,7,6,17,27,45,-18,27
Ballinamalla,5389,11,7,6,17,32,54,-22,27
Crusaders,5390,1,18,7,5,55,33,22,61
Cliftonville,5390,2,16,6,8,50,36,14,54
Linfield,5390,3,14,9,7,56,34,22,51
Glenavon,5390,4,12,12,6,49,40,9,48
Ballymena,5390,5,12,9,9,50,55,-5,45
Ards,5390,6,11,5,14,40,46,-6,38
Coleraine,5390,7,8,13,9,42,40,2,37
Dungannon,5390,8,8,10,12,48,39,9,34
Glentoran,5390,9,9,4,17,28,44,-16,31
Ballinamalla,5390,10,7,6,17,25,49,-24,27
Portadown,5390,11,6,7,17,25,52,-27,25
Linfield,5391,1,16,9,5,62,26,36,57
Cliftonville,5391,2,17,6,7,55,33,22,57
Crusaders,5391,3,15,8,7,50,36,14,53
Glenavon,5391,4,14,9,7,56,40,16,51
Ballymena,5391,5,12,5,13,52,59,-7,41
Coleraine,5391,6,9,11,10,42,37,5,38
Ards,5391,7,10,5,15,37,49,-12,35
Ballinamalla,5391,8,11,2,17,29,47,-18,35
Dungannon,5391,9,9,7,14,49,55,-6,34
Portadown,5391,10,8,6,16,26,48,-22,30
Glentoran,5391,11,7,6,17,25,53,-28,27
Crusaders,5392,1,17,7,6,54,29,25,58
Linfield,5392,2,15,9,6,60,35,25,54
Cliftonville,5392,3,16,6,8,54,38,16,54
Coleraine,5392,4,12,10,8,44,37,7,46
Ballymena,5392,5,13,6,11,54,55,-1,45
Glentoran,5392,6,13,6,11,40,41,-1,45
Dungannon,5392,7,10,8,12,49,45,4,38
Ards,5392,8,10,4,16,37,51,-14,34
Ballinamalla,5392,9,9,3,18,26,47,-21,30
Glenavon,5392,10,6,11,13,41,54,-13,29
Portadown,5392,11,7,4,19,26,53,-27,25
Crusaders,5393,1,17,6,7,57,33,24,57
Cliftonville,5393,2,16,4,10,55,40,15,52
Ballymena,5393,3,16,4,10,68,58,10,52
Coleraine,5393,4,13,8,9,49,38,11,47
Linfield,5393,5,12,10,8,58,40,18,46
Ards,5393,6,12,5,13,45,45,0,41
Glenavon,5393,7,10,10,10,45,47,-2,40
Glentoran,5393,8,8,10,12,25,39,-14,34
Ballinamalla,5393,9,10,4,16,32,54,-22,34
Dungannon,5393,10,7,10,13,40,43,-3,31
Portadown,5393,11,6,5,19,17,54,-37,23
Coleraine,5394,1,15,10,5,47,33,14,55
Linfield,5394,2,15,9,6,64,33,31,54
Crusaders,5394,3,15,8,7,59,45,14,53
Cliftonville,5394,4,14,6,10,46,33,13,48
Glenavon,5394,5,11,14,5,48,41,7,47
Ballymena,5394,6,13,7,10,55,62,-7,46
Dungannon,5394,7,9,10,11,52,43,9,37
Ards,5394,8,10,3,17,38,47,-9,33
Glentoran,5394,9,6,11,13,28,42,-14,29
Ballinamalla,5394,10,7,4,19,26,55,-29,25
Portadown,5394,10,7,4,19,26,55,-29,25
Linfield,5395,1,15,7,8,62,36,26,52
Crusaders,5395,2,14,8,8,56,36,20,50
Cliftonville,5395,3,13,6,11,50,44,6,45
Ballymena,5395,4,13,6,11,58,58,0,45
Glenavon,5395,5,11,10,9,46,45,1,43
Dungannon,5395,6,10,11,9,52,48,4,41
Coleraine,5395,7,10,10,10,42,40,2,40
Glentoran,5395,8,9,11,10,35,46,-11,38
Ballinamalla,5395,9,11,5,14,36,48,-12,38
Portadown,5395,10,9,5,16,31,51,-20,32
Ards,5395,11,6,9,15,40,56,-16,27
Crusaders,5396,1,16,7,7,58,33,25,55
Glenavon,5396,2,15,10,5,54,36,18,55
Cliftonville,5396,3,15,7,8,55,34,21,52
Linfield,5396,4,13,10,7,57,35,22,49
Ballymena,5396,5,13,7,10,61,66,-5,46
Dungannon,5396,6,11,10,9,58,45,13,43
Coleraine,5396,7,9,11,10,37,42,-5,38
Ards,5396,8,9,7,14,41,54,-13,34
Ballinamalla,5396,9,9,6,15,34,51,-17,33
Glentoran,5396,10,8,6,16,26,49,-23,30
Portadown,5396,11,5,3,22,18,54,-36,18
Crusaders,5397,1,18,6,6,57,30,27,60
Linfield,5397,2,14,8,8,58,36,22,50
Ballymena,5397,3,15,5,10,57,52,5,50
Coleraine,5397,4,11,10,9,46,41,5,43
Cliftonville,5397,5,12,7,11,47,49,-2,43
Glenavon,5397,6,10,11,9,43,43,0,41
Ards,5397,7,11,7,12,38,44,-6,40
Dungannon,5397,8,10,9,11,47,39,8,39
Glentoran,5397,9,9,8,13,31,44,-13,35
Portadown,5397,10,8,6,16,30,50,-20,30
Ballinamalla,5397,11,7,3,20,26,52,-26,24
Cliftonville,5398,1,17,6,7,53,30,23,57
Crusaders,5398,2,17,6,7,55,33,22,57
Linfield,5398,3,14,10,6,61,32,29,52
Glenavon,5398,4,13,8,9,48,45,3,47
Coleraine,5398,5,10,13,7,47,39,8,43
Ballymena,5398,6,11,7,12,57,67,-10,40
Glentoran,5398,7,10,8,12,38,46,-8,38
Ards,5398,8,10,5,15,42,56,-14,35
Dungannon,5398,9,8,8,14,48,53,-5,32
Ballinamalla,5398,10,8,5,17,31,54,-23,29
Portadown,5398,11,6,6,18,24,49,-25,24
Crusaders,5399,1,16,9,5,59,30,29,57
Cliftonville,5399,2,15,7,8,53,37,16,52
Ballymena,5399,3,14,6,10,60,55,5,48
Linfield,5399,4,13,8,9,53,41,12,47
Glenavon,5399,5,12,11,7,46,44,2,47
Dungannon,5399,6,11,10,9,46,38,8,43
Glentoran,5399,7,12,6,12,30,35,-5,42
Coleraine,5399,8,10,11,9,38,43,-5,41
Ards,5399,9,10,5,15,39,43,-4,35
Portadown,5399,10,5,7,18,20,47,-27,22
Ballinamalla,5399,11,4,6,20,24,55,-31,18
Linfield,5400,1,15,11,4,61,29,32,56
Cliftonville,5400,2,17,4,9,54,39,15,55
Glenavon,5400,3,13,12,5,54,40,14,51
Crusaders,5400,4,14,8,8,62,44,18,50
Ballymena,5400,5,13,6,11,57,62,-5,45
Dungannon,5400,6,10,11,9,51,44,7,41
Ballinamalla,5400,7,10,7,13,33,46,-13,37
Glentoran,5400,8,7,11,12,31,46,-15,32
Coleraine,5400,9,7,10,13,41,46,-5,31
Portadown,5400,10,7,8,15,31,50,-19,29
Ards,5400,11,5,6,19,28,57,-29,21
Linfield,5401,1,17,7,6,64,30,34,58
Cliftonville,5401,2,18,4,8,59,37,22,58
Crusaders,5401,3,15,10,5,60,38,22,55
Ballymena,5401,4,14,6,10,59,60,-1,48
Coleraine,5401,5,12,10,8,43,42,1,46
Glenavon,5401,6,11,10,9,44,43,1,43
Glentoran,5401,7,9,9,12,35,51,-16,36
Dungannon,5401,8,8,9,13,46,46,0,33
Ards,5401,9,9,6,15,40,45,-5,33
Ballinamalla,5401,10,5,7,18,22,53,-31,22
Portadown,5401,11,5,6,19,23,50,-27,21
Linfield,5402,1,16,8,6,68,33,35,56
Glenavon,5402,2,16,8,6,63,44,19,56
Cliftonville,5402,3,17,3,10,52,37,15,54
Crusaders,5402,4,16,5,9,58,39,19,53
Ballymena,5402,5,12,7,11,51,61,-10,43
Dungannon,5402,6,10,9,11,49,45,4,39
Coleraine,5402,7,9,11,10,39,38,1,38
Glentoran,5402,8,8,9,13,34,47,-13,33
Ballinamalla,5402,9,9,3,18,29,53,-24,30
Portadown,5402,10,8,5,17,25,45,-20,29
Ards,5402,11,7,6,17,30,56,-26,27
Crusaders,5403,1,15,8,7,54,35,19,53
Cliftonville,5403,2,15,6,9,48,36,12,51
Linfield,5403,3,12,12,6,52,31,21,48
Glenavon,5403,4,12,11,7,53,49,4,47
Coleraine,5403,5,10,14,6,50,43,7,44
Ballymena,5403,6,13,5,12,56,62,-6,44
Dungannon,5403,7,9,9,12,49,49,0,36
Portadown,5403,8,11,3,16,34,48,-14,36
Glentoran,5403,9,8,9,13,32,45,-13,33
Ards,5403,10,8,6,16,34,47,-13,30
Ballinamalla,5403,11,8,5,17,37,54,-17,29
Ballymena,5404,1,18,4,8,60,52,8,58
Linfield,5404,2,13,12,5,63,40,23,51
Crusaders,5404,3,14,8,8,52,37,15,50
Cliftonville,5404,4,13,7,10,54,40,14,46
Glenavon,5404,5,10,11,9,47,49,-2,41
Coleraine,5404,6,10,10,10,43,43,0,40
Ards,5404,7,11,3,16,41,47,-6,36
Dungannon,5404,8,8,10,12,51,47,4,34
Ballinamalla,5404,9,10,4,16,34,55,-21,34
Portadown,5404,10,8,8,14,25,43,-18,32
Glentoran,5404,11,8,7,15,34,51,-17,31
Glenavon,5405,1,14,11,5,58,43,15,53
Linfield,5405,2,12,11,7,58,40,18,47
Crusaders,5405,3,13,8,9,55,45,10,47
Ballymena,5405,4,12,10,8,55,54,1,46
Cliftonville,5405,5,12,9,9,45,36,9,45
Dungannon,5405,6,11,10,9,55,44,11,43
Ballinamalla,5405,7,11,4,15,31,43,-12,37
Coleraine,5405,8,7,14,9,34,37,-3,35
Portadown,5405,9,10,5,15,24,38,-14,35
Glentoran,5405,10,8,7,15,27,48,-21,31
Ards,5405,11,9,3,18,33,47,-14,30
Linfield,5406,1,16,7,7,61,32,29,55
Cliftonville,5406,2,16,5,9,48,34,14,53
Crusaders,5406,3,16,4,10,50,36,14,52
Coleraine,5406,4,13,11,6,51,37,14,50
Dungannon,5406,5,10,10,10,53,48,5,40
Glentoran,5406,6,10,8,12,27,34,-7,38
Ballymena,5406,7,10,8,12,53,63,-10,38
Glenavon,5406,8,8,12,10,44,53,-9,36
Ballinamalla,5406,9,9,6,15,37,49,-12,33
Ards,5406,10,9,4,17,35,53,-18,31
Portadown,5406,11,7,7,16,23,43,-20,28
Linfield,5407,1,15,12,3,63,29,34,57
Cliftonville,5407,2,17,5,8,52,37,15,56
Crusaders,5407,3,15,10,5,57,32,25,55
Ballymena,5407,4,13,6,11,55,62,-7,45
Coleraine,5407,5,10,11,9,42,40,2,41
Glenavon,5407,6,10,11,9,44,52,-8,41
Dungannon,5407,7,9,10,11,43,39,4,37
Glentoran,5407,8,9,10,11,36,40,-4,37
Ards,5407,9,8,9,13,38,51,-13,33
Portadown,5407,10,6,6,18,20,42,-22,24
Ballinamalla,5407,11,6,4,20,25,51,-26,22
Cliftonville,5408,1,18,4,8,57,36,21,58
Linfield,5408,2,15,10,5,57,26,31,55
Crusaders,5408,3,16,7,7,53,39,14,55
Ballymena,5408,4,15,4,11,52,53,-1,49
Glenavon,5408,5,13,9,8,48,42,6,48
Coleraine,5408,6,11,8,11,39,38,1,41
Dungannon,5408,7,8,12,10,50,47,3,36
Glentoran,5408,8,8,8,14,26,44,-18,32
Portadown,5408,9,9,4,17,28,46,-18,31
Ards,5408,10,7,7,16,35,48,-13,28
Ballinamalla,5408,11,6,5,19,30,56,-26,23
Ballymena,5409,1,16,6,8,58,52,6,54
Cliftonville,5409,2,15,7,8,54,40,14,52
Crusaders,5409,3,15,6,9,47,35,12,51
Linfield,5409,4,14,7,9,49,31,18,49
Glentoran,5409,5,13,5,12,30,36,-6,44
Coleraine,5409,6,11,10,9,36,40,-4,43
Glenavon,5409,7,10,11,9,48,46,2,41
Dungannon,5409,8,8,11,11,48,44,4,35
Ballinamalla,5409,9,9,4,17,34,51,-17,31
Portadown,5409,10,7,7,16,27,39,-12,28
Ards,5409,11,6,8,16,33,50,-17,26
Linfield,5410,1,16,8,6,57,25,32,56
Crusaders,5410,2,16,6,8,49,32,17,54
Glenavon,5410,3,14,10,6,49,39,10,52
Cliftonville,5410,4,15,5,10,51,37,14,50
Ballymena,5410,5,14,7,9,50,54,-4,49
Dungannon,5410,6,13,8,9,54,38,16,47
Coleraine,5410,7,10,9,11,43,41,2,39
Glentoran,5410,8,10,5,15,31,42,-11,35
Ballinamalla,5410,9,8,6,16,25,46,-21,30
Ards,5410,10,7,6,17,34,56,-22,27
Portadown,5410,11,5,4,21,20,53,-33,19
Cliftonville,5411,1,18,5,7,54,31,23,59
Crusaders,5411,2,15,8,7,55,42,13,53
Ballymena,5411,3,14,6,10,58,49,9,48
Linfield,5411,4,13,7,10,56,41,15,46
Glenavon,5411,5,12,9,9,45,41,4,45
Coleraine,5411,6,10,11,9,36,36,0,41
Glentoran,5411,7,11,7,12,42,44,-2,40
Ards,5411,8,11,4,15,37,45,-8,37
Dungannon,5411,9,8,8,14,47,56,-9,32
Portadown,5411,10,9,4,17,30,51,-21,31
Ballinamalla,5411,11,8,3,19,29,53,-24,27
Crusaders,5412,1,17,7,6,59,32,27,58
Linfield,5412,2,15,7,8,56,33,23,52
Glenavon,5412,3,14,8,8,49,49,0,50
Cliftonville,5412,4,13,9,8,52,39,13,48
Ballymena,5412,5,13,8,9,66,60,6,47
Coleraine,5412,6,12,10,8,50,40,10,46
Ards,5412,7,12,4,14,42,50,-8,40
Dungannon,5412,8,9,10,11,49,46,3,37
Ballinamalla,5412,9,8,3,19,34,58,-24,27
Glentoran,5412,10,6,8,16,28,52,-24,26
Portadown,5412,11,6,6,18,24,50,-26,24
Cliftonville,5413,1,19,4,7,55,35,20,61
Ballymena,5413,2,15,6,9,56,52,4,51
Coleraine,5413,3,14,8,8,48,40,8,50
Linfield,5413,4,14,7,9,57,30,27,49
Crusaders,5413,5,13,8,9,45,33,12,47
Glenavon,5413,6,11,9,10,43,45,-2,42
Dungannon,5413,7,9,12,9,54,47,7,39
Ards,5413,8,10,4,16,36,48,-12,34
Ballinamalla,5413,9,10,3,17,33,51,-18,33
Portadown,5413,10,7,6,17,26,48,-22,27
Glentoran,5413,11,5,9,16,20,44,-24,24
Crusaders,5414,1,17,9,4,58,33,25,60
Cliftonville,5414,2,18,4,8,55,33,22,58
Linfield,5414,3,15,12,3,66,31,35,57
Ballymena,5414,4,13,6,11,52,54,-2,45
Coleraine,5414,5,11,11,8,40,35,5,44
Glenavon,5414,6,10,13,7,42,40,2,43
Glentoran,5414,7,10,7,13,36,43,-7,37
Ards,5414,8,9,6,15,35,47,-12,33
Dungannon,5414,9,8,8,14,47,56,-9,32
Portadown,5414,10,4,9,17,17,45,-28,21
Ballinamalla,5414,11,4,7,19,19,50,-31,19
Crusaders,5415,1,20,5,5,62,30,32,65
Ballymena,5415,2,18,4,8,67,55,12,58
Linfield,5415,3,15,8,7,59,32,27,53
Glenavon,5415,4,11,14,5,52,42,10,47
Cliftonville,5415,5,12,7,11,44,40,4,43
Ards,5415,6,13,4,13,43,43,0,43
Coleraine,5415,7,10,11,9,44,43,1,41
Portadown,5415,8,9,5,16,25,39,-14,32
Dungannon,5415,9,6,8,16,40,55,-15,26
Glentoran,5415,10,6,8,16,29,53,-24,26
Ballinamalla,5415,11,6,4,20,27,60,-33,22
Cliftonville,5416,1,17,7,6,58,37,21,58
Crusaders,5416,2,17,6,7,59,33,26,57
Linfield,5416,3,13,8,9,59,36,23,47
Coleraine,5416,4,12,9,9,45,39,6,45
Glenavon,5416,5,11,11,8,47,45,2,44
Glentoran,5416,6,11,7,12,36,47,-11,40
Ballymena,5416,7,11,6,13,50,71,-21,39
Ards,5416,8,11,4,15,38,44,-6,37
Ballinamalla,5416,9,9,5,16,29,47,-18,32
Portadown,5416,10,9,3,18,29,46,-17,30
Dungannon,5416,11,6,10,14,42,47,-5,28
Cliftonville,5417,1,18,4,8,59,37,22,58
Linfield,5417,2,14,10,6,56,33,23,52
Crusaders,5417,3,14,6,10,52,34,18,48
Coleraine,5417,4,12,11,7,38,28,10,47
Ballymena,5417,5,13,6,11,52,58,-6,45
Glenavon,5417,6,11,11,8,40,41,-1,44
Ballinamalla,5417,7,12,3,15,34,46,-12,39
Portadown,5417,8,9,5,16,26,39,-13,32
Ards,5417,9,9,5,16,35,52,-17,32
Dungannon,5417,10,7,10,13,39,47,-8,31
Glentoran,5417,11,8,5,17,32,48,-16,29
Crusaders,5418,1,17,8,5,51,29,22,59
Cliftonville,5418,2,17,4,9,57,35,22,55
Linfield,5418,3,14,9,7,60,35,25,51
Dungannon,5418,4,12,9,9,49,35,14,45
Ballymena,5418,5,12,7,11,54,58,-4,43
Glenavon,5418,6,9,13,8,44,43,1,40
Coleraine,5418,7,10,10,10,35,35,0,40
Glentoran,5418,8,8,9,13,34,43,-9,33
Ards,5418,9,9,5,16,36,53,-17,32
Ballinamalla,5418,10,8,6,16,28,49,-21,30
Portadown,5418,11,7,4,19,21,54,-33,25
Linfield,5419,1,18,8,4,63,28,35,62
Cliftonville,5419,2,17,4,9,53,36,17,55
Crusaders,5419,3,14,5,11,54,36,18,47
Ballymena,5419,4,14,5,11,62,58,4,47
Glenavon,5419,5,11,12,7,50,44,6,45
Coleraine,5419,6,10,14,6,37,33,4,44
Dungannon,5419,7,10,10,10,52,46,6,40
Glentoran,5419,8,8,6,16,28,50,-22,30
Ards,5419,9,8,5,17,40,60,-20,29
Portadown,5419,10,8,5,17,24,46,-22,29
Ballinamalla,5419,11,7,6,17,27,53,-26,27
Linfield,5420,1,15,9,6,63,30,33,54
Crusaders,5420,2,13,12,5,48,29,19,51
Cliftonville,5420,3,15,6,9,50,38,12,51
Ballymena,5420,4,14,7,9,56,60,-4,49
Dungannon,5420,5,12,9,9,52,42,10,45
Coleraine,5420,6,10,13,7,46,39,7,43
Ards,5420,7,12,5,13,46,49,-3,41
Glenavon,5420,8,8,13,9,45,47,-2,37
Glentoran,5420,9,9,7,14,31,47,-16,34
Ballinamalla,5420,10,6,5,19,23,53,-30,23
Portadown,5420,11,4,8,18,20,46,-26,20
Crusaders,5421,1,17,7,6,56,36,20,58
Cliftonville,5421,2,17,3,10,53,37,16,54
Linfield,5421,3,15,7,8,60,31,29,52
Coleraine,5421,4,14,10,6,41,28,13,52
Glenavon,5421,5,10,10,10,46,47,-1,40
Ballymena,5421,6,11,7,12,51,56,-5,40
Ballinamalla,5421,7,10,5,15,30,48,-18,35
Dungannon,5421,8,9,7,14,48,43,5,34
Portadown,5421,9,9,7,14,26,41,-15,34
Glentoran,5421,10,8,7,15,28,49,-21,31
Ards,5421,11,8,4,18,32,55,-23,28
Crusaders,5422,1,18,7,5,59,35,24,61
Linfield,5422,2,14,9,7,59,36,23,51
Cliftonville,5422,3,14,6,10,53,43,10,48
Dungannon,5422,4,12,8,10,52,43,9,44
Glenavon,5422,5,10,13,7,49,49,0,43
Coleraine,5422,6,9,12,9,41,36,5,39
Ballymena,5422,7,10,8,12,51,64,-13,38
Glentoran,5422,8,10,7,13,37,43,-6,37
Ards,5422,9,10,4,16,42,56,-14,34
Portadown,5422,10,8,5,17,27,44,-17,29
Ballinamalla,5422,11,8,5,17,34,55,-21,29
Linfield,5423,1,17,8,5,67,33,34,59
Crusaders,5423,2,15,10,5,53,34,19,55
Ballymena,5423,3,16,4,10,61,60,1,52
Cliftonville,5423,4,14,6,10,49,38,11,48
Coleraine,5423,5,11,9,10,40,35,5,42
Dungannon,5423,6,11,8,11,55,43,12,41
Ballinamalla,5423,7,11,6,13,32,39,-7,39
Glenavon,5423,8,8,10,12,42,55,-13,34
Glentoran,5423,9,9,6,15,28,49,-21,33
Ards,5423,10,6,8,16,36,50,-14,26
Portadown,5423,11,7,5,18,31,58,-27,26
Cliftonville,5424,1,18,2,10,61,41,20,56
Crusaders,5424,2,16,8,6,55,39,16,56
Linfield,5424,3,13,12,5,60,35,25,51
Coleraine,5424,4,13,9,8,40,36,4,48
Dungannon,5424,5,12,8,10,53,37,16,44
Glenavon,5424,6,11,11,8,45,41,4,44
Ballymena,5424,7,12,7,11,50,57,-7,43
Glentoran,5424,8,10,7,13,36,47,-11,37
Ards,5424,9,7,8,15,34,49,-15,29
Ballinamalla,5424,10,8,5,17,35,57,-22,29
Portadown,5424,11,4,5,21,19,49,-30,17
Linfield,5425,1,16,9,5,59,31,28,57
Crusaders,5425,2,14,7,9,57,36,21,49
Cliftonville,5425,3,13,10,7,48,37,11,49
Ballymena,5425,4,13,6,11,57,61,-4,45
Coleraine,5425,5,11,9,10,48,41,7,42
Glenavon,5425,6,11,8,11,43,52,-9,41
Dungannon,5425,7,9,9,12,48,42,6,36
Ards,5425,8,9,8,13,39,48,-9,35
Ballinamalla,5425,9,10,5,15,33,50,-17,35
Glentoran,5425,10,8,8,14,35,48,-13,32
Portadown,5425,11,7,9,14,24,45,-21,30
Crusaders,5426,1,20,5,5,53,29,24,65
Cliftonville,5426,2,16,6,8,53,30,23,54
Linfield,5426,3,12,8,10,50,36,14,44
Ballymena,5426,4,12,8,10,53,55,-2,44
Glenavon,5426,5,11,9,10,49,52,-3,42
Portadown,5426,6,12,5,13,28,38,-10,41
Coleraine,5426,7,9,11,10,38,40,-2,38
Glentoran,5426,8,11,5,14,35,46,-11,38
Dungannon,5426,9,8,10,12,36,37,-1,34
Ards,5426,10,9,5,16,38,48,-10,32
Ballinamalla,5426,11,7,4,19,24,46,-22,25
Cliftonville,5427,1,18,3,9,51,30,21,57
Linfield,5427,2,15,9,6,62,36,26,54
Crusaders,5427,3,15,6,9,46,35,11,51
Glenavon,5427,4,13,9,8,46,49,-3,48
Ballymena,5427,5,13,6,11,53,50,3,45
Coleraine,5427,6,11,11,8,44,38,6,44
Glentoran,5427,7,11,8,11,36,37,-1,41
Dungannon,5427,8,8,12,10,52,55,-3,36
Ards,5427,9,7,9,14,35,49,-14,30
Portadown,5427,10,6,5,19,28,48,-20,23
Ballinamalla,5427,11,5,8,17,23,49,-26,23
Linfield,5428,1,15,8,7,60,35,25,53
Crusaders,5428,2,15,8,7,51,30,21,53
Ballymena,5428,3,14,8,8,54,50,4,50
Cliftonville,5428,4,15,4,11,58,44,14,49
Coleraine,5428,5,11,12,7,38,33,5,45
Glenavon,5428,6,11,9,10,50,52,-2,42
Glentoran,5428,7,10,11,9,29,34,-5,41
Dungannon,5428,8,7,11,12,48,45,3,32
Ards,5428,9,9,5,16,36,54,-18,32
Ballinamalla,5428,10,7,7,16,26,44,-18,28
Portadown,5428,11,6,7,17,23,52,-29,25
Linfield,5429,1,18,6,6,71,34,37,60
Crusaders,5429,2,18,5,7,58,33,25,59
Cliftonville,5429,3,16,5,9,58,41,17,53
Ballymena,5429,4,12,8,10,61,65,-4,44
Glentoran,5429,5,12,7,11,31,42,-11,43
Coleraine,5429,6,8,14,8,37,38,-1,38
Glenavon,5429,7,8,11,11,46,54,-8,35
Portadown,5429,8,9,5,16,29,41,-12,32
Ards,5429,9,8,7,15,37,52,-15,31
Dungannon,5429,10,7,9,14,44,51,-7,30
Ballinamalla,5429,11,7,7,16,29,50,-21,28
Crusaders,5430,1,17,8,5,61,31,30,59
Linfield,5430,2,15,8,7,55,33,22,53
Ballymena,5430,3,15,5,10,56,60,-4,50
Cliftonville,5430,4,14,5,11,52,42,10,47
Coleraine,5430,5,11,11,8,45,39,6,44
Glenavon,5430,6,10,11,9,45,45,0,41
Dungannon,5430,7,9,12,9,52,44,8,39
Ards,5430,8,11,4,15,43,49,-6,37
Ballinamalla,5430,9,9,4,17,31,51,-20,31
Glentoran,5430,10,7,7,16,27,48,-21,28
Portadown,5430,11,6,7,17,25,50,-25,25
Crusaders,5431,1,17,8,5,55,31,24,59
Linfield,5431,2,14,10,6,55,29,26,52
Ballymena,5431,3,15,6,9,58,55,3,51
Glenavon,5431,4,13,11,6,49,44,5,50
Coleraine,5431,5,13,9,8,44,42,2,48
Cliftonville,5431,6,14,4,12,46,40,6,46
Ballinamalla,5431,7,11,3,16,35,47,-12,36
Ards,5431,8,10,5,15,39,47,-8,35
Dungannon,5431,9,7,9,14,47,46,1,30
Glentoran,5431,10,6,8,16,26,45,-19,26
Portadown,5431,11,5,7,18,24,52,-28,22
Crusaders,5432,1,15,9,6,53,30,23,54
Cliftonville,5432,2,16,6,8,61,44,17,54
Linfield,5432,3,14,9,7,54,31,23,51
Glentoran,5432,4,13,6,11,39,42,-3,45
Glenavon,5432,5,10,10,10,45,46,-1,40
Coleraine,5432,6,10,9,11,47,48,-1,39
Ballymena,5432,7,11,5,14,50,63,-13,38
Ballinamalla,5432,8,11,5,14,31,45,-14,38
Dungannon,5432,9,9,10,11,49,41,8,37
Ards,5432,10,9,6,15,38,52,-14,33
Portadown,5432,11,5,9,16,20,45,-25,24
Linfield,5433,1,16,8,6,61,32,29,56
Crusaders,5433,2,16,5,9,51,34,17,53
Cliftonville,5433,3,15,7,8,51,40,11,52
Glenavon,5433,4,15,7,8,47,36,11,52
Coleraine,5433,5,12,10,8,44,35,9,46
Ballymena,5433,6,12,9,9,52,49,3,45
Dungannon,5433,7,10,9,11,44,39,5,39
Portadown,5433,8,11,2,17,30,54,-24,35
Ballinamalla,5433,9,9,2,19,27,50,-23,29
Ards,5433,10,8,3,19,33,50,-17,27
Glentoran,5433,11,7,6,17,30,51,-21,27
Crusaders,5434,1,17,7,6,59,33,26,58
Cliftonville,5434,2,17,6,7,61,40,21,57
Linfield,5434,3,14,9,7,63,36,27,51
Coleraine,5434,4,12,10,8,50,41,9,46
Dungannon,5434,5,12,8,10,46,37,9,44
Glenavon,5434,6,10,13,7,48,50,-2,43
Ballymena,5434,7,12,6,12,60,62,-2,42
Glentoran,5434,8,7,9,14,27,49,-22,30
Portadown,5434,9,8,4,18,28,50,-22,28
Ards,5434,10,7,6,17,40,60,-20,27
Ballinamalla,5434,11,7,6,17,29,53,-24,27
Crusaders,5435,1,17,5,8,55,36,19,56
Cliftonville,5435,2,17,4,9,64,39,25,55
Linfield,5435,3,14,8,8,54,33,21,50
Glenavon,5435,4,12,12,6,48,42,6,48
Ballymena,5435,5,14,5,11,64,63,1,47
Dungannon,5435,6,9,10,11,46,42,4,37
Ards,5435,7,11,4,15,38,49,-11,37
Coleraine,5435,8,9,9,12,42,51,-9,36
Ballinamalla,5435,9,10,4,16,26,46,-20,34
Glentoran,5435,10,8,8,14,28,41,-13,32
Portadown,5435,11,7,5,18,26,49,-23,26
Crusaders,5436,1,18,6,6,57,29,28,60
Linfield,5436,2,16,8,6,64,33,31,56
Glenavon,5436,3,12,13,5,57,47,10,49
Coleraine,5436,4,13,9,8,47,41,6,48
Ballymena,5436,5,13,8,9,56,56,0,47
Cliftonville,5436,6,14,4,12,47,43,4,46
Dungannon,5436,7,9,11,10,52,48,4,38
Glentoran,5436,8,9,7,14,37,51,-14,34
Ards,5436,9,7,5,18,37,58,-21,26
Ballinamalla,5436,10,7,5,18,31,54,-23,26
Portadown,5436,11,6,6,18,25,50,-25,24
Crusaders,5437,1,17,6,7,50,33,17,57
Cliftonville,5437,2,16,6,8,50,36,14,54
Coleraine,5437,3,14,10,6,43,32,11,52
Linfield,5437,4,13,10,7,68,36,32,49
Glenavon,5437,5,11,11,8,49,43,6,44
Glentoran,5437,6,13,5,12,38,44,-6,44
Dungannon,5437,7,9,9,12,46,41,5,36
Ballymena,5437,8,9,9,12,51,68,-17,36
Portadown,5437,9,9,8,13,31,40,-9,35
Ards,5437,10,6,5,19,31,54,-23,23
Ballinamalla,5437,11,6,5,19,25,55,-30,23
Linfield,5438,1,17,9,4,65,31,34,60
Glenavon,5438,2,13,11,6,56,42,14,50
Cliftonville,5438,3,14,6,10,53,39,14,48
Coleraine,5438,4,13,8,9,43,40,3,47
Crusaders,5438,5,13,7,10,48,41,7,46
Ballymena,5438,6,13,7,10,55,58,-3,46
Portadown,5438,7,11,5,14,32,39,-7,38
Dungannon,5438,8,8,10,12,45,50,-5,34
Glentoran,5438,9,8,10,12,29,40,-11,34
Ards,5438,10,7,6,17,32,50,-18,27
Ballinamalla,5438,11,6,5,19,24,52,-28,23
Crusaders,5439,1,16,10,4,66,39,27,58
Linfield,5439,2,16,8,6,65,41,24,56
Ballymena,5439,3,17,4,9,66,56,10,55
Cliftonville,5439,4,16,3,11,54,37,17,51
Coleraine,5439,5,13,9,8,47,43,4,48
Dungannon,5439,6,11,10,9,50,36,14,43
Glenavon,5439,7,9,11,10,47,47,0,38
Glentoran,5439,8,9,7,14,28,43,-15,34
Ards,5439,9,8,6,16,37,58,-21,30
Ballinamalla,5439,10,7,4,19,25,52,-27,25
Portadown,5439,11,3,8,19,16,49,-33,17
Crusaders,5440,1,16,8,6,58,39,19,56
Linfield,5440,2,15,9,6,52,29,23,54
Cliftonville,5440,3,16,6,8,53,37,16,54
Ballymena,5440,4,14,6,10,60,58,2,48
Glenavon,5440,5,12,9,9,56,46,10,45
Dungannon,5440,6,11,9,10,55,49,6,42
Coleraine,5440,7,10,12,8,40,40,0,42
Glentoran,5440,8,7,12,11,39,52,-13,33
Ballinamalla,5440,9,7,6,17,32,54,-22,27
Ards,5440,10,7,5,18,33,48,-15,26
Portadown,5440,11,7,4,19,31,57,-26,25
Crusaders,5441,1,17,9,4,50,26,24,60
Linfield,5441,2,13,12,5,55,30,25,51
Ballymena,5441,3,15,6,9,63,55,8,51
Coleraine,5441,4,11,13,6,48,38,10,46
Cliftonville,5441,5,13,7,10,52,43,9,46
Glenavon,5441,6,9,11,10,41,46,-5,38
Dungannon,5441,7,9,9,12,46,47,-1,36
Ballinamalla,5441,8,10,3,17,36,55,-19,33
Portadown,5441,9,9,5,16,26,44,-18,32
Ards,5441,10,8,6,16,40,52,-12,30
Glentoran,5441,11,7,7,16,25,46,-21,28
Crusaders,5442,1,16,7,7,61,46,15,55
Coleraine,5442,2,12,13,5,44,32,12,49
Cliftonville,5442,3,14,6,10,58,39,19,48
Glenavon,5442,4,12,12,6,51,45,6,48
Linfield,5442,5,11,11,8,56,39,17,44
Ballymena,5442,6,12,8,10,63,69,-6,44
Glentoran,5442,7,11,5,14,36,45,-9,38
Dungannon,5442,8,9,10,11,53,44,9,37
Ards,5442,9,7,10,13,36,52,-16,31
Portadown,5442,10,8,5,17,27,49,-22,29
Ballinamalla,5442,11,8,3,19,31,56,-25,27
Ballymena,5443,1,17,5,8,62,52,10,56
Crusaders,5443,2,16,7,7,53,35,18,55
Linfield,5443,3,14,10,6,56,37,19,52
Cliftonville,5443,4,14,6,10,56,36,20,48
Glenavon,5443,5,11,9,10,52,47,5,42
Glentoran,5443,6,9,11,10,29,35,-6,38
Dungannon,5443,7,9,9,12,44,48,-4,36
Portadown,5443,8,11,3,16,35,47,-12,36
Coleraine,5443,9,8,10,12,38,43,-5,34
Ards,5443,10,9,5,16,38,56,-18,32
Ballinamalla,5443,11,7,5,18,29,56,-27,26
Crusaders,5444,1,19,5,6,71,34,37,62
Linfield,5444,2,18,7,5,63,29,34,61
Ballymena,5444,3,15,4,11,57,55,2,49
Cliftonville,5444,4,15,2,13,48,44,4,47
Glenavon,5444,5,11,9,10,38,45,-7,42
Coleraine,5444,6,10,11,9,43,40,3,41
Glentoran,5444,7,10,7,13,25,38,-13,37
Ballinamalla,5444,8,11,3,16,32,48,-16,36
Dungannon,5444,9,9,8,13,47,45,2,35
Ards,5444,10,8,4,18,35,54,-19,28
Portadown,5444,11,7,4,19,20,47,-27,25
Crusaders,5445,1,18,6,6,56,35,21,60
Linfield,5445,2,17,7,6,59,30,29,58
Cliftonville,5445,3,18,4,8,58,29,29,58
Ballymena,5445,4,12,6,12,50,57,-7,42
Coleraine,5445,5,11,8,11,38,42,-4,41
Ards,5445,6,11,5,14,36,50,-14,38
Glenavon,5445,7,8,13,9,37,40,-3,37
Ballinamalla,5445,8,11,3,16,31,46,-15,36
Dungannon,5445,9,8,8,14,51,48,3,32
Glentoran,5445,10,8,7,15,30,44,-14,31
Portadown,5445,11,8,3,19,19,44,-25,27
Linfield,5446,1,16,9,5,72,33,39,57
Cliftonville,5446,2,18,3,9,61,33,28,57
Crusaders,5446,3,17,5,8,57,39,18,56
Ballymena,5446,4,15,6,9,62,61,1,51
Glenavon,5446,5,11,11,8,51,48,3,44
Coleraine,5446,6,10,11,9,35,39,-4,41
Glentoran,5446,7,9,7,14,23,40,-17,34
Ards,5446,8,9,4,17,38,53,-15,31
Dungannon,5446,9,6,11,13,43,49,-6,29
Ballinamalla,5446,10,8,5,17,31,55,-24,29
Portadown,5446,11,7,6,17,26,49,-23,27
Crusaders,5447,1,18,7,5,56,32,24,61
Cliftonville,5447,2,15,7,8,56,39,17,52
Linfield,5447,3,13,10,7,58,40,18,49
Ballymena,5447,4,14,7,9,55,52,3,49
Coleraine,5447,5,11,10,9,41,42,-1,43
Dungannon,5447,6,11,8,11,53,43,10,41
Glenavon,5447,7,10,10,10,45,45,0,40
Glentoran,5447,8,10,5,15,36,44,-8,35
Ards,5447,9,9,5,16,43,55,-12,32
Portadown,5447,10,7,7,16,23,44,-21,28
Ballinamalla,5447,11,7,4,19,22,52,-30,25
Crusaders,5448,1,16,8,6,54,34,20,56
Cliftonville,5448,2,16,5,9,55,38,17,53
Linfield,5448,3,13,9,8,53,31,22,48
Dungannon,5448,4,13,8,9,56,41,15,47
Ballymena,5448,5,14,5,11,63,61,2,47
Coleraine,5448,6,11,12,7,47,40,7,45
Ards,5448,7,10,6,14,40,53,-13,36
Portadown,5448,8,10,6,14,26,41,-15,36
Glentoran,5448,9,9,8,13,34,42,-8,35
Glenavon,5448,10,7,10,13,44,59,-15,31
Ballinamalla,5448,11,5,5,20,31,63,-32,20
Crusaders,5449,1,18,6,6,52,34,18,60
Linfield,5449,2,14,11,5,69,35,34,53
Cliftonville,5449,3,14,9,7,58,37,21,51
Dungannon,5449,4,13,9,8,49,35,14,48
Ballymena,5449,5,13,7,10,56,55,1,46
Coleraine,5449,6,11,12,7,41,36,5,45
Glenavon,5449,7,8,11,11,46,55,-9,35
Ards,5449,8,9,6,15,37,53,-16,33
Glentoran,5449,9,8,7,15,30,47,-17,31
Ballinamalla,5449,10,6,6,18,29,53,-24,24
Portadown,5449,11,5,8,17,22,49,-27,23
Linfield,5450,1,13,13,4,65,36,29,52
Cliftonville,5450,2,15,6,9,54,42,12,51
Crusaders,5450,3,13,11,6,57,43,14,50
Coleraine,5450,4,10,13,7,50,39,11,43
Ballymena,5450,5,12,6,12,61,64,-3,42
Dungannon,5450,6,10,10,10,54,46,8,40
Glenavon,5450,7,9,12,9,45,50,-5,39
Ards,5450,8,10,5,15,44,53,-9,35
Glentoran,5450,9,8,10,12,35,46,-11,34
Ballinamalla,5450,10,9,6,15,32,49,-17,33
Portadown,5450,11,7,6,17,28,57,-29,27
Crusaders,5451,1,16,12,2,58,35,23,60
Cliftonville,5451,2,15,5,10,53,37,16,50
Ballymena,5451,3,14,8,8,56,52,4,50
Linfield,5451,4,13,10,7,57,34,23,49
Glenavon,5451,5,12,10,8,54,44,10,46
Coleraine,5451,6,10,12,8,40,34,6,42
Dungannon,5451,7,11,9,10,52,48,4,42
Ballinamalla,5451,8,8,7,15,34,51,-17,31
Ards,5451,9,8,6,16,35,53,-18,30
Glentoran,5451,10,6,8,16,33,53,-20,26
Portadown,5451,11,5,7,18,24,55,-31,22
Crusaders,5452,1,16,7,7,53,39,14,55
Cliftonville,5452,2,15,8,7,53,35,18,53
Glenavon,5452,3,14,7,9,48,45,3,49
Coleraine,5452,4,12,12,6,46,37,9,48
Linfield,5452,5,13,7,10,61,38,23,46
Ballymena,5452,6,11,9,10,49,56,-7,42
Dungannon,5452,7,9,8,13,47,48,-1,35
Portadown,5452,8,10,4,16,31,41,-10,34
Ards,5452,9,9,7,14,41,53,-12,34
Ballinamalla,5452,10,9,4,17,34,52,-18,31
Glentoran,5452,11,7,7,16,29,48,-19,28
Linfield,5453,1,17,10,3,67,28,39,61
Coleraine,5453,2,13,12,5,47,32,15,51
Ballymena,5453,3,15,6,9,58,52,6,51
Crusaders,5453,4,14,8,8,52,40,12,50
Cliftonville,5453,5,14,4,12,49,40,9,46
Dungannon,5453,6,11,8,11,51,44,7,41
Ballinamalla,5453,7,11,4,15,33,46,-13,37
Glenavon,5453,8,8,9,13,51,61,-10,33
Ards,5453,9,9,5,16,32,47,-15,32
Glentoran,5453,10,7,7,16,27,49,-22,28
Portadown,5453,11,7,5,18,23,51,-28,26
Crusaders,5454,1,19,8,3,60,29,31,65
Linfield,5454,2,14,10,6,59,31,28,52
Ballymena,5454,3,14,6,10,62,57,5,48
Cliftonville,5454,4,14,5,11,51,44,7,47
Coleraine,5454,5,11,11,8,41,39,2,44
Ards,5454,6,11,5,14,39,46,-7,38
Glenavon,5454,7,8,10,12,47,49,-2,34
Dungannon,5454,8,8,9,13,49,50,-1,33
Portadown,5454,9,9,5,16,31,49,-18,32
Ballinamalla,5454,10,8,6,16,31,53,-22,30
Glentoran,5454,11,7,9,14,26,49,-23,30
Crusaders,5455,1,15,10,5,54,30,24,55
Cliftonville,5455,2,15,6,9,51,37,14,51
Linfield,5455,3,13,10,7,52,29,23,49
Ballymena,5455,4,14,7,9,68,50,18,49
Coleraine,5455,5,11,11,8,43,46,-3,44
Dungannon,5455,6,9,10,11,46,45,1,37
Glenavon,5455,7,9,10,11,40,46,-6,37
Ballinamalla,5455,8,9,6,15,28,50,-22,33
Glentoran,5455,9,7,11,12,29,44,-15,32
Ards,5455,10,8,7,15,33,46,-13,31
Portadown,5455,11,7,8,15,26,47,-21,29
Linfield,5456,1,16,12,2,64,25,39,60
Cliftonville,5456,2,17,7,6,58,30,28,58
Crusaders,5456,3,15,11,4,58,33,25,56
Glenavon,5456,4,11,10,9,44,42,2,43
Coleraine,5456,5,10,11,9,38,38,0,41
Dungannon,5456,6,10,10,10,50,41,9,40
Glentoran,5456,7,9,9,12,31,46,-15,36
Ballymena,5456,8,9,9,12,49,67,-18,36
Ards,5456,9,9,8,13,43,45,-2,35
Portadown,5456,10,5,6,19,17,48,-31,21
Ballinamalla,5456,11,5,5,20,20,57,-37,20
Crusaders,5457,1,19,6,5,57,27,30,63
Cliftonville,5457,2,17,5,8,60,41,19,56
Linfield,5457,3,15,8,7,58,26,32,53
Ballymena,5457,4,15,6,9,66,56,10,51
Glenavon,5457,5,10,12,8,45,51,-6,42
Dungannon,5457,6,10,11,9,46,36,10,41
Coleraine,5457,7,10,10,10,50,49,1,40
Ards,5457,8,9,6,15,40,53,-13,33
Portadown,5457,9,8,5,17,28,53,-25,29
Glentoran,5457,10,7,5,18,25,49,-24,26
Ballinamalla,5457,11,7,2,21,22,56,-34,23
Linfield,5458,1,17,7,6,65,35,30,58
Cliftonville,5458,2,15,8,7,48,34,14,53
Crusaders,5458,3,13,7,10,51,43,8,46
Glenavon,5458,4,11,13,6,43,37,6,46
Coleraine,5458,5,10,14,6,43,36,7,44
Ballymena,5458,6,11,9,10,53,60,-7,42
Portadown,5458,7,11,4,15,27,41,-14,37
Ards,5458,8,10,5,15,40,51,-11,35
Glentoran,5458,9,9,5,16,35,45,-10,32
Ballinamalla,5458,10,8,6,16,27,47,-20,30
Dungannon,5458,11,6,10,14,42,45,-3,28
Crusaders,5459,1,17,9,4,59,28,31,60
Cliftonville,5459,2,16,6,8,54,34,20,54
Linfield,5459,3,14,7,9,52,31,21,49
Ballymena,5459,4,14,7,9,53,50,3,49
Glenavon,5459,5,11,11,8,42,42,0,44
Coleraine,5459,6,9,12,9,37,34,3,39
Ards,5459,7,10,5,15,34,49,-15,35
Dungannon,5459,8,8,7,15,42,53,-11,31
Glentoran,5459,9,6,12,12,27,39,-12,30
Portadown,5459,10,8,6,16,22,43,-21,30
Ballinamalla,5459,11,7,8,15,33,52,-19,29
Crusaders,5460,1,17,7,6,60,33,27,58
Linfield,5460,2,15,9,6,58,29,29,54
Cliftonville,5460,3,16,5,9,52,40,12,53
Ballymena,5460,4,14,6,10,60,60,0,48
Dungannon,5460,5,11,10,9,49,36,13,43
Glentoran,5460,6,12,5,13,35,40,-5,41
Coleraine,5460,7,9,12,9,40,45,-5,39
Glenavon,5460,8,8,13,9,40,43,-3,37
Ards,5460,9,9,6,15,39,47,-8,33
Ballinamalla,5460,10,6,6,18,29,58,-29,24
Portadown,5460,11,5,7,18,17,48,-31,22
Crusaders,5461,1,17,7,6,62,36,26,58
Linfield,5461,2,16,9,5,66,30,36,57
Cliftonville,5461,3,17,5,8,58,39,19,56
Glenavon,5461,4,11,12,7,45,48,-3,45
Ballymena,5461,5,12,6,12,60,64,-4,42
Coleraine,5461,6,8,14,8,39,39,0,38
Glentoran,5461,7,10,8,12,32,39,-7,38
Dungannon,5461,8,8,11,11,44,38,6,35
Ards,5461,9,9,4,17,37,51,-14,31
Portadown,5461,10,6,8,16,24,50,-26,26
Ballinamalla,5461,11,5,8,17,24,57,-33,23
Crusaders,5462,1,19,6,5,61,29,32,63
Cliftonville,5462,2,15,6,9,63,46,17,51
Ballymena,5462,3,15,5,10,58,57,1,50
Linfield,5462,4,13,9,8,53,33,20,48
Glenavon,5462,5,12,9,9,48,50,-2,45
Coleraine,5462,6,11,10,9,46,44,2,43
Dungannon,5462,7,9,10,11,52,45,7,37
Glentoran,5462,8,9,10,11,27,37,-10,37
Ballinamalla,5462,9,11,1,18,32,50,-18,34
Ards,5462,10,7,4,19,31,55,-24,25
Portadown,5462,11,7,4,19,27,52,-25,25
Linfield,5463,1,15,9,6,63,38,25,54
Crusaders,5463,2,15,9,6,62,40,22,54
Cliftonville,5463,3,16,3,11,58,45,13,51
Dungannon,5463,4,13,10,7,59,39,20,49
Ballymena,5463,5,13,6,11,58,57,1,45
Glenavon,5463,6,10,10,10,51,52,-1,40
Coleraine,5463,7,10,9,11,38,38,0,39
Glentoran,5463,8,11,6,13,39,52,-13,39
Ards,5463,9,9,5,16,36,47,-11,32
Ballinamalla,5463,10,9,3,18,35,56,-21,30
Portadown,5463,11,5,8,17,20,55,-35,23
Crusaders,5464,1,16,8,6,58,38,20,56
Glenavon,5464,2,15,8,7,48,41,7,53
Cliftonville,5464,3,15,4,11,61,48,13,49
Ballymena,5464,4,14,7,9,62,59,3,49
Linfield,5464,5,13,9,8,56,39,17,48
Coleraine,5464,6,10,12,8,39,34,5,42
Dungannon,5464,7,11,8,11,48,41,7,41
Ards,5464,8,10,8,12,38,40,-2,38
Glentoran,5464,9,9,7,14,30,41,-11,34
Ballinamalla,5464,10,7,3,20,28,56,-28,24
Portadown,5464,11,6,4,20,21,52,-31,22
Crusaders,5465,1,20,5,5,69,35,34,65
Cliftonville,5465,2,17,4,9,54,37,17,55
Ballymena,5465,3,14,6,10,57,64,-7,48
Linfield,5465,4,13,7,10,53,37,16,46
Glenavon,5465,5,12,9,9,47,47,0,45
Dungannon,5465,6,12,8,10,56,46,10,44
Coleraine,5465,7,11,10,9,41,38,3,43
Glentoran,5465,8,11,5,14,35,44,-9,38
Ards,5465,9,9,5,16,36,49,-13,32
Ballinamalla,5465,10,8,2,20,32,53,-21,26
Portadown,5465,11,6,3,21,22,52,-30,21
Cliftonville,5466,1,19,3,8,55,34,21,60
Crusaders,5466,2,18,6,6,54,34,20,60
Linfield,5466,3,13,9,8,49,34,15,48
Glenavon,5466,4,12,11,7,50,40,10,47
Coleraine,5466,5,10,10,10,38,35,3,40
Ballymena,5466,6,11,7,12,48,55,-7,40
Glentoran,5466,7,9,9,12,30,38,-8,36
Dungannon,5466,8,8,9,13,43,43,0,33
Ballinamalla,5466,9,10,3,17,34,55,-21,33
Portadown,5466,10,9,4,17,24,41,-17,31
Ards,5466,11,7,7,16,35,51,-16,28
Crusaders,5467,1,17,6,7,49,30,19,57
Linfield,5467,2,16,6,8,61,34,27,54
Ballymena,5467,3,16,5,9,54,51,3,53
Cliftonville,5467,4,13,8,9,50,38,12,47
Coleraine,5467,5,12,9,9,38,39,-1,45
Dungannon,5467,6,11,8,11,52,45,7,41
Glenavon,5467,7,10,10,10,51,49,2,40
Portadown,5467,8,9,5,16,26,42,-16,32
Ards,5467,9,8,7,15,34,46,-12,31
Glentoran,5467,10,8,6,16,29,47,-18,30
Ballinamalla,5467,11,7,6,17,24,47,-23,27
Cliftonville,5468,1,17,7,6,57,32,25,58
Crusaders,5468,2,15,7,8,57,35,22,52
Linfield,5468,3,14,9,7,60,34,26,51
Ballymena,5468,4,14,7,9,58,61,-3,49
Glentoran,5468,5,12,10,8,43,38,5,46
Dungannon,5468,6,11,7,12,51,47,4,40
Glenavon,5468,7,10,10,10,45,51,-6,40
Coleraine,5468,8,9,8,13,45,53,-8,35
Portadown,5468,9,8,5,17,28,50,-22,29
Ballinamalla,5468,10,8,4,18,34,61,-27,28
Ards,5468,11,7,6,17,38,54,-16,27
Crusaders,5469,1,15,6,9,54,46,8,51
Glenavon,5469,2,12,13,5,44,35,9,49
Cliftonville,5469,3,14,5,11,48,37,11,47
Linfield,5469,4,10,16,4,55,33,22,46
Coleraine,5469,5,10,11,9,41,36,5,41
Ballymena,5469,6,11,7,12,48,63,-15,40
Dungannon,5469,7,10,9,11,49,40,9,39
Portadown,5469,8,11,6,13,33,40,-7,39
Ards,5469,9,9,7,14,43,53,-10,34
Glentoran,5469,10,8,9,13,32,47,-15,33
Ballinamalla,5469,11,7,7,16,33,50,-17,28
Crusaders,5470,1,20,7,3,69,38,31,67
Linfield,5470,2,15,8,7,58,32,26,53
Cliftonville,5470,3,14,7,9,47,41,6,49
Coleraine,5470,4,13,9,8,48,36,12,48
Glenavon,5470,5,11,10,9,51,47,4,43
Ballymena,5470,6,11,7,12,59,68,-9,40
Dungannon,5470,7,10,8,12,53,52,1,38
Portadown,5470,8,8,8,14,33,48,-15,32
Ballinamalla,5470,9,9,4,17,33,52,-19,31
Ards,5470,10,7,5,18,29,46,-17,26
Glentoran,5470,11,5,11,14,24,44,-20,26
Crusaders,5471,1,17,10,3,55,27,28,61
Glenavon,5471,2,14,12,4,56,41,15,54
Linfield,5471,3,15,7,8,62,41,21,52
Ballymena,5471,4,13,6,11,61,60,1,45
Cliftonville,5471,5,13,5,12,46,39,7,44
Dungannon,5471,6,11,8,11,52,43,9,41
Coleraine,5471,7,10,10,10,42,40,2,40
Glentoran,5471,8,8,8,14,35,50,-15,32
Ards,5471,9,8,5,17,32,50,-18,29
Portadown,5471,10,7,8,15,24,43,-19,29
Ballinamalla,5471,11,7,5,18,33,64,-31,26
Crusaders,5472,1,17,8,5,61,31,30,59
Linfield,5472,2,13,11,6,52,33,19,50
Cliftonville,5472,3,15,5,10,52,40,12,50
Ballymena,5472,4,14,8,8,56,52,4,50
Glenavon,5472,5,12,12,6,46,40,6,48
Coleraine,5472,6,12,10,8,40,35,5,46
Dungannon,5472,7,10,9,11,54,46,8,39
Glentoran,5472,8,10,5,15,29,48,-19,35
Ards,5472,9,8,5,17,34,48,-14,29
Portadown,5472,10,6,6,18,20,42,-22,24
Ballinamalla,5472,11,5,7,18,31,60,-29,22
Cliftonville,5473,1,20,3,7,66,40,26,63
Crusaders,5473,2,15,8,7,53,40,13,53
Linfield,5473,3,12,11,7,46,30,16,47
Ballymena,5473,4,13,6,11,53,60,-7,45
Ards,5473,5,12,7,11,40,40,0,43
Dungannon,5473,6,10,11,9,50,39,11,41
Coleraine,5473,7,10,9,11,39,36,3,39
Glenavon,5473,8,10,8,12,46,50,-4,38
Glentoran,5473,9,10,4,16,31,48,-17,34
Portadown,5473,10,9,4,17,28,43,-15,31
Ballinamalla,5473,11,7,3,20,30,56,-26,24
Crusaders,5474,1,18,6,6,59,32,27,60
Cliftonville,5474,2,17,6,7,56,37,19,57
Linfield,5474,3,14,11,5,60,26,34,53
Glenavon,5474,4,13,11,6,49,43,6,50
Coleraine,5474,5,11,11,8,41,35,6,44
Ballymena,5474,6,13,4,13,54,61,-7,43
Dungannon,5474,7,9,10,11,51,43,8,37
Glentoran,5474,8,8,9,13,26,44,-18,33
Ballinamalla,5474,9,8,4,18,32,60,-28,28
Ards,5474,10,7,6,17,32,50,-18,27
Portadown,5474,11,5,6,19,18,47,-29,21
Crusaders,5475,1,18,6,6,54,31,23,60
Linfield,5475,2,16,6,8,57,32,25,54
Cliftonville,5475,3,17,2,11,57,41,16,53
Ballymena,5475,4,15,4,11,56,56,0,49
Glenavon,5475,5,10,11,9,43,39,4,41
Coleraine,5475,6,11,8,11,38,44,-6,41
Dungannon,5475,7,9,10,11,44,43,1,37
Portadown,5475,8,11,3,16,33,44,-11,36
Ards,5475,9,9,5,16,35,48,-13,32
Ballinamalla,5475,10,9,4,17,29,47,-18,31
Glentoran,5475,11,8,5,17,28,49,-21,29
Linfield,5476,1,16,7,7,63,27,36,55
Cliftonville,5476,2,16,6,8,53,38,15,54
Ballymena,5476,3,15,6,9,57,54,3,51
Crusaders,5476,4,14,6,10,55,48,7,48
Coleraine,5476,5,12,9,9,44,40,4,45
Dungannon,5476,6,11,9,10,47,38,9,42
Glentoran,5476,7,12,5,13,36,46,-10,41
Ballinamalla,5476,8,10,2,18,30,47,-17,32
Portadown,5476,9,9,4,17,26,52,-26,31
Glenavon,5476,10,6,12,12,37,46,-9,30
Ards,5476,11,8,6,16,40,52,-12,30
Glenavon,5477,1,15,10,5,58,41,17,55
Cliftonville,5477,2,17,3,10,55,35,20,54
Crusaders,5477,3,14,9,7,53,37,16,51
Linfield,5477,4,13,8,9,55,42,13,47
Dungannon,5477,5,12,10,8,54,38,16,46
Coleraine,5477,6,11,11,8,43,38,5,44
Ballymena,5477,7,11,7,12,52,64,-12,40
Glentoran,5477,8,9,9,12,30,42,-12,36
Ards,5477,9,9,5,16,40,49,-9,32
Ballinamalla,5477,10,7,5,18,24,49,-25,26
Portadown,5477,11,7,3,20,25,54,-29,24
Linfield,5478,1,17,7,6,61,31,30,58
Crusaders,5478,2,16,7,7,53,32,21,55
Glenavon,5478,3,15,8,7,59,43,16,53
Cliftonville,5478,4,13,6,11,53,42,11,45
Ballymena,5478,5,13,5,12,61,65,-4,44
Coleraine,5478,6,11,9,10,41,40,1,42
Glentoran,5478,7,10,4,16,33,52,-19,34
Ards,5478,8,9,6,15,36,44,-8,33
Dungannon,5478,9,8,9,13,44,54,-10,33
Ballinamalla,5478,10,10,3,17,32,52,-20,33
Portadown,5478,11,8,6,16,25,43,-18,30
Crusaders,5479,1,18,5,7,52,33,19,59
Cliftonville,5479,2,17,4,9,52,36,16,55
Linfield,5479,3,14,9,7,55,27,28,51
Ballymena,5479,4,13,8,9,54,56,-2,47
Glenavon,5479,5,10,12,8,48,50,-2,42
Coleraine,5479,6,11,8,11,45,41,4,41
Dungannon,5479,7,10,10,10,55,48,7,40
Ards,5479,8,10,4,16,38,51,-13,34
Glentoran,5479,9,8,8,14,33,46,-13,32
Portadown,5479,10,8,5,17,28,48,-20,29
Ballinamalla,5479,11,8,3,19,35,59,-24,27
Crusaders,5480,1,14,12,4,60,39,21,54
Cliftonville,5480,2,16,6,8,54,36,18,54
Linfield,5480,3,15,8,7,55,36,19,53
Ballymena,5480,4,14,7,9,59,59,0,49
Coleraine,5480,5,12,10,8,50,36,14,46
Glenavon,5480,6,10,14,6,46,43,3,44
Dungannon,5480,7,9,9,12,53,51,2,36
Glentoran,5480,8,10,6,14,29,40,-11,36
Ards,5480,9,9,6,15,35,43,-8,33
Ballinamalla,5480,10,7,6,17,22,45,-23,27
Portadown,5480,11,5,4,21,16,51,-35,19
Crusaders,5481,1,19,6,5,66,34,32,63
Linfield,5481,2,14,8,8,58,35,23,50
Cliftonville,5481,3,15,5,10,48,33,15,50
Coleraine,5481,4,13,10,7,44,37,7,49
Glenavon,5481,5,11,12,7,44,39,5,45
Ballymena,5481,6,13,6,11,65,67,-2,45
Dungannon,5481,7,10,8,12,52,57,-5,38
Ards,5481,8,9,6,15,36,47,-11,33
Portadown,5481,9,8,6,16,30,48,-18,30
Glentoran,5481,10,7,7,16,26,47,-21,28
Ballinamalla,5481,11,7,4,19,26,51,-25,25
Crusaders,5482,1,17,8,5,57,32,25,59
Cliftonville,5482,2,14,8,8,55,41,14,50
Linfield,5482,3,12,11,7,50,31,19,47
Ards,5482,4,14,5,11,47,42,5,47
Dungannon,5482,5,12,10,8,50,42,8,46
Ballymena,5482,6,13,5,12,58,54,4,44
Glenavon,5482,7,10,11,9,50,47,3,41
Glentoran,5482,8,8,8,14,34,54,-20,32
Coleraine,5482,9,6,13,11,33,44,-11,31
Ballinamalla,5482,10,8,6,16,30,51,-21,30
Portadown,5482,11,5,7,18,24,50,-26,22
Linfield,5483,1,16,7,7,61,35,26,55
Cliftonville,5483,2,15,4,11,63,49,14,49
Glenavon,5483,3,11,13,6,51,44,7,46
Ballymena,5483,4,13,7,10,62,63,-1,46
Crusaders,5483,5,11,9,10,47,38,9,42
Coleraine,5483,6,10,10,10,37,44,-7,40
Ards,5483,7,11,6,13,43,39,4,39
Dungannon,5483,8,9,11,10,52,50,2,38
Glentoran,5483,9,9,8,13,29,42,-13,35
Portadown,5483,10,9,7,14,29,45,-16,34
Ballinamalla,5483,11,7,6,17,24,49,-25,27
Crusaders,5484,1,18,6,6,65,37,28,60
Cliftonville,5484,2,16,5,9,56,42,14,53
Ballymena,5484,3,15,5,10,64,61,3,50
Linfield,5484,4,12,9,9,57,43,14,45
Glenavon,5484,5,11,12,7,49,43,6,45
Dungannon,5484,6,12,8,10,57,44,13,44
Coleraine,5484,7,11,8,11,39,38,1,41
Glentoran,5484,8,11,6,13,35,45,-10,39
Ards,5484,9,9,7,14,41,53,-12,34
Portadown,5484,10,7,4,19,20,45,-25,25
Ballinamalla,5484,11,6,4,20,26,58,-32,22
Linfield,5485,1,15,10,5,61,28,33,55
Cliftonville,5485,2,16,6,8,53,33,20,54
Crusaders,5485,3,15,6,9,53,37,16,51
Coleraine,5485,4,13,8,9,43,37,6,47
Ballymena,5485,5,12,8,10,55,57,-2,44
Glentoran,5485,6,11,9,10,32,38,-6,42
Glenavon,5485,7,10,10,10,41,39,2,40
Dungannon,5485,8,8,11,11,48,46,2,35
Ards,5485,9,9,3,18,38,60,-22,30
Portadown,5485,10,9,3,18,21,47,-26,30
Ballinamalla,5485,11,7,6,17,28,51,-23,27
Linfield,5486,1,16,8,6,61,30,31,56
Crusaders,5486,2,15,6,9,53,41,12,51
Ballymena,5486,3,14,8,8,51,48,3,50
Coleraine,5486,4,12,12,6,46,38,8,48
Cliftonville,5486,5,12,8,10,50,42,8,44
Dungannon,5486,6,10,10,10,48,36,12,40
Glenavon,5486,7,9,13,8,45,48,-3,40
Ballinamalla,5486,8,11,6,13,35,48,-13,39
Glentoran,5486,9,8,6,16,23,43,-20,30
Ards,5486,10,7,7,16,36,54,-18,28
Portadown,5486,11,7,4,19,25,45,-20,25
Crusaders,5487,1,18,8,4,70,32,38,62
Linfield,5487,2,15,9,6,62,32,30,54
Coleraine,5487,3,12,10,8,42,35,7,46
Glenavon,5487,4,12,10,8,49,46,3,46
Cliftonville,5487,5,12,7,11,50,45,5,43
Dungannon,5487,6,12,6,12,46,42,4,42
Ballymena,5487,7,11,9,10,53,58,-5,42
Ballinamalla,5487,8,11,4,15,30,46,-16,37
Glentoran,5487,9,8,8,14,30,47,-17,32
Portadown,5487,10,7,5,18,26,51,-25,26
Ards,5487,11,6,6,18,32,56,-24,24
Linfield,5488,1,14,9,7,61,29,32,51
Crusaders,5488,2,15,5,10,54,39,15,50
Cliftonville,5488,3,14,6,10,50,40,10,48
Glenavon,5488,4,12,10,8,47,49,-2,46
Glentoran,5488,5,12,8,10,34,39,-5,44
Dungannon,5488,6,11,10,9,54,37,17,43
Coleraine,5488,7,11,10,9,45,40,5,43
Ballymena,5488,8,12,7,11,59,66,-7,43
Ards,5488,9,12,4,14,37,46,-9,40
Portadown,5488,10,6,7,17,24,49,-25,25
Ballinamalla,5488,11,6,4,20,27,58,-31,22
Linfield,5489,1,15,12,3,62,31,31,57
Cliftonville,5489,2,16,5,9,49,29,20,53
Crusaders,5489,3,15,8,7,52,36,16,53
Glenavon,5489,4,13,9,8,57,49,8,48
Ballymena,5489,5,12,8,10,52,54,-2,44
Glentoran,5489,6,11,9,10,39,44,-5,42
Ballinamalla,5489,7,9,7,14,31,49,-18,34
Ards,5489,8,8,8,14,35,46,-11,32
Coleraine,5489,9,6,11,13,32,46,-14,29
Dungannon,5489,10,6,10,14,46,51,-5,28
Portadown,5489,11,6,9,15,24,44,-20,27
Crusaders,5490,1,18,7,5,60,29,31,61
Linfield,5490,2,15,11,4,64,31,33,56
Glenavon,5490,3,13,10,7,51,41,10,49
Cliftonville,5490,4,13,7,10,59,54,5,46
Ballymena,5490,5,11,9,10,49,60,-11,42
Dungannon,5490,6,10,8,12,43,38,5,38
Portadown,5490,7,9,8,13,24,38,-14,35
Coleraine,5490,8,7,12,11,40,46,-6,33
Ballinamalla,5490,9,9,5,16,33,46,-13,32
Glentoran,5490,10,8,6,16,28,49,-21,30
Ards,5490,11,7,7,16,34,53,-19,28
Crusaders,5491,1,16,10,4,54,33,21,58
Ballymena,5491,2,16,6,8,62,57,5,54
Cliftonville,5491,3,15,5,10,50,43,7,50
Linfield,5491,4,13,9,8,53,29,24,48
Glenavon,5491,5,12,11,7,49,44,5,47
Dungannon,5491,6,12,8,10,53,38,15,44
Coleraine,5491,7,10,11,9,40,38,2,41
Glentoran,5491,8,8,7,15,25,39,-14,31
Ballinamalla,5491,9,8,5,17,28,49,-21,29
Portadown,5491,10,7,6,17,25,51,-26,27
Ards,5491,11,7,4,19,34,52,-18,25
Crusaders,5492,1,19,7,4,63,34,29,64
Cliftonville,5492,2,19,2,9,61,40,21,59
Linfield,5492,3,15,9,6,58,31,27,54
Coleraine,5492,4,13,12,5,52,33,19,51
Dungannon,5492,5,10,11,9,50,44,6,41
Ballymena,5492,6,10,8,12,51,60,-9,38
Glenavon,5492,7,7,12,11,42,51,-9,33
Ards,5492,8,9,5,16,36,52,-16,32
Portadown,5492,9,8,5,17,26,50,-24,29
Glentoran,5492,10,5,12,13,28,45,-17,27
Ballinamalla,5492,11,5,7,18,30,57,-27,22
Ballymena,5493,1,17,5,8,66,55,11,56
Crusaders,5493,2,14,10,6,55,37,18,52
Glenavon,5493,3,13,12,5,51,37,14,51
Linfield,5493,4,10,13,7,54,40,14,43
Dungannon,5493,5,11,10,9,52,40,12,43
Coleraine,5493,6,11,10,9,41,43,-2,43
Cliftonville,5493,7,12,5,13,55,45,10,41
Ards,5493,8,11,5,14,42,51,-9,38
Glentoran,5493,9,8,9,13,31,44,-13,33
Ballinamalla,5493,10,7,6,17,29,55,-26,27
Portadown,5493,11,6,5,19,24,53,-29,23
Coleraine,5494,1,15,9,6,52,33,19,54
Cliftonville,5494,2,16,5,9,54,39,15,53
Linfield,5494,3,14,10,6,58,29,29,52
Crusaders,5494,4,15,5,10,43,30,13,50
Ballymena,5494,5,14,5,11,56,58,-2,47
Glentoran,5494,6,12,7,11,33,38,-5,43
Dungannon,5494,7,10,11,9,52,43,9,41
Glenavon,5494,8,9,13,8,43,47,-4,40
Ards,5494,9,8,7,15,32,50,-18,31
Ballinamalla,5494,10,6,4,20,22,47,-25,22
Portadown,5494,11,5,6,19,25,56,-31,21
Crusaders,5495,1,19,8,3,63,31,32,65
Linfield,5495,2,13,10,7,57,38,19,49
Cliftonville,5495,3,14,5,11,51,43,8,47
Glenavon,5495,4,12,11,7,47,42,5,47
Coleraine,5495,5,13,8,9,43,38,5,47
Ballymena,5495,6,12,6,12,51,62,-11,42
Ballinamalla,5495,7,9,6,15,33,50,-17,33
Glentoran,5495,8,9,6,15,27,45,-18,33
Ards,5495,9,9,4,17,41,49,-8,31
Portadown,5495,10,8,7,15,34,47,-13,31
Dungannon,5495,11,6,11,13,41,43,-2,29
Linfield,5496,1,17,9,4,69,39,30,60
Cliftonville,5496,2,18,4,8,55,32,23,58
Glenavon,5496,3,14,8,8,55,46,9,50
Crusaders,5496,4,13,8,9,49,36,13,47
Ballymena,5496,5,12,6,12,57,66,-9,42
Glentoran,5496,6,11,8,11,35,41,-6,41
Dungannon,5496,7,10,9,11,44,41,3,39
Coleraine,5496,8,8,9,13,43,53,-10,33
Ballinamalla,5496,9,9,5,16,34,50,-16,32
Ards,5496,10,8,5,17,38,53,-15,29
Portadown,5496,11,7,5,18,30,52,-22,26
Crusaders,5497,1,14,8,8,49,38,11,50
Ballymena,5497,2,15,5,10,54,51,3,50
Linfield,5497,3,13,10,7,56,34,22,49
Cliftonville,5497,4,13,8,9,52,42,10,47
Glenavon,5497,5,11,13,6,47,37,10,46
Glentoran,5497,6,12,6,12,39,46,-7,42
Dungannon,5497,7,11,8,11,49,41,8,41
Ards,5497,8,12,4,14,45,51,-6,40
Coleraine,5497,9,8,12,10,43,48,-5,36
Portadown,5497,10,7,5,18,23,44,-21,26
Ballinamalla,5497,11,7,5,18,27,52,-25,26
Cliftonville,5498,1,15,8,7,56,40,16,53
Linfield,5498,2,14,10,6,57,32,25,52
Ballymena,5498,3,16,4,10,70,61,9,52
Crusaders,5498,4,13,9,8,52,40,12,48
Glenavon,5498,5,10,13,7,49,43,6,43
Dungannon,5498,6,10,12,8,52,38,14,42
Glentoran,5498,7,11,9,10,30,38,-8,42
Coleraine,5498,8,8,11,11,37,43,-6,35
Ards,5498,9,8,4,18,38,56,-18,28
Portadown,5498,10,7,6,17,24,48,-24,27
Ballinamalla,5498,11,7,6,17,27,53,-26,27
Crusaders,5499,1,20,6,4,64,30,34,66
Linfield,5499,2,15,9,6,64,32,32,54
Cliftonville,5499,3,16,5,9,55,40,15,53
Ballymena,5499,4,13,5,12,52,58,-6,44
Coleraine,5499,5,12,7,11,40,39,1,43
Glenavon,5499,6,10,12,8,44,47,-3,42
Dungannon,5499,7,8,11,11,50,50,0,35
Portadown,5499,8,9,5,16,28,48,-20,32
Glentoran,5499,9,7,9,14,27,43,-16,30
Ballinamalla,5499,10,8,5,17,28,47,-19,29
Ards,5499,11,7,6,17,36,54,-18,27
Linfield,5500,1,18,8,4,64,30,34,62
Crusaders,5500,2,13,11,6,46,31,15,50
Cliftonville,5500,3,15,5,10,55,45,10,50
Coleraine,5500,4,11,10,9,41,32,9,43
Dungannon,5500,5,11,9,10,52,45,7,42
Glenavon,5500,6,10,11,9,45,49,-4,41
Ballymena,5500,7,10,7,13,54,62,-8,37
Ards,5500,8,10,5,15,43,50,-7,35
Glentoran,5500,9,8,10,12,35,48,-13,34
Ballinamalla,5500,10,8,7,15,33,47,-14,31
Portadown,5500,11,7,5,18,23,52,-29,26
Crusaders,5501,1,17,7,6,58,33,25,58
Linfield,5501,2,15,9,6,55,27,28,54
Ballymena,5501,3,15,7,8,51,52,-1,52
Coleraine,5501,4,11,14,5,42,37,5,47
Cliftonville,5501,5,12,8,10,47,41,6,44
Glenavon,5501,6,11,11,8,48,46,2,44
Dungannon,5501,7,10,8,12,51,43,8,38
Glentoran,5501,8,9,9,12,29,40,-11,36
Ballinamalla,5501,9,8,4,18,21,44,-23,28
Ards,5501,10,7,6,17,32,50,-18,27
Portadown,5501,11,6,5,19,27,48,-21,23
Cliftonville,5502,1,18,4,8,61,35,26,58
Crusaders,5502,2,17,7,6,61,41,20,58
Linfield,5502,3,16,8,6,65,34,31,56
Glenavon,5502,4,13,10,7,52,43,9,49
Coleraine,5502,5,12,9,9,47,44,3,45
Ballymena,5502,6,13,6,11,52,54,-2,45
Ards,5502,7,9,8,13,40,44,-4,35
Ballinamalla,5502,8,8,6,16,32,55,-23,30
Dungannon,5502,9,6,10,14,44,51,-7,28
Portadown,5502,10,7,6,17,28,54,-26,27
Glentoran,5502,11,5,8,17,18,45,-27,23
Linfield,5503,1,13,12,5,60,31,29,51
Crusaders,5503,2,14,7,9,48,36,12,49
Glenavon,5503,3,12,11,7,48,42,6,47
Dungannon,5503,4,12,10,8,54,41,13,46
Ballymena,5503,5,13,6,11,54,62,-8,45
Coleraine,5503,6,11,10,9,44,40,4,43
Cliftonville,5503,7,12,6,12,50,44,6,42
Glentoran,5503,8,11,8,11,33,36,-3,41
Ards,5503,9,9,6,15,41,51,-10,33
Ballinamalla,5503,10,9,4,17,28,52,-24,31
Portadown,5503,11,6,6,18,24,49,-25,24
Crusaders,5504,1,18,7,5,58,36,22,61
Coleraine,5504,2,15,10,5,44,29,15,55
Linfield,5504,3,13,11,6,61,37,24,50
Ballymena,5504,4,15,5,10,63,63,0,50
Glenavon,5504,5,13,9,8,49,40,9,48
Cliftonville,5504,6,13,3,14,51,47,4,42
Dungannon,5504,7,9,10,11,47,46,1,37
Ards,5504,8,11,3,16,42,51,-9,36
Glentoran,5504,9,8,6,16,28,44,-16,30
Ballinamalla,5504,10,8,4,18,34,56,-22,28
Portadown,5504,11,6,4,20,25,53,-28,22
Crusaders,5505,1,17,7,6,55,33,22,58
Cliftonville,5505,2,16,6,8,50,37,13,54
Glenavon,5505,3,14,9,7,56,42,14,51
Coleraine,5505,4,11,13,6,40,33,7,46
Ballymena,5505,5,14,4,12,56,57,-1,46
Linfield,5505,6,12,9,9,50,34,16,45
Dungannon,5505,7,9,10,11,45,45,0,37
Portadown,5505,8,10,3,17,29,44,-15,33
Glentoran,5505,9,8,8,14,26,41,-15,32
Ards,5505,10,8,7,15,35,48,-13,31
Ballinamalla,5505,11,6,4,20,24,52,-28,22
Crusaders,5506,1,19,6,5,55,31,24,63
Linfield,5506,2,14,10,6,60,34,26,52
Cliftonville,5506,3,15,5,10,50,39,11,50
Ballymena,5506,4,14,4,12,58,59,-1,46
Glenavon,5506,5,11,12,7,49,44,5,45
Coleraine,5506,6,12,9,9,38,36,2,45
Dungannon,5506,7,9,11,10,45,38,7,38
Glentoran,5506,8,8,8,14,32,46,-14,32
Portadown,5506,9,8,5,17,29,43,-14,29
Ards,5506,10,8,5,17,31,46,-15,29
Ballinamalla,5506,11,8,3,19,28,59,-31,27
Linfield,5507,1,14,10,6,63,30,33,52
Crusaders,5507,2,14,8,8,55,34,21,50
Coleraine,5507,3,12,13,5,46,33,13,49
Cliftonville,5507,4,15,4,11,48,42,6,49
Ballymena,5507,5,11,10,9,49,53,-4,43
Glenavon,5507,6,11,9,10,42,42,0,42
Dungannon,5507,7,8,12,10,44,40,4,36
Ards,5507,8,11,3,16,40,52,-12,36
Glentoran,5507,9,10,5,15,23,49,-26,35
Ballinamalla,5507,10,9,4,17,31,50,-19,31
Portadown,5507,11,7,8,15,25,41,-16,29
Cliftonville,5508,1,16,6,8,57,40,17,54
Ballymena,5508,2,16,4,10,64,57,7,52
Crusaders,5508,3,15,6,9,54,37,17,51
Linfield,5508,4,13,10,7,54,30,24,49
Glenavon,5508,5,13,10,7,47,43,4,49
Coleraine,5508,6,11,9,10,43,44,-1,42
Ards,5508,7,12,4,14,39,48,-9,40
Dungannon,5508,8,8,11,11,50,49,1,35
Portadown,5508,9,10,3,17,33,47,-14,33
Glentoran,5508,10,8,6,16,26,45,-19,30
Ballinamalla,5508,11,6,5,19,30,57,-27,23
Crusaders,5509,1,17,9,4,59,31,28,60
Linfield,5509,2,14,13,3,63,32,31,55
Cliftonville,5509,3,14,6,10,46,37,9,48
Coleraine,5509,4,12,11,7,51,40,11,47
Glenavon,5509,5,12,10,8,52,50,2,46
Ballymena,5509,6,13,4,13,56,61,-5,43
Dungannon,5509,7,10,9,11,52,52,0,39
Glentoran,5509,8,8,8,14,31,45,-14,32
Ballinamalla,5509,9,9,4,17,31,49,-18,31
Ards,5509,10,8,6,16,37,52,-15,30
Portadown,5509,11,7,2,21,20,49,-29,23
Linfield,5510,1,17,8,5,68,37,31,59
Crusaders,5510,2,16,8,6,57,33,24,56
Cliftonville,5510,3,14,6,10,55,44,11,48
Coleraine,5510,4,12,10,8,41,41,0,46
Glenavon,5510,5,12,9,9,50,47,3,45
Ballymena,5510,6,11,10,9,62,65,-3,43
Dungannon,5510,7,9,9,12,45,44,1,36
Portadown,5510,8,8,7,15,29,40,-11,31
Glentoran,5510,9,8,7,15,38,55,-17,31
Ballinamalla,5510,10,9,4,17,31,51,-20,31
Ards,5510,11,8,4,18,34,53,-19,28
Cliftonville,5511,1,19,3,8,58,29,29,60
Linfield,5511,2,14,8,8,59,37,22,50
Glenavon,5511,3,14,8,8,54,44,10,50
Crusaders,5511,4,13,8,9,50,35,15,47
Coleraine,5511,5,10,10,10,41,40,1,40
Ballymena,5511,6,11,7,12,53,63,-10,40
Dungannon,5511,7,10,8,12,53,51,2,38
Glentoran,5511,8,9,9,12,31,45,-14,36
Portadown,5511,9,10,6,14,24,39,-15,36
Ballinamalla,5511,10,8,6,16,33,55,-22,30
Ards,5511,11,7,7,16,33,51,-18,28
Crusaders,5512,1,16,11,3,61,29,32,59
Cliftonville,5512,2,14,11,5,55,37,18,53
Linfield,5512,3,14,9,7,58,33,25,51
Ballymena,5512,4,14,6,10,58,55,3,48
Coleraine,5512,5,11,11,8,42,41,1,44
Glenavon,5512,6,10,12,8,45,47,-2,42
Ards,5512,7,10,4,16,35,51,-16,34
Dungannon,5512,8,6,14,10,40,39,1,32
Portadown,5512,9,7,7,16,34,56,-22,28
Glentoran,5512,10,6,9,15,29,47,-18,27
Ballinamalla,5512,11,6,8,16,30,52,-22,26
Crusaders,5513,1,19,7,4,59,30,29,64
Cliftonville,5513,2,16,3,11,55,40,15,51
Glenavon,5513,3,12,11,7,46,39,7,47
Coleraine,5513,4,10,14,6,43,38,5,44
Linfield,5513,5,11,10,9,54,39,15,43
Dungannon,5513,6,10,12,8,52,41,11,42
Ballymena,5513,7,10,7,13,51,56,-5,37
Glentoran,5513,8,9,7,14,29,50,-21,34
Ballinamalla,5513,9,8,6,16,32,49,-17,30
Portadown,5513,10,8,6,16,21,43,-22,30
Ards,5513,11,7,7,16,36,53,-17,28
Linfield,5514,1,17,10,3,75,28,47,61
Cliftonville,5514,2,15,7,8,48,34,14,52
Ballymena,5514,3,16,4,10,55,57,-2,52
Glenavon,5514,4,14,9,7,52,40,12,51
Crusaders,5514,5,13,8,9,51,43,8,47
Dungannon,5514,6,10,10,10,48,41,7,40
Coleraine,5514,7,10,9,11,43,45,-2,39
Ards,5514,8,9,8,13,40,52,-12,35
Glentoran,5514,9,7,7,16,31,54,-23,28
Ballinamalla,5514,10,7,5,18,31,57,-26,26
Portadown,5514,11,6,5,19,25,48,-23,23
Crusaders,5515,1,18,9,3,58,34,24,63
Cliftonville,5515,2,16,4,10,58,43,15,52
Linfield,5515,3,13,7,10,56,42,14,46
Dungannon,5515,4,13,6,11,58,44,14,45
Coleraine,5515,5,10,11,9,41,42,-1,41
Glenavon,5515,6,10,10,10,46,43,3,40
Ards,5515,7,10,7,13,43,52,-9,37
Ballymena,5515,8,9,9,12,49,64,-15,36
Ballinamalla,5515,9,9,5,16,39,50,-11,32
Glentoran,5515,10,7,10,13,33,48,-15,31
Portadown,5515,11,8,6,16,32,51,-19,30
Crusaders,5516,1,16,8,6,58,38,20,56
Cliftonville,5516,2,16,5,9,55,41,14,53
Linfield,5516,3,13,13,4,55,28,27,52
Ballymena,5516,4,13,7,10,54,54,0,46
Dungannon,5516,5,10,12,8,55,48,7,42
Glenavon,5516,6,10,10,10,46,52,-6,40
Coleraine,5516,7,10,9,11,42,41,1,39
Glentoran,5516,8,10,7,13,29,35,-6,37
Ards,5516,9,7,8,15,38,53,-15,29
Ballinamalla,5516,10,8,5,17,33,53,-20,29
Portadown,5516,11,6,8,16,26,48,-22,26
Crusaders,5517,1,15,6,9,53,39,14,51
Cliftonville,5517,2,16,3,11,51,38,13,51
Linfield,5517,3,14,7,9,62,42,20,49
Glenavon,5517,4,12,11,7,51,40,11,47
Ballymena,5517,5,12,7,11,53,56,-3,43
Coleraine,5517,6,9,15,6,39,35,4,42
Dungannon,5517,7,9,12,9,45,39,6,39
Ballinamalla,5517,8,9,8,13,36,47,-11,35
Ards,5517,9,9,6,15,36,46,-10,33
Portadown,5517,10,8,8,14,32,47,-15,32
Glentoran,5517,11,6,9,15,27,56,-29,27
Linfield,5518,1,16,7,7,59,29,30,55
Crusaders,5518,2,16,6,8,49,33,16,54
Cliftonville,5518,3,15,8,7,56,38,18,53
Coleraine,5518,4,13,10,7,46,39,7,49
Glentoran,5518,5,13,6,11,34,42,-8,45
Ballymena,5518,6,12,7,11,57,58,-1,43
Glenavon,5518,7,9,9,12,48,57,-9,36
Dungannon,5518,8,8,9,13,52,46,6,33
Ards,5518,9,9,5,16,39,55,-16,32
Ballinamalla,5518,10,9,3,18,33,53,-20,30
Portadown,5518,11,8,4,18,24,47,-23,28
Crusaders,5519,1,17,8,5,57,32,25,59
Cliftonville,5519,2,18,5,7,52,32,20,59
Ballymena,5519,3,17,5,8,63,55,8,56
Coleraine,5519,4,12,8,10,39,39,0,44
Linfield,5519,5,12,7,11,55,42,13,43
Ballinamalla,5519,6,12,4,14,44,54,-10,40
Glenavon,5519,7,9,12,9,45,46,-1,39
Ards,5519,8,9,6,15,36,44,-8,33
Dungannon,5519,9,8,8,14,44,44,0,32
Glentoran,5519,10,7,7,16,24,45,-21,28
Portadown,5519,11,5,8,17,21,47,-26,23
Linfield,5520,1,18,8,4,66,27,39,62
Crusaders,5520,2,15,6,9,48,35,13,51
Ballymena,5520,3,15,6,9,65,61,4,51
Cliftonville,5520,4,15,3,12,49,40,9,48
Dungannon,5520,5,11,11,8,50,43,7,44
Coleraine,5520,6,11,11,8,42,40,2,44
Glenavon,5520,7,10,8,12,46,48,-2,38
Ballinamalla,5520,8,10,1,19,35,52,-17,31
Portadown,5520,9,9,4,17,21,39,-18,31
Ards,5520,10,8,6,16,36,51,-15,30
Glentoran,5520,11,8,6,16,30,52,-22,30
Ballymena,5521,1,17,6,7,65,50,15,57
Crusaders,5521,2,17,5,8,58,50,8,56
Linfield,5521,3,15,8,7,65,31,34,53
Glenavon,5521,4,13,9,8,52,45,7,48
Cliftonville,5521,5,13,6,11,46,40,6,45
Coleraine,5521,6,11,10,9,43,44,-1,43
Glentoran,5521,7,12,6,12,38,47,-9,42
Dungannon,5521,8,7,10,13,46,49,-3,31
Ards,5521,9,8,7,15,36,46,-10,31
Portadown,5521,10,6,8,16,23,44,-21,26
Ballinamalla,5521,11,5,7,18,24,50,-26,22
Crusaders,5522,1,18,10,2,63,28,35,64
Linfield,5522,2,15,9,6,61,34,27,54
Cliftonville,5522,3,14,8,8,61,41,20,50
Ballymena,5522,4,13,7,10,58,67,-9,46
Dungannon,5522,5,10,11,9,58,48,10,41
Glenavon,5522,6,9,13,8,44,48,-4,40
Ards,5522,7,11,4,15,38,45,-7,37
Coleraine,5522,8,8,11,11,39,46,-7,35
Glentoran,5522,9,8,10,12,37,46,-9,34
Ballinamalla,5522,10,9,3,18,34,52,-18,30
Portadown,5522,11,5,4,21,22,60,-38,19
Ballymena,5523,1,16,8,6,61,50,11,56
Cliftonville,5523,2,14,7,9,55,38,17,49
Dungannon,5523,3,14,6,10,50,43,7,48
Coleraine,5523,4,12,11,7,50,37,13,47
Glenavon,5523,5,13,8,9,49,41,8,47
Crusaders,5523,6,13,8,9,50,46,4,47
Linfield,5523,7,11,11,8,52,34,18,44
Ards,5523,8,10,4,16,33,48,-15,34
Glentoran,5523,9,7,10,13,36,49,-13,31
Portadown,5523,10,7,6,17,28,48,-20,27
Ballinamalla,5523,11,6,5,19,24,54,-30,23
Crusaders,5524,1,17,8,5,56,33,23,59
Ballymena,5524,2,18,3,9,67,55,12,57
Glenavon,5524,3,12,12,6,45,41,4,48
Coleraine,5524,4,13,8,9,40,36,4,47
Linfield,5524,5,12,9,9,49,33,16,45
Cliftonville,5524,6,13,6,11,50,41,9,45
Dungannon,5524,7,8,11,11,48,46,2,35
Glentoran,5524,8,9,7,14,36,49,-13,34
Ballinamalla,5524,9,9,6,15,35,48,-13,33
Ards,5524,10,8,6,16,36,50,-14,30
Portadown,5524,11,5,6,19,23,53,-30,21
Linfield,5525,1,16,8,6,66,34,32,56
Coleraine,5525,2,15,8,7,49,36,13,53
Crusaders,5525,3,14,10,6,54,38,16,52
Cliftonville,5525,4,14,5,11,52,43,9,47
Glenavon,5525,5,12,10,8,49,46,3,46
Ballymena,5525,6,13,7,10,53,57,-4,46
Dungannon,5525,7,9,13,8,53,47,6,40
Ards,5525,8,11,5,14,40,47,-7,38
Glentoran,5525,9,11,5,14,35,42,-7,38
Portadown,5525,10,5,7,18,18,45,-27,22
Ballinamalla,5525,11,3,6,21,19,53,-34,15
Crusaders,5526,1,15,9,6,57,38,19,54
Cliftonville,5526,2,17,3,10,54,39,15,54
Linfield,5526,3,15,8,7,55,33,22,53
Dungannon,5526,4,15,8,7,61,42,19,53
Glenavon,5526,5,11,9,10,45,47,-2,42
Ballymena,5526,6,12,5,13,51,59,-8,41
Coleraine,5526,7,10,8,12,43,45,-2,38
Ballinamalla,5526,8,11,2,17,38,50,-12,35
Glentoran,5526,9,9,7,14,29,39,-10,34
Ards,5526,10,8,5,17,36,56,-20,29
Portadown,5526,11,9,2,19,31,52,-21,29
Crusaders,5527,1,17,7,6,61,39,22,58
Linfield,5527,2,14,9,7,48,26,22,51
Ballymena,5527,3,14,6,10,59,52,7,48
Dungannon,5527,4,12,10,8,47,38,9,46
Coleraine,5527,5,12,10,8,38,32,6,46
Cliftonville,5527,6,12,6,12,46,40,6,42
Glenavon,5527,7,8,13,9,45,51,-6,37
Ards,5527,8,10,4,16,32,44,-12,34
Glentoran,5527,9,8,8,14,31,45,-14,32
Ballinamalla,5527,10,9,3,18,32,55,-23,30
Portadown,5527,11,7,8,15,23,40,-17,29
Linfield,5528,1,16,8,6,62,32,30,56
Ballymena,5528,2,14,8,8,60,58,2,50
Crusaders,5528,3,13,10,7,53,39,14,49
Glenavon,5528,4,12,11,7,54,48,6,47
Coleraine,5528,5,12,10,8,50,41,9,46
Cliftonville,5528,6,12,6,12,42,39,3,42
Dungannon,5528,7,8,11,11,46,44,2,35
Glentoran,5528,8,9,8,13,38,49,-11,35
Portadown,5528,9,9,5,16,29,46,-17,32
Ballinamalla,5528,10,8,6,16,29,45,-16,30
Ards,5528,11,8,5,17,34,56,-22,29
Crusaders,5529,1,16,5,9,56,38,18,53
Ballymena,5529,2,16,5,9,55,48,7,53
Cliftonville,5529,3,14,10,6,51,34,17,52
Linfield,5529,4,13,10,7,51,28,23,49
Dungannon,5529,5,12,9,9,53,39,14,45
Coleraine,5529,6,10,10,10,43,44,-1,40
Ards,5529,7,10,5,15,39,48,-9,35
Glenavon,5529,8,8,10,12,40,52,-12,34
Glentoran,5529,9,9,6,15,31,49,-18,33
Ballinamalla,5529,10,9,4,17,33,53,-20,31
Portadown,5529,11,8,6,16,23,42,-19,30
Crusaders,5530,1,15,10,5,59,40,19,55
Cliftonville,5530,2,15,8,7,55,35,20,53
Glenavon,5530,3,14,10,6,50,40,10,52
Linfield,5530,4,11,14,5,58,37,21,47
Dungannon,5530,5,10,13,7,56,44,12,43
Ballymena,5530,6,12,7,11,59,63,-4,43
Coleraine,5530,7,8,13,9,43,45,-2,37
Ballinamalla,5530,8,10,6,14,31,43,-12,36
Ards,5530,9,9,5,16,36,52,-16,32
Glentoran,5530,10,5,9,16,32,56,-24,24
Portadown,5530,11,7,3,20,25,49,-24,24
Crusaders,5531,1,18,7,5,56,32,24,61
Coleraine,5531,2,13,13,4,52,31,21,52
Linfield,5531,3,13,12,5,64,33,31,51
Cliftonville,5531,4,14,4,12,49,38,11,46
Dungannon,5531,5,12,10,8,56,46,10,46
Ballymena,5531,6,12,8,10,55,60,-5,44
Glenavon,5531,7,8,12,10,46,55,-9,36
Ballinamalla,5531,8,8,6,16,30,48,-18,30
Glentoran,5531,9,6,11,13,25,47,-22,29
Portadown,5531,10,7,6,17,29,50,-21,27
Ards,5531,11,7,5,18,38,60,-22,26
Cliftonville,5532,1,18,4,8,57,32,25,58
Crusaders,5532,2,17,7,6,58,35,23,58
Linfield,5532,3,15,8,7,52,29,23,53
Ballymena,5532,4,14,7,9,61,53,8,49
Coleraine,5532,5,12,9,9,42,35,7,45
Glenavon,5532,6,10,10,10,41,48,-7,40
Ards,5532,7,10,6,14,37,44,-7,36
Glentoran,5532,8,9,9,12,32,43,-11,36
Dungannon,5532,9,9,8,13,55,53,2,35
Ballinamalla,5532,10,8,3,19,33,63,-30,27
Portadown,5532,11,4,7,19,25,58,-33,19
Crusaders,5533,1,18,6,6,57,39,18,60
Linfield,5533,2,15,9,6,61,30,31,54
Cliftonville,5533,3,12,10,8,53,39,14,46
Glenavon,5533,4,11,13,6,48,40,8,46
Ballymena,5533,5,11,9,10,56,60,-4,42
Dungannon,5533,6,11,8,11,55,44,11,41
Coleraine,5533,7,8,11,11,38,43,-5,35
Portadown,5533,8,9,7,14,29,47,-18,34
Glentoran,5533,9,8,8,14,32,50,-18,32
Ards,5533,10,8,6,16,37,49,-12,30
Ballinamalla,5533,11,8,5,17,29,54,-25,29
Linfield,5534,1,16,9,5,52,26,26,57
Crusaders,5534,2,15,6,9,50,37,13,51
Coleraine,5534,3,13,11,6,42,31,11,50
Cliftonville,5534,4,14,5,11,47,41,6,47
Ballymena,5534,5,13,7,10,56,55,1,46
Dungannon,5534,6,12,9,9,49,38,11,45
Glenavon,5534,7,11,11,8,50,42,8,44
Ards,5534,8,9,7,14,41,49,-8,34
Portadown,5534,9,9,3,18,27,50,-23,30
Glentoran,5534,10,7,7,16,23,43,-20,28
Ballinamalla,5534,11,6,5,19,32,57,-25,23
Crusaders,5535,1,16,8,6,55,37,18,56
Cliftonville,5535,2,15,6,9,57,40,17,51
Coleraine,5535,3,13,10,7,47,39,8,49
Glenavon,5535,4,12,12,6,49,42,7,48
Linfield,5535,5,13,8,9,53,34,19,47
Ballymena,5535,6,14,4,12,54,55,-1,46
Glentoran,5535,7,11,7,12,30,38,-8,40
Dungannon,5535,8,10,9,11,49,43,6,39
Ards,5535,9,8,5,17,36,53,-17,29
Portadown,5535,10,7,5,18,25,44,-19,26
Ballinamalla,5535,11,7,4,19,32,62,-30,25
Crusaders,5536,1,16,8,6,53,34,19,56
Linfield,5536,2,15,10,5,61,26,35,55
Ballymena,5536,3,13,8,9,57,60,-3,47
Coleraine,5536,4,11,13,6,50,37,13,46
Cliftonville,5536,5,12,6,12,49,43,6,42
Dungannon,5536,6,10,11,9,49,39,10,41
Ards,5536,7,10,7,13,40,47,-7,37
Glenavon,5536,8,8,11,11,42,53,-11,35
Glentoran,5536,9,8,8,14,28,45,-17,32
Portadown,5536,10,9,5,16,22,42,-20,32
Ballinamalla,5536,11,6,7,17,29,54,-25,25
Crusaders,5537,1,18,8,4,62,35,27,62
Cliftonville,5537,2,16,4,10,51,41,10,52
Coleraine,5537,3,14,9,7,44,36,8,51
Linfield,5537,4,13,10,7,53,33,20,49
Ballymena,5537,5,14,7,9,61,62,-1,49
Dungannon,5537,6,11,8,11,52,45,7,41
Glenavon,5537,7,10,10,10,49,51,-2,40
Ards,5537,8,10,3,17,41,55,-14,33
Glentoran,5537,9,8,7,15,39,48,-9,31
Portadown,5537,10,8,5,17,26,41,-15,29
Ballinamalla,5537,11,5,5,20,23,54,-31,20
Cliftonville,5538,1,19,4,7,65,34,31,61
Linfield,5538,2,14,13,3,59,28,31,55
Crusaders,5538,3,16,7,7,60,41,19,55
Ballymena,5538,4,15,6,9,59,62,-3,51
Coleraine,5538,5,11,9,10,37,37,0,42
Dungannon,5538,6,10,9,11,59,53,6,39
Glentoran,5538,7,10,6,14,33,41,-8,36
Glenavon,5538,8,8,11,11,39,53,-14,35
Portadown,5538,9,9,6,15,29,43,-14,33
Ards,5538,10,7,5,18,32,54,-22,26
Ballinamalla,5538,11,5,6,19,29,55,-26,21
Linfield,5539,1,16,9,5,68,31,37,57
Ballymena,5539,2,17,5,8,61,51,10,56
Crusaders,5539,3,15,9,6,51,35,16,54
Cliftonville,5539,4,15,7,8,55,38,17,52
Dungannon,5539,5,10,10,10,47,40,7,40
Glenavon,5539,6,9,12,9,49,47,2,39
Coleraine,5539,7,9,11,10,37,43,-6,38
Ards,5539,8,10,6,14,40,47,-7,36
Glentoran,5539,9,8,8,14,31,47,-16,32
Ballinamalla,5539,10,7,7,16,26,50,-24,28
Portadown,5539,11,5,4,21,18,54,-36,19
Crusaders,5540,1,16,9,5,62,42,20,57
Ballymena,5540,2,15,9,6,57,51,6,54
Coleraine,5540,3,14,10,6,45,38,7,52
Cliftonville,5540,4,14,7,9,49,33,16,49
Linfield,5540,5,13,9,8,52,33,19,48
Dungannon,5540,6,11,10,9,56,41,15,43
Glenavon,5540,7,10,9,11,48,51,-3,39
Portadown,5540,8,9,3,18,30,46,-16,30
Glentoran,5540,9,8,6,16,31,49,-18,30
Ballinamalla,5540,10,8,3,19,28,58,-30,27
Ards,5540,11,7,5,18,35,51,-16,26
Linfield,5541,1,14,11,5,58,32,26,53
Crusaders,5541,2,14,10,6,50,37,13,52
Ballymena,5541,3,16,4,10,64,60,4,52
Cliftonville,5541,4,15,4,11,59,44,15,49
Glenavon,5541,5,12,10,8,50,48,2,46
Dungannon,5541,6,11,8,11,45,41,4,41
Portadown,5541,7,10,6,14,28,37,-9,36
Coleraine,5541,8,7,12,11,34,42,-8,33
Ards,5541,9,8,8,14,37,46,-9,32
Glentoran,5541,10,8,7,15,27,42,-15,31
Ballinamalla,5541,11,8,4,18,30,53,-23,28
Cliftonville,5542,1,18,4,8,65,39,26,58
Linfield,5542,2,15,9,6,57,32,25,54
Ballymena,5542,3,15,6,9,67,66,1,51
Crusaders,5542,4,14,6,10,53,47,6,48
Dungannon,5542,5,11,10,9,54,45,9,43
Coleraine,5542,6,10,9,11,46,47,-1,39
Glenavon,5542,7,9,11,10,45,50,-5,38
Ards,5542,8,11,4,15,41,47,-6,37
Glentoran,5542,9,9,8,13,41,47,-6,35
Portadown,5542,10,8,7,15,24,43,-19,31
Ballinamalla,5542,11,5,6,19,31,61,-30,21
Crusaders,5543,1,16,8,6,55,38,17,56
Linfield,5543,2,15,8,7,58,29,29,53
Cliftonville,5543,3,15,7,8,53,36,17,52
Coleraine,5543,4,12,10,8,51,41,10,46
Glentoran,5543,5,12,7,11,32,36,-4,43
Glenavon,5543,6,10,10,10,45,50,-5,40
Dungannon,5543,7,9,10,11,50,48,2,37
Ballymena,5543,8,10,5,15,54,66,-12,35
Ballinamalla,5543,9,10,3,17,34,50,-16,33
Portadown,5543,10,10,3,17,29,48,-19,33
Ards,5543,11,7,7,16,35,54,-19,28
Crusaders,5544,1,19,7,4,61,26,35,64
Linfield,5544,2,16,10,4,57,28,29,58
Coleraine,5544,3,13,9,8,47,37,10,48
Ballymena,5544,4,13,4,13,52,59,-7,43
Cliftonville,5544,5,11,9,10,47,42,5,42
Portadown,5544,6,12,4,14,31,41,-10,40
Glenavon,5544,7,9,12,9,39,45,-6,39
Glentoran,5544,8,10,6,14,25,39,-14,36
Dungannon,5544,9,7,11,12,43,43,0,32
Ballinamalla,5544,10,8,4,18,27,50,-23,28
Ards,5544,11,7,4,19,35,54,-19,25
Linfield,5545,1,16,9,5,63,32,31,57
Crusaders,5545,2,17,6,7,56,32,24,57
Cliftonville,5545,3,16,5,9,54,36,18,53
Coleraine,5545,4,13,11,6,52,40,12,50
Glenavon,5545,5,13,8,9,50,41,9,47
Ballymena,5545,6,11,8,11,58,64,-6,41
Dungannon,5545,7,10,8,12,43,43,0,38
Ards,5545,8,10,3,17,36,50,-14,33
Glentoran,5545,9,7,11,12,30,52,-22,32
Ballinamalla,5545,10,7,5,18,26,51,-25,26
Portadown,5545,11,5,6,19,21,48,-27,21
Crusaders,5546,1,18,7,5,58,31,27,61
Linfield,5546,2,15,10,5,66,30,36,55
Coleraine,5546,3,12,13,5,47,38,9,49
Ballymena,5546,4,13,8,9,53,58,-5,47
Cliftonville,5546,5,12,7,11,51,42,9,43
Dungannon,5546,6,9,11,10,43,41,2,38
Glenavon,5546,7,8,10,12,44,51,-7,34
Portadown,5546,8,8,7,15,29,49,-20,31
Ards,5546,9,8,6,16,33,47,-14,30
Ballinamalla,5546,10,7,9,14,32,50,-18,30
Glentoran,5546,11,7,8,15,27,46,-19,29
Crusaders,5547,1,17,9,4,57,34,23,60
Cliftonville,5547,2,16,8,6,53,35,18,56
Linfield,5547,3,15,8,7,66,36,30,53
Ballymena,5547,4,15,5,10,60,59,1,50
Dungannon,5547,5,10,11,9,52,43,9,41
Glenavon,5547,6,9,11,10,43,44,-1,38
Coleraine,5547,7,7,12,11,40,46,-6,33
Glentoran,5547,8,9,5,16,31,45,-14,32
Ballinamalla,5547,9,8,7,15,30,44,-14,31
Ards,5547,10,7,9,14,35,52,-17,30
Portadown,5547,11,7,5,18,23,52,-29,26
Crusaders,5548,1,17,7,6,61,36,25,58
Ballymena,5548,2,16,7,7,66,59,7,55
Cliftonville,5548,3,15,2,13,52,47,5,47
Coleraine,5548,4,12,10,8,43,31,12,46
Linfield,5548,5,12,8,10,55,39,16,44
Dungannon,5548,6,11,7,12,59,48,11,40
Glenavon,5548,7,10,9,11,50,60,-10,39
Portadown,5548,8,11,4,15,38,44,-6,37
Glentoran,5548,9,8,8,14,33,53,-20,32
Ards,5548,10,9,4,17,34,54,-20,31
Ballinamalla,5548,11,9,4,17,30,50,-20,31
Crusaders,5549,1,15,9,6,52,36,16,54
Linfield,5549,2,13,13,4,64,39,25,52
Cliftonville,5549,3,14,8,8,53,39,14,50
Ballymena,5549,4,15,4,11,58,57,1,49
Coleraine,5549,5,12,10,8,40,31,9,46
Glenavon,5549,6,12,10,8,47,40,7,46
Dungannon,5549,7,11,9,10,50,48,2,42
Ards,5549,8,10,6,14,37,48,-11,36
Glentoran,5549,9,8,7,15,34,46,-12,31
Portadown,5549,10,7,6,17,25,45,-20,27
Ballinamalla,5549,11,4,6,20,22,53,-31,18
Cliftonville,5550,1,19,3,8,64,39,25,60
Crusaders,5550,2,16,7,7,56,34,22,55
Linfield,5550,3,13,9,8,57,35,22,48
Ards,5550,4,14,4,12,42,45,-3,46
Glentoran,5550,5,12,7,11,31,43,-12,43
Coleraine,5550,6,11,9,10,40,38,2,42
Ballymena,5550,7,12,6,12,58,64,-6,42
Dungannon,5550,8,9,8,13,51,52,-1,35
Glenavon,5550,9,9,8,13,45,58,-13,35
Portadown,5550,10,8,4,18,25,47,-22,28
Ballinamalla,5550,11,8,3,19,37,51,-14,27
Crusaders,5551,1,16,10,4,57,32,25,58
Linfield,5551,2,14,10,6,62,31,31,52
Ballymena,5551,3,14,8,8,69,51,18,50
Glenavon,5551,4,12,10,8,48,42,6,46
Cliftonville,5551,5,13,6,11,45,38,7,45
Coleraine,5551,6,11,11,8,43,40,3,44
Dungannon,5551,7,10,7,13,49,48,1,37
Ards,5551,8,10,6,14,42,49,-7,36
Portadown,5551,9,10,5,15,31,49,-18,35
Glentoran,5551,10,7,6,17,24,55,-31,27
Ballinamalla,5551,11,6,5,19,25,60,-35,23
Crusaders,5552,1,18,9,3,62,25,37,63
Cliftonville,5552,2,15,8,7,53,38,15,53
Ballymena,5552,3,13,7,10,48,53,-5,46
Glenavon,5552,4,11,12,7,44,41,3,45
Linfield,5552,5,12,8,10,52,37,15,44
Dungannon,5552,6,9,12,9,46,42,4,39
Coleraine,5552,7,9,10,11,40,39,1,37
Ards,5552,8,9,6,15,44,54,-10,33
Portadown,5552,9,9,6,15,25,44,-19,33
Glentoran,5552,10,7,10,13,30,42,-12,31
Ballinamalla,5552,11,7,4,19,27,56,-29,25
Crusaders,5553,1,17,8,5,68,34,34,59
Linfield,5553,2,15,7,8,60,40,20,52
Cliftonville,5553,3,15,3,12,51,46,5,48
Dungannon,5553,4,11,11,8,51,39,12,44
Glenavon,5553,5,9,14,7,45,43,2,41
Ards,5553,6,12,5,13,41,46,-5,41
Ballymena,5553,7,11,7,12,54,64,-10,40
Coleraine,5553,8,9,11,10,40,43,-3,38
Glentoran,5553,9,9,6,15,36,50,-14,33
Portadown,5553,10,9,4,17,28,45,-17,31
Ballinamalla,5553,11,8,4,18,36,60,-24,28
Crusaders,5554,1,19,6,5,57,30,27,63
Cliftonville,5554,2,17,7,6,52,28,24,58
Linfield,5554,3,14,10,6,52,29,23,52
Ballymena,5554,4,12,7,11,56,59,-3,43
Coleraine,5554,5,10,12,8,40,36,4,42
Glentoran,5554,6,12,5,13,35,45,-10,41
Dungannon,5554,7,8,13,9,49,46,3,37
Glenavon,5554,8,8,12,10,47,51,-4,36
Portadown,5554,9,9,4,17,27,42,-15,31
Ballinamalla,5554,10,9,3,18,28,50,-22,30
Ards,5554,11,5,5,20,27,54,-27,20
Linfield,5555,1,15,10,5,53,26,27,55
Crusaders,5555,2,15,6,9,55,41,14,51
Cliftonville,5555,3,15,5,10,58,43,15,50
Glenavon,5555,4,12,9,9,52,48,4,45
Coleraine,5555,5,10,12,8,41,38,3,42
Ballymena,5555,6,12,5,13,49,56,-7,41
Dungannon,5555,7,10,10,10,60,53,7,40
Glentoran,5555,8,10,9,11,34,40,-6,39
Ballinamalla,5555,9,11,3,16,39,57,-18,36
Ards,5555,10,8,5,17,36,53,-17,29
Portadown,5555,11,8,4,18,22,44,-22,28
Ballymena,5556,1,17,6,7,66,56,10,57
Crusaders,5556,2,15,9,6,51,32,19,54
Cliftonville,5556,3,16,5,9,62,40,22,53
Glenavon,5556,4,14,10,6,58,40,18,52
Linfield,5556,5,12,12,6,57,36,21,48
Coleraine,5556,6,11,10,9,36,36,0,43
Dungannon,5556,7,9,11,10,43,39,4,38
Glentoran,5556,8,7,8,15,29,51,-22,29
Ballinamalla,5556,9,7,7,16,26,47,-21,28
Ards,5556,10,7,6,17,32,54,-22,27
Portadown,5556,11,5,6,19,21,50,-29,21
Crusaders,5557,1,16,8,6,52,31,21,56
Cliftonville,5557,2,15,7,8,58,41,17,52
Linfield,5557,3,15,7,8,52,35,17,52
Ballymena,5557,4,14,7,9,61,54,7,49
Glenavon,5557,5,11,11,8,44,41,3,44
Ards,5557,6,12,4,14,36,42,-6,40
Coleraine,5557,7,9,11,10,41,42,-1,38
Dungannon,5557,8,9,9,12,50,51,-1,36
Glentoran,5557,9,8,11,11,39,44,-5,35
Portadown,5557,10,8,5,17,27,54,-27,29
Ballinamalla,5557,11,6,4,20,28,53,-25,22
Crusaders,5558,1,18,7,5,60,33,27,61
Linfield,5558,2,17,9,4,63,29,34,60
Cliftonville,5558,3,16,4,10,59,41,18,52
Ballymena,5558,4,12,9,9,58,60,-2,45
Coleraine,5558,5,10,13,7,39,35,4,43
Glenavon,5558,6,10,13,7,44,43,1,43
Glentoran,5558,7,11,7,12,27,38,-11,40
Portadown,5558,8,8,7,15,29,47,-18,31
Dungannon,5558,9,6,10,14,39,45,-6,28
Ards,5558,10,7,6,17,33,52,-19,27
Ballinamalla,5558,11,5,5,20,25,53,-28,20
Ballymena,5559,1,18,5,7,65,50,15,59
Crusaders,5559,2,16,7,7,54,37,17,55
Linfield,5559,3,12,9,9,56,35,21,45
Coleraine,5559,4,12,9,9,41,36,5,45
Glentoran,5559,5,11,8,11,33,39,-6,41
Glenavon,5559,6,10,10,10,44,47,-3,40
Cliftonville,5559,7,11,6,13,50,51,-1,39
Dungannon,5559,8,9,10,11,54,46,8,37
Ards,5559,9,9,8,13,38,54,-16,35
Ballinamalla,5559,10,8,6,16,36,54,-18,30
Portadown,5559,11,7,6,17,26,48,-22,27
Linfield,5560,1,16,10,4,58,27,31,58
Cliftonville,5560,2,16,5,9,55,37,18,53
Ballymena,5560,3,15,5,10,56,59,-3,50
Coleraine,5560,4,13,8,9,46,36,10,47
Crusaders,5560,5,12,10,8,45,41,4,46
Glenavon,5560,6,11,11,8,51,47,4,44
Dungannon,5560,7,11,10,9,47,36,11,43
Ards,5560,8,10,3,17,37,47,-10,33
Glentoran,5560,9,8,7,15,30,48,-18,31
Ballinamalla,5560,10,7,5,18,32,55,-23,26
Portadown,5560,11,5,8,17,20,44,-24,23
Crusaders,5561,1,18,6,6,60,34,26,60
Linfield,5561,2,15,10,5,61,32,29,55
Coleraine,5561,3,13,12,5,48,35,13,51
Ballymena,5561,4,14,5,11,61,58,3,47
Glenavon,5561,5,11,13,6,54,50,4,46
Cliftonville,5561,6,13,6,11,44,39,5,45
Dungannon,5561,7,10,8,12,50,48,2,38
Ards,5561,8,9,6,15,36,49,-13,33
Glentoran,5561,9,7,9,14,28,45,-17,30
Portadown,5561,10,6,6,18,21,46,-25,24
Ballinamalla,5561,11,7,3,20,27,54,-27,24
Crusaders,5562,1,17,9,4,53,28,25,60
Cliftonville,5562,2,15,4,11,56,45,11,49
Coleraine,5562,3,11,14,5,45,35,10,47
Linfield,5562,4,11,11,8,55,42,13,44
Glenavon,5562,5,10,13,7,43,45,-2,43
Glentoran,5562,6,10,7,13,35,43,-8,37
Ballymena,5562,7,10,7,13,50,61,-11,37
Dungannon,5562,8,9,8,13,44,43,1,35
Portadown,5562,9,9,7,14,33,43,-10,34
Ards,5562,10,8,8,14,36,48,-12,32
Ballinamalla,5562,11,9,4,17,36,53,-17,31
Ballymena,5563,1,17,6,7,68,57,11,57
Cliftonville,5563,2,16,7,7,58,34,24,55
Linfield,5563,3,14,10,6,59,35,24,52
Crusaders,5563,4,15,7,8,57,40,17,52
Coleraine,5563,5,12,8,10,42,39,3,44
Glenavon,5563,6,11,11,8,51,53,-2,44
Dungannon,5563,7,11,9,10,56,41,15,42
Ballinamalla,5563,8,9,4,17,41,60,-19,31
Portadown,5563,9,8,5,17,29,51,-22,29
Glentoran,5563,10,7,7,16,37,59,-22,28
Ards,5563,11,6,4,20,35,64,-29,22
Linfield,5564,1,15,8,7,60,29,31,53
Crusaders,5564,2,14,9,7,55,36,19,51
Cliftonville,5564,3,15,6,9,54,41,13,51
Glenavon,5564,4,13,9,8,44,41,3,48
Ballymena,5564,5,13,7,10,52,53,-1,46
Dungannon,5564,6,11,9,10,46,43,3,42
Ards,5564,7,12,3,15,43,54,-11,39
Coleraine,5564,8,9,10,11,40,42,-2,37
Glentoran,5564,9,10,4,16,34,45,-11,34
Portadown,5564,10,8,8,14,29,45,-16,32
Ballinamalla,5564,11,6,5,19,28,56,-28,23
Crusaders,5565,1,19,7,4,63,27,36,64
Cliftonville,5565,2,19,5,6,65,30,35,62
Ballymena,5565,3,19,4,7,67,54,13,61
Linfield,5565,4,14,9,7,59,37,22,51
Glenavon,5565,5,11,10,9,48,48,0,43
Dungannon,5565,6,10,8,12,48,45,3,38
Ards,5565,7,9,4,17,39,53,-14,31
Coleraine,5565,8,7,10,13,34,50,-16,31
Glentoran,5565,9,6,10,14,23,45,-22,28
Ballinamalla,5565,10,6,7,17,32,53,-21,25
Portadown,5565,11,5,6,19,19,55,-36,21
Linfield,5566,1,18,8,4,60,24,36,62
Crusaders,5566,2,14,11,5,54,35,19,53
Glenavon,5566,3,14,10,6,52,42,10,52
Cliftonville,5566,4,15,5,10,47,40,7,50
Coleraine,5566,5,10,11,9,44,37,7,41
Ballymena,5566,6,11,8,11,58,63,-5,41
Ards,5566,7,9,8,13,46,49,-3,35
Glentoran,5566,8,8,8,14,28,48,-20,32
Dungannon,5566,9,7,10,13,46,58,-12,31
Ballinamalla,5566,10,8,5,17,34,55,-21,29
Portadown,5566,11,6,6,18,30,48,-18,24
Crusaders,5567,1,17,6,7,57,38,19,57
Cliftonville,5567,2,17,4,9,56,37,19,55
Glenavon,5567,3,13,10,7,45,40,5,49
Linfield,5567,4,12,11,7,50,26,24,47
Coleraine,5567,5,11,10,9,42,39,3,43
Ballymena,5567,6,12,7,11,57,60,-3,43
Dungannon,5567,7,9,10,11,49,42,7,37
Ballinamalla,5567,8,11,4,15,37,51,-14,37
Ards,5567,9,8,7,15,38,55,-17,31
Portadown,5567,10,8,6,16,26,46,-20,30
Glentoran,5567,11,5,9,16,26,49,-23,24
Linfield,5568,1,17,10,3,62,28,34,61
Crusaders,5568,2,16,5,9,58,47,11,53
Cliftonville,5568,3,16,4,10,58,41,17,52
Ballymena,5568,4,14,5,11,59,60,-1,47
Glenavon,5568,5,11,8,11,48,48,0,41
Coleraine,5568,6,9,12,9,38,41,-3,39
Dungannon,5568,7,10,8,12,45,41,4,38
Glentoran,5568,8,10,7,13,32,43,-11,37
Ards,5568,9,10,4,16,41,51,-10,34
Ballinamalla,5568,10,8,7,15,35,49,-14,31
Portadown,5568,11,5,8,17,20,47,-27,23
Crusaders,5569,1,18,5,7,58,41,17,59
Ballymena,5569,2,16,7,7,65,55,10,55
Linfield,5569,3,14,10,6,65,36,29,52
Glenavon,5569,4,14,9,7,58,41,17,51
Cliftonville,5569,5,14,8,8,49,38,11,50
Dungannon,5569,6,10,9,11,47,45,2,39
Coleraine,5569,7,9,12,9,41,43,-2,39
Glentoran,5569,8,9,9,12,27,41,-14,36
Portadown,5569,9,8,4,18,29,45,-16,28
Ards,5569,10,5,7,18,32,56,-24,22
Ballinamalla,5569,11,5,6,19,24,54,-30,21
Linfield,5570,1,16,9,5,63,35,28,57
Glenavon,5570,2,16,9,5,64,37,27,57
Crusaders,5570,3,16,8,6,52,35,17,56
Ballymena,5570,4,13,8,9,58,59,-1,47
Cliftonville,5570,5,13,5,12,52,47,5,44
Coleraine,5570,6,11,8,11,42,39,3,41
Glentoran,5570,7,11,7,12,40,47,-7,40
Dungannon,5570,8,10,8,12,56,54,2,38
Ballinamalla,5570,9,8,4,18,33,57,-24,28
Ards,5570,10,7,4,19,30,53,-23,25
Portadown,5570,11,6,6,18,24,51,-27,24
Linfield,5571,1,15,10,5,67,32,35,55
Ballymena,5571,2,16,5,9,61,58,3,53
Crusaders,5571,3,14,9,7,51,35,16,51
Cliftonville,5571,4,15,5,10,55,37,18,50
Dungannon,5571,5,12,11,7,57,39,18,47
Coleraine,5571,6,12,9,9,51,44,7,45
Ards,5571,7,12,3,15,41,47,-6,39
Glenavon,5571,8,9,9,12,40,56,-16,36
Portadown,5571,9,8,6,16,27,52,-25,30
Glentoran,5571,10,5,9,16,28,54,-26,24
Ballinamalla,5571,11,5,8,17,24,48,-24,23
Cliftonville,5572,1,18,4,8,57,38,19,58
Linfield,5572,2,15,11,4,59,27,32,56
Ballymena,5572,3,16,5,9,58,52,6,53
Crusaders,5572,4,14,7,9,50,34,16,49
Glenavon,5572,5,10,11,9,43,44,-1,41
Coleraine,5572,6,8,14,8,36,36,0,38
Glentoran,5572,7,9,9,12,39,50,-11,36
Ballinamalla,5572,8,10,6,14,35,49,-14,36
Dungannon,5572,9,9,8,13,45,45,0,35
Ards,5572,10,8,4,18,36,54,-18,28
Portadown,5572,11,7,3,20,20,49,-29,24
Crusaders,5573,1,15,7,8,47,37,10,52
Linfield,5573,2,13,11,6,52,30,22,50
Ballymena,5573,3,14,8,8,65,55,10,50
Cliftonville,5573,4,15,4,11,55,42,13,49
Coleraine,5573,5,12,10,8,45,44,1,46
Glenavon,5573,6,11,12,7,53,46,7,45
Dungannon,5573,7,9,10,11,51,49,2,37
Ards,5573,8,11,3,16,41,50,-9,36
Glentoran,5573,9,9,9,12,33,43,-10,36
Portadown,5573,10,7,7,16,24,43,-19,28
Ballinamalla,5573,11,5,7,18,26,53,-27,22
Crusaders,5574,1,19,5,6,63,38,25,62
Linfield,5574,2,16,9,5,64,32,32,57
Cliftonville,5574,3,17,3,10,56,37,19,54
Glenavon,5574,4,14,8,8,55,46,9,50
Ballymena,5574,5,12,7,11,52,60,-8,43
Coleraine,5574,6,11,9,10,41,37,4,42
Ards,5574,7,11,4,15,41,55,-14,37
Dungannon,5574,8,9,8,13,54,49,5,35
Portadown,5574,9,8,5,17,33,52,-19,29
Ballinamalla,5574,10,8,3,19,36,64,-28,27
Glentoran,5574,11,6,7,17,24,49,-25,25
Crusaders,5575,1,19,6,5,61,25,36,63
Linfield,5575,2,18,8,4,64,24,40,62
Cliftonville,5575,3,15,4,11,55,41,14,49
Ballymena,5575,4,14,4,12,52,54,-2,46
Coleraine,5575,5,12,9,9,48,46,2,45
Glenavon,5575,6,9,13,8,45,46,-1,40
Dungannon,5575,7,9,9,12,44,52,-8,36
Ards,5575,8,10,3,17,38,43,-5,33
Ballinamalla,5575,9,9,3,18,29,55,-26,30
Portadown,5575,10,8,4,18,24,46,-22,28
Glentoran,5575,11,7,7,16,22,50,-28,28
Linfield,5576,1,14,11,5,53,28,25,53
Cliftonville,5576,2,16,5,9,52,40,12,53
Crusaders,5576,3,14,8,8,53,37,16,50
Coleraine,5576,4,11,12,7,45,39,6,45
Ballymena,5576,5,13,6,11,62,63,-1,45
Glenavon,5576,6,9,14,7,40,42,-2,41
Glentoran,5576,7,11,5,14,39,47,-8,38
Dungannon,5576,8,9,10,11,47,43,4,37
Ards,5576,9,11,4,15,41,48,-7,37
Ballinamalla,5576,10,8,4,18,27,52,-25,28
Portadown,5576,11,8,3,19,31,51,-20,27
Crusaders,5577,1,17,5,8,54,33,21,56
Linfield,5577,2,15,9,6,63,32,31,54
Ballymena,5577,3,15,6,9,57,55,2,51
Dungannon,5577,4,13,9,8,53,39,14,48
Glenavon,5577,5,12,10,8,52,45,7,46
Coleraine,5577,6,10,11,9,41,42,-1,41
Cliftonville,5577,7,11,4,15,38,45,-7,37
Glentoran,5577,8,10,7,13,31,44,-13,37
Ards,5577,9,8,6,16,37,50,-13,30
Ballinamalla,5577,10,8,5,17,31,51,-20,29
Portadown,5577,11,8,4,18,28,49,-21,28
Linfield,5578,1,15,7,8,63,29,34,52
Cliftonville,5578,2,15,5,10,58,42,16,50
Crusaders,5578,3,13,7,10,52,36,16,46
Dungannon,5578,4,13,7,10,52,39,13,46
Coleraine,5578,5,12,10,8,42,36,6,46
Glenavon,5578,6,12,10,8,47,45,2,46
Ballymena,5578,7,13,7,10,56,60,-4,46
Glentoran,5578,8,11,7,12,40,54,-14,40
Ards,5578,9,10,6,14,44,56,-12,36
Ballinamalla,5578,10,8,4,18,30,57,-27,28
Portadown,5578,11,5,6,19,23,53,-30,21
Crusaders,5579,1,16,8,6,52,35,17,56
Cliftonville,5579,2,16,6,8,60,39,21,54
Linfield,5579,3,14,9,7,64,35,29,51
Glenavon,5579,4,13,9,8,52,45,7,48
Ballymena,5579,5,12,7,11,60,64,-4,43
Coleraine,5579,6,9,12,9,40,42,-2,39
Dungannon,5579,7,9,9,12,43,44,-1,36
Ballinamalla,5579,8,10,4,16,32,47,-15,34
Glentoran,5579,9,8,10,12,28,43,-15,34
Portadown,5579,10,8,7,15,30,47,-17,31
Ards,5579,11,6,7,17,32,52,-20,25
Crusaders,5580,1,16,9,5,52,32,20,57
Cliftonville,5580,2,17,3,10,56,35,21,54
Ballymena,5580,3,16,6,8,55,50,5,54
Linfield,5580,4,13,11,6,57,29,28,50
Glenavon,5580,5,13,9,8,56,43,13,48
Coleraine,5580,6,12,10,8,45,44,1,46
Dungannon,5580,7,8,9,13,46,48,-2,33
Portadown,5580,8,8,6,16,29,48,-19,30
Ards,5580,9,7,8,15,41,58,-17,29
Glentoran,5580,10,5,12,13,20,41,-21,27
Ballinamalla,5580,11,5,7,18,22,51,-29,22
Crusaders,5581,1,17,8,5,64,33,31,59
Linfield,5581,2,15,10,5,60,32,28,55
Coleraine,5581,3,14,9,7,42,34,8,51
Cliftonville,5581,4,15,4,11,52,43,9,49
Glenavon,5581,5,13,9,8,53,49,4,48
Ballymena,5581,6,13,4,13,57,64,-7,43
Dungannon,5581,7,12,6,12,54,46,8,42
Ards,5581,8,10,3,17,40,54,-14,33
Glentoran,5581,9,7,9,14,34,48,-14,30
Ballinamalla,5581,10,8,5,17,33,55,-22,29
Portadown,5581,11,6,3,21,18,49,-31,21
Linfield,5582,1,17,8,5,62,31,31,59
Crusaders,5582,2,17,5,8,59,34,25,56
Coleraine,5582,3,12,11,7,44,34,10,47
Cliftonville,5582,4,14,5,11,48,41,7,47
Glenavon,5582,5,12,9,9,47,41,6,45
Ballymena,5582,6,13,6,11,59,57,2,45
Dungannon,5582,7,10,8,12,51,44,7,38
Ballinamalla,5582,8,10,2,18,32,51,-19,32
Portadown,5582,9,9,4,17,29,52,-23,31
Ards,5582,10,9,4,17,31,55,-24,31
Glentoran,5582,11,6,10,14,23,45,-22,28
Linfield,5583,1,16,10,4,62,30,32,58
Crusaders,5583,2,17,7,6,60,35,25,58
Cliftonville,5583,3,16,5,9,55,40,15,53
Ballymena,5583,4,16,5,9,56,54,2,53
Dungannon,5583,5,11,10,9,48,39,9,43
Coleraine,5583,6,10,11,9,42,37,5,41
Glenavon,5583,7,9,11,10,43,45,-2,38
Ards,5583,8,8,6,16,37,49,-12,30
Portadown,5583,9,8,4,18,25,47,-22,28
Glentoran,5583,10,5,11,14,26,48,-22,26
Ballinamalla,5583,11,6,6,18,21,51,-30,24
Crusaders,5584,1,19,6,5,59,29,30,63
Linfield,5584,2,16,9,5,58,32,26,57
Ballymena,5584,3,17,5,8,72,60,12,56
Coleraine,5584,4,13,9,8,49,40,9,48
Glenavon,5584,5,11,9,10,49,46,3,42
Cliftonville,5584,6,12,6,12,48,45,3,42
Glentoran,5584,7,9,9,12,27,39,-12,36
Dungannon,5584,8,8,9,13,44,47,-3,33
Ards,5584,9,9,3,18,38,52,-14,30
Ballinamalla,5584,10,7,5,18,25,53,-28,26
Portadown,5584,11,7,4,19,22,48,-26,25
Crusaders,5585,1,15,8,7,56,38,18,53
Dungannon,5585,2,15,7,8,59,40,19,52
Cliftonville,5585,3,15,5,10,54,41,13,50
Coleraine,5585,4,13,10,7,43,36,7,49
Linfield,5585,5,13,9,8,58,33,25,48
Ballymena,5585,6,13,7,10,57,58,-1,46
Glenavon,5585,7,11,8,11,51,55,-4,41
Ards,5585,8,9,6,15,37,47,-10,33
Glentoran,5585,9,8,9,13,28,45,-17,33
Portadown,5585,10,7,6,17,24,46,-22,27
Ballinamalla,5585,11,6,5,19,28,56,-28,23
Crusaders,5586,1,16,7,7,50,40,10,55
Ballymena,5586,2,16,4,10,62,58,4,52
Linfield,5586,3,13,11,6,56,30,26,50
Cliftonville,5586,4,13,6,11,45,37,8,45
Coleraine,5586,4,12,9,9,45,37,8,45
Dungannon,5586,6,11,11,8,56,41,15,44
Glenavon,5586,7,10,12,8,46,46,0,42
Ards,5586,8,10,5,15,37,49,-12,35
Ballinamalla,5586,9,9,5,16,38,56,-18,32
Glentoran,5586,10,7,7,16,36,55,-19,28
Portadown,5586,11,7,5,18,21,43,-22,26
Crusaders,5587,1,16,9,5,55,36,19,57
Ballymena,5587,2,16,5,9,68,58,10,53
Linfield,5587,3,15,7,8,54,29,25,52
Cliftonville,5587,4,13,7,10,48,41,7,46
Dungannon,5587,5,12,8,10,60,49,11,44
Coleraine,5587,6,10,8,12,41,44,-3,38
Glentoran,5587,7,10,8,12,31,39,-8,38
Portadown,5587,8,10,5,15,29,45,-16,35
Ards,5587,9,9,5,16,43,62,-19,32
Glenavon,5587,10,6,12,12,41,52,-11,30
Ballinamalla,5587,11,8,6,16,37,52,-15,30
Crusaders,5588,1,17,11,2,58,29,29,62
Linfield,5588,2,16,10,4,60,28,32,58
Cliftonville,5588,3,15,3,12,56,45,11,48
Ballymena,5588,4,12,7,11,59,63,-4,43
Coleraine,5588,5,11,9,10,42,44,-2,42
Dungannon,5588,6,10,10,10,53,44,9,40
Glenavon,5588,7,9,11,10,43,44,-1,38
Ards,5588,8,10,5,15,39,48,-9,35
Ballinamalla,5588,9,9,4,17,33,54,-21,31
Glentoran,5588,10,7,9,14,30,48,-18,30
Portadown,5588,11,6,7,17,23,49,-26,25
Crusaders,5589,1,16,7,7,50,32,18,55
Ballymena,5589,2,15,6,9,55,51,4,51
Cliftonville,5589,3,15,4,11,44,33,11,49
Linfield,5589,4,12,9,9,53,37,16,45
Dungannon,5589,5,10,12,8,50,39,11,42
Glenavon,5589,6,11,9,10,43,39,4,42
Coleraine,5589,7,10,11,9,38,34,4,41
Glentoran,5589,8,10,6,14,26,42,-16,36
Ards,5589,9,10,5,15,40,50,-10,35
Ballinamalla,5589,10,9,3,18,37,59,-22,30
Portadown,5589,11,7,8,15,20,40,-20,29
Linfield,5590,1,19,8,3,69,24,45,65
Coleraine,5590,2,14,10,6,49,33,16,52
Ballymena,5590,3,15,6,9,61,61,0,51
Cliftonville,5590,4,15,5,10,58,46,12,50
Crusaders,5590,5,14,7,9,48,40,8,49
Glenavon,5590,6,9,14,7,43,43,0,41
Dungannon,5590,7,7,11,12,44,44,0,32
Glentoran,5590,8,8,8,14,30,46,-16,32
Ballinamalla,5590,9,8,6,16,25,46,-21,30
Ards,5590,10,5,8,17,30,49,-19,23
Portadown,5590,11,4,11,15,20,45,-25,23
Linfield,5591,1,17,10,3,65,25,40,61
Crusaders,5591,2,16,11,3,64,33,31,59
Cliftonville,5591,3,15,7,8,48,36,12,52
Coleraine,5591,4,10,13,7,39,32,7,43
Ballymena,5591,5,12,5,13,51,61,-10,41
Glenavon,5591,6,9,13,8,44,47,-3,40
Glentoran,5591,7,10,8,12,34,41,-7,38
Ards,5591,8,11,3,16,39,49,-10,36
Portadown,5591,9,7,9,14,27,42,-15,30
Dungannon,5591,10,4,14,12,40,51,-11,26
Ballinamalla,5591,11,5,5,20,26,60,-34,20
Crusaders,5592,1,17,9,4,58,31,27,60
Linfield,5592,2,16,7,7,57,33,24,55
Cliftonville,5592,3,14,8,8,52,36,16,50
Ballymena,5592,4,14,5,11,60,59,1,47
Coleraine,5592,5,12,9,9,44,38,6,45
Glenavon,5592,6,10,10,10,47,51,-4,40
Glentoran,5592,7,10,6,14,29,43,-14,36
Dungannon,5592,8,8,10,12,45,44,1,34
Ards,5592,9,8,8,14,44,55,-11,32
Portadown,5592,10,8,6,16,22,44,-22,30
Ballinamalla,5592,11,7,4,19,30,54,-24,25
Linfield,5593,1,17,8,5,60,25,35,59
Crusaders,5593,2,16,6,8,55,32,23,54
Cliftonville,5593,3,15,6,9,53,45,8,51
Ballymena,5593,4,13,8,9,53,52,1,47
Glenavon,5593,5,11,10,9,49,56,-7,43
Coleraine,5593,6,10,11,9,41,40,1,41
Glentoran,5593,7,11,7,12,32,36,-4,40
Ballinamalla,5593,8,10,3,17,38,52,-14,33
Ards,5593,9,8,6,16,36,49,-13,30
Dungannon,5593,10,6,11,13,38,47,-9,29
Portadown,5593,11,7,6,17,28,49,-21,27
Glenavon,5594,1,14,12,4,58,44,14,54
Crusaders,5594,2,15,7,8,48,30,18,52
Linfield,5594,3,13,12,5,54,29,25,51
Cliftonville,5594,4,16,3,11,52,41,11,51
Coleraine,5594,5,12,11,7,47,36,11,47
Ballymena,5594,6,14,3,13,55,58,-3,45
Ballinamalla,5594,7,9,6,15,35,52,-17,33
Dungannon,5594,8,8,8,14,46,50,-4,32
Portadown,5594,9,9,4,17,21,41,-20,31
Glentoran,5594,10,7,9,14,26,44,-18,30
Ards,5594,11,8,5,17,33,50,-17,29
Cliftonville,5595,1,17,6,7,60,37,23,57
Linfield,5595,2,15,8,7,55,33,22,53
Crusaders,5595,3,15,7,8,53,39,14,52
Glenavon,5595,4,13,8,9,60,48,12,47
Dungannon,5595,5,12,8,10,47,43,4,44
Ballymena,5595,6,11,7,12,54,61,-7,40
Coleraine,5595,7,8,13,9,40,45,-5,37
Ards,5595,8,10,5,15,40,42,-2,35
Glentoran,5595,9,8,8,14,27,45,-18,32
Ballinamalla,5595,10,9,3,18,28,53,-25,30
Portadown,5595,11,8,5,17,24,42,-18,29
Crusaders,5596,1,17,9,4,63,33,30,60
Linfield,5596,2,17,8,5,64,27,37,59
Cliftonville,5596,3,15,3,12,52,46,6,48
Coleraine,5596,4,12,10,8,39,33,6,46
Ballymena,5596,5,13,5,12,56,58,-2,44
Glentoran,5596,6,12,7,11,30,38,-8,43
Glenavon,5596,7,10,10,10,39,45,-6,40
Dungannon,5596,8,10,9,11,50,46,4,39
Ards,5596,9,9,6,15,35,47,-12,33
Ballinamalla,5596,10,6,7,17,31,54,-23,25
Portadown,5596,11,5,4,21,17,49,-32,19
Cliftonville,5597,1,15,8,7,61,37,24,53
Ballymena,5597,2,16,5,9,59,55,4,53
Crusaders,5597,3,15,5,10,52,42,10,50
Glenavon,5597,4,13,10,7,49,45,4,49
Linfield,5597,5,12,10,8,49,35,14,46
Coleraine,5597,6,10,11,9,41,37,4,41
Glentoran,5597,7,11,6,13,33,38,-5,39
Dungannon,5597,8,10,8,12,51,47,4,38
Ards,5597,9,9,7,14,38,47,-9,34
Ballinamalla,5597,10,8,4,18,32,57,-25,28
Portadown,5597,11,6,6,18,21,46,-25,24
Crusaders,5598,1,18,7,5,53,31,22,61
Cliftonville,5598,2,18,5,7,61,41,20,59
Ballymena,5598,3,14,6,10,60,59,1,48
Linfield,5598,4,13,8,9,62,43,19,47
Glenavon,5598,5,12,10,8,48,40,8,46
Dungannon,5598,6,11,7,12,53,40,13,40
Coleraine,5598,7,9,12,9,39,40,-1,39
Glentoran,5598,8,10,7,13,34,43,-9,37
Ards,5598,9,9,4,17,36,51,-15,31
Ballinamalla,5598,10,7,5,18,30,57,-27,26
Portadown,5598,11,6,5,19,22,53,-31,23
Crusaders,5599,1,18,6,6,57,32,25,60
Linfield,5599,2,17,6,7,64,31,33,57
Ballymena,5599,3,17,5,8,68,55,13,56
Glenavon,5599,4,13,8,9,50,41,9,47
Cliftonville,5599,5,13,5,12,43,41,2,44
Coleraine,5599,6,11,9,10,35,36,-1,42
Dungannon,5599,7,11,8,11,49,47,2,41
Ards,5599,8,11,5,14,39,49,-10,38
Glentoran,5599,9,9,6,15,27,40,-13,33
Portadown,5599,10,6,4,20,21,50,-29,22
Ballinamalla,5599,11,6,4,20,29,60,-31,22
Crusaders,5600,1,16,10,4,56,32,24,58
Linfield,5600,2,14,9,7,54,27,27,51
Cliftonville,5600,3,14,7,9,50,41,9,49
Ballymena,5600,4,13,8,9,55,56,-1,47
Coleraine,5600,5,12,10,8,45,35,10,46
Glenavon,5600,6,12,10,8,49,46,3,46
Dungannon,5600,7,12,8,10,49,39,10,44
Ards,5600,8,10,4,16,37,46,-9,34
Portadown,5600,9,6,10,14,29,47,-18,28
Glentoran,5600,10,6,9,15,25,47,-22,27
Ballinamalla,5600,11,6,3,21,30,63,-33,21
Crusaders,5601,1,17,6,7,60,35,25,57
Linfield,5601,2,15,6,9,60,40,20,51
Glenavon,5601,3,13,12,5,49,39,10,51
Ballymena,5601,4,15,6,9,63,55,8,51
Dungannon,5601,5,10,12,8,57,41,16,42
Cliftonville,5601,6,11,8,11,48,42,6,41
Glentoran,5601,7,11,6,13,30,43,-13,39
Ards,5601,8,9,6,15,39,53,-14,33
Ballinamalla,5601,9,9,6,15,33,51,-18,33
Coleraine,5601,10,7,11,12,36,51,-15,32
Portadown,5601,11,6,5,19,24,49,-25,23
Cliftonville,5602,1,17,4,9,58,43,15,55
Crusaders,5602,2,14,12,4,51,30,21,54
Linfield,5602,3,13,12,5,59,32,27,51
Glenavon,5602,4,12,14,4,52,42,10,50
Coleraine,5602,5,11,12,7,45,33,12,45
Ballymena,5602,6,10,9,11,51,59,-8,39
Glentoran,5602,7,9,8,13,33,42,-9,35
Ards,5602,8,9,5,16,36,53,-17,32
Dungannon,5602,9,7,10,13,47,52,-5,31
Portadown,5602,10,8,4,18,30,58,-28,28
Ballinamalla,5602,11,7,6,17,37,55,-18,27
Crusaders,5603,1,19,6,5,62,30,32,63
Cliftonville,5603,2,20,3,7,59,32,27,63
Linfield,5603,3,13,9,8,55,34,21,48
Coleraine,5603,4,12,10,8,43,37,6,46
Ballymena,5603,5,13,5,12,56,57,-1,44
Dungannon,5603,6,8,13,9,47,44,3,37
Glentoran,5603,7,9,10,11,30,38,-8,37
Glenavon,5603,8,7,12,11,38,55,-17,33
Ballinamalla,5603,9,7,7,16,27,50,-23,28
Ards,5603,10,6,8,16,35,54,-19,26
Portadown,5603,11,7,5,18,31,52,-21,26
Crusaders,5604,1,16,7,7,61,39,22,55
Ballymena,5604,2,13,10,7,58,52,6,49
Linfield,5604,3,13,9,8,60,38,22,48
Cliftonville,5604,4,14,4,12,52,50,2,46
Dungannon,5604,5,13,6,11,58,42,16,45
Glentoran,5604,6,12,7,11,39,37,2,43
Glenavon,5604,7,9,12,9,47,46,1,39
Coleraine,5604,8,9,11,10,39,47,-8,38
Ballinamalla,5604,9,11,3,16,33,54,-21,36
Ards,5604,10,6,9,15,37,54,-17,27
Portadown,5604,11,7,6,17,27,52,-25,27
Crusaders,5605,1,19,6,5,65,35,30,63
Cliftonville,5605,2,16,3,11,58,43,15,51
Ballymena,5605,3,14,8,8,57,56,1,50
Coleraine,5605,4,12,13,5,47,36,11,49
Linfield,5605,5,13,9,8,61,36,25,48
Glenavon,5605,6,10,11,9,52,56,-4,41
Ards,5605,7,11,5,14,45,52,-7,38
Dungannon,5605,8,9,10,11,54,50,4,37
Glentoran,5605,9,6,9,15,33,59,-26,27
Ballinamalla,5605,10,6,7,17,30,55,-25,25
Portadown,5605,11,6,5,19,31,55,-24,23
Linfield,5606,1,16,8,6,60,37,23,56
Crusaders,5606,2,16,6,8,59,38,21,54
Dungannon,5606,3,13,8,9,54,39,15,47
Ballymena,5606,4,14,4,12,66,66,0,46
Cliftonville,5606,5,13,6,11,51,47,4,45
Coleraine,5606,6,12,9,9,41,37,4,45
Glenavon,5606,7,11,9,10,45,45,0,42
Glentoran,5606,8,11,7,12,34,40,-6,40
Portadown,5606,9,8,6,16,28,47,-19,30
Ards,5606,10,8,3,19,31,50,-19,27
Ballinamalla,5606,11,7,6,17,29,52,-23,27
Crusaders,5607,1,17,6,7,51,34,17,57
Cliftonville,5607,2,16,4,10,57,43,14,52
Linfield,5607,3,14,9,7,54,35,19,51
Coleraine,5607,4,13,11,6,47,33,14,50
Ballymena,5607,5,13,5,12,55,62,-7,44
Dungannon,5607,6,11,9,10,50,41,9,42
Glenavon,5607,7,11,9,10,43,46,-3,42
Glentoran,5607,8,8,11,11,34,40,-6,35
Ards,5607,9,9,5,16,40,52,-12,32
Ballinamalla,5607,10,7,6,17,30,48,-18,27
Portadown,5607,11,7,3,20,28,55,-27,24
Crusaders,5608,1,16,7,7,58,40,18,55
Cliftonville,5608,2,16,5,9,54,40,14,53
Linfield,5608,3,13,10,7,57,37,20,49
Coleraine,5608,4,13,9,8,46,35,11,48
Ballymena,5608,5,13,8,9,54,55,-1,47
Dungannon,5608,6,10,10,10,56,42,14,40
Glenavon,5608,7,7,14,9,44,49,-5,35
Portadown,5608,8,9,7,14,33,48,-15,34
Ards,5608,9,9,5,16,39,50,-11,32
Ballinamalla,5608,10,8,7,15,33,51,-18,31
Glentoran,5608,11,7,6,17,32,59,-27,27
Crusaders,5609,1,19,6,5,62,33,29,63
Ballymena,5609,2,18,3,9,63,56,7,57
Coleraine,5609,3,13,10,7,52,37,15,49
Cliftonville,5609,4,15,4,11,56,49,7,49
Linfield,5609,5,11,9,10,54,37,17,42
Glenavon,5609,6,11,7,12,49,57,-8,40
Portadown,5609,7,12,2,16,35,44,-9,38
Dungannon,5609,8,9,9,12,45,45,0,36
Ards,5609,9,9,6,15,38,53,-15,33
Glentoran,5609,10,8,7,15,30,48,-18,31
Ballinamalla,5609,11,6,5,19,26,51,-25,23
Crusaders,5610,1,18,9,3,59,29,30,63
Cliftonville,5610,2,18,5,7,62,39,23,59
Linfield,5610,3,17,7,6,67,37,30,58
Coleraine,5610,4,15,7,8,48,39,9,52
Ballymena,5610,5,13,4,13,55,60,-5,43
Glenavon,5610,6,10,10,10,48,48,0,40
Dungannon,5610,7,8,6,16,43,51,-8,30
Glentoran,5610,8,7,8,15,31,46,-15,29
Ards,5610,9,8,5,17,34,55,-21,29
Ballinamalla,5610,10,8,5,17,28,52,-24,29
Portadown,5610,11,8,4,18,30,49,-19,28
Crusaders,5611,1,17,9,4,54,24,30,60
Cliftonville,5611,2,17,5,8,52,33,19,56
Ballymena,5611,3,15,4,11,57,56,1,49
Linfield,5611,4,13,9,8,56,34,22,48
Dungannon,5611,5,13,8,9,50,39,11,47
Glenavon,5611,6,12,10,8,49,44,5,46
Coleraine,5611,7,9,11,10,35,33,2,38
Glentoran,5611,8,10,7,13,34,46,-12,37
Ards,5611,9,9,7,14,38,46,-8,34
Portadown,5611,10,5,6,19,20,55,-35,21
Ballinamalla,5611,11,5,4,21,22,57,-35,19
Crusaders,5612,1,19,6,5,60,33,27,63
Glenavon,5612,2,12,13,5,49,40,9,49
Cliftonville,5612,3,14,6,10,50,38,12,48
Linfield,5612,4,12,9,9,57,32,25,45
Ballymena,5612,5,13,6,11,51,60,-9,45
Coleraine,5612,6,11,11,8,45,42,3,44
Dungannon,5612,7,10,10,10,50,43,7,40
Glentoran,5612,8,8,7,15,23,40,-17,31
Ards,5612,9,9,4,17,36,54,-18,31
Portadown,5612,10,8,5,17,29,47,-18,29
Ballinamalla,5612,11,8,5,17,32,53,-21,29
Crusaders,5613,1,17,7,6,55,26,29,58
Linfield,5613,2,15,10,5,60,31,29,55
Ballymena,5613,3,16,5,9,51,54,-3,53
Glenavon,5613,4,14,10,6,55,41,14,52
Cliftonville,5613,5,15,5,10,52,40,12,50
Coleraine,5613,6,9,10,11,41,42,-1,37
Ards,5613,7,10,6,14,49,55,-6,36
Glentoran,5613,8,9,6,15,29,47,-18,33
Portadown,5613,9,9,3,18,24,46,-22,30
Ballinamalla,5613,10,8,4,18,32,55,-23,28
Dungannon,5613,11,6,8,16,45,56,-11,26
Linfield,5614,1,17,9,4,62,26,36,60
Crusaders,5614,2,17,6,7,58,36,22,57
Glenavon,5614,3,13,11,6,48,36,12,50
Cliftonville,5614,4,13,7,10,51,47,4,46
Coleraine,5614,5,11,10,9,48,43,5,43
Ards,5614,6,13,4,13,44,44,0,43
Ballymena,5614,7,11,6,13,55,66,-11,39
Dungannon,5614,8,9,9,12,47,51,-4,36
Portadown,5614,9,8,6,16,25,45,-20,30
Glentoran,5614,10,7,7,16,24,50,-26,28
Ballinamalla,5614,11,7,3,20,32,50,-18,24
Linfield,5615,1,15,10,5,63,29,34,55
Crusaders,5615,2,16,6,8,57,39,18,54
Cliftonville,5615,3,14,7,9,53,44,9,49
Coleraine,5615,4,12,12,6,45,37,8,48
Glenavon,5615,5,12,10,8,47,41,6,46
Ballymena,5615,6,13,5,12,61,61,0,44
Dungannon,5615,7,11,7,12,51,43,8,40
Glentoran,5615,8,11,7,12,41,48,-7,40
Ballinamalla,5615,9,9,4,17,27,53,-26,31
Portadown,5615,10,6,7,17,21,50,-29,25
Ards,5615,11,6,5,19,31,52,-21,23
Crusaders,5616,1,18,8,4,55,27,28,62
Cliftonville,5616,2,15,5,10,50,43,7,50
Linfield,5616,3,12,10,8,66,38,28,46
Coleraine,5616,4,11,13,6,44,34,10,46
Glenavon,5616,5,11,11,8,47,44,3,44
Dungannon,5616,6,10,11,9,48,41,7,41
Ballymena,5616,7,9,7,14,46,61,-15,34
Ards,5616,8,8,9,13,35,46,-11,33
Ballinamalla,5616,9,9,6,15,30,47,-17,33
Glentoran,5616,10,7,8,15,31,50,-19,29
Portadown,5616,11,7,8,15,26,47,-21,29
Linfield,5617,1,16,8,6,64,29,35,56
Coleraine,5617,2,15,8,7,48,31,17,53
Crusaders,5617,3,15,7,8,60,44,16,52
Glenavon,5617,4,13,10,7,51,44,7,49
Dungannon,5617,5,11,11,8,51,41,10,44
Ballymena,5617,6,12,7,11,53,62,-9,43
Cliftonville,5617,7,13,3,14,52,49,3,42
Ards,5617,8,11,6,13,41,49,-8,39
Ballinamalla,5617,9,10,1,19,34,51,-17,31
Glentoran,5617,10,7,7,16,28,47,-19,28
Portadown,5617,11,5,6,19,17,52,-35,21
Linfield,5618,1,16,7,7,58,28,30,55
Crusaders,5618,2,14,12,4,53,31,22,54
Cliftonville,5618,3,15,8,7,58,37,21,53
Glenavon,5618,4,12,11,7,54,48,6,47
Dungannon,5618,5,13,7,10,49,42,7,46
Ballymena,5618,6,13,6,11,51,53,-2,45
Coleraine,5618,7,8,16,6,38,35,3,40
Glentoran,5618,8,10,7,13,32,42,-10,37
Ards,5618,9,8,5,17,31,55,-24,29
Ballinamalla,5618,10,8,4,18,32,54,-22,28
Portadown,5618,11,5,3,22,25,56,-31,18
Linfield,5619,1,14,11,5,60,32,28,53
Crusaders,5619,2,15,7,8,57,42,15,52
Cliftonville,5619,3,15,4,11,54,38,16,49
Coleraine,5619,4,13,8,9,39,36,3,47
Glenavon,5619,5,12,10,8,48,43,5,46
Ballymena,5619,6,13,6,11,55,57,-2,45
Dungannon,5619,7,10,9,11,52,49,3,39
Ballinamalla,5619,8,12,3,15,37,45,-8,39
Glentoran,5619,9,10,7,13,35,43,-8,37
Ards,5619,10,7,5,18,29,49,-20,26
Portadown,5619,11,6,6,18,20,52,-32,24
Crusaders,5620,1,18,6,6,54,34,20,60
Linfield,5620,2,16,7,7,54,32,22,55
Cliftonville,5620,3,16,4,10,57,40,17,52
Coleraine,5620,4,13,8,9,45,43,2,47
Ballymena,5620,5,14,4,12,57,54,3,46
Glentoran,5620,6,12,6,12,36,42,-6,42
Glenavon,5620,7,9,13,8,47,47,0,40
Dungannon,5620,8,9,10,11,51,42,9,37
Ards,5620,9,8,6,16,35,50,-15,30
Ballinamalla,5620,10,8,6,16,30,54,-24,30
Portadown,5620,11,5,4,21,21,49,-28,19
Crusaders,5621,1,15,11,4,58,34,24,56
Coleraine,5621,2,16,8,6,47,35,12,56
Cliftonville,5621,3,16,6,8,62,42,20,54
Ballymena,5621,4,16,4,10,64,55,9,52
Linfield,5621,5,12,10,8,56,35,21,46
Glentoran,5621,6,10,7,13,32,41,-9,37
Dungannon,5621,7,9,9,12,45,45,0,36
Glenavon,5621,8,8,11,11,40,45,-5,35
Portadown,5621,9,10,3,17,27,44,-17,33
Ballinamalla,5621,10,8,3,19,27,57,-30,27
Ards,5621,11,8,2,20,27,52,-25,26
Crusaders,5622,1,16,7,7,57,36,21,55
Cliftonville,5622,2,16,6,8,54,40,14,54
Ballymena,5622,3,16,5,9,71,56,15,53
Coleraine,5622,4,15,8,7,45,33,12,53
Linfield,5622,5,11,9,10,54,40,14,42
Glenavon,5622,6,11,8,11,44,48,-4,41
Portadown,5622,7,10,7,13,27,42,-15,37
Dungannon,5622,8,9,9,12,46,40,6,36
Ards,5622,9,11,3,16,49,53,-4,36
Glentoran,5622,10,8,6,16,27,52,-25,30
Ballinamalla,5622,11,6,4,20,23,57,-34,22
Linfield,5623,1,14,12,4,58,29,29,54
Crusaders,5623,2,14,10,6,45,29,16,52
Cliftonville,5623,3,15,6,9,50,33,17,51
Ballymena,5623,4,15,6,9,63,52,11,51
Glenavon,5623,5,11,13,6,45,41,4,46
Coleraine,5623,6,10,11,9,39,37,2,41
Dungannon,5623,7,10,9,11,43,40,3,39
Glentoran,5623,8,8,8,14,31,48,-17,32
Ballinamalla,5623,9,10,2,18,28,49,-21,32
Ards,5623,10,8,5,17,38,50,-12,29
Portadown,5623,11,6,6,18,20,52,-32,24
Crusaders,5624,1,18,6,6,55,31,24,60
Linfield,5624,2,15,10,5,53,25,28,55
Cliftonville,5624,3,15,6,9,56,39,17,51
Ballymena,5624,4,15,4,11,53,56,-3,49
Glenavon,5624,5,9,14,7,42,42,0,41
Coleraine,5624,6,9,10,11,39,40,-1,37
Portadown,5624,7,10,6,14,32,43,-11,36
Glentoran,5624,8,9,8,13,31,41,-10,35
Ards,5624,9,10,5,15,42,54,-12,35
Dungannon,5624,10,7,11,12,48,48,0,32
Ballinamalla,5624,11,6,4,20,30,62,-32,22
Crusaders,5625,1,18,7,5,59,31,28,61
Linfield,5625,2,16,9,5,62,31,31,57
Ballymena,5625,3,15,6,9,61,53,8,51
Coleraine,5625,4,11,12,7,39,37,2,45
Cliftonville,5625,5,13,5,12,54,49,5,44
Ards,5625,6,11,7,12,42,42,0,40
Glenavon,5625,7,10,9,11,36,41,-5,39
Glentoran,5625,8,10,7,13,32,43,-11,37
Dungannon,5625,9,7,11,12,44,46,-2,32
Portadown,5625,10,7,6,17,25,50,-25,27
Ballinamalla,5625,11,5,5,20,25,56,-31,20
Crusaders,5626,1,17,8,5,63,40,23,59
Ballymena,5626,2,16,5,9,59,53,6,53
Cliftonville,5626,3,15,7,8,57,41,16,52
Linfield,5626,4,14,9,7,61,35,26,51
Coleraine,5626,5,11,11,8,47,37,10,44
Glentoran,5626,6,12,6,12,35,40,-5,42
Glenavon,5626,7,10,9,11,38,43,-5,39
Dungannon,5626,8,9,9,12,50,48,2,36
Ards,5626,9,9,6,15,38,58,-20,33
Portadown,5626,10,8,6,16,31,49,-18,30
Ballinamalla,5626,11,4,4,22,22,57,-35,16
Crusaders,5627,1,17,8,5,54,33,21,59
Linfield,5627,2,16,7,7,66,42,24,55
Cliftonville,5627,3,17,2,11,55,37,18,53
Ballymena,5627,4,15,3,12,58,61,-3,48
Coleraine,5627,5,12,10,8,42,34,8,46
Glenavon,5627,6,11,11,8,54,48,6,44
Dungannon,5627,7,11,7,12,53,39,14,40
Glentoran,5627,8,9,8,13,33,44,-11,35
Portadown,5627,9,8,5,17,29,53,-24,29
Ballinamalla,5627,10,8,3,19,30,62,-32,27
Ards,5627,11,7,4,19,38,59,-21,25
Linfield,5628,1,15,10,5,62,31,31,55
Cliftonville,5628,2,15,4,11,60,43,17,49
Coleraine,5628,3,13,9,8,42,40,2,48
Crusaders,5628,4,14,5,11,53,41,12,47
Ballymena,5628,5,13,8,9,53,56,-3,47
Dungannon,5628,6,12,6,12,50,43,7,42
Ballinamalla,5628,7,12,4,14,43,52,-9,40
Glenavon,5628,8,9,12,9,47,50,-3,39
Glentoran,5628,9,9,8,13,37,51,-14,35
Ards,5628,10,9,4,17,41,57,-16,31
Portadown,5628,11,6,6,18,26,50,-24,24
Cliftonville,5629,1,17,6,7,61,43,18,57
Crusaders,5629,2,16,8,6,52,32,20,56
Ballymena,5629,3,15,8,7,60,51,9,53
Linfield,5629,4,13,10,7,58,32,26,49
Coleraine,5629,5,12,10,8,42,34,8,46
Glenavon,5629,6,9,13,8,45,41,4,40
Dungannon,5629,7,9,7,14,49,51,-2,34
Glentoran,5629,8,8,8,14,30,48,-18,32
Ards,5629,9,8,7,15,35,54,-19,31
Ballinamalla,5629,10,7,7,16,27,46,-19,28
Portadown,5629,11,5,8,17,21,48,-27,23
Crusaders,5630,1,17,6,7,60,37,23,57
Linfield,5630,2,14,10,6,64,33,31,52
Ballymena,5630,3,14,8,8,58,55,3,50
Coleraine,5630,4,13,9,8,45,38,7,48
Cliftonville,5630,5,12,5,13,40,39,1,41
Dungannon,5630,6,10,10,10,51,45,6,40
Glenavon,5630,7,8,13,9,40,41,-1,37
Ards,5630,8,9,9,12,36,45,-9,36
Ballinamalla,5630,9,8,8,14,31,45,-14,32
Glentoran,5630,10,6,10,14,29,51,-22,28
Portadown,5630,11,7,6,17,20,45,-25,27
Crusaders,5631,1,18,5,7,61,31,30,59
Cliftonville,5631,2,16,7,7,60,41,19,55
Linfield,5631,3,13,10,7,57,35,22,49
Ballymena,5631,4,15,3,12,52,58,-6,48
Dungannon,5631,5,13,8,9,51,39,12,47
Coleraine,5631,6,12,11,7,41,33,8,47
Glenavon,5631,7,9,11,10,45,49,-4,38
Glentoran,5631,8,8,7,15,28,45,-17,31
Ballinamalla,5631,9,9,4,17,31,51,-20,31
Ards,5631,10,8,5,17,32,50,-18,29
Portadown,5631,11,6,5,19,21,47,-26,23
Linfield,5632,1,16,8,6,63,28,35,56
Crusaders,5632,2,14,7,9,52,42,10,49
Ballymena,5632,3,13,9,8,54,51,3,48
Dungannon,5632,4,12,10,8,52,39,13,46
Coleraine,5632,5,12,10,8,46,40,6,46
Cliftonville,5632,6,13,3,14,48,45,3,42
Glenavon,5632,7,10,12,8,47,47,0,42
Glentoran,5632,8,10,6,14,26,38,-12,36
Ards,5632,9,9,7,14,40,49,-9,34
Portadown,5632,10,8,5,17,23,46,-23,29
Ballinamalla,5632,11,8,3,19,31,57,-26,27
Crusaders,5633,1,17,5,8,61,38,23,56
Linfield,5633,2,15,9,6,58,26,32,54
Cliftonville,5633,3,16,5,9,58,47,11,53
Ballymena,5633,4,15,7,8,65,60,5,52
Coleraine,5633,5,12,9,9,43,44,-1,45
Dungannon,5633,6,11,10,9,54,43,11,43
Glenavon,5633,7,11,9,10,48,46,2,42
Glentoran,5633,8,11,6,13,41,44,-3,39
Ards,5633,9,8,5,17,43,58,-15,29
Portadown,5633,10,7,6,17,23,47,-24,27
Ballinamalla,5633,11,6,1,23,29,70,-41,19
Crusaders,5634,1,17,9,4,61,32,29,60
Linfield,5634,2,15,8,7,55,30,25,53
Coleraine,5634,3,13,11,6,40,32,8,50
Glenavon,5634,4,11,11,8,45,44,1,44
Ballymena,5634,5,12,6,12,59,63,-4,42
Cliftonville,5634,6,12,5,13,48,48,0,41
Ards,5634,7,11,5,14,39,45,-6,38
Portadown,5634,8,11,4,15,21,35,-14,37
Dungannon,5634,9,9,8,13,46,44,2,35
Glentoran,5634,10,8,8,14,31,45,-14,32
Ballinamalla,5634,11,7,3,20,26,53,-27,24
Linfield,5635,1,16,8,6,67,34,33,56
Crusaders,5635,2,15,7,8,53,42,11,52
Ballymena,5635,3,15,6,9,56,51,5,51
Glenavon,5635,4,14,7,9,50,41,9,49
Cliftonville,5635,5,13,8,9,52,38,14,47
Dungannon,5635,6,11,8,11,48,44,4,41
Coleraine,5635,7,10,10,10,41,40,1,40
Ballinamalla,5635,8,11,2,17,30,48,-18,35
Glentoran,5635,9,8,6,16,27,46,-19,30
Portadown,5635,10,8,6,16,24,47,-23,30
Ards,5635,11,8,4,18,33,50,-17,28
Cliftonville,5636,1,17,5,8,59,33,26,56
Crusaders,5636,2,16,7,7,57,36,21,55
Coleraine,5636,3,13,10,7,46,39,7,49
Glenavon,5636,4,12,11,7,47,45,2,47
Ballymena,5636,5,13,8,9,57,56,1,47
Linfield,5636,6,11,13,6,60,36,24,46
Dungannon,5636,7,8,11,11,44,43,1,35
Ballinamalla,5636,8,9,5,16,30,49,-19,32
Ards,5636,9,8,5,17,38,52,-14,29
Glentoran,5636,10,6,11,13,27,50,-23,29
Portadown,5636,11,6,6,18,24,50,-26,24
Linfield,5637,1,15,11,4,57,25,32,56
Crusaders,5637,2,17,5,8,56,38,18,56
Cliftonville,5637,3,18,2,10,53,38,15,56
Coleraine,5637,4,12,9,9,42,39,3,45
Glenavon,5637,5,11,11,8,48,41,7,44
Dungannon,5637,6,11,8,11,54,45,9,41
Ballymena,5637,7,11,7,12,51,55,-4,40
Ards,5637,8,11,3,16,35,47,-12,36
Glentoran,5637,9,8,8,14,31,44,-13,32
Ballinamalla,5637,10,8,6,16,29,51,-22,30
Portadown,5637,11,6,4,20,21,54,-33,22
Cliftonville,5638,1,17,6,7,59,39,20,57
Ballymena,5638,2,16,5,9,56,51,5,53
Crusaders,5638,3,15,7,8,48,32,16,52
Linfield,5638,4,11,8,11,50,38,12,41
Glenavon,5638,5,10,10,10,43,44,-1,40
Glentoran,5638,6,11,7,12,30,38,-8,40
Ballinamalla,5638,7,10,7,13,33,46,-13,37
Dungannon,5638,8,8,12,10,47,46,1,36
Coleraine,5638,9,9,9,12,40,46,-6,36
Portadown,5638,10,10,2,18,28,42,-14,32
Ards,5638,11,8,7,15,37,49,-12,31
Linfield,5639,1,17,8,5,58,30,28,59
Ballymena,5639,2,16,6,8,62,57,5,54
Crusaders,5639,3,14,11,5,55,34,21,53
Cliftonville,5639,4,15,7,8,60,39,21,52
Coleraine,5639,5,10,9,11,36,42,-6,39
Glenavon,5639,6,9,11,10,47,44,3,38
Ballinamalla,5639,7,10,5,15,38,51,-13,35
Dungannon,5639,8,8,9,13,42,50,-8,33
Ards,5639,9,9,5,16,36,50,-14,32
Glentoran,5639,10,7,9,14,31,49,-18,30
Portadown,5639,11,8,4,18,26,45,-19,28
Linfield,5640,1,17,7,6,57,28,29,58
Crusaders,5640,2,15,6,9,50,36,14,51
Coleraine,5640,3,13,7,10,50,46,4,46
Glenavon,5640,4,12,9,9,51,50,1,45
Portadown,5640,5,14,3,13,33,43,-10,45
Cliftonville,5640,6,13,5,12,61,47,14,44
Ballymena,5640,7,11,7,12,56,64,-8,40
Dungannon,5640,8,8,10,12,42,42,0,34
Glentoran,5640,9,9,7,14,34,46,-12,34
Ballinamalla,5640,10,10,4,16,30,46,-16,34
Ards,5640,11,8,5,17,37,53,-16,29
Ballymena,5641,1,16,6,8,59,53,6,54
Coleraine,5641,2,13,10,7,48,33,15,49
Crusaders,5641,3,14,7,9,52,42,10,49
Cliftonville,5641,4,14,6,10,51,40,11,48
Glenavon,5641,5,12,9,9,46,50,-4,45
Linfield,5641,6,11,8,11,50,31,19,41
Glentoran,5641,7,10,9,11,36,40,-4,39
Dungannon,5641,8,10,7,13,59,51,8,37
Ards,5641,9,10,5,15,37,53,-16,35
Portadown,5641,10,9,6,15,29,48,-19,33
Ballinamalla,5641,11,7,5,18,27,53,-26,26
Crusaders,5642,1,17,8,5,60,26,34,59
Cliftonville,5642,2,17,5,8,53,32,21,56
Ballymena,5642,3,15,6,9,55,55,0,51
Linfield,5642,4,13,9,8,51,32,19,48
Coleraine,5642,5,12,10,8,39,36,3,46
Glenavon,5642,6,8,14,8,41,45,-4,38
Dungannon,5642,7,9,9,12,50,44,6,36
Glentoran,5642,8,9,9,12,32,44,-12,36
Ards,5642,9,9,5,16,28,43,-15,32
Portadown,5642,10,9,3,18,24,49,-25,30
Ballinamalla,5642,11,5,6,19,28,55,-27,21
Cliftonville,5643,1,17,7,6,57,33,24,58
Coleraine,5643,2,14,9,7,47,33,14,51
Linfield,5643,3,13,9,8,63,39,24,48
Glenavon,5643,4,13,9,8,49,46,3,48
Ards,5643,5,14,4,12,38,42,-4,46
Crusaders,5643,6,12,9,9,47,38,9,45
Ballymena,5643,7,13,6,11,60,64,-4,45
Dungannon,5643,8,9,8,13,41,44,-3,35
Glentoran,5643,9,6,9,15,27,46,-19,27
Portadown,5643,10,7,6,17,23,42,-19,27
Ballinamalla,5643,11,7,4,19,24,49,-25,25
Cliftonville,5644,1,18,4,8,55,34,21,58
Linfield,5644,2,16,7,7,66,36,30,55
Crusaders,5644,3,16,7,7,63,35,28,55
Ballymena,5644,4,13,8,9,57,62,-5,47
Coleraine,5644,5,11,10,9,44,43,1,43
Ballinamalla,5644,6,13,1,16,35,43,-8,40
Glenavon,5644,7,8,12,10,46,53,-7,36
Dungannon,5644,8,8,9,13,49,45,4,33
Ards,5644,9,8,8,14,36,49,-13,32
Portadown,5644,10,8,5,17,26,56,-30,29
Glentoran,5644,11,7,7,16,27,48,-21,28
Crusaders,5645,1,19,7,4,62,27,35,64
Ballymena,5645,2,16,7,7,63,49,14,55
Linfield,5645,3,12,10,8,55,32,23,46
Glenavon,5645,4,12,10,8,48,47,1,46
Coleraine,5645,5,12,9,9,41,32,9,45
Cliftonville,5645,6,13,6,11,44,37,7,45
Glentoran,5645,7,11,5,14,31,39,-8,38
Dungannon,5645,8,8,8,14,45,52,-7,32
Ards,5645,9,9,5,16,38,56,-18,32
Ballinamalla,5645,10,7,6,17,31,60,-29,27
Portadown,5645,11,6,7,17,18,45,-27,25
Crusaders,5646,1,18,7,5,58,33,25,61
Ballymena,5646,2,17,5,8,62,49,13,56
Cliftonville,5646,3,15,6,9,51,37,14,51
Linfield,5646,4,13,11,6,55,30,25,50
Coleraine,5646,5,12,10,8,40,40,0,46
Glenavon,5646,6,11,10,9,47,42,5,43
Dungannon,5646,7,8,13,9,46,42,4,37
Glentoran,5646,8,6,12,12,32,50,-18,30
Ballinamalla,5646,9,7,7,16,29,47,-18,28
Portadown,5646,10,6,6,18,22,50,-28,24
Ards,5646,11,6,5,19,31,53,-22,23
Crusaders,5647,1,17,6,7,57,38,19,57
Linfield,5647,2,13,11,6,63,35,28,50
Cliftonville,5647,3,14,7,9,56,44,12,49
Glenavon,5647,4,13,10,7,46,40,6,49
Ballymena,5647,5,13,9,8,57,53,4,48
Coleraine,5647,6,9,12,9,41,43,-2,39
Dungannon,5647,7,9,8,13,51,50,1,35
Ards,5647,8,10,5,15,43,50,-7,35
Portadown,5647,9,9,8,13,27,40,-13,35
Glentoran,5647,10,8,8,14,32,51,-19,32
Ballinamalla,5647,11,3,10,17,26,55,-29,19
Crusaders,5648,1,16,8,6,53,28,25,56
Ballymena,5648,2,17,3,10,67,59,8,54
Cliftonville,5648,3,15,8,7,60,38,22,53
Glenavon,5648,4,13,10,7,48,39,9,49
Coleraine,5648,5,12,9,9,47,38,9,45
Dungannon,5648,6,11,10,9,52,41,11,43
Linfield,5648,7,9,12,9,50,38,12,39
Glentoran,5648,8,8,9,13,33,50,-17,33
Ards,5648,9,10,3,17,39,61,-22,33
Ballinamalla,5648,10,5,10,15,27,49,-22,25
Portadown,5648,11,4,8,18,22,57,-35,20
Crusaders,5649,1,17,8,5,54,30,24,59
Linfield,5649,2,14,10,6,58,32,26,52
Ballymena,5649,3,15,7,8,57,55,2,52
Glenavon,5649,4,14,9,7,49,41,8,51
Cliftonville,5649,5,14,7,9,46,36,10,49
Coleraine,5649,6,11,8,11,41,38,3,41
Ballinamalla,5649,7,9,7,14,29,44,-15,34
Portadown,5649,8,9,3,18,27,50,-23,30
Dungannon,5649,9,7,8,15,47,48,-1,29
Ards,5649,10,8,5,17,40,52,-12,29
Glentoran,5649,11,6,10,14,24,46,-22,28
Cliftonville,5650,1,18,6,6,65,36,29,60
Linfield,5650,2,17,7,6,62,34,28,58
Crusaders,5650,3,16,6,8,58,43,15,54
Ballymena,5650,4,16,4,10,69,55,14,52
Glenavon,5650,5,11,10,9,44,48,-4,43
Coleraine,5650,6,11,9,10,43,42,1,42
Dungannon,5650,7,10,8,12,50,44,6,38
Glentoran,5650,8,8,8,14,33,51,-18,32
Ards,5650,9,8,4,18,35,49,-14,28
Ballinamalla,5650,10,7,5,18,32,55,-23,26
Portadown,5650,11,7,5,18,23,57,-34,26
Crusaders,5651,1,16,9,5,49,27,22,57
Ballymena,5651,2,16,6,8,62,52,10,54
Cliftonville,5651,3,16,5,9,51,41,10,53
Linfield,5651,4,14,10,6,60,33,27,52
Coleraine,5651,5,12,10,8,44,35,9,46
Dungannon,5651,6,12,9,9,51,42,9,45
Glenavon,5651,7,11,9,10,40,43,-3,42
Glentoran,5651,8,7,8,15,29,46,-17,29
Ards,5651,9,7,7,16,39,52,-13,28
Portadown,5651,10,7,6,17,28,51,-23,27
Ballinamalla,5651,11,6,3,21,28,59,-31,21
Cliftonville,5652,1,17,6,7,63,39,24,57
Crusaders,5652,2,16,7,7,59,42,17,55
Coleraine,5652,3,13,10,7,49,34,15,49
Ballymena,5652,4,14,6,10,54,60,-6,48
Linfield,5652,5,12,11,7,57,36,21,47
Glenavon,5652,6,9,11,10,44,44,0,38
Dungannon,5652,7,9,10,11,50,46,4,37
Glentoran,5652,8,8,10,12,32,44,-12,34
Ballinamalla,5652,9,8,6,16,27,51,-24,30
Portadown,5652,10,8,5,17,25,46,-21,29
Ards,5652,11,7,6,17,33,51,-18,27
Cliftonville,5653,1,18,4,8,63,39,24,58
Crusaders,5653,2,17,7,6,58,38,20,58
Glenavon,5653,3,12,13,5,53,46,7,49
Ballymena,5653,4,14,6,10,58,60,-2,48
Linfield,5653,5,12,11,7,56,33,23,47
Coleraine,5653,6,10,12,8,42,38,4,42
Glentoran,5653,7,8,9,13,30,40,-10,33
Dungannon,5653,8,7,9,14,49,50,-1,30
Ards,5653,9,7,9,14,32,46,-14,30
Ballinamalla,5653,10,8,6,16,32,56,-24,30
Portadown,5653,11,6,6,18,23,50,-27,24
Linfield,5654,1,18,10,2,63,21,42,64
Crusaders,5654,2,16,7,7,56,34,22,55
Coleraine,5654,3,12,9,9,48,46,2,45
Ballymena,5654,4,12,7,11,58,65,-7,43
Cliftonville,5654,5,11,7,12,48,41,7,40
Ballinamalla,5654,6,11,7,12,37,48,-11,40
Dungannon,5654,7,9,12,9,48,43,5,39
Glenavon,5654,8,10,9,11,45,49,-4,39
Glentoran,5654,9,7,10,13,30,41,-11,31
Portadown,5654,10,7,8,15,26,46,-20,29
Ards,5654,11,5,8,17,29,54,-25,23
Linfield,5655,1,16,9,5,62,32,30,57
Cliftonville,5655,2,15,7,8,51,38,13,52
Crusaders,5655,3,13,10,7,44,34,10,49
Ballymena,5655,4,13,5,12,58,60,-2,44
Glenavon,5655,5,10,13,7,49,44,5,43
Dungannon,5655,6,12,7,11,54,50,4,43
Coleraine,5655,7,11,7,12,46,42,4,40
Glentoran,5655,8,11,7,12,31,42,-11,40
Ballinamalla,5655,9,9,7,14,37,50,-13,34
Ards,5655,10,10,3,17,39,51,-12,33
Portadown,5655,11,4,7,19,20,48,-28,19
Linfield,5656,1,18,9,3,70,23,47,63
Crusaders,5656,2,15,9,6,58,37,21,54
Ballymena,5656,3,13,6,11,54,60,-6,45
Glenavon,5656,4,11,11,8,49,46,3,44
Cliftonville,5656,5,12,6,12,50,45,5,42
Coleraine,5656,6,10,9,11,38,45,-7,39
Ards,5656,7,10,8,12,39,39,0,38
Dungannon,5656,8,9,9,12,47,46,1,36
Glentoran,5656,9,9,9,12,29,47,-18,36
Ballinamalla,5656,10,8,7,15,32,52,-20,31
Portadown,5656,11,6,5,19,24,50,-26,23
Linfield,5657,1,17,9,4,57,24,33,60
Crusaders,5657,2,16,9,5,62,43,19,57
Cliftonville,5657,3,16,3,11,61,41,20,51
Coleraine,5657,4,12,9,9,42,41,1,45
Ballymena,5657,5,13,6,11,52,60,-8,45
Glenavon,5657,6,9,14,7,40,43,-3,41
Ards,5657,7,12,4,14,43,48,-5,40
Dungannon,5657,8,9,10,11,46,41,5,37
Glentoran,5657,9,9,7,14,37,47,-10,34
Ballinamalla,5657,10,6,5,19,27,52,-25,23
Portadown,5657,11,6,4,20,22,49,-27,22
Ballymena,5658,1,19,4,7,59,48,11,61
Cliftonville,5658,2,18,3,9,56,39,17,57
Crusaders,5658,3,15,6,9,51,37,14,51
Linfield,5658,4,14,7,9,59,41,18,49
Coleraine,5658,5,13,8,9,51,37,14,47
Glenavon,5658,6,12,9,9,51,45,6,45
Glentoran,5658,7,11,4,15,32,47,-15,37
Dungannon,5658,8,8,11,11,48,45,3,35
Portadown,5658,9,9,3,18,23,46,-23,30
Ards,5658,10,8,4,18,38,54,-16,28
Ballinamalla,5658,11,7,3,20,32,61,-29,24
Crusaders,5659,1,19,6,5,66,29,37,63
Coleraine,5659,2,17,8,5,53,31,22,59
Cliftonville,5659,3,17,6,7,59,40,19,57
Glenavon,5659,4,10,13,7,45,50,-5,43
Linfield,5659,5,11,9,10,53,42,11,42
Ballymena,5659,6,11,7,12,58,68,-10,40
Portadown,5659,7,8,8,14,27,46,-19,32
Ards,5659,8,8,7,15,36,45,-9,31
Dungannon,5659,9,7,9,14,42,48,-6,30
Glentoran,5659,10,7,9,14,28,43,-15,30
Ballinamalla,5659,11,6,6,18,32,57,-25,24
Cliftonville,5660,1,19,6,5,63,29,34,63
Crusaders,5660,2,16,6,8,49,32,17,54
Ballymena,5660,3,14,8,8,57,56,1,50
Linfield,5660,4,11,11,8,44,29,15,44
Coleraine,5660,5,11,9,10,38,33,5,42
Glenavon,5660,6,10,11,9,45,47,-2,41
Glentoran,5660,7,11,8,11,35,44,-9,41
Dungannon,5660,8,9,10,11,47,42,5,37
Ards,5660,9,9,6,15,34,49,-15,33
Portadown,5660,10,6,6,18,20,44,-24,24
Ballinamalla,5660,11,6,5,19,24,51,-27,23
Crusaders,5661,1,18,10,2,60,29,31,64
Linfield,5661,2,15,11,4,59,31,28,56
Cliftonville,5661,3,15,4,11,54,40,14,49
Ballymena,5661,4,13,8,9,65,66,-1,47
Glenavon,5661,5,11,10,9,44,45,-1,43
Coleraine,5661,6,9,11,10,44,43,1,38
Dungannon,5661,7,9,10,11,49,46,3,37
Glentoran,5661,8,8,10,12,36,49,-13,34
Ards,5661,9,7,8,15,41,54,-13,29
Ballinamalla,5661,10,7,7,16,25,46,-21,28
Portadown,5661,11,4,9,17,28,56,-28,21
Crusaders,5662,1,19,8,3,58,26,32,65
Coleraine,5662,2,14,11,5,49,33,16,53
Linfield,5662,3,12,13,5,57,31,26,49
Cliftonville,5662,4,14,6,10,50,41,9,48
Ballymena,5662,5,13,5,12,54,58,-4,44
Glenavon,5662,6,10,10,10,49,54,-5,40
Dungannon,5662,7,10,9,11,47,41,6,39
Ards,5662,8,8,8,14,33,52,-19,32
Glentoran,5662,9,6,11,13,25,39,-14,29
Portadown,5662,10,6,7,17,25,47,-22,25
Ballinamalla,5662,11,5,8,17,28,53,-25,23
Linfield,5663,1,15,8,7,56,32,24,53
Cliftonville,5663,2,16,5,9,63,46,17,53
Crusaders,5663,3,14,8,8,57,39,18,50
Glenavon,5663,4,13,10,7,50,40,10,49
Ballymena,5663,5,14,6,10,62,62,0,48
Dungannon,5663,6,12,8,10,54,42,12,44
Coleraine,5663,7,10,10,10,45,44,1,40
Glentoran,5663,8,10,6,14,34,48,-14,36
Ards,5663,9,8,9,13,36,44,-8,33
Ballinamalla,5663,10,7,7,16,31,53,-22,28
Portadown,5663,11,5,5,20,21,59,-38,20
Crusaders,5664,1,17,6,7,61,36,25,57
Cliftonville,5664,2,17,5,8,49,32,17,56
Linfield,5664,3,14,9,7,60,35,25,51
Coleraine,5664,4,12,8,10,40,36,4,44
Ballymena,5664,5,13,5,12,51,52,-1,44
Glenavon,5664,6,10,12,8,38,42,-4,42
Dungannon,5664,7,11,6,13,54,48,6,39
Ards,5664,8,9,7,14,36,50,-14,34
Portadown,5664,9,10,4,16,28,49,-21,34
Glentoran,5664,10,9,6,15,36,44,-8,33
Ballinamalla,5664,11,8,2,20,27,56,-29,26
Ballymena,5665,1,18,4,8,64,52,12,58
Cliftonville,5665,2,17,5,8,55,37,18,56
Linfield,5665,3,15,9,6,55,24,31,54
Crusaders,5665,4,15,6,9,54,46,8,51
Coleraine,5665,5,13,11,6,43,32,11,50
Glenavon,5665,6,12,11,7,55,48,7,47
Dungannon,5665,7,11,10,9,51,41,10,43
Ards,5665,8,8,7,15,36,51,-15,31
Glentoran,5665,9,7,5,18,28,49,-21,26
Ballinamalla,5665,10,7,3,20,30,55,-25,24
Portadown,5665,11,5,3,22,19,55,-36,18
Linfield,5666,1,15,10,5,61,28,33,55
Crusaders,5666,2,15,8,7,62,45,17,53
Ballymena,5666,3,16,4,10,56,47,9,52
Cliftonville,5666,4,15,6,9,50,35,15,51
Coleraine,5666,5,13,11,6,50,31,19,50
Dungannon,5666,6,11,10,9,50,45,5,43
Glenavon,5666,7,7,14,9,43,46,-3,35
Ards,5666,8,10,3,17,30,49,-19,33
Glentoran,5666,9,8,6,16,29,44,-15,30
Ballinamalla,5666,10,8,6,16,33,57,-24,30
Portadown,5666,11,5,6,19,17,54,-37,21
Crusaders,5667,1,17,9,4,58,29,29,60
Coleraine,5667,2,14,10,6,44,33,11,52
Cliftonville,5667,3,14,6,10,52,35,17,48
Ballymena,5667,4,14,6,10,52,60,-8,48
Linfield,5667,5,13,8,9,50,31,19,47
Dungannon,5667,6,11,11,8,50,41,9,44
Ards,5667,7,11,7,12,36,38,-2,40
Glenavon,5667,8,7,12,11,45,53,-8,33
Ballinamalla,5667,9,8,6,16,35,48,-13,30
Portadown,5667,10,7,5,18,22,47,-25,26
Glentoran,5667,11,5,8,17,24,53,-29,23
Linfield,5668,1,15,10,5,61,30,31,55
Ballymena,5668,2,16,7,7,65,58,7,55
Cliftonville,5668,3,16,5,9,57,45,12,53
Crusaders,5668,4,14,6,10,54,42,12,48
Glenavon,5668,5,13,8,9,49,45,4,47
Coleraine,5668,6,11,11,8,41,33,8,44
Dungannon,5668,7,11,9,10,46,39,7,42
Ards,5668,8,9,7,14,31,41,-10,34
Glentoran,5668,9,8,6,16,32,53,-21,30
Portadown,5668,10,7,5,18,25,43,-18,26
Ballinamalla,5668,11,6,4,20,31,63,-32,22
Crusaders,5669,1,19,8,3,62,32,30,65
Linfield,5669,2,15,10,5,54,27,27,55
Cliftonville,5669,3,17,4,9,53,34,19,55
Ballymena,5669,4,14,5,11,55,55,0,47
Glenavon,5669,5,12,9,9,48,51,-3,45
Dungannon,5669,6,11,8,11,54,46,8,41
Coleraine,5669,7,8,11,11,40,42,-2,35
Glentoran,5669,8,10,4,16,36,48,-12,34
Ballinamalla,5669,9,8,5,17,28,53,-25,29
Portadown,5669,10,7,6,17,24,44,-20,27
Ards,5669,11,6,6,18,29,51,-22,24
Linfield,5670,1,16,9,5,61,26,35,57
Crusaders,5670,2,16,7,7,55,39,16,55
Cliftonville,5670,3,14,5,11,56,41,15,47
Ballymena,5670,4,14,5,11,57,63,-6,47
Coleraine,5670,5,11,9,10,41,41,0,42
Glenavon,5670,6,11,9,10,45,48,-3,42
Dungannon,5670,7,11,7,12,49,44,5,40
Ards,5670,8,10,6,14,42,47,-5,36
Portadown,5670,9,11,3,16,31,43,-12,36
Glentoran,5670,10,10,6,14,32,50,-18,36
Ballinamalla,5670,11,7,2,21,29,56,-27,23
Crusaders,5671,1,18,6,6,54,30,24,60
Linfield,5671,2,14,9,7,57,32,25,51
Cliftonville,5671,3,16,3,11,50,37,13,51
Coleraine,5671,4,12,12,6,50,30,20,48
Ballymena,5671,5,13,7,10,55,61,-6,46
Dungannon,5671,6,10,7,13,46,51,-5,37
Ards,5671,7,10,4,16,37,50,-13,34
Glenavon,5671,8,7,12,11,46,53,-7,33
Portadown,5671,9,8,8,14,21,38,-17,32
Ballinamalla,5671,10,8,6,16,35,52,-17,30
Glentoran,5671,11,6,12,12,22,39,-17,30
Crusaders,5672,1,22,6,2,62,28,34,72
Cliftonville,5672,2,17,4,9,56,34,22,55
Linfield,5672,3,15,8,7,54,31,23,53
Ballymena,5672,4,14,5,11,53,53,0,47
Dungannon,5672,5,10,10,10,46,37,9,40
Glenavon,5672,6,10,10,10,45,51,-6,40
Coleraine,5672,7,9,11,10,37,47,-10,38
Ards,5672,8,10,4,16,39,48,-9,34
Glentoran,5672,9,7,7,16,32,46,-14,28
Portadown,5672,10,6,9,15,21,39,-18,27
Ballinamalla,5672,11,4,8,18,26,57,-31,20
Crusaders,5673,1,18,8,4,60,33,27,62
Ballymena,5673,2,17,6,7,65,48,17,57
Cliftonville,5673,3,17,4,9,52,35,17,55
Linfield,5673,4,15,9,6,54,31,23,54
Glenavon,5673,5,9,11,10,40,49,-9,38
Coleraine,5673,6,9,10,11,41,39,2,37
Dungannon,5673,7,8,10,12,42,44,-2,34
Ards,5673,8,9,6,15,43,57,-14,33
Glentoran,5673,9,7,8,15,32,44,-12,29
Portadown,5673,10,6,9,15,19,39,-20,27
Ballinamalla,5673,11,7,5,18,26,55,-29,26
Crusaders,5674,1,19,4,7,56,32,24,61
Cliftonville,5674,2,18,3,9,55,42,13,57
Linfield,5674,3,13,9,8,58,36,22,48
Ballymena,5674,4,13,9,8,65,60,5,48
Glenavon,5674,5,13,8,9,47,42,5,47
Coleraine,5674,6,11,9,10,38,37,1,42
Dungannon,5674,7,10,7,13,44,49,-5,37
Glentoran,5674,8,9,10,11,39,49,-10,37
Ards,5674,9,8,5,17,39,56,-17,29
Ballinamalla,5674,10,8,4,18,39,57,-18,28
Portadown,5674,11,8,2,20,36,56,-20,26
Linfield,5675,1,15,9,6,58,32,26,54
Glenavon,5675,2,14,10,6,50,41,9,52
Coleraine,5675,3,13,12,5,50,36,14,51
Crusaders,5675,4,14,9,7,49,37,12,51
Cliftonville,5675,5,14,8,8,53,38,15,50
Ballymena,5675,6,10,10,10,50,54,-4,40
Ballinamalla,5675,7,11,4,15,32,46,-14,37
Dungannon,5675,8,7,12,11,41,43,-2,33
Glentoran,5675,9,9,4,17,30,44,-14,31
Ards,5675,10,7,6,17,35,54,-19,27
Portadown,5675,11,6,6,18,27,50,-23,24
Crusaders,5676,1,17,7,6,56,35,21,58
Linfield,5676,2,15,7,8,56,29,27,52
Ballymena,5676,3,14,6,10,56,55,1,48
Coleraine,5676,4,12,9,9,48,42,6,45
Glenavon,5676,5,11,12,7,44,41,3,45
Cliftonville,5676,6,13,5,12,51,50,1,44
Dungannon,5676,7,11,10,9,50,41,9,43
Glentoran,5676,8,12,6,12,35,45,-10,42
Ards,5676,9,10,3,17,40,53,-13,33
Ballinamalla,5676,10,8,5,17,32,52,-20,29
Portadown,5676,11,5,4,21,27,52,-25,19
Crusaders,5677,1,17,6,7,56,35,21,57
Linfield,5677,2,15,9,6,64,33,31,54
Cliftonville,5677,3,16,2,12,52,43,9,50
Coleraine,5677,4,12,10,8,39,37,2,46
Ballymena,5677,5,13,6,11,56,60,-4,45
Glenavon,5677,6,11,11,8,42,41,1,44
Dungannon,5677,7,11,9,10,50,43,7,42
Portadown,5677,8,11,3,16,29,43,-14,36
Ballinamalla,5677,9,9,6,15,29,43,-14,33
Glentoran,5677,10,7,8,15,25,40,-15,29
Ards,5677,11,5,6,19,28,52,-24,21
Crusaders,5678,1,16,11,3,66,41,25,59
Linfield,5678,2,14,9,7,67,45,22,51
Cliftonville,5678,3,15,6,9,47,32,15,51
Dungannon,5678,4,10,12,8,53,41,12,42
Glenavon,5678,5,9,15,6,49,41,8,42
Coleraine,5678,6,9,12,9,33,30,3,39
Ards,5678,7,10,6,14,41,47,-6,36
Ballymena,5678,8,9,9,12,45,65,-20,36
Portadown,5678,9,9,7,14,30,49,-19,34
Glentoran,5678,10,7,12,11,32,43,-11,33
Ballinamalla,5678,11,6,3,21,34,63,-29,21
Crusaders,5679,1,16,9,5,56,42,14,57
Linfield,5679,2,15,9,6,58,31,27,54
Cliftonville,5679,3,15,6,9,50,36,14,51
Ballymena,5679,4,15,6,9,51,49,2,51
Coleraine,5679,5,12,10,8,39,33,6,46
Dungannon,5679,6,12,9,9,53,36,17,45
Glenavon,5679,7,9,12,9,46,47,-1,39
Portadown,5679,8,9,9,12,28,35,-7,36
Ballinamalla,5679,9,8,2,20,23,54,-31,26
Ards,5679,10,7,4,19,38,57,-19,25
Glentoran,5679,11,6,6,18,31,53,-22,24
Cliftonville,5680,1,18,4,8,60,39,21,58
Crusaders,5680,2,15,8,7,56,36,20,53
Ballymena,5680,3,14,5,11,54,53,1,47
Linfield,5680,4,11,13,6,49,29,20,46
Glenavon,5680,5,12,9,9,43,42,1,45
Coleraine,5680,6,11,10,9,38,40,-2,43
Dungannon,5680,7,10,9,11,48,42,6,39
Glentoran,5680,8,9,10,11,37,50,-13,37
Portadown,5680,9,9,7,14,26,42,-16,34
Ballinamalla,5680,10,7,5,18,30,50,-20,26
Ards,5680,11,6,6,18,40,58,-18,24
Crusaders,5681,1,18,5,7,59,33,26,59
Linfield,5681,2,14,12,4,60,32,28,54
Ballymena,5681,3,15,6,9,59,56,3,51
Cliftonville,5681,4,15,3,12,49,43,6,48
Glenavon,5681,5,10,12,8,42,44,-2,42
Coleraine,5681,6,9,12,9,40,38,2,39
Dungannon,5681,7,8,10,12,40,39,1,34
Glentoran,5681,8,8,9,13,34,48,-14,33
Portadown,5681,9,8,9,13,26,41,-15,33
Ards,5681,10,9,4,17,40,55,-15,31
Ballinamalla,5681,11,7,6,17,31,51,-20,27
Ballymena,5682,1,17,6,7,66,51,15,57
Crusaders,5682,2,15,9,6,52,33,19,54
Linfield,5682,3,15,8,7,54,30,24,53
Glenavon,5682,4,11,12,7,47,44,3,45
Cliftonville,5682,5,12,8,10,52,39,13,44
Dungannon,5682,6,12,8,10,48,43,5,44
Coleraine,5682,7,10,13,7,42,37,5,43
Glentoran,5682,8,9,6,15,28,47,-19,33
Ballinamalla,5682,9,9,3,18,31,52,-21,30
Portadown,5682,10,6,10,14,25,42,-17,28
Ards,5682,11,5,5,20,26,53,-27,20
Crusaders,5683,1,19,8,3,68,36,32,65
Linfield,5683,2,16,10,4,68,31,37,58
Cliftonville,5683,3,15,5,10,53,42,11,50
Ballymena,5683,4,15,5,10,66,67,-1,50
Coleraine,5683,5,13,10,7,43,36,7,49
Dungannon,5683,6,12,9,9,52,39,13,45
Ards,5683,7,11,3,16,38,49,-11,36
Glenavon,5683,8,7,11,12,36,45,-9,32
Portadown,5683,9,8,2,20,24,52,-28,26
Ballinamalla,5683,10,7,3,20,34,59,-25,24
Glentoran,5683,11,5,8,17,27,53,-26,23
Crusaders,5684,1,16,9,5,55,33,22,57
Linfield,5684,2,15,11,4,56,28,28,56
Coleraine,5684,3,15,9,6,49,35,14,54
Cliftonville,5684,4,15,5,10,53,36,17,50
Ballymena,5684,5,12,10,8,61,61,0,46
Dungannon,5684,6,11,7,12,53,44,9,40
Glentoran,5684,7,9,7,14,32,48,-16,34
Glenavon,5684,8,8,9,13,46,53,-7,33
Ballinamalla,5684,9,8,5,17,32,53,-21,29
Portadown,5684,10,8,5,17,25,48,-23,29
Ards,5684,11,7,5,18,33,56,-23,26
Crusaders,5685,1,16,8,6,53,32,21,56
Ballymena,5685,2,16,6,8,57,52,5,54
Cliftonville,5685,3,15,4,11,45,34,11,49
Dungannon,5685,4,12,10,8,56,40,16,46
Linfield,5685,5,11,12,7,55,35,20,45
Glenavon,5685,6,11,11,8,46,42,4,44
Coleraine,5685,7,10,9,11,38,39,-1,39
Ards,5685,8,12,3,15,37,46,-9,39
Portadown,5685,9,8,7,15,24,42,-18,31
Glentoran,5685,10,7,8,15,22,41,-19,29
Ballinamalla,5685,11,6,4,20,26,56,-30,22
Linfield,5686,1,16,7,7,74,38,36,55
Cliftonville,5686,2,17,4,9,55,37,18,55
Coleraine,5686,3,14,11,5,49,35,14,53
Crusaders,5686,4,14,10,6,54,35,19,52
Dungannon,5686,5,8,14,8,49,39,10,38
Glenavon,5686,6,8,13,9,40,43,-3,37
Glentoran,5686,7,11,4,15,35,45,-10,37
Ballymena,5686,8,9,9,12,50,63,-13,36
Ballinamalla,5686,9,9,4,17,31,56,-25,31
Ards,5686,10,8,5,17,33,55,-22,29
Portadown,5686,11,8,5,17,24,48,-24,29
Linfield,5687,1,16,8,6,62,35,27,56
Ballymena,5687,2,17,5,8,58,53,5,56
Crusaders,5687,3,16,6,8,54,32,22,54
Glenavon,5687,4,14,9,7,51,39,12,51
Cliftonville,5687,5,14,6,10,47,39,8,48
Coleraine,5687,6,12,11,7,46,33,13,47
Dungannon,5687,7,11,8,11,44,39,5,41
Glentoran,5687,8,7,9,14,25,42,-17,30
Ards,5687,9,7,5,18,30,51,-21,26
Ballinamalla,5687,10,7,4,19,27,51,-24,25
Portadown,5687,11,6,5,19,23,53,-30,23
Linfield,5688,1,15,9,6,58,32,26,54
Crusaders,5688,2,15,8,7,51,33,18,53
Coleraine,5688,3,13,11,6,50,36,14,50
Cliftonville,5688,4,14,5,11,45,36,9,47
Glenavon,5688,5,11,12,7,49,44,5,45
Ballymena,5688,6,13,5,12,60,62,-2,44
Dungannon,5688,7,9,10,11,44,41,3,37
Ballinamalla,5688,8,10,6,14,34,46,-12,36
Glentoran,5688,9,8,11,11,27,40,-13,35
Ards,5688,10,7,6,17,35,55,-20,27
Portadown,5688,11,6,5,19,21,49,-28,23
Crusaders,5689,1,18,5,7,58,32,26,59
Ballymena,5689,2,16,4,10,57,56,1,52
Coleraine,5689,3,13,8,9,45,31,14,47
Cliftonville,5689,4,14,4,12,49,41,8,46
Linfield,5689,5,12,9,9,56,37,19,45
Glenavon,5689,6,10,12,8,46,44,2,42
Ards,5689,7,11,7,12,40,43,-3,40
Dungannon,5689,8,9,11,10,49,48,1,38
Portadown,5689,9,10,5,15,27,43,-16,35
Glentoran,5689,10,7,6,17,29,48,-19,27
Ballinamalla,5689,11,7,5,18,30,63,-33,26
Crusaders,5690,1,18,10,2,59,24,35,64
Cliftonville,5690,2,15,6,9,55,42,13,51
Linfield,5690,3,13,9,8,61,36,25,48
Coleraine,5690,4,12,9,9,46,44,2,45
Ballymena,5690,5,13,6,11,52,55,-3,45
Glenavon,5690,6,10,12,8,51,44,7,42
Dungannon,5690,7,11,7,12,51,50,1,40
Ards,5690,8,10,4,16,36,49,-13,34
Ballinamalla,5690,9,9,4,17,27,47,-20,31
Glentoran,5690,10,7,7,16,28,49,-21,28
Portadown,5690,11,8,4,18,33,59,-26,28
Cliftonville,5691,1,16,7,7,53,33,20,55
Linfield,5691,2,14,10,6,57,31,26,52
Crusaders,5691,3,15,7,8,59,40,19,52
Ballymena,5691,4,14,9,7,58,53,5,51
Glenavon,5691,5,12,13,5,48,38,10,49
Coleraine,5691,6,11,11,8,45,37,8,44
Dungannon,5691,7,8,10,12,44,48,-4,34
Glentoran,5691,8,9,7,14,35,49,-14,34
Ards,5691,9,7,6,17,29,52,-23,27
Portadown,5691,10,7,5,18,23,45,-22,26
Ballinamalla,5691,11,6,7,17,24,49,-25,25
Ballymena,5692,1,16,7,7,64,55,9,55
Cliftonville,5692,2,16,5,9,53,37,16,53
Dungannon,5692,3,14,9,7,59,33,26,51
Linfield,5692,4,14,7,9,55,38,17,49
Crusaders,5692,5,14,7,9,50,40,10,49
Glenavon,5692,6,11,10,9,47,49,-2,43
Coleraine,5692,7,9,10,11,43,43,0,37
Ballinamalla,5692,8,10,3,17,30,50,-20,33
Ards,5692,9,7,8,15,34,49,-15,29
Portadown,5692,10,7,7,16,26,46,-20,28
Glentoran,5692,11,7,7,16,33,54,-21,28
Ballymena,5693,1,16,6,8,63,56,7,54
Linfield,5693,2,14,10,6,61,29,32,52
Glenavon,5693,3,13,12,5,58,44,14,51
Crusaders,5693,4,14,8,8,47,34,13,50
Coleraine,5693,5,13,9,8,42,40,2,48
Cliftonville,5693,6,14,5,11,53,52,1,47
Dungannon,5693,7,9,8,13,44,41,3,35
Ards,5693,8,9,4,17,34,48,-14,31
Ballinamalla,5693,9,8,6,16,38,52,-14,30
Glentoran,5693,10,7,8,15,27,45,-18,29
Portadown,5693,11,7,6,17,27,53,-26,27
Linfield,5694,1,16,8,6,60,31,29,56
Crusaders,5694,2,16,8,6,52,33,19,56
Coleraine,5694,3,13,12,5,46,32,14,51
Cliftonville,5694,4,14,5,11,50,40,10,47
Ballymena,5694,5,13,6,11,59,65,-6,45
Glenavon,5694,6,10,10,10,48,43,5,40
Dungannon,5694,7,10,8,12,51,49,2,38
Ards,5694,8,11,3,16,40,47,-7,36
Glentoran,5694,9,9,7,14,29,44,-15,34
Ballinamalla,5694,10,9,2,19,32,58,-26,29
Portadown,5694,11,7,5,18,21,46,-25,26
Crusaders,5695,1,15,10,5,60,41,19,55
Linfield,5695,2,14,11,5,57,31,26,53
Ballymena,5695,3,15,7,8,62,58,4,52
Glenavon,5695,4,13,11,6,56,48,8,50
Cliftonville,5695,5,14,4,12,52,43,9,46
Coleraine,5695,6,10,13,7,43,36,7,43
Portadown,5695,7,9,6,15,29,46,-17,33
Dungannon,5695,8,7,10,13,43,45,-2,31
Glentoran,5695,9,6,12,12,26,42,-16,30
Ards,5695,10,6,8,16,37,55,-18,26
Ballinamalla,5695,11,6,8,16,32,52,-20,26
Crusaders,5696,1,16,8,6,52,32,20,56
Cliftonville,5696,2,17,3,10,57,40,17,54
Dungannon,5696,3,13,9,8,54,41,13,48
Linfield,5696,4,12,11,7,56,33,23,47
Coleraine,5696,5,11,9,10,42,40,2,42
Ards,5696,6,12,5,13,39,46,-7,41
Ballymena,5696,7,10,9,11,58,66,-8,39
Glenavon,5696,8,9,11,10,43,46,-3,38
Glentoran,5696,9,7,11,12,27,42,-15,32
Ballinamalla,5696,10,8,4,18,29,47,-18,28
Portadown,5696,11,6,8,16,22,46,-24,26
Crusaders,5697,1,19,8,3,64,30,34,65
Ballymena,5697,2,18,6,6,68,51,17,60
Coleraine,5697,3,13,12,5,46,32,14,51
Cliftonville,5697,4,15,5,10,53,42,11,50
Linfield,5697,5,11,10,9,55,38,17,43
Glenavon,5697,6,9,10,11,45,48,-3,37
Dungannon,5697,7,7,13,10,47,48,-1,34
Glentoran,5697,8,9,7,14,32,51,-19,34
Portadown,5697,9,8,6,16,30,48,-18,30
Ballinamalla,5697,10,7,6,17,29,55,-26,27
Ards,5697,11,6,3,21,37,63,-26,21
Cliftonville,5698,1,16,5,9,56,40,16,53
Crusaders,5698,2,14,8,8,60,41,19,50
Linfield,5698,3,13,9,8,57,34,23,48
Ballymena,5698,4,14,5,11,57,60,-3,47
Coleraine,5698,5,12,10,8,45,39,6,46
Glenavon,5698,6,12,9,9,53,50,3,45
Dungannon,5698,7,10,9,11,49,44,5,39
Glentoran,5698,8,10,8,12,28,43,-15,38
Ards,5698,9,8,8,14,37,53,-16,32
Ballinamalla,5698,10,8,6,16,30,46,-16,30
Portadown,5698,11,7,5,18,26,48,-22,26
Linfield,5699,1,15,9,6,57,30,27,54
Crusaders,5699,2,16,5,9,61,37,24,53
Ballymena,5699,3,16,4,10,67,61,6,52
Coleraine,5699,4,12,11,7,49,42,7,47
Cliftonville,5699,5,13,6,11,53,48,5,45
Glenavon,5699,6,11,12,7,51,47,4,45
Dungannon,5699,7,10,10,10,55,51,4,40
Glentoran,5699,8,9,9,12,33,44,-11,36
Portadown,5699,9,8,5,17,26,44,-18,29
Ards,5699,10,7,7,16,33,50,-17,28
Ballinamalla,5699,11,7,4,19,26,57,-31,25
Crusaders,5700,1,18,6,6,59,26,33,60
Coleraine,5700,2,14,9,7,46,37,9,51
Cliftonville,5700,3,15,5,10,49,40,9,50
Ballymena,5700,4,13,8,9,59,54,5,47
Linfield,5700,5,12,8,10,58,34,24,44
Glenavon,5700,6,11,10,9,39,43,-4,43
Dungannon,5700,7,11,7,12,52,46,6,40
Glentoran,5700,8,10,8,12,28,39,-11,38
Ballinamalla,5700,9,9,4,17,30,48,-18,31
Ards,5700,10,7,6,17,31,51,-20,27
Portadown,5700,11,8,3,19,22,55,-33,27
Crusaders,5701,1,17,9,4,59,32,27,60
Cliftonville,5701,2,17,2,11,62,42,20,53
Glenavon,5701,3,14,10,6,48,35,13,52
Linfield,5701,4,13,10,7,52,34,18,49
Ballymena,5701,5,13,8,9,55,56,-1,47
Coleraine,5701,6,12,8,10,46,48,-2,44
Ards,5701,7,12,4,14,47,45,2,40
Dungannon,5701,8,9,9,12,46,47,-1,36
Ballinamalla,5701,9,8,6,16,29,47,-18,30
Portadown,5701,10,5,7,18,19,48,-29,22
Glentoran,5701,11,4,9,17,24,53,-29,21
Linfield,5702,1,17,9,4,67,35,32,60
Crusaders,5702,2,17,8,5,58,35,23,59
Cliftonville,5702,3,17,5,8,57,36,21,56
Ballymena,5702,4,13,6,11,60,63,-3,45
Glenavon,5702,5,11,8,11,54,44,10,41
Coleraine,5702,6,10,10,10,39,44,-5,40
Glentoran,5702,7,11,5,14,38,49,-11,38
Dungannon,5702,8,9,7,14,51,52,-1,34
Ballinamalla,5702,9,9,3,18,28,56,-28,30
Ards,5702,10,8,4,18,35,54,-19,28
Portadown,5702,11,7,7,16,21,40,-19,28
Ballymena,5703,1,15,7,8,63,57,6,52
Crusaders,5703,2,15,6,9,54,37,17,51
Cliftonville,5703,3,15,6,9,48,43,5,51
Linfield,5703,4,12,9,9,52,28,24,45
Coleraine,5703,5,10,13,7,45,36,9,43
Glenavon,5703,6,11,10,9,48,52,-4,43
Dungannon,5703,7,11,9,10,58,44,14,42
Ards,5703,8,10,7,13,40,45,-5,37
Glentoran,5703,9,9,6,15,27,46,-19,33
Portadown,5703,10,8,8,14,29,44,-15,32
Ballinamalla,5703,11,6,5,19,28,60,-32,23
Glenavon,5704,1,14,11,5,58,38,20,53
Crusaders,5704,2,15,7,8,50,35,15,52
Linfield,5704,3,12,11,7,51,34,17,47
Ballymena,5704,4,13,7,10,54,58,-4,46
Cliftonville,5704,5,13,6,11,55,46,9,45
Coleraine,5704,6,10,10,10,40,44,-4,40
Glentoran,5704,7,11,6,13,35,46,-11,39
Ards,5704,8,10,7,13,36,42,-6,37
Dungannon,5704,9,8,9,13,50,54,-4,33
Portadown,5704,10,9,5,16,34,45,-11,32
Ballinamalla,5704,11,8,5,17,27,48,-21,29
Crusaders,5705,1,17,6,7,54,37,17,57
Cliftonville,5705,2,16,5,9,60,41,19,53
Glenavon,5705,3,13,10,7,56,47,9,49
Linfield,5705,4,12,11,7,53,33,20,47
Ballymena,5705,5,11,12,7,64,64,0,45
Dungannon,5705,6,10,9,11,47,44,3,39
Coleraine,5705,7,8,13,9,44,43,1,37
Glentoran,5705,8,8,9,13,32,45,-13,33
Ards,5705,9,8,6,16,31,46,-15,30
Portadown,5705,10,7,8,15,25,45,-20,29
Ballinamalla,5705,11,8,5,17,26,47,-21,29
Cliftonville,5706,1,18,4,8,52,33,19,58
Crusaders,5706,2,17,6,7,53,34,19,57
Ballymena,5706,3,15,6,9,66,62,4,51
Glenavon,5706,4,11,13,6,48,39,9,46
Coleraine,5706,5,12,10,8,46,38,8,46
Linfield,5706,6,13,6,11,57,41,16,45
Glentoran,5706,7,11,9,10,39,47,-8,42
Dungannon,5706,8,11,7,12,55,47,8,40
Portadown,5706,9,7,5,18,25,44,-19,26
Ards,5706,10,7,5,18,36,64,-28,26
Ballinamalla,5706,11,6,3,21,31,59,-28,21
Cliftonville,5707,1,17,3,10,53,40,13,54
Linfield,5707,2,15,8,7,60,32,28,53
Ballymena,5707,3,15,7,8,61,56,5,52
Crusaders,5707,4,14,8,8,49,37,12,50
Dungannon,5707,5,11,11,8,52,43,9,44
Coleraine,5707,6,11,10,9,44,38,6,43
Glenavon,5707,7,10,13,7,48,47,1,43
Ards,5707,8,9,6,15,35,47,-12,33
Portadown,5707,9,9,3,18,23,43,-20,30
Ballinamalla,5707,10,8,3,19,29,53,-24,27
Glentoran,5707,11,6,8,16,28,46,-18,26
Crusaders,5708,1,18,7,5,66,43,23,61
Linfield,5708,2,15,9,6,63,35,28,54
Ballymena,5708,3,14,8,8,58,56,2,50
Cliftonville,5708,4,13,7,10,53,41,12,46
Coleraine,5708,5,11,11,8,42,35,7,44
Glenavon,5708,6,10,11,9,49,48,1,41
Dungannon,5708,7,7,12,11,46,49,-3,33
Ards,5708,8,9,6,15,34,51,-17,33
Portadown,5708,9,10,2,18,27,45,-18,32
Glentoran,5708,10,7,10,13,36,46,-10,31
Ballinamalla,5708,11,6,7,17,27,52,-25,25
Crusaders,5709,1,18,6,6,55,37,18,60
Coleraine,5709,2,15,8,7,51,35,16,53
Linfield,5709,3,14,10,6,58,33,25,52
Cliftonville,5709,4,14,2,14,49,43,6,44
Glenavon,5709,5,11,11,8,48,42,6,44
Dungannon,5709,6,12,7,11,54,48,6,43
Ballymena,5709,7,11,7,12,48,57,-9,40
Glentoran,5709,8,10,6,14,30,43,-13,36
Ballinamalla,5709,9,9,6,15,29,44,-15,33
Ards,5709,10,8,6,16,39,49,-10,30
Portadown,5709,11,5,7,18,19,49,-30,22
Cliftonville,5710,1,17,7,6,54,34,20,58
Crusaders,5710,2,14,11,5,59,41,18,53
Ballymena,5710,3,16,5,9,65,62,3,53
Linfield,5710,4,13,11,6,57,31,26,50
Glenavon,5710,5,11,12,7,52,49,3,45
Coleraine,5710,6,10,11,9,49,46,3,41
Dungannon,5710,7,9,8,13,48,44,4,35
Ards,5710,8,8,8,14,42,55,-13,32
Glentoran,5710,9,8,8,14,31,44,-13,32
Ballinamalla,5710,10,6,8,16,28,52,-24,26
Portadown,5710,11,5,7,18,26,53,-27,22
Crusaders,5711,1,17,9,4,60,32,28,60
Ballymena,5711,2,14,9,7,57,47,10,51
Cliftonville,5711,3,16,2,12,51,38,13,50
Linfield,5711,4,13,9,8,57,33,24,48
Glenavon,5711,5,11,10,9,45,47,-2,43
Dungannon,5711,6,10,9,11,50,42,8,39
Coleraine,5711,7,9,10,11,32,43,-11,37
Portadown,5711,8,10,6,14,24,37,-13,36
Ards,5711,9,7,9,14,40,54,-14,30
Ballinamalla,5711,10,9,3,18,34,52,-18,30
Glentoran,5711,11,7,8,15,26,51,-25,29
Linfield,5712,1,16,9,5,61,28,33,57
Crusaders,5712,2,16,9,5,52,34,18,57
Ballymena,5712,3,15,5,10,52,48,4,50
Cliftonville,5712,4,14,7,9,47,32,15,49
Coleraine,5712,5,12,9,9,37,32,5,45
Glenavon,5712,6,8,13,9,47,50,-3,37
Dungannon,5712,7,7,13,10,45,46,-1,34
Ards,5712,8,10,4,16,35,45,-10,34
Glentoran,5712,9,9,7,14,32,48,-16,34
Portadown,5712,10,9,5,16,26,46,-20,32
Ballinamalla,5712,11,6,5,19,23,48,-25,23
Crusaders,5713,1,19,7,4,57,29,28,64
Glenavon,5713,2,14,9,7,52,39,13,51
Linfield,5713,3,14,8,8,66,41,25,50
Cliftonville,5713,4,16,2,12,59,45,14,50
Coleraine,5713,5,13,9,8,42,36,6,48
Dungannon,5713,6,13,7,10,57,44,13,46
Ballymena,5713,7,10,10,10,53,59,-6,40
Ards,5713,8,10,4,16,44,52,-8,34
Glentoran,5713,9,8,6,16,24,48,-24,30
Portadown,5713,10,6,6,18,21,53,-32,24
Ballinamalla,5713,11,7,2,21,25,54,-29,23
Crusaders,5714,1,19,6,5,63,34,29,63
Cliftonville,5714,2,16,5,9,57,41,16,53
Linfield,5714,3,13,9,8,56,35,21,48
Ballymena,5714,4,14,6,10,56,56,0,48
Coleraine,5714,5,12,8,10,51,45,6,44
Glenavon,5714,6,11,8,11,44,48,-4,41
Dungannon,5714,7,10,8,12,48,45,3,38
Glentoran,5714,8,10,8,12,28,41,-13,38
Portadown,5714,9,9,4,17,27,49,-22,31
Ards,5714,10,8,4,18,35,47,-12,28
Ballinamalla,5714,11,7,6,17,31,55,-24,27
Crusaders,5715,1,16,8,6,52,32,20,56
Linfield,5715,2,15,9,6,57,32,25,54
Ballymena,5715,3,14,7,9,61,57,4,49
Cliftonville,5715,4,13,8,9,48,39,9,47
Dungannon,5715,5,11,8,11,50,41,9,41
Coleraine,5715,6,10,11,9,41,39,2,41
Glenavon,5715,7,10,11,9,45,44,1,41
Glentoran,5715,8,10,7,13,37,47,-10,37
Portadown,5715,9,9,4,17,30,50,-20,31
Ballinamalla,5715,10,8,5,17,29,47,-18,29
Ards,5715,11,7,6,17,29,51,-22,27
Linfield,5716,1,16,10,4,67,28,39,58
Crusaders,5716,2,16,9,5,57,34,23,57
Cliftonville,5716,3,15,5,10,55,43,12,50
Glenavon,5716,4,13,8,9,56,53,3,47
Coleraine,5716,5,11,12,7,40,36,4,45
Ballymena,5716,6,12,6,12,59,62,-3,42
Ards,5716,7,11,7,12,42,46,-4,40
Dungannon,5716,8,9,9,12,47,42,5,36
Glentoran,5716,9,7,10,13,34,52,-18,31
Portadown,5716,10,6,6,18,25,49,-24,24
Ballinamalla,5716,11,5,6,19,26,63,-37,21
Crusaders,5717,1,18,7,5,58,31,27,61
Cliftonville,5717,2,16,5,9,54,34,20,53
Ballymena,5717,3,15,7,8,56,49,7,52
Coleraine,5717,4,12,10,8,49,37,12,46
Linfield,5717,5,12,9,9,52,33,19,45
Glenavon,5717,6,11,10,9,48,48,0,43
Dungannon,5717,7,9,9,12,42,46,-4,36
Ards,5717,8,10,5,15,45,54,-9,35
Ballinamalla,5717,9,8,5,17,26,50,-24,29
Portadown,5717,10,8,5,17,21,49,-28,29
Glentoran,5717,11,6,8,16,30,50,-20,26
Crusaders,5718,1,22,6,2,59,23,36,72
Glenavon,5718,2,16,7,7,57,43,14,55
Linfield,5718,3,14,9,7,60,33,27,51
Ballymena,5718,4,14,6,10,58,60,-2,48
Cliftonville,5718,5,13,6,11,49,43,6,45
Dungannon,5718,6,11,8,11,47,41,6,41
Coleraine,5718,7,11,8,11,42,41,1,41
Ards,5718,8,10,4,16,38,49,-11,34
Glentoran,5718,9,7,9,14,27,47,-20,30
Ballinamalla,5718,10,5,6,19,24,50,-26,21
Portadown,5718,11,6,3,21,22,53,-31,21
Crusaders,5719,1,19,7,4,58,28,30,64
Linfield,5719,2,15,10,5,57,27,30,55
Cliftonville,5719,3,16,6,8,55,39,16,54
Ballymena,5719,4,13,7,10,53,56,-3,46
Coleraine,5719,5,9,13,8,43,36,7,40
Ards,5719,6,11,4,15,36,48,-12,37
Dungannon,5719,7,8,10,12,49,49,0,34
Glenavon,5719,8,8,10,12,41,44,-3,34
Glentoran,5719,9,9,6,15,32,52,-20,33
Ballinamalla,5719,10,9,4,17,35,53,-18,31
Portadown,5719,11,7,5,18,24,51,-27,26
Crusaders,5720,1,18,5,7,61,40,21,59
Linfield,5720,2,16,8,6,61,35,26,56
Ballymena,5720,3,14,8,8,56,53,3,50
Cliftonville,5720,4,15,3,12,52,50,2,48
Coleraine,5720,5,12,8,10,39,36,3,44
Glenavon,5720,6,10,11,9,41,42,-1,41
Glentoran,5720,7,8,12,10,33,39,-6,36
Dungannon,5720,8,7,10,13,45,48,-3,31
Ards,5720,9,8,7,15,39,49,-10,31
Portadown,5720,10,8,6,16,28,44,-16,30
Ballinamalla,5720,11,8,4,18,31,50,-19,28
Crusaders,5721,1,18,10,2,68,34,34,64
Ballymena,5721,2,17,5,8,61,56,5,56
Cliftonville,5721,3,17,4,9,59,42,17,55
Coleraine,5721,4,12,11,7,43,40,3,47
Linfield,5721,5,11,11,8,55,33,22,44
Dungannon,5721,6,10,9,11,49,42,7,39
Glenavon,5721,7,7,11,12,44,59,-15,32
Portadown,5721,8,9,5,16,34,52,-18,32
Glentoran,5721,9,7,8,15,28,40,-12,29
Ballinamalla,5721,10,7,7,16,27,51,-24,28
Ards,5721,11,8,3,19,35,54,-19,27
Crusaders,5722,1,16,9,5,60,31,29,57
Ballymena,5722,2,18,3,9,68,58,10,57
Linfield,5722,3,15,11,4,58,28,30,56
Cliftonville,5722,4,15,6,9,54,37,17,51
Coleraine,5722,5,13,8,9,43,43,0,47
Glenavon,5722,6,9,8,13,52,56,-4,35
Ards,5722,7,9,7,14,35,47,-12,34
Ballinamalla,5722,8,10,2,18,27,51,-24,32
Portadown,5722,9,8,6,16,31,50,-19,30
Dungannon,5722,10,6,11,13,44,52,-8,29
Glentoran,5722,11,6,9,15,27,46,-19,27
Crusaders,5723,1,15,9,6,54,37,17,54
Linfield,5723,2,15,8,7,55,35,20,53
Ballymena,5723,3,16,3,11,60,56,4,51
Cliftonville,5723,4,14,6,10,48,39,9,48
Dungannon,5723,5,12,9,9,53,41,12,45
Glenavon,5723,6,11,10,9,46,49,-3,43
Coleraine,5723,7,9,15,6,40,34,6,42
Glentoran,5723,8,9,6,15,29,43,-14,33
Ballinamalla,5723,9,9,5,16,33,48,-15,32
Portadown,5723,10,9,4,17,36,55,-19,31
Ards,5723,11,7,3,20,33,50,-17,24
Linfield,5724,1,15,11,4,57,31,26,56
Crusaders,5724,2,15,9,6,59,40,19,54
Cliftonville,5724,3,15,8,7,48,34,14,53
Glenavon,5724,4,13,10,7,49,40,9,49
Coleraine,5724,5,11,9,10,40,39,1,42
Ballymena,5724,6,11,8,11,54,58,-4,41
Dungannon,5724,7,9,10,11,46,45,1,37
Portadown,5724,8,7,10,13,24,38,-14,31
Glentoran,5724,9,6,12,12,29,44,-15,30
Ards,5724,10,8,4,18,37,49,-12,28
Ballinamalla,5724,11,6,7,17,26,51,-25,25
Linfield,5725,1,16,10,4,65,31,34,58
Crusaders,5725,2,16,8,6,58,35,23,56
Cliftonville,5725,3,17,4,9,56,38,18,55
Ballymena,5725,4,15,6,9,60,53,7,51
Coleraine,5725,5,11,10,9,43,44,-1,43
Dungannon,5725,6,10,10,10,51,43,8,40
Glenavon,5725,7,10,10,10,42,46,-4,40
Ards,5725,8,8,8,14,38,48,-10,32
Ballinamalla,5725,9,8,4,18,36,55,-19,28
Glentoran,5725,10,7,7,16,29,51,-22,28
Portadown,5725,11,5,7,18,25,59,-34,22
Crusaders,5726,1,21,5,4,58,25,33,68
Linfield,5726,2,16,9,5,60,30,30,57
Cliftonville,5726,3,17,3,10,58,48,10,54
Glenavon,5726,4,11,11,8,58,45,13,44
Coleraine,5726,5,11,10,9,43,37,6,43
Ballymena,5726,6,11,7,12,51,61,-10,40
Dungannon,5726,7,9,10,11,51,51,0,37
Glentoran,5726,8,8,10,12,36,48,-12,34
Ards,5726,9,8,8,14,34,41,-7,32
Ballinamalla,5726,10,6,5,19,23,51,-28,23
Portadown,5726,11,5,6,19,21,56,-35,21
Linfield,5727,1,16,9,5,64,33,31,57
Cliftonville,5727,2,18,3,9,54,35,19,57
Crusaders,5727,3,15,9,6,56,35,21,54
Ballymena,5727,4,15,4,11,67,57,10,49
Glenavon,5727,5,11,12,7,47,51,-4,45
Dungannon,5727,6,8,12,10,53,46,7,36
Glentoran,5727,7,9,8,13,31,49,-18,35
Ards,5727,8,9,7,14,38,45,-7,34
Ballinamalla,5727,9,8,6,16,28,51,-23,30
Coleraine,5727,10,7,8,15,33,43,-10,29
Portadown,5727,11,6,8,16,19,45,-26,26
Crusaders,5728,1,16,6,8,58,41,17,54
Glenavon,5728,2,14,10,6,55,43,12,52
Linfield,5728,3,13,10,7,59,37,22,49
Cliftonville,5728,4,14,6,10,60,45,15,48
Coleraine,5728,5,13,9,8,39,35,4,48
Ballymena,5728,6,14,6,10,57,58,-1,48
Dungannon,5728,7,10,8,12,47,44,3,38
Ards,5728,8,11,4,15,37,44,-7,37
Glentoran,5728,9,9,7,14,35,50,-15,34
Portadown,5728,10,6,7,17,27,48,-21,25
Ballinamalla,5728,11,7,3,20,30,59,-29,24
Cliftonville,5729,1,18,4,8,58,41,17,58
Crusaders,5729,2,16,7,7,60,38,22,55
Linfield,5729,3,15,8,7,56,28,28,53
Ballymena,5729,4,14,9,7,61,54,7,51
Glenavon,5729,5,9,14,7,44,42,2,41
Dungannon,5729,6,11,7,12,52,45,7,40
Coleraine,5729,7,9,12,9,42,39,3,39
Ards,5729,8,10,5,15,40,55,-15,35
Glentoran,5729,9,9,6,15,36,52,-16,33
Portadown,5729,10,7,5,18,27,49,-22,26
Ballinamalla,5729,11,7,3,20,31,64,-33,24
Crusaders,5730,1,17,7,6,59,36,23,58
Glenavon,5730,2,14,10,6,59,45,14,52
Linfield,5730,3,14,7,9,59,44,15,49
Cliftonville,5730,4,14,7,9,54,39,15,49
Ballymena,5730,5,14,5,11,56,50,6,47
Coleraine,5730,6,12,10,8,43,36,7,46
Dungannon,5730,7,11,10,9,49,44,5,43
Ards,5730,8,11,3,16,37,52,-15,36
Glentoran,5730,9,6,10,14,27,46,-19,28
Ballinamalla,5730,10,7,4,19,24,51,-27,25
Portadown,5730,11,5,7,18,22,46,-24,22
Crusaders,5731,1,18,9,3,66,34,32,63
Linfield,5731,2,14,9,7,59,37,22,51
Ballymena,5731,3,16,3,11,57,54,3,51
Cliftonville,5731,4,15,5,10,53,40,13,50
Coleraine,5731,5,11,9,10,43,42,1,42
Glenavon,5731,6,10,10,10,46,50,-4,40
Dungannon,5731,7,8,9,13,44,45,-1,33
Portadown,5731,8,9,6,15,28,44,-16,33
Ballinamalla,5731,9,10,3,17,30,49,-19,33
Ards,5731,10,8,7,15,35,46,-11,31
Glentoran,5731,11,7,8,15,28,48,-20,29
Cliftonville,5732,1,18,4,8,55,35,20,58
Ballymena,5732,2,17,4,9,63,55,8,55
Crusaders,5732,3,15,6,9,54,40,14,51
Glenavon,5732,4,12,10,8,58,52,6,46
Linfield,5732,5,11,12,7,58,38,20,45
Dungannon,5732,6,12,9,9,55,43,12,45
Coleraine,5732,7,9,10,11,41,43,-2,37
Glentoran,5732,8,10,7,13,33,43,-10,37
Ballinamalla,5732,9,9,2,19,33,63,-30,29
Ards,5732,10,7,7,16,40,53,-13,28
Portadown,5732,11,7,5,18,28,53,-25,26
Linfield,5733,1,19,8,3,71,27,44,65
Crusaders,5733,2,18,8,4,72,40,32,62
Cliftonville,5733,3,14,5,11,57,44,13,47
Coleraine,5733,4,12,11,7,40,34,6,47
Glenavon,5733,5,11,12,7,52,50,2,45
Ballymena,5733,6,12,6,12,53,66,-13,42
Glentoran,5733,7,8,10,12,31,46,-15,34
Dungannon,5733,8,8,7,15,44,48,-4,31
Portadown,5733,9,8,6,16,28,40,-12,30
Ballinamalla,5733,10,8,3,19,38,68,-30,27
Ards,5733,11,7,4,19,36,59,-23,25
Crusaders,5734,1,19,8,3,57,29,28,65
Linfield,5734,2,14,11,5,66,36,30,53
Coleraine,5734,3,13,12,5,49,36,13,51
Ballymena,5734,4,13,6,11,60,66,-6,45
Cliftonville,5734,5,12,8,10,50,46,4,44
Dungannon,5734,6,10,8,12,50,49,1,38
Ards,5734,7,11,4,15,40,47,-7,37
Glenavon,5734,8,9,8,13,49,52,-3,35
Glentoran,5734,9,9,7,14,33,49,-16,34
Portadown,5734,10,6,8,16,26,47,-21,26
Ballinamalla,5734,11,7,4,19,29,52,-23,25
Linfield,5735,1,15,11,4,56,27,29,56
Crusaders,5735,2,15,10,5,48,29,19,55
Cliftonville,5735,3,13,7,10,52,44,8,46
Dungannon,5735,4,11,11,8,66,47,19,44
Coleraine,5735,5,10,14,6,54,47,7,44
Glenavon,5735,6,12,8,10,46,49,-3,44
Ballymena,5735,7,11,8,11,53,63,-10,41
Ballinamalla,5735,8,9,5,16,30,50,-20,32
Ards,5735,9,9,4,17,31,46,-15,31
Glentoran,5735,10,7,8,15,27,40,-13,29
Portadown,5735,11,5,10,15,29,50,-21,25
Linfield,5736,1,17,8,5,65,26,39,59
Crusaders,5736,2,14,11,5,61,40,21,53
Ballymena,5736,3,13,8,9,60,58,2,47
Cliftonville,5736,4,13,5,12,49,42,7,44
Glenavon,5736,5,9,13,8,43,44,-1,40
Dungannon,5736,6,9,12,9,57,53,4,39
Coleraine,5736,7,9,12,9,40,42,-2,39
Ards,5736,8,12,3,15,36,49,-13,39
Glentoran,5736,9,8,10,12,30,42,-12,34
Portadown,5736,10,8,6,16,29,48,-19,30
Ballinamalla,5736,11,7,4,19,31,57,-26,25
Cliftonville,5737,1,15,9,6,50,35,15,54
Crusaders,5737,2,13,10,7,50,35,15,49
Ballymena,5737,3,14,5,11,57,59,-2,47
Linfield,5737,4,13,7,10,48,32,16,46
Dungannon,5737,5,11,11,8,47,35,12,44
Glentoran,5737,6,12,8,10,42,42,0,44
Glenavon,5737,7,10,13,7,48,45,3,43
Coleraine,5737,8,10,10,10,35,36,-1,40
Ballinamalla,5737,9,10,5,15,31,47,-16,35
Portadown,5737,10,7,6,17,28,49,-21,27
Ards,5737,11,5,6,19,31,52,-21,21
Linfield,5738,1,17,9,4,63,31,32,60
Crusaders,5738,2,16,10,4,58,34,24,58
Cliftonville,5738,3,15,9,6,56,37,19,54
Coleraine,5738,4,12,10,8,50,48,2,46
Ballymena,5738,5,13,6,11,55,60,-5,45
Glenavon,5738,6,10,13,7,47,45,2,43
Dungannon,5738,7,9,8,13,48,46,2,35
Ballinamalla,5738,8,10,5,15,37,48,-11,35
Glentoran,5738,9,8,6,16,26,48,-22,30
Ards,5738,10,6,6,18,38,54,-16,24
Portadown,5738,11,5,6,19,26,53,-27,21
Linfield,5739,1,18,7,5,63,25,38,61
Crusaders,5739,2,16,9,5,57,41,16,57
Ballymena,5739,3,17,6,7,65,58,7,57
Cliftonville,5739,4,16,6,8,62,36,26,54
Glenavon,5739,5,12,10,8,52,44,8,46
Dungannon,5739,6,12,6,12,53,45,8,42
Coleraine,5739,7,10,11,9,41,44,-3,41
Glentoran,5739,8,9,9,12,33,50,-17,36
Ards,5739,9,7,5,18,35,50,-15,26
Ballinamalla,5739,10,6,3,21,24,55,-31,21
Portadown,5739,11,4,4,22,22,59,-37,16
Crusaders,5740,1,17,8,5,58,30,28,59
Glenavon,5740,2,14,9,7,54,43,11,51
Linfield,5740,3,13,10,7,66,39,27,49
Ballymena,5740,4,12,10,8,64,64,0,46
Cliftonville,5740,5,13,6,11,51,44,7,45
Dungannon,5740,6,9,12,9,47,46,1,39
Coleraine,5740,7,9,12,9,39,38,1,39
Ards,5740,8,10,6,14,37,47,-10,36
Glentoran,5740,9,8,8,14,27,39,-12,32
Ballinamalla,5740,10,7,7,16,29,51,-22,28
Portadown,5740,11,7,4,19,32,63,-31,25
Ballymena,5741,1,17,5,8,68,50,18,56
Linfield,5741,2,14,10,6,59,38,21,52
Crusaders,5741,3,15,7,8,50,42,8,52
Cliftonville,5741,4,13,7,10,49,42,7,46
Glentoran,5741,5,12,6,12,40,43,-3,42
Glenavon,5741,6,10,11,9,49,44,5,41
Coleraine,5741,7,9,11,10,37,42,-5,38
Portadown,5741,8,10,5,15,25,42,-17,35
Dungannon,5741,9,6,13,11,41,43,-2,31
Ballinamalla,5741,10,8,6,16,28,46,-18,30
Ards,5741,11,8,5,17,34,48,-14,29
Crusaders,5742,1,17,9,4,59,36,23,60
Linfield,5742,2,14,11,5,52,24,28,53
Glenavon,5742,3,14,9,7,52,45,7,51
Cliftonville,5742,4,15,4,11,54,39,15,49
Dungannon,5742,5,11,10,9,50,44,6,43
Coleraine,5742,6,11,9,10,42,40,2,42
Ballymena,5742,7,11,8,11,54,58,-4,41
Glentoran,5742,8,9,10,11,32,43,-11,37
Ards,5742,9,8,6,16,39,52,-13,30
Ballinamalla,5742,10,7,4,19,34,56,-22,25
Portadown,5742,11,6,4,20,21,52,-31,22
Cliftonville,5743,1,17,4,9,61,46,15,55
Linfield,5743,2,14,10,6,67,34,33,52
Crusaders,5743,3,15,7,8,56,36,20,52
Coleraine,5743,4,13,9,8,52,43,9,48
Ballymena,5743,5,14,4,12,61,63,-2,46
Glenavon,5743,6,11,11,8,48,45,3,44
Glentoran,5743,7,10,5,15,32,56,-24,35
Dungannon,5743,8,9,7,14,48,54,-6,34
Ballinamalla,5743,9,10,4,16,33,50,-17,34
Portadown,5743,10,8,6,16,30,46,-16,30
Ards,5743,11,8,5,17,39,54,-15,29
Cliftonville,5744,1,16,6,8,57,42,15,54
Linfield,5744,2,14,10,6,58,33,25,52
Crusaders,5744,3,14,8,8,51,41,10,50
Ballymena,5744,4,15,5,10,62,57,5,50
Coleraine,5744,5,11,12,7,39,34,5,45
Dungannon,5744,6,11,8,11,52,44,8,41
Glenavon,5744,7,10,9,11,55,52,3,39
Ballinamalla,5744,8,8,10,12,34,48,-14,34
Ards,5744,9,7,9,14,35,50,-15,30
Glentoran,5744,10,7,8,15,30,47,-17,29
Portadown,5744,11,7,5,18,21,46,-25,26
Crusaders,5745,1,16,8,6,51,34,17,56
Linfield,5745,2,16,7,7,59,30,29,55
Cliftonville,5745,3,17,4,9,63,45,18,55
Glentoran,5745,4,13,8,9,34,35,-1,47
Ballymena,5745,5,14,5,11,55,58,-3,47
Glenavon,5745,6,12,9,9,50,41,9,45
Coleraine,5745,7,10,9,11,45,41,4,39
Ards,5745,8,11,4,15,42,51,-9,37
Dungannon,5745,9,8,11,11,44,43,1,35
Portadown,5745,10,8,6,16,28,50,-22,30
Ballinamalla,5745,11,3,3,24,20,63,-43,12
Cliftonville,5746,1,18,5,7,61,33,28,59
Linfield,5746,2,14,8,8,58,36,22,50
Glenavon,5746,3,14,8,8,51,47,4,50
Crusaders,5746,4,13,10,7,54,36,18,49
Dungannon,5746,5,12,9,9,59,42,17,45
Glentoran,5746,6,12,7,11,31,40,-9,43
Coleraine,5746,7,10,12,8,55,55,0,42
Ballymena,5746,8,10,7,13,50,60,-10,37
Ards,5746,9,8,7,15,38,50,-12,31
Portadown,5746,10,6,6,18,20,46,-26,24
Ballinamalla,5746,11,5,7,18,25,57,-32,22
Crusaders,5747,1,19,6,5,65,40,25,63
Linfield,5747,2,16,8,6,64,31,33,56
Coleraine,5747,3,14,9,7,50,33,17,51
Glenavon,5747,4,14,9,7,55,43,12,51
Cliftonville,5747,5,14,3,13,50,46,4,45
Ballymena,5747,6,12,6,12,50,60,-10,42
Dungannon,5747,7,11,7,12,48,50,-2,40
Glentoran,5747,8,9,7,14,35,52,-17,34
Portadown,5747,9,6,9,15,30,46,-16,27
Ards,5747,10,7,6,17,37,59,-22,27
Ballinamalla,5747,11,5,6,19,32,56,-24,21
Linfield,5748,1,16,9,5,62,30,32,57
Crusaders,5748,2,15,7,8,54,35,19,52
Cliftonville,5748,3,14,7,9,52,36,16,49
Ballymena,5748,4,13,7,10,59,61,-2,46
Coleraine,5748,5,11,11,8,45,42,3,44
Glenavon,5748,6,11,11,8,42,42,0,44
Glentoran,5748,7,9,10,11,30,45,-15,37
Portadown,5748,8,11,3,16,33,44,-11,36
Dungannon,5748,9,9,8,13,37,43,-6,35
Ballinamalla,5748,10,8,5,17,29,47,-18,29
Ards,5748,11,8,2,20,35,53,-18,26
Cliftonville,5749,1,19,3,8,56,31,25,60
Linfield,5749,2,16,8,6,55,26,29,56
Crusaders,5749,3,14,10,6,51,34,17,52
Ballymena,5749,4,15,7,8,67,56,11,52
Dungannon,5749,5,11,11,8,53,40,13,44
Glenavon,5749,6,10,12,8,47,46,1,42
Coleraine,5749,7,11,8,11,43,44,-1,41
Ards,5749,8,8,4,18,34,51,-17,28
Glentoran,5749,9,6,9,15,31,49,-18,27
Portadown,5749,10,8,3,19,30,59,-29,27
Ballinamalla,5749,11,7,5,18,24,55,-31,26
Crusaders,5750,1,17,7,6,57,30,27,58
Cliftonville,5750,2,18,2,10,55,46,9,56
Glenavon,5750,3,14,9,7,59,46,13,51
Ballymena,5750,4,15,4,11,54,59,-5,49
Linfield,5750,5,11,9,10,50,39,11,42
Dungannon,5750,6,9,12,9,50,47,3,39
Glentoran,5750,7,10,9,11,31,34,-3,39
Coleraine,5750,8,7,11,12,42,47,-5,32
Ballinamalla,5750,9,9,5,16,32,44,-12,32
Ards,5750,10,8,7,15,35,51,-16,31
Portadown,5750,11,7,5,18,26,48,-22,26
Crusaders,5751,1,17,10,3,55,33,22,61
Cliftonville,5751,2,16,4,10,57,39,18,52
Coleraine,5751,3,13,8,9,49,38,11,47
Glenavon,5751,4,11,13,6,59,52,7,46
Ballymena,5751,5,13,7,10,58,56,2,46
Linfield,5751,6,12,8,10,50,38,12,44
Dungannon,5751,7,11,11,8,52,43,9,44
Glentoran,5751,8,11,10,9,35,41,-6,43
Ards,5751,9,6,8,16,34,52,-18,26
Ballinamalla,5751,10,5,6,19,29,55,-26,21
Portadown,5751,11,3,9,18,19,50,-31,18
Crusaders,5752,1,17,8,5,56,32,24,59
Linfield,5752,2,16,8,6,63,34,29,56
Ballymena,5752,3,16,6,8,57,53,4,54
Glenavon,5752,4,14,9,7,51,44,7,51
Cliftonville,5752,5,14,4,12,58,47,11,46
Coleraine,5752,6,10,9,11,39,48,-9,39
Ballinamalla,5752,7,11,3,16,39,54,-15,36
Dungannon,5752,8,9,7,14,47,49,-2,34
Glentoran,5752,9,7,10,13,29,44,-15,31
Portadown,5752,10,8,4,18,35,50,-15,28
Ards,5752,11,7,4,19,40,59,-19,25
Linfield,5753,1,16,9,5,60,30,30,57
Cliftonville,5753,2,17,4,9,52,36,16,55
Glenavon,5753,3,13,12,5,55,45,10,51
Crusaders,5753,4,14,7,9,52,35,17,49
Ballymena,5753,5,14,6,10,59,54,5,48
Coleraine,5753,6,12,8,10,41,40,1,44
Dungannon,5753,7,9,11,10,51,46,5,38
Ards,5753,8,11,4,15,44,54,-10,37
Portadown,5753,9,8,6,16,27,47,-20,30
Glentoran,5753,10,7,4,19,29,53,-24,25
Ballinamalla,5753,11,7,3,20,30,60,-30,24
Linfield,5754,1,17,8,5,61,31,30,59
Crusaders,5754,2,17,4,9,58,36,22,55
Cliftonville,5754,3,16,4,10,48,37,11,52
Ballymena,5754,4,15,4,11,63,62,1,49
Coleraine,5754,5,12,10,8,46,40,6,46
Dungannon,5754,6,10,10,10,47,43,4,40
Glenavon,5754,7,10,9,11,42,46,-4,39
Glentoran,5754,8,10,7,13,30,39,-9,37
Ards,5754,9,11,2,17,36,46,-10,35
Ballinamalla,5754,10,6,6,18,24,48,-24,24
Portadown,5754,11,6,6,18,20,47,-27,24
Crusaders,5755,1,20,7,3,56,23,33,67
Linfield,5755,2,17,9,4,68,31,37,60
Ballymena,5755,3,15,5,10,53,52,1,50
Coleraine,5755,4,11,9,10,40,44,-4,42
Glenavon,5755,5,11,8,11,47,48,-1,41
Cliftonville,5755,6,12,4,14,48,47,1,40
Dungannon,5755,7,9,10,11,45,43,2,37
Ards,5755,8,10,5,15,40,48,-8,35
Portadown,5755,9,9,6,15,25,41,-16,33
Glentoran,5755,10,7,7,16,28,48,-20,28
Ballinamalla,5755,11,7,4,19,25,50,-25,25
Crusaders,5756,1,19,7,4,61,38,23,64
Ballymena,5756,2,16,7,7,60,55,5,55
Linfield,5756,3,15,8,7,66,35,31,53
Dungannon,5756,4,14,7,9,56,39,17,49
Cliftonville,5756,5,14,4,12,49,39,10,46
Coleraine,5756,6,11,10,9,41,35,6,43
Glenavon,5756,7,9,12,9,40,41,-1,39
Ards,5756,8,7,9,14,36,51,-15,30
Glentoran,5756,9,7,6,17,28,53,-25,27
Ballinamalla,5756,10,7,4,19,28,55,-27,25
Portadown,5756,11,4,10,16,23,47,-24,22
Crusaders,5757,1,14,7,9,53,39,14,49
Glenavon,5757,2,13,10,7,58,53,5,49
Cliftonville,5757,3,15,3,12,54,51,3,48
Linfield,5757,4,12,11,7,59,35,24,47
Ballymena,5757,5,13,8,9,57,55,2,47
Dungannon,5757,6,11,8,11,54,44,10,41
Coleraine,5757,7,10,11,9,46,42,4,41
Glentoran,5757,8,11,7,12,32,43,-11,40
Ballinamalla,5757,9,9,7,14,41,53,-12,34
Ards,5757,10,8,5,17,39,57,-18,29
Portadown,5757,11,7,7,16,28,49,-21,28
Crusaders,5758,1,21,6,3,60,26,34,69
Cliftonville,5758,2,16,4,10,57,42,15,52
Linfield,5758,3,14,9,7,62,37,25,51
Ballymena,5758,4,13,5,12,56,63,-7,44
Ards,5758,5,12,5,13,45,46,-1,41
Coleraine,5758,6,9,10,11,39,45,-6,37
Glentoran,5758,7,10,7,13,36,44,-8,37
Dungannon,5758,8,8,10,12,45,44,1,34
Glenavon,5758,9,7,12,11,46,57,-11,33
Portadown,5758,10,9,5,16,25,44,-19,32
Ballinamalla,5758,11,7,5,18,33,56,-23,26
Crusaders,5759,1,16,8,6,53,38,15,56
Linfield,5759,2,14,9,7,60,34,26,51
Cliftonville,5759,3,14,6,10,50,37,13,48
Glenavon,5759,4,12,11,7,51,40,11,47
Coleraine,5759,5,10,12,8,34,32,2,42
Ballymena,5759,6,11,7,12,49,59,-10,40
Ards,5759,7,11,6,13,37,41,-4,39
Dungannon,5759,8,9,8,13,46,50,-4,35
Portadown,5759,9,9,6,15,23,42,-19,33
Glentoran,5759,10,8,7,15,29,43,-14,31
Ballinamalla,5759,11,9,4,17,33,49,-16,31
Crusaders,5760,1,18,6,6,59,35,24,60
Linfield,5760,2,15,9,6,66,38,28,54
Cliftonville,5760,3,14,8,8,52,40,12,50
Glenavon,5760,4,12,11,7,39,39,0,47
Ballymena,5760,5,13,7,10,59,59,0,46
Coleraine,5760,6,11,12,7,45,34,11,45
Dungannon,5760,7,8,9,13,46,50,-4,33
Portadown,5760,8,9,6,15,25,39,-14,33
Glentoran,5760,9,7,10,13,32,46,-14,31
Ards,5760,10,8,6,16,41,49,-8,30
Ballinamalla,5760,11,7,2,21,27,62,-35,23
Crusaders,5761,1,18,9,3,60,30,30,63
Cliftonville,5761,2,15,7,8,57,37,20,52
Linfield,5761,3,13,12,5,68,35,33,51
Ballymena,5761,4,14,8,8,58,62,-4,50
Glenavon,5761,5,12,10,8,51,45,6,46
Coleraine,5761,6,9,13,8,39,41,-2,40
Dungannon,5761,7,9,9,12,56,50,6,36
Ards,5761,8,8,6,16,34,52,-18,30
Glentoran,5761,9,6,11,13,37,54,-17,29
Portadown,5761,10,6,7,17,24,51,-27,25
Ballinamalla,5761,11,7,4,19,23,50,-27,25
Linfield,5762,1,15,11,4,51,23,28,56
Cliftonville,5762,2,16,3,11,49,33,16,51
Dungannon,5762,3,13,9,8,56,38,18,48
Crusaders,5762,4,13,9,8,51,44,7,48
Coleraine,5762,5,12,10,8,42,30,12,46
Ballymena,5762,6,12,9,9,52,55,-3,45
Glenavon,5762,7,10,10,10,39,40,-1,40
Ards,5762,8,9,6,15,39,53,-14,33
Portadown,5762,9,8,7,15,27,40,-13,31
Glentoran,5762,10,8,7,15,32,51,-19,31
Ballinamalla,5762,11,5,7,18,25,56,-31,22
Crusaders,5763,1,17,4,9,59,41,18,55
Cliftonville,5763,2,16,4,10,60,37,23,52
Linfield,5763,3,14,9,7,52,29,23,51
Dungannon,5763,4,13,9,8,53,44,9,48
Coleraine,5763,5,12,10,8,42,34,8,46
Ballymena,5763,6,12,7,11,50,56,-6,43
Glenavon,5763,7,11,9,10,50,50,0,42
Glentoran,5763,8,8,10,12,26,39,-13,34
Ballinamalla,5763,9,10,4,16,31,48,-17,34
Ards,5763,10,8,5,17,34,50,-16,29
Portadown,5763,11,7,3,20,22,51,-29,24
Crusaders,5764,1,13,11,6,47,34,13,50
Ballymena,5764,2,14,8,8,62,54,8,50
Cliftonville,5764,3,15,3,12,53,49,4,48
Linfield,5764,4,11,11,8,51,37,14,44
Glenavon,5764,5,11,11,8,46,41,5,44
Coleraine,5764,6,10,12,8,43,38,5,42
Ballinamalla,5764,7,12,2,16,36,53,-17,38
Dungannon,5764,8,9,10,11,51,43,8,37
Ards,5764,9,9,8,13,38,44,-6,35
Glentoran,5764,10,8,11,11,34,43,-9,35
Portadown,5764,11,6,7,17,25,50,-25,25
Crusaders,5765,1,17,8,5,60,33,27,59
Cliftonville,5765,2,16,6,8,63,39,24,54
Ballymena,5765,3,16,3,11,64,62,2,51
Linfield,5765,4,13,11,6,56,31,25,50
Glenavon,5765,5,12,9,9,46,47,-1,45
Coleraine,5765,6,10,11,9,43,44,-1,41
Ballinamalla,5765,7,9,6,15,36,48,-12,33
Portadown,5765,8,9,5,16,37,50,-13,32
Dungannon,5765,9,6,11,13,49,51,-2,29
Ards,5765,10,7,8,15,41,64,-23,29
Glentoran,5765,11,6,10,14,29,55,-26,28
Crusaders,5766,1,18,7,5,58,30,28,61
Ballymena,5766,2,17,6,7,63,49,14,57
Cliftonville,5766,3,15,6,9,59,47,12,51
Linfield,5766,4,12,9,9,52,35,17,45
Glentoran,5766,5,11,5,14,46,52,-6,38
Coleraine,5766,6,9,11,10,40,49,-9,38
Dungannon,5766,7,9,10,11,42,41,1,37
Glenavon,5766,8,8,11,11,41,48,-7,35
Ards,5766,9,10,4,16,43,48,-5,34
Portadown,5766,10,9,6,15,28,44,-16,33
Ballinamalla,5766,11,7,5,18,23,52,-29,26
Crusaders,5767,1,17,7,6,51,36,15,58
Cliftonville,5767,2,16,2,12,53,36,17,50
Ballymena,5767,3,14,8,8,53,57,-4,50
Linfield,5767,4,14,7,9,54,31,23,49
Coleraine,5767,5,12,11,7,39,31,8,47
Dungannon,5767,6,11,9,10,52,39,13,42
Glenavon,5767,7,10,10,10,47,45,2,40
Glentoran,5767,8,8,9,13,30,42,-12,33
Ballinamalla,5767,9,9,6,15,28,43,-15,33
Portadown,5767,10,8,4,18,26,50,-24,28
Ards,5767,11,7,5,18,33,56,-23,26
Linfield,5768,1,15,8,7,57,33,24,53
Glenavon,5768,2,14,10,6,53,41,12,52
Cliftonville,5768,3,15,6,9,50,38,12,51
Ballymena,5768,4,16,3,11,59,56,3,51
Coleraine,5768,5,14,9,7,43,40,3,51
Crusaders,5768,6,13,6,11,50,44,6,45
Glentoran,5768,7,10,8,12,35,44,-9,38
Dungannon,5768,8,9,9,12,54,49,5,36
Portadown,5768,9,8,5,17,28,43,-15,29
Ards,5768,10,7,5,18,36,50,-14,26
Ballinamalla,5768,11,6,7,17,27,54,-27,25
Crusaders,5769,1,18,5,7,52,30,22,59
Cliftonville,5769,2,15,7,8,46,34,12,52
Ballymena,5769,3,15,6,9,61,52,9,51
Linfield,5769,4,14,8,8,51,31,20,50
Coleraine,5769,5,10,11,9,44,39,5,41
Glenavon,5769,6,9,12,9,46,46,0,39
Portadown,5769,7,10,5,15,30,44,-14,35
Dungannon,5769,8,9,7,14,45,52,-7,34
Glentoran,5769,9,9,7,14,31,43,-12,34
Ballinamalla,5769,10,10,3,17,35,52,-17,33
Ards,5769,11,8,5,17,37,55,-18,29
Crusaders,5770,1,16,9,5,56,31,25,57
Coleraine,5770,2,14,9,7,50,37,13,51
Ballymena,5770,3,15,5,10,61,53,8,50
Linfield,5770,4,13,8,9,57,39,18,47
Cliftonville,5770,5,14,5,11,53,48,5,47
Glenavon,5770,6,12,9,9,47,45,2,45
Ards,5770,7,10,7,13,41,44,-3,37
Portadown,5770,8,9,7,14,26,47,-21,34
Dungannon,5770,9,8,9,13,51,50,1,33
Glentoran,5770,10,6,9,15,24,47,-23,27
Ballinamalla,5770,11,7,5,18,28,53,-25,26
Cliftonville,5771,1,17,5,8,60,37,23,56
Crusaders,5771,2,15,6,9,52,38,14,51
Linfield,5771,3,12,11,7,63,38,25,47
Glenavon,5771,4,12,10,8,46,44,2,46
Dungannon,5771,5,12,9,9,62,43,19,45
Ballymena,5771,6,12,7,11,52,60,-8,43
Ards,5771,7,12,6,12,36,38,-2,42
Coleraine,5771,8,8,11,11,38,46,-8,35
Ballinamalla,5771,9,10,2,18,35,56,-21,32
Glentoran,5771,10,8,7,15,30,49,-19,31
Portadown,5771,11,7,6,17,24,49,-25,27
Crusaders,5772,1,17,7,6,53,27,26,58
Ballymena,5772,2,14,7,9,60,55,5,49
Coleraine,5772,3,13,9,8,43,34,9,48
Linfield,5772,4,12,10,8,49,36,13,46
Cliftonville,5772,5,12,7,11,54,47,7,43
Dungannon,5772,6,10,12,8,48,39,9,42
Glenavon,5772,7,10,11,9,48,48,0,41
Ards,5772,8,9,8,13,39,46,-7,35
Glentoran,5772,9,7,10,13,32,50,-18,31
Ballinamalla,5772,10,8,4,18,31,51,-20,28
Portadown,5772,11,7,7,16,29,53,-24,28
Linfield,5773,1,15,10,5,60,33,27,55
Cliftonville,5773,2,16,5,9,51,33,18,53
Crusaders,5773,3,14,8,8,55,35,20,50
Glenavon,5773,4,12,10,8,48,45,3,46
Coleraine,5773,5,12,10,8,38,36,2,46
Ballymena,5773,6,12,7,11,49,56,-7,43
Glentoran,5773,7,10,8,12,30,42,-12,38
Dungannon,5773,8,8,11,11,48,45,3,35
Ballinamalla,5773,9,10,4,16,33,51,-18,34
Portadown,5773,10,7,5,18,28,48,-20,26
Ards,5773,11,5,10,15,33,49,-16,25
Cliftonville,5774,1,18,5,7,58,35,23,59
Crusaders,5774,2,16,8,6,58,39,19,56
Linfield,5774,3,11,14,5,51,32,19,47
Ballymena,5774,4,12,8,10,59,63,-4,44
Coleraine,5774,5,9,14,7,46,42,4,41
Glentoran,5774,6,10,11,9,34,39,-5,41
Glenavon,5774,7,9,13,8,41,41,0,40
Dungannon,5774,8,8,8,14,50,51,-1,32
Ballinamalla,5774,9,7,8,15,27,46,-19,29
Ards,5774,10,6,10,14,33,47,-14,28
Portadown,5774,11,5,9,16,27,49,-22,24
Linfield,5775,1,15,10,5,61,27,34,55
Cliftonville,5775,2,16,4,10,57,44,13,52
Crusaders,5775,3,13,10,7,51,36,15,49
Ballymena,5775,4,14,5,11,58,60,-2,47
Coleraine,5775,5,11,12,7,40,34,6,45
Dungannon,5775,6,11,9,10,50,41,9,42
Glenavon,5775,7,9,15,6,54,48,6,42
Ballinamalla,5775,8,11,5,14,31,50,-19,38
Portadown,5775,9,7,7,16,24,50,-26,28
Glentoran,5775,10,6,9,15,24,40,-16,27
Ards,5775,11,5,8,17,36,56,-20,23
Linfield,5776,1,16,9,5,59,29,30,57
Cliftonville,5776,2,17,5,8,55,31,24,56
Crusaders,5776,3,16,7,7,59,40,19,55
Coleraine,5776,4,15,9,6,52,34,18,54
Glenavon,5776,5,12,11,7,46,40,6,47
Ballymena,5776,6,13,4,13,61,61,0,43
Dungannon,5776,7,11,7,12,59,57,2,40
Glentoran,5776,8,6,11,13,25,44,-19,29
Ballinamalla,5776,9,7,7,16,37,61,-24,28
Ards,5776,10,5,9,16,32,55,-23,24
Portadown,5776,11,5,5,20,24,57,-33,20
Cliftonville,5777,1,17,4,9,51,36,15,55
Crusaders,5777,2,14,9,7,51,36,15,51
Glenavon,5777,3,13,9,8,51,39,12,48
Linfield,5777,4,11,12,7,52,32,20,45
Coleraine,5777,5,11,12,7,40,36,4,45
Ballymena,5777,6,13,6,11,58,55,3,45
Ards,5777,7,10,7,13,40,43,-3,37
Dungannon,5777,8,9,9,12,47,56,-9,36
Glentoran,5777,9,10,5,15,30,40,-10,35
Ballinamalla,5777,10,8,6,16,29,52,-23,30
Portadown,5777,11,6,7,17,24,48,-24,25
Ballymena,5778,1,17,6,7,60,49,11,57
Crusaders,5778,2,15,10,5,51,31,20,55
Linfield,5778,3,15,8,7,59,34,25,53
Cliftonville,5778,4,15,3,12,58,46,12,48
Glentoran,5778,5,11,8,11,36,43,-7,41
Portadown,5778,6,12,4,14,33,42,-9,40
Coleraine,5778,7,9,11,10,36,36,0,38
Glenavon,5778,8,9,11,10,49,50,-1,38
Dungannon,5778,9,8,10,12,48,50,-2,34
Ballinamalla,5778,10,7,6,17,25,48,-23,27
Ards,5778,11,4,9,17,31,57,-26,21
Linfield,5779,1,17,8,5,70,34,36,59
Crusaders,5779,2,15,8,7,59,40,19,53
Cliftonville,5779,3,14,5,11,48,36,12,47
Glentoran,5779,4,13,7,10,43,40,3,46
Coleraine,5779,5,10,12,8,41,43,-2,42
Ballymena,5779,6,11,9,10,56,59,-3,42
Glenavon,5779,7,10,10,10,47,45,2,40
Dungannon,5779,8,10,9,11,46,47,-1,39
Ballinamalla,5779,9,9,6,15,36,49,-13,33
Portadown,5779,10,8,4,18,22,46,-24,28
Ards,5779,11,6,6,18,33,62,-29,24
Ballymena,5780,1,17,7,6,62,49,13,58
Crusaders,5780,2,16,6,8,52,35,17,54
Cliftonville,5780,3,15,7,8,56,38,18,52
Linfield,5780,4,11,9,10,51,35,16,42
Coleraine,5780,5,11,9,10,45,45,0,42
Dungannon,5780,6,10,9,11,50,48,2,39
Glenavon,5780,7,10,9,11,47,52,-5,39
Ards,5780,8,10,8,12,41,45,-4,38
Ballinamalla,5780,9,8,7,15,28,49,-21,31
Glentoran,5780,10,7,8,15,31,45,-14,29
Portadown,5780,11,7,7,16,28,50,-22,28
Linfield,5781,1,16,7,7,62,34,28,55
Cliftonville,5781,2,15,5,10,53,44,9,50
Ballymena,5781,3,14,6,10,59,54,5,48
Crusaders,5781,4,13,7,10,51,41,10,46
Dungannon,5781,5,12,9,9,54,43,11,45
Coleraine,5781,6,11,12,7,43,35,8,45
Glenavon,5781,7,9,11,10,39,46,-7,38
Glentoran,5781,8,10,7,13,32,47,-15,37
Portadown,5781,9,10,5,15,32,45,-13,35
Ards,5781,10,9,6,15,39,49,-10,33
Ballinamalla,5781,11,6,5,19,26,52,-26,23
Crusaders,5782,1,16,7,7,53,42,11,55
Coleraine,5782,2,13,13,4,55,36,19,52
Cliftonville,5782,3,15,5,10,55,43,12,50
Linfield,5782,4,13,10,7,59,33,26,49
Glenavon,5782,5,12,11,7,51,48,3,47
Ballymena,5782,6,12,7,11,60,66,-6,43
Dungannon,5782,7,8,12,10,49,43,6,36
Glentoran,5782,8,8,11,11,33,45,-12,35
Ballinamalla,5782,9,9,7,14,33,43,-10,34
Ards,5782,10,8,4,18,36,55,-19,28
Portadown,5782,11,6,3,21,27,57,-30,21
Crusaders,5783,1,19,6,5,63,29,34,63
Glenavon,5783,2,13,10,7,52,48,4,49
Linfield,5783,3,13,8,9,52,35,17,47
Cliftonville,5783,4,13,7,10,48,40,8,46
Coleraine,5783,5,11,12,7,47,34,13,45
Ballymena,5783,6,12,9,9,54,55,-1,45
Dungannon,5783,7,9,11,10,48,43,5,38
Glentoran,5783,8,9,7,14,32,48,-16,34
Ballinamalla,5783,9,8,6,16,30,52,-22,30
Ards,5783,10,6,8,16,33,51,-18,26
Portadown,5783,11,6,8,16,20,44,-24,26
Crusaders,5784,1,17,5,8,62,45,17,56
Linfield,5784,2,14,8,8,58,33,25,50
Cliftonville,5784,3,14,8,8,58,43,15,50
Ballymena,5784,4,13,9,8,58,55,3,48
Glenavon,5784,5,10,13,7,46,40,6,43
Dungannon,5784,6,10,11,9,43,41,2,41
Coleraine,5784,7,10,10,10,39,45,-6,40
Ards,5784,8,11,4,15,37,44,-7,37
Ballinamalla,5784,9,9,7,14,30,45,-15,34
Glentoran,5784,10,8,6,16,35,51,-16,30
Portadown,5784,11,6,5,19,22,46,-24,23
Crusaders,5785,1,15,9,6,51,30,21,54
Cliftonville,5785,2,16,6,8,52,35,17,54
Linfield,5785,3,13,9,8,58,35,23,48
Ballymena,5785,4,13,7,10,61,59,2,46
Coleraine,5785,5,11,11,8,46,36,10,44
Glenavon,5785,6,10,13,7,50,45,5,43
Dungannon,5785,7,9,10,11,56,51,5,37
Ards,5785,8,11,3,16,38,52,-14,36
Ballinamalla,5785,9,10,6,14,36,51,-15,36
Portadown,5785,10,7,6,17,25,50,-25,27
Glentoran,5785,11,7,6,17,26,55,-29,27
Crusaders,5786,1,17,6,7,50,32,18,57
Linfield,5786,2,16,7,7,67,33,34,55
Coleraine,5786,3,14,8,8,42,36,6,50
Cliftonville,5786,4,15,4,11,48,40,8,49
Dungannon,5786,5,13,8,9,51,40,11,47
Glenavon,5786,6,11,12,7,48,38,10,45
Glentoran,5786,7,9,7,14,28,48,-20,34
Ards,5786,8,9,5,16,44,48,-4,32
Ballymena,5786,9,8,8,14,50,62,-12,32
Portadown,5786,10,8,5,17,26,48,-22,29
Ballinamalla,5786,11,8,4,18,28,57,-29,28
Crusaders,5787,1,18,5,7,61,38,23,59
Linfield,5787,2,15,9,6,62,30,32,54
Ballymena,5787,3,14,6,10,67,62,5,48
Cliftonville,5787,4,14,5,11,48,40,8,47
Glenavon,5787,5,11,10,9,41,38,3,43
Coleraine,5787,6,10,10,10,39,41,-2,40
Glentoran,5787,7,11,6,13,32,49,-17,39
Ards,5787,8,11,5,14,42,48,-6,38
Dungannon,5787,9,8,11,11,44,41,3,35
Portadown,5787,10,8,5,17,24,46,-22,29
Ballinamalla,5787,11,7,4,19,30,57,-27,25
Crusaders,5788,1,16,8,6,55,39,16,56
Linfield,5788,2,14,11,5,56,22,34,53
Cliftonville,5788,3,16,4,10,57,46,11,52
Ballymena,5788,4,13,8,9,59,60,-1,47
Glenavon,5788,5,11,11,8,46,44,2,44
Dungannon,5788,6,10,12,8,47,38,9,42
Coleraine,5788,7,10,10,10,55,50,5,40
Portadown,5788,8,9,5,16,31,45,-14,32
Glentoran,5788,9,7,10,13,34,53,-19,31
Ballinamalla,5788,10,9,3,18,33,49,-16,30
Ards,5788,11,6,6,18,30,57,-27,24
Ballymena,5789,1,17,3,10,68,61,7,54
Linfield,5789,2,15,7,8,59,34,25,52
Glenavon,5789,3,14,8,8,46,38,8,50
Crusaders,5789,4,14,7,9,51,39,12,49
Coleraine,5789,5,13,10,7,49,37,12,49
Cliftonville,5789,6,14,4,12,48,43,5,46
Glentoran,5789,7,9,8,13,34,43,-9,35
Ards,5789,8,9,7,14,40,56,-16,34
Dungannon,5789,9,8,8,14,39,43,-4,32
Ballinamalla,5789,10,8,6,16,35,52,-17,30
Portadown,5789,11,6,8,16,20,43,-23,26
Linfield,5790,1,15,9,6,67,38,29,54
Crusaders,5790,2,15,8,7,60,38,22,53
Glenavon,5790,3,13,10,7,50,41,9,49
Ballymena,5790,4,13,10,7,60,55,5,49
Coleraine,5790,5,10,11,9,40,37,3,41
Cliftonville,5790,6,11,8,11,46,49,-3,41
Glentoran,5790,7,10,8,12,31,42,-11,38
Dungannon,5790,8,9,9,12,44,43,1,36
Portadown,5790,9,9,7,14,28,45,-17,34
Ards,5790,10,8,5,17,35,50,-15,29
Ballinamalla,5790,11,6,7,17,28,51,-23,25
Crusaders,5791,1,17,7,6,60,35,25,58
Linfield,5791,2,14,9,7,64,37,27,51
Cliftonville,5791,3,16,3,11,60,46,14,51
Glenavon,5791,4,13,10,7,53,44,9,49
Ballymena,5791,5,14,6,10,56,57,-1,48
Coleraine,5791,6,11,11,8,40,36,4,44
Dungannon,5791,7,9,11,10,47,42,5,38
Glentoran,5791,8,9,7,14,30,42,-12,34
Ards,5791,9,9,5,16,37,56,-19,32
Portadown,5791,10,7,5,18,28,49,-21,26
Ballinamalla,5791,11,6,6,18,31,62,-31,24
Ballymena,5792,1,17,6,7,59,52,7,57
Crusaders,5792,2,16,8,6,53,30,23,56
Cliftonville,5792,3,15,4,11,56,40,16,49
Linfield,5792,4,13,9,8,59,35,24,48
Dungannon,5792,5,13,8,9,51,37,14,47
Coleraine,5792,6,12,10,8,40,35,5,46
Glenavon,5792,7,10,11,9,42,42,0,41
Ards,5792,8,11,2,17,36,51,-15,35
Glentoran,5792,9,7,7,16,26,47,-21,28
Portadown,5792,10,6,7,17,20,46,-26,25
Ballinamalla,5792,11,7,4,19,26,53,-27,25
Linfield,5793,1,18,7,5,64,26,38,61
Cliftonville,5793,2,16,6,8,51,34,17,54
Crusaders,5793,3,15,9,6,48,31,17,54
Ballymena,5793,4,14,4,12,60,61,-1,46
Glenavon,5793,5,12,8,10,51,47,4,44
Dungannon,5793,6,10,13,7,53,42,11,43
Ards,5793,7,11,5,14,43,49,-6,38
Coleraine,5793,8,9,10,11,31,36,-5,37
Glentoran,5793,9,7,9,14,39,57,-18,30
Portadown,5793,10,7,5,18,23,48,-25,26
Ballinamalla,5793,11,6,4,20,27,59,-32,22
Crusaders,5794,1,19,6,5,56,27,29,63
Cliftonville,5794,2,16,3,11,49,44,5,51
Linfield,5794,3,11,12,7,54,38,16,45
Glenavon,5794,4,12,9,9,45,40,5,45
Coleraine,5794,5,10,12,8,37,33,4,42
Ballymena,5794,6,11,7,12,49,56,-7,40
Dungannon,5794,7,10,8,12,45,41,4,38
Glentoran,5794,8,8,11,11,26,39,-13,35
Ballinamalla,5794,9,8,7,15,32,45,-13,31
Portadown,5794,10,8,7,15,31,45,-14,31
Ards,5794,11,8,6,16,35,51,-16,30
Linfield,5795,1,14,11,5,56,26,30,53
Crusaders,5795,2,15,8,7,49,31,18,53
Coleraine,5795,3,12,11,7,39,33,6,47
Ballymena,5795,4,13,7,10,53,54,-1,46
Cliftonville,5795,5,12,8,10,44,38,6,44
Dungannon,5795,6,11,10,9,53,40,13,43
Glentoran,5795,7,12,6,12,39,45,-6,42
Ards,5795,8,10,6,14,33,44,-11,36
Glenavon,5795,9,8,10,12,36,45,-9,34
Portadown,5795,10,7,6,17,24,45,-21,27
Ballinamalla,5795,11,7,5,18,27,52,-25,26
Crusaders,5796,1,19,5,6,58,33,25,62
Ballymena,5796,2,15,6,9,60,57,3,51
Cliftonville,5796,3,15,5,10,54,37,17,50
Glenavon,5796,4,13,11,6,60,48,12,50
Linfield,5796,5,13,9,8,56,36,20,48
Coleraine,5796,6,11,11,8,43,43,0,44
Glentoran,5796,7,11,6,13,34,44,-10,39
Dungannon,5796,8,9,8,13,48,52,-4,35
Ards,5796,9,8,5,17,38,49,-11,29
Portadown,5796,10,7,4,19,24,48,-24,25
Ballinamalla,5796,11,7,4,19,28,56,-28,25
Linfield,5797,1,15,11,4,61,33,28,56
Crusaders,5797,2,15,8,7,57,36,21,53
Cliftonville,5797,3,14,8,8,51,40,11,50
Ballymena,5797,4,13,7,10,58,60,-2,46
Glenavon,5797,5,11,12,7,52,47,5,45
Coleraine,5797,6,10,12,8,47,45,2,42
Dungannon,5797,7,10,8,12,49,48,1,38
Ballinamalla,5797,8,9,6,15,35,51,-16,33
Glentoran,5797,9,7,10,13,30,48,-18,31
Portadown,5797,10,7,7,16,32,49,-17,28
Ards,5797,11,7,5,18,38,53,-15,26
Crusaders,5798,1,17,8,5,54,28,26,59
Linfield,5798,2,13,9,8,56,33,23,48
Glenavon,5798,3,13,9,8,52,48,4,48
Cliftonville,5798,4,14,5,11,52,43,9,47
Ballymena,5798,5,14,5,11,56,57,-1,47
Glentoran,5798,6,11,7,12,34,44,-10,40
Dungannon,5798,7,11,6,13,57,48,9,39
Coleraine,5798,8,10,7,13,39,46,-7,37
Portadown,5798,9,9,6,15,30,45,-15,33
Ards,5798,10,9,5,16,35,46,-11,32
Ballinamalla,5798,11,8,5,17,26,53,-27,29
Ballymena,5799,1,17,7,6,71,53,18,58
Linfield,5799,2,14,12,4,60,28,32,54
Glenavon,5799,3,13,11,6,49,40,9,50
Cliftonville,5799,4,14,5,11,46,41,5,47
Crusaders,5799,5,12,10,8,50,34,16,46
Dungannon,5799,6,11,8,11,47,37,10,41
Glentoran,5799,7,10,8,12,31,44,-13,38
Coleraine,5799,8,7,12,11,32,43,-11,33
Ards,5799,9,7,9,14,33,47,-14,30
Ballinamalla,5799,10,8,5,17,26,50,-24,29
Portadown,5799,11,5,7,18,20,48,-28,22
Crusaders,5800,1,18,8,4,56,34,22,62
Linfield,5800,2,15,12,3,58,29,29,57
Cliftonville,5800,3,14,5,11,59,45,14,47
Ballymena,5800,4,13,8,9,65,59,6,47
Glenavon,5800,5,13,7,10,52,42,10,46
Coleraine,5800,6,12,8,10,46,47,-1,44
Glentoran,5800,7,9,8,13,31,42,-11,35
Portadown,5800,8,9,6,15,28,45,-17,33
Dungannon,5800,9,8,8,14,42,49,-7,32
Ballinamalla,5800,10,9,4,17,30,52,-22,31
Ards,5800,11,5,6,19,33,56,-23,21
Cliftonville,5801,1,16,8,6,63,34,29,56
Linfield,5801,2,15,10,5,57,32,25,55
Crusaders,5801,3,13,9,8,53,38,15,48
Ballymena,5801,4,13,7,10,52,60,-8,46
Glenavon,5801,5,11,10,9,48,47,1,43
Dungannon,5801,6,9,13,8,46,41,5,40
Coleraine,5801,7,9,9,12,41,45,-4,36
Ballinamalla,5801,8,10,5,15,34,46,-12,35
Ards,5801,9,9,7,14,37,44,-7,34
Glentoran,5801,10,7,9,14,28,47,-19,30
Portadown,5801,11,6,7,17,21,46,-25,25
Linfield,5802,1,15,11,4,65,30,35,56
Cliftonville,5802,2,17,5,8,57,36,21,56
Crusaders,5802,3,16,8,6,54,40,14,56
Ballymena,5802,4,13,6,11,56,59,-3,45
Coleraine,5802,5,10,12,8,38,37,1,42
Glentoran,5802,6,10,10,10,30,33,-3,40
Glenavon,5802,7,8,13,9,44,48,-4,37
Dungannon,5802,8,7,13,10,42,43,-1,34
Ards,5802,9,7,7,16,34,51,-17,28
Ballinamalla,5802,10,7,6,17,31,50,-19,27
Portadown,5802,11,5,9,16,19,43,-24,24
Crusaders,5803,1,16,7,7,52,37,15,55
Ballymena,5803,2,17,4,9,59,52,7,55
Cliftonville,5803,3,14,7,9,49,31,18,49
Linfield,5803,4,13,9,8,51,30,21,48
Glenavon,5803,5,12,11,7,39,38,1,47
Ards,5803,6,13,4,13,44,48,-4,43
Coleraine,5803,7,10,10,10,36,37,-1,40
Dungannon,5803,8,9,9,12,46,44,2,36
Ballinamalla,5803,9,9,3,18,29,45,-16,30
Glentoran,5803,10,7,7,16,26,46,-20,28
Portadown,5803,11,7,5,18,24,47,-23,26
Crusaders,5804,1,17,8,5,60,34,26,59
Cliftonville,5804,2,17,3,10,58,44,14,54
Linfield,5804,3,14,8,8,62,37,25,50
Ballymena,5804,4,14,7,9,64,61,3,49
Coleraine,5804,5,10,12,8,40,37,3,42
Glenavon,5804,6,10,12,8,42,45,-3,42
Ballinamalla,5804,7,12,5,13,35,51,-16,41
Dungannon,5804,8,8,11,11,53,47,6,35
Glentoran,5804,9,9,7,14,30,45,-15,34
Ards,5804,10,6,9,15,45,60,-15,27
Portadown,5804,11,4,6,20,17,45,-28,18
Linfield,5805,1,15,10,5,55,29,26,55
Glenavon,5805,2,13,12,5,57,45,12,51
Cliftonville,5805,3,16,2,12,54,41,13,50
Crusaders,5805,4,12,11,7,48,33,15,47
Ballymena,5805,5,13,7,10,59,60,-1,46
Coleraine,5805,6,10,12,8,45,44,1,42
Dungannon,5805,7,9,10,11,44,47,-3,37
Glentoran,5805,8,9,8,13,34,49,-15,35
Ballinamalla,5805,9,8,6,16,30,49,-19,30
Ards,5805,10,7,7,16,38,49,-11,28
Portadown,5805,11,6,9,15,24,42,-18,27
Ballymena,5806,1,16,5,9,72,56,16,53
Crusaders,5806,2,14,8,8,58,38,20,50
Linfield,5806,3,13,8,9,56,42,14,47
Cliftonville,5806,4,13,7,10,51,44,7,46
Glenavon,5806,5,12,9,9,50,40,10,45
Glentoran,5806,6,11,6,13,37,47,-10,39
Coleraine,5806,7,10,8,12,43,49,-6,38
Ards,5806,8,10,6,14,40,51,-11,36
Portadown,5806,9,10,6,14,27,40,-13,36
Dungannon,5806,10,8,10,12,45,47,-2,34
Ballinamalla,5806,11,9,5,16,31,56,-25,32
Crusaders,5807,1,19,5,6,55,28,27,62
Ballymena,5807,2,16,8,6,68,55,13,56
Glenavon,5807,3,13,8,9,49,47,2,47
Linfield,5807,4,11,10,9,52,41,11,43
Cliftonville,5807,5,12,6,12,51,46,5,42
Coleraine,5807,6,10,11,9,45,40,5,41
Dungannon,5807,7,10,8,12,47,45,2,38
Ards,5807,8,10,5,15,37,45,-8,35
Glentoran,5807,9,9,6,15,40,49,-9,33
Ballinamalla,5807,10,10,2,18,28,50,-22,32
Portadown,5807,11,8,5,17,23,49,-26,29
Crusaders,5808,1,18,7,5,63,36,27,61
Ballymena,5808,2,15,6,9,59,58,1,51
Linfield,5808,3,14,8,8,54,33,21,50
Coleraine,5808,4,11,12,7,47,37,10,45
Dungannon,5808,5,11,11,8,51,39,12,44
Cliftonville,5808,6,12,5,13,51,53,-2,41
Ards,5808,7,12,5,13,51,56,-5,41
Glenavon,5808,8,6,14,10,44,51,-7,32
Portadown,5808,9,8,8,14,29,39,-10,32
Glentoran,5808,10,8,8,14,34,54,-20,32
Ballinamalla,5808,11,4,8,18,30,57,-27,20
Crusaders,5809,1,17,8,5,59,41,18,59
Linfield,5809,2,14,8,8,62,37,25,50
Cliftonville,5809,3,14,6,10,50,41,9,48
Ballymena,5809,4,13,7,10,60,63,-3,46
Dungannon,5809,5,12,9,9,58,43,15,45
Glenavon,5809,6,10,9,11,45,46,-1,39
Ballinamalla,5809,7,11,4,15,37,48,-11,37
Glentoran,5809,8,9,8,13,30,45,-15,35
Coleraine,5809,9,7,12,11,37,47,-10,33
Ards,5809,10,8,7,15,39,47,-8,31
Portadown,5809,11,9,4,17,26,45,-19,31
Ballymena,5810,1,18,6,6,61,49,12,60
Crusaders,5810,2,17,8,5,55,30,25,59
Linfield,5810,3,15,9,6,50,26,24,54
Cliftonville,5810,4,14,4,12,56,39,17,46
Coleraine,5810,5,12,10,8,42,42,0,46
Glentoran,5810,6,11,8,11,35,35,0,41
Glenavon,5810,7,10,9,11,48,46,2,39
Dungannon,5810,8,9,8,13,50,49,1,35
Ards,5810,9,8,7,15,36,48,-12,31
Ballinamalla,5810,10,7,5,18,31,58,-27,26
Portadown,5810,11,5,4,21,20,62,-42,19
Ballymena,5811,1,16,7,7,53,49,4,55
Crusaders,5811,2,14,10,6,57,42,15,52
Linfield,5811,3,14,9,7,62,34,28,51
Glenavon,5811,4,14,9,7,54,39,15,51
Cliftonville,5811,5,14,6,10,52,44,8,48
Coleraine,5811,6,11,12,7,41,38,3,45
Dungannon,5811,7,9,10,11,49,43,6,37
Ards,5811,8,9,5,16,39,49,-10,32
Portadown,5811,9,6,9,15,23,43,-20,27
Glentoran,5811,10,6,9,15,28,52,-24,27
Ballinamalla,5811,11,6,6,18,25,50,-25,24
Cliftonville,5812,1,17,4,9,52,42,10,55
Ballymena,5812,2,16,6,8,68,60,8,54
Crusaders,5812,3,15,7,8,57,37,20,52
Linfield,5812,4,12,9,9,58,44,14,45
Coleraine,5812,5,11,10,9,43,42,1,43
Glenavon,5812,6,9,11,10,45,47,-2,38
Dungannon,5812,7,9,9,12,55,51,4,36
Ards,5812,8,9,8,13,42,50,-8,35
Glentoran,5812,9,8,10,12,30,40,-10,34
Portadown,5812,10,9,5,16,29,48,-19,32
Ballinamalla,5812,11,7,7,16,36,54,-18,28
Crusaders,5813,1,22,4,4,66,28,38,70
Linfield,5813,2,15,11,4,62,33,29,56
Coleraine,5813,3,14,9,7,53,36,17,51
Cliftonville,5813,4,13,7,10,50,43,7,46
Ballymena,5813,5,12,8,10,54,60,-6,44
Glenavon,5813,6,9,11,10,39,44,-5,38
Ballinamalla,5813,7,11,4,15,35,48,-13,37
Dungannon,5813,8,7,10,13,49,54,-5,31
Glentoran,5813,9,9,4,17,29,46,-17,31
Ards,5813,10,6,8,16,39,59,-20,26
Portadown,5813,11,5,8,17,21,46,-25,23
Crusaders,5814,1,17,10,3,55,30,25,61
Ballymena,5814,2,17,4,9,60,57,3,55
Cliftonville,5814,3,15,6,9,52,39,13,51
Glenavon,5814,4,13,10,7,47,38,9,49
Linfield,5814,5,14,6,10,60,41,19,48
Ards,5814,6,11,5,14,44,52,-8,38
Coleraine,5814,7,8,10,12,38,43,-5,34
Glentoran,5814,8,9,5,16,37,50,-13,32
Portadown,5814,9,8,7,15,28,45,-17,31
Ballinamalla,5814,10,8,5,17,34,54,-20,29
Dungannon,5814,11,6,10,14,44,50,-6,28
Crusaders,5815,1,19,9,2,55,23,32,66
Linfield,5815,2,16,9,5,63,31,32,57
Ballymena,5815,3,15,4,11,57,56,1,49
Cliftonville,5815,4,14,5,11,59,45,14,47
Glenavon,5815,5,11,13,6,47,40,7,46
Dungannon,5815,6,10,11,9,45,40,5,41
Coleraine,5815,7,10,11,9,43,43,0,41
Portadown,5815,8,8,5,17,23,44,-21,29
Ballinamalla,5815,9,8,4,18,30,52,-22,28
Ards,5815,10,7,4,19,38,59,-21,25
Glentoran,5815,11,5,9,16,25,52,-27,24
Crusaders,5816,1,16,9,5,64,41,23,57
Linfield,5816,2,13,10,7,60,40,20,49
Ballymena,5816,3,12,8,10,58,66,-8,44
Dungannon,5816,4,11,9,10,58,44,14,42
Cliftonville,5816,5,13,3,14,46,45,1,42
Glenavon,5816,6,10,12,8,44,46,-2,42
Coleraine,5816,7,9,11,10,40,44,-4,38
Glentoran,5816,8,10,8,12,38,42,-4,38
Ballinamalla,5816,9,10,5,15,34,53,-19,35
Ards,5816,10,10,4,16,48,58,-10,34
Portadown,5816,11,9,5,16,32,43,-11,32
Crusaders,5817,1,16,9,5,52,36,16,57
Linfield,5817,2,15,10,5,63,31,32,55
Cliftonville,5817,3,16,6,8,58,39,19,54
Ballymena,5817,4,15,8,7,65,58,7,53
Glenavon,5817,5,13,10,7,44,46,-2,49
Dungannon,5817,6,10,8,12,50,45,5,38
Coleraine,5817,7,9,10,11,43,44,-1,37
Ards,5817,8,9,5,16,39,49,-10,32
Glentoran,5817,9,7,8,15,31,49,-18,29
Portadown,5817,10,8,4,18,28,49,-21,28
Ballinamalla,5817,11,6,4,20,27,54,-27,22
Cliftonville,5818,1,18,4,8,59,40,19,58
Crusaders,5818,2,17,5,8,54,36,18,56
Ballymena,5818,3,16,6,8,60,57,3,54
Linfield,5818,4,13,8,9,61,41,20,47
Glenavon,5818,5,12,10,8,58,43,15,46
Coleraine,5818,6,11,11,8,46,39,7,44
Dungannon,5818,7,8,10,12,46,46,0,34
Ards,5818,8,9,5,16,30,41,-11,32
Glentoran,5818,9,8,7,15,26,47,-21,31
Portadown,5818,10,7,7,16,29,50,-21,28
Ballinamalla,5818,11,7,5,18,27,56,-29,26
Cliftonville,5819,1,18,3,9,53,37,16,57
Crusaders,5819,2,16,8,6,60,39,21,56
Glenavon,5819,3,16,8,6,59,39,20,56
Ballymena,5819,4,16,6,8,67,55,12,54
Linfield,5819,5,10,11,9,53,43,10,41
Ards,5819,6,12,4,14,41,46,-5,40
Coleraine,5819,7,9,11,10,37,39,-2,38
Dungannon,5819,8,9,9,12,43,45,-2,36
Glentoran,5819,9,7,7,16,31,51,-20,28
Portadown,5819,10,8,4,18,23,48,-25,28
Ballinamalla,5819,11,6,5,19,33,58,-25,23
Linfield,5820,1,16,10,4,60,27,33,58
Crusaders,5820,2,15,9,6,56,39,17,54
Glenavon,5820,3,14,10,6,52,37,15,52
Coleraine,5820,4,13,9,8,45,45,0,48
Ballymena,5820,5,14,4,12,58,57,1,46
Cliftonville,5820,6,12,4,14,47,50,-3,40
Dungannon,5820,7,8,9,13,43,43,0,33
Portadown,5820,8,9,6,15,25,38,-13,33
Ards,5820,9,9,5,16,41,52,-11,32
Ballinamalla,5820,10,9,4,17,42,62,-20,31
Glentoran,5820,11,8,6,16,32,51,-19,30
Crusaders,5821,1,17,8,5,59,29,30,59
Cliftonville,5821,2,17,6,7,56,31,25,57
Linfield,5821,3,13,10,7,58,29,29,49
Glenavon,5821,4,13,10,7,53,43,10,49
Coleraine,5821,5,12,8,10,38,47,-9,44
Ballymena,5821,6,11,8,11,51,63,-12,41
Dungannon,5821,7,10,10,10,53,40,13,40
Ards,5821,8,10,2,18,40,54,-14,32
Ballinamalla,5821,9,8,6,16,32,52,-20,30
Glentoran,5821,10,6,9,15,23,45,-22,27
Portadown,5821,11,8,3,19,22,52,-30,27
Linfield,5822,1,15,9,6,63,29,34,54
Crusaders,5822,2,16,6,8,50,36,14,54
Cliftonville,5822,3,16,3,11,49,33,16,51
Coleraine,5822,4,14,9,7,56,43,13,51
Ballymena,5822,5,14,5,11,57,59,-2,47
Glenavon,5822,6,11,10,9,44,44,0,43
Ballinamalla,5822,7,10,7,13,36,44,-8,37
Dungannon,5822,8,9,9,12,47,42,5,36
Glentoran,5822,9,8,10,12,28,44,-16,34
Portadown,5822,10,7,6,17,24,48,-24,27
Ards,5822,11,5,6,19,30,62,-32,21
Crusaders,5823,1,17,7,6,53,30,23,58
Linfield,5823,2,14,8,8,57,30,27,50
Cliftonville,5823,3,14,6,10,49,39,10,48
Glenavon,5823,4,12,12,6,46,39,7,48
Coleraine,5823,5,12,12,6,38,33,5,48
Ballymena,5823,6,13,7,10,56,53,3,46
Dungannon,5823,7,13,6,11,50,44,6,45
Glentoran,5823,8,8,7,15,29,47,-18,31
Ards,5823,9,8,6,16,34,47,-13,30
Ballinamalla,5823,10,8,4,18,31,52,-21,28
Portadown,5823,11,6,5,19,25,54,-29,23
Crusaders,5824,1,17,5,8,56,43,13,56
Cliftonville,5824,2,15,8,7,60,37,23,53
Linfield,5824,3,14,10,6,58,32,26,52
Coleraine,5824,4,14,9,7,46,36,10,51
Ballymena,5824,5,13,7,10,61,63,-2,46
Glenavon,5824,6,11,8,11,46,47,-1,41
Dungannon,5824,7,8,12,10,46,46,0,36
Portadown,5824,8,9,6,15,25,37,-12,33
Ards,5824,9,9,6,15,41,54,-13,33
Glentoran,5824,10,7,6,17,26,48,-22,27
Ballinamalla,5824,11,6,7,17,31,53,-22,25
Linfield,5825,1,18,7,5,71,26,45,61
Crusaders,5825,2,18,7,5,59,29,30,61
Cliftonville,5825,3,18,3,9,69,41,28,57
Coleraine,5825,4,13,9,8,41,40,1,48
Glenavon,5825,5,11,11,8,43,43,0,44
Dungannon,5825,6,10,11,9,48,38,10,41
Ballymena,5825,7,12,5,13,53,62,-9,41
Ballinamalla,5825,8,8,5,17,29,54,-25,29
Glentoran,5825,9,7,6,17,23,44,-21,27
Ards,5825,10,6,7,17,28,52,-24,25
Portadown,5825,11,6,5,19,19,54,-35,23
Crusaders,5826,1,15,7,8,58,38,20,52
Glenavon,5826,2,14,9,7,53,43,10,51
Linfield,5826,3,13,10,7,60,31,29,49
Dungannon,5826,4,14,7,9,55,41,14,49
Ballymena,5826,5,13,7,10,56,58,-2,46
Coleraine,5826,6,12,9,9,41,41,0,45
Cliftonville,5826,7,14,2,14,44,45,-1,44
Glentoran,5826,8,10,7,13,28,41,-13,37
Ards,5826,9,9,6,15,35,46,-11,33
Portadown,5826,10,9,4,17,30,48,-18,31
Ballinamalla,5826,11,7,2,21,29,57,-28,23
Cliftonville,5827,1,17,7,6,54,33,21,58
Crusaders,5827,2,17,6,7,52,34,18,57
Linfield,5827,3,14,12,4,60,29,31,54
Glenavon,5827,4,14,11,5,55,38,17,53
Ballymena,5827,5,15,4,11,58,57,1,49
Coleraine,5827,6,13,8,9,47,33,14,47
Ballinamalla,5827,7,8,6,16,34,51,-17,30
Portadown,5827,8,8,6,16,21,43,-22,30
Dungannon,5827,9,6,10,14,47,50,-3,28
Glentoran,5827,10,7,7,16,31,56,-25,28
Ards,5827,11,5,5,20,28,63,-35,20
Linfield,5828,1,18,8,4,68,34,34,62
Crusaders,5828,2,17,9,4,61,30,31,60
Coleraine,5828,3,13,8,9,47,38,9,47
Ballymena,5828,4,12,8,10,55,59,-4,44
Cliftonville,5828,5,13,3,14,48,38,10,42
Glenavon,5828,6,9,14,7,48,47,1,41
Dungannon,5828,7,10,10,10,50,44,6,40
Ards,5828,8,10,5,15,41,52,-11,35
Ballinamalla,5828,9,10,4,16,25,44,-19,34
Glentoran,5828,10,8,4,18,23,51,-28,28
Portadown,5828,11,6,5,19,24,53,-29,23
Crusaders,5829,1,19,8,3,59,30,29,65
Cliftonville,5829,2,18,3,9,58,44,14,57
Linfield,5829,3,14,8,8,51,29,22,50
Ballymena,5829,4,12,8,10,54,56,-2,44
Glenavon,5829,5,11,10,9,48,45,3,43
Coleraine,5829,6,10,10,10,41,46,-5,40
Glentoran,5829,7,10,8,12,32,41,-9,38
Dungannon,5829,8,7,13,10,53,49,4,34
Ards,5829,9,9,6,15,40,46,-6,33
Ballinamalla,5829,10,8,3,19,30,54,-24,27
Portadown,5829,11,5,7,18,23,49,-26,22
Cliftonville,5830,1,20,2,8,56,32,24,62
Glenavon,5830,2,14,11,5,61,43,18,53
Crusaders,5830,3,15,7,8,59,38,21,52
Ballymena,5830,4,14,5,11,59,62,-3,47
Coleraine,5830,5,12,8,10,45,41,4,44
Linfield,5830,6,10,9,11,57,43,14,39
Dungannon,5830,7,9,10,11,44,44,0,37
Ards,5830,8,10,7,13,39,45,-6,37
Glentoran,5830,9,8,8,14,31,56,-25,32
Ballinamalla,5830,10,7,6,17,37,60,-23,27
Portadown,5830,11,6,7,17,26,50,-24,25
Linfield,5831,1,15,10,5,54,28,26,55
Cliftonville,5831,2,16,6,8,55,37,18,54
Crusaders,5831,3,15,6,9,48,36,12,51
Glenavon,5831,4,12,9,9,43,39,4,45
Glentoran,5831,5,12,7,11,35,35,0,43
Dungannon,5831,6,11,9,10,49,43,6,42
Coleraine,5831,7,9,12,9,36,35,1,39
Ballymena,5831,8,10,8,12,52,61,-9,38
Ballinamalla,5831,9,10,5,15,32,47,-15,35
Ards,5831,10,7,5,18,40,61,-21,26
Portadown,5831,11,6,7,17,25,47,-22,25
Linfield,5832,1,17,7,6,62,33,29,58
Crusaders,5832,2,17,7,6,55,34,21,58
Cliftonville,5832,3,15,6,9,52,39,13,51
Coleraine,5832,4,11,11,8,42,42,0,44
Ballymena,5832,5,12,7,11,51,52,-1,43
Glenavon,5832,6,9,13,8,44,42,2,40
Ards,5832,7,11,3,16,42,48,-6,36
Glentoran,5832,8,10,6,14,31,45,-14,36
Dungannon,5832,9,8,8,14,53,45,8,32
Ballinamalla,5832,10,9,4,17,27,51,-24,31
Portadown,5832,11,8,4,18,23,51,-28,28
Linfield,5833,1,16,7,7,61,32,29,55
Coleraine,5833,2,16,7,7,45,34,11,55
Cliftonville,5833,3,16,4,10,54,41,13,52
Ballymena,5833,4,14,7,9,59,56,3,49
Crusaders,5833,5,14,6,10,46,36,10,48
Dungannon,5833,6,13,7,10,51,44,7,46
Glenavon,5833,7,11,7,12,47,46,1,40
Glentoran,5833,8,7,11,12,27,44,-17,32
Ards,5833,9,9,3,18,40,51,-11,30
Ballinamalla,5833,10,8,4,18,31,53,-22,28
Portadown,5833,11,6,7,17,24,48,-24,25
Crusaders,5834,1,18,8,4,59,29,30,62
Linfield,5834,2,15,10,5,65,29,36,55
Coleraine,5834,3,11,11,8,48,42,6,44
Glenavon,5834,4,11,11,8,55,50,5,44
Cliftonville,5834,5,13,4,13,45,43,2,43
Ballymena,5834,6,11,8,11,49,62,-13,41
Portadown,5834,7,11,4,15,25,42,-17,37
Dungannon,5834,8,8,12,10,49,44,5,36
Glentoran,5834,9,8,9,13,32,45,-13,33
Ballinamalla,5834,10,9,6,15,37,51,-14,33
Ards,5834,11,6,5,19,33,60,-27,23
Ballymena,5835,1,17,7,6,69,52,17,58
Crusaders,5835,2,16,8,6,55,34,21,56
Linfield,5835,3,15,10,5,63,34,29,55
Coleraine,5835,4,15,8,7,48,36,12,53
Cliftonville,5835,5,14,4,12,52,45,7,46
Glenavon,5835,6,11,11,8,46,49,-3,44
Dungannon,5835,7,9,11,10,54,53,1,38
Ards,5835,8,9,5,16,36,46,-10,32
Ballinamalla,5835,9,7,7,16,33,54,-21,28
Portadown,5835,10,6,4,20,23,51,-28,22
Glentoran,5835,11,4,9,17,27,52,-25,21
Crusaders,5836,1,18,6,6,59,33,26,60
Cliftonville,5836,2,16,5,9,55,41,14,53
Ballymena,5836,3,13,9,8,69,63,6,48
Glenavon,5836,4,11,12,7,45,41,4,45
Linfield,5836,5,10,12,8,53,39,14,42
Portadown,5836,6,13,3,14,30,45,-15,42
Coleraine,5836,7,9,9,12,42,43,-1,36
Glentoran,5836,8,9,9,12,30,46,-16,36
Dungannon,5836,9,8,11,11,49,48,1,35
Ards,5836,10,9,8,13,41,47,-6,35
Ballinamalla,5836,11,4,6,20,24,51,-27,18
Linfield,5837,1,18,8,4,68,26,42,62
Cliftonville,5837,2,16,4,10,46,37,9,52
Ballymena,5837,3,14,7,9,62,61,1,49
Crusaders,5837,4,13,7,10,55,46,9,46
Glenavon,5837,5,12,9,9,57,47,10,45
Dungannon,5837,6,10,10,10,53,44,9,40
Coleraine,5837,7,9,10,11,38,45,-7,37
Glentoran,5837,8,8,11,11,32,44,-12,35
Ards,5837,9,9,5,16,32,50,-18,32
Portadown,5837,10,8,7,15,31,44,-13,31
Ballinamalla,5837,11,7,4,19,29,59,-30,25
Crusaders,5838,1,15,9,6,54,37,17,54
Linfield,5838,2,14,11,5,59,30,29,53
Ballymena,5838,3,15,6,9,60,56,4,51
Cliftonville,5838,4,14,5,11,52,39,13,47
Glenavon,5838,5,11,10,9,52,45,7,43
Coleraine,5838,6,9,12,9,45,43,2,39
Glentoran,5838,7,10,9,11,39,48,-9,39
Dungannon,5838,8,9,10,11,49,50,-1,37
Ballinamalla,5838,9,9,4,17,34,52,-18,31
Portadown,5838,10,8,7,15,24,46,-22,31
Ards,5838,11,6,7,17,27,49,-22,25
Crusaders,5839,1,17,7,6,55,35,20,58
Cliftonville,5839,2,17,6,7,60,41,19,57
Linfield,5839,3,14,12,4,61,29,32,54
Glenavon,5839,4,13,11,6,52,43,9,50
Ballymena,5839,5,12,6,12,52,59,-7,42
Dungannon,5839,6,10,10,10,47,41,6,40
Coleraine,5839,7,8,13,9,40,41,-1,37
Ards,5839,8,10,7,13,37,48,-11,37
Glentoran,5839,9,7,9,14,32,47,-15,30
Ballinamalla,5839,10,6,6,18,29,54,-25,24
Portadown,5839,11,4,7,19,21,48,-27,19
Crusaders,5840,1,20,6,4,65,35,30,66
Cliftonville,5840,2,20,3,7,63,33,30,63
Linfield,5840,3,13,11,6,64,36,28,50
Glenavon,5840,4,13,8,9,49,46,3,47
Coleraine,5840,5,11,8,11,43,45,-2,41
Ballymena,5840,6,11,8,11,52,61,-9,41
Ards,5840,7,10,5,15,37,44,-7,35
Dungannon,5840,8,8,9,13,46,50,-4,33
Glentoran,5840,9,9,6,15,34,52,-18,33
Ballinamalla,5840,10,8,3,19,32,55,-23,27
Portadown,5840,11,5,7,18,19,47,-28,22
Crusaders,5841,1,16,6,8,53,32,21,54
Linfield,5841,2,14,11,5,61,35,26,53
Ballymena,5841,3,15,6,9,57,51,6,51
Cliftonville,5841,4,13,7,10,46,46,0,46
Coleraine,5841,5,12,9,9,47,36,11,45
Glenavon,5841,6,11,11,8,48,49,-1,44
Dungannon,5841,7,10,8,12,47,46,1,38
Ballinamalla,5841,8,10,6,14,36,48,-12,36
Ards,5841,9,7,8,15,39,49,-10,29
Glentoran,5841,10,6,10,14,25,44,-19,28
Portadown,5841,11,8,4,18,24,47,-23,28
Cliftonville,5842,1,16,6,8,53,33,20,54
Crusaders,5842,2,15,8,7,55,32,23,53
Linfield,5842,3,14,9,7,61,36,25,51
Ballymena,5842,4,14,8,8,64,60,4,50
Glenavon,5842,5,13,10,7,47,45,2,49
Coleraine,5842,6,10,15,5,42,39,3,45
Dungannon,5842,7,9,10,11,48,44,4,37
Glentoran,5842,8,9,7,14,32,42,-10,34
Ards,5842,9,7,6,17,41,58,-17,27
Ballinamalla,5842,10,7,5,18,27,53,-26,26
Portadown,5842,11,6,6,18,19,47,-28,24
Crusaders,5843,1,16,8,6,55,36,19,56
Ballymena,5843,2,16,6,8,58,51,7,54
Glenavon,5843,3,13,9,8,52,46,6,48
Linfield,5843,4,12,11,7,55,35,20,47
Cliftonville,5843,5,14,5,11,55,46,9,47
Coleraine,5843,6,11,11,8,44,39,5,44
Ards,5843,7,11,4,15,38,46,-8,37
Dungannon,5843,8,9,8,13,53,54,-1,35
Ballinamalla,5843,9,8,5,17,34,50,-16,29
Portadown,5843,10,8,5,17,28,52,-24,29
Glentoran,5843,11,6,10,14,23,40,-17,28
Crusaders,5844,1,18,8,4,51,28,23,62
Linfield,5844,2,16,7,7,63,35,28,55
Dungannon,5844,3,14,7,9,60,41,19,49
Cliftonville,5844,4,14,6,10,51,38,13,48
Ballymena,5844,5,13,7,10,52,59,-7,46
Glenavon,5844,6,11,9,10,55,51,4,42
Coleraine,5844,7,8,12,10,40,46,-6,36
Portadown,5844,8,9,5,16,32,48,-16,32
Glentoran,5844,9,8,7,15,27,46,-19,31
Ballinamalla,5844,10,7,6,17,27,47,-20,27
Ards,5844,11,6,8,16,36,55,-19,26
Crusaders,5845,1,15,7,8,56,41,15,52
Cliftonville,5845,2,15,6,9,50,37,13,51
Glenavon,5845,3,13,11,6,52,38,14,50
Linfield,5845,4,12,9,9,61,40,21,45
Coleraine,5845,5,11,9,10,47,43,4,42
Dungannon,5845,6,10,11,9,50,43,7,41
Ballymena,5845,7,12,5,13,47,59,-12,41
Glentoran,5845,8,10,10,10,38,44,-6,40
Ards,5845,9,11,4,15,46,52,-6,37
Ballinamalla,5845,10,9,4,17,30,49,-19,31
Portadown,5845,11,6,6,18,24,55,-31,24
Crusaders,5846,1,21,6,3,65,26,39,69
Linfield,5846,2,15,8,7,58,27,31,53
Cliftonville,5846,3,15,5,10,56,39,17,50
Ballymena,5846,4,14,7,9,52,56,-4,49
Glenavon,5846,5,12,11,7,43,39,4,47
Coleraine,5846,6,11,9,10,43,39,4,42
Dungannon,5846,7,9,9,12,45,48,-3,36
Glentoran,5846,8,8,9,13,30,45,-15,33
Ards,5846,9,8,7,15,33,49,-16,31
Portadown,5846,10,6,6,18,23,51,-28,24
Ballinamalla,5846,11,5,5,20,27,56,-29,20
Cliftonville,5847,1,17,5,8,55,36,19,56
Crusaders,5847,2,14,9,7,54,36,18,51
Linfield,5847,3,12,12,6,58,36,22,48
Ballymena,5847,4,12,10,8,56,57,-1,46
Glenavon,5847,5,11,11,8,48,45,3,44
Dungannon,5847,6,11,8,11,55,49,6,41
Coleraine,5847,7,9,14,7,40,38,2,41
Glentoran,5847,8,9,8,13,30,43,-13,35
Ards,5847,9,8,8,14,31,43,-12,32
Ballinamalla,5847,10,8,7,15,31,47,-16,31
Portadown,5847,11,5,6,19,28,56,-28,21
Crusaders,5848,1,19,7,4,56,31,25,64
Cliftonville,5848,2,19,4,7,57,33,24,61
Glenavon,5848,3,15,10,5,55,44,11,55
Ballymena,5848,4,14,7,9,65,65,0,49
Linfield,5848,5,12,10,8,58,36,22,46
Dungannon,5848,6,10,9,11,46,38,8,39
Coleraine,5848,7,8,10,12,36,44,-8,34
Ards,5848,8,7,8,15,34,48,-14,29
Portadown,5848,9,7,6,17,22,45,-23,27
Glentoran,5848,10,6,8,16,30,49,-19,26
Ballinamalla,5848,11,6,5,19,32,58,-26,23
Crusaders,5849,1,16,9,5,62,38,24,57
Cliftonville,5849,2,15,6,9,56,39,17,51
Linfield,5849,3,13,11,6,58,31,27,50
Glenavon,5849,4,12,12,6,50,40,10,48
Coleraine,5849,5,11,10,9,42,41,1,43
Ballymena,5849,6,12,6,12,61,68,-7,42
Glentoran,5849,7,10,9,11,34,44,-10,39
Dungannon,5849,8,9,11,10,51,44,7,38
Ards,5849,9,9,7,14,44,54,-10,34
Ballinamalla,5849,10,9,3,18,29,52,-23,30
Portadown,5849,11,5,4,21,23,59,-36,19
Crusaders,5850,1,18,8,4,65,39,26,62
Linfield,5850,2,15,9,6,57,33,24,54
Cliftonville,5850,3,14,5,11,48,40,8,47
Ballymena,5850,4,13,8,9,62,57,5,47
Glenavon,5850,5,12,10,8,50,45,5,46
Coleraine,5850,6,11,10,9,42,34,8,43
Ards,5850,7,12,2,16,44,48,-4,38
Dungannon,5850,8,8,8,14,52,54,-2,32
Glentoran,5850,9,7,9,14,30,50,-20,30
Ballinamalla,5850,10,8,5,17,32,54,-22,29
Portadown,5850,11,6,8,16,20,48,-28,26
Crusaders,5851,1,14,10,6,54,34,20,52
Linfield,5851,2,14,9,7,59,31,28,51
Glenavon,5851,3,14,9,7,56,41,15,51
Cliftonville,5851,4,14,6,10,47,39,8,48
Glentoran,5851,5,14,5,11,42,45,-3,47
Ballymena,5851,6,13,6,11,53,56,-3,45
Dungannon,5851,7,10,10,10,50,43,7,40
Coleraine,5851,8,9,9,12,36,46,-10,36
Ards,5851,9,10,3,17,35,48,-13,33
Portadown,5851,10,9,4,17,22,45,-23,31
Ballinamalla,5851,11,6,5,19,28,54,-26,23
Crusaders,5852,1,17,6,7,54,33,21,57
Cliftonville,5852,2,15,5,10,57,44,13,50
Linfield,5852,3,12,12,6,60,35,25,48
Ballymena,5852,4,13,9,8,59,57,2,48
Glenavon,5852,5,10,13,7,50,49,1,43
Coleraine,5852,6,10,12,8,49,40,9,42
Dungannon,5852,7,11,9,10,49,43,6,42
Ards,5852,8,11,7,12,39,45,-6,40
Portadown,5852,9,8,6,16,27,50,-23,30
Glentoran,5852,10,6,9,15,26,40,-14,27
Ballinamalla,5852,11,6,4,20,26,60,-34,22
Ballymena,5853,1,16,5,9,65,59,6,53
Cliftonville,5853,2,15,7,8,57,41,16,52
Crusaders,5853,3,14,6,10,51,38,13,48
Linfield,5853,4,13,8,9,55,31,24,47
Glenavon,5853,5,11,12,7,58,50,8,45
Coleraine,5853,6,11,11,8,47,46,1,44
Dungannon,5853,7,9,10,11,50,46,4,37
Glentoran,5853,8,9,9,12,32,42,-10,36
Ards,5853,9,10,3,17,41,50,-9,33
Ballinamalla,5853,10,9,5,16,33,54,-21,32
Portadown,5853,11,7,6,17,22,54,-32,27
Crusaders,5854,1,19,6,5,57,32,25,63
Linfield,5854,2,13,10,7,61,38,23,49
Coleraine,5854,3,12,10,8,43,32,11,46
Cliftonville,5854,4,13,5,12,47,40,7,44
Ballymena,5854,5,12,7,11,59,59,0,43
Dungannon,5854,6,10,8,12,50,50,0,38
Glenavon,5854,7,10,8,12,44,48,-4,38
Ards,5854,8,10,7,13,42,45,-3,37
Portadown,5854,9,11,3,16,35,49,-14,36
Glentoran,5854,10,9,6,15,30,48,-18,33
Ballinamalla,5854,11,8,6,16,25,52,-27,30
Crusaders,5855,1,16,7,7,53,37,16,55
Cliftonville,5855,2,17,3,10,55,39,16,54
Coleraine,5855,3,13,11,6,46,34,12,50
Glenavon,5855,4,12,12,6,50,43,7,48
Linfield,5855,5,11,10,9,51,35,16,43
Ballymena,5855,6,12,6,12,55,68,-13,42
Dungannon,5855,7,9,10,11,48,44,4,37
Ards,5855,8,11,4,15,36,44,-8,37
Glentoran,5855,9,10,6,14,35,43,-8,36
Portadown,5855,10,9,4,17,33,53,-20,31
Ballinamalla,5855,11,6,5,19,27,49,-22,23
Crusaders,5856,1,18,8,4,61,29,32,62
Linfield,5856,2,15,9,6,58,35,23,54
Cliftonville,5856,3,16,6,8,58,39,19,54
Glenavon,5856,4,14,9,7,50,37,13,51
Ballymena,5856,5,12,8,10,57,59,-2,44
Coleraine,5856,6,10,12,8,37,40,-3,42
Glentoran,5856,7,9,9,12,29,41,-12,36
Dungannon,5856,8,6,10,14,45,51,-6,28
Ards,5856,9,7,7,16,40,54,-14,28
Ballinamalla,5856,10,6,9,15,24,44,-20,27
Portadown,5856,11,5,7,18,18,48,-30,22
Linfield,5857,1,18,8,4,61,26,35,62
Crusaders,5857,2,18,5,7,61,34,27,59
Cliftonville,5857,3,16,6,8,53,38,15,54
Glenavon,5857,4,14,7,9,53,40,13,49
Coleraine,5857,5,14,7,9,47,36,11,49
Ballymena,5857,6,13,5,12,51,64,-13,44
Dungannon,5857,7,9,9,12,50,51,-1,36
Glentoran,5857,8,9,6,15,32,47,-15,33
Ards,5857,9,7,6,17,33,48,-15,27
Portadown,5857,10,6,6,18,20,47,-27,24
Ballinamalla,5857,11,6,5,19,20,50,-30,23
Linfield,5858,1,16,9,5,58,33,25,57
Ballymena,5858,2,16,7,7,72,52,20,55
Crusaders,5858,3,15,8,7,53,35,18,53
Coleraine,5858,4,13,11,6,44,31,13,50
Cliftonville,5858,5,14,5,11,50,41,9,47
Dungannon,5858,6,11,11,8,48,39,9,44
Glenavon,5858,7,10,8,12,35,45,-10,38
Portadown,5858,8,9,7,14,29,42,-13,34
Glentoran,5858,9,7,9,14,27,48,-21,30
Ards,5858,10,7,4,19,35,55,-20,25
Ballinamalla,5858,11,6,3,21,26,56,-30,21
Crusaders,5859,1,16,9,5,59,40,19,57
Linfield,5859,2,15,9,6,61,36,25,54
Cliftonville,5859,3,16,4,10,53,40,13,52
Coleraine,5859,4,11,11,8,45,38,7,44
Ballymena,5859,5,13,5,12,57,59,-2,44
Glenavon,5859,6,10,11,9,49,45,4,41
Dungannon,5859,7,10,8,12,50,46,4,38
Glentoran,5859,8,10,7,13,35,49,-14,37
Portadown,5859,9,10,4,16,33,47,-14,34
Ballinamalla,5859,10,10,4,16,27,42,-15,34
Ards,5859,11,6,4,20,32,59,-27,22
Crusaders,5860,1,19,9,2,60,27,33,66
Linfield,5860,2,17,7,6,58,27,31,58
Cliftonville,5860,3,14,7,9,53,48,5,49
Ballymena,5860,4,13,8,9,63,54,9,47
Dungannon,5860,5,10,10,10,50,46,4,40
Glenavon,5860,6,9,13,8,44,42,2,40
Ards,5860,7,10,5,15,36,49,-13,35
Coleraine,5860,8,7,12,11,37,47,-10,33
Glentoran,5860,9,7,8,15,29,45,-16,29
Portadown,5860,10,8,5,17,24,47,-23,29
Ballinamalla,5860,11,7,4,19,30,52,-22,25
Crusaders,5861,1,18,8,4,56,35,21,62
Linfield,5861,2,16,8,6,64,32,32,56
Cliftonville,5861,3,15,8,7,52,38,14,53
Coleraine,5861,4,11,11,8,45,33,12,44
Glenavon,5861,5,11,11,8,47,41,6,44
Ards,5861,6,13,4,13,38,41,-3,43
Ballymena,5861,7,11,7,12,49,62,-13,40
Dungannon,5861,8,7,11,12,43,44,-1,32
Glentoran,5861,9,7,7,16,26,46,-20,28
Ballinamalla,5861,10,7,5,18,24,48,-24,26
Portadown,5861,11,5,8,17,24,48,-24,23
Linfield,5862,1,19,8,3,66,21,45,65
Crusaders,5862,2,16,8,6,61,35,26,56
Cliftonville,5862,3,15,6,9,57,43,14,51
Coleraine,5862,4,13,10,7,53,41,12,49
Ballymena,5862,5,14,6,10,58,59,-1,48
Glenavon,5862,6,11,11,8,43,44,-1,44
Glentoran,5862,7,9,9,12,26,36,-10,36
Dungannon,5862,8,7,8,15,42,49,-7,29
Ards,5862,9,7,5,18,32,56,-24,26
Ballinamalla,5862,10,7,5,18,29,53,-24,26
Portadown,5862,11,7,4,19,25,55,-30,25
Crusaders,5863,1,20,7,3,69,33,36,67
Linfield,5863,2,16,8,6,66,31,35,56
Ballymena,5863,3,15,5,10,62,58,4,50
Coleraine,5863,4,13,9,8,46,38,8,48
Cliftonville,5863,5,14,5,11,49,40,9,47
Dungannon,5863,6,9,10,11,53,50,3,37
Glenavon,5863,7,8,12,10,46,51,-5,36
Glentoran,5863,8,9,5,16,31,49,-18,32
Ards,5863,9,8,7,15,38,55,-17,31
Portadown,5863,10,7,5,18,26,54,-28,26
Ballinamalla,5863,11,6,7,17,30,57,-27,25
Linfield,5864,1,14,11,5,56,28,28,53
Crusaders,5864,2,15,8,7,55,37,18,53
Cliftonville,5864,3,15,6,9,49,38,11,51
Glenavon,5864,4,11,12,7,44,41,3,45
Ballymena,5864,5,11,8,11,49,64,-15,41
Dungannon,5864,6,9,13,8,47,39,8,40
Ballinamalla,5864,7,11,3,16,33,49,-16,36
Ards,5864,8,10,5,15,46,43,3,35
Coleraine,5864,9,8,10,12,40,42,-2,34
Glentoran,5864,10,6,12,12,30,49,-19,30
Portadown,5864,11,8,6,16,26,45,-19,30
Cliftonville,5865,1,17,4,9,55,37,18,55
Ballymena,5865,2,16,7,7,64,53,11,55
Crusaders,5865,3,15,8,7,58,38,20,53
Glenavon,5865,4,12,11,7,55,52,3,47
Coleraine,5865,5,11,8,11,53,50,3,41
Linfield,5865,6,10,10,10,51,41,10,40
Glentoran,5865,7,10,8,12,36,44,-8,38
Dungannon,5865,8,9,10,11,50,46,4,37
Ards,5865,9,9,6,15,35,48,-13,33
Portadown,5865,10,9,3,18,30,47,-17,30
Ballinamalla,5865,11,7,5,18,34,65,-31,26
Cliftonville,5866,1,17,6,7,50,31,19,57
Linfield,5866,2,15,11,4,69,32,37,56
Crusaders,5866,3,15,11,4,51,31,20,56
Glenavon,5866,4,11,10,9,44,46,-2,43
Ballymena,5866,5,12,6,12,61,71,-10,42
Coleraine,5866,6,10,11,9,41,41,0,41
Dungannon,5866,7,8,14,8,47,41,6,38
Glentoran,5866,8,8,9,13,29,42,-13,33
Ards,5866,9,7,8,15,32,46,-14,29
Ballinamalla,5866,10,6,7,17,28,49,-21,25
Portadown,5866,11,6,7,17,25,47,-22,25
Crusaders,5867,1,17,7,6,59,35,24,58
Linfield,5867,2,13,10,7,56,32,24,49
Ballymena,5867,3,14,5,11,65,64,1,47
Coleraine,5867,4,12,8,10,46,46,0,44
Cliftonville,5867,5,13,4,13,48,45,3,43
Glenavon,5867,6,11,10,9,45,45,0,43
Ards,5867,7,13,3,14,38,42,-4,42
Glentoran,5867,8,12,6,12,33,38,-5,42
Dungannon,5867,9,8,11,11,44,45,-1,35
Ballinamalla,5867,10,7,6,17,32,53,-21,27
Portadown,5867,11,7,6,17,27,48,-21,27
Crusaders,5868,1,15,8,7,54,38,16,53
Ballymena,5868,2,15,6,9,67,62,5,51
Cliftonville,5868,3,14,7,9,60,44,16,49
Linfield,5868,4,12,12,6,59,37,22,48
Coleraine,5868,5,12,10,8,49,42,7,46
Glentoran,5868,6,12,7,11,34,41,-7,43
Dungannon,5868,7,10,9,11,49,44,5,39
Glenavon,5868,8,9,12,9,51,54,-3,39
Portadown,5868,9,7,8,15,24,41,-17,29
Ballinamalla,5868,10,7,6,17,31,56,-25,27
Ards,5868,11,7,5,18,37,56,-19,26
Linfield,5869,1,17,8,5,58,25,33,59
Crusaders,5869,2,16,9,5,50,28,22,57
Cliftonville,5869,3,16,4,10,54,37,17,52
Ballymena,5869,4,15,6,9,67,58,9,51
Coleraine,5869,5,10,11,9,38,40,-2,41
Glenavon,5869,6,10,10,10,44,46,-2,40
Dungannon,5869,7,10,8,12,52,45,7,38
Ards,5869,8,11,5,14,37,45,-8,38
Glentoran,5869,9,9,6,15,25,46,-21,33
Portadown,5869,10,8,4,18,25,51,-26,28
Ballinamalla,5869,11,5,5,20,29,58,-29,20
Crusaders,5870,1,17,7,6,60,39,21,58
Linfield,5870,2,14,9,7,62,37,25,51
Cliftonville,5870,3,15,5,10,51,39,12,50
Ballymena,5870,4,14,6,10,56,53,3,48
Glentoran,5870,5,12,7,11,37,39,-2,43
Glenavon,5870,6,10,12,8,49,49,0,42
Dungannon,5870,7,10,10,10,51,39,12,40
Coleraine,5870,8,9,9,12,34,42,-8,36
Ards,5870,9,10,4,16,39,48,-9,34
Ballinamalla,5870,10,7,6,17,26,54,-28,27
Portadown,5870,11,7,5,18,25,51,-26,26
Crusaders,5871,1,15,8,7,51,36,15,53
Cliftonville,5871,2,14,8,8,50,33,17,50
Coleraine,5871,3,13,10,7,53,34,19,49
Ballymena,5871,4,14,7,9,57,53,4,49
Linfield,5871,5,12,7,11,54,43,11,43
Glentoran,5871,6,12,7,11,33,38,-5,43
Glenavon,5871,7,10,12,8,44,42,2,42
Portadown,5871,8,9,8,13,27,44,-17,35
Dungannon,5871,9,9,7,14,42,46,-4,34
Ards,5871,10,7,8,15,34,53,-19,29
Ballinamalla,5871,11,7,4,19,25,48,-23,25
Crusaders,5872,1,16,9,5,58,38,20,57
Linfield,5872,2,16,8,6,61,27,34,56
Cliftonville,5872,3,17,4,9,54,37,17,55
Ballymena,5872,4,15,3,12,51,52,-1,48
Coleraine,5872,5,12,9,9,44,39,5,45
Glenavon,5872,6,12,8,10,49,49,0,44
Dungannon,5872,7,10,7,13,46,46,0,37
Portadown,5872,8,10,4,16,29,49,-20,34
Ballinamalla,5872,9,10,2,18,34,51,-17,32
Glentoran,5872,10,8,6,16,28,46,-18,30
Ards,5872,11,7,4,19,31,51,-20,25
Crusaders,5873,1,19,9,2,63,28,35,66
Linfield,5873,2,14,11,5,56,27,29,53
Cliftonville,5873,3,16,3,11,52,37,15,51
Dungannon,5873,4,13,8,9,47,34,13,47
Glenavon,5873,5,11,13,6,42,41,1,46
Coleraine,5873,6,10,13,7,44,40,4,43
Ballymena,5873,7,11,8,11,48,56,-8,41
Glentoran,5873,8,7,9,14,30,47,-17,30
Portadown,5873,9,8,4,18,22,41,-19,28
Ards,5873,10,6,7,17,35,58,-23,25
Ballinamalla,5873,11,4,7,19,25,55,-30,19
Cliftonville,5874,1,18,4,8,60,40,20,58
Crusaders,5874,2,13,11,6,53,37,16,50
Linfield,5874,3,13,8,9,55,38,17,47
Ballymena,5874,4,14,5,11,63,56,7,47
Coleraine,5874,5,12,10,8,45,45,0,46
Glentoran,5874,6,13,5,12,40,41,-1,44
Dungannon,5874,7,9,12,9,46,43,3,39
Glenavon,5874,8,9,11,10,45,48,-3,38
Ards,5874,9,8,6,16,36,47,-11,30
Portadown,5874,10,9,3,18,24,48,-24,30
Ballinamalla,5874,11,6,7,17,27,51,-24,25
Crusaders,5875,1,15,8,7,52,33,19,53
Cliftonville,5875,2,16,4,10,56,42,14,52
Linfield,5875,3,13,11,6,58,32,26,50
Glenavon,5875,4,12,11,7,46,40,6,47
Ballymena,5875,5,12,9,9,53,56,-3,45
Dungannon,5875,6,10,10,10,43,39,4,40
Coleraine,5875,7,9,12,9,42,40,2,39
Portadown,5875,8,8,9,13,25,40,-15,33
Ballinamalla,5875,9,9,5,16,31,47,-16,32
Glentoran,5875,10,7,8,15,22,38,-16,29
Ards,5875,11,8,5,17,29,50,-21,29
Crusaders,5876,1,19,6,5,64,28,36,63
Cliftonville,5876,2,19,4,7,53,32,21,61
Linfield,5876,3,14,8,8,56,32,24,50
Ballymena,5876,4,13,5,12,53,62,-9,44
Coleraine,5876,5,10,9,11,38,36,2,39
Glenavon,5876,6,9,12,9,42,47,-5,39
Dungannon,5876,7,9,10,11,48,47,1,37
Ards,5876,8,10,4,16,38,49,-11,34
Glentoran,5876,9,8,8,14,28,44,-16,32
Ballinamalla,5876,10,8,5,17,34,54,-20,29
Portadown,5876,11,7,7,16,27,50,-23,28
Crusaders,5877,1,17,6,7,58,35,23,57
Cliftonville,5877,2,15,7,8,56,40,16,52
Coleraine,5877,3,14,10,6,47,31,16,52
Ballymena,5877,4,15,5,10,62,57,5,50
Linfield,5877,5,13,10,7,57,36,21,49
Glenavon,5877,6,10,12,8,46,43,3,42
Portadown,5877,7,10,5,15,23,40,-17,35
Dungannon,5877,8,8,9,13,43,47,-4,33
Ards,5877,9,9,4,17,37,50,-13,31
Ballinamalla,5877,10,8,4,18,34,64,-30,28
Glentoran,5877,11,7,6,17,30,50,-20,27
Crusaders,5878,1,18,5,7,57,35,22,59
Cliftonville,5878,2,16,5,9,53,41,12,53
Ballymena,5878,3,16,5,9,61,56,5,53
Linfield,5878,4,12,11,7,57,32,25,47
Glenavon,5878,5,11,11,8,46,43,3,44
Coleraine,5878,6,12,8,10,39,40,-1,44
Dungannon,5878,7,8,11,11,49,48,1,35
Ards,5878,8,9,6,15,36,45,-9,33
Glentoran,5878,9,9,6,15,25,43,-18,33
Ballinamalla,5878,10,8,7,15,37,54,-17,31
Portadown,5878,11,5,7,18,22,45,-23,22
Linfield,5879,1,15,11,4,58,30,28,56
Crusaders,5879,2,14,9,7,55,41,14,51
Ballymena,5879,3,15,6,9,63,58,5,51
Cliftonville,5879,4,14,6,10,54,40,14,48
Glenavon,5879,5,12,11,7,52,42,10,47
Coleraine,5879,6,7,15,8,37,41,-4,36
Dungannon,5879,7,8,11,11,50,49,1,35
Glentoran,5879,8,9,8,13,32,45,-13,35
Ballinamalla,5879,9,9,6,15,28,47,-19,33
Ards,5879,10,7,7,16,35,49,-14,28
Portadown,5879,11,5,10,15,20,42,-22,25
Linfield,5880,1,15,8,7,65,31,34,53
Ballymena,5880,2,16,4,10,56,58,-2,52
Cliftonville,5880,3,15,6,9,56,43,13,51
Coleraine,5880,4,12,13,5,51,37,14,49
Glenavon,5880,5,12,11,7,49,44,5,47
Crusaders,5880,6,11,8,11,50,48,2,41
Portadown,5880,7,10,5,15,30,45,-15,35
Dungannon,5880,8,8,10,12,53,50,3,34
Ballinamalla,5880,9,8,8,14,34,50,-16,32
Glentoran,5880,10,7,10,13,24,41,-17,31
Ards,5880,11,6,7,17,37,58,-21,25
Crusaders,5881,1,19,5,6,57,28,29,62
Linfield,5881,2,15,10,5,60,27,33,55
Cliftonville,5881,3,15,6,9,44,35,9,51
Ballymena,5881,4,14,7,9,61,56,5,49
Glenavon,5881,5,11,8,11,43,39,4,41
Coleraine,5881,6,9,14,7,47,45,2,41
Dungannon,5881,7,9,10,11,48,45,3,37
Glentoran,5881,8,9,9,12,31,44,-13,36
Portadown,5881,9,8,7,15,27,43,-16,31
Ards,5881,10,5,10,15,32,56,-24,25
Ballinamalla,5881,11,5,6,19,24,56,-32,21
Crusaders,5882,1,17,6,7,59,33,26,57
Linfield,5882,2,14,9,7,60,34,26,51
Glenavon,5882,3,13,11,6,51,39,12,50
Cliftonville,5882,4,15,5,10,57,47,10,50
Ballymena,5882,5,14,6,10,65,59,6,48
Glentoran,5882,6,11,8,11,36,43,-7,41
Coleraine,5882,7,9,12,9,42,44,-2,39
Dungannon,5882,8,9,8,13,45,49,-4,35
Portadown,5882,9,8,8,14,24,45,-21,32
Ards,5882,10,8,5,17,35,49,-14,29
Ballinamalla,5882,11,6,4,20,33,65,-32,22
Linfield,5883,1,15,9,6,58,32,26,54
Crusaders,5883,2,15,9,6,55,34,21,54
Coleraine,5883,3,14,12,4,49,28,21,54
Cliftonville,5883,4,14,8,8,59,45,14,50
Ballymena,5883,5,12,6,12,58,66,-8,42
Dungannon,5883,6,10,9,11,51,40,11,39
Glenavon,5883,7,10,8,12,46,56,-10,38
Ards,5883,8,10,5,15,38,51,-13,35
Glentoran,5883,9,9,8,13,28,44,-16,35
Ballinamalla,5883,10,8,5,17,27,46,-19,29
Portadown,5883,11,5,7,18,23,50,-27,22
Linfield,5884,1,16,10,4,59,26,33,58
Crusaders,5884,2,15,9,6,55,32,23,54
Cliftonville,5884,3,14,6,10,49,40,9,48
Coleraine,5884,4,13,8,9,48,34,14,47
Glenavon,5884,5,11,13,6,45,41,4,46
Ballymena,5884,6,12,9,9,52,55,-3,45
Dungannon,5884,7,9,10,11,45,43,2,37
Ards,5884,8,8,7,15,30,46,-16,31
Glentoran,5884,9,6,12,12,24,39,-15,30
Ballinamalla,5884,10,7,6,17,26,53,-27,27
Portadown,5884,11,6,6,18,26,50,-24,24
Crusaders,5885,1,17,6,7,53,36,17,57
Dungannon,5885,2,13,9,8,59,43,16,48
Coleraine,5885,3,12,10,8,45,32,13,46
Cliftonville,5885,4,13,5,12,49,43,6,44
Ards,5885,5,13,5,12,42,44,-2,44
Linfield,5885,6,11,9,10,55,35,20,42
Ballymena,5885,7,10,9,11,53,59,-6,39
Portadown,5885,8,11,4,15,30,47,-17,37
Glenavon,5885,9,8,11,11,52,60,-8,35
Glentoran,5885,10,9,8,13,29,44,-15,35
Ballinamalla,5885,11,7,6,17,31,55,-24,27
Linfield,5886,1,15,8,7,54,31,23,53
Crusaders,5886,2,14,10,6,54,42,12,52
Ballymena,5886,3,15,6,9,64,54,10,51
Cliftonville,5886,4,15,5,10,53,44,9,50
Glenavon,5886,5,13,10,7,55,54,1,49
Coleraine,5886,6,12,10,8,46,34,12,46
Ards,5886,7,11,6,13,42,47,-5,39
Dungannon,5886,8,8,11,11,51,46,5,35
Ballinamalla,5886,9,8,5,17,26,49,-23,29
Portadown,5886,10,6,6,18,28,49,-21,24
Glentoran,5886,11,5,9,16,29,52,-23,24
Cliftonville,5887,1,18,4,8,56,31,25,58
Crusaders,5887,2,17,7,6,57,33,24,58
Glenavon,5887,3,13,10,7,47,39,8,49
Ballymena,5887,4,14,6,10,54,54,0,48
Linfield,5887,5,12,10,8,62,37,25,46
Dungannon,5887,6,11,9,10,48,42,6,42
Glentoran,5887,7,10,9,11,37,47,-10,39
Ards,5887,8,11,5,14,42,48,-6,38
Coleraine,5887,9,9,9,12,40,47,-7,36
Portadown,5887,10,7,5,18,25,49,-24,26
Ballinamalla,5887,11,5,2,23,22,63,-41,17
Crusaders,5888,1,18,7,5,61,32,29,61
Cliftonville,5888,2,16,5,9,54,37,17,53
Linfield,5888,3,14,7,9,57,34,23,49
Dungannon,5888,4,13,9,8,51,39,12,48
Ballymena,5888,5,13,8,9,49,48,1,47
Coleraine,5888,6,10,9,11,37,41,-4,39
Glentoran,5888,7,11,5,14,36,50,-14,38
Glenavon,5888,8,9,10,11,43,48,-5,37
Ballinamalla,5888,9,9,4,17,30,53,-23,31
Ards,5888,10,7,7,16,35,51,-16,28
Portadown,5888,11,7,5,18,26,46,-20,26
Crusaders,5889,1,16,7,7,57,37,20,55
Ballymena,5889,2,15,7,8,58,52,6,52
Cliftonville,5889,3,14,6,10,49,42,7,48
Linfield,5889,4,12,8,10,50,38,12,44
Glenavon,5889,5,11,10,9,46,48,-2,43
Coleraine,5889,6,10,12,8,42,37,5,42
Portadown,5889,7,12,4,14,36,43,-7,40
Dungannon,5889,8,8,9,13,45,45,0,33
Ards,5889,9,7,11,12,39,47,-8,32
Glentoran,5889,10,7,11,12,33,47,-14,32
Ballinamalla,5889,11,8,5,17,30,49,-19,29
Ballymena,5890,1,18,5,7,71,62,9,59
Linfield,5890,2,15,9,6,60,27,33,54
Crusaders,5890,3,14,10,6,51,38,13,52
Glenavon,5890,4,15,7,8,51,40,11,52
Cliftonville,5890,5,13,5,12,52,42,10,44
Coleraine,5890,6,11,10,9,44,44,0,43
Dungannon,5890,7,11,9,10,53,42,11,42
Ballinamalla,5890,8,10,4,16,36,54,-18,34
Ards,5890,9,8,4,18,33,54,-21,28
Glentoran,5890,10,6,7,17,29,52,-23,25
Portadown,5890,11,6,6,18,27,52,-25,24
Crusaders,5891,1,18,5,7,61,38,23,59
Ballymena,5891,2,17,4,9,59,52,7,55
Linfield,5891,3,14,11,5,54,34,20,53
Coleraine,5891,4,12,9,9,44,41,3,45
Cliftonville,5891,5,13,5,12,44,41,3,44
Glenavon,5891,6,11,8,11,47,50,-3,41
Glentoran,5891,7,11,8,11,36,42,-6,41
Dungannon,5891,8,10,9,11,52,44,8,39
Ards,5891,9,7,7,16,34,49,-15,28
Portadown,5891,10,7,5,18,32,51,-19,26
Ballinamalla,5891,11,6,7,17,32,53,-21,25
Linfield,5892,1,17,9,4,62,29,33,60
Cliftonville,5892,2,15,4,11,50,41,9,49
Crusaders,5892,3,13,9,8,49,38,11,48
Coleraine,5892,4,12,10,8,40,33,7,46
Dungannon,5892,5,12,9,9,50,34,16,45
Glenavon,5892,6,11,11,8,43,41,2,44
Glentoran,5892,7,12,7,11,35,41,-6,43
Ballymena,5892,8,12,4,14,47,61,-14,40
Ards,5892,9,9,4,17,34,51,-17,31
Ballinamalla,5892,10,9,2,19,30,47,-17,29
Portadown,5892,11,6,5,19,22,46,-24,23
Linfield,5893,1,14,12,4,56,26,30,54
Ballymena,5893,2,16,6,8,70,60,10,54
Cliftonville,5893,3,16,5,9,53,38,15,53
Glenavon,5893,4,12,9,9,51,44,7,45
Crusaders,5893,5,13,4,13,56,60,-4,43
Coleraine,5893,6,10,12,8,43,44,-1,42
Dungannon,5893,7,10,9,11,59,50,9,39
Glentoran,5893,8,9,11,10,38,42,-4,38
Ballinamalla,5893,9,11,2,17,33,54,-21,35
Portadown,5893,10,7,6,17,25,49,-24,27
Ards,5893,11,6,6,18,30,47,-17,24
Cliftonville,5894,1,20,3,7,65,35,30,63
Crusaders,5894,2,17,6,7,57,40,17,57
Coleraine,5894,3,14,9,7,48,34,14,51
Linfield,5894,4,13,9,8,50,32,18,48
Ballymena,5894,5,13,7,10,60,59,1,46
Ards,5894,6,11,6,13,41,44,-3,39
Dungannon,5894,7,9,9,12,48,49,-1,36
Glenavon,5894,8,8,11,11,41,53,-12,35
Glentoran,5894,9,8,8,14,32,45,-13,32
Portadown,5894,10,7,7,16,29,50,-21,28
Ballinamalla,5894,11,5,5,20,24,54,-30,20
Cliftonville,5895,1,16,7,7,60,36,24,55
Linfield,5895,2,14,12,4,59,26,33,54
Ballymena,5895,3,15,5,10,61,61,0,50
Crusaders,5895,4,14,7,9,45,37,8,49
Glenavon,5895,5,9,12,9,52,52,0,39
Ballinamalla,5895,6,10,8,12,34,42,-8,38
Glentoran,5895,7,10,8,12,34,46,-12,38
Coleraine,5895,8,8,12,10,40,45,-5,36
Dungannon,5895,9,7,12,11,54,50,4,33
Ards,5895,10,8,4,18,38,58,-20,28
Portadown,5895,11,7,7,16,23,47,-24,28
Crusaders,5896,1,17,9,4,60,30,30,60
Linfield,5896,2,16,9,5,54,26,28,57
Ballymena,5896,3,15,7,8,56,53,3,52
Cliftonville,5896,4,13,7,10,50,42,8,46
Dungannon,5896,5,12,9,9,52,41,11,45
Glenavon,5896,6,11,12,7,48,46,2,45
Coleraine,5896,7,11,7,12,39,38,1,40
Glentoran,5896,8,7,11,12,29,40,-11,32
Ballinamalla,5896,9,7,4,19,35,55,-20,25
Portadown,5896,10,6,7,17,26,49,-23,25
Ards,5896,11,6,6,18,29,58,-29,24
Crusaders,5897,1,18,7,5,56,30,26,61
Cliftonville,5897,2,17,7,6,59,33,26,58
Ballymena,5897,3,15,6,9,60,55,5,51
Linfield,5897,4,12,10,8,49,30,19,46
Ards,5897,5,13,4,13,42,40,2,43
Coleraine,5897,6,11,9,10,44,42,2,42
Glenavon,5897,7,8,12,10,40,45,-5,36
Dungannon,5897,8,8,10,12,43,44,-1,34
Glentoran,5897,9,8,6,16,32,48,-16,30
Portadown,5897,10,8,4,18,21,52,-31,28
Ballinamalla,5897,11,7,5,18,28,55,-27,26
Crusaders,5898,1,17,9,4,65,38,27,60
Cliftonville,5898,2,17,6,7,61,41,20,57
Ballymena,5898,3,16,5,9,59,55,4,53
Glenavon,5898,4,10,10,10,50,50,0,40
Coleraine,5898,5,10,10,10,46,47,-1,40
Linfield,5898,6,10,9,11,50,43,7,39
Dungannon,5898,7,9,11,10,52,47,5,38
Glentoran,5898,8,10,8,12,36,44,-8,38
Ards,5898,9,9,10,11,38,41,-3,37
Portadown,5898,10,8,5,17,27,44,-17,29
Ballinamalla,5898,11,5,5,20,27,61,-34,20
Crusaders,5899,1,17,5,8,55,42,13,56
Coleraine,5899,2,14,11,5,44,30,14,53
Linfield,5899,3,15,7,8,60,34,26,52
Cliftonville,5899,4,14,6,10,56,46,10,48
Ballymena,5899,5,13,5,12,61,64,-3,44
Glenavon,5899,6,10,10,10,38,43,-5,40
Dungannon,5899,7,9,11,10,48,44,4,38
Ards,5899,8,11,5,14,49,55,-6,38
Ballinamalla,5899,9,11,3,16,42,53,-11,36
Portadown,5899,10,8,5,17,32,50,-18,29
Glentoran,5899,11,5,8,17,32,56,-24,23
Crusaders,5900,1,17,5,8,56,42,14,56
Glenavon,5900,2,15,9,6,54,34,20,54
Coleraine,5900,3,14,10,6,47,38,9,52
Linfield,5900,4,14,9,7,56,32,24,51
Ballymena,5900,5,11,8,11,58,62,-4,41
Cliftonville,5900,6,12,4,14,46,52,-6,40
Dungannon,5900,7,10,8,12,46,43,3,38
Ards,5900,8,11,4,15,35,49,-14,37
Portadown,5900,9,10,5,15,31,43,-12,35
Glentoran,5900,10,7,8,15,29,46,-17,29
Ballinamalla,5900,11,7,4,19,31,48,-17,25
Crusaders,5901,1,17,8,5,66,38,28,59
Cliftonville,5901,2,17,5,8,52,35,17,56
Coleraine,5901,3,14,10,6,51,38,13,52
Linfield,5901,4,14,9,7,64,38,26,51
Ballymena,5901,5,12,5,13,54,62,-8,41
Dungannon,5901,6,11,7,12,54,46,8,40
Glenavon,5901,7,9,11,10,48,53,-5,38
Glentoran,5901,8,9,10,11,34,43,-9,37
Ballinamalla,5901,9,6,10,14,27,44,-17,28
Ards,5901,10,6,7,17,32,55,-23,25
Portadown,5901,11,6,6,18,27,57,-30,24
Crusaders,5902,1,19,5,6,62,37,25,62
Linfield,5902,2,16,9,5,65,29,36,57
Coleraine,5902,3,13,8,9,48,42,6,47
Glenavon,5902,4,12,10,8,46,38,8,46
Cliftonville,5902,5,14,4,12,48,41,7,46
Ballymena,5902,6,13,6,11,57,60,-3,45
Portadown,5902,7,8,8,14,28,40,-12,32
Glentoran,5902,8,8,8,14,31,49,-18,32
Ballinamalla,5902,9,9,4,17,32,54,-22,31
Dungannon,5902,10,6,11,13,44,53,-9,29
Ards,5902,11,8,5,17,34,52,-18,29
Linfield,5903,1,18,7,5,67,32,35,61
Crusaders,5903,2,15,9,6,51,30,21,54
Cliftonville,5903,3,16,6,8,51,34,17,54
Coleraine,5903,4,14,9,7,46,32,14,51
Ballymena,5903,5,13,7,10,59,65,-6,46
Dungannon,5903,6,11,8,11,54,42,12,41
Glenavon,5903,7,8,11,11,41,52,-11,35
Glentoran,5903,8,9,7,14,30,50,-20,34
Ards,5903,9,9,5,16,37,45,-8,32
Portadown,5903,10,7,4,19,26,51,-25,25
Ballinamalla,5903,11,6,5,19,25,54,-29,23
Crusaders,5904,1,14,11,5,55,34,21,53
Ballymena,5904,2,16,4,10,52,51,1,52
Linfield,5904,3,14,8,8,50,27,23,50
Coleraine,5904,4,12,10,8,41,35,6,46
Glenavon,5904,5,11,12,7,46,38,8,45
Cliftonville,5904,6,14,3,13,44,44,0,45
Dungannon,5904,7,11,10,9,50,38,12,43
Ards,5904,8,10,4,16,33,47,-14,34
Glentoran,5904,9,8,9,13,26,40,-14,33
Ballinamalla,5904,10,8,4,18,28,51,-23,28
Portadown,5904,11,7,5,18,25,45,-20,26
Crusaders,5905,1,21,4,5,62,31,31,67
Linfield,5905,2,18,8,4,63,25,38,62
Cliftonville,5905,3,16,4,10,58,38,20,52
Coleraine,5905,4,12,10,8,39,36,3,46
Ballymena,5905,5,13,6,11,56,56,0,45
Glenavon,5905,6,10,10,10,42,45,-3,40
Dungannon,5905,7,9,9,12,47,49,-2,36
Glentoran,5905,8,8,8,14,25,45,-20,32
Ballinamalla,5905,9,9,4,17,29,49,-20,31
Ards,5905,10,7,5,18,30,50,-20,26
Portadown,5905,11,5,6,19,24,51,-27,21
Crusaders,5906,1,18,5,7,56,33,23,59
Linfield,5906,2,15,8,7,54,26,28,53
Dungannon,5906,3,14,8,8,56,38,18,50
Cliftonville,5906,4,14,6,10,53,43,10,48
Ballymena,5906,5,12,7,11,55,56,-1,43
Coleraine,5906,6,10,12,8,43,36,7,42
Glenavon,5906,7,11,9,10,47,52,-5,42
Ards,5906,8,10,4,16,33,55,-22,34
Glentoran,5906,9,8,9,13,23,37,-14,33
Ballinamalla,5906,10,9,2,19,28,51,-23,29
Portadown,5906,11,5,8,17,29,50,-21,23
Linfield,5907,1,16,8,6,57,29,28,56
Crusaders,5907,2,15,9,6,56,35,21,54
Cliftonville,5907,3,15,6,9,55,41,14,51
Glenavon,5907,4,14,8,8,52,42,10,50
Ballymena,5907,5,14,5,11,56,58,-2,47
Glentoran,5907,6,12,5,13,33,41,-8,41
Coleraine,5907,7,9,11,10,35,37,-2,38
Dungannon,5907,8,9,8,13,52,52,0,35
Ards,5907,9,10,4,16,37,51,-14,34
Portadown,5907,10,8,6,16,27,46,-19,30
Ballinamalla,5907,11,6,4,20,29,57,-28,22
Linfield,5908,1,15,9,6,61,30,31,54
Glenavon,5908,2,14,12,4,48,35,13,54
Crusaders,5908,3,15,6,9,54,39,15,51
Ballymena,5908,4,15,6,9,57,54,3,51
Coleraine,5908,5,13,10,7,41,32,9,49
Cliftonville,5908,6,14,6,10,56,42,14,48
Dungannon,5908,7,9,7,14,43,49,-6,34
Portadown,5908,8,9,5,16,29,45,-16,32
Ards,5908,9,9,4,17,37,50,-13,31
Glentoran,5908,10,7,6,17,24,45,-21,27
Ballinamalla,5908,11,8,3,19,31,60,-29,27
Crusaders,5909,1,16,8,6,62,39,23,56
Ballymena,5909,2,16,4,10,59,61,-2,52
Linfield,5909,3,13,10,7,57,32,25,49
Glenavon,5909,4,13,9,8,49,40,9,48
Dungannon,5909,5,13,8,9,54,43,11,47
Cliftonville,5909,6,14,3,13,50,43,7,45
Coleraine,5909,7,9,11,10,35,40,-5,38
Portadown,5909,8,9,5,16,32,51,-19,32
Ards,5909,9,8,7,15,37,49,-12,31
Glentoran,5909,10,8,7,15,31,43,-12,31
Ballinamalla,5909,11,8,4,18,31,56,-25,28
Crusaders,5910,1,16,5,9,58,39,19,53
Linfield,5910,2,14,8,8,57,37,20,50
Glenavon,5910,3,13,11,6,49,41,8,50
Coleraine,5910,4,12,13,5,41,29,12,49
Cliftonville,5910,5,14,5,11,54,45,9,47
Ballymena,5910,6,13,8,9,53,56,-3,47
Dungannon,5910,7,9,9,12,52,44,8,36
Glentoran,5910,8,8,7,15,36,51,-15,31
Ards,5910,9,9,4,17,33,49,-16,31
Portadown,5910,10,8,7,15,25,44,-19,31
Ballinamalla,5910,11,9,3,18,32,55,-23,30
Crusaders,5911,1,19,6,5,59,29,30,63
Cliftonville,5911,2,17,6,7,59,35,24,57
Linfield,5911,3,13,13,4,58,31,27,52
Ballymena,5911,4,14,7,9,60,56,4,49
Coleraine,5911,5,10,12,8,42,36,6,42
Dungannon,5911,6,10,10,10,45,38,7,40
Glenavon,5911,7,10,9,11,43,53,-10,39
Ards,5911,8,8,7,15,39,53,-14,31
Glentoran,5911,9,7,9,14,27,45,-18,30
Portadown,5911,10,7,5,18,26,53,-27,26
Ballinamalla,5911,11,6,4,20,26,55,-29,22
Crusaders,5912,1,17,7,6,62,37,25,58
Cliftonville,5912,2,17,5,8,58,32,26,56
Linfield,5912,3,14,10,6,56,36,20,52
Glenavon,5912,4,12,12,6,54,46,8,48
Dungannon,5912,5,12,9,9,54,40,14,45
Ballymena,5912,6,13,5,12,56,65,-9,44
Coleraine,5912,7,9,10,11,35,41,-6,37
Glentoran,5912,8,8,8,14,33,44,-11,32
Ballinamalla,5912,9,9,3,18,32,54,-22,30
Ards,5912,10,8,4,18,37,54,-17,28
Portadown,5912,11,7,5,18,27,55,-28,26
Crusaders,5913,1,16,9,5,61,40,21,57
Cliftonville,5913,2,15,7,8,61,44,17,52
Linfield,5913,3,12,11,7,54,32,22,47
Dungannon,5913,4,13,8,9,54,40,14,47
Coleraine,5913,5,12,10,8,40,38,2,46
Ballymena,5913,6,13,5,12,59,59,0,44
Glenavon,5913,7,10,11,9,46,45,1,41
Ards,5913,8,10,6,14,42,54,-12,36
Ballinamalla,5913,9,9,3,18,26,47,-21,30
Portadown,5913,10,7,6,17,25,45,-20,27
Glentoran,5913,11,6,8,16,24,48,-24,26
Crusaders,5914,1,16,6,8,53,33,20,54
Linfield,5914,2,14,10,6,55,30,25,52
Cliftonville,5914,3,15,7,8,54,40,14,52
Ballymena,5914,4,14,6,10,61,60,1,48
Coleraine,5914,5,12,10,8,41,35,6,46
Dungannon,5914,6,10,10,10,53,44,9,40
Glenavon,5914,7,9,11,10,44,49,-5,38
Ballinamalla,5914,8,9,5,16,38,56,-18,32
Ards,5914,9,7,9,14,34,47,-13,30
Portadown,5914,10,7,8,15,22,40,-18,29
Glentoran,5914,11,7,8,15,28,49,-21,29
Crusaders,5915,1,16,9,5,51,29,22,57
Linfield,5915,2,14,10,6,57,33,24,52
Cliftonville,5915,3,14,5,11,50,39,11,47
Ballymena,5915,4,13,7,10,59,58,1,46
Dungannon,5915,5,12,9,9,56,42,14,45
Glenavon,5915,6,11,10,9,57,53,4,43
Glentoran,5915,7,11,8,11,32,40,-8,41
Coleraine,5915,8,8,15,7,39,36,3,39
Ards,5915,9,9,6,15,39,50,-11,33
Ballinamalla,5915,10,7,4,19,29,59,-30,25
Portadown,5915,11,4,9,17,19,49,-30,21
Ballymena,5916,1,17,6,7,70,58,12,57
Cliftonville,5916,2,15,6,9,49,41,8,51
Crusaders,5916,3,13,11,6,55,35,20,50
Coleraine,5916,4,12,13,5,51,33,18,49
Glenavon,5916,5,12,10,8,50,44,6,46
Linfield,5916,6,12,8,10,57,40,17,44
Dungannon,5916,7,9,13,8,49,44,5,40
Glentoran,5916,8,9,9,12,32,44,-12,36
Ballinamalla,5916,9,7,7,16,26,50,-24,28
Ards,5916,10,6,6,18,31,54,-23,24
Portadown,5916,11,5,7,18,25,52,-27,22
Cliftonville,5917,1,15,7,8,46,37,9,52
Ballymena,5917,2,15,7,8,64,56,8,52
Linfield,5917,3,13,12,5,60,40,20,51
Glenavon,5917,4,12,9,9,46,45,1,45
Crusaders,5917,5,13,5,12,50,40,10,44
Glentoran,5917,6,12,8,10,40,41,-1,44
Dungannon,5917,7,11,8,11,52,43,9,41
Coleraine,5917,8,9,11,10,38,40,-2,38
Ards,5917,9,10,3,17,46,58,-12,33
Portadown,5917,10,6,9,15,28,48,-20,27
Ballinamalla,5917,11,8,3,19,32,54,-22,27
Crusaders,5918,1,17,6,7,52,36,16,57
Linfield,5918,2,15,8,7,52,29,23,53
Cliftonville,5918,3,12,9,9,54,46,8,45
Dungannon,5918,4,11,10,9,53,40,13,43
Ballymena,5918,5,12,7,11,58,61,-3,43
Glenavon,5918,6,10,12,8,52,48,4,42
Coleraine,5918,7,10,11,9,41,40,1,41
Ards,5918,8,10,7,13,39,46,-7,37
Glentoran,5918,9,8,8,14,31,44,-13,32
Ballinamalla,5918,10,9,5,16,38,56,-18,32
Portadown,5918,11,6,7,17,22,46,-24,25
Crusaders,5919,1,17,10,3,56,26,30,61
Cliftonville,5919,2,14,10,6,50,36,14,52
Ballymena,5919,3,15,6,9,64,52,12,51
Linfield,5919,4,13,11,6,61,38,23,50
Dungannon,5919,5,12,10,8,58,40,18,46
Glenavon,5919,6,9,11,10,42,52,-10,38
Coleraine,5919,7,7,15,8,35,39,-4,36
Glentoran,5919,8,8,9,13,33,45,-12,33
Ards,5919,9,8,7,15,40,51,-11,31
Portadown,5919,10,8,3,19,30,60,-30,27
Ballinamalla,5919,11,5,6,19,27,57,-30,21
Crusaders,5920,1,18,6,6,52,26,26,60
Cliftonville,5920,2,16,4,10,55,43,12,52
Linfield,5920,3,14,9,7,60,40,20,51
Coleraine,5920,4,13,8,9,45,38,7,47
Glenavon,5920,5,12,8,10,51,48,3,44
Ballymena,5920,6,12,8,10,54,60,-6,44
Dungannon,5920,7,12,7,11,44,42,2,43
Ballinamalla,5920,8,10,2,18,36,53,-17,32
Glentoran,5920,9,8,7,15,34,49,-15,31
Portadown,5920,10,8,4,18,25,44,-19,28
Ards,5920,11,6,9,15,33,46,-13,27
Crusaders,5921,1,19,5,6,58,34,24,62
Linfield,5921,2,16,7,7,62,35,27,55
Cliftonville,5921,3,16,6,8,54,39,15,54
Ballymena,5921,4,13,9,8,60,56,4,48
Glenavon,5921,5,13,9,8,52,48,4,48
Ards,5921,6,11,4,15,40,55,-15,37
Dungannon,5921,7,9,9,12,57,49,8,36
Coleraine,5921,8,8,9,13,38,40,-2,33
Ballinamalla,5921,9,9,6,15,31,53,-22,33
Glentoran,5921,10,8,5,17,33,51,-18,29
Portadown,5921,11,5,7,18,24,49,-25,22
Linfield,5922,1,18,7,5,67,32,35,61
Cliftonville,5922,2,17,5,8,64,40,24,56
Crusaders,5922,3,15,10,5,52,37,15,55
Glenavon,5922,4,13,9,8,53,41,12,48
Ballymena,5922,5,13,5,12,59,61,-2,44
Dungannon,5922,6,9,8,13,44,47,-3,35
Glentoran,5922,7,9,8,13,28,44,-16,35
Coleraine,5922,8,8,10,12,36,45,-9,34
Ballinamalla,5922,9,9,4,17,34,50,-16,31
Ards,5922,10,7,9,14,42,56,-14,30
Portadown,5922,11,6,7,17,27,53,-26,25
Cliftonville,5923,1,18,5,7,64,32,32,59
Crusaders,5923,2,17,5,8,59,36,23,56
Glenavon,5923,3,13,11,6,52,41,11,50
Linfield,5923,4,13,10,7,59,37,22,49
Ballymena,5923,5,13,8,9,51,53,-2,47
Coleraine,5923,6,12,8,10,43,35,8,44
Glentoran,5923,7,10,6,14,30,45,-15,36
Dungannon,5923,8,9,8,13,44,47,-3,35
Portadown,5923,9,7,8,15,26,49,-23,29
Ballinamalla,5923,10,7,4,19,29,55,-26,25
Ards,5923,11,6,7,17,32,59,-27,25
Crusaders,5924,1,16,8,6,57,40,17,56
Linfield,5924,2,14,11,5,57,32,25,53
Ballymena,5924,3,15,7,8,62,56,6,52
Cliftonville,5924,4,15,6,9,54,37,17,51
Coleraine,5924,5,12,9,9,46,41,5,45
Glenavon,5924,6,10,11,9,42,42,0,41
Ards,5924,7,12,3,15,38,43,-5,39
Dungannon,5924,8,9,8,13,46,48,-2,35
Glentoran,5924,9,10,5,15,31,47,-16,35
Ballinamalla,5924,10,5,8,17,30,51,-21,23
Portadown,5924,11,5,8,17,26,52,-26,23
Glenavon,5925,1,16,8,6,52,40,12,56
Cliftonville,5925,2,16,5,9,65,40,25,53
Coleraine,5925,3,13,9,8,41,33,8,48
Linfield,5925,4,13,8,9,52,33,19,47
Crusaders,5925,5,13,7,10,51,46,5,46
Ballymena,5925,6,13,5,12,61,64,-3,44
Dungannon,5925,7,11,9,10,47,39,8,42
Ballinamalla,5925,8,11,5,14,34,45,-11,38
Glentoran,5925,9,8,8,14,29,44,-15,32
Ards,5925,10,8,6,16,36,52,-16,30
Portadown,5925,11,5,6,19,24,56,-32,21
Cliftonville,5926,1,20,3,7,59,31,28,63
Crusaders,5926,2,15,5,10,44,34,10,50
Linfield,5926,3,13,10,7,53,36,17,49
Ballymena,5926,4,14,6,10,51,55,-4,48
Glenavon,5926,5,12,10,8,44,39,5,46
Coleraine,5926,6,11,10,9,44,34,10,43
Dungannon,5926,7,10,8,12,49,41,8,38
Glentoran,5926,8,9,6,15,24,47,-23,33
Ballinamalla,5926,9,9,4,17,28,43,-15,31
Ards,5926,10,7,8,15,34,47,-13,29
Portadown,5926,11,7,6,17,22,45,-23,27
Crusaders,5927,1,20,7,3,61,28,33,67
Ballymena,5927,2,17,4,9,59,57,2,55
Glenavon,5927,3,14,10,6,61,44,17,52
Linfield,5927,4,13,10,7,61,37,24,49
Cliftonville,5927,5,13,3,14,46,51,-5,42
Ards,5927,6,11,6,13,45,46,-1,39
Dungannon,5927,7,10,8,12,54,47,7,38
Coleraine,5927,8,8,10,12,36,45,-9,34
Portadown,5927,9,9,3,18,30,52,-22,30
Ballinamalla,5927,10,7,5,18,33,55,-22,26
Glentoran,5927,11,6,8,16,24,48,-24,26
Ballymena,5928,1,17,6,7,67,52,15,57
Crusaders,5928,2,14,10,6,50,33,17,52
Cliftonville,5928,3,15,6,9,55,43,12,51
Linfield,5928,4,12,10,8,55,37,18,46
Dungannon,5928,5,13,7,10,48,42,6,46
Coleraine,5928,6,11,10,9,46,41,5,43
Glentoran,5928,7,11,8,11,35,42,-7,41
Glenavon,5928,8,10,10,10,44,44,0,40
Ards,5928,9,8,4,18,42,60,-18,28
Ballinamalla,5928,10,8,4,18,34,52,-18,28
Portadown,5928,11,6,5,19,21,51,-30,23
Linfield,5929,1,18,7,5,57,27,30,61
Crusaders,5929,2,16,7,7,52,43,9,55
Ballymena,5929,3,12,9,9,56,52,4,45
Coleraine,5929,4,12,8,10,38,36,2,44
Cliftonville,5929,5,12,7,11,52,39,13,43
Dungannon,5929,6,12,7,11,53,45,8,43
Ards,5929,7,11,6,13,41,49,-8,39
Glenavon,5929,8,9,11,10,40,45,-5,38
Glentoran,5929,9,9,9,12,32,39,-7,36
Portadown,5929,10,7,8,15,26,42,-16,29
Ballinamalla,5929,11,5,5,20,24,54,-30,20
Linfield,5930,1,17,10,3,63,26,37,61
Crusaders,5930,2,16,5,9,55,38,17,53
Cliftonville,5930,3,15,7,8,54,41,13,52
Glenavon,5930,4,11,12,7,48,43,5,45
Dungannon,5930,5,12,8,10,57,45,12,44
Coleraine,5930,6,11,11,8,48,40,8,44
Ballymena,5930,7,11,7,12,55,68,-13,40
Glentoran,5930,8,8,10,12,34,47,-13,34
Portadown,5930,9,8,5,17,23,42,-19,29
Ballinamalla,5930,10,8,4,18,33,59,-26,28
Ards,5930,11,6,5,19,29,50,-21,23
Cliftonville,5931,1,19,4,7,54,33,21,61
Linfield,5931,2,15,12,3,66,27,39,57
Crusaders,5931,3,15,6,9,55,43,12,51
Ballymena,5931,4,13,4,13,53,60,-7,43
Ards,5931,5,12,5,13,38,43,-5,41
Dungannon,5931,6,11,7,12,53,46,7,40
Coleraine,5931,7,9,10,11,34,41,-7,37
Glenavon,5931,8,8,11,11,37,43,-6,35
Portadown,5931,9,9,7,14,23,41,-18,34
Glentoran,5931,10,8,8,14,34,47,-13,32
Ballinamalla,5931,11,7,4,19,27,50,-23,25
Cliftonville,5932,1,16,7,7,56,37,19,55
Crusaders,5932,2,14,10,6,57,38,19,52
Linfield,5932,3,13,9,8,55,32,23,48
Dungannon,5932,4,12,10,8,49,39,10,46
Coleraine,5932,5,12,10,8,45,36,9,46
Ballymena,5932,6,12,7,11,52,63,-11,43
Glenavon,5932,7,8,11,11,44,50,-6,35
Glentoran,5932,8,9,8,13,35,42,-7,35
Portadown,5932,9,9,5,16,24,43,-19,32
Ballinamalla,5932,10,8,7,15,27,47,-20,31
Ards,5932,11,7,6,17,32,49,-17,27
Crusaders,5933,1,17,8,5,61,32,29,59
Cliftonville,5933,2,18,3,9,60,38,22,57
Linfield,5933,3,15,8,7,57,32,25,53
Ballymena,5933,4,13,7,10,56,56,0,46
Glenavon,5933,5,11,13,6,50,52,-2,46
Coleraine,5933,6,11,9,10,40,42,-2,42
Dungannon,5933,7,11,8,11,56,46,10,41
Glentoran,5933,8,10,6,14,37,50,-13,36
Ards,5933,9,8,6,16,36,51,-15,30
Ballinamalla,5933,10,6,6,18,32,56,-24,24
Portadown,5933,11,4,8,18,24,54,-30,20
Ballymena,5934,1,16,9,5,57,47,10,57
Cliftonville,5934,2,15,5,10,51,39,12,50
Crusaders,5934,3,13,8,9,53,43,10,47
Glenavon,5934,4,12,9,9,52,46,6,45
Glentoran,5934,5,13,6,11,36,37,-1,45
Linfield,5934,6,11,11,8,59,42,17,44
Dungannon,5934,7,11,8,11,50,43,7,41
Coleraine,5934,8,10,10,10,41,40,1,40
Portadown,5934,9,7,8,15,22,42,-20,29
Ballinamalla,5934,10,8,4,18,31,52,-21,28
Ards,5934,11,6,8,16,34,55,-21,26
Ballymena,5935,1,18,3,9,69,51,18,57
Linfield,5935,2,16,8,6,57,27,30,56
Crusaders,5935,3,15,6,9,49,33,16,51
Glenavon,5935,4,13,11,6,48,38,10,50
Cliftonville,5935,5,14,6,10,45,38,7,48
Dungannon,5935,6,11,10,9,47,41,6,43
Ards,5935,7,11,5,14,40,42,-2,38
Coleraine,5935,8,7,12,11,39,49,-10,33
Glentoran,5935,9,9,5,16,29,51,-22,32
Ballinamalla,5935,10,7,4,19,28,52,-24,25
Portadown,5935,11,6,6,18,22,51,-29,24
Cliftonville,5936,1,16,6,8,56,39,17,54
Linfield,5936,2,14,9,7,59,36,23,51
Crusaders,5936,3,14,9,7,49,30,19,51
Ballymena,5936,4,14,7,9,64,62,2,49
Glenavon,5936,5,12,11,7,45,40,5,47
Coleraine,5936,6,9,12,9,36,34,2,39
Dungannon,5936,7,9,11,10,47,43,4,38
Ards,5936,8,10,6,14,40,49,-9,36
Glentoran,5936,9,8,9,13,29,44,-15,33
Ballinamalla,5936,10,8,4,18,30,51,-21,28
Portadown,5936,11,6,6,18,23,50,-27,24
Ballymena,5937,1,18,6,6,64,53,11,60
Crusaders,5937,2,15,9,6,53,36,17,54
Cliftonville,5937,3,15,6,9,61,44,17,51
Linfield,5937,4,13,8,9,53,36,17,47
Glenavon,5937,5,12,9,9,53,49,4,45
Coleraine,5937,6,9,12,9,43,35,8,39
Dungannon,5937,7,10,8,12,49,42,7,38
Glentoran,5937,8,9,8,13,31,44,-13,35
Portadown,5937,9,9,5,16,33,48,-15,32
Ards,5937,10,9,3,18,32,57,-25,30
Ballinamalla,5937,11,8,2,20,29,57,-28,26
Crusaders,5938,1,17,6,7,55,30,25,57
Cliftonville,5938,2,14,8,8,50,37,13,50
Coleraine,5938,3,14,8,8,42,37,5,50
Ballymena,5938,4,13,10,7,58,54,4,49
Glentoran,5938,5,12,7,11,42,43,-1,43
Linfield,5938,6,10,12,8,53,40,13,42
Glenavon,5938,7,11,9,10,40,42,-2,42
Dungannon,5938,8,11,7,12,49,42,7,40
Portadown,5938,9,10,5,15,27,40,-13,35
Ballinamalla,5938,10,7,4,19,30,59,-29,25
Ards,5938,11,5,6,19,28,50,-22,21
Crusaders,5939,1,17,8,5,60,35,25,59
Linfield,5939,2,16,8,6,68,36,32,56
Cliftonville,5939,3,17,4,9,53,37,16,55
Glenavon,5939,4,10,12,8,43,40,3,42
Ballymena,5939,5,12,6,12,58,64,-6,42
Glentoran,5939,6,11,9,10,37,44,-7,42
Coleraine,5939,7,10,9,11,40,41,-1,39
Dungannon,5939,8,10,8,12,48,44,4,38
Ards,5939,9,11,4,15,38,45,-7,37
Ballinamalla,5939,10,7,4,19,29,55,-26,25
Portadown,5939,11,6,4,20,20,53,-33,22
Linfield,5940,1,18,7,5,68,32,36,61
Crusaders,5940,2,17,10,3,53,25,28,61
Ballymena,5940,3,15,4,11,50,56,-6,49
Cliftonville,5940,4,15,3,12,47,39,8,48
Coleraine,5940,5,12,10,8,39,32,7,46
Glenavon,5940,6,10,15,5,47,37,10,45
Dungannon,5940,7,8,10,12,53,48,5,34
Glentoran,5940,8,9,7,14,27,40,-13,34
Ards,5940,9,8,6,16,34,50,-16,30
Portadown,5940,10,8,5,17,24,48,-24,29
Ballinamalla,5940,11,4,5,21,22,57,-35,17
Cliftonville,5941,1,17,5,8,59,39,20,56
Linfield,5941,2,15,10,5,61,27,34,55
Crusaders,5941,3,16,7,7,50,31,19,55
Ballymena,5941,4,14,7,9,59,61,-2,49
Coleraine,5941,5,13,8,9,48,35,13,47
Glenavon,5941,6,8,15,7,39,43,-4,39
Glentoran,5941,7,10,8,12,36,44,-8,38
Dungannon,5941,8,7,14,9,42,40,2,35
Ards,5941,9,8,5,17,33,52,-19,29
Ballinamalla,5941,10,8,3,19,31,55,-24,27
Portadown,5941,11,5,6,19,28,59,-31,21
Crusaders,5942,1,18,6,6,57,40,17,60
Ballymena,5942,2,16,7,7,65,55,10,55
Cliftonville,5942,3,16,4,10,56,42,14,52
Coleraine,5942,4,11,10,9,45,35,10,43
Glenavon,5942,5,11,10,9,44,47,-3,43
Linfield,5942,6,11,8,11,49,38,11,41
Ards,5942,7,10,6,14,42,48,-6,36
Dungannon,5942,8,8,11,11,51,46,5,35
Portadown,5942,9,9,6,15,34,51,-17,33
Ballinamalla,5942,10,9,3,18,34,59,-25,30
Glentoran,5942,11,6,9,15,32,48,-16,27
Linfield,5943,1,18,7,5,68,26,42,61
Crusaders,5943,2,16,9,5,59,33,26,57
Glenavon,5943,3,12,14,4,51,39,12,50
Coleraine,5943,4,13,10,7,49,44,5,49
Cliftonville,5943,5,14,6,10,47,40,7,48
Ballymena,5943,6,13,4,13,55,60,-5,43
Dungannon,5943,7,9,10,11,48,39,9,37
Glentoran,5943,8,8,7,15,26,46,-20,31
Ards,5943,9,8,4,18,35,59,-24,28
Portadown,5943,10,6,8,16,25,47,-22,26
Ballinamalla,5943,11,5,7,18,28,58,-30,22
Cliftonville,5944,1,16,5,9,57,37,20,53
Dungannon,5944,2,14,6,10,59,46,13,48
Linfield,5944,3,13,7,10,54,37,17,46
Glenavon,5944,4,12,10,8,45,40,5,46
Crusaders,5944,5,12,9,9,48,38,10,45
Ballymena,5944,6,13,6,11,59,64,-5,45
Coleraine,5944,7,10,14,6,45,39,6,44
Ards,5944,8,11,4,15,39,47,-8,37
Ballinamalla,5944,9,11,4,15,30,48,-18,37
Glentoran,5944,10,8,5,17,30,50,-20,29
Portadown,5944,11,8,4,18,26,46,-20,28
Linfield,5945,1,14,10,6,51,30,21,52
Cliftonville,5945,2,15,7,8,53,35,18,52
Crusaders,5945,3,13,11,6,53,39,14,50
Coleraine,5945,4,13,10,7,46,39,7,49
Glenavon,5945,5,9,13,8,50,49,1,40
Ballymena,5945,6,11,6,13,43,51,-8,39
Dungannon,5945,7,8,11,11,50,49,1,35
Ards,5945,8,10,5,15,40,46,-6,35
Portadown,5945,9,8,10,12,28,37,-9,34
Ballinamalla,5945,10,8,7,15,35,50,-15,31
Glentoran,5945,11,8,6,16,30,54,-24,30
Crusaders,5946,1,18,6,6,60,37,23,60
Linfield,5946,2,14,12,4,54,26,28,54
Cliftonville,5946,3,16,4,10,57,41,16,52
Ballymena,5946,4,12,7,11,58,59,-1,43
Coleraine,5946,5,9,15,6,42,36,6,42
Ballinamalla,5946,6,13,3,14,43,49,-6,42
Dungannon,5946,7,11,8,11,49,44,5,41
Glenavon,5946,8,8,10,12,41,51,-10,34
Glentoran,5946,9,7,9,14,31,47,-16,30
Portadown,5946,10,8,5,17,29,53,-24,29
Ards,5946,11,7,5,18,33,54,-21,26
Crusaders,5947,1,16,8,6,54,35,19,56
Linfield,5947,2,14,9,7,60,30,30,51
Ballymena,5947,3,15,5,10,53,55,-2,50
Cliftonville,5947,4,14,6,10,45,34,11,48
Glenavon,5947,5,11,10,9,48,46,2,43
Coleraine,5947,6,10,10,10,39,38,1,40
Dungannon,5947,7,10,8,12,49,49,0,38
Glentoran,5947,8,9,8,13,26,38,-12,35
Portadown,5947,9,9,6,15,24,41,-17,33
Ards,5947,10,9,5,16,38,51,-13,32
Ballinamalla,5947,11,8,5,17,27,46,-19,29
Crusaders,5948,1,17,8,5,57,33,24,59
Linfield,5948,2,15,8,7,60,32,28,53
Ballymena,5948,3,15,5,10,63,61,2,50
Cliftonville,5948,4,14,6,10,56,42,14,48
Glenavon,5948,5,12,11,7,46,46,0,47
Coleraine,5948,6,9,11,10,36,46,-10,38
Portadown,5948,7,11,3,16,34,45,-11,36
Ballinamalla,5948,8,10,4,16,35,52,-17,34
Ards,5948,9,10,3,17,45,56,-11,33
Dungannon,5948,10,7,10,13,44,47,-3,31
Glentoran,5948,11,7,7,16,27,43,-16,28
Crusaders,5949,1,17,8,5,60,33,27,59
Linfield,5949,2,15,11,4,61,28,33,56
Cliftonville,5949,3,15,3,12,45,42,3,48
Ballymena,5949,4,13,9,8,54,56,-2,48
Glenavon,5949,5,12,11,7,47,40,7,47
Coleraine,5949,6,11,7,12,49,47,2,40
Ards,5949,7,11,5,14,38,44,-6,38
Dungannon,5949,8,10,7,13,44,40,4,37
Glentoran,5949,9,8,9,13,33,48,-15,33
Ballinamalla,5949,10,7,6,17,32,54,-22,27
Portadown,5949,11,5,6,19,20,51,-31,21
Ballymena,5950,1,19,4,7,64,51,13,61
Glenavon,5950,2,15,8,7,56,34,22,53
Crusaders,5950,3,14,9,7,53,38,15,51
Cliftonville,5950,4,16,3,11,50,41,9,51
Linfield,5950,5,12,9,9,48,30,18,45
Dungannon,5950,6,12,8,10,56,42,14,44
Coleraine,5950,7,10,8,12,34,41,-7,38
Ballinamalla,5950,8,10,6,14,26,41,-15,36
Ards,5950,9,8,6,16,34,53,-19,30
Glentoran,5950,10,7,6,17,28,53,-25,27
Portadown,5950,11,6,5,19,26,51,-25,23
Crusaders,5951,1,17,6,7,55,37,18,57
Linfield,5951,2,16,8,6,68,34,34,56
Cliftonville,5951,3,17,4,9,62,39,23,55
Ballymena,5951,4,13,5,12,60,63,-3,44
Dungannon,5951,5,11,8,11,47,43,4,41
Coleraine,5951,6,10,11,9,41,41,0,41
Glenavon,5951,7,9,13,8,43,42,1,40
Ards,5951,8,9,5,16,37,52,-15,32
Glentoran,5951,9,8,8,14,29,46,-17,32
Ballinamalla,5951,10,9,5,16,36,55,-19,32
Portadown,5951,11,6,7,17,22,48,-26,25
Crusaders,5952,1,15,8,7,50,36,14,53
Cliftonville,5952,2,15,6,9,49,38,11,51
Linfield,5952,3,13,10,7,54,30,24,49
Glenavon,5952,4,12,10,8,50,42,8,46
Ballymena,5952,5,12,10,8,61,57,4,46
Dungannon,5952,6,10,8,12,46,38,8,38
Glentoran,5952,7,9,9,12,29,41,-12,36
Coleraine,5952,8,9,8,13,35,50,-15,35
Ards,5952,9,9,6,15,37,46,-9,33
Portadown,5952,10,9,6,15,27,45,-18,33
Ballinamalla,5952,11,9,5,16,33,48,-15,32
Crusaders,5953,1,17,8,5,59,36,23,59
Cliftonville,5953,2,15,8,7,58,38,20,53
Linfield,5953,3,14,9,7,60,29,31,51
Coleraine,5953,4,13,9,8,47,43,4,48
Glenavon,5953,5,12,10,8,54,50,4,46
Ballymena,5953,6,13,6,11,51,57,-6,45
Glentoran,5953,7,10,7,13,34,43,-9,37
Dungannon,5953,8,9,9,12,46,45,1,36
Ballinamalla,5953,9,10,3,17,36,53,-17,33
Ards,5953,10,8,3,19,36,57,-21,27
Portadown,5953,11,6,4,20,24,54,-30,22
Crusaders,5954,1,17,8,5,56,33,23,59
Cliftonville,5954,2,17,5,8,55,38,17,56
Ballymena,5954,3,15,6,9,57,54,3,51
Linfield,5954,4,13,9,8,58,37,21,48
Glenavon,5954,5,12,11,7,54,46,8,47
Dungannon,5954,6,12,7,11,58,45,13,43
Coleraine,5954,7,10,9,11,40,42,-2,39
Glentoran,5954,8,8,11,11,32,44,-12,35
Ards,5954,9,7,5,18,38,58,-20,26
Portadown,5954,10,7,5,18,25,50,-25,26
Ballinamalla,5954,11,7,4,19,33,59,-26,25
Crusaders,5955,1,19,7,4,59,30,29,64
Ballymena,5955,2,16,5,9,57,53,4,53
Coleraine,5955,3,14,9,7,50,36,14,51
Linfield,5955,4,12,12,6,54,34,20,48
Cliftonville,5955,5,14,4,12,52,47,5,46
Dungannon,5955,6,11,9,10,46,36,10,42
Glenavon,5955,7,10,12,8,49,41,8,42
Ards,5955,8,5,13,12,34,48,-14,28
Glentoran,5955,9,7,7,16,28,49,-21,28
Portadown,5955,10,7,5,18,26,48,-22,26
Ballinamalla,5955,11,6,5,19,21,54,-33,23
Crusaders,5956,1,15,10,5,59,41,18,55
Linfield,5956,2,15,9,6,64,34,30,54
Ballymena,5956,3,15,6,9,63,52,11,51
Cliftonville,5956,4,14,8,8,51,39,12,50
Glenavon,5956,5,13,11,6,55,44,11,50
Dungannon,5956,6,9,12,9,44,39,5,39
Ards,5956,7,11,4,15,40,44,-4,37
Glentoran,5956,8,9,8,13,37,44,-7,35
Coleraine,5956,9,7,9,14,32,51,-19,30
Portadown,5956,10,8,4,18,24,54,-30,28
Ballinamalla,5956,11,6,5,19,31,58,-27,23
Crusaders,5957,1,17,7,6,58,31,27,58
Linfield,5957,2,15,7,8,52,26,26,52
Glenavon,5957,3,13,12,5,51,39,12,51
Cliftonville,5957,4,14,5,11,49,43,6,47
Coleraine,5957,5,11,11,8,38,33,5,44
Dungannon,5957,6,10,10,10,47,43,4,40
Ballymena,5957,7,10,7,13,50,58,-8,37
Glentoran,5957,8,9,10,11,31,39,-8,37
Ballinamalla,5957,9,10,2,18,33,53,-20,32
Portadown,5957,10,7,8,15,26,48,-22,29
Ards,5957,11,7,5,18,31,53,-22,26
Linfield,5958,1,18,8,4,69,31,38,62
Crusaders,5958,2,18,6,6,58,33,25,60
Cliftonville,5958,3,16,4,10,56,42,14,52
Glenavon,5958,4,13,9,8,45,38,7,48
Coleraine,5958,5,11,10,9,36,35,1,43
Ballymena,5958,6,13,4,13,61,66,-5,43
Dungannon,5958,7,9,8,13,47,51,-4,35
Glentoran,5958,8,7,11,12,31,46,-15,32
Portadown,5958,9,9,5,16,31,47,-16,32
Ards,5958,10,9,4,17,36,51,-15,31
Ballinamalla,5958,11,5,5,20,29,59,-30,20
Crusaders,5959,1,17,6,7,56,33,23,57
Ballymena,5959,2,14,7,9,62,59,3,49
Glenavon,5959,3,13,9,8,52,40,12,48
Linfield,5959,4,13,8,9,54,34,20,47
Cliftonville,5959,5,14,4,12,50,49,1,46
Coleraine,5959,6,10,10,10,40,37,3,40
Ballinamalla,5959,7,12,3,15,29,47,-18,39
Glentoran,5959,8,10,8,12,35,46,-11,38
Dungannon,5959,9,8,10,12,41,42,-1,34
Ards,5959,10,9,5,16,41,50,-9,32
Portadown,5959,11,6,8,16,21,44,-23,26
Crusaders,5960,1,16,9,5,61,30,31,57
Linfield,5960,2,14,10,6,49,24,25,52
Glenavon,5960,3,13,10,7,44,41,3,49
Ballymena,5960,4,14,7,9,57,58,-1,49
Coleraine,5960,5,12,9,9,47,38,9,45
Cliftonville,5960,6,12,6,12,46,44,2,42
Dungannon,5960,7,10,10,10,50,42,8,40
Ards,5960,8,10,6,14,40,47,-7,36
Ballinamalla,5960,9,8,5,17,28,53,-25,29
Glentoran,5960,10,7,7,16,27,51,-24,28
Portadown,5960,11,6,7,17,26,47,-21,25
Glenavon,5961,1,14,10,6,54,44,10,52
Ballymena,5961,2,15,7,8,62,56,6,52
Crusaders,5961,3,15,6,9,48,37,11,51
Linfield,5961,4,13,9,8,57,40,17,48
Cliftonville,5961,5,13,7,10,49,41,8,46
Coleraine,5961,6,12,10,8,49,44,5,46
Dungannon,5961,7,11,11,8,55,39,16,44
Glentoran,5961,8,8,9,13,29,41,-12,33
Ards,5961,9,7,8,15,36,48,-12,29
Portadown,5961,10,6,8,16,24,48,-24,26
Ballinamalla,5961,11,5,7,18,28,53,-25,22
Crusaders,5962,1,15,9,6,50,29,21,54
Ballymena,5962,2,16,5,9,61,57,4,53
Linfield,5962,3,13,10,7,50,29,21,49
Coleraine,5962,4,13,10,7,40,31,9,49
Cliftonville,5962,5,15,3,12,55,48,7,48
Glenavon,5962,6,11,12,7,49,42,7,45
Dungannon,5962,7,9,10,11,43,43,0,37
Ards,5962,8,9,7,14,36,48,-12,34
Portadown,5962,9,8,6,16,26,45,-19,30
Ballinamalla,5962,10,8,4,18,32,49,-17,28
Glentoran,5962,11,7,6,17,26,47,-21,27
Crusaders,5963,1,17,8,5,60,33,27,59
Linfield,5963,2,13,9,8,51,29,22,48
Cliftonville,5963,3,13,8,9,46,36,10,47
Glenavon,5963,4,12,11,7,51,45,6,47
Ballymena,5963,5,13,7,10,49,54,-5,46
Dungannon,5963,6,11,9,10,54,44,10,42
Ballinamalla,5963,7,12,3,15,33,48,-15,39
Glentoran,5963,8,11,4,15,31,48,-17,37
Coleraine,5963,9,8,10,12,38,44,-6,34
Ards,5963,10,8,6,16,36,45,-9,30
Portadown,5963,11,6,7,17,20,43,-23,25
Crusaders,5964,1,16,6,8,52,34,18,54
Cliftonville,5964,2,15,5,10,54,42,12,50
Coleraine,5964,3,14,8,8,45,40,5,50
Linfield,5964,4,12,12,6,58,31,27,48
Ballymena,5964,5,13,6,11,58,61,-3,45
Glentoran,5964,6,13,6,11,32,37,-5,45
Dungannon,5964,7,12,8,10,54,44,10,44
Glenavon,5964,8,10,11,9,42,42,0,41
Ballinamalla,5964,9,8,6,16,30,47,-17,30
Ards,5964,10,6,7,17,31,53,-22,25
Portadown,5964,11,6,5,19,29,54,-25,23
Cliftonville,5965,1,18,2,10,57,34,23,56
Linfield,5965,2,15,8,7,59,31,28,53
Crusaders,5965,3,14,10,6,56,40,16,52
Coleraine,5965,4,14,8,8,48,37,11,50
Ballymena,5965,5,13,6,11,59,56,3,45
Dungannon,5965,6,11,9,10,51,40,11,42
Glenavon,5965,7,9,11,10,48,52,-4,38
Ballinamalla,5965,8,9,6,15,26,44,-18,33
Glentoran,5965,9,9,6,15,29,49,-20,33
Ards,5965,10,8,6,16,33,49,-16,30
Portadown,5965,11,7,4,19,20,54,-34,25
Ballymena,5966,1,17,5,8,66,56,10,56
Crusaders,5966,2,15,7,8,43,32,11,52
Glenavon,5966,3,12,11,7,52,46,6,47
Linfield,5966,4,13,7,10,53,40,13,46
Cliftonville,5966,5,13,7,10,48,42,6,46
Dungannon,5966,6,12,9,9,57,43,14,45
Coleraine,5966,7,10,13,7,38,31,7,43
Ards,5966,8,10,5,15,34,42,-8,35
Glentoran,5966,9,9,8,13,30,40,-10,35
Ballinamalla,5966,10,8,2,20,29,53,-24,26
Portadown,5966,11,6,6,18,24,49,-25,24
Crusaders,5967,1,16,6,8,57,40,17,54
Ballymena,5967,2,14,5,11,62,62,0,47
Cliftonville,5967,3,13,7,10,50,43,7,46
Linfield,5967,4,11,11,8,49,31,18,44
Glenavon,5967,5,10,12,8,45,49,-4,42
Coleraine,5967,6,10,11,9,39,32,7,41
Portadown,5967,7,11,6,13,30,40,-10,39
Glentoran,5967,8,9,9,12,35,45,-10,36
Dungannon,5967,9,9,8,13,45,48,-3,35
Ards,5967,10,8,10,12,39,48,-9,34
Ballinamalla,5967,11,9,5,16,38,51,-13,32
Crusaders,5968,1,16,9,5,52,32,20,57
Linfield,5968,2,15,10,5,56,28,28,55
Coleraine,5968,3,12,12,6,44,31,13,48
Glenavon,5968,4,13,9,8,49,39,10,48
Ballymena,5968,5,13,6,11,60,57,3,45
Cliftonville,5968,6,13,6,11,47,44,3,45
Dungannon,5968,7,10,11,9,56,40,16,41
Ards,5968,8,8,7,15,36,54,-18,31
Portadown,5968,9,8,6,16,24,48,-24,30
Glentoran,5968,10,6,10,14,25,51,-26,28
Ballinamalla,5968,11,4,8,18,24,49,-25,20
Linfield,5969,1,15,11,4,59,25,34,56
Crusaders,5969,2,15,11,4,56,30,26,56
Ballymena,5969,3,14,8,8,54,53,1,50
Glenavon,5969,4,13,9,8,47,41,6,48
Cliftonville,5969,5,14,4,12,41,33,8,46
Dungannon,5969,6,10,10,10,45,38,7,40
Coleraine,5969,7,9,11,10,34,40,-6,38
Portadown,5969,8,11,4,15,30,42,-12,37
Glentoran,5969,9,8,9,13,26,40,-14,33
Ards,5969,10,7,7,16,32,48,-16,28
Ballinamalla,5969,11,5,4,21,23,57,-34,19
Ballymena,5970,1,16,7,7,67,57,10,55
Linfield,5970,2,14,10,6,60,34,26,52
Crusaders,5970,3,15,7,8,55,40,15,52
Glenavon,5970,4,13,9,8,54,47,7,48
Cliftonville,5970,5,14,4,12,46,42,4,46
Coleraine,5970,6,10,12,8,37,34,3,42
Dungannon,5970,7,9,9,12,55,46,9,36
Portadown,5970,8,10,5,15,26,43,-17,35
Glentoran,5970,9,7,11,12,34,44,-10,32
Ards,5970,10,9,3,18,38,60,-22,30
Ballinamalla,5970,11,8,3,19,28,53,-25,27
Crusaders,5971,1,17,7,6,52,28,24,58
Cliftonville,5971,2,17,3,10,58,37,21,54
Linfield,5971,3,13,10,7,55,33,22,49
Ballymena,5971,4,14,6,10,57,61,-4,48
Glentoran,5971,5,13,4,13,34,42,-8,43
Glenavon,5971,6,10,12,8,43,40,3,42
Coleraine,5971,7,10,11,9,37,37,0,41
Dungannon,5971,8,10,9,11,45,39,6,39
Ballinamalla,5971,9,9,7,14,37,47,-10,34
Ards,5971,10,7,6,17,40,57,-17,27
Portadown,5971,11,5,5,20,21,58,-37,20
Crusaders,5972,1,16,8,6,55,31,24,56
Linfield,5972,2,15,8,7,61,33,28,53
Ballymena,5972,3,14,7,9,64,57,7,49
Cliftonville,5972,4,13,7,10,50,41,9,46
Glenavon,5972,5,11,11,8,45,46,-1,44
Coleraine,5972,6,11,9,10,33,40,-7,42
Portadown,5972,7,9,7,14,28,45,-17,34
Ards,5972,8,9,6,15,37,49,-12,33
Glentoran,5972,9,8,8,14,32,49,-17,32
Ballinamalla,5972,10,8,7,15,32,46,-14,31
Dungannon,5972,11,6,12,12,42,42,0,30
Crusaders,5973,1,17,7,6,55,33,22,58
Linfield,5973,2,15,8,7,65,33,32,53
Ballymena,5973,3,15,8,7,60,50,10,53
Cliftonville,5973,4,13,8,9,43,36,7,47
Coleraine,5973,5,12,10,8,42,38,4,46
Dungannon,5973,6,12,8,10,52,45,7,44
Glenavon,5973,7,9,9,12,47,47,0,36
Glentoran,5973,8,9,8,13,26,41,-15,35
Ballinamalla,5973,9,8,6,16,29,50,-21,30
Ards,5973,10,7,6,17,30,52,-22,27
Portadown,5973,11,7,4,19,28,52,-24,25
Linfield,5974,1,16,7,7,56,28,28,55
Crusaders,5974,2,15,10,5,53,34,19,55
Ballymena,5974,3,15,6,9,53,48,5,51
Coleraine,5974,4,13,9,8,44,38,6,48
Dungannon,5974,5,11,9,10,53,42,11,42
Cliftonville,5974,6,11,7,12,43,47,-4,40
Glenavon,5974,7,9,10,11,44,47,-3,37
Portadown,5974,8,9,8,13,25,37,-12,35
Glentoran,5974,9,8,9,13,31,47,-16,33
Ards,5974,10,9,3,18,37,51,-14,30
Ballinamalla,5974,11,8,4,18,32,52,-20,28
Crusaders,5975,1,17,7,6,56,36,20,58
Ballymena,5975,2,17,7,6,64,49,15,58
Cliftonville,5975,3,14,5,11,54,44,10,47
Coleraine,5975,4,11,12,7,41,38,3,45
Linfield,5975,5,11,11,8,57,37,20,44
Glenavon,5975,6,8,16,6,51,47,4,40
Dungannon,5975,7,9,11,10,52,49,3,38
Ballinamalla,5975,8,10,5,15,34,50,-16,35
Glentoran,5975,9,8,7,15,27,45,-18,31
Ards,5975,10,8,4,18,34,50,-16,28
Portadown,5975,11,6,7,17,26,51,-25,25
Crusaders,5976,1,18,8,4,57,28,29,62
Cliftonville,5976,2,15,6,9,55,41,14,51
Linfield,5976,3,13,11,6,54,33,21,50
Ballymena,5976,4,13,8,9,63,64,-1,47
Glenavon,5976,5,12,9,9,52,42,10,45
Dungannon,5976,6,11,8,11,56,47,9,41
Coleraine,5976,7,9,13,8,41,41,0,40
Glentoran,5976,8,10,7,13,34,44,-10,37
Ballinamalla,5976,9,9,2,19,33,58,-25,29
Ards,5976,10,7,7,16,36,52,-16,28
Portadown,5976,11,7,3,20,27,58,-31,24
Crusaders,5977,1,19,6,5,63,37,26,63
Linfield,5977,2,15,9,6,64,33,31,54
Ballymena,5977,3,15,7,8,67,59,8,52
Cliftonville,5977,4,14,7,9,51,36,15,49
Glenavon,5977,5,12,9,9,52,48,4,45
Coleraine,5977,6,10,11,9,44,46,-2,41
Ards,5977,7,10,3,17,41,53,-12,33
Glentoran,5977,8,8,8,14,35,53,-18,32
Dungannon,5977,9,7,9,14,49,59,-10,30
Portadown,5977,10,8,6,16,27,43,-16,30
Ballinamalla,5977,11,7,5,18,33,59,-26,26
Cliftonville,5978,1,18,4,8,63,37,26,58
Linfield,5978,2,15,12,3,62,32,30,57
Crusaders,5978,3,13,7,10,49,39,10,46
Glenavon,5978,4,12,10,8,53,44,9,46
Ballymena,5978,5,12,7,11,56,71,-15,43
Coleraine,5978,6,11,9,10,44,40,4,42
Glentoran,5978,7,11,6,13,36,46,-10,39
Dungannon,5978,8,9,11,10,54,48,6,38
Ballinamalla,5978,9,9,4,17,37,58,-21,31
Ards,5978,10,7,7,16,35,48,-13,28
Portadown,5978,11,7,5,18,29,55,-26,26
Crusaders,5979,1,17,10,3,54,26,28,61
Ballymena,5979,2,15,8,7,53,48,5,53
Cliftonville,5979,3,13,9,8,51,40,11,48
Linfield,5979,4,12,11,7,55,38,17,47
Coleraine,5979,5,11,13,6,38,31,7,46
Glenavon,5979,6,11,12,7,47,39,8,45
Dungannon,5979,7,7,14,9,45,41,4,35
Glentoran,5979,8,7,11,12,32,46,-14,32
Ards,5979,9,8,6,16,34,52,-18,30
Portadown,5979,10,5,9,16,23,46,-23,24
Ballinamalla,5979,11,5,5,20,27,52,-25,20
Linfield,5980,1,18,7,5,63,31,32,61
Crusaders,5980,2,16,8,6,59,38,21,56
Coleraine,5980,3,14,9,7,46,34,12,51
Glenavon,5980,4,12,10,8,50,47,3,46
Ballymena,5980,5,12,9,9,53,56,-3,45
Dungannon,5980,6,11,10,9,51,36,15,43
Cliftonville,5980,7,10,4,16,42,49,-7,34
Ballinamalla,5980,8,8,9,13,34,50,-16,33
Glentoran,5980,9,8,8,14,30,44,-14,32
Portadown,5980,10,8,4,18,29,45,-16,28
Ards,5980,11,6,6,18,34,61,-27,24
Cliftonville,5981,1,17,8,5,50,30,20,59
Linfield,5981,2,14,9,7,54,33,21,51
Crusaders,5981,3,13,10,7,52,37,15,49
Coleraine,5981,4,11,11,8,40,33,7,44
Ballymena,5981,5,11,8,11,56,58,-2,41
Glentoran,5981,6,11,7,12,35,43,-8,40
Glenavon,5981,7,8,14,8,43,47,-4,38
Dungannon,5981,8,8,11,11,54,47,7,35
Ards,5981,9,9,6,15,35,48,-13,33
Portadown,5981,10,7,9,14,29,49,-20,30
Ballinamalla,5981,11,7,5,18,30,53,-23,26
Cliftonville,5982,1,18,5,7,55,35,20,59
Ballymena,5982,2,14,7,9,58,56,2,49
Crusaders,5982,3,13,9,8,50,34,16,48
Glenavon,5982,4,13,9,8,49,46,3,48
Linfield,5982,5,11,10,9,57,38,19,43
Dungannon,5982,6,11,10,9,52,40,12,43
Coleraine,5982,7,10,9,11,45,45,0,39
Ballinamalla,5982,8,11,3,16,34,51,-17,36
Ards,5982,9,9,6,15,31,44,-13,33
Portadown,5982,10,8,5,17,29,51,-22,29
Glentoran,5982,11,6,9,15,28,48,-20,27
Crusaders,5983,1,18,9,3,53,27,26,63
Cliftonville,5983,2,18,4,8,61,36,25,58
Ballymena,5983,3,17,4,9,67,51,16,55
Coleraine,5983,4,12,8,10,42,35,7,44
Linfield,5983,5,12,7,11,49,37,12,43
Dungannon,5983,6,11,7,12,54,50,4,40
Glenavon,5983,7,9,9,12,37,44,-7,36
Ards,5983,8,10,6,14,36,46,-10,36
Portadown,5983,9,9,4,17,26,50,-24,31
Glentoran,5983,10,8,6,16,28,51,-23,30
Ballinamalla,5983,11,7,4,19,28,54,-26,25
Crusaders,5984,1,21,6,3,64,26,38,69
Linfield,5984,2,13,10,7,54,28,26,49
Coleraine,5984,3,12,13,5,46,33,13,49
Ballymena,5984,4,14,6,10,60,59,1,48
Glenavon,5984,5,11,14,5,44,40,4,47
Cliftonville,5984,6,13,5,12,50,45,5,44
Dungannon,5984,7,8,11,11,52,49,3,35
Ards,5984,8,8,8,14,35,52,-17,32
Glentoran,5984,9,7,6,17,25,47,-22,27
Ballinamalla,5984,10,7,4,19,24,47,-23,25
Portadown,5984,11,6,7,17,21,49,-28,25
Cliftonville,5985,1,14,10,6,52,34,18,52
Crusaders,5985,2,13,11,6,58,39,19,50
Ballymena,5985,3,14,8,8,64,60,4,50
Linfield,5985,4,12,11,7,54,34,20,47
Coleraine,5985,5,11,10,9,45,39,6,43
Glenavon,5985,6,11,9,10,47,47,0,42
Dungannon,5985,7,11,7,12,44,41,3,40
Portadown,5985,8,11,5,14,33,39,-6,38
Glentoran,5985,9,8,9,13,24,42,-18,33
Ards,5985,10,8,8,14,37,49,-12,32
Ballinamalla,5985,11,5,6,19,27,61,-34,21
Linfield,5986,1,15,8,7,52,28,24,53
Coleraine,5986,2,15,8,7,56,38,18,53
Cliftonville,5986,3,15,5,10,53,38,15,50
Crusaders,5986,4,13,8,9,49,41,8,47
Dungannon,5986,5,13,7,10,51,38,13,46
Ballymena,5986,6,13,7,10,54,55,-1,46
Glenavon,5986,7,10,11,9,47,47,0,41
Glentoran,5986,8,9,8,13,31,48,-17,35
Ards,5986,9,8,5,17,35,50,-15,29
Ballinamalla,5986,10,8,5,17,28,55,-27,29
Portadown,5986,11,7,6,17,28,46,-18,27
Cliftonville,5987,1,19,2,9,68,39,29,59
Linfield,5987,2,17,7,6,64,29,35,58
Crusaders,5987,3,17,7,6,57,34,23,58
Ballymena,5987,4,15,5,10,57,53,4,50
Glenavon,5987,5,13,10,7,53,49,4,49
Coleraine,5987,6,12,10,8,40,39,1,46
Glentoran,5987,7,11,6,13,31,46,-15,39
Dungannon,5987,8,7,9,14,48,54,-6,30
Ballinamalla,5987,9,9,1,20,35,58,-23,28
Ards,5987,10,7,4,19,39,60,-21,25
Portadown,5987,11,4,7,19,19,50,-31,19
Crusaders,5988,1,17,7,6,59,36,23,58
Linfield,5988,2,15,10,5,58,28,30,55
Cliftonville,5988,3,16,4,10,52,35,17,52
Ballymena,5988,4,15,4,11,62,63,-1,49
Dungannon,5988,5,11,9,10,48,41,7,42
Portadown,5988,6,11,6,13,30,38,-8,39
Glenavon,5988,7,8,12,10,40,45,-5,36
Coleraine,5988,8,8,12,10,36,47,-11,36
Ards,5988,9,10,3,17,38,46,-8,33
Glentoran,5988,10,8,8,14,23,36,-13,32
Ballinamalla,5988,11,7,3,20,27,58,-31,24
Cliftonville,5989,1,17,4,9,55,37,18,55
Linfield,5989,2,15,9,6,57,34,23,54
Crusaders,5989,3,15,9,6,56,33,23,54
Coleraine,5989,4,13,11,6,55,37,18,50
Ballymena,5989,5,14,3,13,57,60,-3,45
Glenavon,5989,6,10,11,9,48,52,-4,41
Glentoran,5989,7,11,5,14,34,47,-13,38
Dungannon,5989,8,8,12,10,48,45,3,36
Ards,5989,9,10,4,16,36,47,-11,34
Ballinamalla,5989,10,7,5,18,32,51,-19,26
Portadown,5989,11,6,5,19,19,54,-35,23
Crusaders,5990,1,19,8,3,58,28,30,65
Linfield,5990,2,14,8,8,57,35,22,50
Ballymena,5990,3,14,6,10,61,59,2,48
Cliftonville,5990,4,14,5,11,51,42,9,47
Coleraine,5990,5,12,7,11,45,44,1,43
Dungannon,5990,6,10,9,11,53,44,9,39
Ards,5990,7,10,6,14,45,48,-3,36
Glenavon,5990,8,9,9,12,40,47,-7,36
Glentoran,5990,9,8,11,11,31,46,-15,35
Portadown,5990,10,9,6,15,34,50,-16,33
Ballinamalla,5990,11,6,5,19,28,60,-32,23
Linfield,5991,1,15,9,6,65,32,33,54
Cliftonville,5991,2,16,5,9,52,35,17,53
Crusaders,5991,3,14,9,7,50,32,18,51
Coleraine,5991,4,13,9,8,45,35,10,48
Ballymena,5991,5,14,5,11,58,66,-8,47
Dungannon,5991,6,13,7,10,50,38,12,46
Glenavon,5991,7,11,11,8,44,40,4,44
Glentoran,5991,8,10,6,14,38,53,-15,36
Ards,5991,9,8,4,18,37,54,-17,28
Portadown,5991,10,7,5,18,20,46,-26,26
Ballinamalla,5991,11,8,2,20,28,56,-28,26
Crusaders,5992,1,19,9,2,60,25,35,66
Linfield,5992,2,17,8,5,59,27,32,59
Cliftonville,5992,3,13,8,9,52,39,13,47
Glenavon,5992,4,11,12,7,47,41,6,45
Ballymena,5992,5,13,4,13,52,61,-9,43
Ards,5992,6,11,7,12,42,46,-4,40
Dungannon,5992,7,10,8,12,47,46,1,38
Coleraine,5992,8,8,10,12,41,45,-4,34
Ballinamalla,5992,9,9,5,16,31,49,-18,32
Glentoran,5992,10,8,5,17,27,54,-27,29
Portadown,5992,11,5,6,19,21,46,-25,21
Cliftonville,5993,1,18,6,6,50,28,22,60
Crusaders,5993,2,16,8,6,57,37,20,56
Ballymena,5993,3,16,7,7,70,55,15,55
Linfield,5993,4,12,10,8,53,35,18,46
Glenavon,5993,5,11,12,7,45,39,6,45
Coleraine,5993,6,10,13,7,46,39,7,43
Dungannon,5993,7,9,10,11,46,42,4,37
Glentoran,5993,8,9,9,12,36,44,-8,36
Ards,5993,9,8,6,16,36,55,-19,30
Ballinamalla,5993,10,7,5,18,32,58,-26,26
Portadown,5993,11,4,4,22,21,60,-39,16
Linfield,5994,1,14,10,6,62,36,26,52
Dungannon,5994,2,13,9,8,62,41,21,48
Coleraine,5994,3,13,9,8,42,37,5,48
Crusaders,5994,4,13,8,9,49,41,8,47
Ballymena,5994,5,13,7,10,51,50,1,46
Cliftonville,5994,6,13,6,11,51,41,10,45
Glenavon,5994,7,11,11,8,48,49,-1,44
Glentoran,5994,8,9,9,12,32,43,-11,36
Ards,5994,9,9,6,15,34,50,-16,33
Portadown,5994,10,6,8,16,30,48,-18,26
Ballinamalla,5994,11,5,9,16,26,51,-25,24
Crusaders,5995,1,16,9,5,61,35,26,57
Ballymena,5995,2,15,6,9,60,51,9,51
Glenavon,5995,3,13,10,7,51,45,6,49
Coleraine,5995,4,12,9,9,42,36,6,45
Linfield,5995,5,10,13,7,53,37,16,43
Dungannon,5995,6,11,8,11,46,46,0,41
Cliftonville,5995,7,11,6,13,50,50,0,39
Ballinamalla,5995,8,9,6,15,34,49,-15,33
Portadown,5995,9,9,6,15,25,40,-15,33
Ards,5995,10,8,6,16,35,46,-11,30
Glentoran,5995,11,6,11,13,29,51,-22,29
Crusaders,5996,1,17,8,5,56,30,26,59
Ballymena,5996,2,16,5,9,57,51,6,53
Cliftonville,5996,3,15,6,9,54,36,18,51
Glenavon,5996,4,14,8,8,59,48,11,50
Coleraine,5996,5,13,10,7,46,36,10,49
Linfield,5996,6,13,8,9,55,42,13,47
Dungannon,5996,7,9,8,13,47,43,4,35
Glentoran,5996,8,8,10,12,35,50,-15,34
Ards,5996,9,9,4,17,38,52,-14,31
Portadown,5996,10,7,5,18,25,50,-25,26
Ballinamalla,5996,11,7,2,21,31,65,-34,23
Crusaders,5997,1,16,8,6,52,35,17,56
Ballymena,5997,2,16,3,11,63,58,5,51
Linfield,5997,3,13,11,6,58,30,28,50
Cliftonville,5997,4,15,5,10,57,41,16,50
Glenavon,5997,5,12,11,7,45,42,3,47
Dungannon,5997,6,11,9,10,48,44,4,42
Coleraine,5997,7,10,11,9,51,44,7,41
Glentoran,5997,8,10,6,14,29,41,-12,36
Ballinamalla,5997,9,9,5,16,31,50,-19,32
Ards,5997,10,9,4,17,38,50,-12,31
Portadown,5997,11,4,7,19,18,55,-37,19
Crusaders,5998,1,17,7,6,63,32,31,58
Cliftonville,5998,2,16,4,10,51,44,7,52
Linfield,5998,3,14,8,8,57,35,22,50
Ards,5998,4,14,5,11,48,45,3,47
Dungannon,5998,5,11,10,9,44,37,7,43
Glenavon,5998,6,9,13,8,41,46,-5,40
Ballymena,5998,7,11,6,13,52,57,-5,39
Coleraine,5998,8,8,11,11,39,45,-6,35
Portadown,5998,9,9,5,16,32,49,-17,32
Ballinamalla,5998,10,8,6,16,34,52,-18,30
Glentoran,5998,11,5,11,14,32,51,-19,26
Cliftonville,5999,1,18,5,7,51,30,21,59
Crusaders,5999,2,17,6,7,55,38,17,57
Linfield,5999,3,14,9,7,57,31,26,51
Glenavon,5999,4,13,9,8,46,44,2,48
Ballymena,5999,5,14,6,10,53,55,-2,48
Coleraine,5999,6,12,9,9,45,44,1,45
Dungannon,5999,7,9,8,13,47,42,5,35
Portadown,5999,8,9,4,17,35,46,-11,31
Ballinamalla,5999,9,8,5,17,34,55,-21,29
Glentoran,5999,10,7,7,16,24,44,-20,28
Ards,5999,11,7,6,17,33,51,-18,27
Linfield,6000,1,17,7,6,66,25,41,58
Crusaders,6000,2,16,7,7,62,44,18,55
Cliftonville,6000,3,16,4,10,59,41,18,52
Glenavon,6000,4,11,13,6,42,37,5,46
Dungannon,6000,5,10,10,10,53,43,10,40
Coleraine,6000,6,10,10,10,37,46,-9,40
Ballymena,6000,7,11,6,13,53,73,-20,39
Ards,6000,8,10,6,14,37,45,-8,36
Glentoran,6000,9,9,6,15,38,49,-11,33
Portadown,6000,10,10,3,17,24,45,-21,33
Ballinamalla,6000,11,7,4,19,36,59,-23,25
Crusaders,6001,1,19,5,6,54,29,25,62
Cliftonville,6001,2,15,6,9,52,38,14,51
Ballymena,6001,3,15,5,10,53,57,-4,50
Linfield,6001,4,13,9,8,57,36,21,48
Dungannon,6001,5,13,9,8,57,38,19,48
Glenavon,6001,6,12,12,6,49,38,11,48
Coleraine,6001,7,10,10,10,35,41,-6,40
Ards,6001,8,10,3,17,43,55,-12,33
Portadown,6001,9,7,6,17,22,44,-22,27
Ballinamalla,6001,10,7,4,19,35,59,-24,25
Glentoran,6001,11,5,9,16,26,48,-22,24
Crusaders,6002,1,15,9,6,51,35,16,54
Glenavon,6002,2,15,8,7,53,43,10,53
Ballymena,6002,3,15,7,8,53,47,6,52
Coleraine,6002,4,13,10,7,44,32,12,49
Linfield,6002,5,12,9,9,54,36,18,45
Cliftonville,6002,6,13,6,11,39,35,4,45
Dungannon,6002,7,10,9,11,50,44,6,39
Ards,6002,8,11,5,14,40,46,-6,38
Glentoran,6002,9,7,8,15,28,47,-19,29
Portadown,6002,10,7,6,17,27,47,-20,27
Ballinamalla,6002,11,5,7,18,26,53,-27,22
Crusaders,6003,1,17,7,6,51,29,22,58
Ballymena,6003,2,13,8,9,49,49,0,47
Coleraine,6003,3,12,10,8,47,42,5,46
Glenavon,6003,4,11,12,7,51,44,7,45
Linfield,6003,5,11,11,8,53,31,22,44
Cliftonville,6003,6,13,5,12,48,43,5,44
Dungannon,6003,7,10,9,11,50,44,6,39
Glentoran,6003,8,10,9,11,30,40,-10,39
Ballinamalla,6003,9,10,6,14,30,44,-14,36
Portadown,6003,10,7,10,13,21,38,-17,31
Ards,6003,11,5,5,20,36,62,-26,20
Cliftonville,6004,1,17,4,9,56,36,20,55
Crusaders,6004,2,15,9,6,52,38,14,54
Linfield,6004,3,15,8,7,54,29,25,53
Ballymena,6004,4,14,4,12,55,60,-5,46
Glenavon,6004,5,11,8,11,45,43,2,41
Coleraine,6004,6,9,12,9,42,40,2,39
Portadown,6004,7,11,4,15,31,40,-9,37
Ballinamalla,6004,8,11,4,15,34,53,-19,37
Dungannon,6004,9,8,11,11,52,48,4,35
Glentoran,6004,10,9,5,16,31,46,-15,32
Ards,6004,11,7,7,16,33,52,-19,28
Crusaders,6005,1,17,6,7,56,36,20,57
Coleraine,6005,2,14,12,4,46,27,19,54
Linfield,6005,3,12,8,10,45,37,8,44
Glenavon,6005,4,10,14,6,40,41,-1,44
Ballymena,6005,5,12,6,12,50,54,-4,42
Cliftonville,6005,6,11,5,14,43,42,1,38
Ballinamalla,6005,7,11,4,15,31,43,-12,37
Glentoran,6005,8,9,9,12,34,45,-11,36
Ards,6005,9,9,7,14,37,46,-9,34
Portadown,6005,10,10,4,16,25,38,-13,34
Dungannon,6005,11,8,9,13,45,43,2,33
Linfield,6006,1,16,7,7,63,41,22,55
Glenavon,6006,2,15,10,5,54,41,13,55
Ballymena,6006,3,15,7,8,70,66,4,52
Cliftonville,6006,4,13,7,10,51,44,7,46
Crusaders,6006,5,13,5,12,49,44,5,44
Dungannon,6006,6,11,10,9,53,39,14,43
Glentoran,6006,7,11,6,13,41,40,1,39
Coleraine,6006,8,9,10,11,39,38,1,37
Ballinamalla,6006,9,10,3,17,29,53,-24,33
Ards,6006,10,9,5,16,42,58,-16,32
Portadown,6006,11,6,4,20,24,51,-27,22
Crusaders,6007,1,14,9,7,53,34,19,51
Glenavon,6007,2,13,10,7,54,40,14,49
Cliftonville,6007,3,14,7,9,48,41,7,49
Ballymena,6007,4,13,10,7,57,53,4,49
Coleraine,6007,5,11,12,7,47,38,9,45
Linfield,6007,6,11,11,8,52,32,20,44
Dungannon,6007,7,11,9,10,48,41,7,42
Ards,6007,8,10,6,14,36,50,-14,36
Glentoran,6007,9,8,9,13,23,40,-17,33
Ballinamalla,6007,10,6,7,17,25,49,-24,25
Portadown,6007,11,6,6,18,24,49,-25,24
Linfield,6008,1,19,8,3,70,27,43,65
Crusaders,6008,2,14,9,7,58,39,19,51
Cliftonville,6008,3,13,8,9,47,37,10,47
Ballymena,6008,4,14,4,12,62,61,1,46
Coleraine,6008,5,11,8,11,46,46,0,41
Dungannon,6008,6,10,9,11,49,45,4,39
Glentoran,6008,7,10,8,12,34,50,-16,38
Glenavon,6008,8,8,12,10,42,43,-1,36
Portadown,6008,9,9,6,15,29,50,-21,33
Ards,6008,10,8,5,17,44,61,-17,29
Ballinamalla,6008,11,8,5,17,30,52,-22,29
Linfield,6009,1,16,9,5,54,27,27,57
Crusaders,6009,2,17,6,7,59,35,24,57
Dungannon,6009,3,14,9,7,63,42,21,51
Ballymena,6009,4,13,5,12,58,64,-6,44
Cliftonville,6009,5,12,7,11,48,45,3,43
Coleraine,6009,6,10,11,9,45,38,7,41
Portadown,6009,7,10,6,14,33,45,-12,36
Glentoran,6009,8,10,6,14,30,43,-13,36
Glenavon,6009,9,7,13,10,40,45,-5,34
Ards,6009,10,10,4,16,41,57,-16,34
Ballinamalla,6009,11,5,6,19,25,55,-30,21
Crusaders,6010,1,16,8,6,51,31,20,56
Cliftonville,6010,2,15,5,10,51,36,15,50
Ballymena,6010,3,13,8,9,58,56,2,47
Coleraine,6010,4,12,10,8,39,36,3,46
Linfield,6010,5,12,9,9,53,36,17,45
Glenavon,6010,6,12,8,10,48,40,8,44
Dungannon,6010,7,12,7,11,58,49,9,43
Ballinamalla,6010,8,11,5,14,31,45,-14,38
Portadown,6010,9,9,6,15,22,37,-15,33
Glentoran,6010,10,6,9,15,25,47,-22,27
Ards,6010,11,6,7,17,27,50,-23,25
Crusaders,6011,1,16,7,7,56,37,19,55
Ballymena,6011,2,14,9,7,63,52,11,51
Glenavon,6011,3,13,11,6,47,34,13,50
Coleraine,6011,4,13,11,6,45,37,8,50
Cliftonville,6011,5,13,8,9,53,41,12,47
Dungannon,6011,6,13,7,10,58,44,14,46
Linfield,6011,7,12,8,10,59,46,13,44
Ards,6011,8,11,7,12,40,44,-4,40
Portadown,6011,9,8,7,15,26,44,-18,31
Glentoran,6011,10,6,5,19,23,54,-31,23
Ballinamalla,6011,11,4,4,22,23,60,-37,16
Crusaders,6012,1,17,8,5,55,28,27,59
Cliftonville,6012,2,16,4,10,55,39,16,52
Linfield,6012,3,13,10,7,59,36,23,49
Coleraine,6012,4,11,11,8,43,39,4,44
Dungannon,6012,5,11,9,10,52,45,7,42
Portadown,6012,6,12,5,13,34,43,-9,41
Ballymena,6012,7,11,7,12,53,63,-10,40
Glenavon,6012,8,9,12,9,45,41,4,39
Glentoran,6012,9,10,7,13,33,48,-15,37
Ards,6012,10,8,6,16,31,46,-15,30
Ballinamalla,6012,11,6,3,21,29,61,-32,21
Crusaders,6013,1,15,10,5,45,29,16,55
Ballymena,6013,2,16,4,10,64,55,9,52
Dungannon,6013,3,15,6,9,58,37,21,51
Linfield,6013,4,13,11,6,57,35,22,50
Glenavon,6013,5,13,9,8,44,43,1,48
Cliftonville,6013,6,12,6,12,45,37,8,42
Coleraine,6013,7,10,9,11,35,39,-4,39
Ards,6013,8,10,6,14,39,46,-7,36
Portadown,6013,9,8,5,17,24,47,-23,29
Glentoran,6013,10,6,9,15,20,41,-21,27
Ballinamalla,6013,11,7,5,18,27,49,-22,26
Crusaders,6014,1,16,8,6,62,40,22,56
Ballymena,6014,2,15,8,7,67,56,11,53
Linfield,6014,3,14,10,6,59,34,25,52
Coleraine,6014,4,12,12,6,43,35,8,48
Glenavon,6014,5,11,12,7,47,43,4,45
Cliftonville,6014,6,12,8,10,52,43,9,44
Glentoran,6014,7,10,6,14,31,49,-18,36
Ards,6014,8,10,5,15,37,44,-7,35
Dungannon,6014,9,8,9,13,47,51,-4,33
Portadown,6014,10,7,6,17,26,48,-22,27
Ballinamalla,6014,11,7,2,21,33,61,-28,23
Linfield,6015,1,15,11,4,58,29,29,56
Crusaders,6015,2,16,5,9,51,32,19,53
Ballymena,6015,3,15,6,9,64,55,9,51
Coleraine,6015,4,13,9,8,46,39,7,48
Glentoran,6015,5,12,8,10,35,43,-8,44
Cliftonville,6015,6,13,4,13,49,46,3,43
Glenavon,6015,7,9,12,9,49,43,6,39
Dungannon,6015,8,10,8,12,45,45,0,38
Ards,6015,9,8,6,16,39,55,-16,30
Portadown,6015,10,7,7,16,21,45,-24,28
Ballinamalla,6015,11,6,6,18,27,52,-25,24
Linfield,6016,1,16,9,5,68,34,34,57
Crusaders,6016,2,15,10,5,56,33,23,55
Ballymena,6016,3,15,5,10,63,57,6,50
Coleraine,6016,4,12,11,7,45,38,7,47
Cliftonville,6016,5,13,7,10,49,40,9,46
Glenavon,6016,6,10,12,8,43,46,-3,42
Dungannon,6016,7,10,9,11,48,44,4,39
Ards,6016,8,9,6,15,42,52,-10,33
Glentoran,6016,9,8,9,13,28,41,-13,33
Ballinamalla,6016,10,8,3,19,30,59,-29,27
Portadown,6016,11,6,5,19,18,46,-28,23
Linfield,6017,1,15,9,6,60,29,31,54
Cliftonville,6017,2,16,6,8,47,33,14,54
Crusaders,6017,3,14,6,10,51,35,16,48
Ballymena,6017,4,13,7,10,58,58,0,46
Coleraine,6017,5,12,9,9,44,39,5,45
Ards,6017,6,13,4,13,44,49,-5,43
Glenavon,6017,7,11,8,11,47,48,-1,41
Dungannon,6017,8,11,7,12,48,45,3,40
Ballinamalla,6017,9,9,5,16,30,46,-16,32
Glentoran,6017,10,8,7,15,31,52,-21,31
Portadown,6017,11,6,6,18,24,50,-26,24
Crusaders,6018,1,17,6,7,55,32,23,57
Ballymena,6018,2,16,8,6,64,51,13,56
Cliftonville,6018,3,16,3,11,56,38,18,51
Linfield,6018,4,12,11,7,56,37,19,47
Coleraine,6018,5,9,14,7,38,34,4,41
Glenavon,6018,6,8,14,8,42,44,-2,38
Dungannon,6018,7,9,10,11,55,55,0,37
Glentoran,6018,8,9,8,13,40,48,-8,35
Portadown,6018,9,7,8,15,30,52,-22,29
Ards,6018,10,8,5,17,29,51,-22,29
Ballinamalla,6018,11,8,5,17,33,56,-23,29
Linfield,6019,1,18,7,5,68,34,34,61
Crusaders,6019,2,18,7,5,60,33,27,61
Glenavon,6019,3,15,9,6,49,36,13,54
Cliftonville,6019,4,16,3,11,45,35,10,51
Coleraine,6019,5,12,9,9,49,38,11,45
Ballymena,6019,6,10,7,13,56,66,-10,37
Ballinamalla,6019,7,10,5,15,32,45,-13,35
Dungannon,6019,8,8,8,14,43,50,-7,32
Ards,6019,9,9,4,17,37,53,-16,31
Glentoran,6019,10,7,9,14,31,48,-17,30
Portadown,6019,11,5,6,19,21,53,-32,21
Crusaders,6020,1,17,8,5,53,31,22,59
Glenavon,6020,2,13,10,7,49,45,4,49
Ballymena,6020,3,14,7,9,56,54,2,49
Linfield,6020,4,12,11,7,60,36,24,47
Cliftonville,6020,5,14,4,12,48,43,5,46
Dungannon,6020,6,11,10,9,49,44,5,43
Ards,6020,7,12,5,13,46,41,5,41
Coleraine,6020,8,9,8,13,40,50,-10,35
Glentoran,6020,9,9,8,13,35,46,-11,35
Ballinamalla,6020,10,8,4,18,29,51,-22,28
Portadown,6020,11,6,5,19,27,51,-24,23
Crusaders,6021,1,21,6,3,62,30,32,69
Cliftonville,6021,2,17,4,9,65,39,26,55
Linfield,6021,3,15,7,8,58,31,27,52
Glenavon,6021,4,13,11,6,49,40,9,50
Ards,6021,5,12,4,14,46,52,-6,40
Dungannon,6021,6,10,9,11,47,46,1,39
Ballymena,6021,7,11,5,14,61,76,-15,38
Glentoran,6021,8,9,7,14,35,45,-10,34
Coleraine,6021,9,7,10,13,37,45,-8,31
Ballinamalla,6021,10,8,3,19,31,58,-27,27
Portadown,6021,11,7,4,19,24,53,-29,25
Coleraine,6022,1,16,8,6,46,31,15,56
Linfield,6022,2,15,10,5,57,27,30,55
Crusaders,6022,3,16,6,8,56,35,21,54
Cliftonville,6022,4,17,3,10,56,44,12,54
Glenavon,6022,5,14,9,7,57,44,13,51
Dungannon,6022,6,10,10,10,49,40,9,40
Ballymena,6022,7,10,8,12,46,55,-9,38
Glentoran,6022,8,9,6,15,29,40,-11,33
Ards,6022,9,8,5,17,37,55,-18,29
Ballinamalla,6022,10,8,4,18,29,56,-27,28
Portadown,6022,11,6,3,21,24,59,-35,21
Cliftonville,6023,1,16,5,9,48,35,13,53
Coleraine,6023,2,14,9,7,44,32,12,51
Ballymena,6023,3,14,8,8,55,50,5,50
Linfield,6023,4,13,9,8,55,34,21,48
Crusaders,6023,5,13,9,8,52,42,10,48
Dungannon,6023,6,12,9,9,54,44,10,45
Glenavon,6023,7,11,7,12,47,49,-2,40
Glentoran,6023,8,10,9,11,32,44,-12,39
Ards,6023,9,10,4,16,37,47,-10,34
Portadown,6023,10,7,4,19,30,52,-22,25
Ballinamalla,6023,11,7,3,20,31,56,-25,24
Crusaders,6024,1,18,7,5,58,25,33,61
Ballymena,6024,2,17,5,8,73,57,16,56
Glenavon,6024,3,14,10,6,60,42,18,52
Cliftonville,6024,4,13,6,11,46,38,8,45
Coleraine,6024,5,12,9,9,43,43,0,45
Dungannon,6024,6,10,9,11,47,46,1,39
Linfield,6024,7,11,6,13,53,56,-3,39
Portadown,6024,8,9,6,15,27,49,-22,33
Ballinamalla,6024,9,9,4,17,35,56,-21,31
Ards,6024,10,8,6,16,34,48,-14,30
Glentoran,6024,11,6,8,16,34,50,-16,26
Cliftonville,6025,1,18,2,10,54,42,12,56
Ballymena,6025,2,16,7,7,61,53,8,55
Linfield,6025,3,15,7,8,67,38,29,52
Crusaders,6025,4,14,6,10,44,38,6,48
Glenavon,6025,5,12,8,10,50,41,9,44
Coleraine,6025,6,11,11,8,40,32,8,44
Dungannon,6025,7,11,9,10,51,38,13,42
Ards,6025,8,12,5,13,40,45,-5,41
Ballinamalla,6025,9,10,2,18,26,51,-25,32
Portadown,6025,10,7,4,19,23,53,-30,25
Glentoran,6025,11,5,7,18,27,52,-25,22
Linfield,6026,1,17,8,5,66,36,30,59
Crusaders,6026,2,16,5,9,60,38,22,53
Cliftonville,6026,3,16,3,11,55,48,7,51
Ballymena,6026,4,14,4,12,56,61,-5,46
Coleraine,6026,5,12,9,9,42,38,4,45
Glenavon,6026,6,11,10,9,47,45,2,43
Glentoran,6026,7,12,5,13,43,41,2,41
Portadown,6026,8,11,3,16,33,46,-13,36
Dungannon,6026,9,8,8,14,49,52,-3,32
Ards,6026,10,8,7,15,35,50,-15,31
Ballinamalla,6026,11,7,4,19,24,55,-31,25
Linfield,6027,1,15,9,6,58,29,29,54
Cliftonville,6027,2,16,5,9,53,41,12,53
Crusaders,6027,3,14,9,7,53,35,18,51
Ballymena,6027,4,14,6,10,61,61,0,48
Coleraine,6027,5,12,9,9,53,42,11,45
Glenavon,6027,6,10,13,7,51,42,9,43
Dungannon,6027,7,10,10,10,55,50,5,40
Ballinamalla,6027,8,10,6,14,40,54,-14,36
Glentoran,6027,9,9,7,14,34,55,-21,34
Ards,6027,10,7,6,17,38,58,-20,27
Portadown,6027,11,5,6,19,27,56,-29,21
Linfield,6028,1,16,8,6,58,30,28,56
Crusaders,6028,2,17,5,8,58,36,22,56
Ballymena,6028,3,15,6,9,57,53,4,51
Coleraine,6028,4,12,11,7,40,30,10,47
Glenavon,6028,5,12,10,8,48,42,6,46
Glentoran,6028,6,12,5,13,37,49,-12,41
Cliftonville,6028,7,11,7,12,46,44,2,40
Dungannon,6028,8,7,11,12,47,50,-3,32
Ards,6028,9,9,4,17,38,50,-12,31
Ballinamalla,6028,10,8,5,17,30,55,-25,29
Portadown,6028,11,7,6,17,26,46,-20,27
Crusaders,6029,1,19,5,6,60,32,28,62
Linfield,6029,2,16,8,6,62,30,32,56
Cliftonville,6029,3,14,5,11,51,43,8,47
Glenavon,6029,4,13,8,9,56,50,6,47
Ballymena,6029,5,14,5,11,58,60,-2,47
Dungannon,6029,6,11,8,11,49,46,3,41
Glentoran,6029,7,11,6,13,37,45,-8,39
Ards,6029,8,11,4,15,44,51,-7,37
Coleraine,6029,9,9,10,11,45,55,-10,37
Portadown,6029,10,7,5,18,21,43,-22,26
Ballinamalla,6029,11,6,4,20,29,57,-28,22
Crusaders,6030,1,16,7,7,56,38,18,55
Linfield,6030,2,15,9,6,57,31,26,54
Cliftonville,6030,3,15,6,9,50,41,9,51
Ballymena,6030,4,14,6,10,58,57,1,48
Coleraine,6030,5,12,10,8,41,34,7,46
Glentoran,6030,6,10,8,12,33,40,-7,38
Dungannon,6030,7,9,9,12,54,48,6,36
Ards,6030,8,10,5,15,43,50,-7,35
Glenavon,6030,9,7,12,11,42,49,-7,33
Portadown,6030,10,7,8,15,26,48,-22,29
Ballinamalla,6030,11,6,8,16,30,54,-24,26
Crusaders,6031,1,19,6,5,56,31,25,63
Linfield,6031,2,12,12,6,57,33,24,48
Coleraine,6031,3,12,10,8,47,36,11,46
Cliftonville,6031,4,13,6,11,52,43,9,45
Ballymena,6031,5,13,6,11,53,59,-6,45
Glenavon,6031,6,10,13,7,46,46,0,43
Dungannon,6031,7,9,10,11,50,50,0,37
Portadown,6031,8,9,7,14,26,39,-13,34
Ards,6031,9,9,6,15,37,50,-13,33
Glentoran,6031,10,7,8,15,29,43,-14,29
Ballinamalla,6031,11,8,4,18,32,55,-23,28
Crusaders,6032,1,18,4,8,62,34,28,58
Linfield,6032,2,14,11,5,60,33,27,53
Glenavon,6032,3,14,9,7,50,41,9,51
Cliftonville,6032,4,15,3,12,50,43,7,48
Ballymena,6032,5,13,8,9,55,57,-2,47
Coleraine,6032,6,9,11,10,37,36,1,38
Dungannon,6032,7,10,7,13,52,53,-1,37
Portadown,6032,8,10,6,14,32,38,-6,36
Glentoran,6032,9,7,9,14,24,46,-22,30
Ards,6032,10,7,8,15,32,47,-15,29
Ballinamalla,6032,11,7,6,17,27,53,-26,27
Ballymena,6033,1,17,6,7,65,57,8,57
Crusaders,6033,2,16,8,6,69,40,29,56
Cliftonville,6033,3,15,6,9,53,41,12,51
Glenavon,6033,4,14,8,8,54,46,8,50
Linfield,6033,5,13,8,9,56,36,20,47
Coleraine,6033,6,13,8,9,39,37,2,47
Glentoran,6033,7,9,11,10,33,39,-6,38
Dungannon,6033,8,8,9,13,49,52,-3,33
Ballinamalla,6033,9,9,3,18,34,56,-22,30
Ards,6033,10,7,5,18,34,52,-18,26
Portadown,6033,11,6,4,20,27,57,-30,22
Crusaders,6034,1,16,9,5,57,36,21,57
Linfield,6034,2,13,9,8,54,36,18,48
Ballymena,6034,3,13,9,8,61,55,6,48
Cliftonville,6034,4,14,5,11,56,45,11,47
Coleraine,6034,5,12,10,8,52,43,9,46
Glenavon,6034,6,11,10,9,48,46,2,43
Ards,6034,7,13,4,13,44,47,-3,43
Dungannon,6034,8,9,11,10,53,49,4,38
Portadown,6034,9,9,8,13,33,47,-14,35
Ballinamalla,6034,10,6,7,17,26,52,-26,25
Glentoran,6034,11,4,8,18,21,49,-28,20
Crusaders,6035,1,15,7,8,56,34,22,52
Linfield,6035,2,14,8,8,59,34,25,50
Ballymena,6035,3,14,7,9,59,56,3,49
Glenavon,6035,4,12,10,8,46,41,5,46
Coleraine,6035,5,10,13,7,38,39,-1,43
Cliftonville,6035,6,11,8,11,44,40,4,41
Dungannon,6035,7,10,10,10,48,46,2,40
Ards,6035,8,9,11,10,35,38,-3,38
Glentoran,6035,9,8,9,13,30,43,-13,33
Portadown,6035,10,8,7,15,29,45,-16,31
Ballinamalla,6035,11,6,6,18,25,53,-28,24
Cliftonville,6036,1,18,4,8,56,35,21,58
Crusaders,6036,2,16,7,7,58,40,18,55
Ballymena,6036,3,15,8,7,63,57,6,53
Glenavon,6036,4,13,10,7,48,41,7,49
Linfield,6036,5,12,10,8,59,36,23,46
Coleraine,6036,6,9,10,11,38,44,-6,37
Dungannon,6036,7,9,9,12,49,45,4,36
Glentoran,6036,8,7,12,11,24,37,-13,33
Ballinamalla,6036,9,9,6,15,29,47,-18,33
Ards,6036,10,7,7,16,30,46,-16,28
Portadown,6036,11,6,5,19,22,48,-26,23
Coleraine,6037,1,15,8,7,48,35,13,53
Crusaders,6037,2,15,7,8,56,41,15,52
Linfield,6037,3,13,10,7,52,31,21,49
Cliftonville,6037,4,14,5,11,53,41,12,47
Ballymena,6037,5,14,5,11,60,60,0,47
Glenavon,6037,6,12,10,8,53,40,13,46
Dungannon,6037,7,8,13,9,47,43,4,37
Glentoran,6037,8,9,8,13,25,37,-12,35
Ballinamalla,6037,9,10,3,17,27,49,-22,33
Portadown,6037,10,7,7,16,35,55,-20,28
Ards,6037,11,8,4,18,32,56,-24,28
Crusaders,6038,1,16,9,5,50,33,17,57
Cliftonville,6038,2,16,5,9,52,32,20,53
Linfield,6038,3,14,10,6,61,32,29,52
Ballymena,6038,4,12,8,10,61,60,1,44
Glenavon,6038,5,11,10,9,45,46,-1,43
Dungannon,6038,6,11,9,10,46,39,7,42
Glentoran,6038,7,10,8,12,33,41,-8,38
Coleraine,6038,8,9,10,11,34,46,-12,37
Portadown,6038,9,8,8,14,26,40,-14,32
Ards,6038,10,8,3,19,36,50,-14,27
Ballinamalla,6038,11,7,6,17,28,53,-25,27
Crusaders,6039,1,17,7,6,61,39,22,58
Ballymena,6039,2,14,8,8,63,63,0,50
Linfield,6039,3,13,10,7,63,37,26,49
Coleraine,6039,4,12,13,5,52,37,15,49
Dungannon,6039,5,13,8,9,58,44,14,47
Cliftonville,6039,6,13,6,11,50,44,6,45
Glenavon,6039,7,9,9,12,48,53,-5,36
Ards,6039,8,10,6,14,44,51,-7,36
Glentoran,6039,9,8,10,12,37,46,-9,34
Portadown,6039,10,6,6,18,26,54,-28,24
Ballinamalla,6039,11,7,3,20,26,60,-34,24
Linfield,6040,1,15,10,5,64,38,26,55
Cliftonville,6040,2,15,5,10,57,42,15,50
Crusaders,6040,3,13,9,8,58,42,16,48
Ballymena,6040,4,14,5,11,59,57,2,47
Dungannon,6040,5,12,9,9,57,44,13,45
Glenavon,6040,6,11,12,7,48,45,3,45
Coleraine,6040,7,11,9,10,42,41,1,42
Ards,6040,8,11,4,15,42,48,-6,37
Glentoran,6040,9,9,7,14,32,47,-15,34
Ballinamalla,6040,10,8,4,18,30,57,-27,28
Portadown,6040,11,6,6,18,27,55,-28,24
Linfield,6041,1,16,6,8,53,26,27,54
Crusaders,6041,2,15,8,7,56,39,17,53
Coleraine,6041,3,12,12,6,41,31,10,48
Cliftonville,6041,4,14,5,11,52,42,10,47
Glenavon,6041,5,11,10,9,44,43,1,43
Ballymena,6041,6,12,7,11,56,62,-6,43
Glentoran,6041,7,11,7,12,31,41,-10,40
Ards,6041,8,10,6,14,32,43,-11,36
Ballinamalla,6041,9,9,8,13,30,42,-12,35
Dungannon,6041,10,7,8,15,42,51,-9,29
Portadown,6041,11,6,7,17,29,46,-17,25
Linfield,6042,1,14,10,6,54,23,31,52
Cliftonville,6042,2,14,7,9,48,37,11,49
Coleraine,6042,3,13,9,8,44,32,12,48
Crusaders,6042,4,12,11,7,49,35,14,47
Ballymena,6042,5,13,7,10,56,59,-3,46
Glenavon,6042,6,10,11,9,49,49,0,41
Dungannon,6042,7,9,11,10,51,49,2,38
Portadown,6042,8,11,4,15,35,47,-12,37
Glentoran,6042,9,10,7,13,31,44,-13,37
Ards,6042,10,8,7,15,37,53,-16,31
Ballinamalla,6042,11,6,6,18,31,57,-26,24
Linfield,6043,1,16,8,6,62,34,28,56
Ballymena,6043,2,15,6,9,65,61,4,51
Cliftonville,6043,3,15,5,10,57,36,21,50
Coleraine,6043,4,13,11,6,45,35,10,50
Glenavon,6043,5,12,11,7,51,45,6,47
Crusaders,6043,6,12,9,9,45,40,5,45
Ards,6043,7,9,6,15,31,47,-16,33
Ballinamalla,6043,8,9,6,15,32,50,-18,33
Dungannon,6043,9,8,8,14,43,45,-2,32
Glentoran,6043,10,7,9,14,32,48,-16,30
Portadown,6043,11,7,5,18,26,48,-22,26
Linfield,6044,1,17,8,5,65,32,33,59
Ballymena,6044,2,17,6,7,69,51,18,57
Glenavon,6044,3,13,12,5,54,43,11,51
Crusaders,6044,4,14,7,9,52,41,11,49
Cliftonville,6044,5,14,6,10,48,37,11,48
Coleraine,6044,6,12,10,8,42,38,4,46
Dungannon,6044,7,11,7,12,54,49,5,40
Glentoran,6044,8,7,9,14,29,53,-24,30
Ballinamalla,6044,9,7,7,16,26,47,-21,28
Ards,6044,10,6,8,16,33,53,-20,26
Portadown,6044,11,5,4,21,24,52,-28,19
Crusaders,6045,1,17,8,5,67,39,28,59
Coleraine,6045,2,13,12,5,44,34,10,51
Ballymena,6045,3,15,6,9,64,56,8,51
Linfield,6045,4,13,9,8,60,36,24,48
Cliftonville,6045,5,12,8,10,46,43,3,44
Dungannon,6045,6,10,9,11,53,51,2,39
Ards,6045,7,10,6,14,38,46,-8,36
Glenavon,6045,8,8,10,12,45,57,-12,34
Glentoran,6045,9,8,8,14,29,46,-17,32
Ballinamalla,6045,10,9,3,18,35,51,-16,30
Portadown,6045,11,8,5,17,31,53,-22,29
Linfield,6046,1,15,9,6,63,33,30,54
Crusaders,6046,2,15,8,7,49,31,18,53
Cliftonville,6046,3,13,8,9,48,38,10,47
Coleraine,6046,4,12,10,8,49,38,11,46
Glenavon,6046,5,12,8,10,44,50,-6,44
Ballymena,6046,6,11,9,10,56,60,-4,42
Glentoran,6046,7,11,7,12,31,40,-9,40
Dungannon,6046,8,9,9,12,51,52,-1,36
Ards,6046,9,8,7,15,37,52,-15,31
Portadown,6046,10,9,4,17,30,51,-21,31
Ballinamalla,6046,11,9,3,18,33,46,-13,30
Cliftonville,6047,1,16,7,7,60,38,22,55
Ballymena,6047,2,15,8,7,62,56,6,53
Crusaders,6047,3,14,10,6,55,36,19,52
Coleraine,6047,4,12,12,6,42,37,5,48
Linfield,6047,5,11,13,6,57,38,19,46
Glenavon,6047,6,10,10,10,41,47,-6,40
Dungannon,6047,7,8,14,8,55,44,11,38
Ballinamalla,6047,8,9,5,16,34,54,-20,32
Ards,6047,9,8,6,16,32,44,-12,30
Glentoran,6047,10,4,13,13,28,47,-19,25
Portadown,6047,11,4,10,16,19,44,-25,22
Crusaders,6048,1,17,6,7,58,38,20,57
Ballymena,6048,2,17,4,9,55,50,5,55
Linfield,6048,3,15,8,7,61,30,31,53
Coleraine,6048,4,11,11,8,38,38,0,44
Cliftonville,6048,5,13,4,13,46,43,3,43
Glenavon,6048,6,10,10,10,48,44,4,40
Glentoran,6048,7,11,6,13,38,52,-14,39
Dungannon,6048,8,10,8,12,56,46,10,38
Portadown,6048,9,10,5,15,32,48,-16,35
Ards,6048,10,9,5,16,38,54,-16,32
Ballinamalla,6048,11,7,3,20,26,53,-27,24
Cliftonville,6049,1,16,6,8,55,37,18,54
Glenavon,6049,2,14,9,7,60,45,15,51
Ballymena,6049,3,15,5,10,53,52,1,50
Linfield,6049,4,14,7,9,53,39,14,49
Crusaders,6049,5,14,7,9,53,42,11,49
Coleraine,6049,6,12,10,8,45,42,3,46
Glentoran,6049,7,11,6,13,31,38,-7,39
Dungannon,6049,8,9,8,13,52,47,5,35
Portadown,6049,9,9,6,15,29,43,-14,33
Ards,6049,10,7,6,17,38,56,-18,27
Ballinamalla,6049,11,6,6,18,25,53,-28,24
Crusaders,6050,1,17,8,5,59,36,23,59
Cliftonville,6050,2,17,2,11,65,46,19,53
Linfield,6050,3,14,8,8,58,33,25,50
Coleraine,6050,4,12,11,7,47,36,11,47
Ballymena,6050,5,13,5,12,61,66,-5,44
Dungannon,6050,6,12,7,11,57,43,14,43
Glenavon,6050,7,10,11,9,51,48,3,41
Ards,6050,8,10,5,15,35,45,-10,35
Ballinamalla,6050,9,10,4,16,34,54,-20,34
Glentoran,6050,10,8,9,13,26,50,-24,33
Portadown,6050,11,5,4,21,25,61,-36,19
Crusaders,6051,1,19,6,5,60,31,29,63
Ballymena,6051,2,17,4,9,59,58,1,55
Cliftonville,6051,3,16,6,8,52,32,20,54
Linfield,6051,4,14,8,8,60,34,26,50
Coleraine,6051,5,10,10,10,42,41,1,40
Glenavon,6051,6,10,10,10,42,42,0,40
Dungannon,6051,7,9,10,11,45,43,2,37
Ballinamalla,6051,8,9,7,14,34,53,-19,34
Glentoran,6051,9,7,8,15,30,45,-15,29
Ards,6051,10,7,8,15,36,52,-16,29
Portadown,6051,11,6,5,19,20,49,-29,23
Crusaders,6052,1,19,7,4,64,31,33,64
Cliftonville,6052,2,15,5,10,50,37,13,50
Glenavon,6052,3,13,10,7,55,45,10,49
Coleraine,6052,4,13,10,7,43,39,4,49
Linfield,6052,5,13,9,8,55,38,17,48
Ballymena,6052,6,12,6,12,54,58,-4,42
Dungannon,6052,7,9,12,9,47,44,3,39
Ballinamalla,6052,8,9,5,16,36,48,-12,32
Glentoran,6052,9,7,8,15,29,51,-22,29
Ards,6052,10,7,6,17,36,53,-17,27
Portadown,6052,11,5,8,17,23,48,-25,23
Crusaders,6053,1,16,10,4,54,30,24,58
Linfield,6053,2,16,9,5,60,29,31,57
Cliftonville,6053,3,15,7,8,52,40,12,52
Coleraine,6053,4,12,13,5,50,31,19,49
Ballymena,6053,5,14,5,11,60,60,0,47
Glenavon,6053,6,10,13,7,49,46,3,43
Glentoran,6053,7,9,7,14,31,48,-17,34
Dungannon,6053,8,8,9,13,49,53,-4,33
Ards,6053,9,9,4,17,35,51,-16,31
Ballinamalla,6053,10,7,5,18,31,56,-25,26
Portadown,6053,11,4,8,18,24,51,-27,20
Linfield,6054,1,16,8,6,60,34,26,56
Cliftonville,6054,2,16,6,8,53,40,13,54
Crusaders,6054,3,16,5,9,51,29,22,53
Ards,6054,4,16,4,10,54,44,10,52
Ballymena,6054,5,14,6,10,60,57,3,48
Glenavon,6054,6,10,12,8,44,44,0,42
Dungannon,6054,7,11,8,11,47,46,1,41
Coleraine,6054,8,10,9,11,42,45,-3,39
Glentoran,6054,9,7,8,15,26,42,-16,29
Ballinamalla,6054,10,6,6,18,30,52,-22,24
Portadown,6054,11,5,4,21,19,53,-34,19
Linfield,6055,1,17,8,5,55,26,29,59
Cliftonville,6055,2,17,4,9,58,33,25,55
Crusaders,6055,3,15,8,7,54,35,19,53
Coleraine,6055,4,12,12,6,40,35,5,48
Ballymena,6055,5,13,7,10,60,61,-1,46
Dungannon,6055,6,10,11,9,46,37,9,41
Glenavon,6055,7,9,12,9,45,51,-6,39
Glentoran,6055,8,9,7,14,32,48,-16,34
Ards,6055,9,7,7,16,36,52,-16,28
Portadown,6055,10,6,7,17,17,41,-24,25
Ballinamalla,6055,11,6,5,19,28,52,-24,23
Crusaders,6056,1,19,5,6,63,34,29,62
Ballymena,6056,2,14,8,8,53,53,0,50
Cliftonville,6056,3,14,7,9,49,41,8,49
Linfield,6056,4,12,11,7,50,31,19,47
Glenavon,6056,5,12,10,8,51,46,5,46
Glentoran,6056,6,12,8,10,30,39,-9,44
Dungannon,6056,7,9,9,12,50,47,3,36
Coleraine,6056,8,8,12,10,40,41,-1,36
Ards,6056,9,9,6,15,44,52,-8,33
Ballinamalla,6056,10,7,4,19,28,53,-25,25
Portadown,6056,11,6,6,18,32,53,-21,24
Linfield,6057,1,16,9,5,60,27,33,57
Crusaders,6057,2,16,8,6,47,29,18,56
Glenavon,6057,3,14,10,6,46,36,10,52
Coleraine,6057,4,12,12,6,41,30,11,48
Ballymena,6057,5,14,5,11,56,57,-1,47
Cliftonville,6057,6,13,5,12,53,47,6,44
Dungannon,6057,7,11,10,9,48,37,11,43
Glentoran,6057,8,9,5,16,32,51,-19,32
Ards,6057,9,7,8,15,33,48,-15,29
Ballinamalla,6057,10,7,4,19,28,54,-26,25
Portadown,6057,11,6,4,20,22,50,-28,22
Cliftonville,6058,1,16,7,7,48,32,16,55
Crusaders,6058,2,14,9,7,56,34,22,51
Glenavon,6058,3,14,8,8,44,41,3,50
Coleraine,6058,4,11,13,6,45,30,15,46
Linfield,6058,5,11,10,9,51,36,15,43
Dungannon,6058,6,11,10,9,48,36,12,43
Ballymena,6058,7,12,5,13,45,53,-8,41
Glentoran,6058,8,10,6,14,31,45,-14,36
Ballinamalla,6058,9,10,2,18,29,51,-22,32
Ards,6058,10,9,4,17,35,51,-16,31
Portadown,6058,11,7,6,17,28,51,-23,27
Crusaders,6059,1,17,7,6,55,33,22,58
Linfield,6059,2,15,8,7,63,35,28,53
Cliftonville,6059,3,15,5,10,54,41,13,50
Dungannon,6059,4,13,8,9,51,38,13,47
Glenavon,6059,5,12,10,8,51,43,8,46
Coleraine,6059,6,10,12,8,41,39,2,42
Ballymena,6059,7,11,8,11,57,59,-2,41
Ards,6059,8,10,6,14,41,51,-10,36
Ballinamalla,6059,9,6,11,13,29,48,-19,29
Glentoran,6059,10,5,10,15,23,49,-26,25
Portadown,6059,11,6,5,19,24,53,-29,23
Crusaders,6060,1,19,6,5,59,30,29,63
Linfield,6060,2,18,8,4,61,25,36,62
Cliftonville,6060,3,15,2,13,46,41,5,47
Glenavon,6060,4,12,9,9,42,44,-2,45
Ballymena,6060,5,12,7,11,55,57,-2,43
Coleraine,6060,6,11,8,11,40,42,-2,41
Glentoran,6060,7,11,7,12,32,42,-10,40
Dungannon,6060,8,10,9,11,49,37,12,39
Ards,6060,9,9,6,15,35,48,-13,33
Portadown,6060,10,7,3,20,24,50,-26,24
Ballinamalla,6060,11,6,5,19,23,50,-27,23
Cliftonville,6061,1,18,6,6,64,32,32,60
Linfield,6061,2,17,7,6,56,26,30,58
Coleraine,6061,3,15,10,5,47,30,17,55
Crusaders,6061,4,15,6,9,50,36,14,51
Ballymena,6061,5,13,5,12,53,57,-4,44
Dungannon,6061,6,8,12,10,41,41,0,36
Glenavon,6061,7,7,13,10,39,50,-11,34
Ballinamalla,6061,8,8,7,15,28,46,-18,31
Ards,6061,9,8,6,16,37,50,-13,30
Portadown,6061,10,8,6,16,21,42,-21,30
Glentoran,6061,11,6,6,18,24,50,-26,24
Glenavon,6062,1,14,11,5,54,44,10,53
Crusaders,6062,2,15,6,9,51,38,13,51
Ballymena,6062,3,15,6,9,64,57,7,51
Coleraine,6062,4,13,9,8,47,37,10,48
Cliftonville,6062,5,14,5,11,53,44,9,47
Linfield,6062,6,12,10,8,53,33,20,46
Ards,6062,7,10,7,13,35,42,-7,37
Dungannon,6062,8,9,7,14,51,49,2,34
Glentoran,6062,9,9,7,14,33,49,-16,34
Portadown,6062,10,8,6,16,29,51,-22,30
Ballinamalla,6062,11,6,6,18,26,52,-26,24
Crusaders,6063,1,15,8,7,54,35,19,53
Cliftonville,6063,2,16,4,10,57,40,17,52
Ballymena,6063,3,15,5,10,64,64,0,50
Linfield,6063,4,13,10,7,62,34,28,49
Glenavon,6063,5,12,13,5,51,38,13,49
Coleraine,6063,6,11,9,10,42,42,0,42
Ards,6063,7,12,5,13,40,45,-5,41
Dungannon,6063,8,9,9,12,48,48,0,36
Glentoran,6063,9,9,9,12,31,48,-17,36
Ballinamalla,6063,10,8,4,18,27,51,-24,28
Portadown,6063,11,3,8,19,20,51,-31,17
Crusaders,6064,1,18,4,8,58,35,23,58
Cliftonville,6064,2,16,4,10,52,38,14,52
Ballymena,6064,3,16,4,10,58,54,4,52
Linfield,6064,4,14,9,7,58,29,29,51
Dungannon,6064,5,14,7,9,60,44,16,49
Coleraine,6064,6,12,10,8,47,41,6,46
Ards,6064,7,11,3,16,35,52,-17,36
Ballinamalla,6064,8,9,6,15,34,45,-11,33
Glenavon,6064,9,8,9,13,40,53,-13,33
Glentoran,6064,10,8,6,16,30,49,-19,30
Portadown,6064,11,6,4,20,23,55,-32,22
Crusaders,6065,1,19,8,3,67,31,36,65
Cliftonville,6065,2,14,8,8,59,44,15,50
Linfield,6065,3,12,13,5,55,34,21,49
Ballymena,6065,4,14,5,11,58,59,-1,47
Glenavon,6065,5,10,13,7,44,41,3,43
Coleraine,6065,6,10,11,9,36,35,1,41
Glentoran,6065,7,10,6,14,37,47,-10,36
Dungannon,6065,8,8,11,11,49,46,3,35
Portadown,6065,9,9,7,14,22,38,-16,34
Ards,6065,10,8,6,16,42,56,-14,30
Ballinamalla,6065,11,4,6,20,26,64,-38,18
Crusaders,6066,1,16,9,5,52,31,21,57
Linfield,6066,2,15,9,6,67,34,33,54
Coleraine,6066,3,13,10,7,46,33,13,49
Cliftonville,6066,4,15,4,11,48,37,11,49
Ballymena,6066,5,12,8,10,59,62,-3,44
Glenavon,6066,6,10,10,10,43,47,-4,40
Dungannon,6066,7,9,10,11,46,44,2,37
Ards,6066,8,10,4,16,36,50,-14,34
Glentoran,6066,9,8,8,14,38,55,-17,32
Ballinamalla,6066,10,9,5,16,32,51,-19,32
Portadown,6066,11,8,3,19,31,54,-23,27
Cliftonville,6067,1,17,5,8,57,34,23,56
Crusaders,6067,2,14,10,6,52,36,16,52
Dungannon,6067,3,12,11,7,55,44,11,47
Ballymena,6067,4,13,6,11,59,55,4,45
Linfield,6067,5,10,13,7,51,36,15,43
Coleraine,6067,6,11,10,9,40,40,0,43
Glenavon,6067,7,10,10,10,47,45,2,40
Ards,6067,8,10,5,15,44,48,-4,35
Glentoran,6067,9,9,8,13,33,53,-20,35
Portadown,6067,10,9,2,19,26,48,-22,29
Ballinamalla,6067,11,7,6,17,28,53,-25,27
Cliftonville,6068,1,18,4,8,59,34,25,58
Crusaders,6068,2,16,7,7,58,35,23,55
Linfield,6068,3,14,11,5,64,36,28,53
Glenavon,6068,4,13,10,7,62,49,13,49
Glentoran,6068,5,13,6,11,33,36,-3,45
Ballymena,6068,6,12,8,10,53,55,-2,44
Dungannon,6068,7,9,9,12,49,49,0,36
Coleraine,6068,8,9,9,12,42,50,-8,36
Ards,6068,9,9,4,17,37,53,-16,31
Portadown,6068,10,6,6,18,23,52,-29,24
Ballinamalla,6068,11,6,6,18,21,52,-31,24
Linfield,6069,1,17,9,4,62,26,36,60
Crusaders,6069,2,16,7,7,60,39,21,55
Ballymena,6069,3,16,6,8,62,55,7,54
Glenavon,6069,4,14,8,8,54,45,9,50
Cliftonville,6069,5,13,5,12,54,52,2,44
Coleraine,6069,6,11,10,9,41,33,8,43
Glentoran,6069,7,10,11,9,33,39,-6,41
Dungannon,6069,8,9,8,13,48,53,-5,35
Ballinamalla,6069,9,7,6,17,27,51,-24,27
Portadown,6069,10,6,5,19,26,49,-23,23
Ards,6069,11,6,5,19,35,60,-25,23
Ballymena,6070,1,16,5,9,56,54,2,53
Glenavon,6070,2,14,10,6,49,39,10,52
Crusaders,6070,3,15,6,9,52,38,14,51
Linfield,6070,4,13,9,8,62,40,22,48
Cliftonville,6070,5,14,3,13,53,46,7,45
Dungannon,6070,6,11,8,11,50,42,8,41
Coleraine,6070,7,10,11,9,42,42,0,41
Glentoran,6070,8,8,10,12,31,41,-10,34
Ards,6070,9,8,8,14,37,52,-15,32
Portadown,6070,10,8,5,17,26,49,-23,29
Ballinamalla,6070,11,7,7,16,35,50,-15,28
Crusaders,6071,1,19,7,4,55,27,28,64
Cliftonville,6071,2,15,4,11,50,35,15,49
Ballymena,6071,3,14,6,10,55,56,-1,48
Linfield,6071,4,12,10,8,57,37,20,46
Portadown,6071,5,11,6,13,28,36,-8,39
Coleraine,6071,6,9,11,10,36,41,-5,38
Dungannon,6071,7,9,9,12,49,44,5,36
Glenavon,6071,8,9,9,12,42,52,-10,36
Ards,6071,9,9,7,14,35,45,-10,34
Glentoran,6071,10,9,6,15,29,45,-16,33
Ballinamalla,6071,11,8,7,15,25,43,-18,31
Linfield,6072,1,17,7,6,60,28,32,58
Crusaders,6072,2,17,5,8,54,34,20,56
Cliftonville,6072,3,17,4,9,54,36,18,55
Glenavon,6072,4,12,12,6,45,44,1,48
Ballymena,6072,5,14,5,11,63,62,1,47
Ards,6072,6,13,5,12,46,43,3,44
Coleraine,6072,7,10,10,10,39,39,0,40
Dungannon,6072,8,10,7,13,47,49,-2,37
Glentoran,6072,9,9,8,13,33,39,-6,35
Portadown,6072,10,7,6,17,25,45,-20,27
Ballinamalla,6072,11,3,3,24,20,67,-47,12
Linfield,6073,1,16,10,4,62,30,32,58
Cliftonville,6073,2,17,5,8,60,39,21,56
Crusaders,6073,3,15,7,8,54,41,13,52
Ballymena,6073,4,14,4,12,57,62,-5,46
Glenavon,6073,5,10,13,7,43,40,3,43
Coleraine,6073,6,9,12,9,40,42,-2,39
Ards,6073,7,11,4,15,43,48,-5,37
Dungannon,6073,8,9,9,12,51,45,6,36
Glentoran,6073,9,8,7,15,31,48,-17,31
Portadown,6073,10,7,7,16,20,40,-20,28
Ballinamalla,6073,11,7,6,17,30,56,-26,27
Cliftonville,6074,1,18,3,9,51,35,16,57
Linfield,6074,2,16,8,6,60,28,32,56
Crusaders,6074,3,14,9,7,55,44,11,51
Glenavon,6074,4,13,11,6,49,43,6,50
Coleraine,6074,5,12,10,8,46,35,11,46
Ballymena,6074,6,13,4,13,59,65,-6,43
Dungannon,6074,7,11,9,10,55,44,11,42
Glentoran,6074,8,9,9,12,30,38,-8,36
Ards,6074,9,8,6,16,33,49,-16,30
Portadown,6074,10,5,6,19,20,47,-27,21
Ballinamalla,6074,11,4,9,17,22,52,-30,21
Crusaders,6075,1,18,6,6,58,35,23,60
Glenavon,6075,2,14,10,6,58,44,14,52
Linfield,6075,3,13,9,8,61,37,24,48
Cliftonville,6075,4,14,6,10,56,44,12,48
Ballymena,6075,5,11,9,10,58,64,-6,42
Coleraine,6075,6,10,10,10,41,43,-2,40
Ards,6075,7,10,5,15,31,45,-14,35
Dungannon,6075,8,8,10,12,44,49,-5,34
Portadown,6075,9,9,6,15,35,49,-14,33
Glentoran,6075,10,7,9,14,35,50,-15,30
Ballinamalla,6075,11,8,6,16,36,53,-17,30
Crusaders,6076,1,13,11,6,46,32,14,50
Cliftonville,6076,2,14,8,8,54,44,10,50
Linfield,6076,3,13,10,7,53,27,26,49
Ballymena,6076,4,13,8,9,55,55,0,47
Coleraine,6076,5,12,9,9,47,37,10,45
Dungannon,6076,6,11,11,8,49,38,11,44
Glenavon,6076,7,10,11,9,46,46,0,41
Glentoran,6076,8,10,5,15,34,46,-12,35
Ards,6076,9,10,5,15,35,49,-14,35
Ballinamalla,6076,10,7,6,17,28,49,-21,27
Portadown,6076,11,7,6,17,22,46,-24,27
Crusaders,6077,1,18,6,6,61,37,24,60
Cliftonville,6077,2,16,6,8,57,42,15,54
Linfield,6077,3,13,11,6,59,31,28,50
Dungannon,6077,4,11,11,8,52,38,14,44
Coleraine,6077,5,10,14,6,40,35,5,44
Glenavon,6077,6,10,10,10,46,48,-2,40
Ballymena,6077,7,11,4,15,46,64,-18,37
Portadown,6077,8,9,7,14,29,39,-10,34
Ballinamalla,6077,9,9,5,16,33,49,-16,32
Glentoran,6077,10,7,10,13,24,40,-16,31
Ards,6077,11,7,4,19,31,55,-24,25
Cliftonville,6078,1,16,7,7,60,36,24,55
Crusaders,6078,2,15,6,9,61,44,17,51
Ballymena,6078,3,14,7,9,60,57,3,49
Coleraine,6078,4,13,8,9,42,36,6,47
Linfield,6078,5,10,13,7,52,33,19,43
Glenavon,6078,6,10,11,9,49,46,3,41
Ballinamalla,6078,7,11,6,13,40,48,-8,39
Glentoran,6078,8,9,11,10,30,42,-12,38
Dungannon,6078,9,9,10,11,46,48,-2,37
Ards,6078,10,7,5,18,30,52,-22,26
Portadown,6078,11,6,6,18,24,52,-28,24
Linfield,6079,1,14,11,5,61,29,32,53
Crusaders,6079,2,14,9,7,52,32,20,51
Coleraine,6079,3,12,10,8,42,38,4,46
Cliftonville,6079,4,12,9,9,42,32,10,45
Ballymena,6079,5,12,7,11,57,61,-4,43
Glenavon,6079,6,10,9,11,50,46,4,39
Glentoran,6079,7,9,10,11,28,43,-15,37
Portadown,6079,8,9,8,13,26,41,-15,35
Ards,6079,9,9,7,14,33,43,-10,34
Dungannon,6079,10,7,11,12,43,48,-5,32
Ballinamalla,6079,11,9,5,16,28,49,-21,32
Crusaders,6080,1,15,6,9,51,35,16,51
Coleraine,6080,2,14,9,7,47,37,10,51
Linfield,6080,3,13,10,7,55,31,24,49
Cliftonville,6080,4,15,4,11,50,39,11,49
Glenavon,6080,5,12,11,7,45,38,7,47
Ballymena,6080,6,12,7,11,53,59,-6,43
Glentoran,6080,7,11,6,13,36,45,-9,39
Dungannon,6080,8,10,8,12,50,46,4,38
Ards,6080,9,10,4,16,35,46,-11,34
Portadown,6080,10,10,4,16,25,44,-19,34
Ballinamalla,6080,11,4,9,17,24,51,-27,21
Crusaders,6081,1,20,7,3,64,29,35,67
Cliftonville,6081,2,17,5,8,54,36,18,56
Linfield,6081,3,13,10,7,50,30,20,49
Dungannon,6081,4,12,9,9,55,34,21,45
Glenavon,6081,5,11,9,10,41,43,-2,42
Coleraine,6081,6,9,12,9,42,48,-6,39
Glentoran,6081,7,10,8,12,36,49,-13,38
Ballymena,6081,8,10,7,13,54,62,-8,37
Ards,6081,9,8,5,17,33,53,-20,29
Ballinamalla,6081,10,8,3,19,34,58,-24,27
Portadown,6081,11,7,5,18,21,42,-21,26
Crusaders,6082,1,17,7,6,61,37,24,58
Cliftonville,6082,2,14,5,11,53,40,13,47
Coleraine,6082,3,13,8,9,48,41,7,47
Linfield,6082,4,12,9,9,53,36,17,45
Glenavon,6082,5,11,10,9,50,48,2,43
Dungannon,6082,6,10,11,9,54,51,3,41
Ballymena,6082,7,11,8,11,56,59,-3,41
Glentoran,6082,8,9,12,9,40,43,-3,39
Ards,6082,9,11,6,13,41,48,-7,39
Ballinamalla,6082,10,9,4,17,34,55,-21,31
Portadown,6082,11,5,6,19,27,59,-32,21
Crusaders,6083,1,18,7,5,51,34,17,61
Ballymena,6083,2,18,5,7,63,52,11,59
Cliftonville,6083,3,16,4,10,57,40,17,52
Linfield,6083,4,12,9,9,57,35,22,45
Dungannon,6083,5,11,9,10,57,41,16,42
Coleraine,6083,6,9,12,9,42,41,1,39
Glenavon,6083,7,9,12,9,40,43,-3,39
Glentoran,6083,8,9,6,15,32,49,-17,33
Portadown,6083,9,8,8,14,27,41,-14,32
Ballinamalla,6083,10,8,4,18,28,57,-29,28
Ards,6083,11,6,6,18,33,54,-21,24
Cliftonville,6084,1,19,3,8,62,33,29,60
Crusaders,6084,2,14,11,5,49,31,18,53
Linfield,6084,3,13,9,8,47,29,18,48
Coleraine,6084,4,11,11,8,42,40,2,44
Glentoran,6084,5,11,7,12,36,43,-7,40
Glenavon,6084,6,10,8,12,46,50,-4,38
Ballymena,6084,7,10,8,12,51,64,-13,38
Dungannon,6084,8,9,10,11,45,37,8,37
Ards,6084,9,10,7,13,42,50,-8,37
Ballinamalla,6084,10,10,5,15,33,50,-17,35
Portadown,6084,11,7,3,20,25,51,-26,24
Linfield,6085,1,15,10,5,53,28,25,55
Cliftonville,6085,2,16,4,10,51,37,14,52
Crusaders,6085,3,15,6,9,51,33,18,51
Ballymena,6085,4,15,6,9,62,58,4,51
Glenavon,6085,5,11,13,6,55,48,7,46
Dungannon,6085,6,12,8,10,48,43,5,44
Coleraine,6085,7,10,10,10,48,46,2,40
Ards,6085,8,9,6,15,42,53,-11,33
Glentoran,6085,9,7,12,11,34,45,-11,33
Ballinamalla,6085,10,6,6,18,31,57,-26,24
Portadown,6085,11,5,7,18,21,48,-27,22
Crusaders,6086,1,16,5,9,57,39,18,53
Dungannon,6086,2,14,9,7,62,40,22,51
Glenavon,6086,3,14,9,7,53,46,7,51
Linfield,6086,4,13,10,7,54,35,19,49
Cliftonville,6086,5,15,4,11,56,41,15,49
Ballymena,6086,6,13,4,13,53,66,-13,43
Coleraine,6086,7,10,11,9,43,40,3,41
Portadown,6086,8,9,7,14,31,44,-13,34
Ballinamalla,6086,9,9,7,14,33,49,-16,34
Glentoran,6086,10,6,9,15,32,53,-21,27
Ards,6086,11,6,5,19,32,53,-21,23
Cliftonville,6087,1,16,7,7,57,35,22,55
Ballymena,6087,2,15,8,7,60,51,9,53
Crusaders,6087,3,15,6,9,53,38,15,51
Glenavon,6087,4,13,12,5,52,38,14,51
Linfield,6087,5,13,9,8,59,36,23,48
Dungannon,6087,6,11,8,11,55,49,6,41
Ards,6087,7,9,10,11,40,46,-6,37
Coleraine,6087,8,8,11,11,31,39,-8,35
Glentoran,6087,9,8,6,16,29,52,-23,30
Portadown,6087,10,7,6,17,28,49,-21,27
Ballinamalla,6087,11,6,5,19,28,59,-31,23
Crusaders,6088,1,15,11,4,57,31,26,56
Cliftonville,6088,2,14,7,9,50,37,13,49
Linfield,6088,3,13,9,8,62,43,19,48
Coleraine,6088,4,13,9,8,52,40,12,48
Ballymena,6088,5,13,8,9,53,52,1,47
Glenavon,6088,6,11,10,9,48,46,2,43
Ards,6088,7,11,5,14,44,47,-3,38
Dungannon,6088,8,9,8,13,49,52,-3,35
Glentoran,6088,9,9,8,13,30,48,-18,35
Portadown,6088,10,8,4,18,24,48,-24,28
Ballinamalla,6088,11,7,5,18,26,51,-25,26
Crusaders,6089,1,19,5,6,60,30,30,62
Ballymena,6089,2,19,3,8,63,52,11,60
Linfield,6089,3,14,9,7,60,34,26,51
Cliftonville,6089,4,14,4,12,54,49,5,46
Dungannon,6089,5,12,9,9,55,42,13,45
Coleraine,6089,6,11,12,7,42,36,6,45
Glenavon,6089,7,8,10,12,45,53,-8,34
Glentoran,6089,8,8,7,15,20,44,-24,31
Ballinamalla,6089,9,9,3,18,31,55,-24,30
Portadown,6089,10,8,5,17,29,47,-18,29
Ards,6089,11,7,5,18,31,48,-17,26
Linfield,6090,1,16,7,7,69,33,36,55
Glenavon,6090,2,15,10,5,47,35,12,55
Cliftonville,6090,3,15,8,7,54,38,16,53
Crusaders,6090,4,14,7,9,56,41,15,49
Ballymena,6090,5,13,7,10,51,59,-8,46
Glentoran,6090,6,10,7,13,30,43,-13,37
Dungannon,6090,7,8,10,12,46,45,1,34
Coleraine,6090,8,8,10,12,36,39,-3,34
Ards,6090,9,10,3,17,39,53,-14,33
Ballinamalla,6090,10,10,3,17,34,53,-19,33
Portadown,6090,11,7,6,17,25,48,-23,27
Cliftonville,6091,1,16,7,7,57,34,23,55
Glenavon,6091,2,15,9,6,56,40,16,54
Ballymena,6091,3,15,7,8,59,55,4,52
Crusaders,6091,4,13,6,11,47,42,5,45
Coleraine,6091,5,10,12,8,45,38,7,42
Linfield,6091,6,10,11,9,52,38,14,41
Dungannon,6091,7,10,10,10,48,42,6,40
Ards,6091,8,10,6,14,38,44,-6,36
Portadown,6091,9,9,5,16,27,49,-22,32
Glentoran,6091,10,7,9,14,28,48,-20,30
Ballinamalla,6091,11,6,6,18,18,45,-27,24
Crusaders,6092,1,19,5,6,61,32,29,62
Cliftonville,6092,2,18,4,8,62,39,23,58
Linfield,6092,3,13,9,8,63,37,26,48
Coleraine,6092,4,12,11,7,47,40,7,47
Ballymena,6092,5,12,6,12,55,66,-11,42
Dungannon,6092,6,11,8,11,49,45,4,41
Ards,6092,7,12,4,14,44,49,-5,40
Glentoran,6092,8,9,10,11,32,46,-14,37
Glenavon,6092,9,8,10,12,39,50,-11,34
Ballinamalla,6092,10,8,2,20,30,52,-22,26
Portadown,6092,11,7,3,20,26,52,-26,24
Linfield,6093,1,15,9,6,63,31,32,54
Crusaders,6093,2,15,7,8,51,35,16,52
Cliftonville,6093,3,15,6,9,50,35,15,51
Ballymena,6093,4,15,5,10,57,54,3,50
Glentoran,6093,5,13,8,9,39,38,1,47
Glenavon,6093,6,11,10,9,45,45,0,43
Dungannon,6093,7,10,9,11,45,43,2,39
Coleraine,6093,8,8,12,10,40,44,-4,36
Ards,6093,9,7,7,16,30,49,-19,28
Ballinamalla,6093,10,8,4,18,27,53,-26,28
Portadown,6093,11,7,5,18,21,41,-20,26
Linfield,6094,1,13,11,6,62,36,26,50
Crusaders,6094,2,14,8,8,50,32,18,50
Ballymena,6094,3,15,3,12,61,56,5,48
Glenavon,6094,4,13,9,8,44,42,2,48
Cliftonville,6094,5,13,7,10,45,35,10,46
Coleraine,6094,6,12,10,8,37,34,3,46
Dungannon,6094,7,12,7,11,50,42,8,43
Portadown,6094,8,11,6,13,35,39,-4,39
Glentoran,6094,9,10,7,13,30,48,-18,37
Ards,6094,10,8,6,16,33,47,-14,30
Ballinamalla,6094,11,4,6,20,18,54,-36,18
Crusaders,6095,1,15,9,6,52,31,21,54
Linfield,6095,2,14,8,8,56,38,18,50
Cliftonville,6095,3,14,7,9,52,40,12,49
Ballymena,6095,4,13,9,8,55,54,1,48
Coleraine,6095,5,11,10,9,45,36,9,43
Glenavon,6095,6,12,7,11,48,53,-5,43
Portadown,6095,7,10,5,15,31,44,-13,35
Dungannon,6095,8,9,7,14,49,54,-5,34
Glentoran,6095,9,9,7,14,30,41,-11,34
Ards,6095,10,8,8,14,39,49,-10,32
Ballinamalla,6095,11,8,7,15,38,55,-17,31
Crusaders,6096,1,18,8,4,66,35,31,62
Linfield,6096,2,14,11,5,64,32,32,53
Cliftonville,6096,3,16,4,10,51,37,14,52
Coleraine,6096,4,11,11,8,40,36,4,44
Ballymena,6096,5,12,6,12,50,63,-13,42
Glenavon,6096,6,11,8,11,49,49,0,41
Ards,6096,7,12,4,14,39,44,-5,40
Dungannon,6096,8,9,11,10,54,45,9,38
Glentoran,6096,9,6,11,13,21,44,-23,29
Portadown,6096,10,7,6,17,28,50,-22,27
Ballinamalla,6096,11,6,6,18,31,58,-27,24
Crusaders,6097,1,18,6,6,57,34,23,60
Linfield,6097,2,17,7,6,61,33,28,58
Dungannon,6097,3,12,10,8,48,32,16,46
Coleraine,6097,4,12,10,8,40,32,8,46
Ballymena,6097,5,13,7,10,57,59,-2,46
Cliftonville,6097,6,13,4,13,48,47,1,43
Glentoran,6097,7,12,5,13,33,43,-10,41
Glenavon,6097,8,8,13,9,42,44,-2,37
Portadown,6097,9,9,7,14,28,38,-10,34
Ballinamalla,6097,10,7,3,20,32,57,-25,24
Ards,6097,11,6,4,20,34,61,-27,22
Linfield,6098,1,15,9,6,60,37,23,54
Crusaders,6098,2,15,6,9,53,43,10,51
Cliftonville,6098,3,15,3,12,53,41,12,48
Coleraine,6098,4,13,9,8,48,41,7,48
Glenavon,6098,5,12,9,9,52,49,3,45
Ards,6098,6,12,3,15,48,46,2,39
Ballymena,6098,7,11,6,13,49,58,-9,39
Dungannon,6098,8,10,8,12,50,50,0,38
Ballinamalla,6098,9,11,4,15,38,47,-9,37
Glentoran,6098,10,9,6,15,31,48,-17,33
Portadown,6098,11,7,7,16,27,49,-22,28
Crusaders,6099,1,18,6,6,58,34,24,60
Cliftonville,6099,2,16,4,10,52,36,16,52
Linfield,6099,3,14,9,7,60,37,23,51
Coleraine,6099,4,13,10,7,44,33,11,49
Glenavon,6099,5,11,9,10,48,49,-1,42
Glentoran,6099,6,10,9,11,35,41,-6,39
Ballymena,6099,7,9,7,14,49,60,-11,34
Dungannon,6099,8,8,9,13,50,49,1,33
Portadown,6099,9,10,3,17,29,42,-13,33
Ballinamalla,6099,10,9,6,15,32,49,-17,33
Ards,6099,11,10,2,18,35,62,-27,32
Crusaders,6100,1,16,8,6,56,32,24,56
Linfield,6100,2,16,7,7,58,31,27,55
Ballymena,6100,3,17,4,9,63,55,8,55
Coleraine,6100,4,11,11,8,45,39,6,44
Cliftonville,6100,5,13,5,12,46,41,5,44
Glenavon,6100,6,11,10,9,44,45,-1,43
Dungannon,6100,7,9,10,11,46,45,1,37
Glentoran,6100,8,9,9,12,33,43,-10,36
Ballinamalla,6100,9,9,4,17,30,50,-20,31
Ards,6100,10,7,6,17,34,51,-17,27
Portadown,6100,11,7,6,17,21,44,-23,27
Linfield,6101,1,17,8,5,62,25,37,59
Crusaders,6101,2,15,13,2,54,28,26,58
Ballymena,6101,3,15,7,8,61,59,2,52
Cliftonville,6101,4,13,8,9,49,41,8,47
Glenavon,6101,5,11,9,10,53,54,-1,42
Coleraine,6101,6,10,9,11,41,43,-2,39
Dungannon,6101,7,9,11,10,47,41,6,38
Ards,6101,8,11,5,14,39,45,-6,38
Glentoran,6101,9,7,7,16,34,54,-20,28
Ballinamalla,6101,10,8,3,19,30,54,-24,27
Portadown,6101,11,5,8,17,25,51,-26,23
Crusaders,6102,1,17,9,4,54,26,28,60
Linfield,6102,2,16,9,5,59,28,31,57
Cliftonville,6102,3,15,5,10,51,39,12,50
Coleraine,6102,4,13,10,7,41,32,9,49
Glenavon,6102,5,11,9,10,48,43,5,42
Ballymena,6102,6,11,8,11,50,61,-11,41
Ards,6102,7,10,6,14,46,50,-4,36
Dungannon,6102,8,8,9,13,41,50,-9,33
Glentoran,6102,9,8,7,15,29,47,-18,31
Portadown,6102,10,8,4,18,27,42,-15,28
Ballinamalla,6102,11,7,6,17,25,53,-28,27
Ballymena,6103,1,15,8,7,53,50,3,53
Crusaders,6103,2,15,6,9,56,42,14,51
Linfield,6103,3,13,9,8,50,29,21,48
Coleraine,6103,4,12,11,7,38,31,7,47
Cliftonville,6103,5,13,6,11,46,39,7,45
Glentoran,6103,6,11,9,10,28,36,-8,42
Glenavon,6103,7,10,9,11,44,50,-6,39
Dungannon,6103,8,8,11,11,54,48,6,35
Ards,6103,9,10,4,16,46,56,-10,34
Portadown,6103,10,9,5,16,25,39,-14,32
Ballinamalla,6103,11,7,6,17,26,46,-20,27
Crusaders,6104,1,16,8,6,57,36,21,56
Ballymena,6104,2,16,5,9,65,57,8,53
Cliftonville,6104,3,15,6,9,57,41,16,51
Linfield,6104,4,14,8,8,51,30,21,50
Glenavon,6104,5,13,7,10,47,46,1,46
Coleraine,6104,6,11,9,10,41,42,-1,42
Dungannon,6104,7,10,10,10,51,43,8,40
Glentoran,6104,8,9,7,14,35,46,-11,34
Ards,6104,9,9,4,17,35,51,-16,31
Ballinamalla,6104,10,9,3,18,37,60,-23,30
Portadown,6104,11,7,5,18,26,50,-24,26
Linfield,6105,1,16,10,4,64,30,34,58
Cliftonville,6105,2,17,5,8,58,39,19,56
Crusaders,6105,3,16,4,10,52,34,18,52
Coleraine,6105,4,13,10,7,47,39,8,49
Ballymena,6105,5,13,5,12,50,52,-2,44
Glenavon,6105,6,11,9,10,45,53,-8,42
Ballinamalla,6105,7,10,5,15,31,50,-19,35
Dungannon,6105,8,9,7,14,49,48,1,34
Ards,6105,9,8,6,16,40,51,-11,30
Portadown,6105,10,8,6,16,28,44,-16,30
Glentoran,6105,11,8,5,17,23,47,-24,29
Crusaders,6106,1,18,8,4,56,30,26,62
Linfield,6106,2,13,11,6,60,33,27,50
Cliftonville,6106,3,14,5,11,51,43,8,47
Ballymena,6106,4,13,6,11,67,66,1,45
Glenavon,6106,5,11,12,7,45,44,1,45
Coleraine,6106,6,10,11,9,47,48,-1,41
Ards,6106,7,9,9,12,43,47,-4,36
Glentoran,6106,8,10,6,14,32,44,-12,36
Dungannon,6106,9,9,8,13,52,49,3,35
Ballinamalla,6106,10,10,4,16,34,52,-18,34
Portadown,6106,11,6,4,20,21,52,-31,22
Linfield,6107,1,14,10,6,66,33,33,52
Cliftonville,6107,2,16,4,10,58,40,18,52
Glenavon,6107,3,14,10,6,53,45,8,52
Crusaders,6107,4,14,7,9,52,37,15,49
Ballymena,6107,5,14,6,10,60,61,-1,48
Dungannon,6107,6,10,12,8,53,44,9,42
Coleraine,6107,7,10,10,10,43,42,1,40
Ards,6107,8,10,3,17,35,51,-16,33
Glentoran,6107,9,9,5,16,25,46,-21,32
Ballinamalla,6107,10,9,3,18,32,51,-19,30
Portadown,6107,11,7,6,17,24,51,-27,27
Ballymena,6108,1,18,4,8,59,49,10,58
Linfield,6108,2,16,9,5,60,23,37,57
Crusaders,6108,3,14,11,5,50,33,17,53
Coleraine,6108,4,13,11,6,51,33,18,50
Glenavon,6108,5,13,11,6,46,40,6,50
Cliftonville,6108,6,15,4,11,52,40,12,49
Ballinamalla,6108,7,10,3,17,33,51,-18,33
Glentoran,6108,8,8,7,15,24,43,-19,31
Ards,6108,9,8,4,18,33,50,-17,28
Dungannon,6108,10,6,9,15,41,54,-13,27
Portadown,6108,11,5,5,20,18,51,-33,20
Linfield,6109,1,16,9,5,60,26,34,57
Crusaders,6109,2,17,5,8,61,38,23,56
Cliftonville,6109,3,14,7,9,48,42,6,49
Coleraine,6109,4,13,9,8,42,34,8,48
Glenavon,6109,5,12,11,7,48,41,7,47
Ballymena,6109,6,13,8,9,57,56,1,47
Dungannon,6109,7,9,10,11,48,44,4,37
Portadown,6109,8,10,6,14,35,49,-14,36
Ards,6109,9,7,7,16,37,54,-17,28
Glentoran,6109,10,6,9,15,22,44,-22,27
Ballinamalla,6109,11,5,5,20,22,52,-30,20
Crusaders,6110,1,18,5,7,50,32,18,59
Linfield,6110,2,15,7,8,59,33,26,52
Cliftonville,6110,3,15,6,9,55,37,18,51
Coleraine,6110,4,13,8,9,47,40,7,47
Ballymena,6110,5,12,5,13,54,68,-14,41
Glenavon,6110,6,10,9,11,43,47,-4,39
Ballinamalla,6110,7,12,3,15,39,46,-7,39
Ards,6110,8,11,4,15,40,48,-8,37
Dungannon,6110,9,8,10,12,45,45,0,34
Portadown,6110,10,7,9,14,27,48,-21,30
Glentoran,6110,11,7,8,15,30,45,-15,29
Linfield,6111,1,15,11,4,57,31,26,56
Crusaders,6111,2,17,5,8,53,34,19,56
Cliftonville,6111,3,17,3,10,51,38,13,54
Ballymena,6111,4,14,8,8,55,52,3,50
Dungannon,6111,5,11,11,8,50,43,7,44
Coleraine,6111,6,12,8,10,42,38,4,44
Glenavon,6111,7,11,7,12,47,49,-2,40
Ards,6111,8,9,7,14,40,46,-6,34
Glentoran,6111,9,6,9,15,30,51,-21,27
Ballinamalla,6111,10,7,5,18,33,53,-20,26
Portadown,6111,11,6,6,18,26,49,-23,24
Crusaders,6112,1,15,8,7,50,32,18,53
Cliftonville,6112,2,16,3,11,59,42,17,51
Linfield,6112,3,13,9,8,61,39,22,48
Coleraine,6112,4,9,14,7,40,39,1,41
Ballymena,6112,5,11,8,11,60,66,-6,41
Glentoran,6112,6,11,8,11,36,46,-10,41
Ards,6112,7,12,3,15,41,48,-7,39
Dungannon,6112,8,8,12,10,47,44,3,36
Portadown,6112,9,9,8,13,27,41,-14,35
Glenavon,6112,10,8,10,12,42,49,-7,34
Ballinamalla,6112,11,7,9,14,26,43,-17,30
Linfield,6113,1,16,9,5,57,27,30,57
Crusaders,6113,2,16,8,6,62,40,22,56
Cliftonville,6113,3,15,5,10,51,40,11,50
Ballymena,6113,4,15,5,10,56,58,-2,50
Glenavon,6113,5,11,10,9,48,46,2,43
Coleraine,6113,6,9,15,6,44,37,7,42
Glentoran,6113,7,10,9,11,41,48,-7,39
Ards,6113,8,10,5,15,43,48,-5,35
Dungannon,6113,9,7,12,11,42,46,-4,33
Portadown,6113,10,7,5,18,24,45,-21,26
Ballinamalla,6113,11,5,5,20,25,58,-33,20
Crusaders,6114,1,17,7,6,57,33,24,58
Cliftonville,6114,2,17,4,9,53,36,17,55
Linfield,6114,3,14,10,6,57,33,24,52
Ballymena,6114,4,15,7,8,58,57,1,52
Dungannon,6114,5,13,6,11,62,40,22,45
Coleraine,6114,6,11,9,10,42,40,2,42
Glenavon,6114,7,10,11,9,46,48,-2,41
Ards,6114,8,12,3,15,42,50,-8,39
Portadown,6114,9,7,5,18,26,47,-21,26
Glentoran,6114,10,5,10,15,24,53,-29,25
Ballinamalla,6114,11,6,4,20,22,52,-30,22
Crusaders,6115,1,16,8,6,51,32,19,56
Linfield,6115,2,15,10,5,63,35,28,55
Ballymena,6115,3,15,7,8,60,55,5,52
Cliftonville,6115,4,13,8,9,48,42,6,47
Glenavon,6115,5,11,11,8,49,45,4,44
Dungannon,6115,6,11,9,10,49,41,8,42
Coleraine,6115,7,10,12,8,41,37,4,42
Ards,6115,8,8,9,13,41,51,-10,33
Glentoran,6115,9,7,7,16,31,50,-19,28
Portadown,6115,10,5,9,16,29,51,-22,24
Ballinamalla,6115,11,6,6,18,29,52,-23,24
Glenavon,6116,1,15,9,6,44,36,8,54
Linfield,6116,2,14,8,8,60,34,26,50
Cliftonville,6116,3,15,5,10,58,41,17,50
Crusaders,6116,4,12,9,9,51,50,1,45
Ballymena,6116,5,13,6,11,55,59,-4,45
Coleraine,6116,6,12,8,10,40,36,4,44
Glentoran,6116,7,11,8,11,35,42,-7,41
Dungannon,6116,8,9,10,11,47,40,7,37
Ards,6116,9,11,3,16,40,52,-12,36
Portadown,6116,10,8,7,15,33,48,-15,31
Ballinamalla,6116,11,5,7,18,25,50,-25,22
Crusaders,6117,1,17,12,1,64,30,34,63
Cliftonville,6117,2,17,5,8,60,38,22,56
Linfield,6117,3,14,9,7,53,28,25,51
Ballymena,6117,4,15,6,9,62,59,3,51
Coleraine,6117,5,12,9,9,46,43,3,45
Glenavon,6117,6,12,7,11,43,51,-8,43
Ballinamalla,6117,7,10,4,16,36,50,-14,34
Ards,6117,8,8,6,16,43,54,-11,30
Glentoran,6117,9,7,8,15,30,49,-19,29
Dungannon,6117,10,6,10,14,45,56,-11,28
Portadown,6117,11,6,6,18,23,47,-24,24
Cliftonville,6118,1,18,3,9,54,36,18,57
Crusaders,6118,2,16,7,7,49,32,17,55
Linfield,6118,3,15,9,6,61,35,26,54
Ballymena,6118,4,13,9,8,62,63,-1,48
Ballinamalla,6118,5,12,5,13,42,47,-5,41
Glenavon,6118,6,9,13,8,45,49,-4,40
Coleraine,6118,7,8,13,9,41,42,-1,37
Ards,6118,8,10,6,14,46,53,-7,36
Dungannon,6118,9,9,8,13,51,49,2,35
Glentoran,6118,10,8,5,17,32,51,-19,29
Portadown,6118,11,5,6,19,22,48,-26,21
Linfield,6119,1,17,8,5,65,30,35,59
Cliftonville,6119,2,18,3,9,59,39,20,57
Crusaders,6119,3,15,8,7,60,44,16,53
Coleraine,6119,4,14,7,9,44,34,10,49
Ballymena,6119,5,13,9,8,50,51,-1,48
Glenavon,6119,6,10,10,10,46,52,-6,40
Ards,6119,7,12,3,15,39,47,-8,39
Glentoran,6119,8,9,8,13,35,49,-14,35
Dungannon,6119,9,7,10,13,46,50,-4,31
Portadown,6119,10,7,4,19,25,46,-21,25
Ballinamalla,6119,11,5,6,19,28,55,-27,21
Linfield,6120,1,16,8,6,56,30,26,56
Crusaders,6120,2,14,9,7,52,37,15,51
Glenavon,6120,3,13,12,5,51,38,13,51
Ballymena,6120,4,15,5,10,62,51,11,50
Coleraine,6120,5,13,10,7,46,41,5,49
Cliftonville,6120,6,14,6,10,50,41,9,48
Dungannon,6120,7,12,8,10,61,49,12,44
Ards,6120,8,10,6,14,33,42,-9,36
Glentoran,6120,9,6,9,15,22,41,-19,27
Ballinamalla,6120,10,5,7,18,27,60,-33,22
Portadown,6120,11,3,8,19,25,55,-30,17
Crusaders,6121,1,18,7,5,57,29,28,61
Linfield,6121,2,14,10,6,59,27,32,52
Ballymena,6121,3,13,7,10,54,63,-9,46
Cliftonville,6121,4,13,5,12,47,39,8,44
Glenavon,6121,5,10,13,7,45,45,0,43
Coleraine,6121,6,10,12,8,42,35,7,42
Glentoran,6121,7,11,7,12,32,42,-10,40
Dungannon,6121,8,9,11,10,52,43,9,38
Ards,6121,9,8,6,16,41,58,-17,30
Ballinamalla,6121,10,8,4,18,27,48,-21,28
Portadown,6121,11,7,6,17,29,56,-27,27
Linfield,6122,1,13,13,4,49,24,25,52
Cliftonville,6122,2,16,4,10,49,36,13,52
Crusaders,6122,3,14,9,7,53,35,18,51
Coleraine,6122,4,14,8,8,48,36,12,50
Ballymena,6122,5,13,8,9,56,55,1,47
Glenavon,6122,6,9,12,9,46,46,0,39
Dungannon,6122,7,9,11,10,56,50,6,38
Ballinamalla,6122,8,11,2,17,33,50,-17,35
Glentoran,6122,9,9,6,15,32,47,-15,33
Portadown,6122,10,9,4,17,32,52,-20,31
Ards,6122,11,5,9,16,27,50,-23,24
Crusaders,6123,1,17,7,6,59,33,26,58
Linfield,6123,2,17,6,7,56,28,28,57
Cliftonville,6123,3,15,6,9,52,39,13,51
Glenavon,6123,4,13,10,7,47,41,6,49
Ballymena,6123,5,13,7,10,58,57,1,46
Coleraine,6123,6,9,13,8,41,40,1,40
Dungannon,6123,7,11,6,13,55,55,0,39
Ards,6123,8,11,5,14,38,44,-6,38
Glentoran,6123,9,10,7,13,34,46,-12,37
Ballinamalla,6123,10,6,6,18,23,49,-26,24
Portadown,6123,11,4,5,21,23,54,-31,17
Ballymena,6124,1,16,6,8,59,53,6,54
Glenavon,6124,2,14,9,7,51,44,7,51
Cliftonville,6124,3,15,5,10,54,40,14,50
Crusaders,6124,4,14,6,10,51,41,10,48
Coleraine,6124,5,12,10,8,46,42,4,46
Linfield,6124,6,9,11,10,49,40,9,38
Ards,6124,7,11,5,14,48,52,-4,38
Dungannon,6124,8,9,8,13,58,52,6,35
Portadown,6124,9,9,7,14,36,50,-14,34
Glentoran,6124,10,8,9,13,28,39,-11,33
Ballinamalla,6124,11,8,4,18,28,55,-27,28
Crusaders,6125,1,17,6,7,55,35,20,57
Cliftonville,6125,2,16,5,9,56,39,17,53
Coleraine,6125,3,14,10,6,51,38,13,52
Ballymena,6125,4,15,7,8,64,56,8,52
Linfield,6125,5,12,10,8,60,36,24,46
Dungannon,6125,6,11,7,12,57,52,5,40
Glenavon,6125,7,10,10,10,46,53,-7,40
Glentoran,6125,8,9,7,14,32,40,-8,34
Ards,6125,9,9,3,18,38,59,-21,30
Portadown,6125,10,7,6,17,22,51,-29,27
Ballinamalla,6125,11,7,5,18,29,51,-22,26
Crusaders,6126,1,17,9,4,55,27,28,60
Linfield,6126,2,14,12,4,55,27,28,54
Glenavon,6126,3,14,9,7,53,41,12,51
Ballymena,6126,4,14,9,7,58,52,6,51
Cliftonville,6126,5,13,5,12,46,39,7,44
Dungannon,6126,6,11,9,10,52,42,10,42
Coleraine,6126,7,9,9,12,39,47,-8,36
Ballinamalla,6126,8,9,6,15,37,50,-13,33
Glentoran,6126,9,8,9,13,28,46,-18,33
Ards,6126,10,7,6,17,34,52,-18,27
Portadown,6126,11,5,5,20,21,55,-34,20
Crusaders,6127,1,16,7,7,59,37,22,55
Cliftonville,6127,2,16,5,9,63,42,21,53
Glenavon,6127,3,14,9,7,58,44,14,51
Linfield,6127,4,14,8,8,60,36,24,50
Ballymena,6127,5,15,4,11,61,57,4,49
Dungannon,6127,6,11,9,10,59,45,14,42
Coleraine,6127,7,10,12,8,36,38,-2,42
Ballinamalla,6127,8,10,3,17,32,56,-24,33
Ards,6127,9,9,5,16,43,53,-10,32
Glentoran,6127,10,9,5,16,30,52,-22,32
Portadown,6127,11,6,3,21,20,61,-41,21
Linfield,6128,1,16,7,7,63,30,33,55
Cliftonville,6128,2,16,6,8,55,40,15,54
Ballymena,6128,3,15,7,8,62,55,7,52
Crusaders,6128,4,15,5,10,54,46,8,50
Glenavon,6128,5,10,11,9,48,47,1,41
Coleraine,6128,6,10,11,9,41,41,0,41
Dungannon,6128,7,10,9,11,51,44,7,39
Ards,6128,8,9,7,14,41,47,-6,34
Portadown,6128,9,9,5,16,27,48,-21,32
Ballinamalla,6128,10,8,6,16,31,51,-20,30
Glentoran,6128,11,6,8,16,29,53,-24,26
Linfield,6129,1,17,7,6,64,30,34,58
Crusaders,6129,2,16,9,5,53,32,21,57
Coleraine,6129,3,15,10,5,54,39,15,55
Cliftonville,6129,4,15,7,8,53,41,12,52
Ballymena,6129,5,13,4,13,59,62,-3,43
Glenavon,6129,6,10,11,9,40,49,-9,41
Dungannon,6129,7,10,7,13,50,44,6,37
Glentoran,6129,8,10,6,14,32,49,-17,36
Portadown,6129,9,6,9,15,22,44,-22,27
Ballinamalla,6129,10,7,5,18,31,50,-19,26
Ards,6129,11,6,5,19,38,56,-18,23
Crusaders,6130,1,19,7,4,50,26,24,64
Ballymena,6130,2,15,5,10,61,61,0,50
Linfield,6130,3,14,7,9,52,33,19,49
Coleraine,6130,4,13,7,10,51,40,11,46
Cliftonville,6130,5,12,6,12,48,46,2,42
Glentoran,6130,6,12,5,13,31,38,-7,41
Glenavon,6130,7,9,10,11,47,54,-7,37
Ards,6130,8,10,6,14,37,51,-14,36
Dungannon,6130,9,9,7,14,42,46,-4,34
Ballinamalla,6130,10,10,3,17,36,45,-9,33
Portadown,6130,11,7,7,16,28,43,-15,28
Crusaders,6131,1,18,8,4,59,31,28,62
Cliftonville,6131,2,18,4,8,67,44,23,58
Linfield,6131,3,16,9,5,56,26,30,57
Glenavon,6131,4,12,13,5,47,40,7,49
Coleraine,6131,5,12,11,7,42,35,7,47
Ballymena,6131,6,11,4,15,51,66,-15,37
Dungannon,6131,7,8,12,10,48,45,3,36
Glentoran,6131,8,8,10,12,30,43,-13,34
Portadown,6131,9,9,4,17,23,39,-16,31
Ballinamalla,6131,10,5,6,19,28,55,-27,21
Ards,6131,11,5,5,20,33,60,-27,20
Glenavon,6132,1,15,9,6,57,42,15,54
Crusaders,6132,2,15,8,7,57,37,20,53
Linfield,6132,3,13,10,7,61,35,26,49
Dungannon,6132,4,12,9,9,51,40,11,45
Cliftonville,6132,5,13,6,11,43,43,0,45
Ballymena,6132,6,13,4,13,58,65,-7,43
Coleraine,6132,7,10,9,11,41,42,-1,39
Glentoran,6132,8,8,12,10,27,37,-10,36
Portadown,6132,9,9,8,13,25,37,-12,35
Ards,6132,10,9,7,14,38,45,-7,34
Ballinamalla,6132,11,5,4,21,24,59,-35,19
Crusaders,6133,1,19,7,4,57,27,30,64
Cliftonville,6133,2,16,5,9,48,36,12,53
Linfield,6133,3,13,11,6,57,31,26,50
Ballymena,6133,4,13,6,11,52,53,-1,45
Glenavon,6133,5,11,9,10,42,45,-3,42
Coleraine,6133,6,11,8,11,45,41,4,41
Glentoran,6133,7,9,7,14,37,54,-17,34
Ballinamalla,6133,8,9,5,16,31,50,-19,32
Dungannon,6133,9,7,10,13,42,46,-4,31
Ards,6133,10,7,9,14,29,42,-13,30
Portadown,6133,11,7,9,14,23,38,-15,30
Crusaders,6134,1,19,6,5,62,32,30,63
Cliftonville,6134,2,18,4,8,55,35,20,58
Linfield,6134,3,15,7,8,53,29,24,52
Coleraine,6134,4,13,8,9,42,40,2,47
Ballymena,6134,5,12,7,11,58,58,0,43
Glenavon,6134,6,11,10,9,50,53,-3,43
Ards,6134,7,9,8,13,36,43,-7,35
Dungannon,6134,8,8,10,12,40,45,-5,34
Glentoran,6134,9,8,8,14,28,41,-13,32
Ballinamalla,6134,10,9,3,18,31,51,-20,30
Portadown,6134,11,5,5,20,22,50,-28,20
Crusaders,6135,1,17,7,6,63,34,29,58
Ballymena,6135,2,16,7,7,58,52,6,55
Coleraine,6135,3,13,10,7,43,35,8,49
Linfield,6135,4,12,11,7,59,42,17,47
Cliftonville,6135,5,12,9,9,48,41,7,45
Glenavon,6135,6,11,11,8,43,41,2,44
Dungannon,6135,7,10,9,11,55,43,12,39
Glentoran,6135,8,9,10,11,29,42,-13,37
Portadown,6135,9,7,6,17,31,48,-17,27
Ards,6135,10,7,5,18,40,60,-20,26
Ballinamalla,6135,11,6,5,19,26,57,-31,23
Crusaders,6136,1,18,6,6,55,30,25,60
Coleraine,6136,2,15,8,7,52,33,19,53
Linfield,6136,3,14,10,6,58,30,28,52
Ballymena,6136,4,13,8,9,52,52,0,47
Glenavon,6136,5,11,12,7,48,47,1,45
Cliftonville,6136,6,12,4,14,43,50,-7,40
Ballinamalla,6136,7,10,6,14,33,50,-17,36
Dungannon,6136,8,7,11,12,52,46,6,32
Ards,6136,9,9,5,16,36,57,-21,32
Glentoran,6136,10,7,7,16,38,51,-13,28
Portadown,6136,11,7,7,16,25,46,-21,28
Crusaders,6137,1,17,8,5,55,28,27,59
Cliftonville,6137,2,16,6,8,49,36,13,54
Linfield,6137,3,14,9,7,57,35,22,51
Glenavon,6137,4,12,13,5,46,40,6,49
Ballymena,6137,5,12,8,10,49,58,-9,44
Coleraine,6137,6,9,13,8,37,33,4,40
Ards,6137,7,11,4,15,43,45,-2,37
Dungannon,6137,8,8,11,11,48,41,7,35
Glentoran,6137,9,8,7,15,36,51,-15,31
Ballinamalla,6137,10,7,6,17,33,63,-30,27
Portadown,6137,11,6,5,19,23,46,-23,23
Crusaders,6138,1,17,6,7,57,28,29,57
Linfield,6138,2,15,8,7,66,40,26,53
Cliftonville,6138,3,16,4,10,54,35,19,52
Glenavon,6138,4,11,9,10,51,50,1,42
Coleraine,6138,5,11,9,10,49,50,-1,42
Ballymena,6138,6,12,6,12,54,59,-5,42
Dungannon,6138,7,10,9,11,46,47,-1,39
Glentoran,6138,8,9,12,9,34,39,-5,39
Ballinamalla,6138,9,11,4,15,32,47,-15,37
Portadown,6138,10,9,4,17,26,50,-24,31
Ards,6138,11,6,5,19,32,56,-24,23
Linfield,6139,1,15,8,7,64,34,30,53
Ballymena,6139,2,15,7,8,60,53,7,52
Crusaders,6139,3,13,11,6,53,37,16,50
Cliftonville,6139,4,15,4,11,51,42,9,49
Glenavon,6139,5,12,12,6,56,41,15,48
Dungannon,6139,6,11,11,8,51,42,9,44
Ards,6139,7,12,3,15,38,52,-14,39
Coleraine,6139,8,9,11,10,43,42,1,38
Glentoran,6139,9,7,7,16,32,52,-20,28
Ballinamalla,6139,10,7,7,16,37,60,-23,28
Portadown,6139,11,6,5,19,20,50,-30,23
Linfield,6140,1,18,8,4,64,32,32,62
Crusaders,6140,2,16,11,3,60,29,31,59
Cliftonville,6140,3,15,4,11,45,31,14,49
Ballymena,6140,4,12,8,10,55,62,-7,44
Coleraine,6140,5,11,8,11,43,44,-1,41
Dungannon,6140,6,10,10,10,52,46,6,40
Glenavon,6140,7,9,12,9,42,44,-2,39
Glentoran,6140,8,9,9,12,35,43,-8,36
Ards,6140,9,11,3,16,38,50,-12,36
Ballinamalla,6140,10,8,3,19,33,58,-25,27
Portadown,6140,11,6,4,20,22,50,-28,22
Linfield,6141,1,16,8,6,58,27,31,56
Cliftonville,6141,2,17,5,8,61,32,29,56
Crusaders,6141,3,16,8,6,52,41,11,56
Ballymena,6141,4,14,8,8,59,54,5,50
Coleraine,6141,5,12,9,9,40,31,9,45
Glenavon,6141,6,11,10,9,48,47,1,43
Dungannon,6141,7,9,11,10,52,47,5,38
Ards,6141,8,10,4,16,36,53,-17,34
Glentoran,6141,9,8,7,15,23,45,-22,31
Ballinamalla,6141,10,7,5,18,27,49,-22,26
Portadown,6141,11,5,5,20,21,51,-30,20
Cliftonville,6142,1,15,8,7,59,41,18,53
Glenavon,6142,2,14,10,6,52,41,11,52
Ballymena,6142,3,14,7,9,60,58,2,49
Linfield,6142,4,13,9,8,50,30,20,48
Crusaders,6142,5,13,9,8,44,29,15,48
Dungannon,6142,6,12,10,8,54,43,11,46
Coleraine,6142,7,12,8,10,47,44,3,44
Portadown,6142,8,10,4,16,35,49,-14,34
Glentoran,6142,9,9,7,14,25,43,-18,34
Ards,6142,10,8,6,16,38,53,-15,30
Ballinamalla,6142,11,4,4,22,26,59,-33,16
Linfield,6143,1,16,8,6,58,26,32,56
Crusaders,6143,2,17,5,8,52,33,19,56
Ballymena,6143,3,15,5,10,54,57,-3,50
Glenavon,6143,4,12,10,8,45,38,7,46
Dungannon,6143,5,12,9,9,49,38,11,45
Cliftonville,6143,6,13,5,12,43,35,8,44
Ards,6143,7,11,6,13,35,41,-6,39
Coleraine,6143,8,8,14,8,34,35,-1,38
Ballinamalla,6143,9,11,2,17,35,53,-18,35
Glentoran,6143,10,6,8,16,27,51,-24,26
Portadown,6143,11,4,8,18,25,50,-25,20
Crusaders,6144,1,18,5,7,60,36,24,59
Cliftonville,6144,2,17,5,8,57,41,16,56
Linfield,6144,3,12,12,6,49,26,23,48
Glenavon,6144,4,12,9,9,47,45,2,45
Dungannon,6144,5,10,11,9,44,37,7,41
Ballymena,6144,6,11,8,11,54,60,-6,41
Coleraine,6144,7,10,9,11,45,48,-3,39
Glentoran,6144,8,9,9,12,31,45,-14,36
Ards,6144,9,10,5,15,48,52,-4,35
Portadown,6144,10,7,6,17,26,48,-22,27
Ballinamalla,6144,11,6,7,17,28,51,-23,25
Cliftonville,6145,1,17,4,9,59,46,13,55
Crusaders,6145,2,14,10,6,56,36,20,52
Linfield,6145,3,13,12,5,54,30,24,51
Coleraine,6145,4,12,12,6,50,38,12,48
Ballymena,6145,5,12,8,10,57,60,-3,44
Dungannon,6145,6,11,10,9,48,37,11,43
Glenavon,6145,7,10,12,8,48,45,3,42
Glentoran,6145,8,8,8,14,28,41,-13,32
Ards,6145,9,7,9,14,30,45,-15,30
Ballinamalla,6145,10,7,6,17,24,46,-22,27
Portadown,6145,11,4,9,17,20,50,-30,21
Linfield,6146,1,16,10,4,65,31,34,58
Cliftonville,6146,2,17,4,9,49,37,12,55
Crusaders,6146,3,15,8,7,60,38,22,53
Coleraine,6146,4,12,12,6,49,38,11,48
Glenavon,6146,5,11,12,7,52,48,4,45
Ballymena,6146,6,12,5,13,53,60,-7,41
Glentoran,6146,7,10,7,13,38,48,-10,37
Dungannon,6146,8,8,12,10,47,45,2,36
Ards,6146,9,7,7,16,37,52,-15,28
Portadown,6146,10,6,8,16,26,49,-23,26
Ballinamalla,6146,11,5,7,18,24,54,-30,22
Crusaders,6147,1,16,6,8,57,39,18,54
Cliftonville,6147,2,16,5,9,54,38,16,53
Linfield,6147,3,13,11,6,55,29,26,50
Coleraine,6147,4,13,10,7,46,40,6,49
Ballymena,6147,5,13,8,9,59,54,5,47
Dungannon,6147,6,10,10,10,47,45,2,40
Glenavon,6147,7,9,12,9,42,44,-2,39
Ballinamalla,6147,8,9,8,13,32,49,-17,35
Glentoran,6147,9,8,9,13,33,44,-11,33
Ards,6147,10,7,5,18,32,51,-19,26
Portadown,6147,11,6,6,18,22,46,-24,24
Linfield,6148,1,18,8,4,72,32,40,62
Crusaders,6148,2,15,8,7,51,36,15,53
Dungannon,6148,3,12,11,7,58,42,16,47
Cliftonville,6148,4,14,4,12,55,43,12,46
Glenavon,6148,5,11,10,9,48,46,2,43
Ballymena,6148,6,11,8,11,61,64,-3,41
Coleraine,6148,7,10,9,11,41,49,-8,39
Glentoran,6148,8,8,11,11,32,46,-14,35
Ards,6148,9,6,11,13,34,48,-14,29
Portadown,6148,10,8,5,17,30,55,-25,29
Ballinamalla,6148,11,7,5,18,27,48,-21,26
Crusaders,6149,1,17,10,3,60,33,27,61
Cliftonville,6149,2,17,3,10,54,41,13,54
Linfield,6149,3,15,8,7,60,35,25,53
Ballymena,6149,4,15,7,8,61,55,6,52
Glenavon,6149,5,11,12,7,48,42,6,45
Dungannon,6149,6,11,10,9,44,35,9,43
Coleraine,6149,7,8,12,10,33,34,-1,36
Glentoran,6149,8,7,11,12,25,37,-12,32
Ballinamalla,6149,9,8,4,18,30,52,-22,28
Portadown,6149,10,6,6,18,22,48,-26,24
Ards,6149,11,5,7,18,31,56,-25,22
Cliftonville,6150,1,18,5,7,59,37,22,59
Crusaders,6150,2,15,11,4,56,34,22,56
Linfield,6150,3,14,10,6,64,36,28,52
Ballymena,6150,4,13,7,10,55,58,-3,46
Coleraine,6150,5,9,13,8,45,44,1,40
Glenavon,6150,6,9,13,8,47,53,-6,40
Ards,6150,7,11,7,12,40,46,-6,40
Glentoran,6150,8,11,6,13,35,45,-10,39
Dungannon,6150,9,8,9,13,53,51,2,33
Portadown,6150,10,9,3,18,33,51,-18,30
Ballinamalla,6150,11,3,6,21,25,57,-32,15
Crusaders,6151,1,16,9,5,60,33,27,57
Linfield,6151,2,15,9,6,67,33,34,54
Coleraine,6151,3,12,11,7,43,33,10,47
Cliftonville,6151,4,14,4,12,51,42,9,46
Glenavon,6151,5,11,11,8,43,44,-1,44
Ballymena,6151,6,13,4,13,51,59,-8,43
Dungannon,6151,7,10,8,12,55,42,13,38
Ballinamalla,6151,8,11,2,17,35,52,-17,35
Ards,6151,9,8,9,13,34,49,-15,33
Glentoran,6151,10,7,9,14,24,47,-23,30
Portadown,6151,11,7,6,17,23,52,-29,27
Crusaders,6152,1,17,7,6,59,34,25,58
Ballymena,6152,2,14,7,9,61,57,4,49
Linfield,6152,3,13,9,8,57,36,21,48
Cliftonville,6152,4,12,8,10,49,43,6,44
Glenavon,6152,5,11,11,8,57,52,5,44
Dungannon,6152,6,11,7,12,62,45,17,40
Coleraine,6152,7,9,12,9,41,45,-4,39
Ballinamalla,6152,8,10,5,15,34,55,-21,35
Glentoran,6152,9,7,11,12,24,43,-19,32
Portadown,6152,10,8,7,15,29,47,-18,31
Ards,6152,11,8,6,16,35,51,-16,30
Cliftonville,6153,1,16,7,7,61,42,19,55
Linfield,6153,2,15,8,7,55,28,27,53
Crusaders,6153,3,13,9,8,57,46,11,48
Ballymena,6153,4,11,8,11,48,57,-9,41
Dungannon,6153,5,10,10,10,59,53,6,40
Coleraine,6153,6,10,9,11,33,34,-1,39
Glenavon,6153,7,10,9,11,42,48,-6,39
Ards,6153,8,10,6,14,39,49,-10,36
Ballinamalla,6153,9,11,3,16,35,49,-14,36
Glentoran,6153,10,8,11,11,35,44,-9,35
Portadown,6153,11,9,4,17,28,42,-14,31
Crusaders,6154,1,17,8,5,56,30,26,59
Ballymena,6154,2,16,6,8,63,53,10,54
Linfield,6154,3,14,8,8,55,31,24,50
Cliftonville,6154,4,14,5,11,42,39,3,47
Coleraine,6154,5,12,8,10,39,39,0,44
Glenavon,6154,6,11,8,11,47,48,-1,41
Dungannon,6154,7,10,9,11,54,45,9,39
Portadown,6154,8,11,5,14,29,42,-13,38
Glentoran,6154,9,8,9,13,34,43,-9,33
Ards,6154,10,9,5,16,41,53,-12,32
Ballinamalla,6154,11,6,3,21,26,63,-37,21
Glenavon,6155,1,16,9,5,60,38,22,57
Cliftonville,6155,2,16,4,10,52,47,5,52
Linfield,6155,3,14,9,7,60,35,25,51
Crusaders,6155,4,14,8,8,53,41,12,50
Ballymena,6155,5,14,7,9,59,53,6,49
Coleraine,6155,6,11,11,8,43,36,7,44
Dungannon,6155,7,10,8,12,49,45,4,38
Ballinamalla,6155,8,10,4,16,33,48,-15,34
Glentoran,6155,9,8,8,14,30,49,-19,32
Portadown,6155,10,8,4,18,29,48,-19,28
Ards,6155,11,6,4,20,30,58,-28,22
Cliftonville,6156,1,19,6,5,64,36,28,63
Crusaders,6156,2,17,8,5,58,35,23,59
Linfield,6156,3,15,9,6,59,31,28,54
Glenavon,6156,4,11,13,6,49,44,5,46
Ballymena,6156,5,13,6,11,58,59,-1,45
Dungannon,6156,6,10,10,10,47,39,8,40
Coleraine,6156,7,10,10,10,38,38,0,40
Glentoran,6156,8,6,11,13,25,45,-20,29
Portadown,6156,9,5,11,14,24,44,-20,26
Ards,6156,10,6,5,19,32,57,-25,23
Ballinamalla,6156,11,6,5,19,33,59,-26,23
Linfield,6157,1,15,11,4,60,36,24,56
Crusaders,6157,2,16,4,10,50,37,13,52
Coleraine,6157,3,14,8,8,49,31,18,50
Ballymena,6157,4,14,7,9,54,53,1,49
Dungannon,6157,5,13,7,10,52,43,9,46
Cliftonville,6157,6,13,4,13,50,47,3,43
Glenavon,6157,7,10,11,9,45,50,-5,41
Ballinamalla,6157,8,12,2,16,37,51,-14,38
Portadown,6157,9,9,6,15,23,39,-16,33
Ards,6157,10,7,6,17,41,52,-11,27
Glentoran,6157,11,6,6,18,29,51,-22,24
Linfield,6158,1,17,7,6,62,30,32,58
Crusaders,6158,2,16,8,6,51,35,16,56
Cliftonville,6158,3,17,5,8,51,37,14,56
Ballymena,6158,4,12,8,10,56,57,-1,44
Dungannon,6158,5,10,13,7,53,39,14,43
Glenavon,6158,6,11,9,10,46,42,4,42
Glentoran,6158,7,11,7,12,30,40,-10,40
Coleraine,6158,8,9,9,12,37,38,-1,36
Ards,6158,9,5,11,14,29,45,-16,26
Ballinamalla,6158,10,6,8,16,23,43,-20,26
Portadown,6158,11,5,7,18,19,51,-32,22
Ballymena,6159,1,18,6,6,58,51,7,60
Cliftonville,6159,2,16,5,9,56,37,19,53
Linfield,6159,3,15,7,8,61,37,24,52
Crusaders,6159,4,14,8,8,52,43,9,50
Glenavon,6159,5,10,12,8,41,44,-3,42
Dungannon,6159,6,9,13,8,47,41,6,40
Glentoran,6159,7,10,8,12,36,43,-7,38
Coleraine,6159,8,8,13,9,35,35,0,37
Portadown,6159,9,8,6,16,27,44,-17,30
Ballinamalla,6159,10,8,5,17,32,48,-16,29
Ards,6159,11,5,5,20,33,55,-22,20
Cliftonville,6160,1,17,6,7,61,36,25,57
Ballymena,6160,2,17,3,10,66,58,8,54
Linfield,6160,3,15,8,7,64,35,29,53
Crusaders,6160,4,12,10,8,48,38,10,46
Glentoran,6160,5,13,6,11,36,38,-2,45
Glenavon,6160,6,11,11,8,42,43,-1,44
Coleraine,6160,7,10,9,11,40,45,-5,39
Dungannon,6160,8,9,9,12,48,42,6,36
Portadown,6160,9,8,5,17,30,51,-21,29
Ards,6160,10,8,5,17,33,59,-26,29
Ballinamalla,6160,11,7,4,19,30,53,-23,25
Linfield,6161,1,16,11,3,63,28,35,59
Crusaders,6161,2,16,11,3,54,32,22,59
Cliftonville,6161,3,15,6,9,58,39,19,51
Ballymena,6161,4,14,5,11,56,60,-4,47
Glenavon,6161,5,9,13,8,44,47,-3,40
Coleraine,6161,6,9,12,9,39,37,2,39
Dungannon,6161,7,8,11,11,53,50,3,35
Glentoran,6161,8,8,9,13,34,46,-12,33
Ards,6161,9,9,5,16,40,54,-14,32
Ballinamalla,6161,10,9,4,17,34,53,-19,31
Portadown,6161,11,6,5,19,20,49,-29,23
Crusaders,6162,1,19,9,2,54,27,27,66
Ballymena,6162,2,17,5,8,65,53,12,56
Cliftonville,6162,3,15,6,9,47,35,12,51
Linfield,6162,4,14,8,8,61,40,21,50
Glenavon,6162,5,11,9,10,48,51,-3,42
Coleraine,6162,6,10,10,10,41,44,-3,40
Dungannon,6162,7,8,11,11,54,48,6,35
Ards,6162,8,8,6,16,41,52,-11,30
Portadown,6162,9,8,5,17,28,48,-20,29
Ballinamalla,6162,10,7,7,16,31,52,-21,28
Glentoran,6162,11,7,6,17,28,48,-20,27
Crusaders,6163,1,17,7,6,53,30,23,58
Linfield,6163,2,13,11,6,61,36,25,50
Glenavon,6163,3,14,8,8,53,46,7,50
Ballymena,6163,4,13,9,8,59,55,4,48
Coleraine,6163,5,12,9,9,46,43,3,45
Cliftonville,6163,6,13,4,13,50,45,5,43
Dungannon,6163,7,10,8,12,48,48,0,38
Ards,6163,8,9,7,14,37,45,-8,34
Ballinamalla,6163,9,10,4,16,38,51,-13,34
Glentoran,6163,10,8,7,15,25,44,-19,31
Portadown,6163,11,7,4,19,23,50,-27,25
Crusaders,6164,1,18,8,4,57,31,26,62
Linfield,6164,2,16,9,5,60,28,32,57
Cliftonville,6164,3,16,5,9,52,34,18,53
Coleraine,6164,4,14,7,9,53,41,12,49
Ballymena,6164,5,11,7,12,51,59,-8,40
Ards,6164,6,11,4,15,39,46,-7,37
Glentoran,6164,7,9,8,13,31,43,-12,35
Dungannon,6164,8,8,8,14,43,49,-6,32
Glenavon,6164,9,7,11,12,42,52,-10,32
Ballinamalla,6164,10,9,5,16,29,51,-22,32
Portadown,6164,11,8,4,18,24,47,-23,28
Linfield,6165,1,17,9,4,65,28,37,60
Crusaders,6165,2,17,7,6,61,36,25,58
Ballymena,6165,3,15,7,8,61,54,7,52
Coleraine,6165,4,13,11,6,46,35,11,50
Cliftonville,6165,5,14,4,12,47,41,6,46
Glenavon,6165,6,12,10,8,53,51,2,46
Glentoran,6165,7,7,10,13,27,45,-18,31
Dungannon,6165,8,7,9,14,48,50,-2,30
Ballinamalla,6165,9,7,9,14,28,45,-17,30
Ards,6165,10,8,2,20,32,57,-25,26
Portadown,6165,11,6,6,18,25,51,-26,24
Linfield,6166,1,15,8,7,60,32,28,53
Crusaders,6166,2,14,6,10,48,40,8,48
Cliftonville,6166,3,14,5,11,54,50,4,47
Ballymena,6166,4,13,8,9,58,58,0,47
Dungannon,6166,5,12,8,10,54,41,13,44
Glenavon,6166,6,11,10,9,50,46,4,43
Coleraine,6166,7,10,12,8,45,44,1,42
Glentoran,6166,8,10,6,14,35,50,-15,36
Ballinamalla,6166,9,10,4,16,33,46,-13,34
Portadown,6166,10,8,9,13,25,38,-13,33
Ards,6166,11,8,4,18,38,55,-17,28
Crusaders,6167,1,17,6,7,53,32,21,57
Linfield,6167,2,14,10,6,58,30,28,52
Cliftonville,6167,3,16,4,10,52,42,10,52
Coleraine,6167,4,13,7,10,44,41,3,46
Glenavon,6167,5,11,12,7,54,44,10,45
Dungannon,6167,6,12,8,10,56,47,9,44
Ballymena,6167,7,11,8,11,51,55,-4,41
Glentoran,6167,8,8,9,13,32,45,-13,33
Ards,6167,9,9,5,16,36,50,-14,32
Ballinamalla,6167,10,7,6,17,33,59,-26,27
Portadown,6167,11,6,7,17,29,53,-24,25
Crusaders,6168,1,14,10,6,59,42,17,52
Linfield,6168,2,13,10,7,56,34,22,49
Cliftonville,6168,3,14,6,10,53,42,11,48
Ballymena,6168,4,13,9,8,56,57,-1,48
Glenavon,6168,5,12,9,9,47,50,-3,45
Coleraine,6168,6,11,11,8,40,32,8,44
Ards,6168,7,13,4,13,43,46,-3,43
Dungannon,6168,8,10,8,12,53,46,7,38
Portadown,6168,9,11,3,16,28,44,-16,36
Glentoran,6168,10,8,8,14,27,43,-16,32
Ballinamalla,6168,11,6,2,22,26,52,-26,20
Cliftonville,6169,1,16,8,6,55,33,22,56
Crusaders,6169,2,16,8,6,49,30,19,56
Linfield,6169,3,14,9,7,54,31,23,51
Ballymena,6169,4,15,5,10,59,50,9,50
Glenavon,6169,5,13,10,7,45,36,9,49
Coleraine,6169,6,10,11,9,47,41,6,41
Dungannon,6169,7,9,10,11,56,50,6,37
Portadown,6169,8,10,5,15,29,50,-21,35
Glentoran,6169,9,9,7,14,28,48,-20,34
Ards,6169,10,8,5,17,39,56,-17,29
Ballinamalla,6169,11,4,4,22,24,60,-36,16
Linfield,6170,1,17,8,5,68,31,37,59
Cliftonville,6170,2,16,7,7,62,42,20,55
Crusaders,6170,3,15,10,5,49,29,20,55
Glenavon,6170,4,12,8,10,46,44,2,44
Dungannon,6170,5,9,11,10,48,41,7,38
Ballymena,6170,6,11,5,14,53,73,-20,38
Coleraine,6170,7,9,10,11,38,41,-3,37
Ards,6170,8,11,4,15,37,41,-4,37
Glentoran,6170,9,8,7,15,29,45,-16,31
Ballinamalla,6170,10,9,4,17,26,48,-22,31
Portadown,6170,11,8,6,16,26,47,-21,30
Crusaders,6171,1,20,7,3,65,33,32,67
Linfield,6171,2,15,9,6,63,32,31,54
Cliftonville,6171,3,15,7,8,53,36,17,52
Coleraine,6171,4,13,8,9,41,35,6,47
Ballymena,6171,5,12,6,12,56,58,-2,42
Glentoran,6171,6,11,6,13,38,57,-19,39
Glenavon,6171,7,9,10,11,44,47,-3,37
Dungannon,6171,8,8,11,11,48,44,4,35
Ards,6171,9,9,5,16,41,52,-11,32
Portadown,6171,10,8,4,18,25,49,-24,28
Ballinamalla,6171,11,7,3,20,26,57,-31,24
Crusaders,6172,1,19,6,5,60,34,26,63
Linfield,6172,2,15,9,6,55,30,25,54
Glenavon,6172,3,14,7,9,53,42,11,49
Coleraine,6172,4,13,8,9,51,40,11,47
Cliftonville,6172,5,13,5,12,48,42,6,44
Ballymena,6172,6,13,5,12,59,62,-3,44
Glentoran,6172,7,10,10,10,32,40,-8,40
Ballinamalla,6172,8,12,2,16,42,55,-13,38
Ards,6172,9,10,4,16,40,51,-11,34
Dungannon,6172,10,7,10,13,43,49,-6,31
Portadown,6172,11,4,4,22,21,59,-38,16
Crusaders,6173,1,19,5,6,61,37,24,62
Linfield,6173,2,13,11,6,56,32,24,50
Dungannon,6173,3,14,8,8,58,41,17,50
Cliftonville,6173,4,15,5,10,51,36,15,50
Ballymena,6173,5,13,6,11,51,56,-5,45
Coleraine,6173,6,11,11,8,38,36,2,44
Glenavon,6173,7,10,11,9,51,48,3,41
Ards,6173,8,9,5,16,34,44,-10,32
Portadown,6173,9,8,5,17,26,44,-18,29
Glentoran,6173,10,6,9,15,28,50,-22,27
Ballinamalla,6173,11,7,4,19,29,59,-30,25
Crusaders,6174,1,16,8,6,55,34,21,56
Linfield,6174,2,14,9,7,64,32,32,51
Coleraine,6174,3,13,11,6,44,34,10,50
Ballymena,6174,4,14,6,10,63,56,7,48
Cliftonville,6174,5,14,5,11,47,43,4,47
Dungannon,6174,6,11,8,11,56,44,12,41
Glenavon,6174,7,10,10,10,44,46,-2,40
Glentoran,6174,8,10,8,12,30,44,-14,38
Ballinamalla,6174,9,10,5,15,31,50,-19,35
Portadown,6174,10,8,5,17,22,45,-23,29
Ards,6174,11,6,3,21,34,62,-28,21
Crusaders,6175,1,16,11,3,61,38,23,59
Linfield,6175,2,16,8,6,60,33,27,56
Cliftonville,6175,3,15,6,9,50,36,14,51
Coleraine,6175,4,14,8,8,45,34,11,50
Ballymena,6175,5,13,7,10,57,55,2,46
Dungannon,6175,6,11,9,10,58,46,12,42
Glentoran,6175,7,9,9,12,36,41,-5,36
Glenavon,6175,8,8,11,11,43,53,-10,35
Ards,6175,9,10,4,16,41,52,-11,34
Portadown,6175,10,8,4,18,19,42,-23,28
Ballinamalla,6175,11,4,5,21,26,66,-40,17
Crusaders,6176,1,13,11,6,51,37,14,50
Coleraine,6176,2,14,8,8,51,41,10,50
Cliftonville,6176,3,13,7,10,52,42,10,46
Ballymena,6176,4,13,7,10,52,60,-8,46
Glenavon,6176,5,11,12,7,48,41,7,45
Linfield,6176,6,10,12,8,52,37,15,42
Dungannon,6176,7,10,10,10,51,46,5,40
Glentoran,6176,8,9,10,11,36,42,-6,37
Ards,6176,9,9,5,16,38,47,-9,32
Portadown,6176,10,8,7,15,37,53,-16,31
Ballinamalla,6176,11,8,5,17,30,52,-22,29
Crusaders,6177,1,16,11,3,53,26,27,59
Ballymena,6177,2,17,8,5,58,43,15,59
Linfield,6177,3,14,11,5,59,32,27,53
Cliftonville,6177,4,14,8,8,44,33,11,50
Glenavon,6177,5,12,11,7,47,38,9,47
Coleraine,6177,6,10,9,11,38,41,-3,39
Dungannon,6177,7,6,12,12,47,53,-6,30
Ballinamalla,6177,8,8,5,17,28,50,-22,29
Glentoran,6177,9,6,9,15,23,46,-23,27
Ards,6177,10,5,11,14,34,48,-14,26
Portadown,6177,11,7,5,18,23,44,-21,26
Ballymena,6178,1,19,3,8,66,48,18,60
Crusaders,6178,2,16,9,5,58,38,20,57
Cliftonville,6178,3,16,4,10,55,37,18,52
Linfield,6178,4,13,9,8,55,37,18,48
Glenavon,6178,5,11,12,7,52,41,11,45
Ballinamalla,6178,6,13,2,15,34,44,-10,41
Coleraine,6178,7,9,11,10,43,45,-2,38
Portadown,6178,8,8,8,14,28,43,-15,32
Glentoran,6178,9,8,6,16,25,47,-22,30
Dungannon,6178,10,6,10,14,47,58,-11,28
Ards,6178,11,6,6,18,30,55,-25,24
Crusaders,6179,1,16,9,5,59,39,20,57
Glenavon,6179,2,14,12,4,49,37,12,54
Ballymena,6179,3,15,6,9,54,58,-4,51
Linfield,6179,4,12,12,6,56,32,24,48
Cliftonville,6179,5,13,6,11,53,42,11,45
Coleraine,6179,6,12,9,9,43,32,11,45
Dungannon,6179,7,9,12,9,50,44,6,39
Ards,6179,8,10,4,16,38,50,-12,34
Portadown,6179,9,9,7,14,23,38,-15,34
Glentoran,6179,10,5,7,18,26,51,-25,22
Ballinamalla,6179,11,5,6,19,27,55,-28,21
Crusaders,6180,1,14,12,4,52,32,20,54
Cliftonville,6180,2,16,5,9,50,35,15,53
Linfield,6180,3,15,7,8,55,32,23,52
Dungannon,6180,4,11,11,8,51,37,14,44
Glenavon,6180,5,11,10,9,50,48,2,43
Ballymena,6180,6,12,7,11,57,63,-6,43
Coleraine,6180,7,8,14,8,36,35,1,38
Glentoran,6180,8,9,9,12,29,42,-13,36
Ards,6180,9,9,6,15,37,51,-14,33
Portadown,6180,10,7,8,15,30,44,-14,29
Ballinamalla,6180,11,7,3,20,29,57,-28,24
Linfield,6181,1,15,8,7,57,34,23,53
Crusaders,6181,2,14,10,6,52,36,16,52
Ballymena,6181,3,15,5,10,57,60,-3,50
Glenavon,6181,4,13,10,7,55,46,9,49
Coleraine,6181,5,11,10,9,36,32,4,43
Ards,6181,6,11,6,13,38,44,-6,39
Dungannon,6181,7,9,11,10,55,45,10,38
Cliftonville,6181,8,11,5,14,42,45,-3,38
Glentoran,6181,9,9,9,12,31,39,-8,36
Portadown,6181,10,8,6,16,30,48,-18,30
Ballinamalla,6181,11,7,4,19,34,58,-24,25
Cliftonville,6182,1,17,6,7,58,36,22,57
Crusaders,6182,2,16,5,9,51,33,18,53
Ballymena,6182,3,16,5,9,60,54,6,53
Glenavon,6182,4,14,9,7,51,36,15,51
Linfield,6182,5,11,13,6,48,31,17,46
Coleraine,6182,6,11,8,11,42,40,2,41
Ards,6182,7,10,6,14,39,46,-7,36
Glentoran,6182,8,8,10,12,28,46,-18,34
Ballinamalla,6182,9,9,3,18,31,52,-21,30
Dungannon,6182,10,7,8,15,45,52,-7,29
Portadown,6182,11,8,3,19,26,53,-27,27
Crusaders,6183,1,17,4,9,58,35,23,55
Linfield,6183,2,15,6,9,52,32,20,51
Cliftonville,6183,3,15,5,10,49,45,4,50
Glenavon,6183,4,12,11,7,52,48,4,47
Coleraine,6183,5,11,10,9,42,45,-3,43
Dungannon,6183,6,10,10,10,50,41,9,40
Ballymena,6183,7,10,8,12,50,54,-4,38
Ards,6183,8,11,4,15,42,45,-3,37
Portadown,6183,9,10,5,15,29,41,-12,35
Ballinamalla,6183,10,10,5,15,38,51,-13,35
Glentoran,6183,11,7,6,17,24,49,-25,27
Crusaders,6184,1,17,7,6,63,36,27,58
Linfield,6184,2,14,8,8,57,34,23,50
Coleraine,6184,3,13,10,7,54,36,18,49
Ballymena,6184,4,14,7,9,56,50,6,49
Cliftonville,6184,5,15,4,11,49,44,5,49
Glenavon,6184,6,10,13,7,50,50,0,43
Ballinamalla,6184,7,12,5,13,37,47,-10,41
Dungannon,6184,8,10,10,10,53,48,5,40
Glentoran,6184,9,6,9,15,28,47,-19,27
Portadown,6184,10,7,4,19,19,45,-26,25
Ards,6184,11,6,5,19,30,59,-29,23
Crusaders,6185,1,18,7,5,54,29,25,61
Glenavon,6185,2,16,7,7,47,40,7,55
Linfield,6185,3,15,9,6,52,30,22,54
Cliftonville,6185,4,14,7,9,60,35,25,49
Dungannon,6185,5,11,9,10,50,40,10,42
Ballymena,6185,6,12,6,12,50,58,-8,42
Ards,6185,7,9,8,13,34,39,-5,35
Coleraine,6185,8,7,12,11,36,42,-6,33
Glentoran,6185,9,8,6,16,23,47,-24,30
Ballinamalla,6185,10,7,7,16,25,44,-19,28
Portadown,6185,11,6,6,18,23,50,-27,24
Crusaders,6186,1,17,8,5,61,33,28,59
Cliftonville,6186,2,16,5,9,52,35,17,53
Ballymena,6186,3,16,5,9,67,58,9,53
Coleraine,6186,4,13,11,6,41,31,10,50
Linfield,6186,5,13,10,7,58,37,21,49
Glenavon,6186,6,11,11,8,45,44,1,44
Ballinamalla,6186,7,10,5,15,30,43,-13,35
Portadown,6186,8,8,5,17,23,47,-24,29
Dungannon,6186,9,6,10,14,42,50,-8,28
Ards,6186,10,7,7,16,36,55,-19,28
Glentoran,6186,11,6,7,17,25,47,-22,25
Crusaders,6187,1,20,6,4,60,29,31,66
Linfield,6187,2,14,12,4,65,37,28,54
Ballymena,6187,3,14,7,9,57,61,-4,49
Dungannon,6187,4,13,7,10,55,51,4,46
Cliftonville,6187,5,12,7,11,51,50,1,43
Coleraine,6187,6,10,10,10,41,37,4,40
Glenavon,6187,7,9,9,12,51,53,-2,36
Glentoran,6187,8,7,12,11,34,41,-7,33
Portadown,6187,9,7,9,14,28,41,-13,30
Ballinamalla,6187,10,7,6,17,30,50,-20,27
Ards,6187,11,7,5,18,37,59,-22,26
Linfield,6188,1,17,8,5,58,27,31,59
Crusaders,6188,2,14,8,8,51,43,8,50
Ballymena,6188,3,15,5,10,56,55,1,50
Cliftonville,6188,4,15,3,12,54,46,8,48
Glenavon,6188,5,11,11,8,41,38,3,44
Coleraine,6188,6,10,13,7,40,35,5,43
Dungannon,6188,7,10,9,11,42,40,2,39
Ards,6188,8,10,8,12,42,43,-1,38
Glentoran,6188,9,8,8,14,28,42,-14,32
Portadown,6188,10,7,7,16,27,46,-19,28
Ballinamalla,6188,11,6,4,20,27,51,-24,22
Crusaders,6189,1,17,6,7,54,34,20,57
Cliftonville,6189,2,15,8,7,49,35,14,53
Coleraine,6189,3,12,12,6,46,35,11,48
Dungannon,6189,4,12,8,10,51,41,10,44
Linfield,6189,5,12,7,11,52,37,15,43
Ballymena,6189,6,11,9,10,60,58,2,42
Glenavon,6189,7,10,12,8,44,42,2,42
Glentoran,6189,8,10,7,13,32,46,-14,37
Portadown,6189,9,9,5,16,33,48,-15,32
Ballinamalla,6189,10,8,5,17,26,48,-22,29
Ards,6189,11,7,5,18,33,56,-23,26
Crusaders,6190,1,17,9,4,55,32,23,60
Linfield,6190,2,13,10,7,53,30,23,49
Cliftonville,6190,3,14,6,10,53,38,15,48
Coleraine,6190,4,12,10,8,46,35,11,46
Glenavon,6190,5,11,10,9,44,43,1,43
Dungannon,6190,6,10,9,11,48,44,4,39
Ballymena,6190,7,11,6,13,50,60,-10,39
Glentoran,6190,8,10,9,11,36,46,-10,39
Ards,6190,9,7,9,14,36,49,-13,30
Portadown,6190,10,8,6,16,26,41,-15,30
Ballinamalla,6190,11,8,4,18,25,54,-29,28
Crusaders,6191,1,15,9,6,58,38,20,54
Cliftonville,6191,2,16,5,9,47,32,15,53
Ballymena,6191,3,16,5,9,62,56,6,53
Linfield,6191,4,14,8,8,52,32,20,50
Dungannon,6191,5,10,10,10,50,44,6,40
Coleraine,6191,6,8,13,9,39,39,0,37
Glenavon,6191,7,9,10,11,44,52,-8,37
Ards,6191,8,10,6,14,40,47,-7,36
Portadown,6191,9,10,4,16,27,39,-12,34
Glentoran,6191,10,8,9,13,32,43,-11,33
Ballinamalla,6191,11,8,3,19,27,56,-29,27
Linfield,6192,1,15,9,6,61,31,30,54
Crusaders,6192,2,15,9,6,50,33,17,54
Cliftonville,6192,3,15,6,9,53,39,14,51
Glenavon,6192,4,13,11,6,54,42,12,50
Dungannon,6192,5,12,9,9,55,41,14,45
Ballymena,6192,6,11,8,11,59,63,-4,41
Coleraine,6192,7,9,13,8,35,36,-1,40
Glentoran,6192,8,10,8,12,31,42,-11,38
Ards,6192,9,7,7,16,30,50,-20,28
Portadown,6192,10,7,5,18,37,58,-21,26
Ballinamalla,6192,11,5,7,18,22,52,-30,22
Crusaders,6193,1,18,5,7,55,34,21,59
Ballymena,6193,2,15,6,9,56,52,4,51
Linfield,6193,3,14,8,8,58,40,18,50
Cliftonville,6193,4,15,4,11,46,38,8,49
Dungannon,6193,5,13,6,11,56,44,12,45
Glentoran,6193,6,12,7,11,42,40,2,43
Ards,6193,7,10,5,15,38,48,-10,35
Coleraine,6193,8,7,13,10,29,37,-8,34
Glenavon,6193,9,7,11,12,39,42,-3,32
Portadown,6193,10,9,5,16,24,47,-23,32
Ballinamalla,6193,11,7,6,17,25,46,-21,27
Crusaders,6194,1,18,5,7,58,35,23,59
Linfield,6194,2,14,11,5,65,34,31,53
Ballymena,6194,3,16,5,9,60,57,3,53
Glenavon,6194,4,12,8,10,50,44,6,44
Dungannon,6194,5,11,7,12,54,51,3,40
Coleraine,6194,6,10,10,10,44,46,-2,40
Cliftonville,6194,7,11,6,13,40,45,-5,39
Glentoran,6194,8,10,6,14,37,48,-11,36
Portadown,6194,9,10,3,17,34,49,-15,33
Ards,6194,10,8,7,15,33,46,-13,31
Ballinamalla,6194,11,9,4,17,31,51,-20,31
Linfield,6195,1,17,8,5,57,26,31,59
Crusaders,6195,2,15,7,8,56,43,13,52
Cliftonville,6195,3,14,5,11,49,41,8,47
Glenavon,6195,4,12,9,9,45,45,0,45
Ballymena,6195,5,13,6,11,53,57,-4,45
Coleraine,6195,6,12,8,10,39,38,1,44
Dungannon,6195,7,11,9,10,53,38,15,42
Portadown,6195,8,9,6,15,26,39,-13,33
Ards,6195,9,9,5,16,33,50,-17,32
Glentoran,6195,10,8,6,16,29,44,-15,30
Ballinamalla,6195,11,7,7,16,32,51,-19,28
Crusaders,6196,1,15,10,5,48,28,20,55
Linfield,6196,2,14,11,5,57,32,25,53
Cliftonville,6196,3,15,6,9,51,40,11,51
Ballymena,6196,4,13,7,10,60,61,-1,46
Coleraine,6196,5,11,10,9,46,42,4,43
Glenavon,6196,6,10,10,10,43,47,-4,40
Glentoran,6196,7,10,10,10,37,44,-7,40
Dungannon,6196,8,8,12,10,47,44,3,36
Ards,6196,9,9,8,13,40,47,-7,35
Portadown,6196,10,6,8,16,29,46,-17,26
Ballinamalla,6196,11,5,6,19,28,55,-27,21
Crusaders,6197,1,16,7,7,55,36,19,55
Linfield,6197,2,12,13,5,58,35,23,49
Ballymena,6197,3,12,9,9,57,60,-3,45
Cliftonville,6197,4,13,5,12,51,48,3,44
Glenavon,6197,5,11,10,9,46,40,6,43
Dungannon,6197,6,11,9,10,51,43,8,42
Ballinamalla,6197,7,13,3,14,36,44,-8,42
Coleraine,6197,8,9,12,9,42,39,3,39
Glentoran,6197,9,9,8,13,36,49,-13,35
Ards,6197,10,8,7,15,37,50,-13,31
Portadown,6197,11,7,5,18,26,51,-25,26
Cliftonville,6198,1,19,4,7,60,34,26,61
Crusaders,6198,2,15,8,7,55,39,16,53
Linfield,6198,3,14,8,8,58,31,27,50
Coleraine,6198,4,12,11,7,46,38,8,47
Dungannon,6198,5,11,8,11,44,40,4,41
Ballymena,6198,6,12,5,13,50,57,-7,41
Glenavon,6198,7,9,11,10,41,42,-1,38
Ards,6198,8,10,4,16,35,53,-18,34
Portadown,6198,9,10,3,17,30,48,-18,33
Glentoran,6198,10,8,8,14,31,44,-13,32
Ballinamalla,6198,11,7,6,17,29,53,-24,27
Crusaders,6199,1,16,10,4,68,37,31,58
Cliftonville,6199,2,15,5,10,51,39,12,50
Linfield,6199,3,13,10,7,50,27,23,49
Ballymena,6199,4,13,6,11,56,57,-1,45
Coleraine,6199,5,11,11,8,45,40,5,44
Glenavon,6199,6,11,9,10,54,52,2,42
Portadown,6199,7,12,3,15,33,41,-8,39
Dungannon,6199,8,9,8,13,44,48,-4,35
Ards,6199,9,9,7,14,36,47,-11,34
Glentoran,6199,10,8,7,15,31,54,-23,31
Ballinamalla,6199,11,7,6,17,28,54,-26,27
Crusaders,6200,1,18,6,6,56,30,26,60
Linfield,6200,2,14,10,6,54,29,25,52
Cliftonville,6200,3,15,6,9,50,40,10,51
Dungannon,6200,4,13,9,8,60,47,13,48
Ballymena,6200,5,13,9,8,51,51,0,48
Coleraine,6200,6,11,9,10,43,47,-4,42
Glentoran,6200,7,9,7,14,27,41,-14,34
Glenavon,6200,8,7,12,11,48,50,-2,33
Ards,6200,9,8,8,14,41,53,-12,32
Ballinamalla,6200,10,7,6,17,36,54,-18,27
Portadown,6200,11,5,8,17,23,47,-24,23
Linfield,6201,1,18,8,4,65,30,35,62
Crusaders,6201,2,17,7,6,55,31,24,58
Cliftonville,6201,3,16,5,9,51,38,13,53
Coleraine,6201,4,12,9,9,41,37,4,45
Dungannon,6201,5,11,8,11,48,41,7,41
Glenavon,6201,6,9,11,10,41,43,-2,38
Ballymena,6201,7,10,7,13,48,58,-10,37
Ballinamalla,6201,8,9,7,14,30,50,-20,34
Glentoran,6201,9,8,8,14,26,43,-17,32
Ards,6201,10,8,7,15,37,45,-8,31
Portadown,6201,11,4,9,17,19,45,-26,21
Crusaders,6202,1,17,10,3,61,33,28,61
Ballymena,6202,2,15,7,8,61,60,1,52
Linfield,6202,3,14,8,8,59,33,26,50
Cliftonville,6202,4,14,7,9,47,39,8,49
Glenavon,6202,5,11,12,7,50,38,12,45
Coleraine,6202,6,11,11,8,43,35,8,44
Dungannon,6202,7,9,9,12,51,56,-5,36
Ballinamalla,6202,8,10,3,17,34,47,-13,33
Ards,6202,9,9,4,17,38,53,-15,31
Portadown,6202,10,7,6,17,26,47,-21,27
Glentoran,6202,11,6,7,17,22,51,-29,25
Linfield,6203,1,18,8,4,67,28,39,62
Crusaders,6203,2,17,8,5,61,36,25,59
Coleraine,6203,3,14,9,7,47,43,4,51
Cliftonville,6203,4,15,5,10,53,40,13,50
Ballymena,6203,5,14,6,10,55,57,-2,48
Dungannon,6203,6,10,9,11,45,44,1,39
Glenavon,6203,7,8,11,11,45,50,-5,35
Ballinamalla,6203,8,10,4,16,33,48,-15,34
Glentoran,6203,9,7,8,15,27,44,-17,29
Portadown,6203,10,6,7,17,26,44,-18,25
Ards,6203,11,4,9,17,33,58,-25,21
Ballymena,6204,1,16,7,7,65,51,14,55
Crusaders,6204,2,15,9,6,52,37,15,54
Cliftonville,6204,3,16,6,8,52,40,12,54
Glenavon,6204,4,12,11,7,44,39,5,47
Linfield,6204,5,11,10,9,53,32,21,43
Coleraine,6204,6,9,12,9,44,41,3,39
Dungannon,6204,7,8,11,11,40,38,2,35
Portadown,6204,8,9,6,15,30,40,-10,33
Ards,6204,9,9,6,15,33,47,-14,33
Glentoran,6204,10,8,6,16,27,50,-23,30
Ballinamalla,6204,11,8,4,18,27,52,-25,28
Linfield,6205,1,17,9,4,70,27,43,60
Crusaders,6205,2,18,5,7,51,31,20,59
Cliftonville,6205,3,16,4,10,57,40,17,52
Dungannon,6205,4,12,10,8,54,42,12,46
Glenavon,6205,5,11,12,7,53,45,8,45
Coleraine,6205,6,9,12,9,38,37,1,39
Ballymena,6205,7,10,6,14,55,65,-10,36
Glentoran,6205,8,9,8,13,33,54,-21,35
Portadown,6205,9,7,8,15,26,45,-19,29
Ballinamalla,6205,10,8,3,19,33,55,-22,27
Ards,6205,11,7,5,18,31,60,-29,26
Crusaders,6206,1,19,7,4,64,30,34,64
Linfield,6206,2,17,7,6,61,32,29,58
Dungannon,6206,3,12,9,9,44,35,9,45
Ballymena,6206,4,14,3,13,51,62,-11,45
Glenavon,6206,5,11,9,10,46,43,3,42
Portadown,6206,6,13,3,14,35,43,-8,42
Glentoran,6206,7,10,8,12,39,41,-2,38
Coleraine,6206,8,10,8,12,33,39,-6,38
Cliftonville,6206,9,11,4,15,48,51,-3,37
Ards,6206,10,9,5,16,37,52,-15,32
Ballinamalla,6206,11,5,5,20,25,55,-30,20
Crusaders,6207,1,15,8,7,55,35,20,53
Cliftonville,6207,2,16,4,10,49,40,9,52
Linfield,6207,3,13,11,6,60,32,28,50
Ballymena,6207,4,14,8,8,65,68,-3,50
Coleraine,6207,5,13,9,8,47,37,10,48
Glenavon,6207,6,12,9,9,51,46,5,45
Glentoran,6207,7,9,8,13,27,41,-14,35
Dungannon,6207,8,8,9,13,43,46,-3,33
Ards,6207,9,9,6,15,41,48,-7,33
Portadown,6207,10,8,5,17,26,45,-19,29
Ballinamalla,6207,11,6,7,17,26,52,-26,25
Linfield,6208,1,17,7,6,60,28,32,58
Dungannon,6208,2,14,8,8,54,37,17,50
Crusaders,6208,3,13,10,7,51,34,17,49
Cliftonville,6208,4,14,7,9,50,39,11,49
Coleraine,6208,5,11,12,7,40,30,10,45
Ballymena,6208,6,12,8,10,52,57,-5,44
Ballinamalla,6208,7,10,5,15,24,41,-17,35
Glentoran,6208,8,8,9,13,31,46,-15,33
Glenavon,6208,9,7,11,12,38,48,-10,32
Portadown,6208,10,9,5,16,25,38,-13,32
Ards,6208,11,7,4,19,32,59,-27,25
Linfield,6209,1,16,8,6,62,33,29,56
Crusaders,6209,2,16,7,7,52,34,18,55
Glenavon,6209,3,13,10,7,55,43,12,49
Ballymena,6209,4,14,7,9,67,59,8,49
Cliftonville,6209,5,12,7,11,57,44,13,43
Dungannon,6209,6,11,10,9,53,44,9,43
Coleraine,6209,7,11,9,10,41,50,-9,42
Ards,6209,8,10,5,15,33,40,-7,35
Glentoran,6209,9,6,10,14,23,43,-20,28
Portadown,6209,10,7,6,17,31,56,-25,27
Ballinamalla,6209,11,4,11,15,22,50,-28,23
Ballymena,6210,1,17,6,7,60,51,9,57
Linfield,6210,2,15,9,6,59,28,31,54
Cliftonville,6210,3,13,7,10,52,45,7,46
Crusaders,6210,4,13,7,10,46,39,7,46
Glenavon,6210,5,11,11,8,45,46,-1,44
Dungannon,6210,6,10,11,9,53,41,12,41
Coleraine,6210,7,10,11,9,43,41,2,41
Glentoran,6210,8,11,8,11,33,36,-3,41
Ballinamalla,6210,9,8,5,17,29,51,-22,29
Ards,6210,10,8,4,18,35,58,-23,28
Portadown,6210,11,7,5,18,34,53,-19,26
Linfield,6211,1,17,9,4,64,26,38,60
Cliftonville,6211,2,17,5,8,52,37,15,56
Crusaders,6211,3,15,7,8,48,30,18,52
Dungannon,6211,4,13,7,10,53,40,13,46
Glenavon,6211,5,12,10,8,47,43,4,46
Coleraine,6211,6,11,12,7,37,33,4,45
Ballymena,6211,7,10,9,11,48,56,-8,39
Glentoran,6211,8,9,7,14,30,50,-20,34
Ards,6211,9,8,7,15,30,44,-14,31
Ballinamalla,6211,10,8,2,20,31,53,-22,26
Portadown,6211,11,5,5,20,21,49,-28,20
Linfield,6212,1,16,9,5,61,31,30,57
Glenavon,6212,2,15,8,7,54,41,13,53
Glentoran,6212,3,15,6,9,43,40,3,51
Cliftonville,6212,4,15,3,12,50,39,11,48
Coleraine,6212,5,11,12,7,42,34,8,45
Crusaders,6212,6,13,5,12,52,45,7,44
Dungannon,6212,7,9,10,11,47,49,-2,37
Ballymena,6212,8,10,6,14,53,62,-9,36
Portadown,6212,9,9,4,17,22,43,-21,31
Ballinamalla,6212,10,8,5,17,31,57,-26,29
Ards,6212,11,7,6,17,42,56,-14,27
Crusaders,6213,1,16,6,8,55,40,15,54
Ballymena,6213,2,16,6,8,56,49,7,54
Cliftonville,6213,3,15,6,9,51,37,14,51
Linfield,6213,4,13,8,9,53,34,19,47
Coleraine,6213,5,12,10,8,45,42,3,46
Glenavon,6213,6,12,9,9,48,39,9,45
Dungannon,6213,7,8,13,9,44,40,4,37
Ards,6213,8,9,6,15,44,55,-11,33
Portadown,6213,9,8,8,14,28,40,-12,32
Ballinamalla,6213,10,9,4,17,29,50,-21,31
Glentoran,6213,11,6,6,18,25,52,-27,24
Linfield,6214,1,16,8,6,62,30,32,56
Glenavon,6214,2,13,12,5,55,39,16,51
Ballymena,6214,3,15,6,9,69,56,13,51
Coleraine,6214,4,12,13,5,48,35,13,49
Cliftonville,6214,5,15,4,11,48,39,9,49
Crusaders,6214,6,12,10,8,50,41,9,46
Ards,6214,7,8,8,14,35,49,-14,32
Dungannon,6214,8,6,13,11,39,43,-4,31
Ballinamalla,6214,9,8,6,16,33,53,-20,30
Glentoran,6214,10,7,9,14,24,52,-28,30
Portadown,6214,11,5,7,18,17,43,-26,22
Crusaders,6215,1,18,5,7,58,35,23,59
Linfield,6215,2,16,10,4,66,30,36,58
Cliftonville,6215,3,16,6,8,52,40,12,54
Ballymena,6215,4,16,6,8,56,54,2,54
Glenavon,6215,5,8,15,7,40,46,-6,39
Coleraine,6215,6,9,10,11,46,46,0,37
Glentoran,6215,7,9,9,12,30,40,-10,36
Dungannon,6215,8,8,10,12,45,43,2,34
Ards,6215,9,9,5,16,40,53,-13,32
Portadown,6215,10,6,7,17,23,44,-21,25
Ballinamalla,6215,11,6,5,19,26,51,-25,23
Linfield,6216,1,18,8,4,62,27,35,62
Dungannon,6216,2,15,6,9,56,37,19,51
Crusaders,6216,3,15,6,9,52,41,11,51
Cliftonville,6216,4,15,5,10,54,38,16,50
Ballymena,6216,5,15,5,10,59,57,2,50
Glenavon,6216,6,9,13,8,44,45,-1,40
Glentoran,6216,7,11,7,12,30,41,-11,40
Coleraine,6216,8,9,10,11,40,50,-10,37
Ballinamalla,6216,9,8,6,16,34,52,-18,30
Ards,6216,10,6,5,19,33,53,-20,23
Portadown,6216,11,6,5,19,32,55,-23,23
Crusaders,6217,1,20,4,6,66,33,33,64
Cliftonville,6217,2,16,5,9,53,40,13,53
Ballymena,6217,3,15,6,9,54,54,0,51
Linfield,6217,4,14,8,8,60,30,30,50
Dungannon,6217,5,13,8,9,52,40,12,47
Glenavon,6217,6,11,10,9,50,45,5,43
Coleraine,6217,7,8,10,12,34,43,-9,34
Portadown,6217,8,9,6,15,27,45,-18,33
Glentoran,6217,9,7,10,13,26,45,-19,31
Ards,6217,10,8,5,17,36,53,-17,29
Ballinamalla,6217,11,7,2,21,24,54,-30,23
Crusaders,6218,1,17,8,5,61,29,32,59
Ballymena,6218,2,16,7,7,59,51,8,55
Linfield,6218,3,15,8,7,58,32,26,53
Cliftonville,6218,4,12,7,11,50,50,0,43
Glenavon,6218,5,10,10,10,40,40,0,40
Coleraine,6218,6,10,10,10,43,44,-1,40
Dungannon,6218,7,8,13,9,51,48,3,37
Ballinamalla,6218,8,9,9,12,35,44,-9,36
Glentoran,6218,9,8,9,13,28,44,-16,33
Ards,6218,10,7,9,14,32,47,-15,30
Portadown,6218,11,4,8,18,24,52,-28,20
Crusaders,6219,1,18,6,6,59,31,28,60
Linfield,6219,2,12,12,6,55,29,26,48
Cliftonville,6219,3,14,6,10,49,38,11,48
Ballymena,6219,4,13,8,9,57,62,-5,47
Coleraine,6219,5,10,13,7,41,38,3,43
Glenavon,6219,6,9,14,7,42,42,0,41
Glentoran,6219,7,11,8,11,37,39,-2,41
Dungannon,6219,8,10,7,13,44,43,1,37
Ards,6219,9,8,6,16,30,48,-18,30
Portadown,6219,10,7,6,17,27,45,-18,27
Ballinamalla,6219,11,7,6,17,30,56,-26,27
Crusaders,6220,1,17,6,7,62,33,29,57
Ballymena,6220,2,15,6,9,62,61,1,51
Cliftonville,6220,3,15,5,10,55,39,16,50
Linfield,6220,4,13,10,7,62,37,25,49
Ballinamalla,6220,5,14,3,13,35,45,-10,45
Coleraine,6220,6,10,10,10,41,50,-9,40
Glenavon,6220,7,10,8,12,51,50,1,38
Dungannon,6220,8,9,9,12,50,48,2,36
Ards,6220,9,10,5,15,38,49,-11,35
Glentoran,6220,10,8,8,14,32,50,-18,32
Portadown,6220,11,7,4,19,20,46,-26,25
Coleraine,6221,1,15,10,5,46,31,15,55
Crusaders,6221,2,15,8,7,52,33,19,53
Glenavon,6221,3,12,10,8,45,45,0,46
Ards,6221,4,13,5,12,48,44,4,44
Cliftonville,6221,5,12,7,11,45,45,0,43
Glentoran,6221,6,11,8,11,36,39,-3,41
Linfield,6221,7,10,9,11,55,43,12,39
Ballymena,6221,8,11,6,13,55,61,-6,39
Dungannon,6221,9,9,9,12,46,46,0,36
Ballinamalla,6221,10,10,3,17,35,49,-14,33
Portadown,6221,11,6,7,17,26,53,-27,25
Crusaders,6222,1,19,5,6,59,34,25,62
Linfield,6222,2,15,10,5,69,35,34,55
Cliftonville,6222,3,16,5,9,59,44,15,53
Glenavon,6222,4,13,9,8,53,47,6,48
Coleraine,6222,5,11,12,7,43,44,-1,45
Dungannon,6222,6,12,7,11,51,45,6,43
Ballymena,6222,7,12,5,13,62,66,-4,41
Glentoran,6222,8,8,8,14,30,46,-16,32
Portadown,6222,9,8,5,17,26,45,-19,29
Ards,6222,10,8,4,18,39,56,-17,28
Ballinamalla,6222,11,5,6,19,28,57,-29,21
Cliftonville,6223,1,18,3,9,57,39,18,57
Linfield,6223,2,16,8,6,61,36,25,56
Ballymena,6223,3,17,5,8,59,55,4,56
Crusaders,6223,4,14,7,9,57,46,11,49
Dungannon,6223,5,13,8,9,57,38,19,47
Glenavon,6223,6,12,9,9,51,46,5,45
Coleraine,6223,7,10,7,13,43,52,-9,37
Glentoran,6223,8,9,9,12,36,44,-8,36
Ballinamalla,6223,9,9,1,20,34,58,-24,28
Ards,6223,10,8,3,19,36,54,-18,27
Portadown,6223,11,6,6,18,24,47,-23,24
Crusaders,6224,1,18,6,6,54,28,26,60
Cliftonville,6224,2,16,7,7,55,36,19,55
Linfield,6224,3,14,8,8,52,31,21,50
Glenavon,6224,4,12,12,6,47,37,10,48
Coleraine,6224,5,13,9,8,46,39,7,48
Ballymena,6224,6,12,8,10,51,57,-6,44
Dungannon,6224,7,9,11,10,52,50,2,38
Ards,6224,8,9,6,15,34,45,-11,33
Glentoran,6224,9,8,8,14,28,43,-15,32
Portadown,6224,10,5,7,18,21,46,-25,22
Ballinamalla,6224,11,5,6,19,21,49,-28,21
Linfield,6225,1,16,8,6,58,28,30,56
Crusaders,6225,2,16,7,7,49,30,19,55
Dungannon,6225,3,14,7,9,51,35,16,49
Glenavon,6225,4,13,9,8,52,42,10,48
Ballymena,6225,5,14,5,11,50,55,-5,47
Coleraine,6225,6,11,12,7,48,38,10,45
Ards,6225,7,12,4,14,41,46,-5,40
Cliftonville,6225,8,10,7,13,45,43,2,37
Glentoran,6225,9,9,6,15,28,45,-17,33
Portadown,6225,10,7,4,19,17,51,-34,25
Ballinamalla,6225,11,7,3,20,29,55,-26,24
Crusaders,6226,1,18,5,7,64,37,27,59
Linfield,6226,2,15,8,7,52,31,21,53
Cliftonville,6226,3,15,6,9,59,38,21,51
Ballymena,6226,4,14,7,9,55,57,-2,49
Coleraine,6226,5,12,9,9,42,42,0,45
Glenavon,6226,6,9,10,11,43,50,-7,37
Glentoran,6226,7,10,6,14,35,45,-10,36
Dungannon,6226,8,8,11,11,46,46,0,35
Ards,6226,9,8,7,15,36,44,-8,31
Ballinamalla,6226,10,9,3,18,29,54,-25,30
Portadown,6226,11,7,8,15,21,38,-17,29
Crusaders,6227,1,18,6,6,55,37,18,60
Cliftonville,6227,2,18,3,9,58,33,25,57
Coleraine,6227,3,13,9,8,46,37,9,48
Ballymena,6227,4,13,7,10,58,67,-9,46
Linfield,6227,5,12,8,10,62,44,18,44
Dungannon,6227,6,12,7,11,46,39,7,43
Glenavon,6227,7,11,8,11,41,41,0,41
Ards,6227,8,12,3,15,45,47,-2,39
Glentoran,6227,9,10,6,14,37,48,-11,36
Ballinamalla,6227,10,8,2,20,22,46,-24,26
Portadown,6227,11,7,3,20,22,53,-31,24
Crusaders,6228,1,18,8,4,57,31,26,62
Glenavon,6228,2,13,11,6,46,38,8,50
Ballymena,6228,3,14,7,9,60,56,4,49
Cliftonville,6228,4,14,4,12,48,42,6,46
Linfield,6228,5,11,11,8,52,35,17,44
Coleraine,6228,6,9,13,8,37,35,2,40
Dungannon,6228,7,10,9,11,51,42,9,39
Glentoran,6228,8,9,8,13,33,45,-12,35
Portadown,6228,9,8,5,17,24,43,-19,29
Ballinamalla,6228,10,8,5,17,29,53,-24,29
Ards,6228,11,7,7,16,31,48,-17,28
Crusaders,6229,1,15,10,5,53,31,22,55
Cliftonville,6229,2,16,6,8,52,36,16,54
Linfield,6229,3,14,9,7,66,42,24,51
Ballymena,6229,4,14,7,9,57,59,-2,49
Glenavon,6229,5,11,13,6,44,37,7,46
Coleraine,6229,6,9,12,9,40,38,2,39
Ards,6229,7,11,3,16,38,50,-12,36
Dungannon,6229,8,8,10,12,44,43,1,34
Glentoran,6229,9,8,10,12,31,43,-12,34
Portadown,6229,10,7,5,18,21,44,-23,26
Ballinamalla,6229,11,6,7,17,23,46,-23,25
Linfield,6230,1,14,10,6,59,28,31,52
Crusaders,6230,2,15,6,9,50,44,6,51
Cliftonville,6230,3,15,5,10,56,44,12,50
Ballymena,6230,4,15,5,10,56,56,0,50
Dungannon,6230,5,12,9,9,60,41,19,45
Coleraine,6230,6,11,9,10,41,39,2,42
Glenavon,6230,7,9,11,10,42,47,-5,38
Portadown,6230,8,10,4,16,31,45,-14,34
Ballinamalla,6230,9,9,5,16,26,46,-20,32
Ards,6230,10,9,4,17,35,46,-11,31
Glentoran,6230,11,7,10,13,25,45,-20,31
Crusaders,6231,1,16,8,6,51,31,20,56
Ballymena,6231,2,16,5,9,63,55,8,53
Cliftonville,6231,3,15,5,10,49,39,10,50
Linfield,6231,4,13,8,9,55,34,21,47
Glenavon,6231,5,11,11,8,48,43,5,44
Coleraine,6231,6,10,12,8,43,42,1,42
Dungannon,6231,7,11,8,11,57,50,7,41
Ards,6231,8,9,6,15,42,52,-10,33
Glentoran,6231,9,8,9,13,31,45,-14,33
Portadown,6231,10,7,8,15,24,44,-20,29
Ballinamalla,6231,11,6,6,18,23,51,-28,24
Crusaders,6232,1,17,6,7,56,37,19,57
Glenavon,6232,2,16,8,6,49,37,12,56
Linfield,6232,3,15,8,7,63,31,32,53
Cliftonville,6232,4,16,5,9,53,33,20,53
Coleraine,6232,5,13,10,7,43,35,8,49
Ballymena,6232,6,12,6,12,57,64,-7,42
Glentoran,6232,7,9,6,15,32,44,-12,33
Portadown,6232,8,10,3,17,26,46,-20,33
Dungannon,6232,9,8,8,14,45,52,-7,32
Ards,6232,10,9,5,16,35,53,-18,32
Ballinamalla,6232,11,5,5,20,25,52,-27,20
Linfield,6233,1,16,9,5,66,31,35,57
Crusaders,6233,2,16,7,7,54,38,16,55
Coleraine,6233,3,13,12,5,49,36,13,51
Cliftonville,6233,4,13,6,11,51,43,8,45
Ballymena,6233,5,13,6,11,56,57,-1,45
Dungannon,6233,6,11,9,10,51,40,11,42
Glenavon,6233,7,9,12,9,44,52,-8,39
Glentoran,6233,8,8,9,13,31,45,-14,33
Portadown,6233,9,9,5,16,24,50,-26,32
Ballinamalla,6233,10,9,2,19,27,47,-20,29
Ards,6233,11,8,3,19,38,52,-14,27
Crusaders,6234,1,17,8,5,58,39,19,59
Linfield,6234,2,17,7,6,58,27,31,58
Cliftonville,6234,3,15,6,9,53,35,18,51
Coleraine,6234,4,13,9,8,45,46,-1,48
Dungannon,6234,5,12,9,9,62,44,18,45
Ballymena,6234,6,12,9,9,49,54,-5,45
Glenavon,6234,7,9,11,10,49,47,2,38
Ards,6234,8,11,4,15,36,42,-6,37
Portadown,6234,9,9,4,17,26,45,-19,31
Ballinamalla,6234,10,6,5,19,22,53,-31,23
Glentoran,6234,11,5,6,19,20,46,-26,21
Crusaders,6235,1,16,8,6,59,36,23,56
Linfield,6235,2,15,10,5,63,30,33,55
Cliftonville,6235,3,14,7,9,53,38,15,49
Coleraine,6235,4,11,12,7,49,39,10,45
Ballymena,6235,5,12,7,11,51,59,-8,43
Glentoran,6235,6,12,5,13,35,47,-12,41
Glenavon,6235,7,9,10,11,44,51,-7,37
Dungannon,6235,8,9,9,12,53,55,-2,36
Ballinamalla,6235,9,8,7,15,37,50,-13,31
Ards,6235,10,8,7,15,36,50,-14,31
Portadown,6235,11,7,6,17,21,46,-25,27
Crusaders,6236,1,16,7,7,59,43,16,55
Cliftonville,6236,2,17,3,10,57,38,19,54
Linfield,6236,3,13,13,4,59,30,29,52
Ballymena,6236,4,16,3,11,58,58,0,51
Glenavon,6236,5,13,10,7,49,41,8,49
Glentoran,6236,6,10,7,13,30,42,-12,37
Coleraine,6236,7,8,11,11,38,41,-3,35
Dungannon,6236,8,9,8,13,45,49,-4,35
Ards,6236,9,10,4,16,42,49,-7,34
Portadown,6236,10,9,7,14,30,46,-16,34
Ballinamalla,6236,11,4,7,19,30,60,-30,19
Crusaders,6237,1,15,8,7,55,35,20,53
Linfield,6237,2,15,7,8,60,36,24,52
Dungannon,6237,3,13,10,7,58,38,20,49
Cliftonville,6237,4,14,5,11,55,46,9,47
Glenavon,6237,5,11,11,8,52,43,9,44
Coleraine,6237,6,10,9,11,46,46,0,39
Ballinamalla,6237,7,11,4,15,28,46,-18,37
Ards,6237,8,10,6,14,44,57,-13,36
Ballymena,6237,9,10,6,14,49,67,-18,36
Glentoran,6237,10,9,7,14,41,51,-10,34
Portadown,6237,11,8,5,17,26,49,-23,29
Crusaders,6238,1,15,8,7,57,32,25,53
Glenavon,6238,2,13,13,4,58,40,18,52
Linfield,6238,3,14,8,8,63,39,24,50
Cliftonville,6238,4,15,4,11,51,42,9,49
Coleraine,6238,5,14,7,9,50,45,5,49
Ballymena,6238,6,13,5,12,55,62,-7,44
Dungannon,6238,7,11,7,12,52,45,7,40
Ballinamalla,6238,8,10,6,14,32,49,-17,36
Glentoran,6238,9,9,8,13,33,55,-22,35
Ards,6238,10,7,6,17,37,51,-14,27
Portadown,6238,11,6,4,20,26,54,-28,22
Cliftonville,6239,1,16,6,8,52,34,18,54
Linfield,6239,2,13,13,4,57,32,25,52
Crusaders,6239,3,14,9,7,44,27,17,51
Ballymena,6239,4,14,8,8,59,54,5,50
Coleraine,6239,5,12,11,7,47,40,7,47
Glenavon,6239,6,10,14,6,42,36,6,44
Dungannon,6239,7,8,10,12,45,39,6,34
Portadown,6239,8,9,6,15,29,46,-17,33
Ballinamalla,6239,9,7,6,17,24,49,-25,27
Glentoran,6239,10,6,9,15,33,59,-26,27
Ards,6239,11,6,8,16,33,49,-16,26
Crusaders,6240,1,17,9,4,57,34,23,60
Cliftonville,6240,2,17,6,7,64,46,18,57
Linfield,6240,3,14,9,7,63,34,29,51
Ballymena,6240,4,15,4,11,65,59,6,49
Dungannon,6240,5,10,12,8,49,39,10,42
Glenavon,6240,6,8,13,9,48,51,-3,37
Coleraine,6240,7,7,13,10,42,47,-5,34
Portadown,6240,8,9,6,15,34,50,-16,33
Glentoran,6240,9,9,6,15,25,47,-22,33
Ballinamalla,6240,10,7,7,16,35,57,-22,28
Ards,6240,11,6,7,17,39,57,-18,25
Crusaders,6241,1,18,6,6,62,31,31,60
Cliftonville,6241,2,15,6,9,53,39,14,51
Linfield,6241,3,13,9,8,60,36,24,48
Ballymena,6241,4,13,8,9,55,55,0,47
Glenavon,6241,5,12,10,8,44,43,1,46
Dungannon,6241,6,12,8,10,55,41,14,44
Coleraine,6241,7,8,10,12,35,43,-8,34
Glentoran,6241,8,9,6,15,31,53,-22,33
Ards,6241,9,9,5,16,36,50,-14,32
Portadown,6241,10,9,5,16,25,44,-19,32
Ballinamalla,6241,11,7,7,16,26,47,-21,28
Linfield,6242,1,14,11,5,72,38,34,53
Coleraine,6242,2,14,10,6,43,31,12,52
Glenavon,6242,3,13,10,7,51,45,6,49
Cliftonville,6242,4,14,6,10,55,41,14,48
Crusaders,6242,5,13,9,8,46,34,12,48
Ballymena,6242,6,15,3,12,57,62,-5,48
Dungannon,6242,7,10,10,10,43,39,4,40
Glentoran,6242,8,11,6,13,35,43,-8,39
Ards,6242,9,10,6,14,38,49,-11,36
Portadown,6242,10,6,4,20,17,45,-28,22
Ballinamalla,6242,11,5,5,20,26,56,-30,20
Linfield,6243,1,16,8,6,60,29,31,56
Crusaders,6243,2,16,5,9,56,36,20,53
Cliftonville,6243,3,14,6,10,46,38,8,48
Coleraine,6243,4,11,9,10,44,37,7,42
Glenavon,6243,5,11,9,10,48,46,2,42
Ballymena,6243,6,11,9,10,51,55,-4,42
Glentoran,6243,7,11,8,11,33,43,-10,41
Dungannon,6243,8,10,10,10,48,43,5,40
Ards,6243,9,10,4,16,40,51,-11,34
Portadown,6243,10,7,8,15,22,44,-22,29
Ballinamalla,6243,11,9,2,19,26,52,-26,29
Cliftonville,6244,1,22,2,6,66,41,25,68
Crusaders,6244,2,17,6,7,54,32,22,57
Linfield,6244,3,16,8,6,59,32,27,56
Coleraine,6244,4,10,13,7,47,37,10,43
Glenavon,6244,5,10,12,8,49,42,7,42
Dungannon,6244,6,10,9,11,51,47,4,39
Ballymena,6244,7,11,6,13,55,64,-9,39
Ballinamalla,6244,8,8,7,15,36,53,-17,31
Ards,6244,9,8,4,18,38,56,-18,28
Portadown,6244,10,7,5,18,26,49,-23,26
Glentoran,6244,11,6,8,16,30,58,-28,26
Cliftonville,6245,1,16,5,9,59,41,18,53
Crusaders,6245,2,14,10,6,58,38,20,52
Linfield,6245,3,14,9,7,57,29,28,51
Glenavon,6245,4,11,12,7,54,45,9,45
Coleraine,6245,5,11,12,7,45,39,6,45
Ballymena,6245,6,12,9,9,58,57,1,45
Ards,6245,7,12,6,12,46,47,-1,42
Dungannon,6245,8,11,8,11,49,44,5,41
Portadown,6245,9,10,4,16,31,54,-23,34
Glentoran,6245,10,7,5,18,26,54,-28,26
Ballinamalla,6245,11,5,4,21,20,55,-35,19
Crusaders,6246,1,18,8,4,65,37,28,62
Linfield,6246,2,14,8,8,56,33,23,50
Ballymena,6246,3,14,7,9,61,58,3,49
Coleraine,6246,4,11,10,9,44,37,7,43
Cliftonville,6246,5,13,4,13,51,50,1,43
Dungannon,6246,6,9,11,10,54,48,6,38
Ards,6246,7,10,7,13,41,49,-8,37
Glenavon,6246,8,8,12,10,45,52,-7,36
Portadown,6246,9,10,5,15,29,44,-15,35
Glentoran,6246,10,7,11,12,32,49,-17,32
Ballinamalla,6246,11,6,7,17,29,50,-21,25
Cliftonville,6247,1,16,7,7,49,32,17,55
Linfield,6247,2,15,9,6,53,31,22,54
Crusaders,6247,3,15,8,7,51,32,19,53
Ballymena,6247,4,13,8,9,61,59,2,47
Coleraine,6247,5,12,10,8,42,35,7,46
Glenavon,6247,6,10,11,9,47,44,3,41
Dungannon,6247,7,8,13,9,49,46,3,37
Glentoran,6247,8,9,6,15,35,46,-11,33
Portadown,6247,9,8,8,14,28,45,-17,32
Ards,6247,10,7,6,17,36,50,-14,27
Ballinamalla,6247,11,7,4,19,27,58,-31,25
Crusaders,6248,1,16,7,7,53,31,22,55
Linfield,6248,2,14,12,4,64,32,32,54
Cliftonville,6248,3,15,9,6,50,32,18,54
Glenavon,6248,4,12,13,5,49,41,8,49
Dungannon,6248,5,10,11,9,51,44,7,41
Coleraine,6248,6,9,14,7,40,38,2,41
Ballymena,6248,7,11,7,12,49,61,-12,40
Glentoran,6248,8,8,8,14,37,49,-12,32
Portadown,6248,9,8,8,14,30,44,-14,32
Ards,6248,10,9,2,19,32,53,-21,29
Ballinamalla,6248,11,5,5,20,25,55,-30,20
Crusaders,6249,1,20,8,2,66,33,33,68
Linfield,6249,2,16,10,4,63,29,34,58
Coleraine,6249,3,12,11,7,49,38,11,47
Glenavon,6249,4,12,9,9,50,47,3,45
Ballymena,6249,5,13,6,11,57,58,-1,45
Cliftonville,6249,6,12,5,13,46,46,0,41
Dungannon,6249,7,11,7,12,49,45,4,40
Ards,6249,8,9,5,16,34,51,-17,32
Portadown,6249,9,6,9,15,26,48,-22,27
Ballinamalla,6249,10,7,5,18,27,51,-24,26
Glentoran,6249,11,6,7,17,30,51,-21,25
Linfield,6250,1,17,9,4,66,30,36,60
Crusaders,6250,2,15,7,8,51,42,9,52
Ballymena,6250,3,13,7,10,50,56,-6,46
Cliftonville,6250,4,12,8,10,47,41,6,44
Coleraine,6250,5,11,10,9,39,35,4,43
Glenavon,6250,6,10,12,8,44,41,3,42
Dungannon,6250,7,8,11,11,47,41,6,35
Ballinamalla,6250,8,10,4,16,38,49,-11,34
Portadown,6250,9,9,6,15,24,44,-20,33
Glentoran,6250,10,7,10,13,30,42,-12,31
Ards,6250,11,8,6,16,36,51,-15,30
Cliftonville,6251,1,17,6,7,52,33,19,57
Crusaders,6251,2,13,12,5,51,30,21,51
Linfield,6251,3,12,11,7,62,37,25,47
Coleraine,6251,4,11,13,6,45,37,8,46
Ballymena,6251,5,12,9,9,58,60,-2,45
Dungannon,6251,6,10,10,10,49,46,3,40
Glenavon,6251,7,8,14,8,46,53,-7,38
Ards,6251,8,10,4,16,48,54,-6,34
Glentoran,6251,9,7,10,13,28,46,-18,31
Portadown,6251,10,7,8,15,27,48,-21,29
Ballinamalla,6251,11,6,7,17,34,56,-22,25
Cliftonville,6252,1,16,5,9,55,34,21,53
Ballymena,6252,2,15,7,8,64,57,7,52
Glenavon,6252,3,13,11,6,48,36,12,50
Crusaders,6252,4,14,6,10,52,45,7,48
Linfield,6252,5,12,9,9,54,41,13,45
Dungannon,6252,6,11,10,9,46,40,6,43
Coleraine,6252,7,10,12,8,48,38,10,42
Glentoran,6252,8,10,8,12,36,51,-15,38
Ballinamalla,6252,9,8,6,16,33,51,-18,30
Ards,6252,10,8,5,17,38,52,-14,29
Portadown,6252,11,6,5,19,28,57,-29,23
Cliftonville,6253,1,17,5,8,56,36,20,56
Ballymena,6253,2,15,6,9,62,60,2,51
Coleraine,6253,3,12,10,8,50,45,5,46
Linfield,6253,4,11,12,7,55,35,20,45
Crusaders,6253,5,10,13,7,49,42,7,43
Glenavon,6253,6,10,11,9,47,43,4,41
Dungannon,6253,7,9,11,10,48,41,7,38
Glentoran,6253,8,10,8,12,40,52,-12,38
Ards,6253,9,8,8,14,40,54,-14,32
Portadown,6253,10,8,8,14,31,47,-16,32
Ballinamalla,6253,11,6,6,18,25,48,-23,24
Cliftonville,6254,1,17,6,7,55,33,22,57
Linfield,6254,2,14,12,4,61,33,28,54
Ballymena,6254,3,15,6,9,61,59,2,51
Crusaders,6254,4,12,12,6,46,32,14,48
Coleraine,6254,5,13,9,8,52,39,13,48
Glenavon,6254,6,12,9,9,47,49,-2,45
Glentoran,6254,7,10,9,11,36,44,-8,39
Dungannon,6254,8,8,10,12,48,48,0,34
Ards,6254,9,8,8,14,47,50,-3,32
Ballinamalla,6254,10,6,4,20,27,64,-37,22
Portadown,6254,11,5,5,20,25,54,-29,20
Crusaders,6255,1,15,8,7,59,44,15,53
Linfield,6255,2,14,10,6,60,34,26,52
Cliftonville,6255,3,14,8,8,56,42,14,50
Coleraine,6255,4,13,10,7,47,37,10,49
Glenavon,6255,5,11,12,7,53,46,7,45
Ballymena,6255,6,13,4,13,54,60,-6,43
Dungannon,6255,7,8,10,12,55,63,-8,34
Glentoran,6255,8,9,7,14,34,47,-13,34
Ballinamalla,6255,9,8,8,14,36,52,-16,32
Ards,6255,10,7,10,13,48,53,-5,31
Portadown,6255,11,7,5,18,25,49,-24,26
Linfield,6256,1,16,9,5,55,29,26,57
Cliftonville,6256,2,17,4,9,64,47,17,55
Glenavon,6256,3,15,8,7,58,42,16,53
Crusaders,6256,4,12,10,8,56,44,12,46
Ballymena,6256,5,12,7,11,55,58,-3,43
Coleraine,6256,6,10,11,9,41,42,-1,41
Ards,6256,7,11,4,15,34,42,-8,37
Dungannon,6256,8,8,11,11,54,53,1,35
Glentoran,6256,9,9,7,14,31,47,-16,34
Ballinamalla,6256,10,8,5,17,34,50,-16,29
Portadown,6256,11,7,4,19,23,51,-28,25
Crusaders,6257,1,16,11,3,49,24,25,59
Linfield,6257,2,16,9,5,61,30,31,57
Cliftonville,6257,3,16,7,7,59,35,24,55
Ballymena,6257,4,14,4,12,55,63,-8,46
Glenavon,6257,5,11,12,7,43,40,3,45
Coleraine,6257,6,10,10,10,45,38,7,40
Glentoran,6257,7,10,8,12,29,37,-8,38
Ards,6257,8,9,4,17,32,54,-22,31
Dungannon,6257,9,6,11,13,44,45,-1,29
Portadown,6257,10,7,6,17,24,49,-25,27
Ballinamalla,6257,11,6,6,18,20,46,-26,24
Cliftonville,6258,1,17,5,8,55,33,22,56
Crusaders,6258,2,16,7,7,52,36,16,55
Ballymena,6258,3,15,8,7,65,53,12,53
Linfield,6258,4,12,11,7,52,31,21,47
Coleraine,6258,5,11,13,6,42,31,11,46
Glenavon,6258,6,11,10,9,44,49,-5,43
Dungannon,6258,7,9,12,9,51,39,12,39
Portadown,6258,8,10,4,16,29,45,-16,34
Ards,6258,9,7,9,14,32,44,-12,30
Glentoran,6258,10,6,7,17,24,50,-26,25
Ballinamalla,6258,11,7,2,21,23,58,-35,23
Crusaders,6259,1,17,7,6,63,36,27,58
Cliftonville,6259,2,16,5,9,62,47,15,53
Linfield,6259,3,14,10,6,60,32,28,52
Ballymena,6259,4,14,7,9,60,59,1,49
Coleraine,6259,5,12,10,8,43,37,6,46
Glenavon,6259,6,9,11,10,43,50,-7,38
Dungannon,6259,7,10,7,13,44,43,1,37
Ards,6259,8,9,6,15,41,58,-17,33
Glentoran,6259,9,7,10,13,35,46,-11,31
Portadown,6259,10,7,8,15,25,45,-20,29
Ballinamalla,6259,11,6,7,17,25,48,-23,25
Crusaders,6260,1,17,5,8,57,33,24,56
Linfield,6260,2,15,9,6,68,35,33,54
Glenavon,6260,3,13,11,6,55,42,13,50
Ballymena,6260,4,14,6,10,56,55,1,48
Cliftonville,6260,5,12,8,10,51,41,10,44
Coleraine,6260,6,10,12,8,42,46,-4,42
Ards,6260,7,11,5,14,40,48,-8,38
Dungannon,6260,8,10,7,13,49,50,-1,37
Glentoran,6260,9,10,6,14,36,45,-9,36
Ballinamalla,6260,10,8,3,19,32,61,-29,27
Portadown,6260,11,7,4,19,23,53,-30,25
Cliftonville,6261,1,17,4,9,50,37,13,55
Crusaders,6261,2,15,8,7,57,39,18,53
Linfield,6261,3,14,9,7,59,29,30,51
Ballymena,6261,4,14,6,10,54,52,2,48
Coleraine,6261,5,12,11,7,38,36,2,47
Glenavon,6261,6,10,13,7,45,40,5,43
Dungannon,6261,7,11,7,12,51,46,5,40
Ards,6261,8,10,5,15,40,45,-5,35
Glentoran,6261,9,7,10,13,26,45,-19,31
Ballinamalla,6261,10,7,5,18,27,55,-28,26
Portadown,6261,11,6,6,18,22,45,-23,24
Crusaders,6262,1,18,8,4,65,31,34,62
Linfield,6262,2,17,7,6,61,27,34,58
Glenavon,6262,3,13,10,7,49,43,6,49
Coleraine,6262,4,12,11,7,46,41,5,47
Cliftonville,6262,5,13,4,13,46,41,5,43
Ballymena,6262,6,11,8,11,55,59,-4,41
Ballinamalla,6262,7,10,5,15,32,46,-14,35
Ards,6262,8,9,7,14,37,48,-11,34
Dungannon,6262,9,7,11,12,46,48,-2,32
Glentoran,6262,10,5,12,13,36,57,-21,27
Portadown,6262,11,5,7,18,23,55,-32,22
Crusaders,6263,1,17,8,5,61,40,21,59
Cliftonville,6263,2,17,6,7,59,40,19,57
Linfield,6263,3,14,10,6,68,35,33,52
Glenavon,6263,4,12,11,7,49,49,0,47
Ballymena,6263,5,11,7,12,52,62,-10,40
Coleraine,6263,6,10,9,11,42,40,2,39
Ards,6263,7,12,3,15,38,45,-7,39
Dungannon,6263,8,9,10,11,51,45,6,37
Glentoran,6263,9,10,5,15,32,46,-14,35
Ballinamalla,6263,10,8,5,17,32,54,-22,29
Portadown,6263,11,5,6,19,23,51,-28,21
Crusaders,6264,1,15,11,4,54,32,22,56
Ballymena,6264,2,14,9,7,56,51,5,51
Linfield,6264,3,14,6,10,63,43,20,48
Cliftonville,6264,4,14,6,10,47,34,13,48
Glenavon,6264,5,11,10,9,47,44,3,43
Coleraine,6264,6,9,15,6,38,35,3,42
Glentoran,6264,7,11,9,10,42,41,1,42
Dungannon,6264,8,8,12,10,49,47,2,36
Ards,6264,9,10,5,15,39,53,-14,35
Ballinamalla,6264,10,6,6,18,26,52,-26,24
Portadown,6264,11,5,7,18,21,50,-29,22
Crusaders,6265,1,20,6,4,65,37,28,66
Cliftonville,6265,2,18,3,9,55,37,18,57
Linfield,6265,3,14,9,7,60,34,26,51
Ballymena,6265,4,14,6,10,62,58,4,48
Coleraine,6265,5,12,10,8,47,38,9,46
Dungannon,6265,6,11,10,9,56,44,12,43
Glenavon,6265,7,9,12,9,41,50,-9,39
Glentoran,6265,8,7,10,13,34,50,-16,31
Ballinamalla,6265,9,8,3,19,28,57,-29,27
Ards,6265,10,5,8,17,36,55,-19,23
Portadown,6265,11,6,5,19,28,52,-24,23
Crusaders,6266,1,17,11,2,62,33,29,62
Linfield,6266,2,13,9,8,61,41,20,48
Cliftonville,6266,3,14,5,11,48,43,5,47
Ballymena,6266,4,13,6,11,57,63,-6,45
Dungannon,6266,5,11,9,10,54,41,13,42
Glentoran,6266,6,11,7,12,37,46,-9,40
Glenavon,6266,7,9,10,11,48,51,-3,37
Coleraine,6266,8,9,9,12,38,41,-3,36
Ards,6266,9,10,6,14,39,47,-8,36
Portadown,6266,10,10,4,16,29,47,-18,34
Ballinamalla,6266,11,8,4,18,34,54,-20,28
Crusaders,6267,1,17,7,6,58,32,26,58
Linfield,6267,2,13,12,5,59,33,26,51
Coleraine,6267,3,13,11,6,50,36,14,50
Ballymena,6267,4,13,10,7,63,61,2,49
Cliftonville,6267,5,12,11,7,51,38,13,47
Ards,6267,6,10,8,12,40,44,-4,38
Dungannon,6267,7,8,13,9,52,45,7,37
Glenavon,6267,8,9,10,11,42,48,-6,37
Glentoran,6267,9,9,5,16,27,48,-21,32
Portadown,6267,10,6,6,18,26,55,-29,24
Ballinamalla,6267,11,6,5,19,30,58,-28,23
Cliftonville,6268,1,18,5,7,53,35,18,59
Linfield,6268,2,16,9,5,56,26,30,57
Crusaders,6268,3,15,8,7,53,33,20,53
Glenavon,6268,4,12,10,8,45,44,1,46
Ballymena,6268,5,12,8,10,59,57,2,44
Dungannon,6268,6,12,7,11,53,41,12,43
Ards,6268,7,13,3,14,45,50,-5,42
Coleraine,6268,8,8,9,13,30,40,-10,33
Glentoran,6268,9,8,5,17,32,52,-20,29
Ballinamalla,6268,10,8,5,17,29,49,-20,29
Portadown,6268,11,6,5,19,21,49,-28,23
Linfield,6269,1,17,9,4,67,28,39,60
Cliftonville,6269,2,18,2,10,54,39,15,56
Crusaders,6269,3,16,7,7,63,44,19,55
Ballymena,6269,4,14,6,10,58,52,6,48
Coleraine,6269,5,11,9,10,40,34,6,42
Glenavon,6269,6,7,14,9,38,49,-11,35
Dungannon,6269,7,8,10,12,48,48,0,34
Ards,6269,8,10,4,16,32,46,-14,34
Glentoran,6269,9,9,6,15,29,48,-19,33
Ballinamalla,6269,10,9,4,17,30,54,-24,31
Portadown,6269,11,7,7,16,30,47,-17,28
Cliftonville,6270,1,16,8,6,57,39,18,56
Linfield,6270,2,14,10,6,58,31,27,52
Ballymena,6270,3,14,7,9,55,56,-1,49
Crusaders,6270,4,14,6,10,56,51,5,48
Dungannon,6270,5,12,7,11,61,42,19,43
Coleraine,6270,6,10,12,8,38,37,1,42
Ards,6270,7,11,6,13,50,56,-6,39
Glenavon,6270,8,9,11,10,43,45,-2,38
Glentoran,6270,9,9,7,14,30,40,-10,34
Portadown,6270,10,8,5,17,25,44,-19,29
Ballinamalla,6270,11,6,5,19,25,57,-32,23
Crusaders,6271,1,18,7,5,59,26,33,61
Cliftonville,6271,2,18,5,7,50,31,19,59
Linfield,6271,3,13,9,8,57,39,18,48
Glenavon,6271,4,12,9,9,47,43,4,45
Dungannon,6271,5,11,8,11,52,41,11,41
Coleraine,6271,6,10,10,10,40,35,5,40
Ballymena,6271,7,10,10,10,51,59,-8,40
Portadown,6271,8,10,3,17,31,48,-17,33
Glentoran,6271,9,6,12,12,27,46,-19,30
Ballinamalla,6271,10,7,7,16,23,49,-26,28
Ards,6271,11,7,6,17,36,56,-20,27
Linfield,6272,1,15,9,6,62,30,32,54
Cliftonville,6272,2,16,5,9,60,42,18,53
Glenavon,6272,3,14,8,8,53,42,11,50
Ballymena,6272,4,14,6,10,52,54,-2,48
Crusaders,6272,5,13,8,9,49,36,13,47
Coleraine,6272,6,10,12,8,39,39,0,42
Dungannon,6272,7,9,10,11,43,39,4,37
Glentoran,6272,8,9,9,12,26,38,-12,36
Ards,6272,9,10,3,17,35,50,-15,33
Ballinamalla,6272,10,9,3,18,29,48,-19,30
Portadown,6272,11,6,7,17,22,52,-30,25
Crusaders,6273,1,17,7,6,53,31,22,58
Cliftonville,6273,2,18,2,10,55,40,15,56
Coleraine,6273,3,15,10,5,49,35,14,55
Glenavon,6273,4,13,11,6,55,38,17,50
Linfield,6273,5,13,8,9,59,43,16,47
Ballymena,6273,6,12,9,9,54,55,-1,45
Dungannon,6273,7,9,10,11,44,43,1,37
Glentoran,6273,8,9,6,15,24,43,-19,33
Ards,6273,9,9,5,16,37,47,-10,32
Portadown,6273,10,8,4,18,25,48,-23,28
Ballinamalla,6273,11,3,6,21,22,54,-32,15
Cliftonville,6274,1,16,7,7,54,33,21,55
Linfield,6274,2,14,12,4,52,23,29,54
Crusaders,6274,3,15,8,7,51,39,12,53
Ballymena,6274,4,14,8,8,62,60,2,50
Glenavon,6274,5,11,11,8,45,45,0,44
Coleraine,6274,6,10,10,10,43,39,4,40
Dungannon,6274,7,9,12,9,48,41,7,39
Glentoran,6274,8,7,9,14,27,42,-15,30
Ards,6274,9,8,5,17,36,51,-15,29
Ballinamalla,6274,10,8,4,18,30,49,-19,28
Portadown,6274,11,6,8,16,20,46,-26,26
Crusaders,6275,1,18,6,6,60,36,24,60
Linfield,6275,2,16,9,5,56,28,28,57
Cliftonville,6275,3,17,4,9,56,39,17,55
Ballymena,6275,4,13,6,11,59,54,5,45
Glentoran,6275,5,12,8,10,38,39,-1,44
Dungannon,6275,6,11,10,9,53,40,13,43
Coleraine,6275,7,10,10,10,32,38,-6,40
Glenavon,6275,8,7,11,12,40,49,-9,32
Ards,6275,9,8,6,16,33,47,-14,30
Portadown,6275,10,7,6,17,22,49,-27,27
Ballinamalla,6275,11,5,6,19,30,60,-30,21
Linfield,6276,1,14,10,6,57,33,24,52
Crusaders,6276,2,15,7,8,49,30,19,52
Cliftonville,6276,3,16,4,10,54,42,12,52
Ballymena,6276,4,14,7,9,53,52,1,49
Coleraine,6276,5,11,11,8,44,34,10,44
Dungannon,6276,6,11,10,9,54,44,10,43
Glenavon,6276,7,10,11,9,48,43,5,41
Ards,6276,8,9,6,15,34,50,-16,33
Portadown,6276,9,8,8,14,26,42,-16,32
Glentoran,6276,10,7,8,15,26,44,-18,29
Ballinamalla,6276,11,8,2,20,27,58,-31,26
Crusaders,6277,1,17,7,6,60,36,24,58
Linfield,6277,2,15,10,5,61,33,28,55
Cliftonville,6277,3,17,4,9,58,38,20,55
Ballymena,6277,4,15,5,10,60,56,4,50
Coleraine,6277,5,11,11,8,44,42,2,44
Glenavon,6277,6,12,8,10,47,51,-4,44
Dungannon,6277,7,10,9,11,49,43,6,39
Glentoran,6277,8,8,7,15,37,50,-13,31
Ballinamalla,6277,9,8,5,17,32,56,-24,29
Portadown,6277,10,8,4,18,33,53,-20,28
Ards,6277,11,6,6,18,28,51,-23,24
Crusaders,6278,1,15,8,7,59,37,22,53
Coleraine,6278,2,14,9,7,47,34,13,51
Glenavon,6278,3,13,12,5,51,43,8,51
Ballymena,6278,4,14,8,8,59,55,4,50
Linfield,6278,5,13,7,10,50,35,15,46
Cliftonville,6278,6,12,6,12,50,49,1,42
Dungannon,6278,7,10,11,9,52,44,8,41
Glentoran,6278,8,8,7,15,32,47,-15,31
Portadown,6278,9,7,9,14,24,41,-17,30
Ards,6278,10,9,3,18,40,61,-21,30
Ballinamalla,6278,11,9,2,19,36,54,-18,29
Crusaders,6279,1,16,6,8,56,40,16,54
Linfield,6279,2,14,10,6,57,28,29,52
Glenavon,6279,3,12,11,7,48,38,10,47
Ballymena,6279,4,13,8,9,55,60,-5,47
Coleraine,6279,5,9,15,6,43,35,8,42
Cliftonville,6279,6,11,6,13,49,53,-4,39
Dungannon,6279,7,9,9,12,51,47,4,36
Glentoran,6279,8,9,7,14,34,50,-16,34
Ards,6279,9,9,6,15,43,54,-11,33
Ballinamalla,6279,10,9,6,15,28,47,-19,33
Portadown,6279,11,8,8,14,30,42,-12,32
Cliftonville,6280,1,14,9,7,50,35,15,51
Coleraine,6280,2,12,13,5,44,32,12,49
Linfield,6280,3,12,10,8,57,36,21,46
Crusaders,6280,4,13,7,10,44,40,4,46
Glenavon,6280,5,12,10,8,51,48,3,46
Ballymena,6280,6,13,6,11,56,55,1,45
Glentoran,6280,7,11,10,9,37,35,2,43
Dungannon,6280,8,11,7,12,53,43,10,40
Ards,6280,9,8,6,16,35,52,-17,30
Portadown,6280,10,8,5,17,23,47,-24,29
Ballinamalla,6280,11,6,7,17,27,54,-27,25
Cliftonville,6281,1,16,7,7,54,35,19,55
Linfield,6281,2,15,8,7,63,36,27,53
Crusaders,6281,3,12,9,9,48,40,8,45
Glenavon,6281,4,12,8,10,46,45,1,44
Portadown,6281,5,13,5,12,35,42,-7,44
Coleraine,6281,6,11,10,9,47,43,4,43
Ballymena,6281,7,12,7,11,52,60,-8,43
Glentoran,6281,8,12,6,12,38,42,-4,42
Dungannon,6281,9,9,8,13,52,50,2,35
Ards,6281,10,10,3,17,38,52,-14,33
Ballinamalla,6281,11,5,5,20,25,53,-28,20
Cliftonville,6282,1,17,6,7,59,38,21,57
Crusaders,6282,2,16,8,6,54,34,20,56
Linfield,6282,3,15,10,5,58,26,32,55
Glenavon,6282,4,12,12,6,39,36,3,48
Ballymena,6282,5,14,5,11,55,51,4,47
Dungannon,6282,6,11,10,9,47,36,11,43
Glentoran,6282,7,12,6,12,34,44,-10,42
Coleraine,6282,8,9,10,11,35,38,-3,37
Ballinamalla,6282,9,7,5,18,30,56,-26,26
Ards,6282,10,7,4,19,31,47,-16,25
Portadown,6282,11,4,6,20,22,58,-36,18
Linfield,6283,1,14,11,5,61,30,31,53
Ballymena,6283,2,15,5,10,65,65,0,50
Cliftonville,6283,3,14,7,9,59,40,19,49
Crusaders,6283,4,14,7,9,52,34,18,49
Coleraine,6283,5,11,12,7,45,34,11,45
Glenavon,6283,6,11,11,8,47,44,3,44
Dungannon,6283,7,11,9,10,51,45,6,42
Ards,6283,8,9,7,14,36,47,-11,34
Ballinamalla,6283,9,9,4,17,30,54,-24,31
Portadown,6283,10,7,7,16,23,50,-27,28
Glentoran,6283,11,6,8,16,26,52,-26,26
Crusaders,6284,1,16,9,5,59,38,21,57
Cliftonville,6284,2,16,4,10,61,36,25,52
Coleraine,6284,3,12,11,7,44,37,7,47
Linfield,6284,4,13,7,10,58,38,20,46
Glentoran,6284,5,12,9,9,37,41,-4,45
Dungannon,6284,6,10,8,12,46,48,-2,38
Ballymena,6284,7,11,5,14,53,67,-14,38
Glenavon,6284,8,9,10,11,44,48,-4,37
Ballinamalla,6284,9,9,7,14,37,48,-11,34
Ards,6284,10,8,7,15,38,55,-17,31
Portadown,6284,11,9,3,18,23,44,-21,30
Ballymena,6285,1,18,5,7,57,54,3,59
Crusaders,6285,2,16,8,6,62,36,26,56
Glenavon,6285,3,13,11,6,46,40,6,50
Linfield,6285,4,13,8,9,55,33,22,47
Cliftonville,6285,5,13,7,10,47,39,8,46
Glentoran,6285,6,10,9,11,36,48,-12,39
Dungannon,6285,7,10,8,12,45,42,3,38
Coleraine,6285,8,8,9,13,41,44,-3,33
Ards,6285,9,9,6,15,40,55,-15,33
Portadown,6285,10,7,6,17,23,41,-18,27
Ballinamalla,6285,11,6,7,17,32,52,-20,25
Crusaders,6286,1,20,4,6,62,36,26,64
Ballymena,6286,2,18,4,8,63,50,13,58
Linfield,6286,3,13,9,8,54,35,19,48
Cliftonville,6286,4,14,4,12,51,41,10,46
Glenavon,6286,5,12,9,9,49,45,4,45
Dungannon,6286,6,12,8,10,49,40,9,44
Coleraine,6286,7,10,8,12,33,41,-8,38
Ards,6286,8,9,6,15,38,44,-6,33
Glentoran,6286,9,8,8,14,26,41,-15,32
Ballinamalla,6286,10,9,4,17,35,54,-19,31
Portadown,6286,11,7,2,21,26,59,-33,23
Linfield,6287,1,16,9,5,59,27,32,57
Cliftonville,6287,2,16,8,6,58,35,23,56
Crusaders,6287,3,16,8,6,53,38,15,56
Ballymena,6287,4,12,9,9,55,57,-2,45
Dungannon,6287,5,10,10,10,54,48,6,40
Coleraine,6287,6,10,10,10,43,46,-3,40
Glenavon,6287,7,9,10,11,45,45,0,37
Ballinamalla,6287,8,9,8,13,35,45,-10,35
Glentoran,6287,9,7,9,14,34,50,-16,30
Ards,6287,10,7,6,17,32,53,-21,27
Portadown,6287,11,7,5,18,25,49,-24,26
Linfield,6288,1,19,7,4,64,28,36,64
Crusaders,6288,2,18,7,5,58,30,28,61
Cliftonville,6288,3,15,5,10,54,41,13,50
Ballymena,6288,4,15,3,12,54,58,-4,48
Glenavon,6288,5,13,8,9,56,50,6,47
Dungannon,6288,6,12,7,11,50,47,3,43
Coleraine,6288,7,11,9,10,40,42,-2,42
Ards,6288,8,8,5,17,34,47,-13,29
Portadown,6288,9,7,7,16,25,44,-19,28
Ballinamalla,6288,10,8,2,20,29,54,-25,26
Glentoran,6288,11,5,8,17,21,44,-23,23
Crusaders,6289,1,21,6,3,57,24,33,69
Cliftonville,6289,2,16,4,10,47,34,13,52
Linfield,6289,3,14,9,7,52,30,22,51
Glenavon,6289,4,12,10,8,46,38,8,46
Ballymena,6289,5,13,6,11,56,63,-7,45
Coleraine,6289,6,11,8,11,43,40,3,41
Dungannon,6289,7,10,8,12,48,43,5,38
Ards,6289,8,11,4,15,37,46,-9,37
Glentoran,6289,9,9,9,12,31,46,-15,36
Portadown,6289,10,6,5,19,25,48,-23,23
Ballinamalla,6289,11,6,3,21,26,56,-30,21
Crusaders,6290,1,18,5,7,64,33,31,59
Linfield,6290,2,15,9,6,59,33,26,54
Coleraine,6290,3,15,9,6,51,39,12,54
Ballymena,6290,4,15,7,8,62,53,9,52
Cliftonville,6290,5,13,7,10,51,41,10,46
Glenavon,6290,6,10,9,11,48,52,-4,39
Glentoran,6290,7,10,5,15,34,48,-14,35
Ards,6290,8,9,6,15,38,53,-15,33
Dungannon,6290,9,8,8,14,50,55,-5,32
Ballinamalla,6290,10,8,6,16,32,53,-21,30
Portadown,6290,11,5,7,18,27,56,-29,22
Crusaders,6291,1,17,7,6,51,29,22,58
Ballymena,6291,2,15,8,7,59,51,8,53
Cliftonville,6291,3,15,6,9,49,36,13,51
Linfield,6291,4,12,13,5,56,30,26,49
Glenavon,6291,5,13,10,7,54,44,10,49
Coleraine,6291,6,11,8,11,37,39,-2,41
Dungannon,6291,7,9,12,9,47,42,5,39
Glentoran,6291,8,9,5,16,27,46,-19,32
Portadown,6291,9,7,8,15,23,42,-19,29
Ballinamalla,6291,10,8,4,18,31,54,-23,28
Ards,6291,11,6,5,19,32,53,-21,23
Crusaders,6292,1,17,9,4,58,35,23,60
Coleraine,6292,2,17,9,4,47,25,22,60
Ballymena,6292,3,16,6,8,56,52,4,54
Cliftonville,6292,4,13,8,9,53,40,13,47
Glentoran,6292,5,12,6,12,39,47,-8,42
Linfield,6292,6,10,9,11,44,35,9,39
Glenavon,6292,7,8,12,10,43,51,-8,36
Dungannon,6292,8,8,9,13,49,50,-1,33
Ards,6292,9,8,4,18,35,51,-16,28
Ballinamalla,6292,10,7,7,16,30,49,-19,28
Portadown,6292,11,7,5,18,28,47,-19,26
Crusaders,6293,1,20,4,6,60,35,25,64
Linfield,6293,2,17,8,5,66,37,29,59
Cliftonville,6293,3,16,2,12,54,42,12,50
Ballymena,6293,4,14,6,10,59,57,2,48
Coleraine,6293,5,13,8,9,38,31,7,47
Dungannon,6293,6,11,11,8,53,41,12,44
Glenavon,6293,7,10,11,9,41,40,1,41
Glentoran,6293,8,9,6,15,35,48,-13,33
Portadown,6293,9,7,7,16,27,44,-17,28
Ards,6293,10,6,5,19,29,53,-24,23
Ballinamalla,6293,11,6,4,20,22,56,-34,22
Cliftonville,6294,1,15,8,7,59,36,23,53
Linfield,6294,2,13,12,5,56,31,25,51
Crusaders,6294,3,14,7,9,55,35,20,49
Ballymena,6294,4,15,4,11,65,67,-2,49
Dungannon,6294,5,12,8,10,52,43,9,44
Coleraine,6294,6,10,13,7,41,41,0,43
Glenavon,6294,7,10,11,9,43,47,-4,41
Ballinamalla,6294,8,11,3,16,34,48,-14,36
Ards,6294,9,8,5,17,38,51,-13,29
Glentoran,6294,10,7,8,15,28,49,-21,29
Portadown,6294,11,8,5,17,31,54,-23,29
Cliftonville,6295,1,17,4,9,62,40,22,55
Linfield,6295,2,14,9,7,62,33,29,51
Ballymena,6295,3,15,6,9,57,60,-3,51
Crusaders,6295,4,13,10,7,49,33,16,49
Ballinamalla,6295,5,12,5,13,39,47,-8,41
Coleraine,6295,6,10,9,11,38,42,-4,39
Glenavon,6295,7,10,9,11,42,52,-10,39
Glentoran,6295,8,10,8,12,30,40,-10,38
Dungannon,6295,9,8,11,11,41,40,1,35
Ards,6295,10,8,5,17,37,53,-16,29
Portadown,6295,11,8,4,18,26,43,-17,28
Crusaders,6296,1,15,6,9,49,42,7,51
Ballymena,6296,2,14,8,8,60,54,6,50
Glenavon,6296,3,13,10,7,48,42,6,49
Cliftonville,6296,4,15,3,12,52,40,12,48
Dungannon,6296,5,13,8,9,53,41,12,47
Linfield,6296,6,11,10,9,47,29,18,43
Coleraine,6296,7,10,10,10,50,38,12,40
Glentoran,6296,8,10,8,12,33,45,-12,38
Ards,6296,9,10,5,15,35,53,-18,35
Portadown,6296,10,8,4,18,31,52,-21,28
Ballinamalla,6296,11,8,4,18,31,53,-22,28
Crusaders,6297,1,16,9,5,55,34,21,57
Linfield,6297,2,16,7,7,67,34,33,55
Cliftonville,6297,3,14,6,10,49,43,6,48
Dungannon,6297,4,13,8,9,55,41,14,47
Glenavon,6297,5,11,11,8,49,41,8,44
Coleraine,6297,6,10,12,8,43,32,11,42
Ballymena,6297,7,11,8,11,53,65,-12,41
Glentoran,6297,8,9,7,14,28,49,-21,34
Ards,6297,9,9,6,15,45,54,-9,33
Portadown,6297,10,8,5,17,33,56,-23,29
Ballinamalla,6297,11,6,5,19,26,54,-28,23
Crusaders,6298,1,17,10,3,57,29,28,61
Linfield,6298,2,15,10,5,55,29,26,55
Cliftonville,6298,3,15,6,9,50,38,12,51
Glenavon,6298,4,10,14,6,57,45,12,44
Ballymena,6298,5,13,5,12,51,58,-7,44
Glentoran,6298,6,10,8,12,29,39,-10,38
Dungannon,6298,7,8,11,11,46,45,1,35
Coleraine,6298,8,7,12,11,36,44,-8,33
Portadown,6298,9,8,8,14,26,38,-12,32
Ards,6298,10,9,4,17,40,54,-14,31
Ballinamalla,6298,11,5,8,17,24,52,-28,23
Crusaders,6299,1,17,7,6,62,31,31,58
Linfield,6299,2,16,9,5,56,29,27,57
Cliftonville,6299,3,17,5,8,52,35,17,56
Ballymena,6299,4,13,8,9,57,56,1,47
Glenavon,6299,5,11,9,10,49,52,-3,42
Coleraine,6299,6,10,9,11,35,43,-8,39
Dungannon,6299,7,8,11,11,53,51,2,35
Portadown,6299,8,10,5,15,31,45,-14,35
Ballinamalla,6299,9,10,4,16,38,47,-9,34
Glentoran,6299,10,8,4,18,27,54,-27,28
Ards,6299,11,8,3,19,36,53,-17,27
Linfield,6300,1,17,8,5,68,34,34,59
Cliftonville,6300,2,17,6,7,57,37,20,57
Crusaders,6300,3,14,8,8,50,34,16,50
Dungannon,6300,4,10,12,8,52,42,10,42
Glenavon,6300,5,10,12,8,47,47,0,42
Ballymena,6300,6,12,5,13,52,62,-10,41
Coleraine,6300,7,9,11,10,39,44,-5,38
Ards,6300,8,7,11,12,40,46,-6,32
Glentoran,6300,9,7,11,12,31,45,-14,32
Ballinamalla,6300,10,8,4,18,31,52,-21,28
Portadown,6300,11,6,8,16,26,50,-24,26
Crusaders,6301,1,18,8,4,71,33,38,62
Ballymena,6301,2,16,5,9,69,69,0,53
Linfield,6301,3,13,10,7,59,35,24,49
Cliftonville,6301,4,14,6,10,51,44,7,48
Glenavon,6301,5,11,10,9,44,47,-3,43
Coleraine,6301,6,11,9,10,42,38,4,42
Portadown,6301,7,10,7,13,30,38,-8,37
Glentoran,6301,8,8,7,15,30,51,-21,31
Ballinamalla,6301,9,7,9,14,30,47,-17,30
Dungannon,6301,10,6,11,13,44,51,-7,29
Ards,6301,11,7,6,17,35,52,-17,27
Glenavon,6302,1,15,9,6,53,40,13,54
Cliftonville,6302,2,16,4,10,53,41,12,52
Linfield,6302,3,14,8,8,58,31,27,50
Crusaders,6302,4,13,10,7,52,35,17,49
Dungannon,6302,5,12,8,10,51,42,9,44
Portadown,6302,6,10,6,14,31,41,-10,36
Coleraine,6302,7,8,11,11,37,44,-7,35
Glentoran,6302,8,9,8,13,32,42,-10,35
Ards,6302,9,10,5,15,37,49,-12,35
Ballinamalla,6302,10,10,4,16,30,46,-16,34
Ballymena,6302,11,8,7,15,51,74,-23,31
Cliftonville,6303,1,17,6,7,61,37,24,57
Crusaders,6303,2,13,8,9,44,38,6,47
Linfield,6303,3,12,10,8,58,31,27,46
Ballymena,6303,4,13,5,12,59,68,-9,44
Coleraine,6303,5,10,13,7,45,40,5,43
Glenavon,6303,6,10,12,8,50,46,4,42
Ballinamalla,6303,7,12,6,12,38,42,-4,42
Glentoran,6303,8,10,9,11,33,40,-7,39
Dungannon,6303,9,7,9,14,43,53,-10,30
Ards,6303,10,8,6,16,40,58,-18,30
Portadown,6303,11,7,8,15,24,42,-18,29
Crusaders,6304,1,17,8,5,59,32,27,59
Cliftonville,6304,2,15,4,11,62,43,19,49
Ballymena,6304,3,13,8,9,52,53,-1,47
Coleraine,6304,4,11,13,6,39,35,4,46
Ballinamalla,6304,5,13,4,13,38,41,-3,43
Linfield,6304,6,11,9,10,56,38,18,42
Glenavon,6304,7,10,11,9,49,51,-2,41
Dungannon,6304,8,9,10,11,50,50,0,37
Portadown,6304,9,9,5,16,28,51,-23,32
Glentoran,6304,10,8,7,15,32,52,-20,31
Ards,6304,11,6,7,17,32,51,-19,25
Crusaders,6305,1,16,9,5,61,35,26,57
Linfield,6305,2,14,13,3,61,32,29,55
Ballymena,6305,3,16,6,8,58,49,9,54
Cliftonville,6305,4,15,3,12,53,42,11,48
Glenavon,6305,5,10,10,10,45,50,-5,40
Portadown,6305,6,11,6,13,32,41,-9,39
Dungannon,6305,7,9,10,11,49,46,3,37
Coleraine,6305,8,8,11,11,36,42,-6,35
Glentoran,6305,9,8,7,15,36,57,-21,31
Ballinamalla,6305,10,8,5,17,29,49,-20,29
Ards,6305,11,7,6,17,37,54,-17,27
Cliftonville,6306,1,16,4,10,56,45,11,52
Linfield,6306,2,13,10,7,58,37,21,49
Coleraine,6306,3,13,10,7,51,45,6,49
Ballymena,6306,4,14,7,9,56,52,4,49
Crusaders,6306,5,13,8,9,45,33,12,47
Dungannon,6306,6,13,7,10,59,39,20,46
Glenavon,6306,7,11,9,10,50,50,0,42
Ards,6306,8,8,9,13,40,49,-9,33
Glentoran,6306,9,7,10,13,26,43,-17,31
Ballinamalla,6306,10,8,5,17,29,49,-20,29
Portadown,6306,11,8,3,19,24,52,-28,27
Crusaders,6307,1,20,7,3,60,27,33,67
Linfield,6307,2,16,8,6,69,33,36,56
Ballymena,6307,3,15,5,10,60,57,3,50
Cliftonville,6307,4,14,5,11,56,43,13,47
Dungannon,6307,5,12,7,11,49,43,6,43
Ards,6307,6,11,5,14,41,46,-5,38
Glenavon,6307,7,9,11,10,39,46,-7,38
Coleraine,6307,8,9,11,10,37,46,-9,38
Glentoran,6307,9,8,9,13,31,47,-16,33
Portadown,6307,10,8,4,18,27,50,-23,28
Ballinamalla,6307,11,4,6,20,26,57,-31,18
Glenavon,6308,1,15,11,4,58,33,25,56
Crusaders,6308,2,15,11,4,59,38,21,56
Ballymena,6308,3,12,10,8,57,55,2,46
Linfield,6308,4,11,11,8,61,43,18,44
Cliftonville,6308,5,12,8,10,46,39,7,44
Dungannon,6308,6,10,9,11,51,51,0,39
Coleraine,6308,7,9,10,11,37,45,-8,37
Ballinamalla,6308,8,10,7,13,32,44,-12,37
Glentoran,6308,9,9,9,12,37,48,-11,36
Ards,6308,10,8,5,17,35,49,-14,29
Portadown,6308,11,6,5,19,28,56,-28,23
Crusaders,6309,1,19,5,6,61,31,30,62
Ballymena,6309,2,15,8,7,66,60,6,53
Coleraine,6309,3,12,12,6,48,36,12,48
Linfield,6309,4,12,9,9,54,37,17,45
Cliftonville,6309,5,13,4,13,49,45,4,43
Glenavon,6309,6,8,13,9,42,48,-6,37
Glentoran,6309,7,9,9,12,31,39,-8,36
Ards,6309,8,10,4,16,35,52,-17,34
Portadown,6309,9,9,6,15,33,45,-12,33
Ballinamalla,6309,10,9,5,16,29,49,-20,32
Dungannon,6309,11,7,9,14,46,52,-6,30
Crusaders,6310,1,17,7,6,56,34,22,58
Linfield,6310,2,15,8,7,60,32,28,53
Cliftonville,6310,3,16,5,9,52,41,11,53
Glenavon,6310,4,12,11,7,50,42,8,47
Dungannon,6310,5,12,8,10,55,43,12,44
Ballymena,6310,6,13,5,12,50,60,-10,44
Coleraine,6310,7,11,9,10,47,42,5,42
Ards,6310,8,10,4,16,39,50,-11,34
Ballinamalla,6310,9,8,6,16,34,61,-27,30
Portadown,6310,10,8,3,19,31,49,-18,27
Glentoran,6310,11,6,8,16,24,44,-20,26
Linfield,6311,1,18,9,3,78,36,42,63
Crusaders,6311,2,18,5,7,58,34,24,59
Ballymena,6311,3,14,7,9,66,61,5,49
Coleraine,6311,4,12,10,8,47,48,-1,46
Cliftonville,6311,5,13,4,13,52,47,5,43
Dungannon,6311,6,10,8,12,45,41,4,38
Glenavon,6311,7,9,9,12,40,49,-9,36
Ards,6311,8,10,5,15,39,49,-10,35
Glentoran,6311,9,9,7,14,29,48,-19,34
Portadown,6311,10,7,7,16,21,44,-23,28
Ballinamalla,6311,11,8,3,19,30,48,-18,27
Crusaders,6312,1,18,6,6,56,29,27,60
Linfield,6312,2,13,10,7,59,36,23,49
Coleraine,6312,3,13,9,8,51,43,8,48
Cliftonville,6312,4,14,5,11,50,40,10,47
Ballymena,6312,5,12,4,14,58,62,-4,40
Glenavon,6312,6,9,13,8,44,48,-4,40
Portadown,6312,7,11,4,15,35,52,-17,37
Dungannon,6312,8,8,10,12,46,46,0,34
Ards,6312,9,9,7,14,36,52,-16,34
Ballinamalla,6312,10,9,6,15,35,47,-12,33
Glentoran,6312,11,9,6,15,30,45,-15,33
Crusaders,6313,1,21,6,3,64,28,36,69
Linfield,6313,2,15,9,6,65,37,28,54
Cliftonville,6313,3,14,4,12,55,45,10,46
Coleraine,6313,4,12,10,8,39,35,4,46
Glenavon,6313,5,11,11,8,43,39,4,44
Ballymena,6313,6,13,5,12,55,61,-6,44
Dungannon,6313,7,9,9,12,54,48,6,36
Ards,6313,8,11,3,16,41,53,-12,36
Glentoran,6313,9,10,4,16,31,47,-16,34
Ballinamalla,6313,10,8,5,17,30,51,-21,29
Portadown,6313,11,6,4,20,18,51,-33,22
Crusaders,6314,1,16,6,8,54,34,20,54
Cliftonville,6314,2,16,6,8,61,43,18,54
Linfield,6314,3,14,10,6,63,34,29,52
Ballymena,6314,4,14,7,9,61,54,7,49
Dungannon,6314,5,11,8,11,58,39,19,41
Coleraine,6314,6,10,11,9,41,41,0,41
Glenavon,6314,7,10,11,9,44,46,-2,41
Glentoran,6314,8,9,10,11,26,40,-14,37
Portadown,6314,9,7,9,14,33,52,-19,30
Ballinamalla,6314,10,6,7,17,30,56,-26,25
Ards,6314,11,6,7,17,29,61,-32,25
Crusaders,6315,1,17,8,5,57,37,20,59
Linfield,6315,2,14,11,5,60,34,26,53
Cliftonville,6315,3,15,6,9,58,40,18,51
Glenavon,6315,3,13,12,5,58,40,18,51
Coleraine,6315,5,11,10,9,41,39,2,43
Ballymena,6315,6,10,7,13,57,64,-7,37
Glentoran,6315,7,9,10,11,33,46,-13,37
Ards,6315,8,9,6,15,36,50,-14,33
Dungannon,6315,9,6,13,11,49,48,1,31
Portadown,6315,10,8,6,16,24,47,-23,30
Ballinamalla,6315,11,6,5,19,22,50,-28,23
Ballymena,6316,1,16,4,10,72,56,16,52
Crusaders,6316,2,15,7,8,53,39,14,52
Linfield,6316,3,14,9,7,54,28,26,51
Cliftonville,6316,4,13,6,11,54,47,7,45
Coleraine,6316,5,10,13,7,40,40,0,43
Glentoran,6316,6,11,7,12,34,41,-7,40
Glenavon,6316,7,8,12,10,43,53,-10,36
Ards,6316,8,9,7,14,40,48,-8,34
Dungannon,6316,9,7,12,11,48,45,3,33
Portadown,6316,10,8,8,14,31,48,-17,32
Ballinamalla,6316,11,9,5,16,31,55,-24,32
Linfield,6317,1,17,9,4,66,32,34,60
Coleraine,6317,2,14,12,4,48,32,16,54
Crusaders,6317,3,14,11,5,52,37,15,53
Cliftonville,6317,4,15,5,10,51,42,9,50
Glenavon,6317,5,12,12,6,49,39,10,48
Glentoran,6317,6,9,8,13,29,41,-12,35
Ballymena,6317,7,9,8,13,49,63,-14,35
Ards,6317,8,10,4,16,40,48,-8,34
Dungannon,6317,9,7,8,15,45,52,-7,29
Ballinamalla,6317,10,8,5,17,38,55,-17,29
Portadown,6317,11,7,4,19,20,46,-26,25
Crusaders,6318,1,18,7,5,56,31,25,61
Cliftonville,6318,2,16,5,9,58,40,18,53
Linfield,6318,3,14,8,8,59,31,28,50
Ballymena,6318,4,14,6,10,56,53,3,48
Coleraine,6318,5,11,9,10,41,39,2,42
Dungannon,6318,6,10,9,11,48,43,5,39
Glenavon,6318,7,9,11,10,37,45,-8,38
Glentoran,6318,8,8,10,12,32,41,-9,34
Portadown,6318,9,9,6,15,26,48,-22,33
Ards,6318,10,9,5,16,31,45,-14,32
Ballinamalla,6318,11,6,6,18,22,50,-28,24
Crusaders,6319,1,20,5,5,61,34,27,65
Cliftonville,6319,2,15,7,8,56,43,13,52
Coleraine,6319,3,13,11,6,44,35,9,50
Linfield,6319,4,12,11,7,55,40,15,47
Ballymena,6319,5,13,7,10,56,55,1,46
Glenavon,6319,6,9,10,11,42,43,-1,37
Dungannon,6319,7,9,8,13,50,48,2,35
Portadown,6319,8,9,6,15,30,44,-14,33
Ards,6319,9,8,6,16,38,52,-14,30
Glentoran,6319,10,7,8,15,33,50,-17,29
Ballinamalla,6319,11,7,7,16,31,52,-21,28
Linfield,6320,1,17,7,6,58,25,33,58
Crusaders,6320,2,16,9,5,57,32,25,57
Glenavon,6320,3,14,11,5,50,39,11,53
Ballymena,6320,4,14,7,9,52,51,1,49
Cliftonville,6320,5,13,5,12,53,48,5,44
Glentoran,6320,6,9,9,12,35,46,-11,36
Ards,6320,7,10,5,15,36,51,-15,35
Ballinamalla,6320,8,9,6,15,25,43,-18,33
Coleraine,6320,9,7,11,12,36,42,-6,32
Dungannon,6320,10,6,10,14,42,46,-4,28
Portadown,6320,11,8,4,18,23,44,-21,28
Cliftonville,6321,1,16,7,7,58,38,20,55
Crusaders,6321,2,16,7,7,55,36,19,55
Linfield,6321,3,14,9,7,58,31,27,51
Glenavon,6321,4,13,10,7,48,43,5,49
Dungannon,6321,5,11,10,9,56,47,9,43
Coleraine,6321,6,9,10,11,44,40,4,37
Glentoran,6321,7,9,10,11,30,40,-10,37
Ballymena,6321,8,10,6,14,52,58,-6,36
Ballinamalla,6321,9,11,3,16,33,52,-19,36
Ards,6321,10,8,4,18,34,57,-23,28
Portadown,6321,11,7,6,17,27,53,-26,27
Linfield,6322,1,16,9,5,65,33,32,57
Cliftonville,6322,2,17,6,7,61,36,25,57
Ballymena,6322,3,15,6,9,61,57,4,51
Crusaders,6322,4,14,7,9,51,41,10,49
Glenavon,6322,5,11,11,8,55,49,6,44
Coleraine,6322,6,11,10,9,43,38,5,43
Dungannon,6322,7,11,9,10,48,41,7,42
Glentoran,6322,8,8,7,15,24,47,-23,31
Ballinamalla,6322,9,9,3,18,39,58,-19,30
Ards,6322,10,9,3,18,37,58,-21,30
Portadown,6322,11,5,7,18,25,51,-26,22
Crusaders,6323,1,17,7,6,58,31,27,58
Linfield,6323,2,14,10,6,59,36,23,52
Cliftonville,6323,3,14,7,9,53,48,5,49
Ballymena,6323,4,14,6,10,52,54,-2,48
Glenavon,6323,5,12,11,7,48,44,4,47
Coleraine,6323,6,12,10,8,45,39,6,46
Dungannon,6323,7,9,11,10,48,46,2,38
Glentoran,6323,8,8,8,14,34,48,-14,32
Portadown,6323,9,8,5,17,33,47,-14,29
Ards,6323,10,7,6,17,39,54,-15,27
Ballinamalla,6323,11,7,5,18,31,53,-22,26
Linfield,6324,1,17,7,6,63,31,32,58
Cliftonville,6324,2,16,5,9,60,44,16,53
Crusaders,6324,3,14,8,8,50,35,15,50
Dungannon,6324,4,13,8,9,55,44,11,47
Ballymena,6324,5,13,7,10,52,53,-1,46
Glenavon,6324,6,11,11,8,40,37,3,44
Coleraine,6324,7,11,8,11,39,37,2,41
Ards,6324,8,10,3,17,36,49,-13,33
Portadown,6324,9,8,5,17,30,51,-21,29
Glentoran,6324,10,6,10,14,27,47,-20,28
Ballinamalla,6324,11,8,4,18,32,56,-24,28
Linfield,6325,1,16,10,4,62,29,33,58
Crusaders,6325,2,17,5,8,55,43,12,56
Coleraine,6325,3,14,8,8,51,41,10,50
Ballymena,6325,4,14,7,9,56,53,3,49
Cliftonville,6325,5,14,2,14,46,42,4,44
Glenavon,6325,6,10,11,9,44,45,-1,41
Ards,6325,7,11,5,14,43,46,-3,38
Dungannon,6325,8,9,10,11,50,48,2,37
Glentoran,6325,9,9,7,14,35,48,-13,34
Portadown,6325,10,6,8,16,25,45,-20,26
Ballinamalla,6325,11,8,1,21,26,53,-27,25
Linfield,6326,1,16,8,6,67,33,34,56
Crusaders,6326,2,15,8,7,58,35,23,53
Cliftonville,6326,3,15,6,9,48,36,12,51
Ballymena,6326,4,13,7,10,53,57,-4,46
Coleraine,6326,5,11,11,8,39,34,5,44
Dungannon,6326,6,9,11,10,47,41,6,38
Glenavon,6326,7,9,11,10,39,47,-8,38
Ards,6326,8,9,8,13,37,46,-9,35
Glentoran,6326,9,9,7,14,37,50,-13,34
Portadown,6326,10,7,8,15,26,42,-16,29
Ballinamalla,6326,11,8,3,19,24,54,-30,27
Linfield,6327,1,14,13,3,69,28,41,55
Cliftonville,6327,2,16,7,7,57,36,21,55
Crusaders,6327,3,16,7,7,47,30,17,55
Glenavon,6327,4,12,11,7,47,43,4,47
Coleraine,6327,5,11,10,9,39,41,-2,43
Ballymena,6327,6,11,6,13,52,59,-7,39
Glentoran,6327,7,10,7,13,34,44,-10,37
Ards,6327,8,10,7,13,40,51,-11,37
Dungannon,6327,9,6,12,12,44,45,-1,30
Ballinamalla,6327,10,6,7,17,30,59,-29,25
Portadown,6327,11,5,9,16,21,44,-23,24
Linfield,6328,1,17,8,5,68,32,36,59
Crusaders,6328,2,15,8,7,52,36,16,53
Cliftonville,6328,3,16,5,9,48,34,14,53
Glenavon,6328,4,14,9,7,52,38,14,51
Dungannon,6328,5,12,8,10,49,40,9,44
Ballymena,6328,6,11,8,11,49,59,-10,41
Coleraine,6328,7,10,10,10,37,35,2,40
Ards,6328,8,10,5,15,33,46,-13,35
Glentoran,6328,9,8,9,13,33,43,-10,33
Ballinamalla,6328,10,7,4,19,29,56,-27,25
Portadown,6328,11,5,6,19,23,54,-31,21
Crusaders,6329,1,18,5,7,62,37,25,59
Cliftonville,6329,2,16,5,9,55,39,16,53
Ballymena,6329,3,16,5,9,57,55,2,53
Linfield,6329,4,13,12,5,59,33,26,51
Coleraine,6329,5,12,8,10,38,38,0,44
Ards,6329,6,12,7,11,42,38,4,43
Dungannon,6329,7,10,11,9,52,46,6,41
Glenavon,6329,8,7,12,11,40,49,-9,33
Glentoran,6329,9,8,5,17,22,48,-26,29
Ballinamalla,6329,10,8,4,18,33,53,-20,28
Portadown,6329,11,4,8,18,24,48,-24,20
Crusaders,6330,1,15,9,6,53,29,24,54
Linfield,6330,2,15,7,8,59,37,22,52
Cliftonville,6330,3,15,6,9,46,33,13,51
Ballymena,6330,4,14,7,9,57,55,2,49
Dungannon,6330,5,12,10,8,50,38,12,46
Coleraine,6330,6,12,10,8,44,37,7,46
Glenavon,6330,7,9,12,9,44,48,-4,39
Glentoran,6330,8,8,9,13,30,46,-16,33
Portadown,6330,9,7,7,16,26,45,-19,28
Ards,6330,10,8,4,18,35,55,-20,28
Ballinamalla,6330,11,7,5,18,25,46,-21,26
Crusaders,6331,1,18,7,5,56,35,21,61
Linfield,6331,2,16,8,6,62,31,31,56
Coleraine,6331,3,14,9,7,49,35,14,51
Glenavon,6331,4,13,9,8,48,43,5,48
Cliftonville,6331,5,14,5,11,53,44,9,47
Ballymena,6331,6,12,9,9,53,58,-5,45
Dungannon,6331,7,10,10,10,45,39,6,40
Ards,6331,8,8,7,15,35,49,-14,31
Glentoran,6331,9,8,7,15,28,42,-14,31
Portadown,6331,10,5,7,18,25,50,-25,22
Ballinamalla,6331,11,6,4,20,29,57,-28,22
Cliftonville,6332,1,16,6,8,58,40,18,54
Crusaders,6332,2,15,6,9,54,40,14,51
Linfield,6332,3,14,8,8,55,32,23,50
Ballymena,6332,4,14,7,9,67,55,12,49
Glenavon,6332,5,11,9,10,48,45,3,42
Coleraine,6332,6,11,9,10,41,47,-6,42
Dungannon,6332,7,10,11,9,51,44,7,41
Ards,6332,8,11,4,15,38,43,-5,37
Ballinamalla,6332,9,10,2,18,30,50,-20,32
Glentoran,6332,10,9,5,16,30,53,-23,32
Portadown,6332,11,8,5,17,31,54,-23,29
Crusaders,6333,1,17,7,6,58,29,29,58
Linfield,6333,2,14,9,7,56,28,28,51
Cliftonville,6333,3,15,6,9,45,36,9,51
Ballymena,6333,4,14,7,9,61,57,4,49
Coleraine,6333,5,12,11,7,45,36,9,47
Glenavon,6333,6,9,12,9,42,45,-3,39
Dungannon,6333,7,8,13,9,49,42,7,37
Ards,6333,8,10,3,17,36,53,-17,33
Glentoran,6333,9,9,6,15,26,47,-21,33
Ballinamalla,6333,10,8,5,17,27,50,-23,29
Portadown,6333,11,5,9,16,23,45,-22,24
Linfield,6334,1,15,9,6,64,35,29,54
Crusaders,6334,2,14,9,7,53,36,17,51
Cliftonville,6334,3,15,5,10,56,47,9,50
Ballymena,6334,4,13,5,12,63,65,-2,44
Coleraine,6334,5,10,13,7,42,39,3,43
Glentoran,6334,6,11,9,10,36,42,-6,42
Dungannon,6334,7,10,11,9,54,38,16,41
Glenavon,6334,8,9,12,9,44,46,-2,39
Ballinamalla,6334,9,10,5,15,35,51,-16,35
Ards,6334,10,7,6,17,35,54,-19,27
Portadown,6334,11,6,6,18,23,52,-29,24
Crusaders,6335,1,19,7,4,63,30,33,64
Cliftonville,6335,2,16,5,9,55,39,16,53
Ballymena,6335,3,15,5,10,56,54,2,50
Linfield,6335,4,13,8,9,53,33,20,47
Ballinamalla,6335,5,12,4,14,36,51,-15,40
Glenavon,6335,6,10,9,11,44,44,0,39
Coleraine,6335,7,9,10,11,39,44,-5,37
Glentoran,6335,8,8,11,11,30,44,-14,35
Ards,6335,9,10,4,16,43,52,-9,34
Dungannon,6335,10,7,10,13,44,46,-2,31
Portadown,6335,11,8,3,19,20,46,-26,27
Crusaders,6336,1,16,6,8,62,45,17,54
Glenavon,6336,2,13,13,4,53,39,14,52
Linfield,6336,3,13,10,7,58,37,21,49
Cliftonville,6336,4,14,5,11,54,42,12,47
Dungannon,6336,5,12,9,9,52,43,9,45
Ballymena,6336,6,12,7,11,65,65,0,43
Coleraine,6336,7,11,10,9,41,43,-2,43
Glentoran,6336,8,7,9,14,32,45,-13,30
Portadown,6336,9,7,9,14,32,51,-19,30
Ards,6336,10,7,7,16,34,52,-18,28
Ballinamalla,6336,11,7,7,16,31,52,-21,28
Cliftonville,6337,1,16,7,7,53,38,15,55
Linfield,6337,2,14,9,7,57,33,24,51
Coleraine,6337,3,12,11,7,50,37,13,47
Crusaders,6337,4,13,7,10,48,37,11,46
Dungannon,6337,5,12,9,9,53,42,11,45
Glenavon,6337,6,11,12,7,47,47,0,45
Ballymena,6337,7,12,6,12,57,60,-3,42
Glentoran,6337,8,12,5,13,28,41,-13,41
Ballinamalla,6337,9,10,3,17,28,44,-16,33
Portadown,6337,10,7,6,17,26,46,-20,27
Ards,6337,11,7,3,20,34,56,-22,24
Crusaders,6338,1,18,6,6,56,35,21,60
Linfield,6338,2,16,7,7,60,29,31,55
Ballymena,6338,3,14,9,7,61,58,3,51
Coleraine,6338,4,13,11,6,47,34,13,50
Cliftonville,6338,5,15,5,10,55,44,11,50
Glentoran,6338,6,11,8,11,33,41,-8,41
Dungannon,6338,7,10,8,12,49,44,5,38
Glenavon,6338,8,9,11,10,47,51,-4,38
Portadown,6338,9,8,3,19,24,47,-23,27
Ards,6338,10,6,7,17,34,57,-23,25
Ballinamalla,6338,11,5,5,20,30,56,-26,20
Linfield,6339,1,18,8,4,65,29,36,62
Crusaders,6339,2,18,7,5,59,34,25,61
Cliftonville,6339,3,13,8,9,50,38,12,47
Coleraine,6339,4,12,9,9,49,46,3,45
Ballymena,6339,5,13,5,12,51,58,-7,44
Glentoran,6339,6,12,7,11,36,38,-2,43
Glenavon,6339,7,9,10,11,54,59,-5,37
Ballinamalla,6339,8,8,7,15,31,51,-20,31
Dungannon,6339,9,7,9,14,46,51,-5,30
Ards,6339,10,7,6,17,29,45,-16,27
Portadown,6339,11,7,6,17,28,49,-21,27
Crusaders,6340,1,17,6,7,60,37,23,57
Linfield,6340,2,15,9,6,58,37,21,54
Ballymena,6340,3,16,5,9,61,58,3,53
Glenavon,6340,4,13,11,6,60,47,13,50
Coleraine,6340,5,13,9,8,43,36,7,48
Dungannon,6340,6,13,8,9,55,42,13,47
Cliftonville,6340,7,13,7,10,54,42,12,46
Glentoran,6340,8,9,6,15,36,47,-11,33
Ards,6340,9,8,4,18,37,57,-20,28
Ballinamalla,6340,10,7,2,21,23,56,-33,23
Portadown,6340,11,5,5,20,18,46,-28,20
Crusaders,6341,1,17,7,6,68,39,29,58
Linfield,6341,2,15,7,8,58,33,25,52
Ballymena,6341,3,14,5,11,57,60,-3,47
Cliftonville,6341,4,14,4,12,61,46,15,46
Dungannon,6341,5,12,9,9,57,46,11,45
Glenavon,6341,6,11,12,7,48,49,-1,45
Coleraine,6341,7,12,8,10,39,38,1,44
Ards,6341,8,9,5,16,37,50,-13,32
Ballinamalla,6341,9,9,4,17,31,55,-24,31
Glentoran,6341,10,8,6,16,27,44,-17,30
Portadown,6341,11,7,7,16,22,45,-23,28
Crusaders,6342,1,15,10,5,57,35,22,55
Linfield,6342,2,15,9,6,62,32,30,54
Glenavon,6342,3,14,10,6,55,40,15,52
Ballymena,6342,4,13,9,8,62,61,1,48
Cliftonville,6342,5,12,6,12,51,46,5,42
Dungannon,6342,6,11,8,11,48,46,2,41
Coleraine,6342,7,10,11,9,35,40,-5,41
Glentoran,6342,8,9,6,15,31,43,-12,33
Portadown,6342,9,8,7,15,33,53,-20,31
Ards,6342,10,7,7,16,30,47,-17,28
Ballinamalla,6342,11,7,5,18,33,54,-21,26
Cliftonville,6343,1,16,6,8,62,37,25,54
Ballymena,6343,2,14,10,6,60,52,8,52
Linfield,6343,3,14,9,7,57,33,24,51
Crusaders,6343,4,14,6,10,44,39,5,48
Coleraine,6343,5,12,11,7,43,35,8,47
Dungannon,6343,6,10,11,9,48,41,7,41
Glentoran,6343,7,11,8,11,40,43,-3,41
Glenavon,6343,8,8,11,11,46,52,-6,35
Ards,6343,9,9,5,16,38,54,-16,32
Ballinamalla,6343,10,9,3,18,34,52,-18,30
Portadown,6343,11,6,4,20,22,56,-34,22
Cliftonville,6344,1,19,3,8,55,34,21,60
Crusaders,6344,2,16,7,7,54,36,18,55
Linfield,6344,3,14,11,5,69,34,35,53
Glenavon,6344,4,12,12,6,50,39,11,48
Ards,6344,5,13,6,11,36,39,-3,45
Ballymena,6344,6,13,6,11,48,58,-10,45
Glentoran,6344,7,10,8,12,32,40,-8,38
Coleraine,6344,8,8,11,11,42,43,-1,35
Dungannon,6344,9,9,7,14,45,52,-7,34
Ballinamalla,6344,10,7,4,19,28,55,-27,25
Portadown,6344,11,3,7,20,17,46,-29,16
Linfield,6345,1,16,8,6,59,32,27,56
Crusaders,6345,2,14,9,7,55,35,20,51
Ballymena,6345,3,14,9,7,55,51,4,51
Cliftonville,6345,4,13,7,10,51,42,9,46
Coleraine,6345,5,12,10,8,45,36,9,46
Glenavon,6345,6,11,11,8,49,45,4,44
Ards,6345,7,11,5,14,38,45,-7,38
Dungannon,6345,8,9,10,11,52,49,3,37
Glentoran,6345,9,8,7,15,27,44,-17,31
Portadown,6345,10,6,9,15,31,51,-20,27
Ballinamalla,6345,11,6,5,19,25,57,-32,23
Cliftonville,6346,1,16,7,7,53,34,19,55
Crusaders,6346,2,13,9,8,52,39,13,48
Linfield,6346,3,12,11,7,58,31,27,47
Ballymena,6346,4,14,5,11,57,62,-5,47
Coleraine,6346,5,11,11,8,53,46,7,44
Glenavon,6346,6,11,11,8,47,50,-3,44
Glentoran,6346,7,10,8,12,32,46,-14,38
Ards,6346,8,10,5,15,42,52,-10,35
Dungannon,6346,9,7,10,13,47,48,-1,31
Portadown,6346,10,7,9,14,24,40,-16,30
Ballinamalla,6346,11,7,8,15,32,49,-17,29
Crusaders,6347,1,19,5,6,53,30,23,62
Linfield,6347,2,15,9,6,60,27,33,54
Cliftonville,6347,3,15,6,9,52,40,12,51
Dungannon,6347,4,13,7,10,54,41,13,46
Ballymena,6347,5,13,7,10,56,55,1,46
Glenavon,6347,6,12,8,10,45,48,-3,44
Coleraine,6347,7,9,11,10,38,40,-2,38
Ards,6347,8,9,5,16,35,49,-14,32
Glentoran,6347,9,9,5,16,30,44,-14,32
Portadown,6347,10,8,6,16,24,45,-21,30
Ballinamalla,6347,11,8,1,21,31,59,-28,25
Crusaders,6348,1,18,8,4,58,27,31,62
Linfield,6348,2,15,7,8,66,31,35,52
Cliftonville,6348,3,14,6,10,50,42,8,48
Coleraine,6348,4,13,9,8,44,36,8,48
Ballymena,6348,5,13,9,8,59,57,2,48
Glenavon,6348,6,10,13,7,44,41,3,43
Dungannon,6348,7,10,8,12,52,46,6,38
Ards,6348,8,9,6,15,42,59,-17,33
Portadown,6348,9,9,2,19,30,52,-22,29
Ballinamalla,6348,10,8,3,19,25,52,-27,27
Glentoran,6348,11,5,11,14,29,56,-27,26
Crusaders,6349,1,19,6,5,58,31,27,63
Coleraine,6349,2,16,9,5,56,32,24,57
Ballymena,6349,3,13,8,9,54,56,-2,47
Linfield,6349,4,11,11,8,52,35,17,44
Glenavon,6349,5,11,11,8,43,45,-2,44
Cliftonville,6349,6,13,4,13,43,38,5,43
Dungannon,6349,7,10,8,12,52,50,2,38
Ards,6349,8,10,8,12,45,49,-4,38
Portadown,6349,9,7,7,16,25,43,-18,28
Ballinamalla,6349,10,8,4,18,30,52,-22,28
Glentoran,6349,11,4,10,16,28,55,-27,22
Crusaders,6350,1,16,6,8,53,37,16,54
Linfield,6350,2,14,9,7,57,35,22,51
Cliftonville,6350,3,13,6,11,53,43,10,45
Ballymena,6350,4,13,6,11,54,64,-10,45
Coleraine,6350,5,11,10,9,40,39,1,43
Glenavon,6350,6,10,12,8,44,42,2,42
Dungannon,6350,7,10,9,11,50,46,4,39
Ballinamalla,6350,8,11,4,15,38,43,-5,37
Portadown,6350,9,9,6,15,31,41,-10,33
Ards,6350,10,9,6,15,34,46,-12,33
Glentoran,6350,11,8,8,14,27,45,-18,32
Crusaders,6351,1,18,5,7,55,30,25,59
Linfield,6351,2,14,10,6,63,30,33,52
Coleraine,6351,3,14,10,6,42,36,6,52
Ballymena,6351,4,14,8,8,63,57,6,50
Cliftonville,6351,5,13,5,12,47,47,0,44
Glenavon,6351,6,11,9,10,53,47,6,42
Dungannon,6351,7,10,8,12,54,44,10,38
Portadown,6351,8,11,4,15,33,46,-13,37
Ards,6351,9,10,5,15,38,47,-9,35
Glentoran,6351,10,5,10,15,21,46,-25,25
Ballinamalla,6351,11,4,8,18,23,62,-39,20
Crusaders,6352,1,16,7,7,54,42,12,55
Linfield,6352,2,15,8,7,56,30,26,53
Cliftonville,6352,3,16,5,9,52,33,19,53
Glenavon,6352,4,13,11,6,57,47,10,50
Ballymena,6352,5,14,6,10,58,57,1,48
Glentoran,6352,6,11,6,13,39,45,-6,39
Dungannon,6352,7,9,10,11,44,42,2,37
Coleraine,6352,8,9,9,12,39,50,-11,36
Portadown,6352,9,9,3,18,27,45,-18,30
Ards,6352,10,7,7,16,41,56,-15,28
Ballinamalla,6352,11,7,6,17,32,52,-20,27
Linfield,6353,1,16,10,4,65,31,34,58
Crusaders,6353,2,15,9,6,49,33,16,54
Cliftonville,6353,3,16,5,9,56,40,16,53
Ballymena,6353,4,13,8,9,60,59,1,47
Coleraine,6353,5,11,10,9,39,45,-6,43
Dungannon,6353,6,10,11,9,52,43,9,41
Glenavon,6353,7,10,11,9,50,45,5,41
Ballinamalla,6353,8,10,4,16,32,45,-13,34
Glentoran,6353,9,8,7,15,33,49,-16,31
Portadown,6353,10,8,5,17,30,48,-18,29
Ards,6353,11,5,6,19,27,55,-28,21
Crusaders,6354,1,16,11,3,61,33,28,59
Cliftonville,6354,2,14,8,8,57,42,15,50
Ballymena,6354,3,12,9,9,59,58,1,45
Linfield,6354,4,11,11,8,57,40,17,44
Glenavon,6354,5,10,13,7,51,48,3,43
Coleraine,6354,6,10,11,9,45,44,1,41
Ards,6354,7,12,5,13,47,54,-7,41
Dungannon,6354,8,9,10,11,53,51,2,37
Glentoran,6354,9,6,12,12,27,42,-15,30
Ballinamalla,6354,10,7,7,16,28,51,-23,28
Portadown,6354,11,6,7,17,27,49,-22,25
Crusaders,6355,1,16,7,7,58,34,24,55
Linfield,6355,2,16,6,8,64,43,21,54
Ballymena,6355,3,15,7,8,57,49,8,52
Coleraine,6355,4,13,9,8,42,34,8,48
Glenavon,6355,5,13,9,8,54,52,2,48
Cliftonville,6355,6,14,5,11,64,46,18,47
Dungannon,6355,7,12,9,9,53,43,10,45
Glentoran,6355,8,6,10,14,33,56,-23,28
Ards,6355,9,7,6,17,34,53,-19,27
Portadown,6355,10,6,7,17,25,49,-24,25
Ballinamalla,6355,11,5,9,16,25,50,-25,24
Crusaders,6356,1,18,9,3,53,25,28,63
Linfield,6356,2,16,8,6,61,35,26,56
Cliftonville,6356,3,16,4,10,62,47,15,52
Coleraine,6356,4,12,9,9,45,38,7,45
Ballymena,6356,5,12,7,11,56,61,-5,43
Glenavon,6356,6,11,9,10,51,47,4,42
Glentoran,6356,7,10,8,12,31,44,-13,38
Dungannon,6356,8,8,8,14,43,47,-4,32
Ards,6356,9,8,6,16,34,47,-13,30
Ballinamalla,6356,10,8,5,17,30,51,-21,29
Portadown,6356,11,8,3,19,27,51,-24,27
Crusaders,6357,1,17,9,4,57,27,30,60
Linfield,6357,2,16,8,6,65,33,32,56
Ballymena,6357,3,15,6,9,61,62,-1,51
Cliftonville,6357,4,13,9,8,61,42,19,48
Glenavon,6357,5,11,11,8,50,47,3,44
Coleraine,6357,6,11,10,9,42,42,0,43
Ards,6357,7,9,9,12,37,42,-5,36
Dungannon,6357,8,8,9,13,47,48,-1,33
Ballinamalla,6357,9,9,6,15,35,52,-17,33
Glentoran,6357,10,7,6,17,18,43,-25,27
Portadown,6357,11,4,7,19,22,57,-35,19
Crusaders,6358,1,15,11,4,57,28,29,56
Ballymena,6358,2,16,6,8,66,59,7,54
Linfield,6358,3,13,11,6,55,39,16,50
Glenavon,6358,4,12,10,8,44,43,1,46
Cliftonville,6358,5,12,5,13,54,50,4,41
Coleraine,6358,6,9,12,9,40,38,2,39
Dungannon,6358,7,8,13,9,45,38,7,37
Ards,6358,8,10,5,15,40,53,-13,35
Glentoran,6358,9,9,8,13,28,42,-14,35
Portadown,6358,10,8,6,16,29,45,-16,30
Ballinamalla,6358,11,8,3,19,27,50,-23,27
Cliftonville,6359,1,18,4,8,54,30,24,58
Crusaders,6359,2,17,7,6,49,30,19,58
Linfield,6359,3,14,9,7,59,38,21,51
Ballymena,6359,4,14,8,8,61,51,10,50
Glenavon,6359,5,12,12,6,49,39,10,48
Coleraine,6359,6,10,10,10,39,40,-1,40
Dungannon,6359,7,9,12,9,49,39,10,39
Ards,6359,8,9,6,15,31,48,-17,33
Glentoran,6359,9,6,11,13,32,50,-18,29
Ballinamalla,6359,10,7,4,19,33,56,-23,25
Portadown,6359,11,3,9,18,17,52,-35,18
Crusaders,6360,1,17,7,6,59,37,22,58
Linfield,6360,2,15,10,5,61,28,33,55
Cliftonville,6360,3,17,4,9,60,39,21,55
Glenavon,6360,4,12,9,9,53,48,5,45
Ballymena,6360,5,13,6,11,52,56,-4,45
Coleraine,6360,6,11,10,9,45,44,1,43
Glentoran,6360,7,8,9,13,32,45,-13,33
Dungannon,6360,8,7,10,13,44,49,-5,31
Portadown,6360,9,8,7,15,23,44,-21,31
Ballinamalla,6360,10,7,7,16,35,64,-29,28
Ards,6360,11,6,9,15,38,48,-10,27
Cliftonville,6361,1,16,7,7,54,38,16,55
Crusaders,6361,2,14,10,6,48,32,16,52
Linfield,6361,3,13,12,5,58,32,26,51
Coleraine,6361,4,11,11,8,41,35,6,44
Ballymena,6361,5,12,7,11,57,54,3,43
Glentoran,6361,6,10,8,12,35,46,-11,38
Glenavon,6361,7,8,13,9,42,45,-3,37
Dungannon,6361,8,8,12,10,45,45,0,36
Ards,6361,9,10,4,16,41,50,-9,34
Ballinamalla,6361,10,10,3,17,31,48,-17,33
Portadown,6361,11,6,7,17,21,48,-27,25
Crusaders,6362,1,17,10,3,62,28,34,61
Cliftonville,6362,2,16,6,8,50,43,7,54
Coleraine,6362,3,13,11,6,46,33,13,50
Linfield,6362,4,13,9,8,62,41,21,48
Glenavon,6362,5,12,9,9,46,46,0,45
Ballymena,6362,6,11,5,14,50,59,-9,38
Dungannon,6362,7,8,13,9,46,42,4,37
Ards,6362,8,10,6,14,43,51,-8,36
Glentoran,6362,9,9,8,13,33,41,-8,35
Portadown,6362,10,8,5,17,26,48,-22,29
Ballinamalla,6362,11,5,4,21,23,55,-32,19
Crusaders,6363,1,20,6,4,65,36,29,66
Cliftonville,6363,2,16,4,10,56,41,15,52
Linfield,6363,3,13,9,8,56,39,17,48
Glenavon,6363,4,12,10,8,54,45,9,46
Ballymena,6363,5,11,8,11,61,62,-1,41
Glentoran,6363,6,11,8,11,38,48,-10,41
Dungannon,6363,7,9,10,11,49,48,1,37
Coleraine,6363,8,9,10,11,41,47,-6,37
Ards,6363,9,10,4,16,36,48,-12,34
Ballinamalla,6363,10,10,3,17,35,50,-15,33
Portadown,6363,11,6,4,20,24,51,-27,22
Crusaders,6364,1,16,7,7,53,39,14,55
Ballymena,6364,2,14,9,7,65,58,7,51
Linfield,6364,3,12,12,6,55,30,25,48
Glenavon,6364,4,12,12,6,50,41,9,48
Coleraine,6364,5,12,11,7,39,36,3,47
Cliftonville,6364,6,13,6,11,45,40,5,45
Dungannon,6364,7,10,10,10,47,40,7,40
Glentoran,6364,8,8,9,13,28,42,-14,33
Portadown,6364,9,8,7,15,30,46,-16,31
Ards,6364,10,6,9,15,29,43,-14,27
Ballinamalla,6364,11,4,8,18,28,54,-26,20
Cliftonville,6365,1,15,5,10,51,36,15,50
Dungannon,6365,2,13,9,8,60,41,19,48
Glenavon,6365,3,13,9,8,52,42,10,48
Coleraine,6365,4,13,9,8,43,42,1,48
Crusaders,6365,5,13,8,9,53,41,12,47
Ballymena,6365,6,13,8,9,60,58,2,47
Linfield,6365,7,11,13,6,54,30,24,46
Ards,6365,8,12,4,14,32,42,-10,40
Glentoran,6365,9,8,9,13,38,52,-14,33
Ballinamalla,6365,10,6,5,19,24,51,-27,23
Portadown,6365,11,5,7,18,21,53,-32,22
Crusaders,6366,1,18,9,3,56,32,24,63
Linfield,6366,2,15,11,4,66,37,29,56
Cliftonville,6366,3,16,4,10,55,36,19,52
Ballymena,6366,4,14,8,8,63,53,10,50
Glenavon,6366,5,11,12,7,47,44,3,45
Dungannon,6366,6,10,10,10,49,42,7,40
Coleraine,6366,7,10,10,10,38,36,2,40
Glentoran,6366,8,9,8,13,35,49,-14,35
Ards,6366,9,7,6,17,35,53,-18,27
Ballinamalla,6366,10,7,4,19,23,52,-29,25
Portadown,6366,11,5,4,21,21,54,-33,19
Linfield,6367,1,16,8,6,59,28,31,56
Cliftonville,6367,2,16,4,10,49,33,16,52
Crusaders,6367,3,14,9,7,58,44,14,51
Coleraine,6367,4,12,12,6,43,36,7,48
Glenavon,6367,5,12,12,6,52,47,5,48
Ballymena,6367,6,14,3,13,61,64,-3,45
Dungannon,6367,7,8,11,11,43,41,2,35
Ballinamalla,6367,8,10,3,17,34,50,-16,33
Glentoran,6367,9,8,8,14,30,45,-15,32
Ards,6367,10,8,4,18,41,57,-16,28
Portadown,6367,11,7,6,17,23,48,-25,27
Linfield,6368,1,15,11,4,60,31,29,56
Cliftonville,6368,2,15,7,8,62,48,14,52
Crusaders,6368,3,14,7,9,62,45,17,49
Ballymena,6368,4,14,7,9,63,61,2,49
Glenavon,6368,5,13,8,9,46,40,6,47
Dungannon,6368,6,12,8,10,51,43,8,44
Coleraine,6368,7,9,10,11,38,41,-3,37
Ards,6368,8,9,8,13,33,45,-12,35
Ballinamalla,6368,9,9,7,14,39,52,-13,34
Glentoran,6368,10,6,8,16,25,47,-22,26
Portadown,6368,11,4,9,17,21,47,-26,21
Linfield,6369,1,14,10,6,66,33,33,52
Crusaders,6369,2,14,9,7,51,38,13,51
Cliftonville,6369,3,14,5,11,53,46,7,47
Coleraine,6369,4,11,13,6,44,34,10,46
Glenavon,6369,5,11,11,8,50,41,9,44
Dungannon,6369,6,10,12,8,51,43,8,42
Ballymena,6369,7,11,9,10,61,67,-6,42
Glentoran,6369,8,9,8,13,31,47,-16,35
Ards,6369,9,10,4,16,43,57,-14,34
Ballinamalla,6369,10,9,3,18,33,53,-20,30
Portadown,6369,11,7,6,17,23,47,-24,27
Linfield,6370,1,15,11,4,59,30,29,56
Ballymena,6370,2,16,6,8,59,54,5,54
Crusaders,6370,3,15,8,7,56,36,20,53
Cliftonville,6370,4,15,3,12,48,43,5,48
Glenavon,6370,5,12,11,7,53,43,10,47
Coleraine,6370,6,10,10,10,36,37,-1,40
Glentoran,6370,7,9,11,10,34,38,-4,38
Dungannon,6370,8,8,11,11,47,42,5,35
Ards,6370,9,7,8,15,32,48,-16,29
Portadown,6370,10,8,4,18,23,45,-22,28
Ballinamalla,6370,11,5,7,18,26,57,-31,22
Crusaders,6371,1,17,7,6,59,30,29,58
Cliftonville,6371,2,14,8,8,52,40,12,50
Ballymena,6371,3,14,7,9,61,58,3,49
Linfield,6371,4,12,9,9,51,37,14,45
Coleraine,6371,5,10,11,9,41,37,4,41
Glenavon,6371,6,10,10,10,44,45,-1,40
Glentoran,6371,7,9,12,9,35,39,-4,39
Ards,6371,8,9,7,14,37,51,-14,34
Portadown,6371,9,9,6,15,26,44,-18,33
Ballinamalla,6371,10,7,9,14,26,43,-17,30
Dungannon,6371,11,7,8,15,44,52,-8,29
Crusaders,6372,1,17,6,7,62,35,27,57
Linfield,6372,2,16,8,6,59,30,29,56
Ballymena,6372,3,15,7,8,66,59,7,52
Glenavon,6372,4,14,8,8,47,40,7,50
Coleraine,6372,5,13,9,8,50,39,11,48
Cliftonville,6372,6,14,6,10,52,43,9,48
Ards,6372,7,11,5,14,42,47,-5,38
Dungannon,6372,8,8,10,12,43,46,-3,34
Glentoran,6372,9,6,7,17,26,55,-29,25
Ballinamalla,6372,10,7,4,19,26,56,-30,25
Portadown,6372,11,5,8,17,29,52,-23,23
Crusaders,6373,1,19,5,6,55,32,23,62
Linfield,6373,2,14,9,7,57,32,25,51
Glenavon,6373,3,14,8,8,49,40,9,50
Cliftonville,6373,4,13,6,11,47,37,10,45
Ballymena,6373,5,12,7,11,55,56,-1,43
Coleraine,6373,6,10,9,11,38,45,-7,39
Ards,6373,7,11,5,14,41,49,-8,38
Dungannon,6373,8,9,9,12,46,46,0,36
Glentoran,6373,9,9,9,12,31,41,-10,36
Portadown,6373,10,8,10,12,22,36,-14,34
Ballinamalla,6373,11,6,3,21,25,52,-27,21
Linfield,6374,1,15,8,7,64,35,29,53
Cliftonville,6374,2,15,8,7,53,39,14,53
Crusaders,6374,3,15,5,10,52,38,14,50
Glenavon,6374,4,13,9,8,49,44,5,48
Ballymena,6374,5,13,8,9,65,63,2,47
Coleraine,6374,6,10,10,10,45,44,1,40
Ballinamalla,6374,7,10,6,14,35,46,-11,36
Dungannon,6374,8,8,10,12,40,45,-5,34
Glentoran,6374,9,9,7,14,41,55,-14,34
Portadown,6374,10,8,6,16,29,51,-22,30
Ards,6374,11,7,7,16,36,49,-13,28
Crusaders,6375,1,17,5,8,57,38,19,56
Linfield,6375,2,15,8,7,56,29,27,53
Glenavon,6375,3,13,10,7,50,43,7,49
Cliftonville,6375,4,15,3,12,45,44,1,48
Ballymena,6375,5,13,6,11,57,56,1,45
Coleraine,6375,6,11,10,9,48,43,5,43
Dungannon,6375,7,10,8,12,49,44,5,38
Ards,6375,8,10,5,15,40,48,-8,35
Glentoran,6375,9,9,7,14,29,42,-13,34
Portadown,6375,10,9,5,16,30,48,-18,32
Ballinamalla,6375,11,9,1,20,29,55,-26,28
Linfield,6376,1,16,9,5,65,32,33,57
Cliftonville,6376,2,16,6,8,55,33,22,54
Crusaders,6376,3,14,9,7,51,37,14,51
Coleraine,6376,4,11,11,8,47,46,1,44
Glenavon,6376,5,11,10,9,46,44,2,43
Ballymena,6376,6,12,6,12,56,64,-8,42
Dungannon,6376,7,9,9,12,51,49,2,36
Glentoran,6376,8,10,6,14,39,50,-11,36
Ballinamalla,6376,9,11,3,16,32,50,-18,36
Ards,6376,10,9,5,16,44,59,-15,32
Portadown,6376,11,6,6,18,30,52,-22,24
Cliftonville,6377,1,16,6,8,50,34,16,54
Crusaders,6377,2,15,8,7,59,40,19,53
Ballymena,6377,3,16,5,9,58,53,5,53
Linfield,6377,4,14,9,7,60,35,25,51
Coleraine,6377,5,12,10,8,44,39,5,46
Glenavon,6377,6,11,11,8,47,44,3,44
Glentoran,6377,7,11,5,14,34,45,-11,38
Dungannon,6377,8,9,8,13,44,48,-4,35
Ards,6377,9,10,3,17,37,50,-13,33
Ballinamalla,6377,10,8,4,18,32,50,-18,28
Portadown,6377,11,6,5,19,25,52,-27,23
Linfield,6378,1,14,10,6,55,32,23,52
Cliftonville,6378,2,14,7,9,54,39,15,49
Crusaders,6378,3,14,7,9,50,36,14,49
Glenavon,6378,4,13,8,9,49,41,8,47
Ballymena,6378,5,13,8,9,58,58,0,47
Coleraine,6378,6,12,7,11,46,53,-7,43
Dungannon,6378,7,10,8,12,57,49,8,38
Ards,6378,8,11,5,14,40,47,-7,38
Portadown,6378,9,9,6,15,25,48,-23,33
Glentoran,6378,10,7,11,12,29,39,-10,32
Ballinamalla,6378,11,8,3,19,33,54,-21,27
Cliftonville,6379,1,18,3,9,57,36,21,57
Crusaders,6379,2,15,9,6,54,36,18,54
Coleraine,6379,3,13,10,7,46,32,14,49
Ballymena,6379,4,13,7,10,60,61,-1,46
Dungannon,6379,5,10,11,9,46,40,6,41
Linfield,6379,6,11,7,12,52,44,8,40
Glenavon,6379,7,8,12,10,41,47,-6,36
Ballinamalla,6379,8,10,4,16,32,46,-14,34
Ards,6379,9,8,9,13,40,52,-12,33
Portadown,6379,10,10,3,17,32,51,-19,33
Glentoran,6379,11,8,7,15,32,47,-15,31
Linfield,6380,1,16,8,6,60,37,23,56
Ballymena,6380,2,16,4,10,57,53,4,52
Cliftonville,6380,3,16,3,11,61,42,19,51
Crusaders,6380,4,13,11,6,52,37,15,50
Coleraine,6380,5,11,12,7,37,31,6,45
Dungannon,6380,6,11,9,10,51,38,13,42
Glenavon,6380,7,10,12,8,41,45,-4,42
Ards,6380,8,10,6,14,39,46,-7,36
Ballinamalla,6380,9,10,5,15,38,48,-10,35
Portadown,6380,10,7,4,19,22,50,-28,25
Glentoran,6380,11,5,6,19,29,60,-31,21
Linfield,6381,1,16,10,4,61,32,29,58
Crusaders,6381,2,15,9,6,58,36,22,54
Cliftonville,6381,3,13,11,6,53,39,14,50
Glenavon,6381,4,11,11,8,57,51,6,44
Coleraine,6381,5,11,11,8,46,43,3,44
Ballymena,6381,6,11,9,10,55,57,-2,42
Dungannon,6381,7,11,8,11,60,51,9,41
Ards,6381,8,9,8,13,40,48,-8,35
Glentoran,6381,9,7,8,15,25,46,-21,29
Ballinamalla,6381,10,8,4,18,33,55,-22,28
Portadown,6381,11,6,5,19,20,50,-30,23
Crusaders,6382,1,18,8,4,65,33,32,62
Cliftonville,6382,2,17,5,8,57,36,21,56
Linfield,6382,3,15,9,6,66,33,33,54
Ballymena,6382,4,12,9,9,60,66,-6,45
Dungannon,6382,5,11,9,10,53,38,15,42
Glentoran,6382,6,11,8,11,39,48,-9,41
Coleraine,6382,7,9,11,10,39,45,-6,38
Glenavon,6382,8,7,13,10,41,49,-8,34
Ards,6382,9,8,5,17,34,55,-21,29
Ballinamalla,6382,10,6,6,18,26,51,-25,24
Portadown,6382,11,5,9,16,20,46,-26,24
Ballymena,6383,1,17,4,9,66,50,16,55
Linfield,6383,2,14,12,4,54,26,28,54
Crusaders,6383,3,16,6,8,60,43,17,54
Cliftonville,6383,4,15,4,11,53,42,11,49
Glenavon,6383,5,13,10,7,46,40,6,49
Ards,6383,6,11,7,12,40,40,0,40
Dungannon,6383,7,9,11,10,55,52,3,38
Coleraine,6383,8,9,9,12,36,40,-4,36
Glentoran,6383,9,8,8,14,27,42,-15,32
Ballinamalla,6383,10,9,2,19,28,58,-30,29
Portadown,6383,11,5,5,20,22,54,-32,20
Cliftonville,6384,1,18,5,7,64,41,23,59
Linfield,6384,2,13,11,6,66,33,33,50
Dungannon,6384,3,13,9,8,61,39,22,48
Glenavon,6384,4,12,9,9,50,48,2,45
Crusaders,6384,5,12,7,11,51,46,5,43
Ballymena,6384,6,12,7,11,54,63,-9,43
Coleraine,6384,7,10,11,9,44,40,4,41
Glentoran,6384,8,11,7,12,31,39,-8,40
Ards,6384,9,9,7,14,38,50,-12,34
Ballinamalla,6384,10,7,5,18,29,64,-35,26
Portadown,6384,11,5,8,17,26,51,-25,23
Cliftonville,6385,1,16,7,7,59,34,25,55
Linfield,6385,2,13,13,4,54,24,30,52
Glenavon,6385,3,13,12,5,52,40,12,51
Crusaders,6385,4,13,11,6,47,34,13,50
Ballymena,6385,5,13,5,12,58,62,-4,44
Coleraine,6385,6,11,10,9,45,41,4,43
Dungannon,6385,7,10,9,11,50,43,7,39
Glentoran,6385,8,9,7,14,30,48,-18,34
Ards,6385,9,10,3,17,38,52,-14,33
Ballinamalla,6385,10,8,2,20,24,53,-29,26
Portadown,6385,11,5,9,16,19,45,-26,24
Linfield,6386,1,17,7,6,66,31,35,58
Crusaders,6386,2,17,7,6,60,36,24,58
Coleraine,6386,3,12,11,7,41,33,8,47
Cliftonville,6386,4,14,5,11,52,48,4,47
Glenavon,6386,5,11,11,8,44,41,3,44
Ballymena,6386,6,13,5,12,55,60,-5,44
Dungannon,6386,7,9,9,12,48,47,1,36
Ards,6386,8,8,10,12,37,45,-8,34
Glentoran,6386,9,7,10,13,23,42,-19,31
Ballinamalla,6386,10,7,8,15,30,48,-18,29
Portadown,6386,11,6,5,19,21,46,-25,23
Crusaders,6387,1,14,11,5,53,33,20,53
Coleraine,6387,2,13,12,5,50,30,20,51
Cliftonville,6387,3,15,5,10,54,38,16,50
Linfield,6387,4,11,11,8,51,39,12,44
Ballymena,6387,5,12,8,10,50,60,-10,44
Ballinamalla,6387,6,12,4,14,35,43,-8,40
Dungannon,6387,7,9,10,11,51,50,1,37
Glentoran,6387,8,10,7,13,33,42,-9,37
Glenavon,6387,9,9,9,12,44,49,-5,36
Portadown,6387,10,7,8,15,24,41,-17,29
Ards,6387,11,7,7,16,30,50,-20,28
Cliftonville,6388,1,19,4,7,60,33,27,61
Crusaders,6388,2,16,7,7,59,34,25,55
Coleraine,6388,3,14,10,6,43,29,14,52
Ballymena,6388,4,13,7,10,51,54,-3,46
Linfield,6388,5,11,11,8,50,30,20,44
Glentoran,6388,6,13,5,12,36,43,-7,44
Glenavon,6388,7,10,11,9,44,41,3,41
Ballinamalla,6388,8,10,4,16,33,53,-20,34
Dungannon,6388,9,7,10,13,42,45,-3,31
Ards,6388,10,8,4,18,34,57,-23,28
Portadown,6388,11,6,3,21,25,58,-33,21
Crusaders,6389,1,17,8,5,55,32,23,59
Cliftonville,6389,2,17,2,11,56,44,12,53
Linfield,6389,3,14,8,8,62,46,16,50
Glenavon,6389,4,13,10,7,54,45,9,49
Ballymena,6389,5,13,6,11,54,59,-5,45
Coleraine,6389,6,10,11,9,43,38,5,41
Dungannon,6389,7,10,9,11,52,44,8,39
Ballinamalla,6389,8,10,6,14,35,47,-12,36
Ards,6389,9,9,5,16,39,49,-10,32
Glentoran,6389,10,8,6,16,27,49,-22,30
Portadown,6389,11,6,5,19,25,49,-24,23
Crusaders,6390,1,16,8,6,64,39,25,56
Linfield,6390,2,14,12,4,63,31,32,54
Glenavon,6390,3,13,12,5,61,40,21,51
Dungannon,6390,4,11,10,9,48,41,7,43
Cliftonville,6390,5,13,4,13,49,50,-1,43
Ballymena,6390,6,11,8,11,54,64,-10,41
Coleraine,6390,7,10,10,10,39,46,-7,40
Glentoran,6390,8,9,7,14,33,44,-11,34
Ards,6390,9,9,4,17,40,53,-13,31
Portadown,6390,10,8,7,15,27,46,-19,31
Ballinamalla,6390,11,8,4,18,28,52,-24,28
Crusaders,6391,1,19,5,6,62,38,24,62
Linfield,6391,2,16,10,4,60,25,35,58
Glenavon,6391,3,11,13,6,51,42,9,46
Cliftonville,6391,4,13,7,10,51,44,7,46
Dungannon,6391,5,11,8,11,55,44,11,41
Glentoran,6391,6,10,8,12,30,42,-12,38
Ballymena,6391,7,9,10,11,45,60,-15,37
Coleraine,6391,8,9,9,12,40,42,-2,36
Ballinamalla,6391,9,10,3,17,32,47,-15,33
Ards,6391,10,7,7,16,34,52,-18,28
Portadown,6391,11,7,6,17,21,45,-24,27
Crusaders,6392,1,16,8,6,50,30,20,56
Ballymena,6392,2,14,6,10,61,60,1,48
Cliftonville,6392,3,14,5,11,63,54,9,47
Coleraine,6392,4,11,12,7,46,34,12,45
Linfield,6392,5,11,11,8,55,38,17,44
Glenavon,6392,6,10,12,8,48,48,0,42
Ballinamalla,6392,7,11,2,17,32,48,-16,35
Dungannon,6392,8,8,10,12,53,54,-1,34
Glentoran,6392,9,8,10,12,31,42,-11,34
Portadown,6392,10,10,4,16,28,47,-19,34
Ards,6392,11,9,6,15,36,48,-12,33
Crusaders,6393,1,17,9,4,61,34,27,60
Linfield,6393,2,16,9,5,63,27,36,57
Cliftonville,6393,3,15,5,10,52,42,10,50
Coleraine,6393,4,14,8,8,42,34,8,50
Ballymena,6393,5,13,7,10,50,50,0,46
Glenavon,6393,6,11,11,8,46,44,2,44
Dungannon,6393,7,8,11,11,49,49,0,35
Ballinamalla,6393,8,9,6,15,32,51,-19,33
Ards,6393,9,8,5,17,39,54,-15,29
Glentoran,6393,10,8,5,17,30,51,-21,29
Portadown,6393,11,5,6,19,23,51,-28,21
Linfield,6394,1,18,8,4,66,30,36,62
Crusaders,6394,2,18,5,7,58,34,24,59
Cliftonville,6394,3,15,4,11,60,44,16,49
Coleraine,6394,4,12,12,6,46,39,7,48
Glenavon,6394,5,12,10,8,51,46,5,46
Dungannon,6394,6,11,6,13,55,45,10,39
Ballymena,6394,7,11,6,13,58,70,-12,39
Ballinamalla,6394,8,10,2,18,29,56,-27,32
Portadown,6394,9,9,3,18,24,51,-27,30
Ards,6394,10,8,5,17,38,50,-12,29
Glentoran,6394,11,6,9,15,27,47,-20,27
Crusaders,6395,1,19,8,3,62,28,34,65
Linfield,6395,2,16,8,6,58,26,32,56
Ballymena,6395,3,16,5,9,61,62,-1,53
Cliftonville,6395,4,15,7,8,52,41,11,52
Coleraine,6395,5,11,8,11,43,44,-1,41
Dungannon,6395,6,10,9,11,53,43,10,39
Glenavon,6395,7,9,10,11,49,51,-2,37
Portadown,6395,8,8,5,17,26,43,-17,29
Ards,6395,9,8,5,17,37,55,-18,29
Ballinamalla,6395,10,8,4,18,27,54,-27,28
Glentoran,6395,11,5,11,14,29,50,-21,26
Crusaders,6396,1,19,6,5,63,35,28,63
Ballymena,6396,2,15,8,7,60,54,6,53
Linfield,6396,3,12,13,5,56,35,21,49
Coleraine,6396,4,13,10,7,46,33,13,49
Cliftonville,6396,5,13,7,10,52,48,4,46
Glenavon,6396,6,9,13,8,47,46,1,40
Glentoran,6396,7,10,8,12,28,35,-7,38
Dungannon,6396,8,8,9,13,45,45,0,33
Portadown,6396,9,8,7,15,27,43,-16,31
Ards,6396,10,7,6,17,33,54,-21,27
Ballinamalla,6396,11,5,5,20,29,58,-29,20
Crusaders,6397,1,18,8,4,61,34,27,62
Linfield,6397,2,17,9,4,74,33,41,60
Cliftonville,6397,3,15,6,9,54,44,10,51
Ballymena,6397,4,13,9,8,62,61,1,48
Coleraine,6397,5,12,9,9,37,34,3,45
Glenavon,6397,6,10,11,9,42,41,1,41
Dungannon,6397,7,10,8,12,50,44,6,38
Ballinamalla,6397,8,8,6,16,32,51,-19,30
Glentoran,6397,9,8,6,16,25,50,-25,30
Portadown,6397,10,7,6,17,25,49,-24,27
Ards,6397,11,6,4,20,33,54,-21,22
Linfield,6398,1,14,9,7,62,34,28,51
Cliftonville,6398,2,15,4,11,54,39,15,49
Crusaders,6398,3,13,9,8,50,37,13,48
Coleraine,6398,4,12,11,7,42,36,6,47
Dungannon,6398,5,12,10,8,55,39,16,46
Glenavon,6398,6,11,13,6,47,43,4,46
Ballymena,6398,7,12,7,11,46,58,-12,43
Ards,6398,8,11,5,14,49,52,-3,38
Glentoran,6398,9,9,9,12,35,43,-8,36
Ballinamalla,6398,10,7,5,18,37,60,-23,26
Portadown,6398,11,6,4,20,19,55,-36,22
Crusaders,6399,1,16,8,6,59,39,20,56
Glenavon,6399,2,14,8,8,48,44,4,50
Ballymena,6399,3,14,6,10,59,61,-2,48
Cliftonville,6399,4,12,8,10,49,46,3,44
Portadown,6399,5,12,7,11,27,31,-4,43
Linfield,6399,6,10,12,8,57,43,14,42
Dungannon,6399,7,9,10,11,48,43,5,37
Coleraine,6399,8,8,13,9,38,38,0,37
Ards,6399,9,9,7,14,39,41,-2,34
Glentoran,6399,10,7,9,14,35,51,-16,30
Ballinamalla,6399,11,8,4,18,31,53,-22,28
Crusaders,6400,1,17,8,5,59,33,26,59
Ballymena,6400,2,16,5,9,61,49,12,53
Linfield,6400,3,12,9,9,64,38,26,45
Cliftonville,6400,4,13,6,11,46,42,4,45
Coleraine,6400,5,11,12,7,40,39,1,45
Glenavon,6400,6,11,10,9,43,45,-2,43
Dungannon,6400,7,11,8,11,49,42,7,41
Ards,6400,8,12,5,13,50,51,-1,41
Glentoran,6400,9,10,9,11,30,40,-10,39
Portadown,6400,10,5,7,18,21,52,-31,22
Ballinamalla,6400,11,5,5,20,26,58,-32,20
Linfield,6401,1,16,10,4,63,34,29,58
Crusaders,6401,2,15,7,8,54,48,6,52
Coleraine,6401,3,13,11,6,50,35,15,50
Cliftonville,6401,4,14,4,12,57,41,16,46
Glenavon,6401,5,11,13,6,51,44,7,46
Dungannon,6401,6,10,9,11,48,40,8,39
Ards,6401,7,10,7,13,40,46,-6,37
Ballymena,6401,8,10,6,14,51,64,-13,36
Portadown,6401,9,10,4,16,32,47,-15,34
Glentoran,6401,10,7,10,13,32,52,-20,31
Ballinamalla,6401,11,4,9,17,28,55,-27,21
Crusaders,6402,1,16,8,6,61,35,26,56
Linfield,6402,2,13,10,7,51,31,20,49
Ballymena,6402,3,14,7,9,57,56,1,49
Coleraine,6402,4,13,9,8,42,33,9,48
Cliftonville,6402,5,13,6,11,44,38,6,45
Dungannon,6402,6,11,11,8,52,39,13,44
Glentoran,6402,7,10,8,12,35,47,-12,38
Glenavon,6402,8,8,12,10,40,43,-3,36
Ards,6402,9,8,6,16,37,48,-11,30
Portadown,6402,10,8,5,17,28,47,-19,29
Ballinamalla,6402,11,6,8,16,24,54,-30,26
Crusaders,6403,1,18,6,6,58,33,25,60
Linfield,6403,2,15,10,5,62,30,32,55
Cliftonville,6403,3,15,5,10,51,41,10,50
Glenavon,6403,4,12,12,6,57,49,8,48
Ballymena,6403,5,13,5,12,58,62,-4,44
Dungannon,6403,6,12,7,11,60,46,14,43
Ards,6403,7,9,8,13,48,52,-4,35
Coleraine,6403,8,8,10,12,39,44,-5,34
Glentoran,6403,9,7,10,13,30,49,-19,31
Portadown,6403,10,8,4,18,29,52,-23,28
Ballinamalla,6403,11,6,7,17,27,61,-34,25
Linfield,6404,1,17,7,6,63,31,32,58
Coleraine,6404,2,16,10,4,46,25,21,58
Ballymena,6404,3,16,5,9,61,55,6,53
Crusaders,6404,4,14,8,8,46,33,13,50
Cliftonville,6404,5,13,6,11,50,39,11,45
Glenavon,6404,6,12,9,9,44,45,-1,45
Dungannon,6404,7,8,8,14,43,46,-3,32
Ballinamalla,6404,8,9,5,16,28,48,-20,32
Glentoran,6404,9,8,7,15,29,44,-15,31
Ards,6404,10,7,6,17,37,55,-18,27
Portadown,6404,11,7,5,18,20,46,-26,26
Linfield,6405,1,17,7,6,60,25,35,58
Crusaders,6405,2,17,7,6,53,30,23,58
Cliftonville,6405,3,18,4,8,54,32,22,58
Ballymena,6405,4,16,6,8,69,55,14,54
Glenavon,6405,5,13,10,7,51,43,8,49
Coleraine,6405,6,11,9,10,45,41,4,42
Dungannon,6405,7,9,9,12,44,44,0,36
Portadown,6405,8,8,4,18,24,52,-28,28
Glentoran,6405,9,6,9,15,20,47,-27,27
Ards,6405,10,7,4,19,34,54,-20,25
Ballinamalla,6405,11,6,5,19,24,55,-31,23
Linfield,6406,1,16,6,8,57,32,25,54
Crusaders,6406,2,15,6,9,61,49,12,51
Coleraine,6406,3,11,15,4,40,31,9,48
Cliftonville,6406,4,14,5,11,54,43,11,47
Dungannon,6406,5,12,10,8,49,40,9,46
Ballymena,6406,6,12,7,11,52,57,-5,43
Glenavon,6406,7,9,15,6,46,44,2,42
Glentoran,6406,8,10,6,14,31,42,-11,36
Ards,6406,9,11,2,17,45,46,-1,35
Ballinamalla,6406,10,10,4,16,35,53,-18,34
Portadown,6406,11,5,4,21,24,57,-33,19
Linfield,6407,1,15,8,7,53,31,22,53
Crusaders,6407,2,16,4,10,54,38,16,52
Cliftonville,6407,3,14,6,10,53,44,9,48
Ballymena,6407,4,14,6,10,52,55,-3,48
Coleraine,6407,5,11,10,9,47,39,8,43
Glenavon,6407,6,11,10,9,48,49,-1,43
Dungannon,6407,7,10,11,9,46,37,9,41
Glentoran,6407,8,10,10,10,36,43,-7,40
Ballinamalla,6407,9,11,1,18,38,51,-13,34
Ards,6407,10,8,5,17,37,55,-18,29
Portadown,6407,11,7,5,18,27,49,-22,26
Crusaders,6408,1,18,7,5,62,35,27,61
Cliftonville,6408,2,15,4,11,50,41,9,49
Linfield,6408,3,13,9,8,54,37,17,48
Coleraine,6408,4,13,7,10,46,40,6,46
Ballymena,6408,5,12,6,12,55,62,-7,42
Portadown,6408,6,12,5,13,36,43,-7,41
Ballinamalla,6408,7,11,6,13,46,51,-5,39
Glenavon,6408,8,9,8,13,48,55,-7,35
Dungannon,6408,9,7,12,11,49,51,-2,33
Glentoran,6408,10,8,8,14,30,45,-15,32
Ards,6408,11,9,4,17,34,50,-16,31
Crusaders,6409,1,14,13,3,54,34,20,55
Cliftonville,6409,2,16,6,8,56,35,21,54
Ballymena,6409,3,15,5,10,60,54,6,50
Coleraine,6409,4,13,9,8,40,38,2,48
Linfield,6409,5,12,7,11,57,39,18,43
Glentoran,6409,6,11,9,10,39,41,-2,42
Glenavon,6409,7,10,11,9,47,49,-2,41
Ards,6409,8,10,5,15,35,46,-11,35
Dungannon,6409,9,8,9,13,48,48,0,33
Ballinamalla,6409,10,8,3,19,34,58,-24,27
Portadown,6409,11,5,9,16,21,49,-28,24
Crusaders,6410,1,20,7,3,60,25,35,67
Linfield,6410,2,16,8,6,58,28,30,56
Cliftonville,6410,3,17,3,10,52,39,13,54
Coleraine,6410,4,11,12,7,44,40,4,45
Ballymena,6410,5,13,5,12,54,56,-2,44
Glenavon,6410,6,10,12,8,54,49,5,42
Glentoran,6410,7,10,9,11,35,43,-8,39
Dungannon,6410,8,9,7,14,50,51,-1,34
Ards,6410,9,7,5,18,36,54,-18,26
Portadown,6410,10,7,4,19,23,49,-26,25
Ballinamalla,6410,11,7,4,19,27,59,-32,25
Crusaders,6411,1,17,7,6,56,35,21,58
Linfield,6411,2,13,9,8,58,39,19,48
Coleraine,6411,3,13,9,8,43,35,8,48
Dungannon,6411,4,13,8,9,52,41,11,47
Ballymena,6411,5,13,8,9,58,55,3,47
Glenavon,6411,6,12,9,9,42,42,0,45
Ards,6411,7,11,5,14,40,46,-6,38
Cliftonville,6411,8,11,4,15,44,44,0,37
Glentoran,6411,9,9,8,13,30,43,-13,35
Ballinamalla,6411,10,8,3,19,29,47,-18,27
Portadown,6411,11,7,6,17,28,53,-25,27
Crusaders,6412,1,18,8,4,55,35,20,62
Linfield,6412,2,15,9,6,59,34,25,54
Ballymena,6412,3,14,6,10,54,58,-4,48
Cliftonville,6412,4,13,7,10,46,34,12,46
Coleraine,6412,5,11,11,8,41,40,1,44
Glenavon,6412,6,10,9,11,47,47,0,39
Glentoran,6412,7,11,6,13,33,42,-9,39
Dungannon,6412,8,9,10,11,47,46,1,37
Ards,6412,9,7,8,15,35,50,-15,29
Ballinamalla,6412,10,8,4,18,32,48,-16,28
Portadown,6412,11,7,6,17,26,41,-15,27
Linfield,6413,1,19,7,4,62,26,36,64
Cliftonville,6413,2,17,5,8,51,37,14,56
Coleraine,6413,3,12,10,8,48,32,16,46
Crusaders,6413,4,12,8,10,48,40,8,44
Glenavon,6413,5,10,12,8,42,40,2,42
Ballymena,6413,6,12,6,12,53,52,1,42
Dungannon,6413,7,9,8,13,47,47,0,35
Glentoran,6413,8,8,10,12,29,47,-18,34
Portadown,6413,9,10,4,16,26,45,-19,34
Ards,6413,10,9,6,15,36,50,-14,33
Ballinamalla,6413,11,4,10,16,28,54,-26,22
Crusaders,6414,1,16,9,5,52,30,22,57
Cliftonville,6414,2,16,5,9,58,41,17,53
Linfield,6414,3,13,12,5,56,26,30,51
Coleraine,6414,4,12,11,7,51,36,15,47
Ballymena,6414,5,13,8,9,58,62,-4,47
Glenavon,6414,6,12,10,8,40,38,2,46
Ards,6414,7,11,5,14,43,50,-7,38
Glentoran,6414,8,10,7,13,31,41,-10,37
Dungannon,6414,9,8,8,14,40,45,-5,32
Ballinamalla,6414,10,6,4,20,24,57,-33,22
Portadown,6414,11,4,9,17,25,52,-27,21
Linfield,6415,1,14,11,5,59,31,28,53
Crusaders,6415,2,14,9,7,49,31,18,51
Cliftonville,6415,3,14,6,10,48,39,9,48
Coleraine,6415,4,13,9,8,41,35,6,48
Glenavon,6415,5,11,12,7,45,43,2,45
Ballymena,6415,6,13,6,11,56,58,-2,45
Dungannon,6415,7,8,13,9,48,46,2,37
Glentoran,6415,8,8,9,13,33,46,-13,33
Portadown,6415,9,9,5,16,26,45,-19,32
Ards,6415,10,8,5,17,37,49,-12,29
Ballinamalla,6415,11,7,7,16,32,51,-19,28
Linfield,6416,1,16,7,7,62,36,26,55
Crusaders,6416,2,15,9,6,60,40,20,54
Cliftonville,6416,3,16,5,9,64,46,18,53
Coleraine,6416,4,13,9,8,43,36,7,48
Ballymena,6416,5,13,8,9,63,58,5,47
Glenavon,6416,6,10,14,6,48,42,6,44
Ards,6416,7,12,3,15,47,54,-7,39
Dungannon,6416,8,9,9,12,49,45,4,36
Ballinamalla,6416,9,11,3,16,34,52,-18,36
Glentoran,6416,10,6,5,19,28,59,-31,23
Portadown,6416,11,6,4,20,21,51,-30,22
Crusaders,6417,1,18,8,4,61,30,31,62
Linfield,6417,2,15,12,3,58,27,31,57
Cliftonville,6417,3,17,5,8,55,33,22,56
Ballymena,6417,4,14,6,10,60,54,6,48
Glenavon,6417,5,10,12,8,48,49,-1,42
Dungannon,6417,6,9,13,8,46,39,7,40
Coleraine,6417,7,9,10,11,34,37,-3,37
Ards,6417,8,6,11,13,35,46,-11,29
Glentoran,6417,9,6,10,14,25,51,-26,28
Portadown,6417,10,5,8,17,22,48,-26,23
Ballinamalla,6417,11,6,5,19,29,59,-30,23
Crusaders,6418,1,17,8,5,59,35,24,59
Cliftonville,6418,2,17,5,8,55,35,20,56
Linfield,6418,3,14,8,8,53,32,21,50
Ballymena,6418,4,14,7,9,63,57,6,49
Glenavon,6418,5,12,10,8,47,40,7,46
Dungannon,6418,6,10,11,9,49,41,8,41
Ards,6418,7,9,8,13,41,48,-7,35
Coleraine,6418,8,8,11,11,41,52,-11,35
Ballinamalla,6418,9,8,5,17,34,55,-21,29
Glentoran,6418,10,6,10,14,24,43,-19,28
Portadown,6418,11,6,5,19,18,46,-28,23
Cliftonville,6419,1,18,4,8,51,33,18,58
Crusaders,6419,2,15,7,8,61,43,18,52
Linfield,6419,3,14,7,9,60,34,26,49
Dungannon,6419,4,12,8,10,54,43,11,44
Coleraine,6419,5,12,8,10,50,44,6,44
Glenavon,6419,6,12,8,10,51,58,-7,44
Ballymena,6419,7,11,8,11,54,55,-1,41
Glentoran,6419,8,12,4,14,39,49,-10,40
Ards,6419,9,9,4,17,39,56,-17,31
Ballinamalla,6419,10,9,3,18,32,52,-20,30
Portadown,6419,11,8,5,17,24,48,-24,29
Crusaders,6420,1,17,8,5,52,31,21,59
Linfield,6420,2,15,7,8,57,34,23,52
Cliftonville,6420,3,15,5,10,50,38,12,50
Glenavon,6420,4,13,9,8,48,41,7,48
Dungannon,6420,5,12,11,7,51,38,13,47
Coleraine,6420,6,12,11,7,46,39,7,47
Ballymena,6420,7,13,4,13,53,53,0,43
Glentoran,6420,8,8,9,13,33,44,-11,33
Ards,6420,9,7,6,17,34,53,-19,27
Portadown,6420,10,7,6,17,29,51,-22,27
Ballinamalla,6420,11,4,8,18,25,56,-31,20
Crusaders,6421,1,18,5,7,64,32,32,59
Linfield,6421,2,16,8,6,65,32,33,56
Cliftonville,6421,3,17,4,9,57,39,18,55
Ballymena,6421,4,13,5,12,53,62,-9,44
Glenavon,6421,5,11,10,9,47,52,-5,43
Coleraine,6421,6,10,10,10,45,45,0,40
Glentoran,6421,7,11,6,13,38,44,-6,39
Ballinamalla,6421,8,11,4,15,33,49,-16,37
Ards,6421,9,8,6,16,37,55,-18,30
Dungannon,6421,10,6,11,13,47,50,-3,29
Portadown,6421,11,7,5,18,24,50,-26,26
Linfield,6422,1,16,7,7,62,38,24,55
Crusaders,6422,2,15,10,5,47,30,17,55
Ballymena,6422,3,14,7,9,66,57,9,49
Cliftonville,6422,4,14,5,11,47,34,13,47
Dungannon,6422,5,11,10,9,56,42,14,43
Glenavon,6422,6,10,10,10,42,48,-6,40
Glentoran,6422,7,9,9,12,35,38,-3,36
Ballinamalla,6422,8,11,3,16,33,50,-17,36
Coleraine,6422,9,8,11,11,34,44,-10,35
Portadown,6422,10,9,5,16,28,44,-16,32
Ards,6422,11,6,7,17,34,59,-25,25
Crusaders,6423,1,17,9,4,60,33,27,60
Linfield,6423,2,15,10,5,66,31,35,55
Cliftonville,6423,3,16,6,8,54,34,20,54
Ballymena,6423,4,14,8,8,67,63,4,50
Coleraine,6423,5,12,11,7,43,40,3,47
Glentoran,6423,6,11,8,11,41,41,0,41
Ards,6423,7,11,5,14,38,45,-7,38
Glenavon,6423,8,8,12,10,46,53,-7,36
Dungannon,6423,9,8,11,11,49,46,3,35
Portadown,6423,10,4,6,20,22,55,-33,18
Ballinamalla,6423,11,3,6,21,19,64,-45,15
Crusaders,6424,1,13,9,8,46,34,12,48
Linfield,6424,2,12,11,7,57,32,25,47
Cliftonville,6424,3,13,8,9,54,43,11,47
Coleraine,6424,4,12,11,7,42,37,5,47
Ballymena,6424,5,13,7,10,58,58,0,46
Glenavon,6424,6,9,13,8,47,49,-2,40
Ards,6424,7,12,3,15,42,44,-2,39
Glentoran,6424,8,11,6,13,25,37,-12,39
Dungannon,6424,9,9,10,11,48,45,3,37
Ballinamalla,6424,10,9,5,16,29,51,-22,32
Portadown,6424,11,8,5,17,24,42,-18,29
Linfield,6425,1,18,6,6,66,23,43,60
Ballymena,6425,2,15,7,8,56,52,4,52
Cliftonville,6425,3,15,6,9,61,47,14,51
Crusaders,6425,4,14,7,9,52,43,9,49
Glenavon,6425,5,9,13,8,47,49,-2,40
Coleraine,6425,6,10,9,11,38,41,-3,39
Glentoran,6425,7,9,8,13,36,49,-13,35
Portadown,6425,8,9,6,15,28,46,-18,33
Dungannon,6425,9,7,11,12,47,49,-2,32
Ards,6425,10,8,7,15,32,46,-14,31
Ballinamalla,6425,11,8,6,16,31,49,-18,30
Linfield,6426,1,15,11,4,61,32,29,56
Crusaders,6426,2,15,9,6,57,33,24,54
Cliftonville,6426,3,16,5,9,58,42,16,53
Dungannon,6426,4,11,9,10,50,45,5,42
Ballymena,6426,5,11,9,10,46,52,-6,42
Glentoran,6426,6,11,7,12,34,45,-11,40
Glenavon,6426,7,9,12,9,42,45,-3,39
Coleraine,6426,8,8,12,10,42,46,-4,36
Ards,6426,9,9,4,17,38,48,-10,31
Ballinamalla,6426,10,8,5,17,30,53,-23,29
Portadown,6426,11,6,9,15,28,45,-17,27
Ballymena,6427,1,17,6,7,62,51,11,57
Cliftonville,6427,2,15,7,8,58,40,18,52
Crusaders,6427,3,15,7,8,55,39,16,52
Linfield,6427,4,12,9,9,52,34,18,45
Glenavon,6427,5,11,11,8,51,51,0,44
Coleraine,6427,6,10,12,8,40,40,0,42
Dungannon,6427,7,10,9,11,54,46,8,39
Glentoran,6427,8,11,5,14,33,45,-12,38
Ards,6427,9,10,5,15,42,49,-7,35
Ballinamalla,6427,10,8,4,18,30,52,-22,28
Portadown,6427,11,4,9,17,29,59,-30,21
Crusaders,6428,1,17,6,7,65,40,25,57
Cliftonville,6428,2,16,5,9,55,38,17,53
Ballymena,6428,3,16,5,9,71,65,6,53
Linfield,6428,4,14,9,7,55,35,20,51
Glenavon,6428,5,12,10,8,48,44,4,46
Glentoran,6428,6,13,5,12,39,47,-8,44
Coleraine,6428,7,10,11,9,44,42,2,41
Dungannon,6428,8,11,6,13,49,42,7,39
Ards,6428,9,8,4,18,35,53,-18,28
Ballinamalla,6428,10,8,4,18,30,54,-24,28
Portadown,6428,11,4,7,19,20,51,-31,19
Crusaders,6429,1,19,5,6,65,33,32,62
Cliftonville,6429,2,18,4,8,61,40,21,58
Linfield,6429,3,15,7,8,56,34,22,52
Coleraine,6429,4,12,9,9,50,40,10,45
Glenavon,6429,5,11,8,11,45,47,-2,41
Dungannon,6429,6,10,10,10,48,45,3,40
Ballymena,6429,7,11,5,14,49,66,-17,38
Ballinamalla,6429,8,10,6,14,37,52,-15,36
Glentoran,6429,9,10,5,15,31,45,-14,35
Ards,6429,10,9,5,16,38,53,-15,32
Portadown,6429,11,6,4,20,21,46,-25,22
Glenavon,6430,1,17,8,5,54,35,19,59
Crusaders,6430,2,17,7,6,55,29,26,58
Cliftonville,6430,3,16,6,8,54,33,21,54
Linfield,6430,4,13,12,5,55,32,23,51
Coleraine,6430,5,10,11,9,40,40,0,41
Dungannon,6430,6,10,10,10,49,43,6,40
Ballymena,6430,7,11,7,12,54,62,-8,40
Ballinamalla,6430,8,8,7,15,28,47,-19,31
Portadown,6430,9,7,7,16,22,42,-20,28
Glentoran,6430,10,6,8,16,28,53,-25,26
Ards,6430,11,6,5,19,30,53,-23,23
Crusaders,6431,1,21,8,1,69,22,47,71
Linfield,6431,2,14,8,8,59,37,22,50
Cliftonville,6431,3,14,8,8,50,41,9,50
Coleraine,6431,4,13,10,7,51,39,12,49
Glenavon,6431,5,12,10,8,49,48,1,46
Ballymena,6431,6,13,4,13,49,57,-8,43
Dungannon,6431,7,10,9,11,51,40,11,39
Ards,6431,8,9,5,16,41,55,-14,32
Ballinamalla,6431,9,9,2,19,31,55,-24,29
Portadown,6431,10,8,3,19,23,49,-26,27
Glentoran,6431,11,5,7,18,24,54,-30,22
Crusaders,6432,1,18,8,4,70,32,38,62
Linfield,6432,2,16,10,4,65,27,38,58
Ballymena,6432,3,15,6,9,64,56,8,51
Coleraine,6432,4,12,11,7,48,37,11,47
Cliftonville,6432,5,13,8,9,48,44,4,47
Glenavon,6432,6,11,9,10,46,53,-7,42
Dungannon,6432,7,9,6,15,49,47,2,33
Glentoran,6432,8,9,6,15,28,47,-19,33
Ards,6432,9,10,2,18,39,58,-19,32
Portadown,6432,10,8,4,18,25,54,-29,28
Ballinamalla,6432,11,7,4,19,24,51,-27,25
Cliftonville,6433,1,19,4,7,60,35,25,61
Linfield,6433,2,13,9,8,61,37,24,48
Crusaders,6433,3,14,6,10,52,40,12,48
Dungannon,6433,4,12,8,10,50,42,8,44
Glenavon,6433,5,10,13,7,47,45,2,43
Coleraine,6433,6,12,7,11,46,44,2,43
Ballymena,6433,7,12,7,11,55,60,-5,43
Ballinamalla,6433,8,11,3,16,34,49,-15,36
Ards,6433,9,9,7,14,40,47,-7,34
Glentoran,6433,10,7,9,14,27,48,-21,30
Portadown,6433,11,5,9,16,20,45,-25,24
Crusaders,6434,1,16,9,5,54,28,26,57
Cliftonville,6434,2,16,6,8,58,38,20,54
Linfield,6434,3,14,8,8,62,37,25,50
Dungannon,6434,4,12,10,8,51,38,13,46
Coleraine,6434,5,13,7,10,48,37,11,46
Ballymena,6434,6,12,9,9,55,57,-2,45
Glenavon,6434,7,8,11,11,45,51,-6,35
Ards,6434,8,9,5,16,36,50,-14,32
Ballinamalla,6434,9,8,7,15,32,52,-20,31
Glentoran,6434,10,8,7,15,26,52,-26,31
Portadown,6434,11,7,5,18,26,53,-27,26
Crusaders,6435,1,16,6,8,50,33,17,54
Linfield,6435,2,15,7,8,57,32,25,52
Glenavon,6435,3,14,10,6,51,40,11,52
Cliftonville,6435,4,15,5,10,51,42,9,50
Coleraine,6435,5,12,10,8,40,35,5,46
Ballymena,6435,6,13,5,12,58,60,-2,44
Dungannon,6435,7,10,10,10,43,38,5,40
Ards,6435,8,10,6,14,40,48,-8,36
Glentoran,6435,9,9,7,14,33,47,-14,34
Portadown,6435,10,7,7,16,28,46,-18,28
Ballinamalla,6435,11,6,3,21,22,52,-30,21
Crusaders,6436,1,17,6,7,58,41,17,57
Linfield,6436,2,15,10,5,63,32,31,55
Coleraine,6436,3,14,11,5,43,28,15,53
Dungannon,6436,4,12,11,7,51,35,16,47
Cliftonville,6436,5,14,5,11,55,48,7,47
Ballymena,6436,6,13,7,10,53,59,-6,46
Glenavon,6436,7,11,11,8,42,38,4,44
Ards,6436,8,8,5,17,39,54,-15,29
Ballinamalla,6436,9,8,4,18,34,52,-18,28
Glentoran,6436,10,7,7,16,29,49,-20,28
Portadown,6436,11,4,7,19,22,53,-31,19
Crusaders,6437,1,17,6,7,48,28,20,57
Linfield,6437,2,16,7,7,62,32,30,55
Cliftonville,6437,3,14,7,9,51,38,13,49
Glenavon,6437,4,12,10,8,46,39,7,46
Ballymena,6437,5,13,7,10,49,52,-3,46
Coleraine,6437,6,9,12,9,36,37,-1,39
Dungannon,6437,7,9,10,11,44,45,-1,37
Ards,6437,8,10,6,14,39,44,-5,36
Glentoran,6437,9,8,9,13,26,43,-17,33
Portadown,6437,10,7,8,15,24,39,-15,29
Ballinamalla,6437,11,7,4,19,26,54,-28,25
Crusaders,6438,1,18,6,6,60,32,28,60
Ballymena,6438,2,16,5,9,64,63,1,53
Cliftonville,6438,3,16,4,10,62,49,13,52
Linfield,6438,4,14,8,8,67,41,26,50
Dungannon,6438,5,12,8,10,58,45,13,44
Glenavon,6438,6,11,8,11,44,54,-10,41
Coleraine,6438,7,9,8,13,39,51,-12,35
Ballinamalla,6438,8,11,1,18,43,54,-11,34
Glentoran,6438,9,8,9,13,29,44,-15,33
Ards,6438,10,8,7,15,35,49,-14,31
Portadown,6438,11,8,4,18,30,49,-19,28
Ballymena,6439,1,16,7,7,59,54,5,55
Linfield,6439,2,15,8,7,55,26,29,53
Crusaders,6439,3,14,8,8,53,44,9,50
Cliftonville,6439,4,14,5,11,45,38,7,47
Glenavon,6439,5,11,10,9,45,46,-1,43
Dungannon,6439,6,11,7,12,58,51,7,40
Ballinamalla,6439,7,12,4,14,34,45,-11,40
Ards,6439,8,9,8,13,33,44,-11,35
Coleraine,6439,9,8,10,12,42,44,-2,34
Glentoran,6439,10,8,8,14,31,44,-13,32
Portadown,6439,11,8,3,19,29,48,-19,27
Linfield,6440,1,19,6,5,67,30,37,63
Crusaders,6440,2,15,8,7,57,38,19,53
Ballymena,6440,3,15,6,9,55,51,4,51
Cliftonville,6440,4,15,5,10,56,43,13,50
Coleraine,6440,5,12,12,6,42,36,6,48
Glenavon,6440,6,10,11,9,44,44,0,41
Glentoran,6440,7,9,7,14,36,49,-13,34
Dungannon,6440,8,8,6,16,39,47,-8,30
Portadown,6440,9,8,6,16,22,42,-20,30
Ballinamalla,6440,10,8,5,17,30,48,-18,29
Ards,6440,11,8,4,18,37,57,-20,28
Crusaders,6441,1,15,9,6,55,33,22,54
Linfield,6441,2,13,13,4,54,23,31,52
Ballymena,6441,3,13,9,8,60,57,3,48
Cliftonville,6441,4,13,7,10,52,46,6,46
Glenavon,6441,5,12,9,9,51,49,2,45
Ards,6441,6,11,6,13,38,47,-9,39
Dungannon,6441,7,9,10,11,54,48,6,37
Coleraine,6441,8,8,12,10,42,51,-9,36
Ballinamalla,6441,9,9,6,15,29,45,-16,33
Portadown,6441,10,8,6,16,29,44,-15,30
Glentoran,6441,11,6,9,15,29,50,-21,27
Linfield,6442,1,17,7,6,66,32,34,58
Ballymena,6442,2,15,6,9,56,51,5,51
Dungannon,6442,3,14,8,8,52,38,14,50
Glenavon,6442,4,13,10,7,54,45,9,49
Crusaders,6442,5,12,9,9,51,38,13,45
Cliftonville,6442,6,13,6,11,49,41,8,45
Coleraine,6442,7,10,11,9,45,40,5,41
Ards,6442,8,8,7,15,35,49,-14,31
Ballinamalla,6442,9,7,7,16,29,51,-22,28
Glentoran,6442,10,7,7,16,27,51,-24,28
Portadown,6442,11,8,4,18,26,54,-28,28
Linfield,6443,1,17,9,4,65,30,35,60
Cliftonville,6443,2,19,3,8,65,41,24,60
Crusaders,6443,3,15,8,7,55,36,19,53
Ballymena,6443,4,15,4,11,63,60,3,49
Coleraine,6443,5,13,8,9,46,45,1,47
Glenavon,6443,6,9,9,12,49,55,-6,36
Dungannon,6443,7,8,9,13,50,51,-1,33
Glentoran,6443,8,8,9,13,25,43,-18,33
Ballinamalla,6443,9,9,4,17,34,55,-21,31
Portadown,6443,10,9,3,18,32,52,-20,30
Ards,6443,11,6,8,16,40,56,-16,26
Crusaders,6444,1,17,8,5,55,35,20,59
Cliftonville,6444,2,16,4,10,54,36,18,52
Glenavon,6444,3,13,12,5,49,36,13,51
Coleraine,6444,4,14,9,7,45,39,6,51
Ballymena,6444,5,15,6,9,55,53,2,51
Linfield,6444,6,14,7,9,51,27,24,49
Dungannon,6444,7,9,8,13,49,49,0,35
Ballinamalla,6444,8,8,6,16,29,48,-19,30
Glentoran,6444,9,7,6,17,28,52,-24,27
Ards,6444,10,7,5,18,35,51,-16,26
Portadown,6444,11,7,5,18,27,51,-24,26
Glenavon,6445,1,15,10,5,57,41,16,55
Crusaders,6445,2,15,9,6,52,35,17,54
Ballymena,6445,3,15,8,7,63,54,9,53
Linfield,6445,4,13,9,8,57,36,21,48
Coleraine,6445,5,11,13,6,52,36,16,46
Dungannon,6445,6,11,10,9,50,40,10,43
Cliftonville,6445,7,13,4,13,49,43,6,43
Ards,6445,8,10,5,15,40,54,-14,35
Glentoran,6445,9,6,11,13,29,48,-19,29
Portadown,6445,10,7,5,18,26,54,-28,26
Ballinamalla,6445,11,5,4,21,25,59,-34,19
Crusaders,6446,1,16,6,8,55,33,22,54
Linfield,6446,2,14,11,5,55,27,28,53
Cliftonville,6446,3,15,8,7,54,39,15,53
Dungannon,6446,4,13,8,9,59,47,12,47
Glenavon,6446,5,11,11,8,48,46,2,44
Ballymena,6446,6,12,7,11,55,56,-1,43
Coleraine,6446,7,10,11,9,37,40,-3,41
Glentoran,6446,8,9,8,13,36,46,-10,35
Ballinamalla,6446,9,10,4,16,32,50,-18,34
Ards,6446,10,6,6,18,30,51,-21,24
Portadown,6446,11,5,8,17,23,49,-26,23
Crusaders,6447,1,19,8,3,66,32,34,65
Coleraine,6447,2,15,10,5,51,29,22,55
Linfield,6447,3,14,8,8,56,36,20,50
Dungannon,6447,4,12,10,8,56,43,13,46
Glenavon,6447,5,11,10,9,51,50,1,43
Cliftonville,6447,6,13,3,14,51,48,3,42
Ballymena,6447,7,10,6,14,51,66,-15,36
Portadown,6447,8,9,7,14,31,45,-14,34
Ards,6447,9,8,7,15,42,59,-17,31
Glentoran,6447,10,7,9,14,39,56,-17,30
Ballinamalla,6447,11,5,6,19,24,54,-30,21
Linfield,6448,1,16,11,3,67,29,38,59
Crusaders,6448,2,17,6,7,56,39,17,57
Cliftonville,6448,3,17,3,10,60,45,15,54
Coleraine,6448,4,11,12,7,50,45,5,45
Dungannon,6448,5,10,11,9,47,35,12,41
Glenavon,6448,6,10,8,12,50,57,-7,38
Glentoran,6448,7,10,6,14,31,43,-12,36
Ballymena,6448,8,10,6,14,57,77,-20,36
Portadown,6448,9,9,5,16,25,43,-18,32
Ballinamalla,6448,10,9,4,17,39,52,-13,31
Ards,6448,11,6,8,16,34,51,-17,26
Crusaders,6449,1,19,5,6,56,30,26,62
Linfield,6449,2,15,10,5,54,27,27,55
Cliftonville,6449,3,16,5,9,58,44,14,53
Coleraine,6449,4,12,12,6,45,34,11,48
Ballymena,6449,5,13,7,10,51,51,0,46
Glenavon,6449,6,11,11,8,50,49,1,44
Dungannon,6449,7,8,9,13,44,47,-3,33
Ballinamalla,6449,8,7,8,15,27,45,-18,29
Ards,6449,9,7,7,16,34,48,-14,28
Glentoran,6449,10,7,7,16,31,52,-21,28
Portadown,6449,11,6,7,17,21,44,-23,25
Linfield,6450,1,16,8,6,61,24,37,56
Crusaders,6450,2,16,8,6,51,34,17,56
Glenavon,6450,3,13,11,6,49,37,12,50
Cliftonville,6450,4,13,5,12,48,36,12,44
Ballymena,6450,5,12,8,10,48,56,-8,44
Dungannon,6450,6,11,9,10,54,43,11,42
Coleraine,6450,7,9,11,10,35,40,-5,38
Ards,6450,8,10,7,13,46,51,-5,37
Portadown,6450,9,9,7,14,24,42,-18,34
Glentoran,6450,10,7,10,13,25,41,-16,31
Ballinamalla,6450,11,5,4,21,22,59,-37,19
Crusaders,6451,1,15,10,5,51,26,25,55
Glenavon,6451,2,15,10,5,51,37,14,55
Linfield,6451,3,14,11,5,59,29,30,53
Ballymena,6451,4,14,6,10,55,58,-3,48
Coleraine,6451,5,11,11,8,39,37,2,44
Cliftonville,6451,6,12,7,11,49,50,-1,43
Dungannon,6451,7,10,10,10,51,46,5,40
Glentoran,6451,8,9,9,12,38,43,-5,36
Ballinamalla,6451,9,10,4,16,35,49,-14,34
Ards,6451,10,7,3,20,29,52,-23,24
Portadown,6451,11,5,5,20,23,53,-30,20
Linfield,6452,1,17,8,5,59,25,34,59
Cliftonville,6452,2,15,4,11,53,38,15,49
Coleraine,6452,3,13,10,7,50,44,6,49
Glenavon,6452,4,12,9,9,49,50,-1,45
Crusaders,6452,5,12,7,11,44,36,8,43
Ballymena,6452,6,11,7,12,53,66,-13,40
Dungannon,6452,7,11,6,13,50,52,-2,39
Ards,6452,8,10,7,13,41,48,-7,37
Glentoran,6452,9,10,7,13,30,41,-11,37
Portadown,6452,10,9,4,17,32,49,-17,31
Ballinamalla,6452,11,8,5,17,37,49,-12,29
Cliftonville,6453,1,19,4,7,56,36,20,61
Ballymena,6453,2,16,8,6,60,50,10,56
Linfield,6453,3,15,9,6,58,31,27,54
Crusaders,6453,4,14,6,10,52,36,16,48
Glenavon,6453,5,11,11,8,50,51,-1,44
Coleraine,6453,6,9,13,8,40,36,4,40
Dungannon,6453,7,8,12,10,49,46,3,36
Glentoran,6453,8,9,7,14,31,50,-19,34
Ards,6453,9,9,5,16,40,48,-8,32
Ballinamalla,6453,10,6,7,17,30,52,-22,25
Portadown,6453,11,5,6,19,15,45,-30,21
Crusaders,6454,1,17,7,6,60,40,20,58
Linfield,6454,2,14,9,7,59,34,25,51
Cliftonville,6454,3,13,9,8,49,39,10,48
Ballymena,6454,4,13,5,12,58,59,-1,44
Coleraine,6454,5,10,11,9,44,41,3,41
Glenavon,6454,6,10,11,9,46,45,1,41
Glentoran,6454,7,10,8,12,36,45,-9,38
Dungannon,6454,8,9,10,11,55,48,7,37
Portadown,6454,9,11,4,15,26,50,-24,37
Ards,6454,10,9,7,14,44,46,-2,34
Ballinamalla,6454,11,6,5,19,31,61,-30,23
Crusaders,6455,1,18,9,3,57,29,28,63
Glenavon,6455,2,15,10,5,51,40,11,55
Linfield,6455,3,14,9,7,63,36,27,51
Cliftonville,6455,4,15,6,9,53,40,13,51
Coleraine,6455,5,11,7,12,40,41,-1,40
Dungannon,6455,6,10,7,13,45,41,4,37
Ballymena,6455,7,10,6,14,61,79,-18,36
Ballinamalla,6455,8,9,5,16,32,50,-18,32
Glentoran,6455,9,7,10,13,29,41,-12,31
Portadown,6455,10,7,8,15,29,45,-16,29
Ards,6455,11,8,5,17,42,60,-18,29
Crusaders,6456,1,15,8,7,48,35,13,53
Ballymena,6456,2,15,6,9,72,56,16,51
Linfield,6456,3,13,11,6,63,34,29,50
Coleraine,6456,4,12,9,9,39,36,3,45
Cliftonville,6456,5,13,6,11,45,46,-1,45
Dungannon,6456,6,11,10,9,52,41,11,43
Glenavon,6456,7,10,13,7,51,44,7,43
Ards,6456,8,11,6,13,45,47,-2,39
Glentoran,6456,9,8,8,14,32,47,-15,32
Portadown,6456,10,6,8,16,28,56,-28,26
Ballinamalla,6456,11,6,5,19,22,55,-33,23
Ballymena,6457,1,18,4,8,64,52,12,58
Crusaders,6457,2,16,9,5,60,43,17,57
Linfield,6457,3,14,9,7,65,33,32,51
Cliftonville,6457,4,16,3,11,53,42,11,51
Glenavon,6457,5,13,10,7,49,50,-1,49
Dungannon,6457,6,11,10,9,45,34,11,43
Coleraine,6457,7,10,12,8,42,39,3,42
Ards,6457,8,8,5,17,36,51,-15,29
Glentoran,6457,9,6,9,15,25,45,-20,27
Ballinamalla,6457,10,5,8,17,29,52,-23,23
Portadown,6457,11,5,7,18,21,48,-27,22
Linfield,6458,1,16,9,5,57,26,31,57
Crusaders,6458,2,15,10,5,57,31,26,55
Glenavon,6458,3,14,10,6,51,39,12,52
Cliftonville,6458,4,14,6,10,49,37,12,48
Ballymena,6458,5,13,6,11,47,53,-6,45
Coleraine,6458,6,10,12,8,37,33,4,42
Dungannon,6458,7,10,8,12,45,45,0,38
Ards,6458,8,10,6,14,47,46,1,36
Glentoran,6458,9,6,10,14,26,48,-22,28
Portadown,6458,10,8,3,19,26,51,-25,27
Ballinamalla,6458,11,7,4,19,27,60,-33,25
Crusaders,6459,1,20,6,4,61,30,31,66
Cliftonville,6459,2,15,5,10,49,36,13,50
Linfield,6459,3,13,9,8,58,35,23,48
Coleraine,6459,4,11,12,7,45,42,3,45
Ballymena,6459,5,13,6,11,57,60,-3,45
Dungannon,6459,6,10,11,9,50,45,5,41
Glenavon,6459,7,10,9,11,45,47,-2,39
Ards,6459,8,11,4,15,40,45,-5,37
Ballinamalla,6459,9,10,3,17,36,55,-19,33
Glentoran,6459,10,8,5,17,31,52,-21,29
Portadown,6459,11,6,6,18,24,49,-25,24
Crusaders,6460,1,16,9,5,58,36,22,57
Ballymena,6460,2,17,4,9,57,58,-1,55
Linfield,6460,3,13,10,7,57,31,26,49
Cliftonville,6460,4,15,4,11,49,37,12,49
Dungannon,6460,5,12,7,11,51,40,11,43
Coleraine,6460,6,11,9,10,39,37,2,42
Glenavon,6460,7,11,7,12,44,46,-2,40
Ards,6460,8,11,5,14,37,47,-10,38
Portadown,6460,9,7,8,15,26,43,-17,29
Glentoran,6460,10,8,5,17,27,48,-21,29
Ballinamalla,6460,11,8,4,18,27,49,-22,28
Linfield,6461,1,14,8,8,56,29,27,50
Crusaders,6461,2,14,8,8,54,35,19,50
Ballymena,6461,3,13,11,6,53,49,4,50
Cliftonville,6461,4,15,4,11,45,34,11,49
Coleraine,6461,5,12,12,6,46,32,14,48
Dungannon,6461,6,12,8,10,55,48,7,44
Glentoran,6461,7,13,5,12,33,41,-8,44
Glenavon,6461,8,10,10,10,40,47,-7,40
Ards,6461,9,8,5,17,32,54,-22,29
Portadown,6461,10,5,9,16,23,41,-18,24
Ballinamalla,6461,11,6,6,18,24,51,-27,24
Crusaders,6462,1,19,5,6,57,31,26,62
Cliftonville,6462,2,16,3,11,49,40,9,51
Coleraine,6462,3,13,10,7,44,36,8,49
Linfield,6462,4,13,9,8,62,40,22,48
Ballymena,6462,5,14,6,10,60,55,5,48
Glenavon,6462,6,10,12,8,45,41,4,42
Dungannon,6462,7,10,8,12,46,46,0,38
Ballinamalla,6462,8,10,3,17,33,48,-15,33
Glentoran,6462,9,8,7,15,31,50,-19,31
Ards,6462,10,8,6,16,31,49,-18,30
Portadown,6462,11,7,5,18,23,45,-22,26
Crusaders,6463,1,16,8,6,50,35,15,56
Linfield,6463,2,15,8,7,50,26,24,53
Cliftonville,6463,3,15,6,9,54,42,12,51
Glenavon,6463,4,13,8,9,53,46,7,47
Ballymena,6463,5,13,7,10,62,55,7,46
Dungannon,6463,6,12,8,10,56,42,14,44
Coleraine,6463,7,11,9,10,40,39,1,42
Portadown,6463,8,10,5,15,29,41,-12,35
Ards,6463,9,8,7,15,35,45,-10,31
Glentoran,6463,10,6,8,16,24,52,-28,26
Ballinamalla,6463,11,6,6,18,21,51,-30,24
Crusaders,6464,1,17,9,4,56,32,24,60
Linfield,6464,2,16,6,8,58,33,25,54
Ballymena,6464,3,15,5,10,62,58,4,50
Cliftonville,6464,4,14,7,9,45,33,12,49
Coleraine,6464,5,11,11,8,38,35,3,44
Glenavon,6464,6,10,9,11,42,46,-4,39
Dungannon,6464,7,8,9,13,52,49,3,33
Ards,6464,8,8,8,14,37,47,-10,32
Ballinamalla,6464,9,8,7,15,29,49,-20,31
Portadown,6464,10,8,7,15,27,49,-22,31
Glentoran,6464,11,6,10,14,27,42,-15,28
Crusaders,6465,1,17,11,2,66,28,38,62
Linfield,6465,2,16,9,5,70,32,38,57
Cliftonville,6465,3,15,5,10,51,42,9,50
Coleraine,6465,4,14,7,9,43,36,7,49
Ballymena,6465,5,12,9,9,56,65,-9,45
Glenavon,6465,6,9,12,9,43,46,-3,39
Glentoran,6465,7,10,9,11,39,43,-4,39
Dungannon,6465,8,8,10,12,44,51,-7,34
Portadown,6465,9,8,6,16,32,49,-17,30
Ards,6465,10,6,6,18,36,57,-21,24
Ballinamalla,6465,11,5,6,19,27,58,-31,21
Ballymena,6466,1,18,4,8,74,60,14,58
Crusaders,6466,2,15,7,8,59,39,20,52
Linfield,6466,3,15,7,8,58,40,18,52
Coleraine,6466,4,14,10,6,49,37,12,52
Glenavon,6466,5,14,9,7,58,44,14,51
Cliftonville,6466,6,14,4,12,55,49,6,46
Dungannon,6466,7,11,8,11,52,48,4,41
Glentoran,6466,8,11,7,12,32,42,-10,40
Ards,6466,9,8,4,18,36,55,-19,28
Portadown,6466,10,6,5,19,19,48,-29,23
Ballinamalla,6466,11,4,5,21,25,55,-30,17
Crusaders,6467,1,19,5,6,58,28,30,62
Linfield,6467,2,15,10,5,52,24,28,55
Ballymena,6467,3,16,6,8,57,49,8,54
Glenavon,6467,4,13,9,8,49,40,9,48
Coleraine,6467,5,12,10,8,42,35,7,46
Cliftonville,6467,6,12,7,11,39,32,7,43
Ards,6467,7,9,7,14,35,46,-11,34
Portadown,6467,8,10,3,17,26,43,-17,33
Glentoran,6467,9,8,8,14,25,46,-21,32
Dungannon,6467,10,6,9,15,39,43,-4,27
Ballinamalla,6467,11,5,6,19,26,62,-36,21
Linfield,6468,1,17,8,5,60,30,30,59
Dungannon,6468,2,14,9,7,58,39,19,51
Ballymena,6468,3,13,10,7,53,53,0,49
Coleraine,6468,4,13,9,8,39,29,10,48
Crusaders,6468,5,13,8,9,48,41,7,47
Cliftonville,6468,6,13,5,12,45,38,7,44
Glentoran,6468,7,10,10,10,43,42,1,40
Glenavon,6468,8,9,11,10,41,47,-6,38
Ards,6468,9,7,7,16,30,47,-17,28
Ballinamalla,6468,10,6,6,18,25,48,-23,24
Portadown,6468,11,5,7,18,24,52,-28,22
Crusaders,6469,1,18,6,6,60,33,27,60
Linfield,6469,2,15,9,6,60,33,27,54
Cliftonville,6469,3,15,6,9,57,41,16,51
Coleraine,6469,4,10,11,9,40,44,-4,41
Portadown,6469,5,12,5,13,30,37,-7,41
Glenavon,6469,6,9,13,8,45,44,1,40
Ballymena,6469,7,11,7,12,55,61,-6,40
Glentoran,6469,8,10,7,13,32,46,-14,37
Ballinamalla,6469,9,9,5,16,31,49,-18,32
Ards,6469,10,9,3,18,42,55,-13,30
Dungannon,6469,11,7,8,15,43,52,-9,29
Cliftonville,6470,1,16,8,6,52,32,20,56
Crusaders,6470,2,16,7,7,45,27,18,55
Ballymena,6470,3,14,6,10,49,51,-2,48
Linfield,6470,4,12,11,7,51,28,23,47
Coleraine,6470,5,12,9,9,40,34,6,45
Dungannon,6470,6,11,9,10,45,38,7,42
Glenavon,6470,7,9,12,9,47,51,-4,39
Ards,6470,8,9,7,14,30,43,-13,34
Glentoran,6470,9,8,9,13,31,42,-11,33
Portadown,6470,10,5,11,14,18,39,-21,26
Ballinamalla,6470,11,6,5,19,25,48,-23,23
Crusaders,6471,1,18,7,5,56,29,27,61
Linfield,6471,2,15,12,3,65,30,35,57
Ballymena,6471,3,15,6,9,58,50,8,51
Glenavon,6471,4,13,11,6,51,44,7,50
Coleraine,6471,5,12,9,9,44,41,3,45
Cliftonville,6471,6,13,5,12,45,37,8,44
Dungannon,6471,7,10,8,12,50,46,4,38
Ards,6471,8,10,7,13,39,48,-9,37
Ballinamalla,6471,9,9,2,19,30,57,-27,29
Glentoran,6471,10,6,5,19,24,52,-28,23
Portadown,6471,11,6,4,20,21,49,-28,22
Crusaders,6472,1,18,8,4,56,27,29,62
Linfield,6472,2,14,10,6,60,30,30,52
Ballymena,6472,3,14,5,11,56,63,-7,47
Coleraine,6472,4,12,10,8,41,36,5,46
Cliftonville,6472,5,11,8,11,45,39,6,41
Glentoran,6472,6,10,10,10,31,36,-5,40
Glenavon,6472,7,9,11,10,49,47,2,38
Dungannon,6472,8,9,10,11,47,49,-2,37
Ards,6472,9,9,5,16,36,46,-10,32
Ballinamalla,6472,10,8,6,16,29,52,-23,30
Portadown,6472,11,7,5,18,22,47,-25,26
Linfield,6473,1,16,8,6,56,27,29,56
Dungannon,6473,2,16,6,8,56,39,17,54
Crusaders,6473,3,15,6,9,46,36,10,51
Glenavon,6473,4,12,11,7,47,39,8,47
Coleraine,6473,5,13,8,9,43,42,1,47
Cliftonville,6473,6,14,4,12,56,42,14,46
Ballymena,6473,7,11,8,11,51,55,-4,41
Glentoran,6473,8,11,7,12,31,37,-6,40
Ards,6473,9,9,8,13,32,40,-8,35
Ballinamalla,6473,10,6,3,21,27,57,-30,21
Portadown,6473,11,6,3,21,22,53,-31,21
Crusaders,6474,1,19,5,6,60,33,27,62
Linfield,6474,2,15,10,5,66,31,35,55
Ballymena,6474,3,15,6,9,58,61,-3,51
Glenavon,6474,4,12,10,8,46,40,6,46
Cliftonville,6474,5,13,6,11,45,37,8,45
Dungannon,6474,6,11,6,13,51,45,6,39
Glentoran,6474,7,11,5,14,30,38,-8,38
Coleraine,6474,8,9,10,11,40,42,-2,37
Ards,6474,9,9,4,17,34,52,-18,31
Portadown,6474,10,8,6,16,24,44,-20,30
Ballinamalla,6474,11,6,6,18,25,56,-31,24
Crusaders,6475,1,15,7,8,56,37,19,52
Coleraine,6475,2,14,9,7,48,38,10,51
Cliftonville,6475,3,16,2,12,55,42,13,50
Linfield,6475,4,12,10,8,53,38,15,46
Glenavon,6475,5,11,12,7,43,45,-2,45
Ballymena,6475,6,13,5,12,58,65,-7,44
Glentoran,6475,7,11,8,11,33,41,-8,41
Dungannon,6475,8,8,11,11,53,54,-1,35
Portadown,6475,9,10,5,15,41,43,-2,35
Ards,6475,10,10,3,17,41,51,-10,33
Ballinamalla,6475,11,7,4,19,28,55,-27,25
Crusaders,6476,1,17,7,6,54,35,19,58
Cliftonville,6476,2,18,3,9,57,36,21,57
Ballymena,6476,3,16,3,11,62,56,6,51
Linfield,6476,4,14,8,8,62,38,24,50
Coleraine,6476,5,13,8,9,48,41,7,47
Ards,6476,6,11,4,15,36,45,-9,37
Glenavon,6476,7,7,14,9,41,47,-6,35
Portadown,6476,8,9,6,15,24,40,-16,33
Glentoran,6476,9,9,5,16,35,52,-17,32
Dungannon,6476,10,7,10,13,43,45,-2,31
Ballinamalla,6476,11,8,4,18,28,55,-27,28
Crusaders,6477,1,17,6,7,54,33,21,57
Linfield,6477,2,15,11,4,63,24,39,56
Cliftonville,6477,3,17,5,8,54,36,18,56
Ballymena,6477,4,15,5,10,62,56,6,50
Dungannon,6477,5,10,8,12,54,52,2,38
Glenavon,6477,6,10,8,12,46,53,-7,38
Glentoran,6477,7,10,7,13,27,43,-16,37
Coleraine,6477,8,9,9,12,37,43,-6,36
Ards,6477,9,9,6,15,38,51,-13,33
Portadown,6477,10,9,6,15,26,44,-18,33
Ballinamalla,6477,11,7,3,20,28,54,-26,24
Crusaders,6478,1,20,8,2,62,26,36,68
Linfield,6478,2,13,9,8,54,35,19,48
Cliftonville,6478,3,11,12,7,50,43,7,45
Ballymena,6478,4,13,5,12,51,58,-7,44
Coleraine,6478,5,10,12,8,39,36,3,42
Glenavon,6478,6,10,11,9,41,40,1,41
Glentoran,6478,7,10,9,11,33,39,-6,39
Dungannon,6478,8,10,8,12,45,47,-2,38
Ards,6478,9,9,6,15,39,50,-11,33
Ballinamalla,6478,10,7,5,18,25,45,-20,26
Portadown,6478,11,6,7,17,21,41,-20,25
Crusaders,6479,1,17,7,6,57,35,22,58
Linfield,6479,2,16,9,5,66,28,38,57
Glenavon,6479,3,14,8,8,51,42,9,50
Ballymena,6479,4,12,10,8,60,61,-1,46
Coleraine,6479,5,10,14,6,45,38,7,44
Cliftonville,6479,6,11,8,11,47,43,4,41
Dungannon,6479,7,9,11,10,55,45,10,38
Ballinamalla,6479,8,9,5,16,28,47,-19,32
Glentoran,6479,9,8,8,14,26,49,-23,32
Ards,6479,10,6,7,17,36,55,-19,25
Portadown,6479,11,6,7,17,25,53,-28,25
Linfield,6480,1,17,8,5,68,33,35,59
Crusaders,6480,2,15,7,8,49,34,15,52
Ballymena,6480,3,15,7,8,61,52,9,52
Cliftonville,6480,4,13,7,10,49,43,6,46
Dungannon,6480,5,11,9,10,51,44,7,42
Glenavon,6480,6,10,9,11,51,50,1,39
Ards,6480,7,12,3,15,35,46,-11,39
Coleraine,6480,8,9,10,11,41,43,-2,37
Glentoran,6480,9,10,6,14,36,47,-11,36
Portadown,6480,10,9,4,17,32,56,-24,31
Ballinamalla,6480,11,7,4,19,27,52,-25,25
Crusaders,6481,1,17,8,5,52,30,22,59
Cliftonville,6481,2,16,4,10,45,33,12,52
Linfield,6481,3,14,8,8,57,30,27,50
Glenavon,6481,4,13,11,6,50,41,9,50
Ballymena,6481,5,13,6,11,59,61,-2,45
Coleraine,6481,6,9,14,7,42,39,3,41
Glentoran,6481,7,9,9,12,34,43,-9,36
Ballinamalla,6481,8,8,8,14,29,46,-17,32
Dungannon,6481,9,6,13,11,39,39,0,31
Ards,6481,10,8,5,17,33,51,-18,29
Portadown,6481,11,7,4,19,25,52,-27,25
Crusaders,6482,1,18,5,7,58,40,18,59
Cliftonville,6482,2,16,5,9,54,34,20,53
Ballymena,6482,3,14,10,6,47,44,3,52
Linfield,6482,4,13,9,8,59,31,28,48
Coleraine,6482,5,12,9,9,44,35,9,45
Glenavon,6482,6,10,14,6,42,38,4,44
Dungannon,6482,7,7,13,10,46,45,1,34
Ballinamalla,6482,8,9,6,15,30,41,-11,33
Glentoran,6482,9,9,6,15,27,48,-21,33
Ards,6482,10,7,4,19,31,56,-25,25
Portadown,6482,11,6,7,17,23,49,-26,25
Crusaders,6483,1,18,5,7,55,38,17,59
Linfield,6483,2,16,6,8,60,29,31,54
Cliftonville,6483,3,16,5,9,55,41,14,53
Ballymena,6483,4,15,5,10,61,60,1,50
Dungannon,6483,5,13,7,10,59,45,14,46
Coleraine,6483,6,10,10,10,43,45,-2,40
Glenavon,6483,7,8,14,8,40,42,-2,38
Glentoran,6483,8,9,7,14,35,46,-11,34
Ards,6483,9,9,4,17,43,52,-9,31
Ballinamalla,6483,10,8,4,18,30,54,-24,28
Portadown,6483,11,7,5,18,24,53,-29,26
Crusaders,6484,1,19,5,6,59,35,24,62
Cliftonville,6484,2,15,5,10,50,42,8,50
Linfield,6484,3,14,7,9,51,32,19,49
Coleraine,6484,4,13,10,7,44,29,15,49
Ballymena,6484,5,12,7,11,58,59,-1,43
Dungannon,6484,6,11,8,11,59,49,10,41
Ards,6484,7,12,3,15,39,46,-7,39
Glenavon,6484,8,8,14,8,39,47,-8,38
Ballinamalla,6484,9,9,4,17,30,44,-14,31
Glentoran,6484,10,8,7,15,27,50,-23,31
Portadown,6484,11,6,6,18,21,44,-23,24
Linfield,6485,1,15,11,4,60,27,33,56
Ballymena,6485,2,17,4,9,58,53,5,55
Cliftonville,6485,3,15,8,7,48,33,15,53
Glenavon,6485,4,12,12,6,46,44,2,48
Crusaders,6485,5,13,8,9,49,41,8,47
Dungannon,6485,6,11,9,10,47,38,9,42
Coleraine,6485,7,10,8,12,42,46,-4,38
Ballinamalla,6485,8,9,6,15,37,45,-8,33
Ards,6485,9,9,5,16,35,47,-12,32
Portadown,6485,10,5,10,15,21,44,-23,25
Glentoran,6485,11,5,7,18,20,45,-25,22
Crusaders,6486,1,20,7,3,63,30,33,67
Cliftonville,6486,2,18,4,8,60,38,22,58
Glenavon,6486,3,13,11,6,48,41,7,50
Linfield,6486,4,13,9,8,58,37,21,48
Ballymena,6486,5,14,5,11,58,58,0,47
Glentoran,6486,6,11,9,10,43,44,-1,42
Coleraine,6486,7,11,8,11,39,40,-1,41
Dungannon,6486,8,7,10,13,40,47,-7,31
Portadown,6486,9,8,6,16,26,41,-15,30
Ards,6486,10,6,4,20,37,61,-24,22
Ballinamalla,6486,11,6,3,21,21,56,-35,21
Crusaders,6487,1,18,7,5,62,29,33,61
Linfield,6487,2,14,11,5,60,29,31,53
Ballymena,6487,3,16,5,9,63,59,4,53
Cliftonville,6487,4,16,3,11,49,41,8,51
Dungannon,6487,5,14,8,8,50,35,15,50
Coleraine,6487,6,9,10,11,38,36,2,37
Glenavon,6487,7,9,9,12,34,44,-10,36
Ards,6487,8,9,8,13,35,43,-8,35
Glentoran,6487,9,7,7,16,24,49,-25,28
Ballinamalla,6487,10,7,6,17,28,50,-22,27
Portadown,6487,11,6,6,18,18,46,-28,24
Linfield,6488,1,14,10,6,56,32,24,52
Crusaders,6488,2,14,8,8,56,43,13,50
Cliftonville,6488,3,14,6,10,58,43,15,48
Ballymena,6488,4,13,5,12,57,62,-5,44
Dungannon,6488,5,10,11,9,53,39,14,41
Glenavon,6488,6,10,11,9,49,52,-3,41
Ards,6488,7,11,7,12,46,48,-2,40
Glentoran,6488,8,10,9,11,36,43,-7,39
Coleraine,6488,9,8,14,8,41,40,1,38
Portadown,6488,10,9,7,14,25,43,-18,34
Ballinamalla,6488,11,5,6,19,27,59,-32,21
Crusaders,6489,1,16,7,7,61,39,22,55
Cliftonville,6489,2,15,6,9,54,42,12,51
Ballymena,6489,3,14,8,8,58,58,0,50
Linfield,6489,4,13,10,7,64,35,29,49
Glenavon,6489,5,12,9,9,50,45,5,45
Dungannon,6489,6,12,6,12,56,45,11,42
Coleraine,6489,7,10,9,11,45,46,-1,39
Ards,6489,8,10,5,15,39,51,-12,35
Portadown,6489,9,9,5,16,29,45,-16,32
Glentoran,6489,10,8,8,14,29,48,-19,32
Ballinamalla,6489,11,7,5,18,30,61,-31,26
Crusaders,6490,1,17,10,3,63,33,30,61
Linfield,6490,2,15,8,7,57,33,24,53
Cliftonville,6490,3,14,7,9,52,43,9,49
Ballymena,6490,4,13,7,10,60,57,3,46
Coleraine,6490,5,9,13,8,42,43,-1,40
Glenavon,6490,6,8,15,7,45,48,-3,39
Dungannon,6490,7,9,8,13,51,54,-3,35
Ards,6490,8,10,4,16,39,44,-5,34
Ballinamalla,6490,9,10,4,16,35,48,-13,34
Glentoran,6490,10,9,7,14,37,54,-17,34
Portadown,6490,11,6,7,17,22,46,-24,25
Crusaders,6491,1,19,8,3,55,29,26,65
Linfield,6491,2,14,9,7,60,34,26,51
Cliftonville,6491,3,15,4,11,61,43,18,49
Coleraine,6491,4,12,9,9,43,41,2,45
Dungannon,6491,5,12,7,11,51,48,3,43
Ballymena,6491,6,12,7,11,50,56,-6,43
Glenavon,6491,7,11,9,10,48,47,1,42
Ards,6491,8,12,4,14,36,44,-8,40
Glentoran,6491,9,8,8,14,28,43,-15,32
Portadown,6491,10,7,3,20,26,49,-23,24
Ballinamalla,6491,11,6,6,18,29,53,-24,24
Cliftonville,6492,1,17,5,8,54,33,21,56
Ballymena,6492,2,15,6,9,60,55,5,51
Crusaders,6492,3,14,8,8,49,38,11,50
Linfield,6492,4,13,9,8,48,32,16,48
Coleraine,6492,5,10,12,8,40,36,4,42
Dungannon,6492,6,11,8,11,48,42,6,41
Glenavon,6492,7,9,11,10,44,51,-7,38
Portadown,6492,8,11,4,15,30,41,-11,37
Glentoran,6492,9,9,6,15,29,47,-18,33
Ards,6492,10,8,6,16,34,44,-10,30
Ballinamalla,6492,11,8,5,17,29,46,-17,29
Crusaders,6493,1,22,5,3,63,26,37,71
Linfield,6493,2,15,9,6,66,33,33,54
Cliftonville,6493,3,15,6,9,48,37,11,51
Ballymena,6493,4,14,4,12,59,64,-5,46
Coleraine,6493,5,10,12,8,43,37,6,42
Glentoran,6493,6,12,6,12,38,42,-4,42
Dungannon,6493,7,10,6,14,49,49,0,36
Glenavon,6493,8,8,10,12,39,50,-11,34
Portadown,6493,9,9,5,16,27,41,-14,32
Ards,6493,10,9,4,17,38,55,-17,31
Ballinamalla,6493,11,6,3,21,25,61,-36,21
Cliftonville,6494,1,16,4,10,57,45,12,52
Crusaders,6494,2,15,7,8,54,42,12,52
Coleraine,6494,3,14,10,6,43,32,11,52
Ballymena,6494,4,13,6,11,61,60,1,45
Glenavon,6494,5,11,10,9,47,42,5,43
Linfield,6494,6,11,8,11,47,37,10,41
Dungannon,6494,7,10,10,10,51,39,12,40
Glentoran,6494,8,11,6,13,40,48,-8,39
Ards,6494,9,11,2,17,44,59,-15,35
Portadown,6494,10,10,3,17,27,45,-18,33
Ballinamalla,6494,11,8,4,18,29,51,-22,28
Cliftonville,6495,1,15,7,8,51,34,17,52
Crusaders,6495,2,15,7,8,52,37,15,52
Glenavon,6495,3,13,11,6,51,39,12,50
Linfield,6495,4,13,10,7,57,35,22,49
Coleraine,6495,5,11,11,8,48,35,13,44
Ballymena,6495,6,12,6,12,56,67,-11,42
Dungannon,6495,7,9,9,12,50,47,3,36
Glentoran,6495,8,9,9,12,34,44,-10,36
Ballinamalla,6495,9,10,4,16,38,52,-14,34
Ards,6495,10,9,6,15,34,50,-16,33
Portadown,6495,11,7,4,19,22,53,-31,25
Linfield,6496,1,18,7,5,61,27,34,61
Crusaders,6496,2,16,9,5,56,36,20,57
Cliftonville,6496,3,14,6,10,51,42,9,48
Glenavon,6496,4,13,9,8,48,39,9,48
Coleraine,6496,5,13,9,8,56,50,6,48
Dungannon,6496,6,13,7,10,50,33,17,46
Ballymena,6496,7,11,7,12,52,61,-9,40
Glentoran,6496,8,6,12,12,32,46,-14,30
Ards,6496,9,8,4,18,37,58,-21,28
Ballinamalla,6496,10,7,5,18,24,50,-26,26
Portadown,6496,11,6,5,19,23,48,-25,23
Ballymena,6497,1,17,6,7,61,51,10,57
Glenavon,6497,2,14,10,6,49,39,10,52
Linfield,6497,3,14,9,7,59,34,25,51
Crusaders,6497,4,14,7,9,49,33,16,49
Cliftonville,6497,5,15,4,11,53,40,13,49
Coleraine,6497,6,9,12,9,40,42,-2,39
Dungannon,6497,7,8,10,12,48,44,4,34
Glentoran,6497,8,9,6,15,28,44,-16,33
Ards,6497,9,9,5,16,36,51,-15,32
Ballinamalla,6497,10,7,8,15,27,46,-19,29
Portadown,6497,11,7,7,16,27,53,-26,28
Linfield,6498,1,16,7,7,59,27,32,55
Crusaders,6498,2,14,7,9,51,32,19,49
Cliftonville,6498,3,15,4,11,49,41,8,49
Ballymena,6498,4,14,7,9,56,60,-4,49
Glenavon,6498,5,11,12,7,45,46,-1,45
Ards,6498,6,11,6,13,41,45,-4,39
Glentoran,6498,7,11,6,13,36,45,-9,39
Dungannon,6498,8,9,10,11,52,48,4,37
Coleraine,6498,9,8,11,11,41,43,-2,35
Ballinamalla,6498,10,10,3,17,29,50,-21,33
Portadown,6498,11,7,5,18,24,46,-22,26
Coleraine,6499,1,15,9,6,50,31,19,54
Crusaders,6499,2,15,8,7,57,39,18,53
Ballymena,6499,3,14,9,7,61,53,8,51
Cliftonville,6499,4,15,5,10,51,42,9,50
Glenavon,6499,5,10,13,7,43,44,-1,43
Linfield,6499,6,11,9,10,51,36,15,42
Dungannon,6499,7,10,9,11,49,43,6,39
Ards,6499,8,11,4,15,41,46,-5,37
Glentoran,6499,9,8,9,13,29,42,-13,33
Portadown,6499,10,10,2,18,24,46,-22,32
Ballinamalla,6499,11,4,7,19,20,54,-34,19
Crusaders,6500,1,15,8,7,59,37,22,53
Glenavon,6500,2,14,9,7,60,45,15,51
Ballymena,6500,3,15,6,9,58,54,4,51
Linfield,6500,4,13,9,8,57,39,18,48
Cliftonville,6500,5,12,9,9,47,42,5,45
Coleraine,6500,6,10,13,7,49,43,6,43
Dungannon,6500,7,10,10,10,50,47,3,40
Ballinamalla,6500,8,10,3,17,32,51,-19,33
Ards,6500,9,9,4,17,39,56,-17,31
Glentoran,6500,10,8,6,16,31,48,-17,30
Portadown,6500,11,8,5,17,28,48,-20,29
Cliftonville,6501,1,16,7,7,52,36,16,55
Linfield,6501,2,15,9,6,56,30,26,54
Glenavon,6501,3,13,9,8,50,44,6,48
Crusaders,6501,4,12,8,10,49,39,10,44
Coleraine,6501,5,12,8,10,40,36,4,44
Ballymena,6501,6,12,4,14,53,59,-6,40
Glentoran,6501,7,11,6,13,37,44,-7,39
Portadown,6501,8,11,3,16,32,47,-15,36
Ards,6501,9,10,4,16,39,49,-10,34
Dungannon,6501,10,8,9,13,43,50,-7,33
Ballinamalla,6501,11,9,5,16,31,48,-17,32
Crusaders,6502,1,18,10,2,55,27,28,64
Cliftonville,6502,2,18,6,6,56,32,24,60
Ballymena,6502,3,14,6,10,56,52,4,48
Linfield,6502,4,12,10,8,59,38,21,46
Glenavon,6502,5,11,10,9,50,47,3,43
Glentoran,6502,6,12,6,12,34,43,-9,42
Dungannon,6502,7,9,9,12,50,45,5,36
Coleraine,6502,8,6,14,10,42,52,-10,32
Ards,6502,9,8,5,17,36,56,-20,29
Portadown,6502,10,8,3,19,25,46,-21,27
Ballinamalla,6502,11,7,5,18,32,57,-25,26
Crusaders,6503,1,13,10,7,54,37,17,49
Cliftonville,6503,2,15,4,11,49,39,10,49
Linfield,6503,3,13,9,8,52,32,20,48
Coleraine,6503,4,13,8,9,40,34,6,47
Dungannon,6503,5,11,10,9,54,43,11,43
Glenavon,6503,6,10,12,8,43,45,-2,42
Glentoran,6503,7,11,7,12,38,46,-8,40
Ballymena,6503,8,10,7,13,54,65,-11,37
Ballinamalla,6503,9,11,4,15,34,47,-13,37
Portadown,6503,10,8,7,15,29,46,-17,31
Ards,6503,11,8,6,16,38,51,-13,30
Crusaders,6504,1,15,11,4,57,39,18,56
Linfield,6504,2,14,11,5,64,34,30,53
Coleraine,6504,3,14,10,6,50,40,10,52
Cliftonville,6504,4,15,4,11,52,40,12,49
Glenavon,6504,5,12,11,7,54,43,11,47
Ballymena,6504,6,12,8,10,55,57,-2,44
Dungannon,6504,7,8,13,9,60,48,12,37
Ards,6504,8,9,5,16,36,54,-18,32
Glentoran,6504,9,7,10,13,29,44,-15,31
Portadown,6504,10,7,4,19,23,49,-26,25
Ballinamalla,6504,11,6,5,19,30,62,-32,23
Linfield,6505,1,17,7,6,66,32,34,58
Cliftonville,6505,2,17,5,8,56,30,26,56
Crusaders,6505,3,15,9,6,51,34,17,54
Glenavon,6505,4,13,11,6,49,37,12,50
Ballymena,6505,5,13,7,10,61,63,-2,46
Dungannon,6505,6,10,8,12,48,45,3,38
Coleraine,6505,7,9,10,11,37,42,-5,37
Portadown,6505,8,9,5,16,23,44,-21,32
Glentoran,6505,9,6,12,12,31,50,-19,30
Ards,6505,10,7,7,16,36,55,-19,28
Ballinamalla,6505,11,6,5,19,23,49,-26,23
Crusaders,6506,1,19,5,6,60,31,29,62
Cliftonville,6506,2,15,6,9,49,43,6,51
Linfield,6506,3,13,10,7,54,31,23,49
Ballymena,6506,4,14,5,11,63,61,2,47
Dungannon,6506,5,12,10,8,48,37,11,46
Coleraine,6506,6,10,13,7,44,36,8,43
Glenavon,6506,7,12,7,11,50,47,3,43
Glentoran,6506,8,9,7,14,30,45,-15,34
Portadown,6506,9,8,6,16,33,50,-17,30
Ballinamalla,6506,10,7,5,18,23,52,-29,26
Ards,6506,11,6,6,18,30,51,-21,24
Crusaders,6507,1,18,7,5,63,35,28,61
Cliftonville,6507,2,15,6,9,56,42,14,51
Linfield,6507,3,12,12,6,58,36,22,48
Coleraine,6507,4,11,10,9,49,44,5,43
Ballymena,6507,5,12,7,11,58,63,-5,43
Glenavon,6507,6,9,14,7,47,51,-4,41
Ballinamalla,6507,7,11,5,14,33,45,-12,38
Glentoran,6507,8,10,6,14,32,39,-7,36
Dungannon,6507,9,9,7,14,47,51,-4,34
Portadown,6507,10,9,6,15,30,45,-15,33
Ards,6507,11,6,6,18,32,54,-22,24
Crusaders,6508,1,19,5,6,53,31,22,62
Ballymena,6508,2,14,9,7,66,53,13,51
Cliftonville,6508,3,14,9,7,52,40,12,51
Linfield,6508,4,11,15,4,66,39,27,48
Dungannon,6508,5,10,10,10,53,44,9,40
Coleraine,6508,6,9,12,9,42,44,-2,39
Glenavon,6508,7,9,11,10,43,50,-7,38
Ards,6508,8,11,4,15,41,46,-5,37
Glentoran,6508,9,7,12,11,34,44,-10,33
Ballinamalla,6508,10,6,6,18,32,61,-29,24
Portadown,6508,11,4,9,17,20,50,-30,21
Crusaders,6509,1,19,6,5,62,32,30,63
Linfield,6509,2,15,10,5,65,36,29,55
Ballymena,6509,3,15,9,6,56,48,8,54
Glenavon,6509,4,15,8,7,57,41,16,53
Cliftonville,6509,5,14,7,9,55,40,15,49
Dungannon,6509,6,10,9,11,47,48,-1,39
Coleraine,6509,7,8,11,11,41,45,-4,35
Ards,6509,8,9,6,15,39,50,-11,33
Glentoran,6509,9,8,6,16,28,49,-21,30
Ballinamalla,6509,10,8,4,18,31,57,-26,28
Portadown,6509,11,5,2,23,23,58,-35,17
Crusaders,6510,1,15,10,5,53,35,18,55
Linfield,6510,2,15,9,6,63,33,30,54
Cliftonville,6510,3,16,4,10,59,49,10,52
Dungannon,6510,4,12,11,7,60,42,18,47
Coleraine,6510,5,11,12,7,53,44,9,45
Ballymena,6510,6,13,6,11,62,59,3,45
Glenavon,6510,7,11,11,8,49,50,-1,44
Glentoran,6510,8,8,6,16,35,52,-17,30
Ballinamalla,6510,9,9,3,18,30,50,-20,30
Ards,6510,10,7,5,18,36,63,-27,26
Portadown,6510,11,5,9,16,30,53,-23,24
Cliftonville,6511,1,15,6,9,58,42,16,51
Crusaders,6511,2,14,8,8,48,36,12,50
Ballymena,6511,3,15,5,10,59,54,5,50
Coleraine,6511,4,11,11,8,47,42,5,44
Linfield,6511,5,11,10,9,53,37,16,43
Glentoran,6511,6,11,9,10,40,43,-3,42
Glenavon,6511,7,10,11,9,48,47,1,41
Dungannon,6511,8,10,9,11,50,42,8,39
Ards,6511,9,11,5,14,38,45,-7,38
Portadown,6511,10,9,5,16,25,50,-25,32
Ballinamalla,6511,11,5,7,18,26,54,-28,22
Linfield,6512,1,16,8,6,55,25,30,56
Cliftonville,6512,2,17,5,8,53,34,19,56
Crusaders,6512,3,16,8,6,51,32,19,56
Ballymena,6512,4,14,4,12,58,62,-4,46
Coleraine,6512,5,11,12,7,43,40,3,45
Glenavon,6512,6,11,11,8,48,41,7,44
Dungannon,6512,7,9,7,14,43,51,-8,34
Portadown,6512,8,9,5,16,30,47,-17,32
Ballinamalla,6512,9,8,6,16,30,48,-18,30
Ards,6512,10,7,7,16,39,49,-10,28
Glentoran,6512,11,7,7,16,21,42,-21,28
Cliftonville,6513,1,18,4,8,59,33,26,58
Crusaders,6513,2,15,8,7,67,35,32,53
Ballymena,6513,3,16,5,9,63,68,-5,53
Glenavon,6513,4,13,9,8,47,47,0,48
Coleraine,6513,5,12,9,9,41,43,-2,45
Linfield,6513,6,11,11,8,59,38,21,44
Dungannon,6513,7,11,10,9,51,40,11,43
Ballinamalla,6513,8,10,3,17,37,57,-20,33
Glentoran,6513,9,7,9,14,36,50,-14,30
Ards,6513,10,8,4,18,34,54,-20,28
Portadown,6513,11,4,8,18,17,46,-29,20
Crusaders,6514,1,19,6,5,60,34,26,63
Linfield,6514,2,15,9,6,62,34,28,54
Ballymena,6514,3,14,5,11,59,61,-2,47
Glenavon,6514,4,10,11,9,47,46,1,41
Glentoran,6514,5,11,8,11,31,46,-15,41
Coleraine,6514,6,10,10,10,46,42,4,40
Dungannon,6514,7,10,9,11,46,40,6,39
Cliftonville,6514,8,11,6,13,44,42,2,39
Ballinamalla,6514,9,9,6,15,36,50,-14,33
Ards,6514,10,8,5,17,39,54,-15,29
Portadown,6514,11,8,5,17,27,48,-21,29
Linfield,6515,1,16,7,7,62,32,30,55
Ballymena,6515,2,16,6,8,65,52,13,54
Crusaders,6515,3,15,8,7,49,34,15,53
Cliftonville,6515,4,16,4,10,53,42,11,52
Coleraine,6515,5,12,8,10,48,47,1,44
Glenavon,6515,6,11,10,9,46,44,2,43
Ballinamalla,6515,7,13,4,13,33,41,-8,43
Ards,6515,8,9,5,16,38,51,-13,32
Dungannon,6515,9,6,13,11,43,46,-3,31
Glentoran,6515,10,7,8,15,30,43,-13,29
Portadown,6515,11,4,7,19,21,56,-35,19
Crusaders,6516,1,17,9,4,55,30,25,60
Cliftonville,6516,2,17,4,9,55,36,19,55
Linfield,6516,3,15,8,7,66,33,33,53
Glenavon,6516,4,12,10,8,51,44,7,46
Ballymena,6516,5,14,4,12,57,61,-4,46
Coleraine,6516,6,11,10,9,40,39,1,43
Dungannon,6516,7,10,8,12,48,42,6,38
Glentoran,6516,8,8,10,12,28,42,-14,34
Ards,6516,9,8,7,15,36,51,-15,31
Ballinamalla,6516,10,8,5,17,27,51,-24,29
Portadown,6516,11,5,5,20,18,52,-34,20
Cliftonville,6517,1,19,4,7,58,36,22,61
Ballymena,6517,2,17,7,6,81,51,30,58
Crusaders,6517,3,17,4,9,54,43,11,55
Glenavon,6517,4,14,10,6,54,46,8,52
Linfield,6517,5,14,8,8,58,33,25,50
Coleraine,6517,6,12,9,9,37,40,-3,45
Dungannon,6517,7,9,8,13,52,52,0,35
Glentoran,6517,8,8,6,16,27,48,-21,30
Ards,6517,9,8,5,17,34,54,-20,29
Ballinamalla,6517,10,6,4,20,30,56,-26,22
Portadown,6517,11,5,7,18,20,46,-26,22
Crusaders,6518,1,15,8,7,54,34,20,53
Cliftonville,6518,2,14,8,8,52,36,16,50
Ballymena,6518,3,14,7,9,55,52,3,49
Linfield,6518,4,11,10,9,52,42,10,43
Coleraine,6518,5,10,12,8,39,35,4,42
Glenavon,6518,6,10,12,8,39,42,-3,42
Dungannon,6518,7,10,10,10,51,39,12,40
Ards,6518,8,9,9,12,40,47,-7,36
Glentoran,6518,9,9,6,15,29,43,-14,33
Ballinamalla,6518,10,7,8,15,29,48,-19,29
Portadown,6518,11,7,8,15,23,45,-22,29
Crusaders,6519,1,21,6,3,65,29,36,69
Glenavon,6519,2,15,9,6,58,40,18,54
Linfield,6519,3,15,8,7,54,33,21,53
Ballymena,6519,4,14,7,9,56,55,1,49
Cliftonville,6519,5,13,5,12,50,39,11,44
Coleraine,6519,6,12,8,10,39,40,-1,44
Glentoran,6519,7,11,5,14,29,41,-12,38
Dungannon,6519,8,10,6,14,48,46,2,36
Portadown,6519,9,7,5,18,24,49,-25,26
Ards,6519,10,7,4,19,35,57,-22,25
Ballinamalla,6519,11,6,5,19,27,56,-29,23
Cliftonville,6520,1,16,5,9,56,37,19,53
Crusaders,6520,2,14,8,8,50,36,14,50
Ballymena,6520,3,14,7,9,60,62,-2,49
Linfield,6520,4,13,9,8,55,38,17,48
Coleraine,6520,5,12,10,8,43,35,8,46
Glenavon,6520,6,11,12,7,43,39,4,45
Dungannon,6520,7,10,9,11,57,48,9,39
Glentoran,6520,8,10,6,14,34,48,-14,36
Ballinamalla,6520,9,9,5,16,32,49,-17,32
Ards,6520,10,7,7,16,39,57,-18,28
Portadown,6520,11,6,8,16,29,49,-20,26
Crusaders,6521,1,18,6,6,56,39,17,60
Cliftonville,6521,2,18,5,7,57,33,24,59
Linfield,6521,3,15,9,6,57,27,30,54
Dungannon,6521,4,14,9,7,52,33,19,51
Coleraine,6521,5,10,12,8,46,42,4,42
Glentoran,6521,6,11,6,13,39,41,-2,39
Glenavon,6521,7,9,11,10,48,54,-6,38
Ballymena,6521,8,10,8,12,53,65,-12,38
Ards,6521,9,9,6,15,42,49,-7,33
Portadown,6521,10,5,6,19,23,54,-31,21
Ballinamalla,6521,11,4,6,20,30,66,-36,18
Crusaders,6522,1,18,6,6,59,28,31,60
Linfield,6522,2,14,9,7,53,31,22,51
Coleraine,6522,3,14,9,7,40,36,4,51
Cliftonville,6522,4,15,5,10,54,34,20,50
Glenavon,6522,5,11,12,7,46,41,5,45
Dungannon,6522,6,12,7,11,50,40,10,43
Ballymena,6522,7,12,5,13,48,61,-13,41
Ballinamalla,6522,8,9,5,16,33,52,-19,32
Ards,6522,9,9,3,18,33,52,-19,30
Glentoran,6522,10,8,6,16,30,49,-19,30
Portadown,6522,11,6,7,17,27,49,-22,25
Linfield,6523,1,17,8,5,56,30,26,59
Crusaders,6523,2,15,8,7,48,31,17,53
Cliftonville,6523,3,15,7,8,53,40,13,52
Coleraine,6523,4,12,9,9,45,33,12,45
Ballymena,6523,5,13,6,11,58,61,-3,45
Glenavon,6523,6,11,10,9,42,41,1,43
Ards,6523,7,11,4,15,36,42,-6,37
Glentoran,6523,8,9,7,14,26,43,-17,34
Ballinamalla,6523,9,8,6,16,29,48,-19,30
Dungannon,6523,10,6,11,13,39,42,-3,29
Portadown,6523,11,8,4,18,26,47,-21,28
Ballymena,6524,1,16,4,10,59,59,0,52
Coleraine,6524,2,13,12,5,42,30,12,51
Linfield,6524,3,13,10,7,57,29,28,49
Crusaders,6524,4,14,5,11,50,37,13,47
Cliftonville,6524,5,14,3,13,51,44,7,45
Dungannon,6524,6,11,10,9,52,42,10,43
Glenavon,6524,7,10,10,10,48,47,1,40
Portadown,6524,8,10,4,16,26,43,-17,34
Ballinamalla,6524,9,10,4,16,30,50,-20,34
Ards,6524,10,8,8,14,39,51,-12,32
Glentoran,6524,11,6,10,14,26,48,-22,28
Linfield,6525,1,13,10,7,58,32,26,49
Cliftonville,6525,2,15,4,11,56,42,14,49
Crusaders,6525,3,14,6,10,56,40,16,48
Coleraine,6525,4,11,14,5,46,36,10,47
Glenavon,6525,5,11,10,9,47,46,1,43
Dungannon,6525,6,10,11,9,48,43,5,41
Glentoran,6525,7,11,8,11,31,37,-6,41
Ballymena,6525,8,11,6,13,52,62,-10,39
Ards,6525,9,10,5,15,41,51,-10,35
Portadown,6525,10,9,6,15,24,44,-20,33
Ballinamalla,6525,11,7,6,17,22,48,-26,27
Crusaders,6526,1,17,8,5,59,39,20,59
Linfield,6526,2,15,9,6,60,33,27,54
Cliftonville,6526,3,16,3,11,54,42,12,51
Glenavon,6526,4,13,9,8,51,43,8,48
Coleraine,6526,5,12,9,9,40,33,7,45
Dungannon,6526,6,9,13,8,50,46,4,40
Ballymena,6526,7,11,7,12,52,62,-10,40
Ards,6526,8,9,6,15,35,46,-11,33
Portadown,6526,9,7,7,16,30,47,-17,28
Ballinamalla,6526,10,7,7,16,33,52,-19,28
Glentoran,6526,11,6,8,16,31,52,-21,26
Cliftonville,6527,1,16,6,8,56,36,20,54
Crusaders,6527,2,16,5,9,50,34,16,53
Linfield,6527,3,14,10,6,56,31,25,52
Ballymena,6527,4,13,7,10,58,58,0,46
Glenavon,6527,5,11,10,9,39,37,2,43
Coleraine,6527,6,10,12,8,42,38,4,42
Dungannon,6527,7,10,9,11,50,44,6,39
Ards,6527,8,10,5,15,34,41,-7,35
Glentoran,6527,9,9,7,14,25,43,-18,34
Ballinamalla,6527,10,7,7,16,25,47,-22,28
Portadown,6527,11,7,6,17,22,48,-26,27
Cliftonville,6528,1,16,6,8,58,40,18,54
Crusaders,6528,2,15,8,7,54,39,15,53
Linfield,6528,3,14,8,8,54,31,23,50
Ballymena,6528,4,14,5,11,56,64,-8,47
Dungannon,6528,5,11,10,9,54,42,12,43
Coleraine,6528,6,10,12,8,43,39,4,42
Glenavon,6528,7,9,12,9,38,39,-1,39
Ards,6528,8,10,5,15,37,48,-11,35
Glentoran,6528,9,9,6,15,30,46,-16,33
Portadown,6528,10,10,2,18,26,47,-21,32
Ballinamalla,6528,11,9,2,19,33,48,-15,29
Crusaders,6529,1,19,7,4,61,27,34,64
Cliftonville,6529,2,14,10,6,50,32,18,52
Glenavon,6529,3,13,9,8,50,46,4,48
Linfield,6529,4,12,10,8,53,34,19,46
Ballymena,6529,5,13,7,10,55,56,-1,46
Coleraine,6529,6,10,11,9,43,40,3,41
Dungannon,6529,7,9,10,11,47,42,5,37
Ards,6529,8,10,5,15,34,48,-14,35
Portadown,6529,9,8,7,15,25,45,-20,31
Glentoran,6529,10,6,9,15,27,47,-20,27
Ballinamalla,6529,11,6,5,19,28,56,-28,23
Cliftonville,6530,1,16,3,11,52,42,10,51
Crusaders,6530,2,14,8,8,58,41,17,50
Coleraine,6530,3,13,10,7,49,43,6,49
Linfield,6530,4,13,9,8,55,36,19,48
Ballymena,6530,5,13,6,11,59,59,0,45
Glenavon,6530,6,11,11,8,42,43,-1,44
Portadown,6530,7,11,6,13,32,37,-5,39
Glentoran,6530,8,11,6,13,38,49,-11,39
Dungannon,6530,9,9,9,12,45,41,4,36
Ards,6530,10,10,5,15,41,49,-8,35
Ballinamalla,6530,11,5,5,20,24,55,-31,20
Crusaders,6531,1,16,8,6,56,32,24,56
Ballymena,6531,2,15,10,5,59,49,10,55
Glenavon,6531,3,11,13,6,51,44,7,46
Cliftonville,6531,4,13,6,11,49,49,0,45
Linfield,6531,5,10,11,9,54,35,19,41
Coleraine,6531,6,10,10,10,36,39,-3,40
Glentoran,6531,7,9,9,12,30,36,-6,36
Dungannon,6531,8,9,8,13,48,53,-5,35
Ballinamalla,6531,9,9,6,15,32,50,-18,33
Ards,6531,10,7,11,12,39,45,-6,32
Portadown,6531,11,6,8,16,27,49,-22,26
Linfield,6532,1,13,10,7,51,25,26,49
Cliftonville,6532,2,14,7,9,44,34,10,49
Glenavon,6532,3,13,10,7,47,44,3,49
Ballymena,6532,4,13,10,7,52,51,1,49
Crusaders,6532,5,12,10,8,47,32,15,46
Ards,6532,6,11,6,13,39,41,-2,39
Coleraine,6532,7,9,10,11,36,39,-3,37
Glentoran,6532,8,9,9,12,34,41,-7,36
Dungannon,6532,9,8,10,12,44,50,-6,34
Portadown,6532,10,7,8,15,24,38,-14,29
Ballinamalla,6532,11,7,8,15,26,49,-23,29
Cliftonville,6533,1,19,2,9,59,42,17,59
Crusaders,6533,2,17,7,6,55,30,25,58
Glenavon,6533,3,13,11,6,55,43,12,50
Coleraine,6533,4,14,8,8,47,41,6,50
Linfield,6533,5,13,10,7,58,25,33,49
Ballymena,6533,6,12,5,13,52,63,-11,41
Glentoran,6533,7,9,9,12,30,44,-14,36
Dungannon,6533,8,7,10,13,46,48,-2,31
Ards,6533,9,8,5,17,37,53,-16,29
Ballinamalla,6533,10,6,9,15,33,55,-22,27
Portadown,6533,11,5,8,17,24,52,-28,23
Crusaders,6534,1,17,5,8,58,34,24,56
Cliftonville,6534,2,16,4,10,56,37,19,52
Coleraine,6534,3,13,10,7,47,32,15,49
Linfield,6534,4,12,10,8,50,32,18,46
Ballymena,6534,5,13,7,10,57,62,-5,46
Glenavon,6534,6,10,12,8,45,47,-2,42
Ards,6534,7,11,7,12,41,47,-6,40
Dungannon,6534,8,8,11,11,47,46,1,35
Glentoran,6534,9,7,9,14,36,52,-16,30
Ballinamalla,6534,10,7,9,14,34,56,-22,30
Portadown,6534,11,7,4,19,24,50,-26,25
Cliftonville,6535,1,17,3,10,50,35,15,54
Ballymena,6535,2,16,4,10,58,52,6,52
Crusaders,6535,3,14,8,8,53,41,12,50
Linfield,6535,4,12,8,10,59,45,14,44
Dungannon,6535,5,10,12,8,56,42,14,42
Glenavon,6535,6,11,8,11,46,51,-5,41
Coleraine,6535,7,10,10,10,43,39,4,40
Glentoran,6535,8,10,7,13,38,47,-9,37
Ards,6535,9,10,4,16,41,51,-10,34
Ballinamalla,6535,10,11,1,18,34,58,-24,34
Portadown,6535,11,9,5,16,28,45,-17,32
Cliftonville,6536,1,17,6,7,57,31,26,57
Crusaders,6536,2,15,8,7,49,37,12,53
Ballymena,6536,3,14,7,9,59,59,0,49
Linfield,6536,4,13,9,8,56,34,22,48
Coleraine,6536,5,12,10,8,43,33,10,46
Glenavon,6536,6,13,7,10,48,45,3,46
Dungannon,6536,7,11,8,11,46,40,6,41
Ards,6536,8,11,4,15,40,50,-10,37
Portadown,6536,9,8,4,18,28,49,-21,28
Glentoran,6536,10,7,6,17,21,44,-23,27
Ballinamalla,6536,11,7,5,18,24,49,-25,26
Crusaders,6537,1,15,11,4,52,34,18,56
Linfield,6537,2,14,9,7,54,27,27,51
Glenavon,6537,3,14,9,7,51,43,8,51
Cliftonville,6537,4,15,5,10,50,33,17,50
Ballymena,6537,5,15,5,10,58,51,7,50
Coleraine,6537,6,13,9,8,44,38,6,48
Dungannon,6537,7,9,11,10,47,44,3,38
Glentoran,6537,8,8,7,15,23,44,-21,31
Ards,6537,9,8,5,17,32,47,-15,29
Portadown,6537,10,7,6,17,26,49,-23,27
Ballinamalla,6537,11,6,5,19,28,55,-27,23
Crusaders,6538,1,19,5,6,59,30,29,62
Linfield,6538,2,16,7,7,61,33,28,55
Coleraine,6538,3,12,9,9,47,41,6,45
Glenavon,6538,4,12,9,9,52,48,4,45
Dungannon,6538,5,11,9,10,47,43,4,42
Ballymena,6538,6,12,6,12,53,55,-2,42
Cliftonville,6538,7,12,5,13,46,41,5,41
Portadown,6538,8,13,2,15,30,40,-10,41
Glentoran,6538,9,8,9,13,29,45,-16,33
Ards,6538,10,8,5,17,35,53,-18,29
Ballinamalla,6538,11,7,4,19,21,51,-30,25
Cliftonville,6539,1,17,6,7,62,34,28,57
Ballymena,6539,2,15,6,9,57,55,2,51
Linfield,6539,3,13,11,6,58,32,26,50
Crusaders,6539,4,14,8,8,52,45,7,50
Dungannon,6539,5,12,9,9,56,41,15,45
Glenavon,6539,6,9,13,8,44,48,-4,40
Glentoran,6539,7,11,5,14,33,41,-8,38
Ballinamalla,6539,8,11,3,16,33,49,-16,36
Coleraine,6539,9,8,10,12,38,45,-7,34
Ards,6539,10,8,4,18,36,54,-18,28
Portadown,6539,11,6,7,17,22,47,-25,25
Crusaders,6540,1,17,9,4,62,32,30,60
Linfield,6540,2,14,10,6,60,29,31,52
Cliftonville,6540,3,15,6,9,53,36,17,51
Coleraine,6540,4,13,8,9,48,41,7,47
Ballymena,6540,5,13,7,10,55,56,-1,46
Dungannon,6540,6,12,9,9,49,38,11,45
Glentoran,6540,7,10,7,13,32,44,-12,37
Ards,6540,8,10,4,16,41,52,-11,34
Glenavon,6540,9,8,10,12,47,61,-14,34
Ballinamalla,6540,10,6,7,17,27,50,-23,25
Portadown,6540,11,7,3,20,18,53,-35,24
Ballymena,6541,1,16,7,7,60,51,9,55
Crusaders,6541,2,15,7,8,55,36,19,52
Linfield,6541,3,15,6,9,57,38,19,51
Coleraine,6541,4,12,10,8,47,49,-2,46
Glenavon,6541,5,12,9,9,47,43,4,45
Dungannon,6541,6,11,11,8,50,39,11,44
Cliftonville,6541,7,13,4,13,46,41,5,43
Glentoran,6541,8,10,8,12,36,43,-7,38
Ards,6541,9,10,3,17,33,48,-15,33
Ballinamalla,6541,10,7,5,18,26,47,-21,26
Portadown,6541,11,7,4,19,22,44,-22,25
Linfield,6542,1,14,10,6,60,38,22,52
Crusaders,6542,2,14,8,8,55,40,15,50
Glenavon,6542,3,11,13,6,48,39,9,46
Ballymena,6542,4,13,5,12,59,58,1,44
Cliftonville,6542,5,12,6,12,43,42,1,42
Dungannon,6542,6,9,12,9,50,41,9,39
Coleraine,6542,7,9,12,9,42,41,1,39
Ards,6542,8,11,6,13,38,41,-3,39
Ballinamalla,6542,9,10,5,15,30,43,-13,35
Portadown,6542,10,9,6,15,23,43,-20,33
Glentoran,6542,11,8,7,15,28,50,-22,31
Crusaders,6543,1,15,7,8,61,45,16,52
Linfield,6543,2,14,9,7,60,37,23,51
Ballymena,6543,3,14,8,8,57,45,12,50
Cliftonville,6543,4,14,8,8,46,35,11,50
Glenavon,6543,5,11,11,8,53,45,8,44
Dungannon,6543,6,10,12,8,48,41,7,42
Ballinamalla,6543,7,10,7,13,31,45,-14,37
Coleraine,6543,8,8,11,11,34,41,-7,35
Ards,6543,9,9,6,15,31,44,-13,33
Portadown,6543,10,7,7,16,23,42,-19,28
Glentoran,6543,11,5,10,15,25,49,-24,25
Linfield,6544,1,15,10,5,68,33,35,55
Coleraine,6544,2,14,11,5,43,34,9,53
Crusaders,6544,3,14,9,7,52,32,20,51
Cliftonville,6544,4,16,3,11,50,45,5,51
Glenavon,6544,5,13,9,8,49,45,4,48
Ballymena,6544,6,14,5,11,56,55,1,47
Dungannon,6544,7,13,7,10,47,35,12,46
Ballinamalla,6544,8,9,6,15,30,49,-19,33
Ards,6544,9,8,3,19,39,59,-20,27
Glentoran,6544,10,6,9,15,27,48,-21,27
Portadown,6544,11,4,6,20,18,44,-26,18
Crusaders,6545,1,16,9,5,51,38,13,57
Ballymena,6545,2,16,8,6,61,54,7,56
Cliftonville,6545,3,17,4,9,53,36,17,55
Linfield,6545,4,13,8,9,60,41,19,47
Glenavon,6545,5,11,9,10,47,45,2,42
Dungannon,6545,6,10,10,10,52,42,10,40
Coleraine,6545,7,10,8,12,39,44,-5,38
Glentoran,6545,8,9,7,14,35,44,-9,34
Ards,6545,9,9,7,14,31,43,-12,34
Ballinamalla,6545,10,9,3,18,27,50,-23,30
Portadown,6545,11,6,5,19,27,46,-19,23
Cliftonville,6546,1,17,5,8,61,37,24,56
Linfield,6546,2,15,8,7,59,29,30,53
Crusaders,6546,3,14,9,7,59,42,17,51
Coleraine,6546,4,13,10,7,52,36,16,49
Ballymena,6546,5,14,6,10,56,55,1,48
Glenavon,6546,6,10,15,5,44,40,4,45
Dungannon,6546,7,10,9,11,52,48,4,39
Ards,6546,8,9,5,16,41,57,-16,32
Glentoran,6546,9,7,9,14,30,49,-19,30
Portadown,6546,10,7,4,19,27,57,-30,25
Ballinamalla,6546,11,7,4,19,30,61,-31,25
Crusaders,6547,1,17,7,6,56,36,20,58
Coleraine,6547,2,14,10,6,49,34,15,52
Linfield,6547,3,13,8,9,53,32,21,47
Cliftonville,6547,4,13,8,9,56,40,16,47
Ballymena,6547,5,12,8,10,57,59,-2,44
Glenavon,6547,6,10,11,9,47,44,3,41
Portadown,6547,7,10,7,13,33,43,-10,37
Glentoran,6547,8,8,12,10,34,44,-10,36
Dungannon,6547,9,7,13,10,48,53,-5,34
Ards,6547,10,7,5,18,30,54,-24,26
Ballinamalla,6547,11,6,7,17,31,55,-24,25
Cliftonville,6548,1,20,4,6,62,40,22,64
Crusaders,6548,2,15,10,5,56,32,24,55
Coleraine,6548,3,15,9,6,49,32,17,54
Ballymena,6548,4,11,10,9,53,59,-6,43
Linfield,6548,5,10,9,11,53,39,14,39
Glenavon,6548,6,9,11,10,46,47,-1,38
Dungannon,6548,7,9,9,12,52,49,3,36
Portadown,6548,8,10,6,14,33,42,-9,36
Ards,6548,9,10,5,15,36,50,-14,35
Glentoran,6548,10,7,9,14,33,48,-15,30
Ballinamalla,6548,11,5,6,19,25,60,-35,21
Linfield,6549,1,14,12,4,57,31,26,54
Cliftonville,6549,2,15,7,8,50,37,13,52
Coleraine,6549,3,14,9,7,53,35,18,51
Glenavon,6549,4,12,12,6,51,47,4,48
Ballymena,6549,5,14,6,10,52,57,-5,48
Crusaders,6549,6,13,8,9,56,38,18,47
Dungannon,6549,7,8,12,10,49,47,2,36
Ards,6549,8,10,4,16,36,51,-15,34
Glentoran,6549,9,8,9,13,34,45,-11,33
Portadown,6549,10,6,8,16,26,46,-20,26
Ballinamalla,6549,11,4,7,19,25,55,-30,19
Crusaders,6550,1,17,8,5,58,38,20,59
Linfield,6550,2,14,12,4,56,31,25,54
Cliftonville,6550,3,15,6,9,61,38,23,51
Glenavon,6550,4,12,12,6,47,39,8,48
Coleraine,6550,5,12,11,7,46,35,11,47
Ballymena,6550,6,12,6,12,58,61,-3,42
Ards,6550,7,11,6,13,34,42,-8,39
Dungannon,6550,8,8,9,13,44,45,-1,33
Glentoran,6550,9,9,6,15,28,45,-17,33
Ballinamalla,6550,10,7,5,18,24,47,-23,26
Portadown,6550,11,5,5,20,15,50,-35,20
Crusaders,6551,1,16,8,6,57,35,22,56
Linfield,6551,2,15,10,5,57,26,31,55
Cliftonville,6551,3,14,5,11,49,40,9,47
Dungannon,6551,4,12,10,8,56,40,16,46
Ballymena,6551,5,13,6,11,58,58,0,45
Coleraine,6551,6,10,11,9,41,40,1,41
Glenavon,6551,7,9,10,11,45,54,-9,37
Ballinamalla,6551,8,11,2,17,36,53,-17,35
Portadown,6551,9,9,6,15,29,44,-15,33
Glentoran,6551,10,8,8,14,29,50,-21,32
Ards,6551,11,7,6,17,30,47,-17,27
Ballymena,6552,1,16,5,9,64,51,13,53
Cliftonville,6552,2,16,4,10,53,39,14,52
Crusaders,6552,3,12,10,8,43,36,7,46
Glenavon,6552,4,12,10,8,44,39,5,46
Linfield,6552,5,11,12,7,51,32,19,45
Coleraine,6552,6,10,11,9,37,42,-5,41
Dungannon,6552,7,9,9,12,50,49,1,36
Glentoran,6552,8,9,9,12,30,42,-12,36
Ards,6552,9,9,7,14,38,48,-10,34
Portadown,6552,10,9,5,16,33,46,-13,32
Ballinamalla,6552,11,8,6,16,32,51,-19,30
Coleraine,6553,1,13,11,6,51,40,11,50
Cliftonville,6553,2,14,6,10,56,49,7,48
Linfield,6553,3,12,10,8,55,38,17,46
Crusaders,6553,4,13,7,10,50,43,7,46
Ards,6553,5,14,4,12,46,44,2,46
Glenavon,6553,6,11,11,8,50,43,7,44
Ballymena,6553,7,12,6,12,51,58,-7,42
Dungannon,6553,8,11,8,11,48,42,6,41
Glentoran,6553,9,8,8,14,29,44,-15,32
Portadown,6553,10,6,11,13,23,37,-14,29
Ballinamalla,6553,11,6,8,16,34,55,-21,26
Crusaders,6554,1,18,6,6,64,33,31,60
Linfield,6554,2,16,7,7,59,33,26,55
Cliftonville,6554,3,16,6,8,54,37,17,54
Ballymena,6554,4,14,7,9,60,63,-3,49
Coleraine,6554,5,11,10,9,48,47,1,43
Glenavon,6554,6,9,13,8,57,52,5,40
Dungannon,6554,7,10,10,10,50,46,4,40
Glentoran,6554,8,6,12,12,29,48,-19,30
Ards,6554,9,8,5,17,35,44,-9,29
Ballinamalla,6554,10,7,5,18,26,54,-28,26
Portadown,6554,11,6,7,17,19,44,-25,25
Linfield,6555,1,15,10,5,57,26,31,55
Cliftonville,6555,2,17,4,9,51,38,13,55
Crusaders,6555,3,15,7,8,55,43,12,52
Ballymena,6555,4,15,7,8,60,55,5,52
Coleraine,6555,5,13,8,9,45,35,10,47
Glenavon,6555,6,12,7,11,45,45,0,43
Glentoran,6555,7,8,10,12,35,47,-12,34
Dungannon,6555,8,8,8,14,54,55,-1,32
Portadown,6555,9,9,5,16,29,49,-20,32
Ballinamalla,6555,10,8,5,17,36,55,-19,29
Ards,6555,11,7,5,18,29,48,-19,26
Cliftonville,6556,1,16,6,8,51,32,19,54
Linfield,6556,2,13,13,4,59,34,25,52
Crusaders,6556,3,14,7,9,48,35,13,49
Coleraine,6556,4,12,11,7,45,36,9,47
Ballymena,6556,5,12,9,9,55,57,-2,45
Dungannon,6556,6,9,13,8,42,36,6,40
Glenavon,6556,7,8,14,8,44,47,-3,38
Ards,6556,8,10,4,16,41,50,-9,34
Glentoran,6556,9,7,9,14,32,46,-14,30
Portadown,6556,10,7,8,15,28,45,-17,29
Ballinamalla,6556,11,6,8,16,28,55,-27,26
Cliftonville,6557,1,20,4,6,64,33,31,64
Linfield,6557,2,18,8,4,63,28,35,62
Crusaders,6557,3,15,10,5,49,33,16,55
Coleraine,6557,4,12,11,7,45,39,6,47
Ballymena,6557,5,11,6,13,55,66,-11,39
Glentoran,6557,6,9,10,11,37,44,-7,37
Glenavon,6557,7,9,8,13,49,56,-7,35
Dungannon,6557,8,8,8,14,44,46,-2,32
Ards,6557,9,9,5,16,35,46,-11,32
Ballinamalla,6557,10,7,7,16,27,48,-21,28
Portadown,6557,11,7,3,20,24,53,-29,24
Linfield,6558,1,15,10,5,57,30,27,55
Cliftonville,6558,2,16,6,8,49,35,14,54
Coleraine,6558,3,13,11,6,40,33,7,50
Crusaders,6558,4,12,8,10,47,38,9,44
Glenavon,6558,5,10,11,9,52,49,3,41
Ballymena,6558,6,12,5,13,57,58,-1,41
Dungannon,6558,7,10,9,11,51,45,6,39
Glentoran,6558,8,9,8,13,33,41,-8,35
Portadown,6558,9,9,7,14,24,42,-18,34
Ards,6558,10,8,6,16,36,52,-16,30
Ballinamalla,6558,11,9,3,18,27,50,-23,30
Ballymena,6559,1,17,6,7,63,53,10,57
Cliftonville,6559,2,17,4,9,53,39,14,55
Crusaders,6559,3,16,5,9,50,37,13,53
Linfield,6559,4,13,9,8,62,38,24,48
Coleraine,6559,5,10,12,8,46,42,4,42
Dungannon,6559,6,11,6,13,50,45,5,39
Glenavon,6559,7,9,12,9,46,49,-3,39
Portadown,6559,8,9,5,16,26,46,-20,32
Ards,6559,9,8,7,15,34,46,-12,31
Glentoran,6559,10,8,7,15,24,42,-18,31
Ballinamalla,6559,11,9,3,18,36,53,-17,30
Crusaders,6560,1,16,7,7,55,40,15,55
Linfield,6560,2,14,11,5,56,31,25,53
Glenavon,6560,3,14,9,7,49,43,6,51
Ballymena,6560,4,14,7,9,55,53,2,49
Cliftonville,6560,5,15,3,12,51,42,9,48
Coleraine,6560,6,10,11,9,39,38,1,41
Dungannon,6560,7,8,12,10,49,41,8,36
Portadown,6560,8,9,7,14,28,39,-11,34
Ballinamalla,6560,9,9,5,16,28,43,-15,32
Ards,6560,10,8,5,17,33,51,-18,29
Glentoran,6560,11,6,7,17,33,55,-22,25
Cliftonville,6561,1,18,5,7,61,39,22,59
Linfield,6561,2,13,11,6,59,30,29,50
Dungannon,6561,3,11,13,6,54,40,14,46
Coleraine,6561,4,11,13,6,42,39,3,46
Crusaders,6561,5,13,5,12,48,46,2,44
Glenavon,6561,5,11,11,8,48,46,2,44
Ballymena,6561,7,12,4,14,53,61,-8,40
Ards,6561,8,10,7,13,43,48,-5,37
Ballinamalla,6561,9,9,5,16,29,46,-17,32
Glentoran,6561,10,7,7,16,27,48,-21,28
Portadown,6561,11,8,3,19,26,47,-21,27
Crusaders,6562,1,18,6,6,54,31,23,60
Cliftonville,6562,2,17,3,10,58,37,21,54
Linfield,6562,3,14,10,6,62,37,25,52
Ballymena,6562,4,14,5,11,63,56,7,47
Coleraine,6562,5,12,9,9,37,33,4,45
Glenavon,6562,6,10,9,11,49,53,-4,39
Dungannon,6562,7,10,8,12,53,46,7,38
Ards,6562,8,10,5,15,43,52,-9,35
Glentoran,6562,9,9,8,13,36,55,-19,35
Ballinamalla,6562,10,8,4,18,30,55,-25,28
Portadown,6562,11,7,5,18,25,55,-30,26
Cliftonville,6563,1,18,4,8,53,38,15,58
Ballymena,6563,2,16,6,8,57,49,8,54
Crusaders,6563,3,14,9,7,56,41,15,51
Linfield,6563,4,13,10,7,58,33,25,49
Coleraine,6563,5,10,13,7,45,35,10,43
Glenavon,6563,6,9,14,7,42,43,-1,41
Dungannon,6563,7,10,9,11,50,50,0,39
Glentoran,6563,8,11,6,13,38,43,-5,39
Ards,6563,9,9,5,16,37,50,-13,32
Ballinamalla,6563,10,7,4,19,26,56,-30,25
Portadown,6563,11,6,4,20,24,48,-24,22
Linfield,6564,1,17,8,5,62,29,33,59
Crusaders,6564,2,16,9,5,60,34,26,57
Cliftonville,6564,3,15,6,9,50,37,13,51
Glenavon,6564,4,14,9,7,49,43,6,51
Ballymena,6564,5,14,8,8,62,56,6,50
Coleraine,6564,6,10,9,11,38,42,-4,39
Dungannon,6564,7,8,9,13,46,49,-3,33
Ards,6564,8,9,5,16,35,55,-20,32
Ballinamalla,6564,9,9,4,17,37,55,-18,31
Portadown,6564,10,8,5,17,24,42,-18,29
Glentoran,6564,11,6,6,18,27,48,-21,24
Crusaders,6565,1,18,6,6,66,32,34,60
Linfield,6565,2,16,8,6,63,34,29,56
Ballymena,6565,3,14,8,8,60,54,6,50
Cliftonville,6565,4,14,6,10,50,43,7,48
Dungannon,6565,5,11,10,9,49,40,9,43
Coleraine,6565,6,11,10,9,43,39,4,43
Ards,6565,7,11,5,14,38,45,-7,38
Glenavon,6565,8,8,11,11,46,54,-8,35
Ballinamalla,6565,9,8,4,18,28,51,-23,28
Glentoran,6565,10,7,7,16,27,54,-27,28
Portadown,6565,11,8,3,19,28,52,-24,27
Cliftonville,6566,1,20,4,6,64,30,34,64
Crusaders,6566,2,18,9,3,66,33,33,63
Linfield,6566,3,14,8,8,53,33,20,50
Glenavon,6566,4,13,9,8,49,44,5,48
Coleraine,6566,5,12,10,8,43,38,5,46
Ballymena,6566,6,10,8,12,49,60,-11,38
Dungannon,6566,7,8,12,10,52,47,5,36
Ards,6566,8,10,6,14,37,47,-10,36
Glentoran,6566,9,9,6,15,29,49,-20,33
Ballinamalla,6566,10,4,9,17,29,53,-24,21
Portadown,6566,11,4,5,21,22,59,-37,17
Crusaders,6567,1,19,9,2,62,29,33,66
Cliftonville,6567,2,17,5,8,51,36,15,56
Linfield,6567,3,14,8,8,51,31,20,50
Glenavon,6567,4,11,11,8,42,36,6,44
Coleraine,6567,5,10,12,8,41,39,2,42
Ballymena,6567,6,11,6,13,49,57,-8,39
Ards,6567,7,9,8,13,41,49,-8,35
Dungannon,6567,8,8,9,13,43,45,-2,33
Glentoran,6567,9,7,10,13,30,48,-18,31
Portadown,6567,10,8,6,16,30,44,-14,30
Ballinamalla,6567,11,7,4,19,30,56,-26,25
Crusaders,6568,1,15,7,8,55,36,19,52
Linfield,6568,2,14,9,7,54,31,23,51
Cliftonville,6568,3,15,6,9,48,36,12,51
Ballymena,6568,4,15,5,10,64,55,9,50
Dungannon,6568,5,11,11,8,50,39,11,44
Coleraine,6568,6,11,10,9,42,40,2,43
Glentoran,6568,7,10,7,13,27,43,-16,37
Glenavon,6568,8,9,9,12,46,51,-5,36
Ards,6568,9,10,5,15,37,49,-12,35
Ballinamalla,6568,10,9,3,18,33,54,-21,30
Portadown,6568,11,7,6,17,29,51,-22,27
Crusaders,6569,1,16,6,8,61,40,21,54
Coleraine,6569,2,13,10,7,57,44,13,49
Linfield,6569,3,12,11,7,63,41,22,47
Cliftonville,6569,4,14,5,11,52,45,7,47
Glenavon,6569,5,12,9,9,50,48,2,45
Ballymena,6569,6,13,4,13,59,64,-5,43
Dungannon,6569,7,11,7,12,54,48,6,40
Glentoran,6569,8,10,7,13,36,47,-11,37
Ballinamalla,6569,9,10,5,15,40,50,-10,35
Ards,6569,10,8,8,14,35,52,-17,32
Portadown,6569,11,7,6,17,29,57,-28,27
Linfield,6570,1,17,10,3,69,27,42,61
Crusaders,6570,2,18,5,7,55,32,23,59
Cliftonville,6570,3,15,6,9,52,39,13,51
Glenavon,6570,4,12,13,5,53,45,8,49
Ballymena,6570,5,10,9,11,51,60,-9,39
Dungannon,6570,6,9,11,10,50,45,5,38
Coleraine,6570,7,9,10,11,42,45,-3,37
Glentoran,6570,8,10,6,14,37,48,-11,36
Ballinamalla,6570,9,8,7,15,36,54,-18,31
Ards,6570,10,7,7,16,32,50,-18,28
Portadown,6570,11,6,4,20,26,58,-32,22
Linfield,6571,1,15,10,5,63,30,33,55
Crusaders,6571,2,16,6,8,57,40,17,54
Coleraine,6571,3,13,11,6,51,35,16,50
Glenavon,6571,4,11,11,8,52,45,7,44
Ballymena,6571,5,12,8,10,58,56,2,44
Cliftonville,6571,6,12,6,12,44,52,-8,42
Glentoran,6571,7,9,10,11,34,45,-11,37
Dungannon,6571,8,9,9,12,45,45,0,36
Ballinamalla,6571,9,10,4,16,36,51,-15,34
Portadown,6571,10,7,8,15,28,48,-20,29
Ards,6571,11,5,9,16,29,50,-21,24
Linfield,6572,1,17,9,4,68,26,42,60
Crusaders,6572,2,15,9,6,53,34,19,54
Glenavon,6572,3,13,11,6,54,41,13,50
Coleraine,6572,4,13,10,7,51,39,12,49
Cliftonville,6572,5,15,3,12,52,46,6,48
Ballymena,6572,6,13,8,9,59,60,-1,47
Ards,6572,7,10,4,16,35,47,-12,34
Ballinamalla,6572,8,10,4,16,39,53,-14,34
Dungannon,6572,9,8,8,14,45,57,-12,32
Glentoran,6572,10,7,5,18,24,50,-26,26
Portadown,6572,11,6,5,19,24,51,-27,23
Cliftonville,6573,1,18,6,6,60,35,25,60
Crusaders,6573,2,17,8,5,65,41,24,59
Linfield,6573,3,14,9,7,65,38,27,51
Coleraine,6573,4,13,12,5,46,35,11,51
Ballymena,6573,5,13,6,11,65,63,2,45
Glenavon,6573,6,11,10,9,52,52,0,43
Dungannon,6573,7,9,9,12,51,51,0,36
Glentoran,6573,8,9,7,14,31,49,-18,34
Ards,6573,9,8,3,19,39,56,-17,27
Ballinamalla,6573,10,6,7,17,32,56,-24,25
Portadown,6573,11,4,9,17,26,56,-30,21
Crusaders,6574,1,18,5,7,55,34,21,59
Linfield,6574,2,16,7,7,58,33,25,55
Cliftonville,6574,3,15,8,7,54,35,19,53
Ballymena,6574,4,14,7,9,57,58,-1,49
Glenavon,6574,5,10,13,7,45,43,2,43
Coleraine,6574,6,8,14,8,38,38,0,38
Dungannon,6574,7,9,10,11,54,51,3,37
Glentoran,6574,8,8,8,14,32,47,-15,32
Ballinamalla,6574,9,9,5,16,30,49,-19,32
Ards,6574,10,7,7,16,38,50,-12,28
Portadown,6574,11,5,8,17,21,44,-23,23
Linfield,6575,1,15,10,5,57,33,24,55
Crusaders,6575,2,14,9,7,59,39,20,51
Coleraine,6575,3,13,11,6,49,30,19,50
Ballymena,6575,4,15,5,10,59,61,-2,50
Cliftonville,6575,5,14,6,10,54,45,9,48
Dungannon,6575,6,12,11,7,56,41,15,47
Ards,6575,7,10,5,15,41,48,-7,35
Glenavon,6575,8,8,9,13,43,58,-15,33
Portadown,6575,9,9,5,16,28,47,-19,32
Ballinamalla,6575,10,6,8,16,31,52,-21,26
Glentoran,6575,11,4,11,15,23,46,-23,23
Linfield,6576,1,16,10,4,58,29,29,58
Cliftonville,6576,2,17,4,9,52,39,13,55
Coleraine,6576,3,14,11,5,42,30,12,53
Crusaders,6576,4,14,10,6,50,31,19,52
Glenavon,6576,5,10,9,11,48,44,4,39
Ballymena,6576,6,11,6,13,52,63,-11,39
Glentoran,6576,7,9,11,10,34,40,-6,38
Dungannon,6576,8,9,8,13,42,46,-4,35
Ballinamalla,6576,9,8,4,18,35,55,-20,28
Portadown,6576,10,8,4,18,25,48,-23,28
Ards,6576,11,6,9,15,36,49,-13,27
Linfield,6577,1,20,7,3,68,25,43,67
Crusaders,6577,2,18,7,5,63,35,28,61
Ballymena,6577,3,14,8,8,52,49,3,50
Coleraine,6577,4,12,11,7,46,41,5,47
Dungannon,6577,5,10,13,7,50,36,14,43
Glentoran,6577,6,10,8,12,28,40,-12,38
Ards,6577,7,11,2,17,43,44,-1,35
Cliftonville,6577,8,10,4,16,44,52,-8,34
Glenavon,6577,9,7,10,13,37,55,-18,31
Ballinamalla,6577,10,5,9,16,30,58,-28,24
Portadown,6577,11,5,7,18,27,53,-26,22
Linfield,6578,1,14,11,5,61,30,31,53
Crusaders,6578,2,14,11,5,55,37,18,53
Cliftonville,6578,3,14,6,10,55,40,15,48
Coleraine,6578,4,12,11,7,53,44,9,47
Dungannon,6578,5,12,10,8,53,40,13,46
Ballymena,6578,6,12,9,9,57,57,0,45
Glenavon,6578,7,6,15,9,44,50,-6,33
Ballinamalla,6578,8,9,6,15,29,46,-17,33
Glentoran,6578,9,7,10,13,32,50,-18,31
Ards,6578,10,7,9,14,38,52,-14,30
Portadown,6578,11,6,6,18,25,56,-31,24
Crusaders,6579,1,16,8,6,50,31,19,56
Linfield,6579,2,15,10,5,64,30,34,55
Glenavon,6579,3,14,10,6,52,44,8,52
Cliftonville,6579,4,14,6,10,48,37,11,48
Ballymena,6579,5,13,7,10,56,56,0,46
Dungannon,6579,6,11,9,10,50,40,10,42
Coleraine,6579,7,10,12,8,40,35,5,42
Glentoran,6579,8,8,6,16,27,47,-20,30
Ards,6579,9,8,5,17,41,59,-18,29
Ballinamalla,6579,10,7,7,16,28,50,-22,28
Portadown,6579,11,5,8,17,22,49,-27,23
Crusaders,6580,1,19,5,6,66,38,28,62
Linfield,6580,2,15,10,5,64,34,30,55
Glenavon,6580,3,13,10,7,48,37,11,49
Cliftonville,6580,4,14,6,10,59,40,19,48
Coleraine,6580,5,12,11,7,46,40,6,47
Ballymena,6580,6,13,5,12,56,60,-4,44
Glentoran,6580,7,9,10,11,30,42,-12,37
Dungannon,6580,8,8,10,12,47,50,-3,34
Ards,6580,9,6,8,16,37,56,-19,26
Portadown,6580,10,7,5,18,27,52,-25,26
Ballinamalla,6580,11,6,6,18,27,58,-31,24
Crusaders,6581,1,18,6,6,54,30,24,60
Cliftonville,6581,2,15,6,9,50,35,15,51
Linfield,6581,3,14,7,9,57,42,15,49
Coleraine,6581,4,13,10,7,42,34,8,49
Glenavon,6581,5,11,12,7,48,43,5,45
Ballymena,6581,6,13,5,12,58,62,-4,44
Dungannon,6581,7,10,10,10,49,43,6,40
Ards,6581,8,11,4,15,41,46,-5,37
Ballinamalla,6581,9,8,5,17,31,52,-21,29
Glentoran,6581,10,6,8,16,30,48,-18,26
Portadown,6581,11,6,7,17,26,51,-25,25
Crusaders,6582,1,16,7,7,50,35,15,55
Ballymena,6582,2,16,7,7,62,50,12,55
Linfield,6582,3,14,11,5,60,29,31,53
Cliftonville,6582,4,15,7,8,49,38,11,52
Coleraine,6582,5,10,12,8,37,35,2,42
Glenavon,6582,6,10,12,8,42,41,1,42
Dungannon,6582,7,11,8,11,53,48,5,41
Glentoran,6582,8,9,8,13,29,40,-11,35
Ards,6582,9,9,7,14,37,48,-11,34
Portadown,6582,10,5,6,19,23,49,-26,21
Ballinamalla,6582,11,5,5,20,26,55,-29,20
Cliftonville,6583,1,17,6,7,58,37,21,57
Crusaders,6583,2,16,6,8,57,39,18,54
Glenavon,6583,3,12,12,6,49,45,4,48
Linfield,6583,4,13,8,9,53,38,15,47
Dungannon,6583,5,12,9,9,54,39,15,45
Ballymena,6583,6,13,6,11,62,58,4,45
Coleraine,6583,7,8,13,9,43,46,-3,37
Glentoran,6583,8,8,7,15,30,49,-19,31
Ards,6583,9,8,6,16,38,49,-11,30
Ballinamalla,6583,10,9,3,18,32,52,-20,30
Portadown,6583,11,8,6,16,25,49,-24,30
Linfield,6584,1,15,11,4,62,28,34,56
Crusaders,6584,2,15,7,8,50,37,13,52
Coleraine,6584,3,14,8,8,43,36,7,50
Cliftonville,6584,4,14,7,9,52,42,10,49
Dungannon,6584,5,13,9,8,57,38,19,48
Ballymena,6584,6,13,6,11,55,56,-1,45
Glenavon,6584,7,10,10,10,46,47,-1,40
Glentoran,6584,8,9,7,14,32,45,-13,34
Ards,6584,9,10,3,17,40,56,-16,33
Ballinamalla,6584,10,7,4,19,25,52,-27,25
Portadown,6584,11,6,6,18,20,45,-25,24
Crusaders,6585,1,17,7,6,57,31,26,58
Linfield,6585,2,16,9,5,67,31,36,57
Cliftonville,6585,3,16,5,9,62,46,16,53
Coleraine,6585,4,12,10,8,41,35,6,46
Ballymena,6585,5,13,6,11,60,70,-10,45
Dungannon,6585,6,11,8,11,56,49,7,41
Glentoran,6585,7,10,9,11,32,40,-8,39
Glenavon,6585,8,7,14,9,44,50,-6,35
Ballinamalla,6585,9,9,4,17,31,52,-21,31
Ards,6585,10,7,5,18,34,52,-18,26
Portadown,6585,11,5,7,18,22,50,-28,22
Linfield,6586,1,15,10,5,56,33,23,55
Cliftonville,6586,2,16,5,9,64,37,27,53
Crusaders,6586,3,12,9,9,43,36,7,45
Coleraine,6586,4,10,12,8,37,35,2,42
Glentoran,6586,5,11,9,10,38,39,-1,42
Dungannon,6586,6,9,13,8,46,41,5,40
Ballymena,6586,7,10,10,10,49,58,-9,40
Glenavon,6586,8,9,10,11,46,52,-6,37
Ards,6586,9,10,4,16,37,45,-8,34
Ballinamalla,6586,10,10,4,16,29,46,-17,34
Portadown,6586,11,8,4,18,30,53,-23,28
Linfield,6587,1,15,9,6,60,35,25,54
Crusaders,6587,2,15,7,8,52,34,18,52
Ballymena,6587,3,15,6,9,56,55,1,51
Cliftonville,6587,4,14,7,9,45,36,9,49
Glenavon,6587,5,12,8,10,47,46,1,44
Dungannon,6587,6,11,9,10,51,44,7,42
Coleraine,6587,7,10,11,9,36,30,6,41
Glentoran,6587,8,9,10,11,34,42,-8,37
Ards,6587,9,8,6,16,37,51,-14,30
Ballinamalla,6587,10,8,6,16,31,50,-19,30
Portadown,6587,11,7,3,20,24,50,-26,24
Cliftonville,6588,1,17,4,9,56,39,17,55
Linfield,6588,2,14,11,5,60,32,28,53
Glenavon,6588,3,14,9,7,54,45,9,51
Ballymena,6588,4,15,5,10,64,56,8,50
Crusaders,6588,5,14,7,9,55,48,7,49
Coleraine,6588,6,11,11,8,41,35,6,44
Ballinamalla,6588,7,11,5,14,36,49,-13,38
Dungannon,6588,8,10,6,14,44,48,-4,36
Glentoran,6588,9,9,6,15,30,45,-15,33
Ards,6588,10,6,6,18,30,51,-21,24
Portadown,6588,11,6,6,18,25,47,-22,24
Cliftonville,6589,1,21,3,6,63,31,32,66
Linfield,6589,2,16,8,6,63,34,29,56
Coleraine,6589,3,15,7,8,45,33,12,52
Ballymena,6589,4,14,7,9,58,54,4,49
Crusaders,6589,5,14,6,10,55,48,7,48
Glenavon,6589,6,10,14,6,54,46,8,44
Dungannon,6589,7,8,11,11,44,50,-6,35
Ards,6589,8,8,7,15,34,44,-10,31
Glentoran,6589,9,8,6,16,30,45,-15,30
Ballinamalla,6589,10,6,6,18,32,55,-23,24
Portadown,6589,11,5,5,20,20,58,-38,20
Crusaders,6590,1,15,9,6,58,33,25,54
Cliftonville,6590,2,16,5,9,64,44,20,53
Ballymena,6590,3,16,5,9,65,60,5,53
Linfield,6590,4,12,9,9,50,33,17,45
Coleraine,6590,5,10,14,6,40,39,1,44
Glenavon,6590,6,9,11,10,42,43,-1,38
Glentoran,6590,7,10,7,13,37,50,-13,37
Dungannon,6590,8,9,7,14,56,50,6,34
Ards,6590,9,8,10,12,36,49,-13,34
Ballinamalla,6590,10,10,3,17,37,57,-20,33
Portadown,6590,11,8,4,18,26,53,-27,28
Cliftonville,6591,1,18,3,9,58,40,18,57
Crusaders,6591,2,16,7,7,52,37,15,55
Linfield,6591,3,15,8,7,59,34,25,53
Coleraine,6591,4,14,11,5,57,35,22,53
Dungannon,6591,5,13,9,8,54,45,9,48
Glenavon,6591,6,12,8,10,52,52,0,44
Ballymena,6591,7,11,6,13,55,64,-9,39
Portadown,6591,8,9,3,18,34,58,-24,30
Ards,6591,9,8,5,17,33,49,-16,29
Glentoran,6591,10,7,6,17,30,49,-19,27
Ballinamalla,6591,11,6,6,18,30,51,-21,24
Crusaders,6592,1,17,8,5,65,37,28,59
Linfield,6592,2,16,7,7,63,34,29,55
Ballymena,6592,3,14,8,8,53,55,-2,50
Cliftonville,6592,4,14,5,11,49,40,9,47
Glenavon,6592,5,11,13,6,54,45,9,46
Coleraine,6592,6,11,10,9,42,36,6,43
Ards,6592,7,10,4,16,40,49,-9,34
Dungannon,6592,8,8,9,13,43,49,-6,33
Glentoran,6592,9,8,7,15,30,46,-16,31
Ballinamalla,6592,10,8,5,17,35,56,-21,29
Portadown,6592,11,7,6,17,20,47,-27,27
Crusaders,6593,1,19,7,4,64,33,31,64
Linfield,6593,2,15,11,4,52,24,28,56
Coleraine,6593,3,15,7,8,51,37,14,52
Ballymena,6593,4,14,7,9,56,56,0,49
Glenavon,6593,5,9,12,9,45,48,-3,39
Cliftonville,6593,6,11,6,13,44,48,-4,39
Dungannon,6593,7,9,11,10,51,48,3,38
Ards,6593,8,9,4,17,37,50,-13,31
Glentoran,6593,9,6,11,13,30,46,-16,29
Ballinamalla,6593,10,8,5,17,30,49,-19,29
Portadown,6593,11,6,7,17,31,52,-21,25
Crusaders,6594,1,16,7,7,52,39,13,55
Ballymena,6594,2,15,6,9,65,62,3,51
Cliftonville,6594,3,15,4,11,53,40,13,49
Coleraine,6594,4,12,13,5,46,35,11,49
Linfield,6594,5,12,9,9,60,46,14,45
Dungannon,6594,6,9,13,8,51,41,10,40
Glentoran,6594,7,10,8,12,33,43,-10,38
Glenavon,6594,8,7,13,10,44,48,-4,34
Ards,6594,9,8,8,14,37,46,-9,32
Portadown,6594,10,7,7,16,32,52,-20,28
Ballinamalla,6594,11,6,8,16,30,51,-21,26
Crusaders,6595,1,16,7,7,54,32,22,55
Glenavon,6595,2,14,10,6,53,46,7,52
Cliftonville,6595,3,15,5,10,52,39,13,50
Ballymena,6595,4,13,6,11,57,60,-3,45
Coleraine,6595,5,11,9,10,38,34,4,42
Dungannon,6595,6,10,11,9,54,48,6,41
Linfield,6595,7,10,10,10,50,36,14,40
Glentoran,6595,8,11,7,12,31,39,-8,40
Ards,6595,9,9,5,16,32,43,-11,32
Ballinamalla,6595,10,9,5,16,30,50,-20,32
Portadown,6595,11,7,5,18,22,46,-24,26
Crusaders,6596,1,16,8,6,59,39,20,56
Coleraine,6596,2,14,9,7,49,38,11,51
Ballymena,6596,3,15,6,9,61,64,-3,51
Linfield,6596,4,14,8,8,60,39,21,50
Portadown,6596,5,12,4,14,32,41,-9,40
Glenavon,6596,6,10,9,11,41,45,-4,39
Cliftonville,6596,7,11,5,14,47,46,1,38
Ards,6596,8,10,6,14,40,48,-8,36
Glentoran,6596,9,9,7,14,36,47,-11,34
Ballinamalla,6596,10,8,7,15,37,54,-17,31
Dungannon,6596,11,7,9,14,47,48,-1,30
Ballymena,6597,1,18,6,6,65,53,12,60
Linfield,6597,2,17,7,6,57,29,28,58
Crusaders,6597,3,13,10,7,52,35,17,49
Coleraine,6597,4,13,10,7,53,40,13,49
Cliftonville,6597,5,11,7,12,50,51,-1,40
Dungannon,6597,6,9,8,13,48,46,2,35
Glenavon,6597,7,8,11,11,47,48,-1,35
Ards,6597,8,9,6,15,41,50,-9,33
Glentoran,6597,9,8,8,14,25,40,-15,32
Portadown,6597,10,9,5,16,29,51,-22,32
Ballinamalla,6597,11,8,6,16,28,52,-24,30
Crusaders,6598,1,16,10,4,55,30,25,58
Linfield,6598,2,15,10,5,64,36,28,55
Ballymena,6598,3,14,7,9,58,56,2,49
Coleraine,6598,4,13,9,8,49,45,4,48
Cliftonville,6598,5,13,5,12,45,39,6,44
Glenavon,6598,6,11,9,10,49,51,-2,42
Portadown,6598,7,11,5,14,30,40,-10,38
Dungannon,6598,8,8,10,12,48,47,1,34
Ballinamalla,6598,9,9,4,17,31,48,-17,31
Glentoran,6598,10,7,8,15,28,48,-20,29
Ards,6598,11,6,7,17,32,49,-17,25
Ballymena,6599,1,17,4,9,68,61,7,55
Crusaders,6599,2,15,8,7,50,35,15,53
Linfield,6599,3,14,8,8,63,36,27,50
Cliftonville,6599,4,14,7,9,49,37,12,49
Glenavon,6599,5,10,11,9,44,44,0,41
Coleraine,6599,6,10,9,11,39,45,-6,39
Glentoran,6599,7,11,6,13,32,42,-10,39
Portadown,6599,8,10,6,14,31,38,-7,36
Ards,6599,9,10,6,14,43,54,-11,36
Dungannon,6599,10,8,11,11,45,45,0,35
Ballinamalla,6599,11,6,4,20,25,52,-27,22
Linfield,6600,1,17,8,5,59,28,31,59
Cliftonville,6600,2,18,5,7,63,33,30,59
Ballymena,6600,3,15,7,8,65,59,6,52
Crusaders,6600,4,13,11,6,54,43,11,50
Glenavon,6600,5,12,13,5,52,41,11,49
Coleraine,6600,6,9,9,12,32,38,-6,36
Ards,6600,7,10,5,15,42,50,-8,35
Dungannon,6600,8,7,12,11,49,46,3,33
Glentoran,6600,9,8,8,14,36,55,-19,32
Ballinamalla,6600,10,6,5,19,35,64,-29,23
Portadown,6600,11,5,7,18,21,51,-30,22
Crusaders,6601,1,17,6,7,55,28,27,57
Linfield,6601,2,14,9,7,61,35,26,51
Glenavon,6601,3,13,11,6,55,40,15,50
Ballymena,6601,4,13,10,7,54,51,3,49
Coleraine,6601,5,12,10,8,40,36,4,46
Cliftonville,6601,6,12,8,10,46,40,6,44
Ards,6601,7,11,4,15,36,52,-16,37
Dungannon,6601,8,8,11,11,44,45,-1,35
Ballinamalla,6601,9,7,7,16,33,51,-18,28
Portadown,6601,10,8,4,18,29,51,-22,28
Glentoran,6601,11,5,10,15,27,51,-24,25
Linfield,6602,1,16,8,6,62,34,28,56
Crusaders,6602,2,15,7,8,52,38,14,52
Ballymena,6602,3,15,4,11,55,55,0,49
Glenavon,6602,4,12,11,7,51,40,11,47
Cliftonville,6602,5,12,6,12,42,38,4,42
Coleraine,6602,6,10,12,8,41,41,0,42
Dungannon,6602,7,10,8,12,50,43,7,38
Glentoran,6602,8,9,9,12,31,43,-12,36
Portadown,6602,9,8,8,14,25,41,-16,32
Ballinamalla,6602,10,9,4,17,28,47,-19,31
Ards,6602,11,7,7,16,35,52,-17,28
Crusaders,6603,1,16,6,8,51,36,15,54
Linfield,6603,2,14,10,6,58,35,23,52
Ballymena,6603,3,15,5,10,55,56,-1,50
Glenavon,6603,4,13,10,7,47,40,7,49
Cliftonville,6603,5,15,3,12,51,43,8,48
Coleraine,6603,6,12,8,10,46,38,8,44
Ards,6603,7,11,5,14,38,42,-4,38
Dungannon,6603,8,10,6,14,44,44,0,36
Portadown,6603,9,9,6,15,30,46,-16,33
Ballinamalla,6603,10,8,7,15,33,47,-14,31
Glentoran,6603,11,6,6,18,29,55,-26,24
Cliftonville,6604,1,18,4,8,55,34,21,58
Crusaders,6604,2,15,9,6,61,38,23,54
Ballymena,6604,3,14,6,10,63,60,3,48
Linfield,6604,4,13,8,9,54,39,15,47
Glenavon,6604,5,10,13,7,43,44,-1,43
Dungannon,6604,6,10,11,9,50,41,9,41
Coleraine,6604,7,10,10,10,41,38,3,40
Glentoran,6604,8,9,8,13,34,48,-14,35
Ards,6604,9,8,6,16,35,50,-15,30
Ballinamalla,6604,10,8,6,16,31,48,-17,30
Portadown,6604,11,8,3,19,25,52,-27,27
Cliftonville,6605,1,16,5,9,58,44,14,53
Crusaders,6605,2,14,9,7,52,39,13,51
Linfield,6605,3,12,11,7,49,26,23,47
Ballymena,6605,4,14,5,11,55,58,-3,47
Coleraine,6605,5,12,10,8,43,41,2,46
Glenavon,6605,6,12,9,9,46,43,3,45
Dungannon,6605,7,11,8,11,55,44,11,41
Ballinamalla,6605,8,12,5,13,37,45,-8,41
Ards,6605,9,7,8,15,38,51,-13,29
Glentoran,6605,10,7,8,15,25,46,-21,29
Portadown,6605,11,6,6,18,24,45,-21,24
Crusaders,6606,1,17,6,7,58,36,22,57
Linfield,6606,2,14,9,7,59,31,28,51
Ballymena,6606,3,13,6,11,56,57,-1,45
Coleraine,6606,4,12,9,9,40,41,-1,45
Dungannon,6606,5,11,10,9,54,47,7,43
Cliftonville,6606,6,12,6,12,48,42,6,42
Glentoran,6606,7,12,6,12,32,39,-7,42
Glenavon,6606,8,10,11,9,41,44,-3,41
Ards,6606,9,10,4,16,39,50,-11,34
Portadown,6606,10,8,6,16,29,43,-14,30
Ballinamalla,6606,11,7,5,18,28,54,-26,26
Crusaders,6607,1,18,7,5,57,29,28,61
Linfield,6607,2,15,10,5,57,33,24,55
Cliftonville,6607,3,15,6,9,52,37,15,51
Ballymena,6607,4,14,6,10,62,59,3,48
Dungannon,6607,5,12,9,9,55,45,10,45
Coleraine,6607,6,10,12,8,44,40,4,42
Glentoran,6607,7,12,4,14,36,49,-13,40
Glenavon,6607,8,8,11,11,42,51,-9,35
Ards,6607,9,9,6,15,39,45,-6,33
Ballinamalla,6607,10,6,5,19,26,54,-28,23
Portadown,6607,11,5,6,19,25,53,-28,21
Crusaders,6608,1,15,10,5,63,36,27,55
Cliftonville,6608,2,15,5,10,56,50,6,50
Coleraine,6608,3,12,13,5,44,32,12,49
Linfield,6608,4,12,11,7,48,31,17,47
Ballymena,6608,5,12,9,9,55,51,4,45
Glenavon,6608,6,10,11,9,47,46,1,41
Dungannon,6608,7,8,15,7,52,46,6,39
Ards,6608,8,9,7,14,43,53,-10,34
Glentoran,6608,9,7,9,14,30,47,-17,30
Portadown,6608,10,8,6,16,27,47,-20,30
Ballinamalla,6608,11,6,6,18,28,54,-26,24
Crusaders,6609,1,18,6,6,51,27,24,60
Linfield,6609,2,16,9,5,60,27,33,57
Cliftonville,6609,3,15,6,9,60,50,10,51
Ballymena,6609,4,13,9,8,62,56,6,48
Dungannon,6609,5,12,8,10,51,42,9,44
Coleraine,6609,6,9,11,10,42,45,-3,38
Glentoran,6609,7,10,8,12,29,37,-8,38
Ards,6609,8,8,8,14,35,44,-9,32
Ballinamalla,6609,9,9,4,17,29,50,-21,31
Glenavon,6609,10,7,9,14,40,52,-12,30
Portadown,6609,11,7,4,19,19,48,-29,25
Linfield,6610,1,15,9,6,61,33,28,54
Glenavon,6610,2,14,10,6,55,32,23,52
Cliftonville,6610,3,15,6,9,52,41,11,51
Crusaders,6610,4,14,7,9,45,33,12,49
Ballymena,6610,5,13,9,8,54,52,2,48
Dungannon,6610,6,10,11,9,48,39,9,41
Coleraine,6610,7,9,11,10,37,43,-6,38
Ards,6610,8,10,5,15,36,43,-7,35
Glentoran,6610,9,7,10,13,29,47,-18,31
Ballinamalla,6610,10,7,5,18,25,52,-27,26
Portadown,6610,11,7,5,18,23,50,-27,26
Linfield,6611,1,16,9,5,60,31,29,57
Cliftonville,6611,2,16,5,9,59,43,16,53
Crusaders,6611,3,14,7,9,47,33,14,49
Ballymena,6611,4,13,7,10,61,55,6,46
Glenavon,6611,5,11,13,6,49,44,5,46
Dungannon,6611,6,10,11,9,51,43,8,41
Ards,6611,7,11,6,13,43,47,-4,39
Coleraine,6611,8,8,10,12,34,38,-4,34
Glentoran,6611,9,7,11,12,35,50,-15,32
Ballinamalla,6611,10,8,5,17,29,57,-28,29
Portadown,6611,11,5,8,17,21,48,-27,23
Ballymena,6612,1,16,7,7,62,54,8,55
Linfield,6612,2,15,9,6,64,33,31,54
Crusaders,6612,3,15,8,7,57,34,23,53
Coleraine,6612,4,12,11,7,51,40,11,47
Glenavon,6612,5,12,10,8,49,42,7,46
Cliftonville,6612,6,14,4,12,48,45,3,46
Dungannon,6612,7,8,9,13,50,51,-1,33
Ballinamalla,6612,8,8,8,14,27,44,-17,32
Glentoran,6612,9,8,8,14,31,51,-20,32
Portadown,6612,10,8,4,18,25,51,-26,28
Ards,6612,11,6,8,16,34,53,-19,26
Cliftonville,6613,1,16,7,7,55,35,20,55
Linfield,6613,2,15,7,8,57,34,23,52
Crusaders,6613,3,13,8,9,51,42,9,47
Glenavon,6613,4,11,10,9,55,53,2,43
Glentoran,6613,5,12,7,11,37,42,-5,43
Ballymena,6613,6,12,6,12,59,62,-3,42
Coleraine,6613,7,10,10,10,41,37,4,40
Ards,6613,8,12,4,14,43,47,-4,40
Dungannon,6613,9,10,7,13,52,54,-2,37
Ballinamalla,6613,10,9,6,15,30,49,-19,33
Portadown,6613,11,7,4,19,27,52,-25,25
Crusaders,6614,1,18,6,6,57,34,23,60
Linfield,6614,2,15,8,7,58,27,31,53
Ballymena,6614,3,16,5,9,58,50,8,53
Cliftonville,6614,4,15,6,9,56,41,15,51
Glenavon,6614,5,12,12,6,59,45,14,48
Coleraine,6614,6,9,12,9,38,38,0,39
Ards,6614,7,11,5,14,38,44,-6,38
Dungannon,6614,8,9,9,12,47,49,-2,36
Glentoran,6614,9,7,7,16,28,49,-21,28
Ballinamalla,6614,10,7,6,17,27,51,-24,27
Portadown,6614,11,7,2,21,22,60,-38,23
Crusaders,6615,1,20,6,4,64,32,32,66
Linfield,6615,2,17,6,7,60,31,29,57
Ballymena,6615,3,16,5,9,63,56,7,53
Cliftonville,6615,4,15,4,11,51,38,13,49
Glenavon,6615,5,12,10,8,46,40,6,46
Dungannon,6615,6,11,7,12,46,38,8,40
Coleraine,6615,7,8,10,12,37,46,-9,34
Ards,6615,8,9,6,15,38,48,-10,33
Ballinamalla,6615,9,8,4,18,33,55,-22,28
Glentoran,6615,10,6,9,15,28,49,-21,27
Portadown,6615,11,7,5,18,22,55,-33,26
Crusaders,6616,1,15,11,4,50,26,24,56
Ballymena,6616,2,16,7,7,55,48,7,55
Cliftonville,6616,3,16,4,10,56,40,16,52
Linfield,6616,4,13,11,6,59,30,29,50
Glenavon,6616,5,13,10,7,51,42,9,49
Coleraine,6616,6,12,9,9,44,38,6,45
Portadown,6616,7,9,6,15,28,42,-14,33
Dungannon,6616,8,7,8,15,45,55,-10,29
Ards,6616,9,8,5,17,34,49,-15,29
Ballinamalla,6616,10,7,7,16,31,51,-20,28
Glentoran,6616,11,7,6,17,25,57,-32,27
Crusaders,6617,1,17,7,6,57,33,24,58
Linfield,6617,2,14,10,6,62,37,25,52
Ballymena,6617,3,12,8,10,59,60,-1,44
Dungannon,6617,4,11,10,9,46,41,5,43
Glenavon,6617,5,10,13,7,45,41,4,43
Coleraine,6617,6,10,11,9,44,40,4,41
Cliftonville,6617,7,11,7,12,45,42,3,40
Ards,6617,8,11,5,14,41,49,-8,38
Glentoran,6617,9,7,10,13,31,49,-18,31
Ballinamalla,6617,10,8,6,16,34,51,-17,30
Portadown,6617,11,7,7,16,30,51,-21,28
Crusaders,6618,1,18,6,6,56,32,24,60
Ballymena,6618,2,16,6,8,67,55,12,54
Linfield,6618,3,15,7,8,60,38,22,52
Cliftonville,6618,4,15,6,9,54,40,14,51
Glenavon,6618,5,12,10,8,49,45,4,46
Dungannon,6618,6,10,7,13,51,45,6,37
Portadown,6618,7,11,3,16,27,43,-16,36
Coleraine,6618,8,8,11,11,39,43,-4,35
Ballinamalla,6618,9,10,4,16,35,53,-18,34
Ards,6618,10,8,4,18,37,54,-17,28
Glentoran,6618,11,7,6,17,26,53,-27,27
Cliftonville,6619,1,18,3,9,56,34,22,57
Linfield,6619,2,14,9,7,54,33,21,51
Crusaders,6619,3,15,6,9,55,36,19,51
Ballymena,6619,4,15,4,11,56,57,-1,49
Glenavon,6619,5,13,8,9,46,44,2,47
Coleraine,6619,6,11,10,9,43,42,1,43
Dungannon,6619,7,11,8,11,51,42,9,41
Glentoran,6619,8,9,7,14,33,48,-15,34
Ards,6619,9,10,3,17,31,47,-16,33
Ballinamalla,6619,10,9,3,18,35,50,-15,30
Portadown,6619,11,8,3,19,23,50,-27,27
Crusaders,6620,1,17,7,6,58,29,29,58
Cliftonville,6620,2,16,6,8,53,38,15,54
Linfield,6620,3,13,9,8,56,38,18,48
Ballymena,6620,4,12,11,7,57,55,2,47
Glenavon,6620,5,10,13,7,49,43,6,43
Dungannon,6620,6,10,10,10,47,42,5,40
Ards,6620,7,11,4,15,42,51,-9,37
Coleraine,6620,8,8,13,9,36,45,-9,37
Glentoran,6620,9,8,8,14,35,45,-10,32
Portadown,6620,10,8,5,17,24,46,-22,29
Ballinamalla,6620,11,6,6,18,27,52,-25,24
Crusaders,6621,1,19,7,4,62,36,26,64
Linfield,6621,2,18,9,3,63,28,35,63
Cliftonville,6621,3,15,4,11,58,48,10,49
Ballymena,6621,4,12,8,10,65,60,5,44
Glenavon,6621,5,10,10,10,47,52,-5,40
Coleraine,6621,6,10,9,11,43,45,-2,39
Glentoran,6621,7,11,6,13,37,46,-9,39
Dungannon,6621,8,9,8,13,47,46,1,35
Ballinamalla,6621,9,8,5,17,33,50,-17,29
Ards,6621,10,8,5,17,34,52,-18,29
Portadown,6621,11,7,5,18,25,51,-26,26
Crusaders,6622,1,18,5,7,52,32,20,59
Linfield,6622,2,13,10,7,54,32,22,49
Cliftonville,6622,3,14,6,10,43,33,10,48
Coleraine,6622,4,12,11,7,42,32,10,47
Glentoran,6622,5,12,7,11,37,41,-4,43
Glenavon,6622,6,10,10,10,44,43,1,40
Dungannon,6622,7,10,9,11,51,47,4,39
Ards,6622,8,12,3,15,37,45,-8,39
Ballymena,6622,9,10,6,14,51,59,-8,36
Ballinamalla,6622,10,9,3,18,35,52,-17,30
Portadown,6622,11,7,6,17,21,51,-30,27
Crusaders,6623,1,17,5,8,51,38,13,56
Cliftonville,6623,2,17,3,10,56,37,19,54
Coleraine,6623,3,14,11,5,49,35,14,53
Ballymena,6623,4,14,8,8,62,56,6,50
Linfield,6623,5,12,9,9,51,32,19,45
Dungannon,6623,6,10,10,10,54,48,6,40
Glenavon,6623,7,10,10,10,46,44,2,40
Ballinamalla,6623,8,10,3,17,34,54,-20,33
Glentoran,6623,9,8,8,14,23,39,-16,32
Portadown,6623,10,6,8,16,22,43,-21,26
Ards,6623,11,6,7,17,34,56,-22,25
Crusaders,6624,1,18,7,5,55,28,27,61
Linfield,6624,2,12,13,5,53,28,25,49
Cliftonville,6624,3,13,7,10,51,39,12,46
Glenavon,6624,4,10,13,7,42,38,4,43
Coleraine,6624,5,11,9,10,40,48,-8,42
Ballymena,6624,6,11,8,11,55,59,-4,41
Ards,6624,7,11,6,13,43,42,1,39
Glentoran,6624,8,9,7,14,31,50,-19,34
Ballinamalla,6624,9,10,3,17,28,50,-22,33
Dungannon,6624,10,8,8,14,41,44,-3,32
Portadown,6624,11,7,9,14,23,36,-13,30
Cliftonville,6625,1,19,4,7,52,32,20,61
Crusaders,6625,2,16,9,5,56,31,25,57
Linfield,6625,3,14,11,5,54,32,22,53
Ballymena,6625,4,14,6,10,65,59,6,48
Glenavon,6625,5,11,12,7,53,52,1,45
Coleraine,6625,6,9,13,8,41,37,4,40
Dungannon,6625,7,9,9,12,48,45,3,36
Glentoran,6625,8,8,8,14,32,51,-19,32
Portadown,6625,9,8,6,16,31,45,-14,30
Ards,6625,10,7,6,17,33,49,-16,27
Ballinamalla,6625,11,5,6,19,26,58,-32,21
Crusaders,6626,1,16,10,4,54,32,22,58
Glenavon,6626,2,13,12,5,54,38,16,51
Linfield,6626,3,13,9,8,60,38,22,48
Cliftonville,6626,4,14,6,10,56,44,12,48
Ballymena,6626,5,13,7,10,56,61,-5,46
Coleraine,6626,6,12,8,10,44,40,4,44
Ballinamalla,6626,7,11,5,14,32,45,-13,38
Glentoran,6626,8,9,7,14,35,46,-11,34
Dungannon,6626,9,7,8,15,42,47,-5,29
Ards,6626,10,8,5,17,33,54,-21,29
Portadown,6626,11,7,7,16,25,46,-21,28
Crusaders,6627,1,17,8,5,55,30,25,59
Linfield,6627,2,14,9,7,54,30,24,51
Cliftonville,6627,3,15,3,12,49,43,6,48
Ballymena,6627,4,14,5,11,64,63,1,47
Dungannon,6627,5,13,7,10,49,39,10,46
Coleraine,6627,6,12,7,11,42,44,-2,43
Glenavon,6627,7,11,9,10,46,44,2,42
Glentoran,6627,8,11,7,12,34,40,-6,40
Ballinamalla,6627,9,9,7,14,38,51,-13,34
Ards,6627,10,7,5,18,32,50,-18,26
Portadown,6627,11,6,5,19,25,54,-29,23
Crusaders,6628,1,19,7,4,57,21,36,64
Linfield,6628,2,16,9,5,59,23,36,57
Glenavon,6628,3,13,11,6,49,41,8,50
Cliftonville,6628,4,15,4,11,49,40,9,49
Ballymena,6628,5,13,8,9,52,53,-1,47
Coleraine,6628,6,12,10,8,44,36,8,46
Dungannon,6628,7,7,9,14,43,46,-3,30
Portadown,6628,8,8,6,16,28,45,-17,30
Glentoran,6628,9,8,5,17,27,51,-24,29
Ards,6628,10,8,4,18,33,61,-28,28
Ballinamalla,6628,11,6,7,17,25,49,-24,25
Crusaders,6629,1,20,9,1,69,26,43,69
Cliftonville,6629,2,16,7,7,54,37,17,55
Ballymena,6629,3,15,8,7,64,56,8,53
Glenavon,6629,4,11,10,9,47,52,-5,43
Linfield,6629,5,11,9,10,58,43,15,42
Dungannon,6629,6,10,9,11,46,37,9,39
Ards,6629,7,11,4,15,35,46,-11,37
Coleraine,6629,8,9,9,12,38,46,-8,36
Ballinamalla,6629,9,8,5,17,36,56,-20,29
Glentoran,6629,10,6,10,14,33,50,-17,28
Portadown,6629,11,3,10,17,23,54,-31,19
Linfield,6630,1,18,7,5,66,25,41,61
Crusaders,6630,2,18,6,6,59,30,29,60
Cliftonville,6630,3,16,6,8,53,37,16,54
Coleraine,6630,4,12,12,6,43,31,12,48
Ballymena,6630,5,12,7,11,56,67,-11,43
Glenavon,6630,6,10,10,10,48,50,-2,40
Dungannon,6630,7,10,9,11,46,43,3,39
Ards,6630,8,11,4,15,38,48,-10,37
Ballinamalla,6630,9,8,3,19,32,55,-23,27
Glentoran,6630,10,6,7,17,28,55,-27,25
Portadown,6630,11,6,5,19,23,51,-28,23
Linfield,6631,1,16,8,6,58,26,32,56
Cliftonville,6631,2,16,7,7,52,33,19,55
Crusaders,6631,3,14,7,9,48,33,15,49
Glentoran,6631,4,12,9,9,36,38,-2,45
Dungannon,6631,5,11,8,11,51,44,7,41
Glenavon,6631,6,10,10,10,46,45,1,40
Ballymena,6631,7,11,7,12,52,58,-6,40
Ards,6631,8,9,6,15,33,45,-12,33
Portadown,6631,9,9,5,16,30,47,-17,32
Ballinamalla,6631,10,9,5,16,29,52,-23,32
Coleraine,6631,11,6,12,12,35,49,-14,30
Crusaders,6632,1,17,7,6,54,40,14,58
Coleraine,6632,2,13,9,8,48,40,8,48
Ballymena,6632,3,14,6,10,59,57,2,48
Cliftonville,6632,4,15,2,13,54,49,5,47
Linfield,6632,5,10,13,7,52,33,19,43
Glenavon,6632,6,10,12,8,58,50,8,42
Dungannon,6632,7,9,13,8,48,39,9,40
Ballinamalla,6632,8,9,6,15,41,52,-11,33
Glentoran,6632,9,8,8,14,30,43,-13,32
Ards,6632,10,8,7,15,37,52,-15,31
Portadown,6632,11,7,7,16,21,47,-26,28
Crusaders,6633,1,18,7,5,55,25,30,61
Ballymena,6633,2,17,5,8,56,53,3,56
Linfield,6633,3,15,8,7,58,33,25,53
Cliftonville,6633,4,14,4,12,53,44,9,46
Glenavon,6633,5,12,9,9,54,47,7,45
Coleraine,6633,6,10,12,8,40,39,1,42
Dungannon,6633,7,10,10,10,48,45,3,40
Glentoran,6633,8,11,6,13,32,44,-12,39
Ards,6633,9,9,4,17,32,47,-15,31
Ballinamalla,6633,10,6,6,18,29,52,-23,24
Portadown,6633,11,5,5,20,22,50,-28,20
Ballymena,6634,1,17,7,6,70,55,15,58
Cliftonville,6634,2,17,4,9,52,33,19,55
Crusaders,6634,3,16,6,8,51,34,17,54
Linfield,6634,4,15,8,7,54,28,26,53
Glenavon,6634,5,11,12,7,50,48,2,45
Coleraine,6634,6,10,11,9,36,36,0,41
Dungannon,6634,7,11,7,12,48,37,11,40
Glentoran,6634,8,10,6,14,23,41,-18,36
Ards,6634,9,7,6,17,27,47,-20,27
Portadown,6634,10,7,6,17,21,45,-24,27
Ballinamalla,6634,11,5,5,20,24,52,-28,20
Linfield,6635,1,15,10,5,52,27,25,55
Glenavon,6635,2,14,11,5,50,41,9,53
Cliftonville,6635,3,15,7,8,49,36,13,52
Coleraine,6635,4,13,9,8,50,39,11,48
Ballymena,6635,5,12,11,7,56,49,7,47
Crusaders,6635,6,11,11,8,46,37,9,44
Dungannon,6635,7,11,7,12,50,47,3,40
Glentoran,6635,8,9,8,13,31,41,-10,35
Ards,6635,9,6,7,17,38,59,-21,25
Ballinamalla,6635,10,6,7,17,27,52,-25,25
Portadown,6635,11,6,6,18,29,50,-21,24
Crusaders,6636,1,19,8,3,61,29,32,65
Cliftonville,6636,2,15,6,9,65,44,21,51
Linfield,6636,3,13,11,6,56,32,24,50
Coleraine,6636,4,13,10,7,43,34,9,49
Ballymena,6636,5,13,9,8,58,55,3,48
Glenavon,6636,6,10,11,9,45,48,-3,41
Dungannon,6636,7,8,11,11,47,46,1,35
Glentoran,6636,8,9,8,13,36,46,-10,35
Ards,6636,9,6,8,16,27,51,-24,26
Portadown,6636,10,6,7,17,31,56,-25,25
Ballinamalla,6636,11,5,7,18,28,56,-28,22
Crusaders,6637,1,17,10,3,60,28,32,61
Cliftonville,6637,2,15,7,8,61,47,14,52
Coleraine,6637,3,13,11,6,46,34,12,50
Dungannon,6637,4,13,9,8,54,44,10,48
Linfield,6637,5,11,12,7,43,24,19,45
Glenavon,6637,6,10,12,8,43,42,1,42
Ards,6637,7,11,6,13,39,42,-3,39
Ballymena,6637,8,11,6,13,50,64,-14,39
Glentoran,6637,9,8,7,15,31,46,-15,31
Portadown,6637,10,5,6,19,24,48,-24,21
Ballinamalla,6637,11,5,6,19,19,51,-32,21
Crusaders,6638,1,16,8,6,57,36,21,56
Ballymena,6638,2,17,5,8,68,62,6,56
Linfield,6638,3,16,7,7,63,25,38,55
Cliftonville,6638,4,17,3,10,62,49,13,54
Coleraine,6638,5,11,10,9,46,43,3,43
Dungannon,6638,6,10,9,11,51,44,7,39
Ards,6638,7,11,4,15,43,49,-6,37
Glenavon,6638,8,7,13,10,41,52,-11,34
Glentoran,6638,9,7,9,14,27,48,-21,30
Portadown,6638,10,8,4,18,24,50,-26,28
Ballinamalla,6638,11,7,4,19,30,54,-24,25
Crusaders,6639,1,17,7,6,51,34,17,58
Linfield,6639,2,14,11,5,51,24,27,53
Coleraine,6639,3,12,12,6,53,36,17,48
Glenavon,6639,4,10,14,6,48,38,10,44
Cliftonville,6639,5,12,7,11,51,44,7,43
Dungannon,6639,6,10,8,12,48,51,-3,38
Ards,6639,7,10,7,13,43,49,-6,37
Ballymena,6639,8,9,9,12,45,59,-14,36
Glentoran,6639,9,9,6,15,36,50,-14,33
Portadown,6639,10,8,6,16,24,44,-20,30
Ballinamalla,6639,11,8,5,17,28,49,-21,29
Cliftonville,6640,1,17,5,8,59,35,24,56
Crusaders,6640,2,16,7,7,59,34,25,55
Linfield,6640,3,13,10,7,56,36,20,49
Glenavon,6640,4,12,11,7,48,48,0,47
Ballinamalla,6640,5,13,5,12,39,42,-3,44
Glentoran,6640,6,11,6,13,32,44,-12,39
Ballymena,6640,7,10,8,12,56,58,-2,38
Coleraine,6640,8,9,10,11,39,50,-11,37
Dungannon,6640,9,8,10,12,43,42,1,34
Portadown,6640,10,6,9,15,22,46,-24,27
Ards,6640,11,6,7,17,35,53,-18,25
Crusaders,6641,1,18,7,5,57,33,24,61
Coleraine,6641,2,14,12,4,50,35,15,54
Linfield,6641,3,12,12,6,54,29,25,48
Ballymena,6641,4,14,6,10,58,55,3,48
Cliftonville,6641,5,12,6,12,47,46,1,42
Dungannon,6641,6,11,7,12,60,48,12,40
Glenavon,6641,7,10,10,10,47,47,0,40
Portadown,6641,8,9,7,14,26,44,-18,34
Ballinamalla,6641,9,10,4,16,29,48,-19,34
Ards,6641,10,7,7,16,33,51,-18,28
Glentoran,6641,11,6,6,18,26,51,-25,24
Crusaders,6642,1,18,6,6,62,34,28,60
Cliftonville,6642,2,15,5,10,48,40,8,50
Ballymena,6642,3,14,6,10,55,57,-2,48
Linfield,6642,4,12,11,7,57,36,21,47
Glenavon,6642,5,11,13,6,49,42,7,46
Dungannon,6642,6,11,11,8,54,43,11,44
Coleraine,6642,7,11,10,9,39,32,7,43
Ards,6642,8,9,7,14,39,49,-10,34
Glentoran,6642,9,7,8,15,29,45,-16,29
Portadown,6642,10,5,11,14,21,42,-21,26
Ballinamalla,6642,11,6,4,20,23,56,-33,22
Crusaders,6643,1,16,7,7,58,41,17,55
Linfield,6643,2,15,8,7,61,35,26,53
Cliftonville,6643,3,16,4,10,55,38,17,52
Coleraine,6643,4,12,10,8,46,36,10,46
Ards,6643,5,14,3,13,44,42,2,45
Ballymena,6643,6,12,5,13,58,69,-11,41
Glentoran,6643,7,11,6,13,34,41,-7,39
Glenavon,6643,8,10,9,11,45,56,-11,39
Dungannon,6643,9,8,12,10,47,42,5,36
Portadown,6643,10,8,5,17,27,49,-22,29
Ballinamalla,6643,11,6,5,19,24,50,-26,23
Linfield,6644,1,15,9,6,61,31,30,54
Crusaders,6644,2,14,8,8,55,41,14,50
Cliftonville,6644,3,14,7,9,51,37,14,49
Glenavon,6644,4,12,11,7,49,48,1,47
Ballymena,6644,5,12,8,10,54,57,-3,44
Coleraine,6644,6,11,10,9,46,46,0,43
Dungannon,6644,7,10,11,9,53,43,10,41
Glentoran,6644,8,10,7,13,33,38,-5,37
Ards,6644,9,8,6,16,37,51,-14,30
Portadown,6644,10,7,8,15,23,47,-24,29
Ballinamalla,6644,11,7,5,18,27,50,-23,26
Crusaders,6645,1,16,7,7,56,41,15,55
Linfield,6645,2,15,8,7,57,34,23,53
Cliftonville,6645,3,16,4,10,65,45,20,52
Ballymena,6645,4,15,5,10,61,54,7,50
Dungannon,6645,5,11,11,8,47,39,8,44
Coleraine,6645,6,12,8,10,46,48,-2,44
Glenavon,6645,7,11,9,10,48,44,4,42
Ards,6645,8,10,5,15,43,53,-10,35
Glentoran,6645,9,8,7,15,36,50,-14,31
Portadown,6645,10,8,4,18,25,48,-23,28
Ballinamalla,6645,11,6,6,18,29,57,-28,24
Cliftonville,6646,1,19,3,8,65,42,23,60
Linfield,6646,2,13,12,5,68,37,31,51
Ballymena,6646,3,15,5,10,66,61,5,50
Dungannon,6646,4,13,7,10,53,43,10,46
Crusaders,6646,5,13,7,10,50,41,9,46
Coleraine,6646,6,10,12,8,44,37,7,42
Portadown,6646,7,11,3,16,32,47,-15,36
Glenavon,6646,8,8,10,12,41,49,-8,34
Ards,6646,9,8,7,15,34,43,-9,31
Ballinamalla,6646,10,9,4,17,32,59,-27,31
Glentoran,6646,11,8,6,16,31,57,-26,30
Crusaders,6647,1,16,9,5,60,30,30,57
Linfield,6647,2,15,11,4,63,29,34,56
Glenavon,6647,3,13,9,8,48,43,5,48
Cliftonville,6647,4,13,7,10,50,43,7,46
Ards,6647,5,14,3,13,43,45,-2,45
Dungannon,6647,6,11,8,11,47,40,7,41
Coleraine,6647,7,10,10,10,36,39,-3,40
Ballymena,6647,8,10,10,10,46,54,-8,40
Glentoran,6647,9,8,9,13,30,43,-13,33
Ballinamalla,6647,10,7,4,19,26,57,-31,25
Portadown,6647,11,6,4,20,23,49,-26,22
Linfield,6648,1,15,9,6,62,32,30,54
Crusaders,6648,2,13,12,5,50,32,18,51
Ballymena,6648,3,15,6,9,54,52,2,51
Cliftonville,6648,4,13,8,9,49,39,10,47
Coleraine,6648,5,11,13,6,42,32,10,46
Glenavon,6648,6,9,14,7,46,44,2,41
Dungannon,6648,7,7,15,8,42,40,2,36
Glentoran,6648,8,8,7,15,28,44,-16,31
Portadown,6648,9,7,9,14,25,41,-16,30
Ballinamalla,6648,10,8,5,17,27,52,-25,29
Ards,6648,11,5,10,15,31,48,-17,25
Crusaders,6649,1,20,4,6,62,35,27,64
Cliftonville,6649,2,16,5,9,57,37,20,53
Linfield,6649,3,13,9,8,50,26,24,48
Ballymena,6649,4,14,6,10,60,60,0,48
Glenavon,6649,5,11,12,7,44,44,0,45
Coleraine,6649,6,10,12,8,38,38,0,42
Dungannon,6649,7,9,8,13,47,42,5,35
Ballinamalla,6649,8,9,5,16,36,48,-12,32
Portadown,6649,9,8,8,14,25,42,-17,32
Glentoran,6649,10,7,7,16,26,52,-26,28
Ards,6649,11,7,6,17,36,57,-21,27
Crusaders,6650,1,16,8,6,59,32,27,56
Linfield,6650,2,16,7,7,57,32,25,55
Ballymena,6650,3,14,7,9,61,55,6,49
Cliftonville,6650,4,13,8,9,52,39,13,47
Glenavon,6650,5,10,11,9,44,45,-1,41
Coleraine,6650,6,9,11,10,48,48,0,38
Glentoran,6650,7,10,8,12,25,37,-12,38
Dungannon,6650,8,8,10,12,44,45,-1,34
Ards,6650,9,9,6,15,34,46,-12,33
Ballinamalla,6650,10,10,3,17,32,53,-21,33
Portadown,6650,11,7,7,16,24,48,-24,28
Cliftonville,6651,1,18,4,8,58,35,23,58
Crusaders,6651,2,17,6,7,51,33,18,57
Linfield,6651,3,12,9,9,55,34,21,45
Glenavon,6651,4,11,11,8,50,38,12,44
Ballymena,6651,5,13,5,12,48,53,-5,44
Coleraine,6651,6,10,13,7,38,33,5,43
Glentoran,6651,7,11,6,13,31,46,-15,39
Dungannon,6651,8,10,7,13,47,44,3,37
Portadown,6651,9,9,5,16,24,46,-22,32
Ards,6651,10,9,3,18,35,53,-18,30
Ballinamalla,6651,11,8,5,17,28,50,-22,29
Crusaders,6652,1,19,5,6,58,33,25,62
Linfield,6652,2,16,7,7,57,30,27,55
Cliftonville,6652,3,16,6,8,56,42,14,54
Glenavon,6652,4,12,11,7,46,39,7,47
Coleraine,6652,5,12,10,8,45,38,7,46
Ballymena,6652,6,12,9,9,55,53,2,45
Portadown,6652,7,11,2,17,30,43,-13,35
Ards,6652,8,10,4,16,37,46,-9,34
Dungannon,6652,9,8,9,13,42,44,-2,33
Glentoran,6652,10,7,7,16,26,46,-20,28
Ballinamalla,6652,11,6,2,22,22,60,-38,20
Cliftonville,6653,1,19,4,7,63,40,23,61
Ballymena,6653,2,14,7,9,64,62,2,49
Linfield,6653,3,13,8,9,58,37,21,47
Glenavon,6653,4,10,14,6,49,44,5,44
Crusaders,6653,5,10,12,8,47,42,5,42
Dungannon,6653,6,10,11,9,56,48,8,41
Coleraine,6653,7,10,10,10,45,52,-7,40
Ballinamalla,6653,8,12,2,16,34,45,-11,38
Glentoran,6653,9,8,9,13,31,42,-11,33
Ards,6653,10,8,5,17,40,52,-12,29
Portadown,6653,11,6,8,16,25,48,-23,26
Coleraine,6654,1,15,9,6,46,34,12,54
Cliftonville,6654,2,15,7,8,54,40,14,52
Ballymena,6654,3,15,7,8,66,55,11,52
Linfield,6654,4,13,12,5,62,35,27,51
Crusaders,6654,5,13,11,6,60,48,12,50
Glenavon,6654,6,11,9,10,42,46,-4,42
Dungannon,6654,7,8,12,10,53,48,5,36
Ards,6654,8,6,11,13,30,42,-12,29
Glentoran,6654,9,6,11,13,29,46,-17,29
Portadown,6654,10,6,7,17,25,45,-20,25
Ballinamalla,6654,11,5,8,17,25,53,-28,23
Crusaders,6655,1,17,8,5,62,34,28,59
Glenavon,6655,2,15,9,6,55,39,16,54
Cliftonville,6655,3,16,4,10,57,42,15,52
Linfield,6655,4,14,9,7,57,32,25,51
Ards,6655,5,14,3,13,42,43,-1,45
Ballymena,6655,6,11,9,10,61,58,3,42
Coleraine,6655,7,9,12,9,31,36,-5,39
Dungannon,6655,8,8,12,10,46,43,3,36
Glentoran,6655,9,8,8,14,31,52,-21,32
Ballinamalla,6655,10,7,4,19,31,61,-30,25
Portadown,6655,11,4,6,20,18,51,-33,18
Crusaders,6656,1,18,8,4,62,35,27,62
Linfield,6656,2,17,7,6,59,32,27,58
Cliftonville,6656,3,16,4,10,58,48,10,52
Coleraine,6656,4,10,14,6,43,36,7,44
Glenavon,6656,5,9,12,9,50,52,-2,39
Ballymena,6656,6,9,11,10,51,58,-7,38
Dungannon,6656,7,9,9,12,49,45,4,36
Ballinamalla,6656,8,9,6,15,36,54,-18,33
Glentoran,6656,9,7,9,14,34,47,-13,30
Ards,6656,10,7,8,15,38,54,-16,29
Portadown,6656,11,5,10,15,28,47,-19,25
Crusaders,6657,1,18,8,4,68,43,25,62
Cliftonville,6657,2,16,6,8,59,39,20,54
Coleraine,6657,3,13,9,8,51,42,9,48
Glenavon,6657,4,12,10,8,56,48,8,46
Linfield,6657,5,12,9,9,57,36,21,45
Ballymena,6657,6,12,7,11,56,62,-6,43
Dungannon,6657,7,10,10,10,50,42,8,40
Ards,6657,8,9,5,16,39,50,-11,32
Glentoran,6657,9,8,7,15,31,51,-20,31
Ballinamalla,6657,10,7,6,17,31,62,-31,27
Portadown,6657,11,7,5,18,26,49,-23,26
Crusaders,6658,1,21,4,5,59,34,25,67
Coleraine,6658,2,14,9,7,46,36,10,51
Linfield,6658,3,13,11,6,57,32,25,50
Glenavon,6658,4,13,9,8,55,44,11,48
Cliftonville,6658,5,14,5,11,54,47,7,47
Dungannon,6658,6,12,10,8,58,41,17,46
Ballymena,6658,7,10,7,13,48,60,-12,37
Ards,6658,8,10,4,16,39,52,-13,34
Glentoran,6658,9,7,10,13,27,41,-14,31
Portadown,6658,10,7,6,17,24,47,-23,27
Ballinamalla,6658,11,5,3,22,26,59,-33,18
Crusaders,6659,1,16,7,7,49,26,23,55
Coleraine,6659,2,15,8,7,56,36,20,53
Glenavon,6659,3,15,8,7,54,39,15,53
Linfield,6659,4,15,7,8,64,39,25,52
Cliftonville,6659,5,15,4,11,47,38,9,49
Ballymena,6659,6,11,7,12,56,63,-7,40
Ards,6659,7,12,2,16,37,54,-17,38
Dungannon,6659,8,8,10,12,46,52,-6,34
Glentoran,6659,9,9,5,16,30,50,-20,32
Ballinamalla,6659,10,7,6,17,32,54,-22,27
Portadown,6659,11,6,8,16,22,42,-20,26
Crusaders,6660,1,18,5,7,50,30,20,59
Ballymena,6660,2,18,5,7,66,51,15,59
Linfield,6660,3,15,9,6,60,31,29,54
Dungannon,6660,4,13,8,9,52,40,12,47
Cliftonville,6660,5,13,6,11,53,48,5,45
Coleraine,6660,6,11,12,7,48,46,2,45
Glenavon,6660,7,11,8,11,48,53,-5,41
Ards,6660,8,8,5,17,39,53,-14,29
Glentoran,6660,9,7,7,16,24,41,-17,28
Portadown,6660,10,8,4,18,23,44,-21,28
Ballinamalla,6660,11,6,5,19,27,53,-26,23
Crusaders,6661,1,17,7,6,63,37,26,58
Linfield,6661,2,14,12,4,51,25,26,54
Coleraine,6661,3,15,8,7,52,38,14,53
Cliftonville,6661,4,16,5,9,48,36,12,53
Ballymena,6661,5,13,6,11,61,58,3,45
Glenavon,6661,6,8,14,8,41,43,-2,38
Dungannon,6661,7,8,11,11,45,49,-4,35
Glentoran,6661,8,9,7,14,32,50,-18,34
Ards,6661,9,7,7,16,41,52,-11,28
Portadown,6661,10,7,6,17,20,43,-23,27
Ballinamalla,6661,11,6,7,17,32,55,-23,25
Crusaders,6662,1,18,6,6,54,29,25,60
Linfield,6662,2,15,9,6,58,28,30,54
Cliftonville,6662,3,17,2,11,53,40,13,53
Ballymena,6662,4,14,6,10,56,56,0,48
Glenavon,6662,5,11,13,6,43,38,5,46
Coleraine,6662,6,11,9,10,48,42,6,42
Dungannon,6662,7,10,9,11,46,44,2,39
Ards,6662,8,11,5,14,41,45,-4,38
Glentoran,6662,9,9,7,14,30,46,-16,34
Portadown,6662,10,6,4,20,22,53,-31,22
Ballinamalla,6662,11,5,6,19,27,57,-30,21
Crusaders,6663,1,18,7,5,66,34,32,61
Cliftonville,6663,2,15,7,8,49,34,15,52
Ballymena,6663,3,15,6,9,56,56,0,51
Coleraine,6663,4,13,11,6,45,34,11,50
Linfield,6663,5,12,9,9,54,33,21,45
Glenavon,6663,6,10,11,9,46,49,-3,41
Glentoran,6663,7,10,5,15,42,53,-11,35
Ards,6663,8,10,4,16,37,53,-16,34
Ballinamalla,6663,9,9,5,16,35,57,-22,32
Portadown,6663,10,8,5,17,23,42,-19,29
Dungannon,6663,11,5,10,15,41,49,-8,25
Crusaders,6664,1,17,7,6,52,28,24,58
Linfield,6664,2,15,11,4,57,23,34,56
Cliftonville,6664,3,16,3,11,47,34,13,51
Ballymena,6664,4,14,6,10,56,57,-1,48
Coleraine,6664,5,12,11,7,41,38,3,47
Glenavon,6664,6,11,12,7,49,39,10,45
Dungannon,6664,7,10,8,12,52,50,2,38
Glentoran,6664,8,7,8,15,25,46,-21,29
Ards,6664,9,8,4,18,35,51,-16,28
Portadown,6664,10,6,9,15,26,49,-23,27
Ballinamalla,6664,11,7,5,18,25,50,-25,26
Crusaders,6665,1,15,7,8,60,41,19,52
Cliftonville,6665,2,16,3,11,52,41,11,51
Linfield,6665,3,14,7,9,52,35,17,49
Coleraine,6665,4,12,12,6,46,36,10,48
Ballymena,6665,5,11,10,9,54,55,-1,43
Glenavon,6665,6,11,10,9,45,49,-4,43
Glentoran,6665,7,11,9,10,34,38,-4,42
Dungannon,6665,8,11,8,11,55,40,15,41
Portadown,6665,9,8,6,16,24,45,-21,30
Ballinamalla,6665,10,8,5,17,32,56,-24,29
Ards,6665,11,7,5,18,34,52,-18,26
Crusaders,6666,1,17,8,5,62,31,31,59
Linfield,6666,2,13,10,7,56,38,18,49
Cliftonville,6666,3,14,7,9,49,36,13,49
Ballymena,6666,4,14,6,10,61,57,4,48
Coleraine,6666,5,11,12,7,42,37,5,45
Glenavon,6666,6,11,10,9,45,44,1,43
Ards,6666,7,12,5,13,43,47,-4,41
Dungannon,6666,8,10,7,13,45,49,-4,37
Glentoran,6666,9,9,7,14,30,41,-11,34
Ballinamalla,6666,10,7,4,19,26,52,-26,25
Portadown,6666,11,7,4,19,25,52,-27,25
Linfield,6667,1,16,7,7,56,31,25,55
Crusaders,6667,2,16,6,8,52,29,23,54
Cliftonville,6667,3,15,6,9,51,37,14,51
Coleraine,6667,4,14,9,7,44,33,11,51
Ballymena,6667,5,15,5,10,49,52,-3,50
Ards,6667,6,12,4,14,46,50,-4,40
Dungannon,6667,7,10,9,11,49,43,6,39
Glenavon,6667,8,9,10,11,41,47,-6,37
Glentoran,6667,9,8,11,11,31,38,-7,35
Portadown,6667,10,6,5,19,24,53,-29,23
Ballinamalla,6667,11,6,4,20,24,54,-30,22
Linfield,6668,1,16,10,4,59,29,30,58
Crusaders,6668,2,15,8,7,54,40,14,53
Ballymena,6668,3,13,11,6,59,52,7,50
Cliftonville,6668,4,14,6,10,50,40,10,48
Coleraine,6668,5,12,9,9,42,38,4,45
Glenavon,6668,6,12,9,9,49,48,1,45
Ards,6668,7,10,6,14,49,52,-3,36
Dungannon,6668,8,8,9,13,48,48,0,33
Ballinamalla,6668,9,9,4,17,30,46,-16,31
Glentoran,6668,10,8,6,16,26,50,-24,30
Portadown,6668,11,5,8,17,30,53,-23,23
Linfield,6669,1,15,10,5,65,34,31,55
Ballymena,6669,2,16,5,9,65,60,5,53
Coleraine,6669,3,15,7,8,50,34,16,52
Crusaders,6669,4,15,5,10,56,47,9,50
Glenavon,6669,5,11,11,8,49,46,3,44
Dungannon,6669,6,11,10,9,50,42,8,43
Cliftonville,6669,7,12,4,14,49,48,1,40
Ballinamalla,6669,8,9,6,15,33,48,-15,33
Ards,6669,9,8,7,15,31,47,-16,31
Glentoran,6669,10,8,6,16,27,48,-21,30
Portadown,6669,11,6,7,17,25,46,-21,25
Crusaders,6670,1,14,11,5,58,36,22,53
Ballymena,6670,2,14,9,7,66,60,6,51
Cliftonville,6670,3,14,6,10,53,45,8,48
Linfield,6670,4,12,9,9,52,39,13,45
Glenavon,6670,5,10,12,8,44,47,-3,42
Glentoran,6670,6,11,8,11,37,37,0,41
Ards,6670,7,12,5,13,41,45,-4,41
Coleraine,6670,8,9,11,10,43,44,-1,38
Dungannon,6670,9,9,10,11,50,49,1,37
Ballinamalla,6670,10,6,8,16,29,48,-19,26
Portadown,6670,11,5,9,16,28,51,-23,24
Crusaders,6671,1,17,10,3,53,28,25,61
Linfield,6671,2,14,10,6,59,33,26,52
Ballymena,6671,3,14,7,9,60,61,-1,49
Cliftonville,6671,4,14,6,10,51,46,5,48
Glenavon,6671,5,12,11,7,50,38,12,47
Ards,6671,6,13,5,12,44,40,4,44
Coleraine,6671,7,10,11,9,37,37,0,41
Dungannon,6671,8,9,9,12,54,46,8,36
Ballinamalla,6671,9,8,5,17,33,53,-20,29
Portadown,6671,10,7,5,18,25,54,-29,26
Glentoran,6671,11,4,7,19,21,51,-30,19
Crusaders,6672,1,17,8,5,58,33,25,59
Cliftonville,6672,2,15,4,11,55,42,13,49
Ballymena,6672,3,14,7,9,63,58,5,49
Linfield,6672,4,12,12,6,59,36,23,48
Glenavon,6672,5,13,8,9,51,41,10,47
Coleraine,6672,6,12,9,9,44,44,0,45
Dungannon,6672,7,11,11,8,50,35,15,44
Ards,6672,8,8,6,16,33,51,-18,30
Ballinamalla,6672,9,8,5,17,31,55,-24,29
Glentoran,6672,10,7,7,16,32,54,-22,28
Portadown,6672,11,7,5,18,22,49,-27,26
Crusaders,6673,1,17,5,8,53,34,19,56
Glenavon,6673,2,12,13,5,43,37,6,49
Linfield,6673,3,13,9,8,57,35,22,48
Cliftonville,6673,4,14,6,10,55,45,10,48
Ballymena,6673,5,13,6,11,55,58,-3,45
Dungannon,6673,6,11,10,9,58,43,15,43
Ards,6673,7,13,3,14,42,49,-7,42
Coleraine,6673,8,10,11,9,35,33,2,41
Portadown,6673,9,7,9,14,19,38,-19,30
Ballinamalla,6673,10,7,5,18,25,48,-23,26
Glentoran,6673,11,5,9,16,21,43,-22,24
Crusaders,6674,1,18,10,2,60,29,31,64
Glenavon,6674,2,13,12,5,58,42,16,51
Cliftonville,6674,3,15,4,11,58,48,10,49
Ballymena,6674,4,15,4,11,62,58,4,49
Linfield,6674,5,12,9,9,57,36,21,45
Coleraine,6674,6,10,10,10,42,50,-8,40
Dungannon,6674,7,10,6,14,41,48,-7,36
Glentoran,6674,8,10,5,15,37,51,-14,35
Ballinamalla,6674,9,10,3,17,39,49,-10,33
Portadown,6674,10,7,7,16,27,46,-19,28
Ards,6674,11,7,6,17,30,54,-24,27
Crusaders,6675,1,20,6,4,67,36,31,66
Linfield,6675,2,17,8,5,71,34,37,59
Cliftonville,6675,3,16,5,9,58,41,17,53
Dungannon,6675,4,13,9,8,55,35,20,48
Glenavon,6675,5,13,9,8,53,51,2,48
Coleraine,6675,6,11,8,11,44,43,1,41
Ballymena,6675,7,10,6,14,44,69,-25,36
Ards,6675,8,9,5,16,37,52,-15,32
Portadown,6675,9,8,4,18,32,51,-19,28
Glentoran,6675,10,7,7,16,24,49,-25,28
Ballinamalla,6675,11,6,3,21,31,55,-24,21
Crusaders,6676,1,19,7,4,56,31,25,64
Linfield,6676,2,15,9,6,57,33,24,54
Cliftonville,6676,3,15,4,11,63,45,18,49
Coleraine,6676,4,12,10,8,43,35,8,46
Ballymena,6676,5,14,4,12,59,66,-7,46
Dungannon,6676,6,11,7,12,47,44,3,40
Glenavon,6676,7,11,7,12,45,48,-3,40
Portadown,6676,8,10,3,17,29,46,-17,33
Glentoran,6676,9,8,7,15,28,43,-15,31
Ards,6676,10,8,6,16,36,52,-16,30
Ballinamalla,6676,11,8,4,18,30,50,-20,28
Crusaders,6677,1,17,7,6,63,38,25,58
Linfield,6677,2,14,9,7,56,45,11,51
Coleraine,6677,3,12,13,5,49,36,13,49
Cliftonville,6677,4,14,5,11,49,39,10,47
Glenavon,6677,5,12,10,8,54,47,7,46
Ballymena,6677,6,11,10,9,46,52,-6,43
Dungannon,6677,7,10,9,11,50,44,6,39
Glentoran,6677,8,11,6,13,36,40,-4,39
Ards,6677,9,8,6,16,36,52,-16,30
Portadown,6677,10,6,8,16,26,44,-18,26
Ballinamalla,6677,11,5,7,18,25,53,-28,22
Glenavon,6678,1,17,9,4,58,34,24,60
Linfield,6678,2,15,10,5,55,27,28,55
Crusaders,6678,3,13,12,5,48,31,17,51
Ballymena,6678,4,13,8,9,58,55,3,47
Cliftonville,6678,5,13,6,11,50,41,9,45
Coleraine,6678,6,9,10,11,38,44,-6,37
Portadown,6678,7,10,5,15,30,45,-15,35
Ballinamalla,6678,8,9,5,16,30,51,-21,32
Glentoran,6678,9,7,10,13,28,41,-13,31
Ards,6678,10,8,5,17,31,52,-21,29
Dungannon,6678,11,6,10,14,42,47,-5,28
Crusaders,6679,1,19,8,3,62,32,30,65
Linfield,6679,2,15,10,5,59,29,30,55
Ballymena,6679,3,13,6,11,63,62,1,45
Glenavon,6679,4,12,8,10,49,48,1,44
Cliftonville,6679,5,12,7,11,48,40,8,43
Dungannon,6679,6,9,10,11,48,46,2,37
Glentoran,6679,7,9,10,11,34,43,-9,37
Coleraine,6679,8,7,13,10,41,48,-7,34
Ards,6679,9,9,7,14,39,48,-9,34
Ballinamalla,6679,10,9,4,17,34,54,-20,31
Portadown,6679,11,7,5,18,20,47,-27,26
Ballymena,6680,1,17,4,9,65,54,11,55
Crusaders,6680,2,15,8,7,52,36,16,53
Linfield,6680,3,14,9,7,58,34,24,51
Cliftonville,6680,4,15,6,9,53,41,12,51
Glenavon,6680,5,12,10,8,52,47,5,46
Coleraine,6680,6,11,10,9,45,41,4,43
Dungannon,6680,7,11,8,11,51,43,8,41
Glentoran,6680,8,9,7,14,31,50,-19,34
Ards,6680,9,8,4,18,42,60,-18,28
Ballinamalla,6680,10,8,4,18,34,55,-21,28
Portadown,6680,11,6,8,16,24,46,-22,26
Cliftonville,6681,1,18,4,8,59,37,22,58
Crusaders,6681,2,16,6,8,56,42,14,54
Linfield,6681,3,15,8,7,59,35,24,53
Glenavon,6681,4,13,9,8,50,44,6,48
Ballymena,6681,5,12,9,9,69,64,5,45
Dungannon,6681,6,11,8,11,49,45,4,41
Glentoran,6681,7,10,7,13,42,54,-12,37
Ards,6681,8,10,4,16,42,49,-7,34
Coleraine,6681,9,8,9,13,43,51,-8,33
Ballinamalla,6681,10,8,4,18,34,56,-22,28
Portadown,6681,11,7,6,17,26,52,-26,27
Cliftonville,6682,1,19,4,7,56,30,26,61
Crusaders,6682,2,17,7,6,52,28,24,58
Ballymena,6682,3,17,5,8,62,52,10,56
Linfield,6682,4,14,10,6,62,30,32,52
Glenavon,6682,5,10,15,5,44,38,6,45
Coleraine,6682,6,8,11,11,34,41,-7,35
Ards,6682,7,9,7,14,36,48,-12,34
Dungannon,6682,8,8,7,15,41,42,-1,31
Portadown,6682,9,8,5,17,22,51,-29,29
Glentoran,6682,10,6,8,16,21,48,-27,26
Ballinamalla,6682,11,6,7,17,29,51,-22,25
Crusaders,6683,1,16,6,8,55,45,10,54
Cliftonville,6683,2,17,2,11,61,47,14,53
Dungannon,6683,3,11,11,8,53,34,19,44
Linfield,6683,4,12,8,10,53,35,18,44
Glenavon,6683,5,10,13,7,43,40,3,43
Ballymena,6683,6,12,7,11,56,62,-6,43
Coleraine,6683,7,11,8,11,40,42,-2,41
Ards,6683,8,11,4,15,38,44,-6,37
Glentoran,6683,9,10,7,13,31,43,-12,37
Ballinamalla,6683,10,9,5,16,30,47,-17,32
Portadown,6683,11,8,5,17,21,42,-21,29
Ballymena,6684,1,17,6,7,60,51,9,57
Crusaders,6684,2,14,11,5,52,33,19,53
Linfield,6684,3,14,10,6,56,33,23,52
Glenavon,6684,4,13,9,8,50,44,6,48
Cliftonville,6684,5,14,5,11,52,42,10,47
Dungannon,6684,6,10,11,9,49,43,6,41
Coleraine,6684,7,10,9,11,35,39,-4,39
Ards,6684,8,10,5,15,37,44,-7,35
Glentoran,6684,9,9,7,14,29,39,-10,34
Ballinamalla,6684,10,8,5,17,27,48,-21,29
Portadown,6684,11,4,6,20,28,59,-31,18
Cliftonville,6685,1,16,7,7,50,38,12,55
Crusaders,6685,2,16,6,8,55,36,19,54
Ballymena,6685,3,15,7,8,66,54,12,52
Linfield,6685,4,13,8,9,60,41,19,47
Coleraine,6685,5,12,10,8,44,37,7,46
Glenavon,6685,6,10,10,10,46,46,0,40
Glentoran,6685,7,10,7,13,39,49,-10,37
Portadown,6685,8,9,7,14,28,44,-16,34
Ards,6685,9,9,5,16,40,56,-16,32
Dungannon,6685,10,7,8,15,44,51,-7,29
Ballinamalla,6685,11,8,5,17,34,54,-20,29
Linfield,6686,1,15,9,6,57,26,31,54
Cliftonville,6686,2,16,6,8,53,39,14,54
Ballymena,6686,3,15,4,11,60,58,2,49
Crusaders,6686,4,13,9,8,48,35,13,48
Glenavon,6686,5,11,11,8,47,44,3,44
Coleraine,6686,6,11,10,9,46,42,4,43
Dungannon,6686,7,9,12,9,51,48,3,39
Portadown,6686,8,9,6,15,27,43,-16,33
Ards,6686,9,9,5,16,34,49,-15,32
Glentoran,6686,10,9,5,16,28,45,-17,32
Ballinamalla,6686,11,8,3,19,35,57,-22,27
Crusaders,6687,1,17,7,6,52,35,17,58
Linfield,6687,2,15,11,4,58,30,28,56
Ballymena,6687,3,14,7,9,53,52,1,49
Cliftonville,6687,4,13,7,10,47,35,12,46
Ballinamalla,6687,5,13,2,15,38,46,-8,41
Coleraine,6687,6,10,9,11,36,42,-6,39
Glenavon,6687,7,9,10,11,43,45,-2,37
Glentoran,6687,8,9,10,11,31,38,-7,37
Dungannon,6687,9,9,8,13,49,47,2,35
Ards,6687,10,8,5,17,33,44,-11,29
Portadown,6687,11,7,6,17,25,51,-26,27
Crusaders,6688,1,18,10,2,64,27,37,64
Coleraine,6688,2,14,11,5,49,32,17,53
Linfield,6688,3,15,7,8,58,32,26,52
Glenavon,6688,4,13,12,5,48,39,9,51
Cliftonville,6688,5,14,8,8,56,39,17,50
Ballymena,6688,6,11,5,14,50,62,-12,38
Ards,6688,7,10,4,16,37,47,-10,34
Glentoran,6688,8,8,10,12,30,40,-10,34
Dungannon,6688,9,7,9,14,40,45,-5,30
Portadown,6688,10,4,10,16,19,49,-30,22
Ballinamalla,6688,11,5,6,19,23,62,-39,21
Glenavon,6689,1,15,11,4,55,38,17,56
Cliftonville,6689,2,16,4,10,60,40,20,52
Crusaders,6689,3,14,10,6,46,33,13,52
Linfield,6689,4,13,11,6,55,29,26,50
Ballymena,6689,5,10,11,9,46,55,-9,41
Coleraine,6689,6,10,10,10,39,36,3,40
Dungannon,6689,7,9,11,10,46,42,4,38
Glentoran,6689,8,9,9,12,31,42,-11,36
Ards,6689,9,9,5,16,36,50,-14,32
Ballinamalla,6689,10,7,5,18,23,45,-22,26
Portadown,6689,11,4,11,15,21,48,-27,23
Cliftonville,6690,1,18,3,9,60,39,21,57
Crusaders,6690,2,14,9,7,48,33,15,51
Linfield,6690,3,12,12,6,60,37,23,48
Coleraine,6690,4,10,15,5,40,31,9,45
Ballymena,6690,5,12,8,10,51,57,-6,44
Dungannon,6690,6,9,11,10,49,43,6,38
Glenavon,6690,7,9,11,10,41,48,-7,38
Ards,6690,8,10,6,14,40,51,-11,36
Glentoran,6690,9,8,8,14,33,49,-16,32
Ballinamalla,6690,10,8,6,16,31,50,-19,30
Portadown,6690,11,8,5,17,31,46,-15,29
Cliftonville,6691,1,17,6,7,65,42,23,57
Crusaders,6691,2,16,6,8,50,32,18,54
Ballymena,6691,3,14,9,7,60,57,3,51
Linfield,6691,4,11,11,8,51,34,17,44
Glenavon,6691,5,11,11,8,44,42,2,44
Coleraine,6691,6,10,12,8,41,38,3,42
Glentoran,6691,7,10,7,13,38,42,-4,37
Portadown,6691,8,9,7,14,27,42,-15,34
Dungannon,6691,9,8,9,13,43,45,-2,33
Ballinamalla,6691,10,9,5,16,39,58,-19,32
Ards,6691,11,7,3,20,31,57,-26,24
Linfield,6692,1,15,10,5,64,31,33,55
Glenavon,6692,2,14,10,6,53,39,14,52
Crusaders,6692,3,15,7,8,52,45,7,52
Cliftonville,6692,4,14,7,9,49,33,16,49
Ballymena,6692,5,13,8,9,61,58,3,47
Ballinamalla,6692,6,12,5,13,37,46,-9,41
Coleraine,6692,7,9,10,11,40,45,-5,37
Dungannon,6692,8,9,9,12,48,48,0,36
Ards,6692,9,8,6,16,31,47,-16,30
Glentoran,6692,10,8,6,16,26,45,-19,30
Portadown,6692,11,6,6,18,25,49,-24,24
Linfield,6693,1,16,9,5,61,28,33,57
Crusaders,6693,2,16,9,5,58,35,23,57
Cliftonville,6693,3,16,6,8,63,42,21,54
Ballymena,6693,4,16,6,8,67,59,8,54
Coleraine,6693,5,12,10,8,40,38,2,46
Dungannon,6693,6,10,10,10,43,36,7,40
Glentoran,6693,7,9,7,14,35,52,-17,34
Glenavon,6693,8,8,9,13,47,56,-9,33
Ards,6693,9,8,3,19,34,55,-21,27
Ballinamalla,6693,10,8,3,19,28,50,-22,27
Portadown,6693,11,7,6,17,28,53,-25,27
Crusaders,6694,1,21,6,3,60,27,33,69
Linfield,6694,2,16,8,6,62,29,33,56
Cliftonville,6694,3,13,8,9,48,34,14,47
Coleraine,6694,4,12,10,8,42,39,3,46
Glenavon,6694,5,10,11,9,49,44,5,41
Ballymena,6694,6,10,9,11,47,55,-8,39
Glentoran,6694,7,10,7,13,37,51,-14,37
Ards,6694,8,9,6,15,37,49,-12,33
Portadown,6694,9,8,6,16,27,48,-21,30
Dungannon,6694,10,6,10,14,44,49,-5,28
Ballinamalla,6694,11,7,5,18,27,55,-28,26
Linfield,6695,1,19,8,3,68,29,39,65
Cliftonville,6695,2,14,8,8,54,35,19,50
Glenavon,6695,3,13,11,6,48,39,9,50
Crusaders,6695,4,13,8,9,46,40,6,47
Ballymena,6695,5,13,8,9,59,59,0,47
Coleraine,6695,6,10,11,9,40,36,4,41
Dungannon,6695,7,9,10,11,49,48,1,37
Ballinamalla,6695,8,9,5,16,34,51,-17,32
Glentoran,6695,9,8,7,15,26,47,-21,31
Ards,6695,10,8,5,17,34,49,-15,29
Portadown,6695,11,5,7,18,22,47,-25,22
Cliftonville,6696,1,17,5,8,56,35,21,56
Crusaders,6696,2,16,8,6,48,34,14,56
Ballymena,6696,3,14,6,10,54,52,2,48
Linfield,6696,4,11,11,8,51,33,18,44
Glenavon,6696,5,11,9,10,43,43,0,42
Dungannon,6696,6,11,8,11,51,43,8,41
Glentoran,6696,7,11,7,12,34,42,-8,40
Coleraine,6696,8,9,12,9,39,41,-2,39
Ards,6696,9,9,5,16,33,49,-16,32
Portadown,6696,10,7,7,16,26,44,-18,28
Ballinamalla,6696,11,8,4,18,28,47,-19,28
Crusaders,6697,1,18,7,5,51,27,24,61
Dungannon,6697,2,14,7,9,56,39,17,49
Cliftonville,6697,3,15,4,11,52,37,15,49
Linfield,6697,4,13,9,8,59,38,21,48
Glenavon,6697,5,12,9,9,53,50,3,45
Ballymena,6697,6,12,8,10,56,58,-2,44
Coleraine,6697,7,9,11,10,36,37,-1,38
Glentoran,6697,8,10,6,14,30,53,-23,36
Ballinamalla,6697,9,8,7,15,34,54,-20,31
Portadown,6697,10,8,4,18,31,50,-19,28
Ards,6697,11,6,8,16,41,56,-15,26
Cliftonville,6698,1,17,3,10,56,37,19,54
Crusaders,6698,2,15,8,7,56,35,21,53
Ballymena,6698,3,13,7,10,60,64,-4,46
Linfield,6698,4,11,11,8,53,35,18,44
Glenavon,6698,5,11,11,8,45,43,2,44
Glentoran,6698,6,11,8,11,36,41,-5,41
Coleraine,6698,7,10,10,10,37,34,3,40
Ballinamalla,6698,8,11,3,16,31,49,-18,36
Dungannon,6698,9,9,8,13,41,39,2,35
Ards,6698,10,8,7,15,39,53,-14,31
Portadown,6698,11,8,6,16,23,47,-24,30
Crusaders,6699,1,17,9,4,62,38,24,60
Linfield,6699,2,15,10,5,66,32,34,55
Cliftonville,6699,3,15,7,8,56,38,18,52
Glenavon,6699,4,12,11,7,53,45,8,47
Ballymena,6699,5,13,4,13,53,62,-9,43
Dungannon,6699,6,10,9,11,47,38,9,39
Portadown,6699,7,10,7,13,29,45,-16,37
Coleraine,6699,8,9,9,12,38,44,-6,36
Glentoran,6699,9,6,11,13,29,44,-15,29
Ards,6699,10,8,5,17,36,58,-22,29
Ballinamalla,6699,11,7,4,19,30,55,-25,25
Crusaders,6700,1,19,7,4,62,35,27,64
Cliftonville,6700,2,15,6,9,52,35,17,51
Coleraine,6700,3,12,12,6,39,38,1,48
Linfield,6700,4,12,10,8,67,35,32,46
Dungannon,6700,5,11,9,10,46,40,6,42
Ballymena,6700,6,12,5,13,53,67,-14,41
Glenavon,6700,7,10,10,10,49,46,3,40
Ards,6700,8,11,5,14,43,49,-6,38
Glentoran,6700,9,8,8,14,28,46,-18,32
Portadown,6700,10,7,9,14,28,46,-18,30
Ballinamalla,6700,11,4,7,19,25,55,-30,19
Cliftonville,6701,1,16,7,7,56,32,24,55
Crusaders,6701,2,16,6,8,54,31,23,54
Linfield,6701,3,12,10,8,54,35,19,46
Ards,6701,4,14,4,12,40,39,1,46
Dungannon,6701,5,11,9,10,56,48,8,42
Coleraine,6701,6,10,11,9,42,38,4,41
Glenavon,6701,7,10,10,10,44,48,-4,40
Glentoran,6701,8,10,8,12,35,48,-13,38
Ballymena,6701,9,10,7,13,54,67,-13,37
Ballinamalla,6701,10,11,1,18,32,52,-20,34
Portadown,6701,11,7,3,20,24,53,-29,24
Coleraine,6702,1,16,11,3,50,28,22,59
Crusaders,6702,2,16,7,7,59,45,14,55
Cliftonville,6702,3,17,3,10,51,35,16,54
Linfield,6702,4,15,8,7,62,34,28,53
Ballymena,6702,5,13,7,10,49,51,-2,46
Glenavon,6702,6,12,9,9,45,48,-3,45
Glentoran,6702,7,10,7,13,35,43,-8,37
Dungannon,6702,8,8,8,14,52,54,-2,32
Ards,6702,9,9,3,18,37,49,-12,30
Ballinamalla,6702,10,9,3,18,28,48,-20,30
Portadown,6702,11,4,6,20,16,49,-33,18
Cliftonville,6703,1,18,3,9,60,41,19,57
Linfield,6703,2,16,8,6,59,29,30,56
Crusaders,6703,3,15,5,10,52,40,12,50
Ballymena,6703,4,15,5,10,61,68,-7,50
Glenavon,6703,5,13,9,8,43,41,2,48
Coleraine,6703,6,11,10,9,41,37,4,43
Dungannon,6703,7,11,9,10,51,39,12,42
Glentoran,6703,8,10,6,14,36,43,-7,36
Ards,6703,9,9,6,15,35,51,-16,33
Ballinamalla,6703,10,6,5,19,25,49,-24,23
Portadown,6703,11,6,4,20,24,49,-25,22
Linfield,6704,1,15,11,4,64,37,27,56
Crusaders,6704,2,14,11,5,58,39,19,53
Cliftonville,6704,3,15,4,11,55,43,12,49
Ballymena,6704,4,14,6,10,62,61,1,48
Coleraine,6704,5,12,9,9,43,42,1,45
Glenavon,6704,6,10,10,10,46,42,4,40
Ballinamalla,6704,7,9,7,14,32,49,-17,34
Dungannon,6704,8,8,9,13,47,44,3,33
Ards,6704,9,9,5,16,42,55,-13,32
Glentoran,6704,10,8,8,14,30,46,-16,32
Portadown,6704,11,8,6,16,23,44,-21,30
Crusaders,6705,1,19,6,5,58,35,23,63
Coleraine,6705,2,14,10,6,48,40,8,52
Cliftonville,6705,3,14,8,8,64,40,24,50
Linfield,6705,4,14,8,8,56,32,24,50
Glenavon,6705,5,12,10,8,52,48,4,46
Ballymena,6705,6,12,8,10,55,56,-1,44
Dungannon,6705,7,10,11,9,52,43,9,41
Glentoran,6705,8,10,5,15,35,48,-13,35
Ards,6705,9,10,2,18,30,52,-22,32
Ballinamalla,6705,10,8,2,20,31,58,-27,26
Portadown,6705,11,4,6,20,21,50,-29,18
Crusaders,6706,1,18,6,6,58,31,27,60
Cliftonville,6706,2,16,6,8,54,35,19,54
Glenavon,6706,3,15,9,6,50,45,5,54
Ballymena,6706,4,15,6,9,57,51,6,51
Glentoran,6706,5,11,10,9,37,39,-2,43
Coleraine,6706,6,11,9,10,44,44,0,42
Linfield,6706,7,9,11,10,50,38,12,38
Dungannon,6706,8,9,8,13,48,49,-1,35
Portadown,6706,9,6,9,15,29,49,-20,27
Ards,6706,10,6,8,16,30,47,-17,26
Ballinamalla,6706,11,5,6,19,23,52,-29,21
Linfield,6707,1,18,9,3,71,29,42,63
Crusaders,6707,2,15,8,7,51,33,18,53
Cliftonville,6707,3,16,4,10,52,36,16,52
Ballymena,6707,4,14,4,12,56,60,-4,46
Glenavon,6707,5,11,11,8,48,45,3,44
Coleraine,6707,6,10,11,9,37,37,0,41
Ards,6707,7,10,6,14,40,48,-8,36
Dungannon,6707,8,8,11,11,44,44,0,35
Glentoran,6707,9,9,7,14,30,48,-18,34
Ballinamalla,6707,10,8,2,20,31,56,-25,26
Portadown,6707,11,6,7,17,20,44,-24,25
Crusaders,6708,1,18,6,6,55,34,21,60
Linfield,6708,2,15,10,5,57,27,30,55
Coleraine,6708,3,13,11,6,42,31,11,50
Cliftonville,6708,4,15,4,11,47,34,13,49
Glenavon,6708,5,10,12,8,45,42,3,42
Ballymena,6708,6,10,9,11,51,61,-10,39
Dungannon,6708,7,8,13,9,48,40,8,37
Ards,6708,8,9,5,16,36,48,-12,32
Ballinamalla,6708,9,7,8,15,28,47,-19,29
Portadown,6708,10,8,5,17,18,39,-21,29
Glentoran,6708,11,7,7,16,25,49,-24,28
Linfield,6709,1,17,7,6,68,36,32,58
Cliftonville,6709,2,17,3,10,54,43,11,54
Crusaders,6709,3,14,7,9,60,52,8,49
Glenavon,6709,4,13,8,9,45,44,1,47
Coleraine,6709,5,12,10,8,43,33,10,46
Ballymena,6709,6,12,8,10,58,54,4,44
Dungannon,6709,7,11,8,11,59,44,15,41
Ballinamalla,6709,8,10,3,17,31,49,-18,33
Ards,6709,9,8,6,16,36,49,-13,30
Portadown,6709,10,9,3,18,30,52,-22,30
Glentoran,6709,11,7,7,16,29,57,-28,28
Linfield,6710,1,18,8,4,61,27,34,62
Cliftonville,6710,2,14,8,8,53,35,18,50
Crusaders,6710,3,14,6,10,46,40,6,48
Coleraine,6710,4,12,10,8,40,33,7,46
Glenavon,6710,5,11,12,7,46,37,9,45
Ballymena,6710,6,12,6,12,57,61,-4,42
Glentoran,6710,7,11,8,11,33,41,-8,41
Dungannon,6710,8,9,8,13,47,45,2,35
Ballinamalla,6710,9,9,5,16,35,49,-14,32
Portadown,6710,10,6,9,15,22,50,-28,27
Ards,6710,11,7,4,19,33,55,-22,25
Crusaders,6711,1,18,7,5,55,29,26,61
Linfield,6711,2,15,9,6,59,30,29,54
Cliftonville,6711,3,15,6,9,49,40,9,51
Glenavon,6711,4,13,10,7,54,41,13,49
Coleraine,6711,5,11,10,9,42,37,5,43
Glentoran,6711,6,11,9,10,36,40,-4,42
Ballymena,6711,7,12,4,14,57,67,-10,40
Dungannon,6711,8,9,9,12,54,51,3,36
Ards,6711,9,9,8,13,37,44,-7,35
Portadown,6711,10,5,8,17,24,50,-26,23
Ballinamalla,6711,11,4,6,20,21,59,-38,18
Linfield,6712,1,17,8,5,64,28,36,59
Crusaders,6712,2,16,5,9,57,40,17,53
Cliftonville,6712,3,16,3,11,51,42,9,51
Ballymena,6712,4,14,4,12,55,54,1,46
Coleraine,6712,5,11,10,9,40,34,6,43
Dungannon,6712,6,11,9,10,51,45,6,42
Ards,6712,7,12,4,14,40,44,-4,40
Glenavon,6712,8,8,11,11,39,45,-6,35
Portadown,6712,9,8,6,16,27,50,-23,30
Ballinamalla,6712,10,8,6,16,29,53,-24,30
Glentoran,6712,11,7,8,15,24,42,-18,29
Linfield,6713,1,15,10,5,62,30,32,55
Crusaders,6713,2,15,9,6,48,29,19,54
Cliftonville,6713,3,14,8,8,53,39,14,50
Coleraine,6713,4,12,11,7,44,34,10,47
Dungannon,6713,5,12,9,9,52,42,10,45
Glenavon,6713,6,10,11,9,46,44,2,41
Ballymena,6713,7,10,10,10,45,53,-8,40
Glentoran,6713,8,8,8,14,27,37,-10,32
Ballinamalla,6713,9,9,4,17,32,52,-20,31
Portadown,6713,10,8,5,17,25,48,-23,29
Ards,6713,11,7,5,18,32,58,-26,26
Crusaders,6714,1,17,9,4,60,29,31,60
Coleraine,6714,2,13,13,4,45,33,12,52
Ballymena,6714,3,14,8,8,60,56,4,50
Cliftonville,6714,4,14,6,10,51,42,9,48
Linfield,6714,5,13,6,11,52,37,15,45
Glenavon,6714,6,11,11,8,45,41,4,44
Dungannon,6714,7,9,9,12,45,40,5,36
Ards,6714,8,10,3,17,40,50,-10,33
Ballinamalla,6714,9,9,4,17,30,55,-25,31
Glentoran,6714,10,7,8,15,28,48,-20,29
Portadown,6714,11,7,5,18,20,45,-25,26
Crusaders,6715,1,15,9,6,59,40,19,54
Glenavon,6715,2,13,11,6,58,41,17,50
Cliftonville,6715,3,14,7,9,55,40,15,49
Ballymena,6715,4,14,6,10,56,59,-3,48
Linfield,6715,5,12,11,7,52,32,20,47
Coleraine,6715,6,11,9,10,48,48,0,42
Glentoran,6715,7,10,8,12,28,34,-6,38
Dungannon,6715,8,8,11,11,52,50,2,35
Ards,6715,9,9,5,16,34,50,-16,32
Ballinamalla,6715,10,9,4,17,37,58,-21,31
Portadown,6715,11,6,7,17,24,51,-27,25
Linfield,6716,1,16,9,5,65,32,33,57
Crusaders,6716,2,15,8,7,51,34,17,53
Ballymena,6716,3,14,7,9,52,51,1,49
Glenavon,6716,4,12,12,6,56,42,14,48
Coleraine,6716,5,12,11,7,47,35,12,47
Cliftonville,6716,6,13,5,12,52,44,8,44
Dungannon,6716,7,10,9,11,46,44,2,39
Glentoran,6716,8,9,8,13,30,48,-18,35
Ballinamalla,6716,9,7,8,15,31,51,-20,29
Ards,6716,10,7,5,18,34,57,-23,26
Portadown,6716,11,5,8,17,20,46,-26,23
Linfield,6717,1,16,9,5,61,29,32,57
Crusaders,6717,2,16,9,5,53,30,23,57
Cliftonville,6717,3,15,5,10,63,44,19,50
Coleraine,6717,4,12,11,7,45,41,4,47
Glenavon,6717,5,9,13,8,51,48,3,40
Ballymena,6717,6,10,10,10,51,55,-4,40
Glentoran,6717,7,10,10,10,30,41,-11,40
Dungannon,6717,8,10,7,13,45,45,0,37
Ards,6717,9,9,6,15,39,49,-10,33
Ballinamalla,6717,10,6,6,18,28,55,-27,24
Portadown,6717,11,6,6,18,22,51,-29,24
Cliftonville,6718,1,15,8,7,58,45,13,53
Linfield,6718,2,14,10,6,66,39,27,52
Crusaders,6718,3,14,9,7,52,37,15,51
Glenavon,6718,4,13,9,8,50,40,10,48
Ballymena,6718,5,13,6,11,59,63,-4,45
Coleraine,6718,6,11,10,9,42,40,2,43
Ards,6718,7,13,4,13,51,51,0,43
Dungannon,6718,8,10,9,11,53,49,4,39
Glentoran,6718,9,9,7,14,35,47,-12,34
Portadown,6718,10,6,6,18,30,53,-23,24
Ballinamalla,6718,11,6,4,20,33,65,-32,22
Linfield,6719,1,16,7,7,61,32,29,55
Crusaders,6719,2,16,7,7,54,35,19,55
Glenavon,6719,3,14,8,8,54,47,7,50
Cliftonville,6719,4,14,5,11,47,37,10,47
Coleraine,6719,5,12,9,9,44,38,6,45
Glentoran,6719,6,11,8,11,36,43,-7,41
Portadown,6719,7,11,6,13,27,39,-12,39
Ballymena,6719,8,10,9,11,45,58,-13,39
Dungannon,6719,9,9,8,13,56,56,0,35
Ards,6719,10,9,5,16,33,43,-10,32
Ballinamalla,6719,11,3,8,19,23,52,-29,17
Crusaders,6720,1,16,8,6,61,38,23,56
Cliftonville,6720,2,15,5,10,53,43,10,50
Linfield,6720,3,14,7,9,59,39,20,49
Glenavon,6720,4,13,9,8,53,46,7,48
Ards,6720,5,13,5,12,46,45,1,44
Ballymena,6720,6,13,4,13,50,56,-6,43
Dungannon,6720,7,11,7,12,56,51,5,40
Coleraine,6720,8,8,11,11,38,43,-5,35
Glentoran,6720,9,9,8,13,33,48,-15,35
Ballinamalla,6720,10,9,3,18,35,55,-20,30
Portadown,6720,11,8,5,17,29,49,-20,29
Crusaders,6721,1,18,7,5,59,31,28,61
Linfield,6721,2,15,9,6,56,29,27,54
Cliftonville,6721,3,15,5,10,48,36,12,50
Dungannon,6721,4,12,9,9,53,43,10,45
Glenavon,6721,5,10,11,9,49,47,2,41
Coleraine,6721,6,9,10,11,38,41,-3,37
Ards,6721,7,10,7,13,37,45,-8,37
Ballymena,6721,8,10,6,14,48,57,-9,36
Glentoran,6721,9,9,8,13,31,44,-13,35
Ballinamalla,6721,10,9,4,17,30,51,-21,31
Portadown,6721,11,6,8,16,18,43,-25,26
Crusaders,6722,1,18,5,7,59,34,25,59
Ballymena,6722,2,15,7,8,59,55,4,52
Cliftonville,6722,3,15,5,10,58,36,22,50
Linfield,6722,4,13,10,7,51,30,21,49
Glenavon,6722,5,12,10,8,48,44,4,46
Coleraine,6722,6,10,13,7,38,39,-1,43
Dungannon,6722,7,11,8,11,54,50,4,41
Ards,6722,8,9,8,13,38,42,-4,35
Glentoran,6722,9,8,8,14,27,49,-22,32
Ballinamalla,6722,10,6,5,19,30,57,-27,23
Portadown,6722,11,5,7,18,25,51,-26,22
Cliftonville,6723,1,18,4,8,58,34,24,58
Crusaders,6723,2,16,8,6,59,37,22,56
Linfield,6723,3,14,9,7,67,39,28,51
Ballymena,6723,4,15,4,11,56,60,-4,49
Dungannon,6723,5,11,10,9,56,44,12,43
Glenavon,6723,6,11,9,10,51,49,2,42
Coleraine,6723,7,10,10,10,38,43,-5,40
Glentoran,6723,8,10,7,13,29,42,-13,37
Ballinamalla,6723,9,9,4,17,34,54,-20,31
Ards,6723,10,8,5,17,37,50,-13,29
Portadown,6723,11,6,4,20,20,53,-33,22
Crusaders,6724,1,19,6,5,65,32,33,63
Ballymena,6724,2,17,4,9,63,62,1,55
Linfield,6724,3,15,8,7,67,34,33,53
Glenavon,6724,4,10,14,6,47,40,7,44
Cliftonville,6724,5,12,6,12,47,42,5,42
Dungannon,6724,6,11,9,10,49,45,4,42
Coleraine,6724,7,10,11,9,43,44,-1,41
Ards,6724,8,11,4,15,44,52,-8,37
Glentoran,6724,9,9,8,13,32,46,-14,35
Ballinamalla,6724,10,6,4,20,27,58,-31,22
Portadown,6724,11,5,6,19,22,51,-29,21
Cliftonville,6725,1,16,6,8,63,40,23,54
Ballymena,6725,2,16,6,8,56,54,2,54
Crusaders,6725,3,14,10,6,55,38,17,52
Linfield,6725,4,13,10,7,53,32,21,49
Coleraine,6725,5,12,12,6,45,40,5,48
Glenavon,6725,6,11,9,10,52,46,6,42
Dungannon,6725,7,10,9,11,52,47,5,39
Glentoran,6725,8,8,8,14,31,44,-13,32
Ballinamalla,6725,9,9,5,16,38,54,-16,32
Ards,6725,10,8,5,17,33,52,-19,29
Portadown,6725,11,6,4,20,22,53,-31,22
Crusaders,6726,1,17,10,3,66,37,29,61
Cliftonville,6726,2,17,5,8,51,32,19,56
Linfield,6726,3,13,11,6,59,41,18,50
Coleraine,6726,4,10,13,7,51,47,4,43
Glenavon,6726,5,11,10,9,47,48,-1,43
Ballymena,6726,6,11,7,12,56,67,-11,40
Glentoran,6726,7,9,9,12,39,42,-3,36
Ards,6726,8,9,7,14,45,51,-6,34
Dungannon,6726,9,8,8,14,48,49,-1,32
Ballinamalla,6726,10,8,5,17,33,55,-22,29
Portadown,6726,11,7,5,18,28,54,-26,26
Linfield,6727,1,15,7,8,62,33,29,52
Crusaders,6727,2,15,7,8,55,44,11,52
Coleraine,6727,3,12,11,7,48,37,11,47
Glenavon,6727,4,11,13,6,55,48,7,46
Dungannon,6727,5,10,13,7,57,46,11,43
Ballymena,6727,6,12,5,13,49,65,-16,41
Ards,6727,7,11,7,12,43,45,-2,40
Cliftonville,6727,8,11,6,13,51,48,3,39
Glentoran,6727,9,9,8,13,37,48,-11,35
Portadown,6727,10,10,4,16,29,46,-17,34
Ballinamalla,6727,11,4,9,17,32,58,-26,21
Ballymena,6728,1,17,5,8,64,52,12,56
Glenavon,6728,2,15,9,6,59,38,21,54
Cliftonville,6728,3,16,5,9,50,37,13,53
Crusaders,6728,4,14,7,9,54,35,19,49
Linfield,6728,5,12,10,8,56,40,16,46
Coleraine,6728,6,10,9,11,42,47,-5,39
Ards,6728,7,10,6,14,41,48,-7,36
Glentoran,6728,8,10,5,15,30,50,-20,35
Dungannon,6728,9,7,10,13,43,50,-7,31
Portadown,6728,10,7,7,16,30,50,-20,28
Ballinamalla,6728,11,7,7,16,27,49,-22,28
Crusaders,6729,1,20,6,4,59,32,27,66
Ballymena,6729,2,15,8,7,61,52,9,53
Linfield,6729,3,14,9,7,64,35,29,51
Coleraine,6729,4,13,12,5,41,31,10,51
Cliftonville,6729,5,12,8,10,52,37,15,44
Dungannon,6729,6,10,9,11,52,45,7,39
Glenavon,6729,7,9,11,10,46,46,0,38
Glentoran,6729,8,8,9,13,28,45,-17,33
Ards,6729,9,9,5,16,41,52,-11,32
Ballinamalla,6729,10,6,4,20,27,59,-32,22
Portadown,6729,11,4,9,17,23,60,-37,21
Cliftonville,6730,1,17,5,8,52,33,19,56
Crusaders,6730,2,13,7,10,46,40,6,46
Ballymena,6730,3,13,7,10,55,56,-1,46
Dungannon,6730,4,11,12,7,58,39,19,45
Linfield,6730,5,12,9,9,52,36,16,45
Glenavon,6730,6,10,14,6,48,44,4,44
Coleraine,6730,7,9,13,8,39,36,3,40
Ards,6730,8,11,5,14,39,45,-6,38
Glentoran,6730,9,8,10,12,27,39,-12,34
Portadown,6730,10,7,7,16,21,45,-24,28
Ballinamalla,6730,11,5,9,16,28,52,-24,24
Crusaders,6731,1,17,8,5,58,33,25,59
Linfield,6731,2,14,12,4,59,29,30,54
Cliftonville,6731,3,16,4,10,55,43,12,52
Ballymena,6731,4,14,7,9,58,58,0,49
Coleraine,6731,5,13,8,9,46,35,11,47
Glenavon,6731,6,12,9,9,47,45,2,45
Glentoran,6731,7,10,7,13,32,49,-17,37
Dungannon,6731,8,9,8,13,45,42,3,35
Portadown,6731,9,7,6,17,22,43,-21,27
Ards,6731,10,8,2,20,31,53,-22,26
Ballinamalla,6731,11,7,5,18,25,48,-23,26
Crusaders,6732,1,16,6,8,51,39,12,54
Linfield,6732,2,15,6,9,57,38,19,51
Cliftonville,6732,3,15,6,9,53,38,15,51
Coleraine,6732,4,13,9,8,43,35,8,48
Ballymena,6732,5,14,5,11,61,64,-3,47
Dungannon,6732,6,12,7,11,46,39,7,43
Glenavon,6732,7,11,9,10,44,44,0,42
Glentoran,6732,8,11,7,12,38,41,-3,40
Ards,6732,9,9,7,14,40,45,-5,34
Ballinamalla,6732,10,7,6,17,32,54,-22,27
Portadown,6732,11,6,4,20,24,52,-28,22
Linfield,6733,1,17,8,5,62,29,33,59
Crusaders,6733,2,16,5,9,54,34,20,53
Cliftonville,6733,3,13,7,10,58,46,12,46
Ards,6733,4,13,5,12,39,47,-8,44
Glenavon,6733,5,10,12,8,43,42,1,42
Ballymena,6733,6,11,9,10,50,57,-7,42
Coleraine,6733,7,9,14,7,40,37,3,41
Dungannon,6733,8,8,10,12,45,49,-4,34
Glentoran,6733,9,9,7,14,42,57,-15,34
Ballinamalla,6733,10,9,5,16,31,44,-13,32
Portadown,6733,11,6,6,18,23,45,-22,24
Crusaders,6734,1,20,6,4,62,27,35,66
Glenavon,6734,2,14,8,8,50,47,3,50
Linfield,6734,3,13,10,7,58,35,23,49
Cliftonville,6734,4,14,4,12,48,44,4,46
Ballymena,6734,5,12,8,10,52,60,-8,44
Dungannon,6734,6,11,9,10,54,46,8,42
Coleraine,6734,7,10,9,11,37,36,1,39
Ards,6734,8,9,6,15,43,49,-6,33
Ballinamalla,6734,9,9,3,18,29,49,-20,30
Portadown,6734,10,8,5,17,25,46,-21,29
Glentoran,6734,11,6,10,14,26,45,-19,28
Crusaders,6735,1,15,7,8,53,35,18,52
Glenavon,6735,2,14,10,6,54,42,12,52
Cliftonville,6735,3,16,4,10,48,37,11,52
Linfield,6735,4,13,10,7,57,36,21,49
Coleraine,6735,5,11,12,7,40,35,5,45
Ballymena,6735,6,13,5,12,54,53,1,44
Dungannon,6735,7,12,7,11,50,42,8,43
Ards,6735,8,12,3,15,43,52,-9,39
Glentoran,6735,9,10,6,14,33,47,-14,36
Portadown,6735,10,7,6,17,24,46,-22,27
Ballinamalla,6735,11,4,6,20,28,59,-31,18
Crusaders,6736,1,18,6,6,62,35,27,60
Linfield,6736,2,16,8,6,63,33,30,56
Ballymena,6736,3,15,6,9,65,59,6,51
Cliftonville,6736,4,15,5,10,62,45,17,50
Coleraine,6736,5,14,8,8,43,39,4,50
Glenavon,6736,6,11,10,9,43,47,-4,43
Ards,6736,7,10,5,15,36,45,-9,35
Dungannon,6736,8,8,9,13,47,53,-6,33
Glentoran,6736,9,8,7,15,33,48,-15,31
Ballinamalla,6736,10,6,6,18,29,55,-26,24
Portadown,6736,11,5,8,17,20,44,-24,23
Crusaders,6737,1,20,6,4,64,35,29,66
Linfield,6737,2,15,6,9,60,37,23,51
Cliftonville,6737,3,14,7,9,59,42,17,49
Ballymena,6737,4,13,10,7,58,60,-2,49
Glenavon,6737,5,12,9,9,48,45,3,45
Coleraine,6737,6,12,9,9,41,40,1,45
Glentoran,6737,7,11,9,10,39,40,-1,42
Dungannon,6737,8,8,11,11,48,45,3,35
Ballinamalla,6737,9,8,5,17,29,53,-24,29
Portadown,6737,10,6,5,19,29,56,-27,23
Ards,6737,11,5,5,20,38,60,-22,20
Cliftonville,6738,1,18,4,8,52,32,20,58
Crusaders,6738,2,17,6,7,50,32,18,57
Ballymena,6738,3,14,6,10,53,50,3,48
Linfield,6738,4,12,9,9,53,31,22,45
Dungannon,6738,5,12,9,9,53,41,12,45
Coleraine,6738,6,11,12,7,40,36,4,45
Glenavon,6738,7,9,11,10,40,42,-2,38
Glentoran,6738,8,9,8,13,27,42,-15,35
Ballinamalla,6738,9,8,7,15,34,51,-17,31
Ards,6738,10,8,6,16,32,45,-13,30
Portadown,6738,11,6,4,20,22,54,-32,22
Linfield,6739,1,16,8,6,60,33,27,56
Crusaders,6739,2,15,7,8,54,38,16,52
Coleraine,6739,3,12,13,5,49,35,14,49
Cliftonville,6739,4,14,7,9,49,40,9,49
Glenavon,6739,5,13,10,7,53,45,8,49
Ballymena,6739,6,13,8,9,56,58,-2,47
Dungannon,6739,7,9,10,11,48,49,-1,37
Portadown,6739,8,9,3,18,27,47,-20,30
Ballinamalla,6739,9,7,7,16,30,47,-17,28
Glentoran,6739,10,7,7,16,30,52,-22,28
Ards,6739,11,7,6,17,35,47,-12,27
Crusaders,6740,1,20,7,3,59,28,31,67
Linfield,6740,2,14,9,7,61,38,23,51
Cliftonville,6740,3,15,4,11,49,39,10,49
Ballymena,6740,4,15,4,11,61,56,5,49
Glenavon,6740,5,12,10,8,46,38,8,46
Coleraine,6740,6,10,11,9,34,33,1,41
Glentoran,6740,7,11,8,11,33,40,-7,41
Dungannon,6740,8,9,8,13,46,39,7,35
Portadown,6740,9,8,4,18,22,43,-21,28
Ards,6740,10,7,5,18,29,50,-21,26
Ballinamalla,6740,11,6,6,18,22,58,-36,24
Linfield,6741,1,16,6,8,51,29,22,54
Cliftonville,6741,2,16,5,9,55,35,20,53
Glenavon,6741,3,12,12,6,52,44,8,48
Crusaders,6741,4,12,8,10,52,46,6,44
Coleraine,6741,5,11,11,8,43,38,5,44
Ballymena,6741,6,12,8,10,49,53,-4,44
Dungannon,6741,7,11,10,9,51,39,12,43
Glentoran,6741,8,12,7,11,42,43,-1,43
Portadown,6741,9,8,6,16,26,45,-19,30
Ballinamalla,6741,10,7,6,17,28,52,-24,27
Ards,6741,11,5,7,18,31,56,-25,22
Crusaders,6742,1,18,7,5,52,28,24,61
Cliftonville,6742,2,18,2,10,53,33,20,56
Linfield,6742,3,13,8,9,53,33,20,47
Glenavon,6742,4,13,8,9,46,44,2,47
Dungannon,6742,5,11,9,10,58,43,15,42
Ballymena,6742,6,12,6,12,54,66,-12,42
Coleraine,6742,7,10,11,9,43,39,4,41
Glentoran,6742,8,9,7,14,28,48,-20,34
Ards,6742,9,9,5,16,34,44,-10,32
Portadown,6742,10,8,5,17,24,44,-20,29
Ballinamalla,6742,11,9,2,19,33,56,-23,29
Crusaders,6743,1,18,7,5,64,29,35,61
Cliftonville,6743,2,16,6,8,57,42,15,54
Ballymena,6743,3,15,4,11,61,61,0,49
Coleraine,6743,4,13,9,8,50,37,13,48
Linfield,6743,5,12,6,12,46,36,10,42
Dungannon,6743,6,10,10,10,60,44,16,40
Glenavon,6743,7,7,15,8,36,47,-11,36
Glentoran,6743,8,10,6,14,32,46,-14,36
Ballinamalla,6743,9,9,5,16,32,53,-21,32
Portadown,6743,10,8,6,16,24,45,-21,30
Ards,6743,11,8,4,18,33,55,-22,28
Crusaders,6744,1,18,5,7,54,33,21,59
Cliftonville,6744,2,16,4,10,51,39,12,52
Ballymena,6744,3,15,5,10,61,57,4,50
Linfield,6744,4,13,7,10,54,36,18,46
Coleraine,6744,5,12,8,10,42,42,0,44
Glenavon,6744,6,10,12,8,50,46,4,42
Glentoran,6744,7,11,9,10,39,42,-3,42
Ards,6744,8,10,4,16,40,53,-13,34
Dungannon,6744,9,8,9,13,50,52,-2,33
Portadown,6744,10,8,7,15,30,44,-14,31
Ballinamalla,6744,11,6,6,18,29,56,-27,24
Ballymena,6745,1,18,4,8,70,54,16,58
Crusaders,6745,2,16,7,7,58,38,20,55
Linfield,6745,3,14,10,6,61,33,28,52
Cliftonville,6745,4,15,4,11,51,35,16,49
Coleraine,6745,5,10,11,9,44,48,-4,41
Glentoran,6745,6,11,7,12,34,35,-1,40
Dungannon,6745,7,10,8,12,46,48,-2,38
Glenavon,6745,8,7,13,10,37,49,-12,34
Ards,6745,9,9,6,15,31,47,-16,33
Ballinamalla,6745,10,9,5,16,32,47,-15,32
Portadown,6745,11,5,7,18,26,56,-30,22
Linfield,6746,1,15,9,6,60,37,23,54
Crusaders,6746,2,16,6,8,58,43,15,54
Glenavon,6746,3,15,9,6,54,39,15,54
Coleraine,6746,4,14,8,8,48,36,12,50
Cliftonville,6746,5,14,6,10,45,38,7,48
Ballymena,6746,6,14,5,11,55,56,-1,47
Ards,6746,7,10,6,14,39,48,-9,36
Dungannon,6746,8,9,8,13,51,51,0,35
Ballinamalla,6746,9,9,5,16,37,54,-17,32
Glentoran,6746,10,8,6,16,29,48,-19,30
Portadown,6746,11,5,4,21,22,48,-26,19
Crusaders,6747,1,16,8,6,57,37,20,56
Cliftonville,6747,2,16,4,10,55,36,19,52
Glenavon,6747,3,14,8,8,50,43,7,50
Ballymena,6747,4,14,6,10,57,55,2,48
Coleraine,6747,5,12,8,10,41,40,1,44
Linfield,6747,6,11,10,9,53,34,19,43
Dungannon,6747,7,10,8,12,49,47,2,38
Ards,6747,8,8,10,12,42,47,-5,34
Glentoran,6747,9,8,9,13,31,45,-14,33
Ballinamalla,6747,10,8,7,15,29,55,-26,31
Portadown,6747,11,6,6,18,19,44,-25,24
Linfield,6748,1,17,7,6,57,28,29,58
Crusaders,6748,2,16,7,7,57,36,21,55
Cliftonville,6748,3,16,3,11,52,41,11,51
Coleraine,6748,4,12,10,8,44,34,10,46
Ballymena,6748,5,13,7,10,61,57,4,46
Glenavon,6748,6,12,9,9,46,48,-2,45
Dungannon,6748,7,10,8,12,47,44,3,38
Ards,6748,8,10,5,15,41,51,-10,35
Portadown,6748,9,10,3,17,25,51,-26,33
Glentoran,6748,10,7,6,17,28,45,-17,27
Ballinamalla,6748,11,7,5,18,31,54,-23,26
Crusaders,6749,1,17,6,7,58,35,23,57
Ballymena,6749,2,16,6,8,56,51,5,54
Cliftonville,6749,3,15,5,10,49,37,12,50
Linfield,6749,4,14,7,9,54,36,18,49
Dungannon,6749,5,13,8,9,55,42,13,47
Glenavon,6749,6,11,11,8,43,40,3,44
Coleraine,6749,7,10,11,9,43,39,4,41
Ards,6749,8,11,5,14,41,49,-8,38
Ballinamalla,6749,9,7,5,18,26,48,-22,26
Portadown,6749,10,7,5,18,20,44,-24,26
Glentoran,6749,11,6,7,17,26,50,-24,25
Linfield,6750,1,18,8,4,69,29,40,62
Coleraine,6750,2,13,12,5,46,30,16,51
Crusaders,6750,3,13,11,6,54,41,13,50
Cliftonville,6750,4,15,4,11,52,43,9,49
Ballymena,6750,5,11,9,10,51,62,-11,42
Glenavon,6750,6,9,10,11,43,46,-3,37
Dungannon,6750,7,8,12,10,44,45,-1,36
Ards,6750,8,10,6,14,39,48,-9,36
Portadown,6750,9,9,5,16,28,45,-17,32
Glentoran,6750,10,7,7,16,27,45,-18,28
Ballinamalla,6750,11,7,6,17,31,50,-19,27
Crusaders,6751,1,19,8,3,50,23,27,65
Cliftonville,6751,2,18,4,8,55,37,18,58
Ballymena,6751,3,16,6,8,62,50,12,54
Linfield,6751,4,14,10,6,59,33,26,52
Dungannon,6751,5,10,10,10,49,38,11,40
Coleraine,6751,6,9,12,9,38,40,-2,39
Glenavon,6751,7,8,11,11,40,46,-6,35
Ballinamalla,6751,8,9,5,16,30,50,-20,32
Portadown,6751,9,7,7,16,21,42,-21,28
Glentoran,6751,10,7,6,17,23,44,-21,27
Ards,6751,11,5,7,18,34,58,-24,22
Linfield,6752,1,16,10,4,59,27,32,58
Crusaders,6752,2,16,7,7,57,39,18,55
Cliftonville,6752,3,17,4,9,59,45,14,55
Dungannon,6752,4,12,7,11,53,40,13,43
Ballymena,6752,5,10,10,10,50,57,-7,40
Ballinamalla,6752,6,12,2,16,38,52,-14,38
Coleraine,6752,7,8,13,9,41,43,-2,37
Glenavon,6752,8,8,12,10,43,48,-5,36
Glentoran,6752,9,8,8,14,31,44,-13,32
Portadown,6752,10,7,9,14,30,46,-16,30
Ards,6752,11,7,6,17,31,51,-20,27
Linfield,6753,1,18,6,6,60,29,31,60
Cliftonville,6753,2,16,7,7,58,39,19,55
Ballymena,6753,3,16,5,9,54,51,3,53
Crusaders,6753,4,15,7,8,52,36,16,52
Coleraine,6753,5,13,8,9,45,40,5,47
Glenavon,6753,6,10,12,8,38,42,-4,42
Dungannon,6753,7,9,10,11,58,50,8,37
Glentoran,6753,8,9,9,12,35,44,-9,36
Ards,6753,9,9,4,17,35,50,-15,31
Portadown,6753,10,6,6,18,29,51,-22,24
Ballinamalla,6753,11,5,4,21,27,59,-32,19
Crusaders,6754,1,18,10,2,66,32,34,64
Cliftonville,6754,2,17,4,9,53,38,15,55
Linfield,6754,3,14,8,8,58,35,23,50
Ballymena,6754,4,15,5,10,59,59,0,50
Glenavon,6754,5,12,12,6,46,44,2,48
Coleraine,6754,6,11,11,8,44,39,5,44
Dungannon,6754,7,10,9,11,53,43,10,39
Ards,6754,8,10,5,15,44,54,-10,35
Glentoran,6754,9,7,8,15,28,45,-17,29
Portadown,6754,10,4,8,18,25,52,-27,20
Ballinamalla,6754,11,5,4,21,23,58,-35,19
Crusaders,6755,1,16,8,6,57,38,19,56
Linfield,6755,2,15,9,6,65,32,33,54
Cliftonville,6755,3,16,5,9,55,36,19,53
Glenavon,6755,4,13,10,7,52,41,11,49
Ballymena,6755,5,13,7,10,63,62,1,46
Coleraine,6755,6,9,9,12,40,49,-9,36
Glentoran,6755,7,9,9,12,32,44,-12,36
Dungannon,6755,8,8,9,13,43,52,-9,33
Ards,6755,9,9,5,16,38,52,-14,32
Portadown,6755,10,7,8,15,25,43,-18,29
Ballinamalla,6755,11,8,5,17,26,47,-21,29
Cliftonville,6756,1,15,8,7,54,34,20,53
Crusaders,6756,2,15,8,7,50,35,15,53
Linfield,6756,3,12,12,6,61,32,29,48
Ballymena,6756,4,12,10,8,64,60,4,46
Coleraine,6756,5,12,8,10,37,47,-10,44
Glentoran,6756,6,12,7,11,40,39,1,43
Dungannon,6756,7,10,8,12,51,49,2,38
Glenavon,6756,8,9,9,12,40,49,-9,36
Ards,6756,9,10,4,16,37,49,-12,34
Ballinamalla,6756,10,10,4,16,39,54,-15,34
Portadown,6756,11,7,4,19,27,52,-25,25
Linfield,6757,1,15,10,5,57,27,30,55
Crusaders,6757,2,16,7,7,58,35,23,55
Coleraine,6757,3,12,11,7,50,39,11,47
Cliftonville,6757,4,12,7,11,52,47,5,43
Glenavon,6757,5,11,10,9,46,52,-6,43
Ballymena,6757,6,12,7,11,62,70,-8,43
Dungannon,6757,7,10,10,10,52,44,8,40
Ards,6757,8,11,6,13,41,49,-8,39
Glentoran,6757,9,9,7,14,28,43,-15,34
Portadown,6757,10,8,6,16,33,49,-16,30
Ballinamalla,6757,11,7,3,20,31,55,-24,24
Crusaders,6758,1,19,7,4,59,29,30,64
Linfield,6758,2,16,7,7,61,38,23,55
Glenavon,6758,3,15,10,5,60,39,21,55
Cliftonville,6758,4,17,4,9,59,41,18,55
Coleraine,6758,5,10,11,9,42,42,0,41
Dungannon,6758,6,10,8,12,51,50,1,38
Ballymena,6758,7,10,7,13,53,65,-12,37
Portadown,6758,8,8,6,16,28,50,-22,30
Ards,6758,9,8,5,17,36,50,-14,29
Glentoran,6758,10,6,9,15,20,39,-19,27
Ballinamalla,6758,11,6,6,18,26,52,-26,24
Crusaders,6759,1,17,5,8,57,34,23,56
Linfield,6759,2,14,9,7,55,31,24,51
Ballymena,6759,3,15,4,11,54,55,-1,49
Cliftonville,6759,4,14,6,10,58,43,15,48
Glenavon,6759,5,10,12,8,47,45,2,42
Coleraine,6759,6,9,14,7,38,36,2,41
Dungannon,6759,7,10,8,12,45,40,5,38
Ards,6759,8,11,3,16,35,48,-13,36
Ballinamalla,6759,9,9,6,15,34,49,-15,33
Glentoran,6759,10,9,5,16,31,53,-22,32
Portadown,6759,11,8,6,16,23,43,-20,30
Crusaders,6760,1,16,8,6,58,36,22,56
Linfield,6760,2,13,11,6,59,32,27,50
Cliftonville,6760,3,15,5,10,52,39,13,50
Coleraine,6760,4,12,10,8,46,42,4,46
Glenavon,6760,5,11,11,8,49,44,5,44
Ballymena,6760,6,11,9,10,48,53,-5,42
Glentoran,6760,7,9,10,11,31,38,-7,37
Dungannon,6760,8,9,9,12,46,51,-5,36
Portadown,6760,9,10,4,16,33,45,-12,34
Ards,6760,10,8,8,14,39,50,-11,32
Ballinamalla,6760,11,5,7,18,21,52,-31,22
Crusaders,6761,1,18,5,7,65,43,22,59
Cliftonville,6761,2,18,4,8,58,35,23,58
Ballymena,6761,3,16,5,9,66,54,12,53
Linfield,6761,4,13,11,6,59,35,24,50
Coleraine,6761,5,13,10,7,51,35,16,49
Glenavon,6761,6,12,9,9,46,46,0,45
Dungannon,6761,7,10,8,12,47,45,2,38
Portadown,6761,8,8,7,15,28,49,-21,31
Ards,6761,9,8,6,16,41,55,-14,30
Glentoran,6761,10,5,7,18,23,56,-33,22
Ballinamalla,6761,11,5,6,19,23,54,-31,21
Ballymena,6762,1,16,6,8,60,54,6,54
Crusaders,6762,2,15,7,8,58,40,18,52
Linfield,6762,3,13,8,9,53,36,17,47
Coleraine,6762,4,12,8,10,47,39,8,44
Glenavon,6762,5,12,8,10,49,47,2,44
Dungannon,6762,6,11,10,9,66,45,21,43
Glentoran,6762,7,11,8,11,35,39,-4,41
Cliftonville,6762,8,12,3,15,45,48,-3,39
Portadown,6762,9,11,5,14,27,43,-16,38
Ards,6762,10,9,5,16,39,58,-19,32
Ballinamalla,6762,11,6,6,18,25,55,-30,24
Glenavon,6763,1,16,10,4,61,42,19,58
Ballymena,6763,2,17,6,7,64,56,8,57
Crusaders,6763,3,16,7,7,58,34,24,55
Linfield,6763,4,13,10,7,58,31,27,49
Cliftonville,6763,5,15,3,12,50,43,7,48
Dungannon,6763,6,8,13,9,48,45,3,37
Ards,6763,7,11,3,16,44,50,-6,36
Coleraine,6763,8,8,11,11,44,48,-4,35
Glentoran,6763,9,9,7,14,24,42,-18,34
Portadown,6763,10,8,8,14,30,43,-13,32
Ballinamalla,6763,11,4,2,24,17,64,-47,14
Crusaders,6764,1,17,7,6,58,35,23,58
Linfield,6764,2,15,9,6,62,34,28,54
Glenavon,6764,3,12,11,7,46,43,3,47
Ballymena,6764,4,13,8,9,56,56,0,47
Coleraine,6764,5,12,10,8,40,32,8,46
Cliftonville,6764,6,12,7,11,47,40,7,43
Glentoran,6764,7,12,6,12,36,45,-9,42
Dungannon,6764,8,10,9,11,54,48,6,39
Portadown,6764,9,7,6,17,28,49,-21,27
Ards,6764,10,6,7,17,32,51,-19,25
Ballinamalla,6764,11,7,4,19,27,53,-26,25
Linfield,6765,1,18,8,4,65,29,36,62
Crusaders,6765,2,16,6,8,56,36,20,54
Cliftonville,6765,3,16,5,9,54,42,12,53
Ballymena,6765,4,15,4,11,56,58,-2,49
Dungannon,6765,5,12,7,11,52,44,8,43
Ards,6765,6,12,4,14,37,44,-7,40
Ballinamalla,6765,7,12,3,15,34,44,-10,39
Glenavon,6765,8,9,11,10,45,43,2,38
Coleraine,6765,9,8,12,10,42,46,-4,36
Glentoran,6765,10,6,6,18,28,51,-23,24
Portadown,6765,11,6,4,20,24,56,-32,22
Dungannon,6766,1,14,9,7,57,38,19,51
Linfield,6766,2,14,9,7,52,35,17,51
Crusaders,6766,3,13,11,6,52,35,17,50
Cliftonville,6766,4,15,5,10,57,47,10,50
Ballymena,6766,5,15,5,10,63,57,6,50
Glenavon,6766,6,11,9,10,45,42,3,42
Coleraine,6766,7,11,9,10,39,39,0,42
Glentoran,6766,8,9,11,10,36,46,-10,38
Ards,6766,9,8,6,16,38,53,-15,30
Ballinamalla,6766,10,7,5,18,29,49,-20,26
Portadown,6766,11,7,3,20,20,47,-27,24
Crusaders,6767,1,17,6,7,58,32,26,57
Cliftonville,6767,2,17,3,10,61,44,17,54
Linfield,6767,3,14,9,7,65,39,26,51
Glenavon,6767,4,12,11,7,59,47,12,47
Coleraine,6767,5,12,8,10,46,40,6,44
Ballymena,6767,6,12,6,12,56,66,-10,42
Dungannon,6767,7,9,10,11,55,53,2,37
Glentoran,6767,8,10,7,13,35,53,-18,37
Ards,6767,9,10,5,15,36,47,-11,35
Ballinamalla,6767,10,8,4,18,31,55,-24,28
Portadown,6767,11,6,7,17,26,52,-26,25
Linfield,6768,1,15,10,5,64,30,34,55
Crusaders,6768,2,15,7,8,49,32,17,52
Cliftonville,6768,3,14,7,9,50,36,14,49
Coleraine,6768,4,13,8,9,46,39,7,47
Ballymena,6768,5,14,4,12,52,58,-6,46
Glentoran,6768,6,11,9,10,32,37,-5,42
Glenavon,6768,7,10,10,10,44,48,-4,40
Dungannon,6768,8,7,12,11,48,47,1,33
Ards,6768,9,9,6,15,34,48,-14,33
Portadown,6768,10,9,3,18,27,49,-22,30
Ballinamalla,6768,11,8,4,18,30,52,-22,28
Crusaders,6769,1,16,7,7,61,41,20,55
Cliftonville,6769,2,16,5,9,57,40,17,53
Linfield,6769,3,14,9,7,59,34,25,51
Coleraine,6769,4,11,13,6,44,32,12,46
Ballymena,6769,5,12,7,11,50,61,-11,43
Glentoran,6769,6,12,6,12,35,44,-9,42
Glenavon,6769,7,9,13,8,44,43,1,40
Dungannon,6769,8,9,12,9,54,46,8,39
Ballinamalla,6769,9,9,4,17,28,48,-20,31
Portadown,6769,10,6,9,15,31,48,-17,27
Ards,6769,11,6,5,19,27,53,-26,23
Crusaders,6770,1,17,8,5,59,33,26,59
Linfield,6770,2,17,7,6,54,34,20,58
Cliftonville,6770,3,16,4,10,57,40,17,52
Ballymena,6770,4,15,5,10,68,64,4,50
Glenavon,6770,5,10,13,7,40,42,-2,43
Coleraine,6770,6,11,9,10,48,39,9,42
Dungannon,6770,7,10,11,9,50,41,9,41
Ards,6770,8,8,5,17,33,53,-20,29
Glentoran,6770,9,6,9,15,27,46,-19,27
Portadown,6770,10,7,6,17,22,49,-27,27
Ballinamalla,6770,11,6,7,17,36,53,-17,25
Crusaders,6771,1,18,6,6,58,35,23,60
Cliftonville,6771,2,15,5,10,49,41,8,50
Linfield,6771,3,12,12,6,58,36,22,48
Glenavon,6771,4,11,12,7,51,44,7,45
Dungannon,6771,5,12,8,10,53,41,12,44
Ballymena,6771,6,13,4,13,56,61,-5,43
Coleraine,6771,7,10,10,10,47,42,5,40
Glentoran,6771,8,9,6,15,32,49,-17,33
Ards,6771,9,8,8,14,40,52,-12,32
Ballinamalla,6771,10,8,7,15,28,46,-18,31
Portadown,6771,11,6,8,16,23,48,-25,26
Crusaders,6772,1,17,7,6,65,37,28,58
Ballymena,6772,2,17,3,10,73,60,13,54
Linfield,6772,3,14,8,8,58,36,22,50
Coleraine,6772,4,14,8,8,42,32,10,50
Cliftonville,6772,5,14,4,12,54,40,14,46
Dungannon,6772,6,11,8,11,55,45,10,41
Ards,6772,7,11,3,16,34,55,-21,36
Glenavon,6772,8,8,11,11,42,44,-2,35
Portadown,6772,9,9,4,17,24,54,-30,31
Ballinamalla,6772,10,8,6,16,31,54,-23,30
Glentoran,6772,11,7,8,15,29,50,-21,29
Ballymena,6773,1,16,5,9,56,56,0,53
Crusaders,6773,2,15,7,8,49,33,16,52
Linfield,6773,3,14,8,8,52,31,21,50
Coleraine,6773,4,11,11,8,48,41,7,44
Glenavon,6773,5,9,14,7,48,44,4,41
Cliftonville,6773,6,12,4,14,46,44,2,40
Glentoran,6773,7,11,7,12,32,39,-7,40
Dungannon,6773,8,8,13,9,46,38,8,37
Ards,6773,9,10,5,15,39,50,-11,35
Portadown,6773,10,10,4,16,28,43,-15,34
Ballinamalla,6773,11,7,6,17,31,56,-25,27
Crusaders,6774,1,16,7,7,50,30,20,55
Cliftonville,6774,2,16,6,8,62,45,17,54
Ballymena,6774,3,15,8,7,64,51,13,53
Linfield,6774,4,13,10,7,57,35,22,49
Glenavon,6774,5,11,12,7,41,40,1,45
Coleraine,6774,6,10,10,10,40,44,-4,40
Dungannon,6774,7,10,9,11,43,38,5,39
Glentoran,6774,8,8,9,13,33,46,-13,33
Ards,6774,9,9,4,17,37,46,-9,31
Portadown,6774,10,5,11,14,25,47,-22,26
Ballinamalla,6774,11,6,6,18,23,53,-30,24
Coleraine,6775,1,15,9,6,48,38,10,54
Cliftonville,6775,2,16,5,9,60,34,26,53
Glenavon,6775,3,14,9,7,57,48,9,51
Ballymena,6775,4,15,5,10,60,60,0,50
Crusaders,6775,5,12,13,5,50,35,15,49
Linfield,6775,6,13,9,8,59,39,20,48
Dungannon,6775,7,10,8,12,56,49,7,38
Glentoran,6775,8,8,10,12,29,44,-15,34
Portadown,6775,9,8,4,18,27,50,-23,28
Ballinamalla,6775,10,8,3,19,30,54,-24,27
Ards,6775,11,6,5,19,32,57,-25,23
Linfield,6776,1,15,9,6,59,33,26,54
Crusaders,6776,2,15,9,6,54,35,19,54
Coleraine,6776,3,14,10,6,44,30,14,52
Ballymena,6776,4,16,4,10,58,50,8,52
Cliftonville,6776,5,14,6,10,54,43,11,48
Glenavon,6776,6,11,12,7,45,43,2,45
Dungannon,6776,7,8,11,11,48,43,5,35
Glentoran,6776,8,8,10,12,28,41,-13,34
Ballinamalla,6776,9,8,6,16,29,52,-23,30
Ards,6776,10,6,8,16,33,51,-18,26
Portadown,6776,11,5,5,20,23,54,-31,20
Cliftonville,6777,1,16,6,8,45,30,15,54
Crusaders,6777,2,14,8,8,46,34,12,50
Ballymena,6777,3,14,6,10,60,60,0,48
Glenavon,6777,4,12,10,8,47,43,4,46
Coleraine,6777,5,12,9,9,45,35,10,45
Linfield,6777,6,11,11,8,52,35,17,44
Ards,6777,7,12,5,13,43,46,-3,41
Dungannon,6777,8,11,7,12,45,45,0,40
Glentoran,6777,9,10,8,12,32,39,-7,38
Portadown,6777,10,8,3,19,29,53,-24,27
Ballinamalla,6777,11,6,5,19,26,50,-24,23
Crusaders,6778,1,18,7,5,56,29,27,61
Cliftonville,6778,2,18,2,10,59,36,23,56
Linfield,6778,3,14,10,6,56,32,24,52
Ballymena,6778,4,15,3,12,54,58,-4,48
Dungannon,6778,5,10,9,11,49,46,3,39
Glenavon,6778,6,10,9,11,44,51,-7,39
Ards,6778,7,10,7,13,42,47,-5,37
Glentoran,6778,8,10,6,14,33,46,-13,36
Coleraine,6778,9,9,8,13,37,46,-9,35
Ballinamalla,6778,10,9,3,18,31,51,-20,30
Portadown,6778,11,8,4,18,27,46,-19,28
Crusaders,6779,1,17,10,3,52,25,27,61
Linfield,6779,2,15,9,6,57,28,29,54
Cliftonville,6779,3,16,4,10,50,40,10,52
Ballymena,6779,4,13,4,13,57,63,-6,43
Glenavon,6779,5,10,11,9,47,48,-1,41
Ards,6779,6,11,5,14,40,43,-3,38
Coleraine,6779,7,9,10,11,34,40,-6,37
Dungannon,6779,8,9,8,13,48,50,-2,35
Glentoran,6779,9,9,8,13,27,40,-13,35
Ballinamalla,6779,10,8,8,14,29,45,-16,32
Portadown,6779,11,8,3,19,22,41,-19,27
Crusaders,6780,1,17,8,5,55,28,27,59
Linfield,6780,2,15,9,6,66,34,32,54
Cliftonville,6780,3,16,3,11,55,44,11,51
Ballymena,6780,4,15,6,9,62,58,4,51
Glenavon,6780,5,10,11,9,43,47,-4,41
Coleraine,6780,6,9,12,9,41,42,-1,39
Dungannon,6780,7,9,11,10,51,46,5,38
Portadown,6780,8,9,6,15,31,41,-10,33
Ards,6780,9,9,4,17,38,49,-11,31
Glentoran,6780,10,7,8,15,32,56,-24,29
Ballinamalla,6780,11,8,4,18,26,55,-29,28
Crusaders,6781,1,20,6,4,60,33,27,66
Linfield,6781,2,17,8,5,64,28,36,59
Cliftonville,6781,3,15,7,8,50,36,14,52
Ballymena,6781,4,15,6,9,60,56,4,51
Dungannon,6781,5,10,10,10,46,39,7,40
Coleraine,6781,6,10,10,10,43,39,4,40
Ards,6781,7,8,8,14,34,45,-11,32
Glenavon,6781,8,8,8,14,38,54,-16,32
Glentoran,6781,9,7,8,15,28,48,-20,29
Ballinamalla,6781,10,8,4,18,30,53,-23,28
Portadown,6781,11,7,5,18,28,50,-22,26
Linfield,6782,1,18,7,5,64,25,39,61
Crusaders,6782,2,15,8,7,47,33,14,53
Cliftonville,6782,3,14,8,8,55,43,12,50
Ballymena,6782,4,13,8,9,50,53,-3,47
Coleraine,6782,5,11,12,7,42,36,6,45
Glenavon,6782,6,10,12,8,46,45,1,42
Glentoran,6782,7,10,7,13,29,37,-8,37
Dungannon,6782,8,8,9,13,48,51,-3,33
Portadown,6782,9,5,12,13,21,38,-17,27
Ballinamalla,6782,10,7,5,18,24,44,-20,26
Ards,6782,11,6,8,16,35,56,-21,26
Crusaders,6783,1,17,10,3,65,38,27,61
Linfield,6783,2,14,8,8,55,35,20,50
Coleraine,6783,3,13,11,6,49,38,11,50
Cliftonville,6783,4,13,9,8,56,39,17,48
Ballymena,6783,5,13,8,9,64,58,6,47
Dungannon,6783,6,9,11,10,52,49,3,38
Glenavon,6783,7,9,11,10,47,56,-9,38
Ards,6783,8,10,5,15,40,53,-13,35
Glentoran,6783,9,7,7,16,40,60,-20,28
Ballinamalla,6783,10,7,7,16,26,46,-20,28
Portadown,6783,11,7,5,18,30,52,-22,26
Linfield,6784,1,16,8,6,64,31,33,56
Ballymena,6784,2,17,5,8,67,53,14,56
Crusaders,6784,3,15,8,7,54,37,17,53
Coleraine,6784,4,12,12,6,42,36,6,48
Cliftonville,6784,5,14,5,11,46,36,10,47
Glenavon,6784,6,10,11,9,42,45,-3,41
Glentoran,6784,7,7,11,12,32,42,-10,32
Ballinamalla,6784,8,9,5,16,30,49,-19,32
Dungannon,6784,9,7,10,13,38,46,-8,31
Ards,6784,10,6,9,15,36,55,-19,27
Portadown,6784,11,6,8,16,21,42,-21,26
Linfield,6785,1,17,9,4,60,27,33,60
Crusaders,6785,2,16,8,6,52,33,19,56
Ballymena,6785,3,16,4,10,60,58,2,52
Cliftonville,6785,4,14,6,10,46,36,10,48
Glenavon,6785,5,12,9,9,45,38,7,45
Coleraine,6785,6,11,9,10,42,38,4,42
Glentoran,6785,7,10,8,12,30,37,-7,38
Dungannon,6785,8,8,11,11,49,52,-3,35
Ards,6785,9,8,4,18,31,49,-18,28
Portadown,6785,10,7,6,17,23,46,-23,27
Ballinamalla,6785,11,6,6,18,26,50,-24,24
Linfield,6786,1,13,12,5,62,34,28,51
Cliftonville,6786,2,15,6,9,50,39,11,51
Crusaders,6786,3,14,8,8,54,40,14,50
Coleraine,6786,4,13,11,6,45,33,12,50
Ballymena,6786,5,14,7,9,57,55,2,49
Glenavon,6786,6,11,11,8,46,46,0,44
Dungannon,6786,7,10,9,11,46,39,7,39
Ballinamalla,6786,8,9,7,14,36,52,-16,34
Glentoran,6786,9,7,7,16,28,46,-18,28
Ards,6786,10,7,6,17,35,52,-17,27
Portadown,6786,11,5,10,15,20,43,-23,25
Linfield,6787,1,16,11,3,56,22,34,59
Cliftonville,6787,2,17,4,9,56,40,16,55
Crusaders,6787,3,14,8,8,51,42,9,50
Coleraine,6787,4,13,10,7,49,38,11,49
Dungannon,6787,5,12,9,9,51,38,13,45
Ballymena,6787,6,12,6,12,54,56,-2,42
Glenavon,6787,7,10,11,9,46,47,-1,41
Ards,6787,8,9,6,15,38,46,-8,33
Glentoran,6787,9,7,10,13,29,44,-15,31
Ballinamalla,6787,10,6,5,19,30,53,-23,23
Portadown,6787,11,5,8,17,22,56,-34,23
Crusaders,6788,1,16,8,6,61,39,22,56
Cliftonville,6788,2,17,4,9,49,34,15,55
Linfield,6788,3,15,9,6,62,30,32,54
Ballymena,6788,4,15,5,10,57,53,4,50
Coleraine,6788,5,11,11,8,42,35,7,44
Dungannon,6788,6,9,12,9,58,50,8,39
Glenavon,6788,7,10,8,12,42,48,-6,38
Portadown,6788,8,10,6,14,26,43,-17,36
Ballinamalla,6788,9,9,4,17,32,52,-20,31
Ards,6788,10,8,4,18,37,54,-17,28
Glentoran,6788,11,6,7,17,23,51,-28,25
Crusaders,6789,1,19,8,3,65,32,33,65
Linfield,6789,2,13,12,5,63,35,28,51
Ballymena,6789,3,14,7,9,66,59,7,49
Glenavon,6789,4,11,10,9,49,43,6,43
Cliftonville,6789,5,12,7,11,55,51,4,43
Dungannon,6789,6,10,9,11,52,47,5,39
Coleraine,6789,7,8,13,9,41,43,-2,37
Ballinamalla,6789,8,9,4,17,35,58,-23,31
Glentoran,6789,9,7,10,13,26,55,-29,31
Ards,6789,10,8,6,16,38,51,-13,30
Portadown,6789,11,8,6,16,32,48,-16,30
Ballymena,6790,1,17,6,7,58,49,9,57
Cliftonville,6790,2,16,5,9,57,34,23,53
Crusaders,6790,3,15,7,8,53,36,17,52
Coleraine,6790,4,12,12,6,41,32,9,48
Glenavon,6790,5,9,13,8,47,49,-2,40
Ards,6790,6,12,3,15,41,52,-11,39
Linfield,6790,7,10,8,12,51,42,9,38
Dungannon,6790,8,8,11,11,48,49,-1,35
Glentoran,6790,9,9,8,13,41,47,-6,35
Ballinamalla,6790,10,9,5,16,30,53,-23,32
Portadown,6790,11,6,6,18,27,51,-24,24
Linfield,6791,1,15,8,7,57,32,25,53
Crusaders,6791,2,15,8,7,55,40,15,53
Coleraine,6791,3,13,11,6,50,33,17,50
Cliftonville,6791,4,13,7,10,54,48,6,46
Ards,6791,5,12,6,12,41,42,-1,42
Ballymena,6791,6,10,10,10,58,69,-11,40
Glenavon,6791,7,10,8,12,45,50,-5,38
Dungannon,6791,8,10,7,13,52,54,-2,37
Glentoran,6791,9,9,7,14,35,46,-11,34
Portadown,6791,10,9,4,17,31,48,-17,31
Ballinamalla,6791,11,7,8,15,36,52,-16,29
Linfield,6792,1,17,9,4,59,26,33,60
Crusaders,6792,2,17,7,6,59,38,21,58
Cliftonville,6792,3,14,6,10,61,44,17,48
Glenavon,6792,4,12,9,9,45,47,-2,45
Coleraine,6792,5,11,10,9,41,36,5,43
Ballymena,6792,6,12,6,12,52,65,-13,42
Ballinamalla,6792,7,12,2,16,34,44,-10,38
Glentoran,6792,8,9,9,12,30,40,-10,36
Dungannon,6792,9,6,11,13,50,51,-1,29
Ards,6792,10,8,5,17,31,50,-19,29
Portadown,6792,11,7,6,17,27,48,-21,27
Crusaders,6793,1,18,7,5,62,29,33,61
Linfield,6793,2,16,8,6,60,31,29,56
Cliftonville,6793,3,15,5,10,47,36,11,50
Ballymena,6793,4,14,5,11,59,65,-6,47
Dungannon,6793,5,12,9,9,50,42,8,45
Coleraine,6793,6,11,8,11,40,42,-2,41
Glentoran,6793,7,11,8,11,34,41,-7,41
Glenavon,6793,8,8,12,10,36,44,-8,36
Ards,6793,9,8,4,18,34,54,-20,28
Ballinamalla,6793,10,8,3,19,35,52,-17,27
Portadown,6793,11,8,3,19,27,48,-21,27
Crusaders,6794,1,17,7,6,55,34,21,58
Cliftonville,6794,2,17,6,7,63,35,28,57
Ballymena,6794,3,18,3,9,59,54,5,57
Linfield,6794,4,15,9,6,65,34,31,54
Glenavon,6794,5,12,12,6,50,42,8,48
Dungannon,6794,6,11,8,11,48,42,6,41
Coleraine,6794,7,10,8,12,41,51,-10,38
Ards,6794,8,9,6,15,36,47,-11,33
Ballinamalla,6794,9,8,4,18,21,47,-26,28
Glentoran,6794,10,5,7,18,24,50,-26,22
Portadown,6794,11,6,4,20,23,49,-26,22
Crusaders,6795,1,15,11,4,56,33,23,56
Cliftonville,6795,2,16,5,9,57,38,19,53
Linfield,6795,3,14,9,7,56,33,23,51
Ballymena,6795,4,15,6,9,58,55,3,51
Coleraine,6795,5,13,10,7,51,41,10,49
Glenavon,6795,6,10,12,8,52,51,1,42
Dungannon,6795,7,8,12,10,48,43,5,36
Glentoran,6795,8,9,7,14,34,46,-12,34
Ballinamalla,6795,9,8,7,15,37,54,-17,31
Portadown,6795,10,7,4,19,30,55,-25,25
Ards,6795,11,6,5,19,39,69,-30,23
Linfield,6796,1,16,10,4,62,29,33,58
Cliftonville,6796,2,14,7,9,57,42,15,49
Crusaders,6796,3,12,12,6,53,40,13,48
Coleraine,6796,4,11,13,6,35,29,6,46
Glenavon,6796,5,11,13,6,54,49,5,46
Ballymena,6796,6,12,7,11,53,57,-4,43
Dungannon,6796,7,8,12,10,43,40,3,36
Glentoran,6796,8,8,11,11,34,42,-8,35
Portadown,6796,9,7,9,14,34,46,-12,30
Ballinamalla,6796,10,6,8,16,28,55,-27,26
Ards,6796,11,7,4,19,30,54,-24,25
Cliftonville,6797,1,19,5,6,67,43,24,62
Linfield,6797,2,16,9,5,67,37,30,57
Crusaders,6797,3,14,9,7,55,39,16,51
Ballymena,6797,4,14,8,8,65,60,5,50
Glenavon,6797,5,11,9,10,49,50,-1,42
Coleraine,6797,6,10,10,10,51,50,1,40
Dungannon,6797,7,9,9,12,49,46,3,36
Ballinamalla,6797,8,9,7,14,36,47,-11,34
Glentoran,6797,9,8,10,12,32,46,-14,34
Ards,6797,10,6,8,16,33,54,-21,26
Portadown,6797,11,4,6,20,23,55,-32,18
Ballymena,6798,1,17,6,7,71,53,18,57
Linfield,6798,2,13,13,4,57,32,25,52
Crusaders,6798,3,14,9,7,54,38,16,51
Cliftonville,6798,4,15,4,11,52,40,12,49
Coleraine,6798,5,12,11,7,42,36,6,47
Glenavon,6798,6,11,13,6,46,38,8,46
Glentoran,6798,7,9,9,12,29,42,-13,36
Dungannon,6798,8,7,11,12,47,51,-4,32
Portadown,6798,9,6,10,14,26,46,-20,28
Ards,6798,10,6,6,18,29,50,-21,24
Ballinamalla,6798,11,5,8,17,29,56,-27,23
Crusaders,6799,1,18,7,5,59,39,20,61
Cliftonville,6799,2,16,5,9,63,37,26,53
Ballymena,6799,3,14,10,6,58,51,7,52
Linfield,6799,4,11,11,8,48,33,15,44
Dungannon,6799,5,11,11,8,51,41,10,44
Coleraine,6799,6,10,9,11,43,41,2,39
Glenavon,6799,7,9,10,11,47,50,-3,37
Glentoran,6799,8,9,10,11,37,50,-13,37
Ards,6799,9,8,8,14,44,50,-6,32
Ballinamalla,6799,10,7,7,16,31,54,-23,28
Portadown,6799,11,5,6,19,24,59,-35,21
Linfield,6800,1,14,11,5,65,35,30,53
Crusaders,6800,2,15,7,8,52,37,15,52
Ballymena,6800,3,14,5,11,58,61,-3,47
Cliftonville,6800,4,13,7,10,53,41,12,46
Coleraine,6800,5,9,15,6,37,34,3,42
Ards,6800,6,11,6,13,40,39,1,39
Glenavon,6800,7,9,10,11,40,46,-6,37
Portadown,6800,8,10,6,14,28,43,-15,36
Dungannon,6800,9,8,10,12,43,45,-2,34
Glentoran,6800,10,7,10,13,28,45,-17,31
Ballinamalla,6800,11,8,7,15,27,45,-18,31
Crusaders,6801,1,17,7,6,58,35,23,58
Linfield,6801,2,15,11,4,61,34,27,56
Ballymena,6801,3,17,5,8,61,48,13,56
Cliftonville,6801,4,17,4,9,53,42,11,55
Glenavon,6801,5,13,8,9,50,47,3,47
Coleraine,6801,6,12,9,9,49,44,5,45
Dungannon,6801,7,8,10,12,48,48,0,34
Ballinamalla,6801,8,9,4,17,38,55,-17,31
Glentoran,6801,9,6,10,14,27,50,-23,28
Ards,6801,10,7,5,18,45,62,-17,26
Portadown,6801,11,6,3,21,26,51,-25,21
Crusaders,6802,1,17,7,6,54,30,24,58
Linfield,6802,2,16,9,5,52,24,28,57
Ballymena,6802,3,15,5,10,55,58,-3,50
Cliftonville,6802,4,13,6,11,43,36,7,45
Dungannon,6802,5,12,8,10,48,36,12,44
Coleraine,6802,6,12,8,10,42,32,10,44
Glenavon,6802,7,8,15,7,48,48,0,39
Ards,6802,8,10,4,16,36,56,-20,34
Glentoran,6802,9,8,8,14,28,43,-15,32
Portadown,6802,10,7,6,17,21,41,-20,27
Ballinamalla,6802,11,8,2,20,24,47,-23,26
Crusaders,6803,1,19,6,5,75,39,36,63
Coleraine,6803,2,13,10,7,45,33,12,49
Glenavon,6803,3,13,10,7,45,39,6,49
Cliftonville,6803,4,15,3,12,50,37,13,48
Linfield,6803,5,12,9,9,56,39,17,45
Ards,6803,6,12,6,12,47,47,0,42
Ballymena,6803,7,12,6,12,58,65,-7,42
Portadown,6803,8,10,5,15,29,46,-17,35
Dungannon,6803,9,8,10,12,49,50,-1,34
Glentoran,6803,10,6,8,16,28,57,-29,26
Ballinamalla,6803,11,6,5,19,28,58,-30,23
Crusaders,6804,1,16,8,6,53,30,23,56
Cliftonville,6804,2,16,5,9,52,33,19,53
Glenavon,6804,3,13,11,6,53,42,11,50
Ballymena,6804,4,15,4,11,58,64,-6,49
Linfield,6804,5,13,9,8,54,35,19,48
Coleraine,6804,6,11,11,8,46,40,6,44
Dungannon,6804,7,9,8,13,48,52,-4,35
Glentoran,6804,8,9,7,14,31,45,-14,34
Ards,6804,9,7,8,15,42,56,-14,29
Portadown,6804,10,8,5,17,32,49,-17,29
Ballinamalla,6804,11,7,6,17,24,47,-23,27
Linfield,6805,1,16,10,4,60,30,30,58
Crusaders,6805,2,17,6,7,53,31,22,57
Coleraine,6805,3,16,9,5,45,27,18,57
Cliftonville,6805,4,16,4,10,44,33,11,52
Ballymena,6805,5,13,7,10,58,57,1,46
Dungannon,6805,6,10,8,12,47,47,0,38
Glenavon,6805,7,7,13,10,44,49,-5,34
Ards,6805,8,9,6,15,35,52,-17,33
Ballinamalla,6805,9,8,7,15,31,47,-16,31
Portadown,6805,10,7,4,19,26,43,-17,25
Glentoran,6805,11,5,8,17,25,52,-27,23
Linfield,6806,1,16,9,5,55,25,30,57
Cliftonville,6806,2,17,3,10,54,39,15,54
Glenavon,6806,3,14,10,6,47,37,10,52
Crusaders,6806,4,14,7,9,45,36,9,49
Ballymena,6806,5,14,7,9,58,59,-1,49
Coleraine,6806,6,10,12,8,40,40,0,42
Dungannon,6806,7,9,9,12,46,37,9,36
Ards,6806,8,10,6,14,39,43,-4,36
Glentoran,6806,9,6,10,14,23,40,-17,28
Ballinamalla,6806,10,6,8,16,24,51,-27,26
Portadown,6806,11,6,5,19,20,44,-24,23
Crusaders,6807,1,16,10,4,59,30,29,58
Cliftonville,6807,2,17,3,10,59,42,17,54
Ballymena,6807,3,15,7,8,58,54,4,52
Coleraine,6807,4,12,11,7,41,34,7,47
Linfield,6807,5,12,9,9,60,41,19,45
Glenavon,6807,6,9,15,6,53,53,0,42
Dungannon,6807,7,11,8,11,54,46,8,41
Ballinamalla,6807,8,10,3,17,30,52,-22,33
Ards,6807,9,8,6,16,38,52,-14,30
Portadown,6807,10,8,4,18,26,52,-26,28
Glentoran,6807,11,6,6,18,30,52,-22,24
Crusaders,6808,1,16,8,6,57,35,22,56
Linfield,6808,2,13,9,8,56,34,22,48
Ballymena,6808,3,13,8,9,57,51,6,47
Glentoran,6808,4,13,6,11,43,47,-4,45
Dungannon,6808,5,11,9,10,54,48,6,42
Cliftonville,6808,6,12,6,12,46,43,3,42
Glenavon,6808,7,10,11,9,46,50,-4,41
Coleraine,6808,8,9,9,12,42,43,-1,36
Ards,6808,9,10,4,16,36,53,-17,34
Portadown,6808,10,8,8,14,30,41,-11,32
Ballinamalla,6808,11,10,2,18,29,51,-22,32
Crusaders,6809,1,18,6,6,59,28,31,60
Cliftonville,6809,2,16,5,9,47,34,13,53
Linfield,6809,3,14,10,6,60,32,28,52
Glenavon,6809,4,14,9,7,46,39,7,51
Dungannon,6809,5,12,9,9,53,38,15,45
Ards,6809,6,11,6,13,39,42,-3,39
Ballymena,6809,7,11,6,13,55,64,-9,39
Coleraine,6809,8,8,11,11,36,43,-7,35
Ballinamalla,6809,9,9,4,17,29,56,-27,31
Glentoran,6809,10,6,8,16,22,44,-22,26
Portadown,6809,11,5,8,17,20,46,-26,23
Ballymena,6810,1,16,5,9,67,55,12,53
Crusaders,6810,2,14,9,7,52,29,23,51
Cliftonville,6810,3,16,3,11,51,44,7,51
Linfield,6810,4,13,11,6,65,38,27,50
Glenavon,6810,5,11,11,8,45,46,-1,44
Coleraine,6810,6,10,10,10,43,45,-2,40
Ards,6810,7,11,6,13,45,48,-3,39
Ballinamalla,6810,8,10,7,13,32,47,-15,37
Glentoran,6810,9,10,7,13,30,47,-17,37
Dungannon,6810,10,5,11,14,40,50,-10,26
Portadown,6810,11,4,10,16,25,46,-21,22
Crusaders,6811,1,16,9,5,56,37,19,57
Linfield,6811,2,15,8,7,56,30,26,53
Glenavon,6811,3,13,10,7,59,48,11,49
Ballymena,6811,4,13,9,8,66,62,4,48
Cliftonville,6811,5,14,5,11,55,43,12,47
Coleraine,6811,6,12,9,9,50,44,6,45
Dungannon,6811,7,12,8,10,52,43,9,44
Glentoran,6811,8,9,7,14,34,50,-16,34
Ballinamalla,6811,9,9,5,16,35,55,-20,32
Ards,6811,10,7,5,18,34,53,-19,26
Portadown,6811,11,5,5,20,22,54,-32,20
Ballymena,6812,1,17,6,7,62,56,6,57
Linfield,6812,2,15,8,7,62,35,27,53
Crusaders,6812,3,15,7,8,48,35,13,52
Coleraine,6812,4,11,13,6,51,37,14,46
Cliftonville,6812,5,12,8,10,48,42,6,44
Glenavon,6812,6,9,14,7,47,45,2,41
Dungannon,6812,7,8,11,11,39,37,2,35
Ards,6812,8,8,8,14,38,50,-12,32
Ballinamalla,6812,9,8,6,16,34,51,-17,30
Portadown,6812,10,8,6,16,30,53,-23,30
Glentoran,6812,11,6,9,15,36,54,-18,27
Cliftonville,6813,1,17,7,6,56,31,25,58
Crusaders,6813,2,14,7,9,55,41,14,49
Linfield,6813,3,12,10,8,50,35,15,46
Ballymena,6813,4,13,7,10,59,54,5,46
Glenavon,6813,5,10,12,8,46,42,4,42
Glentoran,6813,6,11,8,11,37,45,-8,41
Coleraine,6813,7,10,10,10,42,43,-1,40
Dungannon,6813,8,10,8,12,51,47,4,38
Portadown,6813,9,9,7,14,24,38,-14,34
Ards,6813,10,9,5,16,32,45,-13,32
Ballinamalla,6813,11,6,7,17,28,59,-31,25
Linfield,6814,1,17,7,6,65,31,34,58
Cliftonville,6814,2,16,5,9,49,37,12,53
Crusaders,6814,3,13,8,9,52,37,15,47
Ballymena,6814,4,14,4,12,58,56,2,46
Glenavon,6814,5,12,10,8,50,49,1,46
Coleraine,6814,6,12,8,10,44,43,1,44
Dungannon,6814,7,8,12,10,52,48,4,36
Glentoran,6814,8,9,6,15,37,54,-17,33
Portadown,6814,9,8,8,14,25,40,-15,32
Ballinamalla,6814,10,9,5,16,31,54,-23,32
Ards,6814,11,8,5,17,40,54,-14,29
Crusaders,6815,1,15,9,6,66,42,24,54
Cliftonville,6815,2,16,6,8,58,38,20,54
Glenavon,6815,3,12,13,5,52,44,8,49
Linfield,6815,4,11,12,7,53,33,20,45
Ballymena,6815,5,13,6,11,58,59,-1,45
Coleraine,6815,6,11,9,10,42,42,0,42
Dungannon,6815,7,10,9,11,47,41,6,39
Glentoran,6815,8,9,9,12,28,40,-12,36
Portadown,6815,9,9,5,16,25,44,-19,32
Ards,6815,10,7,7,16,36,54,-18,28
Ballinamalla,6815,11,7,5,18,27,55,-28,26
Crusaders,6816,1,17,7,6,56,30,26,58
Cliftonville,6816,2,15,3,12,54,39,15,48
Dungannon,6816,3,13,8,9,53,39,14,47
Ballymena,6816,4,14,5,11,51,56,-5,47
Linfield,6816,5,12,9,9,60,39,21,45
Coleraine,6816,6,12,9,9,41,39,2,45
Glenavon,6816,7,11,11,8,48,46,2,44
Ards,6816,8,10,5,15,37,51,-14,35
Glentoran,6816,9,8,7,15,32,48,-16,31
Ballinamalla,6816,10,9,4,17,32,55,-23,31
Portadown,6816,11,6,8,16,33,55,-22,26
Crusaders,6817,1,18,7,5,58,32,26,61
Cliftonville,6817,2,17,4,9,55,35,20,55
Glenavon,6817,3,15,9,6,54,40,14,54
Linfield,6817,4,14,9,7,59,30,29,51
Coleraine,6817,5,10,11,9,37,36,1,41
Dungannon,6817,6,10,10,10,56,49,7,40
Ballymena,6817,7,11,6,13,50,64,-14,39
Ballinamalla,6817,8,8,7,15,34,54,-20,31
Ards,6817,9,7,6,17,32,51,-19,27
Portadown,6817,10,7,6,17,19,43,-24,27
Glentoran,6817,11,5,11,14,27,47,-20,26
Ballymena,6818,1,16,7,7,60,50,10,55
Cliftonville,6818,2,17,3,10,58,32,26,54
Crusaders,6818,3,15,9,6,56,44,12,54
Linfield,6818,4,14,11,5,55,27,28,53
Glenavon,6818,5,11,11,8,43,41,2,44
Coleraine,6818,6,9,13,8,36,34,2,40
Dungannon,6818,7,9,9,12,50,52,-2,36
Ards,6818,8,9,7,14,32,41,-9,34
Glentoran,6818,9,7,9,14,29,47,-18,30
Ballinamalla,6818,10,7,6,17,30,53,-23,27
Portadown,6818,11,5,7,18,22,50,-28,22
Crusaders,6819,1,17,7,6,59,33,26,58
Cliftonville,6819,2,18,4,8,58,38,20,58
Linfield,6819,3,13,13,4,58,34,24,52
Ballymena,6819,4,15,4,11,61,61,0,49
Coleraine,6819,5,12,10,8,39,29,10,46
Dungannon,6819,6,10,7,13,47,46,1,37
Glenavon,6819,7,8,12,10,40,47,-7,36
Ards,6819,8,11,3,16,40,52,-12,36
Portadown,6819,9,9,2,19,33,52,-19,29
Ballinamalla,6819,10,8,5,17,29,52,-23,29
Glentoran,6819,11,6,9,15,23,43,-20,27
Crusaders,6820,1,16,7,7,60,30,30,55
Linfield,6820,2,15,10,5,63,34,29,55
Cliftonville,6820,3,14,8,8,54,41,13,50
Glenavon,6820,4,12,10,8,46,50,-4,46
Ballymena,6820,5,13,6,11,62,64,-2,45
Coleraine,6820,6,11,10,9,46,41,5,43
Dungannon,6820,7,11,8,11,53,44,9,41
Glentoran,6820,8,9,8,13,36,43,-7,35
Ards,6820,9,8,6,16,31,54,-23,30
Ballinamalla,6820,10,7,6,17,28,48,-20,27
Portadown,6820,11,6,7,17,22,52,-30,25
Crusaders,6821,1,18,6,6,52,30,22,60
Cliftonville,6821,2,17,3,10,55,39,16,54
Linfield,6821,3,14,11,5,55,25,30,53
Ballymena,6821,4,15,5,10,60,54,6,50
Glenavon,6821,5,10,11,9,41,42,-1,41
Coleraine,6821,6,10,10,10,44,45,-1,40
Dungannon,6821,7,9,10,11,50,45,5,37
Ards,6821,8,9,5,16,38,53,-15,32
Glentoran,6821,9,8,8,14,23,40,-17,32
Portadown,6821,10,8,7,15,29,49,-20,31
Ballinamalla,6821,11,5,8,17,25,50,-25,23
Crusaders,6822,1,17,6,7,69,41,28,57
Cliftonville,6822,2,17,5,8,47,34,13,56
Linfield,6822,3,14,8,8,58,36,22,50
Glenavon,6822,4,11,9,10,48,45,3,42
Ballymena,6822,5,11,9,10,50,53,-3,42
Coleraine,6822,6,10,11,9,42,38,4,41
Dungannon,6822,7,10,8,12,51,47,4,38
Ards,6822,8,11,4,15,39,44,-5,37
Portadown,6822,9,11,3,16,25,46,-21,36
Ballinamalla,6822,10,9,4,17,31,56,-25,31
Glentoran,6822,11,8,5,17,30,50,-20,29
Crusaders,6823,1,16,8,6,57,35,22,56
Cliftonville,6823,2,16,5,9,52,36,16,53
Linfield,6823,3,13,12,5,56,35,21,51
Coleraine,6823,4,12,13,5,46,38,8,49
Dungannon,6823,5,11,9,10,51,45,6,42
Ballymena,6823,6,11,7,12,51,58,-7,40
Glenavon,6823,7,8,15,7,43,42,1,39
Ards,6823,8,8,7,15,39,49,-10,31
Ballinamalla,6823,9,8,5,17,26,50,-24,29
Glentoran,6823,10,6,10,14,25,41,-16,28
Portadown,6823,11,7,7,16,25,42,-17,28
Linfield,6824,1,17,7,6,56,25,31,58
Cliftonville,6824,2,17,3,10,57,40,17,54
Crusaders,6824,3,14,8,8,56,37,19,50
Ballymena,6824,4,14,7,9,55,51,4,49
Glenavon,6824,5,12,11,7,41,40,1,47
Coleraine,6824,6,12,10,8,44,37,7,46
Glentoran,6824,7,10,7,13,34,48,-14,37
Dungannon,6824,8,7,11,12,43,47,-4,32
Ards,6824,9,9,5,16,37,48,-11,32
Portadown,6824,10,5,9,16,18,42,-24,24
Ballinamalla,6824,11,5,8,17,29,55,-26,23
Glenavon,6825,1,15,9,6,56,41,15,54
Cliftonville,6825,2,16,5,9,57,37,20,53
Linfield,6825,3,14,10,6,57,32,25,52
Ballymena,6825,4,16,4,10,64,62,2,52
Crusaders,6825,5,13,7,10,45,38,7,46
Coleraine,6825,6,11,11,8,50,43,7,44
Glentoran,6825,7,13,5,12,35,36,-1,44
Dungannon,6825,8,8,10,12,46,47,-1,34
Ards,6825,9,9,6,15,37,49,-12,33
Ballinamalla,6825,10,6,6,18,27,52,-25,24
Portadown,6825,11,5,5,20,20,57,-37,20
Crusaders,6826,1,15,11,4,56,33,23,56
Ballymena,6826,2,16,5,9,60,56,4,53
Cliftonville,6826,3,15,4,11,54,40,14,49
Coleraine,6826,4,13,9,8,47,40,7,48
Dungannon,6826,5,12,11,7,52,37,15,47
Linfield,6826,6,12,8,10,60,36,24,44
Glenavon,6826,7,8,12,10,41,49,-8,36
Ards,6826,8,10,2,18,37,55,-18,32
Portadown,6826,9,9,5,16,26,44,-18,32
Glentoran,6826,10,8,7,15,30,50,-20,31
Ballinamalla,6826,11,8,4,18,34,57,-23,28
Linfield,6827,1,16,9,5,59,24,35,57
Crusaders,6827,2,16,7,7,52,33,19,55
Ballymena,6827,3,15,7,8,57,47,10,52
Glenavon,6827,4,13,12,5,52,38,14,51
Cliftonville,6827,5,15,4,11,52,51,1,49
Coleraine,6827,6,13,8,9,43,34,9,47
Ards,6827,7,10,8,12,40,43,-3,38
Dungannon,6827,8,7,11,12,47,51,-4,32
Portadown,6827,9,6,8,16,29,46,-17,26
Glentoran,6827,10,5,8,17,23,54,-31,23
Ballinamalla,6827,11,6,4,20,25,58,-33,22
Crusaders,6828,1,16,9,5,57,33,24,57
Linfield,6828,2,14,9,7,60,37,23,51
Ballymena,6828,3,13,7,10,58,58,0,46
Cliftonville,6828,4,14,3,13,55,43,12,45
Coleraine,6828,5,11,11,8,47,42,5,44
Glenavon,6828,6,9,13,8,49,50,-1,40
Dungannon,6828,7,10,8,12,49,50,-1,38
Ballinamalla,6828,8,11,4,15,30,47,-17,37
Glentoran,6828,9,9,9,12,37,47,-10,36
Portadown,6828,10,8,6,16,30,46,-16,30
Ards,6828,11,6,9,15,32,51,-19,27
Cliftonville,6829,1,18,4,8,60,37,23,58
Crusaders,6829,2,17,4,9,54,31,23,55
Linfield,6829,3,15,8,7,60,33,27,53
Glenavon,6829,4,12,11,7,48,41,7,47
Coleraine,6829,5,11,12,7,39,30,9,45
Ballymena,6829,6,12,7,11,59,63,-4,43
Ballinamalla,6829,7,11,3,16,42,51,-9,36
Glentoran,6829,8,9,7,14,28,47,-19,34
Portadown,6829,9,10,3,17,29,54,-25,33
Dungannon,6829,10,7,9,14,42,50,-8,30
Ards,6829,11,5,8,17,28,52,-24,23
Cliftonville,6830,1,19,2,9,58,33,25,59
Crusaders,6830,2,15,6,9,54,38,16,51
Linfield,6830,3,12,11,7,65,38,27,47
Glenavon,6830,4,10,13,7,47,43,4,43
Coleraine,6830,5,10,12,8,37,42,-5,42
Ards,6830,6,11,6,13,47,51,-4,39
Dungannon,6830,7,10,8,12,58,50,8,38
Ballymena,6830,8,10,7,13,52,67,-15,37
Glentoran,6830,9,9,8,13,35,46,-11,35
Portadown,6830,10,10,4,16,28,47,-19,34
Ballinamalla,6830,11,8,5,17,30,56,-26,29
Crusaders,6831,1,16,8,6,57,35,22,56
Linfield,6831,2,14,9,7,56,37,19,51
Cliftonville,6831,3,16,3,11,56,41,15,51
Ballymena,6831,4,13,8,9,57,58,-1,47
Coleraine,6831,5,11,10,9,46,41,5,43
Glenavon,6831,6,9,12,9,37,43,-6,39
Ards,6831,7,11,5,14,42,48,-6,38
Dungannon,6831,8,8,12,10,51,45,6,36
Glentoran,6831,9,10,6,14,37,47,-10,36
Ballinamalla,6831,10,10,3,17,36,56,-20,33
Portadown,6831,11,6,6,18,24,48,-24,24
Cliftonville,6832,1,19,4,7,61,37,24,61
Crusaders,6832,2,16,4,10,56,40,16,52
Linfield,6832,3,14,9,7,61,33,28,51
Ballymena,6832,4,14,7,9,59,51,8,49
Glenavon,6832,5,11,12,7,46,45,1,45
Coleraine,6832,6,12,8,10,37,41,-4,44
Dungannon,6832,7,11,7,12,49,45,4,40
Glentoran,6832,8,10,6,14,33,45,-12,36
Ards,6832,9,10,5,15,39,51,-12,35
Portadown,6832,10,6,6,18,28,53,-25,24
Ballinamalla,6832,11,5,6,19,27,55,-28,21
Linfield,6833,1,15,9,6,62,38,24,54
Crusaders,6833,2,14,11,5,55,33,22,53
Ballymena,6833,3,16,5,9,67,61,6,53
Cliftonville,6833,4,15,6,9,58,42,16,51
Coleraine,6833,5,12,8,10,45,43,2,44
Glenavon,6833,6,9,11,10,41,47,-6,38
Ards,6833,7,10,7,13,48,46,2,37
Dungannon,6833,8,9,9,12,47,49,-2,36
Glentoran,6833,9,8,9,13,33,49,-16,33
Portadown,6833,10,7,7,16,27,52,-25,28
Ballinamalla,6833,11,6,6,18,28,51,-23,24
Crusaders,6834,1,16,6,8,52,38,14,54
Linfield,6834,2,14,11,5,64,41,23,53
Glenavon,6834,3,14,11,5,53,40,13,53
Cliftonville,6834,4,16,4,10,53,41,12,52
Ballymena,6834,5,13,10,7,53,49,4,49
Dungannon,6834,6,10,10,10,48,41,7,40
Coleraine,6834,7,9,11,10,39,36,3,38
Glentoran,6834,8,8,9,13,31,45,-14,33
Ards,6834,9,6,8,16,32,50,-18,26
Portadown,6834,10,6,7,17,27,49,-22,25
Ballinamalla,6834,11,5,9,16,30,52,-22,24
Crusaders,6835,1,15,9,6,55,39,16,54
Ballymena,6835,2,16,6,8,61,50,11,54
Linfield,6835,3,15,8,7,63,33,30,53
Cliftonville,6835,4,14,5,11,45,38,7,47
Dungannon,6835,5,12,9,9,55,43,12,45
Glenavon,6835,6,10,12,8,51,49,2,42
Coleraine,6835,7,10,10,10,41,40,1,40
Glentoran,6835,8,11,4,15,34,47,-13,37
Ballinamalla,6835,9,9,4,17,28,49,-21,31
Portadown,6835,10,8,5,17,26,50,-24,29
Ards,6835,11,6,6,18,32,53,-21,24
Crusaders,6836,1,17,6,7,55,34,21,57
Ballymena,6836,2,14,7,9,58,55,3,49
Linfield,6836,3,12,12,6,60,35,25,48
Coleraine,6836,4,12,11,7,37,32,5,47
Cliftonville,6836,5,13,7,10,46,43,3,46
Glenavon,6836,6,12,9,9,54,44,10,45
Ards,6836,7,9,8,13,35,41,-6,35
Glentoran,6836,8,9,7,14,30,42,-12,34
Dungannon,6836,9,7,12,11,44,43,1,33
Ballinamalla,6836,10,8,6,16,33,53,-20,30
Portadown,6836,11,6,7,17,33,63,-30,25
Crusaders,6837,1,16,7,7,57,34,23,55
Coleraine,6837,2,15,10,5,46,32,14,55
Linfield,6837,3,15,8,7,58,35,23,53
Glenavon,6837,4,12,10,8,52,45,7,46
Cliftonville,6837,5,13,6,11,54,44,10,45
Ballymena,6837,6,11,8,11,52,63,-11,41
Glentoran,6837,7,10,5,15,32,46,-14,35
Dungannon,6837,8,8,10,12,50,53,-3,34
Ards,6837,9,9,7,14,39,46,-7,34
Ballinamalla,6837,10,8,7,15,29,48,-19,31
Portadown,6837,11,7,4,19,23,46,-23,25
Ballymena,6838,1,16,7,7,65,54,11,55
Cliftonville,6838,2,16,3,11,58,46,12,51
Crusaders,6838,2,15,6,9,58,46,12,51
Linfield,6838,4,13,10,7,55,33,22,49
Dungannon,6838,5,13,6,11,61,48,13,45
Glenavon,6838,6,11,11,8,46,43,3,44
Coleraine,6838,7,10,11,9,45,40,5,41
Glentoran,6838,8,8,7,15,30,46,-16,31
Portadown,6838,9,9,4,17,24,45,-21,31
Ballinamalla,6838,10,9,4,17,28,52,-24,31
Ards,6838,11,7,7,16,32,49,-17,28
Glenavon,6839,1,16,10,4,53,32,21,58
Cliftonville,6839,2,18,3,9,53,37,16,57
Crusaders,6839,3,16,7,7,55,39,16,55
Ballymena,6839,4,16,5,9,61,56,5,53
Linfield,6839,5,11,15,4,61,29,32,48
Dungannon,6839,6,10,9,11,50,46,4,39
Coleraine,6839,7,10,9,11,39,42,-3,39
Ards,6839,8,8,6,16,35,49,-14,30
Ballinamalla,6839,9,9,2,19,34,56,-22,29
Glentoran,6839,10,7,6,17,24,53,-29,27
Portadown,6839,11,5,6,19,21,47,-26,21
Crusaders,6840,1,16,8,6,58,32,26,56
Cliftonville,6840,2,16,6,8,59,43,16,54
Glenavon,6840,3,12,13,5,47,38,9,49
Ballymena,6840,4,14,6,10,57,58,-1,48
Linfield,6840,5,12,10,8,52,29,23,46
Ards,6840,6,10,7,13,40,45,-5,37
Coleraine,6840,7,8,12,10,44,51,-7,36
Portadown,6840,8,9,8,13,29,40,-11,35
Dungannon,6840,9,9,7,14,45,48,-3,34
Glentoran,6840,10,8,9,13,28,47,-19,33
Ballinamalla,6840,11,6,4,20,27,55,-28,22
Coleraine,6841,1,13,10,7,49,40,9,49
Crusaders,6841,2,13,8,9,57,39,18,47
Dungannon,6841,3,13,8,9,53,35,18,47
Ballymena,6841,4,14,5,11,55,57,-2,47
Linfield,6841,5,12,10,8,58,39,19,46
Glenavon,6841,6,11,10,9,45,46,-1,43
Cliftonville,6841,7,12,5,13,49,48,1,41
Ards,6841,8,10,8,12,39,46,-7,38
Ballinamalla,6841,9,10,4,16,32,50,-18,34
Glentoran,6841,10,8,9,13,34,49,-15,33
Portadown,6841,11,8,5,17,21,43,-22,29
Linfield,6842,1,16,9,5,61,28,33,57
Crusaders,6842,2,15,8,7,49,33,16,53
Cliftonville,6842,3,15,6,9,51,34,17,51
Coleraine,6842,4,13,10,7,48,40,8,49
Glenavon,6842,5,11,12,7,45,43,2,45
Ballymena,6842,6,13,6,11,61,64,-3,45
Dungannon,6842,7,10,9,11,46,44,2,39
Ards,6842,8,9,6,15,33,47,-14,33
Glentoran,6842,9,8,7,15,30,47,-17,31
Portadown,6842,10,5,9,16,24,46,-22,24
Ballinamalla,6842,11,4,10,16,26,48,-22,22
Crusaders,6843,1,19,5,6,64,30,34,62
Linfield,6843,2,17,10,3,65,27,38,61
Dungannon,6843,3,12,9,9,48,38,10,45
Cliftonville,6843,4,14,3,13,49,45,4,45
Ballymena,6843,5,12,9,9,58,59,-1,45
Coleraine,6843,6,9,14,7,39,37,2,41
Glenavon,6843,7,8,12,10,43,50,-7,36
Glentoran,6843,8,9,9,12,31,42,-11,36
Portadown,6843,9,8,6,16,28,53,-25,30
Ballinamalla,6843,10,7,6,17,31,57,-26,27
Ards,6843,11,6,5,19,35,53,-18,23
Linfield,6844,1,16,9,5,70,37,33,57
Glenavon,6844,2,15,10,5,61,42,19,55
Crusaders,6844,3,15,8,7,54,39,15,53
Cliftonville,6844,4,15,6,9,53,40,13,51
Ballymena,6844,5,15,4,11,61,57,4,49
Dungannon,6844,6,10,8,12,48,47,1,38
Coleraine,6844,7,9,11,10,36,40,-4,38
Ards,6844,8,10,6,14,41,51,-10,36
Glentoran,6844,9,9,7,14,30,47,-17,34
Ballinamalla,6844,10,4,10,16,26,52,-26,22
Portadown,6844,11,5,5,20,24,52,-28,20
Cliftonville,6845,1,18,5,7,56,37,19,59
Crusaders,6845,2,16,7,7,56,36,20,55
Linfield,6845,3,12,12,6,55,30,25,48
Coleraine,6845,4,12,11,7,50,39,11,47
Ballymena,6845,5,13,8,9,55,55,0,47
Dungannon,6845,6,11,9,10,59,45,14,42
Glenavon,6845,7,11,8,11,43,48,-5,41
Ballinamalla,6845,8,11,3,16,30,48,-18,36
Ards,6845,9,8,5,17,32,46,-14,29
Glentoran,6845,10,7,8,15,25,47,-22,29
Portadown,6845,11,6,4,20,19,49,-30,22
Cliftonville,6846,1,20,4,6,77,41,36,64
Crusaders,6846,2,16,8,6,52,30,22,56
Linfield,6846,3,12,11,7,57,40,17,47
Ballymena,6846,4,13,7,10,56,63,-7,46
Glenavon,6846,5,10,11,9,43,38,5,41
Coleraine,6846,6,8,12,10,38,46,-8,36
Ards,6846,7,9,9,12,37,46,-9,36
Portadown,6846,8,8,9,13,25,38,-13,33
Ballinamalla,6846,9,8,7,15,27,44,-17,31
Dungannon,6846,10,6,12,12,44,47,-3,30
Glentoran,6846,11,6,8,16,24,47,-23,26
Linfield,6847,1,17,10,3,59,27,32,61
Crusaders,6847,2,18,7,5,53,31,22,61
Glenavon,6847,3,12,11,7,52,46,6,47
Ballymena,6847,4,12,9,9,56,53,3,45
Ballinamalla,6847,5,12,6,12,44,47,-3,42
Cliftonville,6847,6,11,8,11,49,43,6,41
Coleraine,6847,7,8,11,11,38,44,-6,35
Glentoran,6847,8,9,8,13,32,41,-9,35
Portadown,6847,9,7,8,15,31,51,-20,29
Dungannon,6847,10,6,9,15,44,53,-9,27
Ards,6847,11,7,5,18,34,56,-22,26
Crusaders,6848,1,18,6,6,60,34,26,60
Cliftonville,6848,2,18,4,8,56,40,16,58
Linfield,6848,3,15,8,7,57,33,24,53
Coleraine,6848,4,13,9,8,50,39,11,48
Ballymena,6848,5,15,3,12,61,58,3,48
Glenavon,6848,6,11,12,7,48,43,5,45
Ballinamalla,6848,7,12,3,15,33,47,-14,39
Dungannon,6848,8,9,9,12,43,44,-1,36
Glentoran,6848,9,8,5,17,32,48,-16,29
Portadown,6848,10,5,7,18,25,54,-29,22
Ards,6848,11,5,6,19,35,60,-25,21
Crusaders,6849,1,19,7,4,63,31,32,64
Linfield,6849,2,14,10,6,57,33,24,52
Cliftonville,6849,3,14,7,9,53,36,17,49
Glenavon,6849,4,12,11,7,54,49,5,47
Ballymena,6849,5,14,3,13,53,59,-6,45
Coleraine,6849,6,10,11,9,39,34,5,41
Ballinamalla,6849,7,11,6,13,35,45,-10,39
Dungannon,6849,8,7,10,13,39,45,-6,31
Ards,6849,9,9,4,17,35,52,-17,31
Portadown,6849,10,7,6,17,27,48,-21,27
Glentoran,6849,11,6,9,15,30,53,-23,27
Linfield,6850,1,17,10,3,64,25,39,61
Crusaders,6850,2,16,8,6,53,37,16,56
Cliftonville,6850,3,16,6,8,56,34,22,54
Coleraine,6850,4,11,10,9,40,37,3,43
Ballymena,6850,5,11,7,12,50,61,-11,40
Dungannon,6850,6,9,12,9,43,36,7,39
Glenavon,6850,7,9,10,11,42,48,-6,37
Glentoran,6850,8,10,6,14,27,44,-17,36
Portadown,6850,9,10,4,16,35,45,-10,34
Ards,6850,10,8,4,18,32,52,-20,28
Ballinamalla,6850,11,7,5,18,28,51,-23,26
Linfield,6851,1,19,8,3,65,26,39,65
Crusaders,6851,2,14,10,6,51,31,20,52
Ballymena,6851,3,16,4,10,59,56,3,52
Cliftonville,6851,4,14,6,10,53,39,14,48
Coleraine,6851,5,12,12,6,49,39,10,48
Glenavon,6851,6,10,12,8,53,52,1,42
Dungannon,6851,7,11,6,13,46,46,0,39
Ards,6851,8,11,4,15,39,47,-8,37
Glentoran,6851,9,7,9,14,29,47,-18,30
Portadown,6851,10,6,4,20,24,59,-35,22
Ballinamalla,6851,11,5,5,20,30,56,-26,20
Crusaders,6852,1,18,8,4,60,32,28,62
Linfield,6852,2,16,8,6,62,32,30,56
Coleraine,6852,3,14,9,7,54,37,17,51
Ballymena,6852,4,14,3,13,55,68,-13,45
Cliftonville,6852,5,12,6,12,48,44,4,42
Glenavon,6852,6,10,11,9,49,47,2,41
Dungannon,6852,7,10,10,10,50,39,11,40
Glentoran,6852,8,10,9,11,27,38,-11,39
Portadown,6852,9,7,6,17,30,48,-18,27
Ballinamalla,6852,10,7,6,17,23,48,-25,27
Ards,6852,11,6,6,18,28,53,-25,24
Crusaders,6853,1,18,7,5,66,36,30,61
Cliftonville,6853,2,15,5,10,52,42,10,50
Linfield,6853,3,12,11,7,58,38,20,47
Coleraine,6853,4,12,11,7,37,32,5,47
Ballymena,6853,5,12,10,8,56,55,1,46
Glenavon,6853,6,10,12,8,44,47,-3,42
Dungannon,6853,7,10,11,9,58,48,10,41
Glentoran,6853,8,10,8,12,38,44,-6,38
Ards,6853,9,11,4,15,42,52,-10,37
Portadown,6853,10,5,8,17,28,48,-20,23
Ballinamalla,6853,11,5,3,22,20,57,-37,18
Cliftonville,6854,1,18,7,5,54,28,26,61
Crusaders,6854,2,17,9,4,59,29,30,60
Linfield,6854,3,13,8,9,52,30,22,47
Dungannon,6854,4,12,11,7,55,41,14,47
Coleraine,6854,5,11,12,7,38,33,5,45
Ballymena,6854,6,13,6,11,51,55,-4,45
Glenavon,6854,7,9,10,11,40,42,-2,37
Glentoran,6854,8,9,8,13,28,44,-16,35
Ards,6854,9,7,7,16,31,52,-21,28
Ballinamalla,6854,10,7,4,19,24,53,-29,25
Portadown,6854,11,4,8,18,28,53,-25,20
Glenavon,6855,1,14,10,6,47,42,5,52
Crusaders,6855,2,14,9,7,52,38,14,51
Cliftonville,6855,3,15,6,9,46,36,10,51
Coleraine,6855,4,11,14,5,40,30,10,47
Ballymena,6855,5,13,4,13,62,62,0,43
Glentoran,6855,6,12,6,12,37,42,-5,42
Linfield,6855,7,11,8,11,55,41,14,41
Dungannon,6855,8,9,10,11,47,42,5,37
Ards,6855,9,10,3,17,40,50,-10,33
Ballinamalla,6855,10,10,3,17,28,48,-20,33
Portadown,6855,11,5,9,16,23,46,-23,24
Crusaders,6856,1,14,11,5,55,36,19,53
Glenavon,6856,2,12,12,6,58,43,15,48
Linfield,6856,3,11,14,5,53,35,18,47
Ballymena,6856,4,13,8,9,55,59,-4,47
Dungannon,6856,5,12,9,9,51,43,8,45
Cliftonville,6856,6,13,5,12,51,43,8,44
Coleraine,6856,7,10,11,9,42,41,1,41
Glentoran,6856,8,10,8,12,37,44,-7,38
Ards,6856,9,10,4,16,44,57,-13,34
Portadown,6856,10,8,6,16,30,46,-16,30
Ballinamalla,6856,11,6,4,20,25,54,-29,22
Crusaders,6857,1,18,8,4,59,31,28,62
Linfield,6857,2,13,10,7,50,29,21,49
Glenavon,6857,3,12,13,5,53,46,7,49
Cliftonville,6857,4,13,8,9,45,34,11,47
Dungannon,6857,5,12,8,10,57,43,14,44
Ballymena,6857,6,12,6,12,51,60,-9,42
Glentoran,6857,7,10,10,10,38,45,-7,40
Coleraine,6857,8,10,9,11,40,39,1,39
Ards,6857,9,8,5,17,32,47,-15,29
Portadown,6857,10,7,7,16,27,44,-17,28
Ballinamalla,6857,11,5,6,19,22,56,-34,21
Crusaders,6858,1,21,5,4,63,23,40,68
Ballymena,6858,2,16,5,9,59,53,6,53
Cliftonville,6858,3,15,4,11,47,36,11,49
Coleraine,6858,4,12,10,8,43,35,8,46
Linfield,6858,5,11,9,10,48,34,14,42
Glenavon,6858,6,9,13,8,41,43,-2,40
Dungannon,6858,7,9,10,11,46,41,5,37
Ards,6858,8,9,7,14,36,46,-10,34
Glentoran,6858,9,9,6,15,29,47,-18,33
Portadown,6858,10,9,3,18,24,50,-26,30
Ballinamalla,6858,11,8,2,20,23,51,-28,26
Crusaders,6859,1,18,8,4,60,34,26,62
Linfield,6859,2,16,8,6,55,28,27,56
Cliftonville,6859,3,15,5,10,48,36,12,50
Coleraine,6859,4,11,12,7,46,35,11,45
Ballymena,6859,5,11,10,9,51,54,-3,43
Glenavon,6859,6,11,8,11,43,45,-2,41
Ballinamalla,6859,7,12,3,15,35,44,-9,39
Portadown,6859,8,9,6,15,29,42,-13,33
Dungannon,6859,9,8,8,14,47,49,-2,32
Glentoran,6859,10,7,6,17,26,49,-23,27
Ards,6859,11,7,6,17,32,56,-24,27
Linfield,6860,1,16,10,4,68,30,38,58
Crusaders,6860,2,17,6,7,62,38,24,57
Ballymena,6860,3,14,7,9,59,61,-2,49
Glenavon,6860,4,13,8,9,52,45,7,47
Cliftonville,6860,5,13,6,11,48,40,8,45
Dungannon,6860,6,11,9,10,58,46,12,42
Coleraine,6860,7,10,9,11,44,41,3,39
Ards,6860,8,10,5,15,38,50,-12,35
Glentoran,6860,9,9,8,13,29,51,-22,35
Portadown,6860,10,8,7,15,30,49,-19,31
Ballinamalla,6860,11,6,1,23,27,64,-37,19
Ballymena,6861,1,16,6,8,60,52,8,54
Cliftonville,6861,2,16,5,9,58,40,18,53
Crusaders,6861,3,15,7,8,45,33,12,52
Linfield,6861,4,13,10,7,58,33,25,49
Dungannon,6861,5,12,8,10,49,44,5,44
Glenavon,6861,6,10,13,7,46,42,4,43
Coleraine,6861,7,9,12,9,35,35,0,39
Glentoran,6861,8,9,7,14,27,39,-12,34
Ards,6861,9,10,3,17,39,51,-12,33
Ballinamalla,6861,10,9,5,16,34,53,-19,32
Portadown,6861,11,6,4,20,22,51,-29,22
Cliftonville,6862,1,18,4,8,53,36,17,58
Crusaders,6862,2,16,7,7,53,30,23,55
Linfield,6862,3,13,10,7,55,33,22,49
Dungannon,6862,4,13,7,10,52,41,11,46
Coleraine,6862,5,12,10,8,45,37,8,46
Ballymena,6862,6,12,6,12,56,64,-8,42
Glenavon,6862,7,11,8,11,42,46,-4,41
Ards,6862,8,10,4,16,39,49,-10,34
Portadown,6862,9,9,4,17,26,43,-17,31
Glentoran,6862,10,7,8,15,29,49,-20,29
Ballinamalla,6862,11,9,2,19,27,49,-22,29
Crusaders,6863,1,16,8,6,54,29,25,56
Coleraine,6863,2,14,12,4,43,27,16,54
Cliftonville,6863,3,14,7,9,51,39,12,49
Linfield,6863,4,12,11,7,55,34,21,47
Ballymena,6863,5,13,6,11,58,63,-5,45
Dungannon,6863,6,11,11,8,53,40,13,44
Glenavon,6863,7,8,13,9,44,44,0,37
Ballinamalla,6863,8,10,5,15,29,45,-16,35
Glentoran,6863,9,7,11,12,30,46,-16,32
Ards,6863,10,7,4,19,29,54,-25,25
Portadown,6863,11,7,4,19,23,48,-25,25
Crusaders,6864,1,15,8,7,58,38,20,53
Cliftonville,6864,2,16,5,9,47,33,14,53
Linfield,6864,3,13,11,6,52,29,23,50
Ballymena,6864,4,14,7,9,62,57,5,49
Glentoran,6864,5,12,7,11,33,40,-7,43
Glenavon,6864,6,10,12,8,46,47,-1,42
Coleraine,6864,7,9,11,10,41,42,-1,38
Ards,6864,8,10,6,14,41,49,-8,36
Dungannon,6864,9,6,14,10,46,46,0,32
Ballinamalla,6864,10,8,3,19,35,55,-20,27
Portadown,6864,11,6,8,16,23,48,-25,26
Crusaders,6865,1,15,11,4,53,30,23,56
Linfield,6865,2,15,9,6,56,28,28,54
Cliftonville,6865,3,13,7,10,41,32,9,46
Ballymena,6865,4,12,10,8,57,55,2,46
Glenavon,6865,5,12,10,8,48,48,0,46
Coleraine,6865,6,8,15,7,38,35,3,39
Dungannon,6865,7,8,11,11,48,44,4,35
Glentoran,6865,8,8,11,11,33,41,-8,35
Ballinamalla,6865,9,9,7,14,26,47,-21,34
Ards,6865,10,9,5,16,32,46,-14,32
Portadown,6865,11,4,8,18,24,50,-26,20
Linfield,6866,1,18,9,3,66,22,44,63
Crusaders,6866,2,16,9,5,52,29,23,57
Cliftonville,6866,3,14,8,8,50,39,11,50
Coleraine,6866,4,11,11,8,38,36,2,44
Ballymena,6866,5,11,10,9,54,61,-7,43
Glenavon,6866,6,10,11,9,49,44,5,41
Ards,6866,7,10,5,15,39,49,-10,35
Dungannon,6866,8,7,11,12,43,44,-1,32
Glentoran,6866,9,7,11,12,30,44,-14,32
Ballinamalla,6866,10,9,2,19,29,55,-26,29
Portadown,6866,11,5,7,18,17,44,-27,22
Crusaders,6867,1,16,7,7,51,34,17,55
Linfield,6867,2,15,9,6,59,30,29,54
Cliftonville,6867,3,16,6,8,52,34,18,54
Ballymena,6867,4,16,6,8,60,53,7,54
Coleraine,6867,5,12,10,8,41,33,8,46
Glenavon,6867,6,11,9,10,42,42,0,42
Dungannon,6867,7,10,9,11,52,46,6,39
Glentoran,6867,8,10,9,11,31,44,-13,39
Ards,6867,9,10,5,15,43,54,-11,35
Ballinamalla,6867,10,6,3,21,23,51,-28,21
Portadown,6867,11,4,5,21,20,53,-33,17
Crusaders,6868,1,18,7,5,55,31,24,61
Linfield,6868,2,17,7,6,62,33,29,58
Cliftonville,6868,3,15,7,8,54,37,17,52
Glenavon,6868,4,12,10,8,49,45,4,46
Ballymena,6868,5,12,9,9,59,63,-4,45
Coleraine,6868,6,10,9,11,44,44,0,39
Glentoran,6868,7,10,6,14,36,44,-8,36
Dungannon,6868,8,8,9,13,39,42,-3,33
Ballinamalla,6868,9,8,6,16,29,50,-21,30
Ards,6868,10,7,7,16,36,48,-12,28
Portadown,6868,11,6,7,17,23,49,-26,25
Crusaders,6869,1,16,7,7,57,36,21,55
Cliftonville,6869,2,16,5,9,53,35,18,53
Linfield,6869,3,11,11,8,52,37,15,44
Coleraine,6869,4,12,8,10,45,37,8,44
Glenavon,6869,5,10,14,6,50,45,5,44
Ballymena,6869,6,11,10,9,55,55,0,43
Dungannon,6869,7,11,9,10,52,51,1,42
Glentoran,6869,8,8,9,13,28,52,-24,33
Ards,6869,9,8,8,14,32,44,-12,32
Portadown,6869,10,7,9,14,33,47,-14,30
Ballinamalla,6869,11,6,8,16,32,50,-18,26
Crusaders,6870,1,18,7,5,59,30,29,61
Cliftonville,6870,2,15,8,7,56,36,20,53
Glenavon,6870,3,12,13,5,45,38,7,49
Linfield,6870,4,12,11,7,56,36,20,47
Ballymena,6870,5,12,8,10,57,58,-1,44
Coleraine,6870,6,9,10,11,37,44,-7,37
Ballinamalla,6870,7,11,2,17,29,51,-22,35
Dungannon,6870,8,8,10,12,48,43,5,34
Ards,6870,9,10,4,16,39,47,-8,34
Glentoran,6870,10,8,10,12,32,46,-14,34
Portadown,6870,11,4,9,17,28,57,-29,21
Crusaders,6871,1,16,6,8,53,35,18,54
Cliftonville,6871,2,15,7,8,58,44,14,52
Linfield,6871,3,13,12,5,58,30,28,51
Coleraine,6871,4,13,10,7,43,33,10,49
Glenavon,6871,5,12,10,8,45,44,1,46
Ballymena,6871,6,12,6,12,52,58,-6,42
Dungannon,6871,7,10,9,11,54,44,10,39
Portadown,6871,8,8,9,13,30,46,-16,33
Ballinamalla,6871,9,8,5,17,27,47,-20,29
Glentoran,6871,10,7,8,15,22,48,-26,29
Ards,6871,11,7,6,17,35,48,-13,27
Cliftonville,6872,1,18,5,7,61,31,30,59
Linfield,6872,2,14,10,6,57,32,25,52
Crusaders,6872,3,13,8,9,51,41,10,47
Ballymena,6872,4,13,7,10,52,56,-4,46
Dungannon,6872,5,12,7,11,52,43,9,43
Coleraine,6872,6,11,10,9,39,40,-1,43
Ards,6872,7,11,6,13,39,40,-1,39
Glentoran,6872,8,10,8,12,37,46,-9,38
Glenavon,6872,9,8,12,10,43,52,-9,36
Portadown,6872,10,7,6,17,27,49,-22,27
Ballinamalla,6872,11,6,5,19,30,58,-28,23
Crusaders,6873,1,17,6,7,56,34,22,57
Cliftonville,6873,2,17,3,10,52,37,15,54
Glenavon,6873,3,14,9,7,51,41,10,51
Ballymena,6873,4,14,8,8,61,56,5,50
Linfield,6873,5,13,10,7,56,35,21,49
Dungannon,6873,6,13,6,11,57,47,10,45
Coleraine,6873,7,10,9,11,37,41,-4,39
Glentoran,6873,8,8,8,14,27,41,-14,32
Ards,6873,9,9,2,19,33,51,-18,29
Portadown,6873,10,8,4,18,28,49,-21,28
Ballinamalla,6873,11,8,3,19,25,51,-26,27
Glenavon,6874,1,14,10,6,57,43,14,52
Cliftonville,6874,2,16,4,10,51,39,12,52
Crusaders,6874,3,14,8,8,48,29,19,50
Ballymena,6874,4,14,8,8,61,60,1,50
Linfield,6874,5,12,10,8,55,35,20,46
Glentoran,6874,6,12,8,10,33,35,-2,44
Coleraine,6874,7,10,10,10,42,43,-1,40
Portadown,6874,8,9,6,15,34,47,-13,33
Ards,6874,9,10,3,17,30,47,-17,33
Dungannon,6874,10,7,11,12,43,47,-4,32
Ballinamalla,6874,11,6,4,20,27,56,-29,22
Linfield,6875,1,18,8,4,61,25,36,62
Crusaders,6875,2,18,6,6,60,32,28,60
Cliftonville,6875,3,15,7,8,47,35,12,52
Coleraine,6875,4,13,10,7,41,34,7,49
Ballymena,6875,5,12,6,12,53,59,-6,42
Glenavon,6875,6,11,8,11,47,44,3,41
Dungannon,6875,7,9,13,8,48,41,7,40
Ards,6875,8,8,8,14,35,48,-13,32
Ballinamalla,6875,9,8,5,17,30,52,-22,29
Glentoran,6875,10,5,8,17,22,48,-26,23
Portadown,6875,11,5,7,18,21,47,-26,22
Crusaders,6876,1,20,8,2,58,25,33,68
Ballymena,6876,2,16,6,8,66,58,8,54
Cliftonville,6876,3,13,8,9,53,46,7,47
Linfield,6876,4,11,10,9,53,40,13,43
Glenavon,6876,5,10,11,9,45,44,1,41
Coleraine,6876,6,10,10,10,41,41,0,40
Ards,6876,7,11,6,13,50,50,0,39
Portadown,6876,8,10,5,15,31,45,-14,35
Glentoran,6876,9,8,8,14,32,47,-15,32
Dungannon,6876,10,7,7,16,41,55,-14,28
Ballinamalla,6876,11,7,5,18,34,53,-19,26
Cliftonville,6877,1,17,5,8,58,38,20,56
Linfield,6877,2,14,10,6,53,28,25,52
Dungannon,6877,3,14,7,9,57,45,12,49
Crusaders,6877,4,13,7,10,55,47,8,46
Ballymena,6877,5,13,6,11,57,58,-1,45
Glenavon,6877,6,11,10,9,41,39,2,43
Coleraine,6877,7,9,15,6,38,36,2,42
Glentoran,6877,8,11,7,12,38,42,-4,40
Ards,6877,9,8,7,15,37,52,-15,31
Ballinamalla,6877,10,8,3,19,27,49,-22,27
Portadown,6877,11,6,5,19,23,50,-27,23
Ballymena,6878,1,17,5,8,63,50,13,56
Linfield,6878,2,15,8,7,55,30,25,53
Cliftonville,6878,3,16,4,10,56,41,15,52
Crusaders,6878,4,13,10,7,55,37,18,49
Glenavon,6878,5,12,10,8,52,47,5,46
Coleraine,6878,6,11,9,10,41,40,1,42
Dungannon,6878,7,10,11,9,51,43,8,41
Ards,6878,8,8,6,16,35,51,-16,30
Glentoran,6878,9,8,6,16,32,53,-21,30
Ballinamalla,6878,10,8,5,17,37,56,-19,29
Portadown,6878,11,9,2,19,30,59,-29,29
Crusaders,6879,1,16,9,5,57,30,27,57
Cliftonville,6879,2,17,3,10,57,41,16,54
Ballymena,6879,3,14,6,10,58,61,-3,48
Linfield,6879,4,13,8,9,52,36,16,47
Glenavon,6879,5,10,15,5,50,43,7,45
Ards,6879,6,13,3,14,41,47,-6,42
Coleraine,6879,7,11,8,11,44,46,-2,41
Dungannon,6879,8,10,8,12,51,45,6,38
Glentoran,6879,9,9,6,15,29,40,-11,33
Portadown,6879,10,8,8,14,29,44,-15,32
Ballinamalla,6879,11,5,4,21,20,55,-35,19
Linfield,6880,1,17,8,5,63,23,40,59
Crusaders,6880,2,18,5,7,54,33,21,59
Cliftonville,6880,3,17,2,11,46,36,10,53
Ballymena,6880,4,14,5,11,52,54,-2,47
Glenavon,6880,5,11,8,11,51,50,1,41
Coleraine,6880,6,10,11,9,39,38,1,41
Ards,6880,7,10,6,14,36,48,-12,36
Dungannon,6880,8,8,10,12,44,48,-4,34
Ballinamalla,6880,9,10,4,16,32,49,-17,34
Glentoran,6880,10,8,7,15,26,41,-15,31
Portadown,6880,11,6,6,18,25,48,-23,24
Ballymena,6881,1,17,6,7,64,50,14,57
Linfield,6881,2,15,9,6,62,33,29,54
Crusaders,6881,3,14,10,6,63,41,22,52
Cliftonville,6881,4,14,6,10,57,49,8,48
Coleraine,6881,5,12,11,7,50,36,14,47
Glenavon,6881,6,9,11,10,49,53,-4,38
Dungannon,6881,7,6,16,8,43,42,1,34
Portadown,6881,8,10,4,16,29,47,-18,34
Glentoran,6881,9,8,6,16,28,51,-23,30
Ballinamalla,6881,10,7,7,16,32,52,-20,28
Ards,6881,11,6,8,16,32,55,-23,26
Linfield,6882,1,15,10,5,63,31,32,55
Crusaders,6882,2,16,6,8,53,31,22,54
Cliftonville,6882,3,16,4,10,50,41,9,52
Ballymena,6882,4,15,7,8,57,55,2,52
Glenavon,6882,5,14,9,7,56,45,11,51
Dungannon,6882,6,10,11,9,47,43,4,41
Coleraine,6882,7,10,11,9,37,40,-3,41
Ards,6882,8,10,8,12,43,50,-7,38
Glentoran,6882,9,9,6,15,30,39,-9,33
Portadown,6882,10,4,7,19,20,45,-25,19
Ballinamalla,6882,11,5,3,22,27,63,-36,18
Cliftonville,6883,1,17,4,9,57,41,16,55
Crusaders,6883,2,15,9,6,48,30,18,54
Coleraine,6883,3,14,8,8,51,35,16,50
Glenavon,6883,4,13,11,6,55,44,11,50
Linfield,6883,5,11,11,8,52,36,16,44
Dungannon,6883,6,12,7,11,52,46,6,43
Ballymena,6883,7,11,7,12,51,60,-9,40
Ards,6883,8,11,4,15,45,51,-6,37
Glentoran,6883,9,10,6,14,36,45,-9,36
Ballinamalla,6883,10,6,5,19,21,50,-29,23
Portadown,6883,11,5,8,17,26,56,-30,23
Cliftonville,6884,1,16,6,8,53,38,15,54
Coleraine,6884,2,14,10,6,49,37,12,52
Ballymena,6884,3,15,7,8,58,49,9,52
Crusaders,6884,4,15,6,9,57,40,17,51
Linfield,6884,5,13,8,9,55,35,20,47
Glenavon,6884,6,12,8,10,45,45,0,44
Dungannon,6884,7,11,8,11,44,40,4,41
Glentoran,6884,8,10,5,15,32,43,-11,35
Ballinamalla,6884,9,9,6,15,31,49,-18,33
Ards,6884,10,7,4,19,29,49,-20,25
Portadown,6884,11,7,4,19,22,50,-28,25
Crusaders,6885,1,20,5,5,59,31,28,65
Linfield,6885,2,15,6,9,59,31,28,51
Cliftonville,6885,3,15,5,10,54,39,15,50
Dungannon,6885,4,13,8,9,57,48,9,47
Ballymena,6885,5,13,5,12,57,62,-5,44
Glenavon,6885,6,11,10,9,46,52,-6,43
Coleraine,6885,7,10,8,12,36,40,-4,38
Portadown,6885,8,9,5,16,32,47,-15,32
Glentoran,6885,9,9,5,16,29,45,-16,32
Ballinamalla,6885,10,9,4,17,33,52,-19,31
Ards,6885,11,9,3,18,41,56,-15,30
Linfield,6886,1,16,10,4,57,29,28,58
Crusaders,6886,2,15,9,6,51,34,17,54
Glenavon,6886,3,12,13,5,48,38,10,49
Cliftonville,6886,4,14,4,12,53,42,11,46
Coleraine,6886,5,10,13,7,40,35,5,43
Ballymena,6886,6,12,6,12,52,61,-9,42
Dungannon,6886,7,9,9,12,49,48,1,36
Ards,6886,8,7,9,14,39,49,-10,30
Glentoran,6886,9,6,12,12,25,39,-14,30
Ballinamalla,6886,10,7,9,14,26,44,-18,30
Portadown,6886,11,8,4,18,29,50,-21,28
Cliftonville,6887,1,16,7,7,56,36,20,55
Crusaders,6887,2,16,6,8,56,36,20,54
Glenavon,6887,3,14,10,6,52,45,7,52
Linfield,6887,4,14,9,7,64,38,26,51
Ballymena,6887,5,15,5,10,67,69,-2,50
Dungannon,6887,6,10,9,11,50,44,6,39
Coleraine,6887,7,9,11,10,45,49,-4,38
Ballinamalla,6887,8,9,5,16,40,52,-12,32
Glentoran,6887,9,8,6,16,30,51,-21,30
Ards,6887,10,7,7,16,33,50,-17,28
Portadown,6887,11,7,5,18,29,52,-23,26
Crusaders,6888,1,17,7,6,61,31,30,58
Cliftonville,6888,2,18,4,8,59,37,22,58
Linfield,6888,3,15,9,6,56,27,29,54
Ballymena,6888,4,15,5,10,51,53,-2,50
Coleraine,6888,5,12,8,10,44,37,7,44
Glenavon,6888,6,10,11,9,52,54,-2,41
Glentoran,6888,7,10,8,12,29,44,-15,38
Dungannon,6888,8,9,10,11,47,46,1,37
Ards,6888,9,9,3,18,39,54,-15,30
Ballinamalla,6888,10,7,4,19,30,59,-29,25
Portadown,6888,11,6,5,19,21,47,-26,23
Crusaders,6889,1,20,4,6,59,32,27,64
Linfield,6889,2,14,10,6,61,30,31,52
Cliftonville,6889,3,16,4,10,53,43,10,52
Ballymena,6889,4,12,6,12,54,56,-2,42
Glentoran,6889,5,10,10,10,35,44,-9,40
Coleraine,6889,6,10,9,11,41,37,4,39
Glenavon,6889,7,8,13,9,44,51,-7,37
Ards,6889,8,10,5,15,38,49,-11,35
Dungannon,6889,9,8,8,14,51,54,-3,32
Portadown,6889,10,9,5,16,29,47,-18,32
Ballinamalla,6889,11,7,8,15,32,54,-22,29
Linfield,6890,1,19,6,5,63,27,36,63
Crusaders,6890,2,16,7,7,60,38,22,55
Cliftonville,6890,3,15,5,10,57,39,18,50
Ballymena,6890,4,14,4,12,60,61,-1,46
Coleraine,6890,5,11,9,10,42,55,-13,42
Dungannon,6890,6,10,9,11,56,47,9,39
Glenavon,6890,7,10,9,11,52,50,2,39
Portadown,6890,8,10,6,14,26,42,-16,36
Glentoran,6890,9,9,6,15,35,46,-11,33
Ards,6890,10,9,6,15,34,48,-14,33
Ballinamalla,6890,11,6,5,19,34,66,-32,23
Cliftonville,6891,1,19,4,7,59,38,21,61
Glenavon,6891,2,13,10,7,52,37,15,49
Linfield,6891,3,12,10,8,58,37,21,46
Crusaders,6891,4,12,10,8,49,38,11,46
Coleraine,6891,5,10,11,9,41,38,3,41
Dungannon,6891,6,10,10,10,46,42,4,40
Glentoran,6891,7,10,8,12,34,41,-7,38
Ballymena,6891,8,9,10,11,51,60,-9,37
Ards,6891,9,10,5,15,35,49,-14,35
Ballinamalla,6891,10,7,8,15,27,49,-22,29
Portadown,6891,11,6,8,16,25,48,-23,26
Linfield,6892,1,17,9,4,65,28,37,60
Glenavon,6892,2,13,11,6,48,38,10,50
Cliftonville,6892,3,15,4,11,46,36,10,49
Ballymena,6892,4,14,5,11,57,52,5,47
Dungannon,6892,5,13,7,10,50,38,12,46
Crusaders,6892,6,11,9,10,41,34,7,42
Coleraine,6892,7,10,12,8,39,40,-1,42
Ards,6892,8,10,5,15,33,47,-14,35
Glentoran,6892,9,8,10,12,29,41,-12,34
Ballinamalla,6892,10,9,3,18,31,52,-21,30
Portadown,6892,11,4,7,19,23,56,-33,19
Crusaders,6893,1,18,8,4,66,34,32,62
Linfield,6893,2,15,10,5,60,33,27,55
Cliftonville,6893,3,16,5,9,57,41,16,53
Ballymena,6893,4,15,4,11,60,55,5,49
Glentoran,6893,5,10,10,10,33,40,-7,40
Coleraine,6893,6,10,9,11,43,45,-2,39
Glenavon,6893,7,10,9,11,44,48,-4,39
Ards,6893,8,10,6,14,38,53,-15,36
Dungannon,6893,9,7,12,11,50,47,3,33
Portadown,6893,10,7,7,16,28,49,-21,28
Ballinamalla,6893,11,5,4,21,24,58,-34,19
Crusaders,6894,1,16,8,6,57,37,20,56
Cliftonville,6894,2,18,2,10,56,36,20,56
Linfield,6894,3,13,11,6,61,38,23,50
Glenavon,6894,4,10,12,8,49,42,7,42
Coleraine,6894,5,10,12,8,41,41,0,42
Ballymena,6894,6,11,7,12,56,64,-8,40
Portadown,6894,7,10,7,13,26,37,-11,37
Dungannon,6894,8,9,8,13,52,55,-3,35
Ards,6894,9,9,7,14,37,47,-10,34
Glentoran,6894,10,8,10,12,29,40,-11,34
Ballinamalla,6894,11,7,4,19,29,56,-27,25
Crusaders,6895,1,19,7,4,57,29,28,64
Ballymena,6895,2,15,6,9,68,57,11,51
Linfield,6895,3,13,7,10,62,38,24,46
Dungannon,6895,4,11,9,10,52,44,8,42
Glenavon,6895,5,10,11,9,44,55,-11,41
Coleraine,6895,6,10,9,11,39,41,-2,39
Cliftonville,6895,7,9,11,10,43,47,-4,38
Glentoran,6895,8,10,8,12,36,40,-4,38
Ards,6895,9,9,8,13,45,52,-7,35
Portadown,6895,10,9,5,16,30,48,-18,32
Ballinamalla,6895,11,8,3,19,30,55,-25,27
Crusaders,6896,1,19,7,4,59,30,29,64
Linfield,6896,2,18,7,5,67,29,38,61
Glenavon,6896,3,13,10,7,54,40,14,49
Cliftonville,6896,4,14,6,10,51,45,6,48
Coleraine,6896,5,11,9,10,44,46,-2,42
Ballymena,6896,6,11,4,15,52,67,-15,37
Portadown,6896,7,10,5,15,31,45,-14,35
Dungannon,6896,8,8,10,12,49,48,1,34
Ards,6896,9,9,6,15,37,48,-11,33
Glentoran,6896,10,9,6,15,30,48,-18,33
Ballinamalla,6896,11,6,4,20,28,56,-28,22
Linfield,6897,1,16,10,4,62,28,34,58
Crusaders,6897,2,15,9,6,53,35,18,54
Cliftonville,6897,3,16,3,11,54,38,16,51
Dungannon,6897,4,10,12,8,52,42,10,42
Coleraine,6897,5,10,12,8,37,37,0,42
Glenavon,6897,6,10,11,9,50,45,5,41
Ballymena,6897,7,11,8,11,52,59,-7,41
Glentoran,6897,8,9,10,11,29,39,-10,37
Ards,6897,9,10,5,15,39,50,-11,35
Portadown,6897,10,7,5,18,21,45,-24,26
Ballinamalla,6897,11,6,5,19,25,56,-31,23
Crusaders,6898,1,19,8,3,69,34,35,65
Cliftonville,6898,2,17,3,10,58,38,20,54
Linfield,6898,3,14,11,5,60,30,30,53
Ballymena,6898,4,14,6,10,59,58,1,48
Glenavon,6898,5,11,8,11,41,49,-8,41
Coleraine,6898,6,10,9,11,37,35,2,39
Ards,6898,7,11,6,13,37,46,-9,39
Glentoran,6898,8,9,9,12,33,43,-10,36
Dungannon,6898,9,8,10,12,47,46,1,34
Portadown,6898,10,7,4,19,22,50,-28,25
Ballinamalla,6898,11,6,4,20,24,58,-34,22
Crusaders,6899,1,17,9,4,54,31,23,60
Ballymena,6899,2,16,4,10,55,50,5,52
Cliftonville,6899,3,14,6,10,53,37,16,48
Coleraine,6899,4,12,9,9,45,41,4,45
Dungannon,6899,5,12,8,10,54,48,6,44
Linfield,6899,6,11,10,9,54,38,16,43
Glentoran,6899,7,11,6,13,35,45,-10,39
Ards,6899,8,9,8,13,38,48,-10,35
Glenavon,6899,9,7,12,11,43,50,-7,33
Portadown,6899,10,9,3,18,29,45,-16,30
Ballinamalla,6899,11,8,3,19,34,61,-27,27
Crusaders,6900,1,17,7,6,49,27,22,58
Cliftonville,6900,2,16,6,8,55,36,19,54
Linfield,6900,3,11,12,7,53,39,14,45
Ballymena,6900,4,12,9,9,66,60,6,45
Coleraine,6900,5,11,11,8,45,44,1,44
Dungannon,6900,6,11,10,9,55,44,11,43
Ards,6900,7,11,5,14,50,53,-3,38
Glenavon,6900,8,9,10,11,40,43,-3,37
Glentoran,6900,9,9,7,14,30,46,-16,34
Portadown,6900,10,7,6,17,29,50,-21,27
Ballinamalla,6900,11,7,5,18,26,56,-30,26
Cliftonville,6901,1,18,5,7,54,36,18,59
Crusaders,6901,2,16,5,9,47,35,12,53
Dungannon,6901,3,13,10,7,57,39,18,49
Linfield,6901,4,14,7,9,62,46,16,49
Glenavon,6901,5,11,12,7,58,47,11,45
Ballymena,6901,6,13,5,12,56,59,-3,44
Coleraine,6901,7,10,9,11,42,37,5,39
Ards,6901,8,10,3,17,41,54,-13,33
Glentoran,6901,9,9,5,16,28,48,-20,32
Portadown,6901,10,8,7,15,25,44,-19,31
Ballinamalla,6901,11,7,4,19,30,55,-25,25
Linfield,6902,1,17,8,5,63,29,34,59
Crusaders,6902,2,15,9,6,57,37,20,54
Cliftonville,6902,3,15,4,11,59,43,16,49
Coleraine,6902,4,12,12,6,46,39,7,48
Dungannon,6902,5,10,10,10,52,43,9,40
Glenavon,6902,6,8,14,8,37,37,0,38
Ballymena,6902,7,10,8,12,43,60,-17,38
Ards,6902,8,10,6,14,42,48,-6,36
Portadown,6902,9,8,7,15,29,47,-18,31
Glentoran,6902,10,8,6,16,28,44,-16,30
Ballinamalla,6902,11,8,4,18,31,60,-29,28
Crusaders,6903,1,17,7,6,56,31,25,58
Linfield,6903,2,15,11,4,59,29,30,56
Cliftonville,6903,3,14,8,8,52,35,17,50
Dungannon,6903,4,10,11,9,61,47,14,41
Coleraine,6903,5,10,10,10,47,47,0,40
Glentoran,6903,6,10,9,11,34,48,-14,39
Ballymena,6903,7,10,7,13,48,58,-10,37
Glenavon,6903,8,7,12,11,37,49,-12,33
Portadown,6903,9,8,8,14,29,47,-18,32
Ballinamalla,6903,10,8,7,15,35,56,-21,31
Ards,6903,11,8,6,16,40,51,-11,30
Crusaders,6904,1,16,6,8,56,39,17,54
Ballymena,6904,2,15,6,9,56,58,-2,51
Cliftonville,6904,3,14,8,8,61,38,23,50
Linfield,6904,4,13,11,6,56,35,21,50
Coleraine,6904,5,13,11,6,46,32,14,50
Glentoran,6904,6,12,9,9,39,39,0,45
Glenavon,6904,7,10,13,7,47,41,6,43
Ards,6904,8,11,5,14,37,47,-10,38
Dungannon,6904,9,8,9,13,51,47,4,33
Portadown,6904,10,5,5,20,22,57,-35,20
Ballinamalla,6904,11,5,3,22,23,61,-38,18
Crusaders,6905,1,15,9,6,50,30,20,54
Ballymena,6905,2,15,8,7,66,54,12,53
Cliftonville,6905,3,15,5,10,52,39,13,50
Linfield,6905,4,11,13,6,56,40,16,46
Glenavon,6905,5,11,13,6,45,42,3,46
Dungannon,6905,6,11,8,11,50,42,8,41
Coleraine,6905,7,9,12,9,36,39,-3,39
Portadown,6905,8,10,3,17,35,49,-14,33
Ards,6905,9,8,8,14,35,47,-12,32
Glentoran,6905,10,7,9,14,27,47,-20,30
Ballinamalla,6905,11,6,6,18,31,54,-23,24
Crusaders,6906,1,16,6,8,60,38,22,54
Linfield,6906,2,14,10,6,54,30,24,52
Coleraine,6906,3,13,11,6,49,36,13,50
Ballymena,6906,4,14,8,8,57,56,1,50
Cliftonville,6906,5,15,3,12,51,41,10,48
Glenavon,6906,6,11,9,10,53,56,-3,42
Dungannon,6906,7,10,9,11,50,42,8,39
Glentoran,6906,8,9,7,14,37,50,-13,34
Ards,6906,9,8,7,15,32,44,-12,31
Ballinamalla,6906,10,9,4,17,32,51,-19,31
Portadown,6906,11,6,6,18,21,52,-31,24
Linfield,6907,1,18,7,5,65,32,33,61
Crusaders,6907,2,17,8,5,63,37,26,59
Ballymena,6907,3,17,4,9,63,49,14,55
Glenavon,6907,4,11,11,8,48,41,7,44
Cliftonville,6907,5,12,5,13,48,46,2,41
Dungannon,6907,6,10,10,10,51,40,11,40
Coleraine,6907,7,10,10,10,36,46,-10,40
Ballinamalla,6907,8,10,4,16,31,53,-22,34
Glentoran,6907,9,8,6,16,26,46,-20,30
Portadown,6907,10,7,6,17,26,50,-24,27
Ards,6907,11,6,7,17,35,52,-17,25
Crusaders,6908,1,13,11,6,51,38,13,50
Linfield,6908,2,13,10,7,58,34,24,49
Ballymena,6908,3,13,9,8,54,56,-2,48
Cliftonville,6908,4,13,6,11,50,43,7,45
Glenavon,6908,5,11,11,8,50,44,6,44
Coleraine,6908,6,11,10,9,39,36,3,43
Dungannon,6908,7,9,12,9,55,44,11,39
Ards,6908,8,10,7,13,44,52,-8,37
Glentoran,6908,9,8,10,12,33,47,-14,34
Ballinamalla,6908,10,9,4,17,34,55,-21,31
Portadown,6908,11,8,4,18,29,48,-19,28
Crusaders,6909,1,15,8,7,57,37,20,53
Linfield,6909,2,14,10,6,59,35,24,52
Cliftonville,6909,3,13,8,9,52,40,12,47
Coleraine,6909,4,11,12,7,49,39,10,45
Ballymena,6909,5,13,6,11,58,60,-2,45
Glenavon,6909,6,12,9,9,45,48,-3,45
Dungannon,6909,7,9,11,10,55,51,4,38
Glentoran,6909,8,9,7,14,34,41,-7,34
Ards,6909,9,10,3,17,40,56,-16,33
Portadown,6909,10,9,5,16,27,48,-21,32
Ballinamalla,6909,11,8,5,17,32,53,-21,29
Linfield,6910,1,17,7,6,64,33,31,58
Crusaders,6910,2,17,7,6,47,29,18,58
Cliftonville,6910,3,16,4,10,57,35,22,52
Ballymena,6910,4,13,9,8,56,54,2,48
Dungannon,6910,5,12,9,9,56,46,10,45
Coleraine,6910,6,11,10,9,38,44,-6,43
Glenavon,6910,7,10,10,10,43,41,2,40
Ballinamalla,6910,8,11,2,17,35,46,-11,35
Ards,6910,9,7,6,17,42,58,-16,27
Glentoran,6910,10,6,8,16,23,48,-25,26
Portadown,6910,11,5,8,17,21,48,-27,23
Crusaders,6911,1,19,4,7,58,37,21,61
Cliftonville,6911,2,18,4,8,60,39,21,58
Glenavon,6911,3,15,9,6,57,40,17,54
Linfield,6911,4,15,7,8,57,35,22,52
Ballymena,6911,5,13,6,11,55,63,-8,45
Coleraine,6911,6,10,14,6,46,41,5,44
Glentoran,6911,7,9,7,14,25,40,-15,34
Portadown,6911,8,9,5,16,30,46,-16,32
Dungannon,6911,9,7,8,15,45,47,-2,29
Ards,6911,10,8,5,17,37,50,-13,29
Ballinamalla,6911,11,5,5,20,27,59,-32,20
Crusaders,6912,1,15,9,6,55,39,16,54
Linfield,6912,2,15,8,7,59,34,25,53
Glenavon,6912,3,13,12,5,49,39,10,51
Ballymena,6912,4,14,9,7,59,54,5,51
Cliftonville,6912,5,13,8,9,49,40,9,47
Coleraine,6912,6,10,15,5,43,35,8,45
Dungannon,6912,7,9,10,11,42,39,3,37
Glentoran,6912,8,8,7,15,36,52,-16,31
Ards,6912,9,7,7,16,34,49,-15,28
Ballinamalla,6912,10,7,5,18,25,49,-24,26
Portadown,6912,11,5,8,17,24,45,-21,23
Crusaders,6913,1,14,10,6,57,42,15,52
Linfield,6913,2,13,9,8,60,34,26,48
Ballymena,6913,3,13,9,8,55,51,4,48
Ards,6913,4,13,6,11,38,37,1,45
Coleraine,6913,5,10,14,6,44,34,10,44
Cliftonville,6913,6,12,8,10,52,45,7,44
Glenavon,6913,7,11,10,9,52,55,-3,43
Dungannon,6913,8,11,9,10,59,46,13,42
Portadown,6913,9,9,4,17,25,44,-19,31
Glentoran,6913,10,7,6,17,27,50,-23,27
Ballinamalla,6913,11,7,5,18,27,58,-31,26
Crusaders,6914,1,16,8,6,53,36,17,56
Linfield,6914,2,16,7,7,55,30,25,55
Ballymena,6914,3,14,8,8,53,54,-1,50
Dungannon,6914,4,14,7,9,62,41,21,49
Glenavon,6914,5,12,11,7,53,48,5,47
Cliftonville,6914,6,11,7,12,46,39,7,40
Coleraine,6914,7,10,9,11,41,39,2,39
Ballinamalla,6914,8,9,5,16,37,55,-18,32
Glentoran,6914,9,7,9,14,27,45,-18,30
Ards,6914,10,7,8,15,35,53,-18,29
Portadown,6914,11,7,5,18,30,52,-22,26
Ballymena,6915,1,17,7,6,70,52,18,58
Crusaders,6915,2,15,7,8,58,43,15,52
Linfield,6915,3,13,9,8,54,35,19,48
Coleraine,6915,4,12,10,8,41,39,2,46
Cliftonville,6915,5,13,6,11,47,36,11,45
Glenavon,6915,6,11,11,8,45,43,2,44
Glentoran,6915,7,11,7,12,36,44,-8,40
Ards,6915,8,9,6,15,34,47,-13,33
Dungannon,6915,9,8,8,14,45,45,0,32
Ballinamalla,6915,10,8,5,17,30,53,-23,29
Portadown,6915,11,6,8,16,22,45,-23,26
Linfield,6916,1,16,8,6,63,32,31,56
Crusaders,6916,2,15,7,8,54,40,14,52
Coleraine,6916,3,13,11,6,47,34,13,50
Ballymena,6916,4,14,6,10,50,53,-3,48
Glenavon,6916,5,11,12,7,48,41,7,45
Cliftonville,6916,6,13,5,12,52,44,8,44
Glentoran,6916,7,9,8,13,36,41,-5,35
Ards,6916,8,10,4,16,41,54,-13,34
Dungannon,6916,9,7,11,12,45,48,-3,32
Portadown,6916,10,8,8,14,26,43,-17,32
Ballinamalla,6916,11,7,4,19,27,59,-32,25
Crusaders,6917,1,16,8,6,54,30,24,56
Linfield,6917,2,14,12,4,59,29,30,54
Cliftonville,6917,3,16,4,10,54,40,14,52
Coleraine,6917,4,12,10,8,42,33,9,46
Ballymena,6917,5,13,7,10,53,56,-3,46
Glenavon,6917,6,11,12,7,44,41,3,45
Dungannon,6917,7,11,10,9,48,39,9,43
Portadown,6917,8,8,5,17,27,44,-17,29
Ballinamalla,6917,9,7,7,16,28,52,-24,28
Glentoran,6917,10,5,11,14,27,49,-22,26
Ards,6917,11,6,6,18,30,53,-23,24
Linfield,6918,1,15,10,5,61,31,30,55
Crusaders,6918,2,16,6,8,54,35,19,54
Cliftonville,6918,3,16,5,9,53,32,21,53
Ballymena,6918,4,15,4,11,65,65,0,49
Coleraine,6918,5,11,12,7,43,37,6,45
Dungannon,6918,6,11,9,10,58,49,9,42
Glenavon,6918,7,9,15,6,41,40,1,42
Ballinamalla,6918,8,10,4,16,33,46,-13,34
Glentoran,6918,9,8,10,12,30,44,-14,34
Ards,6918,10,7,7,16,36,60,-24,28
Portadown,6918,11,4,4,22,15,50,-35,16
Cliftonville,6919,1,18,3,9,56,42,14,57
Crusaders,6919,2,16,8,6,66,37,29,56
Linfield,6919,3,15,8,7,58,31,27,53
Ballymena,6919,4,15,6,9,65,60,5,51
Coleraine,6919,5,11,10,9,45,40,5,43
Glenavon,6919,6,10,11,9,50,55,-5,41
Dungannon,6919,7,10,8,12,62,53,9,38
Glentoran,6919,8,8,7,15,31,51,-20,31
Portadown,6919,9,9,4,17,30,50,-20,31
Ards,6919,10,8,5,17,34,56,-22,29
Ballinamalla,6919,11,8,4,18,35,57,-22,28
Cliftonville,6920,1,16,5,9,57,38,19,53
Linfield,6920,2,14,8,8,54,36,18,50
Crusaders,6920,3,14,8,8,51,38,13,50
Glenavon,6920,4,13,9,8,56,53,3,48
Ballymena,6920,5,14,6,10,57,55,2,48
Dungannon,6920,6,10,11,9,54,42,12,41
Glentoran,6920,7,12,5,13,39,42,-3,41
Coleraine,6920,8,9,12,9,44,43,1,39
Ards,6920,9,9,5,16,35,50,-15,32
Portadown,6920,10,8,4,18,28,54,-26,28
Ballinamalla,6920,11,7,5,18,29,53,-24,26
Linfield,6921,1,16,9,5,62,25,37,57
Cliftonville,6921,2,16,5,9,51,42,9,53
Glenavon,6921,3,11,12,7,50,42,8,45
Crusaders,6921,4,12,9,9,47,39,8,45
Coleraine,6921,5,10,13,7,37,36,1,43
Ballymena,6921,6,12,7,11,48,55,-7,43
Dungannon,6921,7,10,10,10,55,48,7,40
Glentoran,6921,8,10,8,12,36,39,-3,38
Ballinamalla,6921,9,8,9,13,29,41,-12,33
Ards,6921,10,6,7,17,30,53,-23,25
Portadown,6921,11,6,7,17,23,48,-25,25
Crusaders,6922,1,16,8,6,53,32,21,56
Coleraine,6922,2,14,12,4,48,28,20,54
Linfield,6922,3,14,8,8,56,31,25,50
Cliftonville,6922,4,14,5,11,53,41,12,47
Dungannon,6922,5,12,6,12,51,48,3,42
Glenavon,6922,6,10,12,8,48,48,0,42
Glentoran,6922,7,10,8,12,34,47,-13,38
Ballymena,6922,8,10,7,13,56,72,-16,37
Portadown,6922,9,11,3,16,32,44,-12,36
Ards,6922,10,8,4,18,40,57,-17,28
Ballinamalla,6922,11,9,1,20,29,52,-23,28
Crusaders,6923,1,17,6,7,58,39,19,57
Cliftonville,6923,2,16,6,8,56,41,15,54
Linfield,6923,3,14,9,7,49,32,17,51
Ballymena,6923,4,13,9,8,56,52,4,48
Coleraine,6923,5,10,11,9,39,43,-4,41
Ballinamalla,6923,6,12,5,13,30,43,-13,41
Dungannon,6923,7,11,6,13,53,48,5,39
Glenavon,6923,8,9,11,10,44,42,2,38
Glentoran,6923,9,9,8,13,32,38,-6,35
Ards,6923,10,8,5,17,33,49,-16,29
Portadown,6923,11,5,6,19,23,46,-23,21
Linfield,6924,1,16,10,4,61,27,34,58
Crusaders,6924,2,16,8,6,54,34,20,56
Cliftonville,6924,3,16,5,9,54,39,15,53
Ballymena,6924,4,14,6,10,54,56,-2,48
Dungannon,6924,5,11,10,9,56,38,18,43
Glenavon,6924,6,11,10,9,44,49,-5,43
Coleraine,6924,7,11,9,10,42,41,1,42
Ballinamalla,6924,8,10,5,15,42,55,-13,35
Portadown,6924,9,6,8,16,23,46,-23,26
Ards,6924,10,6,6,18,35,57,-22,24
Glentoran,6924,11,5,9,16,28,51,-23,24
Linfield,6925,1,16,8,6,56,27,29,56
Crusaders,6925,2,13,12,5,52,36,16,51
Coleraine,6925,3,12,13,5,41,29,12,49
Cliftonville,6925,4,12,8,10,50,44,6,44
Ballymena,6925,5,12,6,12,51,56,-5,42
Dungannon,6925,6,9,11,10,45,43,2,38
Glenavon,6925,7,8,14,8,41,43,-2,38
Glentoran,6925,8,9,7,14,32,43,-11,34
Ards,6925,9,10,3,17,36,53,-17,33
Ballinamalla,6925,10,10,2,18,33,46,-13,32
Portadown,6925,11,8,8,14,25,42,-17,32
Crusaders,6926,1,15,9,6,55,37,18,54
Linfield,6926,2,14,10,6,51,28,23,52
Cliftonville,6926,3,14,7,9,48,36,12,49
Ballymena,6926,4,14,6,10,50,51,-1,48
Coleraine,6926,5,10,13,7,46,39,7,43
Dungannon,6926,6,10,10,10,44,39,5,40
Glenavon,6926,7,8,13,9,40,42,-2,37
Ards,6926,8,9,7,14,39,43,-4,34
Ballinamalla,6926,9,8,7,15,30,48,-18,31
Portadown,6926,10,8,7,15,25,43,-18,31
Glentoran,6926,11,6,9,15,23,45,-22,27
Linfield,6927,1,17,8,5,66,35,31,59
Crusaders,6927,2,16,8,6,55,35,20,56
Ballymena,6927,3,15,7,8,66,60,6,52
Coleraine,6927,4,14,9,7,53,42,11,51
Cliftonville,6927,5,15,3,12,56,44,12,48
Glenavon,6927,6,12,10,8,45,43,2,46
Dungannon,6927,7,8,8,14,46,45,1,32
Glentoran,6927,8,8,8,14,26,43,-17,32
Ballinamalla,6927,9,8,6,16,28,48,-20,30
Portadown,6927,10,7,6,17,26,47,-21,27
Ards,6927,11,4,9,17,34,59,-25,21
Linfield,6928,1,18,9,3,69,30,39,63
Crusaders,6928,2,17,8,5,66,40,26,59
Cliftonville,6928,3,14,6,10,51,38,13,48
Coleraine,6928,4,12,12,6,41,35,6,48
Glenavon,6928,5,10,13,7,45,41,4,43
Ballymena,6928,6,11,7,12,52,60,-8,40
Dungannon,6928,7,9,11,10,56,53,3,38
Ballinamalla,6928,8,8,8,14,33,54,-21,32
Glentoran,6928,9,7,9,14,34,51,-17,30
Ards,6928,10,7,5,18,35,56,-21,26
Portadown,6928,11,5,6,19,22,46,-24,21
Crusaders,6929,1,17,10,3,52,27,25,61
Cliftonville,6929,2,15,8,7,56,35,21,53
Linfield,6929,3,14,9,7,54,29,25,51
Ballymena,6929,4,14,6,10,61,61,0,48
Coleraine,6929,5,12,11,7,43,44,-1,47
Dungannon,6929,6,10,9,11,49,43,6,39
Ballinamalla,6929,7,10,5,15,31,48,-17,35
Glenavon,6929,8,6,13,11,39,48,-9,31
Ards,6929,9,9,4,17,36,48,-12,31
Portadown,6929,10,9,3,18,30,48,-18,30
Glentoran,6929,11,7,6,17,31,51,-20,27
Linfield,6930,1,16,9,5,59,27,32,57
Cliftonville,6930,2,16,6,8,51,37,14,54
Crusaders,6930,3,13,9,8,50,35,15,48
Ballymena,6930,4,14,6,10,63,67,-4,48
Dungannon,6930,5,9,11,10,48,46,2,38
Glenavon,6930,6,8,14,8,46,48,-2,38
Coleraine,6930,7,8,13,9,44,40,4,37
Ards,6930,8,9,7,14,37,46,-9,34
Glentoran,6930,9,9,6,15,29,42,-13,33
Ballinamalla,6930,10,9,6,15,27,44,-17,33
Portadown,6930,11,9,3,18,23,45,-22,30
Crusaders,6931,1,15,9,6,55,34,21,54
Linfield,6931,2,14,8,8,58,32,26,50
Cliftonville,6931,3,13,9,8,56,41,15,48
Ballymena,6931,4,13,7,10,63,65,-2,46
Glenavon,6931,5,12,9,9,54,57,-3,45
Coleraine,6931,6,10,13,7,44,36,8,43
Dungannon,6931,7,11,9,10,47,44,3,42
Glentoran,6931,8,9,8,13,25,43,-18,35
Ballinamalla,6931,9,8,6,16,36,50,-14,30
Ards,6931,10,8,6,16,34,48,-14,30
Portadown,6931,11,5,10,15,28,50,-22,25
Crusaders,6932,1,18,8,4,57,30,27,62
Linfield,6932,2,14,8,8,54,31,23,50
Coleraine,6932,3,13,11,6,44,36,8,50
Ballymena,6932,4,13,8,9,64,56,8,47
Cliftonville,6932,5,12,8,10,49,40,9,44
Glenavon,6932,6,10,13,7,50,45,5,43
Portadown,6932,7,10,5,15,28,41,-13,35
Dungannon,6932,8,7,10,13,48,54,-6,31
Ards,6932,9,8,6,16,37,55,-18,30
Ballinamalla,6932,10,9,3,18,35,60,-25,30
Glentoran,6932,11,7,8,15,30,48,-18,29
Cliftonville,6933,1,18,3,9,59,35,24,57
Crusaders,6933,2,16,8,6,59,38,21,56
Linfield,6933,3,14,9,7,59,36,23,51
Coleraine,6933,4,12,12,6,53,39,14,48
Glenavon,6933,5,11,9,10,43,44,-1,42
Dungannon,6933,6,10,9,11,53,51,2,39
Ballymena,6933,7,11,6,13,53,68,-15,39
Glentoran,6933,8,11,5,14,32,39,-7,38
Ards,6933,9,9,6,15,40,54,-14,33
Ballinamalla,6933,10,8,4,18,29,54,-25,28
Portadown,6933,11,7,5,18,27,49,-22,26
Crusaders,6934,1,16,10,4,61,32,29,58
Cliftonville,6934,2,16,5,9,55,34,21,53
Linfield,6934,3,13,12,5,52,28,24,51
Ballymena,6934,4,15,5,10,57,55,2,50
Coleraine,6934,5,13,9,8,41,36,5,48
Glenavon,6934,6,12,9,9,48,47,1,45
Dungannon,6934,7,9,11,10,51,46,5,38
Glentoran,6934,8,8,8,14,32,43,-11,32
Ards,6934,9,9,4,17,34,52,-18,31
Portadown,6934,10,7,6,17,19,47,-28,27
Ballinamalla,6934,11,6,3,21,25,55,-30,21
Crusaders,6935,1,17,8,5,53,27,26,59
Linfield,6935,2,14,11,5,60,30,30,53
Ballymena,6935,3,14,7,9,52,54,-2,49
Cliftonville,6935,4,13,6,11,48,42,6,45
Coleraine,6935,5,11,10,9,41,35,6,43
Glenavon,6935,6,9,12,9,41,45,-4,39
Glentoran,6935,7,10,7,13,37,46,-9,37
Dungannon,6935,8,8,9,13,47,50,-3,33
Portadown,6935,9,9,6,15,21,37,-16,33
Ballinamalla,6935,10,8,6,16,28,44,-16,30
Ards,6935,11,8,6,16,33,51,-18,30
Linfield,6936,1,17,9,4,65,30,35,60
Crusaders,6936,2,16,6,8,52,36,16,54
Glenavon,6936,3,14,10,6,53,43,10,52
Cliftonville,6936,4,14,6,10,50,47,3,48
Coleraine,6936,5,11,12,7,51,39,12,45
Dungannon,6936,6,10,10,10,49,46,3,40
Ballymena,6936,7,11,7,12,54,63,-9,40
Ards,6936,8,10,4,16,40,52,-12,34
Ballinamalla,6936,9,9,4,17,38,50,-12,31
Glentoran,6936,10,7,9,14,29,46,-17,30
Portadown,6936,11,4,7,19,22,51,-29,19
Cliftonville,6937,1,16,6,8,53,40,13,54
Ballymena,6937,2,16,5,9,69,59,10,53
Crusaders,6937,3,15,6,9,60,46,14,51
Coleraine,6937,4,13,11,6,51,33,18,50
Linfield,6937,5,14,7,9,56,37,19,49
Dungannon,6937,6,11,8,11,50,44,6,41
Glenavon,6937,7,9,12,9,37,39,-2,39
Ards,6937,8,11,6,13,41,45,-4,39
Ballinamalla,6937,9,9,5,16,31,51,-20,32
Glentoran,6937,10,6,9,15,35,54,-19,27
Portadown,6937,11,5,5,20,17,52,-35,20
Crusaders,6938,1,16,8,6,60,33,27,56
Ballymena,6938,2,15,5,10,55,54,1,50
Coleraine,6938,3,12,11,7,44,35,9,47
Glenavon,6938,4,12,11,7,48,42,6,47
Cliftonville,6938,5,13,7,10,48,38,10,46
Linfield,6938,6,12,8,10,51,35,16,44
Glentoran,6938,7,13,5,12,31,40,-9,44
Dungannon,6938,8,8,11,11,46,45,1,35
Ards,6938,9,8,8,14,39,52,-13,32
Ballinamalla,6938,10,8,5,17,32,54,-22,29
Portadown,6938,11,6,5,19,22,48,-26,23
Ballymena,6939,1,16,8,6,68,53,15,56
Crusaders,6939,2,16,5,9,52,37,15,53
Linfield,6939,3,12,12,6,61,38,23,48
Coleraine,6939,4,12,10,8,50,41,9,46
Cliftonville,6939,5,13,7,10,52,45,7,46
Glenavon,6939,6,11,10,9,45,52,-7,43
Glentoran,6939,7,11,8,11,36,45,-9,41
Ards,6939,8,12,3,15,48,54,-6,39
Dungannon,6939,9,8,11,11,50,43,7,35
Portadown,6939,10,5,8,17,23,49,-26,23
Ballinamalla,6939,11,5,6,19,26,54,-28,21
Linfield,6940,1,19,6,5,61,23,38,63
Cliftonville,6940,2,16,3,11,58,45,13,51
Crusaders,6940,3,12,13,5,48,30,18,49
Coleraine,6940,4,12,10,8,46,37,9,46
Ballymena,6940,5,12,7,11,56,59,-3,43
Dungannon,6940,6,10,11,9,52,45,7,41
Glentoran,6940,7,10,8,12,35,45,-10,38
Glenavon,6940,8,9,9,12,46,55,-9,36
Ards,6940,9,9,5,16,39,56,-17,32
Portadown,6940,10,7,7,16,29,49,-20,28
Ballinamalla,6940,11,7,5,18,32,58,-26,26
Crusaders,6941,1,17,6,7,57,40,17,57
Coleraine,6941,2,13,13,4,46,28,18,52
Ballymena,6941,3,14,6,10,53,62,-9,48
Cliftonville,6941,4,14,5,11,54,43,11,47
Linfield,6941,5,12,9,9,56,38,18,45
Glenavon,6941,6,11,11,8,45,41,4,44
Dungannon,6941,7,11,8,11,51,41,10,41
Glentoran,6941,8,10,5,15,33,43,-10,35
Portadown,6941,9,10,3,17,26,43,-17,33
Ballinamalla,6941,10,8,4,18,31,55,-24,28
Ards,6941,11,7,6,17,38,56,-18,27
Crusaders,6942,1,19,7,4,58,31,27,64
Linfield,6942,2,16,7,7,63,30,33,55
Cliftonville,6942,3,13,7,10,50,38,12,46
Ballymena,6942,4,13,7,10,59,63,-4,46
Dungannon,6942,5,11,7,12,51,41,10,40
Glenavon,6942,6,10,10,10,43,44,-1,40
Coleraine,6942,7,10,8,12,35,43,-8,38
Portadown,6942,8,10,4,16,33,47,-14,34
Glentoran,6942,9,9,7,14,24,45,-21,34
Ballinamalla,6942,10,8,6,16,29,50,-21,30
Ards,6942,11,7,8,15,40,53,-13,29
Linfield,6943,1,15,8,7,57,34,23,53
Cliftonville,6943,2,15,7,8,55,37,18,52
Coleraine,6943,3,14,10,6,49,31,18,52
Crusaders,6943,4,13,8,9,50,43,7,47
Glenavon,6943,5,12,11,7,47,40,7,47
Ards,6943,6,14,3,13,42,43,-1,45
Ballymena,6943,7,12,7,11,53,61,-8,43
Dungannon,6943,8,11,9,10,51,47,4,42
Glentoran,6943,9,6,8,16,32,50,-18,26
Ballinamalla,6943,10,6,6,18,29,51,-22,24
Portadown,6943,11,6,5,19,21,49,-28,23
Linfield,6944,1,15,9,6,60,30,30,54
Crusaders,6944,2,16,6,8,54,36,18,54
Cliftonville,6944,3,16,6,8,52,41,11,54
Ballymena,6944,4,14,5,11,55,57,-2,47
Dungannon,6944,5,11,8,11,51,45,6,41
Glenavon,6944,6,10,10,10,46,51,-5,40
Coleraine,6944,7,9,11,10,42,41,1,38
Ards,6944,8,11,5,14,40,44,-4,38
Ballinamalla,6944,9,8,7,15,33,54,-21,31
Portadown,6944,10,8,6,16,32,42,-10,30
Glentoran,6944,11,6,9,15,24,48,-24,27
Crusaders,6945,1,18,7,5,62,38,24,61
Linfield,6945,2,16,7,7,61,38,23,55
Ballymena,6945,3,16,5,9,57,51,6,53
Cliftonville,6945,4,15,4,11,49,36,13,49
Glenavon,6945,5,12,11,7,51,42,9,47
Coleraine,6945,6,11,11,8,40,31,9,44
Glentoran,6945,7,11,6,13,38,49,-11,39
Dungannon,6945,8,9,11,10,47,47,0,38
Ards,6945,9,7,5,18,38,61,-23,26
Portadown,6945,10,7,4,19,27,47,-20,25
Ballinamalla,6945,11,6,3,21,23,53,-30,21
Linfield,6946,1,15,9,6,58,30,28,54
Cliftonville,6946,2,16,4,10,54,42,12,52
Crusaders,6946,3,14,9,7,52,39,13,51
Glenavon,6946,4,11,12,7,50,47,3,45
Ballymena,6946,5,12,7,11,56,61,-5,43
Coleraine,6946,6,10,11,9,43,40,3,41
Glentoran,6946,7,11,7,12,31,38,-7,40
Dungannon,6946,8,9,10,11,49,42,7,37
Ards,6946,9,10,6,14,43,54,-11,36
Ballinamalla,6946,10,7,5,18,32,51,-19,26
Portadown,6946,11,6,8,16,28,52,-24,26
Glenavon,6947,1,15,12,3,49,35,14,57
Linfield,6947,2,16,8,6,63,36,27,56
Crusaders,6947,3,16,6,8,61,40,21,54
Cliftonville,6947,4,14,7,9,47,35,12,49
Dungannon,6947,5,12,9,9,46,38,8,45
Coleraine,6947,6,11,12,7,40,33,7,45
Ballymena,6947,7,11,8,11,55,57,-2,41
Glentoran,6947,8,10,5,15,41,45,-4,35
Ards,6947,9,7,8,15,35,56,-21,29
Ballinamalla,6947,10,6,5,19,23,53,-30,23
Portadown,6947,11,5,4,21,26,58,-32,19
Linfield,6948,1,17,9,4,60,28,32,60
Crusaders,6948,2,15,7,8,52,32,20,52
Cliftonville,6948,3,15,7,8,54,40,14,52
Glenavon,6948,4,12,13,5,48,44,4,49
Coleraine,6948,5,11,9,10,43,35,8,42
Ballymena,6948,6,12,6,12,53,61,-8,42
Dungannon,6948,7,10,10,10,51,39,12,40
Glentoran,6948,8,10,7,13,31,42,-11,37
Ards,6948,9,8,6,16,39,57,-18,30
Ballinamalla,6948,10,7,5,18,28,55,-27,26
Portadown,6948,11,5,7,18,18,44,-26,22
Crusaders,6949,1,18,6,6,50,24,26,60
Ballymena,6949,2,16,7,7,61,51,10,55
Cliftonville,6949,3,15,3,12,47,39,8,48
Linfield,6949,4,12,11,7,52,36,16,47
Coleraine,6949,5,12,11,7,49,40,9,47
Glenavon,6949,6,10,11,9,43,41,2,41
Dungannon,6949,7,11,7,12,54,44,10,40
Ballinamalla,6949,8,11,3,16,28,48,-20,36
Glentoran,6949,9,8,6,16,27,45,-18,30
Ards,6949,10,8,3,19,30,52,-22,27
Portadown,6949,11,6,8,16,22,43,-21,26
Ballymena,6950,1,17,7,6,70,51,19,58
Cliftonville,6950,2,16,6,8,55,38,17,54
Crusaders,6950,3,15,8,7,55,37,18,53
Linfield,6950,4,14,9,7,55,35,20,51
Glenavon,6950,5,13,8,9,51,44,7,47
Glentoran,6950,6,12,5,13,32,41,-9,41
Coleraine,6950,7,9,11,10,42,45,-3,38
Dungannon,6950,8,9,7,14,46,47,-1,34
Ards,6950,9,9,7,14,36,50,-14,34
Ballinamalla,6950,10,6,6,18,24,51,-27,24
Portadown,6950,11,5,6,19,17,44,-27,21
Cliftonville,6951,1,17,8,5,59,33,26,59
Crusaders,6951,2,16,8,6,57,31,26,56
Linfield,6951,3,14,10,6,57,31,26,52
Glenavon,6951,4,12,10,8,49,44,5,46
Ballymena,6951,5,13,5,12,45,53,-8,44
Glentoran,6951,6,12,5,13,32,40,-8,41
Coleraine,6951,7,9,11,10,41,41,0,38
Dungannon,6951,8,9,9,12,42,41,1,36
Ards,6951,9,8,6,16,36,51,-15,30
Portadown,6951,10,8,5,17,22,45,-23,29
Ballinamalla,6951,11,5,7,18,22,52,-30,22
Linfield,6952,1,17,9,4,62,24,38,60
Crusaders,6952,2,17,8,5,58,38,20,59
Ballymena,6952,3,14,5,11,60,55,5,47
Cliftonville,6952,4,12,9,9,49,47,2,45
Coleraine,6952,5,11,11,8,44,45,-1,44
Dungannon,6952,6,11,8,11,46,38,8,41
Glenavon,6952,7,9,11,10,44,46,-2,38
Portadown,6952,8,8,7,15,28,46,-18,31
Ballinamalla,6952,9,8,6,16,29,49,-20,30
Glentoran,6952,10,7,8,15,32,52,-20,29
Ards,6952,11,7,6,17,39,51,-12,27
Cliftonville,6953,1,17,6,7,60,38,22,57
Crusaders,6953,2,15,9,6,52,34,18,54
Linfield,6953,3,13,9,8,62,42,20,48
Coleraine,6953,4,12,12,6,51,41,10,48
Dungannon,6953,5,13,7,10,54,40,14,46
Ballymena,6953,6,12,6,12,59,64,-5,42
Glenavon,6953,7,9,12,9,42,44,-2,39
Ards,6953,8,10,4,16,37,52,-15,34
Portadown,6953,9,9,5,16,29,50,-21,32
Ballinamalla,6953,10,8,4,18,30,50,-20,28
Glentoran,6953,11,6,8,16,30,51,-21,26
Crusaders,6954,1,14,11,5,54,35,19,53
Cliftonville,6954,2,15,8,7,49,34,15,53
Coleraine,6954,3,14,10,6,41,31,10,52
Ballymena,6954,4,15,6,9,60,59,1,51
Glenavon,6954,5,11,11,8,56,47,9,44
Linfield,6954,6,11,8,11,57,38,19,41
Dungannon,6954,7,10,10,10,56,51,5,40
Glentoran,6954,8,9,11,10,34,38,-4,38
Ards,6954,9,8,4,18,32,52,-20,28
Portadown,6954,10,6,7,17,25,49,-24,25
Ballinamalla,6954,11,6,6,18,25,55,-30,24
Crusaders,6955,1,16,8,6,55,32,23,56
Cliftonville,6955,2,17,5,8,56,37,19,56
Linfield,6955,3,14,7,9,57,30,27,49
Ballymena,6955,4,14,5,11,62,58,4,47
Dungannon,6955,5,12,9,9,54,41,13,45
Coleraine,6955,6,12,9,9,39,36,3,45
Glentoran,6955,7,11,6,13,34,46,-12,39
Glenavon,6955,8,9,10,11,43,50,-7,37
Ards,6955,9,10,6,14,37,46,-9,36
Ballinamalla,6955,10,7,7,16,28,52,-24,28
Portadown,6955,11,5,4,21,22,59,-37,19
Crusaders,6956,1,17,9,4,57,31,26,60
Linfield,6956,2,15,10,5,63,29,34,55
Coleraine,6956,3,13,13,4,49,36,13,52
Ballymena,6956,4,14,9,7,54,54,0,51
Cliftonville,6956,5,14,7,9,50,44,6,49
Dungannon,6956,6,12,9,9,59,38,21,45
Glenavon,6956,7,8,8,14,37,49,-12,32
Glentoran,6956,8,7,7,16,37,54,-17,28
Portadown,6956,9,7,7,16,27,47,-20,28
Ards,6956,10,7,5,18,35,58,-23,26
Ballinamalla,6956,11,5,8,17,28,56,-28,23
Crusaders,6957,1,15,8,7,57,38,19,53
Linfield,6957,2,14,10,6,64,29,35,52
Glenavon,6957,3,13,12,5,53,44,9,51
Cliftonville,6957,4,15,5,10,56,42,14,50
Ballymena,6957,5,13,6,11,53,66,-13,45
Coleraine,6957,6,11,10,9,45,41,4,43
Dungannon,6957,7,10,10,10,51,46,5,40
Glentoran,6957,8,11,5,14,36,44,-8,38
Ards,6957,9,10,6,14,44,50,-6,36
Ballinamalla,6957,10,7,4,19,30,56,-26,25
Portadown,6957,11,5,6,19,21,54,-33,21
Linfield,6958,1,17,9,4,70,32,38,60
Crusaders,6958,2,16,7,7,58,41,17,55
Cliftonville,6958,3,15,4,11,60,48,12,49
Coleraine,6958,4,12,10,8,40,35,5,46
Dungannon,6958,5,11,11,8,56,43,13,44
Glenavon,6958,6,10,12,8,49,48,1,42
Ballymena,6958,7,12,4,14,54,67,-13,40
Portadown,6958,8,10,5,15,33,50,-17,35
Glentoran,6958,9,8,7,15,30,48,-18,31
Ards,6958,10,6,8,16,35,52,-17,26
Ballinamalla,6958,11,6,7,17,27,48,-21,25
Ballymena,6959,1,15,7,8,61,53,8,52
Linfield,6959,2,15,6,9,58,34,24,51
Crusaders,6959,3,14,9,7,49,32,17,51
Glenavon,6959,4,13,9,8,47,39,8,48
Coleraine,6959,5,12,9,9,52,40,12,45
Cliftonville,6959,6,13,5,12,44,41,3,44
Ards,6959,7,12,5,13,39,47,-8,41
Glentoran,6959,8,11,6,13,30,47,-17,39
Dungannon,6959,9,10,7,13,55,53,2,37
Portadown,6959,10,7,7,16,27,51,-24,28
Ballinamalla,6959,11,6,4,20,28,53,-25,22
Linfield,6960,1,16,11,3,61,28,33,59
Crusaders,6960,2,16,9,5,55,34,21,57
Cliftonville,6960,3,13,9,8,50,38,12,48
Ballymena,6960,4,13,9,8,57,54,3,48
Glentoran,6960,5,11,7,12,29,40,-11,40
Coleraine,6960,6,9,12,9,42,41,1,39
Glenavon,6960,7,10,9,11,46,51,-5,39
Dungannon,6960,8,8,12,10,42,41,1,36
Ards,6960,9,8,5,17,40,52,-12,29
Ballinamalla,6960,10,8,5,17,34,58,-24,29
Portadown,6960,11,7,4,19,24,43,-19,25
Cliftonville,6961,1,16,5,9,54,41,13,53
Crusaders,6961,2,13,10,7,61,41,20,49
Linfield,6961,3,13,8,9,53,41,12,47
Coleraine,6961,4,11,10,9,48,39,9,43
Dungannon,6961,5,10,10,10,50,41,9,40
Glenavon,6961,6,9,12,9,48,51,-3,39
Ballinamalla,6961,7,11,5,14,40,53,-13,38
Ballymena,6961,8,9,9,12,50,61,-11,36
Ards,6961,9,11,3,16,44,55,-11,36
Glentoran,6961,10,10,6,14,32,44,-12,36
Portadown,6961,11,10,6,14,28,41,-13,36
Linfield,6962,1,17,7,6,62,31,31,58
Cliftonville,6962,2,14,7,9,52,42,10,49
Glenavon,6962,3,13,10,7,50,42,8,49
Ballymena,6962,4,14,6,10,59,55,4,48
Crusaders,6962,5,12,9,9,44,33,11,45
Dungannon,6962,6,11,10,9,47,40,7,43
Coleraine,6962,7,11,10,9,44,43,1,43
Ards,6962,8,11,5,14,41,46,-5,38
Ballinamalla,6962,9,9,5,16,33,50,-17,32
Glentoran,6962,10,8,7,15,33,52,-19,31
Portadown,6962,11,4,6,20,22,53,-31,18
Crusaders,6963,1,15,8,7,54,40,14,53
Cliftonville,6963,2,15,7,8,50,29,21,52
Linfield,6963,3,13,12,5,62,31,31,51
Coleraine,6963,4,11,11,8,45,45,0,44
Glenavon,6963,5,11,11,8,50,52,-2,44
Ballymena,6963,6,12,7,11,53,55,-2,43
Dungannon,6963,7,9,11,10,47,37,10,38
Portadown,6963,8,9,8,13,28,43,-15,35
Ards,6963,9,9,5,16,41,54,-13,32
Ballinamalla,6963,10,7,8,15,29,50,-21,29
Glentoran,6963,11,6,8,16,23,46,-23,26
Linfield,6964,1,15,9,6,58,37,21,54
Crusaders,6964,2,16,6,8,57,38,19,54
Cliftonville,6964,3,14,7,9,59,41,18,49
Coleraine,6964,4,12,12,6,49,38,11,48
Glentoran,6964,5,14,6,10,37,38,-1,48
Glenavon,6964,6,12,9,9,47,42,5,45
Ballymena,6964,7,13,6,11,60,62,-2,45
Ards,6964,8,9,6,15,40,47,-7,33
Dungannon,6964,9,7,9,14,43,50,-7,30
Ballinamalla,6964,10,8,3,19,28,55,-27,27
Portadown,6964,11,5,7,18,23,53,-30,22
Linfield,6965,1,19,7,4,67,27,40,64
Crusaders,6965,2,17,9,4,57,30,27,60
Ballymena,6965,3,16,5,9,67,56,11,53
Cliftonville,6965,4,14,6,10,51,47,4,48
Glenavon,6965,5,11,11,8,41,42,-1,44
Coleraine,6965,6,9,12,9,41,43,-2,39
Dungannon,6965,7,10,7,13,51,47,4,37
Glentoran,6965,8,8,10,12,33,44,-11,34
Portadown,6965,9,6,7,17,25,49,-24,25
Ards,6965,10,6,6,18,31,54,-23,24
Ballinamalla,6965,11,6,6,18,23,48,-25,24
Crusaders,6966,1,16,9,5,58,34,24,57
Cliftonville,6966,2,14,8,8,54,44,10,50
Ballymena,6966,3,13,9,8,63,55,8,48
Linfield,6966,4,12,10,8,54,37,17,46
Glenavon,6966,5,11,13,6,47,40,7,46
Dungannon,6966,6,11,9,10,53,41,12,42
Coleraine,6966,7,9,11,10,35,46,-11,38
Ards,6966,8,8,8,14,35,45,-10,32
Glentoran,6966,9,7,9,14,27,45,-18,30
Portadown,6966,10,7,8,15,27,42,-15,29
Ballinamalla,6966,11,5,10,15,27,51,-24,25
Linfield,6967,1,16,8,6,57,25,32,56
Ballymena,6967,2,15,5,10,60,61,-1,50
Crusaders,6967,3,13,10,7,52,40,12,49
Coleraine,6967,4,12,11,7,43,36,7,47
Cliftonville,6967,5,13,5,12,48,40,8,44
Glenavon,6967,6,10,11,9,48,45,3,41
Dungannon,6967,7,10,9,11,52,48,4,39
Ards,6967,8,10,8,12,42,44,-2,38
Portadown,6967,9,11,5,14,29,44,-15,38
Glentoran,6967,10,9,7,14,35,48,-13,34
Ballinamalla,6967,11,4,5,21,19,54,-35,17
Crusaders,6968,1,17,8,5,64,39,25,59
Linfield,6968,2,15,9,6,61,28,33,54
Ballymena,6968,3,15,6,9,59,55,4,51
Cliftonville,6968,4,15,4,11,54,43,11,49
Dungannon,6968,5,11,10,9,53,45,8,43
Coleraine,6968,6,11,8,11,41,38,3,41
Glentoran,6968,7,11,6,13,32,44,-12,39
Glenavon,6968,8,9,9,12,38,50,-12,36
Ards,6968,9,8,6,16,34,49,-15,30
Portadown,6968,10,8,6,16,26,46,-20,30
Ballinamalla,6968,11,8,2,20,27,52,-25,26
Crusaders,6969,1,18,7,5,62,35,27,61
Ballymena,6969,2,14,7,9,53,55,-2,49
Linfield,6969,3,12,10,8,51,33,18,46
Glenavon,6969,4,12,10,8,46,46,0,46
Cliftonville,6969,5,13,6,11,49,38,11,45
Ards,6969,6,12,6,12,44,44,0,42
Coleraine,6969,7,10,11,9,45,39,6,41
Dungannon,6969,8,10,7,13,49,48,1,37
Glentoran,6969,9,9,9,12,32,43,-11,36
Ballinamalla,6969,10,8,3,19,32,54,-22,27
Portadown,6969,11,7,4,19,20,48,-28,25
Linfield,6970,1,17,8,5,56,25,31,59
Crusaders,6970,2,16,8,6,59,41,18,56
Glenavon,6970,3,13,9,8,52,47,5,48
Cliftonville,6970,4,13,7,10,55,44,11,46
Ballymena,6970,5,12,8,10,51,52,-1,44
Coleraine,6970,6,11,9,10,43,41,2,42
Glentoran,6970,7,10,11,9,32,36,-4,41
Ards,6970,8,9,6,15,41,47,-6,33
Dungannon,6970,9,7,11,12,45,46,-1,32
Ballinamalla,6970,10,8,3,19,27,54,-27,27
Portadown,6970,11,5,8,17,26,54,-28,23
Linfield,6971,1,18,8,4,68,27,41,62
Crusaders,6971,2,16,8,6,62,36,26,56
Cliftonville,6971,3,15,5,10,46,35,11,50
Glenavon,6971,4,13,9,8,51,46,5,48
Ballymena,6971,5,14,5,11,61,57,4,47
Coleraine,6971,6,11,13,6,46,42,4,46
Dungannon,6971,7,8,8,14,45,52,-7,32
Glentoran,6971,8,8,7,15,29,45,-16,31
Ballinamalla,6971,9,7,8,15,25,46,-21,29
Ards,6971,10,7,7,16,38,60,-22,28
Portadown,6971,11,6,6,18,25,50,-25,24
Crusaders,6972,1,18,7,5,53,30,23,61
Coleraine,6972,2,14,10,6,45,32,13,52
Cliftonville,6972,3,15,6,9,52,34,18,51
Ballymena,6972,4,14,4,12,57,58,-1,46
Linfield,6972,5,12,9,9,59,44,15,45
Glenavon,6972,6,10,9,11,41,40,1,39
Glentoran,6972,7,10,9,11,32,45,-13,39
Ards,6972,8,10,6,14,41,46,-5,36
Dungannon,6972,9,7,9,14,45,47,-2,30
Ballinamalla,6972,10,8,6,16,27,51,-24,30
Portadown,6972,11,7,5,18,33,58,-25,26
Crusaders,6973,1,17,7,6,55,32,23,58
Cliftonville,6973,2,16,5,9,53,38,15,53
Ballymena,6973,3,15,5,10,59,56,3,50
Linfield,6973,4,13,9,8,56,37,19,48
Glenavon,6973,5,13,9,8,47,38,9,48
Coleraine,6973,6,12,11,7,54,46,8,47
Dungannon,6973,7,10,10,10,51,42,9,40
Ballinamalla,6973,8,8,7,15,31,47,-16,31
Ards,6973,9,7,7,16,36,52,-16,28
Glentoran,6973,10,7,6,17,27,57,-30,27
Portadown,6973,11,6,6,18,22,46,-24,24
Crusaders,6974,1,17,7,6,61,35,26,58
Cliftonville,6974,2,17,4,9,53,38,15,55
Linfield,6974,3,14,8,8,55,37,18,50
Ballymena,6974,4,14,8,8,61,53,8,50
Glenavon,6974,5,12,9,9,46,48,-2,45
Coleraine,6974,6,10,10,10,39,40,-1,40
Ards,6974,7,9,8,13,38,44,-6,35
Glentoran,6974,8,10,5,15,32,44,-12,35
Dungannon,6974,9,8,9,13,42,47,-5,33
Ballinamalla,6974,10,7,7,16,31,51,-20,28
Portadown,6974,11,8,3,19,30,51,-21,27
Crusaders,6975,1,16,7,7,61,35,26,55
Cliftonville,6975,2,15,4,11,53,43,10,49
Coleraine,6975,3,12,10,8,49,44,5,46
Linfield,6975,4,12,9,9,54,36,18,45
Ballymena,6975,5,13,6,11,59,60,-1,45
Glenavon,6975,6,12,9,9,45,48,-3,45
Glentoran,6975,7,12,7,11,33,41,-8,43
Dungannon,6975,8,9,12,9,50,39,11,39
Ards,6975,9,9,7,14,37,50,-13,34
Portadown,6975,10,6,9,15,23,40,-17,27
Ballinamalla,6975,11,7,4,19,30,58,-28,25
Crusaders,6976,1,15,8,7,59,39,20,53
Ballymena,6976,2,15,8,7,54,47,7,53
Linfield,6976,3,13,11,6,57,30,27,50
Cliftonville,6976,4,14,5,11,49,46,3,47
Glenavon,6976,5,11,10,9,45,42,3,43
Dungannon,6976,6,12,6,12,48,44,4,42
Glentoran,6976,7,11,8,11,31,37,-6,41
Coleraine,6976,8,9,9,12,36,40,-4,36
Ards,6976,9,9,8,13,30,39,-9,35
Ballinamalla,6976,10,10,2,18,32,49,-17,32
Portadown,6976,11,7,3,20,25,53,-28,24
Glenavon,6977,1,16,9,5,61,40,21,57
Linfield,6977,2,14,11,5,55,28,27,53
Crusaders,6977,3,14,11,5,56,36,20,53
Cliftonville,6977,4,15,5,10,40,33,7,50
Ballymena,6977,5,14,5,11,57,58,-1,47
Coleraine,6977,6,10,12,8,41,36,5,42
Dungannon,6977,7,10,7,13,51,49,2,37
Glentoran,6977,8,8,7,15,29,46,-17,31
Ballinamalla,6977,9,9,4,17,34,53,-19,31
Ards,6977,10,7,7,16,32,47,-15,28
Portadown,6977,11,6,6,18,23,53,-30,24
Crusaders,6978,1,17,8,5,59,38,21,59
Ballymena,6978,2,15,7,8,55,48,7,52
Coleraine,6978,3,12,14,4,48,34,14,50
Linfield,6978,4,12,11,7,55,33,22,47
Cliftonville,6978,5,13,6,11,60,49,11,45
Glenavon,6978,6,9,13,8,43,44,-1,40
Ards,6978,7,9,6,15,38,48,-10,33
Glentoran,6978,8,8,9,13,26,42,-16,33
Dungannon,6978,9,6,13,11,48,46,2,31
Portadown,6978,10,7,8,15,24,49,-25,29
Ballinamalla,6978,11,7,5,18,26,51,-25,26
Cliftonville,6979,1,17,3,10,58,41,17,54
Crusaders,6979,2,15,7,8,53,33,20,52
Linfield,6979,3,14,9,7,59,32,27,51
Coleraine,6979,4,13,9,8,47,43,4,48
Ballymena,6979,5,13,5,12,53,57,-4,44
Dungannon,6979,6,11,10,9,51,39,12,43
Glenavon,6979,7,10,11,9,44,46,-2,41
Ards,6979,8,10,4,16,42,55,-13,34
Glentoran,6979,9,8,8,14,28,48,-20,32
Ballinamalla,6979,10,9,4,17,32,50,-18,31
Portadown,6979,11,8,4,18,25,48,-23,28
Crusaders,6980,1,17,9,4,60,35,25,60
Linfield,6980,2,17,8,5,57,31,26,59
Cliftonville,6980,3,14,6,10,52,39,13,48
Ballymena,6980,4,13,6,11,50,53,-3,45
Dungannon,6980,5,10,11,9,53,40,13,41
Coleraine,6980,6,10,11,9,39,38,1,41
Glenavon,6980,7,9,10,11,38,41,-3,37
Ards,6980,8,10,7,13,38,44,-6,37
Ballinamalla,6980,9,9,5,16,32,53,-21,32
Glentoran,6980,10,7,8,15,25,41,-16,29
Portadown,6980,11,6,5,19,19,48,-29,23
Crusaders,6981,1,19,4,7,62,31,31,61
Linfield,6981,2,15,8,7,53,29,24,53
Cliftonville,6981,3,15,5,10,53,38,15,50
Ballymena,6981,4,14,6,10,52,53,-1,48
Dungannon,6981,5,12,7,11,47,42,5,43
Coleraine,6981,6,10,12,8,40,39,1,42
Glenavon,6981,7,10,11,9,40,40,0,41
Glentoran,6981,8,12,5,13,34,41,-7,41
Ards,6981,9,7,7,16,30,48,-18,28
Ballinamalla,6981,10,7,5,18,30,57,-27,26
Portadown,6981,11,5,8,17,21,44,-23,23
Crusaders,6982,1,15,9,6,49,31,18,54
Cliftonville,6982,2,16,4,10,56,40,16,52
Glenavon,6982,3,12,14,4,55,42,13,50
Linfield,6982,4,12,8,10,52,37,15,44
Ballymena,6982,5,12,6,12,57,63,-6,42
Coleraine,6982,6,9,12,9,40,34,6,39
Dungannon,6982,7,9,10,11,44,46,-2,37
Glentoran,6982,8,9,8,13,34,47,-13,35
Portadown,6982,9,7,12,11,30,42,-12,33
Ards,6982,10,9,5,16,35,49,-14,32
Ballinamalla,6982,11,8,6,16,25,46,-21,30
Linfield,6983,1,17,9,4,62,28,34,60
Crusaders,6983,2,18,5,7,57,37,20,59
Cliftonville,6983,3,15,4,11,49,36,13,49
Ballymena,6983,4,13,7,10,53,56,-3,46
Coleraine,6983,5,11,10,9,44,41,3,43
Glenavon,6983,6,11,8,11,42,44,-2,41
Dungannon,6983,7,9,11,10,47,43,4,38
Glentoran,6983,8,9,8,13,33,47,-14,35
Ballinamalla,6983,9,9,5,16,29,48,-19,32
Portadown,6983,10,8,4,18,30,46,-16,28
Ards,6983,11,7,5,18,38,58,-20,26
Ballymena,6984,1,17,5,8,57,52,5,56
Crusaders,6984,2,15,7,8,51,35,16,52
Linfield,6984,3,13,9,8,55,34,21,48
Glenavon,6984,4,12,9,9,48,44,4,45
Coleraine,6984,5,12,9,9,41,38,3,45
Cliftonville,6984,6,12,6,12,49,45,4,42
Glentoran,6984,7,12,5,13,38,41,-3,41
Ballinamalla,6984,8,11,3,16,34,48,-14,36
Dungannon,6984,9,8,9,13,44,44,0,33
Ards,6984,10,8,7,15,37,50,-13,31
Portadown,6984,11,8,5,17,26,49,-23,29
Glenavon,6985,1,17,7,6,58,41,17,58
Linfield,6985,2,14,10,6,55,30,25,52
Crusaders,6985,3,15,6,9,61,44,17,51
Ballymena,6985,4,13,9,8,56,50,6,48
Cliftonville,6985,5,13,7,10,51,43,8,46
Coleraine,6985,6,12,9,9,42,40,2,45
Glentoran,6985,7,8,9,13,28,38,-10,33
Ballinamalla,6985,8,10,3,17,27,46,-19,33
Dungannon,6985,9,8,8,14,45,53,-8,32
Ards,6985,10,8,6,16,36,54,-18,30
Portadown,6985,11,6,8,16,24,44,-20,26
Linfield,6986,1,16,10,4,67,31,36,58
Crusaders,6986,2,16,10,4,55,32,23,58
Cliftonville,6986,3,15,5,10,55,37,18,50
Glenavon,6986,4,13,10,7,45,41,4,49
Dungannon,6986,5,11,9,10,53,41,12,42
Ballymena,6986,6,12,6,12,54,60,-6,42
Coleraine,6986,7,9,10,11,38,39,-1,37
Glentoran,6986,8,7,11,12,28,41,-13,32
Ards,6986,9,7,9,14,33,47,-14,30
Ballinamalla,6986,10,8,5,17,29,54,-25,29
Portadown,6986,11,7,3,20,19,53,-34,24
Crusaders,6987,1,18,8,4,59,29,30,62
Linfield,6987,2,15,10,5,60,28,32,55
Cliftonville,6987,3,15,6,9,53,35,18,51
Ballymena,6987,4,15,6,9,57,56,1,51
Glenavon,6987,5,11,12,7,49,45,4,45
Coleraine,6987,6,11,10,9,39,34,5,43
Dungannon,6987,7,10,10,10,55,46,9,40
Ards,6987,8,8,8,14,35,48,-13,32
Glentoran,6987,9,7,9,14,28,49,-21,30
Ballinamalla,6987,10,6,7,17,29,50,-21,25
Portadown,6987,11,4,4,22,16,60,-44,16
Crusaders,6988,1,19,6,5,60,30,30,63
Cliftonville,6988,2,18,2,10,61,48,13,56
Linfield,6988,3,14,10,6,61,31,30,52
Glenavon,6988,4,14,10,6,55,46,9,52
Coleraine,6988,5,11,13,6,49,37,12,46
Ballymena,6988,6,12,6,12,53,61,-8,42
Dungannon,6988,7,8,10,12,44,45,-1,34
Ards,6988,8,9,4,17,34,49,-15,31
Ballinamalla,6988,9,9,4,17,32,54,-22,31
Portadown,6988,10,7,6,17,26,51,-25,27
Glentoran,6988,11,5,7,18,26,49,-23,22
Crusaders,6989,1,16,11,3,60,30,30,59
Cliftonville,6989,2,15,6,9,55,35,20,51
Linfield,6989,3,13,11,6,61,34,27,50
Ballymena,6989,4,15,5,10,65,63,2,50
Coleraine,6989,5,11,12,7,44,41,3,45
Glenavon,6989,6,10,11,9,48,48,0,41
Dungannon,6989,7,9,11,10,52,51,1,38
Glentoran,6989,8,9,7,14,28,41,-13,34
Ards,6989,9,9,5,16,40,51,-11,32
Ballinamalla,6989,10,8,3,19,25,54,-29,27
Portadown,6989,11,6,6,18,26,56,-30,24
Crusaders,6990,1,15,10,5,57,35,22,55
Linfield,6990,2,15,9,6,59,31,28,54
Cliftonville,6990,3,16,5,9,57,43,14,53
Glenavon,6990,4,14,9,7,55,43,12,51
Coleraine,6990,5,12,10,8,44,39,5,46
Ballymena,6990,6,12,6,12,62,60,2,42
Glentoran,6990,7,10,9,11,30,36,-6,39
Ards,6990,8,10,4,16,37,49,-12,34
Dungannon,6990,9,7,10,13,41,48,-7,31
Portadown,6990,10,8,6,16,23,47,-24,30
Ballinamalla,6990,11,5,4,21,29,63,-34,19
Linfield,6991,1,16,8,6,60,30,30,56
Crusaders,6991,2,15,9,6,58,39,19,54
Coleraine,6991,3,13,9,8,37,30,7,48
Glenavon,6991,4,12,12,6,50,45,5,48
Cliftonville,6991,5,14,5,11,51,41,10,47
Ballymena,6991,6,13,8,9,49,51,-2,47
Glentoran,6991,7,10,6,14,31,44,-13,36
Dungannon,6991,8,9,7,14,46,50,-4,34
Ards,6991,9,9,6,15,41,49,-8,33
Ballinamalla,6991,10,6,8,16,31,51,-20,26
Portadown,6991,11,6,6,18,23,47,-24,24
Crusaders,6992,1,16,9,5,54,32,22,57
Dungannon,6992,2,15,7,8,61,39,22,52
Ballymena,6992,3,15,7,8,56,54,2,52
Cliftonville,6992,4,14,6,10,49,36,13,48
Linfield,6992,5,12,10,8,50,38,12,46
Ards,6992,6,14,2,14,47,45,2,44
Coleraine,6992,7,11,9,10,39,41,-2,42
Glenavon,6992,8,9,9,12,42,44,-2,36
Glentoran,6992,9,8,8,14,34,45,-11,32
Ballinamalla,6992,10,6,7,17,24,51,-27,25
Portadown,6992,11,7,2,21,17,48,-31,23
Crusaders,6993,1,15,8,7,53,35,18,53
Linfield,6993,2,14,8,8,64,39,25,50
Cliftonville,6993,3,15,5,10,57,43,14,50
Coleraine,6993,4,13,11,6,46,38,8,50
Ballymena,6993,5,14,8,8,53,53,0,50
Dungannon,6993,6,13,7,10,54,43,11,46
Glenavon,6993,7,10,9,11,46,45,1,39
Glentoran,6993,8,8,9,13,28,44,-16,33
Ards,6993,9,8,6,16,39,49,-10,30
Ballinamalla,6993,10,9,3,18,37,57,-20,30
Portadown,6993,11,7,4,19,25,56,-31,25
Cliftonville,6994,1,16,5,9,61,38,23,53
Crusaders,6994,2,16,5,9,55,43,12,53
Ballymena,6994,3,15,5,10,59,65,-6,50
Glenavon,6994,4,12,13,5,56,39,17,49
Linfield,6994,5,13,9,8,65,38,27,48
Coleraine,6994,6,12,9,9,47,44,3,45
Dungannon,6994,7,9,12,9,54,48,6,39
Ballinamalla,6994,8,9,5,16,31,53,-22,32
Ards,6994,9,9,4,17,36,51,-15,31
Glentoran,6994,10,7,7,16,29,51,-22,28
Portadown,6994,11,6,8,16,32,55,-23,26
Crusaders,6995,1,18,7,5,56,32,24,61
Linfield,6995,2,16,9,5,62,37,25,57
Coleraine,6995,3,14,12,4,51,33,18,54
Cliftonville,6995,4,15,5,10,50,39,11,50
Ballymena,6995,5,12,6,12,52,60,-8,42
Dungannon,6995,6,10,10,10,45,37,8,40
Glenavon,6995,7,9,10,11,40,47,-7,37
Ards,6995,8,9,7,14,44,52,-8,34
Ballinamalla,6995,9,7,8,15,33,50,-17,29
Glentoran,6995,10,6,8,16,28,49,-21,26
Portadown,6995,11,6,4,20,18,43,-25,22
Crusaders,6996,1,17,7,6,50,35,15,58
Linfield,6996,2,16,9,5,60,32,28,57
Cliftonville,6996,3,16,5,9,60,37,23,53
Ballymena,6996,4,14,6,10,57,58,-1,48
Coleraine,6996,5,9,14,7,40,35,5,41
Dungannon,6996,6,10,6,14,48,46,2,36
Glentoran,6996,7,8,10,12,30,40,-10,34
Glenavon,6996,8,7,12,11,41,49,-8,33
Portadown,6996,9,9,5,16,27,44,-17,32
Ballinamalla,6996,10,8,7,15,35,57,-22,31
Ards,6996,11,7,7,16,40,55,-15,28
Linfield,6997,1,13,10,7,55,32,23,49
Ballymena,6997,2,14,6,10,58,55,3,48
Crusaders,6997,3,11,13,6,50,37,13,46
Glenavon,6997,4,11,13,6,52,42,10,46
Coleraine,6997,5,11,12,7,38,35,3,45
Cliftonville,6997,6,13,5,12,43,35,8,44
Glentoran,6997,7,10,8,12,30,38,-8,38
Dungannon,6997,8,8,11,11,54,50,4,35
Portadown,6997,9,9,7,14,34,50,-16,34
Ards,6997,10,7,9,14,35,54,-19,30
Ballinamalla,6997,11,8,6,16,27,48,-21,30
Crusaders,6998,1,18,6,6,54,32,22,60
Linfield,6998,2,16,7,7,60,32,28,55
Cliftonville,6998,3,15,5,10,53,40,13,50
Coleraine,6998,4,11,14,5,40,33,7,47
Dungannon,6998,5,11,10,9,50,41,9,43
Ballymena,6998,6,11,10,9,53,57,-4,43
Glenavon,6998,7,10,12,8,43,40,3,42
Ballinamalla,6998,8,10,4,16,39,54,-15,34
Ards,6998,9,8,5,17,40,55,-15,29
Glentoran,6998,10,7,8,15,26,48,-22,29
Portadown,6998,11,4,7,19,23,49,-26,19
Cliftonville,6999,1,17,7,6,67,42,25,58
Crusaders,6999,2,17,7,6,54,37,17,58
Glenavon,6999,3,12,12,6,48,38,10,48
Ballymena,6999,4,14,6,10,61,58,3,48
Dungannon,6999,5,12,10,8,57,43,14,46
Linfield,6999,6,12,9,9,51,32,19,45
Coleraine,6999,7,8,12,10,36,42,-6,36
Ards,6999,8,10,3,17,41,57,-16,33
Glentoran,6999,9,8,7,15,28,49,-21,31
Ballinamalla,6999,10,9,3,18,36,52,-16,30
Portadown,6999,11,6,4,20,24,53,-29,22
Crusaders,7000,1,17,6,7,55,39,16,57
Linfield,7000,2,16,7,7,60,36,24,55
Cliftonville,7000,3,16,5,9,47,33,14,53
Coleraine,7000,4,13,8,9,51,38,13,47
Glenavon,7000,5,11,10,9,48,48,0,43
Ballymena,7000,6,11,8,11,56,59,-3,41
Dungannon,7000,7,9,13,8,48,37,11,40
Glentoran,7000,8,9,7,14,30,50,-20,34
Ards,7000,9,8,8,14,37,48,-11,32
Portadown,7000,10,7,7,16,25,45,-20,28
Ballinamalla,7000,11,5,7,18,27,51,-24,22
Crusaders,7001,1,17,9,4,57,29,28,60
Linfield,7001,2,14,11,5,56,28,28,53
Cliftonville,7001,3,15,5,10,56,44,12,50
Ballymena,7001,4,14,7,9,57,50,7,49
Coleraine,7001,5,10,12,8,39,37,2,42
Glenavon,7001,6,10,12,8,46,45,1,42
Dungannon,7001,7,10,11,9,49,42,7,41
Glentoran,7001,8,7,11,12,29,49,-20,32
Ards,7001,9,8,7,15,41,52,-11,31
Ballinamalla,7001,10,8,4,18,26,54,-28,28
Portadown,7001,11,5,5,20,26,52,-26,20
Cliftonville,7002,1,18,4,8,60,37,23,58
Linfield,7002,2,15,9,6,61,33,28,54
Crusaders,7002,3,13,8,9,55,44,11,47
Ballymena,7002,4,13,8,9,57,56,1,47
Dungannon,7002,5,11,10,9,57,47,10,43
Glenavon,7002,6,11,10,9,45,42,3,43
Coleraine,7002,7,9,14,7,45,40,5,41
Ards,7002,8,9,9,12,41,47,-6,36
Ballinamalla,7002,9,9,5,16,34,54,-20,32
Glentoran,7002,10,7,8,15,28,47,-19,29
Portadown,7002,11,6,3,21,20,56,-36,21
Crusaders,7003,1,19,6,5,63,37,26,63
Linfield,7003,2,16,9,5,67,30,37,57
Ballymena,7003,3,17,4,9,62,56,6,55
Coleraine,7003,4,12,9,9,43,40,3,45
Dungannon,7003,5,10,11,9,51,41,10,41
Cliftonville,7003,6,12,5,13,48,45,3,41
Glenavon,7003,7,10,10,10,45,49,-4,40
Ards,7003,8,8,6,16,31,47,-16,30
Ballinamalla,7003,9,9,3,18,30,48,-18,30
Glentoran,7003,10,7,9,14,23,45,-22,30
Portadown,7003,11,6,6,18,23,48,-25,24
Crusaders,7004,1,18,6,6,61,32,29,60
Cliftonville,7004,2,16,5,9,51,39,12,53
Linfield,7004,3,13,12,5,67,36,31,51
Ballymena,7004,4,15,5,10,59,60,-1,50
Glenavon,7004,5,11,9,10,50,45,5,42
Coleraine,7004,6,11,9,10,43,40,3,42
Dungannon,7004,7,8,12,10,44,41,3,36
Glentoran,7004,8,9,9,12,27,41,-14,36
Portadown,7004,9,8,7,15,30,51,-21,31
Ards,7004,10,9,3,18,36,55,-19,30
Ballinamalla,7004,11,6,5,19,28,56,-28,23
Linfield,7005,1,16,7,7,61,33,28,55
Crusaders,7005,2,16,6,8,57,40,17,54
Cliftonville,7005,3,16,4,10,57,42,15,52
Glenavon,7005,4,13,9,8,47,42,5,48
Coleraine,7005,5,12,10,8,45,40,5,46
Ballymena,7005,6,11,8,11,51,59,-8,41
Ards,7005,7,11,4,15,39,49,-10,37
Dungannon,7005,8,8,10,12,44,41,3,34
Glentoran,7005,9,8,8,14,27,38,-11,32
Ballinamalla,7005,10,9,3,18,31,49,-18,30
Portadown,7005,11,7,7,16,27,53,-26,28
Ballymena,7006,1,16,6,8,58,52,6,54
Cliftonville,7006,2,16,5,9,52,46,6,53
Linfield,7006,3,13,12,5,60,33,27,51
Crusaders,7006,4,14,8,8,49,33,16,50
Dungannon,7006,5,12,7,11,58,43,15,43
Glenavon,7006,6,11,9,10,40,38,2,42
Ards,7006,7,13,3,14,46,49,-3,42
Coleraine,7006,8,8,11,11,37,42,-5,35
Glentoran,7006,9,8,7,15,28,48,-20,31
Ballinamalla,7006,10,8,6,16,28,49,-21,30
Portadown,7006,11,4,10,16,22,45,-23,22
Crusaders,7007,1,18,7,5,61,37,24,61
Cliftonville,7007,2,17,4,9,56,37,19,55
Linfield,7007,3,14,8,8,59,37,22,50
Glenavon,7007,4,13,10,7,56,45,11,49
Ballymena,7007,5,14,6,10,61,59,2,48
Dungannon,7007,6,11,8,11,50,46,4,41
Glentoran,7007,7,10,9,11,34,40,-6,39
Coleraine,7007,8,9,10,11,42,52,-10,37
Ards,7007,9,9,6,15,38,52,-14,33
Ballinamalla,7007,10,5,7,18,26,50,-24,22
Portadown,7007,11,5,5,20,28,56,-28,20
Cliftonville,7008,1,20,3,7,74,35,39,63
Linfield,7008,2,17,9,4,55,22,33,60
Crusaders,7008,3,16,6,8,61,41,20,54
Dungannon,7008,4,12,8,10,54,46,8,44
Ballymena,7008,5,11,9,10,53,66,-13,42
Glenavon,7008,6,10,9,11,46,46,0,39
Coleraine,7008,7,7,13,10,37,42,-5,34
Ards,7008,8,9,7,14,38,47,-9,34
Ballinamalla,7008,9,10,3,17,33,56,-23,33
Glentoran,7008,10,8,5,17,24,45,-21,29
Portadown,7008,11,6,6,18,19,48,-29,24
Crusaders,7009,1,18,7,5,64,35,29,61
Linfield,7009,2,15,9,6,61,31,30,54
Ballymena,7009,3,15,6,9,67,61,6,51
Cliftonville,7009,4,13,5,12,50,44,6,44
Coleraine,7009,5,11,10,9,41,40,1,43
Glenavon,7009,6,10,11,9,52,50,2,41
Dungannon,7009,7,9,10,11,51,50,1,37
Ards,7009,8,10,4,16,41,52,-11,34
Glentoran,7009,9,9,7,14,29,47,-18,34
Ballinamalla,7009,10,11,1,18,33,53,-20,34
Portadown,7009,11,7,4,19,24,50,-26,25
Crusaders,7010,1,18,9,3,59,31,28,63
Linfield,7010,2,15,9,6,59,29,30,54
Cliftonville,7010,3,15,5,10,51,33,18,50
Glenavon,7010,4,11,12,7,44,42,2,45
Coleraine,7010,5,11,8,11,36,38,-2,41
Ballymena,7010,6,11,6,13,51,63,-12,39
Dungannon,7010,7,9,10,11,47,43,4,37
Glentoran,7010,8,10,6,14,31,47,-16,36
Ards,7010,9,9,6,15,29,40,-11,33
Ballinamalla,7010,10,8,6,16,34,52,-18,30
Portadown,7010,11,7,5,18,23,46,-23,26
Crusaders,7011,1,17,10,3,59,31,28,61
Linfield,7011,2,16,9,5,65,27,38,57
Cliftonville,7011,3,16,5,9,50,35,15,53
Coleraine,7011,4,13,9,8,38,37,1,48
Glenavon,7011,5,11,11,8,49,47,2,44
Ballymena,7011,6,12,6,12,57,62,-5,42
Dungannon,7011,7,9,10,11,51,44,7,37
Portadown,7011,8,9,5,16,29,42,-13,32
Glentoran,7011,9,8,6,16,29,50,-21,30
Ards,7011,10,9,3,18,34,57,-23,30
Ballinamalla,7011,11,5,6,19,30,59,-29,21
Crusaders,7012,1,16,7,7,55,40,15,55
Cliftonville,7012,2,15,6,9,54,37,17,51
Linfield,7012,3,14,8,8,57,33,24,50
Dungannon,7012,4,12,10,8,55,45,10,46
Coleraine,7012,5,12,9,9,52,49,3,45
Glenavon,7012,6,12,9,9,46,44,2,45
Ballymena,7012,7,12,8,10,63,60,3,44
Ards,7012,8,12,6,12,40,40,0,42
Glentoran,7012,9,7,9,14,25,41,-16,30
Ballinamalla,7012,10,9,1,20,27,56,-29,28
Portadown,7012,11,5,5,20,22,51,-29,20
Linfield,7013,1,18,8,4,67,29,38,62
Crusaders,7013,2,18,8,4,61,32,29,62
Cliftonville,7013,3,15,3,12,54,44,10,48
Coleraine,7013,4,11,11,8,40,40,0,44
Glenavon,7013,5,9,14,7,45,43,2,41
Ballymena,7013,6,10,8,12,51,69,-18,38
Dungannon,7013,7,9,7,14,48,50,-2,34
Portadown,7013,8,10,4,16,30,42,-12,34
Glentoran,7013,9,7,10,13,35,49,-14,31
Ards,7013,10,8,6,16,37,50,-13,30
Ballinamalla,7013,11,8,5,17,30,50,-20,29
Ballymena,7014,1,16,8,6,62,47,15,56
Crusaders,7014,2,16,7,7,66,47,19,55
Linfield,7014,3,14,11,5,61,30,31,53
Coleraine,7014,4,14,8,8,45,36,9,50
Cliftonville,7014,5,13,6,11,50,42,8,45
Glenavon,7014,6,10,10,10,40,44,-4,40
Dungannon,7014,7,10,8,12,51,46,5,38
Ballinamalla,7014,8,9,6,15,32,50,-18,33
Ards,7014,9,9,5,16,33,47,-14,32
Glentoran,7014,10,7,9,14,31,53,-22,30
Portadown,7014,11,7,2,21,22,51,-29,23
Crusaders,7015,1,20,5,5,56,34,22,65
Linfield,7015,2,16,10,4,65,31,34,58
Cliftonville,7015,3,13,6,11,51,40,11,45
Ballymena,7015,4,13,6,11,55,62,-7,45
Glenavon,7015,5,11,10,9,52,45,7,43
Coleraine,7015,6,11,10,9,46,42,4,43
Dungannon,7015,7,9,10,11,50,42,8,37
Glentoran,7015,8,10,6,14,32,45,-13,36
Ards,7015,9,9,7,14,38,50,-12,34
Portadown,7015,10,7,6,17,28,54,-26,27
Ballinamalla,7015,11,7,2,21,33,61,-28,23
Ballymena,7016,1,16,6,8,63,52,11,54
Linfield,7016,2,14,10,6,60,33,27,52
Crusaders,7016,3,14,10,6,49,34,15,52
Cliftonville,7016,4,14,6,10,55,43,12,48
Coleraine,7016,5,12,11,7,47,38,9,47
Dungannon,7016,6,11,8,11,48,43,5,41
Glenavon,7016,7,8,12,10,41,48,-7,36
Glentoran,7016,8,9,7,14,28,41,-13,34
Ballinamalla,7016,9,10,3,17,27,43,-16,33
Ards,7016,10,8,5,17,34,60,-26,29
Portadown,7016,11,7,6,17,27,44,-17,27
Crusaders,7017,1,16,9,5,57,37,20,57
Cliftonville,7017,2,15,7,8,60,36,24,52
Linfield,7017,3,14,7,9,47,30,17,49
Dungannon,7017,4,13,8,9,54,42,12,47
Ballymena,7017,5,12,10,8,52,54,-2,46
Glenavon,7017,6,11,10,9,46,45,1,43
Coleraine,7017,7,10,10,10,41,44,-3,40
Glentoran,7017,8,10,9,11,35,42,-7,39
Ards,7017,9,10,6,14,38,45,-7,36
Portadown,7017,10,8,4,18,24,42,-18,28
Ballinamalla,7017,11,5,2,23,22,59,-37,17
Crusaders,7018,1,19,7,4,62,32,30,64
Cliftonville,7018,2,18,2,10,48,37,11,56
Glenavon,7018,3,12,10,8,53,47,6,46
Coleraine,7018,4,11,11,8,47,42,5,44
Linfield,7018,5,12,7,11,56,40,16,43
Ballymena,7018,6,9,11,10,55,64,-9,38
Dungannon,7018,7,8,11,11,50,43,7,35
Ards,7018,8,9,7,14,41,48,-7,34
Portadown,7018,9,9,5,16,25,52,-27,32
Glentoran,7018,10,7,10,13,31,43,-12,31
Ballinamalla,7018,11,6,9,15,31,51,-20,27
Cliftonville,7019,1,18,6,6,58,29,29,60
Linfield,7019,2,16,8,6,57,30,27,56
Ballymena,7019,3,16,6,8,68,54,14,54
Crusaders,7019,4,14,9,7,52,38,14,51
Coleraine,7019,5,13,8,9,41,37,4,47
Glenavon,7019,6,12,8,10,47,46,1,44
Ballinamalla,7019,7,11,4,15,38,53,-15,37
Dungannon,7019,8,9,9,12,48,45,3,36
Ards,7019,9,8,5,17,33,53,-20,29
Glentoran,7019,10,6,6,18,23,50,-27,24
Portadown,7019,11,6,3,21,25,55,-30,21
Linfield,7020,1,17,7,6,63,27,36,58
Crusaders,7020,2,15,10,5,55,33,22,55
Cliftonville,7020,3,14,8,8,54,42,12,50
Ballinamalla,7020,4,15,2,13,41,45,-4,47
Glenavon,7020,5,12,10,8,46,44,2,46
Ballymena,7020,6,12,6,12,50,63,-13,42
Coleraine,7020,7,10,9,11,40,41,-1,39
Dungannon,7020,8,9,9,12,50,45,5,36
Ards,7020,9,9,3,18,34,53,-19,30
Glentoran,7020,10,8,6,16,29,48,-19,30
Portadown,7020,11,7,4,19,26,47,-21,25
Crusaders,7021,1,16,9,5,59,37,22,57
Cliftonville,7021,2,15,5,10,50,43,7,50
Linfield,7021,3,13,10,7,60,38,22,49
Ballymena,7021,4,12,9,9,55,59,-4,45
Glenavon,7021,5,11,10,9,49,42,7,43
Coleraine,7021,6,9,12,9,38,40,-2,39
Ards,7021,7,11,6,13,40,45,-5,39
Glentoran,7021,8,9,10,11,31,41,-10,37
Dungannon,7021,9,9,8,13,47,45,2,35
Ballinamalla,7021,10,9,4,17,32,51,-19,31
Portadown,7021,11,5,9,16,31,51,-20,24
Crusaders,7022,1,14,10,6,53,36,17,52
Linfield,7022,2,14,9,7,62,36,26,51
Cliftonville,7022,3,15,5,10,52,42,10,50
Ballymena,7022,4,13,10,7,56,55,1,49
Dungannon,7022,5,11,10,9,53,41,12,43
Coleraine,7022,6,11,10,9,45,44,1,43
Ards,7022,7,10,7,13,44,48,-4,37
Glenavon,7022,8,8,11,11,44,49,-5,35
Glentoran,7022,9,6,12,12,29,42,-13,30
Ballinamalla,7022,10,8,6,16,29,51,-22,30
Portadown,7022,11,7,6,17,27,50,-23,27
Linfield,7023,1,15,9,6,65,34,31,54
Crusaders,7023,2,14,12,4,60,37,23,54
Cliftonville,7023,3,15,9,6,55,36,19,54
Glenavon,7023,4,14,9,7,53,44,9,51
Ballymena,7023,5,13,9,8,58,62,-4,48
Coleraine,7023,6,9,8,13,40,45,-5,35
Dungannon,7023,7,7,13,10,49,45,4,34
Glentoran,7023,8,9,7,14,29,43,-14,34
Ards,7023,9,8,7,15,40,54,-14,31
Ballinamalla,7023,10,8,7,15,29,49,-20,31
Portadown,7023,11,5,6,19,22,51,-29,21
Linfield,7024,1,18,10,2,68,28,40,64
Ballymena,7024,2,17,5,8,70,55,15,56
Crusaders,7024,3,15,9,6,53,31,22,54
Coleraine,7024,4,13,8,9,42,38,4,47
Cliftonville,7024,5,13,7,10,49,39,10,46
Dungannon,7024,6,9,10,11,43,37,6,37
Ards,7024,7,10,5,15,38,49,-11,35
Glenavon,7024,8,8,10,12,37,45,-8,34
Glentoran,7024,9,8,8,14,30,50,-20,32
Portadown,7024,10,7,6,17,19,46,-27,27
Ballinamalla,7024,11,6,4,20,26,57,-31,22
Crusaders,7025,1,17,8,5,61,36,25,59
Cliftonville,7025,2,15,6,9,55,38,17,51
Ballymena,7025,3,15,5,10,50,56,-6,50
Linfield,7025,4,12,10,8,55,34,21,46
Coleraine,7025,5,11,12,7,46,39,7,45
Glenavon,7025,6,10,12,8,50,44,6,42
Ballinamalla,7025,7,11,4,15,39,54,-15,37
Dungannon,7025,8,9,9,12,46,40,6,36
Ards,7025,9,9,6,15,40,54,-14,33
Portadown,7025,10,7,8,15,24,43,-19,29
Glentoran,7025,11,5,8,17,24,52,-28,23
Linfield,7026,1,18,8,4,69,30,39,62
Crusaders,7026,2,16,7,7,61,35,26,55
Cliftonville,7026,3,14,5,11,54,54,0,47
Ballymena,7026,4,13,7,10,58,62,-4,46
Dungannon,7026,5,11,10,9,54,43,11,43
Glenavon,7026,6,9,12,9,45,46,-1,39
Coleraine,7026,7,8,12,10,43,45,-2,36
Ards,7026,8,10,4,16,39,50,-11,34
Ballinamalla,7026,9,9,5,16,32,48,-16,32
Glentoran,7026,10,8,7,15,33,51,-18,31
Portadown,7026,11,8,5,17,22,46,-24,29
Crusaders,7027,1,17,7,6,60,36,24,58
Ballymena,7027,2,16,5,9,59,52,7,53
Coleraine,7027,3,14,10,6,44,29,15,52
Linfield,7027,4,14,8,8,57,35,22,50
Glenavon,7027,5,14,8,8,48,41,7,50
Cliftonville,7027,6,15,5,10,44,37,7,50
Dungannon,7027,7,11,8,11,54,45,9,41
Glentoran,7027,8,9,9,12,38,50,-12,36
Ards,7027,9,8,5,17,42,62,-20,29
Ballinamalla,7027,10,6,6,18,27,54,-27,24
Portadown,7027,11,3,5,22,20,52,-32,14
Cliftonville,7028,1,20,3,7,62,36,26,63
Crusaders,7028,2,18,7,5,61,38,23,61
Linfield,7028,3,16,8,6,61,29,32,56
Ballymena,7028,4,13,7,10,62,63,-1,46
Glenavon,7028,5,12,9,9,56,54,2,45
Coleraine,7028,6,10,12,8,40,43,-3,42
Dungannon,7028,7,9,10,11,51,49,2,37
Glentoran,7028,8,7,8,15,28,44,-16,29
Ballinamalla,7028,9,8,4,18,29,51,-22,28
Ards,7028,10,7,6,17,37,53,-16,27
Portadown,7028,11,5,6,19,25,52,-27,21
Linfield,7029,1,15,11,4,61,26,35,56
Crusaders,7029,2,15,6,9,52,41,11,51
Coleraine,7029,3,13,11,6,43,34,9,50
Cliftonville,7029,4,14,7,9,56,38,18,49
Glenavon,7029,5,13,10,7,52,48,4,49
Ballymena,7029,6,14,5,11,57,61,-4,47
Ards,7029,7,12,5,13,43,43,0,41
Dungannon,7029,8,10,9,11,52,45,7,39
Glentoran,7029,9,7,7,16,28,55,-27,28
Portadown,7029,10,6,5,19,26,53,-27,23
Ballinamalla,7029,11,6,4,20,30,56,-26,22
Cliftonville,7030,1,17,5,8,52,36,16,56
Linfield,7030,2,15,10,5,53,22,31,55
Crusaders,7030,3,16,7,7,60,39,21,55
Ballymena,7030,4,14,7,9,59,53,6,49
Coleraine,7030,5,12,9,9,40,34,6,45
Dungannon,7030,6,11,9,10,46,41,5,42
Glenavon,7030,7,9,12,9,47,49,-2,39
Glentoran,7030,8,8,9,13,29,41,-12,33
Ards,7030,9,8,5,17,31,47,-16,29
Ballinamalla,7030,10,7,7,16,24,46,-22,28
Portadown,7030,11,5,6,19,20,53,-33,21
Ballymena,7031,1,16,4,10,62,53,9,52
Linfield,7031,2,14,8,8,57,36,21,50
Crusaders,7031,3,14,6,10,53,40,13,48
Glenavon,7031,4,11,13,6,50,43,7,46
Cliftonville,7031,5,12,8,10,50,43,7,44
Dungannon,7031,6,10,11,9,49,44,5,41
Coleraine,7031,7,8,14,8,37,38,-1,38
Ards,7031,8,9,8,13,36,41,-5,35
Portadown,7031,9,9,6,15,31,47,-16,33
Ballinamalla,7031,10,9,4,17,29,50,-21,31
Glentoran,7031,11,5,14,11,22,41,-19,29
Linfield,7032,1,17,8,5,62,36,26,59
Cliftonville,7032,2,17,4,9,54,39,15,55
Coleraine,7032,3,13,11,6,49,37,12,50
Crusaders,7032,4,14,7,9,60,38,22,49
Dungannon,7032,5,13,6,11,53,49,4,45
Ballymena,7032,6,13,5,12,59,58,1,44
Glenavon,7032,7,11,9,10,46,50,-4,42
Ards,7032,8,8,7,15,38,53,-15,31
Ballinamalla,7032,9,8,5,17,36,56,-20,29
Glentoran,7032,10,7,7,16,30,49,-19,28
Portadown,7032,11,7,5,18,26,48,-22,26
Crusaders,7033,1,16,6,8,54,36,18,54
Cliftonville,7033,2,17,3,10,54,45,9,54
Linfield,7033,3,15,8,7,67,31,36,53
Ballymena,7033,4,14,6,10,56,58,-2,48
Glenavon,7033,5,12,9,9,46,43,3,45
Ards,7033,6,12,7,11,45,47,-2,43
Coleraine,7033,7,10,12,8,42,40,2,42
Dungannon,7033,8,9,10,11,47,44,3,37
Glentoran,7033,9,8,10,12,35,48,-13,34
Ballinamalla,7033,10,7,4,19,30,54,-24,25
Portadown,7033,11,4,7,19,21,51,-30,19
Linfield,7034,1,16,8,6,62,27,35,56
Crusaders,7034,2,15,7,8,54,38,16,52
Coleraine,7034,3,13,11,6,47,34,13,50
Cliftonville,7034,4,14,6,10,53,42,11,48
Ballymena,7034,5,13,5,12,52,66,-14,44
Glenavon,7034,6,10,13,7,42,47,-5,43
Glentoran,7034,7,11,7,12,32,43,-11,40
Dungannon,7034,8,9,11,10,50,45,5,38
Ballinamalla,7034,9,8,7,15,35,46,-11,31
Ards,7034,10,8,5,17,38,53,-15,29
Portadown,7034,11,5,6,19,19,43,-24,21
Crusaders,7035,1,19,6,5,60,32,28,63
Cliftonville,7035,2,17,5,8,56,36,20,56
Linfield,7035,3,15,9,6,59,32,27,54
Ballymena,7035,4,15,7,8,53,53,0,52
Coleraine,7035,5,13,10,7,42,32,10,49
Glenavon,7035,6,10,11,9,44,46,-2,41
Dungannon,7035,7,9,9,12,42,40,2,36
Ards,7035,8,7,9,14,31,42,-11,30
Ballinamalla,7035,9,7,5,18,22,45,-23,26
Glentoran,7035,10,6,6,18,22,46,-24,24
Portadown,7035,11,6,5,19,25,52,-27,23
Cliftonville,7036,1,18,6,6,60,30,30,60
Glenavon,7036,2,13,11,6,47,43,4,50
Linfield,7036,3,13,10,7,61,41,20,49
Crusaders,7036,4,12,13,5,49,41,8,49
Ballymena,7036,5,12,10,8,56,54,2,46
Dungannon,7036,6,9,12,9,49,35,14,39
Coleraine,7036,7,8,14,8,39,38,1,38
Glentoran,7036,8,9,7,14,31,46,-15,34
Ards,7036,9,8,5,17,41,59,-18,29
Portadown,7036,10,5,10,15,21,43,-22,25
Ballinamalla,7036,11,5,8,17,28,52,-24,23
Crusaders,7037,1,17,6,7,56,38,18,57
Linfield,7037,2,14,10,6,60,31,29,52
Cliftonville,7037,3,13,5,12,57,49,8,44
Ballymena,7037,4,12,8,10,57,60,-3,44
Coleraine,7037,5,10,13,7,41,36,5,43
Dungannon,7037,6,10,9,11,54,51,3,39
Glenavon,7037,7,9,12,9,42,42,0,39
Glentoran,7037,8,11,6,13,36,49,-13,39
Ballinamalla,7037,9,12,2,16,34,50,-16,38
Ards,7037,10,9,6,15,39,49,-10,33
Portadown,7037,11,6,7,17,27,48,-21,25
Crusaders,7038,1,18,8,4,59,31,28,62
Linfield,7038,2,14,10,6,56,31,25,52
Cliftonville,7038,3,16,4,10,52,36,16,52
Ballymena,7038,4,14,8,8,56,55,1,50
Coleraine,7038,5,13,10,7,44,35,9,49
Glenavon,7038,6,10,10,10,49,50,-1,40
Dungannon,7038,7,9,7,14,44,41,3,34
Portadown,7038,8,9,5,16,31,47,-16,32
Glentoran,7038,9,7,10,13,26,44,-18,31
Ards,7038,10,7,6,17,35,52,-17,27
Ballinamalla,7038,11,6,6,18,24,54,-30,24
Crusaders,7039,1,16,8,6,49,28,21,56
Cliftonville,7039,2,16,6,8,55,44,11,54
Linfield,7039,3,12,10,8,56,35,21,46
Glenavon,7039,4,12,10,8,53,44,9,46
Coleraine,7039,5,11,12,7,42,35,7,45
Dungannon,7039,6,11,9,10,52,42,10,42
Ballymena,7039,7,10,9,11,50,59,-9,39
Ballinamalla,7039,8,10,5,15,32,52,-20,35
Glentoran,7039,9,7,11,12,32,46,-14,32
Ards,7039,10,6,9,15,36,52,-16,27
Portadown,7039,11,5,9,16,31,51,-20,24
Crusaders,7040,1,19,5,6,54,34,20,62
Cliftonville,7040,2,16,5,9,49,33,16,53
Linfield,7040,3,13,10,7,59,31,28,49
Ballymena,7040,4,14,7,9,60,54,6,49
Coleraine,7040,5,12,8,10,47,42,5,44
Glenavon,7040,6,9,12,9,43,47,-4,39
Dungannon,7040,7,9,10,11,48,47,1,37
Glentoran,7040,8,8,10,12,24,37,-13,34
Ards,7040,9,8,7,15,33,49,-16,31
Portadown,7040,10,8,4,18,26,45,-19,28
Ballinamalla,7040,11,7,6,17,28,52,-24,27
Cliftonville,7041,1,18,3,9,60,38,22,57
Coleraine,7041,2,16,8,6,52,36,16,56
Crusaders,7041,3,16,6,8,51,35,16,54
Linfield,7041,4,15,8,7,59,32,27,53
Ballinamalla,7041,5,12,3,15,34,47,-13,39
Ballymena,7041,6,11,5,14,56,68,-12,38
Glenavon,7041,7,9,10,11,40,49,-9,37
Dungannon,7041,8,9,9,12,50,45,5,36
Glentoran,7041,9,9,7,14,33,44,-11,34
Portadown,7041,10,7,8,15,25,44,-19,29
Ards,7041,11,7,5,18,30,52,-22,26
Linfield,7042,1,15,11,4,56,27,29,56
Glenavon,7042,2,14,12,4,55,39,16,54
Crusaders,7042,3,13,11,6,47,30,17,50
Cliftonville,7042,4,14,8,8,50,37,13,50
Coleraine,7042,5,11,10,9,48,42,6,43
Ballymena,7042,6,10,8,12,51,62,-11,38
Ards,7042,7,11,4,15,37,45,-8,37
Portadown,7042,8,9,9,12,31,43,-12,36
Dungannon,7042,9,8,10,12,47,47,0,34
Glentoran,7042,10,8,6,16,26,48,-22,30
Ballinamalla,7042,11,5,5,20,31,59,-28,20
Crusaders,7043,1,15,8,7,52,39,13,53
Ballymena,7043,2,15,8,7,63,62,1,53
Cliftonville,7043,3,15,4,11,58,41,17,49
Coleraine,7043,4,13,8,9,46,38,8,47
Linfield,7043,5,13,7,10,55,39,16,46
Dungannon,7043,6,12,9,9,51,39,12,45
Glentoran,7043,7,12,9,9,48,42,6,45
Glenavon,7043,8,10,10,10,44,41,3,40
Ballinamalla,7043,9,8,4,18,28,49,-21,28
Ards,7043,10,8,4,18,27,51,-24,28
Portadown,7043,11,5,7,18,23,54,-31,22
Crusaders,7044,1,15,9,6,53,34,19,54
Coleraine,7044,2,12,11,7,43,39,4,47
Ballymena,7044,3,12,11,7,61,58,3,47
Glenavon,7044,4,12,10,8,46,44,2,46
Glentoran,7044,5,13,6,11,40,40,0,45
Linfield,7044,6,12,8,10,54,36,18,44
Dungannon,7044,7,11,7,12,56,47,9,40
Cliftonville,7044,8,11,7,12,49,49,0,40
Ards,7044,9,10,6,14,40,50,-10,36
Portadown,7044,10,7,9,14,23,40,-17,30
Ballinamalla,7044,11,6,4,20,19,47,-28,22
Linfield,7045,1,15,7,8,58,36,22,52
Crusaders,7045,2,15,7,8,51,35,16,52
Glenavon,7045,3,12,12,6,55,49,6,48
Ballymena,7045,4,13,6,11,60,63,-3,45
Coleraine,7045,5,11,9,10,40,40,0,42
Dungannon,7045,6,9,14,7,49,40,9,41
Cliftonville,7045,7,12,4,14,47,46,1,40
Ballinamalla,7045,8,11,7,12,39,46,-7,40
Portadown,7045,9,9,5,16,34,49,-15,32
Glentoran,7045,10,8,7,15,26,39,-13,31
Ards,7045,11,8,6,16,31,47,-16,30
Linfield,7046,1,16,9,5,60,26,34,57
Coleraine,7046,2,16,9,5,45,30,15,57
Crusaders,7046,3,16,8,6,57,35,22,56
Cliftonville,7046,4,15,5,10,51,36,15,50
Glenavon,7046,5,11,10,9,48,47,1,43
Dungannon,7046,6,11,9,10,53,43,10,42
Ballymena,7046,7,10,9,11,57,62,-5,39
Glentoran,7046,8,10,6,14,38,54,-16,36
Portadown,7046,9,8,6,16,29,49,-20,30
Ards,7046,10,7,7,16,30,49,-19,28
Ballinamalla,7046,11,5,2,23,30,67,-37,17
Crusaders,7047,1,18,6,6,62,39,23,60
Linfield,7047,2,16,8,6,59,38,21,56
Coleraine,7047,3,15,9,6,54,33,21,54
Ballymena,7047,4,16,4,10,62,58,4,52
Cliftonville,7047,5,14,5,11,50,40,10,47
Dungannon,7047,6,11,7,12,55,48,7,40
Glenavon,7047,7,9,10,11,46,53,-7,37
Ards,7047,8,10,6,14,45,47,-2,36
Glentoran,7047,9,8,8,14,29,43,-14,32
Portadown,7047,10,7,5,18,29,55,-26,26
Ballinamalla,7047,11,5,4,21,24,61,-37,19
Crusaders,7048,1,17,6,7,51,32,19,57
Linfield,7048,2,14,10,6,52,26,26,52
Cliftonville,7048,3,14,5,11,52,45,7,47
Dungannon,7048,4,11,11,8,57,41,16,44
Ballymena,7048,5,12,7,11,56,58,-2,43
Glenavon,7048,6,11,9,10,45,45,0,42
Coleraine,7048,7,10,12,8,42,42,0,42
Glentoran,7048,8,11,8,11,35,38,-3,41
Ballinamalla,7048,9,7,8,15,26,45,-19,29
Ards,7048,10,7,6,17,32,52,-20,27
Portadown,7048,11,6,8,16,20,44,-24,26
Crusaders,7049,1,18,5,7,63,33,30,59
Linfield,7049,2,16,9,5,56,27,29,57
Glenavon,7049,3,12,12,6,54,44,10,48
Cliftonville,7049,4,14,5,11,47,38,9,47
Ballymena,7049,5,12,7,11,55,58,-3,43
Coleraine,7049,6,10,11,9,37,33,4,41
Dungannon,7049,7,10,10,10,47,44,3,40
Ards,7049,8,10,4,16,36,52,-16,34
Ballinamalla,7049,9,10,3,17,37,55,-18,33
Glentoran,7049,10,7,7,16,27,48,-21,28
Portadown,7049,11,8,3,19,23,50,-27,27
Crusaders,7050,1,16,6,8,56,41,15,54
Cliftonville,7050,2,16,5,9,52,40,12,53
Glenavon,7050,3,13,11,6,53,44,9,50
Ballymena,7050,4,15,4,11,56,60,-4,49
Linfield,7050,5,12,9,9,65,42,23,45
Coleraine,7050,6,11,12,7,44,36,8,45
Dungannon,7050,7,9,10,11,50,48,2,37
Ards,7050,8,10,6,14,38,50,-12,36
Ballinamalla,7050,9,9,5,16,32,46,-14,32
Glentoran,7050,10,6,9,15,35,53,-18,27
Portadown,7050,11,5,9,16,26,47,-21,24
Linfield,7051,1,15,8,7,65,36,29,53
Ballymena,7051,2,16,4,10,62,63,-1,52
Crusaders,7051,3,15,5,10,59,42,17,50
Glenavon,7051,4,13,11,6,52,44,8,50
Cliftonville,7051,5,15,4,11,51,43,8,49
Dungannon,7051,6,10,10,10,55,47,8,40
Coleraine,7051,7,10,10,10,42,38,4,40
Ards,7051,8,10,7,13,39,46,-7,37
Ballinamalla,7051,9,9,8,13,32,44,-12,35
Glentoran,7051,10,7,6,17,32,56,-24,27
Portadown,7051,11,7,3,20,24,54,-30,24
Linfield,7052,1,16,8,6,63,31,32,56
Crusaders,7052,2,16,8,6,58,38,20,56
Cliftonville,7052,3,16,8,6,56,36,20,56
Coleraine,7052,4,11,10,9,42,41,1,43
Ballymena,7052,5,12,6,12,55,59,-4,42
Dungannon,7052,6,11,8,11,46,44,2,41
Glenavon,7052,7,10,10,10,45,47,-2,40
Ards,7052,8,12,2,16,40,53,-13,38
Ballinamalla,7052,9,8,9,13,38,48,-10,33
Glentoran,7052,10,8,5,17,27,45,-18,29
Portadown,7052,11,6,4,20,22,50,-28,22
Linfield,7053,1,17,7,6,62,30,32,58
Coleraine,7053,2,15,10,5,48,29,19,55
Crusaders,7053,3,14,8,8,50,39,11,50
Cliftonville,7053,4,15,3,12,47,37,10,48
Ballymena,7053,5,13,6,11,59,62,-3,45
Glenavon,7053,6,11,10,9,46,47,-1,43
Dungannon,7053,7,9,11,10,43,38,5,38
Glentoran,7053,8,10,8,12,38,40,-2,38
Ards,7053,9,10,5,15,36,55,-19,35
Ballinamalla,7053,10,7,4,19,25,49,-24,25
Portadown,7053,11,5,6,19,22,50,-28,21
Crusaders,7054,1,16,9,5,49,28,21,57
Cliftonville,7054,2,15,10,5,55,31,24,55
Glenavon,7054,3,12,13,5,47,38,9,49
Ballymena,7054,4,14,7,9,56,52,4,49
Linfield,7054,5,13,9,8,58,37,21,48
Coleraine,7054,6,12,9,9,40,36,4,45
Dungannon,7054,7,6,15,9,45,47,-2,33
Glentoran,7054,8,8,9,13,23,38,-15,33
Ballinamalla,7054,9,8,6,16,33,55,-22,30
Ards,7054,10,6,6,18,31,48,-17,24
Portadown,7054,11,6,5,19,27,54,-27,23
Ballymena,7055,1,17,5,8,64,59,5,56
Crusaders,7055,2,16,5,9,55,31,24,53
Cliftonville,7055,3,16,4,10,58,40,18,52
Linfield,7055,4,14,8,8,62,38,24,50
Glenavon,7055,5,12,10,8,50,44,6,46
Dungannon,7055,6,10,10,10,51,43,8,40
Coleraine,7055,7,9,10,11,37,44,-7,37
Ballinamalla,7055,8,11,3,16,33,51,-18,36
Ards,7055,9,9,7,14,39,51,-12,34
Portadown,7055,10,6,9,15,28,47,-19,27
Glentoran,7055,11,4,11,15,24,53,-29,23
Crusaders,7056,1,17,10,3,63,30,33,61
Cliftonville,7056,2,15,8,7,52,29,23,53
Linfield,7056,3,14,8,8,52,28,24,50
Ballymena,7056,4,13,8,9,59,64,-5,47
Glenavon,7056,5,11,11,8,51,45,6,44
Coleraine,7056,6,11,10,9,42,44,-2,43
Dungannon,7056,7,11,9,10,51,46,5,42
Ards,7056,8,11,5,14,40,45,-5,38
Glentoran,7056,9,8,7,15,39,52,-13,31
Portadown,7056,10,6,5,19,24,54,-30,23
Ballinamalla,7056,11,5,5,20,27,63,-36,20
Crusaders,7057,1,19,7,4,62,30,32,64
Linfield,7057,2,17,8,5,66,33,33,59
Coleraine,7057,3,13,9,8,45,37,8,48
Glenavon,7057,4,12,10,8,48,41,7,46
Ballymena,7057,5,13,6,11,56,59,-3,45
Cliftonville,7057,6,13,4,13,46,40,6,43
Dungannon,7057,7,9,9,12,45,48,-3,36
Ards,7057,8,11,2,17,33,51,-18,35
Glentoran,7057,9,8,8,14,32,45,-13,32
Ballinamalla,7057,10,7,5,18,29,54,-25,26
Portadown,7057,11,6,6,18,26,50,-24,24
Crusaders,7058,1,17,6,7,58,34,24,57
Linfield,7058,2,14,9,7,56,29,27,51
Cliftonville,7058,3,15,4,11,51,45,6,49
Coleraine,7058,4,11,12,7,38,31,7,45
Glentoran,7058,5,12,8,10,33,39,-6,44
Ballymena,7058,6,12,7,11,55,60,-5,43
Glenavon,7058,7,10,10,10,54,53,1,40
Ards,7058,8,9,6,15,36,48,-12,33
Dungannon,7058,9,7,11,12,48,43,5,32
Ballinamalla,7058,10,9,4,17,32,53,-21,31
Portadown,7058,11,7,7,16,21,47,-26,28
Crusaders,7059,1,21,5,4,60,33,27,68
Cliftonville,7059,2,16,4,10,47,35,12,52
Glenavon,7059,3,14,8,8,56,45,11,50
Ballymena,7059,4,14,7,9,65,52,13,49
Linfield,7059,5,12,9,9,60,49,11,45
Ards,7059,6,13,5,12,49,48,1,44
Dungannon,7059,7,10,7,13,52,44,8,37
Coleraine,7059,8,9,8,13,37,48,-11,35
Ballinamalla,7059,9,9,3,18,35,51,-16,30
Portadown,7059,10,9,2,19,25,52,-27,29
Glentoran,7059,11,6,6,18,24,53,-29,24
Ballymena,7060,1,16,6,8,65,53,12,54
Linfield,7060,2,14,9,7,61,39,22,51
Cliftonville,7060,3,16,2,12,52,40,12,50
Crusaders,7060,4,15,5,10,50,41,9,50
Glenavon,7060,5,12,9,9,46,45,1,45
Dungannon,7060,6,11,10,9,49,39,10,43
Coleraine,7060,7,10,10,10,37,37,0,40
Glentoran,7060,8,10,6,14,35,51,-16,36
Portadown,7060,9,10,4,16,24,44,-20,34
Ards,7060,10,8,6,16,41,49,-8,30
Ballinamalla,7060,11,7,5,18,35,57,-22,26
Linfield,7061,1,14,7,9,57,32,25,49
Crusaders,7061,2,13,9,8,46,35,11,48
Dungannon,7061,3,12,10,8,54,38,16,46
Cliftonville,7061,4,14,3,13,50,48,2,45
Glenavon,7061,5,12,9,9,47,48,-1,45
Coleraine,7061,6,10,12,8,41,35,6,42
Ballymena,7061,7,12,5,13,51,62,-11,41
Ards,7061,8,11,6,13,41,43,-2,39
Glentoran,7061,9,10,8,12,28,37,-9,38
Ballinamalla,7061,10,8,8,14,29,49,-20,32
Portadown,7061,11,9,3,18,31,48,-17,30
Crusaders,7062,1,17,9,4,59,32,27,60
Glenavon,7062,2,14,12,4,59,41,18,54
Linfield,7062,3,13,10,7,56,34,22,49
Cliftonville,7062,4,14,6,10,51,42,9,48
Ballymena,7062,5,13,7,10,57,59,-2,46
Coleraine,7062,6,10,10,10,41,49,-8,40
Dungannon,7062,7,9,10,11,50,45,5,37
Ards,7062,8,10,5,15,40,54,-14,35
Glentoran,7062,9,7,9,14,34,48,-14,30
Ballinamalla,7062,10,8,3,19,29,53,-24,27
Portadown,7062,11,6,7,17,28,47,-19,25
Crusaders,7063,1,18,5,7,58,33,25,59
Ballymena,7063,2,16,5,9,53,56,-3,53
Cliftonville,7063,3,15,6,9,51,36,15,51
Linfield,7063,4,12,11,7,53,29,24,47
Dungannon,7063,5,12,7,11,47,44,3,43
Glenavon,7063,6,11,8,11,45,46,-1,41
Glentoran,7063,7,11,8,11,32,36,-4,41
Coleraine,7063,8,8,11,11,32,39,-7,35
Ards,7063,9,8,7,15,36,50,-14,31
Ballinamalla,7063,10,9,4,17,28,45,-17,31
Portadown,7063,11,6,6,18,23,44,-21,24
Crusaders,7064,1,16,8,6,56,34,22,56
Linfield,7064,2,13,10,7,55,33,22,49
Ballymena,7064,3,13,7,10,67,68,-1,46
Cliftonville,7064,4,12,9,9,50,43,7,45
Coleraine,7064,5,12,9,9,44,42,2,45
Glenavon,7064,6,11,9,10,51,47,4,42
Dungannon,7064,7,11,8,11,49,43,6,41
Portadown,7064,8,10,7,13,33,37,-4,37
Ards,7064,9,8,8,14,37,51,-14,32
Glentoran,7064,10,7,10,13,37,58,-21,31
Ballinamalla,7064,11,7,5,18,25,48,-23,26
Crusaders,7065,1,15,10,5,51,31,20,55
Linfield,7065,2,14,12,4,53,24,29,54
Ballymena,7065,3,13,7,10,51,55,-4,46
Dungannon,7065,4,12,8,10,51,40,11,44
Cliftonville,7065,5,13,4,13,45,39,6,43
Coleraine,7065,6,11,10,9,41,36,5,43
Glentoran,7065,7,11,6,13,29,42,-13,39
Glenavon,7065,8,9,11,10,39,42,-3,38
Ards,7065,9,9,6,15,35,47,-12,33
Portadown,7065,10,8,6,16,27,45,-18,30
Ballinamalla,7065,11,8,4,18,29,50,-21,28
Ballymena,7066,1,19,5,6,67,46,21,62
Linfield,7066,2,16,10,4,64,31,33,58
Cliftonville,7066,3,18,4,8,58,36,22,58
Glenavon,7066,4,12,13,5,54,47,7,49
Coleraine,7066,5,13,9,8,44,38,6,48
Crusaders,7066,6,11,7,12,45,43,2,40
Glentoran,7066,7,10,6,14,30,44,-14,36
Dungannon,7066,8,8,8,14,46,49,-3,32
Portadown,7066,9,7,5,18,26,54,-28,26
Ballinamalla,7066,10,5,8,17,29,51,-22,23
Ards,7066,11,5,7,18,23,47,-24,22
Linfield,7067,1,17,8,5,62,28,34,59
Crusaders,7067,2,16,6,8,54,31,23,54
Coleraine,7067,3,13,10,7,51,38,13,49
Glenavon,7067,4,12,13,5,48,38,10,49
Cliftonville,7067,5,14,5,11,53,44,9,47
Ballymena,7067,6,12,8,10,54,57,-3,44
Glentoran,7067,7,10,8,12,35,46,-11,38
Dungannon,7067,8,9,8,13,51,52,-1,35
Ards,7067,9,9,5,16,30,51,-21,32
Ballinamalla,7067,10,8,4,18,32,55,-23,28
Portadown,7067,11,6,3,21,25,55,-30,21
Glenavon,7068,1,15,8,7,53,43,10,53
Linfield,7068,2,14,10,6,64,33,31,52
Dungannon,7068,3,14,8,8,57,35,22,50
Cliftonville,7068,4,15,5,10,57,37,20,50
Ballymena,7068,5,14,4,12,57,58,-1,46
Crusaders,7068,6,12,9,9,50,41,9,45
Coleraine,7068,7,12,9,9,45,42,3,45
Ards,7068,8,11,2,17,35,55,-20,35
Glentoran,7068,9,8,7,15,31,52,-21,31
Ballinamalla,7068,10,8,4,18,29,51,-22,28
Portadown,7068,11,6,6,18,23,54,-31,24
Crusaders,7069,1,18,6,6,60,32,28,60
Linfield,7069,2,16,10,4,63,26,37,58
Cliftonville,7069,3,15,5,10,47,37,10,50
Glenavon,7069,4,13,11,6,49,40,9,50
Ballymena,7069,5,13,7,10,51,57,-6,46
Ards,7069,6,11,7,12,43,48,-5,40
Coleraine,7069,7,9,12,9,39,38,1,39
Dungannon,7069,8,9,9,12,43,42,1,36
Glentoran,7069,9,6,9,15,27,46,-19,27
Ballinamalla,7069,10,7,5,18,25,49,-24,26
Portadown,7069,11,5,5,20,22,54,-32,20
Crusaders,7070,1,20,7,3,64,32,32,67
Ballymena,7070,2,17,6,7,65,52,13,57
Linfield,7070,3,13,9,8,57,37,20,48
Cliftonville,7070,4,13,6,11,47,44,3,45
Coleraine,7070,5,10,12,8,43,38,5,42
Glenavon,7070,6,10,12,8,52,51,1,42
Dungannon,7070,7,9,10,11,49,46,3,37
Glentoran,7070,8,7,11,12,32,45,-13,32
Ards,7070,9,7,7,16,37,52,-15,28
Portadown,7070,10,6,10,14,25,46,-21,28
Ballinamalla,7070,11,6,4,20,30,58,-28,22
Linfield,7071,1,19,8,3,70,24,46,65
Crusaders,7071,2,15,10,5,53,30,23,55
Cliftonville,7071,3,16,3,11,59,40,19,51
Glenavon,7071,4,11,12,7,46,39,7,45
Coleraine,7071,5,10,13,7,42,38,4,43
Dungannon,7071,6,10,10,10,50,49,1,40
Ballymena,7071,7,10,8,12,55,61,-6,38
Glentoran,7071,8,7,10,13,30,47,-17,31
Ballinamalla,7071,9,8,6,16,36,58,-22,30
Ards,7071,10,6,7,17,28,51,-23,25
Portadown,7071,11,5,9,16,21,53,-32,24
Cliftonville,7072,1,16,3,11,57,43,14,51
Crusaders,7072,2,15,6,9,54,41,13,51
Ballymena,7072,3,14,7,9,60,56,4,49
Coleraine,7072,4,12,12,6,43,34,9,48
Linfield,7072,5,11,10,9,55,35,20,43
Dungannon,7072,6,10,12,8,45,38,7,42
Glentoran,7072,7,10,10,10,33,37,-4,40
Glenavon,7072,8,8,13,9,47,43,4,37
Ballinamalla,7072,9,10,2,18,29,53,-24,32
Ards,7072,10,7,8,15,36,56,-20,29
Portadown,7072,11,7,7,16,26,49,-23,28
Crusaders,7073,1,16,11,3,64,35,29,59
Linfield,7073,2,15,9,6,64,43,21,54
Cliftonville,7073,3,15,4,11,51,38,13,49
Ballymena,7073,4,11,8,11,62,64,-2,41
Glentoran,7073,5,11,7,12,37,48,-11,40
Dungannon,7073,6,10,9,11,55,50,5,39
Glenavon,7073,7,9,12,9,43,50,-7,39
Coleraine,7073,8,8,13,9,43,44,-1,37
Ards,7073,9,9,8,13,50,55,-5,35
Ballinamalla,7073,10,8,5,17,38,53,-15,29
Portadown,7073,11,6,8,16,25,52,-27,26
Crusaders,7074,1,17,7,6,52,36,16,58
Cliftonville,7074,2,15,4,11,56,40,16,49
Coleraine,7074,3,13,10,7,50,36,14,49
Glenavon,7074,4,11,14,5,51,44,7,47
Linfield,7074,5,13,7,10,53,35,18,46
Ballymena,7074,6,13,7,10,58,58,0,46
Glentoran,7074,7,12,8,10,42,47,-5,44
Dungannon,7074,8,10,7,13,47,46,1,37
Portadown,7074,9,8,4,18,30,52,-22,28
Ards,7074,10,7,5,18,37,56,-19,26
Ballinamalla,7074,11,6,7,17,29,55,-26,25
Crusaders,7075,1,14,12,4,47,31,16,54
Cliftonville,7075,2,16,3,11,58,45,13,51
Linfield,7075,3,12,12,6,57,29,28,48
Ballymena,7075,4,13,9,8,54,58,-4,48
Dungannon,7075,5,11,10,9,51,39,12,43
Coleraine,7075,6,10,13,7,45,44,1,43
Glenavon,7075,7,9,11,10,43,43,0,38
Glentoran,7075,8,8,8,14,28,44,-16,32
Ards,7075,9,7,10,13,39,47,-8,31
Portadown,7075,10,8,6,16,22,39,-17,30
Ballinamalla,7075,11,7,6,17,36,61,-25,27
Crusaders,7076,1,17,8,5,64,40,24,59
Glenavon,7076,2,15,8,7,55,42,13,53
Ballymena,7076,3,16,5,9,59,59,0,53
Cliftonville,7076,4,15,4,11,53,42,11,49
Linfield,7076,5,13,9,8,53,36,17,48
Coleraine,7076,6,12,10,8,44,34,10,46
Dungannon,7076,7,8,12,10,52,45,7,36
Ards,7076,8,8,6,16,35,48,-13,30
Ballinamalla,7076,9,9,3,18,34,56,-22,30
Glentoran,7076,10,6,10,14,37,61,-24,28
Portadown,7076,11,6,5,19,26,49,-23,23
Crusaders,7077,1,17,7,6,56,35,21,58
Glenavon,7077,2,13,9,8,47,41,6,48
Coleraine,7077,3,12,11,7,45,37,8,47
Linfield,7077,4,12,9,9,56,32,24,45
Glentoran,7077,5,12,8,10,29,35,-6,44
Cliftonville,7077,6,13,4,13,47,47,0,43
Dungannon,7077,7,11,7,12,47,43,4,40
Ballymena,7077,8,12,4,14,53,63,-10,40
Ards,7077,9,9,7,14,32,39,-7,34
Portadown,7077,10,7,9,14,24,43,-19,30
Ballinamalla,7077,11,7,5,18,29,50,-21,26
Crusaders,7078,1,16,7,7,58,34,24,55
Glenavon,7078,2,15,9,6,54,41,13,54
Linfield,7078,3,14,8,8,59,31,28,50
Dungannon,7078,4,13,9,8,48,34,14,48
Cliftonville,7078,5,13,4,13,48,41,7,43
Ballymena,7078,6,12,5,13,52,60,-8,41
Coleraine,7078,7,10,9,11,43,50,-7,39
Glentoran,7078,8,9,9,12,37,52,-15,36
Portadown,7078,9,10,4,16,24,42,-18,34
Ballinamalla,7078,10,7,9,14,32,50,-18,30
Ards,7078,11,8,3,19,36,56,-20,27
Crusaders,7079,1,18,9,3,57,27,30,63
Linfield,7079,2,15,6,9,57,32,25,51
Glenavon,7079,3,12,10,8,45,40,5,46
Dungannon,7079,4,12,9,9,50,42,8,45
Ballymena,7079,5,13,6,11,57,60,-3,45
Cliftonville,7079,6,13,5,12,49,41,8,44
Coleraine,7079,7,11,11,8,40,41,-1,44
Glentoran,7079,8,8,8,14,34,46,-12,32
Portadown,7079,9,8,6,16,29,47,-18,30
Ards,7079,10,8,4,18,33,53,-20,28
Ballinamalla,7079,11,8,4,18,26,48,-22,28
Ballymena,7080,1,16,6,8,61,51,10,54
Cliftonville,7080,2,16,4,10,49,36,13,52
Crusaders,7080,3,14,8,8,52,37,15,50
Linfield,7080,4,14,7,9,52,28,24,49
Glenavon,7080,5,13,9,8,50,52,-2,48
Coleraine,7080,6,10,11,9,41,38,3,41
Dungannon,7080,7,9,10,11,44,44,0,37
Glentoran,7080,8,9,9,12,33,46,-13,36
Ards,7080,9,10,4,16,37,48,-11,34
Ballinamalla,7080,10,8,5,17,34,52,-18,29
Portadown,7080,11,5,9,16,25,46,-21,24
Crusaders,7081,1,14,10,6,60,38,22,52
Ballymena,7081,2,15,6,9,52,55,-3,51
Linfield,7081,3,12,13,5,62,39,23,49
Coleraine,7081,4,13,10,7,48,40,8,49
Cliftonville,7081,5,14,5,11,48,37,11,47
Glenavon,7081,6,11,14,5,48,38,10,47
Ards,7081,7,12,4,14,40,44,-4,40
Dungannon,7081,8,9,8,13,46,48,-2,35
Glentoran,7081,9,8,8,14,28,43,-15,32
Portadown,7081,10,7,7,16,21,41,-20,28
Ballinamalla,7081,11,5,5,20,26,56,-30,20
Crusaders,7082,1,17,7,6,54,35,19,58
Cliftonville,7082,2,17,5,8,62,37,25,56
Coleraine,7082,3,14,10,6,54,39,15,52
Glenavon,7082,4,11,12,7,48,45,3,45
Linfield,7082,5,11,9,10,53,43,10,42
Dungannon,7082,6,10,10,10,48,40,8,40
Ballymena,7082,7,11,6,13,52,67,-15,39
Ards,7082,8,10,6,14,38,47,-9,36
Glentoran,7082,9,7,9,14,30,42,-12,30
Portadown,7082,10,8,5,17,27,46,-19,29
Ballinamalla,7082,11,7,5,18,28,53,-25,26
Crusaders,7083,1,19,6,5,58,32,26,63
Cliftonville,7083,2,17,4,9,55,33,22,55
Linfield,7083,3,12,13,5,52,31,21,49
Ballymena,7083,4,15,3,12,48,57,-9,48
Coleraine,7083,5,11,11,8,41,34,7,44
Glenavon,7083,6,9,10,11,44,45,-1,37
Ballinamalla,7083,7,11,3,16,31,48,-17,36
Ards,7083,8,9,6,15,40,50,-10,33
Dungannon,7083,9,7,11,12,43,42,1,32
Glentoran,7083,10,8,7,15,28,46,-18,31
Portadown,7083,11,7,6,17,23,45,-22,27
Crusaders,7084,1,16,9,5,65,34,31,57
Ballymena,7084,2,16,5,9,64,56,8,53
Cliftonville,7084,3,14,7,9,52,44,8,49
Linfield,7084,4,13,9,8,57,30,27,48
Coleraine,7084,5,11,11,8,39,37,2,44
Glenavon,7084,6,11,11,8,46,53,-7,44
Dungannon,7084,7,10,10,10,50,42,8,40
Ballinamalla,7084,8,9,6,15,31,44,-13,33
Portadown,7084,9,7,7,16,21,41,-20,28
Glentoran,7084,10,7,7,16,23,50,-27,28
Ards,7084,11,5,10,15,30,47,-17,25
Linfield,7085,1,14,13,3,58,29,29,55
Crusaders,7085,2,15,9,6,56,35,21,54
Coleraine,7085,3,14,10,6,49,34,15,52
Cliftonville,7085,4,15,4,11,52,43,9,49
Glenavon,7085,5,10,12,8,43,43,0,42
Dungannon,7085,6,10,10,10,47,41,6,40
Ballymena,7085,7,10,8,12,48,60,-12,38
Ballinamalla,7085,8,9,8,13,31,41,-10,35
Ards,7085,9,9,6,15,41,49,-8,33
Glentoran,7085,10,7,8,15,25,43,-18,29
Portadown,7085,11,5,6,19,19,51,-32,21
Crusaders,7086,1,17,6,7,55,33,22,57
Ballymena,7086,2,17,4,9,60,54,6,55
Cliftonville,7086,3,16,5,9,55,39,16,53
Linfield,7086,4,13,9,8,54,37,17,48
Glenavon,7086,5,11,11,8,51,44,7,44
Glentoran,7086,6,11,9,10,37,44,-7,42
Coleraine,7086,7,10,10,10,47,47,0,40
Dungannon,7086,8,7,12,11,49,52,-3,33
Ards,7086,9,8,6,16,33,46,-13,30
Ballinamalla,7086,10,8,6,16,33,52,-19,30
Portadown,7086,11,6,4,20,24,50,-26,22
Linfield,7087,1,17,7,6,66,28,38,58
Crusaders,7087,2,14,10,6,61,44,17,52
Glenavon,7087,3,12,13,5,54,44,10,49
Coleraine,7087,4,12,11,7,52,37,15,47
Ballymena,7087,5,14,5,11,63,61,2,47
Cliftonville,7087,6,13,7,10,52,44,8,46
Dungannon,7087,7,9,11,10,51,46,5,38
Ards,7087,8,10,5,15,44,56,-12,35
Glentoran,7087,9,7,8,15,31,53,-22,29
Portadown,7087,10,7,6,17,24,50,-26,27
Ballinamalla,7087,11,6,5,19,31,66,-35,23
Crusaders,7088,1,14,11,5,52,33,19,53
Cliftonville,7088,2,16,4,10,49,39,10,52
Coleraine,7088,3,13,10,7,46,36,10,49
Linfield,7088,4,13,9,8,55,37,18,48
Ballymena,7088,5,12,9,9,58,54,4,45
Ards,7088,6,14,3,13,40,44,-4,45
Glentoran,7088,7,10,10,10,34,39,-5,40
Glenavon,7088,8,8,14,8,48,52,-4,38
Dungannon,7088,9,9,10,11,51,48,3,37
Portadown,7088,10,5,7,18,20,45,-25,22
Ballinamalla,7088,11,5,5,20,28,54,-26,20
Ballymena,7089,1,16,6,8,67,60,7,54
Cliftonville,7089,2,16,5,9,52,39,13,53
Linfield,7089,3,14,8,8,57,32,25,50
Crusaders,7089,4,13,7,10,48,46,2,46
Dungannon,7089,5,11,10,9,51,36,15,43
Glenavon,7089,6,10,12,8,48,43,5,42
Coleraine,7089,7,9,12,9,36,40,-4,39
Glentoran,7089,8,10,9,11,37,46,-9,39
Ards,7089,9,9,7,14,40,48,-8,34
Ballinamalla,7089,10,8,4,18,27,47,-20,28
Portadown,7089,11,6,6,18,20,46,-26,24
Linfield,7090,1,18,9,3,58,22,36,63
Crusaders,7090,2,18,9,3,61,26,35,63
Cliftonville,7090,3,15,6,9,51,38,13,51
Ballymena,7090,4,14,3,13,52,54,-2,45
Dungannon,7090,5,11,10,9,49,40,9,43
Coleraine,7090,6,9,15,6,37,33,4,42
Glentoran,7090,7,8,10,12,24,38,-14,34
Glenavon,7090,8,7,12,11,35,44,-9,33
Ards,7090,9,8,5,17,35,47,-12,29
Portadown,7090,10,7,5,18,22,49,-27,26
Ballinamalla,7090,11,7,2,21,25,58,-33,23
Crusaders,7091,1,16,7,7,52,33,19,55
Glenavon,7091,2,14,10,6,48,40,8,52
Linfield,7091,3,14,9,7,64,34,30,51
Dungannon,7091,4,13,9,8,55,37,18,48
Ballymena,7091,5,14,4,12,54,54,0,46
Cliftonville,7091,6,13,6,11,56,46,10,45
Coleraine,7091,7,10,10,10,39,41,-2,40
Ards,7091,8,11,4,15,37,51,-14,37
Glentoran,7091,9,6,12,12,28,44,-16,30
Ballinamalla,7091,10,7,7,16,29,49,-20,28
Portadown,7091,11,4,8,18,23,56,-33,20
Ballymena,7092,1,16,6,8,53,48,5,54
Cliftonville,7092,2,14,8,8,59,42,17,50
Coleraine,7092,3,13,11,6,48,36,12,50
Crusaders,7092,4,13,10,7,46,35,11,49
Dungannon,7092,5,10,12,8,54,43,11,42
Linfield,7092,6,10,11,9,47,36,11,41
Glenavon,7092,7,9,13,8,45,41,4,40
Ards,7092,8,10,4,16,36,47,-11,34
Glentoran,7092,9,6,12,12,28,45,-17,30
Portadown,7092,10,7,8,15,29,48,-19,29
Ballinamalla,7092,11,6,7,17,26,50,-24,25
Ballymena,7093,1,17,7,6,73,56,17,58
Linfield,7093,2,15,11,4,61,34,27,56
Cliftonville,7093,3,17,3,10,52,38,14,54
Crusaders,7093,4,14,9,7,61,44,17,51
Glenavon,7093,5,11,11,8,46,46,0,44
Dungannon,7093,6,12,7,11,50,47,3,43
Coleraine,7093,7,10,10,10,37,36,1,40
Ballinamalla,7093,8,7,7,16,32,48,-16,28
Glentoran,7093,9,6,10,14,30,52,-22,28
Ards,7093,10,7,6,17,39,52,-13,27
Portadown,7093,11,6,5,19,25,53,-28,23
Crusaders,7094,1,18,6,6,60,36,24,60
Cliftonville,7094,2,16,8,6,55,33,22,56
Glenavon,7094,3,11,13,6,48,43,5,46
Coleraine,7094,4,11,12,7,41,36,5,45
Linfield,7094,5,12,8,10,56,39,17,44
Ballymena,7094,6,11,7,12,54,59,-5,40
Dungannon,7094,7,8,10,12,44,41,3,34
Glentoran,7094,8,8,8,14,27,50,-23,32
Ards,7094,9,8,7,15,36,47,-11,31
Portadown,7094,10,8,7,15,34,53,-19,31
Ballinamalla,7094,11,7,8,15,26,44,-18,29
Linfield,7095,1,16,10,4,56,24,32,58
Cliftonville,7095,2,15,4,11,49,37,12,49
Coleraine,7095,3,13,10,7,37,37,0,49
Crusaders,7095,4,13,8,9,51,39,12,47
Dungannon,7095,5,13,6,11,57,45,12,45
Ballymena,7095,6,12,9,9,54,54,0,45
Glenavon,7095,7,9,13,8,53,46,7,40
Glentoran,7095,8,10,8,12,30,44,-14,38
Ards,7095,9,8,6,16,34,47,-13,30
Portadown,7095,10,6,8,16,26,49,-23,26
Ballinamalla,7095,11,6,6,18,26,51,-25,24
Crusaders,7096,1,17,8,5,65,39,26,59
Linfield,7096,2,16,10,4,59,27,32,58
Cliftonville,7096,3,16,7,7,53,35,18,55
Ballymena,7096,4,13,4,13,55,59,-4,43
Ards,7096,5,12,5,13,38,42,-4,41
Coleraine,7096,6,10,10,10,46,46,0,40
Glenavon,7096,7,8,13,9,46,50,-4,37
Glentoran,7096,8,9,6,15,26,43,-17,33
Ballinamalla,7096,9,10,3,17,30,50,-20,33
Dungannon,7096,10,7,10,13,44,48,-4,31
Portadown,7096,11,6,6,18,28,51,-23,24
Linfield,7097,1,16,9,5,56,26,30,57
Crusaders,7097,2,16,5,9,51,36,15,53
Cliftonville,7097,3,15,5,10,51,40,11,50
Glenavon,7097,4,13,9,8,51,46,5,48
Ballymena,7097,5,14,4,12,53,57,-4,46
Coleraine,7097,6,10,10,10,43,40,3,40
Dungannon,7097,7,9,11,10,45,38,7,38
Ards,7097,8,10,5,15,39,49,-10,35
Ballinamalla,7097,9,9,4,17,30,49,-19,31
Glentoran,7097,10,8,6,16,30,49,-19,30
Portadown,7097,11,8,6,16,27,46,-19,30
Crusaders,7098,1,19,6,5,65,34,31,63
Cliftonville,7098,2,16,6,8,52,32,20,54
Linfield,7098,3,14,8,8,55,32,23,50
Glenavon,7098,4,11,10,9,50,45,5,43
Ballymena,7098,5,13,4,13,57,60,-3,43
Coleraine,7098,6,10,11,9,34,36,-2,41
Portadown,7098,7,12,4,14,27,41,-14,40
Dungannon,7098,8,9,8,13,50,51,-1,35
Glentoran,7098,9,8,9,13,25,43,-18,33
Ballinamalla,7098,10,8,5,17,28,53,-25,29
Ards,7098,11,8,3,19,33,49,-16,27
Linfield,7099,1,17,8,5,64,28,36,59
Cliftonville,7099,2,15,5,10,45,33,12,50
Coleraine,7099,3,12,11,7,40,31,9,47
Crusaders,7099,4,12,8,10,47,46,1,44
Ballymena,7099,5,13,5,12,55,62,-7,44
Dungannon,7099,6,12,7,11,54,44,10,43
Glenavon,7099,7,10,11,9,51,46,5,41
Glentoran,7099,8,9,8,13,31,41,-10,35
Portadown,7099,9,9,6,15,35,52,-17,33
Ards,7099,10,9,5,16,35,53,-18,32
Ballinamalla,7099,11,6,8,16,28,49,-21,26
Crusaders,7100,1,15,9,6,53,31,22,54
Ballymena,7100,2,15,5,10,62,57,5,50
Linfield,7100,3,12,12,6,56,33,23,48
Cliftonville,7100,4,14,6,10,53,38,15,48
Glenavon,7100,5,10,12,8,45,45,0,42
Ards,7100,6,12,4,14,42,50,-8,40
Dungannon,7100,7,10,9,11,47,47,0,39
Coleraine,7100,8,9,12,9,44,44,0,39
Glentoran,7100,9,8,10,12,29,41,-12,34
Portadown,7100,10,8,6,16,23,43,-20,30
Ballinamalla,7100,11,7,5,18,29,54,-25,26
Crusaders,7101,1,17,8,5,54,32,22,59
Ballymena,7101,2,16,6,8,58,54,4,54
Linfield,7101,3,14,7,9,57,33,24,49
Dungannon,7101,4,12,10,8,57,40,17,46
Cliftonville,7101,5,13,5,12,47,42,5,44
Ards,7101,6,13,2,15,46,51,-5,41
Glenavon,7101,7,8,14,8,42,44,-2,38
Glentoran,7101,8,10,8,12,30,44,-14,38
Coleraine,7101,9,8,11,11,38,41,-3,35
Portadown,7101,10,8,6,16,28,46,-18,30
Ballinamalla,7101,11,4,7,19,21,51,-30,19
Crusaders,7102,1,15,9,6,57,32,25,54
Cliftonville,7102,2,17,3,10,54,40,14,54
Linfield,7102,3,15,8,7,57,37,20,53
Glenavon,7102,4,11,13,6,52,41,11,46
Ballymena,7102,5,13,7,10,55,54,1,46
Coleraine,7102,6,12,9,9,46,45,1,45
Ards,7102,7,11,3,16,38,50,-12,36
Dungannon,7102,8,7,12,11,45,46,-1,33
Glentoran,7102,9,8,8,14,33,46,-13,32
Ballinamalla,7102,10,8,7,15,28,49,-21,31
Portadown,7102,11,6,5,19,23,48,-25,23
Crusaders,7103,1,16,7,7,55,36,19,55
Coleraine,7103,2,15,8,7,47,32,15,53
Cliftonville,7103,3,16,5,9,53,40,13,53
Linfield,7103,4,15,7,8,59,32,27,52
Ballymena,7103,5,16,4,10,60,62,-2,52
Glenavon,7103,6,12,8,10,51,47,4,44
Dungannon,7103,7,10,10,10,47,37,10,40
Ards,7103,8,11,4,15,41,48,-7,37
Glentoran,7103,9,7,7,16,26,54,-28,28
Portadown,7103,10,7,4,19,23,46,-23,25
Ballinamalla,7103,11,6,4,20,28,56,-28,22
Cliftonville,7104,1,18,5,7,58,32,26,59
Crusaders,7104,2,18,4,8,51,34,17,58
Linfield,7104,3,16,8,6,65,33,32,56
Coleraine,7104,4,11,13,6,45,37,8,46
Dungannon,7104,5,11,8,11,49,43,6,41
Glenavon,7104,6,10,10,10,45,43,2,40
Glentoran,7104,7,11,6,13,34,41,-7,39
Ballymena,7104,8,9,8,13,50,64,-14,35
Ballinamalla,7104,9,9,3,18,34,52,-18,30
Ards,7104,10,9,3,18,41,60,-19,30
Portadown,7104,11,7,4,19,23,56,-33,25
Crusaders,7105,1,17,8,5,63,36,27,59
Linfield,7105,2,16,8,6,61,30,31,56
Ballymena,7105,3,16,4,10,57,60,-3,52
Glenavon,7105,4,13,9,8,52,43,9,48
Cliftonville,7105,5,13,5,12,40,33,7,44
Coleraine,7105,6,11,10,9,41,36,5,43
Dungannon,7105,7,11,6,13,51,47,4,39
Glentoran,7105,8,9,7,14,29,43,-14,34
Ballinamalla,7105,9,9,5,16,33,52,-19,32
Portadown,7105,10,7,6,17,21,44,-23,27
Ards,7105,11,7,4,19,32,56,-24,25
Cliftonville,7106,1,16,6,8,51,34,17,54
Linfield,7106,2,13,8,9,52,32,20,47
Dungannon,7106,3,13,7,10,47,40,7,46
Ballymena,7106,4,13,7,10,54,58,-4,46
Crusaders,7106,5,11,11,8,50,40,10,44
Glenavon,7106,6,9,13,8,42,40,2,40
Coleraine,7106,7,9,13,8,40,38,2,40
Glentoran,7106,8,10,9,11,38,44,-6,39
Ballinamalla,7106,9,10,5,15,35,46,-11,35
Ards,7106,10,9,5,16,39,54,-15,32
Portadown,7106,11,7,6,17,21,43,-22,27
Crusaders,7107,1,15,8,7,55,37,18,53
Cliftonville,7107,2,15,8,7,60,46,14,53
Linfield,7107,3,12,12,6,56,32,24,48
Coleraine,7107,4,12,11,7,47,38,9,47
Dungannon,7107,5,12,10,8,52,41,11,46
Ballymena,7107,6,13,7,10,55,58,-3,46
Ards,7107,7,10,8,12,40,43,-3,38
Glenavon,7107,8,10,8,12,44,51,-7,38
Glentoran,7107,9,7,9,14,32,44,-12,30
Ballinamalla,7107,10,7,5,18,28,55,-27,26
Portadown,7107,11,5,8,17,19,43,-24,23
Linfield,7108,1,16,10,4,67,29,38,58
Crusaders,7108,2,15,9,6,53,34,19,54
Glenavon,7108,3,14,9,7,55,43,12,51
Coleraine,7108,4,14,8,8,47,42,5,50
Cliftonville,7108,5,14,3,13,57,49,8,45
Ballymena,7108,6,13,6,11,59,64,-5,45
Ards,7108,7,10,6,14,43,42,1,36
Dungannon,7108,8,9,8,13,48,51,-3,35
Glentoran,7108,9,9,8,13,30,46,-16,35
Portadown,7108,10,7,6,17,25,50,-25,27
Ballinamalla,7108,11,6,3,21,23,57,-34,21
Linfield,7109,1,16,7,7,61,33,28,55
Dungannon,7109,2,13,9,8,56,44,12,48
Crusaders,7109,3,14,6,10,55,43,12,48
Cliftonville,7109,4,15,2,13,59,45,14,47
Ballymena,7109,5,14,5,11,60,61,-1,47
Glenavon,7109,6,9,13,8,48,50,-2,40
Coleraine,7109,7,11,7,12,43,46,-3,40
Ballinamalla,7109,8,12,3,15,35,48,-13,39
Glentoran,7109,9,10,5,15,36,50,-14,35
Portadown,7109,10,9,6,15,31,47,-16,33
Ards,7109,11,8,5,17,37,54,-17,29
Cliftonville,7110,1,17,4,9,55,37,18,55
Crusaders,7110,2,15,8,7,50,31,19,53
Linfield,7110,3,13,12,5,57,30,27,51
Glenavon,7110,4,13,10,7,52,42,10,49
Coleraine,7110,5,12,10,8,47,37,10,46
Dungannon,7110,6,12,8,10,53,48,5,44
Ballymena,7110,7,11,10,9,49,55,-6,43
Ards,7110,8,11,5,14,39,50,-11,38
Glentoran,7110,9,9,7,14,31,42,-11,34
Portadown,7110,10,6,7,17,22,44,-22,25
Ballinamalla,7110,11,4,3,23,27,66,-39,15
Linfield,7111,1,15,8,7,65,36,29,53
Crusaders,7111,2,14,10,6,53,32,21,52
Glenavon,7111,3,13,12,5,55,44,11,51
Coleraine,7111,4,13,11,6,53,39,14,50
Cliftonville,7111,5,13,6,11,57,51,6,45
Ballymena,7111,6,13,6,11,57,62,-5,45
Glentoran,7111,7,9,9,12,36,47,-11,36
Dungannon,7111,8,7,11,12,42,47,-5,32
Ards,7111,9,8,7,15,38,52,-14,31
Portadown,7111,10,6,9,15,24,46,-22,27
Ballinamalla,7111,11,8,3,19,30,54,-24,27
Crusaders,7112,1,14,9,7,53,40,13,51
Ballymena,7112,2,14,6,10,60,54,6,48
Cliftonville,7112,3,13,8,9,54,46,8,47
Glenavon,7112,4,12,10,8,49,50,-1,46
Linfield,7112,5,12,9,9,55,38,17,45
Coleraine,7112,6,11,11,8,42,35,7,44
Dungannon,7112,7,9,8,13,46,43,3,35
Ards,7112,8,8,11,11,44,48,-4,35
Glentoran,7112,9,9,8,13,38,43,-5,35
Portadown,7112,10,9,6,15,30,50,-20,33
Ballinamalla,7112,11,7,8,15,29,53,-24,29
Cliftonville,7113,1,18,5,7,53,33,20,59
Ballymena,7113,2,17,7,6,65,47,18,58
Crusaders,7113,3,16,6,8,54,39,15,54
Linfield,7113,4,13,10,7,59,33,26,49
Glenavon,7113,5,12,11,7,44,45,-1,47
Dungannon,7113,6,10,10,10,52,46,6,40
Coleraine,7113,7,9,11,10,32,37,-5,38
Ballinamalla,7113,8,9,6,15,40,52,-12,33
Glentoran,7113,9,8,5,17,29,44,-15,29
Portadown,7113,10,8,3,19,26,49,-23,27
Ards,7113,11,6,4,20,30,59,-29,22
Crusaders,7114,1,18,6,6,62,32,30,60
Linfield,7114,2,16,9,5,54,33,21,57
Coleraine,7114,3,14,10,6,42,27,15,52
Cliftonville,7114,4,14,3,13,53,44,9,45
Ballymena,7114,5,12,4,14,56,68,-12,40
Portadown,7114,6,11,4,15,29,42,-13,37
Dungannon,7114,7,8,12,10,49,47,2,36
Glenavon,7114,8,8,12,10,43,52,-9,36
Glentoran,7114,9,9,6,15,30,49,-19,33
Ards,7114,10,8,7,15,41,51,-10,31
Ballinamalla,7114,11,8,5,17,33,47,-14,29
Crusaders,7115,1,19,6,5,56,27,29,63
Ballymena,7115,2,18,4,8,63,45,18,58
Dungannon,7115,3,15,7,8,57,42,15,52
Linfield,7115,4,12,12,6,52,33,19,48
Glenavon,7115,5,11,9,10,47,41,6,42
Coleraine,7115,6,10,11,9,39,43,-4,41
Cliftonville,7115,7,10,7,13,44,51,-7,37
Portadown,7115,8,10,5,15,31,43,-12,35
Ballinamalla,7115,9,9,2,19,38,57,-19,29
Glentoran,7115,10,6,10,14,30,55,-25,28
Ards,7115,11,5,7,18,31,51,-20,22
Crusaders,7116,1,19,7,4,57,28,29,64
Linfield,7116,2,15,11,4,61,28,33,56
Coleraine,7116,3,12,14,4,46,33,13,50
Cliftonville,7116,4,13,7,10,50,38,12,46
Ballymena,7116,5,13,7,10,56,66,-10,46
Dungannon,7116,6,9,10,11,47,42,5,37
Glentoran,7116,7,9,8,13,27,42,-15,35
Glenavon,7116,8,8,10,12,44,54,-10,34
Ards,7116,9,7,8,15,35,50,-15,29
Portadown,7116,10,7,5,18,32,49,-17,26
Ballinamalla,7116,11,7,5,18,32,57,-25,26
Crusaders,7117,1,19,10,1,66,29,37,67
Linfield,7117,2,14,11,5,62,34,28,53
Coleraine,7117,3,13,11,6,46,34,12,50
Glenavon,7117,4,11,13,6,47,41,6,46
Ballymena,7117,5,12,10,8,56,58,-2,46
Cliftonville,7117,6,12,3,15,49,50,-1,39
Dungannon,7117,7,9,7,14,48,56,-8,34
Ards,7117,8,9,6,15,38,49,-11,33
Portadown,7117,9,7,8,15,27,42,-15,29
Glentoran,7117,10,6,8,16,23,48,-25,26
Ballinamalla,7117,11,6,7,17,28,49,-21,25
Crusaders,7118,1,16,8,6,58,34,24,56
Linfield,7118,2,14,9,7,68,35,33,51
Ballymena,7118,3,14,8,8,60,58,2,50
Cliftonville,7118,4,14,6,10,56,41,15,48
Glenavon,7118,5,12,9,9,53,50,3,45
Dungannon,7118,6,10,11,9,57,48,9,41
Coleraine,7118,7,10,11,9,46,46,0,41
Glentoran,7118,8,11,7,12,36,46,-10,40
Ards,7118,9,9,8,13,40,51,-11,35
Portadown,7118,10,7,3,20,23,53,-30,24
Ballinamalla,7118,11,6,4,20,25,60,-35,22
Linfield,7119,1,18,7,5,61,26,35,61
Crusaders,7119,2,16,9,5,57,37,20,57
Cliftonville,7119,3,14,6,10,46,41,5,48
Ballymena,7119,4,14,6,10,56,54,2,48
Glenavon,7119,5,11,12,7,48,42,6,45
Coleraine,7119,6,10,9,11,40,42,-2,39
Dungannon,7119,7,9,8,13,46,45,1,35
Glentoran,7119,8,8,8,14,31,41,-10,32
Ards,7119,9,9,5,16,36,52,-16,32
Portadown,7119,10,7,7,16,28,45,-17,28
Ballinamalla,7119,11,7,7,16,28,52,-24,28
Crusaders,7120,1,17,6,7,61,37,24,57
Linfield,7120,2,13,10,7,57,34,23,49
Glenavon,7120,3,12,10,8,42,40,2,46
Ballymena,7120,4,13,5,12,59,59,0,44
Coleraine,7120,5,11,9,10,38,39,-1,42
Dungannon,7120,6,10,11,9,51,45,6,41
Cliftonville,7120,7,11,6,13,45,45,0,39
Portadown,7120,8,11,6,13,36,42,-6,39
Ards,7120,9,10,7,13,41,44,-3,37
Glentoran,7120,10,8,10,12,31,48,-17,34
Ballinamalla,7120,11,6,6,18,31,59,-28,24
Crusaders,7121,1,15,8,7,56,40,16,53
Coleraine,7121,2,14,11,5,48,32,16,53
Linfield,7121,3,14,10,6,59,36,23,52
Cliftonville,7121,4,13,8,9,53,40,13,47
Glenavon,7121,5,11,12,7,48,47,1,45
Ballymena,7121,6,11,10,9,54,55,-1,43
Dungannon,7121,7,9,9,12,46,46,0,36
Portadown,7121,8,7,9,14,27,42,-15,30
Glentoran,7121,9,7,9,14,33,49,-16,30
Ards,7121,10,7,7,16,35,51,-16,28
Ballinamalla,7121,11,6,9,15,28,49,-21,27
Crusaders,7122,1,17,8,5,57,31,26,59
Cliftonville,7122,2,16,6,8,53,38,15,54
Linfield,7122,3,13,8,9,51,34,17,47
Ballinamalla,7122,4,14,1,15,42,44,-2,43
Glentoran,7122,5,12,6,12,37,42,-5,42
Ballymena,7122,6,12,6,12,55,61,-6,42
Dungannon,7122,7,10,11,9,48,38,10,41
Ards,7122,8,11,3,16,42,47,-5,36
Glenavon,7122,9,8,9,13,36,57,-21,33
Coleraine,7122,10,8,8,14,33,42,-9,32
Portadown,7122,11,7,8,15,20,40,-20,29
Cliftonville,7123,1,17,4,9,50,33,17,55
Crusaders,7123,2,15,8,7,47,35,12,53
Coleraine,7123,3,13,10,7,40,32,8,49
Linfield,7123,4,13,8,9,54,29,25,47
Dungannon,7123,5,13,8,9,59,44,15,47
Ballymena,7123,6,14,5,11,54,55,-1,47
Glenavon,7123,7,9,9,12,41,47,-6,36
Ards,7123,8,9,8,13,36,44,-8,35
Glentoran,7123,9,6,11,13,35,49,-14,29
Ballinamalla,7123,10,7,7,16,29,53,-24,28
Portadown,7123,11,8,4,18,24,48,-24,28
Crusaders,7124,1,17,7,6,55,32,23,58
Linfield,7124,2,14,9,7,48,28,20,51
Ballymena,7124,3,14,7,9,55,54,1,49
Glenavon,7124,4,12,12,6,48,40,8,48
Cliftonville,7124,5,14,6,10,43,35,8,48
Coleraine,7124,6,9,11,10,37,41,-4,38
Dungannon,7124,7,9,9,12,46,40,6,36
Ballinamalla,7124,8,10,5,15,36,49,-13,35
Glentoran,7124,9,8,9,13,29,41,-12,33
Ards,7124,10,8,6,16,41,56,-15,30
Portadown,7124,11,6,7,17,21,43,-22,25
Crusaders,7125,1,17,10,3,62,33,29,61
Linfield,7125,2,16,8,6,65,31,34,56
Dungannon,7125,3,12,10,8,63,47,16,46
Cliftonville,7125,4,13,6,11,50,41,9,45
Glenavon,7125,5,12,9,9,45,50,-5,45
Ballymena,7125,6,12,6,12,54,64,-10,42
Ards,7125,7,12,5,13,40,44,-4,41
Coleraine,7125,8,8,12,10,40,40,0,36
Glentoran,7125,9,8,7,15,28,46,-18,31
Portadown,7125,10,8,4,18,29,53,-24,28
Ballinamalla,7125,11,6,5,19,28,55,-27,23
Crusaders,7126,1,18,8,4,58,29,29,62
Glenavon,7126,2,18,8,4,62,34,28,62
Cliftonville,7126,3,17,4,9,53,39,14,55
Linfield,7126,4,14,8,8,49,27,22,50
Ballymena,7126,5,14,6,10,57,53,4,48
Coleraine,7126,6,8,11,11,39,42,-3,35
Glentoran,7126,7,7,12,11,24,35,-11,33
Dungannon,7126,8,6,11,13,39,53,-14,29
Ards,7126,9,7,7,16,31,50,-19,28
Ballinamalla,7126,10,7,7,16,26,51,-25,28
Portadown,7126,11,5,6,19,22,47,-25,21
Crusaders,7127,1,20,7,3,62,30,32,67
Linfield,7127,2,14,8,8,47,25,22,50
Ballymena,7127,3,15,5,10,55,57,-2,50
Glentoran,7127,4,14,7,9,41,36,5,49
Glenavon,7127,5,11,10,9,49,51,-2,43
Coleraine,7127,6,10,11,9,48,42,6,41
Cliftonville,7127,7,12,3,15,44,46,-2,39
Portadown,7127,8,10,5,15,34,47,-13,35
Dungannon,7127,9,9,7,14,55,50,5,34
Ards,7127,10,8,5,17,39,58,-19,29
Ballinamalla,7127,11,5,6,19,26,58,-32,21
Linfield,7128,1,17,8,5,61,27,34,59
Cliftonville,7128,2,16,6,8,48,32,16,54
Crusaders,7128,3,15,8,7,54,37,17,53
Ballymena,7128,4,14,7,9,53,56,-3,49
Dungannon,7128,5,11,10,9,55,50,5,43
Coleraine,7128,6,11,10,9,43,39,4,43
Glenavon,7128,7,9,10,11,49,55,-6,37
Ards,7128,8,8,7,15,39,50,-11,31
Glentoran,7128,9,8,6,16,27,46,-19,30
Ballinamalla,7128,10,9,3,18,31,51,-20,30
Portadown,7128,11,6,7,17,32,49,-17,25
Cliftonville,7129,1,18,3,9,56,35,21,57
Crusaders,7129,2,14,11,5,53,36,17,53
Linfield,7129,3,13,10,7,60,31,29,49
Ballymena,7129,4,14,6,10,56,55,1,48
Coleraine,7129,5,11,10,9,39,41,-2,43
Dungannon,7129,6,10,11,9,49,38,11,41
Glenavon,7129,7,9,12,9,46,50,-4,39
Ballinamalla,7129,8,10,6,14,32,43,-11,36
Portadown,7129,9,10,5,15,33,46,-13,35
Glentoran,7129,10,7,9,14,28,44,-16,30
Ards,7129,11,6,3,21,28,61,-33,21
Glenavon,7130,1,16,9,5,60,43,17,57
Linfield,7130,2,15,9,6,54,26,28,54
Cliftonville,7130,3,16,4,10,50,35,15,52
Crusaders,7130,4,14,8,8,57,47,10,50
Ballymena,7130,5,13,7,10,52,54,-2,46
Coleraine,7130,6,12,9,9,45,38,7,45
Dungannon,7130,7,11,9,10,56,42,14,42
Glentoran,7130,8,11,5,14,31,49,-18,38
Ards,7130,9,9,6,15,34,47,-13,33
Ballinamalla,7130,10,6,5,19,28,54,-26,23
Portadown,7130,11,5,3,22,23,55,-32,18
Crusaders,7131,1,17,7,6,54,30,24,58
Ballymena,7131,2,17,7,6,66,52,14,58
Cliftonville,7131,3,15,5,10,48,40,8,50
Linfield,7131,4,12,10,8,52,30,22,46
Glenavon,7131,5,12,10,8,50,42,8,46
Dungannon,7131,6,9,10,11,47,50,-3,37
Coleraine,7131,7,8,11,11,41,49,-8,35
Glentoran,7131,8,9,7,14,26,42,-16,34
Ards,7131,9,8,7,15,35,47,-12,31
Ballinamalla,7131,10,9,4,17,34,52,-18,31
Portadown,7131,11,6,8,16,22,41,-19,26
Crusaders,7132,1,19,8,3,65,34,31,65
Linfield,7132,2,16,10,4,62,30,32,58
Cliftonville,7132,3,16,3,11,53,40,13,51
Glenavon,7132,4,13,10,7,46,35,11,49
Ballymena,7132,5,12,7,11,50,57,-7,43
Coleraine,7132,6,10,11,9,43,41,2,41
Glentoran,7132,7,7,11,12,31,44,-13,32
Dungannon,7132,8,7,10,13,50,49,1,31
Ballinamalla,7132,9,9,4,17,32,53,-21,31
Portadown,7132,10,7,6,17,21,49,-28,27
Ards,7132,11,5,8,17,30,51,-21,23
Ballymena,7133,1,18,4,8,62,51,11,58
Cliftonville,7133,2,16,6,8,49,32,17,54
Linfield,7133,3,13,11,6,55,29,26,50
Crusaders,7133,4,13,11,6,45,33,12,50
Glenavon,7133,5,12,9,9,49,43,6,45
Coleraine,7133,6,10,8,12,38,41,-3,38
Dungannon,7133,7,8,12,10,47,41,6,36
Ards,7133,8,11,3,16,38,51,-13,36
Glentoran,7133,9,7,9,14,26,43,-17,30
Ballinamalla,7133,10,7,7,16,27,46,-19,28
Portadown,7133,11,7,6,17,18,44,-26,27
Linfield,7134,1,17,8,5,62,30,32,59
Crusaders,7134,2,15,9,6,57,36,21,54
Cliftonville,7134,3,16,5,9,52,37,15,53
Dungannon,7134,4,13,8,9,50,41,9,47
Glentoran,7134,5,12,5,13,34,44,-10,41
Ballymena,7134,6,11,7,12,61,62,-1,40
Coleraine,7134,7,9,12,9,40,36,4,39
Glenavon,7134,8,9,11,10,42,49,-7,38
Ards,7134,9,9,4,17,32,51,-19,31
Ballinamalla,7134,10,8,4,18,30,52,-22,28
Portadown,7134,11,8,3,19,27,49,-22,27
Crusaders,7135,1,17,7,6,59,36,23,58
Linfield,7135,2,16,8,6,63,36,27,56
Glenavon,7135,3,13,10,7,53,40,13,49
Coleraine,7135,4,13,10,7,50,41,9,49
Cliftonville,7135,5,13,7,10,48,37,11,46
Ballymena,7135,6,12,8,10,52,53,-1,44
Glentoran,7135,7,9,9,12,34,43,-9,36
Ards,7135,8,9,6,15,34,48,-14,33
Ballinamalla,7135,9,8,6,16,33,56,-23,30
Dungannon,7135,10,7,8,15,45,53,-8,29
Portadown,7135,11,5,7,18,21,49,-28,22
Crusaders,7136,1,17,7,6,59,32,27,58
Ballymena,7136,2,15,6,9,60,55,5,51
Coleraine,7136,3,13,10,7,48,37,11,49
Linfield,7136,4,13,9,8,57,37,20,48
Cliftonville,7136,5,14,4,12,55,46,9,46
Glenavon,7136,6,11,10,9,45,41,4,43
Ards,7136,7,11,6,13,41,46,-5,39
Dungannon,7136,8,9,7,14,45,50,-5,34
Ballinamalla,7136,9,10,3,17,31,51,-20,33
Glentoran,7136,10,9,5,16,31,51,-20,32
Portadown,7136,11,6,7,17,24,50,-26,25
Ballymena,7137,1,17,5,8,61,48,13,56
Linfield,7137,2,15,6,9,58,35,23,51
Crusaders,7137,3,14,9,7,46,32,14,51
Cliftonville,7137,4,14,7,9,54,40,14,49
Glenavon,7137,5,11,12,7,44,35,9,45
Dungannon,7137,6,11,9,10,45,34,11,42
Glentoran,7137,7,11,8,11,33,42,-9,41
Coleraine,7137,8,9,11,10,43,49,-6,38
Ards,7137,9,10,3,17,34,48,-14,33
Portadown,7137,10,6,7,17,25,50,-25,25
Ballinamalla,7137,11,4,9,17,23,53,-30,21
Crusaders,7138,1,16,9,5,59,34,25,57
Linfield,7138,2,16,8,6,57,34,23,56
Ballymena,7138,3,17,4,9,61,56,5,55
Dungannon,7138,4,13,9,8,55,40,15,48
Cliftonville,7138,5,14,5,11,53,42,11,47
Coleraine,7138,6,12,11,7,42,35,7,47
Glenavon,7138,7,10,13,7,41,39,2,43
Ards,7138,8,8,8,14,39,48,-9,32
Glentoran,7138,9,7,10,13,32,46,-14,31
Ballinamalla,7138,10,5,4,21,27,62,-35,19
Portadown,7138,11,5,3,22,25,55,-30,18
Crusaders,7139,1,21,4,5,68,30,38,67
Cliftonville,7139,2,16,3,11,52,43,9,51
Ballymena,7139,3,14,6,10,57,55,2,48
Glenavon,7139,4,13,9,8,44,42,2,48
Linfield,7139,5,12,10,8,57,32,25,46
Coleraine,7139,6,11,11,8,43,40,3,44
Dungannon,7139,7,10,9,11,48,43,5,39
Glentoran,7139,8,10,7,13,38,48,-10,37
Ards,7139,9,7,8,15,36,53,-17,29
Ballinamalla,7139,10,7,5,18,27,51,-24,26
Portadown,7139,11,5,6,19,22,55,-33,21
Crusaders,7140,1,16,7,7,58,40,18,55
Ballymena,7140,2,14,8,8,54,56,-2,50
Cliftonville,7140,3,15,4,11,48,39,9,49
Linfield,7140,4,11,11,8,55,37,18,44
Dungannon,7140,5,12,8,10,56,45,11,44
Coleraine,7140,6,11,10,9,49,43,6,43
Glenavon,7140,7,10,13,7,47,45,2,43
Ards,7140,8,10,7,13,39,44,-5,37
Glentoran,7140,9,9,10,11,32,42,-10,37
Portadown,7140,10,8,4,18,31,49,-18,28
Ballinamalla,7140,11,7,2,21,28,57,-29,23
Ballymena,7141,1,18,5,7,65,48,17,59
Linfield,7141,2,15,8,7,64,33,31,53
Cliftonville,7141,3,15,6,9,50,35,15,51
Glenavon,7141,4,13,9,8,43,42,1,48
Crusaders,7141,5,11,10,9,48,39,9,43
Coleraine,7141,6,11,8,11,34,38,-4,41
Dungannon,7141,7,10,8,12,47,48,-1,38
Ballinamalla,7141,8,10,8,12,33,42,-9,38
Glentoran,7141,9,8,9,13,28,43,-15,33
Ards,7141,10,9,4,17,34,50,-16,31
Portadown,7141,11,5,5,20,18,46,-28,20
Linfield,7142,1,17,6,7,63,26,37,57
Crusaders,7142,2,16,9,5,50,32,18,57
Dungannon,7142,3,14,8,8,57,35,22,50
Coleraine,7142,4,11,13,6,48,40,8,46
Cliftonville,7142,5,13,5,12,48,39,9,44
Ballymena,7142,6,13,4,13,57,58,-1,43
Glentoran,7142,7,12,7,11,28,37,-9,43
Glenavon,7142,8,9,9,12,44,48,-4,36
Ballinamalla,7142,9,10,4,16,28,45,-17,34
Ards,7142,10,7,9,14,33,48,-15,30
Portadown,7142,11,5,2,23,16,64,-48,17
Linfield,7143,1,13,10,7,57,35,22,49
Cliftonville,7143,2,13,9,8,53,40,13,48
Dungannon,7143,3,12,10,8,50,36,14,46
Coleraine,7143,4,11,11,8,43,40,3,44
Ballymena,7143,5,12,8,10,59,62,-3,44
Glenavon,7143,6,11,10,9,42,39,3,43
Crusaders,7143,7,11,9,10,44,41,3,42
Ballinamalla,7143,8,11,5,14,36,46,-10,38
Glentoran,7143,9,8,8,14,30,46,-16,32
Ards,7143,10,8,7,15,39,50,-11,31
Portadown,7143,11,8,7,15,20,38,-18,31
Crusaders,7144,1,14,10,6,59,41,18,52
Cliftonville,7144,2,16,4,10,62,46,16,52
Ballymena,7144,3,15,6,9,61,61,0,51
Linfield,7144,4,12,11,7,58,38,20,47
Glenavon,7144,5,12,10,8,52,46,6,46
Coleraine,7144,6,12,10,8,46,44,2,46
Dungannon,7144,7,11,9,10,51,42,9,42
Ards,7144,8,10,4,16,39,45,-6,34
Glentoran,7144,9,9,7,14,31,48,-17,34
Ballinamalla,7144,10,6,7,17,36,59,-23,25
Portadown,7144,11,5,8,17,30,55,-25,23
Crusaders,7145,1,18,9,3,58,29,29,63
Linfield,7145,2,16,9,5,57,27,30,57
Coleraine,7145,3,12,9,9,35,32,3,45
Ballymena,7145,4,11,11,8,62,62,0,44
Cliftonville,7145,5,13,4,13,48,42,6,43
Glenavon,7145,6,9,12,9,42,48,-6,39
Glentoran,7145,7,10,7,13,35,46,-11,37
Portadown,7145,8,9,6,15,28,43,-15,33
Ards,7145,9,9,5,16,34,45,-11,32
Dungannon,7145,10,5,14,11,47,48,-1,29
Ballinamalla,7145,11,7,6,17,25,49,-24,27
Crusaders,7146,1,18,8,4,55,27,28,62
Coleraine,7146,2,15,9,6,47,34,13,54
Cliftonville,7146,3,14,6,10,52,43,9,48
Linfield,7146,4,13,8,9,61,40,21,47
Glenavon,7146,5,11,11,8,49,43,6,44
Ballymena,7146,6,11,7,12,54,64,-10,40
Dungannon,7146,7,10,8,12,52,46,6,38
Portadown,7146,8,11,2,17,33,51,-18,35
Glentoran,7146,9,8,7,15,30,48,-18,31
Ards,7146,10,8,6,16,37,53,-16,30
Ballinamalla,7146,11,9,2,19,32,53,-21,29
Glenavon,7147,1,14,11,5,56,40,16,53
Crusaders,7147,2,14,8,8,53,42,11,50
Coleraine,7147,3,12,12,6,46,35,11,48
Ballymena,7147,4,13,7,10,62,67,-5,46
Linfield,7147,5,11,11,8,58,39,19,44
Cliftonville,7147,6,11,9,10,47,39,8,42
Dungannon,7147,7,9,11,10,54,49,5,38
Glentoran,7147,8,10,7,13,30,45,-15,37
Portadown,7147,9,10,4,16,33,47,-14,34
Ballinamalla,7147,10,10,2,18,38,56,-18,32
Ards,7147,11,7,6,17,32,50,-18,27
Linfield,7148,1,17,8,5,60,28,32,59
Crusaders,7148,2,17,6,7,58,32,26,57
Coleraine,7148,3,13,12,5,47,35,12,51
Cliftonville,7148,4,15,3,12,49,38,11,48
Ballymena,7148,5,14,5,11,64,62,2,47
Glenavon,7148,6,10,10,10,43,45,-2,40
Glentoran,7148,7,11,6,13,35,46,-11,39
Dungannon,7148,8,8,11,11,45,45,0,35
Ards,7148,9,7,10,13,30,44,-14,31
Portadown,7148,10,7,5,18,23,52,-29,26
Ballinamalla,7148,11,6,4,20,26,53,-27,22
Linfield,7149,1,16,8,6,58,27,31,56
Glenavon,7149,2,15,9,6,49,38,11,54
Crusaders,7149,3,15,8,7,55,34,21,53
Coleraine,7149,4,12,10,8,43,38,5,46
Cliftonville,7149,5,13,6,11,50,43,7,45
Ballymena,7149,6,11,10,9,46,50,-4,43
Dungannon,7149,7,10,7,13,48,48,0,37
Ards,7149,8,10,6,14,43,53,-10,36
Glentoran,7149,9,9,4,17,32,52,-20,31
Portadown,7149,10,8,5,17,25,45,-20,29
Ballinamalla,7149,11,7,5,18,32,53,-21,26
Crusaders,7150,1,16,8,6,54,30,24,56
Linfield,7150,2,16,7,7,63,33,30,55
Cliftonville,7150,3,16,6,8,51,38,13,54
Ballymena,7150,4,14,6,10,56,60,-4,48
Coleraine,7150,5,10,12,8,45,36,9,42
Glenavon,7150,6,10,11,9,44,44,0,41
Dungannon,7150,7,9,9,12,53,47,6,36
Portadown,7150,8,10,5,15,28,42,-14,35
Glentoran,7150,9,7,12,11,34,47,-13,33
Ards,7150,10,7,6,17,34,55,-21,27
Ballinamalla,7150,11,7,4,19,25,55,-30,25
Linfield,7151,1,15,11,4,57,28,29,56
Cliftonville,7151,2,17,4,9,60,38,22,55
Crusaders,7151,3,14,6,10,49,37,12,48
Coleraine,7151,4,12,12,6,41,31,10,48
Dungannon,7151,5,13,7,10,52,35,17,46
Glenavon,7151,6,11,13,6,48,47,1,46
Ballymena,7151,7,11,8,11,58,64,-6,41
Glentoran,7151,8,10,5,15,23,44,-21,35
Ballinamalla,7151,9,8,5,17,29,52,-23,29
Portadown,7151,10,6,8,16,20,43,-23,26
Ards,7151,11,6,5,19,33,51,-18,23
Linfield,7152,1,16,8,6,62,34,28,56
Crusaders,7152,2,15,6,9,61,44,17,51
Cliftonville,7152,3,15,6,9,53,39,14,51
Ballymena,7152,4,13,6,11,60,58,2,45
Ards,7152,5,13,4,13,44,44,0,43
Coleraine,7152,6,10,12,8,38,39,-1,42
Glenavon,7152,7,10,9,11,43,46,-3,39
Dungannon,7152,8,10,7,13,50,46,4,37
Ballinamalla,7152,9,10,5,15,28,41,-13,35
Portadown,7152,10,10,3,17,27,49,-22,33
Glentoran,7152,11,5,10,15,31,57,-26,25
Linfield,7153,1,17,8,5,63,25,38,59
Crusaders,7153,2,15,10,5,53,32,21,55
Cliftonville,7153,3,16,5,9,56,40,16,53
Dungannon,7153,4,12,9,9,53,37,16,45
Coleraine,7153,5,11,9,10,40,43,-3,42
Glenavon,7153,6,9,14,7,42,43,-1,41
Ballymena,7153,7,12,5,13,53,60,-7,41
Ards,7153,8,9,4,17,33,48,-15,31
Portadown,7153,9,8,5,17,23,48,-25,29
Glentoran,7153,10,6,10,14,23,38,-15,28
Ballinamalla,7153,11,7,7,16,27,52,-25,28
Crusaders,7154,1,16,7,7,60,37,23,55
Ballymena,7154,2,16,5,9,60,57,3,53
Linfield,7154,3,14,10,6,56,29,27,52
Glenavon,7154,4,12,10,8,54,50,4,46
Coleraine,7154,5,11,10,9,51,43,8,43
Cliftonville,7154,6,12,6,12,48,47,1,42
Dungannon,7154,7,10,9,11,45,41,4,39
Glentoran,7154,8,10,6,14,30,49,-19,36
Ards,7154,9,9,6,15,37,50,-13,33
Ballinamalla,7154,10,8,5,17,30,48,-18,29
Portadown,7154,11,8,4,18,20,40,-20,28
Cliftonville,7155,1,17,7,6,53,31,22,58
Crusaders,7155,2,16,8,6,56,38,18,56
Linfield,7155,3,15,9,6,66,33,33,54
Glenavon,7155,4,12,11,7,49,44,5,47
Dungannon,7155,5,12,8,10,56,43,13,44
Ballymena,7155,6,13,5,12,57,59,-2,44
Coleraine,7155,7,8,13,9,36,38,-2,37
Ards,7155,8,10,5,15,35,46,-11,35
Glentoran,7155,9,8,8,14,24,36,-12,32
Portadown,7155,10,8,8,14,27,50,-23,32
Ballinamalla,7155,11,4,2,24,18,59,-41,14
Crusaders,7156,1,17,8,5,61,32,29,59
Linfield,7156,2,14,13,3,58,30,28,55
Glenavon,7156,3,12,11,7,53,44,9,47
Cliftonville,7156,4,13,7,10,59,43,16,46
Coleraine,7156,5,11,13,6,47,33,14,46
Ballymena,7156,6,11,9,10,56,62,-6,42
Glentoran,7156,7,8,11,11,28,44,-16,35
Portadown,7156,8,9,6,15,24,45,-21,33
Ards,7156,9,9,5,16,38,55,-17,32
Dungannon,7156,10,6,10,14,43,51,-8,28
Ballinamalla,7156,11,5,7,18,28,56,-28,22
Crusaders,7157,1,16,9,5,60,30,30,57
Cliftonville,7157,2,16,5,9,48,36,12,53
Linfield,7157,3,14,8,8,56,38,18,50
Coleraine,7157,4,13,11,6,44,30,14,50
Dungannon,7157,5,11,10,9,53,43,10,43
Glenavon,7157,6,10,12,8,50,44,6,42
Ballymena,7157,7,11,8,11,53,62,-9,41
Ards,7157,8,11,5,14,40,50,-10,38
Glentoran,7157,9,8,5,17,29,50,-21,29
Portadown,7157,10,7,6,17,28,49,-21,27
Ballinamalla,7157,11,7,3,20,27,56,-29,24
Crusaders,7158,1,16,8,6,54,36,18,56
Linfield,7158,2,15,10,5,79,37,42,55
Glenavon,7158,3,13,11,6,57,42,15,50
Cliftonville,7158,4,13,11,6,57,43,14,50
Coleraine,7158,5,10,11,9,40,34,6,41
Ballymena,7158,6,11,7,12,51,68,-17,40
Dungannon,7158,7,10,9,11,52,48,4,39
Ards,7158,8,9,5,16,43,57,-14,32
Glentoran,7158,9,8,7,15,36,58,-22,31
Portadown,7158,10,7,7,16,27,47,-20,28
Ballinamalla,7158,11,7,6,17,25,51,-26,27
Cliftonville,7159,1,17,5,8,55,35,20,56
Crusaders,7159,2,17,5,8,56,41,15,56
Linfield,7159,3,13,10,7,58,36,22,49
Coleraine,7159,4,12,9,9,46,41,5,45
Ballymena,7159,5,11,10,9,56,59,-3,43
Glentoran,7159,6,11,9,10,35,38,-3,42
Dungannon,7159,7,8,11,11,41,39,2,35
Glenavon,7159,8,8,11,11,43,48,-5,35
Ards,7159,9,9,7,14,35,45,-10,34
Ballinamalla,7159,10,7,8,15,33,52,-19,29
Portadown,7159,11,6,7,17,30,54,-24,25
Crusaders,7160,1,16,10,4,57,31,26,58
Linfield,7160,2,16,6,8,61,38,23,54
Ballymena,7160,3,16,5,9,55,51,4,53
Cliftonville,7160,4,14,7,9,54,37,17,49
Coleraine,7160,5,9,12,9,41,36,5,39
Portadown,7160,6,11,6,13,32,45,-13,39
Dungannon,7160,7,10,7,13,49,48,1,37
Glenavon,7160,8,9,9,12,47,57,-10,36
Glentoran,7160,9,10,4,16,25,43,-18,34
Ards,7160,10,9,4,17,36,48,-12,31
Ballinamalla,7160,11,8,4,18,32,55,-23,28
Crusaders,7161,1,20,6,4,67,32,35,66
Ballymena,7161,2,14,7,9,54,56,-2,49
Cliftonville,7161,3,15,3,12,56,47,9,48
Linfield,7161,4,11,11,8,61,39,22,44
Glenavon,7161,5,11,10,9,52,50,2,43
Coleraine,7161,6,10,10,10,40,43,-3,40
Ards,7161,7,11,5,14,43,50,-7,38
Glentoran,7161,8,10,7,13,34,43,-9,37
Dungannon,7161,9,8,9,13,50,54,-4,33
Portadown,7161,10,9,6,15,26,43,-17,33
Ballinamalla,7161,11,8,2,20,30,56,-26,26
Crusaders,7162,1,19,5,6,57,34,23,62
Linfield,7162,2,16,7,7,69,32,37,55
Coleraine,7162,3,13,12,5,47,32,15,51
Cliftonville,7162,4,15,6,9,47,35,12,51
Glenavon,7162,5,11,11,8,45,39,6,44
Ballymena,7162,6,11,6,13,53,66,-13,39
Dungannon,7162,7,8,9,13,44,44,0,33
Ballinamalla,7162,8,10,3,17,24,39,-15,33
Glentoran,7162,9,9,5,16,29,53,-24,32
Ards,7162,10,9,4,17,35,56,-21,31
Portadown,7162,11,5,10,15,24,44,-20,25
Linfield,7163,1,17,9,4,66,28,38,60
Cliftonville,7163,2,18,4,8,60,38,22,58
Crusaders,7163,3,14,7,9,49,35,14,49
Ballymena,7163,4,13,7,10,62,56,6,46
Dungannon,7163,5,11,10,9,48,42,6,43
Glenavon,7163,6,8,14,8,43,43,0,38
Coleraine,7163,7,8,13,9,35,40,-5,37
Glentoran,7163,8,10,5,15,30,45,-15,35
Ballinamalla,7163,9,8,6,16,29,54,-25,30
Ards,7163,10,7,7,16,39,52,-13,28
Portadown,7163,11,7,6,17,25,53,-28,27
Cliftonville,7164,1,16,5,9,49,32,17,53
Linfield,7164,2,13,11,6,64,37,27,50
Glenavon,7164,3,12,13,5,51,47,4,49
Dungannon,7164,4,13,9,8,57,41,16,48
Crusaders,7164,5,12,10,8,49,40,9,46
Ballymena,7164,6,10,10,10,57,58,-1,40
Glentoran,7164,7,10,8,12,35,45,-10,38
Coleraine,7164,8,9,9,12,42,46,-4,36
Ards,7164,9,10,6,14,41,54,-13,36
Portadown,7164,10,6,9,15,31,53,-22,27
Ballinamalla,7164,11,6,6,18,26,49,-23,24
Crusaders,7165,1,18,6,6,64,35,29,60
Cliftonville,7165,2,18,3,9,59,37,22,57
Coleraine,7165,3,13,9,8,49,34,15,48
Linfield,7165,4,12,9,9,53,44,9,45
Ballymena,7165,5,12,7,11,52,61,-9,43
Glenavon,7165,6,11,8,11,47,46,1,41
Ards,7165,7,12,3,15,46,49,-3,39
Dungannon,7165,8,10,8,12,48,46,2,38
Ballinamalla,7165,9,10,4,16,30,51,-21,34
Glentoran,7165,10,9,6,15,33,50,-17,33
Portadown,7165,11,6,5,19,24,52,-28,23
Cliftonville,7166,1,18,5,7,66,35,31,59
Crusaders,7166,2,17,5,8,54,41,13,56
Linfield,7166,3,15,9,6,59,32,27,54
Coleraine,7166,4,12,10,8,45,39,6,46
Glenavon,7166,5,11,11,8,49,43,6,44
Dungannon,7166,6,12,7,11,59,52,7,43
Ballymena,7166,7,11,4,15,55,67,-12,37
Ards,7166,8,10,6,14,46,52,-6,36
Portadown,7166,9,9,3,18,22,47,-25,30
Glentoran,7166,10,6,9,15,26,48,-22,27
Ballinamalla,7166,11,7,5,18,27,52,-25,26
Crusaders,7167,1,15,7,8,57,42,15,52
Linfield,7167,2,13,12,5,60,32,28,51
Glenavon,7167,3,14,9,7,54,40,14,51
Cliftonville,7167,4,15,6,9,51,38,13,51
Coleraine,7167,5,10,12,8,42,43,-1,42
Dungannon,7167,6,11,8,11,54,46,8,41
Ballymena,7167,7,11,5,14,52,65,-13,38
Ards,7167,8,9,6,15,33,45,-12,33
Ballinamalla,7167,9,10,3,17,33,55,-22,33
Portadown,7167,10,9,5,16,31,44,-13,32
Glentoran,7167,11,8,7,15,31,48,-17,31
Crusaders,7168,1,18,9,3,57,31,26,63
Ballymena,7168,2,16,8,6,62,52,10,56
Coleraine,7168,3,14,8,8,45,38,7,50
Cliftonville,7168,4,14,7,9,62,45,17,49
Linfield,7168,5,13,8,9,55,39,16,47
Dungannon,7168,6,10,9,11,48,45,3,39
Ards,7168,7,9,6,15,41,50,-9,33
Ballinamalla,7168,8,8,7,15,36,52,-16,31
Glentoran,7168,9,7,9,14,25,44,-19,30
Glenavon,7168,10,6,10,14,40,54,-14,28
Portadown,7168,11,8,3,19,28,49,-21,27
Cliftonville,7169,1,17,5,8,51,30,21,56
Linfield,7169,2,15,8,7,52,28,24,53
Dungannon,7169,3,14,8,8,58,40,18,50
Crusaders,7169,4,13,7,10,54,41,13,46
Ballymena,7169,5,12,7,11,61,61,0,43
Glentoran,7169,6,12,5,13,34,46,-12,41
Ards,7169,7,11,6,13,45,43,2,39
Coleraine,7169,8,10,9,11,40,43,-3,39
Glenavon,7169,9,10,9,11,44,52,-8,39
Portadown,7169,10,8,4,18,23,49,-26,28
Ballinamalla,7169,11,7,4,19,23,52,-29,25
Crusaders,7170,1,20,7,3,64,30,34,67
Coleraine,7170,2,14,9,7,45,34,11,51
Linfield,7170,3,13,11,6,54,28,26,50
Ballymena,7170,4,13,7,10,51,55,-4,46
Cliftonville,7170,5,12,6,12,51,49,2,42
Glenavon,7170,6,10,9,11,40,45,-5,39
Ballinamalla,7170,7,11,4,15,34,47,-13,37
Dungannon,7170,8,8,9,13,43,42,1,33
Ards,7170,9,9,6,15,34,47,-13,33
Glentoran,7170,10,8,8,14,35,51,-16,32
Portadown,7170,11,6,6,18,28,51,-23,24
Linfield,7171,1,15,11,4,64,30,34,56
Cliftonville,7171,2,16,6,8,53,37,16,54
Crusaders,7171,3,15,8,7,56,36,20,53
Glenavon,7171,4,13,9,8,42,39,3,48
Coleraine,7171,5,11,12,7,38,36,2,45
Ballymena,7171,6,12,9,9,59,62,-3,45
Dungannon,7171,7,8,12,10,43,39,4,36
Ards,7171,8,7,8,15,32,44,-12,29
Portadown,7171,9,7,8,15,24,43,-19,29
Glentoran,7171,10,6,9,15,25,49,-24,27
Ballinamalla,7171,11,7,4,19,31,52,-21,25
Linfield,7172,1,16,10,4,64,25,39,58
Crusaders,7172,2,14,9,7,50,38,12,51
Glenavon,7172,3,12,13,5,52,39,13,49
Ballymena,7172,4,14,6,10,56,57,-1,48
Cliftonville,7172,5,14,5,11,44,42,2,47
Coleraine,7172,6,10,15,5,43,36,7,45
Dungannon,7172,7,10,10,10,51,40,11,40
Portadown,7172,8,7,8,15,26,43,-17,29
Ballinamalla,7172,9,8,4,18,32,58,-26,28
Ards,7172,10,7,6,17,33,50,-17,27
Glentoran,7172,11,7,6,17,31,54,-23,27
Crusaders,7173,1,15,10,5,56,34,22,55
Cliftonville,7173,2,16,5,9,44,31,13,53
Ballymena,7173,3,15,6,9,60,50,10,51
Glenavon,7173,4,11,12,7,54,44,10,45
Linfield,7173,5,11,11,8,51,35,16,44
Coleraine,7173,6,11,10,9,41,42,-1,43
Dungannon,7173,7,11,9,10,51,39,12,42
Glentoran,7173,8,10,7,13,32,45,-13,37
Portadown,7173,9,7,7,16,23,46,-23,28
Ards,7173,10,6,9,15,27,45,-18,27
Ballinamalla,7173,11,6,6,18,24,52,-28,24
Crusaders,7174,1,17,9,4,57,30,27,60
Coleraine,7174,2,15,10,5,50,34,16,55
Linfield,7174,3,15,7,8,66,43,23,52
Dungannon,7174,4,13,8,9,60,43,17,47
Cliftonville,7174,5,13,6,11,54,45,9,45
Glenavon,7174,6,10,12,8,47,47,0,42
Ballymena,7174,7,11,6,13,56,65,-9,39
Glentoran,7174,8,8,9,13,33,42,-9,33
Ards,7174,9,9,5,16,40,53,-13,32
Portadown,7174,10,6,7,17,24,52,-28,25
Ballinamalla,7174,11,7,3,20,27,60,-33,24
Linfield,7175,1,18,7,5,63,26,37,61
Crusaders,7175,2,18,6,6,55,41,14,60
Cliftonville,7175,3,17,4,9,54,42,12,55
Glenavon,7175,4,11,10,9,56,45,11,43
Coleraine,7175,5,11,9,10,36,41,-5,42
Ballymena,7175,6,12,6,12,56,66,-10,42
Dungannon,7175,7,10,7,13,56,51,5,37
Glentoran,7175,8,9,7,14,30,40,-10,34
Ards,7175,9,9,5,16,35,45,-10,32
Portadown,7175,10,8,5,17,27,47,-20,29
Ballinamalla,7175,11,7,4,19,30,54,-24,25
Linfield,7176,1,15,9,6,59,31,28,54
Cliftonville,7176,2,17,3,10,57,39,18,54
Crusaders,7176,3,14,9,7,53,42,11,51
Ballymena,7176,4,15,6,9,60,61,-1,51
Ballinamalla,7176,5,13,5,12,38,43,-5,44
Coleraine,7176,6,10,9,11,38,45,-7,39
Glenavon,7176,7,9,11,10,50,51,-1,38
Ards,7176,8,10,6,14,37,45,-8,36
Dungannon,7176,9,8,8,14,49,49,0,32
Glentoran,7176,10,7,8,15,34,49,-15,29
Portadown,7176,11,7,6,17,24,44,-20,27
Crusaders,7177,1,18,9,3,60,34,26,63
Linfield,7177,2,13,13,4,59,28,31,52
Cliftonville,7177,3,14,5,11,49,39,10,47
Ballymena,7177,4,13,8,9,53,58,-5,47
Dungannon,7177,5,11,11,8,56,45,11,44
Coleraine,7177,6,12,8,10,46,35,11,44
Glenavon,7177,7,9,12,9,45,49,-4,39
Ards,7177,8,10,6,14,40,46,-6,36
Glentoran,7177,9,7,8,15,25,45,-20,29
Ballinamalla,7177,10,8,3,19,25,51,-26,27
Portadown,7177,11,6,5,19,22,50,-28,23
Crusaders,7178,1,17,7,6,66,43,23,58
Linfield,7178,2,15,10,5,60,37,23,55
Cliftonville,7178,3,15,4,11,53,46,7,49
Ballymena,7178,4,14,7,9,54,55,-1,49
Glenavon,7178,5,11,11,8,53,47,6,44
Dungannon,7178,6,11,9,10,52,38,14,42
Coleraine,7178,7,10,9,11,40,41,-1,39
Ballinamalla,7178,8,10,6,14,33,45,-12,36
Glentoran,7178,9,9,5,16,29,44,-15,32
Portadown,7178,10,7,6,17,21,42,-21,27
Ards,7178,11,7,4,19,32,55,-23,25
Crusaders,7179,1,17,8,5,59,32,27,59
Ballymena,7179,2,15,6,9,62,57,5,51
Linfield,7179,3,14,8,8,60,32,28,50
Cliftonville,7179,4,14,5,11,55,46,9,47
Dungannon,7179,5,12,8,10,50,43,7,44
Coleraine,7179,6,11,9,10,43,43,0,42
Glentoran,7179,7,10,10,10,33,40,-7,40
Glenavon,7179,8,9,12,9,49,46,3,39
Portadown,7179,9,9,5,16,27,47,-20,32
Ards,7179,10,7,8,15,41,59,-18,29
Ballinamalla,7179,11,5,5,20,26,60,-34,20
Crusaders,7180,1,17,7,6,54,38,16,58
Coleraine,7180,2,14,12,4,49,29,20,54
Cliftonville,7180,3,15,3,12,50,40,10,48
Glenavon,7180,4,13,9,8,55,46,9,48
Linfield,7180,5,13,8,9,63,40,23,47
Ballymena,7180,6,14,4,12,58,60,-2,46
Dungannon,7180,7,9,9,12,48,47,1,36
Ards,7180,8,11,3,16,42,48,-6,36
Glentoran,7180,9,8,8,14,31,51,-20,32
Portadown,7180,10,9,5,16,21,45,-24,32
Ballinamalla,7180,11,5,6,19,28,55,-27,21
Linfield,7181,1,17,10,3,62,31,31,61
Crusaders,7181,2,15,10,5,57,34,23,55
Ballymena,7181,3,15,7,8,63,56,7,52
Cliftonville,7181,4,14,5,11,50,41,9,47
Coleraine,7181,5,11,12,7,45,34,11,45
Ards,7181,6,12,5,13,43,44,-1,41
Glenavon,7181,7,10,11,9,38,41,-3,41
Dungannon,7181,8,8,12,10,48,47,1,36
Glentoran,7181,9,7,12,11,32,43,-11,33
Ballinamalla,7181,10,4,8,18,30,58,-28,20
Portadown,7181,11,4,4,22,17,56,-39,16
Crusaders,7182,1,16,8,6,52,31,21,56
Cliftonville,7182,2,16,4,10,56,40,16,52
Linfield,7182,3,14,9,7,60,36,24,51
Coleraine,7182,4,14,9,7,42,33,9,51
Ballymena,7182,5,13,6,11,51,60,-9,45
Glenavon,7182,6,11,11,8,43,41,2,44
Dungannon,7182,7,11,8,11,49,42,7,41
Ballinamalla,7182,8,11,3,16,31,47,-16,36
Glentoran,7182,9,9,6,15,38,48,-10,33
Ards,7182,10,7,7,16,34,51,-17,28
Portadown,7182,11,5,5,20,20,47,-27,20
Linfield,7183,1,15,9,6,57,29,28,54
Glenavon,7183,2,14,9,7,51,44,7,51
Crusaders,7183,3,14,8,8,51,36,15,50
Cliftonville,7183,4,14,6,10,46,35,11,48
Ballymena,7183,5,14,5,11,62,61,1,47
Coleraine,7183,6,12,10,8,43,43,0,46
Glentoran,7183,7,13,6,11,38,41,-3,45
Dungannon,7183,8,10,9,11,53,49,4,39
Ards,7183,9,9,3,18,42,54,-12,30
Portadown,7183,10,8,5,17,28,42,-14,29
Ballinamalla,7183,11,4,6,20,20,57,-37,18
Linfield,7184,1,14,11,5,56,31,25,53
Crusaders,7184,2,15,6,9,53,38,15,51
Ballymena,7184,3,15,6,9,64,55,9,51
Cliftonville,7184,4,15,5,10,47,35,12,50
Glenavon,7184,5,14,8,8,49,42,7,50
Dungannon,7184,6,13,7,10,50,40,10,46
Coleraine,7184,7,11,11,8,50,41,9,44
Glentoran,7184,8,9,7,14,36,48,-12,34
Ards,7184,9,8,5,17,34,54,-20,29
Ballinamalla,7184,10,8,4,18,29,56,-27,28
Portadown,7184,11,6,4,20,18,46,-28,22
Crusaders,7185,1,18,6,6,56,33,23,60
Cliftonville,7185,2,16,4,10,55,35,20,52
Coleraine,7185,3,14,9,7,47,43,4,51
Ballymena,7185,4,14,7,9,54,59,-5,49
Linfield,7185,5,12,10,8,56,38,18,46
Glenavon,7185,6,11,11,8,52,44,8,44
Dungannon,7185,7,9,9,12,44,44,0,36
Portadown,7185,8,10,4,16,26,40,-14,34
Glentoran,7185,9,8,9,13,24,39,-15,33
Ards,7185,10,8,5,17,36,47,-11,29
Ballinamalla,7185,11,5,6,19,22,50,-28,21
Cliftonville,7186,1,17,5,8,59,35,24,56
Linfield,7186,2,15,10,5,59,27,32,55
Ballymena,7186,3,16,7,7,61,49,12,55
Crusaders,7186,4,15,7,8,60,41,19,52
Glenavon,7186,5,14,8,8,49,46,3,50
Dungannon,7186,6,11,10,9,51,41,10,43
Coleraine,7186,7,8,12,10,40,45,-5,36
Ards,7186,8,9,6,15,37,48,-11,33
Glentoran,7186,9,8,6,16,29,51,-22,30
Ballinamalla,7186,10,5,7,18,33,60,-27,22
Portadown,7186,11,6,4,20,21,56,-35,22
Crusaders,7187,1,20,5,5,69,35,34,65
Cliftonville,7187,2,17,3,10,49,35,14,54
Ballymena,7187,3,14,7,9,56,57,-1,49
Linfield,7187,4,12,10,8,58,35,23,46
Glenavon,7187,5,11,12,7,48,44,4,45
Dungannon,7187,6,10,7,13,47,45,2,37
Coleraine,7187,7,8,11,11,41,44,-3,35
Glentoran,7187,8,9,7,14,31,43,-12,34
Ballinamalla,7187,9,9,6,15,35,51,-16,33
Ards,7187,10,8,8,14,38,53,-15,32
Portadown,7187,11,7,4,19,23,53,-30,25
Linfield,7188,1,19,8,3,66,28,38,65
Crusaders,7188,2,16,7,7,49,33,16,55
Ballymena,7188,3,15,7,8,65,53,12,52
Glenavon,7188,4,13,9,8,50,44,6,48
Coleraine,7188,5,11,10,9,42,44,-2,43
Dungannon,7188,6,11,9,10,53,46,7,42
Cliftonville,7188,7,12,5,13,44,41,3,41
Ards,7188,8,9,6,15,35,47,-12,33
Glentoran,7188,9,8,9,13,32,45,-13,33
Ballinamalla,7188,10,6,5,19,28,54,-26,23
Portadown,7188,11,5,5,20,23,52,-29,20
Crusaders,7189,1,16,8,6,54,32,22,56
Glenavon,7189,2,13,11,6,49,39,10,50
Linfield,7189,3,13,10,7,59,34,25,49
Cliftonville,7189,4,14,7,9,52,38,14,49
Ballymena,7189,5,14,7,9,62,61,1,49
Coleraine,7189,6,9,12,9,46,48,-2,39
Dungannon,7189,7,8,12,10,41,40,1,36
Glentoran,7189,8,7,11,12,34,46,-12,32
Ards,7189,9,8,7,15,34,48,-14,31
Portadown,7189,10,9,3,18,24,50,-26,30
Ballinamalla,7189,11,8,4,18,35,54,-19,28
Ballymena,7190,1,17,5,8,65,54,11,56
Glenavon,7190,2,15,9,6,56,38,18,54
Crusaders,7190,3,13,9,8,45,39,6,48
Linfield,7190,4,13,8,9,51,33,18,47
Cliftonville,7190,5,13,8,9,53,37,16,47
Coleraine,7190,6,10,12,8,39,36,3,42
Ballinamalla,7190,7,10,7,13,31,44,-13,37
Dungannon,7190,8,8,9,13,37,41,-4,33
Ards,7190,9,9,5,16,35,51,-16,32
Glentoran,7190,10,8,8,14,25,41,-16,32
Portadown,7190,11,6,6,18,23,46,-23,24
Crusaders,7191,1,18,7,5,53,33,20,61
Ballymena,7191,2,18,5,7,68,55,13,59
Coleraine,7191,3,13,11,6,51,37,14,50
Glenavon,7191,4,13,9,8,52,41,11,48
Linfield,7191,5,12,11,7,53,30,23,47
Cliftonville,7191,6,12,6,12,46,47,-1,42
Dungannon,7191,7,10,8,12,49,48,1,38
Ards,7191,8,9,4,17,41,50,-9,31
Glentoran,7191,9,8,7,15,32,45,-13,31
Portadown,7191,10,7,4,19,21,54,-33,25
Ballinamalla,7191,11,6,6,18,26,52,-26,24
Linfield,7192,1,16,10,4,51,22,29,58
Crusaders,7192,2,16,10,4,59,31,28,58
Cliftonville,7192,3,16,6,8,51,39,12,54
Glenavon,7192,4,12,10,8,48,39,9,46
Ballymena,7192,5,12,10,8,56,59,-3,46
Coleraine,7192,6,11,10,9,40,40,0,43
Dungannon,7192,7,9,9,12,48,42,6,36
Portadown,7192,8,10,5,15,29,43,-14,35
Ards,7192,9,9,4,17,37,54,-17,31
Glentoran,7192,10,5,9,16,26,46,-20,24
Ballinamalla,7192,11,6,3,21,27,57,-30,21
Crusaders,7193,1,16,7,7,57,38,19,55
Ballymena,7193,2,16,7,7,66,51,15,55
Cliftonville,7193,3,15,5,10,54,40,14,50
Coleraine,7193,4,13,10,7,44,31,13,49
Linfield,7193,5,12,10,8,54,35,19,46
Glenavon,7193,6,11,9,10,49,39,10,42
Dungannon,7193,7,11,8,11,51,45,6,41
Glentoran,7193,8,12,5,13,29,44,-15,41
Portadown,7193,9,9,3,18,21,47,-26,30
Ards,7193,10,7,5,18,31,54,-23,26
Ballinamalla,7193,11,7,3,20,27,59,-32,24
Linfield,7194,1,15,9,6,57,29,28,54
Crusaders,7194,2,16,6,8,57,42,15,54
Ballymena,7194,3,14,7,9,54,55,-1,49
Coleraine,7194,4,13,9,8,53,36,17,48
Cliftonville,7194,5,14,5,11,51,43,8,47
Glenavon,7194,6,13,7,10,48,45,3,46
Glentoran,7194,7,11,8,11,32,42,-10,41
Dungannon,7194,8,9,11,10,51,47,4,38
Portadown,7194,9,7,8,15,25,44,-19,29
Ballinamalla,7194,10,8,4,18,29,50,-21,28
Ards,7194,11,6,4,20,30,54,-24,22
Crusaders,7195,1,18,7,5,59,35,24,61
Linfield,7195,2,15,10,5,60,30,30,55
Cliftonville,7195,3,15,8,7,62,39,23,53
Ballymena,7195,4,15,5,10,64,62,2,50
Glenavon,7195,5,12,11,7,51,39,12,47
Dungannon,7195,6,10,11,9,53,47,6,41
Coleraine,7195,7,9,11,10,39,46,-7,38
Ards,7195,8,7,7,16,36,53,-17,28
Glentoran,7195,9,7,7,16,32,55,-23,28
Portadown,7195,10,8,3,19,23,47,-24,27
Ballinamalla,7195,11,5,8,17,26,52,-26,23
Linfield,7196,1,19,9,2,72,29,43,66
Crusaders,7196,2,17,8,5,53,27,26,59
Cliftonville,7196,3,13,7,10,53,44,9,46
Ballymena,7196,4,13,5,12,60,63,-3,44
Coleraine,7196,5,10,11,9,44,42,2,41
Dungannon,7196,6,9,10,11,45,43,2,37
Glenavon,7196,7,8,13,9,43,51,-8,37
Ballinamalla,7196,8,10,4,16,30,44,-14,34
Glentoran,7196,9,8,8,14,29,53,-24,32
Ards,7196,10,8,7,15,42,53,-11,31
Portadown,7196,11,6,6,18,24,46,-22,24
Crusaders,7197,1,21,6,3,66,31,35,69
Linfield,7197,2,12,12,6,57,31,26,48
Cliftonville,7197,3,13,8,9,46,40,6,47
Coleraine,7197,4,11,12,7,48,42,6,45
Glenavon,7197,5,10,11,9,47,47,0,41
Dungannon,7197,6,10,10,10,47,41,6,40
Ballymena,7197,7,9,10,11,56,66,-10,37
Portadown,7197,8,8,7,15,29,43,-14,31
Ards,7197,9,8,6,16,35,52,-17,30
Ballinamalla,7197,10,8,6,16,28,46,-18,30
Glentoran,7197,11,8,6,16,30,50,-20,30
Crusaders,7198,1,17,7,6,63,37,26,58
Linfield,7198,2,14,10,6,63,40,23,52
Cliftonville,7198,3,15,6,9,49,36,13,51
Glenavon,7198,4,13,11,6,56,45,11,50
Dungannon,7198,5,12,9,9,54,42,12,45
Coleraine,7198,6,12,8,10,45,50,-5,44
Ballymena,7198,7,12,7,11,57,61,-4,43
Ballinamalla,7198,8,9,5,16,33,49,-16,32
Ards,7198,9,9,3,18,40,55,-15,30
Glentoran,7198,10,8,5,17,26,43,-17,29
Portadown,7198,11,5,7,18,21,49,-28,22
Crusaders,7199,1,16,9,5,59,31,28,57
Cliftonville,7199,2,14,7,9,50,38,12,49
Linfield,7199,3,13,8,9,56,47,9,47
Ballymena,7199,4,14,5,11,55,53,2,47
Glenavon,7199,5,11,13,6,40,39,1,46
Coleraine,7199,6,8,16,6,37,31,6,40
Dungannon,7199,7,10,9,11,43,37,6,39
Ards,7199,8,11,5,14,37,44,-7,38
Ballinamalla,7199,9,10,4,16,35,49,-14,34
Glentoran,7199,10,7,9,14,32,46,-14,30
Portadown,7199,11,6,5,19,25,54,-29,23
Crusaders,7200,1,16,7,7,51,36,15,55
Linfield,7200,2,12,13,5,54,29,25,49
Ballymena,7200,3,13,9,8,54,50,4,48
Cliftonville,7200,4,14,5,11,52,42,10,47
Glenavon,7200,5,13,8,9,51,47,4,47
Dungannon,7200,6,11,9,10,54,47,7,42
Coleraine,7200,7,9,12,9,41,46,-5,39
Ballinamalla,7200,8,11,4,15,37,43,-6,37
Glentoran,7200,9,7,10,13,25,40,-15,31
Portadown,7200,10,9,4,17,24,42,-18,31
Ards,7200,11,6,7,17,36,57,-21,25
Cliftonville,7201,1,16,4,10,46,37,9,52
Linfield,7201,2,14,9,7,58,30,28,51
Crusaders,7201,3,14,9,7,45,29,16,51
Coleraine,7201,4,12,9,9,43,40,3,45
Ballymena,7201,5,13,6,11,52,57,-5,45
Glenavon,7201,6,10,13,7,39,38,1,43
Dungannon,7201,7,10,12,8,51,44,7,42
Glentoran,7201,8,9,9,12,33,44,-11,36
Portadown,7201,9,9,5,16,30,44,-14,32
Ards,7201,10,8,5,17,40,52,-12,29
Ballinamalla,7201,11,7,5,18,31,53,-22,26
Crusaders,7202,1,17,6,7,55,35,20,57
Linfield,7202,2,14,10,6,57,30,27,52
Cliftonville,7202,3,15,5,10,51,44,7,50
Coleraine,7202,4,13,9,8,49,39,10,48
Ballymena,7202,5,13,7,10,62,58,4,46
Glenavon,7202,6,12,9,9,49,46,3,45
Dungannon,7202,7,11,8,11,49,42,7,41
Portadown,7202,8,10,6,14,25,38,-13,36
Glentoran,7202,9,9,6,15,30,48,-18,33
Ballinamalla,7202,10,7,5,18,24,53,-29,26
Ards,7202,11,6,5,19,32,50,-18,23
Cliftonville,7203,1,17,6,7,55,36,19,57
Crusaders,7203,2,14,8,8,56,41,15,50
Linfield,7203,3,11,14,5,50,30,20,47
Glenavon,7203,4,11,12,7,51,46,5,45
Ballymena,7203,5,13,6,11,62,65,-3,45
Coleraine,7203,6,11,11,8,40,36,4,44
Glentoran,7203,7,10,9,11,40,44,-4,39
Dungannon,7203,8,9,9,12,53,54,-1,36
Ards,7203,9,10,3,17,43,55,-12,33
Portadown,7203,10,9,6,15,29,45,-16,33
Ballinamalla,7203,11,5,6,19,30,57,-27,21
Crusaders,7204,1,16,8,6,52,34,18,56
Linfield,7204,2,13,11,6,61,31,30,50
Ballymena,7204,3,14,8,8,59,58,1,50
Cliftonville,7204,4,15,4,11,50,38,12,49
Dungannon,7204,5,13,9,8,54,40,14,48
Coleraine,7204,6,13,9,8,44,36,8,48
Ards,7204,7,12,3,15,35,43,-8,39
Glenavon,7204,8,9,9,12,46,53,-7,36
Portadown,7204,9,8,8,14,25,40,-15,32
Glentoran,7204,10,8,7,15,27,44,-17,31
Ballinamalla,7204,11,5,2,23,20,56,-36,17
Crusaders,7205,1,17,6,7,57,34,23,57
Linfield,7205,2,16,8,6,69,34,35,56
Cliftonville,7205,3,16,4,10,57,41,16,52
Coleraine,7205,4,14,9,7,45,35,10,51
Ballymena,7205,5,16,3,11,55,61,-6,51
Dungannon,7205,6,11,7,12,48,46,2,40
Glenavon,7205,7,10,10,10,42,46,-4,40
Ards,7205,8,10,4,16,50,58,-8,34
Glentoran,7205,9,7,7,16,27,46,-19,28
Ballinamalla,7205,10,7,7,16,27,48,-21,28
Portadown,7205,11,6,5,19,20,48,-28,23
Coleraine,7206,1,15,8,7,56,36,20,53
Linfield,7206,2,14,10,6,61,35,26,52
Cliftonville,7206,3,16,4,10,49,35,14,52
Crusaders,7206,4,14,9,7,48,30,18,51
Glenavon,7206,5,12,9,9,51,50,1,45
Ballymena,7206,6,12,6,12,56,60,-4,42
Dungannon,7206,7,9,8,13,47,52,-5,35
Ards,7206,8,10,4,16,36,49,-13,34
Glentoran,7206,9,9,6,15,28,44,-16,33
Ballinamalla,7206,10,8,7,15,32,51,-19,31
Portadown,7206,11,7,7,16,27,49,-22,28
Crusaders,7207,1,19,7,4,63,35,28,64
Cliftonville,7207,2,17,5,8,58,35,23,56
Linfield,7207,3,13,11,6,57,32,25,50
Ballymena,7207,4,13,7,10,53,54,-1,46
Coleraine,7207,5,11,12,7,36,33,3,45
Glenavon,7207,6,9,9,12,43,51,-8,36
Glentoran,7207,7,8,11,11,32,42,-10,35
Portadown,7207,8,9,7,14,26,44,-18,34
Dungannon,7207,9,7,9,14,47,51,-4,30
Ballinamalla,7207,10,8,5,17,31,51,-20,29
Ards,7207,11,7,5,18,36,54,-18,26
Crusaders,7208,1,15,8,7,54,38,16,53
Ballymena,7208,2,15,8,7,64,53,11,53
Linfield,7208,3,14,10,6,57,31,26,52
Glenavon,7208,4,13,11,6,58,48,10,50
Coleraine,7208,5,12,11,7,46,36,10,47
Cliftonville,7208,6,14,5,11,49,43,6,47
Dungannon,7208,7,10,8,12,51,50,1,38
Glentoran,7208,8,8,9,13,30,43,-13,33
Ards,7208,9,9,4,17,40,54,-14,31
Ballinamalla,7208,10,7,4,19,28,54,-26,25
Portadown,7208,11,7,4,19,26,53,-27,25
Linfield,7209,1,16,9,5,58,29,29,57
Cliftonville,7209,2,16,5,9,54,36,18,53
Crusaders,7209,3,15,6,9,51,34,17,51
Ballymena,7209,4,13,8,9,60,59,1,47
Glentoran,7209,5,12,8,10,32,39,-7,44
Glenavon,7209,6,10,10,10,51,49,2,40
Coleraine,7209,7,8,15,7,37,38,-1,39
Dungannon,7209,8,9,10,11,44,40,4,37
Ards,7209,9,9,8,13,38,45,-7,35
Ballinamalla,7209,10,6,7,17,24,48,-24,25
Portadown,7209,11,5,6,19,25,57,-32,21
Linfield,7210,1,18,8,4,67,26,41,62
Crusaders,7210,2,16,7,7,63,36,27,55
Ballymena,7210,3,15,7,8,58,55,3,52
Coleraine,7210,4,12,11,7,45,36,9,47
Cliftonville,7210,5,13,4,13,53,51,2,43
Glenavon,7210,6,10,10,10,39,43,-4,40
Dungannon,7210,7,10,8,12,48,45,3,38
Ballinamalla,7210,8,9,6,15,28,49,-21,33
Ards,7210,9,9,3,18,36,56,-20,30
Glentoran,7210,10,7,7,16,29,48,-19,28
Portadown,7210,11,7,7,16,26,47,-21,28
Crusaders,7211,1,18,6,6,56,28,28,60
Linfield,7211,2,16,11,3,57,24,33,59
Glenavon,7211,3,14,8,8,53,40,13,50
Cliftonville,7211,4,14,4,12,50,44,6,46
Coleraine,7211,5,11,11,8,41,40,1,44
Ballymena,7211,6,11,7,12,50,58,-8,40
Dungannon,7211,7,9,11,10,44,41,3,38
Ards,7211,8,10,4,16,34,45,-11,34
Portadown,7211,9,9,6,15,28,45,-17,33
Glentoran,7211,10,8,7,15,29,46,-17,31
Ballinamalla,7211,11,5,5,20,23,54,-31,20
Crusaders,7212,1,18,8,4,56,35,21,62
Cliftonville,7212,2,16,6,8,58,39,19,54
Linfield,7212,3,14,8,8,60,37,23,50
Ballymena,7212,4,14,8,8,59,53,6,50
Glenavon,7212,5,13,10,7,53,43,10,49
Coleraine,7212,6,10,11,9,44,40,4,41
Ards,7212,7,10,6,14,38,49,-11,36
Dungannon,7212,8,7,10,13,54,57,-3,31
Glentoran,7212,9,7,9,14,28,45,-17,30
Portadown,7212,10,8,5,17,31,52,-21,29
Ballinamalla,7212,11,5,5,20,27,58,-31,20
Cliftonville,7213,1,17,6,7,56,36,20,57
Ballymena,7213,2,14,10,6,60,58,2,52
Linfield,7213,3,14,9,7,59,32,27,51
Crusaders,7213,4,13,9,8,56,43,13,48
Glenavon,7213,5,11,13,6,46,41,5,46
Coleraine,7213,6,10,8,12,38,39,-1,38
Dungannon,7213,7,8,11,11,45,44,1,35
Portadown,7213,8,9,6,15,31,47,-16,33
Glentoran,7213,9,8,7,15,30,50,-20,31
Ards,7213,10,9,3,18,40,54,-14,30
Ballinamalla,7213,11,8,6,16,31,48,-17,30
Crusaders,7214,1,19,6,5,65,32,33,63
Ballymena,7214,2,15,5,10,58,55,3,50
Cliftonville,7214,3,15,4,11,46,37,9,49
Linfield,7214,4,13,7,10,58,38,20,46
Glenavon,7214,5,11,11,8,46,46,0,44
Ballinamalla,7214,6,11,5,14,36,47,-11,38
Ards,7214,7,10,5,15,36,47,-11,35
Glentoran,7214,8,9,8,13,29,41,-12,35
Dungannon,7214,9,8,10,12,51,52,-1,34
Portadown,7214,10,9,5,16,27,47,-20,32
Coleraine,7214,11,7,10,13,38,48,-10,31
Cliftonville,7215,1,15,7,8,57,37,20,52
Crusaders,7215,2,15,7,8,48,37,11,52
Ballymena,7215,3,15,7,8,59,55,4,52
Linfield,7215,4,12,12,6,54,34,20,48
Coleraine,7215,5,12,11,7,47,40,7,47
Ards,7215,6,10,7,13,39,41,-2,37
Glenavon,7215,7,7,15,8,46,47,-1,36
Portadown,7215,8,9,7,14,33,45,-12,34
Dungannon,7215,9,6,13,11,43,45,-2,31
Ballinamalla,7215,10,8,5,17,27,49,-22,29
Glentoran,7215,11,7,7,16,27,50,-23,28
Linfield,7216,1,20,6,4,63,28,35,66
Cliftonville,7216,2,18,2,10,54,35,19,56
Crusaders,7216,3,15,9,6,58,40,18,54
Coleraine,7216,4,13,8,9,41,37,4,47
Glenavon,7216,5,11,9,10,48,43,5,42
Ballymena,7216,6,12,6,12,57,66,-9,42
Ards,7216,7,11,5,14,38,44,-6,38
Ballinamalla,7216,8,11,4,15,33,43,-10,37
Glentoran,7216,9,7,7,16,26,43,-17,28
Dungannon,7216,10,5,10,15,42,55,-13,25
Portadown,7216,11,7,4,19,25,51,-26,25
Crusaders,7217,1,17,7,6,57,35,22,58
Linfield,7217,2,15,10,5,60,28,32,55
Cliftonville,7217,3,15,5,10,53,37,16,50
Glentoran,7217,4,12,7,11,35,43,-8,43
Ballymena,7217,5,12,6,12,57,59,-2,42
Glenavon,7217,6,9,10,11,44,43,1,37
Coleraine,7217,7,7,14,9,37,40,-3,35
Ards,7217,8,10,4,16,46,59,-13,34
Portadown,7217,9,10,4,16,25,46,-21,34
Dungannon,7217,10,7,12,11,47,53,-6,33
Ballinamalla,7217,11,9,5,16,34,52,-18,32
Crusaders,7218,1,16,7,7,53,36,17,55
Glenavon,7218,2,15,10,5,52,39,13,55
Ballymena,7218,3,15,5,10,50,51,-1,50
Cliftonville,7218,4,14,7,9,51,34,17,49
Linfield,7218,5,13,7,10,55,29,26,46
Coleraine,7218,6,10,12,8,40,40,0,42
Dungannon,7218,7,8,12,10,46,44,2,36
Ballinamalla,7218,8,8,6,16,30,48,-18,30
Glentoran,7218,9,7,9,14,26,45,-19,30
Portadown,7218,9,8,6,16,26,45,-19,30
Ards,7218,11,7,7,16,38,56,-18,28
Crusaders,7219,1,17,6,7,52,31,21,57
Cliftonville,7219,2,16,7,7,55,39,16,55
Ballymena,7219,3,14,8,8,54,53,1,50
Glenavon,7219,4,12,11,7,48,42,6,47
Linfield,7219,5,12,10,8,53,33,20,46
Dungannon,7219,6,12,8,10,57,45,12,44
Coleraine,7219,7,9,11,10,41,44,-3,38
Ards,7219,8,10,6,14,42,45,-3,36
Portadown,7219,9,7,7,16,30,51,-21,28
Glentoran,7219,10,7,6,17,24,51,-27,27
Ballinamalla,7219,11,6,6,18,26,48,-22,24
Crusaders,7220,1,16,8,6,55,35,20,56
Linfield,7220,2,13,10,7,58,34,24,49
Cliftonville,7220,3,14,6,10,49,37,12,48
Ballymena,7220,4,13,7,10,58,61,-3,46
Coleraine,7220,5,11,12,7,45,40,5,45
Glenavon,7220,6,11,12,7,44,42,2,45
Ards,7220,7,9,8,13,40,46,-6,35
Dungannon,7220,8,8,10,12,53,50,3,34
Glentoran,7220,9,8,10,12,26,36,-10,34
Portadown,7220,10,8,5,17,23,44,-21,29
Ballinamalla,7220,11,8,4,18,28,54,-26,28
Crusaders,7221,1,17,7,6,57,31,26,58
Cliftonville,7221,2,17,6,7,57,35,22,57
Coleraine,7221,3,15,10,5,48,33,15,55
Linfield,7221,4,13,10,7,57,39,18,49
Ballymena,7221,5,11,7,12,55,61,-6,40
Glenavon,7221,6,9,8,13,41,57,-16,35
Glentoran,7221,7,10,4,16,30,50,-20,34
Dungannon,7221,8,8,9,13,47,46,1,33
Ards,7221,9,8,9,13,40,47,-7,33
Ballinamalla,7221,10,8,6,16,30,48,-18,30
Portadown,7221,11,7,8,15,29,44,-15,29
Linfield,7222,1,16,7,7,57,27,30,55
Crusaders,7222,2,15,10,5,54,38,16,55
Ballymena,7222,3,16,5,9,57,62,-5,53
Cliftonville,7222,4,16,4,10,55,38,17,52
Coleraine,7222,5,12,10,8,46,37,9,46
Dungannon,7222,6,10,9,11,53,46,7,39
Glenavon,7222,7,9,12,9,46,46,0,39
Ards,7222,8,11,5,14,37,43,-6,38
Ballinamalla,7222,9,11,3,16,35,50,-15,36
Glentoran,7222,10,6,5,19,22,47,-25,23
Portadown,7222,11,4,8,18,20,48,-28,20
Crusaders,7223,1,16,7,7,52,34,18,55
Linfield,7223,2,15,9,6,60,34,26,54
Cliftonville,7223,3,15,4,11,52,40,12,49
Coleraine,7223,4,12,11,7,45,38,7,47
Ballymena,7223,5,13,7,10,55,59,-4,46
Glenavon,7223,6,10,11,9,40,43,-3,41
Ards,7223,7,10,9,11,39,42,-3,39
Glentoran,7223,8,9,10,11,31,44,-13,37
Dungannon,7223,9,8,8,14,40,40,0,32
Ballinamalla,7223,10,7,5,18,30,47,-17,26
Portadown,7223,11,7,5,18,25,48,-23,26
Linfield,7224,1,17,6,7,65,35,30,57
Crusaders,7224,2,16,7,7,55,31,24,55
Cliftonville,7224,3,17,4,9,48,36,12,55
Ballymena,7224,4,15,5,10,60,58,2,50
Coleraine,7224,5,12,10,8,55,43,12,46
Glenavon,7224,6,10,11,9,46,49,-3,41
Dungannon,7224,7,9,9,12,54,54,0,36
Ards,7224,8,10,5,15,42,51,-9,35
Portadown,7224,9,9,5,16,27,41,-14,32
Glentoran,7224,10,7,6,17,28,56,-28,27
Ballinamalla,7224,11,7,4,19,27,53,-26,25
Crusaders,7225,1,17,8,5,52,31,21,59
Cliftonville,7225,2,18,3,9,48,31,17,57
Ballymena,7225,3,13,7,10,55,56,-1,46
Glenavon,7225,4,12,9,9,44,42,2,45
Linfield,7225,5,12,8,10,56,39,17,44
Coleraine,7225,6,11,8,11,43,39,4,41
Dungannon,7225,7,10,9,11,47,43,4,39
Ballinamalla,7225,8,9,6,15,31,46,-15,33
Glentoran,7225,9,9,6,15,29,44,-15,33
Portadown,7225,10,9,4,17,28,44,-16,31
Ards,7225,11,8,6,16,33,51,-18,30
Crusaders,7226,1,19,6,5,60,28,32,63
Linfield,7226,2,16,7,7,60,32,28,55
Ballymena,7226,3,14,6,10,56,62,-6,48
Cliftonville,7226,4,14,5,11,48,36,12,47
Glenavon,7226,5,11,14,5,52,44,8,47
Coleraine,7226,6,11,12,7,44,36,8,45
Dungannon,7226,7,8,9,13,42,49,-7,33
Ards,7226,8,8,8,14,37,49,-12,32
Portadown,7226,9,9,3,18,25,45,-20,30
Ballinamalla,7226,10,7,7,16,33,56,-23,28
Glentoran,7226,11,7,5,18,34,54,-20,26
Crusaders,7227,1,15,7,8,60,43,17,52
Glentoran,7227,2,14,7,9,39,36,3,49
Cliftonville,7227,3,15,2,13,52,47,5,47
Glenavon,7227,4,12,9,9,49,45,4,45
Ballymena,7227,5,13,5,12,51,58,-7,44
Linfield,7227,6,12,7,11,52,40,12,43
Coleraine,7227,7,11,9,10,45,37,8,42
Dungannon,7227,8,9,11,10,53,45,8,38
Ballinamalla,7227,9,10,5,15,35,52,-17,35
Ards,7227,10,10,3,17,35,54,-19,33
Portadown,7227,11,8,7,15,31,45,-14,31
Cliftonville,7228,1,18,4,8,53,31,22,58
Crusaders,7228,2,16,9,5,55,29,26,57
Linfield,7228,3,14,9,7,53,32,21,51
Ballymena,7228,4,14,4,12,51,57,-6,46
Coleraine,7228,5,10,11,9,35,34,1,41
Dungannon,7228,6,10,10,10,44,41,3,40
Ards,7228,7,11,4,15,41,51,-10,37
Glenavon,7228,8,7,14,9,42,47,-5,35
Glentoran,7228,9,9,8,13,30,39,-9,35
Portadown,7228,10,9,3,18,23,42,-19,30
Ballinamalla,7228,11,6,6,18,27,51,-24,24
Cliftonville,7229,1,16,6,8,53,36,17,54
Linfield,7229,2,14,10,6,52,27,25,52
Crusaders,7229,3,14,7,9,51,44,7,49
Coleraine,7229,4,13,9,8,44,33,11,48
Ballymena,7229,5,12,7,11,54,56,-2,43
Portadown,7229,6,12,5,13,36,38,-2,41
Glenavon,7229,7,10,10,10,41,40,1,40
Dungannon,7229,8,9,10,11,48,46,2,37
Ards,7229,9,11,4,15,39,44,-5,37
Ballinamalla,7229,10,10,2,18,31,50,-19,32
Glentoran,7229,11,5,8,17,23,58,-35,23
Crusaders,7230,1,17,5,8,52,37,15,56
Cliftonville,7230,2,16,4,10,53,34,19,52
Ballymena,7230,3,15,7,8,56,51,5,52
Glenavon,7230,4,13,11,6,44,36,8,50
Linfield,7230,5,13,9,8,56,31,25,48
Dungannon,7230,6,10,9,11,46,41,5,39
Glentoran,7230,7,11,5,14,35,46,-11,38
Coleraine,7230,8,9,9,12,34,41,-7,36
Ballinamalla,7230,9,9,6,15,28,50,-22,33
Portadown,7230,10,8,6,16,22,40,-18,30
Ards,7230,11,5,7,18,36,55,-19,22
Cliftonville,7231,1,19,5,6,61,32,29,62
Crusaders,7231,2,18,6,6,59,37,22,60
Linfield,7231,3,15,9,6,61,35,26,54
Ballymena,7231,4,15,7,8,66,53,13,52
Coleraine,7231,5,12,9,9,41,39,2,45
Glenavon,7231,6,11,10,9,44,43,1,43
Ards,7231,7,8,8,14,35,44,-9,32
Dungannon,7231,8,7,10,13,48,48,0,31
Glentoran,7231,9,8,5,17,35,57,-22,29
Portadown,7231,10,7,4,19,23,54,-31,25
Ballinamalla,7231,11,6,5,19,29,60,-31,23
Crusaders,7232,1,16,8,6,55,36,19,56
Cliftonville,7232,2,16,7,7,51,31,20,55
Linfield,7232,3,13,10,7,60,35,25,49
Ballymena,7232,4,14,6,10,59,63,-4,48
Glenavon,7232,5,12,10,8,53,39,14,46
Glentoran,7232,6,10,11,9,31,36,-5,41
Coleraine,7232,7,8,11,11,44,45,-1,35
Ards,7232,8,9,7,14,38,51,-13,34
Dungannon,7232,9,7,10,13,42,51,-9,31
Portadown,7232,10,8,6,16,29,47,-18,30
Ballinamalla,7232,11,8,2,20,28,56,-28,26
Ballymena,7233,1,17,5,8,60,49,11,56
Crusaders,7233,2,16,7,7,57,33,24,55
Cliftonville,7233,3,16,4,10,52,41,11,52
Linfield,7233,4,13,9,8,58,37,21,48
Coleraine,7233,5,12,9,9,50,42,8,45
Glenavon,7233,6,10,12,8,45,42,3,42
Ards,7233,7,11,5,14,40,49,-9,38
Dungannon,7233,8,9,9,12,47,48,-1,36
Glentoran,7233,9,9,7,14,34,48,-14,34
Portadown,7233,10,8,7,15,28,48,-20,31
Ballinamalla,7233,11,6,2,22,25,59,-34,20
Linfield,7234,1,16,10,4,61,29,32,58
Crusaders,7234,2,17,6,7,57,34,23,57
Ballymena,7234,3,16,5,9,59,49,10,53
Cliftonville,7234,4,14,4,12,43,42,1,46
Coleraine,7234,5,11,9,10,42,40,2,42
Glenavon,7234,6,10,12,8,45,46,-1,42
Ards,7234,7,13,3,14,46,50,-4,42
Ballinamalla,7234,8,10,3,17,35,51,-16,33
Dungannon,7234,9,6,14,10,48,47,1,32
Portadown,7234,10,5,10,15,22,43,-21,25
Glentoran,7234,11,6,6,18,29,56,-27,24
Cliftonville,7235,1,17,5,8,57,38,19,56
Linfield,7235,2,15,10,5,56,25,31,55
Crusaders,7235,3,15,6,9,51,40,11,51
Ballymena,7235,4,13,7,10,57,58,-1,46
Coleraine,7235,5,11,11,8,49,44,5,44
Dungannon,7235,6,10,11,9,55,43,12,41
Glenavon,7235,7,10,10,10,45,52,-7,40
Ballinamalla,7235,8,10,3,17,27,45,-18,33
Portadown,7235,9,9,5,16,29,47,-18,32
Ards,7235,10,8,5,17,36,48,-12,29
Glentoran,7235,11,6,9,15,23,45,-22,27
Cliftonville,7236,1,16,7,7,60,34,26,55
Linfield,7236,2,15,9,6,64,35,29,54
Crusaders,7236,3,15,7,8,55,37,18,52
Dungannon,7236,4,14,8,8,61,42,19,50
Ballymena,7236,5,14,7,9,63,63,0,49
Glenavon,7236,6,12,8,10,51,51,0,44
Coleraine,7236,7,10,9,11,38,42,-4,39
Glentoran,7236,8,8,8,14,33,49,-16,32
Portadown,7236,9,8,6,16,27,47,-20,30
Ards,7236,10,9,2,19,40,60,-20,29
Ballinamalla,7236,11,7,3,20,32,64,-32,24
Crusaders,7237,1,18,7,5,64,42,22,61
Ballymena,7237,2,15,6,9,58,56,2,51
Linfield,7237,3,14,8,8,62,35,27,50
Cliftonville,7237,4,13,7,10,55,47,8,46
Glenavon,7237,5,11,10,9,57,47,10,43
Dungannon,7237,6,9,10,11,47,45,2,37
Portadown,7237,7,10,7,13,31,45,-14,37
Ards,7237,8,10,5,15,36,51,-15,35
Coleraine,7237,9,8,10,12,34,38,-4,34
Glentoran,7237,10,9,6,15,32,44,-12,33
Ballinamalla,7237,11,8,4,18,29,55,-26,28
Crusaders,7238,1,17,7,6,54,37,17,58
Linfield,7238,2,14,9,7,55,27,28,51
Ballymena,7238,3,13,8,9,54,56,-2,47
Glenavon,7238,4,12,10,8,52,43,9,46
Cliftonville,7238,5,12,8,10,45,40,5,44
Coleraine,7238,6,9,13,8,36,39,-3,40
Ards,7238,7,11,5,14,45,49,-4,38
Glentoran,7238,8,10,8,12,33,42,-9,38
Dungannon,7238,9,9,10,11,54,48,6,37
Ballinamalla,7238,10,8,5,17,30,52,-22,29
Portadown,7238,11,5,7,18,25,50,-25,22
Cliftonville,7239,1,20,3,7,57,31,26,63
Crusaders,7239,2,16,7,7,54,35,19,55
Ballymena,7239,3,16,5,9,66,56,10,53
Glenavon,7239,4,13,11,6,49,44,5,50
Linfield,7239,5,13,9,8,58,37,21,48
Coleraine,7239,6,13,9,8,44,32,12,48
Dungannon,7239,7,10,10,10,45,41,4,40
Ards,7239,8,9,4,17,38,54,-16,31
Glentoran,7239,9,7,6,17,28,54,-26,27
Portadown,7239,10,6,5,19,23,50,-27,23
Ballinamalla,7239,11,6,3,21,22,50,-28,21
Crusaders,7240,1,20,7,3,63,29,34,67
Cliftonville,7240,2,18,3,9,61,40,21,57
Ballymena,7240,3,16,6,8,63,57,6,54
Linfield,7240,4,15,8,7,63,38,25,53
Glenavon,7240,5,10,12,8,46,43,3,42
Coleraine,7240,6,10,10,10,38,41,-3,40
Glentoran,7240,7,9,7,14,29,41,-12,34
Dungannon,7240,8,9,6,15,50,51,-1,33
Ards,7240,9,10,2,18,35,53,-18,32
Portadown,7240,10,8,4,18,25,47,-22,28
Ballinamalla,7240,11,6,3,21,24,57,-33,21
Crusaders,7241,1,19,8,3,63,27,36,65
Linfield,7241,2,16,7,7,59,33,26,55
Cliftonville,7241,3,15,6,9,52,41,11,51
Coleraine,7241,4,13,9,8,46,37,9,48
Ballymena,7241,5,12,7,11,61,62,-1,43
Glentoran,7241,6,12,5,13,33,40,-7,41
Glenavon,7241,7,9,12,9,44,46,-2,39
Ards,7241,8,11,5,14,41,43,-2,38
Dungannon,7241,9,8,9,13,44,50,-6,33
Portadown,7241,10,5,8,17,24,49,-25,23
Ballinamalla,7241,11,6,2,22,22,61,-39,20
Linfield,7242,1,16,11,3,66,32,34,59
Ballymena,7242,2,15,8,7,52,45,7,53
Crusaders,7242,3,13,9,8,50,37,13,48
Glenavon,7242,4,11,11,8,50,46,4,44
Cliftonville,7242,5,12,7,11,44,37,7,43
Dungannon,7242,6,10,10,10,50,42,8,40
Glentoran,7242,7,10,8,12,31,42,-11,38
Ballinamalla,7242,8,11,4,15,35,49,-14,37
Coleraine,7242,9,8,12,10,31,36,-5,36
Portadown,7242,10,8,4,18,25,49,-24,28
Ards,7242,11,6,6,18,33,52,-19,24
Crusaders,7243,1,19,6,5,63,31,32,63
Linfield,7243,2,14,8,8,63,36,27,50
Cliftonville,7243,3,14,5,11,51,40,11,47
Glenavon,7243,4,12,10,8,45,42,3,46
Coleraine,7243,5,11,12,7,42,37,5,45
Ballymena,7243,6,12,6,12,55,57,-2,42
Glentoran,7243,7,9,10,11,32,46,-14,37
Portadown,7243,8,9,7,14,23,44,-21,34
Ards,7243,9,8,6,16,37,52,-15,30
Dungannon,7243,10,5,14,11,40,45,-5,29
Ballinamalla,7243,11,8,4,18,29,50,-21,28
Linfield,7244,1,17,8,5,67,33,34,59
Crusaders,7244,2,16,9,5,54,34,20,57
Cliftonville,7244,3,17,4,9,58,42,16,55
Coleraine,7244,4,14,8,8,51,36,15,50
Ballymena,7244,5,13,4,13,53,67,-14,43
Glenavon,7244,6,8,12,10,45,50,-5,36
Dungannon,7244,7,9,8,13,47,48,-1,35
Ballinamalla,7244,8,8,10,12,36,45,-9,34
Ards,7244,9,7,8,15,42,57,-15,29
Glentoran,7244,10,7,8,15,31,50,-19,29
Portadown,7244,11,7,5,18,28,50,-22,26
Crusaders,7245,1,19,6,5,60,31,29,63
Linfield,7245,2,16,12,2,67,25,42,60
Ballymena,7245,3,14,7,9,58,61,-3,49
Coleraine,7245,4,12,8,10,47,44,3,44
Cliftonville,7245,5,13,3,14,53,48,5,42
Dungannon,7245,6,10,10,10,53,49,4,40
Glenavon,7245,7,9,13,8,46,48,-2,40
Ards,7245,8,9,6,15,33,42,-9,33
Portadown,7245,9,8,7,15,26,45,-19,31
Glentoran,7245,10,7,7,16,29,52,-23,28
Ballinamalla,7245,11,5,7,18,22,49,-27,22
Linfield,7246,1,16,10,4,63,29,34,58
Crusaders,7246,2,16,8,6,54,30,24,56
Ballymena,7246,3,15,8,7,60,55,5,53
Cliftonville,7246,4,14,7,9,51,38,13,49
Glenavon,7246,5,12,12,6,46,37,9,48
Coleraine,7246,6,9,14,7,35,36,-1,41
Dungannon,7246,7,10,10,10,46,43,3,40
Glentoran,7246,8,9,7,14,31,43,-12,34
Ards,7246,9,9,3,18,31,45,-14,30
Portadown,7246,10,4,9,17,23,53,-30,21
Ballinamalla,7246,11,4,6,20,25,56,-31,18
Linfield,7247,1,15,9,6,65,32,33,54
Ballymena,7247,2,16,6,8,61,55,6,54
Crusaders,7247,3,16,5,9,51,34,17,53
Glenavon,7247,4,14,10,6,59,40,19,52
Cliftonville,7247,5,14,7,9,52,40,12,49
Coleraine,7247,6,10,9,11,34,37,-3,39
Dungannon,7247,7,9,11,10,47,40,7,38
Glentoran,7247,8,9,9,12,29,43,-14,36
Ards,7247,9,7,6,17,34,53,-19,27
Ballinamalla,7247,10,6,7,17,22,49,-27,25
Portadown,7247,11,6,7,17,26,57,-31,25
Crusaders,7248,1,18,4,8,61,41,20,58
Cliftonville,7248,2,16,5,9,60,43,17,53
Linfield,7248,3,14,10,6,57,34,23,52
Ballymena,7248,4,14,4,12,58,58,0,46
Dungannon,7248,5,13,6,11,52,42,10,45
Glenavon,7248,6,12,9,9,48,46,2,45
Coleraine,7248,7,10,10,10,47,50,-3,40
Ards,7248,8,10,6,14,41,49,-8,36
Glentoran,7248,9,8,8,14,30,45,-15,32
Portadown,7248,10,8,5,17,28,49,-21,29
Ballinamalla,7248,11,7,3,20,30,55,-25,24
Crusaders,7249,1,18,8,4,62,31,31,62
Linfield,7249,2,16,8,6,61,26,35,56
Glenavon,7249,3,14,9,7,53,43,10,51
Ballymena,7249,4,15,6,9,56,53,3,51
Cliftonville,7249,5,13,5,12,47,44,3,44
Coleraine,7249,6,9,9,12,38,41,-3,36
Dungannon,7249,7,8,10,12,49,47,2,34
Ards,7249,8,8,8,14,36,50,-14,32
Glentoran,7249,9,7,10,13,30,47,-17,31
Portadown,7249,10,8,6,16,27,48,-21,30
Ballinamalla,7249,11,7,5,18,27,56,-29,26
Linfield,7250,1,17,8,5,60,27,33,59
Crusaders,7250,2,15,7,8,54,35,19,52
Coleraine,7250,3,13,11,6,47,39,8,50
Cliftonville,7250,4,15,4,11,53,42,11,49
Glenavon,7250,5,12,10,8,52,40,12,46
Ballymena,7250,6,13,7,10,46,50,-4,46
Dungannon,7250,7,10,10,10,49,47,2,40
Ards,7250,8,10,5,15,37,47,-10,35
Ballinamalla,7250,9,10,3,17,35,51,-16,33
Glentoran,7250,10,7,7,16,26,49,-23,28
Portadown,7250,11,5,4,21,24,56,-32,19
Crusaders,7251,1,19,7,4,61,30,31,64
Linfield,7251,2,15,10,5,62,35,27,55
Ballymena,7251,3,16,5,9,62,61,1,53
Glenavon,7251,4,13,11,6,50,41,9,50
Coleraine,7251,5,11,10,9,43,40,3,43
Cliftonville,7251,6,13,4,13,44,42,2,43
Portadown,7251,7,10,5,15,29,42,-13,35
Dungannon,7251,8,8,10,12,46,47,-1,34
Ards,7251,9,8,8,14,34,46,-12,32
Glentoran,7251,10,6,7,17,27,49,-22,25
Ballinamalla,7251,11,6,3,21,33,58,-25,21
Cliftonville,7252,1,18,4,8,55,35,20,58
Linfield,7252,2,16,7,7,58,31,27,55
Crusaders,7252,3,15,9,6,53,37,16,54
Coleraine,7252,4,14,8,8,44,33,11,50
Glenavon,7252,5,12,8,10,41,39,2,44
Dungannon,7252,6,10,11,9,47,41,6,41
Ballymena,7252,7,12,4,14,51,53,-2,40
Glentoran,7252,8,9,6,15,27,44,-17,33
Ards,7252,9,9,5,16,33,46,-13,32
Portadown,7252,10,8,4,18,24,49,-25,28
Ballinamalla,7252,11,6,6,18,30,55,-25,24
Linfield,7253,1,17,9,4,60,25,35,60
Crusaders,7253,2,15,7,8,53,34,19,52
Cliftonville,7253,3,15,5,10,52,37,15,50
Ballymena,7253,4,15,5,10,55,56,-1,50
Glenavon,7253,5,13,8,9,57,49,8,47
Coleraine,7253,6,11,10,9,40,40,0,43
Glentoran,7253,7,10,9,11,32,44,-12,39
Dungannon,7253,8,7,11,12,46,49,-3,32
Ards,7253,9,7,8,15,35,50,-15,29
Portadown,7253,10,7,5,18,23,45,-22,26
Ballinamalla,7253,11,7,5,18,29,53,-24,26
Linfield,7254,1,17,10,3,58,29,29,61
Crusaders,7254,2,17,8,5,57,32,25,59
Cliftonville,7254,3,15,6,9,57,41,16,51
Glenavon,7254,4,12,11,7,54,46,8,47
Coleraine,7254,5,10,14,6,47,44,3,44
Ballymena,7254,6,11,11,8,49,50,-1,44
Ards,7254,7,11,4,15,42,46,-4,37
Glentoran,7254,8,7,8,15,30,48,-18,29
Portadown,7254,9,7,6,17,25,47,-22,27
Dungannon,7254,10,5,10,15,41,51,-10,25
Ballinamalla,7254,11,7,4,19,28,54,-26,25
Crusaders,7255,1,16,9,5,52,30,22,57
Linfield,7255,2,14,9,7,56,31,25,51
Cliftonville,7255,3,15,4,11,51,42,9,49
Glenavon,7255,4,12,12,6,45,39,6,48
Ballymena,7255,5,12,10,8,60,58,2,46
Dungannon,7255,6,10,12,8,54,41,13,42
Coleraine,7255,7,8,15,7,40,38,2,39
Glentoran,7255,8,8,10,12,27,44,-17,34
Ards,7255,9,8,6,16,33,50,-17,30
Portadown,7255,10,7,7,16,22,39,-17,28
Ballinamalla,7255,11,6,4,20,28,56,-28,22
Crusaders,7256,1,18,6,6,54,29,25,60
Linfield,7256,2,15,10,5,59,34,25,55
Dungannon,7256,3,12,11,7,55,33,22,47
Cliftonville,7256,4,13,4,13,52,45,7,43
Ballymena,7256,5,13,4,13,51,58,-7,43
Glenavon,7256,6,11,9,10,48,49,-1,42
Ards,7256,7,11,7,12,36,40,-4,40
Coleraine,7256,8,9,8,13,40,45,-5,35
Glentoran,7256,9,9,8,13,35,47,-12,35
Portadown,7256,10,8,6,16,29,50,-21,30
Ballinamalla,7256,11,8,3,19,33,62,-29,27
Crusaders,7257,1,18,7,5,57,32,25,61
Linfield,7257,2,14,9,7,50,24,26,51
Cliftonville,7257,3,16,3,11,57,48,9,51
Glenavon,7257,4,13,7,10,51,43,8,46
Coleraine,7257,5,13,7,10,42,38,4,46
Ballymena,7257,6,13,6,11,49,52,-3,45
Ards,7257,7,11,5,14,37,45,-8,38
Dungannon,7257,8,9,8,13,48,42,6,35
Ballinamalla,7257,9,9,4,17,31,51,-20,31
Glentoran,7257,10,8,5,17,28,51,-23,29
Portadown,7257,11,8,5,17,18,42,-24,29
Cliftonville,7258,1,15,7,8,53,40,13,52
Glenavon,7258,2,14,9,7,51,42,9,51
Crusaders,7258,3,14,5,11,54,42,12,47
Linfield,7258,4,12,10,8,57,34,23,46
Dungannon,7258,5,12,9,9,58,42,16,45
Ballymena,7258,6,12,8,10,55,55,0,44
Coleraine,7258,7,10,10,10,43,46,-3,40
Glentoran,7258,8,11,7,12,29,41,-12,40
Ards,7258,9,8,8,14,36,49,-13,32
Ballinamalla,7258,10,7,8,15,31,47,-16,29
Portadown,7258,11,7,5,18,25,54,-29,26
Crusaders,7259,1,17,7,6,56,36,20,58
Linfield,7259,2,13,10,7,65,42,23,49
Cliftonville,7259,3,15,4,11,49,37,12,49
Glenavon,7259,4,11,13,6,50,41,9,46
Ballymena,7259,5,12,9,9,61,62,-1,45
Coleraine,7259,6,12,8,10,45,36,9,44
Glentoran,7259,7,9,8,13,32,46,-14,35
Portadown,7259,8,10,5,15,29,45,-16,35
Ards,7259,9,10,4,16,39,51,-12,34
Dungannon,7259,10,7,10,13,45,48,-3,31
Ballinamalla,7259,11,8,4,18,28,55,-27,28
Linfield,7260,1,16,7,7,56,28,28,55
Crusaders,7260,2,16,7,7,53,33,20,55
Cliftonville,7260,3,15,6,9,52,41,11,51
Dungannon,7260,4,11,11,8,51,41,10,44
Coleraine,7260,5,9,13,8,38,40,-2,40
Ballymena,7260,6,12,3,15,52,60,-8,39
Glenavon,7260,7,8,13,9,40,44,-4,37
Ards,7260,8,11,4,15,38,43,-5,37
Ballinamalla,7260,9,8,8,14,24,39,-15,32
Portadown,7260,10,8,7,15,28,44,-16,31
Glentoran,7260,11,8,7,15,28,47,-19,31
Cliftonville,7261,1,18,4,8,65,38,27,58
Coleraine,7261,2,14,10,6,52,39,13,52
Linfield,7261,3,13,11,6,57,34,23,50
Crusaders,7261,4,14,8,8,52,37,15,50
Glenavon,7261,5,11,10,9,51,49,2,43
Ballymena,7261,6,13,4,13,52,57,-5,43
Glentoran,7261,7,10,8,12,32,43,-11,38
Dungannon,7261,8,7,13,10,46,45,1,34
Ballinamalla,7261,9,10,4,16,36,49,-13,34
Ards,7261,10,9,3,18,37,60,-23,30
Portadown,7261,11,6,5,19,23,52,-29,23
Linfield,7262,1,16,9,5,63,29,34,57
Crusaders,7262,2,16,7,7,56,33,23,55
Cliftonville,7262,3,15,5,10,51,38,13,50
Ballymena,7262,4,15,5,10,56,53,3,50
Coleraine,7262,5,10,12,8,40,40,0,42
Glenavon,7262,6,10,12,8,41,42,-1,42
Dungannon,7262,7,10,11,9,53,42,11,41
Glentoran,7262,8,9,7,14,29,50,-21,34
Ballinamalla,7262,9,9,6,15,30,47,-17,33
Ards,7262,10,8,5,17,32,50,-18,29
Portadown,7262,11,5,5,20,23,50,-27,20
Crusaders,7263,1,17,7,6,53,35,18,58
Coleraine,7263,2,16,9,5,55,31,24,57
Linfield,7263,3,14,8,8,58,27,31,50
Ballymena,7263,4,14,6,10,53,54,-1,48
Cliftonville,7263,5,13,5,12,54,48,6,44
Glenavon,7263,6,10,9,11,42,51,-9,39
Glentoran,7263,7,9,7,14,29,43,-14,34
Ballinamalla,7263,8,10,4,16,37,52,-15,34
Dungannon,7263,9,7,12,11,42,43,-1,33
Ards,7263,10,9,4,17,40,56,-16,31
Portadown,7263,11,7,7,16,25,48,-23,28
Crusaders,7264,1,16,5,9,57,33,24,53
Ballymena,7264,2,14,7,9,53,55,-2,49
Linfield,7264,3,12,11,7,52,32,20,47
Coleraine,7264,4,12,11,7,48,35,13,47
Cliftonville,7264,5,13,3,14,51,44,7,42
Dungannon,7264,6,10,11,9,49,44,5,41
Glenavon,7264,7,10,11,9,42,46,-4,41
Ballinamalla,7264,8,11,3,16,31,51,-20,36
Glentoran,7264,9,9,7,14,31,44,-13,34
Ards,7264,10,8,8,14,36,49,-13,32
Portadown,7264,11,8,7,15,27,44,-17,31
Cliftonville,7265,1,19,3,8,66,41,25,60
Ballymena,7265,2,16,6,8,62,50,12,54
Crusaders,7265,3,15,7,8,51,33,18,52
Glenavon,7265,4,13,11,6,54,46,8,50
Linfield,7265,5,13,8,9,58,44,14,47
Coleraine,7265,6,11,10,9,42,37,5,43
Glentoran,7265,7,11,6,13,33,43,-10,39
Dungannon,7265,8,8,12,10,47,43,4,36
Portadown,7265,9,7,6,17,22,49,-27,27
Ballinamalla,7265,10,7,4,19,28,55,-27,25
Ards,7265,11,6,5,19,32,54,-22,23
Linfield,7266,1,16,9,5,62,31,31,57
Cliftonville,7266,2,16,4,10,60,43,17,52
Crusaders,7266,3,14,6,10,53,43,10,48
Coleraine,7266,4,10,14,6,46,39,7,44
Dungannon,7266,5,11,8,11,51,41,10,41
Glenavon,7266,6,9,14,7,44,44,0,41
Ballymena,7266,7,11,8,11,52,58,-6,41
Glentoran,7266,8,10,7,13,35,46,-11,37
Ards,7266,9,10,3,17,43,57,-14,33
Ballinamalla,7266,10,10,3,17,33,52,-19,33
Portadown,7266,11,8,4,18,26,51,-25,28
Linfield,7267,1,17,7,6,61,31,30,58
Crusaders,7267,2,18,4,8,61,43,18,58
Cliftonville,7267,3,14,8,8,55,39,16,50
Glenavon,7267,4,11,12,7,44,40,4,45
Ballymena,7267,5,13,5,12,55,62,-7,44
Coleraine,7267,6,11,9,10,44,41,3,42
Dungannon,7267,7,9,10,11,50,39,11,37
Glentoran,7267,8,10,7,13,35,50,-15,37
Ards,7267,9,9,5,16,40,49,-9,32
Portadown,7267,10,7,6,17,27,49,-22,27
Ballinamalla,7267,11,7,5,18,25,54,-29,26
Linfield,7268,1,17,10,3,65,23,42,61
Crusaders,7268,2,18,6,6,55,31,24,60
Cliftonville,7268,3,17,4,9,58,40,18,55
Ballymena,7268,4,13,8,9,53,60,-7,47
Glenavon,7268,5,11,9,10,54,53,1,42
Portadown,7268,6,12,6,12,39,46,-7,42
Coleraine,7268,7,11,7,12,48,48,0,40
Glentoran,7268,8,9,7,14,34,48,-14,34
Dungannon,7268,9,7,10,13,43,45,-2,31
Ards,7268,10,7,5,18,37,54,-17,26
Ballinamalla,7268,11,5,4,21,29,67,-38,19
Ballymena,7269,1,17,5,8,62,54,8,56
Crusaders,7269,2,15,10,5,61,38,23,55
Cliftonville,7269,3,15,6,9,54,44,10,51
Linfield,7269,4,14,8,8,56,34,22,50
Coleraine,7269,5,13,7,10,45,37,8,46
Dungannon,7269,6,9,11,10,56,53,3,38
Glenavon,7269,7,9,11,10,48,52,-4,38
Ards,7269,8,11,5,14,39,49,-10,38
Glentoran,7269,9,8,7,15,27,42,-15,31
Ballinamalla,7269,10,8,5,17,33,57,-24,29
Portadown,7269,11,7,3,20,26,47,-21,24
Crusaders,7270,1,14,8,8,53,40,13,50
Linfield,7270,2,11,15,4,59,35,24,48
Cliftonville,7270,3,13,6,11,50,41,9,45
Coleraine,7270,4,11,12,7,48,39,9,45
Ballymena,7270,5,10,13,7,54,56,-2,43
Glenavon,7270,6,8,14,8,54,50,4,38
Dungannon,7270,7,9,10,11,49,50,-1,37
Ards,7270,8,10,7,13,42,47,-5,37
Portadown,7270,9,9,8,13,31,45,-14,35
Glentoran,7270,10,8,9,13,23,42,-19,33
Ballinamalla,7270,11,10,2,18,32,50,-18,32
Crusaders,7271,1,16,8,6,59,34,25,56
Linfield,7271,2,14,10,6,62,38,24,52
Cliftonville,7271,3,16,3,11,61,50,11,51
Coleraine,7271,4,13,11,6,44,36,8,50
Ballymena,7271,5,14,6,10,63,60,3,48
Dungannon,7271,6,11,10,9,55,46,9,43
Glenavon,7271,7,10,11,9,46,47,-1,41
Ballinamalla,7271,8,9,6,15,33,48,-15,33
Glentoran,7271,9,7,8,15,30,54,-24,29
Ards,7271,10,6,8,16,35,49,-14,26
Portadown,7271,11,7,3,20,29,55,-26,24
Crusaders,7272,1,18,9,3,54,27,27,63
Ballymena,7272,2,13,7,10,55,57,-2,46
Cliftonville,7272,3,13,6,11,53,46,7,45
Glenavon,7272,4,11,11,8,45,40,5,44
Dungannon,7272,5,10,11,9,52,43,9,41
Coleraine,7272,6,9,12,9,40,40,0,39
Portadown,7272,7,11,6,13,35,41,-6,39
Linfield,7272,8,10,8,12,53,49,4,38
Ballinamalla,7272,9,9,7,14,33,46,-13,34
Glentoran,7272,10,9,6,15,33,46,-13,33
Ards,7272,11,9,3,18,32,50,-18,30
Linfield,7273,1,16,10,4,64,31,33,58
Coleraine,7273,2,14,11,5,40,27,13,53
Ballymena,7273,3,15,7,8,58,53,5,52
Crusaders,7273,4,15,6,9,51,39,12,51
Cliftonville,7273,5,14,5,11,52,40,12,47
Glenavon,7273,6,11,14,5,46,39,7,47
Dungannon,7273,7,8,12,10,47,41,6,36
Ards,7273,8,9,6,15,43,52,-9,33
Glentoran,7273,9,8,6,16,29,49,-20,30
Portadown,7273,10,5,7,18,21,50,-29,22
Ballinamalla,7273,11,6,4,20,23,53,-30,22
Crusaders,7274,1,18,8,4,60,38,22,62
Ballymena,7274,2,15,7,8,62,57,5,52
Glenavon,7274,3,13,10,7,47,41,6,49
Cliftonville,7274,4,14,6,10,53,43,10,48
Linfield,7274,5,12,10,8,57,35,22,46
Coleraine,7274,6,10,10,10,44,44,0,40
Dungannon,7274,7,9,12,9,56,43,13,39
Ards,7274,8,10,3,17,35,50,-15,33
Portadown,7274,9,8,8,14,33,49,-16,32
Glentoran,7274,10,9,4,17,26,46,-20,31
Ballinamalla,7274,11,6,4,20,27,54,-27,22
Crusaders,7275,1,18,6,6,59,36,23,60
Linfield,7275,2,16,9,5,59,29,30,57
Ballymena,7275,3,15,6,9,50,48,2,51
Dungannon,7275,4,12,10,8,55,36,19,46
Cliftonville,7275,5,11,9,10,52,44,8,42
Glenavon,7275,6,9,14,7,44,43,1,41
Glentoran,7275,7,9,9,12,30,39,-9,36
Coleraine,7275,8,8,10,12,39,49,-10,34
Ards,7275,9,7,9,14,42,52,-10,30
Portadown,7275,10,8,4,18,25,49,-24,28
Ballinamalla,7275,11,7,4,19,24,54,-30,25
Linfield,7276,1,17,6,7,62,30,32,57
Coleraine,7276,2,15,8,7,49,37,12,53
Crusaders,7276,3,13,12,5,57,39,18,51
Cliftonville,7276,4,15,5,10,51,36,15,50
Ballymena,7276,5,11,7,12,55,67,-12,40
Glenavon,7276,6,8,14,8,42,44,-2,38
Ards,7276,7,10,5,15,43,49,-6,35
Dungannon,7276,8,8,10,12,46,45,1,34
Glentoran,7276,9,8,10,12,31,44,-13,34
Ballinamalla,7276,10,9,5,16,26,47,-21,32
Portadown,7276,11,7,6,17,21,45,-24,27
Crusaders,7277,1,18,5,7,58,31,27,59
Linfield,7277,2,16,7,7,59,31,28,55
Cliftonville,7277,3,16,5,9,52,36,16,53
Ballymena,7277,4,13,10,7,57,56,1,49
Glenavon,7277,5,12,10,8,51,49,2,46
Coleraine,7277,6,12,9,9,41,37,4,45
Dungannon,7277,7,9,9,12,46,45,1,36
Glentoran,7277,8,8,8,14,32,45,-13,32
Ballinamalla,7277,9,9,3,18,27,54,-27,30
Ards,7277,10,6,9,15,31,46,-15,27
Portadown,7277,11,5,7,18,22,46,-24,22
Crusaders,7278,1,19,5,6,57,30,27,62
Ballymena,7278,2,16,6,8,63,58,5,54
Linfield,7278,3,14,9,7,54,32,22,51
Cliftonville,7278,4,14,7,9,46,38,8,49
Ballinamalla,7278,5,12,3,15,38,49,-11,39
Glentoran,7278,6,11,5,14,38,42,-4,38
Portadown,7278,7,10,7,13,30,40,-10,37
Coleraine,7278,8,8,10,12,40,47,-7,34
Glenavon,7278,9,8,10,12,39,50,-11,34
Dungannon,7278,10,7,10,13,45,45,0,31
Ards,7278,11,7,6,17,32,51,-19,27
Linfield,7279,1,17,8,5,54,26,28,59
Crusaders,7279,2,17,6,7,54,34,20,57
Coleraine,7279,3,15,10,5,46,30,16,55
Cliftonville,7279,4,14,5,11,52,37,15,47
Glenavon,7279,5,13,8,9,47,46,1,47
Ballymena,7279,6,13,6,11,58,62,-4,45
Dungannon,7279,7,8,11,11,46,44,2,35
Ards,7279,8,8,6,16,35,46,-11,30
Glentoran,7279,9,7,8,15,29,48,-19,29
Portadown,7279,10,8,5,17,25,47,-22,29
Ballinamalla,7279,11,5,7,18,23,49,-26,22
Cliftonville,7280,1,14,7,9,54,39,15,49
Crusaders,7280,2,13,9,8,53,41,12,48
Glenavon,7280,3,12,11,7,48,44,4,47
Linfield,7280,4,11,10,9,52,38,14,43
Dungannon,7280,5,11,10,9,60,47,13,43
Coleraine,7280,6,11,10,9,43,35,8,43
Ballymena,7280,7,11,8,11,55,62,-7,41
Glentoran,7280,8,10,9,11,36,44,-8,39
Ards,7280,9,10,7,13,38,46,-8,37
Portadown,7280,10,8,7,15,27,42,-15,31
Ballinamalla,7280,11,6,8,16,30,58,-28,26
Linfield,7281,1,18,7,5,69,30,39,61
Cliftonville,7281,2,17,6,7,59,41,18,57
Coleraine,7281,3,13,11,6,52,39,13,50
Crusaders,7281,4,13,8,9,49,38,11,47
Glenavon,7281,5,10,12,8,43,39,4,42
Ballymena,7281,6,11,7,12,49,62,-13,40
Dungannon,7281,7,8,9,13,47,47,0,33
Ards,7281,8,9,6,15,39,51,-12,33
Ballinamalla,7281,9,8,6,16,27,45,-18,30
Portadown,7281,10,8,6,16,27,46,-19,30
Glentoran,7281,11,7,8,15,26,49,-23,29
Crusaders,7282,1,14,12,4,50,27,23,54
Ballymena,7282,2,15,6,9,58,58,0,51
Cliftonville,7282,3,15,5,10,57,39,18,50
Coleraine,7282,4,12,12,6,46,37,9,48
Glenavon,7282,5,12,11,7,47,43,4,47
Linfield,7282,6,12,6,12,55,39,16,42
Dungannon,7282,7,9,13,8,48,39,9,40
Portadown,7282,8,9,5,16,27,43,-16,32
Ards,7282,9,9,4,17,40,55,-15,31
Glentoran,7282,10,8,7,15,32,52,-20,31
Ballinamalla,7282,11,7,5,18,25,53,-28,26
Crusaders,7283,1,19,6,5,62,30,32,63
Linfield,7283,2,17,9,4,64,26,38,60
Coleraine,7283,3,13,10,7,44,38,6,49
Cliftonville,7283,4,14,6,10,49,43,6,48
Glenavon,7283,5,11,12,7,45,43,2,45
Ballymena,7283,6,11,9,10,49,59,-10,42
Dungannon,7283,7,10,9,11,56,42,14,39
Glentoran,7283,8,9,7,14,31,43,-12,34
Portadown,7283,9,7,6,17,22,45,-23,27
Ards,7283,10,5,8,17,32,56,-24,23
Ballinamalla,7283,11,5,6,19,26,55,-29,21
Crusaders,7284,1,17,7,6,60,33,27,58
Cliftonville,7284,2,17,2,11,52,44,8,53
Dungannon,7284,3,14,7,9,65,41,24,49
Coleraine,7284,4,13,9,8,42,34,8,48
Linfield,7284,5,12,9,9,60,39,21,45
Ballymena,7284,6,12,6,12,51,56,-5,42
Glenavon,7284,7,9,10,11,40,48,-8,37
Portadown,7284,8,10,6,14,25,39,-14,36
Ballinamalla,7284,9,10,2,18,27,54,-27,32
Ards,7284,10,9,4,17,38,55,-17,31
Glentoran,7284,11,7,8,15,26,43,-17,29
Crusaders,7285,1,17,8,5,55,30,25,59
Linfield,7285,2,17,7,6,61,26,35,58
Cliftonville,7285,3,15,5,10,53,41,12,50
Ballymena,7285,4,15,5,10,64,64,0,50
Coleraine,7285,5,12,10,8,45,39,6,46
Glenavon,7285,6,11,13,6,53,48,5,46
Dungannon,7285,7,9,8,13,48,50,-2,35
Ards,7285,8,9,5,16,41,50,-9,32
Glentoran,7285,9,8,6,16,29,49,-20,30
Portadown,7285,10,8,4,18,28,49,-21,28
Ballinamalla,7285,11,6,5,19,29,60,-31,23
Linfield,7286,1,16,7,7,61,34,27,55
Cliftonville,7286,2,17,4,9,53,39,14,55
Crusaders,7286,3,16,5,9,54,41,13,53
Coleraine,7286,4,13,9,8,39,37,2,48
Ballymena,7286,5,14,5,11,61,56,5,47
Glenavon,7286,6,9,12,9,48,49,-1,39
Dungannon,7286,7,10,8,12,51,46,5,38
Glentoran,7286,8,10,4,16,36,49,-13,34
Portadown,7286,9,9,7,14,21,36,-15,34
Ballinamalla,7286,10,9,2,19,34,52,-18,29
Ards,7286,11,8,5,17,39,58,-19,29
Linfield,7287,1,18,9,3,64,27,37,63
Crusaders,7287,2,16,7,7,55,36,19,55
Cliftonville,7287,3,14,4,12,48,39,9,46
Coleraine,7287,4,10,13,7,43,37,6,43
Glenavon,7287,5,11,9,10,48,46,2,42
Dungannon,7287,6,9,12,9,45,38,7,39
Ards,7287,7,10,7,13,46,52,-6,37
Portadown,7287,8,9,8,13,30,46,-16,35
Ballymena,7287,9,8,10,12,48,64,-16,34
Glentoran,7287,10,7,7,16,26,47,-21,28
Ballinamalla,7287,11,7,6,17,30,51,-21,27
Crusaders,7288,1,18,5,7,56,37,19,59
Linfield,7288,2,15,8,7,60,32,28,53
Cliftonville,7288,3,16,3,11,53,37,16,51
Ballymena,7288,4,11,10,9,54,59,-5,43
Glenavon,7288,5,10,12,8,51,47,4,42
Portadown,7288,6,12,4,14,35,43,-8,40
Dungannon,7288,7,9,12,9,48,39,9,39
Coleraine,7288,8,9,11,10,40,51,-11,38
Ards,7288,9,8,5,17,38,52,-14,29
Glentoran,7288,10,6,11,13,30,47,-17,29
Ballinamalla,7288,11,7,7,16,31,52,-21,28
Cliftonville,7289,1,19,3,8,62,34,28,60
Crusaders,7289,2,17,8,5,50,26,24,59
Linfield,7289,3,15,8,7,59,31,28,53
Coleraine,7289,4,14,10,6,53,38,15,52
Glenavon,7289,5,12,9,9,43,38,5,45
Ballymena,7289,6,13,4,13,57,67,-10,43
Dungannon,7289,7,9,8,13,42,45,-3,35
Portadown,7289,8,9,7,14,24,40,-16,34
Ards,7289,9,8,5,17,34,52,-18,29
Glentoran,7289,10,5,11,14,23,46,-23,26
Ballinamalla,7289,11,5,5,20,18,48,-30,20
Crusaders,7290,1,19,5,6,59,30,29,62
Linfield,7290,2,16,10,4,67,29,38,58
Glenavon,7290,3,12,11,7,52,43,9,47
Ballymena,7290,4,13,7,10,61,62,-1,46
Cliftonville,7290,5,14,3,13,47,46,1,45
Coleraine,7290,6,11,10,9,45,43,2,43
Dungannon,7290,7,8,10,12,53,52,1,34
Ards,7290,8,9,7,14,40,49,-9,34
Glentoran,7290,9,9,5,16,34,53,-19,32
Ballinamalla,7290,10,9,3,18,33,58,-25,30
Portadown,7290,11,6,7,17,23,49,-26,25
Crusaders,7291,1,16,8,6,57,33,24,56
Ballymena,7291,2,16,7,7,63,55,8,55
Linfield,7291,3,14,11,5,57,32,25,53
Cliftonville,7291,4,15,6,9,51,33,18,51
Glenavon,7291,5,13,10,7,49,41,8,49
Coleraine,7291,6,10,12,8,41,39,2,42
Dungannon,7291,7,7,13,10,45,42,3,34
Ards,7291,8,8,7,15,41,55,-14,31
Glentoran,7291,9,8,7,15,27,45,-18,31
Portadown,7291,10,6,6,18,24,47,-23,24
Ballinamalla,7291,11,6,5,19,23,56,-33,23
Crusaders,7292,1,15,8,7,55,37,18,53
Cliftonville,7292,2,15,6,9,53,36,17,51
Linfield,7292,3,14,8,8,57,30,27,50
Ballymena,7292,4,14,8,8,51,48,3,50
Dungannon,7292,5,12,9,9,53,47,6,45
Glenavon,7292,6,11,11,8,46,41,5,44
Coleraine,7292,7,9,10,11,38,42,-4,37
Ards,7292,8,11,3,16,35,49,-14,36
Glentoran,7292,9,8,8,14,25,42,-17,32
Portadown,7292,10,8,6,16,27,44,-17,30
Ballinamalla,7292,11,8,3,19,28,52,-24,27
Linfield,7293,1,17,6,7,67,36,31,57
Crusaders,7293,2,16,7,7,60,36,24,55
Coleraine,7293,3,13,10,7,48,40,8,49
Ballymena,7293,4,15,4,11,57,58,-1,49
Cliftonville,7293,5,13,8,9,51,42,9,47
Glenavon,7293,6,11,10,9,51,49,2,43
Dungannon,7293,7,11,8,11,53,46,7,41
Glentoran,7293,8,10,8,12,36,43,-7,38
Ballinamalla,7293,9,8,6,16,32,61,-29,30
Ards,7293,10,6,6,18,31,54,-23,24
Portadown,7293,11,6,5,19,27,48,-21,23
Crusaders,7294,1,21,5,4,63,29,34,68
Linfield,7294,2,15,9,6,65,33,32,54
Cliftonville,7294,3,15,4,11,49,41,8,49
Coleraine,7294,4,12,10,8,47,43,4,46
Ballymena,7294,5,12,9,9,56,56,0,45
Ballinamalla,7294,6,12,3,15,34,44,-10,39
Glentoran,7294,7,9,10,11,26,40,-14,37
Dungannon,7294,8,9,8,13,43,44,-1,35
Glenavon,7294,9,8,9,13,38,44,-6,33
Ards,7294,10,8,5,17,37,53,-16,29
Portadown,7294,11,6,4,20,16,47,-31,22
Cliftonville,7295,1,17,7,6,56,31,25,58
Crusaders,7295,2,17,7,6,53,31,22,58
Ballymena,7295,3,17,6,7,61,47,14,57
Linfield,7295,4,15,9,6,49,27,22,54
Glenavon,7295,5,12,10,8,42,37,5,46
Coleraine,7295,6,10,12,8,36,34,2,42
Ards,7295,7,11,6,13,41,49,-8,39
Glentoran,7295,8,10,5,15,33,48,-15,35
Dungannon,7295,9,7,9,14,39,47,-8,30
Ballinamalla,7295,10,5,4,21,28,60,-32,19
Portadown,7295,11,5,3,22,19,46,-27,18
Crusaders,7296,1,17,8,5,54,28,26,59
Linfield,7296,2,16,9,5,62,29,33,57
Ballymena,7296,3,17,4,9,60,49,11,55
Cliftonville,7296,4,15,4,11,48,35,13,49
Coleraine,7296,5,11,10,9,46,41,5,43
Glenavon,7296,6,11,9,10,41,41,0,42
Dungannon,7296,7,10,10,10,45,37,8,40
Glentoran,7296,8,9,8,13,36,50,-14,35
Ards,7296,9,8,7,15,39,52,-13,31
Ballinamalla,7296,10,8,4,18,27,52,-25,28
Portadown,7296,11,5,3,22,18,62,-44,18
Cliftonville,7297,1,17,3,10,51,38,13,54
Crusaders,7297,2,16,5,9,50,31,19,53
Linfield,7297,3,14,9,7,62,34,28,51
Coleraine,7297,4,13,10,7,45,36,9,49
Ballymena,7297,5,13,8,9,56,60,-4,47
Glenavon,7297,6,11,12,7,44,42,2,45
Dungannon,7297,7,10,12,8,46,36,10,42
Ballinamalla,7297,8,9,6,15,36,46,-10,33
Glentoran,7297,9,7,11,12,28,45,-17,32
Portadown,7297,10,5,8,17,20,43,-23,23
Ards,7297,11,6,4,20,34,61,-27,22
Crusaders,7298,1,17,9,4,58,32,26,60
Ballymena,7298,2,15,7,8,60,57,3,52
Linfield,7298,3,15,6,9,57,32,25,51
Cliftonville,7298,4,15,6,9,53,40,13,51
Glenavon,7298,5,12,10,8,52,46,6,46
Coleraine,7298,6,10,10,10,41,38,3,40
Glentoran,7298,7,8,11,11,27,37,-10,35
Dungannon,7298,8,7,10,13,43,53,-10,31
Ards,7298,9,7,8,15,35,51,-16,29
Portadown,7298,10,8,5,17,26,45,-19,29
Ballinamalla,7298,11,8,4,18,28,49,-21,28
Crusaders,7299,1,14,11,5,52,34,18,53
Linfield,7299,2,13,10,7,57,30,27,49
Ballymena,7299,3,13,7,10,51,55,-4,46
Dungannon,7299,4,11,11,8,53,37,16,44
Glenavon,7299,5,10,13,7,45,43,2,43
Cliftonville,7299,6,12,7,11,44,42,2,43
Coleraine,7299,7,10,12,8,40,40,0,42
Glentoran,7299,8,9,8,13,30,40,-10,35
Portadown,7299,9,9,6,15,28,42,-14,33
Ballinamalla,7299,10,9,5,16,29,47,-18,32
Ards,7299,11,6,8,16,31,50,-19,26
Cliftonville,7300,1,17,5,8,55,38,17,56
Crusaders,7300,2,15,9,6,57,38,19,54
Linfield,7300,3,14,10,6,59,32,27,52
Ballymena,7300,4,14,6,10,61,61,0,48
Coleraine,7300,5,10,14,6,41,34,7,44
Glenavon,7300,6,9,13,8,47,46,1,40
Dungannon,7300,7,8,11,11,47,46,1,35
Ards,7300,8,9,7,14,35,45,-10,34
Glentoran,7300,9,9,5,16,32,51,-19,32
Ballinamalla,7300,10,8,4,18,35,53,-18,28
Portadown,7300,11,7,6,17,22,47,-25,27
Crusaders,7301,1,16,12,2,57,27,30,60
Linfield,7301,2,15,12,3,55,25,30,57
Cliftonville,7301,3,17,6,7,53,32,21,57
Dungannon,7301,4,11,12,7,58,44,14,45
Ballymena,7301,5,12,9,9,60,59,1,45
Glenavon,7301,6,8,14,8,47,50,-3,38
Coleraine,7301,7,8,11,11,33,40,-7,35
Ards,7301,8,8,7,15,33,44,-11,31
Portadown,7301,9,9,4,17,27,47,-20,31
Glentoran,7301,10,4,11,15,24,48,-24,23
Ballinamalla,7301,11,5,6,19,30,61,-31,21
Crusaders,7302,1,18,8,4,62,33,29,62
Linfield,7302,2,15,9,6,70,34,36,54
Cliftonville,7302,3,16,5,9,57,39,18,53
Ballymena,7302,4,13,6,11,58,65,-7,45
Dungannon,7302,5,12,8,10,52,44,8,44
Coleraine,7302,6,11,11,8,44,39,5,44
Glenavon,7302,7,8,12,10,44,52,-8,36
Glentoran,7302,8,8,11,11,37,53,-16,35
Ballinamalla,7302,9,8,4,18,31,51,-20,28
Ards,7302,10,7,5,18,39,57,-18,26
Portadown,7302,11,5,9,16,26,53,-27,24
Crusaders,7303,1,17,9,4,58,30,28,60
Cliftonville,7303,2,14,7,9,52,39,13,49
Ballymena,7303,3,14,7,9,53,48,5,49
Linfield,7303,4,12,11,7,54,34,20,47
Dungannon,7303,5,13,8,9,54,45,9,47
Coleraine,7303,6,10,11,9,38,39,-1,41
Glenavon,7303,7,8,10,12,39,47,-8,34
Glentoran,7303,8,8,10,12,32,41,-9,34
Ballinamalla,7303,9,9,7,14,32,49,-17,34
Portadown,7303,10,8,5,17,25,44,-19,29
Ards,7303,11,7,5,18,30,51,-21,26
Crusaders,7304,1,15,7,8,54,39,15,52
Ballymena,7304,2,15,7,8,69,58,11,52
Coleraine,7304,3,14,8,8,49,46,3,50
Glenavon,7304,4,12,11,7,51,49,2,47
Cliftonville,7304,5,12,7,11,48,40,8,43
Linfield,7304,6,10,12,8,56,40,16,42
Dungannon,7304,7,11,8,11,57,51,6,41
Ballinamalla,7304,8,12,4,14,42,49,-7,40
Glentoran,7304,9,9,7,14,29,45,-16,34
Ards,7304,10,8,4,18,35,51,-16,28
Portadown,7304,11,5,9,16,30,52,-22,24
Crusaders,7305,1,19,7,4,54,25,29,64
Cliftonville,7305,2,16,6,8,50,36,14,54
Ballymena,7305,3,16,6,8,55,49,6,54
Linfield,7305,4,14,9,7,60,35,25,51
Dungannon,7305,5,10,8,12,44,39,5,38
Ards,7305,6,11,5,14,38,51,-13,38
Coleraine,7305,7,9,10,11,34,36,-2,37
Glenavon,7305,8,8,13,9,42,45,-3,37
Glentoran,7305,9,8,9,13,36,46,-10,33
Ballinamalla,7305,10,7,5,18,23,47,-24,26
Portadown,7305,11,5,6,19,22,49,-27,21
Crusaders,7306,1,18,9,3,58,29,29,63
Linfield,7306,2,15,8,7,62,37,25,53
Cliftonville,7306,3,16,5,9,55,40,15,53
Ballymena,7306,4,15,3,12,62,59,3,48
Coleraine,7306,5,11,10,9,43,38,5,43
Dungannon,7306,6,9,10,11,53,48,5,37
Ballinamalla,7306,7,10,7,13,33,49,-16,37
Glenavon,7306,8,9,9,12,41,46,-5,36
Ards,7306,9,9,6,15,38,51,-13,33
Portadown,7306,10,7,7,16,26,44,-18,28
Glentoran,7306,11,5,8,17,21,51,-30,23
Crusaders,7307,1,17,6,7,58,30,28,57
Linfield,7307,2,15,11,4,66,33,33,56
Cliftonville,7307,3,16,3,11,56,36,20,51
Coleraine,7307,4,13,9,8,41,43,-2,48
Ballymena,7307,5,13,6,11,54,55,-1,45
Glenavon,7307,6,9,11,10,46,48,-2,38
Dungannon,7307,7,9,8,13,44,45,-1,35
Ards,7307,8,8,9,13,37,45,-8,33
Glentoran,7307,9,8,7,15,24,46,-22,31
Ballinamalla,7307,10,9,4,17,28,53,-25,31
Portadown,7307,11,7,8,15,23,43,-20,29
Crusaders,7308,1,18,7,5,49,24,25,61
Ballymena,7308,2,15,5,10,56,54,2,50
Linfield,7308,3,12,12,6,51,25,26,48
Coleraine,7308,4,12,9,9,43,41,2,45
Cliftonville,7308,5,13,4,13,44,46,-2,43
Ards,7308,6,12,5,13,42,47,-5,41
Glentoran,7308,7,9,10,11,30,38,-8,37
Dungannon,7308,8,9,9,12,47,44,3,36
Ballinamalla,7308,9,10,4,16,32,47,-15,34
Glenavon,7308,10,7,12,11,41,47,-6,33
Portadown,7308,11,8,3,19,23,45,-22,27
Linfield,7309,1,18,6,6,66,32,34,60
Crusaders,7309,2,17,6,7,51,33,18,57
Cliftonville,7309,3,15,5,10,51,36,15,50
Coleraine,7309,4,12,11,7,41,34,7,47
Ballymena,7309,5,13,6,11,54,59,-5,45
Dungannon,7309,6,11,9,10,45,37,8,42
Glenavon,7309,7,11,9,10,43,41,2,42
Glentoran,7309,8,8,9,13,33,50,-17,33
Ards,7309,9,8,5,17,38,51,-13,29
Ballinamalla,7309,10,8,4,18,32,54,-22,28
Portadown,7309,11,6,6,18,22,49,-27,24
Crusaders,7310,1,17,8,5,56,33,23,59
Cliftonville,7310,2,16,5,9,55,39,16,53
Linfield,7310,3,14,10,6,59,33,26,52
Dungannon,7310,4,13,9,8,59,40,19,48
Ballymena,7310,5,15,3,12,58,57,1,48
Coleraine,7310,6,12,9,9,48,42,6,45
Glenavon,7310,7,12,9,9,52,54,-2,45
Ards,7310,8,10,5,15,42,54,-12,35
Glentoran,7310,9,8,5,17,34,55,-21,29
Ballinamalla,7310,10,6,5,19,34,61,-27,23
Portadown,7310,11,6,4,20,27,56,-29,22
Crusaders,7311,1,15,9,6,57,35,22,54
Cliftonville,7311,2,17,3,10,60,41,19,54
Ballymena,7311,3,16,4,10,61,57,4,52
Glenavon,7311,4,14,9,7,46,38,8,51
Linfield,7311,5,12,12,6,61,37,24,48
Dungannon,7311,6,10,10,10,55,45,10,40
Glentoran,7311,7,8,10,12,28,45,-17,34
Coleraine,7311,8,7,12,11,37,43,-6,33
Ards,7311,9,8,9,13,40,47,-7,33
Ballinamalla,7311,10,8,3,19,29,58,-29,27
Portadown,7311,11,7,5,18,20,48,-28,26
Linfield,7312,1,16,9,5,59,28,31,57
Crusaders,7312,2,14,10,6,56,36,20,52
Cliftonville,7312,3,15,6,9,53,40,13,51
Ballymena,7312,4,14,5,11,55,61,-6,47
Coleraine,7312,5,10,10,10,39,41,-2,40
Glenavon,7312,6,9,11,10,43,48,-5,38
Glentoran,7312,7,10,7,13,33,44,-11,37
Dungannon,7312,8,8,11,11,43,39,4,35
Ballinamalla,7312,9,8,8,14,29,45,-16,32
Ards,7312,10,9,4,17,37,50,-13,31
Portadown,7312,11,8,7,15,20,35,-15,31
Linfield,7313,1,16,10,4,58,25,33,58
Cliftonville,7313,2,16,4,10,59,46,13,52
Crusaders,7313,3,12,10,8,48,37,11,46
Glenavon,7313,4,11,11,8,50,45,5,44
Coleraine,7313,5,10,13,7,43,35,8,43
Ballymena,7313,6,10,9,11,53,61,-8,39
Portadown,7313,7,10,6,14,33,46,-13,36
Glentoran,7313,8,10,6,14,33,49,-16,36
Ards,7313,9,8,9,13,37,48,-11,33
Dungannon,7313,10,7,11,12,48,49,-1,32
Ballinamalla,7313,11,9,3,18,31,52,-21,30
Crusaders,7314,1,16,7,7,53,34,19,55
Linfield,7314,2,14,7,9,60,34,26,49
Cliftonville,7314,3,15,4,11,49,38,11,49
Glenavon,7314,4,12,11,7,52,42,10,47
Ballymena,7314,5,12,10,8,49,48,1,46
Coleraine,7314,6,10,10,10,43,46,-3,40
Ards,7314,7,11,5,14,38,42,-4,38
Dungannon,7314,8,9,10,11,43,45,-2,37
Glentoran,7314,9,9,9,12,26,41,-15,36
Ballinamalla,7314,10,8,5,17,31,54,-23,29
Portadown,7314,11,7,6,17,22,42,-20,27
Crusaders,7315,1,21,6,3,62,29,33,69
Cliftonville,7315,2,16,5,9,53,34,19,53
Ballymena,7315,3,14,7,9,61,54,7,49
Linfield,7315,4,12,11,7,60,36,24,47
Coleraine,7315,5,11,11,8,46,38,8,44
Glentoran,7315,6,10,9,11,36,47,-11,39
Glenavon,7315,7,8,13,9,50,55,-5,37
Ballinamalla,7315,8,9,6,15,29,49,-20,33
Dungannon,7315,9,8,8,14,46,52,-6,32
Ards,7315,10,6,6,18,31,54,-23,24
Portadown,7315,11,6,6,18,25,51,-26,24
Coleraine,7316,1,14,11,5,44,26,18,53
Crusaders,7316,2,15,8,7,53,36,17,53
Cliftonville,7316,3,15,7,8,60,40,20,52
Linfield,7316,4,14,9,7,58,36,22,51
Dungannon,7316,5,14,7,9,57,43,14,49
Ballymena,7316,6,12,7,11,54,62,-8,43
Glenavon,7316,7,9,11,10,40,45,-5,38
Glentoran,7316,8,7,10,13,32,48,-16,31
Ards,7316,9,8,5,17,34,51,-17,29
Ballinamalla,7316,10,8,5,17,27,48,-21,29
Portadown,7316,11,6,6,18,19,43,-24,24
Linfield,7317,1,17,8,5,65,27,38,59
Crusaders,7317,2,16,8,6,51,28,23,56
Cliftonville,7317,3,16,6,8,54,37,17,54
Ballymena,7317,4,13,7,10,58,53,5,46
Coleraine,7317,5,11,9,10,43,43,0,42
Glenavon,7317,6,11,8,11,46,46,0,41
Dungannon,7317,7,10,9,11,51,48,3,39
Ards,7317,8,12,3,15,33,46,-13,39
Glentoran,7317,9,7,9,14,27,47,-20,30
Ballinamalla,7317,10,7,6,17,31,51,-20,27
Portadown,7317,11,6,5,19,20,53,-33,23
Linfield,7318,1,16,11,3,59,27,32,59
Crusaders,7318,2,15,8,7,48,37,11,53
Ballymena,7318,3,13,10,7,61,55,6,49
Cliftonville,7318,4,14,6,10,51,40,11,48
Coleraine,7318,5,12,11,7,43,34,9,47
Glenavon,7318,6,9,13,8,46,42,4,40
Dungannon,7318,7,9,10,11,47,45,2,37
Glentoran,7318,8,8,11,11,36,44,-8,35
Ballinamalla,7318,9,6,10,14,27,48,-21,28
Ards,7318,10,7,5,18,33,49,-16,26
Portadown,7318,11,6,5,19,21,51,-30,23
Linfield,7319,1,15,10,5,61,31,30,55
Ballymena,7319,2,16,5,9,67,58,9,53
Coleraine,7319,3,14,10,6,54,38,16,52
Crusaders,7319,4,13,10,7,44,40,4,49
Cliftonville,7319,5,12,6,12,52,41,11,42
Glenavon,7319,6,9,12,9,46,50,-4,39
Dungannon,7319,7,10,8,12,52,43,9,38
Ballinamalla,7319,8,10,5,15,35,46,-11,35
Glentoran,7319,9,10,5,15,35,50,-15,35
Portadown,7319,10,7,7,16,19,47,-28,28
Ards,7319,11,7,6,17,37,58,-21,27
Linfield,7320,1,15,10,5,62,33,29,55
Cliftonville,7320,2,17,3,10,57,42,15,54
Crusaders,7320,3,15,7,8,55,37,18,52
Coleraine,7320,4,14,10,6,48,34,14,52
Glenavon,7320,5,11,9,10,45,48,-3,42
Ballymena,7320,6,12,6,12,53,57,-4,42
Dungannon,7320,7,10,9,11,51,46,5,39
Glentoran,7320,8,10,7,13,32,44,-12,37
Ballinamalla,7320,9,8,5,17,27,52,-25,29
Ards,7320,10,7,7,16,34,50,-16,28
Portadown,7320,11,7,5,18,23,44,-21,26
Crusaders,7321,1,19,5,6,60,36,24,62
Coleraine,7321,2,14,10,6,41,29,12,52
Dungannon,7321,3,14,7,9,54,39,15,49
Linfield,7321,4,13,9,8,63,42,21,48
Ballymena,7321,5,14,3,13,56,63,-7,45
Cliftonville,7321,6,13,3,14,50,47,3,42
Glenavon,7321,7,9,10,11,43,43,0,37
Glentoran,7321,8,10,7,13,37,47,-10,37
Portadown,7321,9,8,6,16,29,50,-21,30
Ards,7321,10,8,5,17,37,51,-14,29
Ballinamalla,7321,11,8,5,17,30,53,-23,29
Cliftonville,7322,1,19,3,8,54,29,25,60
Crusaders,7322,2,17,6,7,61,42,19,57
Ballymena,7322,3,15,5,10,60,59,1,50
Linfield,7322,4,13,9,8,57,32,25,48
Dungannon,7322,5,11,10,9,50,40,10,43
Coleraine,7322,6,10,11,9,44,44,0,41
Ards,7322,7,10,4,16,38,44,-6,34
Glentoran,7322,8,9,7,14,32,49,-17,34
Ballinamalla,7322,9,10,3,17,33,54,-21,33
Glenavon,7322,10,6,12,12,41,56,-15,30
Portadown,7322,11,8,4,18,26,47,-21,28
Crusaders,7323,1,16,7,7,46,31,15,55
Ballymena,7323,2,14,6,10,58,58,0,48
Linfield,7323,3,13,8,9,59,39,20,47
Dungannon,7323,4,13,8,9,56,38,18,47
Cliftonville,7323,5,13,7,10,53,39,14,46
Glenavon,7323,6,12,10,8,55,50,5,46
Coleraine,7323,7,11,9,10,45,41,4,42
Ards,7323,8,10,6,14,35,47,-12,36
Glentoran,7323,9,10,6,14,31,46,-15,36
Portadown,7323,10,8,4,18,28,47,-19,28
Ballinamalla,7323,11,8,3,19,31,61,-30,27
Cliftonville,7324,1,17,5,8,52,39,13,56
Crusaders,7324,2,14,8,8,55,35,20,50
Ballymena,7324,3,14,6,10,55,54,1,48
Glenavon,7324,4,12,9,9,46,45,1,45
Linfield,7324,5,11,11,8,48,32,16,44
Coleraine,7324,6,11,10,9,42,39,3,43
Dungannon,7324,7,11,9,10,49,42,7,42
Glentoran,7324,8,9,9,12,32,40,-8,36
Ards,7324,9,10,5,15,41,48,-7,35
Ballinamalla,7324,10,9,3,18,32,55,-23,30
Portadown,7324,11,7,5,18,21,44,-23,26
Crusaders,7325,1,18,6,6,63,39,24,60
Linfield,7325,2,15,9,6,60,29,31,54
Glenavon,7325,3,14,9,7,52,42,10,51
Cliftonville,7325,4,15,3,12,53,44,9,48
Coleraine,7325,5,11,10,9,44,39,5,43
Dungannon,7325,6,11,9,10,57,45,12,42
Glentoran,7325,7,12,4,14,37,49,-12,40
Ballymena,7325,8,11,6,13,53,64,-11,39
Portadown,7325,9,9,6,15,32,51,-19,33
Ards,7325,10,9,5,16,40,57,-17,32
Ballinamalla,7325,11,4,5,21,21,53,-32,17
Linfield,7326,1,14,10,6,55,26,29,52
Coleraine,7326,2,14,8,8,42,34,8,50
Crusaders,7326,3,13,9,8,51,33,18,48
Cliftonville,7326,4,14,6,10,57,41,16,48
Ballymena,7326,5,13,7,10,56,59,-3,46
Ards,7326,6,12,4,14,38,45,-7,40
Glentoran,7326,7,11,6,13,32,45,-13,39
Dungannon,7326,8,9,11,10,48,42,6,38
Glenavon,7326,9,10,8,12,39,50,-11,38
Ballinamalla,7326,10,9,4,17,30,51,-21,31
Portadown,7326,11,6,7,17,30,52,-22,25
Crusaders,7327,1,17,7,6,55,27,28,58
Cliftonville,7327,2,17,3,10,54,39,15,54
Ballymena,7327,3,16,5,9,65,59,6,53
Linfield,7327,4,14,9,7,58,35,23,51
Dungannon,7327,5,11,9,10,44,42,2,42
Coleraine,7327,6,9,12,9,39,41,-2,39
Glenavon,7327,7,9,11,10,46,49,-3,38
Ards,7327,8,10,5,15,46,51,-5,35
Glentoran,7327,9,7,8,15,31,54,-23,29
Portadown,7327,10,7,7,16,25,42,-17,28
Ballinamalla,7327,11,7,6,17,25,49,-24,27
Cliftonville,7328,1,20,4,6,56,32,24,64
Crusaders,7328,2,15,8,7,52,34,18,53
Linfield,7328,3,14,10,6,59,31,28,52
Glenavon,7328,4,12,11,7,52,45,7,47
Coleraine,7328,5,11,12,7,53,49,4,45
Ballymena,7328,6,10,6,14,47,61,-14,36
Dungannon,7328,7,8,10,12,47,41,6,34
Portadown,7328,8,9,6,15,31,44,-13,33
Glentoran,7328,9,9,5,16,29,53,-24,32
Ballinamalla,7328,10,8,7,15,43,55,-12,31
Ards,7328,11,7,5,18,37,61,-24,26
Cliftonville,7329,1,17,3,10,57,42,15,54
Ballymena,7329,2,16,5,9,65,54,11,53
Crusaders,7329,3,15,7,8,59,41,18,52
Linfield,7329,4,13,10,7,57,36,21,49
Glenavon,7329,5,11,11,8,46,43,3,44
Coleraine,7329,6,11,11,8,41,39,2,44
Ards,7329,7,12,6,12,41,43,-2,42
Glentoran,7329,8,10,4,16,34,45,-11,34
Dungannon,7329,9,8,8,14,43,49,-6,32
Ballinamalla,7329,10,7,6,17,30,55,-25,27
Portadown,7329,11,7,5,18,26,52,-26,26
Linfield,7330,1,16,9,5,64,25,39,57
Crusaders,7330,2,15,10,5,56,33,23,55
Cliftonville,7330,3,16,6,8,48,36,12,54
Ballymena,7330,4,14,6,10,59,60,-1,48
Glenavon,7330,5,10,9,11,42,48,-6,39
Coleraine,7330,6,9,11,10,43,44,-1,38
Dungannon,7330,7,9,9,12,43,41,2,36
Glentoran,7330,8,9,9,12,26,37,-11,36
Ards,7330,9,9,7,14,34,46,-12,34
Ballinamalla,7330,10,8,6,16,28,51,-23,30
Portadown,7330,11,6,6,18,23,45,-22,24
Crusaders,7331,1,16,10,4,55,32,23,58
Cliftonville,7331,2,17,6,7,58,34,24,57
Linfield,7331,3,13,9,8,59,41,18,48
Coleraine,7331,4,13,9,8,49,38,11,48
Glenavon,7331,5,10,11,9,49,50,-1,41
Ballymena,7331,6,11,7,12,62,61,1,40
Dungannon,7331,7,9,10,11,52,48,4,37
Ards,7331,8,10,5,15,41,51,-10,35
Portadown,7331,9,8,8,14,27,49,-22,32
Glentoran,7331,10,8,7,15,29,53,-24,31
Ballinamalla,7331,11,7,4,19,28,52,-24,25
Cliftonville,7332,1,18,5,7,54,34,20,59
Crusaders,7332,2,17,7,6,50,30,20,58
Glenavon,7332,3,13,12,5,53,42,11,51
Linfield,7332,4,12,10,8,54,37,17,46
Ballymena,7332,5,12,9,9,52,53,-1,45
Dungannon,7332,6,11,11,8,47,34,13,44
Coleraine,7332,7,10,8,12,42,42,0,38
Glentoran,7332,8,8,7,15,32,49,-17,31
Ards,7332,9,8,5,17,35,52,-17,29
Portadown,7332,10,5,9,16,23,44,-21,24
Ballinamalla,7332,11,5,9,16,25,50,-25,24
Crusaders,7333,1,21,5,4,64,31,33,68
Coleraine,7333,2,13,11,6,48,36,12,50
Linfield,7333,3,13,10,7,60,33,27,49
Dungannon,7333,4,12,9,9,58,42,16,45
Cliftonville,7333,5,12,6,12,51,51,0,42
Glentoran,7333,6,11,7,12,31,41,-10,40
Glenavon,7333,7,9,11,10,41,43,-2,38
Ballymena,7333,8,10,7,13,49,63,-14,37
Ards,7333,9,9,5,16,38,49,-11,32
Ballinamalla,7333,10,9,3,18,28,50,-22,30
Portadown,7333,11,8,2,20,27,56,-29,26
Crusaders,7334,1,15,9,6,47,28,19,54
Glenavon,7334,2,13,10,7,50,37,13,49
Coleraine,7334,3,13,9,8,41,32,9,48
Ballymena,7334,4,14,6,10,58,58,0,48
Linfield,7334,5,12,9,9,53,37,16,45
Cliftonville,7334,6,14,3,13,47,40,7,45
Glentoran,7334,7,12,6,12,34,41,-7,42
Dungannon,7334,8,10,8,12,51,48,3,38
Ards,7334,9,11,5,14,39,47,-8,38
Ballinamalla,7334,10,7,6,17,23,45,-22,27
Portadown,7334,11,6,5,19,23,53,-30,23
Crusaders,7335,1,18,4,8,57,31,26,58
Coleraine,7335,2,12,13,5,49,38,11,49
Linfield,7335,3,12,11,7,54,32,22,47
Ballymena,7335,4,13,8,9,55,54,1,47
Cliftonville,7335,5,13,5,12,45,41,4,44
Glenavon,7335,6,9,12,9,48,47,1,39
Glentoran,7335,7,10,8,12,30,42,-12,38
Dungannon,7335,8,9,9,12,49,47,2,36
Ards,7335,9,9,5,16,43,55,-12,32
Ballinamalla,7335,10,9,5,16,33,56,-23,32
Portadown,7335,11,8,6,16,27,47,-20,30
Crusaders,7336,1,15,10,5,57,31,26,55
Cliftonville,7336,2,16,5,9,54,44,10,53
Linfield,7336,3,14,10,6,55,30,25,52
Ballymena,7336,4,15,7,8,71,58,13,52
Coleraine,7336,5,12,12,6,45,36,9,48
Glenavon,7336,6,11,11,8,49,46,3,44
Dungannon,7336,7,9,11,10,44,39,5,38
Glentoran,7336,8,9,7,14,33,48,-15,34
Ballinamalla,7336,9,7,5,18,26,55,-29,26
Ards,7336,10,6,7,17,36,53,-17,25
Portadown,7336,11,5,7,18,21,51,-30,22
Cliftonville,7337,1,17,6,7,58,35,23,57
Ballymena,7337,2,16,6,8,56,55,1,54
Linfield,7337,3,14,8,8,62,32,30,50
Crusaders,7337,4,14,8,8,50,36,14,50
Glenavon,7337,5,12,10,8,47,44,3,46
Coleraine,7337,6,12,8,10,40,35,5,44
Dungannon,7337,7,11,8,11,54,45,9,41
Glentoran,7337,8,8,10,12,31,44,-13,34
Ards,7337,9,8,7,15,42,56,-14,31
Portadown,7337,10,7,4,19,19,47,-28,25
Ballinamalla,7337,11,7,3,20,34,64,-30,24
Crusaders,7338,1,18,9,3,57,28,29,63
Linfield,7338,2,18,7,5,61,32,29,61
Ballymena,7338,3,16,5,9,57,55,2,53
Cliftonville,7338,4,14,5,11,52,45,7,47
Coleraine,7338,5,11,11,8,47,37,10,44
Glenavon,7338,6,10,11,9,46,46,0,41
Ards,7338,7,10,5,15,39,47,-8,35
Dungannon,7338,8,8,9,13,51,48,3,33
Glentoran,7338,9,8,8,14,30,47,-17,32
Ballinamalla,7338,10,7,6,17,27,48,-21,27
Portadown,7338,11,5,4,21,22,56,-34,19
Linfield,7339,1,16,8,6,65,33,32,56
Cliftonville,7339,2,16,4,10,57,42,15,52
Crusaders,7339,3,15,7,8,54,40,14,52
Glenavon,7339,4,11,11,8,54,51,3,44
Ballymena,7339,5,12,5,13,51,58,-7,41
Dungannon,7339,6,10,10,10,54,49,5,40
Coleraine,7339,7,9,12,9,44,46,-2,39
Glentoran,7339,8,10,9,11,34,42,-8,39
Portadown,7339,9,10,4,16,35,51,-16,34
Ards,7339,10,8,5,17,38,53,-15,29
Ballinamalla,7339,11,8,5,17,33,54,-21,29
Crusaders,7340,1,16,9,5,61,38,23,57
Ballymena,7340,2,14,6,10,64,63,1,48
Linfield,7340,3,12,9,9,52,36,16,45
Dungannon,7340,4,11,10,9,54,44,10,43
Cliftonville,7340,5,13,4,13,52,48,4,43
Glenavon,7340,6,10,12,8,52,45,7,42
Coleraine,7340,7,10,11,9,45,42,3,41
Portadown,7340,8,11,4,15,27,40,-13,37
Ards,7340,9,11,3,16,40,52,-12,36
Glentoran,7340,10,9,8,13,27,41,-14,35
Ballinamalla,7340,11,7,6,17,28,53,-25,27
Crusaders,7341,1,19,8,3,62,32,30,65
Cliftonville,7341,2,18,2,10,56,37,19,56
Ballymena,7341,3,17,5,8,58,55,3,56
Coleraine,7341,4,11,9,10,36,34,2,42
Ballinamalla,7341,5,13,3,14,31,43,-12,42
Linfield,7341,6,9,11,10,52,39,13,38
Glenavon,7341,7,8,13,9,40,41,-1,37
Glentoran,7341,8,9,8,13,31,44,-13,35
Dungannon,7341,9,6,13,11,39,41,-2,31
Portadown,7341,10,7,5,18,26,47,-21,26
Ards,7341,11,6,7,17,33,51,-18,25
Linfield,7342,1,15,9,6,64,37,27,54
Cliftonville,7342,2,17,3,10,51,38,13,54
Ballymena,7342,3,15,5,10,56,54,2,50
Coleraine,7342,4,12,12,6,43,33,10,48
Dungannon,7342,5,12,8,10,49,44,5,44
Crusaders,7342,6,12,7,11,47,41,6,43
Glenavon,7342,7,11,9,10,48,47,1,42
Ards,7342,8,11,3,16,41,50,-9,36
Glentoran,7342,9,9,8,13,32,47,-15,35
Portadown,7342,10,7,6,17,30,47,-17,27
Ballinamalla,7342,11,7,4,19,22,45,-23,25
Crusaders,7343,1,16,7,7,57,38,19,55
Ballymena,7343,2,16,7,7,67,52,15,55
Linfield,7343,3,13,11,6,51,30,21,50
Cliftonville,7343,4,15,5,10,54,40,14,50
Glenavon,7343,5,11,11,8,51,38,13,44
Dungannon,7343,6,11,8,11,51,49,2,41
Glentoran,7343,7,9,8,13,35,49,-14,35
Ballinamalla,7343,8,10,4,16,35,52,-17,34
Coleraine,7343,9,8,9,13,34,45,-11,33
Ards,7343,10,8,6,16,40,57,-17,30
Portadown,7343,11,7,6,17,24,49,-25,27
Crusaders,7344,1,19,4,7,54,32,22,61
Glenavon,7344,2,14,10,6,50,43,7,52
Ballymena,7344,3,16,3,11,61,52,9,51
Linfield,7344,4,14,7,9,54,30,24,49
Cliftonville,7344,5,13,6,11,49,42,7,45
Coleraine,7344,6,11,11,8,38,39,-1,44
Ballinamalla,7344,7,12,2,16,35,45,-10,38
Dungannon,7344,8,9,9,12,50,43,7,36
Ards,7344,9,8,7,15,39,48,-9,31
Glentoran,7344,10,7,7,16,27,51,-24,28
Portadown,7344,11,7,4,19,22,54,-32,25
Crusaders,7345,1,16,9,5,52,29,23,57
Linfield,7345,2,15,9,6,50,26,24,54
Ballymena,7345,3,15,8,7,65,53,12,53
Cliftonville,7345,4,13,7,10,49,41,8,46
Glenavon,7345,5,12,9,9,46,44,2,45
Coleraine,7345,6,10,12,8,41,37,4,42
Portadown,7345,7,9,6,15,28,42,-14,33
Ards,7345,8,9,5,16,39,54,-15,32
Ballinamalla,7345,9,9,5,16,33,53,-20,32
Dungannon,7345,10,8,6,16,49,53,-4,30
Glentoran,7345,11,7,8,15,26,46,-20,29
Crusaders,7346,1,19,6,5,65,32,33,63
Cliftonville,7346,2,16,7,7,54,36,18,55
Linfield,7346,3,13,10,7,57,36,21,49
Ballymena,7346,4,14,7,9,57,52,5,49
Glenavon,7346,5,12,9,9,48,48,0,45
Dungannon,7346,6,11,7,12,50,39,11,40
Coleraine,7346,7,10,10,10,36,49,-13,40
Ballinamalla,7346,8,9,4,17,30,48,-18,31
Glentoran,7346,9,8,6,16,26,47,-21,30
Portadown,7346,10,8,5,17,31,51,-20,29
Ards,7346,11,7,5,18,37,53,-16,26
Crusaders,7347,1,18,6,6,61,36,25,60
Cliftonville,7347,2,16,4,10,56,39,17,52
Linfield,7347,3,14,8,8,51,35,16,50
Ballymena,7347,4,14,8,8,67,64,3,50
Glentoran,7347,5,12,6,12,39,45,-6,42
Coleraine,7347,6,9,12,9,44,42,2,39
Dungannon,7347,7,10,6,14,51,53,-2,36
Glenavon,7347,8,8,10,12,49,56,-7,34
Ballinamalla,7347,9,10,3,17,35,53,-18,33
Portadown,7347,10,8,7,15,35,49,-14,31
Ards,7347,11,9,4,17,38,54,-16,31
Crusaders,7348,1,18,9,3,59,32,27,63
Linfield,7348,2,17,10,3,59,27,32,61
Ballymena,7348,3,15,5,10,59,55,4,50
Cliftonville,7348,4,13,6,11,46,36,10,45
Glenavon,7348,5,12,9,9,53,50,3,45
Coleraine,7348,6,11,11,8,40,36,4,44
Dungannon,7348,7,9,11,10,54,49,5,38
Glentoran,7348,8,8,8,14,29,44,-15,32
Portadown,7348,9,8,6,16,32,49,-17,30
Ards,7348,10,6,5,19,26,49,-23,23
Ballinamalla,7348,11,6,4,20,26,56,-30,22
Linfield,7349,1,14,11,5,60,31,29,53
Crusaders,7349,2,15,6,9,59,43,16,51
Cliftonville,7349,3,14,6,10,57,43,14,48
Ballymena,7349,4,14,6,10,60,54,6,48
Glenavon,7349,5,12,9,9,48,50,-2,45
Coleraine,7349,6,11,9,10,37,38,-1,42
Dungannon,7349,7,10,11,9,56,47,9,41
Glentoran,7349,8,9,8,13,35,47,-12,35
Ballinamalla,7349,9,10,5,15,30,45,-15,35
Ards,7349,10,8,5,17,34,48,-14,29
Portadown,7349,11,7,6,17,22,52,-30,27
Crusaders,7350,1,18,10,2,64,32,32,64
Linfield,7350,2,16,8,6,59,32,27,56
Cliftonville,7350,3,15,6,9,50,38,12,51
Coleraine,7350,4,11,11,8,42,40,2,44
Ballymena,7350,5,12,5,13,54,58,-4,41
Ards,7350,6,11,4,15,45,53,-8,37
Glenavon,7350,7,9,9,12,49,53,-4,36
Dungannon,7350,8,9,8,13,51,48,3,35
Ballinamalla,7350,9,10,4,16,34,49,-15,34
Glentoran,7350,10,8,8,14,28,45,-17,32
Portadown,7350,11,7,5,18,28,56,-28,26
Crusaders,7351,1,18,9,3,61,30,31,63
Linfield,7351,2,14,8,8,63,40,23,50
Coleraine,7351,3,12,9,9,51,47,4,45
Ballymena,7351,4,12,8,10,67,68,-1,44
Cliftonville,7351,5,13,4,13,44,40,4,43
Glenavon,7351,6,9,15,6,45,46,-1,42
Dungannon,7351,7,11,8,11,51,45,6,41
Ballinamalla,7351,8,11,4,15,35,54,-19,37
Ards,7351,9,9,6,15,40,49,-9,33
Portadown,7351,10,8,6,16,28,46,-18,30
Glentoran,7351,11,6,7,17,35,55,-20,25
Crusaders,7352,1,16,8,6,57,37,20,56
Cliftonville,7352,2,17,4,9,52,40,12,55
Linfield,7352,3,14,11,5,65,33,32,53
Ballymena,7352,4,14,7,9,64,59,5,49
Coleraine,7352,5,10,12,8,43,35,8,42
Glenavon,7352,6,10,11,9,43,40,3,41
Ards,7352,7,10,5,15,35,55,-20,35
Ballinamalla,7352,8,10,3,17,35,53,-18,33
Glentoran,7352,9,8,8,14,31,47,-16,32
Dungannon,7352,10,7,9,14,46,48,-2,30
Portadown,7352,11,7,6,17,27,51,-24,27
Cliftonville,7353,1,18,5,7,61,33,28,59
Linfield,7353,2,16,10,4,63,27,36,58
Crusaders,7353,3,17,6,7,50,35,15,57
Coleraine,7353,4,13,7,10,43,40,3,46
Dungannon,7353,5,11,8,11,44,38,6,41
Ballymena,7353,6,11,6,13,45,59,-14,39
Glenavon,7353,7,9,10,11,37,38,-1,37
Ballinamalla,7353,8,11,4,15,33,48,-15,37
Ards,7353,9,9,5,16,36,52,-16,32
Glentoran,7353,10,7,7,16,28,46,-18,28
Portadown,7353,11,6,6,18,23,47,-24,24
Cliftonville,7354,1,16,6,8,50,34,16,54
Crusaders,7354,2,16,6,8,51,37,14,54
Linfield,7354,3,14,11,5,62,33,29,53
Ballymena,7354,4,14,7,9,62,53,9,49
Glenavon,7354,5,12,9,9,49,48,1,45
Coleraine,7354,6,8,14,8,46,46,0,38
Dungannon,7354,7,7,12,11,46,41,5,33
Ards,7354,8,9,5,16,38,52,-14,32
Ballinamalla,7354,9,8,7,15,24,45,-21,31
Portadown,7354,10,7,9,14,29,44,-15,30
Glentoran,7354,11,7,8,15,28,52,-24,29
Ballymena,7355,1,16,5,9,69,59,10,53
Cliftonville,7355,2,16,4,10,54,40,14,52
Linfield,7355,3,14,8,8,61,41,20,50
Crusaders,7355,4,14,8,8,52,42,10,50
Dungannon,7355,5,14,7,9,59,45,14,49
Coleraine,7355,6,13,7,10,45,37,8,46
Glenavon,7355,7,13,7,10,50,51,-1,46
Glentoran,7355,8,9,8,13,39,48,-9,35
Ballinamalla,7355,9,8,5,17,30,45,-15,29
Portadown,7355,10,8,4,18,31,52,-21,28
Ards,7355,11,5,7,18,38,68,-30,22
Crusaders,7356,1,16,9,5,54,29,25,57
Ballymena,7356,2,14,7,9,53,51,2,49
Cliftonville,7356,3,13,9,8,50,41,9,48
Coleraine,7356,4,13,9,8,47,38,9,48
Linfield,7356,5,12,11,7,50,32,18,47
Dungannon,7356,6,12,9,9,53,36,17,45
Glenavon,7356,7,9,13,8,45,44,1,40
Ballinamalla,7356,8,9,6,15,27,44,-17,33
Ards,7356,9,9,5,16,41,52,-11,32
Glentoran,7356,10,7,8,15,26,48,-22,29
Portadown,7356,11,6,4,20,21,52,-31,22
Linfield,7357,1,15,9,6,63,35,28,54
Cliftonville,7357,2,15,7,8,46,33,13,52
Crusaders,7357,3,14,9,7,48,33,15,51
Glenavon,7357,4,13,10,7,51,42,9,49
Ballymena,7357,5,13,9,8,61,53,8,48
Glentoran,7357,6,13,6,11,40,42,-2,45
Dungannon,7357,7,11,10,9,57,49,8,43
Coleraine,7357,8,9,10,11,36,43,-7,37
Ballinamalla,7357,9,8,4,18,30,55,-25,28
Ards,7357,10,6,6,18,31,51,-20,24
Portadown,7357,11,5,6,19,18,45,-27,21
Linfield,7358,1,15,9,6,56,28,28,54
Crusaders,7358,2,15,9,6,54,36,18,54
Cliftonville,7358,3,16,3,11,59,47,12,51
Glenavon,7358,4,14,8,8,49,42,7,50
Coleraine,7358,5,13,9,8,47,39,8,48
Dungannon,7358,6,10,14,6,51,38,13,44
Ballymena,7358,7,11,9,10,47,51,-4,42
Glentoran,7358,8,10,7,13,34,44,-10,37
Ards,7358,9,9,5,16,38,51,-13,32
Portadown,7358,10,5,7,18,25,51,-26,22
Ballinamalla,7358,11,5,4,21,28,61,-33,19
Linfield,7359,1,15,11,4,60,26,34,56
Crusaders,7359,2,14,8,8,51,38,13,50
Cliftonville,7359,3,15,4,11,50,41,9,49
Ballymena,7359,4,13,8,9,59,58,1,47
Glenavon,7359,5,11,11,8,41,44,-3,44
Coleraine,7359,6,11,8,11,38,36,2,41
Dungannon,7359,7,11,7,12,48,41,7,40
Ballinamalla,7359,8,10,5,15,37,49,-12,35
Ards,7359,9,10,3,17,35,49,-14,33
Glentoran,7359,10,8,7,15,32,51,-19,31
Portadown,7359,11,8,6,16,23,41,-18,30
Cliftonville,7360,1,16,5,9,52,30,22,53
Linfield,7360,2,14,9,7,64,36,28,51
Coleraine,7360,3,13,12,5,48,35,13,51
Crusaders,7360,4,15,6,9,50,43,7,51
Dungannon,7360,5,13,9,8,58,42,16,48
Glenavon,7360,6,12,9,9,45,46,-1,45
Ballymena,7360,7,12,6,12,52,61,-9,42
Ards,7360,8,9,5,16,42,49,-7,32
Ballinamalla,7360,9,8,7,15,31,49,-18,31
Portadown,7360,10,8,4,18,23,49,-26,28
Glentoran,7360,11,6,6,18,29,54,-25,24
Glenavon,7361,1,13,13,4,54,40,14,52
Crusaders,7361,2,13,11,6,57,41,16,50
Ballymena,7361,3,15,5,10,59,53,6,50
Linfield,7361,4,12,10,8,57,39,18,46
Dungannon,7361,5,12,9,9,55,40,15,45
Cliftonville,7361,6,12,7,11,45,46,-1,43
Coleraine,7361,7,10,12,8,36,36,0,42
Ballinamalla,7361,8,9,6,15,34,42,-8,33
Ards,7361,9,8,7,15,35,50,-15,31
Portadown,7361,10,7,8,15,36,55,-19,29
Glentoran,7361,11,7,6,17,31,57,-26,27
Crusaders,7362,1,14,10,6,54,39,15,52
Cliftonville,7362,2,16,3,11,51,45,6,51
Linfield,7362,3,13,10,7,55,36,19,49
Coleraine,7362,4,12,13,5,44,31,13,49
Ballymena,7362,5,14,5,11,60,58,2,47
Glenavon,7362,6,11,11,8,47,42,5,44
Glentoran,7362,7,9,7,14,33,44,-11,34
Ards,7362,8,9,6,15,42,51,-9,33
Portadown,7362,9,9,6,15,26,41,-15,33
Dungannon,7362,10,7,11,12,41,40,1,32
Ballinamalla,7362,11,8,4,18,28,54,-26,28
Crusaders,7363,1,19,4,7,63,35,28,61
Coleraine,7363,2,14,11,5,49,32,17,53
Linfield,7363,3,13,10,7,54,32,22,49
Cliftonville,7363,4,13,7,10,46,41,5,46
Ballymena,7363,5,12,8,10,47,54,-7,44
Dungannon,7363,6,11,9,10,54,45,9,42
Glenavon,7363,7,10,10,10,44,45,-1,40
Glentoran,7363,8,9,7,14,29,43,-14,34
Ards,7363,9,8,7,15,38,50,-12,31
Ballinamalla,7363,10,8,5,17,26,51,-25,29
Portadown,7363,11,6,6,18,25,47,-22,24
Linfield,7364,1,15,10,5,64,35,29,55
Cliftonville,7364,2,15,6,9,53,39,14,51
Glenavon,7364,3,13,10,7,52,39,13,49
Ballymena,7364,4,14,7,9,59,56,3,49
Crusaders,7364,5,13,7,10,50,45,5,46
Coleraine,7364,6,12,8,10,42,34,8,44
Glentoran,7364,7,11,8,11,33,38,-5,41
Dungannon,7364,8,10,8,12,54,54,0,38
Portadown,7364,9,9,6,15,26,42,-16,33
Ards,7364,10,8,7,15,37,49,-12,31
Ballinamalla,7364,11,5,3,22,27,66,-39,18
Crusaders,7365,1,19,4,7,62,34,28,61
Ballymena,7365,2,15,7,8,54,47,7,52
Linfield,7365,3,14,9,7,56,29,27,51
Coleraine,7365,4,14,8,8,46,35,11,50
Cliftonville,7365,5,13,6,11,51,44,7,45
Glenavon,7365,6,11,11,8,50,46,4,44
Dungannon,7365,7,10,9,11,46,45,1,39
Ards,7365,8,9,7,14,37,47,-10,34
Glentoran,7365,9,7,8,15,25,45,-20,29
Portadown,7365,10,7,5,18,18,43,-25,26
Ballinamalla,7365,11,8,2,20,30,60,-30,26
Ballymena,7366,1,17,6,7,59,54,5,57
Cliftonville,7366,2,16,5,9,52,38,14,53
Crusaders,7366,3,14,7,9,49,35,14,49
Glenavon,7366,4,13,9,8,54,49,5,48
Glentoran,7366,5,14,5,11,39,41,-2,47
Linfield,7366,6,13,7,10,56,34,22,46
Coleraine,7366,7,11,9,10,38,36,2,42
Ballinamalla,7366,8,12,2,16,39,54,-15,38
Dungannon,7366,9,7,12,11,44,42,2,33
Portadown,7366,10,6,6,18,30,56,-26,24
Ards,7366,11,6,4,20,31,52,-21,22
Cliftonville,7367,1,17,6,7,59,36,23,57
Crusaders,7367,2,16,9,5,50,27,23,57
Linfield,7367,3,15,10,5,59,28,31,55
Glenavon,7367,4,15,9,6,55,38,17,54
Coleraine,7367,5,13,9,8,41,39,2,48
Dungannon,7367,6,11,10,9,51,40,11,43
Ballymena,7367,7,11,6,13,51,56,-5,39
Ballinamalla,7367,8,10,4,16,30,50,-20,34
Glentoran,7367,9,7,5,18,27,59,-32,26
Portadown,7367,10,7,3,20,23,51,-28,24
Ards,7367,11,6,3,21,31,53,-22,21
Cliftonville,7368,1,18,3,9,55,38,17,57
Crusaders,7368,2,17,5,8,53,36,17,56
Linfield,7368,3,15,8,7,59,34,25,53
Glenavon,7368,4,14,10,6,57,48,9,52
Coleraine,7368,5,10,10,10,37,40,-3,40
Ballymena,7368,6,11,7,12,53,63,-10,40
Dungannon,7368,7,8,10,12,52,47,5,34
Glentoran,7368,8,8,9,13,32,41,-9,33
Ballinamalla,7368,9,9,6,15,32,49,-17,33
Ards,7368,10,8,6,16,37,50,-13,30
Portadown,7368,11,7,6,17,23,44,-21,27
Linfield,7369,1,16,8,6,60,31,29,56
Crusaders,7369,2,16,8,6,54,32,22,56
Glenavon,7369,3,15,10,5,61,49,12,55
Cliftonville,7369,4,14,8,8,51,37,14,50
Ballymena,7369,5,14,5,11,55,56,-1,47
Coleraine,7369,6,11,13,6,46,37,9,46
Ards,7369,7,9,4,17,30,48,-18,31
Dungannon,7369,8,8,6,16,48,53,-5,30
Glentoran,7369,9,7,8,15,29,44,-15,29
Portadown,7369,10,8,4,18,21,46,-25,28
Ballinamalla,7369,11,7,6,17,37,59,-22,27
Crusaders,7370,1,18,6,6,57,29,28,60
Linfield,7370,2,14,11,5,59,32,27,53
Cliftonville,7370,3,15,5,10,53,42,11,50
Dungannon,7370,4,12,9,9,57,37,20,45
Coleraine,7370,5,11,10,9,41,39,2,43
Ballymena,7370,6,13,4,13,58,67,-9,43
Glenavon,7370,7,11,9,10,53,49,4,42
Glentoran,7370,8,9,8,13,27,43,-16,35
Ards,7370,9,9,5,16,47,63,-16,32
Ballinamalla,7370,10,9,3,18,24,48,-24,30
Portadown,7370,11,7,4,19,24,51,-27,25
Cliftonville,7371,1,19,4,7,57,32,25,61
Crusaders,7371,2,17,6,7,50,33,17,57
Linfield,7371,3,12,8,10,57,39,18,44
Dungannon,7371,4,12,8,10,52,44,8,44
Glentoran,7371,5,12,8,10,39,39,0,44
Ballymena,7371,6,11,6,13,53,55,-2,39
Coleraine,7371,7,10,8,12,37,50,-13,38
Glenavon,7371,8,9,9,12,43,51,-8,36
Portadown,7371,9,10,4,16,25,40,-15,34
Ards,7371,10,9,5,16,39,52,-13,32
Ballinamalla,7371,11,7,8,15,29,46,-17,29
Crusaders,7372,1,18,8,4,61,36,25,62
Linfield,7372,2,15,8,7,61,37,24,53
Ballymena,7372,3,15,4,11,51,52,-1,49
Glenavon,7372,4,12,11,7,55,44,11,47
Coleraine,7372,5,11,11,8,48,38,10,44
Cliftonville,7372,6,13,5,12,47,41,6,44
Dungannon,7372,7,8,11,11,43,48,-5,35
Ballinamalla,7372,8,10,4,16,31,46,-15,34
Glentoran,7372,9,7,10,13,25,41,-16,31
Ards,7372,10,7,6,17,32,49,-17,27
Portadown,7372,11,7,6,17,31,53,-22,27
Cliftonville,7373,1,19,5,6,66,43,23,62
Crusaders,7373,2,16,8,6,58,34,24,56
Linfield,7373,3,15,7,8,62,37,25,52
Ballymena,7373,4,13,6,11,58,60,-2,45
Glenavon,7373,5,11,11,8,51,49,2,44
Coleraine,7373,6,10,9,11,44,43,1,39
Dungannon,7373,7,9,10,11,48,48,0,37
Ards,7373,8,9,8,13,39,46,-7,35
Glentoran,7373,9,9,8,13,35,50,-15,35
Ballinamalla,7373,10,8,4,18,31,53,-22,28
Portadown,7373,11,6,4,20,23,52,-29,22
Crusaders,7374,1,16,10,4,60,30,30,58
Cliftonville,7374,2,16,5,9,52,33,19,53
Linfield,7374,3,14,8,8,54,35,19,50
Ballymena,7374,4,12,8,10,63,59,4,44
Coleraine,7374,5,11,10,9,41,42,-1,43
Glenavon,7374,6,10,12,8,48,48,0,42
Ards,7374,7,11,8,11,36,41,-5,41
Dungannon,7374,8,7,12,11,48,47,1,33
Portadown,7374,9,9,5,16,31,48,-17,32
Glentoran,7374,10,5,15,10,26,45,-19,30
Ballinamalla,7374,11,5,5,20,22,53,-31,20
Crusaders,7375,1,18,8,4,56,34,22,62
Ballymena,7375,2,15,6,9,61,58,3,51
Cliftonville,7375,3,15,5,10,50,38,12,50
Glenavon,7375,4,11,11,8,45,45,0,44
Linfield,7375,5,11,10,9,48,31,17,43
Coleraine,7375,6,11,10,9,43,38,5,43
Glentoran,7375,7,10,7,13,35,46,-11,37
Dungannon,7375,8,7,11,12,46,47,-1,32
Ards,7375,9,8,7,15,36,50,-14,31
Portadown,7375,10,8,6,16,32,42,-10,30
Ballinamalla,7375,11,8,5,17,25,48,-23,29
Linfield,7376,1,15,10,5,59,31,28,55
Cliftonville,7376,2,16,6,8,55,43,12,54
Ballymena,7376,3,14,6,10,61,56,5,48
Crusaders,7376,4,13,8,9,56,46,10,47
Glentoran,7376,5,12,7,11,42,44,-2,43
Glenavon,7376,6,9,15,6,49,49,0,42
Coleraine,7376,7,10,11,9,42,42,0,41
Dungannon,7376,8,8,12,10,50,44,6,36
Ballinamalla,7376,9,7,9,14,29,49,-20,30
Ards,7376,10,7,5,18,28,47,-19,26
Portadown,7376,11,6,7,17,21,41,-20,25
Crusaders,7377,1,17,8,5,56,36,20,59
Linfield,7377,2,14,9,7,59,34,25,51
Coleraine,7377,3,13,12,5,46,35,11,51
Cliftonville,7377,4,13,6,11,51,45,6,45
Glenavon,7377,5,12,8,10,47,42,5,44
Ballymena,7377,6,12,6,12,57,66,-9,42
Glentoran,7377,7,11,6,13,38,44,-6,39
Dungannon,7377,8,9,10,11,55,52,3,37
Portadown,7377,9,10,4,16,31,48,-17,34
Ballinamalla,7377,10,7,6,17,25,46,-21,27
Ards,7377,11,7,5,18,39,56,-17,26
Ballymena,7378,1,15,6,9,56,58,-2,51
Crusaders,7378,2,14,8,8,50,36,14,50
Glenavon,7378,3,13,11,6,49,43,6,50
Linfield,7378,4,11,11,8,54,39,15,44
Cliftonville,7378,5,13,5,12,48,40,8,44
Coleraine,7378,6,10,12,8,44,38,6,42
Ballinamalla,7378,7,12,5,13,35,43,-8,41
Dungannon,7378,8,10,8,12,52,44,8,38
Glentoran,7378,9,9,10,11,28,38,-10,37
Ards,7378,10,8,5,17,36,51,-15,29
Portadown,7378,11,7,5,18,31,53,-22,26
Cliftonville,7379,1,16,6,8,54,35,19,54
Crusaders,7379,2,16,5,9,54,37,17,53
Ballymena,7379,3,16,5,9,58,51,7,53
Linfield,7379,4,15,7,8,58,30,28,52
Coleraine,7379,5,12,10,8,41,35,6,46
Glenavon,7379,6,11,10,9,41,44,-3,43
Dungannon,7379,7,10,8,12,46,42,4,38
Glentoran,7379,8,10,5,15,30,46,-16,35
Ballinamalla,7379,9,10,5,15,29,47,-18,35
Portadown,7379,10,8,6,16,26,45,-19,30
Ards,7379,11,6,3,21,30,55,-25,21
Linfield,7380,1,15,9,6,57,26,31,54
Crusaders,7380,2,14,9,7,50,34,16,51
Cliftonville,7380,3,14,7,9,51,38,13,49
Ballymena,7380,4,14,6,10,57,57,0,48
Coleraine,7380,5,12,7,11,44,40,4,43
Dungannon,7380,6,11,9,10,48,42,6,42
Glentoran,7380,7,10,7,13,28,39,-11,37
Glenavon,7380,8,9,9,12,45,53,-8,36
Ards,7380,9,10,5,15,37,50,-13,35
Ballinamalla,7380,10,11,2,17,33,49,-16,35
Portadown,7380,11,7,6,17,23,45,-22,27
Linfield,7381,1,17,8,5,70,33,37,59
Cliftonville,7381,2,15,6,9,50,41,9,51
Ballymena,7381,3,14,8,8,60,58,2,50
Crusaders,7381,4,13,9,8,51,39,12,48
Coleraine,7381,5,11,12,7,44,36,8,45
Dungannon,7381,6,11,9,10,48,44,4,42
Glenavon,7381,7,10,12,8,40,38,2,42
Ards,7381,8,12,2,16,44,47,-3,38
Ballinamalla,7381,9,8,4,18,31,54,-23,28
Glentoran,7381,10,7,6,17,28,55,-27,27
Portadown,7381,11,6,6,18,25,46,-21,24
Linfield,7382,1,14,11,5,57,32,25,53
Cliftonville,7382,2,16,5,9,54,33,21,53
Coleraine,7382,3,13,9,8,42,32,10,48
Crusaders,7382,4,14,6,10,48,42,6,48
Glenavon,7382,5,13,8,9,46,42,4,47
Dungannon,7382,6,11,10,9,55,40,15,43
Ballymena,7382,7,12,7,11,51,56,-5,43
Ballinamalla,7382,8,10,6,14,30,48,-18,36
Ards,7382,9,8,8,14,40,52,-12,32
Glentoran,7382,10,5,11,14,30,53,-23,26
Portadown,7382,11,7,3,20,29,52,-23,24
Cliftonville,7383,1,17,5,8,55,38,17,56
Linfield,7383,2,14,11,5,64,33,31,53
Crusaders,7383,3,15,7,8,52,37,15,52
Coleraine,7383,4,12,12,6,40,28,12,48
Ballymena,7383,5,13,5,12,55,63,-8,44
Dungannon,7383,6,10,10,10,52,45,7,40
Ards,7383,7,11,4,15,40,47,-7,37
Portadown,7383,8,10,4,16,26,39,-13,34
Glenavon,7383,9,8,8,14,40,51,-11,32
Glentoran,7383,10,8,7,15,27,46,-19,31
Ballinamalla,7383,11,8,5,17,27,51,-24,29
Linfield,7384,1,18,8,4,68,27,41,62
Crusaders,7384,2,18,6,6,60,38,22,60
Ballymena,7384,3,13,8,9,58,55,3,47
Cliftonville,7384,4,14,4,12,48,42,6,46
Glenavon,7384,5,11,11,8,50,42,8,44
Coleraine,7384,6,12,8,10,41,38,3,44
Ards,7384,7,9,7,14,39,45,-6,34
Ballinamalla,7384,8,10,4,16,31,49,-18,34
Dungannon,7384,9,7,9,14,44,50,-6,30
Glentoran,7384,10,7,8,15,29,53,-24,29
Portadown,7384,11,6,7,17,22,51,-29,25
Ballymena,7385,1,18,3,9,57,58,-1,57
Crusaders,7385,2,17,5,8,65,32,33,56
Linfield,7385,3,16,7,7,59,33,26,55
Cliftonville,7385,4,15,5,10,55,44,11,50
Dungannon,7385,5,12,10,8,56,42,14,46
Coleraine,7385,6,11,11,8,50,45,5,44
Glenavon,7385,7,10,10,10,50,49,1,40
Ards,7385,8,10,4,16,39,50,-11,34
Ballinamalla,7385,9,8,6,16,36,60,-24,30
Portadown,7385,10,7,6,17,29,52,-23,27
Glentoran,7385,11,4,7,19,25,56,-31,19
Crusaders,7386,1,17,8,5,57,37,20,59
Coleraine,7386,2,13,11,6,49,36,13,50
Cliftonville,7386,3,14,5,11,50,39,11,47
Glenavon,7386,4,12,10,8,47,42,5,46
Linfield,7386,5,12,8,10,55,40,15,44
Ballymena,7386,6,12,7,11,54,59,-5,43
Ballinamalla,7386,7,11,5,14,39,49,-10,38
Dungannon,7386,8,10,7,13,50,45,5,37
Glentoran,7386,9,10,7,13,32,44,-12,37
Portadown,7386,10,8,4,18,20,49,-29,28
Ards,7386,11,6,8,16,33,46,-13,26
Crusaders,7387,1,14,10,6,53,35,18,52
Glenavon,7387,2,14,9,7,48,35,13,51
Linfield,7387,3,14,7,9,63,42,21,49
Coleraine,7387,4,13,9,8,39,35,4,48
Ballymena,7387,5,13,8,9,54,56,-2,47
Cliftonville,7387,6,14,4,12,48,39,9,46
Glentoran,7387,7,11,9,10,33,38,-5,42
Dungannon,7387,8,9,10,11,48,46,2,37
Ballinamalla,7387,9,9,5,16,30,47,-17,32
Ards,7387,10,8,5,17,39,54,-15,29
Portadown,7387,11,4,8,18,20,48,-28,20
Crusaders,7388,1,18,7,5,61,37,24,61
Cliftonville,7388,2,18,5,7,54,34,20,59
Linfield,7388,3,16,9,5,57,31,26,57
Ballymena,7388,4,15,5,10,55,55,0,50
Glenavon,7388,5,11,11,8,46,41,5,44
Coleraine,7388,6,9,9,12,40,42,-2,36
Glentoran,7388,7,8,9,13,29,41,-12,33
Ards,7388,8,8,5,17,38,52,-14,29
Portadown,7388,9,7,8,15,23,40,-17,29
Ballinamalla,7388,10,9,2,19,25,49,-24,29
Dungannon,7388,11,6,10,14,43,49,-6,28
Ballymena,7389,1,18,5,7,70,53,17,59
Crusaders,7389,2,15,9,6,54,32,22,54
Linfield,7389,3,15,8,7,68,33,35,53
Glenavon,7389,4,13,9,8,53,44,9,48
Cliftonville,7389,5,13,7,10,54,40,14,46
Coleraine,7389,6,10,9,11,39,46,-7,39
Dungannon,7389,7,10,7,13,48,50,-2,37
Ballinamalla,7389,8,10,4,16,32,52,-20,34
Glentoran,7389,9,8,7,15,26,53,-27,31
Portadown,7389,10,8,6,16,26,46,-20,30
Ards,7389,11,8,3,19,34,55,-21,27
Ballymena,7390,1,16,6,8,61,55,6,54
Linfield,7390,2,15,8,7,55,31,24,53
Cliftonville,7390,3,16,4,10,59,37,22,52
Crusaders,7390,4,14,6,10,56,43,13,48
Glenavon,7390,5,11,12,7,50,46,4,45
Coleraine,7390,6,11,10,9,44,44,0,43
Dungannon,7390,7,11,9,10,51,44,7,42
Glentoran,7390,8,9,7,14,27,46,-19,34
Ards,7390,9,8,6,16,37,48,-11,30
Ballinamalla,7390,10,7,8,15,39,58,-19,29
Portadown,7390,11,7,4,19,23,50,-27,25
Linfield,7391,1,17,10,3,61,30,31,61
Crusaders,7391,2,18,6,6,53,29,24,60
Cliftonville,7391,3,16,4,10,54,38,16,52
Coleraine,7391,4,13,9,8,41,32,9,48
Glenavon,7391,5,11,12,7,47,44,3,45
Ballymena,7391,6,12,8,10,51,56,-5,44
Glentoran,7391,7,10,8,12,36,46,-10,38
Ards,7391,8,7,8,15,33,47,-14,29
Ballinamalla,7391,9,8,4,18,33,52,-19,28
Portadown,7391,10,7,5,18,22,46,-24,26
Dungannon,7391,11,6,6,18,42,53,-11,24
Crusaders,7392,1,17,7,6,53,29,24,58
Linfield,7392,2,16,7,7,62,25,37,55
Cliftonville,7392,3,14,7,9,49,38,11,49
Glenavon,7392,4,12,12,6,56,44,12,48
Coleraine,7392,5,12,9,9,40,40,0,45
Ballymena,7392,6,12,7,11,58,67,-9,43
Glentoran,7392,7,10,6,14,31,45,-14,36
Dungannon,7392,8,9,7,14,49,50,-1,34
Portadown,7392,9,10,4,16,24,45,-21,34
Ards,7392,10,9,3,18,36,51,-15,30
Ballinamalla,7392,11,8,3,19,30,54,-24,27
Crusaders,7393,1,18,5,7,58,38,20,59
Coleraine,7393,2,15,9,6,50,32,18,54
Linfield,7393,3,14,8,8,60,38,22,50
Dungannon,7393,4,12,7,11,55,43,12,43
Cliftonville,7393,5,13,3,14,45,44,1,42
Ballymena,7393,6,12,5,13,58,61,-3,41
Glenavon,7393,7,10,11,9,47,51,-4,41
Ballinamalla,7393,8,11,2,17,32,50,-18,35
Glentoran,7393,9,9,7,14,29,43,-14,34
Portadown,7393,10,9,5,16,33,50,-17,32
Ards,7393,11,9,4,17,35,52,-17,31
Crusaders,7394,1,18,7,5,50,27,23,61
Cliftonville,7394,2,16,4,10,59,40,19,52
Ballymena,7394,3,15,6,9,59,57,2,51
Linfield,7394,4,13,9,8,57,36,21,48
Coleraine,7394,5,12,11,7,42,35,7,47
Glenavon,7394,6,12,10,8,53,45,8,46
Ards,7394,7,11,5,14,40,48,-8,38
Dungannon,7394,8,9,9,12,45,43,2,36
Portadown,7394,9,9,4,17,31,53,-22,31
Glentoran,7394,10,8,6,16,25,46,-21,30
Ballinamalla,7394,11,5,3,22,23,54,-31,18
Crusaders,7395,1,19,8,3,57,31,26,65
Cliftonville,7395,2,17,4,9,61,42,19,55
Glenavon,7395,3,13,9,8,46,42,4,48
Ballymena,7395,4,14,3,13,56,65,-9,45
Linfield,7395,5,12,8,10,52,36,16,44
Coleraine,7395,6,11,9,10,45,40,5,42
Glentoran,7395,7,10,9,11,32,38,-6,39
Dungannon,7395,8,9,9,12,50,46,4,36
Portadown,7395,9,8,6,16,24,41,-17,30
Ards,7395,10,8,5,17,33,49,-16,29
Ballinamalla,7395,11,8,2,20,33,59,-26,26
Cliftonville,7396,1,17,6,7,56,30,26,57
Linfield,7396,2,15,8,7,62,33,29,53
Coleraine,7396,3,14,10,6,47,32,15,52
Glenavon,7396,4,12,12,6,46,42,4,48
Crusaders,7396,5,13,8,9,45,40,5,47
Ballymena,7396,6,12,6,12,55,57,-2,42
Dungannon,7396,7,10,10,10,45,42,3,40
Ballinamalla,7396,8,10,5,15,35,48,-13,35
Ards,7396,9,8,6,16,36,51,-15,30
Portadown,7396,10,6,7,17,24,47,-23,25
Glentoran,7396,11,5,8,17,28,57,-29,23
Crusaders,7397,1,19,6,5,69,40,29,63
Linfield,7397,2,14,10,6,55,28,27,52
Ballymena,7397,3,14,6,10,53,58,-5,48
Cliftonville,7397,4,13,5,12,51,43,8,44
Coleraine,7397,5,11,10,9,36,36,0,43
Dungannon,7397,6,10,10,10,53,42,11,40
Glenavon,7397,7,9,13,8,45,46,-1,40
Portadown,7397,8,10,8,12,27,37,-10,38
Glentoran,7397,9,9,6,15,29,43,-14,33
Ballinamalla,7397,10,8,6,16,28,50,-22,30
Ards,7397,11,5,6,19,31,54,-23,21
Glenavon,7398,1,16,9,5,57,37,20,57
Cliftonville,7398,2,17,6,7,49,30,19,57
Crusaders,7398,3,16,8,6,52,33,19,56
Ballymena,7398,4,12,6,12,53,59,-6,42
Linfield,7398,5,11,8,11,48,36,12,41
Ards,7398,6,12,5,13,33,40,-7,41
Coleraine,7398,7,9,12,9,42,42,0,39
Dungannon,7398,8,8,12,10,46,41,5,36
Glentoran,7398,9,8,8,14,24,39,-15,32
Ballinamalla,7398,10,8,6,16,33,51,-18,30
Portadown,7398,11,5,6,19,19,48,-29,21
Ballymena,7399,1,16,7,7,63,52,11,55
Linfield,7399,2,14,11,5,59,35,24,53
Crusaders,7399,3,13,12,5,57,40,17,51
Cliftonville,7399,4,15,6,9,58,45,13,51
Dungannon,7399,5,11,10,9,56,42,14,43
Glenavon,7399,6,11,10,9,49,46,3,43
Coleraine,7399,7,8,11,11,33,37,-4,35
Glentoran,7399,8,8,9,13,34,51,-17,33
Ards,7399,9,7,9,14,40,54,-14,30
Ballinamalla,7399,10,8,4,18,32,55,-23,28
Portadown,7399,11,7,5,18,28,52,-24,26
Crusaders,7400,1,19,7,4,60,27,33,64
Linfield,7400,2,17,7,6,69,35,34,58
Cliftonville,7400,3,16,5,9,54,36,18,53
Glenavon,7400,4,11,13,6,51,44,7,46
Coleraine,7400,5,11,11,8,41,39,2,44
Ballymena,7400,6,11,7,12,50,62,-12,40
Dungannon,7400,7,8,11,11,49,41,8,35
Glentoran,7400,8,8,8,14,32,47,-15,32
Ards,7400,9,9,5,16,32,48,-16,32
Ballinamalla,7400,10,7,5,18,27,56,-29,26
Portadown,7400,11,6,5,19,19,49,-30,23
Crusaders,7401,1,16,9,5,51,32,19,57
Cliftonville,7401,2,15,8,7,51,35,16,53
Glenavon,7401,3,11,13,6,53,46,7,46
Linfield,7401,4,10,15,5,59,35,24,45
Coleraine,7401,5,11,11,8,47,44,3,44
Ballymena,7401,6,12,8,10,57,61,-4,44
Dungannon,7401,7,9,11,10,48,45,3,38
Ards,7401,8,10,7,13,39,43,-4,37
Glentoran,7401,9,8,10,12,36,43,-7,34
Ballinamalla,7401,10,5,7,18,25,53,-28,22
Portadown,7401,11,5,7,18,23,52,-29,22
Crusaders,7402,1,19,7,4,56,27,29,64
Cliftonville,7402,2,17,6,7,56,35,21,57
Linfield,7402,3,15,11,4,65,33,32,56
Dungannon,7402,4,13,8,9,45,34,11,47
Ards,7402,5,11,6,13,41,49,-8,39
Glenavon,7402,6,9,11,10,43,46,-3,38
Ballymena,7402,7,11,5,14,57,61,-4,38
Coleraine,7402,8,9,10,11,47,48,-1,37
Ballinamalla,7402,9,8,5,17,30,50,-20,29
Glentoran,7402,10,7,7,16,29,56,-27,28
Portadown,7402,11,6,4,20,21,51,-30,22
Linfield,7403,1,15,10,5,61,25,36,55
Dungannon,7403,2,15,9,6,63,39,24,54
Cliftonville,7403,3,15,6,9,54,41,13,51
Crusaders,7403,4,13,11,6,52,41,11,50
Ballymena,7403,5,14,8,8,59,55,4,50
Coleraine,7403,6,11,14,5,46,37,9,47
Glenavon,7403,7,8,13,9,42,47,-5,37
Portadown,7403,8,8,6,16,24,41,-17,30
Glentoran,7403,9,5,10,15,27,52,-25,25
Ards,7403,10,5,8,17,32,56,-24,23
Ballinamalla,7403,11,6,5,19,30,56,-26,23
Crusaders,7404,1,14,8,8,57,38,19,50
Linfield,7404,2,13,10,7,52,33,19,49
Cliftonville,7404,3,14,5,11,49,43,6,47
Glenavon,7404,4,11,12,7,44,36,8,45
Ballymena,7404,5,12,8,10,61,59,2,44
Coleraine,7404,6,10,12,8,43,41,2,42
Glentoran,7404,7,10,9,11,35,45,-10,39
Dungannon,7404,8,9,8,13,46,48,-2,35
Ballinamalla,7404,9,10,4,16,29,45,-16,34
Ards,7404,10,9,6,15,36,47,-11,33
Portadown,7404,11,9,6,15,27,44,-17,33
Crusaders,7405,1,17,7,6,59,42,17,58
Cliftonville,7405,2,15,9,6,54,31,23,54
Linfield,7405,3,13,10,7,60,41,19,49
Coleraine,7405,4,13,10,7,46,30,16,49
Ballymena,7405,5,14,7,9,59,56,3,49
Glenavon,7405,6,13,9,8,52,44,8,48
Dungannon,7405,7,9,9,12,44,44,0,36
Ballinamalla,7405,8,10,4,16,35,48,-13,34
Portadown,7405,9,8,6,16,28,47,-19,30
Ards,7405,10,7,6,17,29,45,-16,27
Glentoran,7405,11,4,7,19,21,59,-38,19
Cliftonville,7406,1,16,5,9,57,37,20,53
Crusaders,7406,2,15,7,8,56,39,17,52
Linfield,7406,3,12,13,5,59,36,23,49
Glenavon,7406,4,13,9,8,48,43,5,48
Ballymena,7406,5,13,7,10,60,59,1,46
Dungannon,7406,6,10,10,10,48,39,9,40
Ards,7406,7,11,4,15,38,43,-5,37
Coleraine,7406,8,9,10,11,46,52,-6,37
Glentoran,7406,9,8,10,12,34,48,-14,34
Portadown,7406,10,9,4,17,24,49,-25,31
Ballinamalla,7406,11,7,5,18,26,51,-25,26
Linfield,7407,1,16,10,4,64,32,32,58
Cliftonville,7407,2,18,3,9,64,41,23,57
Crusaders,7407,3,16,8,6,62,42,20,56
Coleraine,7407,4,13,9,8,50,38,12,48
Glenavon,7407,5,12,10,8,40,41,-1,46
Ballymena,7407,6,12,7,11,54,58,-4,43
Dungannon,7407,7,9,9,12,43,41,2,36
Glentoran,7407,8,8,8,14,28,49,-21,32
Portadown,7407,9,8,5,17,32,50,-18,29
Ballinamalla,7407,10,7,5,18,27,53,-26,26
Ards,7407,11,7,4,19,33,52,-19,25
Ballymena,7408,1,16,5,9,65,54,11,53
Linfield,7408,2,13,11,6,57,35,22,50
Crusaders,7408,3,15,5,10,56,37,19,50
Cliftonville,7408,4,14,6,10,52,40,12,48
Glenavon,7408,5,11,11,8,48,49,-1,44
Dungannon,7408,6,11,8,11,53,52,1,41
Coleraine,7408,7,10,10,10,40,40,0,40
Ards,7408,8,11,4,15,39,48,-9,37
Ballinamalla,7408,9,9,5,16,34,49,-15,32
Glentoran,7408,10,7,9,14,33,51,-18,30
Portadown,7408,11,8,6,16,24,46,-22,30
Crusaders,7409,1,15,9,6,48,30,18,54
Linfield,7409,2,13,10,7,68,39,29,49
Coleraine,7409,3,13,8,9,49,38,11,47
Glenavon,7409,4,12,10,8,49,48,1,46
Cliftonville,7409,5,13,6,11,53,44,9,45
Portadown,7409,6,12,5,13,30,42,-12,41
Ballymena,7409,7,11,7,12,55,68,-13,40
Glentoran,7409,8,11,6,13,34,44,-10,39
Dungannon,7409,9,10,8,12,49,43,6,38
Ballinamalla,7409,10,7,7,16,29,50,-21,28
Ards,7409,11,6,8,16,38,56,-18,26
Linfield,7410,1,16,8,6,62,32,30,56
Crusaders,7410,2,15,7,8,57,38,19,52
Cliftonville,7410,3,15,6,9,49,35,14,51
Glenavon,7410,4,13,12,5,58,45,13,51
Coleraine,7410,5,12,10,8,42,35,7,46
Ballymena,7410,6,12,6,12,54,59,-5,42
Ards,7410,7,10,8,12,36,42,-6,38
Dungannon,7410,8,8,11,11,45,42,3,35
Glentoran,7410,9,7,8,15,25,45,-20,29
Ballinamalla,7410,10,8,5,17,28,55,-27,29
Portadown,7410,11,6,5,19,18,46,-28,23
Linfield,7411,1,15,9,6,59,34,25,54
Crusaders,7411,2,14,8,8,48,36,12,50
Dungannon,7411,3,13,8,9,55,38,17,47
Coleraine,7411,4,11,14,5,49,39,10,47
Cliftonville,7411,5,13,8,9,52,43,9,47
Ballymena,7411,6,13,6,11,58,59,-1,45
Glenavon,7411,7,10,14,6,50,46,4,44
Ballinamalla,7411,8,9,4,17,34,53,-19,31
Glentoran,7411,9,8,7,15,30,49,-19,31
Ards,7411,10,8,6,16,35,48,-13,30
Portadown,7411,11,5,8,17,25,50,-25,23
Ballymena,7412,1,16,5,9,59,60,-1,53
Linfield,7412,2,14,10,6,63,32,31,52
Crusaders,7412,3,14,8,8,52,35,17,50
Cliftonville,7412,4,15,5,10,56,42,14,50
Coleraine,7412,5,12,10,8,40,34,6,46
Glenavon,7412,6,11,8,11,57,58,-1,41
Glentoran,7412,7,11,7,12,42,46,-4,40
Ballinamalla,7412,8,11,3,16,42,57,-15,36
Dungannon,7412,9,9,8,13,49,52,-3,35
Ards,7412,10,10,2,18,39,59,-20,32
Portadown,7412,11,6,6,18,24,48,-24,24
Crusaders,7413,1,17,10,3,63,29,34,61
Linfield,7413,2,14,10,6,60,33,27,52
Cliftonville,7413,3,15,7,8,50,33,17,52
Ballymena,7413,4,14,7,9,66,67,-1,49
Coleraine,7413,5,10,13,7,37,33,4,43
Dungannon,7413,6,9,13,8,52,43,9,40
Glenavon,7413,7,9,12,9,39,49,-10,39
Ballinamalla,7413,8,7,8,15,36,55,-19,29
Portadown,7413,9,7,7,16,22,43,-21,28
Ards,7413,10,7,6,17,37,51,-14,27
Glentoran,7413,11,5,9,16,27,53,-26,24
Linfield,7414,1,18,6,6,62,29,33,60
Crusaders,7414,2,17,8,5,58,38,20,59
Cliftonville,7414,3,14,9,7,54,40,14,51
Dungannon,7414,4,13,6,11,53,41,12,45
Glenavon,7414,5,9,12,9,42,44,-2,39
Ballinamalla,7414,6,12,3,15,35,49,-14,39
Ballymena,7414,7,10,6,14,53,64,-11,36
Coleraine,7414,8,8,11,11,42,49,-7,35
Ards,7414,9,10,5,15,31,41,-10,35
Portadown,7414,10,9,5,16,32,49,-17,32
Glentoran,7414,11,5,9,16,26,44,-18,24
Crusaders,7415,1,15,6,9,57,41,16,51
Cliftonville,7415,2,15,6,9,58,45,13,51
Linfield,7415,3,13,11,6,60,32,28,50
Coleraine,7415,4,13,11,6,44,36,8,50
Ballymena,7415,5,14,7,9,56,57,-1,49
Glenavon,7415,6,10,10,10,52,48,4,40
Dungannon,7415,7,10,10,10,47,43,4,40
Ballinamalla,7415,8,10,5,15,32,47,-15,35
Portadown,7415,9,10,4,16,31,45,-14,34
Glentoran,7415,10,6,10,14,29,51,-22,28
Ards,7415,11,5,8,17,31,52,-21,23
Linfield,7416,1,18,6,6,63,34,29,60
Crusaders,7416,2,15,11,4,60,39,21,56
Cliftonville,7416,3,16,5,9,59,38,21,53
Coleraine,7416,4,12,12,6,49,38,11,48
Ballymena,7416,5,13,6,11,51,56,-5,45
Glenavon,7416,6,10,12,8,44,43,1,42
Dungannon,7416,7,8,9,13,51,47,4,33
Ards,7416,8,8,7,15,36,50,-14,31
Portadown,7416,9,8,6,16,28,47,-19,30
Glentoran,7416,10,7,7,16,35,53,-18,28
Ballinamalla,7416,11,7,5,18,33,64,-31,26
Linfield,7417,1,15,11,4,59,30,29,56
Crusaders,7417,2,14,12,4,56,36,20,54
Cliftonville,7417,3,15,3,12,58,43,15,48
Ballymena,7417,4,14,6,10,66,62,4,48
Glenavon,7417,5,11,12,7,53,43,10,45
Coleraine,7417,6,9,11,10,43,49,-6,38
Dungannon,7417,7,9,9,12,51,50,1,36
Glentoran,7417,8,9,9,12,39,51,-12,36
Ards,7417,9,10,5,15,38,46,-8,35
Portadown,7417,10,7,7,16,25,52,-27,28
Ballinamalla,7417,11,8,3,19,31,57,-26,27
Crusaders,7418,1,17,7,6,63,34,29,58
Cliftonville,7418,2,18,4,8,56,35,21,58
Ballymena,7418,3,18,4,8,61,52,9,58
Linfield,7418,4,14,7,9,60,34,26,49
Glenavon,7418,5,11,10,9,47,46,1,43
Dungannon,7418,6,11,7,12,54,45,9,40
Coleraine,7418,7,9,10,11,38,43,-5,37
Glentoran,7418,8,8,8,14,32,50,-18,32
Ballinamalla,7418,9,9,4,17,36,61,-25,31
Ards,7418,10,8,4,18,36,52,-16,28
Portadown,7418,11,8,3,19,29,60,-31,27
Linfield,7419,1,15,8,7,62,27,35,53
Coleraine,7419,2,14,9,7,44,35,9,51
Crusaders,7419,3,14,6,10,52,40,12,48
Ballymena,7419,4,13,8,9,56,57,-1,47
Glenavon,7419,5,12,9,9,47,46,1,45
Cliftonville,7419,6,13,5,12,49,44,5,44
Dungannon,7419,7,11,9,10,49,43,6,42
Glentoran,7419,8,11,6,13,33,45,-12,39
Ards,7419,9,10,6,14,39,44,-5,36
Portadown,7419,10,9,5,16,27,46,-19,32
Ballinamalla,7419,11,6,3,21,25,56,-31,21
Linfield,7420,1,15,10,5,60,28,32,55
Crusaders,7420,2,16,6,8,53,38,15,54
Ballymena,7420,3,14,8,8,52,50,2,50
Cliftonville,7420,4,13,10,7,50,37,13,49
Dungannon,7420,5,13,9,8,51,38,13,48
Coleraine,7420,6,9,14,7,37,32,5,41
Glentoran,7420,7,10,6,14,30,41,-11,36
Glenavon,7420,8,8,9,13,37,49,-12,33
Portadown,7420,9,8,8,14,24,38,-14,32
Ballinamalla,7420,10,9,2,19,29,49,-20,29
Ards,7420,11,7,4,19,35,58,-23,25
Linfield,7421,1,16,8,6,64,39,25,56
Crusaders,7421,2,15,7,8,61,37,24,52
Cliftonville,7421,3,13,9,8,50,36,14,48
Ballymena,7421,4,14,5,11,56,59,-3,47
Glenavon,7421,5,12,10,8,52,53,-1,46
Ards,7421,6,12,5,13,41,44,-3,41
Dungannon,7421,7,10,9,11,53,47,6,39
Coleraine,7421,8,9,12,9,42,40,2,39
Glentoran,7421,9,8,8,14,30,48,-18,32
Portadown,7421,10,8,6,16,30,48,-18,30
Ballinamalla,7421,11,7,3,20,22,50,-28,24
Crusaders,7422,1,18,7,5,68,37,31,61
Linfield,7422,2,14,11,5,55,29,26,53
Glenavon,7422,3,13,10,7,47,42,5,49
Cliftonville,7422,4,14,6,10,46,38,8,48
Coleraine,7422,5,12,9,9,41,34,7,45
Ballymena,7422,6,11,7,12,50,61,-11,40
Dungannon,7422,7,8,11,11,49,50,-1,35
Glentoran,7422,8,7,11,12,27,41,-14,32
Ballinamalla,7422,9,8,7,15,25,44,-19,31
Ards,7422,10,7,8,15,38,46,-8,29
Portadown,7422,11,6,7,17,24,48,-24,25
Cliftonville,7423,1,19,3,8,61,40,21,60
Ballymena,7423,2,16,6,8,62,51,11,54
Linfield,7423,3,14,9,7,57,37,20,51
Glenavon,7423,4,13,9,8,54,48,6,48
Crusaders,7423,5,13,7,10,50,41,9,46
Dungannon,7423,6,11,9,10,45,39,6,42
Glentoran,7423,7,12,5,13,26,36,-10,41
Coleraine,7423,8,10,10,10,46,43,3,40
Portadown,7423,9,7,7,16,23,42,-19,28
Ballinamalla,7423,10,7,4,19,28,54,-26,25
Ards,7423,11,7,3,20,37,58,-21,24
Crusaders,7424,1,17,8,5,55,29,26,59
Ballymena,7424,2,16,8,6,67,54,13,56
Linfield,7424,3,15,9,6,57,30,27,54
Cliftonville,7424,4,15,5,10,56,47,9,50
Dungannon,7424,5,12,8,10,55,46,9,44
Coleraine,7424,6,12,7,11,49,41,8,43
Glenavon,7424,7,8,11,11,44,48,-4,35
Ards,7424,8,9,6,15,37,50,-13,33
Glentoran,7424,9,7,10,13,28,47,-19,31
Portadown,7424,10,8,5,17,20,42,-22,29
Ballinamalla,7424,11,5,5,20,22,56,-34,20
Linfield,7425,1,16,9,5,63,31,32,57
Crusaders,7425,2,16,5,9,54,44,10,53
Cliftonville,7425,3,15,5,10,52,38,14,50
Ballymena,7425,4,13,7,10,54,58,-4,46
Coleraine,7425,5,10,13,7,43,40,3,43
Dungannon,7425,6,10,12,8,54,39,15,42
Glenavon,7425,7,8,13,9,51,59,-8,37
Ards,7425,8,10,4,16,41,50,-9,34
Ballinamalla,7425,9,9,6,15,30,46,-16,33
Portadown,7425,10,8,8,14,32,45,-13,32
Glentoran,7425,11,5,8,17,28,52,-24,23
Linfield,7426,1,17,8,5,69,29,40,59
Crusaders,7426,2,16,9,5,56,36,20,57
Cliftonville,7426,3,15,3,12,56,41,15,48
Glenavon,7426,4,12,10,8,46,43,3,46
Coleraine,7426,5,12,10,8,42,39,3,46
Dungannon,7426,6,12,9,9,48,38,10,45
Ballymena,7426,7,12,6,12,54,68,-14,42
Ards,7426,8,11,6,13,38,44,-6,39
Glentoran,7426,9,10,8,12,38,48,-10,38
Ballinamalla,7426,10,6,2,22,22,53,-31,20
Portadown,7426,11,5,3,22,22,52,-30,18
Crusaders,7427,1,18,6,6,55,33,22,60
Ballymena,7427,2,16,6,8,61,58,3,54
Linfield,7427,3,15,8,7,60,31,29,53
Glenavon,7427,4,12,10,8,44,40,4,46
Cliftonville,7427,5,12,8,10,50,39,11,44
Coleraine,7427,6,11,11,8,46,37,9,44
Dungannon,7427,7,11,7,12,46,45,1,40
Ballinamalla,7427,8,9,4,17,30,46,-16,31
Glentoran,7427,9,8,7,15,30,50,-20,31
Ards,7427,10,6,8,16,35,52,-17,26
Portadown,7427,11,7,5,18,21,47,-26,26
Crusaders,7428,1,18,5,7,54,34,20,59
Linfield,7428,2,15,9,6,57,33,24,54
Coleraine,7428,3,13,11,6,45,36,9,50
Glenavon,7428,4,12,12,6,48,35,13,48
Dungannon,7428,5,10,11,9,56,43,13,41
Cliftonville,7428,6,12,4,14,46,45,1,40
Glentoran,7428,7,10,9,11,35,42,-7,39
Ballymena,7428,8,10,9,11,53,63,-10,39
Ballinamalla,7428,9,8,5,17,29,46,-17,29
Ards,7428,10,7,7,16,34,53,-19,28
Portadown,7428,11,6,6,18,19,46,-27,24
Crusaders,7429,1,18,5,7,51,31,20,59
Linfield,7429,2,16,7,7,59,27,32,55
Cliftonville,7429,3,16,7,7,48,32,16,55
Coleraine,7429,4,14,9,7,44,30,14,51
Dungannon,7429,5,12,9,9,56,46,10,45
Ballymena,7429,6,13,6,11,53,54,-1,45
Ards,7429,7,11,3,16,33,44,-11,36
Glenavon,7429,8,8,10,12,38,46,-8,34
Ballinamalla,7429,9,9,2,19,25,51,-26,29
Portadown,7429,10,7,5,18,24,46,-22,26
Glentoran,7429,11,5,9,16,24,48,-24,24
Crusaders,7430,1,17,8,5,58,34,24,59
Cliftonville,7430,2,16,5,9,47,36,11,53
Ballymena,7430,3,15,5,10,58,55,3,50
Linfield,7430,4,12,11,7,52,28,24,47
Glenavon,7430,5,13,8,9,47,50,-3,47
Dungannon,7430,6,11,10,9,51,41,10,43
Coleraine,7430,7,10,9,11,42,45,-3,39
Ards,7430,8,11,5,14,41,45,-4,38
Glentoran,7430,9,7,11,12,29,40,-11,32
Ballinamalla,7430,10,9,2,19,30,50,-20,29
Portadown,7430,11,4,6,20,19,50,-31,18
Crusaders,7431,1,19,4,7,62,32,30,61
Cliftonville,7431,2,15,6,9,52,39,13,51
Glenavon,7431,3,14,8,8,48,42,6,50
Coleraine,7431,4,13,10,7,47,38,9,49
Linfield,7431,5,12,9,9,53,34,19,45
Ballymena,7431,6,13,5,12,51,57,-6,44
Glentoran,7431,7,11,8,11,35,39,-4,41
Dungannon,7431,8,9,9,12,44,41,3,36
Portadown,7431,9,8,4,18,19,43,-24,28
Ballinamalla,7431,10,7,6,17,33,54,-21,27
Ards,7431,11,7,5,18,32,57,-25,26
Crusaders,7432,1,16,10,4,57,38,19,58
Ballymena,7432,2,16,8,6,63,52,11,56
Coleraine,7432,3,14,11,5,53,35,18,53
Linfield,7432,4,14,10,6,64,35,29,52
Glenavon,7432,5,11,13,6,53,48,5,46
Cliftonville,7432,6,12,7,11,52,45,7,43
Dungannon,7432,7,9,12,9,55,48,7,39
Ballinamalla,7432,8,7,7,16,36,54,-18,28
Glentoran,7432,9,5,11,14,30,49,-19,26
Ards,7432,10,6,5,19,36,64,-28,23
Portadown,7432,11,5,6,19,25,56,-31,21
Linfield,7433,1,16,8,6,59,34,25,56
Crusaders,7433,2,13,12,5,51,33,18,51
Ballymena,7433,3,13,9,8,56,55,1,48
Cliftonville,7433,4,13,7,10,49,41,8,46
Coleraine,7433,5,10,13,7,44,40,4,43
Glenavon,7433,6,11,9,10,46,43,3,42
Glentoran,7433,7,10,9,11,32,37,-5,39
Dungannon,7433,8,9,10,11,50,47,3,37
Ards,7433,9,8,7,15,40,52,-12,31
Portadown,7433,10,8,5,17,22,43,-21,29
Ballinamalla,7433,11,8,3,19,28,52,-24,27
Crusaders,7434,1,17,7,6,59,37,22,58
Cliftonville,7434,2,15,7,8,48,35,13,52
Ballymena,7434,3,16,4,10,62,50,12,52
Linfield,7434,4,13,11,6,60,33,27,50
Dungannon,7434,5,13,9,8,49,36,13,48
Glentoran,7434,6,13,4,13,32,38,-6,43
Glenavon,7434,7,10,11,9,47,47,0,41
Coleraine,7434,8,9,10,11,41,45,-4,37
Ards,7434,9,9,7,14,36,45,-9,34
Ballinamalla,7434,10,5,7,18,30,54,-24,22
Portadown,7434,11,5,3,22,19,63,-44,18
Crusaders,7435,1,21,6,3,61,25,36,69
Linfield,7435,2,14,11,5,61,32,29,53
Cliftonville,7435,3,14,6,10,53,43,10,48
Coleraine,7435,4,11,10,9,38,34,4,43
Ballymena,7435,5,11,8,11,52,58,-6,41
Ards,7435,6,10,8,12,40,43,-3,38
Glentoran,7435,7,10,7,13,28,37,-9,37
Glenavon,7435,8,8,12,10,46,49,-3,36
Dungannon,7435,9,8,11,11,55,54,1,35
Portadown,7435,10,7,5,18,27,56,-29,26
Ballinamalla,7435,11,6,6,18,27,57,-30,24
Linfield,7436,1,17,9,4,57,22,35,60
Cliftonville,7436,2,15,8,7,54,40,14,53
Dungannon,7436,3,12,11,7,51,37,14,47
Crusaders,7436,4,12,8,10,48,38,10,44
Coleraine,7436,5,10,12,8,36,37,-1,42
Glenavon,7436,6,9,13,8,43,41,2,40
Glentoran,7436,7,9,11,10,33,42,-9,38
Ballymena,7436,8,9,8,13,48,61,-13,35
Ards,7436,9,8,7,15,34,48,-14,31
Portadown,7436,10,7,7,16,29,46,-17,28
Ballinamalla,7436,11,7,6,17,32,53,-21,27
Linfield,7437,1,17,10,3,66,29,37,61
Crusaders,7437,2,18,7,5,59,36,23,61
Cliftonville,7437,3,15,4,11,46,39,7,49
Glenavon,7437,4,12,9,9,48,45,3,45
Ballymena,7437,5,13,5,12,56,58,-2,44
Coleraine,7437,6,11,9,10,34,40,-6,42
Dungannon,7437,7,11,8,11,49,40,9,41
Ards,7437,8,9,6,15,37,44,-7,33
Glentoran,7437,9,7,9,14,34,51,-17,30
Portadown,7437,10,8,4,18,23,43,-20,28
Ballinamalla,7437,11,6,5,19,27,54,-27,23
Coleraine,7438,1,15,9,6,55,39,16,54
Crusaders,7438,2,14,11,5,59,43,16,53
Ballymena,7438,3,15,7,8,60,55,5,52
Linfield,7438,4,14,8,8,59,31,28,50
Cliftonville,7438,5,16,2,12,53,45,8,50
Glentoran,7438,6,10,9,11,40,43,-3,39
Glenavon,7438,7,8,11,11,43,48,-5,35
Dungannon,7438,8,8,9,13,52,51,1,33
Ballinamalla,7438,9,8,8,14,29,45,-16,32
Portadown,7438,10,8,5,17,29,51,-22,29
Ards,7438,11,7,5,18,33,61,-28,26
Crusaders,7439,1,17,8,5,52,31,21,59
Cliftonville,7439,2,18,4,8,62,37,25,58
Linfield,7439,3,14,8,8,58,38,20,50
Ballymena,7439,4,14,6,10,57,55,2,48
Dungannon,7439,5,12,8,10,48,37,11,44
Glenavon,7439,6,11,11,8,44,41,3,44
Coleraine,7439,7,9,9,12,44,48,-4,36
Glentoran,7439,8,10,6,14,33,47,-14,36
Ards,7439,9,10,5,15,36,48,-12,35
Ballinamalla,7439,10,7,5,18,30,53,-23,26
Portadown,7439,11,4,8,18,19,48,-29,20
Crusaders,7440,1,17,8,5,58,36,22,59
Cliftonville,7440,2,15,6,9,50,37,13,51
Linfield,7440,3,13,10,7,49,30,19,49
Glenavon,7440,4,12,12,6,51,44,7,48
Ballymena,7440,5,12,7,11,55,54,1,43
Coleraine,7440,6,11,9,10,41,44,-3,42
Dungannon,7440,7,10,7,13,43,41,2,37
Glentoran,7440,8,7,11,12,38,48,-10,32
Ards,7440,9,8,7,15,29,42,-13,31
Portadown,7440,10,8,7,15,27,42,-15,31
Ballinamalla,7440,11,8,4,18,29,52,-23,28
Linfield,7441,1,18,9,3,61,23,38,63
Crusaders,7441,2,16,7,7,56,34,22,55
Cliftonville,7441,3,15,3,12,61,50,11,48
Ballymena,7441,4,14,5,11,57,57,0,47
Coleraine,7441,5,12,9,9,44,39,5,45
Glenavon,7441,6,11,11,8,41,41,0,44
Glentoran,7441,7,10,6,14,33,42,-9,36
Dungannon,7441,8,8,9,13,41,43,-2,33
Ards,7441,9,9,4,17,33,47,-14,31
Portadown,7441,10,8,5,17,23,47,-24,29
Ballinamalla,7441,11,8,4,18,27,54,-27,28
Crusaders,7442,1,16,6,8,54,33,21,54
Cliftonville,7442,2,17,3,10,61,44,17,54
Linfield,7442,3,14,8,8,51,34,17,50
Glenavon,7442,4,12,10,8,46,44,2,46
Ballymena,7442,5,13,5,12,65,67,-2,44
Coleraine,7442,6,9,12,9,38,36,2,39
Glentoran,7442,7,10,8,12,35,49,-14,38
Ballinamalla,7442,8,11,4,15,32,42,-10,37
Dungannon,7442,9,9,8,13,49,49,0,35
Portadown,7442,10,10,4,16,30,43,-13,34
Ards,7442,11,7,6,17,33,53,-20,27
Cliftonville,7443,1,19,4,7,59,32,27,61
Crusaders,7443,2,16,10,4,60,36,24,58
Ballymena,7443,3,13,8,9,60,60,0,47
Linfield,7443,4,12,8,10,52,41,11,44
Coleraine,7443,5,11,10,9,40,38,2,43
Glenavon,7443,6,10,13,7,47,48,-1,43
Dungannon,7443,7,11,7,12,59,51,8,40
Ards,7443,8,9,7,14,36,46,-10,34
Ballinamalla,7443,9,9,6,15,30,46,-16,33
Glentoran,7443,10,7,8,15,33,45,-12,29
Portadown,7443,11,5,5,20,22,55,-33,20
Cliftonville,7444,1,18,5,7,62,36,26,59
Ballymena,7444,2,15,7,8,57,54,3,52
Linfield,7444,3,12,11,7,57,36,21,47
Coleraine,7444,4,12,11,7,48,37,11,47
Crusaders,7444,5,13,8,9,49,39,10,47
Glenavon,7444,6,11,10,9,50,52,-2,43
Ards,7444,7,10,6,14,43,50,-7,36
Dungannon,7444,8,7,10,13,43,46,-3,31
Glentoran,7444,9,7,9,14,27,40,-13,30
Portadown,7444,10,8,6,16,30,49,-19,30
Ballinamalla,7444,11,8,5,17,24,51,-27,29
Crusaders,7445,1,17,10,3,54,27,27,61
Linfield,7445,2,15,7,8,67,39,28,52
Ballymena,7445,3,15,7,8,60,56,4,52
Cliftonville,7445,4,15,4,11,58,45,13,49
Coleraine,7445,5,12,8,10,49,48,1,44
Glenavon,7445,6,11,10,9,54,53,1,43
Ards,7445,7,10,6,14,42,51,-9,36
Glentoran,7445,8,8,9,13,33,50,-17,33
Dungannon,7445,9,7,11,12,46,46,0,32
Portadown,7445,10,7,7,16,32,51,-19,28
Ballinamalla,7445,11,6,5,19,25,54,-29,23
Crusaders,7446,1,17,7,6,66,41,25,58
Linfield,7446,2,15,8,7,63,39,24,53
Cliftonville,7446,3,13,6,11,52,42,10,45
Ballymena,7446,4,13,6,11,53,56,-3,45
Coleraine,7446,5,11,11,8,42,37,5,44
Glenavon,7446,6,10,12,8,48,47,1,42
Dungannon,7446,7,11,8,11,51,49,2,41
Ards,7446,8,11,5,14,38,43,-5,38
Ballinamalla,7446,9,8,6,16,29,51,-22,30
Portadown,7446,10,8,5,17,31,49,-18,29
Glentoran,7446,11,7,8,15,30,49,-19,29
Crusaders,7447,1,15,9,6,57,36,21,54
Cliftonville,7447,2,15,6,9,52,35,17,51
Ballymena,7447,3,15,6,9,54,58,-4,51
Dungannon,7447,4,14,7,9,60,41,19,49
Linfield,7447,5,13,8,9,58,30,28,47
Glenavon,7447,6,12,10,8,47,41,6,46
Ards,7447,7,13,3,14,37,43,-6,42
Coleraine,7447,8,10,10,10,40,34,6,40
Glentoran,7447,9,8,8,14,29,50,-21,32
Ballinamalla,7447,10,8,3,19,31,57,-26,27
Portadown,7447,11,4,6,20,17,57,-40,18
Crusaders,7448,1,16,8,6,57,37,20,56
Linfield,7448,2,15,10,5,59,28,31,55
Coleraine,7448,3,15,8,7,46,31,15,53
Cliftonville,7448,4,14,7,9,53,38,15,49
Glenavon,7448,5,12,12,6,51,42,9,48
Dungannon,7448,6,10,10,10,48,40,8,40
Ballymena,7448,7,12,4,14,54,60,-6,40
Glentoran,7448,8,7,10,13,25,41,-16,31
Ballinamalla,7448,9,8,6,16,34,54,-20,30
Portadown,7448,10,7,7,16,22,46,-24,28
Ards,7448,11,5,6,19,29,61,-32,21
Linfield,7449,1,17,9,4,69,23,46,60
Cliftonville,7449,2,17,4,9,51,34,17,55
Ballymena,7449,3,14,9,7,61,53,8,51
Glenavon,7449,4,12,10,8,46,44,2,46
Coleraine,7449,5,11,12,7,44,45,-1,45
Crusaders,7449,6,11,10,9,43,37,6,43
Dungannon,7449,7,8,11,11,49,44,5,35
Ballinamalla,7449,8,10,4,16,30,46,-16,34
Ards,7449,9,9,5,16,38,53,-15,32
Glentoran,7449,10,6,10,14,25,47,-22,28
Portadown,7449,11,5,6,19,20,50,-30,21
Linfield,7450,1,17,8,5,63,31,32,59
Crusaders,7450,2,17,4,9,59,41,18,55
Coleraine,7450,3,12,13,5,49,34,15,49
Cliftonville,7450,4,15,4,11,49,41,8,49
Glenavon,7450,5,12,11,7,52,39,13,47
Ballymena,7450,6,14,5,11,57,62,-5,47
Dungannon,7450,7,12,9,9,49,44,5,45
Glentoran,7450,8,9,6,15,26,38,-12,33
Ballinamalla,7450,9,7,8,15,29,50,-21,29
Ards,7450,10,5,8,17,29,47,-18,23
Portadown,7450,11,4,6,20,18,53,-35,18
Linfield,7451,1,15,11,4,66,35,31,56
Crusaders,7451,2,14,11,5,59,45,14,53
Cliftonville,7451,3,16,3,11,64,39,25,51
Coleraine,7451,4,11,12,7,49,41,8,45
Ballymena,7451,5,12,9,9,56,58,-2,45
Glenavon,7451,6,11,11,8,54,45,9,44
Dungannon,7451,7,8,12,10,50,46,4,36
Glentoran,7451,8,10,6,14,26,46,-20,36
Ards,7451,9,8,6,16,44,54,-10,30
Portadown,7451,10,7,7,16,28,55,-27,28
Ballinamalla,7451,11,6,6,18,28,60,-32,24
Crusaders,7452,1,19,7,4,62,32,30,64
Cliftonville,7452,2,18,6,6,63,36,27,60
Linfield,7452,3,13,9,8,64,42,22,48
Glenavon,7452,4,11,15,4,53,39,14,48
Ballymena,7452,5,14,6,10,64,64,0,48
Coleraine,7452,6,9,9,12,37,48,-11,36
Ards,7452,7,10,4,16,50,55,-5,34
Glentoran,7452,8,9,6,15,27,49,-22,33
Dungannon,7452,9,7,8,15,42,47,-5,29
Portadown,7452,10,7,6,17,28,56,-28,27
Ballinamalla,7452,11,6,8,16,33,55,-22,26
Linfield,7453,1,17,8,5,62,28,34,59
Crusaders,7453,2,18,5,7,56,34,22,59
Coleraine,7453,3,13,12,5,50,37,13,51
Ballymena,7453,4,14,5,11,61,61,0,47
Glenavon,7453,5,12,9,9,54,49,5,45
Cliftonville,7453,6,12,6,12,47,42,5,42
Dungannon,7453,7,9,9,12,44,45,-1,36
Glentoran,7453,8,9,6,15,29,41,-12,33
Ards,7453,9,9,6,15,37,50,-13,33
Ballinamalla,7453,10,8,4,18,33,59,-26,28
Portadown,7453,11,7,4,19,25,52,-27,25
Crusaders,7454,1,15,8,7,59,37,22,53
Coleraine,7454,2,14,10,6,47,35,12,52
Glenavon,7454,3,12,14,4,49,40,9,50
Cliftonville,7454,4,13,9,8,55,42,13,48
Ballymena,7454,5,13,9,8,53,54,-1,48
Linfield,7454,6,12,11,7,64,36,28,47
Dungannon,7454,7,9,9,12,43,46,-3,36
Ards,7454,8,9,6,15,35,49,-14,33
Ballinamalla,7454,9,8,6,16,29,49,-20,30
Glentoran,7454,10,5,10,15,28,50,-22,25
Portadown,7454,11,6,6,18,26,50,-24,24
Cliftonville,7455,1,17,5,8,58,40,18,56
Crusaders,7455,2,15,6,9,58,42,16,51
Glenavon,7455,3,13,9,8,57,44,13,48
Linfield,7455,4,13,8,9,48,40,8,47
Ballymena,7455,5,13,5,12,53,60,-7,44
Coleraine,7455,6,11,10,9,43,37,6,43
Glentoran,7455,7,12,6,12,41,46,-5,42
Portadown,7455,8,12,4,14,26,39,-13,40
Dungannon,7455,9,10,7,13,60,52,8,37
Ballinamalla,7455,10,8,6,16,31,55,-24,30
Ards,7455,11,6,4,20,31,51,-20,22
Linfield,7456,1,18,8,4,65,29,36,62
Crusaders,7456,2,16,6,8,60,36,24,54
Glenavon,7456,3,13,11,6,53,41,12,50
Ballymena,7456,4,13,9,8,62,59,3,48
Cliftonville,7456,5,14,5,11,53,51,2,47
Dungannon,7456,6,9,9,12,43,41,2,36
Ards,7456,7,10,5,15,44,49,-5,35
Coleraine,7456,8,8,11,11,35,41,-6,35
Ballinamalla,7456,9,9,5,16,36,55,-19,32
Glentoran,7456,10,7,9,14,26,50,-24,30
Portadown,7456,11,7,4,19,26,51,-25,25
Linfield,7457,1,17,9,4,61,27,34,60
Crusaders,7457,2,16,7,7,53,33,20,55
Cliftonville,7457,3,15,5,10,47,36,11,50
Coleraine,7457,4,12,10,8,42,36,6,46
Dungannon,7457,5,12,9,9,59,44,15,45
Glenavon,7457,6,11,10,9,46,46,0,43
Ballymena,7457,7,11,8,11,48,59,-11,41
Ballinamalla,7457,8,10,4,16,39,52,-13,34
Glentoran,7457,9,8,8,14,31,45,-14,32
Portadown,7457,10,7,5,18,25,46,-21,26
Ards,7457,11,6,5,19,29,56,-27,23
Cliftonville,7458,1,17,4,9,53,42,11,55
Linfield,7458,2,15,9,6,56,31,25,54
Crusaders,7458,3,16,5,9,59,40,19,53
Ballymena,7458,4,16,5,9,65,54,11,53
Coleraine,7458,5,12,11,7,41,31,10,47
Glenavon,7458,6,12,10,8,48,43,5,46
Ballinamalla,7458,7,11,5,14,33,47,-14,38
Glentoran,7458,8,7,9,14,25,41,-16,30
Dungannon,7458,9,7,8,15,45,50,-5,29
Ards,7458,10,8,5,17,39,54,-15,29
Portadown,7458,11,6,5,19,25,56,-31,23
Crusaders,7459,1,18,7,5,55,32,23,61
Linfield,7459,2,15,7,8,66,41,25,52
Coleraine,7459,3,13,12,5,51,36,15,51
Cliftonville,7459,4,13,5,12,52,46,6,44
Ballymena,7459,5,12,7,11,66,66,0,43
Dungannon,7459,6,10,12,8,53,40,13,42
Ards,7459,7,12,5,13,50,50,0,41
Glenavon,7459,8,9,11,10,43,46,-3,38
Glentoran,7459,9,6,10,14,27,47,-20,28
Ballinamalla,7459,10,8,4,18,28,55,-27,28
Portadown,7459,11,6,6,18,25,57,-32,24
Linfield,7460,1,18,9,3,69,30,39,63
Crusaders,7460,2,16,9,5,52,29,23,57
Coleraine,7460,3,10,11,9,40,37,3,41
Ballymena,7460,4,12,5,13,53,64,-11,41
Dungannon,7460,5,10,9,11,49,43,6,39
Glenavon,7460,6,9,12,9,44,48,-4,39
Glentoran,7460,7,10,9,11,32,36,-4,39
Cliftonville,7460,8,11,5,14,42,45,-3,38
Ballinamalla,7460,9,10,4,16,30,48,-18,34
Portadown,7460,10,8,7,15,28,44,-16,31
Ards,7460,11,8,6,16,38,53,-15,30
Crusaders,7461,1,19,6,5,59,28,31,63
Linfield,7461,2,16,8,6,62,35,27,56
Cliftonville,7461,3,16,3,11,55,40,15,51
Coleraine,7461,4,13,11,6,46,33,13,50
Glenavon,7461,5,11,12,7,47,49,-2,45
Ballymena,7461,6,12,6,12,47,56,-9,42
Ards,7461,7,12,3,15,44,54,-10,39
Dungannon,7461,8,9,7,14,45,48,-3,34
Ballinamalla,7461,9,8,4,18,27,47,-20,28
Portadown,7461,10,7,6,17,26,44,-18,27
Glentoran,7461,11,5,8,17,23,47,-24,23
Crusaders,7462,1,15,9,6,48,30,18,54
Coleraine,7462,2,15,9,6,52,35,17,54
Linfield,7462,3,14,11,5,57,25,32,53
Cliftonville,7462,4,16,5,9,59,42,17,53
Ballymena,7462,5,11,8,11,53,61,-8,41
Glenavon,7462,6,10,10,10,45,47,-2,40
Dungannon,7462,7,9,10,11,52,43,9,37
Ballinamalla,7462,8,10,4,16,26,49,-23,34
Glentoran,7462,9,8,8,14,33,51,-18,32
Ards,7462,10,7,6,17,30,47,-17,27
Portadown,7462,11,6,8,16,20,45,-25,26
Cliftonville,7463,1,18,4,8,50,31,19,58
Crusaders,7463,2,14,8,8,54,35,19,50
Linfield,7463,3,12,12,6,58,39,19,48
Ballymena,7463,4,13,8,9,61,55,6,47
Coleraine,7463,5,11,12,7,46,40,6,45
Glenavon,7463,6,12,9,9,46,45,1,45
Dungannon,7463,7,10,8,12,51,46,5,38
Ards,7463,8,10,5,15,42,55,-13,35
Glentoran,7463,9,9,7,14,38,50,-12,34
Ballinamalla,7463,10,8,5,17,32,53,-21,29
Portadown,7463,11,7,4,19,20,49,-29,25
Crusaders,7464,1,17,7,6,62,36,26,58
Linfield,7464,2,16,8,6,63,31,32,56
Coleraine,7464,3,13,11,6,46,36,10,50
Cliftonville,7464,4,14,5,11,52,43,9,47
Ballymena,7464,5,11,11,8,47,48,-1,44
Dungannon,7464,6,10,8,12,48,49,-1,38
Glenavon,7464,7,9,11,10,44,45,-1,38
Glentoran,7464,8,9,9,12,30,42,-12,36
Ballinamalla,7464,9,9,5,16,35,59,-24,32
Portadown,7464,10,7,8,15,22,42,-20,29
Ards,7464,11,6,5,19,33,51,-18,23
Crusaders,7465,1,17,6,7,59,35,24,57
Linfield,7465,2,14,10,6,56,34,22,52
Ballymena,7465,3,15,7,8,67,61,6,52
Cliftonville,7465,4,16,3,11,49,44,5,51
Coleraine,7465,5,11,12,7,50,38,12,45
Dungannon,7465,6,11,11,8,53,37,16,44
Glenavon,7465,7,8,14,8,45,47,-2,38
Glentoran,7465,8,8,7,15,29,43,-14,31
Ards,7465,9,8,6,16,33,52,-19,30
Ballinamalla,7465,10,7,6,17,29,50,-21,27
Portadown,7465,11,7,4,19,23,52,-29,25
Crusaders,7466,1,18,7,5,61,35,26,61
Linfield,7466,2,16,9,5,61,27,34,57
Cliftonville,7466,3,17,6,7,57,36,21,57
Ballymena,7466,4,15,3,12,54,56,-2,48
Glenavon,7466,5,13,8,9,53,54,-1,47
Dungannon,7466,6,11,11,8,56,39,17,44
Glentoran,7466,7,11,6,13,38,48,-10,39
Coleraine,7466,8,8,12,10,35,36,-1,36
Ards,7466,9,10,5,15,34,45,-11,35
Portadown,7466,10,5,5,20,23,54,-31,20
Ballinamalla,7466,11,3,4,23,23,65,-42,13
Linfield,7467,1,16,10,4,63,35,28,58
Crusaders,7467,2,13,14,3,63,37,26,53
Ballymena,7467,3,15,5,10,59,56,3,50
Glenavon,7467,4,14,7,9,53,53,0,49
Coleraine,7467,5,12,10,8,45,39,6,46
Cliftonville,7467,6,12,9,9,53,45,8,45
Dungannon,7467,7,8,10,12,47,46,1,34
Ards,7467,8,8,7,15,39,53,-14,31
Ballinamalla,7467,9,7,7,16,35,52,-17,28
Glentoran,7467,10,6,9,15,30,49,-19,27
Portadown,7467,11,7,6,17,25,47,-22,27
Crusaders,7468,1,15,7,8,51,36,15,52
Ballymena,7468,2,15,7,8,55,51,4,52
Linfield,7468,3,14,8,8,54,31,23,50
Glenavon,7468,4,13,9,8,55,45,10,48
Cliftonville,7468,5,13,7,10,52,44,8,46
Ards,7468,6,11,7,12,43,46,-3,40
Dungannon,7468,7,9,10,11,46,41,5,37
Coleraine,7468,8,9,10,11,41,42,-1,37
Glentoran,7468,9,9,7,14,33,49,-16,34
Portadown,7468,10,10,4,16,25,44,-19,34
Ballinamalla,7468,11,6,6,18,26,52,-26,24
Crusaders,7469,1,17,8,5,57,36,21,59
Glenavon,7469,2,15,9,6,54,40,14,54
Ballymena,7469,3,15,4,11,58,58,0,49
Cliftonville,7469,4,14,6,10,55,41,14,48
Coleraine,7469,5,12,9,9,47,42,5,45
Linfield,7469,6,10,14,6,54,38,16,44
Dungannon,7469,7,11,7,12,58,53,5,40
Glentoran,7469,8,8,11,11,35,44,-9,35
Ards,7469,9,9,5,16,42,49,-7,32
Portadown,7469,10,7,6,17,24,51,-27,27
Ballinamalla,7469,11,6,3,21,29,61,-32,21
Crusaders,7470,1,18,7,5,57,36,21,61
Ballymena,7470,2,17,5,8,58,55,3,56
Coleraine,7470,3,12,9,9,49,41,8,45
Linfield,7470,4,12,8,10,50,40,10,44
Glenavon,7470,5,11,10,9,46,46,0,43
Ards,7470,6,13,4,13,46,49,-3,43
Cliftonville,7470,7,11,7,12,53,56,-3,40
Dungannon,7470,8,10,7,13,52,43,9,37
Ballinamalla,7470,9,10,3,17,35,49,-14,33
Portadown,7470,10,7,8,15,27,42,-15,29
Glentoran,7470,11,8,4,18,30,46,-16,28
Crusaders,7471,1,17,8,5,64,35,29,59
Linfield,7471,2,16,8,6,67,36,31,56
Cliftonville,7471,3,14,6,10,52,44,8,48
Coleraine,7471,4,12,11,7,45,34,11,47
Ballymena,7471,5,13,7,10,66,61,5,46
Glentoran,7471,6,13,7,10,35,41,-6,46
Glenavon,7471,7,8,12,10,45,49,-4,36
Dungannon,7471,8,9,8,13,51,54,-3,35
Portadown,7471,9,8,7,15,31,47,-16,31
Ards,7471,10,8,5,17,35,54,-19,29
Ballinamalla,7471,11,5,5,20,25,61,-36,20
Cliftonville,7472,1,15,7,8,57,42,15,52
Crusaders,7472,2,15,6,9,52,42,10,51
Glenavon,7472,3,13,8,9,50,43,7,47
Linfield,7472,4,12,10,8,55,34,21,46
Ballymena,7472,5,12,7,11,56,61,-5,43
Dungannon,7472,6,11,9,10,59,40,19,42
Coleraine,7472,7,10,12,8,39,37,2,42
Ards,7472,8,12,6,12,41,49,-8,42
Glentoran,7472,9,8,10,12,30,44,-14,34
Ballinamalla,7472,10,7,7,16,28,49,-21,28
Portadown,7472,11,6,6,18,23,49,-26,24
Cliftonville,7473,1,18,5,7,60,37,23,59
Crusaders,7473,2,17,8,5,53,30,23,59
Linfield,7473,3,14,10,6,69,34,35,52
Ballymena,7473,4,14,7,9,58,58,0,49
Glenavon,7473,5,11,10,9,54,43,11,43
Glentoran,7473,6,10,10,10,29,39,-10,40
Coleraine,7473,7,10,9,11,38,43,-5,39
Dungannon,7473,8,10,8,12,47,50,-3,38
Ballinamalla,7473,9,6,7,17,30,53,-23,25
Portadown,7473,10,6,7,17,27,57,-30,25
Ards,7473,11,5,7,18,34,55,-21,22
Crusaders,7474,1,18,7,5,56,31,25,61
Glenavon,7474,2,15,8,7,55,43,12,53
Linfield,7474,3,13,8,9,51,33,18,47
Cliftonville,7474,4,14,4,12,50,42,8,46
Ballymena,7474,5,12,8,10,56,58,-2,44
Dungannon,7474,6,10,10,10,53,48,5,40
Ards,7474,7,11,6,13,41,44,-3,39
Glentoran,7474,8,9,10,11,32,40,-8,37
Coleraine,7474,9,8,10,12,35,39,-4,34
Portadown,7474,10,7,8,15,24,45,-21,29
Ballinamalla,7474,11,7,3,20,25,55,-30,24
Crusaders,7475,1,16,8,6,48,32,16,56
Coleraine,7475,2,15,11,4,40,26,14,56
Linfield,7475,3,15,9,6,60,30,30,54
Ballymena,7475,4,13,7,10,54,52,2,46
Cliftonville,7475,5,13,6,11,48,39,9,45
Glenavon,7475,6,10,10,10,48,48,0,40
Glentoran,7475,7,11,7,12,38,46,-8,40
Dungannon,7475,8,8,9,13,47,46,1,33
Portadown,7475,9,9,5,16,29,46,-17,32
Ards,7475,10,7,7,16,34,47,-13,28
Ballinamalla,7475,11,5,7,18,24,58,-34,22
Crusaders,7476,1,16,10,4,64,35,29,58
Coleraine,7476,2,14,10,6,47,36,11,52
Linfield,7476,3,14,9,7,60,32,28,51
Ballymena,7476,4,15,5,10,60,54,6,50
Cliftonville,7476,5,14,4,12,48,47,1,46
Dungannon,7476,6,10,10,10,50,44,6,40
Glentoran,7476,7,11,5,14,34,48,-14,38
Ards,7476,8,10,6,14,41,47,-6,36
Glenavon,7476,9,9,9,12,43,53,-10,36
Ballinamalla,7476,10,10,5,15,35,52,-17,35
Portadown,7476,11,3,5,22,22,56,-34,14
Linfield,7477,1,16,9,5,62,30,32,57
Crusaders,7477,2,15,10,5,52,33,19,55
Ballymena,7477,3,15,7,8,63,55,8,52
Cliftonville,7477,4,15,6,9,60,42,18,51
Glenavon,7477,5,10,13,7,47,42,5,43
Coleraine,7477,6,10,11,9,38,42,-4,41
Dungannon,7477,7,10,8,12,52,45,7,38
Ards,7477,8,10,6,14,44,49,-5,36
Glentoran,7477,9,9,8,13,30,48,-18,35
Ballinamalla,7477,10,7,4,19,27,56,-29,25
Portadown,7477,11,5,4,21,21,54,-33,19
Crusaders,7478,1,18,9,3,53,29,24,63
Cliftonville,7478,2,16,5,9,57,39,18,53
Linfield,7478,3,13,10,7,66,39,27,49
Ballymena,7478,4,12,10,8,53,55,-2,46
Coleraine,7478,5,11,10,9,39,38,1,43
Glentoran,7478,6,12,6,12,33,37,-4,42
Ards,7478,7,12,5,13,41,43,-2,41
Dungannon,7478,8,9,8,13,47,44,3,35
Glenavon,7478,9,6,11,13,38,50,-12,29
Portadown,7478,10,6,8,16,30,54,-24,26
Ballinamalla,7478,11,7,4,19,29,58,-29,25
Linfield,7479,1,17,7,6,66,32,34,58
Ballymena,7479,2,16,5,9,64,64,0,53
Cliftonville,7479,3,16,3,11,44,34,10,51
Crusaders,7479,4,13,7,10,47,38,9,46
Coleraine,7479,5,12,10,8,43,38,5,46
Glenavon,7479,6,12,8,10,49,46,3,44
Glentoran,7479,7,12,5,13,42,44,-2,41
Dungannon,7479,8,11,6,13,43,44,-1,39
Ballinamalla,7479,9,12,2,16,32,47,-15,38
Portadown,7479,10,7,5,18,30,53,-23,26
Ards,7479,11,5,6,19,26,46,-20,21
Crusaders,7480,1,16,5,9,46,30,16,53
Cliftonville,7480,2,15,3,12,53,42,11,48
Ballymena,7480,3,14,5,11,62,58,4,47
Linfield,7480,4,12,10,8,57,38,19,46
Glenavon,7480,5,10,12,8,50,50,0,42
Coleraine,7480,6,11,8,11,42,43,-1,41
Dungannon,7480,7,10,10,10,49,40,9,40
Glentoran,7480,8,9,9,12,27,41,-14,36
Ballinamalla,7480,9,9,8,13,32,47,-15,35
Portadown,7480,10,8,10,12,33,48,-15,34
Ards,7480,11,7,8,15,36,50,-14,29
Cliftonville,7481,1,21,3,6,62,28,34,66
Linfield,7481,2,15,10,5,52,23,29,55
Crusaders,7481,3,15,7,8,60,43,17,52
Ballymena,7481,4,14,5,11,58,56,2,47
Glenavon,7481,5,10,11,9,53,49,4,41
Coleraine,7481,6,10,10,10,43,48,-5,40
Dungannon,7481,7,10,9,11,49,44,5,39
Glentoran,7481,8,10,7,13,31,41,-10,37
Portadown,7481,9,9,4,17,25,46,-21,31
Ards,7481,10,7,6,17,33,52,-19,27
Ballinamalla,7481,11,5,6,19,26,62,-36,21
Linfield,7482,1,18,6,6,72,38,34,60
Crusaders,7482,2,14,11,5,51,32,19,53
Ballymena,7482,3,15,8,7,66,58,8,53
Cliftonville,7482,4,15,4,11,55,43,12,49
Dungannon,7482,5,13,9,8,58,45,13,48
Coleraine,7482,6,10,11,9,40,41,-1,41
Glentoran,7482,7,8,10,12,33,46,-13,34
Glenavon,7482,8,7,10,13,45,57,-12,31
Ards,7482,9,7,9,14,32,44,-12,30
Portadown,7482,10,6,7,17,26,49,-23,25
Ballinamalla,7482,11,6,7,17,24,49,-25,25
Linfield,7483,1,18,7,5,64,28,36,61
Crusaders,7483,2,16,9,5,57,32,25,57
Cliftonville,7483,3,15,6,9,58,42,16,51
Coleraine,7483,4,12,8,10,44,42,2,44
Glenavon,7483,5,10,13,7,49,47,2,43
Ballymena,7483,6,11,8,11,59,56,3,41
Dungannon,7483,7,9,10,11,42,41,1,37
Ballinamalla,7483,8,10,5,15,32,45,-13,35
Ards,7483,9,9,4,17,33,51,-18,31
Glentoran,7483,10,8,6,16,27,54,-27,30
Portadown,7483,11,6,6,18,22,49,-27,24
Crusaders,7484,1,17,10,3,56,29,27,61
Linfield,7484,2,15,8,7,57,34,23,53
Glenavon,7484,3,13,11,6,50,41,9,50
Ballymena,7484,4,14,6,10,59,64,-5,48
Cliftonville,7484,5,13,4,13,44,41,3,43
Coleraine,7484,6,10,12,8,37,34,3,42
Ards,7484,7,10,6,14,40,46,-6,36
Dungannon,7484,8,9,7,14,48,49,-1,34
Glentoran,7484,9,9,7,14,37,41,-4,34
Ballinamalla,7484,10,7,6,17,28,56,-28,27
Portadown,7484,11,6,7,17,25,46,-21,25
Crusaders,7485,1,15,11,4,56,33,23,56
Cliftonville,7485,2,15,7,8,51,39,12,52
Ballymena,7485,3,15,5,10,57,55,2,50
Glenavon,7485,4,10,12,8,50,50,0,42
Linfield,7485,5,10,11,9,54,42,12,41
Coleraine,7485,6,10,10,10,43,44,-1,40
Glentoran,7485,7,10,6,14,28,38,-10,36
Ballinamalla,7485,8,11,3,16,32,49,-17,36
Dungannon,7485,9,8,10,12,47,42,5,34
Ards,7485,10,9,7,14,45,46,-1,34
Portadown,7485,11,9,4,17,26,51,-25,31
Cliftonville,7486,1,17,6,7,58,35,23,57
Crusaders,7486,2,16,7,7,58,42,16,55
Linfield,7486,3,13,10,7,55,31,24,49
Glentoran,7486,4,13,6,11,38,37,1,45
Dungannon,7486,5,10,11,9,48,43,5,41
Coleraine,7486,6,10,10,10,39,38,1,40
Ballymena,7486,7,11,5,14,52,66,-14,38
Glenavon,7486,8,8,13,9,46,51,-5,37
Ards,7486,9,9,6,15,40,49,-9,33
Ballinamalla,7486,10,7,7,16,26,50,-24,28
Portadown,7486,11,6,9,15,26,44,-18,27
Linfield,7487,1,16,9,5,69,37,32,57
Crusaders,7487,2,16,8,6,58,36,22,56
Cliftonville,7487,3,17,4,9,55,32,23,55
Coleraine,7487,4,14,8,8,47,36,11,50
Ballymena,7487,5,14,4,12,57,62,-5,46
Dungannon,7487,6,12,8,10,47,38,9,44
Glenavon,7487,7,10,9,11,46,45,1,39
Glentoran,7487,8,8,8,14,30,52,-22,32
Ards,7487,9,9,4,17,36,49,-13,31
Ballinamalla,7487,10,8,5,17,26,51,-25,29
Portadown,7487,11,6,3,21,19,52,-33,21
Crusaders,7488,1,18,6,6,65,36,29,60
Linfield,7488,2,16,8,6,71,37,34,56
Cliftonville,7488,3,17,5,8,51,31,20,56
Coleraine,7488,4,12,10,8,37,33,4,46
Glenavon,7488,5,10,13,7,48,44,4,43
Ballymena,7488,6,11,5,14,55,68,-13,38
Glentoran,7488,7,9,8,13,31,43,-12,35
Dungannon,7488,8,8,10,12,44,49,-5,34
Ards,7488,9,10,4,16,38,52,-14,34
Portadown,7488,10,6,9,15,25,44,-19,27
Ballinamalla,7488,11,6,6,18,25,53,-28,24
Crusaders,7489,1,15,9,6,57,39,18,54
Ballymena,7489,2,15,8,7,54,48,6,53
Linfield,7489,3,12,11,7,50,30,20,47
Coleraine,7489,4,11,13,6,46,38,8,46
Cliftonville,7489,5,13,6,11,46,38,8,45
Ards,7489,6,12,5,13,43,45,-2,41
Dungannon,7489,7,9,10,11,53,48,5,37
Portadown,7489,8,11,3,16,28,42,-14,36
Glentoran,7489,9,10,5,15,32,48,-16,35
Glenavon,7489,10,7,9,14,41,53,-12,30
Ballinamalla,7489,11,7,7,16,30,51,-21,28
Crusaders,7490,1,18,7,5,56,32,24,61
Glenavon,7490,2,15,11,4,59,35,24,56
Ballymena,7490,3,15,6,9,56,57,-1,51
Linfield,7490,4,12,12,6,57,35,22,48
Coleraine,7490,5,13,9,8,44,37,7,48
Cliftonville,7490,6,12,7,11,54,48,6,43
Dungannon,7490,7,11,8,11,49,44,5,41
Portadown,7490,8,8,5,17,34,50,-16,29
Ards,7490,9,8,4,18,41,58,-17,28
Glentoran,7490,10,6,9,15,30,54,-24,27
Ballinamalla,7490,11,7,2,21,28,58,-30,23
Crusaders,7491,1,15,7,8,54,43,11,52
Cliftonville,7491,2,15,6,9,46,39,7,51
Glenavon,7491,3,14,9,7,48,42,6,51
Linfield,7491,4,13,11,6,52,27,25,50
Ballymena,7491,5,13,6,11,50,55,-5,45
Coleraine,7491,6,10,12,8,45,35,10,42
Dungannon,7491,7,10,8,12,43,40,3,38
Portadown,7491,8,10,7,13,33,41,-8,37
Glentoran,7491,9,8,8,14,26,39,-13,32
Ballinamalla,7491,10,8,6,16,25,45,-20,30
Ards,7491,11,7,4,19,36,52,-16,25
Crusaders,7492,1,19,6,5,62,31,31,63
Cliftonville,7492,2,20,3,7,62,35,27,63
Ballymena,7492,3,15,7,8,58,52,6,52
Linfield,7492,4,11,13,6,53,33,20,46
Coleraine,7492,5,10,11,9,42,39,3,41
Glenavon,7492,6,10,10,10,43,54,-11,40
Dungannon,7492,7,9,9,12,52,50,2,36
Glentoran,7492,8,9,9,12,27,38,-11,36
Ards,7492,9,7,7,16,38,53,-15,28
Portadown,7492,10,7,6,17,29,51,-22,27
Ballinamalla,7492,11,4,7,19,25,55,-30,19
Crusaders,7493,1,15,11,4,52,33,19,56
Linfield,7493,2,14,10,6,63,31,32,52
Cliftonville,7493,3,15,6,9,49,39,10,51
Dungannon,7493,4,13,9,8,58,41,17,48
Coleraine,7493,5,11,12,7,40,31,9,45
Ballymena,7493,6,12,5,13,60,64,-4,41
Glentoran,7493,7,11,8,11,33,43,-10,41
Glenavon,7493,8,10,10,10,44,49,-5,40
Ards,7493,9,9,6,15,40,52,-12,33
Portadown,7493,10,6,6,18,20,45,-25,24
Ballinamalla,7493,11,5,5,20,25,56,-31,20
Crusaders,7494,1,20,7,3,62,27,35,67
Cliftonville,7494,2,17,4,9,48,33,15,55
Ballymena,7494,3,15,4,11,54,55,-1,49
Linfield,7494,4,14,6,10,56,41,15,48
Coleraine,7494,5,12,8,10,38,32,6,44
Glentoran,7494,6,13,5,12,38,42,-4,44
Glenavon,7494,7,10,10,10,43,45,-2,40
Dungannon,7494,8,9,8,13,47,45,2,35
Ballinamalla,7494,9,9,3,18,36,51,-15,30
Ards,7494,10,9,3,18,32,50,-18,30
Portadown,7494,11,7,2,21,19,52,-33,23
Crusaders,7495,1,18,4,8,62,40,22,58
Cliftonville,7495,2,16,5,9,57,37,20,53
Glenavon,7495,3,12,11,7,48,42,6,47
Linfield,7495,4,13,7,10,49,34,15,46
Dungannon,7495,5,12,7,11,44,38,6,43
Coleraine,7495,6,11,10,9,40,38,2,43
Ballymena,7495,7,11,8,11,54,55,-1,41
Ballinamalla,7495,8,10,4,16,32,46,-14,34
Ards,7495,9,10,3,17,35,49,-14,33
Glentoran,7495,10,8,8,14,28,47,-19,32
Portadown,7495,11,8,5,17,21,44,-23,29
Linfield,7496,1,15,10,5,64,31,33,55
Cliftonville,7496,2,17,3,10,57,41,16,54
Crusaders,7496,3,15,8,7,57,38,19,53
Ballymena,7496,4,16,4,10,60,56,4,52
Coleraine,7496,5,12,9,9,41,37,4,45
Dungannon,7496,6,11,9,10,53,48,5,42
Glentoran,7496,7,10,6,14,31,43,-12,36
Glenavon,7496,8,8,10,12,43,56,-13,34
Ballinamalla,7496,9,9,4,17,39,57,-18,31
Portadown,7496,10,8,5,17,26,50,-24,29
Ards,7496,11,8,4,18,43,57,-14,28
Linfield,7497,1,15,9,6,54,33,21,54
Cliftonville,7497,2,16,5,9,52,38,14,53
Crusaders,7497,3,14,10,6,54,30,24,52
Coleraine,7497,4,12,10,8,39,33,6,46
Glenavon,7497,5,10,11,9,46,47,-1,41
Glentoran,7497,6,11,7,12,37,48,-11,40
Ballymena,7497,7,11,6,13,45,55,-10,39
Dungannon,7497,8,8,11,11,51,51,0,35
Ballinamalla,7497,9,10,4,16,35,44,-9,34
Ards,7497,10,10,4,16,40,53,-13,34
Portadown,7497,11,6,7,17,25,46,-21,25
Crusaders,7498,1,16,10,4,56,30,26,58
Cliftonville,7498,2,17,7,6,63,43,20,58
Linfield,7498,3,15,7,8,67,36,31,52
Coleraine,7498,4,11,11,8,42,38,4,44
Ballymena,7498,5,12,8,10,58,57,1,44
Dungannon,7498,6,11,9,10,53,45,8,42
Glentoran,7498,7,9,9,12,27,37,-10,36
Glenavon,7498,8,8,9,13,41,51,-10,33
Ards,7498,9,8,6,16,42,60,-18,30
Ballinamalla,7498,10,7,8,15,28,50,-22,29
Portadown,7498,11,7,4,19,24,54,-30,25
Cliftonville,7499,1,17,7,6,53,32,21,58
Ballymena,7499,2,17,5,8,59,52,7,56
Crusaders,7499,3,15,7,8,56,43,13,52
Glentoran,7499,4,12,9,9,42,41,1,45
Glenavon,7499,5,11,9,10,53,52,1,42
Coleraine,7499,6,10,10,10,46,36,10,40
Linfield,7499,7,9,11,10,52,40,12,38
Ards,7499,8,9,6,15,43,59,-16,33
Ballinamalla,7499,9,9,6,15,32,50,-18,33
Portadown,7499,10,10,2,18,31,48,-17,32
Dungannon,7499,11,6,8,16,42,56,-14,26
Crusaders,7500,1,21,5,4,55,25,30,68
Ballymena,7500,2,15,5,10,62,58,4,50
Cliftonville,7500,3,14,5,11,53,45,8,47
Linfield,7500,4,12,10,8,57,34,23,46
Coleraine,7500,5,11,10,9,47,42,5,43
Glentoran,7500,6,12,6,12,38,45,-7,42
Dungannon,7500,7,10,11,9,53,41,12,41
Glenavon,7500,8,10,9,11,48,46,2,39
Ballinamalla,7500,9,12,1,17,38,56,-18,37
Portadown,7500,10,9,4,17,22,46,-24,31
Ards,7500,11,4,4,22,25,60,-35,16
Crusaders,7501,1,18,4,8,60,39,21,58
Linfield,7501,2,16,8,6,61,28,33,56
Cliftonville,7501,3,16,4,10,54,39,15,52
Dungannon,7501,4,13,10,7,48,32,16,49
Coleraine,7501,5,12,10,8,43,39,4,46
Glenavon,7501,6,10,10,10,44,41,3,40
Ballymena,7501,7,12,4,14,55,66,-11,40
Ballinamalla,7501,8,11,3,16,38,55,-17,36
Glentoran,7501,9,9,5,16,30,48,-18,32
Ards,7501,10,7,6,17,34,55,-21,27
Portadown,7501,11,7,4,19,25,50,-25,25
Crusaders,7502,1,18,8,4,60,31,29,62
Ballymena,7502,2,16,7,7,62,56,6,55
Cliftonville,7502,3,15,8,7,59,44,15,53
Linfield,7502,4,11,11,8,56,40,16,44
Coleraine,7502,5,10,10,10,42,43,-1,40
Glenavon,7502,6,10,9,11,45,46,-1,39
Dungannon,7502,7,9,10,11,45,43,2,37
Glentoran,7502,8,9,9,12,33,41,-8,36
Portadown,7502,9,8,6,16,29,48,-19,30
Ballinamalla,7502,10,8,4,18,31,56,-25,28
Ards,7502,11,7,6,17,29,43,-14,27
Crusaders,7503,1,17,8,5,60,38,22,59
Linfield,7503,2,14,10,6,55,27,28,52
Glenavon,7503,3,13,12,5,48,40,8,51
Cliftonville,7503,4,15,5,10,53,43,10,50
Ballymena,7503,5,13,8,9,52,52,0,47
Coleraine,7503,6,11,11,8,45,41,4,44
Portadown,7503,7,11,5,14,30,38,-8,38
Ards,7503,8,10,5,15,37,49,-12,35
Glentoran,7503,9,7,8,15,24,41,-17,29
Dungannon,7503,10,6,8,16,45,50,-5,26
Ballinamalla,7503,11,5,6,19,22,52,-30,21
Crusaders,7504,1,16,9,5,58,32,26,57
Cliftonville,7504,2,17,6,7,62,39,23,57
Linfield,7504,3,14,9,7,54,31,23,51
Ballymena,7504,4,14,5,11,62,63,-1,47
Coleraine,7504,5,12,10,8,48,41,7,46
Glentoran,7504,6,13,6,11,44,46,-2,45
Glenavon,7504,7,9,12,9,47,48,-1,39
Dungannon,7504,8,8,10,12,50,52,-2,34
Ards,7504,9,7,8,15,37,53,-16,29
Ballinamalla,7504,10,7,3,20,26,59,-33,24
Portadown,7504,11,5,8,17,23,47,-24,23
Crusaders,7505,1,19,8,3,61,26,35,65
Cliftonville,7505,2,16,3,11,52,38,14,51
Ballymena,7505,3,15,6,9,63,51,12,51
Linfield,7505,4,13,10,7,54,34,20,49
Coleraine,7505,5,13,7,10,43,38,5,46
Glenavon,7505,6,11,8,11,46,44,2,41
Dungannon,7505,7,9,10,11,46,44,2,37
Ballinamalla,7505,8,10,3,17,36,52,-16,33
Ards,7505,9,10,2,18,32,57,-25,32
Glentoran,7505,10,7,9,14,31,51,-20,30
Portadown,7505,11,8,2,20,25,54,-29,26
Crusaders,7506,1,16,8,6,60,41,19,56
Linfield,7506,2,13,10,7,57,34,23,49
Glenavon,7506,3,13,10,7,49,42,7,49
Coleraine,7506,4,12,12,6,47,34,13,48
Cliftonville,7506,5,14,4,12,54,46,8,46
Ballymena,7506,6,11,8,11,53,57,-4,41
Ards,7506,7,10,6,14,42,50,-8,36
Glentoran,7506,8,9,8,13,30,42,-12,35
Dungannon,7506,9,8,10,12,49,52,-3,34
Ballinamalla,7506,10,9,4,17,33,53,-20,31
Portadown,7506,11,6,8,16,25,48,-23,26
Crusaders,7507,1,19,9,2,62,25,37,66
Cliftonville,7507,2,17,3,10,56,38,18,54
Ballymena,7507,3,16,4,10,54,55,-1,52
Linfield,7507,4,12,11,7,55,35,20,47
Coleraine,7507,5,11,10,9,44,35,9,43
Glenavon,7507,6,7,16,7,41,41,0,37
Ards,7507,7,9,6,15,33,49,-16,33
Portadown,7507,8,8,7,15,27,42,-15,31
Glentoran,7507,9,7,10,13,28,45,-17,31
Ballinamalla,7507,10,8,5,17,26,47,-21,29
Dungannon,7507,11,6,9,15,39,53,-14,27
Crusaders,7508,1,19,6,5,64,32,32,63
Linfield,7508,2,14,9,7,65,37,28,51
Coleraine,7508,3,13,10,7,39,30,9,49
Ballymena,7508,4,13,8,9,51,53,-2,47
Cliftonville,7508,5,13,6,11,51,40,11,45
Glenavon,7508,6,9,12,9,47,46,1,39
Glentoran,7508,7,10,9,11,32,44,-12,39
Portadown,7508,8,11,5,14,26,40,-14,38
Ballinamalla,7508,9,10,4,16,27,47,-20,34
Ards,7508,10,7,7,16,39,57,-18,28
Dungannon,7508,11,5,6,19,40,55,-15,21
Linfield,7509,1,16,7,7,55,29,26,55
Cliftonville,7509,2,16,3,11,60,46,14,51
Crusaders,7509,3,14,8,8,55,37,18,50
Ballymena,7509,4,14,5,11,57,50,7,47
Glenavon,7509,5,11,13,6,47,45,2,46
Coleraine,7509,6,11,9,10,36,40,-4,42
Portadown,7509,7,10,6,14,30,42,-12,36
Glentoran,7509,8,9,8,13,25,37,-12,35
Ards,7509,9,10,4,16,33,47,-14,34
Dungannon,7509,10,7,10,13,44,51,-7,31
Ballinamalla,7509,11,9,3,18,34,52,-18,30
Crusaders,7510,1,18,5,7,58,33,25,59
Linfield,7510,2,15,9,6,58,28,30,54
Cliftonville,7510,3,15,6,9,50,40,10,51
Glenavon,7510,4,14,9,7,53,44,9,51
Ballymena,7510,5,14,7,9,56,48,8,49
Dungannon,7510,6,12,10,8,46,40,6,46
Coleraine,7510,7,11,11,8,41,37,4,44
Glentoran,7510,8,7,8,15,25,49,-24,29
Ards,7510,9,7,6,17,39,53,-14,27
Ballinamalla,7510,10,7,3,20,32,59,-27,24
Portadown,7510,11,5,6,19,21,48,-27,21
Crusaders,7511,1,16,6,8,54,32,22,54
Ballymena,7511,2,15,7,8,55,58,-3,52
Cliftonville,7511,3,14,8,8,49,35,14,50
Linfield,7511,4,14,7,9,57,32,25,49
Glenavon,7511,5,13,9,8,42,38,4,48
Coleraine,7511,6,11,12,7,42,36,6,45
Glentoran,7511,7,10,10,10,32,42,-10,40
Dungannon,7511,8,7,10,13,45,49,-4,31
Ards,7511,9,8,7,15,33,44,-11,31
Portadown,7511,10,7,6,17,26,46,-20,27
Ballinamalla,7511,11,5,8,17,28,51,-23,23
Crusaders,7512,1,18,5,7,56,30,26,59
Linfield,7512,2,14,12,4,60,28,32,54
Coleraine,7512,3,13,9,8,45,41,4,48
Ballymena,7512,4,14,6,10,53,60,-7,48
Glenavon,7512,5,11,9,10,47,47,0,42
Cliftonville,7512,6,10,7,13,43,45,-2,37
Glentoran,7512,7,8,11,11,33,44,-11,35
Dungannon,7512,8,9,7,14,51,53,-2,34
Ards,7512,9,8,9,13,39,44,-5,33
Portadown,7512,10,8,7,15,35,49,-14,31
Ballinamalla,7512,11,7,8,15,27,48,-21,29
Cliftonville,7513,1,18,6,6,63,34,29,60
Crusaders,7513,2,15,10,5,55,38,17,55
Ballymena,7513,3,15,8,7,61,60,1,53
Linfield,7513,4,11,12,7,59,36,23,45
Glenavon,7513,5,12,8,10,53,47,6,44
Coleraine,7513,6,8,13,9,46,47,-1,37
Ards,7513,7,10,7,13,39,48,-9,37
Dungannon,7513,8,8,10,12,49,49,0,34
Glentoran,7513,9,6,12,12,25,38,-13,30
Portadown,7513,10,6,8,16,28,57,-29,26
Ballinamalla,7513,11,6,6,18,26,50,-24,24
Cliftonville,7514,1,16,3,11,52,37,15,51
Linfield,7514,2,13,10,7,53,32,21,49
Coleraine,7514,3,12,11,7,48,34,14,47
Glenavon,7514,4,12,11,7,47,41,6,47
Dungannon,7514,5,13,7,10,57,43,14,46
Crusaders,7514,6,12,9,9,49,39,10,45
Ballymena,7514,7,13,6,11,52,57,-5,45
Glentoran,7514,8,10,8,12,33,43,-10,38
Ards,7514,9,7,8,15,31,51,-20,29
Ballinamalla,7514,10,8,5,17,28,50,-22,29
Portadown,7514,11,7,6,17,27,50,-23,27
Linfield,7515,1,16,7,7,62,34,28,55
Cliftonville,7515,2,16,4,10,60,49,11,52
Ballymena,7515,3,16,4,10,67,57,10,52
Crusaders,7515,4,13,10,7,55,42,13,49
Glenavon,7515,5,12,10,8,54,47,7,46
Coleraine,7515,6,12,9,9,41,38,3,45
Dungannon,7515,7,10,9,11,57,56,1,39
Glentoran,7515,8,9,8,13,35,46,-11,35
Ballinamalla,7515,9,9,5,16,33,55,-22,32
Ards,7515,10,7,9,14,39,50,-11,30
Portadown,7515,11,5,5,20,26,55,-29,20
Crusaders,7516,1,16,8,6,52,30,22,56
Ballymena,7516,2,14,8,8,57,57,0,50
Cliftonville,7516,3,14,7,9,56,41,15,49
Linfield,7516,4,12,10,8,56,35,21,46
Coleraine,7516,5,12,10,8,47,38,9,46
Glenavon,7516,6,10,11,9,44,48,-4,41
Ards,7516,7,10,8,12,37,45,-8,38
Ballinamalla,7516,8,9,5,16,32,48,-16,32
Dungannon,7516,9,8,7,15,48,48,0,31
Glentoran,7516,10,8,7,15,30,49,-19,31
Portadown,7516,11,8,7,15,29,49,-20,31
Cliftonville,7517,1,17,4,9,60,42,18,55
Linfield,7517,2,14,8,8,52,34,18,50
Glenavon,7517,3,13,8,9,55,45,10,47
Crusaders,7517,4,13,8,9,57,50,7,47
Coleraine,7517,5,12,11,7,43,37,6,47
Ballymena,7517,6,13,7,10,59,62,-3,46
Glentoran,7517,7,11,8,11,34,40,-6,41
Dungannon,7517,8,7,12,11,47,45,2,33
Portadown,7517,9,8,8,14,28,46,-18,32
Ards,7517,10,7,7,16,37,46,-9,28
Ballinamalla,7517,11,7,5,18,36,61,-25,26
Crusaders,7518,1,17,9,4,60,37,23,60
Linfield,7518,2,16,10,4,65,31,34,58
Cliftonville,7518,3,18,3,9,64,37,27,57
Glenavon,7518,4,12,10,8,43,40,3,46
Ards,7518,5,13,3,14,43,47,-4,42
Coleraine,7518,6,11,9,10,42,47,-5,42
Ballymena,7518,7,11,8,11,51,64,-13,41
Dungannon,7518,8,9,11,10,47,40,7,38
Glentoran,7518,9,6,8,16,26,47,-21,26
Ballinamalla,7518,10,6,6,18,29,50,-21,24
Portadown,7518,11,4,7,19,20,50,-30,19
Crusaders,7519,1,18,5,7,57,31,26,59
Cliftonville,7519,2,16,5,9,51,40,11,53
Ballymena,7519,3,16,5,9,66,56,10,53
Linfield,7519,4,13,10,7,63,38,25,49
Dungannon,7519,5,11,9,10,58,48,10,42
Coleraine,7519,6,10,11,9,40,46,-6,41
Glenavon,7519,7,10,10,10,41,44,-3,40
Glentoran,7519,8,10,6,14,40,49,-9,36
Ards,7519,9,9,4,17,35,53,-18,31
Portadown,7519,10,7,7,16,21,45,-24,28
Ballinamalla,7519,11,7,4,19,36,58,-22,25
Crusaders,7520,1,19,6,5,63,31,32,63
Ballymena,7520,2,16,6,8,64,56,8,54
Linfield,7520,3,14,10,6,57,32,25,52
Cliftonville,7520,4,13,7,10,53,43,10,46
Dungannon,7520,5,11,10,9,55,45,10,43
Coleraine,7520,6,10,9,11,44,46,-2,39
Glenavon,7520,7,8,12,10,43,53,-10,36
Glentoran,7520,8,8,9,13,29,42,-13,33
Ards,7520,9,9,4,17,35,51,-16,31
Portadown,7520,10,9,4,17,25,51,-26,31
Ballinamalla,7520,11,6,7,17,36,54,-18,25
Cliftonville,7521,1,16,5,9,49,31,18,53
Crusaders,7521,2,15,6,9,56,46,10,51
Linfield,7521,3,13,10,7,58,36,22,49
Coleraine,7521,4,13,9,8,49,38,11,48
Glenavon,7521,5,12,10,8,54,49,5,46
Ballymena,7521,6,12,8,10,56,62,-6,44
Glentoran,7521,7,10,8,12,32,47,-15,38
Ards,7521,8,10,5,15,38,49,-11,35
Dungannon,7521,9,9,7,14,52,49,3,34
Portadown,7521,10,10,4,16,26,41,-15,34
Ballinamalla,7521,11,5,8,17,26,48,-22,23
Crusaders,7522,1,17,7,6,56,40,16,58
Linfield,7522,2,14,12,4,58,26,32,54
Ballymena,7522,3,15,4,11,65,62,3,49
Cliftonville,7522,4,14,5,11,46,43,3,47
Glenavon,7522,5,11,11,8,55,47,8,44
Coleraine,7522,6,12,8,10,34,35,-1,44
Glentoran,7522,7,10,7,13,31,45,-14,37
Dungannon,7522,8,9,9,12,52,50,2,36
Ballinamalla,7522,9,10,4,16,31,44,-13,34
Ards,7522,10,8,6,16,36,44,-8,30
Portadown,7522,11,7,3,20,25,53,-28,24
Ballymena,7523,1,16,5,9,63,52,11,53
Linfield,7523,2,14,10,6,54,32,22,52
Crusaders,7523,3,12,14,4,52,32,20,50
Glenavon,7523,4,12,12,6,53,47,6,48
Cliftonville,7523,5,13,7,10,53,41,12,46
Coleraine,7523,6,11,11,8,42,37,5,44
Dungannon,7523,7,11,8,11,50,45,5,41
Ards,7523,8,11,6,13,39,42,-3,39
Glentoran,7523,9,6,12,12,24,44,-20,30
Portadown,7523,10,6,4,20,23,54,-31,22
Ballinamalla,7523,11,4,9,17,23,50,-27,21
Crusaders,7524,1,18,6,6,52,31,21,60
Linfield,7524,2,15,9,6,57,31,26,54
Cliftonville,7524,3,13,6,11,46,38,8,45
Ballymena,7524,4,12,9,9,51,51,0,45
Glenavon,7524,5,11,11,8,50,43,7,44
Ards,7524,6,12,6,12,40,46,-6,42
Coleraine,7524,7,10,10,10,36,38,-2,40
Dungannon,7524,8,10,7,13,46,43,3,37
Portadown,7524,9,9,6,15,27,41,-14,33
Glentoran,7524,10,7,8,15,29,48,-19,29
Ballinamalla,7524,11,6,6,18,26,50,-24,24
Ballymena,7525,1,18,5,7,60,49,11,59
Linfield,7525,2,14,10,6,62,36,26,52
Crusaders,7525,3,15,7,8,51,32,19,52
Cliftonville,7525,4,16,4,10,46,43,3,52
Coleraine,7525,5,12,13,5,44,32,12,49
Dungannon,7525,6,11,10,9,54,39,15,43
Glenavon,7525,7,7,16,7,37,40,-3,37
Glentoran,7525,8,7,10,13,24,39,-15,31
Ards,7525,9,6,9,15,36,49,-13,27
Ballinamalla,7525,10,5,8,17,29,59,-30,23
Portadown,7525,11,6,4,20,27,52,-25,22
Crusaders,7526,1,15,8,7,59,39,20,53
Cliftonville,7526,2,16,5,9,56,36,20,53
Linfield,7526,3,15,7,8,62,33,29,52
Ballymena,7526,4,12,7,11,60,67,-7,43
Coleraine,7526,5,11,9,10,39,39,0,42
Glentoran,7526,6,11,9,10,39,41,-2,42
Dungannon,7526,7,8,14,8,47,41,6,38
Ards,7526,8,11,4,15,37,50,-13,37
Glenavon,7526,9,8,11,11,44,55,-11,35
Portadown,7526,10,10,5,15,33,49,-16,35
Ballinamalla,7526,11,7,3,20,28,54,-26,24
Linfield,7527,1,18,7,5,66,33,33,61
Crusaders,7527,2,18,6,6,61,33,28,60
Cliftonville,7527,3,15,4,11,54,45,9,49
Coleraine,7527,4,12,10,8,47,39,8,46
Glenavon,7527,5,10,12,8,48,43,5,42
Dungannon,7527,6,10,9,11,58,48,10,39
Ballymena,7527,7,10,8,12,51,60,-9,38
Glentoran,7527,8,8,10,12,37,46,-9,34
Ards,7527,9,8,8,14,35,50,-15,32
Ballinamalla,7527,10,8,4,18,36,65,-29,28
Portadown,7527,11,7,4,19,23,54,-31,25
Ballymena,7528,1,18,5,7,74,52,22,59
Cliftonville,7528,2,17,7,6,57,36,21,58
Crusaders,7528,3,16,7,7,57,35,22,55
Linfield,7528,4,14,9,7,61,39,22,51
Dungannon,7528,5,12,10,8,52,40,12,46
Glenavon,7528,6,8,11,11,39,48,-9,35
Glentoran,7528,7,10,5,15,32,49,-17,35
Ards,7528,8,10,3,17,35,44,-9,33
Coleraine,7528,9,7,9,14,39,49,-10,30
Ballinamalla,7528,10,7,6,17,26,48,-22,27
Portadown,7528,11,7,6,17,26,58,-32,27
Crusaders,7529,1,20,6,4,62,34,28,66
Linfield,7529,2,18,8,4,66,29,37,62
Ballymena,7529,3,13,7,10,61,58,3,46
Coleraine,7529,4,11,11,8,40,35,5,44
Glenavon,7529,5,9,15,6,48,43,5,42
Cliftonville,7529,6,12,6,12,47,46,1,42
Ards,7529,7,10,7,13,31,42,-11,37
Dungannon,7529,8,7,13,10,50,45,5,34
Ballinamalla,7529,9,8,7,15,37,58,-21,31
Glentoran,7529,10,5,10,15,25,46,-21,25
Portadown,7529,11,4,6,20,23,54,-31,18
Linfield,7530,1,15,11,4,67,33,34,56
Cliftonville,7530,2,17,5,8,54,35,19,56
Crusaders,7530,3,15,8,7,45,28,17,53
Coleraine,7530,4,12,10,8,45,39,6,46
Ballymena,7530,5,13,7,10,53,59,-6,46
Dungannon,7530,6,12,9,9,57,46,11,45
Glenavon,7530,7,9,11,10,47,50,-3,38
Ards,7530,8,8,8,14,43,49,-6,32
Glentoran,7530,9,8,6,16,27,49,-22,30
Ballinamalla,7530,10,8,4,18,29,54,-25,28
Portadown,7530,11,6,5,19,28,53,-25,23
Crusaders,7531,1,17,6,7,55,32,23,57
Coleraine,7531,2,15,10,5,46,33,13,55
Linfield,7531,3,15,7,8,57,27,30,52
Glenavon,7531,4,12,10,8,45,41,4,46
Glentoran,7531,5,14,4,12,29,37,-8,46
Cliftonville,7531,6,12,7,11,46,39,7,43
Ballymena,7531,7,10,7,13,48,61,-13,37
Dungannon,7531,8,8,9,13,47,48,-1,33
Ards,7531,9,8,7,15,29,42,-13,31
Portadown,7531,10,9,4,17,23,45,-22,31
Ballinamalla,7531,11,8,3,19,31,51,-20,27
Linfield,7532,1,17,9,4,70,30,40,60
Crusaders,7532,2,17,7,6,60,37,23,58
Cliftonville,7532,3,18,4,8,49,35,14,58
Ballymena,7532,4,16,4,10,67,56,11,52
Glenavon,7532,5,10,12,8,44,46,-2,42
Coleraine,7532,6,9,11,10,34,37,-3,38
Dungannon,7532,7,9,10,11,50,45,5,37
Ballinamalla,7532,8,8,6,16,30,48,-18,30
Ards,7532,9,7,7,16,28,46,-18,28
Glentoran,7532,10,6,9,15,22,50,-28,27
Portadown,7532,11,5,7,18,21,45,-24,22
Linfield,7533,1,18,8,4,62,27,35,62
Crusaders,7533,2,14,9,7,52,40,12,51
Ballymena,7533,3,14,7,9,55,51,4,49
Cliftonville,7533,4,14,5,11,51,41,10,47
Coleraine,7533,5,10,14,6,43,43,0,44
Glenavon,7533,6,10,13,7,49,42,7,43
Glentoran,7533,7,9,8,13,33,44,-11,35
Ards,7533,8,10,4,16,39,47,-8,34
Dungannon,7533,9,7,9,14,41,48,-7,30
Portadown,7533,10,7,7,16,29,48,-19,28
Ballinamalla,7533,11,7,6,17,28,51,-23,27
Ballymena,7534,1,17,5,8,65,57,8,56
Coleraine,7534,2,15,8,7,49,31,18,53
Cliftonville,7534,3,15,5,10,55,43,12,50
Crusaders,7534,4,14,7,9,49,36,13,49
Glenavon,7534,5,13,10,7,55,44,11,49
Linfield,7534,6,12,9,9,51,33,18,45
Ards,7534,7,10,6,14,43,55,-12,36
Dungannon,7534,8,8,10,12,45,45,0,34
Glentoran,7534,9,8,7,15,27,45,-18,31
Portadown,7534,10,9,3,18,29,51,-22,30
Ballinamalla,7534,11,7,4,19,28,56,-28,25
Crusaders,7535,1,18,7,5,60,33,27,61
Linfield,7535,2,14,9,7,55,35,20,51
Cliftonville,7535,3,14,8,8,48,34,14,50
Ballymena,7535,4,13,6,11,54,56,-2,45
Glenavon,7535,5,11,11,8,49,46,3,44
Coleraine,7535,6,10,11,9,38,37,1,41
Glentoran,7535,7,10,10,10,35,39,-4,40
Portadown,7535,8,10,5,15,36,49,-13,35
Dungannon,7535,9,8,10,12,43,48,-5,34
Ards,7535,10,8,3,19,36,53,-17,27
Ballinamalla,7535,11,6,6,18,30,54,-24,24
Linfield,7536,1,16,9,5,64,30,34,57
Crusaders,7536,2,16,8,6,53,33,20,56
Glenavon,7536,3,13,10,7,53,47,6,49
Ballymena,7536,4,14,5,11,54,57,-3,47
Cliftonville,7536,5,13,7,10,50,40,10,46
Coleraine,7536,6,11,10,9,41,36,5,43
Dungannon,7536,7,9,8,13,48,47,1,35
Portadown,7536,8,9,5,16,26,45,-19,32
Ballinamalla,7536,9,9,4,17,33,53,-20,31
Ards,7536,10,8,5,17,32,45,-13,29
Glentoran,7536,11,6,11,13,21,42,-21,29
Cliftonville,7537,1,17,5,8,64,42,22,56
Coleraine,7537,2,15,8,7,52,34,18,53
Ballymena,7537,3,15,6,9,63,52,11,51
Crusaders,7537,4,13,8,9,53,36,17,47
Linfield,7537,5,11,13,6,49,31,18,46
Glenavon,7537,6,10,10,10,47,54,-7,40
Dungannon,7537,7,10,8,12,51,56,-5,38
Glentoran,7537,8,9,10,11,31,44,-13,37
Ballinamalla,7537,9,9,4,17,29,52,-23,31
Ards,7537,10,8,5,17,38,53,-15,29
Portadown,7537,11,7,5,18,32,55,-23,26
Linfield,7538,1,15,8,7,59,34,25,53
Crusaders,7538,2,15,7,8,49,32,17,52
Cliftonville,7538,3,15,6,9,53,37,16,51
Coleraine,7538,4,13,9,8,46,35,11,48
Ballymena,7538,5,13,8,9,52,55,-3,47
Glenavon,7538,6,12,10,8,48,48,0,46
Dungannon,7538,7,10,10,10,52,46,6,40
Glentoran,7538,8,10,7,13,29,38,-9,37
Portadown,7538,9,9,5,16,25,43,-18,32
Ballinamalla,7538,10,7,4,19,30,51,-21,25
Ards,7538,11,7,4,19,31,55,-24,25
Linfield,7539,1,15,9,6,63,30,33,54
Cliftonville,7539,2,17,3,10,49,35,14,54
Dungannon,7539,3,13,10,7,56,41,15,49
Crusaders,7539,4,13,7,10,49,39,10,46
Coleraine,7539,5,12,9,9,41,36,5,45
Ballymena,7539,6,11,10,9,50,57,-7,43
Ards,7539,7,12,5,13,42,45,-3,41
Glenavon,7539,8,9,11,10,42,44,-2,38
Ballinamalla,7539,9,10,4,16,28,46,-18,34
Glentoran,7539,10,9,5,16,29,47,-18,32
Portadown,7539,11,5,5,20,27,56,-29,20
Crusaders,7540,1,16,7,7,52,29,23,55
Coleraine,7540,2,13,11,6,45,35,10,50
Linfield,7540,3,13,10,7,57,38,19,49
Dungannon,7540,4,13,9,8,55,40,15,48
Cliftonville,7540,5,15,3,12,53,44,9,48
Ballymena,7540,6,12,11,7,58,58,0,47
Glenavon,7540,7,9,12,9,42,46,-4,39
Glentoran,7540,8,9,7,14,32,45,-13,34
Portadown,7540,9,8,5,17,27,45,-18,29
Ards,7540,10,7,6,17,37,51,-14,27
Ballinamalla,7540,11,6,7,17,26,53,-27,25
Crusaders,7541,1,14,9,7,55,39,16,51
Cliftonville,7541,2,15,6,9,54,40,14,51
Ballymena,7541,3,13,8,9,56,57,-1,47
Linfield,7541,4,12,7,11,57,46,11,43
Glenavon,7541,5,9,15,6,47,41,6,42
Coleraine,7541,6,9,14,7,43,39,4,41
Ards,7541,7,11,5,14,41,50,-9,38
Dungannon,7541,8,8,11,11,43,41,2,35
Glentoran,7541,9,8,10,12,33,46,-13,34
Portadown,7541,10,9,6,15,27,42,-15,33
Ballinamalla,7541,11,8,7,15,30,45,-15,31
Crusaders,7542,1,18,7,5,56,32,24,61
Linfield,7542,2,16,9,5,61,30,31,57
Glenavon,7542,3,15,10,5,49,39,10,55
Ballymena,7542,4,15,5,10,60,56,4,50
Cliftonville,7542,5,14,4,12,52,39,13,46
Coleraine,7542,6,11,9,10,40,39,1,42
Glentoran,7542,7,9,8,13,34,44,-10,35
Dungannon,7542,8,8,9,13,47,51,-4,33
Portadown,7542,9,7,7,16,26,46,-20,28
Ards,7542,10,8,3,19,36,56,-20,27
Ballinamalla,7542,11,5,7,18,25,54,-29,22
Linfield,7543,1,15,10,5,58,39,19,55
Glenavon,7543,2,13,11,6,61,39,22,50
Crusaders,7543,3,14,8,8,47,39,8,50
Coleraine,7543,4,12,11,7,46,32,14,47
Ballymena,7543,5,13,6,11,59,58,1,45
Cliftonville,7543,6,12,6,12,45,41,4,42
Ards,7543,7,10,8,12,35,43,-8,38
Portadown,7543,8,9,6,15,31,44,-13,33
Glentoran,7543,9,8,9,13,35,52,-17,33
Dungannon,7543,10,6,11,13,45,51,-6,29
Ballinamalla,7543,11,7,6,17,27,51,-24,27
Crusaders,7544,1,16,9,5,57,36,21,57
Linfield,7544,2,15,8,7,66,37,29,53
Cliftonville,7544,3,16,3,11,57,42,15,51
Ballymena,7544,4,15,6,9,60,58,2,51
Glenavon,7544,5,12,11,7,46,41,5,47
Coleraine,7544,6,9,10,11,40,46,-6,37
Dungannon,7544,7,9,9,12,49,56,-7,36
Ards,7544,8,10,5,15,40,50,-10,35
Portadown,7544,9,9,6,15,37,43,-6,33
Glentoran,7544,10,8,7,15,29,44,-15,31
Ballinamalla,7544,11,7,4,19,28,56,-28,25
Ballymena,7545,1,16,7,7,60,53,7,55
Crusaders,7545,2,14,10,6,49,26,23,52
Linfield,7545,3,14,7,9,60,39,21,49
Cliftonville,7545,4,14,5,11,49,37,12,47
Glenavon,7545,5,11,13,6,50,46,4,46
Dungannon,7545,6,10,11,9,46,41,5,41
Glentoran,7545,7,10,8,12,37,41,-4,38
Coleraine,7545,8,9,11,10,40,47,-7,38
Ards,7545,9,8,8,14,34,46,-12,32
Portadown,7545,10,7,9,14,24,45,-21,30
Ballinamalla,7545,11,5,5,20,26,54,-28,20
Linfield,7546,1,16,8,6,65,32,33,56
Cliftonville,7546,2,16,6,8,56,37,19,54
Crusaders,7546,3,14,7,9,51,39,12,49
Dungannon,7546,4,11,9,10,45,40,5,42
Glenavon,7546,5,10,12,8,40,41,-1,42
Coleraine,7546,6,9,12,9,41,37,4,39
Ballymena,7546,7,10,8,12,50,56,-6,38
Ballinamalla,7546,8,11,5,14,30,41,-11,38
Ards,7546,9,10,6,14,40,49,-9,36
Glentoran,7546,10,7,8,15,23,50,-27,29
Portadown,7546,11,7,7,16,28,47,-19,28
Cliftonville,7547,1,16,6,8,52,36,16,54
Crusaders,7547,2,14,9,7,55,39,16,51
Linfield,7547,3,14,7,9,58,39,19,49
Coleraine,7547,4,13,9,8,48,36,12,48
Glenavon,7547,5,11,10,9,52,46,6,43
Dungannon,7547,6,11,10,9,48,44,4,43
Ballymena,7547,7,11,10,9,54,59,-5,43
Ards,7547,8,10,5,15,48,57,-9,35
Ballinamalla,7547,9,10,3,17,25,46,-21,33
Glentoran,7547,10,7,7,16,31,49,-18,28
Portadown,7547,11,6,8,16,27,47,-20,26
Crusaders,7548,1,15,10,5,53,30,23,55
Linfield,7548,2,15,9,6,68,34,34,54
Ballymena,7548,3,15,6,9,57,53,4,51
Glenavon,7548,4,12,13,5,49,40,9,49
Cliftonville,7548,5,13,5,12,47,41,6,44
Dungannon,7548,6,10,10,10,44,44,0,40
Ards,7548,7,12,4,14,44,49,-5,40
Coleraine,7548,8,10,8,12,39,41,-2,38
Glentoran,7548,9,7,9,14,31,56,-25,30
Portadown,7548,10,7,6,17,26,47,-21,27
Ballinamalla,7548,11,7,4,19,32,55,-23,25
Crusaders,7549,1,19,7,4,63,29,34,64
Linfield,7549,2,15,13,2,62,30,32,58
Ballymena,7549,3,15,7,8,56,51,5,52
Cliftonville,7549,4,14,5,11,53,43,10,47
Coleraine,7549,5,9,14,7,43,39,4,41
Dungannon,7549,6,10,10,10,48,42,6,40
Ballinamalla,7549,7,9,5,16,30,49,-19,32
Glenavon,7549,8,7,9,14,43,59,-16,30
Glentoran,7549,9,6,11,13,29,49,-20,29
Ards,7549,10,7,7,16,34,49,-15,28
Portadown,7549,11,5,10,15,25,46,-21,25
Crusaders,7550,1,18,7,5,63,34,29,61
Linfield,7550,2,14,10,6,64,34,30,52
Ballymena,7550,3,14,7,9,59,55,4,49
Coleraine,7550,4,13,8,9,47,39,8,47
Cliftonville,7550,5,13,6,11,45,40,5,45
Glentoran,7550,6,13,5,12,36,40,-4,44
Glenavon,7550,7,10,7,13,44,54,-10,37
Dungannon,7550,8,9,8,13,52,50,2,35
Ards,7550,9,10,4,16,34,42,-8,34
Ballinamalla,7550,10,9,3,18,29,60,-31,30
Portadown,7550,11,7,5,18,26,51,-25,26
Linfield,7551,1,15,10,5,61,32,29,55
Coleraine,7551,2,14,9,7,51,39,12,51
Cliftonville,7551,3,14,7,9,56,44,12,49
Crusaders,7551,4,13,8,9,50,46,4,47
Ballymena,7551,5,12,10,8,54,55,-1,46
Glenavon,7551,6,11,10,9,52,50,2,43
Dungannon,7551,7,9,11,10,54,46,8,38
Portadown,7551,8,9,8,13,30,41,-11,35
Ards,7551,9,10,3,17,39,52,-13,33
Glentoran,7551,10,8,7,15,32,45,-13,31
Ballinamalla,7551,11,6,5,19,26,55,-29,23
Crusaders,7552,1,19,5,6,56,33,23,62
Cliftonville,7552,2,17,4,9,54,38,16,55
Linfield,7552,3,14,11,5,62,34,28,53
Ballymena,7552,4,15,4,11,54,53,1,49
Coleraine,7552,5,12,9,9,42,39,3,45
Glenavon,7552,6,11,10,9,44,41,3,43
Glentoran,7552,7,11,9,10,42,48,-6,42
Dungannon,7552,8,10,9,11,49,42,7,39
Ballinamalla,7552,9,7,4,19,27,53,-26,25
Ards,7552,10,5,7,18,35,57,-22,22
Portadown,7552,11,5,6,19,19,46,-27,21
Linfield,7553,1,17,10,3,69,26,43,61
Cliftonville,7553,2,18,3,9,66,40,26,57
Crusaders,7553,3,14,8,8,57,40,17,50
Coleraine,7553,4,12,10,8,42,42,0,46
Ballymena,7553,5,14,4,12,54,62,-8,46
Glenavon,7553,6,9,14,7,44,44,0,41
Glentoran,7553,7,10,7,13,33,40,-7,37
Ballinamalla,7553,8,10,3,17,33,51,-18,33
Dungannon,7553,9,7,11,12,41,44,-3,32
Ards,7553,10,9,5,16,40,60,-20,32
Portadown,7553,11,4,7,19,26,56,-30,19
Linfield,7554,1,16,10,4,61,28,33,58
Crusaders,7554,2,15,12,3,57,31,26,57
Cliftonville,7554,3,15,7,8,61,39,22,52
Ballymena,7554,4,14,9,7,57,52,5,51
Glenavon,7554,5,10,11,9,44,42,2,41
Coleraine,7554,6,9,12,9,44,43,1,39
Dungannon,7554,7,10,7,13,52,50,2,37
Glentoran,7554,8,9,8,13,31,49,-18,35
Ards,7554,9,8,5,17,34,51,-17,29
Portadown,7554,10,7,7,16,23,46,-23,28
Ballinamalla,7554,11,7,2,21,22,55,-33,23
Crusaders,7555,1,19,8,3,70,36,34,65
Linfield,7555,2,15,10,5,66,31,35,55
Cliftonville,7555,3,14,4,12,52,43,9,46
Ballymena,7555,4,14,4,12,52,61,-9,46
Glenavon,7555,5,10,14,6,52,48,4,44
Coleraine,7555,6,9,12,9,44,42,2,39
Ballinamalla,7555,7,11,5,14,34,53,-19,38
Dungannon,7555,8,8,11,11,51,45,6,35
Glentoran,7555,9,9,7,14,39,53,-14,34
Portadown,7555,10,7,5,18,28,52,-24,26
Ards,7555,11,6,6,18,34,58,-24,24
Cliftonville,7556,1,18,5,7,60,30,30,59
Crusaders,7556,2,17,8,5,56,34,22,59
Coleraine,7556,3,14,11,5,47,33,14,53
Linfield,7556,4,11,12,7,57,35,22,45
Glenavon,7556,5,11,10,9,47,43,4,43
Ballymena,7556,6,10,9,11,57,65,-8,39
Ards,7556,7,9,7,14,38,49,-11,34
Ballinamalla,7556,8,10,3,17,29,44,-15,33
Glentoran,7556,9,9,6,15,29,49,-20,33
Portadown,7556,10,6,9,15,25,48,-23,27
Dungannon,7556,11,6,8,16,39,54,-15,26
Crusaders,7557,1,19,7,4,56,28,28,64
Cliftonville,7557,2,17,4,9,57,43,14,55
Linfield,7557,3,15,8,7,67,40,27,53
Glenavon,7557,4,11,12,7,53,46,7,45
Glentoran,7557,5,12,7,11,35,39,-4,43
Ballymena,7557,6,12,6,12,47,54,-7,42
Coleraine,7557,7,10,10,10,38,41,-3,40
Dungannon,7557,8,10,8,12,53,49,4,38
Ards,7557,9,7,6,17,32,49,-17,27
Portadown,7557,10,6,8,16,30,49,-19,26
Ballinamalla,7557,11,6,4,20,28,58,-30,22
Crusaders,7558,1,16,9,5,45,30,15,57
Linfield,7558,2,15,10,5,55,27,28,55
Cliftonville,7558,3,15,5,10,51,34,17,50
Coleraine,7558,4,13,10,7,51,42,9,49
Ballymena,7558,5,11,8,11,49,58,-9,41
Ards,7558,6,11,4,15,39,45,-6,37
Dungannon,7558,7,9,8,13,47,48,-1,35
Glenavon,7558,8,8,11,11,46,48,-2,35
Glentoran,7558,9,9,8,13,31,47,-16,35
Portadown,7558,10,9,7,14,25,36,-11,34
Ballinamalla,7558,11,6,6,18,28,52,-24,24
Cliftonville,7559,1,17,7,6,55,31,24,58
Crusaders,7559,2,16,8,6,55,35,20,56
Linfield,7559,3,14,9,7,55,31,24,51
Ballymena,7559,4,13,6,11,59,61,-2,45
Glenavon,7559,5,10,12,8,46,46,0,42
Coleraine,7559,6,11,8,11,37,45,-8,41
Ards,7559,7,10,5,15,38,48,-10,35
Ballinamalla,7559,8,9,8,13,37,49,-12,35
Dungannon,7559,9,7,13,10,44,46,-2,34
Glentoran,7559,10,9,7,14,28,39,-11,34
Portadown,7559,11,5,5,20,23,46,-23,20
Crusaders,7560,1,17,5,8,56,37,19,56
Ballymena,7560,2,17,5,8,71,59,12,56
Cliftonville,7560,3,15,5,10,55,40,15,50
Linfield,7560,4,13,9,8,50,33,17,48
Dungannon,7560,5,12,7,11,51,42,9,43
Glenavon,7560,6,11,10,9,50,47,3,43
Coleraine,7560,7,9,11,10,37,42,-5,38
Glentoran,7560,8,10,5,15,37,50,-13,35
Ards,7560,9,11,2,17,40,54,-14,35
Ballinamalla,7560,10,8,5,17,31,47,-16,29
Portadown,7560,11,8,4,18,27,54,-27,28
Crusaders,7561,1,17,7,6,55,34,21,58
Glenavon,7561,2,17,7,6,58,45,13,58
Ballymena,7561,3,16,6,8,65,58,7,54
Coleraine,7561,4,15,8,7,50,37,13,53
Linfield,7561,5,15,7,8,63,35,28,52
Cliftonville,7561,6,14,5,11,51,44,7,47
Glentoran,7561,7,8,9,13,27,47,-20,33
Dungannon,7561,8,8,8,14,51,49,2,32
Portadown,7561,9,8,6,16,22,44,-22,30
Ballinamalla,7561,10,6,4,20,28,54,-26,22
Ards,7561,11,4,7,19,31,54,-23,19
Crusaders,7562,1,17,9,4,56,33,23,60
Cliftonville,7562,2,17,5,8,52,33,19,56
Ballymena,7562,3,15,4,11,67,65,2,49
Linfield,7562,4,13,8,9,53,33,20,47
Coleraine,7562,5,12,11,7,44,37,7,47
Glenavon,7562,6,10,11,9,49,44,5,41
Ards,7562,7,10,6,14,39,47,-8,36
Glentoran,7562,8,9,8,13,32,44,-12,35
Dungannon,7562,9,8,9,13,47,49,-2,33
Portadown,7562,10,7,6,17,24,48,-24,27
Ballinamalla,7562,11,6,5,19,29,59,-30,23
Crusaders,7563,1,18,7,5,56,37,19,61
Cliftonville,7563,2,16,3,11,59,41,18,51
Coleraine,7563,3,13,9,8,43,41,2,48
Ballymena,7563,4,14,6,10,57,56,1,48
Linfield,7563,5,13,8,9,57,36,21,47
Glenavon,7563,6,11,11,8,53,46,7,44
Dungannon,7563,7,10,7,13,55,56,-1,37
Portadown,7563,8,10,5,15,36,49,-13,35
Glentoran,7563,9,9,8,13,33,47,-14,35
Ballinamalla,7563,10,8,3,19,33,54,-21,27
Ards,7563,11,7,5,18,36,55,-19,26
Crusaders,7564,1,18,5,7,52,27,25,59
Linfield,7564,2,14,10,6,54,28,26,52
Cliftonville,7564,3,15,7,8,53,37,16,52
Glenavon,7564,4,12,14,4,44,35,9,50
Ballymena,7564,5,13,8,9,55,56,-1,47
Coleraine,7564,6,11,11,8,37,31,6,44
Ards,7564,7,10,5,15,40,48,-8,35
Dungannon,7564,8,9,7,14,44,47,-3,34
Ballinamalla,7564,9,9,4,17,34,51,-17,31
Glentoran,7564,10,8,4,18,25,51,-26,28
Portadown,7564,11,6,5,19,23,50,-27,23
Ballymena,7565,1,17,6,7,61,49,12,57
Crusaders,7565,2,15,6,9,57,43,14,51
Linfield,7565,3,13,10,7,57,40,17,49
Coleraine,7565,4,12,12,6,41,35,6,48
Cliftonville,7565,5,13,7,10,51,38,13,46
Dungannon,7565,6,11,11,8,51,37,14,44
Glenavon,7565,7,9,10,11,45,45,0,37
Glentoran,7565,8,9,8,13,33,46,-13,35
Ballinamalla,7565,9,7,8,15,32,54,-22,29
Ards,7565,10,7,6,17,37,51,-14,27
Portadown,7565,11,6,8,16,23,50,-27,26
Linfield,7566,1,15,10,5,62,35,27,55
Cliftonville,7566,2,16,6,8,63,36,27,54
Crusaders,7566,3,15,8,7,55,40,15,53
Ballymena,7566,4,14,7,9,57,56,1,49
Dungannon,7566,5,11,8,11,49,40,9,41
Glenavon,7566,6,9,10,11,45,50,-5,37
Ards,7566,7,9,7,14,45,55,-10,34
Portadown,7566,8,9,7,14,32,45,-13,34
Coleraine,7566,9,7,12,11,36,51,-15,33
Ballinamalla,7566,10,9,5,16,33,54,-21,32
Glentoran,7566,11,8,6,16,31,46,-15,30
Crusaders,7567,1,17,5,8,57,41,16,56
Linfield,7567,2,14,11,5,66,38,28,53
Ballymena,7567,3,15,8,7,65,57,8,53
Glenavon,7567,4,11,12,7,43,38,5,45
Cliftonville,7567,5,12,8,10,57,48,9,44
Coleraine,7567,6,12,8,10,53,50,3,44
Dungannon,7567,7,10,10,10,52,47,5,40
Ards,7567,8,10,7,13,40,46,-6,37
Glentoran,7567,9,7,7,16,29,43,-14,28
Ballinamalla,7567,10,8,3,19,26,53,-27,27
Portadown,7567,11,7,5,18,27,54,-27,26
Crusaders,7568,1,17,10,3,61,34,27,61
Ballymena,7568,2,15,7,8,65,52,13,52
Coleraine,7568,3,13,11,6,40,33,7,50
Cliftonville,7568,4,13,8,9,49,43,6,47
Glenavon,7568,5,11,11,8,46,45,1,44
Linfield,7568,6,11,10,9,57,36,21,43
Ballinamalla,7568,7,11,4,15,38,53,-15,37
Glentoran,7568,8,8,8,14,29,47,-18,32
Dungannon,7568,9,6,11,13,45,52,-7,29
Ards,7568,10,7,7,16,38,52,-14,28
Portadown,7568,11,8,3,19,34,55,-21,27
Crusaders,7569,1,17,6,7,60,42,18,57
Cliftonville,7569,2,15,6,9,53,42,11,51
Glenavon,7569,3,13,10,7,50,41,9,49
Coleraine,7569,4,12,12,6,47,37,10,48
Linfield,7569,5,13,8,9,57,36,21,47
Dungannon,7569,6,13,8,9,53,41,12,47
Ballymena,7569,7,12,8,10,61,62,-1,44
Ards,7569,8,9,4,17,40,56,-16,31
Glentoran,7569,9,6,11,13,35,49,-14,29
Portadown,7569,10,8,5,17,27,49,-22,29
Ballinamalla,7569,11,6,4,20,28,56,-28,22
Crusaders,7570,1,18,8,4,62,28,34,62
Cliftonville,7570,2,15,5,10,52,41,11,50
Ballymena,7570,3,14,6,10,57,64,-7,48
Linfield,7570,4,12,11,7,53,36,17,47
Coleraine,7570,5,12,10,8,39,32,7,46
Glenavon,7570,6,11,9,10,47,48,-1,42
Glentoran,7570,7,9,9,12,31,38,-7,36
Dungannon,7570,8,8,11,11,43,41,2,35
Ards,7570,9,9,7,14,43,51,-8,34
Portadown,7570,10,10,4,16,30,45,-15,34
Ballinamalla,7570,11,5,4,21,22,55,-33,19
Cliftonville,7571,1,16,8,6,52,35,17,56
Crusaders,7571,2,16,6,8,62,33,29,54
Linfield,7571,3,13,9,8,56,30,26,48
Glenavon,7571,4,13,9,8,50,44,6,48
Dungannon,7571,5,11,9,10,50,48,2,42
Coleraine,7571,6,11,9,10,41,39,2,42
Ballymena,7571,7,12,6,12,47,62,-15,42
Glentoran,7571,8,10,9,11,33,33,0,39
Ballinamalla,7571,9,11,4,15,35,53,-18,37
Ards,7571,10,7,3,20,28,52,-24,24
Portadown,7571,11,6,6,18,20,45,-25,24
Crusaders,7572,1,20,5,5,61,31,30,65
Linfield,7572,2,18,7,5,66,27,39,61
Cliftonville,7572,3,15,4,11,54,43,11,49
Coleraine,7572,4,13,9,8,43,41,2,48
Glenavon,7572,5,11,11,8,49,38,11,44
Ballymena,7572,6,12,8,10,54,62,-8,44
Dungannon,7572,7,9,11,10,45,41,4,38
Ards,7572,8,9,4,17,41,59,-18,31
Glentoran,7572,9,7,5,18,27,51,-24,26
Portadown,7572,10,5,10,15,24,42,-18,25
Ballinamalla,7572,11,7,4,19,32,61,-29,25
Linfield,7573,1,16,10,4,71,33,38,58
Crusaders,7573,2,17,6,7,59,37,22,57
Ballymena,7573,3,15,5,10,58,56,2,50
Cliftonville,7573,4,13,5,12,46,48,-2,44
Dungannon,7573,5,10,10,10,53,51,2,40
Coleraine,7573,6,10,10,10,43,41,2,40
Ballinamalla,7573,7,11,4,15,39,49,-10,37
Glentoran,7573,8,11,4,15,39,58,-19,37
Glenavon,7573,9,9,9,12,44,49,-5,36
Portadown,7573,10,8,8,14,35,46,-11,32
Ards,7573,11,7,5,18,33,52,-19,26
Linfield,7574,1,17,7,6,63,31,32,58
Ballymena,7574,2,16,7,7,68,53,15,55
Crusaders,7574,3,15,8,7,53,31,22,53
Coleraine,7574,4,14,9,7,44,30,14,51
Cliftonville,7574,5,12,7,11,55,47,8,43
Glenavon,7574,6,10,13,7,48,42,6,43
Dungannon,7574,7,9,11,10,47,43,4,38
Glentoran,7574,8,9,10,11,34,49,-15,37
Portadown,7574,9,8,3,19,20,50,-30,27
Ards,7574,10,6,7,17,29,52,-23,25
Ballinamalla,7574,11,5,6,19,24,57,-33,21
Linfield,7575,1,18,8,4,59,27,32,62
Crusaders,7575,2,15,9,6,53,36,17,54
Dungannon,7575,3,14,9,7,60,41,19,51
Cliftonville,7575,4,14,5,11,45,38,7,47
Ballymena,7575,5,14,5,11,50,54,-4,47
Coleraine,7575,6,9,12,9,39,36,3,39
Glenavon,7575,7,8,13,9,40,42,-2,37
Glentoran,7575,8,8,8,14,34,44,-10,32
Ballinamalla,7575,9,9,5,16,34,50,-16,32
Ards,7575,10,6,9,15,30,50,-20,27
Portadown,7575,11,7,3,20,25,51,-26,24
Linfield,7576,1,14,10,6,60,31,29,52
Coleraine,7576,2,13,11,6,47,30,17,50
Crusaders,7576,3,14,8,8,45,34,11,50
Ballymena,7576,4,14,8,8,57,51,6,50
Glenavon,7576,5,13,8,9,51,44,7,47
Cliftonville,7576,6,13,5,12,48,42,6,44
Dungannon,7576,7,11,10,9,46,36,10,43
Portadown,7576,8,10,4,16,31,47,-16,34
Glentoran,7576,9,9,5,16,24,50,-26,32
Ards,7576,10,8,6,16,32,47,-15,30
Ballinamalla,7576,11,6,5,19,22,51,-29,23
Crusaders,7577,1,19,6,5,58,33,25,63
Cliftonville,7577,2,16,5,9,58,37,21,53
Linfield,7577,3,13,10,7,55,29,26,49
Ballymena,7577,4,13,7,10,58,58,0,46
Glenavon,7577,5,11,10,9,50,45,5,43
Glentoran,7577,6,12,6,12,33,37,-4,42
Coleraine,7577,7,10,11,9,39,39,0,41
Dungannon,7577,8,9,9,12,49,48,1,36
Ballinamalla,7577,9,10,2,18,31,53,-22,32
Ards,7577,10,8,7,15,31,45,-14,31
Portadown,7577,11,5,5,20,19,57,-38,20
Linfield,7578,1,17,9,4,65,28,37,60
Crusaders,7578,2,18,6,6,60,33,27,60
Glenavon,7578,3,13,8,9,55,50,5,47
Ballymena,7578,4,12,8,10,58,65,-7,44
Dungannon,7578,5,11,8,11,51,49,2,41
Cliftonville,7578,6,12,4,14,49,53,-4,40
Coleraine,7578,7,10,9,11,43,39,4,39
Ards,7578,8,9,6,15,38,52,-14,33
Ballinamalla,7578,9,9,6,15,34,52,-18,33
Glentoran,7578,10,8,8,14,32,46,-14,32
Portadown,7578,11,6,8,16,30,48,-18,26
Glenavon,7579,1,13,13,4,48,39,9,52
Crusaders,7579,2,14,9,7,52,36,16,51
Ballymena,7579,3,15,5,10,57,58,-1,50
Cliftonville,7579,4,13,8,9,49,36,13,47
Linfield,7579,5,11,11,8,53,37,16,44
Coleraine,7579,6,11,11,8,41,35,6,44
Dungannon,7579,7,11,6,13,45,42,3,39
Ballinamalla,7579,8,12,3,15,33,43,-10,39
Glentoran,7579,9,8,8,14,30,45,-15,32
Ards,7579,10,8,4,18,35,51,-16,28
Portadown,7579,11,6,8,16,29,50,-21,26
Linfield,7580,1,16,10,4,64,29,35,58
Crusaders,7580,2,16,8,6,52,32,20,56
Ballymena,7580,3,15,3,12,64,63,1,48
Glenavon,7580,4,12,11,7,49,39,10,47
Coleraine,7580,5,12,9,9,43,38,5,45
Cliftonville,7580,6,13,5,12,45,40,5,44
Ballinamalla,7580,7,13,2,15,41,49,-8,41
Dungannon,7580,8,8,12,10,48,43,5,36
Glentoran,7580,9,9,7,14,32,50,-18,34
Portadown,7580,10,7,5,18,20,50,-30,26
Ards,7580,11,5,6,19,36,61,-25,21
Crusaders,7581,1,18,4,8,53,41,12,58
Cliftonville,7581,2,17,2,11,54,38,16,53
Glenavon,7581,3,14,9,7,46,38,8,51
Ballymena,7581,4,15,5,10,55,52,3,50
Linfield,7581,5,13,10,7,53,31,22,49
Ards,7581,6,12,6,12,41,45,-4,42
Coleraine,7581,7,9,11,10,36,38,-2,38
Dungannon,7581,8,10,7,13,55,50,5,37
Glentoran,7581,9,8,10,12,26,39,-13,34
Portadown,7581,10,6,8,16,25,43,-18,26
Ballinamalla,7581,11,5,4,21,25,54,-29,19
Crusaders,7582,1,18,5,7,59,34,25,59
Linfield,7582,2,15,12,3,60,27,33,57
Ballymena,7582,3,15,6,9,64,61,3,51
Cliftonville,7582,4,14,8,8,50,39,11,50
Coleraine,7582,5,10,12,8,44,39,5,42
Dungannon,7582,6,11,9,10,48,45,3,42
Glenavon,7582,7,7,14,9,44,48,-4,35
Ards,7582,8,8,8,14,39,47,-8,32
Portadown,7582,9,8,4,18,26,46,-20,28
Ballinamalla,7582,10,7,6,17,30,54,-24,27
Glentoran,7582,11,5,10,15,26,50,-24,25
Linfield,7583,1,14,9,7,65,40,25,51
Coleraine,7583,2,14,9,7,45,35,10,51
Crusaders,7583,3,14,7,9,55,43,12,49
Cliftonville,7583,4,15,3,12,55,42,13,48
Dungannon,7583,5,12,10,8,58,40,18,46
Ballymena,7583,6,11,9,10,58,70,-12,42
Ards,7583,7,11,5,14,41,51,-10,38
Glentoran,7583,8,9,8,13,36,41,-5,35
Portadown,7583,9,9,5,16,29,49,-20,32
Glenavon,7583,10,7,10,13,43,55,-12,31
Ballinamalla,7583,11,8,7,15,29,48,-19,31
Linfield,7584,1,15,10,5,64,30,34,55
Cliftonville,7584,2,17,3,10,55,38,17,54
Crusaders,7584,3,15,7,8,58,44,14,52
Coleraine,7584,4,12,12,6,42,38,4,48
Glenavon,7584,5,10,11,9,51,50,1,41
Ballymena,7584,6,11,8,11,57,67,-10,41
Glentoran,7584,7,11,6,13,35,42,-7,39
Portadown,7584,8,9,6,15,29,44,-15,33
Dungannon,7584,9,7,10,13,52,54,-2,31
Ballinamalla,7584,10,8,6,16,37,58,-21,30
Ards,7584,11,7,7,16,33,48,-15,28
Crusaders,7585,1,16,6,8,48,32,16,54
Ballymena,7585,2,16,5,9,59,54,5,53
Cliftonville,7585,3,16,3,11,49,34,15,51
Linfield,7585,4,14,7,9,60,41,19,49
Glenavon,7585,5,13,10,7,53,44,9,49
Coleraine,7585,6,13,9,8,46,36,10,48
Glentoran,7585,7,11,5,14,38,49,-11,38
Dungannon,7585,8,10,6,14,50,48,2,36
Portadown,7585,9,10,6,14,29,43,-14,36
Ballinamalla,7585,10,8,2,20,30,61,-31,26
Ards,7585,11,6,5,19,37,57,-20,23
Crusaders,7586,1,19,8,3,53,26,27,65
Linfield,7586,2,18,9,3,70,29,41,63
Cliftonville,7586,3,13,5,12,43,39,4,44
Coleraine,7586,4,11,10,9,40,37,3,43
Glenavon,7586,5,10,10,10,49,50,-1,40
Ballymena,7586,6,12,4,14,48,61,-13,40
Dungannon,7586,7,9,11,10,55,45,10,38
Glentoran,7586,8,9,10,11,30,38,-8,37
Portadown,7586,9,9,4,17,25,42,-17,31
Ballinamalla,7586,10,9,2,19,29,53,-24,29
Ards,7586,11,8,3,19,33,55,-22,27
Crusaders,7587,1,18,7,5,56,32,24,61
Linfield,7587,2,13,10,7,58,35,23,49
Cliftonville,7587,3,14,5,11,53,42,11,47
Glenavon,7587,4,12,10,8,54,42,12,46
Coleraine,7587,5,11,11,8,37,36,1,44
Dungannon,7587,6,9,11,10,47,45,2,38
Ballymena,7587,7,10,5,15,49,62,-13,35
Glentoran,7587,8,9,8,13,35,51,-16,35
Ards,7587,9,8,9,13,36,49,-13,33
Ballinamalla,7587,10,8,7,15,29,44,-15,31
Portadown,7587,11,7,9,14,26,42,-16,30
Crusaders,7588,1,17,10,3,55,27,28,61
Cliftonville,7588,2,16,5,9,54,41,13,53
Linfield,7588,3,14,10,6,62,37,25,52
Coleraine,7588,4,12,10,8,46,38,8,46
Glentoran,7588,5,13,4,13,39,42,-3,43
Dungannon,7588,6,10,10,10,53,42,11,40
Ballymena,7588,7,11,7,12,50,61,-11,40
Glenavon,7588,8,9,12,9,54,61,-7,39
Ards,7588,9,9,6,15,41,50,-9,33
Portadown,7588,10,5,8,17,24,51,-27,23
Ballinamalla,7588,11,6,4,20,30,58,-28,22
Linfield,7589,1,14,8,8,57,37,20,50
Crusaders,7589,2,14,8,8,52,37,15,50
Ballymena,7589,3,15,5,10,60,56,4,50
Cliftonville,7589,4,14,7,9,46,33,13,49
Coleraine,7589,5,12,11,7,41,38,3,47
Dungannon,7589,6,11,9,10,58,46,12,42
Glenavon,7589,7,8,12,10,43,49,-6,36
Portadown,7589,8,9,7,14,35,45,-10,34
Glentoran,7589,9,8,8,14,32,46,-14,32
Ballinamalla,7589,10,9,5,16,31,54,-23,32
Ards,7589,11,9,4,17,36,50,-14,31
Linfield,7590,1,17,6,7,59,33,26,57
Crusaders,7590,2,17,6,7,57,39,18,57
Cliftonville,7590,3,15,8,7,57,39,18,53
Coleraine,7590,4,12,12,6,40,31,9,48
Ballymena,7590,5,13,8,9,58,61,-3,47
Glenavon,7590,6,11,13,6,44,34,10,46
Glentoran,7590,7,10,7,13,33,43,-10,37
Dungannon,7590,8,9,7,14,52,51,1,34
Ards,7590,9,8,3,19,41,56,-15,27
Portadown,7590,10,7,5,18,26,52,-26,26
Ballinamalla,7590,11,5,7,18,23,51,-28,22
Crusaders,7591,1,21,5,4,68,26,42,68
Cliftonville,7591,2,16,5,9,47,36,11,53
Linfield,7591,3,15,7,8,56,34,22,52
Ballymena,7591,4,15,6,9,63,51,12,51
Glenavon,7591,5,12,10,8,47,37,10,46
Dungannon,7591,6,11,8,11,45,46,-1,41
Coleraine,7591,7,10,7,13,39,44,-5,37
Glentoran,7591,8,8,7,15,28,49,-21,31
Ards,7591,9,9,2,19,38,60,-22,29
Portadown,7591,10,7,6,17,31,53,-22,27
Ballinamalla,7591,11,7,5,18,32,58,-26,26
Linfield,7592,1,16,6,8,64,34,30,54
Cliftonville,7592,2,17,3,10,59,34,25,54
Crusaders,7592,3,16,6,8,54,40,14,54
Dungannon,7592,4,14,7,9,65,40,25,49
Ballymena,7592,5,12,6,12,48,59,-11,42
Glenavon,7592,6,10,10,10,45,44,1,40
Coleraine,7592,7,10,9,11,39,42,-3,39
Ballinamalla,7592,8,12,3,15,36,51,-15,39
Portadown,7592,9,11,3,16,32,47,-15,36
Glentoran,7592,10,9,5,16,30,53,-23,32
Ards,7592,11,6,6,18,32,60,-28,24
Cliftonville,7593,1,17,5,8,55,37,18,56
Crusaders,7593,2,16,6,8,48,37,11,54
Ballymena,7593,3,14,7,9,58,51,7,49
Glenavon,7593,4,12,12,6,48,38,10,48
Linfield,7593,5,12,7,11,51,39,12,43
Glentoran,7593,6,11,6,13,38,44,-6,39
Portadown,7593,7,11,6,13,30,38,-8,39
Coleraine,7593,8,9,11,10,42,40,2,38
Dungannon,7593,9,8,7,15,49,59,-10,31
Ards,7593,10,8,6,16,33,51,-18,30
Ballinamalla,7593,11,7,7,16,30,48,-18,28
Crusaders,7594,1,18,8,4,63,31,32,62
Cliftonville,7594,2,17,7,6,60,32,28,58
Linfield,7594,3,13,10,7,54,31,23,49
Glenavon,7594,4,13,9,8,49,37,12,48
Ballymena,7594,5,14,4,12,54,60,-6,46
Coleraine,7594,6,11,9,10,44,51,-7,42
Dungannon,7594,7,10,9,11,52,43,9,39
Glentoran,7594,8,10,5,15,35,55,-20,35
Ards,7594,9,9,4,17,37,58,-21,31
Portadown,7594,10,6,6,18,28,51,-23,24
Ballinamalla,7594,11,7,3,20,28,55,-27,24
Crusaders,7595,1,18,8,4,55,30,25,62
Cliftonville,7595,2,15,8,7,55,34,21,53
Linfield,7595,3,13,13,4,58,29,29,52
Glenavon,7595,4,12,11,7,55,43,12,47
Ballymena,7595,5,12,7,11,53,62,-9,43
Coleraine,7595,6,10,11,9,36,37,-1,41
Glentoran,7595,7,8,10,12,30,41,-11,34
Dungannon,7595,8,7,10,13,41,47,-6,31
Ards,7595,9,8,7,15,36,47,-11,31
Portadown,7595,10,6,8,16,27,49,-22,26
Ballinamalla,7595,11,7,5,18,32,59,-27,26
Crusaders,7596,1,17,8,5,60,32,28,59
Ballymena,7596,2,16,7,7,64,54,10,55
Linfield,7596,3,14,10,6,59,31,28,52
Cliftonville,7596,4,14,7,9,54,40,14,49
Coleraine,7596,5,12,8,10,44,43,1,44
Glenavon,7596,6,12,7,11,46,47,-1,43
Glentoran,7596,7,11,7,12,35,41,-6,40
Portadown,7596,8,10,5,15,35,50,-15,35
Dungannon,7596,9,8,8,14,45,49,-4,32
Ards,7596,10,8,5,17,39,57,-18,29
Ballinamalla,7596,11,6,2,22,27,64,-37,20
Crusaders,7597,1,18,7,5,63,31,32,61
Ballymena,7597,2,16,5,9,61,56,5,53
Dungannon,7597,3,12,10,8,54,45,9,46
Linfield,7597,4,12,9,9,54,31,23,45
Cliftonville,7597,5,13,5,12,47,47,0,44
Glenavon,7597,6,10,13,7,50,49,1,43
Coleraine,7597,7,10,10,10,42,40,2,40
Portadown,7597,8,10,5,15,33,47,-14,35
Ards,7597,9,8,7,15,38,53,-15,31
Glentoran,7597,10,8,7,15,30,45,-15,31
Ballinamalla,7597,11,7,4,19,25,53,-28,25
Crusaders,7598,1,20,5,5,60,29,31,65
Linfield,7598,2,16,10,4,57,27,30,58
Coleraine,7598,3,16,9,5,55,35,20,57
Cliftonville,7598,4,16,5,9,50,37,13,53
Ballymena,7598,5,15,4,11,57,52,5,49
Dungannon,7598,6,9,11,10,46,38,8,38
Glenavon,7598,7,9,10,11,45,50,-5,37
Glentoran,7598,8,8,7,15,26,47,-21,31
Portadown,7598,9,6,6,18,19,50,-31,24
Ards,7598,10,6,5,19,32,53,-21,23
Ballinamalla,7598,11,6,4,20,22,51,-29,22
Linfield,7599,1,15,9,6,64,29,35,54
Glenavon,7599,2,14,10,6,43,31,12,52
Crusaders,7599,3,14,7,9,51,37,14,49
Coleraine,7599,4,12,10,8,35,36,-1,46
Ballymena,7599,5,13,7,10,56,58,-2,46
Cliftonville,7599,6,14,3,13,46,40,6,45
Dungannon,7599,7,12,8,10,64,49,15,44
Ards,7599,8,11,5,14,41,49,-8,38
Portadown,7599,9,7,8,15,27,43,-16,29
Glentoran,7599,10,7,7,16,23,49,-26,28
Ballinamalla,7599,11,7,4,19,23,52,-29,25
Crusaders,7600,1,18,6,6,62,39,23,60
Cliftonville,7600,2,16,5,9,51,38,13,53
Linfield,7600,3,12,12,6,55,29,26,48
Coleraine,7600,4,11,13,6,43,36,7,46
Ballymena,7600,5,12,7,11,58,59,-1,43
Glenavon,7600,6,10,12,8,48,46,2,42
Dungannon,7600,7,9,10,11,43,37,6,37
Ards,7600,8,9,5,16,42,57,-15,32
Glentoran,7600,9,7,10,13,28,47,-19,31
Ballinamalla,7600,10,7,9,14,31,44,-13,30
Portadown,7600,11,6,7,17,21,50,-29,25
Linfield,7601,1,17,9,4,65,30,35,60
Glenavon,7601,2,14,11,5,55,40,15,53
Crusaders,7601,3,14,7,9,53,39,14,49
Cliftonville,7601,4,13,9,8,58,42,16,48
Coleraine,7601,5,11,11,8,46,38,8,44
Ballymena,7601,6,11,9,10,61,64,-3,42
Dungannon,7601,7,10,8,12,50,51,-1,38
Ards,7601,8,11,5,14,36,46,-10,38
Ballinamalla,7601,9,10,3,17,33,52,-19,33
Glentoran,7601,10,7,8,15,36,55,-19,29
Portadown,7601,11,5,4,21,21,57,-36,19
Cliftonville,7602,1,15,5,10,59,43,16,50
Crusaders,7602,2,13,11,6,51,35,16,50
Dungannon,7602,3,12,12,6,49,37,12,48
Coleraine,7602,4,11,13,6,48,41,7,46
Linfield,7602,5,11,12,7,59,36,23,45
Glenavon,7602,6,11,12,7,48,43,5,45
Glentoran,7602,7,9,9,12,35,47,-12,36
Ballymena,7602,8,9,9,12,52,65,-13,36
Ballinamalla,7602,9,8,8,14,33,46,-13,32
Ards,7602,10,9,4,17,31,50,-19,31
Portadown,7602,11,6,7,17,28,50,-22,25
Cliftonville,7603,1,17,6,7,51,33,18,57
Crusaders,7603,2,14,10,6,46,29,17,52
Linfield,7603,3,13,8,9,51,31,20,47
Ballymena,7603,4,13,8,9,55,50,5,47
Glenavon,7603,5,9,14,7,44,42,2,41
Coleraine,7603,6,9,13,8,34,33,1,40
Ards,7603,7,11,5,14,38,44,-6,38
Glentoran,7603,8,9,8,13,28,43,-15,35
Dungannon,7603,9,7,10,13,44,44,0,31
Portadown,7603,10,6,11,13,27,45,-18,29
Ballinamalla,7603,11,8,5,17,28,52,-24,29
Crusaders,7604,1,21,6,3,64,30,34,69
Linfield,7604,2,17,9,4,56,21,35,60
Coleraine,7604,3,12,10,8,48,39,9,46
Cliftonville,7604,4,12,6,12,53,41,12,42
Glenavon,7604,5,11,9,10,49,52,-3,42
Portadown,7604,6,12,6,12,29,38,-9,42
Ballymena,7604,7,11,5,14,52,68,-16,38
Dungannon,7604,8,10,7,13,54,49,5,37
Ards,7604,9,7,8,15,32,42,-10,29
Glentoran,7604,10,7,8,15,23,49,-26,29
Ballinamalla,7604,11,7,2,21,34,65,-31,23
Linfield,7605,1,17,8,5,57,23,34,59
Ballymena,7605,2,16,7,7,59,49,10,55
Crusaders,7605,3,15,8,7,59,37,22,53
Cliftonville,7605,4,14,5,11,54,45,9,47
Glenavon,7605,5,10,12,8,42,46,-4,42
Coleraine,7605,6,11,8,11,44,43,1,41
Ards,7605,7,11,5,14,40,48,-8,38
Glentoran,7605,8,10,7,13,23,39,-16,37
Dungannon,7605,9,8,12,10,40,36,4,36
Portadown,7605,10,7,5,18,22,48,-26,26
Ballinamalla,7605,11,6,3,21,25,51,-26,21
Crusaders,7606,1,19,7,4,66,36,30,64
Linfield,7606,2,16,9,5,59,28,31,57
Cliftonville,7606,3,16,5,9,50,39,11,53
Coleraine,7606,4,14,9,7,51,37,14,51
Dungannon,7606,5,11,10,9,46,34,12,43
Glenavon,7606,6,10,11,9,43,45,-2,41
Glentoran,7606,7,9,10,11,32,43,-11,37
Ballymena,7606,8,9,5,16,51,67,-16,32
Portadown,7606,9,6,8,16,24,42,-18,26
Ards,7606,10,7,5,18,33,60,-27,26
Ballinamalla,7606,11,6,5,19,26,50,-24,23
Crusaders,7607,1,16,8,6,60,33,27,56
Coleraine,7607,2,13,11,6,51,37,14,50
Linfield,7607,3,13,9,8,57,41,16,48
Cliftonville,7607,4,14,6,10,49,41,8,48
Ballymena,7607,5,14,5,11,52,54,-2,47
Dungannon,7607,6,12,8,10,54,44,10,44
Glenavon,7607,7,9,14,7,52,52,0,41
Ballinamalla,7607,8,10,2,18,32,53,-21,32
Glentoran,7607,9,7,8,15,28,45,-17,29
Portadown,7607,9,7,8,15,28,45,-17,29
Ards,7607,11,6,9,15,33,51,-18,27
Crusaders,7608,1,16,7,7,54,35,19,55
Linfield,7608,2,13,10,7,57,30,27,49
Coleraine,7608,3,13,9,8,49,38,11,48
Glenavon,7608,4,12,10,8,48,46,2,46
Ballymena,7608,5,13,5,12,57,61,-4,44
Glentoran,7608,6,12,6,12,35,45,-10,42
Cliftonville,7608,7,12,3,15,52,53,-1,39
Portadown,7608,8,11,4,15,24,39,-15,37
Dungannon,7608,9,8,9,13,48,50,-2,33
Ards,7608,10,9,6,15,37,50,-13,33
Ballinamalla,7608,11,9,5,16,32,46,-14,32
Linfield,7609,1,16,8,6,59,31,28,56
Cliftonville,7609,2,17,5,8,51,39,12,56
Crusaders,7609,3,15,8,7,51,33,18,53
Glenavon,7609,4,12,10,8,48,43,5,46
Coleraine,7609,5,9,13,8,38,35,3,40
Ballymena,7609,6,11,7,12,57,56,1,40
Dungannon,7609,7,10,9,11,55,48,7,39
Ards,7609,8,10,7,13,43,49,-6,37
Glentoran,7609,9,7,11,12,28,40,-12,32
Portadown,7609,10,8,7,15,20,40,-20,31
Ballinamalla,7609,11,5,5,20,29,65,-36,20
Linfield,7610,1,14,10,6,61,30,31,52
Crusaders,7610,2,14,10,6,64,40,24,52
Glenavon,7610,3,13,10,7,46,40,6,49
Cliftonville,7610,4,15,4,11,44,42,2,49
Coleraine,7610,5,11,12,7,47,35,12,45
Glentoran,7610,6,10,8,12,34,46,-12,38
Ballymena,7610,7,10,7,13,50,65,-15,37
Dungannon,7610,8,9,8,13,53,53,0,35
Ards,7610,9,10,4,16,38,50,-12,34
Portadown,7610,10,8,7,15,25,40,-15,31
Ballinamalla,7610,11,8,6,16,30,51,-21,30
Linfield,7611,1,15,11,4,63,30,33,56
Ballymena,7611,2,15,9,6,61,53,8,54
Crusaders,7611,3,15,8,7,51,36,15,53
Cliftonville,7611,4,16,3,11,50,42,8,51
Dungannon,7611,5,11,9,10,51,38,13,42
Glenavon,7611,6,10,12,8,46,45,1,42
Coleraine,7611,7,10,10,10,40,41,-1,40
Glentoran,7611,8,8,8,14,35,45,-10,32
Ards,7611,9,8,6,16,43,57,-14,30
Portadown,7611,10,8,3,19,29,55,-26,27
Ballinamalla,7611,11,8,3,19,31,58,-27,27
Crusaders,7612,1,16,9,5,67,40,27,57
Linfield,7612,2,15,10,5,55,29,26,55
Coleraine,7612,3,12,12,6,46,32,14,48
Cliftonville,7612,4,13,6,11,52,45,7,45
Ballymena,7612,5,11,10,9,56,59,-3,43
Glenavon,7612,6,8,13,9,42,49,-7,37
Portadown,7612,7,10,6,14,33,41,-8,36
Glentoran,7612,8,9,9,12,38,50,-12,36
Dungannon,7612,9,8,9,13,44,46,-2,33
Ards,7612,10,7,8,15,33,54,-21,29
Ballinamalla,7612,11,8,4,18,35,56,-21,28
Crusaders,7613,1,16,8,6,61,34,27,56
Cliftonville,7613,2,15,7,8,57,41,16,52
Linfield,7613,3,13,11,6,63,39,24,50
Coleraine,7613,4,12,10,8,48,38,10,46
Ballymena,7613,5,12,9,9,60,59,1,45
Dungannon,7613,6,10,12,8,53,41,12,42
Glentoran,7613,7,10,9,11,32,39,-7,39
Glenavon,7613,8,8,11,11,44,58,-14,35
Ards,7613,9,8,7,15,35,47,-12,31
Portadown,7613,10,8,5,17,26,49,-23,29
Ballinamalla,7613,11,5,7,18,23,57,-34,22
Crusaders,7614,1,15,7,8,56,37,19,52
Cliftonville,7614,2,15,5,10,56,38,18,50
Glenavon,7614,3,13,10,7,52,45,7,49
Coleraine,7614,4,12,11,7,48,36,12,47
Ballymena,7614,5,13,7,10,58,61,-3,46
Linfield,7614,6,12,9,9,57,35,22,45
Dungannon,7614,7,12,9,9,53,41,12,45
Glentoran,7614,8,9,7,14,35,50,-15,34
Portadown,7614,9,9,6,15,29,45,-16,33
Ards,7614,10,9,3,18,32,59,-27,30
Ballinamalla,7614,11,8,2,20,28,57,-29,26
Crusaders,7615,1,18,7,5,58,36,22,61
Linfield,7615,2,13,10,7,54,35,19,49
Glenavon,7615,3,13,10,7,55,45,10,49
Ballymena,7615,4,14,6,10,55,56,-1,48
Cliftonville,7615,5,13,6,11,50,44,6,45
Dungannon,7615,6,11,10,9,58,46,12,43
Coleraine,7615,7,10,10,10,43,37,6,40
Glentoran,7615,8,11,6,13,36,49,-13,39
Ards,7615,9,9,4,17,37,50,-13,31
Ballinamalla,7615,10,9,4,17,32,52,-20,31
Portadown,7615,11,5,5,20,23,51,-28,20
Crusaders,7616,1,15,8,7,54,36,18,53
Cliftonville,7616,2,16,4,10,52,43,9,52
Glenavon,7616,3,14,8,8,54,41,13,50
Linfield,7616,4,13,9,8,56,37,19,48
Ballymena,7616,5,12,6,12,48,54,-6,42
Coleraine,7616,6,10,10,10,37,36,1,40
Dungannon,7616,7,10,8,12,49,48,1,38
Glentoran,7616,8,10,7,13,33,45,-12,37
Ards,7616,9,10,6,14,38,43,-5,36
Ballinamalla,7616,10,8,7,15,27,46,-19,31
Portadown,7616,11,7,7,16,29,48,-19,28
Crusaders,7617,1,19,7,4,62,31,31,64
Linfield,7617,2,17,6,7,66,34,32,57
Coleraine,7617,3,13,10,7,45,28,17,49
Ballymena,7617,4,14,6,10,62,59,3,48
Cliftonville,7617,5,13,5,12,47,49,-2,44
Glenavon,7617,6,10,10,10,41,47,-6,40
Dungannon,7617,7,9,10,11,46,41,5,37
Ballinamalla,7617,8,10,3,17,31,53,-22,33
Portadown,7617,9,8,5,17,32,50,-18,29
Ards,7617,10,8,5,17,31,50,-19,29
Glentoran,7617,11,8,5,17,27,48,-21,29
Ballymena,7618,1,17,6,7,63,48,15,57
Crusaders,7618,2,14,10,6,53,35,18,52
Coleraine,7618,3,14,10,6,53,37,16,52
Cliftonville,7618,4,13,6,11,46,43,3,45
Linfield,7618,5,10,13,7,55,36,19,43
Glenavon,7618,6,9,10,11,44,51,-7,37
Ballinamalla,7618,7,11,4,15,32,47,-15,37
Dungannon,7618,8,9,7,14,49,46,3,34
Glentoran,7618,9,6,14,10,33,45,-12,32
Ards,7618,10,9,5,16,37,52,-15,32
Portadown,7618,11,8,5,17,27,52,-25,29
Crusaders,7619,1,18,9,3,61,35,26,63
Linfield,7619,2,14,11,5,60,32,28,53
Cliftonville,7619,3,14,6,10,49,38,11,48
Coleraine,7619,4,11,11,8,51,39,12,44
Ballymena,7619,5,12,8,10,53,55,-2,44
Glenavon,7619,6,10,12,8,47,47,0,42
Dungannon,7619,7,9,11,10,50,44,6,38
Glentoran,7619,8,10,8,12,33,41,-8,38
Ards,7619,9,8,5,17,33,51,-18,29
Ballinamalla,7619,10,8,4,18,25,53,-28,28
Portadown,7619,11,6,5,19,26,53,-27,23
Crusaders,7620,1,16,6,8,57,38,19,54
Cliftonville,7620,2,15,5,10,59,39,20,50
Linfield,7620,3,13,10,7,51,28,23,49
Glenavon,7620,4,13,10,7,49,41,8,49
Ballymena,7620,5,15,4,11,53,55,-2,49
Coleraine,7620,6,11,10,9,46,48,-2,43
Dungannon,7620,7,9,10,11,48,49,-1,37
Portadown,7620,8,10,4,16,32,44,-12,34
Ards,7620,9,8,7,15,34,47,-13,31
Ballinamalla,7620,10,9,4,17,26,45,-19,31
Glentoran,7620,11,7,8,15,24,45,-21,29
Ballymena,7621,1,17,4,9,60,50,10,55
Linfield,7621,2,14,11,5,62,36,26,53
Crusaders,7621,3,15,8,7,60,39,21,53
Coleraine,7621,4,12,11,7,45,36,9,47
Glenavon,7621,5,12,11,7,52,47,5,47
Cliftonville,7621,6,12,8,10,49,47,2,44
Dungannon,7621,7,11,8,11,51,41,10,41
Glentoran,7621,8,10,7,13,35,46,-11,37
Ards,7621,9,7,7,16,36,52,-16,28
Ballinamalla,7621,10,7,5,18,28,52,-24,26
Portadown,7621,11,6,4,20,28,60,-32,22
Crusaders,7622,1,18,8,4,65,36,29,62
Linfield,7622,2,14,12,4,61,32,29,54
Coleraine,7622,3,14,8,8,41,36,5,50
Dungannon,7622,4,14,7,9,53,37,16,49
Cliftonville,7622,5,14,6,10,51,40,11,48
Ballymena,7622,6,11,8,11,53,58,-5,41
Glenavon,7622,7,9,11,10,41,49,-8,38
Glentoran,7622,8,8,7,15,29,44,-15,31
Ballinamalla,7622,9,7,7,16,30,48,-18,28
Portadown,7622,10,7,6,17,23,48,-25,27
Ards,7622,11,6,6,18,27,46,-19,24
Crusaders,7623,1,16,6,8,55,39,16,54
Coleraine,7623,2,14,10,6,47,32,15,52
Cliftonville,7623,3,16,3,11,47,39,8,51
Ballymena,7623,4,14,6,10,61,59,2,48
Linfield,7623,5,11,11,8,58,38,20,44
Glenavon,7623,6,11,10,9,52,46,6,43
Portadown,7623,7,11,5,14,35,44,-9,38
Glentoran,7623,8,10,7,13,33,46,-13,37
Dungannon,7623,9,8,7,15,43,55,-12,31
Ards,7623,10,8,6,16,39,50,-11,30
Ballinamalla,7623,11,8,5,17,35,57,-22,29
Cliftonville,7624,1,18,5,7,58,34,24,59
Crusaders,7624,2,14,9,7,52,34,18,51
Ballymena,7624,3,13,7,10,59,58,1,46
Coleraine,7624,4,10,12,8,44,44,0,42
Dungannon,7624,5,11,8,11,52,44,8,41
Ards,7624,6,12,5,13,42,45,-3,41
Glenavon,7624,7,10,11,9,41,46,-5,41
Linfield,7624,8,9,10,11,54,43,11,37
Ballinamalla,7624,9,9,6,15,33,49,-16,33
Portadown,7624,10,10,3,17,32,48,-16,33
Glentoran,7624,11,7,8,15,26,48,-22,29
Crusaders,7625,1,15,9,6,59,38,21,54
Linfield,7625,2,15,7,8,65,33,32,52
Ballymena,7625,3,13,9,8,52,50,2,48
Cliftonville,7625,4,13,7,10,49,42,7,46
Coleraine,7625,5,11,10,9,41,35,6,43
Glenavon,7625,6,9,13,8,45,47,-2,40
Glentoran,7625,7,11,7,12,37,49,-12,40
Dungannon,7625,8,8,10,12,48,49,-1,34
Ards,7625,9,9,6,15,36,48,-12,33
Ballinamalla,7625,10,9,4,17,36,55,-19,31
Portadown,7625,11,8,6,16,22,44,-22,30
Crusaders,7626,1,15,8,7,59,38,21,53
Linfield,7626,2,14,9,7,56,39,17,51
Glenavon,7626,3,13,11,6,52,40,12,50
Cliftonville,7626,4,14,6,10,50,38,12,48
Ballymena,7626,5,12,8,10,50,53,-3,44
Dungannon,7626,6,10,11,9,50,45,5,41
Portadown,7626,7,12,5,13,36,39,-3,41
Coleraine,7626,8,10,9,11,41,51,-10,39
Ards,7626,9,8,7,15,50,53,-3,31
Glentoran,7626,10,6,9,15,28,48,-20,27
Ballinamalla,7626,11,7,5,18,27,55,-28,26
Coleraine,7627,1,16,9,5,56,34,22,57
Crusaders,7627,2,15,9,6,56,36,20,54
Linfield,7627,3,14,9,7,58,34,24,51
Ballymena,7627,4,14,8,8,57,51,6,50
Glenavon,7627,5,12,10,8,48,41,7,46
Cliftonville,7627,6,12,7,11,46,41,5,43
Dungannon,7627,7,10,10,10,53,45,8,40
Ards,7627,8,10,5,15,40,48,-8,35
Glentoran,7627,9,7,9,14,28,50,-22,30
Ballinamalla,7627,10,7,4,19,25,52,-27,25
Portadown,7627,11,6,4,20,23,58,-35,22
Crusaders,7628,1,18,4,8,55,33,22,58
Cliftonville,7628,2,17,4,9,55,38,17,55
Linfield,7628,3,13,10,7,52,28,24,49
Glenavon,7628,4,12,12,6,47,40,7,48
Coleraine,7628,5,11,10,9,36,37,-1,43
Ballymena,7628,6,11,8,11,53,61,-8,41
Dungannon,7628,7,9,11,10,51,44,7,38
Portadown,7628,8,10,5,15,32,42,-10,35
Ballinamalla,7628,9,9,8,13,31,46,-15,35
Ards,7628,10,7,6,17,29,45,-16,27
Glentoran,7628,11,6,6,18,23,50,-27,24
Crusaders,7629,1,17,8,5,60,39,21,59
Glenavon,7629,2,15,9,6,53,40,13,54
Cliftonville,7629,3,15,5,10,49,39,10,50
Linfield,7629,4,12,11,7,49,28,21,47
Ballymena,7629,5,12,8,10,59,58,1,44
Coleraine,7629,6,10,11,9,42,39,3,41
Ballinamalla,7629,7,9,7,14,37,50,-13,34
Glentoran,7629,8,9,7,14,36,50,-14,34
Dungannon,7629,9,7,10,13,44,50,-6,31
Ards,7629,10,8,6,16,38,51,-13,30
Portadown,7629,11,8,4,18,24,47,-23,28
Cliftonville,7630,1,17,4,9,52,35,17,55
Linfield,7630,2,14,11,5,55,29,26,53
Crusaders,7630,3,15,7,8,54,39,15,52
Coleraine,7630,4,13,12,5,47,36,11,51
Glenavon,7630,5,14,8,8,50,44,6,50
Ballymena,7630,6,14,6,10,58,61,-3,48
Dungannon,7630,7,12,7,11,55,49,6,43
Ards,7630,8,9,3,18,37,48,-11,30
Glentoran,7630,9,6,8,16,30,48,-18,26
Ballinamalla,7630,10,7,5,18,29,53,-24,26
Portadown,7630,11,6,5,19,25,50,-25,23
Crusaders,7631,1,17,7,6,58,33,25,58
Cliftonville,7631,2,17,4,9,52,35,17,55
Linfield,7631,3,15,8,7,60,30,30,53
Ballymena,7631,4,16,5,9,64,58,6,53
Dungannon,7631,5,11,9,10,53,46,7,42
Glenavon,7631,6,10,10,10,43,48,-5,40
Glentoran,7631,7,10,7,13,34,43,-9,37
Ards,7631,8,10,6,14,39,51,-12,36
Coleraine,7631,9,8,11,11,37,43,-6,35
Ballinamalla,7631,10,6,5,19,27,53,-26,23
Portadown,7631,11,5,8,17,18,45,-27,23
Cliftonville,7632,1,15,6,9,48,35,13,51
Dungannon,7632,2,14,8,8,61,46,15,50
Crusaders,7632,3,14,6,10,54,44,10,48
Linfield,7632,4,12,8,10,46,30,16,44
Glenavon,7632,5,11,9,10,47,46,1,42
Glentoran,7632,6,11,9,10,35,40,-5,42
Ballymena,7632,7,12,5,13,49,60,-11,41
Ards,7632,8,10,7,13,44,48,-4,37
Ballinamalla,7632,9,11,4,15,42,52,-10,37
Coleraine,7632,10,8,11,11,36,39,-3,35
Portadown,7632,11,9,3,18,25,47,-22,30
Crusaders,7633,1,20,7,3,62,30,32,67
Cliftonville,7633,2,18,4,8,54,33,21,58
Linfield,7633,3,13,10,7,59,36,23,49
Ballymena,7633,4,12,6,12,57,63,-6,42
Coleraine,7633,5,11,9,10,41,47,-6,42
Dungannon,7633,6,10,10,10,47,38,9,40
Glenavon,7633,7,9,12,9,47,45,2,39
Glentoran,7633,8,9,6,15,27,46,-19,33
Ards,7633,9,9,4,17,39,49,-10,31
Ballinamalla,7633,10,7,6,17,27,50,-23,27
Portadown,7633,11,7,6,17,24,47,-23,27
Linfield,7634,1,15,8,7,61,32,29,53
Cliftonville,7634,2,15,5,10,51,43,8,50
Crusaders,7634,3,14,6,10,48,40,8,48
Ballymena,7634,4,14,6,10,60,58,2,48
Coleraine,7634,5,12,11,7,43,38,5,47
Glentoran,7634,6,13,7,10,45,41,4,46
Glenavon,7634,7,9,13,8,44,44,0,40
Dungannon,7634,8,8,12,10,50,49,1,36
Ards,7634,9,9,5,16,40,48,-8,32
Portadown,7634,10,8,4,18,27,51,-24,28
Ballinamalla,7634,11,5,9,16,27,52,-25,24
Linfield,7635,1,16,9,5,63,33,30,57
Cliftonville,7635,2,15,6,9,54,44,10,51
Ballymena,7635,3,15,6,9,61,62,-1,51
Glenavon,7635,4,12,12,6,52,42,10,48
Crusaders,7635,5,12,9,9,50,40,10,45
Glentoran,7635,6,11,9,10,37,36,1,42
Coleraine,7635,7,9,10,11,42,43,-1,37
Dungannon,7635,8,6,13,11,46,49,-3,31
Ards,7635,9,9,4,17,39,56,-17,31
Portadown,7635,10,8,5,17,33,49,-16,29
Ballinamalla,7635,11,8,5,17,34,57,-23,29
Glenavon,7636,1,15,9,6,60,46,14,54
Ballymena,7636,2,17,3,10,61,55,6,54
Linfield,7636,3,14,10,6,58,31,27,52
Crusaders,7636,4,13,8,9,47,37,10,47
Coleraine,7636,5,12,10,8,47,40,7,46
Cliftonville,7636,6,13,5,12,52,41,11,44
Dungannon,7636,7,12,7,11,53,43,10,43
Ards,7636,8,13,3,14,41,47,-6,42
Ballinamalla,7636,9,11,1,18,32,49,-17,34
Glentoran,7636,10,6,6,18,25,53,-28,24
Portadown,7636,11,5,6,19,21,55,-34,21
Cliftonville,7637,1,17,5,8,60,42,18,56
Crusaders,7637,2,16,7,7,58,37,21,55
Glenavon,7637,3,13,11,6,54,41,13,50
Linfield,7637,4,12,12,6,59,41,18,48
Ballymena,7637,5,13,8,9,56,57,-1,47
Coleraine,7637,6,12,7,11,41,46,-5,43
Dungannon,7637,7,9,7,14,49,49,0,34
Ards,7637,8,9,6,15,36,45,-9,33
Glentoran,7637,9,8,9,13,36,48,-12,33
Ballinamalla,7637,10,9,3,18,31,47,-16,30
Portadown,7637,11,7,5,18,25,52,-27,26
Cliftonville,7638,1,17,7,6,57,33,24,58
Crusaders,7638,2,15,9,6,55,33,22,54
Linfield,7638,3,14,9,7,54,36,18,51
Coleraine,7638,4,12,8,10,39,38,1,44
Glentoran,7638,5,12,7,11,37,41,-4,43
Glenavon,7638,6,11,9,10,48,48,0,42
Ballymena,7638,7,9,12,9,49,57,-8,39
Dungannon,7638,8,9,10,11,43,38,5,37
Ards,7638,9,9,6,15,39,45,-6,33
Ballinamalla,7638,10,8,3,19,28,58,-30,27
Portadown,7638,11,5,8,17,20,42,-22,23
Crusaders,7639,1,17,8,5,60,36,24,59
Cliftonville,7639,2,16,6,8,56,36,20,54
Coleraine,7639,3,14,10,6,41,29,12,52
Ballymena,7639,4,13,8,9,56,56,0,47
Linfield,7639,5,10,12,8,55,35,20,42
Dungannon,7639,6,10,11,9,47,37,10,41
Ballinamalla,7639,7,10,3,17,32,56,-24,33
Ards,7639,8,8,8,14,36,49,-13,32
Glenavon,7639,9,7,10,13,37,52,-15,31
Glentoran,7639,10,7,9,14,32,45,-13,30
Portadown,7639,11,6,9,15,26,47,-21,27
Crusaders,7640,1,19,4,7,59,37,22,61
Ballymena,7640,2,16,5,9,64,57,7,53
Coleraine,7640,3,14,9,7,44,35,9,51
Dungannon,7640,4,14,7,9,68,42,26,49
Cliftonville,7640,5,14,6,10,50,43,7,48
Linfield,7640,6,12,10,8,53,34,19,46
Glenavon,7640,7,12,8,10,50,47,3,44
Ards,7640,8,8,8,14,34,46,-12,32
Glentoran,7640,9,7,8,15,28,45,-17,29
Portadown,7640,10,6,5,19,24,54,-30,23
Ballinamalla,7640,11,7,2,21,24,58,-34,23
Crusaders,7641,1,17,8,5,52,30,22,59
Linfield,7641,2,15,9,6,59,28,31,54
Cliftonville,7641,3,15,4,11,53,41,12,49
Dungannon,7641,4,14,7,9,52,40,12,49
Ballymena,7641,5,13,7,10,52,55,-3,46
Coleraine,7641,6,12,8,10,42,43,-1,44
Glenavon,7641,7,10,11,9,48,47,1,41
Glentoran,7641,8,11,7,12,41,43,-2,40
Portadown,7641,9,9,3,18,21,43,-22,30
Ards,7641,10,8,4,18,34,51,-17,28
Ballinamalla,7641,11,5,4,21,28,61,-33,19
Crusaders,7642,1,15,8,7,51,39,12,53
Ballymena,7642,2,14,7,9,50,49,1,49
Cliftonville,7642,3,14,6,10,51,37,14,48
Linfield,7642,4,13,8,9,63,46,17,47
Glenavon,7642,5,12,10,8,53,42,11,46
Coleraine,7642,6,8,15,7,43,40,3,39
Glentoran,7642,7,9,8,13,33,47,-14,35
Portadown,7642,8,9,7,14,26,38,-12,34
Dungannon,7642,9,8,9,13,43,46,-3,33
Ards,7642,10,9,6,15,40,55,-15,33
Ballinamalla,7642,11,8,8,14,34,48,-14,32
Crusaders,7643,1,18,6,6,57,35,22,60
Linfield,7643,2,16,8,6,59,30,29,56
Cliftonville,7643,3,16,6,8,51,31,20,54
Ballymena,7643,4,14,7,9,59,56,3,49
Coleraine,7643,5,11,9,10,46,43,3,42
Glenavon,7643,6,10,12,8,49,49,0,42
Ards,7643,7,10,5,15,43,51,-8,35
Dungannon,7643,8,8,8,14,50,54,-4,32
Glentoran,7643,9,7,9,14,23,43,-20,30
Ballinamalla,7643,10,7,6,17,33,58,-25,27
Portadown,7643,11,6,8,16,25,45,-20,26
Coleraine,7644,1,15,9,6,57,37,20,54
Crusaders,7644,2,15,8,7,47,34,13,53
Cliftonville,7644,3,15,4,11,54,44,10,49
Ballymena,7644,4,13,5,12,57,66,-9,44
Linfield,7644,5,11,10,9,57,42,15,43
Dungannon,7644,6,10,11,9,50,41,9,41
Glenavon,7644,7,10,8,12,39,48,-9,38
Ballinamalla,7644,8,11,4,15,35,43,-8,37
Glentoran,7644,9,9,7,14,32,44,-12,34
Ards,7644,10,9,5,16,40,51,-11,32
Portadown,7644,11,9,5,16,28,46,-18,32
Cliftonville,7645,1,17,5,8,58,38,20,56
Ballymena,7645,2,17,4,9,61,53,8,55
Linfield,7645,3,13,12,5,58,32,26,51
Crusaders,7645,4,15,6,9,55,38,17,51
Glenavon,7645,5,12,10,8,48,46,2,46
Coleraine,7645,6,11,11,8,42,38,4,44
Dungannon,7645,7,10,11,9,51,41,10,41
Ballinamalla,7645,8,8,6,16,37,55,-18,30
Glentoran,7645,9,7,8,15,32,53,-21,29
Ards,7645,10,6,7,17,34,51,-17,25
Portadown,7645,11,6,6,18,22,53,-31,24
Linfield,7646,1,18,9,3,60,21,39,63
Crusaders,7646,2,18,4,8,62,34,28,58
Ballymena,7646,3,14,8,8,66,58,8,50
Dungannon,7646,4,13,7,10,56,44,12,46
Cliftonville,7646,5,13,7,10,47,41,6,46
Coleraine,7646,6,11,12,7,44,38,6,45
Glenavon,7646,7,11,10,9,47,50,-3,43
Glentoran,7646,8,10,7,13,33,48,-15,37
Ards,7646,9,7,6,17,30,48,-18,27
Ballinamalla,7646,10,7,3,20,25,53,-28,24
Portadown,7646,11,5,3,22,22,57,-35,18
Crusaders,7647,1,19,7,4,53,23,30,64
Linfield,7647,2,15,9,6,59,29,30,54
Ballymena,7647,3,15,8,7,64,58,6,53
Cliftonville,7647,4,15,5,10,54,42,12,50
Dungannon,7647,5,13,8,9,57,45,12,47
Glenavon,7647,6,9,13,8,49,48,1,40
Coleraine,7647,7,9,12,9,35,37,-2,39
Ards,7647,8,7,8,15,33,49,-16,29
Glentoran,7647,9,7,7,16,28,51,-23,28
Portadown,7647,10,6,8,16,20,42,-22,26
Ballinamalla,7647,11,6,3,21,30,58,-28,21
Crusaders,7648,1,21,6,3,63,33,30,69
Cliftonville,7648,2,16,2,12,47,35,12,50
Ballymena,7648,3,15,4,11,55,51,4,49
Linfield,7648,4,13,9,8,52,34,18,48
Glenavon,7648,5,13,9,8,52,41,11,48
Dungannon,7648,6,11,8,11,49,42,7,41
Ards,7648,7,10,4,16,42,54,-12,34
Ballinamalla,7648,8,10,3,17,26,49,-23,33
Coleraine,7648,9,8,8,14,34,42,-8,32
Glentoran,7648,10,8,7,15,33,49,-16,31
Portadown,7648,11,7,6,17,20,43,-23,27
Cliftonville,7649,1,18,6,6,59,35,24,60
Crusaders,7649,2,15,6,9,50,37,13,51
Linfield,7649,3,14,8,8,57,34,23,50
Glenavon,7649,4,13,9,8,45,40,5,48
Dungannon,7649,5,12,9,9,50,41,9,45
Ballymena,7649,6,13,5,12,60,60,0,44
Coleraine,7649,7,10,9,11,44,45,-1,39
Ards,7649,8,11,3,16,39,49,-10,36
Glentoran,7649,9,7,9,14,28,43,-15,30
Ballinamalla,7649,10,7,6,17,25,47,-22,27
Portadown,7649,11,7,6,17,25,51,-26,27
Linfield,7650,1,18,7,5,60,29,31,61
Crusaders,7650,2,17,7,6,56,34,22,58
Cliftonville,7650,3,15,6,9,53,40,13,51
Glenavon,7650,4,13,9,8,54,40,14,48
Glentoran,7650,5,12,8,10,33,37,-4,44
Ballymena,7650,6,12,6,12,51,56,-5,42
Dungannon,7650,7,10,8,12,50,47,3,38
Coleraine,7650,8,8,9,13,35,44,-9,33
Portadown,7650,9,7,8,15,25,43,-18,29
Ards,7650,10,8,4,18,36,55,-19,28
Ballinamalla,7650,11,7,4,19,31,59,-28,25
Crusaders,7651,1,17,9,4,62,31,31,60
Cliftonville,7651,2,17,5,8,70,45,25,56
Linfield,7651,3,14,10,6,61,36,25,52
Coleraine,7651,4,11,10,9,41,47,-6,43
Ballymena,7651,5,11,7,12,56,64,-8,40
Dungannon,7651,6,10,9,11,48,41,7,39
Ards,7651,7,10,7,13,41,50,-9,37
Glenavon,7651,8,8,10,12,36,47,-11,34
Glentoran,7651,9,9,7,14,33,50,-17,34
Ballinamalla,7651,10,9,3,18,31,50,-19,30
Portadown,7651,11,8,5,17,29,47,-18,29
Crusaders,7652,1,22,5,3,61,28,33,71
Linfield,7652,2,14,12,4,58,32,26,54
Cliftonville,7652,3,14,5,11,59,53,6,47
Coleraine,7652,4,10,13,7,44,39,5,43
Ballymena,7652,5,11,10,9,53,55,-2,43
Glenavon,7652,6,10,11,9,44,48,-4,41
Portadown,7652,7,10,5,15,28,40,-12,35
Ards,7652,8,9,7,14,38,44,-6,34
Ballinamalla,7652,9,9,3,18,31,50,-19,30
Glentoran,7652,10,7,7,16,28,53,-25,28
Dungannon,7652,11,6,8,16,45,47,-2,26
Crusaders,7653,1,19,5,6,59,34,25,62
Coleraine,7653,2,13,10,7,48,34,14,49
Cliftonville,7653,3,15,4,11,58,47,11,49
Linfield,7653,4,13,9,8,56,39,17,48
Glenavon,7653,5,12,10,8,46,42,4,46
Ballymena,7653,6,13,6,11,57,62,-5,45
Dungannon,7653,7,10,11,9,52,38,14,41
Ards,7653,8,9,4,17,39,58,-19,31
Portadown,7653,9,8,6,16,30,48,-18,30
Ballinamalla,7653,10,7,6,17,35,56,-21,27
Glentoran,7653,11,6,9,15,29,51,-22,27
Cliftonville,7654,1,18,6,6,60,34,26,60
Crusaders,7654,2,17,8,5,53,27,26,59
Linfield,7654,3,15,10,5,57,28,29,55
Ballymena,7654,4,14,4,12,55,55,0,46
Coleraine,7654,5,11,10,9,46,42,4,43
Glenavon,7654,6,10,12,8,47,48,-1,42
Glentoran,7654,7,11,7,12,33,45,-12,40
Dungannon,7654,8,8,10,12,49,48,1,34
Ards,7654,9,8,5,17,38,54,-16,29
Portadown,7654,10,5,9,16,26,45,-19,24
Ballinamalla,7654,11,5,5,20,23,61,-38,20
Crusaders,7655,1,20,6,4,55,24,31,66
Linfield,7655,2,16,8,6,61,30,31,56
Cliftonville,7655,3,14,6,10,46,36,10,48
Ballymena,7655,4,14,5,11,59,57,2,47
Dungannon,7655,5,11,10,9,48,39,9,43
Coleraine,7655,6,10,10,10,43,40,3,40
Glenavon,7655,7,10,9,11,46,52,-6,39
Ards,7655,8,11,3,16,40,52,-12,36
Ballinamalla,7655,9,8,5,17,33,56,-23,29
Glentoran,7655,10,7,7,16,35,54,-19,28
Portadown,7655,11,7,5,18,24,50,-26,26
Crusaders,7656,1,18,7,5,64,37,27,61
Linfield,7656,2,14,9,7,61,34,27,51
Coleraine,7656,3,12,11,7,46,37,9,47
Cliftonville,7656,4,14,4,12,55,51,4,46
Ballymena,7656,5,13,6,11,52,55,-3,45
Dungannon,7656,6,11,9,10,55,48,7,42
Glenavon,7656,7,11,8,11,44,52,-8,41
Ards,7656,8,11,7,12,43,46,-3,40
Glentoran,7656,9,9,6,15,28,41,-13,33
Portadown,7656,10,8,6,16,29,44,-15,30
Ballinamalla,7656,11,6,3,21,30,62,-32,21
Crusaders,7657,1,15,9,6,55,30,25,54
Cliftonville,7657,2,16,6,8,53,33,20,54
Ballymena,7657,3,16,5,9,64,60,4,53
Linfield,7657,4,13,10,7,52,32,20,49
Coleraine,7657,5,10,13,7,43,39,4,43
Glenavon,7657,6,9,9,12,46,57,-11,36
Glentoran,7657,7,8,10,12,32,44,-12,34
Ballinamalla,7657,8,10,4,16,34,54,-20,34
Portadown,7657,9,8,8,14,26,45,-19,32
Dungannon,7657,10,7,10,13,44,44,0,31
Ards,7657,11,9,4,17,36,47,-11,31
Crusaders,7658,1,18,7,5,59,31,28,61
Cliftonville,7658,2,19,3,8,66,35,31,60
Linfield,7658,3,15,9,6,58,30,28,54
Coleraine,7658,4,11,11,8,49,42,7,44
Dungannon,7658,5,11,10,9,45,40,5,43
Ballymena,7658,6,12,5,13,54,60,-6,41
Glenavon,7658,7,9,10,11,45,53,-8,37
Ballinamalla,7658,8,9,8,13,33,49,-16,35
Ards,7658,9,8,7,15,42,53,-11,31
Glentoran,7658,10,6,7,17,32,58,-26,25
Portadown,7658,11,6,5,19,27,59,-32,23
Cliftonville,7659,1,20,3,7,55,30,25,63
Crusaders,7659,2,17,7,6,56,35,21,58
Linfield,7659,3,13,10,7,55,28,27,49
Ballymena,7659,4,15,4,11,59,63,-4,49
Coleraine,7659,5,10,10,10,43,45,-2,40
Glenavon,7659,6,10,10,10,47,51,-4,40
Portadown,7659,7,11,4,15,30,38,-8,37
Dungannon,7659,8,8,10,12,48,44,4,34
Ards,7659,9,10,3,17,38,53,-15,33
Ballinamalla,7659,10,8,4,18,36,64,-28,28
Glentoran,7659,11,6,9,15,30,46,-16,27
Crusaders,7660,1,17,8,5,51,30,21,59
Linfield,7660,2,14,11,5,61,30,31,53
Cliftonville,7660,3,16,4,10,51,36,15,52
Glenavon,7660,4,12,9,9,43,42,1,45
Ards,7660,5,13,5,12,45,44,1,44
Ballymena,7660,6,12,7,11,59,60,-1,43
Dungannon,7660,7,11,8,11,51,44,7,41
Glentoran,7660,8,10,8,12,34,39,-5,38
Coleraine,7660,9,7,8,15,34,53,-19,29
Ballinamalla,7660,10,7,6,17,35,57,-22,27
Portadown,7660,11,6,6,18,22,51,-29,24
Crusaders,7661,1,17,8,5,64,25,39,59
Linfield,7661,2,16,9,5,58,29,29,57
Ballymena,7661,3,16,5,9,58,57,1,53
Cliftonville,7661,4,15,3,12,60,49,11,48
Glenavon,7661,5,12,11,7,52,47,5,47
Dungannon,7661,6,12,7,11,51,48,3,43
Coleraine,7661,7,9,11,10,43,44,-1,38
Glentoran,7661,8,9,7,14,31,49,-18,34
Ballinamalla,7661,9,7,7,16,37,57,-20,28
Ards,7661,10,5,9,16,34,55,-21,24
Portadown,7661,11,6,5,19,25,53,-28,23
Crusaders,7662,1,20,6,4,59,29,30,66
Ballymena,7662,2,18,4,8,66,51,15,58
Linfield,7662,3,15,8,7,59,28,31,53
Cliftonville,7662,4,16,3,11,54,45,9,51
Glenavon,7662,5,12,11,7,53,41,12,47
Coleraine,7662,6,11,9,10,41,44,-3,42
Ards,7662,7,9,7,14,34,45,-11,34
Glentoran,7662,8,8,8,14,28,46,-18,32
Dungannon,7662,9,7,10,13,41,48,-7,31
Ballinamalla,7662,10,6,4,20,27,57,-30,22
Portadown,7662,11,4,8,18,20,48,-28,20
Ballymena,7663,1,16,8,6,68,59,9,56
Crusaders,7663,2,15,9,6,55,39,16,54
Cliftonville,7663,3,15,5,10,55,42,13,50
Linfield,7663,4,13,9,8,57,40,17,48
Coleraine,7663,5,9,12,9,42,43,-1,39
Ballinamalla,7663,6,11,6,13,37,48,-11,39
Dungannon,7663,7,9,8,13,55,49,6,35
Ards,7663,8,10,4,16,42,48,-6,34
Glentoran,7663,9,8,10,12,33,44,-11,34
Glenavon,7663,10,8,9,13,44,54,-10,33
Portadown,7663,11,8,6,16,28,50,-22,30
Cliftonville,7664,1,17,6,7,55,37,18,57
Linfield,7664,2,15,7,8,59,39,20,52
Crusaders,7664,3,14,8,8,52,37,15,50
Dungannon,7664,4,13,7,10,51,40,11,46
Coleraine,7664,5,12,8,10,48,46,2,44
Glenavon,7664,6,11,9,10,50,47,3,42
Ballymena,7664,7,11,9,10,45,49,-4,42
Ballinamalla,7664,8,11,4,15,31,50,-19,37
Portadown,7664,9,8,5,17,24,41,-17,29
Ards,7664,10,7,7,16,37,50,-13,28
Glentoran,7664,11,6,10,14,31,47,-16,28
Crusaders,7665,1,17,8,5,55,29,26,59
Ballymena,7665,2,16,6,8,58,52,6,54
Linfield,7665,3,14,11,5,58,28,30,53
Cliftonville,7665,4,13,9,8,49,35,14,48
Coleraine,7665,5,13,9,8,47,38,9,48
Glentoran,7665,6,10,9,11,33,40,-7,39
Glenavon,7665,7,9,11,10,45,51,-6,38
Ards,7665,8,8,6,16,37,50,-13,30
Dungannon,7665,9,6,10,14,41,50,-9,28
Portadown,7665,10,7,5,18,23,51,-28,26
Ballinamalla,7665,11,5,10,15,25,47,-22,25
Crusaders,7666,1,16,9,5,60,32,28,57
Linfield,7666,2,16,8,6,58,27,31,56
Cliftonville,7666,3,13,8,9,54,45,9,47
Dungannon,7666,4,11,11,8,49,40,9,44
Ards,7666,5,12,6,12,40,44,-4,42
Ballymena,7666,6,11,6,13,48,57,-9,39
Coleraine,7666,7,9,10,11,36,38,-2,37
Portadown,7666,8,10,6,14,26,38,-12,36
Glentoran,7666,9,8,8,14,29,43,-14,32
Ballinamalla,7666,10,9,4,17,32,48,-16,31
Glenavon,7666,11,6,12,12,40,60,-20,30
Ballymena,7667,1,17,5,8,62,48,14,56
Crusaders,7667,2,15,7,8,55,42,13,52
Glenavon,7667,3,14,9,7,56,45,11,51
Cliftonville,7667,4,15,5,10,53,38,15,50
Linfield,7667,5,12,11,7,54,31,23,47
Dungannon,7667,6,13,8,9,56,49,7,47
Glentoran,7667,7,11,6,13,29,43,-14,39
Coleraine,7667,8,9,11,10,38,37,1,38
Portadown,7667,9,7,5,18,33,53,-20,26
Ballinamalla,7667,10,7,5,18,23,52,-29,26
Ards,7667,11,6,6,18,34,55,-21,24
Crusaders,7668,1,15,7,8,57,42,15,52
Cliftonville,7668,2,15,5,10,54,39,15,50
Linfield,7668,3,13,10,7,59,32,27,49
Ballymena,7668,4,14,6,10,64,67,-3,48
Dungannon,7668,5,12,9,9,55,39,16,45
Glenavon,7668,6,11,11,8,47,51,-4,44
Ards,7668,7,13,3,14,45,50,-5,42
Coleraine,7668,8,7,13,10,39,43,-4,34
Portadown,7668,9,10,3,17,34,55,-21,33
Glentoran,7668,10,9,5,16,33,46,-13,32
Ballinamalla,7668,11,6,8,16,35,58,-23,26
Crusaders,7669,1,15,12,3,53,27,26,57
Cliftonville,7669,2,16,5,9,52,39,13,53
Ballymena,7669,3,14,9,7,57,52,5,51
Linfield,7669,4,14,8,8,58,36,22,50
Coleraine,7669,5,13,10,7,43,31,12,49
Glenavon,7669,6,12,10,8,46,39,7,46
Glentoran,7669,7,10,5,15,32,44,-12,35
Dungannon,7669,8,7,10,13,39,46,-7,31
Portadown,7669,9,9,3,18,24,47,-23,30
Ards,7669,10,8,5,17,32,45,-13,29
Ballinamalla,7669,11,7,3,20,22,52,-30,24
Linfield,7670,1,17,9,4,66,33,33,60
Crusaders,7670,2,16,7,7,53,29,24,55
Glenavon,7670,3,13,10,7,52,41,11,49
Cliftonville,7670,4,13,7,10,52,39,13,46
Ballymena,7670,5,12,7,11,54,59,-5,43
Coleraine,7670,6,8,13,9,41,45,-4,37
Glentoran,7670,7,9,8,13,31,42,-11,35
Dungannon,7670,8,7,12,11,45,43,2,33
Ballinamalla,7670,9,8,7,15,32,48,-16,31
Ards,7670,10,8,6,16,36,58,-22,30
Portadown,7670,11,7,8,15,27,52,-25,29
Linfield,7671,1,14,10,6,61,33,28,52
Ballymena,7671,2,15,4,11,61,62,-1,49
Crusaders,7671,3,14,6,10,50,36,14,48
Cliftonville,7671,4,14,5,11,49,38,11,47
Glenavon,7671,5,12,11,7,48,47,1,47
Coleraine,7671,6,11,10,9,46,42,4,43
Glentoran,7671,7,12,6,12,39,41,-2,42
Dungannon,7671,8,9,11,10,52,44,8,38
Ards,7671,9,9,5,16,34,47,-13,32
Portadown,7671,10,8,6,16,22,43,-21,30
Ballinamalla,7671,11,9,2,19,26,55,-29,29
Cliftonville,7672,1,17,6,7,57,32,25,57
Crusaders,7672,2,14,8,8,51,40,11,50
Ballymena,7672,3,14,7,9,58,55,3,49
Linfield,7672,4,13,9,8,56,36,20,48
Coleraine,7672,5,12,10,8,42,38,4,46
Glentoran,7672,6,11,9,10,37,37,0,42
Glenavon,7672,7,9,12,9,45,49,-4,39
Ards,7672,8,9,7,14,35,43,-8,34
Dungannon,7672,9,8,9,13,41,44,-3,33
Portadown,7672,10,9,2,19,27,51,-24,29
Ballinamalla,7672,11,7,5,18,28,52,-24,26
Crusaders,7673,1,17,8,5,60,38,22,59
Cliftonville,7673,2,16,5,9,60,38,22,53
Linfield,7673,3,11,13,6,53,33,20,46
Glenavon,7673,4,12,9,9,49,49,0,45
Ballymena,7673,5,11,8,11,52,60,-8,41
Dungannon,7673,6,10,9,11,56,48,8,39
Coleraine,7673,7,9,12,9,43,41,2,39
Glentoran,7673,8,9,9,12,30,39,-9,36
Ards,7673,9,9,8,13,45,53,-8,35
Ballinamalla,7673,10,7,7,16,31,53,-22,28
Portadown,7673,11,6,8,16,25,52,-27,26
Linfield,7674,1,17,7,6,62,30,32,58
Cliftonville,7674,2,16,5,9,56,32,24,53
Crusaders,7674,3,15,7,8,51,35,16,52
Ballymena,7674,4,15,7,8,53,50,3,52
Glenavon,7674,5,13,10,7,46,40,6,49
Coleraine,7674,6,13,7,10,48,40,8,46
Dungannon,7674,7,11,10,9,47,38,9,43
Ards,7674,8,8,3,19,44,67,-23,27
Glentoran,7674,9,7,6,17,26,54,-28,27
Portadown,7674,10,6,8,16,21,41,-20,26
Ballinamalla,7674,11,6,6,18,25,52,-27,24
Crusaders,7675,1,17,8,5,56,32,24,59
Cliftonville,7675,2,17,5,8,56,39,17,56
Linfield,7675,3,14,8,8,58,35,23,50
Glenavon,7675,4,12,10,8,60,47,13,46
Ballymena,7675,5,13,6,11,56,59,-3,45
Dungannon,7675,6,12,6,12,54,44,10,42
Portadown,7675,7,10,5,15,23,40,-17,35
Ballinamalla,7675,8,10,3,17,31,50,-19,33
Coleraine,7675,9,7,10,13,36,49,-13,31
Glentoran,7675,10,7,9,14,31,52,-21,30
Ards,7675,11,7,8,15,37,51,-14,29
Cliftonville,7676,1,18,4,8,55,37,18,58
Crusaders,7676,2,16,8,6,60,37,23,56
Linfield,7676,3,14,11,5,59,29,30,53
Ballymena,7676,4,14,4,12,66,62,4,46
Dungannon,7676,5,10,10,10,53,48,5,40
Glenavon,7676,6,10,10,10,46,50,-4,40
Coleraine,7676,7,10,10,10,38,42,-4,40
Ards,7676,8,10,5,15,35,49,-14,35
Glentoran,7676,9,9,5,16,36,45,-9,32
Portadown,7676,10,7,9,14,28,44,-16,30
Ballinamalla,7676,11,6,6,18,27,60,-33,24
Cliftonville,7677,1,16,7,7,61,44,17,55
Linfield,7677,2,15,8,7,62,36,26,53
Glenavon,7677,3,14,9,7,51,42,9,51
Crusaders,7677,4,12,8,10,49,42,7,44
Ballymena,7677,5,13,5,12,57,60,-3,44
Coleraine,7677,6,12,7,11,43,39,4,43
Ards,7677,7,13,4,13,48,52,-4,43
Dungannon,7677,8,10,9,11,52,42,10,39
Ballinamalla,7677,9,10,3,17,30,55,-25,33
Glentoran,7677,10,8,6,16,27,41,-14,30
Portadown,7677,11,7,4,19,24,51,-27,25
Cliftonville,7678,1,16,3,11,55,42,13,51
Ballymena,7678,2,15,6,9,62,57,5,51
Linfield,7678,3,13,11,6,62,32,30,50
Glenavon,7678,4,13,11,6,54,43,11,50
Ards,7678,5,15,3,12,46,45,1,48
Crusaders,7678,6,14,5,11,50,41,9,47
Dungannon,7678,7,11,11,8,63,43,20,44
Coleraine,7678,8,10,9,11,42,45,-3,39
Glentoran,7678,9,9,7,14,33,51,-18,34
Portadown,7678,10,6,5,19,26,52,-26,23
Ballinamalla,7678,11,7,1,22,27,69,-42,22
Crusaders,7679,1,15,11,4,58,31,27,56
Linfield,7679,2,15,10,5,59,30,29,55
Coleraine,7679,3,13,10,7,47,33,14,49
Cliftonville,7679,4,14,6,10,52,44,8,48
Ballymena,7679,5,12,6,12,55,60,-5,42
Glenavon,7679,6,10,11,9,48,48,0,41
Ballinamalla,7679,7,12,4,14,38,46,-8,40
Glentoran,7679,8,11,6,13,31,43,-12,39
Dungannon,7679,9,7,9,14,44,47,-3,30
Portadown,7679,10,9,3,18,23,50,-27,30
Ards,7679,11,6,6,18,31,54,-23,24
Crusaders,7680,1,16,8,6,54,36,18,56
Linfield,7680,2,15,9,6,60,32,28,54
Glenavon,7680,3,13,13,4,53,40,13,52
Cliftonville,7680,4,14,7,9,49,37,12,49
Ballymena,7680,5,12,8,10,59,58,1,44
Dungannon,7680,6,10,11,9,48,45,3,41
Coleraine,7680,7,9,10,11,44,42,2,37
Ards,7680,8,10,6,14,40,50,-10,36
Glentoran,7680,9,7,10,13,29,45,-16,31
Ballinamalla,7680,10,8,6,16,31,52,-21,30
Portadown,7680,11,4,6,20,22,52,-30,18
Linfield,7681,1,15,11,4,65,30,35,56
Cliftonville,7681,2,17,5,8,55,35,20,56
Crusaders,7681,3,15,7,8,55,39,16,52
Ballymena,7681,4,13,9,8,56,47,9,48
Glenavon,7681,5,11,12,7,50,46,4,45
Dungannon,7681,6,11,9,10,53,44,9,42
Ards,7681,7,11,6,13,39,46,-7,39
Coleraine,7681,8,9,10,11,37,41,-4,37
Glentoran,7681,9,7,7,16,33,54,-21,28
Ballinamalla,7681,10,7,4,19,27,58,-31,25
Portadown,7681,11,6,6,18,22,52,-30,24
Ballymena,7682,1,17,5,8,60,54,6,56
Crusaders,7682,2,16,6,8,53,35,18,54
Linfield,7682,3,13,11,6,58,32,26,50
Glentoran,7682,4,14,5,11,33,38,-5,47
Cliftonville,7682,5,14,4,12,48,41,7,46
Glenavon,7682,6,11,12,7,41,39,2,45
Dungannon,7682,7,11,11,8,56,44,12,44
Coleraine,7682,8,10,9,11,42,40,2,39
Portadown,7682,9,7,7,16,24,43,-19,28
Ards,7682,10,7,5,18,30,51,-21,26
Ballinamalla,7682,11,5,5,20,32,60,-28,20
Linfield,7683,1,16,8,6,64,35,29,56
Crusaders,7683,2,13,11,6,52,37,15,50
Dungannon,7683,3,14,7,9,52,36,16,49
Coleraine,7683,4,13,8,9,50,46,4,47
Ballymena,7683,5,13,7,10,65,60,5,46
Cliftonville,7683,6,12,6,12,52,44,8,42
Glenavon,7683,7,11,9,10,50,50,0,42
Glentoran,7683,8,11,6,13,35,46,-11,39
Ards,7683,9,9,7,14,41,52,-11,34
Ballinamalla,7683,10,9,2,19,30,53,-23,29
Portadown,7683,11,5,7,18,29,61,-32,22
Crusaders,7684,1,18,9,3,63,34,29,63
Linfield,7684,2,14,11,5,59,27,32,53
Cliftonville,7684,3,14,6,10,53,46,7,48
Glenavon,7684,4,12,10,8,50,46,4,46
Ards,7684,5,14,3,13,44,44,0,45
Ballymena,7684,6,12,7,11,53,61,-8,43
Coleraine,7684,7,10,10,10,42,38,4,40
Dungannon,7684,8,8,12,10,47,48,-1,36
Portadown,7684,9,8,7,15,25,42,-17,31
Glentoran,7684,10,5,9,16,28,49,-21,24
Ballinamalla,7684,11,7,2,21,32,61,-29,23
Crusaders,7685,1,17,8,5,61,36,25,59
Ballymena,7685,2,14,8,8,61,53,8,50
Coleraine,7685,3,13,9,8,45,37,8,48
Cliftonville,7685,4,14,5,11,53,42,11,47
Linfield,7685,5,12,7,11,53,42,11,43
Glenavon,7685,6,10,11,9,42,43,-1,41
Glentoran,7685,7,10,10,10,33,41,-8,40
Dungannon,7685,8,9,11,10,55,49,6,38
Ards,7685,9,9,5,16,34,45,-11,32
Ballinamalla,7685,10,8,4,18,32,60,-28,28
Portadown,7685,11,6,8,16,29,50,-21,26
Crusaders,7686,1,16,7,7,52,32,20,55
Cliftonville,7686,2,16,4,10,46,32,14,52
Linfield,7686,3,13,9,8,56,35,21,48
Ballymena,7686,4,14,6,10,54,58,-4,48
Dungannon,7686,5,12,7,11,54,42,12,43
Coleraine,7686,6,10,13,7,41,36,5,43
Glenavon,7686,7,10,9,11,39,46,-7,39
Glentoran,7686,8,8,11,11,33,40,-7,35
Portadown,7686,9,10,4,16,32,45,-13,34
Ards,7686,10,9,6,15,38,49,-11,33
Ballinamalla,7686,11,7,4,19,26,56,-30,25
Linfield,7687,1,16,7,7,67,39,28,55
Crusaders,7687,2,16,6,8,51,37,14,54
Glenavon,7687,3,15,9,6,51,41,10,54
Ballymena,7687,4,16,5,9,64,54,10,53
Dungannon,7687,5,14,8,8,61,34,27,50
Cliftonville,7687,6,13,4,13,46,47,-1,43
Coleraine,7687,7,9,10,11,35,40,-5,37
Ards,7687,8,9,5,16,46,56,-10,32
Glentoran,7687,9,8,7,15,27,54,-27,31
Portadown,7687,10,8,4,18,22,41,-19,28
Ballinamalla,7687,11,7,3,20,27,54,-27,24
Crusaders,7688,1,16,6,8,50,32,18,54
Ballymena,7688,2,14,6,10,54,55,-1,48
Linfield,7688,3,12,11,7,54,34,20,47
Coleraine,7688,4,12,10,8,42,37,5,46
Glenavon,7688,5,11,11,8,44,40,4,44
Dungannon,7688,6,10,12,8,50,39,11,42
Cliftonville,7688,7,12,5,13,44,42,2,41
Ards,7688,8,11,8,11,39,38,1,41
Glentoran,7688,9,8,11,11,27,39,-12,35
Portadown,7688,10,8,5,17,27,44,-17,29
Ballinamalla,7688,11,6,5,19,24,55,-31,23
Crusaders,7689,1,17,9,4,60,32,28,60
Linfield,7689,2,15,9,6,60,33,27,54
Ballymena,7689,3,15,5,10,59,59,0,50
Coleraine,7689,4,13,10,7,52,39,13,49
Cliftonville,7689,5,13,6,11,51,41,10,45
Glenavon,7689,6,11,12,7,51,48,3,45
Dungannon,7689,7,9,7,14,48,48,0,34
Glentoran,7689,8,8,6,16,29,46,-17,30
Portadown,7689,9,6,11,13,27,44,-17,29
Ards,7689,10,8,5,17,35,60,-25,29
Ballinamalla,7689,11,6,8,16,31,53,-22,26
Crusaders,7690,1,17,7,6,57,34,23,58
Linfield,7690,2,16,7,7,65,37,28,55
Cliftonville,7690,3,16,6,8,54,34,20,54
Ballymena,7690,4,14,8,8,57,58,-1,50
Dungannon,7690,5,13,7,10,52,37,15,46
Glenavon,7690,6,11,9,10,39,42,-3,42
Coleraine,7690,7,10,11,9,41,38,3,41
Ards,7690,8,9,5,16,40,54,-14,32
Ballinamalla,7690,9,9,4,17,28,52,-24,31
Glentoran,7690,10,6,6,18,36,57,-21,24
Portadown,7690,11,6,6,18,24,50,-26,24
Crusaders,7691,1,20,5,5,61,26,35,65
Coleraine,7691,2,14,9,7,53,41,12,51
Linfield,7691,3,14,8,8,58,31,27,50
Ballymena,7691,4,14,5,11,56,60,-4,47
Glenavon,7691,5,12,9,9,53,45,8,45
Dungannon,7691,6,12,8,10,53,43,10,44
Cliftonville,7691,7,13,5,12,48,45,3,44
Ards,7691,8,8,6,16,38,53,-15,30
Portadown,7691,9,7,8,15,30,48,-18,29
Glentoran,7691,10,6,9,15,25,54,-29,27
Ballinamalla,7691,11,8,2,20,26,55,-29,26
Crusaders,7692,1,15,9,6,58,36,22,54
Linfield,7692,2,14,11,5,62,30,32,53
Coleraine,7692,3,14,9,7,48,36,12,51
Cliftonville,7692,4,14,6,10,50,45,5,48
Glenavon,7692,5,12,11,7,48,46,2,47
Ballymena,7692,6,11,10,9,54,59,-5,43
Dungannon,7692,7,9,9,12,47,44,3,36
Glentoran,7692,8,9,9,12,30,44,-14,36
Ballinamalla,7692,9,9,4,17,30,49,-19,31
Ards,7692,10,8,5,17,40,52,-12,29
Portadown,7692,11,6,5,19,23,49,-26,23
Crusaders,7693,1,18,6,6,56,38,18,60
Ballymena,7693,2,17,4,9,61,52,9,55
Cliftonville,7693,3,16,3,11,49,37,12,51
Glenavon,7693,4,14,8,8,58,39,19,50
Linfield,7693,5,13,10,7,58,33,25,49
Coleraine,7693,6,11,9,10,43,44,-1,42
Dungannon,7693,7,11,8,11,52,44,8,41
Glentoran,7693,8,9,7,14,34,45,-11,34
Ards,7693,9,8,5,17,33,53,-20,29
Portadown,7693,10,5,9,16,21,48,-27,24
Ballinamalla,7693,11,7,3,20,26,58,-32,24
Cliftonville,7694,1,17,4,9,53,35,18,55
Dungannon,7694,2,15,7,8,60,39,21,52
Crusaders,7694,3,15,6,9,52,34,18,51
Linfield,7694,4,12,11,7,54,30,24,47
Coleraine,7694,5,12,10,8,49,40,9,46
Ballymena,7694,6,12,7,11,49,60,-11,43
Glenavon,7694,7,10,12,8,45,42,3,42
Glentoran,7694,8,9,9,12,34,44,-10,36
Ards,7694,9,10,5,15,37,54,-17,35
Portadown,7694,10,6,7,17,27,53,-26,25
Ballinamalla,7694,11,6,4,20,25,54,-29,22
Crusaders,7695,1,16,9,5,55,31,24,57
Ballymena,7695,2,16,7,7,70,51,19,55
Linfield,7695,3,14,9,7,59,29,30,51
Coleraine,7695,4,12,11,7,41,35,6,47
Cliftonville,7695,5,12,7,11,44,43,1,43
Dungannon,7695,6,11,9,10,50,43,7,42
Glenavon,7695,7,8,13,9,44,47,-3,37
Ballinamalla,7695,8,8,7,15,29,47,-18,31
Ards,7695,9,7,9,14,35,46,-11,30
Glentoran,7695,10,7,8,15,27,54,-27,29
Portadown,7695,11,8,3,19,20,48,-28,27
Linfield,7696,1,17,10,3,57,19,38,61
Crusaders,7696,2,16,5,9,51,34,17,53
Cliftonville,7696,3,16,5,9,50,35,15,53
Glenavon,7696,4,11,10,9,50,46,4,43
Ards,7696,5,13,4,13,44,42,2,43
Ballymena,7696,6,12,7,11,56,60,-4,43
Coleraine,7696,7,11,9,10,37,37,0,42
Glentoran,7696,8,9,6,15,29,48,-19,33
Dungannon,7696,9,8,8,14,42,51,-9,32
Portadown,7696,10,8,6,16,25,43,-18,30
Ballinamalla,7696,11,8,2,20,31,57,-26,26
Crusaders,7697,1,18,7,5,58,31,27,61
Cliftonville,7697,2,18,3,9,61,41,20,57
Linfield,7697,3,15,8,7,58,36,22,53
Glenavon,7697,4,14,8,8,51,36,15,50
Coleraine,7697,5,13,10,7,48,42,6,49
Ballymena,7697,6,14,6,10,54,53,1,48
Ballinamalla,7697,7,12,4,14,39,50,-11,40
Portadown,7697,8,8,3,19,25,46,-21,27
Dungannon,7697,9,5,11,14,39,52,-13,26
Glentoran,7697,10,6,7,17,24,48,-24,25
Ards,7697,11,5,7,18,34,56,-22,22
Linfield,7698,1,16,9,5,61,29,32,57
Crusaders,7698,2,16,8,6,60,38,22,56
Cliftonville,7698,3,17,5,8,57,37,20,56
Ballymena,7698,4,13,6,11,60,62,-2,45
Glenavon,7698,5,11,10,9,49,45,4,43
Dungannon,7698,6,11,8,11,54,47,7,41
Coleraine,7698,7,8,13,9,37,41,-4,37
Glentoran,7698,8,8,9,13,28,42,-14,33
Ards,7698,9,8,5,17,36,52,-16,29
Portadown,7698,10,7,7,16,26,48,-22,28
Ballinamalla,7698,11,8,4,18,31,58,-27,28
Crusaders,7699,1,16,8,6,58,38,20,56
Glenavon,7699,2,16,8,6,54,44,10,56
Ballymena,7699,3,15,6,9,66,59,7,51
Cliftonville,7699,4,15,5,10,62,48,14,50
Linfield,7699,5,13,9,8,57,37,20,48
Coleraine,7699,6,13,9,8,44,37,7,48
Glentoran,7699,7,10,9,11,42,46,-4,39
Dungannon,7699,8,9,9,12,42,42,0,36
Ards,7699,9,8,6,16,37,51,-14,30
Portadown,7699,10,4,9,17,31,59,-28,21
Ballinamalla,7699,11,5,4,21,25,57,-32,19
Linfield,7700,1,17,8,5,68,32,36,59
Crusaders,7700,2,16,8,6,49,31,18,56
Coleraine,7700,3,15,10,5,47,27,20,55
Cliftonville,7700,4,16,5,9,54,33,21,53
Ballymena,7700,5,14,5,11,51,61,-10,47
Dungannon,7700,6,10,10,10,51,41,10,40
Glenavon,7700,7,9,12,9,49,46,3,39
Ards,7700,8,9,6,15,34,52,-18,33
Glentoran,7700,9,9,6,15,27,48,-21,33
Portadown,7700,10,5,6,19,22,49,-27,21
Ballinamalla,7700,11,4,6,20,24,56,-32,18
Crusaders,7701,1,18,4,8,54,37,17,58
Linfield,7701,2,16,9,5,63,28,35,57
Cliftonville,7701,3,16,6,8,52,30,22,54
Dungannon,7701,4,13,8,9,55,39,16,47
Glenavon,7701,5,12,9,9,48,45,3,45
Coleraine,7701,6,10,13,7,40,36,4,43
Ballymena,7701,7,10,8,12,49,64,-15,38
Ballinamalla,7701,8,9,6,15,38,52,-14,33
Glentoran,7701,9,8,8,14,25,44,-19,32
Ards,7701,10,7,7,16,32,52,-20,28
Portadown,7701,11,4,6,20,16,45,-29,18
Linfield,7702,1,17,9,4,66,26,40,60
Crusaders,7702,2,16,6,8,58,48,10,54
Ballymena,7702,3,14,6,10,63,60,3,48
Dungannon,7702,4,12,9,9,51,41,10,45
Coleraine,7702,5,12,9,9,43,39,4,45
Cliftonville,7702,6,11,9,10,46,40,6,42
Ards,7702,7,12,5,13,43,45,-2,41
Glentoran,7702,8,10,9,11,37,39,-2,39
Glenavon,7702,9,9,10,11,41,46,-5,37
Ballinamalla,7702,10,6,4,20,26,58,-32,22
Portadown,7702,11,5,6,19,23,55,-32,21
Crusaders,7703,1,16,8,6,57,39,18,56
Cliftonville,7703,2,16,4,10,57,39,18,52
Glenavon,7703,3,14,8,8,51,45,6,50
Coleraine,7703,4,13,10,7,42,33,9,49
Linfield,7703,5,12,10,8,57,37,20,46
Ballymena,7703,6,12,10,8,53,53,0,46
Dungannon,7703,7,9,10,11,46,42,4,37
Glentoran,7703,8,8,9,13,26,37,-11,33
Ards,7703,9,8,8,14,35,48,-13,32
Ballinamalla,7703,10,9,4,17,26,49,-23,31
Portadown,7703,11,4,7,19,19,47,-28,19
Crusaders,7704,1,16,9,5,57,35,22,57
Cliftonville,7704,2,14,7,9,54,37,17,49
Dungannon,7704,3,12,11,7,57,34,23,47
Coleraine,7704,4,10,14,6,43,40,3,44
Linfield,7704,5,11,9,10,46,39,7,42
Ballymena,7704,6,11,8,11,55,60,-5,41
Glenavon,7704,7,8,12,10,42,50,-8,36
Ards,7704,8,10,5,15,40,45,-5,35
Glentoran,7704,9,8,11,11,30,43,-13,35
Ballinamalla,7704,10,9,6,15,37,58,-21,33
Portadown,7704,11,5,10,15,25,45,-20,25
Coleraine,7705,1,15,10,5,53,34,19,55
Crusaders,7705,2,15,8,7,57,41,16,53
Linfield,7705,3,14,8,8,62,40,22,50
Glentoran,7705,4,14,7,9,41,37,4,49
Cliftonville,7705,5,13,6,11,58,46,12,45
Glenavon,7705,6,9,12,9,47,46,1,39
Ballymena,7705,7,10,8,12,51,66,-15,38
Dungannon,7705,8,7,13,10,50,48,2,34
Ards,7705,9,9,5,16,34,53,-19,32
Portadown,7705,10,8,5,17,28,46,-18,29
Ballinamalla,7705,11,7,6,17,28,52,-24,27
Ballymena,7706,1,15,8,7,57,53,4,53
Cliftonville,7706,2,15,7,8,55,36,19,52
Crusaders,7706,3,14,9,7,49,33,16,51
Linfield,7706,4,13,8,9,56,36,20,47
Ards,7706,5,13,5,12,45,41,4,44
Dungannon,7706,6,9,13,8,53,42,11,40
Coleraine,7706,7,10,10,10,42,40,2,40
Glenavon,7706,8,9,13,8,43,49,-6,40
Ballinamalla,7706,9,9,5,16,32,50,-18,32
Glentoran,7706,10,6,7,17,20,41,-21,25
Portadown,7706,11,6,7,17,24,55,-31,25
Linfield,7707,1,16,9,5,59,31,28,57
Cliftonville,7707,2,16,6,8,55,41,14,54
Glenavon,7707,3,13,10,7,54,44,10,49
Crusaders,7707,4,14,6,10,52,43,9,48
Coleraine,7707,5,12,11,7,43,36,7,47
Ballymena,7707,6,12,9,9,60,59,1,45
Dungannon,7707,7,10,9,11,47,43,4,39
Glentoran,7707,8,7,9,14,24,41,-17,30
Portadown,7707,9,7,8,15,28,49,-21,29
Ards,7707,10,6,8,16,38,52,-14,26
Ballinamalla,7707,11,7,5,18,32,53,-21,26
Cliftonville,7708,1,18,6,6,54,31,23,60
Crusaders,7708,2,16,9,5,56,35,21,57
Linfield,7708,3,15,8,7,60,31,29,53
Ballymena,7708,4,12,9,9,50,54,-4,45
Coleraine,7708,5,11,11,8,48,41,7,44
Dungannon,7708,6,9,11,10,52,47,5,38
Glenavon,7708,7,10,8,12,42,44,-2,38
Ards,7708,8,10,4,16,39,53,-14,34
Glentoran,7708,9,6,10,14,26,45,-19,28
Portadown,7708,10,6,9,15,25,44,-19,27
Ballinamalla,7708,11,8,3,19,26,53,-27,27
Ballymena,7709,1,16,7,7,70,62,8,55
Linfield,7709,2,15,9,6,50,25,25,54
Cliftonville,7709,3,15,7,8,65,42,23,52
Crusaders,7709,4,15,6,9,59,40,19,51
Coleraine,7709,5,10,12,8,40,45,-5,42
Dungannon,7709,6,10,10,10,46,41,5,40
Glenavon,7709,7,8,11,11,40,46,-6,35
Portadown,7709,8,9,5,16,29,48,-19,32
Ards,7709,9,7,10,13,38,48,-10,31
Glentoran,7709,10,7,9,14,29,47,-18,30
Ballinamalla,7709,11,8,4,18,28,50,-22,28
Crusaders,7710,1,18,7,5,55,31,24,61
Cliftonville,7710,2,17,5,8,56,37,19,56
Linfield,7710,3,14,8,8,60,43,17,50
Glenavon,7710,4,12,8,10,45,46,-1,44
Ballymena,7710,5,12,7,11,59,55,4,43
Glentoran,7710,6,10,9,11,27,34,-7,39
Dungannon,7710,7,9,11,10,52,44,8,38
Coleraine,7710,8,8,11,11,42,46,-4,35
Ballinamalla,7710,9,9,5,16,29,50,-21,32
Ards,7710,10,8,4,18,33,52,-19,28
Portadown,7710,11,6,9,15,24,44,-20,27
Linfield,7711,1,16,8,6,62,27,35,56
Cliftonville,7711,2,17,5,8,58,38,20,56
Crusaders,7711,3,14,9,7,58,40,18,51
Dungannon,7711,4,13,9,8,51,40,11,48
Coleraine,7711,5,12,10,8,47,41,6,46
Ballymena,7711,6,12,4,14,51,62,-11,40
Glenavon,7711,7,8,13,9,43,43,0,37
Ards,7711,8,10,5,15,42,52,-10,35
Ballinamalla,7711,9,11,2,17,26,46,-20,35
Glentoran,7711,10,6,9,15,23,49,-26,27
Portadown,7711,11,7,4,19,26,49,-23,25
Cliftonville,7712,1,18,4,8,60,38,22,58
Crusaders,7712,2,15,7,8,53,37,16,52
Linfield,7712,3,13,10,7,59,42,17,49
Glenavon,7712,4,10,11,9,50,47,3,41
Coleraine,7712,5,11,8,11,41,45,-4,41
Ards,7712,6,12,4,14,44,50,-6,40
Ballymena,7712,7,11,7,12,57,64,-7,40
Dungannon,7712,8,9,8,13,46,42,4,35
Glentoran,7712,9,10,5,15,31,41,-10,35
Portadown,7712,10,10,5,15,24,42,-18,35
Ballinamalla,7712,11,9,5,16,32,49,-17,32
Crusaders,7713,1,16,9,5,56,35,21,57
Linfield,7713,2,14,12,4,59,25,34,54
Ballymena,7713,3,16,6,8,61,52,9,54
Cliftonville,7713,4,14,8,8,52,39,13,50
Glenavon,7713,5,11,11,8,52,45,7,44
Coleraine,7713,6,11,11,8,41,40,1,44
Ards,7713,7,10,5,15,39,47,-8,35
Glentoran,7713,8,8,8,14,27,48,-21,32
Dungannon,7713,9,7,9,14,41,49,-8,30
Ballinamalla,7713,10,9,2,19,30,54,-24,29
Portadown,7713,11,4,9,17,24,48,-24,21
Crusaders,7714,1,16,8,6,50,34,16,56
Linfield,7714,2,13,10,7,58,33,25,49
Ballymena,7714,3,13,8,9,53,59,-6,47
Glenavon,7714,4,12,10,8,48,41,7,46
Coleraine,7714,5,12,10,8,43,38,5,46
Cliftonville,7714,6,13,6,11,49,41,8,45
Glentoran,7714,7,12,8,10,32,38,-6,44
Dungannon,7714,8,9,9,12,52,47,5,36
Ballinamalla,7714,9,10,4,16,35,49,-14,34
Ards,7714,10,7,8,15,36,49,-13,29
Portadown,7714,11,5,5,20,23,50,-27,20
Crusaders,7715,1,16,8,6,53,35,18,56
Linfield,7715,2,13,12,5,60,30,30,51
Cliftonville,7715,3,15,6,9,51,35,16,51
Dungannon,7715,4,11,11,8,47,35,12,44
Glenavon,7715,5,11,11,8,46,39,7,44
Coleraine,7715,6,11,10,9,39,40,-1,43
Ballymena,7715,7,11,8,11,51,63,-12,41
Glentoran,7715,8,9,9,12,30,38,-8,36
Ballinamalla,7715,9,10,1,19,31,56,-25,31
Portadown,7715,10,7,6,17,22,46,-24,27
Ards,7715,11,6,8,16,41,54,-13,26
Cliftonville,7716,1,16,6,8,56,35,21,54
Crusaders,7716,2,15,4,11,53,41,12,49
Linfield,7716,3,13,8,9,55,39,16,47
Coleraine,7716,4,12,10,8,41,36,5,46
Ballymena,7716,5,13,7,10,60,60,0,46
Glentoran,7716,6,13,6,11,39,41,-2,45
Glenavon,7716,7,11,9,10,44,48,-4,42
Dungannon,7716,8,9,9,12,52,44,8,36
Ballinamalla,7716,9,10,4,16,29,47,-18,34
Portadown,7716,10,9,7,14,28,48,-20,34
Ards,7716,11,5,8,17,31,49,-18,23
Linfield,7717,1,16,9,5,67,32,35,57
Crusaders,7717,2,16,7,7,56,37,19,55
Ballymena,7717,3,15,6,9,58,56,2,51
Glenavon,7717,4,11,14,5,52,39,13,47
Coleraine,7717,5,12,11,7,52,40,12,47
Cliftonville,7717,6,13,5,12,49,44,5,44
Dungannon,7717,7,10,10,10,48,46,2,40
Glentoran,7717,8,8,10,12,28,41,-13,34
Ards,7717,9,8,3,19,33,55,-22,27
Portadown,7717,10,7,6,17,29,53,-24,27
Ballinamalla,7717,11,6,5,19,25,54,-29,23
Linfield,7718,1,14,12,4,65,35,30,54
Crusaders,7718,2,14,9,7,57,42,15,51
Cliftonville,7718,3,14,9,7,56,42,14,51
Glenavon,7718,4,11,13,6,46,41,5,46
Dungannon,7718,5,11,11,8,54,40,14,44
Ballymena,7718,6,12,8,10,64,67,-3,44
Coleraine,7718,7,10,10,10,43,44,-1,40
Ballinamalla,7718,8,9,6,15,35,48,-13,33
Glentoran,7718,9,8,8,14,34,50,-16,32
Portadown,7718,10,6,7,17,26,53,-27,25
Ards,7718,11,5,9,16,31,49,-18,24
Linfield,7719,1,17,8,5,65,26,39,59
Crusaders,7719,2,16,5,9,56,34,22,53
Ballymena,7719,3,16,3,11,57,60,-3,51
Cliftonville,7719,4,14,6,10,55,41,14,48
Coleraine,7719,5,13,7,10,42,33,9,46
Glenavon,7719,6,12,8,10,46,54,-8,44
Dungannon,7719,7,10,7,13,55,42,13,37
Ballinamalla,7719,8,10,5,15,28,43,-15,35
Ards,7719,9,10,4,16,30,52,-22,34
Glentoran,7719,10,8,7,15,27,49,-22,31
Portadown,7719,11,6,6,18,27,54,-27,24
Linfield,7720,1,16,9,5,63,31,32,57
Crusaders,7720,2,16,6,8,60,38,22,54
Cliftonville,7720,3,17,3,10,55,36,19,54
Glenavon,7720,4,12,10,8,53,47,6,46
Ballymena,7720,5,12,7,11,59,62,-3,43
Ards,7720,6,12,4,14,38,51,-13,40
Coleraine,7720,7,10,9,11,39,39,0,39
Glentoran,7720,8,11,6,13,34,43,-9,39
Dungannon,7720,9,8,11,11,45,45,0,35
Ballinamalla,7720,10,8,3,19,33,58,-25,27
Portadown,7720,11,5,8,17,22,51,-29,23
Crusaders,7721,1,18,8,4,62,32,30,62
Cliftonville,7721,2,15,7,8,50,34,16,52
Linfield,7721,3,11,15,4,59,35,24,48
Glenavon,7721,4,10,14,6,44,45,-1,44
Dungannon,7721,5,9,13,8,49,42,7,40
Ballymena,7721,6,8,15,7,48,53,-5,39
Coleraine,7721,7,9,11,10,38,41,-3,38
Glentoran,7721,8,8,11,11,31,43,-12,35
Ards,7721,9,7,8,15,37,50,-13,29
Ballinamalla,7721,10,7,6,17,28,46,-18,27
Portadown,7721,11,4,10,16,24,49,-25,22
Cliftonville,7722,1,17,5,8,53,32,21,56
Linfield,7722,2,13,11,6,60,33,27,50
Glenavon,7722,3,12,11,7,51,43,8,47
Coleraine,7722,4,12,10,8,41,35,6,46
Glentoran,7722,5,14,4,12,33,43,-10,46
Crusaders,7722,6,13,6,11,50,42,8,45
Ballymena,7722,7,12,9,9,57,57,0,45
Dungannon,7722,8,11,10,9,50,38,12,43
Ards,7722,9,8,5,17,33,49,-16,29
Ballinamalla,7722,10,6,6,18,29,52,-23,24
Portadown,7722,11,5,7,18,21,54,-33,22
Linfield,7723,1,18,8,4,65,25,40,62
Cliftonville,7723,2,17,5,8,65,40,25,56
Crusaders,7723,3,15,9,6,53,38,15,54
Ballymena,7723,4,13,6,11,52,56,-4,45
Coleraine,7723,5,11,10,9,44,42,2,43
Dungannon,7723,6,11,8,11,54,52,2,41
Glentoran,7723,7,11,6,13,36,45,-9,39
Ards,7723,8,9,5,16,37,46,-9,32
Glenavon,7723,9,7,10,13,39,50,-11,31
Ballinamalla,7723,10,8,4,18,26,51,-25,28
Portadown,7723,11,6,7,17,24,50,-26,25
Cliftonville,7724,1,19,2,9,56,36,20,59
Linfield,7724,2,15,8,7,55,30,25,53
Ballymena,7724,3,15,7,8,58,55,3,52
Crusaders,7724,4,15,5,10,43,33,10,50
Glenavon,7724,5,13,9,8,49,45,4,48
Dungannon,7724,6,11,7,12,51,38,13,40
Coleraine,7724,7,10,9,11,43,40,3,39
Glentoran,7724,8,10,7,13,32,45,-13,37
Ballinamalla,7724,9,10,4,16,36,54,-18,34
Ards,7724,10,6,6,18,35,55,-20,24
Portadown,7724,11,5,8,17,22,49,-27,23
Linfield,7725,1,16,8,6,66,31,35,56
Cliftonville,7725,2,15,6,9,56,35,21,51
Ballymena,7725,3,15,5,10,62,58,4,50
Crusaders,7725,4,12,11,7,53,40,13,47
Coleraine,7725,5,12,11,7,49,42,7,47
Dungannon,7725,6,11,9,10,48,46,2,42
Glenavon,7725,7,8,15,7,43,45,-2,39
Glentoran,7725,8,10,7,13,31,43,-12,37
Ards,7725,9,9,8,13,41,50,-9,35
Portadown,7725,10,7,4,19,20,49,-29,25
Ballinamalla,7725,11,6,4,20,27,57,-30,22
Linfield,7726,1,15,9,6,55,29,26,54
Crusaders,7726,2,15,8,7,57,40,17,53
Ballymena,7726,3,16,5,9,63,56,7,53
Cliftonville,7726,4,14,6,10,55,39,16,48
Coleraine,7726,5,11,11,8,48,42,6,44
Glenavon,7726,6,10,12,8,45,45,0,42
Ards,7726,7,12,4,14,42,48,-6,40
Glentoran,7726,8,9,8,13,37,47,-10,35
Dungannon,7726,9,7,12,11,49,55,-6,33
Portadown,7726,10,7,4,19,29,53,-24,25
Ballinamalla,7726,11,6,7,17,32,58,-26,25
Crusaders,7727,1,16,9,5,50,31,19,57
Linfield,7727,2,14,13,3,55,27,28,55
Ballymena,7727,3,13,11,6,58,54,4,50
Cliftonville,7727,4,13,7,10,54,43,11,46
Coleraine,7727,5,12,10,8,44,34,10,46
Glenavon,7727,6,12,9,9,50,45,5,45
Dungannon,7727,7,9,11,10,49,44,5,38
Glentoran,7727,8,9,9,12,33,43,-10,36
Portadown,7727,9,6,11,13,25,41,-16,29
Ballinamalla,7727,10,6,5,19,26,58,-32,23
Ards,7727,11,6,3,21,31,55,-24,21
Crusaders,7728,1,17,8,5,66,31,35,59
Cliftonville,7728,2,16,5,9,54,42,12,53
Glenavon,7728,3,14,8,8,54,43,11,50
Ballymena,7728,4,14,7,9,56,55,1,49
Linfield,7728,5,13,8,9,53,31,22,47
Coleraine,7728,6,11,13,6,39,31,8,46
Dungannon,7728,7,11,8,11,54,48,6,41
Ards,7728,8,11,5,14,43,44,-1,38
Glentoran,7728,9,7,9,14,27,50,-23,30
Portadown,7728,10,6,7,17,19,48,-29,25
Ballinamalla,7728,11,5,2,23,19,61,-42,17
Linfield,7729,1,15,9,6,62,38,24,54
Cliftonville,7729,2,16,6,8,58,40,18,54
Dungannon,7729,3,12,9,9,54,39,15,45
Crusaders,7729,4,12,8,10,49,42,7,44
Glenavon,7729,5,10,12,8,51,51,0,42
Ballymena,7729,6,12,6,12,52,57,-5,42
Coleraine,7729,7,9,13,8,42,41,1,40
Ballinamalla,7729,8,11,5,14,29,44,-15,38
Ards,7729,9,10,6,14,41,46,-5,36
Portadown,7729,10,8,5,17,28,53,-25,29
Glentoran,7729,11,6,9,15,35,50,-15,27
Crusaders,7730,1,17,7,6,61,39,22,58
Cliftonville,7730,2,16,4,10,52,43,9,52
Linfield,7730,3,14,7,9,58,37,21,49
Dungannon,7730,4,13,7,10,56,41,15,46
Glenavon,7730,5,12,10,8,52,43,9,46
Coleraine,7730,6,11,9,10,38,35,3,42
Ballymena,7730,7,11,9,10,52,58,-6,42
Ards,7730,8,12,5,13,42,43,-1,41
Glentoran,7730,9,8,8,14,26,44,-18,32
Ballinamalla,7730,10,7,5,18,29,57,-28,26
Portadown,7730,11,4,9,17,27,53,-26,21
Crusaders,7731,1,19,7,4,60,27,33,64
Cliftonville,7731,2,16,7,7,57,38,19,55
Linfield,7731,3,14,9,7,54,32,22,51
Glenavon,7731,4,13,9,8,46,44,2,48
Ballymena,7731,5,12,7,11,50,56,-6,43
Ards,7731,6,12,4,14,41,44,-3,40
Coleraine,7731,7,8,11,11,33,41,-8,35
Dungannon,7731,8,7,11,12,42,40,2,32
Ballinamalla,7731,9,10,2,18,33,50,-17,32
Glentoran,7731,10,7,7,16,29,51,-22,28
Portadown,7731,11,6,8,16,20,42,-22,26
Linfield,7732,1,17,9,4,63,25,38,60
Glenavon,7732,2,15,7,8,55,46,9,52
Crusaders,7732,3,14,8,8,49,37,12,50
Ballymena,7732,4,15,4,11,58,57,1,49
Coleraine,7732,5,11,12,7,43,34,9,45
Cliftonville,7732,6,13,4,13,53,45,8,43
Dungannon,7732,7,11,7,12,51,45,6,40
Ards,7732,8,12,4,14,37,44,-7,40
Ballinamalla,7732,9,11,1,18,31,52,-21,34
Glentoran,7732,10,5,9,16,27,52,-25,24
Portadown,7732,11,6,5,19,24,54,-30,23
Linfield,7733,1,16,8,6,64,28,36,56
Crusaders,7733,2,16,8,6,50,31,19,56
Cliftonville,7733,3,14,7,9,51,42,9,49
Glenavon,7733,4,11,13,6,50,38,12,46
Dungannon,7733,5,11,9,10,49,40,9,42
Ballymena,7733,6,12,6,12,50,65,-15,42
Coleraine,7733,7,9,12,9,37,43,-6,39
Ballinamalla,7733,8,10,5,15,35,44,-9,35
Ards,7733,9,9,6,15,40,50,-10,33
Glentoran,7733,10,9,6,15,27,43,-16,33
Portadown,7733,11,5,6,19,15,44,-29,21
Linfield,7734,1,18,7,5,55,22,33,61
Crusaders,7734,2,18,6,6,61,33,28,60
Cliftonville,7734,3,15,4,11,50,37,13,49
Glenavon,7734,4,12,11,7,53,43,10,47
Ballymena,7734,5,13,8,9,51,53,-2,47
Coleraine,7734,6,9,10,11,39,42,-3,37
Dungannon,7734,7,9,9,12,54,59,-5,36
Glentoran,7734,8,9,9,12,26,35,-9,36
Ards,7734,9,9,3,18,34,52,-18,30
Portadown,7734,10,8,4,18,25,45,-20,28
Ballinamalla,7734,11,7,5,18,28,55,-27,26
Crusaders,7735,1,17,8,5,57,29,28,59
Coleraine,7735,2,14,11,5,53,30,23,53
Linfield,7735,3,14,8,8,59,43,16,50
Glenavon,7735,4,13,11,6,51,43,8,50
Cliftonville,7735,5,13,5,12,46,47,-1,44
Ballymena,7735,6,12,7,11,53,63,-10,43
Dungannon,7735,7,10,9,11,44,43,1,39
Glentoran,7735,8,9,7,14,34,41,-7,34
Portadown,7735,9,9,4,17,27,42,-15,31
Ballinamalla,7735,10,7,6,17,25,51,-26,27
Ards,7735,11,6,6,18,34,51,-17,24
Crusaders,7736,1,16,9,5,56,30,26,57
Linfield,7736,2,15,11,4,61,30,31,56
Glenavon,7736,3,15,8,7,54,40,14,53
Cliftonville,7736,4,14,5,11,54,45,9,47
Ballymena,7736,5,13,8,9,59,53,6,47
Coleraine,7736,6,11,12,7,42,43,-1,45
Dungannon,7736,7,9,10,11,48,48,0,37
Glentoran,7736,8,9,9,12,37,50,-13,36
Ballinamalla,7736,9,8,4,18,28,50,-22,28
Portadown,7736,10,7,4,19,23,51,-28,25
Ards,7736,11,6,4,20,29,51,-22,22
Crusaders,7737,1,16,8,6,60,36,24,56
Cliftonville,7737,2,15,7,8,56,41,15,52
Glenavon,7737,3,13,11,6,53,47,6,50
Linfield,7737,4,13,7,10,54,37,17,46
Ballymena,7737,5,12,8,10,59,64,-5,44
Coleraine,7737,6,11,10,9,37,35,2,43
Glentoran,7737,7,10,7,13,34,42,-8,37
Dungannon,7737,8,9,9,12,54,49,5,36
Ballinamalla,7737,9,10,3,17,27,52,-25,33
Portadown,7737,10,8,7,15,31,50,-19,31
Ards,7737,11,6,7,17,34,46,-12,25
Crusaders,7738,1,19,7,4,65,31,34,64
Linfield,7738,2,13,12,5,54,28,26,51
Cliftonville,7738,3,14,5,11,50,42,8,47
Ballymena,7738,4,13,8,9,53,56,-3,47
Coleraine,7738,5,11,11,8,45,39,6,44
Glenavon,7738,6,10,11,9,47,56,-9,41
Ards,7738,7,10,5,15,38,44,-6,35
Glentoran,7738,8,8,10,12,27,41,-14,34
Dungannon,7738,9,8,9,13,45,44,1,33
Portadown,7738,10,6,9,15,24,44,-20,27
Ballinamalla,7738,11,7,5,18,31,54,-23,26
Crusaders,7739,1,18,7,5,51,27,24,61
Linfield,7739,2,14,10,6,55,27,28,52
Cliftonville,7739,3,15,4,11,51,40,11,49
Dungannon,7739,4,11,11,8,54,37,17,44
Coleraine,7739,5,11,11,8,48,42,6,44
Ballymena,7739,6,13,4,13,52,61,-9,43
Glenavon,7739,7,10,12,8,46,47,-1,42
Glentoran,7739,8,11,5,14,31,47,-16,38
Ards,7739,9,7,8,15,35,50,-15,29
Portadown,7739,10,7,8,15,27,48,-21,29
Ballinamalla,7739,11,6,4,20,25,49,-24,22
Linfield,7740,1,15,9,6,58,27,31,54
Cliftonville,7740,2,16,6,8,51,35,16,54
Crusaders,7740,3,15,6,9,62,43,19,51
Ballymena,7740,4,14,8,8,58,57,1,50
Coleraine,7740,5,10,12,8,43,38,5,42
Portadown,7740,6,11,5,14,32,39,-7,38
Glenavon,7740,7,9,10,11,40,49,-9,37
Dungannon,7740,8,9,8,13,47,46,1,35
Ballinamalla,7740,9,9,5,16,29,55,-26,32
Ards,7740,10,8,7,15,32,44,-12,31
Glentoran,7740,11,6,10,14,21,40,-19,28
Crusaders,7741,1,18,6,6,57,31,26,60
Linfield,7741,2,16,9,5,63,32,31,57
Ballymena,7741,3,15,6,9,57,55,2,51
Cliftonville,7741,4,15,5,10,51,43,8,50
Coleraine,7741,5,13,8,9,50,41,9,47
Glenavon,7741,6,13,8,9,54,49,5,47
Dungannon,7741,7,9,7,14,46,43,3,34
Ards,7741,8,9,4,17,34,49,-15,31
Ballinamalla,7741,8,9,4,17,34,49,-15,31
Portadown,7741,10,8,4,18,26,52,-26,28
Glentoran,7741,11,7,5,18,23,51,-28,26
Crusaders,7742,1,17,7,6,60,33,27,58
Linfield,7742,2,15,10,5,70,35,35,55
Cliftonville,7742,3,17,3,10,52,39,13,54
Coleraine,7742,4,14,8,8,41,39,2,50
Glenavon,7742,5,12,9,9,43,45,-2,45
Dungannon,7742,6,11,10,9,55,44,11,43
Ballymena,7742,7,11,10,9,55,59,-4,43
Glentoran,7742,8,9,9,12,31,44,-13,36
Portadown,7742,9,10,2,18,30,43,-13,32
Ards,7742,10,6,4,20,35,61,-26,22
Ballinamalla,7742,11,5,4,21,30,60,-30,19
Crusaders,7743,1,16,9,5,54,31,23,57
Linfield,7743,2,13,11,6,59,40,19,50
Ballymena,7743,3,14,6,10,55,53,2,48
Cliftonville,7743,4,13,8,9,47,36,11,47
Dungannon,7743,5,10,13,7,54,41,13,43
Coleraine,7743,6,10,12,8,42,43,-1,42
Glenavon,7743,7,9,14,7,40,38,2,41
Ards,7743,8,8,9,13,33,41,-8,33
Ballinamalla,7743,9,8,6,16,27,47,-20,30
Glentoran,7743,10,6,11,13,26,44,-18,29
Portadown,7743,11,5,7,18,20,43,-23,22
Linfield,7744,1,16,10,4,67,34,33,58
Crusaders,7744,2,16,7,7,58,32,26,55
Ballymena,7744,3,14,5,11,65,56,9,47
Coleraine,7744,4,12,10,8,46,36,10,46
Cliftonville,7744,5,12,7,11,44,46,-2,43
Glenavon,7744,6,10,10,10,43,46,-3,40
Glentoran,7744,7,11,7,12,31,40,-9,40
Ards,7744,8,12,3,15,40,54,-14,39
Dungannon,7744,9,7,10,13,45,49,-4,31
Portadown,7744,10,8,6,16,27,49,-22,30
Ballinamalla,7744,11,7,5,18,35,59,-24,26
Crusaders,7745,1,16,9,5,56,37,19,57
Cliftonville,7745,2,15,6,9,57,45,12,51
Linfield,7745,3,14,8,8,62,35,27,50
Coleraine,7745,4,13,10,7,47,34,13,49
Ballymena,7745,5,14,4,12,63,63,0,46
Glenavon,7745,6,10,11,9,50,47,3,41
Dungannon,7745,7,8,10,12,45,51,-6,34
Ards,7745,8,9,7,14,33,42,-9,34
Glentoran,7745,9,9,7,14,29,44,-15,34
Ballinamalla,7745,10,10,4,16,30,47,-17,34
Portadown,7745,11,6,6,18,27,54,-27,24
Linfield,7746,1,15,9,6,58,31,27,54
Crusaders,7746,2,15,8,7,56,36,20,53
Ballymena,7746,3,14,7,9,63,57,6,49
Cliftonville,7746,4,14,5,11,46,41,5,47
Ards,7746,5,14,4,12,41,39,2,46
Glenavon,7746,6,11,10,9,49,44,5,43
Glentoran,7746,7,11,8,11,27,37,-10,41
Coleraine,7746,8,10,7,13,40,45,-5,37
Dungannon,7746,9,7,10,13,45,50,-5,31
Ballinamalla,7746,10,7,7,16,28,48,-20,28
Portadown,7746,11,6,7,17,28,53,-25,25
Coleraine,7747,1,16,8,6,48,31,17,56
Linfield,7747,2,16,6,8,58,29,29,54
Crusaders,7747,3,15,7,8,51,36,15,52
Dungannon,7747,4,13,9,8,53,37,16,48
Ballymena,7747,5,13,6,11,57,63,-6,45
Cliftonville,7747,6,14,2,14,49,45,4,44
Portadown,7747,7,11,4,15,33,45,-12,37
Glenavon,7747,8,7,12,11,47,54,-7,33
Ards,7747,9,9,6,15,39,51,-12,33
Glentoran,7747,10,7,9,14,28,50,-22,30
Ballinamalla,7747,11,7,5,18,30,52,-22,26
Crusaders,7748,1,18,6,6,55,28,27,60
Cliftonville,7748,2,15,5,10,49,39,10,50
Ballymena,7748,3,14,7,9,55,57,-2,49
Linfield,7748,4,12,12,6,57,33,24,48
Glenavon,7748,5,11,9,10,40,44,-4,42
Coleraine,7748,6,10,10,10,38,41,-3,40
Portadown,7748,7,12,4,14,36,44,-8,40
Ballinamalla,7748,8,11,5,14,37,47,-10,38
Dungannon,7748,9,9,6,15,49,50,-1,33
Ards,7748,10,8,6,16,37,52,-15,30
Glentoran,7748,11,6,8,16,25,43,-18,26
Ballymena,7749,1,17,4,9,70,50,20,55
Linfield,7749,2,15,8,7,55,31,24,53
Crusaders,7749,3,15,7,8,52,45,7,52
Cliftonville,7749,4,16,3,11,51,39,12,51
Glenavon,7749,5,12,12,6,53,42,11,48
Coleraine,7749,6,13,8,9,43,34,9,47
Glentoran,7749,7,12,5,13,40,44,-4,41
Dungannon,7749,8,9,9,12,52,55,-3,36
Ards,7749,9,8,5,17,30,49,-19,29
Ballinamalla,7749,10,8,2,20,30,56,-26,26
Portadown,7749,11,6,5,19,25,56,-31,23
Cliftonville,7750,1,18,6,6,58,32,26,60
Linfield,7750,2,13,12,5,55,32,23,51
Crusaders,7750,3,14,8,8,49,37,12,50
Ballymena,7750,4,14,7,9,56,53,3,49
Coleraine,7750,5,12,11,7,42,36,6,47
Dungannon,7750,6,10,13,7,48,37,11,43
Glenavon,7750,7,8,11,11,41,50,-9,35
Glentoran,7750,8,7,11,12,32,42,-10,32
Portadown,7750,9,7,6,17,22,40,-18,27
Ards,7750,10,7,5,18,36,52,-16,26
Ballinamalla,7750,11,6,8,16,24,52,-28,26
Linfield,7751,1,16,11,3,60,26,34,59
Crusaders,7751,2,17,6,7,54,33,21,57
Ballymena,7751,3,17,4,9,64,63,1,55
Cliftonville,7751,4,15,4,11,55,42,13,49
Coleraine,7751,5,12,10,8,44,35,9,46
Dungannon,7751,6,10,12,8,54,45,9,42
Glenavon,7751,7,10,11,9,52,52,0,41
Ards,7751,8,8,6,16,44,54,-10,30
Glentoran,7751,9,7,8,15,28,49,-21,29
Portadown,7751,10,5,8,17,28,53,-25,23
Ballinamalla,7751,11,6,4,20,27,58,-31,22
Cliftonville,7752,1,18,3,9,50,33,17,57
Crusaders,7752,2,16,8,6,56,40,16,56
Ballymena,7752,3,16,4,10,58,51,7,52
Glenavon,7752,4,14,9,7,48,41,7,51
Linfield,7752,5,12,11,7,52,36,16,47
Coleraine,7752,6,10,11,9,43,39,4,41
Dungannon,7752,7,11,7,12,53,47,6,40
Ards,7752,8,11,4,15,39,46,-7,37
Glentoran,7752,9,8,7,15,36,47,-11,31
Ballinamalla,7752,10,9,2,19,26,50,-24,29
Portadown,7752,11,4,6,20,22,53,-31,18
Crusaders,7753,1,18,6,6,57,37,20,60
Linfield,7753,2,14,12,4,61,34,27,54
Cliftonville,7753,3,14,8,8,49,32,17,50
Glenavon,7753,4,12,10,8,49,43,6,46
Dungannon,7753,5,11,10,9,47,39,8,43
Ballinamalla,7753,6,11,5,14,36,46,-10,38
Ballymena,7753,7,10,7,13,50,62,-12,37
Coleraine,7753,8,8,11,11,40,43,-3,35
Glentoran,7753,9,9,7,14,31,44,-13,34
Ards,7753,10,7,9,14,34,50,-16,30
Portadown,7753,11,7,3,20,29,53,-24,24
Ballymena,7754,1,18,4,8,62,50,12,58
Crusaders,7754,2,16,7,7,57,35,22,55
Cliftonville,7754,3,16,7,7,56,41,15,55
Linfield,7754,4,14,9,7,60,37,23,51
Glenavon,7754,5,13,10,7,49,44,5,49
Dungannon,7754,6,11,9,10,55,45,10,42
Coleraine,7754,7,11,9,10,47,48,-1,42
Glentoran,7754,8,10,9,11,44,47,-3,39
Ards,7754,9,8,5,17,38,54,-16,29
Ballinamalla,7754,10,7,3,20,27,59,-32,24
Portadown,7754,11,4,2,24,17,52,-35,14
Linfield,7755,1,15,10,5,58,30,28,55
Crusaders,7755,2,16,6,8,51,34,17,54
Ballymena,7755,3,15,8,7,62,52,10,53
Glenavon,7755,4,13,10,7,51,44,7,49
Cliftonville,7755,5,13,7,10,44,38,6,46
Coleraine,7755,6,11,11,8,41,37,4,44
Dungannon,7755,7,10,10,10,52,42,10,40
Glentoran,7755,8,10,6,14,28,41,-13,36
Ballinamalla,7755,9,7,6,17,29,50,-21,27
Portadown,7755,10,7,4,19,24,50,-26,25
Ards,7755,11,6,6,18,29,51,-22,24
Crusaders,7756,1,17,7,6,58,32,26,58
Cliftonville,7756,2,16,8,6,52,34,18,56
Linfield,7756,3,14,8,8,58,28,30,50
Coleraine,7756,4,14,8,8,51,36,15,50
Ballymena,7756,5,14,6,10,59,56,3,48
Dungannon,7756,6,9,10,11,47,44,3,37
Ards,7756,7,10,5,15,37,47,-10,35
Glenavon,7756,8,8,10,12,40,52,-12,34
Ballinamalla,7756,9,9,6,15,35,49,-14,33
Glentoran,7756,10,6,9,15,23,54,-31,27
Portadown,7756,11,7,5,18,23,51,-28,26
Cliftonville,7757,1,18,3,9,62,37,25,57
Crusaders,7757,2,17,5,8,51,31,20,56
Linfield,7757,3,15,9,6,66,34,32,54
Glenavon,7757,4,12,11,7,44,43,1,47
Coleraine,7757,5,10,12,8,39,38,1,42
Ballinamalla,7757,6,11,5,14,33,48,-15,38
Ballymena,7757,7,11,5,14,53,70,-17,38
Glentoran,7757,8,9,7,14,32,43,-11,34
Dungannon,7757,9,8,7,15,42,44,-2,31
Ards,7757,10,9,4,17,32,48,-16,31
Portadown,7757,11,8,6,16,28,46,-18,30
Linfield,7758,1,16,7,7,55,32,23,55
Cliftonville,7758,2,15,5,10,50,36,14,50
Crusaders,7758,3,13,9,8,47,35,12,48
Glentoran,7758,4,14,6,10,38,37,1,48
Coleraine,7758,5,12,9,9,44,33,11,45
Ballymena,7758,6,12,8,10,60,58,2,44
Glenavon,7758,7,9,14,7,43,40,3,41
Dungannon,7758,8,9,8,13,46,49,-3,35
Ballinamalla,7758,9,10,5,15,37,49,-12,35
Ards,7758,10,7,6,17,33,56,-23,27
Portadown,7758,11,6,7,17,21,49,-28,25
Crusaders,7759,1,17,8,5,55,31,24,59
Ballymena,7759,2,18,4,8,61,48,13,58
Glenavon,7759,3,13,11,6,53,45,8,50
Linfield,7759,4,13,9,8,58,37,21,48
Coleraine,7759,5,13,8,9,44,39,5,47
Cliftonville,7759,6,14,3,13,47,40,7,45
Dungannon,7759,7,9,9,12,52,52,0,36
Ards,7759,8,9,5,16,33,47,-14,32
Glentoran,7759,9,7,9,14,26,42,-16,30
Portadown,7759,10,8,4,18,26,50,-24,28
Ballinamalla,7759,11,6,6,18,29,53,-24,24
Linfield,7760,1,15,9,6,64,31,33,54
Crusaders,7760,2,15,9,6,53,39,14,54
Glentoran,7760,3,15,7,8,43,37,6,52
Cliftonville,7760,4,15,5,10,49,40,9,50
Ballymena,7760,5,14,8,8,62,58,4,50
Glenavon,7760,6,11,11,8,44,43,1,44
Coleraine,7760,7,10,11,9,40,40,0,41
Dungannon,7760,8,9,10,11,47,46,1,37
Ballinamalla,7760,9,7,5,18,30,56,-26,26
Ards,7760,10,6,6,18,35,52,-17,24
Portadown,7760,11,6,3,21,23,48,-25,21
Crusaders,7761,1,15,9,6,56,37,19,54
Linfield,7761,2,14,11,5,58,29,29,53
Ballymena,7761,3,14,6,10,61,52,9,48
Cliftonville,7761,4,14,6,10,49,43,6,48
Coleraine,7761,5,11,13,6,46,42,4,46
Glenavon,7761,6,10,11,9,38,41,-3,41
Glentoran,7761,7,11,7,12,35,44,-9,40
Ards,7761,8,10,5,15,38,49,-11,35
Dungannon,7761,9,8,10,12,47,46,1,34
Portadown,7761,10,6,9,15,22,41,-19,27
Ballinamalla,7761,11,7,3,20,23,49,-26,24
Cliftonville,7762,1,15,7,8,59,44,15,52
Crusaders,7762,2,15,7,8,53,38,15,52
Dungannon,7762,3,13,10,7,49,38,11,49
Glenavon,7762,4,13,9,8,49,39,10,48
Coleraine,7762,5,11,12,7,44,37,7,45
Linfield,7762,6,11,10,9,56,34,22,43
Ballymena,7762,7,12,6,12,54,60,-6,42
Glentoran,7762,8,10,5,15,30,51,-21,35
Ards,7762,9,8,6,16,38,49,-11,30
Ballinamalla,7762,10,8,6,16,30,50,-20,30
Portadown,7762,11,6,8,16,22,44,-22,26
Crusaders,7763,1,17,7,6,57,36,21,58
Linfield,7763,2,14,12,4,58,31,27,54
Glenavon,7763,3,14,10,6,52,45,7,52
Ballymena,7763,4,15,5,10,55,52,3,50
Cliftonville,7763,5,13,4,13,46,46,0,43
Dungannon,7763,6,11,8,11,55,42,13,41
Coleraine,7763,7,10,8,12,37,41,-4,38
Glentoran,7763,8,11,4,15,35,48,-13,37
Ards,7763,9,9,4,17,39,54,-15,31
Ballinamalla,7763,10,8,5,17,36,57,-21,29
Portadown,7763,11,8,3,19,26,44,-18,27
Crusaders,7764,1,16,11,3,61,32,29,59
Linfield,7764,2,15,7,8,54,32,22,52
Cliftonville,7764,3,14,6,10,51,39,12,48
Coleraine,7764,4,10,11,9,42,35,7,41
Glenavon,7764,5,9,12,9,46,50,-4,39
Ballymena,7764,6,10,9,11,48,55,-7,39
Dungannon,7764,7,9,11,10,42,41,1,38
Glentoran,7764,8,11,5,14,29,45,-16,38
Ballinamalla,7764,9,10,5,15,30,45,-15,35
Ards,7764,10,10,3,17,35,45,-10,33
Portadown,7764,11,8,6,16,24,43,-19,30
Linfield,7765,1,16,7,7,60,38,22,55
Crusaders,7765,2,16,6,8,61,39,22,54
Cliftonville,7765,3,14,8,8,50,35,15,50
Ballymena,7765,4,13,9,8,65,60,5,48
Glenavon,7765,5,10,11,9,45,49,-4,41
Coleraine,7765,6,9,13,8,51,53,-2,40
Dungannon,7765,7,9,10,11,44,39,5,37
Glentoran,7765,8,9,8,13,35,45,-10,35
Ards,7765,9,9,5,16,41,52,-11,32
Portadown,7765,10,7,8,15,26,48,-22,29
Ballinamalla,7765,11,7,7,16,27,47,-20,28
Crusaders,7766,1,19,7,4,64,32,32,64
Coleraine,7766,2,15,9,6,55,36,19,54
Cliftonville,7766,3,16,6,8,49,35,14,54
Ballymena,7766,4,13,9,8,55,58,-3,48
Glenavon,7766,5,10,11,9,44,40,4,41
Linfield,7766,6,10,10,10,47,37,10,40
Dungannon,7766,7,10,9,11,49,45,4,39
Ballinamalla,7766,8,8,9,13,31,45,-14,33
Glentoran,7766,9,6,12,12,28,44,-16,30
Ards,7766,10,6,7,17,30,53,-23,25
Portadown,7766,11,4,7,19,21,48,-27,19
Linfield,7767,1,16,8,6,61,31,30,56
Crusaders,7767,2,16,8,6,53,33,20,56
Ballymena,7767,3,15,5,10,67,60,7,50
Cliftonville,7767,4,14,4,12,48,37,11,46
Coleraine,7767,5,12,10,8,42,41,1,46
Glenavon,7767,6,12,9,9,50,52,-2,45
Ards,7767,7,10,5,15,35,47,-12,35
Glentoran,7767,8,10,5,15,36,52,-16,35
Portadown,7767,9,9,5,16,25,38,-13,32
Dungannon,7767,10,7,8,15,48,53,-5,29
Ballinamalla,7767,11,7,7,16,26,47,-21,28
Crusaders,7768,1,15,9,6,51,33,18,54
Ballymena,7768,2,15,6,9,60,54,6,51
Linfield,7768,3,14,8,8,55,34,21,50
Dungannon,7768,4,12,9,9,51,38,13,45
Coleraine,7768,5,11,11,8,46,42,4,44
Cliftonville,7768,6,13,5,12,44,42,2,44
Ards,7768,7,11,6,13,45,48,-3,39
Glenavon,7768,8,8,13,9,47,52,-5,37
Glentoran,7768,9,9,8,13,34,46,-12,35
Portadown,7768,10,7,6,17,27,49,-22,27
Ballinamalla,7768,11,7,5,18,34,56,-22,26
Crusaders,7769,1,18,9,3,57,29,28,63
Cliftonville,7769,2,15,6,9,52,36,16,51
Glenavon,7769,3,13,8,9,51,45,6,47
Ballymena,7769,4,14,5,11,58,54,4,47
Coleraine,7769,5,12,10,8,43,35,8,46
Linfield,7769,6,11,8,11,56,44,12,41
Dungannon,7769,7,10,9,11,46,40,6,39
Ards,7769,8,10,4,16,39,48,-9,34
Glentoran,7769,9,7,9,14,35,54,-19,30
Portadown,7769,10,8,5,17,24,50,-26,29
Ballinamalla,7769,11,7,7,16,24,50,-26,28
Linfield,7770,1,17,8,5,64,34,30,59
Crusaders,7770,2,15,9,6,56,36,20,54
Cliftonville,7770,3,16,5,9,55,39,16,53
Dungannon,7770,4,13,9,8,54,40,14,48
Glenavon,7770,5,11,12,7,46,49,-3,45
Ballymena,7770,6,11,4,15,56,70,-14,37
Coleraine,7770,7,9,9,12,38,40,-2,36
Portadown,7770,8,9,7,14,32,41,-9,34
Ards,7770,9,9,5,16,43,52,-9,32
Glentoran,7770,10,7,7,16,27,45,-18,28
Ballinamalla,7770,11,7,7,16,30,55,-25,28
Linfield,7771,1,16,8,6,59,28,31,56
Crusaders,7771,2,15,9,6,53,37,16,54
Glenavon,7771,3,15,9,6,57,43,14,54
Ballymena,7771,4,14,6,10,63,60,3,48
Cliftonville,7771,5,13,6,11,46,42,4,45
Coleraine,7771,6,10,9,11,34,50,-16,39
Dungannon,7771,7,8,12,10,53,43,10,36
Glentoran,7771,8,9,7,14,31,44,-13,34
Ards,7771,9,9,6,15,44,52,-8,33
Ballinamalla,7771,10,8,6,16,30,46,-16,30
Portadown,7771,11,4,10,16,19,44,-25,22
Crusaders,7772,1,18,7,5,60,31,29,61
Linfield,7772,2,14,9,7,57,39,18,51
Glenavon,7772,3,13,11,6,44,39,5,50
Ballymena,7772,4,14,8,8,63,61,2,50
Cliftonville,7772,5,13,8,9,53,43,10,47
Coleraine,7772,6,11,10,9,41,36,5,43
Dungannon,7772,7,9,9,12,47,46,1,36
Ards,7772,8,10,3,17,40,52,-12,33
Ballinamalla,7772,9,10,2,18,28,49,-21,32
Glentoran,7772,10,7,7,16,31,50,-19,28
Portadown,7772,11,7,4,19,26,44,-18,25
Linfield,7773,1,15,10,5,67,26,41,55
Crusaders,7773,2,15,7,8,56,37,19,52
Glenavon,7773,3,12,11,7,60,51,9,47
Dungannon,7773,4,12,10,8,55,41,14,46
Cliftonville,7773,5,12,9,9,52,43,9,45
Coleraine,7773,6,11,12,7,44,44,0,45
Ballymena,7773,7,11,8,11,59,64,-5,41
Ards,7773,8,8,7,15,32,45,-13,31
Ballinamalla,7773,9,8,6,16,30,51,-21,30
Glentoran,7773,10,7,9,14,25,46,-21,30
Portadown,7773,11,6,7,17,22,54,-32,25
Linfield,7774,1,16,10,4,56,24,32,58
Cliftonville,7774,2,15,8,7,53,34,19,53
Crusaders,7774,3,14,8,8,57,46,11,50
Coleraine,7774,4,10,13,7,44,40,4,43
Glenavon,7774,5,10,12,8,47,45,2,42
Dungannon,7774,6,10,9,11,41,37,4,39
Ballymena,7774,7,10,8,12,52,62,-10,38
Glentoran,7774,8,8,9,13,29,44,-15,33
Portadown,7774,9,9,6,15,28,43,-15,33
Ards,7774,10,9,5,16,34,47,-13,32
Ballinamalla,7774,11,7,6,17,32,51,-19,27
Cliftonville,7775,1,18,5,7,57,32,25,59
Crusaders,7775,2,17,6,7,54,39,15,57
Linfield,7775,3,15,7,8,62,42,20,52
Ballymena,7775,4,14,5,11,60,59,1,47
Dungannon,7775,5,10,11,9,51,43,8,41
Coleraine,7775,6,10,11,9,38,39,-1,41
Glenavon,7775,7,10,10,10,52,45,7,40
Ballinamalla,7775,8,10,5,15,37,51,-14,35
Glentoran,7775,9,8,10,12,32,44,-12,34
Ards,7775,10,9,4,17,38,57,-19,31
Portadown,7775,11,4,6,20,17,47,-30,18
Crusaders,7776,1,19,6,5,62,35,27,63
Linfield,7776,2,15,8,7,57,34,23,53
Cliftonville,7776,3,16,4,10,51,43,8,52
Glenavon,7776,4,11,11,8,48,43,5,44
Coleraine,7776,5,9,13,8,39,35,4,40
Dungannon,7776,6,9,11,10,57,49,8,38
Portadown,7776,7,10,6,14,32,46,-14,36
Ards,7776,8,10,5,15,35,45,-10,35
Ballymena,7776,9,9,7,14,48,60,-12,34
Glentoran,7776,10,7,8,15,31,49,-18,29
Ballinamalla,7776,11,8,5,17,30,51,-21,29
Crusaders,7777,1,18,6,6,62,35,27,60
Linfield,7777,2,16,9,5,69,30,39,57
Cliftonville,7777,3,16,4,10,61,41,20,52
Glenavon,7777,4,15,7,8,49,48,1,52
Ballymena,7777,5,14,3,13,54,64,-10,45
Dungannon,7777,6,10,10,10,49,45,4,40
Coleraine,7777,7,10,9,11,42,47,-5,39
Ballinamalla,7777,8,11,3,16,39,46,-7,36
Portadown,7777,9,6,9,15,34,50,-16,27
Ards,7777,10,8,3,19,33,55,-22,27
Glentoran,7777,11,6,7,17,25,56,-31,25
Linfield,7778,1,15,9,6,61,31,30,54
Crusaders,7778,2,15,8,7,60,36,24,53
Coleraine,7778,3,14,8,8,46,39,7,50
Ballymena,7778,4,13,7,10,53,59,-6,46
Glentoran,7778,5,12,9,9,38,39,-1,45
Cliftonville,7778,6,12,7,11,53,45,8,43
Glenavon,7778,7,10,10,10,46,49,-3,40
Ards,7778,8,10,6,14,42,46,-4,36
Dungannon,7778,9,7,13,10,45,49,-4,34
Portadown,7778,10,9,4,17,27,51,-24,31
Ballinamalla,7778,11,7,1,22,27,54,-27,22
Crusaders,7779,1,16,7,7,60,29,31,55
Cliftonville,7779,2,16,7,7,54,33,21,55
Ballymena,7779,3,14,8,8,64,61,3,50
Linfield,7779,4,12,9,9,58,33,25,45
Coleraine,7779,5,10,13,7,41,37,4,43
Glenavon,7779,6,10,12,8,46,42,4,42
Ards,7779,7,12,5,13,41,46,-5,41
Dungannon,7779,8,10,10,10,46,43,3,40
Glentoran,7779,9,7,6,17,26,53,-27,27
Portadown,7779,10,7,6,17,20,54,-34,27
Ballinamalla,7779,11,6,7,17,29,54,-25,25
Crusaders,7780,1,17,7,6,65,37,28,58
Cliftonville,7780,2,18,3,9,67,43,24,57
Ballymena,7780,3,16,4,10,64,68,-4,52
Linfield,7780,4,13,8,9,60,37,23,47
Glenavon,7780,5,12,9,9,49,47,2,45
Coleraine,7780,6,11,10,9,45,44,1,43
Dungannon,7780,7,10,9,11,50,48,2,39
Ards,7780,8,9,7,14,37,45,-8,34
Ballinamalla,7780,9,10,2,18,38,56,-18,32
Glentoran,7780,10,7,7,16,35,59,-24,28
Portadown,7780,11,7,4,19,28,54,-26,25
Crusaders,7781,1,19,5,6,59,33,26,62
Linfield,7781,2,14,10,6,62,38,24,52
Ballymena,7781,3,15,4,11,63,60,3,49
Cliftonville,7781,4,13,5,12,55,45,10,44
Coleraine,7781,5,12,8,10,47,42,5,44
Dungannon,7781,6,11,9,10,56,48,8,42
Glenavon,7781,7,10,10,10,46,44,2,40
Glentoran,7781,8,10,5,15,28,47,-19,35
Portadown,7781,9,9,6,15,29,48,-19,33
Ards,7781,10,9,5,16,38,53,-15,32
Ballinamalla,7781,11,7,5,18,29,54,-25,26
Crusaders,7782,1,17,9,4,58,29,29,60
Cliftonville,7782,2,17,3,10,67,48,19,54
Glenavon,7782,3,13,9,8,51,49,2,48
Linfield,7782,4,13,8,9,55,35,20,47
Ballymena,7782,5,13,6,11,48,51,-3,45
Coleraine,7782,6,10,11,9,41,45,-4,41
Dungannon,7782,7,10,8,12,54,46,8,38
Ards,7782,8,9,7,14,36,47,-11,34
Portadown,7782,9,9,4,17,30,52,-22,31
Glentoran,7782,10,7,9,14,29,47,-18,30
Ballinamalla,7782,11,8,4,18,35,55,-20,28
Crusaders,7783,1,17,9,4,52,31,21,60
Linfield,7783,2,12,13,5,59,32,27,49
Cliftonville,7783,3,14,4,12,53,39,14,46
Ballymena,7783,4,13,7,10,57,59,-2,46
Coleraine,7783,5,12,9,9,42,42,0,45
Glenavon,7783,6,11,10,9,50,46,4,43
Dungannon,7783,7,10,9,11,47,44,3,39
Glentoran,7783,8,9,8,13,30,45,-15,35
Ards,7783,9,9,4,17,41,57,-16,31
Ballinamalla,7783,10,7,9,14,28,45,-17,30
Portadown,7783,11,6,8,16,25,44,-19,26
Ballymena,7784,1,18,4,8,64,54,10,58
Crusaders,7784,2,16,8,6,60,43,17,56
Coleraine,7784,3,13,11,6,51,39,12,50
Linfield,7784,4,13,9,8,56,35,21,48
Cliftonville,7784,5,11,8,11,53,47,6,41
Dungannon,7784,6,10,10,10,55,48,7,40
Glenavon,7784,7,10,10,10,47,48,-1,40
Ards,7784,8,11,5,14,37,46,-9,38
Portadown,7784,9,8,6,16,30,46,-16,30
Ballinamalla,7784,10,7,5,18,27,53,-26,26
Glentoran,7784,11,5,10,15,23,44,-21,25
Crusaders,7785,1,16,8,6,55,37,18,56
Glenavon,7785,2,14,13,3,53,37,16,55
Linfield,7785,3,14,11,5,57,28,29,53
Cliftonville,7785,4,14,5,11,43,42,1,47
Ballymena,7785,5,13,8,9,50,52,-2,47
Coleraine,7785,6,12,9,9,50,41,9,45
Dungannon,7785,7,7,9,14,44,49,-5,30
Ards,7785,8,7,9,14,37,44,-7,30
Portadown,7785,9,8,6,16,28,43,-15,30
Glentoran,7785,10,7,9,14,27,47,-20,30
Ballinamalla,7785,11,7,5,18,26,50,-24,26
Crusaders,7786,1,15,7,8,51,33,18,52
Glenavon,7786,2,14,9,7,54,38,16,51
Ballymena,7786,3,16,3,11,63,60,3,51
Cliftonville,7786,4,15,5,10,55,42,13,50
Dungannon,7786,5,13,9,8,53,39,14,48
Linfield,7786,6,13,8,9,65,39,26,47
Coleraine,7786,7,9,10,11,33,37,-4,37
Ards,7786,8,10,5,15,32,45,-13,35
Portadown,7786,9,10,4,16,33,43,-10,34
Glentoran,7786,10,7,7,16,26,56,-30,28
Ballinamalla,7786,11,8,3,19,24,57,-33,27
Crusaders,7787,1,19,6,5,57,31,26,63
Cliftonville,7787,2,17,4,9,50,35,15,55
Linfield,7787,3,15,8,7,64,31,33,53
Glenavon,7787,4,12,10,8,44,42,2,46
Coleraine,7787,5,9,12,9,41,36,5,39
Dungannon,7787,6,10,8,12,51,45,6,38
Glentoran,7787,7,10,7,13,39,44,-5,37
Ballymena,7787,8,10,6,14,51,68,-17,36
Ards,7787,9,10,4,16,34,51,-17,34
Ballinamalla,7787,10,9,5,16,36,52,-16,32
Portadown,7787,11,7,4,19,20,52,-32,25
Crusaders,7788,1,17,7,6,61,33,28,58
Linfield,7788,2,15,9,6,67,36,31,54
Cliftonville,7788,3,16,6,8,55,33,22,54
Coleraine,7788,4,12,11,7,40,33,7,47
Ballymena,7788,5,12,8,10,54,61,-7,44
Dungannon,7788,6,10,10,10,53,42,11,40
Glenavon,7788,7,8,14,8,43,47,-4,38
Ards,7788,8,10,5,15,39,54,-15,35
Ballinamalla,7788,9,10,4,16,35,50,-15,34
Glentoran,7788,10,6,7,17,32,60,-28,25
Portadown,7788,11,6,5,19,24,54,-30,23
Crusaders,7789,1,21,5,4,65,31,34,68
Cliftonville,7789,2,16,4,10,46,35,11,52
Linfield,7789,3,13,9,8,62,36,26,48
Ballymena,7789,4,14,4,12,58,61,-3,46
Coleraine,7789,5,11,10,9,40,35,5,43
Dungannon,7789,6,10,10,10,47,42,5,40
Glenavon,7789,7,9,11,10,40,46,-6,38
Ards,7789,8,11,5,14,39,45,-6,38
Ballinamalla,7789,9,10,3,17,39,52,-13,33
Glentoran,7789,10,7,11,12,37,53,-16,32
Portadown,7789,11,4,6,20,20,57,-37,18
Linfield,7790,1,16,9,5,65,31,34,57
Crusaders,7790,2,16,9,5,52,34,18,57
Glenavon,7790,3,13,14,3,52,36,16,53
Ballymena,7790,4,16,5,9,57,54,3,53
Cliftonville,7790,5,14,6,10,51,37,14,48
Coleraine,7790,6,11,8,11,39,40,-1,41
Dungannon,7790,7,9,12,9,48,45,3,39
Ards,7790,8,10,4,16,36,50,-14,34
Ballinamalla,7790,9,8,4,18,31,50,-19,28
Glentoran,7790,10,7,5,18,34,50,-16,26
Portadown,7790,11,5,4,21,23,61,-38,19
Linfield,7791,1,16,9,5,67,33,34,57
Cliftonville,7791,2,17,6,7,53,38,15,57
Crusaders,7791,3,16,6,8,54,38,16,54
Coleraine,7791,4,11,12,7,42,36,6,45
Dungannon,7791,5,11,9,10,56,44,12,42
Glenavon,7791,6,9,11,10,46,51,-5,38
Glentoran,7791,7,9,11,10,30,36,-6,38
Ballymena,7791,8,10,7,13,52,65,-13,37
Ballinamalla,7791,9,9,4,17,33,49,-16,31
Ards,7791,10,7,7,16,39,54,-15,28
Portadown,7791,11,6,6,18,28,56,-28,24
Cliftonville,7792,1,17,3,10,54,42,12,54
Crusaders,7792,2,14,8,8,61,47,14,50
Ballymena,7792,3,14,7,9,62,64,-2,49
Linfield,7792,4,13,9,8,57,39,18,48
Glenavon,7792,5,13,9,8,55,48,7,48
Ards,7792,6,12,6,12,52,46,6,42
Coleraine,7792,7,10,11,9,49,41,8,41
Glentoran,7792,8,8,11,11,34,46,-12,35
Dungannon,7792,9,8,10,12,46,51,-5,34
Portadown,7792,10,8,7,15,29,47,-18,31
Ballinamalla,7792,11,6,3,21,30,58,-28,21
Linfield,7793,1,18,10,2,63,23,40,64
Crusaders,7793,2,15,9,6,50,30,20,54
Ballymena,7793,3,15,5,10,53,60,-7,50
Cliftonville,7793,4,14,5,11,48,39,9,47
Coleraine,7793,5,12,9,9,41,38,3,45
Glenavon,7793,6,12,8,10,48,45,3,44
Dungannon,7793,7,11,8,11,59,48,11,41
Glentoran,7793,8,10,7,13,33,48,-15,37
Ards,7793,9,7,6,17,39,50,-11,27
Ballinamalla,7793,10,7,3,20,29,60,-31,24
Portadown,7793,11,5,8,17,24,46,-22,23
Linfield,7794,1,19,7,4,69,25,44,64
Cliftonville,7794,2,20,3,7,56,32,24,63
Crusaders,7794,3,14,6,10,54,44,10,48
Coleraine,7794,4,11,11,8,39,33,6,44
Dungannon,7794,5,12,7,11,52,44,8,43
Glenavon,7794,6,11,9,10,47,48,-1,42
Ballymena,7794,7,11,6,13,52,64,-12,39
Portadown,7794,8,11,3,16,30,43,-13,36
Glentoran,7794,9,9,6,15,34,51,-17,33
Ballinamalla,7794,10,7,5,18,38,58,-20,26
Ards,7794,11,6,5,19,28,57,-29,23
Crusaders,7795,1,21,6,3,66,30,36,69
Glenavon,7795,2,13,12,5,55,42,13,51
Cliftonville,7795,3,15,4,11,55,43,12,49
Linfield,7795,4,12,10,8,49,30,19,46
Dungannon,7795,5,11,8,11,51,42,9,41
Ballymena,7795,6,11,7,12,51,62,-11,40
Coleraine,7795,7,10,9,11,39,40,-1,39
Ards,7795,8,9,5,16,36,50,-14,32
Glentoran,7795,9,8,8,14,29,44,-15,32
Ballinamalla,7795,10,7,8,15,27,49,-22,29
Portadown,7795,11,7,5,18,24,50,-26,26
Crusaders,7796,1,20,5,5,67,35,32,65
Cliftonville,7796,2,17,6,7,58,42,16,57
Ballymena,7796,3,17,4,9,67,60,7,55
Linfield,7796,4,13,10,7,62,33,29,49
Coleraine,7796,5,12,10,8,48,40,8,46
Dungannon,7796,6,11,9,10,56,42,14,42
Glenavon,7796,7,7,11,12,40,56,-16,32
Glentoran,7796,8,8,6,16,25,44,-19,30
Ballinamalla,7796,9,8,6,16,37,61,-24,30
Portadown,7796,10,5,10,15,26,50,-24,25
Ards,7796,11,5,7,18,28,51,-23,22
Cliftonville,7797,1,17,6,7,59,31,28,57
Crusaders,7797,2,14,10,6,44,28,16,52
Linfield,7797,3,14,9,7,61,36,25,51
Ballymena,7797,4,12,7,11,59,65,-6,43
Glenavon,7797,5,11,9,10,42,48,-6,42
Ards,7797,6,12,3,15,36,47,-11,39
Coleraine,7797,7,9,11,10,34,40,-6,38
Ballinamalla,7797,8,11,4,15,38,48,-10,37
Dungannon,7797,9,8,11,11,48,44,4,35
Portadown,7797,10,9,6,15,26,41,-15,33
Glentoran,7797,11,6,8,16,26,45,-19,26
Linfield,7798,1,16,10,4,68,30,38,58
Crusaders,7798,2,13,7,10,50,43,7,46
Cliftonville,7798,3,13,7,10,47,42,5,46
Dungannon,7798,4,11,9,10,61,46,15,42
Coleraine,7798,5,11,9,10,37,35,2,42
Glenavon,7798,6,10,12,8,41,43,-2,42
Ards,7798,7,11,5,14,35,44,-9,38
Portadown,7798,8,11,3,16,29,37,-8,36
Ballymena,7798,9,9,9,12,48,57,-9,36
Glentoran,7798,10,9,7,14,32,51,-19,34
Ballinamalla,7798,11,9,6,15,23,43,-20,33
Crusaders,7799,1,16,11,3,59,34,25,59
Ballymena,7799,2,15,7,8,66,61,5,52
Cliftonville,7799,3,15,6,9,51,37,14,51
Coleraine,7799,4,10,12,8,43,38,5,42
Ards,7799,5,12,5,13,44,49,-5,41
Linfield,7799,6,10,10,10,50,37,13,40
Dungannon,7799,7,10,10,10,54,44,10,40
Glenavon,7799,8,9,13,8,46,46,0,40
Glentoran,7799,9,8,8,14,34,54,-20,32
Portadown,7799,10,7,7,16,25,45,-20,28
Ballinamalla,7799,11,5,7,18,34,61,-27,22
Linfield,7800,1,16,6,8,64,33,31,54
Crusaders,7800,2,15,8,7,55,39,16,53
Ballymena,7800,3,14,8,8,55,56,-1,50
Cliftonville,7800,4,15,4,11,50,44,6,49
Glenavon,7800,5,12,11,7,57,45,12,47
Coleraine,7800,6,12,11,7,46,37,9,47
Dungannon,7800,7,12,8,10,47,38,9,44
Portadown,7800,8,9,3,18,32,49,-17,30
Ballinamalla,7800,9,8,5,17,29,55,-26,29
Ards,7800,10,7,6,17,35,49,-14,27
Glentoran,7800,11,7,6,17,30,55,-25,27
Crusaders,7801,1,17,6,7,60,32,28,57
Linfield,7801,2,15,7,8,61,33,28,52
Cliftonville,7801,3,15,4,11,52,36,16,49
Glenavon,7801,4,11,13,6,45,42,3,46
Coleraine,7801,5,12,7,11,43,47,-4,43
Dungannon,7801,6,11,8,11,45,39,6,41
Glentoran,7801,7,12,5,13,34,41,-7,41
Ballymena,7801,8,12,5,13,54,66,-12,41
Ards,7801,9,10,3,17,41,53,-12,33
Ballinamalla,7801,10,9,4,17,28,51,-23,31
Portadown,7801,11,7,6,17,20,43,-23,27
Linfield,7802,1,17,7,6,65,32,33,58
Glenavon,7802,2,14,10,6,57,43,14,52
Crusaders,7802,3,15,7,8,48,34,14,52
Ballymena,7802,4,14,7,9,58,60,-2,49
Cliftonville,7802,5,14,5,11,45,38,7,47
Dungannon,7802,6,11,8,11,48,48,0,41
Coleraine,7802,7,9,11,10,39,37,2,38
Ards,7802,8,9,6,15,33,48,-15,33
Glentoran,7802,9,8,8,14,29,44,-15,32
Ballinamalla,7802,10,8,3,19,33,55,-22,27
Portadown,7802,11,6,8,16,31,47,-16,26
Crusaders,7803,1,17,5,8,48,27,21,56
Linfield,7803,2,14,10,6,60,33,27,52
Glenavon,7803,3,11,14,5,51,41,10,47
Cliftonville,7803,4,14,5,11,50,46,4,47
Coleraine,7803,5,11,13,6,38,35,3,46
Ballymena,7803,6,12,8,10,60,57,3,44
Dungannon,7803,7,8,11,11,46,47,-1,35
Ards,7803,8,8,7,15,32,44,-12,31
Ballinamalla,7803,9,9,4,17,35,50,-15,31
Portadown,7803,10,7,9,14,29,42,-13,30
Glentoran,7803,11,7,8,15,29,56,-27,29
Linfield,7804,1,15,10,5,62,28,34,55
Cliftonville,7804,2,16,6,8,56,38,18,54
Crusaders,7804,3,14,9,7,51,30,21,51
Glenavon,7804,4,12,12,6,46,39,7,48
Ballymena,7804,5,12,7,11,55,67,-12,43
Coleraine,7804,6,10,12,8,35,33,2,42
Glentoran,7804,7,11,6,13,34,46,-12,39
Dungannon,7804,8,8,12,10,44,45,-1,36
Ards,7804,9,8,6,16,37,52,-15,30
Ballinamalla,7804,10,7,5,18,29,50,-21,26
Portadown,7804,11,6,7,17,25,46,-21,25
Linfield,7805,1,15,11,4,66,30,36,56
Crusaders,7805,2,15,9,6,55,37,18,54
Cliftonville,7805,3,13,7,10,50,46,4,46
Coleraine,7805,4,11,11,8,42,36,6,44
Glenavon,7805,5,10,12,8,49,49,0,42
Ballymena,7805,6,11,9,10,51,55,-4,42
Portadown,7805,7,12,6,12,32,38,-6,42
Dungannon,7805,8,10,7,13,48,42,6,37
Glentoran,7805,9,10,7,13,29,40,-11,37
Ards,7805,10,9,5,16,35,52,-17,32
Ballinamalla,7805,11,5,4,21,28,60,-32,19
Linfield,7806,1,16,11,3,62,24,38,59
Crusaders,7806,2,16,8,6,61,41,20,56
Cliftonville,7806,3,16,4,10,55,44,11,52
Ballymena,7806,4,15,7,8,62,56,6,52
Glenavon,7806,5,10,12,8,49,52,-3,42
Glentoran,7806,6,12,5,13,40,44,-4,41
Coleraine,7806,7,8,11,11,37,41,-4,35
Ards,7806,8,10,5,15,46,53,-7,35
Dungannon,7806,9,7,11,12,47,48,-1,32
Portadown,7806,10,7,6,17,28,51,-23,27
Ballinamalla,7806,11,5,6,19,20,53,-33,21
Crusaders,7807,1,16,9,5,57,34,23,57
Ballymena,7807,2,16,5,9,62,55,7,53
Cliftonville,7807,3,15,7,8,50,32,18,52
Glenavon,7807,4,13,8,9,60,50,10,47
Linfield,7807,5,11,11,8,56,33,23,44
Coleraine,7807,6,10,12,8,47,41,6,42
Ballinamalla,7807,7,11,4,15,29,51,-22,37
Dungannon,7807,8,7,12,11,42,45,-3,33
Glentoran,7807,9,9,6,15,31,48,-17,33
Ards,7807,10,8,4,18,30,55,-25,28
Portadown,7807,11,7,6,17,28,48,-20,27
Crusaders,7808,1,17,8,5,55,29,26,59
Cliftonville,7808,2,18,2,10,69,48,21,56
Linfield,7808,3,13,11,6,62,35,27,50
Coleraine,7808,4,12,10,8,41,36,5,46
Dungannon,7808,5,8,14,8,47,42,5,38
Ballymena,7808,6,10,8,12,56,65,-9,38
Glentoran,7808,7,10,8,12,33,45,-12,38
Glenavon,7808,8,8,13,9,46,51,-5,37
Ards,7808,9,10,4,16,41,50,-9,34
Portadown,7808,10,8,7,15,28,50,-22,31
Ballinamalla,7808,11,7,3,20,28,55,-27,24
Crusaders,7809,1,17,5,8,62,38,24,56
Linfield,7809,2,13,11,6,60,38,22,50
Glenavon,7809,3,13,9,8,52,42,10,48
Cliftonville,7809,4,14,6,10,47,40,7,48
Dungannon,7809,5,12,9,9,55,40,15,45
Ballymena,7809,6,13,6,11,63,63,0,45
Coleraine,7809,7,10,13,7,45,35,10,43
Ards,7809,8,9,6,15,37,47,-10,33
Ballinamalla,7809,9,9,6,15,29,49,-20,33
Portadown,7809,10,7,6,17,30,51,-21,27
Glentoran,7809,11,6,7,17,25,62,-37,25
Crusaders,7810,1,19,5,6,61,33,28,62
Ballymena,7810,2,16,5,9,59,55,4,53
Coleraine,7810,3,13,11,6,46,36,10,50
Linfield,7810,4,12,8,10,52,29,23,44
Cliftonville,7810,5,12,7,11,48,41,7,43
Glentoran,7810,6,11,7,12,30,36,-6,40
Glenavon,7810,7,9,11,10,46,52,-6,38
Portadown,7810,8,10,4,16,30,53,-23,34
Dungannon,7810,9,9,6,15,43,47,-4,33
Ards,7810,10,8,7,15,38,51,-13,31
Ballinamalla,7810,11,9,3,18,31,51,-20,30
Cliftonville,7811,1,17,6,7,59,38,21,57
Crusaders,7811,2,14,9,7,57,44,13,51
Linfield,7811,3,13,11,6,59,30,29,50
Ballymena,7811,4,14,5,11,59,60,-1,47
Coleraine,7811,5,12,10,8,51,40,11,46
Glenavon,7811,6,11,12,7,47,45,2,45
Glentoran,7811,7,11,8,11,37,43,-6,41
Dungannon,7811,8,9,8,13,49,49,0,35
Ards,7811,9,10,3,17,35,51,-16,33
Ballinamalla,7811,10,8,2,20,26,55,-29,26
Portadown,7811,11,7,4,19,28,52,-24,25
Linfield,7812,1,17,9,4,65,28,37,60
Crusaders,7812,2,16,7,7,59,33,26,55
Cliftonville,7812,3,16,4,10,48,35,13,52
Ballymena,7812,4,16,3,11,55,61,-6,51
Dungannon,7812,5,13,7,10,53,39,14,46
Glenavon,7812,6,12,8,10,50,45,5,44
Coleraine,7812,7,12,8,10,36,36,0,44
Glentoran,7812,8,11,7,12,33,39,-6,40
Ards,7812,9,7,4,19,36,55,-19,25
Ballinamalla,7812,10,7,3,20,25,57,-32,24
Portadown,7812,11,5,6,19,21,53,-32,21
Crusaders,7813,1,18,8,4,59,28,31,62
Linfield,7813,2,12,11,7,56,36,20,47
Glenavon,7813,3,12,11,7,50,42,8,47
Coleraine,7813,4,12,9,9,48,41,7,45
Cliftonville,7813,5,13,6,11,54,54,0,45
Ballymena,7813,6,12,7,11,52,57,-5,43
Dungannon,7813,7,10,10,10,49,45,4,40
Ards,7813,8,12,3,15,38,48,-10,39
Ballinamalla,7813,9,10,5,15,40,45,-5,35
Portadown,7813,10,6,8,16,26,50,-24,26
Glentoran,7813,11,5,8,17,23,49,-26,23
Ballymena,7814,1,18,4,8,71,50,21,58
Linfield,7814,2,14,9,7,49,30,19,51
Cliftonville,7814,3,15,5,10,48,35,13,50
Crusaders,7814,4,14,8,8,53,41,12,50
Coleraine,7814,5,10,11,9,41,39,2,41
Glenavon,7814,6,10,11,9,50,51,-1,41
Dungannon,7814,7,9,10,11,44,44,0,37
Glentoran,7814,8,9,6,15,31,46,-15,33
Portadown,7814,9,10,3,17,26,41,-15,33
Ballinamalla,7814,10,8,7,15,34,52,-18,31
Ards,7814,11,8,6,16,35,53,-18,30
Crusaders,7815,1,18,7,5,51,30,21,61
Linfield,7815,2,14,9,7,59,30,29,51
Glenavon,7815,3,13,10,7,49,42,7,49
Dungannon,7815,4,13,7,10,58,40,18,46
Coleraine,7815,5,11,12,7,42,37,5,45
Cliftonville,7815,6,14,3,13,48,44,4,45
Ballymena,7815,7,12,5,13,59,65,-6,41
Glentoran,7815,8,9,9,12,27,41,-14,36
Ards,7815,9,10,4,16,40,52,-12,34
Ballinamalla,7815,10,9,1,20,32,56,-24,28
Portadown,7815,11,6,5,19,19,47,-28,23
Linfield,7816,1,15,11,4,60,30,30,56
Cliftonville,7816,2,16,7,7,60,35,25,55
Crusaders,7816,3,15,9,6,61,37,24,54
Ballymena,7816,4,14,5,11,57,59,-2,47
Glenavon,7816,5,12,10,8,47,42,5,46
Coleraine,7816,6,8,12,10,41,43,-2,36
Dungannon,7816,7,8,10,12,51,50,1,34
Ards,7816,8,10,4,16,43,51,-8,34
Glentoran,7816,9,7,11,12,24,46,-22,32
Ballinamalla,7816,10,7,8,15,32,54,-22,29
Portadown,7816,11,7,5,18,25,54,-29,26
Ballymena,7817,1,15,7,8,58,51,7,52
Crusaders,7817,2,14,7,9,51,32,19,49
Glenavon,7817,3,13,10,7,51,41,10,49
Linfield,7817,4,13,8,9,57,40,17,47
Cliftonville,7817,5,14,4,12,46,41,5,46
Coleraine,7817,6,12,10,8,38,37,1,46
Ards,7817,7,13,5,12,44,42,2,44
Dungannon,7817,8,9,9,12,47,43,4,36
Ballinamalla,7817,9,8,7,15,30,50,-20,31
Glentoran,7817,10,6,9,15,25,47,-22,27
Portadown,7817,11,7,6,17,24,47,-23,27
Crusaders,7818,1,17,5,8,54,42,12,56
Linfield,7818,2,15,10,5,51,28,23,55
Cliftonville,7818,3,15,9,6,55,34,21,54
Dungannon,7818,4,12,9,9,58,41,17,45
Glenavon,7818,5,11,9,10,49,47,2,42
Ballymena,7818,6,11,7,12,51,55,-4,40
Coleraine,7818,7,9,10,11,41,49,-8,37
Glentoran,7818,8,8,11,11,32,41,-9,35
Ballinamalla,7818,9,10,4,16,29,50,-21,34
Portadown,7818,10,8,5,17,28,45,-17,29
Ards,7818,11,8,3,19,37,53,-16,27
Linfield,7819,1,15,11,4,62,28,34,56
Cliftonville,7819,2,17,3,10,54,36,18,54
Ballymena,7819,3,15,6,9,55,50,5,51
Crusaders,7819,4,13,10,7,50,40,10,49
Glenavon,7819,5,13,8,9,54,49,5,47
Dungannon,7819,6,12,7,11,54,44,10,43
Coleraine,7819,7,9,11,10,37,41,-4,38
Glentoran,7819,8,9,6,15,28,43,-15,33
Portadown,7819,9,9,5,16,25,44,-19,32
Ards,7819,10,8,6,16,36,55,-19,30
Ballinamalla,7819,11,6,5,19,27,52,-25,23
Glenavon,7820,1,15,10,5,59,42,17,55
Linfield,7820,2,14,12,4,60,31,29,54
Crusaders,7820,3,15,9,6,54,43,11,54
Cliftonville,7820,4,15,5,10,47,38,9,50
Ballymena,7820,5,14,6,10,55,52,3,48
Dungannon,7820,6,10,10,10,59,43,16,40
Coleraine,7820,7,9,11,10,38,44,-6,38
Glentoran,7820,8,9,7,14,28,43,-15,34
Ards,7820,9,9,5,16,37,51,-14,32
Ballinamalla,7820,10,6,6,18,28,52,-24,24
Portadown,7820,11,6,5,19,24,50,-26,23
Crusaders,7821,1,16,7,7,59,33,26,55
Cliftonville,7821,2,16,7,7,56,41,15,55
Ballymena,7821,3,14,6,10,58,59,-1,48
Linfield,7821,4,12,10,8,57,38,19,46
Glenavon,7821,5,11,12,7,47,43,4,45
Glentoran,7821,6,12,7,11,36,44,-8,43
Dungannon,7821,7,11,8,11,52,41,11,41
Coleraine,7821,8,9,10,11,40,49,-9,37
Portadown,7821,9,11,4,15,26,39,-13,37
Ards,7821,10,6,7,17,32,50,-18,25
Ballinamalla,7821,11,6,4,20,27,53,-26,22
Crusaders,7822,1,16,8,6,59,29,30,56
Linfield,7822,2,16,8,6,64,35,29,56
Ballymena,7822,3,15,7,8,56,54,2,52
Coleraine,7822,4,13,8,9,48,39,9,47
Cliftonville,7822,5,13,8,9,45,40,5,47
Glenavon,7822,6,10,10,10,45,47,-2,40
Ards,7822,7,10,5,15,33,48,-15,35
Dungannon,7822,8,8,9,13,44,50,-6,33
Portadown,7822,9,8,7,15,28,41,-13,31
Glentoran,7822,10,8,5,17,31,50,-19,29
Ballinamalla,7822,11,7,7,16,32,52,-20,28
Crusaders,7823,1,18,7,5,59,34,25,61
Linfield,7823,2,16,9,5,59,25,34,57
Ballymena,7823,3,16,6,8,56,51,5,54
Cliftonville,7823,4,14,6,10,55,45,10,48
Coleraine,7823,5,12,9,9,43,40,3,45
Glenavon,7823,6,8,15,7,41,44,-3,39
Ards,7823,7,9,6,15,37,50,-13,33
Dungannon,7823,8,7,11,12,43,45,-2,32
Portadown,7823,9,8,7,15,33,50,-17,31
Ballinamalla,7823,10,6,7,17,25,46,-21,25
Glentoran,7823,11,5,9,16,24,45,-21,24
Crusaders,7824,1,17,8,5,55,30,25,59
Linfield,7824,2,15,7,8,61,34,27,52
Ballymena,7824,3,14,6,10,59,64,-5,48
Dungannon,7824,4,13,8,9,53,37,16,47
Cliftonville,7824,5,14,5,11,51,42,9,47
Glenavon,7824,6,10,13,7,50,45,5,43
Coleraine,7824,7,9,11,10,36,39,-3,38
Ards,7824,8,10,4,16,38,53,-15,34
Glentoran,7824,9,9,7,14,29,48,-19,34
Ballinamalla,7824,10,8,4,18,34,50,-16,28
Portadown,7824,11,6,7,17,22,46,-24,25
Crusaders,7825,1,17,5,8,56,40,16,56
Glenavon,7825,2,13,11,6,56,47,9,50
Cliftonville,7825,3,14,7,9,56,42,14,49
Ballymena,7825,4,13,9,8,54,53,1,48
Linfield,7825,5,13,8,9,52,36,16,47
Dungannon,7825,6,11,10,9,54,44,10,43
Coleraine,7825,7,11,9,10,40,43,-3,42
Ballinamalla,7825,8,11,7,12,40,47,-7,40
Ards,7825,9,8,5,17,36,49,-13,29
Portadown,7825,10,7,4,19,27,47,-20,25
Glentoran,7825,11,6,7,17,26,49,-23,25
Linfield,7826,1,16,8,6,70,36,34,56
Cliftonville,7826,2,17,4,9,58,38,20,55
Ballymena,7826,3,16,5,9,63,59,4,53
Crusaders,7826,4,14,9,7,52,33,19,51
Glenavon,7826,5,10,13,7,43,46,-3,43
Ards,7826,6,11,6,13,42,45,-3,39
Coleraine,7826,7,8,12,10,38,43,-5,36
Glentoran,7826,8,9,7,14,31,50,-19,34
Dungannon,7826,9,8,8,14,52,50,2,32
Portadown,7826,10,8,5,17,24,45,-21,29
Ballinamalla,7826,11,7,5,18,29,57,-28,26
Crusaders,7827,1,17,8,5,56,31,25,59
Ballymena,7827,2,16,7,7,58,52,6,55
Cliftonville,7827,3,16,3,11,54,39,15,51
Coleraine,7827,4,13,10,7,45,30,15,49
Linfield,7827,5,12,8,10,54,36,18,44
Glenavon,7827,6,10,10,10,42,45,-3,40
Ards,7827,7,10,6,14,32,47,-15,36
Dungannon,7827,8,8,9,13,42,47,-5,33
Portadown,7827,9,10,3,17,23,43,-20,33
Glentoran,7827,10,8,6,16,30,44,-14,30
Ballinamalla,7827,11,8,4,18,28,50,-22,28
Crusaders,7828,1,17,7,6,57,34,23,58
Ballymena,7828,2,16,5,9,63,56,7,53
Linfield,7828,3,13,11,6,59,34,25,50
Cliftonville,7828,4,15,5,10,49,41,8,50
Ards,7828,5,14,4,12,42,41,1,46
Dungannon,7828,6,12,8,10,55,42,13,44
Coleraine,7828,7,11,9,10,41,38,3,42
Glenavon,7828,8,10,10,10,49,49,0,40
Glentoran,7828,9,8,7,15,28,50,-22,31
Portadown,7828,10,6,5,19,24,52,-28,23
Ballinamalla,7828,11,5,5,20,28,58,-30,20
Linfield,7829,1,18,7,5,66,34,32,61
Crusaders,7829,2,15,8,7,60,35,25,53
Glenavon,7829,3,11,12,7,46,37,9,45
Cliftonville,7829,4,12,9,9,49,46,3,45
Ballymena,7829,5,11,10,9,51,54,-3,43
Coleraine,7829,6,11,8,11,42,40,2,41
Dungannon,7829,7,9,9,12,52,45,7,36
Ballinamalla,7829,8,9,6,15,33,54,-21,33
Ards,7829,9,7,10,13,36,47,-11,31
Glentoran,7829,10,7,9,14,25,45,-20,30
Portadown,7829,11,8,6,16,28,51,-23,30
Crusaders,7830,1,17,8,5,56,34,22,59
Linfield,7830,2,15,11,4,58,24,34,56
Cliftonville,7830,3,15,6,9,53,38,15,51
Ballymena,7830,4,15,6,9,56,54,2,51
Dungannon,7830,5,13,7,10,55,43,12,46
Coleraine,7830,6,10,13,7,40,36,4,43
Glenavon,7830,7,10,10,10,49,54,-5,40
Glentoran,7830,8,9,6,15,26,43,-17,33
Ards,7830,9,8,6,16,33,48,-15,30
Portadown,7830,10,7,6,17,22,48,-26,27
Ballinamalla,7830,11,6,1,23,31,57,-26,19
Crusaders,7831,1,17,8,5,59,32,27,59
Linfield,7831,2,15,8,7,57,34,23,53
Ballymena,7831,3,13,9,8,58,52,6,48
Cliftonville,7831,4,14,4,12,58,45,13,46
Coleraine,7831,5,11,10,9,41,40,1,43
Glenavon,7831,6,9,12,9,46,54,-8,39
Dungannon,7831,7,7,14,9,50,44,6,35
Ards,7831,8,9,5,16,37,49,-12,32
Ballinamalla,7831,9,9,5,16,35,50,-15,32
Glentoran,7831,10,7,11,12,24,40,-16,32
Portadown,7831,11,6,10,14,25,50,-25,28
Crusaders,7832,1,18,8,4,62,34,28,62
Linfield,7832,2,15,8,7,64,35,29,53
Cliftonville,7832,3,13,10,7,48,39,9,49
Ballymena,7832,4,12,7,11,61,63,-2,43
Glenavon,7832,5,10,12,8,45,45,0,42
Coleraine,7832,6,9,13,8,40,41,-1,40
Dungannon,7832,7,8,11,11,46,44,2,35
Glentoran,7832,8,9,8,13,30,44,-14,35
Portadown,7832,9,8,7,15,24,41,-17,31
Ballinamalla,7832,10,7,8,15,27,45,-18,29
Ards,7832,11,8,4,18,36,52,-16,28
Crusaders,7833,1,18,5,7,55,36,19,59
Linfield,7833,2,15,12,3,60,30,30,57
Cliftonville,7833,3,14,7,9,50,40,10,49
Dungannon,7833,4,13,9,8,56,39,17,48
Glenavon,7833,5,13,8,9,53,44,9,47
Coleraine,7833,6,11,12,7,45,38,7,45
Ballymena,7833,7,10,9,11,51,65,-14,39
Ballinamalla,7833,8,9,3,18,35,57,-22,30
Portadown,7833,9,7,7,16,31,47,-16,28
Glentoran,7833,10,7,6,17,29,49,-20,27
Ards,7833,11,7,4,19,34,54,-20,25
Glenavon,7834,1,14,13,3,64,38,26,55
Linfield,7834,2,16,7,7,61,37,24,55
Cliftonville,7834,3,16,5,9,52,35,17,53
Crusaders,7834,4,13,10,7,58,44,14,49
Ballymena,7834,5,13,6,11,62,62,0,45
Coleraine,7834,6,11,9,10,36,36,0,42
Dungannon,7834,7,9,9,12,48,53,-5,36
Glentoran,7834,8,9,9,12,35,45,-10,36
Ards,7834,9,8,8,14,40,51,-11,32
Ballinamalla,7834,10,7,5,18,23,49,-26,26
Portadown,7834,11,5,7,18,24,53,-29,22
Crusaders,7835,1,16,8,6,55,35,20,56
Linfield,7835,2,13,12,5,60,32,28,51
Cliftonville,7835,3,15,5,10,55,38,17,50
Coleraine,7835,4,12,12,6,42,32,10,48
Ballymena,7835,5,12,8,10,52,57,-5,44
Glenavon,7835,6,9,14,7,46,42,4,41
Dungannon,7835,7,10,8,12,41,41,0,38
Glentoran,7835,8,10,6,14,33,45,-12,36
Ards,7835,9,8,7,15,35,50,-15,31
Portadown,7835,10,7,6,17,27,48,-21,27
Ballinamalla,7835,11,7,6,17,25,51,-26,27
Linfield,7836,1,16,9,5,62,31,31,57
Ballymena,7836,2,15,5,10,56,50,6,50
Crusaders,7836,3,14,7,9,50,37,13,49
Dungannon,7836,4,13,8,9,55,45,10,47
Coleraine,7836,5,12,10,8,40,31,9,46
Cliftonville,7836,6,12,8,10,51,43,8,44
Glenavon,7836,7,9,11,10,44,52,-8,38
Glentoran,7836,8,9,10,11,29,39,-10,37
Ballinamalla,7836,9,10,4,16,34,47,-13,34
Ards,7836,10,8,5,17,34,49,-15,29
Portadown,7836,11,6,5,19,22,53,-31,23
Crusaders,7837,1,17,6,7,54,36,18,57
Linfield,7837,2,16,7,7,59,33,26,55
Ballymena,7837,3,15,7,8,62,59,3,52
Coleraine,7837,4,14,9,7,43,32,11,51
Cliftonville,7837,5,12,8,10,47,44,3,44
Dungannon,7837,6,12,7,11,55,36,19,43
Glenavon,7837,7,8,11,11,46,52,-6,35
Ballinamalla,7837,8,10,4,16,35,55,-20,34
Portadown,7837,9,9,6,15,29,41,-12,33
Glentoran,7837,10,6,8,16,23,47,-24,26
Ards,7837,11,6,7,17,32,50,-18,25
Crusaders,7838,1,19,5,6,55,33,22,62
Ballymena,7838,2,17,3,10,58,54,4,54
Cliftonville,7838,3,14,9,7,53,38,15,51
Linfield,7838,4,13,8,9,56,32,24,47
Glenavon,7838,5,11,12,7,53,46,7,45
Dungannon,7838,6,11,8,11,51,48,3,41
Coleraine,7838,7,8,11,11,38,46,-8,35
Portadown,7838,8,9,7,14,30,44,-14,34
Ards,7838,9,8,5,17,37,56,-19,29
Glentoran,7838,10,7,7,16,33,49,-16,28
Ballinamalla,7838,11,7,7,16,37,55,-18,28
Crusaders,7839,1,17,6,7,62,36,26,57
Linfield,7839,2,14,11,5,61,37,24,53
Cliftonville,7839,3,16,5,9,51,36,15,53
Ballymena,7839,4,15,4,11,67,63,4,49
Glenavon,7839,5,11,13,6,47,41,6,46
Ards,7839,6,13,3,14,44,46,-2,42
Dungannon,7839,7,8,13,9,48,44,4,37
Coleraine,7839,8,8,12,10,34,42,-8,36
Glentoran,7839,9,7,8,15,33,49,-16,29
Ballinamalla,7839,10,7,6,17,36,63,-27,27
Portadown,7839,11,6,5,19,23,49,-26,23
Cliftonville,7840,1,17,6,7,54,35,19,57
Crusaders,7840,2,16,8,6,52,31,21,56
Linfield,7840,3,13,11,6,54,32,22,50
Dungannon,7840,4,11,10,9,56,44,12,43
Glenavon,7840,5,11,10,9,48,48,0,43
Glentoran,7840,6,9,11,10,34,39,-5,38
Ballinamalla,7840,7,11,5,14,34,45,-11,38
Ballymena,7840,8,9,9,12,51,67,-16,36
Coleraine,7840,9,7,11,12,36,43,-7,32
Portadown,7840,10,7,7,16,27,46,-19,28
Ards,7840,11,6,8,16,34,50,-16,26
Linfield,7841,1,17,7,6,60,24,36,58
Crusaders,7841,2,16,7,7,52,31,21,55
Ballymena,7841,3,15,8,7,58,55,3,53
Glenavon,7841,4,11,12,7,46,43,3,45
Coleraine,7841,5,11,10,9,43,44,-1,43
Cliftonville,7841,6,11,8,11,55,49,6,41
Dungannon,7841,7,11,7,12,53,45,8,40
Ards,7841,8,10,4,16,37,48,-11,34
Portadown,7841,9,10,4,16,31,45,-14,34
Glentoran,7841,10,7,7,16,28,53,-25,28
Ballinamalla,7841,11,6,6,18,21,47,-26,24
Linfield,7842,1,17,7,6,61,29,32,58
Cliftonville,7842,2,17,5,8,62,45,17,56
Crusaders,7842,3,14,8,8,50,35,15,50
Ballymena,7842,4,13,8,9,63,64,-1,47
Ards,7842,5,12,5,13,44,44,0,41
Glenavon,7842,6,9,13,8,51,50,1,40
Coleraine,7842,7,9,11,10,43,46,-3,38
Dungannon,7842,8,8,11,11,46,45,1,35
Glentoran,7842,9,7,11,12,35,48,-13,32
Ballinamalla,7842,10,7,6,17,36,63,-27,27
Portadown,7842,11,5,9,16,28,50,-22,24
Crusaders,7843,1,16,8,6,58,37,21,56
Cliftonville,7843,2,15,7,8,53,37,16,52
Linfield,7843,3,14,9,7,54,27,27,51
Coleraine,7843,4,14,9,7,46,33,13,51
Glenavon,7843,5,12,11,7,51,46,5,47
Ballymena,7843,6,10,9,11,52,62,-10,39
Glentoran,7843,7,10,8,12,29,39,-10,38
Dungannon,7843,8,10,7,13,51,49,2,37
Ards,7843,9,8,7,15,31,46,-15,31
Ballinamalla,7843,10,7,5,18,30,54,-24,26
Portadown,7843,11,6,6,18,22,47,-25,24
Crusaders,7844,1,16,8,6,57,30,27,56
Ballymena,7844,2,14,6,10,61,60,1,48
Glenavon,7844,3,11,13,6,53,45,8,46
Coleraine,7844,4,11,12,7,39,31,8,45
Cliftonville,7844,5,12,7,11,50,43,7,43
Dungannon,7844,6,11,9,10,49,43,6,42
Linfield,7844,7,9,11,10,49,38,11,38
Ards,7844,8,10,5,15,36,47,-11,35
Glentoran,7844,9,9,8,13,27,42,-15,35
Ballinamalla,7844,10,11,2,17,36,56,-20,35
Portadown,7844,11,8,5,17,32,54,-22,29
Cliftonville,7845,1,19,4,7,61,33,28,61
Crusaders,7845,2,16,7,7,57,34,23,55
Linfield,7845,3,14,8,8,59,30,29,50
Ballymena,7845,4,15,5,10,57,59,-2,50
Glenavon,7845,5,10,12,8,43,48,-5,42
Coleraine,7845,6,9,12,9,43,41,2,39
Dungannon,7845,7,10,8,12,46,45,1,38
Ards,7845,8,9,5,16,36,54,-18,32
Glentoran,7845,9,7,10,13,28,45,-17,31
Portadown,7845,10,8,6,16,23,41,-18,30
Ballinamalla,7845,11,8,3,19,31,54,-23,27
Crusaders,7846,1,19,5,6,53,29,24,62
Linfield,7846,2,16,8,6,68,38,30,56
Coleraine,7846,3,13,10,7,50,39,11,49
Ballymena,7846,4,15,3,12,57,57,0,48
Cliftonville,7846,5,13,4,13,46,41,5,43
Glenavon,7846,6,10,11,9,46,44,2,41
Dungannon,7846,7,10,9,11,48,43,5,39
Ards,7846,8,12,3,15,48,51,-3,39
Portadown,7846,9,10,3,17,30,54,-24,33
Glentoran,7846,10,8,7,15,38,53,-15,31
Ballinamalla,7846,11,6,3,21,26,61,-35,21
Crusaders,7847,1,18,7,5,58,33,25,61
Cliftonville,7847,2,16,5,9,53,42,11,53
Linfield,7847,3,14,9,7,60,33,27,51
Coleraine,7847,4,13,11,6,55,33,22,50
Dungannon,7847,5,11,8,11,52,44,8,41
Ballymena,7847,6,11,7,12,51,59,-8,40
Glenavon,7847,7,10,9,11,48,49,-1,39
Glentoran,7847,8,9,9,12,37,54,-17,36
Ballinamalla,7847,9,9,7,14,29,46,-17,34
Portadown,7847,10,7,5,18,28,48,-20,26
Ards,7847,11,6,5,19,34,64,-30,23
Cliftonville,7848,1,16,6,8,57,35,22,54
Crusaders,7848,2,14,9,7,52,39,13,51
Linfield,7848,3,13,11,6,63,40,23,50
Glenavon,7848,4,13,10,7,55,44,11,49
Ballymena,7848,5,14,5,11,60,57,3,47
Coleraine,7848,6,8,15,7,44,43,1,39
Dungannon,7848,7,9,9,12,40,46,-6,36
Ards,7848,8,9,6,15,40,52,-12,33
Glentoran,7848,9,9,6,15,31,46,-15,33
Ballinamalla,7848,10,8,6,16,34,51,-17,30
Portadown,7848,11,7,7,16,25,48,-23,28
Crusaders,7849,1,17,10,3,51,26,25,61
Cliftonville,7849,2,17,5,8,59,34,25,56
Dungannon,7849,3,13,7,10,53,37,16,46
Glenavon,7849,4,11,13,6,44,43,1,46
Linfield,7849,5,11,12,7,54,32,22,45
Ballymena,7849,6,12,8,10,56,59,-3,44
Glentoran,7849,7,9,9,12,28,40,-12,36
Coleraine,7849,8,7,11,12,35,43,-8,32
Portadown,7849,9,8,7,15,28,46,-18,31
Ards,7849,10,7,7,16,34,55,-21,28
Ballinamalla,7849,11,6,5,19,25,52,-27,23
Crusaders,7850,1,15,10,5,56,43,13,55
Linfield,7850,2,16,6,8,62,29,33,54
Dungannon,7850,3,14,9,7,57,36,21,51
Ballymena,7850,4,12,9,9,58,61,-3,45
Cliftonville,7850,5,13,3,14,44,48,-4,42
Coleraine,7850,6,10,11,9,45,38,7,41
Glenavon,7850,7,10,11,9,51,45,6,41
Glentoran,7850,8,11,7,12,37,38,-1,40
Ards,7850,9,9,4,17,36,57,-21,31
Portadown,7850,10,8,4,18,21,47,-26,28
Ballinamalla,7850,11,7,6,17,27,52,-25,27
Crusaders,7851,1,19,7,4,57,31,26,64
Linfield,7851,2,16,9,5,60,29,31,57
Cliftonville,7851,3,12,9,9,46,39,7,45
Glenavon,7851,4,9,15,6,42,38,4,42
Ballymena,7851,5,11,7,12,53,60,-7,40
Glentoran,7851,6,11,7,12,28,36,-8,40
Dungannon,7851,7,9,12,9,52,44,8,39
Coleraine,7851,8,9,12,9,38,39,-1,39
Portadown,7851,9,9,3,18,26,46,-20,30
Ards,7851,10,7,6,17,35,51,-16,27
Ballinamalla,7851,11,6,7,17,25,49,-24,25
Linfield,7852,1,16,10,4,64,31,33,58
Crusaders,7852,2,16,9,5,49,35,14,57
Ballymena,7852,3,17,5,8,62,52,10,56
Cliftonville,7852,4,14,10,6,60,33,27,52
Glenavon,7852,5,11,10,9,49,53,-4,43
Coleraine,7852,6,9,12,9,37,39,-2,39
Ards,7852,7,10,6,14,38,44,-6,36
Glentoran,7852,8,8,7,15,31,45,-14,31
Dungannon,7852,9,6,12,12,45,49,-4,30
Ballinamalla,7852,10,8,4,18,28,48,-20,28
Portadown,7852,11,4,7,19,18,52,-34,19
Crusaders,7853,1,18,8,4,61,31,30,62
Ballymena,7853,2,15,5,10,58,55,3,50
Cliftonville,7853,3,15,4,11,55,42,13,49
Linfield,7853,4,12,9,9,60,43,17,45
Coleraine,7853,5,11,9,10,49,52,-3,42
Dungannon,7853,6,10,11,9,51,38,13,41
Glenavon,7853,7,9,10,11,44,47,-3,37
Ards,7853,8,10,7,13,40,49,-9,37
Ballinamalla,7853,9,9,7,14,29,45,-16,34
Glentoran,7853,10,7,8,15,29,48,-19,29
Portadown,7853,11,7,6,17,24,50,-26,27
Crusaders,7854,1,20,6,4,63,33,30,66
Linfield,7854,2,13,11,6,56,34,22,50
Ballymena,7854,3,14,6,10,51,52,-1,48
Coleraine,7854,4,11,11,8,46,36,10,44
Cliftonville,7854,5,12,8,10,43,36,7,44
Dungannon,7854,6,12,7,11,56,49,7,43
Glenavon,7854,7,9,13,8,39,41,-2,40
Glentoran,7854,8,9,9,12,35,44,-9,36
Ballinamalla,7854,9,8,6,16,29,47,-18,30
Portadown,7854,10,7,6,17,22,46,-24,27
Ards,7854,11,6,5,19,32,54,-22,23
Linfield,7855,1,16,8,6,56,30,26,56
Crusaders,7855,2,15,8,7,51,33,18,53
Glenavon,7855,3,15,8,7,50,44,6,53
Ballymena,7855,4,15,8,7,52,48,4,53
Coleraine,7855,5,12,12,6,47,33,14,48
Cliftonville,7855,6,14,4,12,50,41,9,46
Dungannon,7855,7,11,8,11,50,40,10,41
Ards,7855,8,9,6,15,35,44,-9,33
Portadown,7855,9,7,5,18,27,47,-20,26
Glentoran,7855,10,5,9,16,21,45,-24,24
Ballinamalla,7855,11,5,6,19,24,58,-34,21
Crusaders,7856,1,16,9,5,52,27,25,57
Coleraine,7856,2,15,10,5,44,29,15,55
Cliftonville,7856,3,15,4,11,51,41,10,49
Glenavon,7856,4,12,11,7,43,38,5,47
Ballymena,7856,5,12,10,8,54,54,0,46
Linfield,7856,6,11,12,7,51,31,20,45
Dungannon,7856,7,9,10,11,47,43,4,37
Ballinamalla,7856,8,10,4,16,26,45,-19,34
Glentoran,7856,9,8,8,14,29,43,-14,32
Ards,7856,10,6,6,18,30,49,-19,24
Portadown,7856,11,5,8,17,22,49,-27,23
Crusaders,7857,1,18,6,6,56,27,29,60
Ballymena,7857,2,15,5,10,53,57,-4,50
Linfield,7857,3,13,9,8,55,33,22,48
Coleraine,7857,4,10,12,8,40,36,4,42
Ards,7857,5,12,5,13,36,42,-6,41
Glenavon,7857,6,11,7,12,41,49,-8,40
Dungannon,7857,7,10,9,11,50,38,12,39
Cliftonville,7857,8,11,6,13,43,46,-3,39
Ballinamalla,7857,9,11,3,16,33,45,-12,36
Portadown,7857,10,10,4,16,32,48,-16,34
Glentoran,7857,11,7,8,15,25,43,-18,29
Ballymena,7858,1,16,5,9,66,63,3,53
Cliftonville,7858,2,15,6,9,51,42,9,51
Linfield,7858,3,14,7,9,57,32,25,49
Crusaders,7858,4,13,10,7,53,40,13,49
Dungannon,7858,5,13,9,8,52,41,11,48
Glenavon,7858,6,10,11,9,48,43,5,41
Coleraine,7858,7,10,9,11,42,42,0,39
Ballinamalla,7858,8,11,4,15,38,50,-12,37
Glentoran,7858,9,9,8,13,28,41,-13,35
Ards,7858,10,9,3,18,31,51,-20,30
Portadown,7858,11,7,4,19,18,39,-21,25
Linfield,7859,1,17,9,4,61,28,33,60
Crusaders,7859,2,15,10,5,59,38,21,55
Glenavon,7859,3,14,10,6,53,40,13,52
Cliftonville,7859,4,14,5,11,58,49,9,47
Coleraine,7859,5,11,13,6,42,35,7,46
Ballymena,7859,6,13,6,11,56,55,1,45
Dungannon,7859,7,11,10,9,49,42,7,43
Glentoran,7859,8,10,6,14,32,42,-10,36
Ballinamalla,7859,9,7,6,17,30,52,-22,27
Ards,7859,10,7,5,18,36,56,-20,26
Portadown,7859,11,4,4,22,21,60,-39,16
Crusaders,7860,1,17,6,7,51,35,16,57
Linfield,7860,2,15,10,5,55,30,25,55
Coleraine,7860,3,12,12,6,41,30,11,48
Cliftonville,7860,4,14,4,12,51,40,11,46
Glenavon,7860,5,11,12,7,45,40,5,45
Ballymena,7860,6,12,7,11,54,58,-4,43
Dungannon,7860,7,9,10,11,47,42,5,37
Portadown,7860,8,10,2,18,32,49,-17,32
Ards,7860,9,8,7,15,31,45,-14,31
Glentoran,7860,10,7,10,13,30,45,-15,31
Ballinamalla,7860,11,8,4,18,28,51,-23,28
Crusaders,7861,1,16,8,6,49,28,21,56
Glenavon,7861,2,14,10,6,49,39,10,52
Linfield,7861,3,14,8,8,60,34,26,50
Coleraine,7861,4,12,12,6,46,37,9,48
Cliftonville,7861,5,12,6,12,44,38,6,42
Ballymena,7861,6,11,8,11,63,67,-4,41
Glentoran,7861,7,10,7,13,41,49,-8,37
Dungannon,7861,8,8,11,11,39,43,-4,35
Ballinamalla,7861,9,8,6,16,30,47,-17,30
Portadown,7861,10,8,6,16,25,43,-18,30
Ards,7861,11,8,6,16,39,60,-21,30
Crusaders,7862,1,14,11,5,57,33,24,53
Cliftonville,7862,2,15,7,8,52,38,14,52
Coleraine,7862,3,13,9,8,43,38,5,48
Linfield,7862,4,11,13,6,54,32,22,46
Ballymena,7862,5,12,9,9,56,59,-3,45
Glenavon,7862,6,8,14,8,41,43,-2,38
Dungannon,7862,7,9,10,11,54,49,5,37
Ards,7862,8,9,8,13,36,46,-10,35
Glentoran,7862,9,8,10,12,28,39,-11,34
Portadown,7862,10,9,7,14,33,47,-14,34
Ballinamalla,7862,11,5,6,19,27,57,-30,21
Crusaders,7863,1,14,11,5,58,41,17,53
Ballymena,7863,2,16,5,9,62,53,9,53
Linfield,7863,3,14,9,7,62,41,21,51
Cliftonville,7863,4,13,8,9,52,42,10,47
Dungannon,7863,5,11,8,11,52,48,4,41
Glenavon,7863,6,11,7,12,46,47,-1,40
Coleraine,7863,7,9,12,9,38,34,4,39
Glentoran,7863,8,10,8,12,34,43,-9,38
Ards,7863,9,11,3,16,40,50,-10,36
Ballinamalla,7863,10,7,8,15,34,55,-21,29
Portadown,7863,11,7,5,18,21,45,-24,26
Crusaders,7864,1,15,10,5,64,40,24,55
Linfield,7864,2,15,9,6,64,33,31,54
Cliftonville,7864,3,14,7,9,57,46,11,49
Ballymena,7864,4,14,4,12,59,64,-5,46
Glentoran,7864,5,10,8,12,29,44,-15,38
Glenavon,7864,6,8,12,10,48,51,-3,36
Coleraine,7864,7,8,12,10,40,49,-9,36
Dungannon,7864,8,7,14,9,51,47,4,35
Ards,7864,9,9,8,13,51,52,-1,35
Ballinamalla,7864,10,9,8,13,35,49,-14,35
Portadown,7864,11,6,8,16,24,47,-23,26
Linfield,7865,1,15,9,6,53,25,28,54
Cliftonville,7865,2,15,5,10,52,37,15,50
Crusaders,7865,3,13,10,7,50,35,15,49
Coleraine,7865,4,13,9,8,51,40,11,48
Ballymena,7865,5,12,7,11,49,57,-8,43
Glenavon,7865,6,9,13,8,39,36,3,40
Glentoran,7865,7,9,10,11,30,44,-14,37
Dungannon,7865,8,8,11,11,40,43,-3,35
Ballinamalla,7865,9,9,8,13,29,42,-13,35
Ards,7865,10,8,5,17,36,49,-13,29
Portadown,7865,11,8,5,17,23,44,-21,29
Linfield,7866,1,17,9,4,66,31,35,60
Crusaders,7866,2,15,8,7,55,40,15,53
Cliftonville,7866,3,14,6,10,54,44,10,48
Glenavon,7866,4,13,9,8,51,43,8,48
Coleraine,7866,5,13,8,9,48,37,11,47
Dungannon,7866,6,13,7,10,56,48,8,46
Ballymena,7866,7,11,7,12,58,62,-4,40
Glentoran,7866,8,9,9,12,35,42,-7,36
Ballinamalla,7866,9,9,3,18,27,52,-25,30
Ards,7866,10,7,5,18,32,51,-19,26
Portadown,7866,11,6,5,19,23,55,-32,23
Crusaders,7867,1,18,8,4,61,34,27,62
Cliftonville,7867,2,14,8,8,50,39,11,50
Linfield,7867,3,14,7,9,56,32,24,49
Ballymena,7867,4,13,10,7,58,60,-2,49
Coleraine,7867,5,12,8,10,48,38,10,44
Dungannon,7867,6,12,8,10,48,42,6,44
Glenavon,7867,7,11,11,8,48,45,3,44
Glentoran,7867,8,10,9,11,29,35,-6,39
Ards,7867,9,6,9,15,27,42,-15,27
Portadown,7867,10,7,5,18,29,54,-25,26
Ballinamalla,7867,11,4,5,21,18,51,-33,17
Ballymena,7868,1,15,9,6,64,53,11,54
Linfield,7868,2,15,7,8,56,28,28,52
Crusaders,7868,3,14,6,10,55,45,10,48
Glenavon,7868,4,13,9,8,48,39,9,48
Cliftonville,7868,5,13,7,10,48,43,5,46
Coleraine,7868,6,12,10,8,44,46,-2,46
Dungannon,7868,7,12,6,12,55,41,14,42
Glentoran,7868,8,9,7,14,33,50,-17,34
Portadown,7868,9,8,8,14,29,40,-11,32
Ballinamalla,7868,10,8,4,18,31,52,-21,28
Ards,7868,11,7,5,18,33,59,-26,26
Crusaders,7869,1,19,7,4,58,30,28,64
Cliftonville,7869,2,15,6,9,54,41,13,51
Linfield,7869,3,13,10,7,54,31,23,49
Dungannon,7869,4,13,9,8,58,37,21,48
Ballymena,7869,5,13,7,10,52,58,-6,46
Coleraine,7869,6,11,10,9,49,41,8,43
Glentoran,7869,7,9,8,13,33,49,-16,35
Ards,7869,8,9,5,16,39,49,-10,32
Portadown,7869,9,7,9,14,27,42,-15,30
Glenavon,7869,10,6,10,14,34,54,-20,28
Ballinamalla,7869,11,7,5,18,28,54,-26,26
Linfield,7870,1,16,9,5,67,29,38,57
Crusaders,7870,2,17,5,8,54,40,14,56
Ballymena,7870,3,16,7,7,64,56,8,55
Cliftonville,7870,4,15,5,10,57,42,15,50
Glenavon,7870,5,12,9,9,46,42,4,45
Coleraine,7870,6,10,11,9,45,40,5,41
Dungannon,7870,7,10,9,11,44,39,5,39
Glentoran,7870,8,8,8,14,30,47,-17,32
Ards,7870,9,9,4,17,35,53,-18,31
Ballinamalla,7870,10,8,6,16,34,53,-19,30
Portadown,7870,11,6,3,21,24,59,-35,21
Crusaders,7871,1,18,6,6,58,38,20,60
Cliftonville,7871,2,16,5,9,59,45,14,53
Linfield,7871,3,14,8,8,65,34,31,50
Ballymena,7871,4,15,5,10,62,60,2,50
Coleraine,7871,5,11,10,9,41,40,1,43
Glentoran,7871,6,12,7,11,42,49,-7,43
Glenavon,7871,7,10,10,10,45,46,-1,40
Dungannon,7871,8,8,8,14,40,42,-2,32
Portadown,7871,9,9,5,16,29,44,-15,32
Ards,7871,10,8,5,17,35,51,-16,29
Ballinamalla,7871,11,8,3,19,27,54,-27,27
Cliftonville,7872,1,16,6,8,50,34,16,54
Crusaders,7872,2,15,7,8,55,41,14,52
Ballymena,7872,3,14,6,10,52,53,-1,48
Linfield,7872,4,12,11,7,62,35,27,47
Coleraine,7872,5,10,13,7,36,32,4,43
Ards,7872,6,13,4,13,43,49,-6,43
Glenavon,7872,7,11,9,10,46,44,2,42
Dungannon,7872,8,11,7,12,53,46,7,40
Portadown,7872,9,10,5,15,32,44,-12,35
Glentoran,7872,10,7,8,15,27,50,-23,29
Ballinamalla,7872,11,7,2,21,29,57,-28,23
Cliftonville,7873,1,19,3,8,59,38,21,60
Linfield,7873,2,16,8,6,61,29,32,56
Crusaders,7873,3,13,8,9,57,48,9,47
Coleraine,7873,4,13,7,10,41,38,3,46
Ballymena,7873,5,13,6,11,59,67,-8,45
Dungannon,7873,6,11,10,9,51,38,13,43
Glenavon,7873,7,10,11,9,44,43,1,41
Glentoran,7873,8,9,5,16,26,41,-15,32
Portadown,7873,9,9,5,16,29,48,-19,32
Ards,7873,10,9,3,18,34,49,-15,30
Ballinamalla,7873,11,7,6,17,31,53,-22,27
Crusaders,7874,1,18,9,3,61,32,29,63
Cliftonville,7874,2,20,2,8,58,39,19,62
Linfield,7874,3,13,11,6,51,28,23,50
Ballymena,7874,4,13,6,11,60,57,3,45
Coleraine,7874,5,11,11,8,47,49,-2,44
Glenavon,7874,6,9,13,8,47,49,-2,40
Portadown,7874,7,9,5,16,34,46,-12,32
Dungannon,7874,8,6,12,12,50,56,-6,30
Ards,7874,9,8,6,16,36,52,-16,30
Glentoran,7874,10,6,9,15,27,43,-16,27
Ballinamalla,7874,11,6,8,16,31,51,-20,26
Cliftonville,7875,1,19,4,7,61,34,27,61
Ballymena,7875,2,16,5,9,62,58,4,53
Crusaders,7875,3,14,10,6,50,34,16,52
Linfield,7875,4,14,8,8,56,31,25,50
Glenavon,7875,5,11,9,10,45,45,0,42
Ards,7875,6,12,5,13,45,41,4,41
Coleraine,7875,7,9,12,9,44,46,-2,39
Dungannon,7875,8,8,12,10,45,46,-1,36
Glentoran,7875,9,8,9,13,28,48,-20,33
Portadown,7875,10,7,5,18,24,47,-23,26
Ballinamalla,7875,11,5,5,20,26,56,-30,20
Crusaders,7876,1,19,5,6,55,30,25,62
Linfield,7876,2,15,8,7,62,35,27,53
Ards,7876,3,15,5,10,47,39,8,50
Glenavon,7876,4,14,8,8,48,44,4,50
Cliftonville,7876,5,15,3,12,57,47,10,48
Ballymena,7876,6,10,8,12,57,72,-15,38
Dungannon,7876,7,9,7,14,45,44,1,34
Coleraine,7876,8,8,10,12,35,37,-2,34
Glentoran,7876,9,9,7,14,30,42,-12,34
Ballinamalla,7876,10,10,2,18,29,52,-23,32
Portadown,7876,11,8,3,19,23,46,-23,27
Linfield,7877,1,16,11,3,60,30,30,59
Coleraine,7877,2,16,9,5,51,25,26,57
Ballymena,7877,3,16,6,8,55,50,5,54
Crusaders,7877,4,15,8,7,53,31,22,53
Glenavon,7877,5,14,9,7,49,44,5,51
Cliftonville,7877,6,14,5,11,48,43,5,47
Dungannon,7877,7,7,8,15,41,49,-8,29
Ards,7877,8,7,7,16,34,48,-14,28
Portadown,7877,9,7,6,17,22,46,-24,27
Glentoran,7877,10,6,8,16,23,44,-21,26
Ballinamalla,7877,11,7,3,20,26,52,-26,24
Coleraine,7878,1,16,8,6,57,33,24,56
Linfield,7878,2,14,11,5,58,31,27,53
Crusaders,7878,3,15,7,8,61,39,22,52
Cliftonville,7878,4,16,3,11,52,40,12,51
Ballymena,7878,5,13,6,11,58,58,0,45
Glenavon,7878,6,10,11,9,45,50,-5,41
Dungannon,7878,7,10,8,12,49,51,-2,38
Glentoran,7878,8,9,9,12,31,43,-12,36
Ards,7878,9,9,6,15,38,56,-18,33
Portadown,7878,10,8,5,17,24,45,-21,29
Ballinamalla,7878,11,6,4,20,24,51,-27,22
Linfield,7879,1,17,9,4,70,35,35,60
Crusaders,7879,2,17,6,7,54,33,21,57
Cliftonville,7879,3,15,4,11,53,46,7,49
Ballymena,7879,4,14,7,9,62,60,2,49
Coleraine,7879,5,10,11,9,41,39,2,41
Dungannon,7879,6,10,9,11,46,43,3,39
Glenavon,7879,7,9,12,9,47,48,-1,39
Glentoran,7879,8,10,8,12,38,41,-3,38
Ards,7879,9,10,4,16,40,54,-14,34
Portadown,7879,10,7,5,18,30,55,-25,26
Ballinamalla,7879,11,6,5,19,25,52,-27,23
Crusaders,7880,1,16,8,6,52,31,21,56
Cliftonville,7880,2,16,6,8,52,32,20,54
Ballymena,7880,3,12,9,9,52,54,-2,45
Linfield,7880,4,12,8,10,56,45,11,44
Coleraine,7880,5,11,10,9,44,44,0,43
Glenavon,7880,6,10,11,9,48,43,5,41
Ards,7880,7,10,6,14,36,49,-13,36
Ballinamalla,7880,8,10,6,14,32,49,-17,36
Glentoran,7880,9,9,7,14,38,47,-9,34
Dungannon,7880,10,7,12,11,47,46,1,33
Portadown,7880,11,8,5,17,25,42,-17,29
Linfield,7881,1,14,11,5,57,33,24,53
Coleraine,7881,2,14,9,7,45,34,11,51
Crusaders,7881,3,14,8,8,52,35,17,50
Cliftonville,7881,4,14,6,10,51,36,15,48
Ballymena,7881,5,14,4,12,59,61,-2,46
Dungannon,7881,6,10,10,10,49,46,3,40
Glenavon,7881,7,8,12,10,41,44,-3,36
Ards,7881,8,10,6,14,37,45,-8,36
Glentoran,7881,9,8,8,14,23,44,-21,32
Portadown,7881,10,7,9,14,28,44,-16,30
Ballinamalla,7881,11,7,7,16,29,49,-20,28
Crusaders,7882,1,17,6,7,58,36,22,57
Cliftonville,7882,2,16,5,9,51,37,14,53
Linfield,7882,3,13,11,6,53,27,26,50
Glenavon,7882,4,12,12,6,50,41,9,48
Ballymena,7882,5,13,7,10,55,55,0,46
Coleraine,7882,6,10,11,9,44,39,5,41
Portadown,7882,7,11,4,15,34,47,-13,37
Ballinamalla,7882,8,10,4,16,31,46,-15,34
Ards,7882,9,9,4,17,34,54,-20,31
Dungannon,7882,10,7,9,14,48,54,-6,30
Glentoran,7882,11,6,9,15,20,42,-22,27
Linfield,7883,1,16,9,5,58,30,28,57
Crusaders,7883,2,14,10,6,53,36,17,52
Glenavon,7883,3,14,9,7,55,40,15,51
Cliftonville,7883,4,13,8,9,48,36,12,47
Ballymena,7883,5,13,8,9,50,57,-7,47
Coleraine,7883,6,11,10,9,44,39,5,43
Glentoran,7883,7,11,9,10,34,40,-6,42
Dungannon,7883,8,9,10,11,43,37,6,37
Ballinamalla,7883,9,8,5,17,28,49,-21,29
Ards,7883,10,6,6,18,34,54,-20,24
Portadown,7883,11,5,6,19,20,49,-29,21
Linfield,7884,1,18,6,6,64,28,36,60
Crusaders,7884,2,17,9,4,52,28,24,60
Cliftonville,7884,3,17,3,10,57,34,23,54
Ballymena,7884,4,15,5,10,58,58,0,50
Coleraine,7884,5,12,9,9,46,45,1,45
Glenavon,7884,6,12,9,9,45,47,-2,45
Ards,7884,7,11,5,14,46,48,-2,38
Dungannon,7884,8,9,9,12,50,45,5,36
Portadown,7884,9,7,4,19,24,50,-26,25
Ballinamalla,7884,10,7,3,20,30,59,-29,24
Glentoran,7884,11,6,6,18,24,54,-30,24
Cliftonville,7885,1,16,7,7,60,40,20,55
Linfield,7885,2,15,9,6,61,32,29,54
Crusaders,7885,3,16,6,8,55,32,23,54
Coleraine,7885,4,10,13,7,44,34,10,43
Ballymena,7885,5,12,7,11,52,67,-15,43
Glenavon,7885,6,9,15,6,45,43,2,42
Dungannon,7885,7,9,9,12,46,44,2,36
Ards,7885,8,10,5,15,33,46,-13,35
Ballinamalla,7885,9,8,7,15,32,49,-17,31
Glentoran,7885,10,7,9,14,27,43,-16,30
Portadown,7885,11,6,7,17,22,47,-25,25
Crusaders,7886,1,18,8,4,53,27,26,62
Cliftonville,7886,2,17,7,6,57,35,22,58
Glenavon,7886,3,13,9,8,47,41,6,48
Linfield,7886,4,12,10,8,52,27,25,46
Ballymena,7886,5,11,9,10,55,58,-3,42
Coleraine,7886,6,10,11,9,35,37,-2,41
Ards,7886,7,9,8,13,37,42,-5,35
Glentoran,7886,8,7,9,14,22,40,-18,30
Portadown,7886,9,8,6,16,26,46,-20,30
Ballinamalla,7886,10,8,6,16,33,56,-23,30
Dungannon,7886,11,5,11,14,39,47,-8,26
Crusaders,7887,1,19,5,6,61,27,34,62
Linfield,7887,2,15,8,7,60,29,31,53
Glenavon,7887,3,12,13,5,51,40,11,49
Ballymena,7887,4,14,6,10,54,54,0,48
Coleraine,7887,5,10,12,8,40,38,2,42
Cliftonville,7887,6,12,5,13,47,45,2,41
Ards,7887,7,10,8,12,37,43,-6,38
Dungannon,7887,8,9,9,12,41,42,-1,36
Glentoran,7887,9,8,6,16,25,50,-25,30
Portadown,7887,10,7,6,17,24,46,-22,27
Ballinamalla,7887,11,6,8,16,24,50,-26,26
Crusaders,7888,1,18,8,4,60,32,28,62
Linfield,7888,2,14,10,6,57,30,27,52
Cliftonville,7888,3,16,4,10,49,40,9,52
Coleraine,7888,4,12,11,7,45,38,7,47
Ballymena,7888,5,12,7,11,58,59,-1,43
Glenavon,7888,6,9,14,7,46,45,1,41
Dungannon,7888,7,10,10,10,49,43,6,40
Portadown,7888,8,9,5,16,29,43,-14,32
Glentoran,7888,9,7,10,13,28,44,-16,31
Ards,7888,10,7,6,17,35,56,-21,27
Ballinamalla,7888,11,6,5,19,24,50,-26,23
Crusaders,7889,1,19,7,4,58,30,28,64
Linfield,7889,2,16,9,5,55,28,27,57
Ballymena,7889,3,16,4,10,60,58,2,52
Cliftonville,7889,4,15,6,9,57,43,14,51
Dungannon,7889,5,10,11,9,52,41,11,41
Coleraine,7889,6,10,9,11,42,40,2,39
Glenavon,7889,7,8,14,8,36,42,-6,38
Ards,7889,8,10,5,15,36,44,-8,35
Glentoran,7889,9,7,10,13,27,40,-13,31
Ballinamalla,7889,10,8,4,18,31,51,-20,28
Portadown,7889,11,4,5,21,19,56,-37,17
Crusaders,7890,1,17,6,7,56,27,29,57
Linfield,7890,2,16,8,6,62,32,30,56
Cliftonville,7890,3,16,4,10,53,42,11,52
Dungannon,7890,4,14,7,9,58,49,9,49
Ballymena,7890,5,14,7,9,62,60,2,49
Coleraine,7890,6,12,10,8,50,43,7,46
Glenavon,7890,7,11,12,7,48,47,1,45
Ards,7890,8,7,6,17,36,55,-19,27
Portadown,7890,9,7,5,18,30,50,-20,26
Glentoran,7890,10,6,8,16,29,51,-22,26
Ballinamalla,7890,11,7,3,20,30,58,-28,24
Crusaders,7891,1,19,5,6,65,36,29,62
Linfield,7891,2,16,8,6,59,32,27,56
Ballymena,7891,3,14,6,10,56,55,1,48
Cliftonville,7891,4,14,5,11,54,44,10,47
Glenavon,7891,5,13,8,9,48,43,5,47
Glentoran,7891,6,13,6,11,35,41,-6,45
Dungannon,7891,7,10,9,11,48,40,8,39
Coleraine,7891,8,9,10,11,36,39,-3,37
Ards,7891,9,9,2,19,38,58,-20,29
Ballinamalla,7891,10,7,5,18,25,51,-26,26
Portadown,7891,11,7,4,19,20,45,-25,25
Crusaders,7892,1,18,6,6,59,32,27,60
Linfield,7892,2,16,9,5,65,34,31,57
Cliftonville,7892,3,15,6,9,57,42,15,51
Dungannon,7892,4,13,8,9,55,42,13,47
Glenavon,7892,5,11,9,10,44,50,-6,42
Coleraine,7892,6,10,11,9,38,35,3,41
Ballymena,7892,7,9,10,11,49,58,-9,37
Portadown,7892,8,8,8,14,28,44,-16,32
Ballinamalla,7892,9,9,5,16,29,53,-24,32
Ards,7892,10,7,6,17,34,49,-15,27
Glentoran,7892,11,5,10,15,30,49,-19,25
Crusaders,7893,1,18,6,6,53,31,22,60
Linfield,7893,2,15,8,7,63,40,23,53
Glenavon,7893,3,14,11,5,56,37,19,53
Ballymena,7893,4,12,11,7,57,53,4,47
Coleraine,7893,5,12,10,8,43,35,8,46
Cliftonville,7893,6,13,4,13,49,43,6,43
Dungannon,7893,7,11,8,11,53,48,5,41
Glentoran,7893,8,12,5,13,34,47,-13,41
Portadown,7893,9,8,4,18,26,51,-25,28
Ards,7893,10,7,3,20,32,51,-19,24
Ballinamalla,7893,11,6,4,20,26,56,-30,22
Crusaders,7894,1,15,9,6,55,36,19,54
Cliftonville,7894,2,16,4,10,56,39,17,52
Linfield,7894,3,13,11,6,67,42,25,50
Ballymena,7894,4,13,8,9,60,60,0,47
Dungannon,7894,5,12,10,8,53,39,14,46
Coleraine,7894,6,11,10,9,48,46,2,43
Glenavon,7894,7,9,13,8,48,45,3,40
Ballinamalla,7894,8,9,4,17,29,49,-20,31
Ards,7894,9,8,6,16,33,51,-18,30
Glentoran,7894,10,7,9,14,30,48,-18,30
Portadown,7894,11,6,8,16,32,56,-24,26
Linfield,7895,1,15,9,6,57,30,27,54
Crusaders,7895,2,15,6,9,49,39,10,51
Cliftonville,7895,3,14,7,9,48,33,15,49
Coleraine,7895,4,12,10,8,46,34,12,46
Glenavon,7895,5,11,13,6,51,43,8,46
Ballymena,7895,6,13,7,10,52,59,-7,46
Dungannon,7895,7,9,9,12,54,52,2,36
Ards,7895,8,10,6,14,38,45,-7,36
Glentoran,7895,9,10,6,14,37,45,-8,36
Portadown,7895,10,7,7,16,25,49,-24,28
Ballinamalla,7895,11,8,2,20,30,58,-28,26
Crusaders,7896,1,18,8,4,60,34,26,62
Cliftonville,7896,2,18,2,10,57,37,20,56
Linfield,7896,3,13,9,8,61,32,29,48
Ballymena,7896,4,14,5,11,59,64,-5,47
Glenavon,7896,5,11,12,7,46,46,0,45
Dungannon,7896,6,11,8,11,52,48,4,41
Coleraine,7896,7,10,9,11,42,42,0,39
Glentoran,7896,8,10,6,14,31,45,-14,36
Ards,7896,9,10,4,16,37,50,-13,34
Ballinamalla,7896,10,9,3,18,33,50,-17,30
Portadown,7896,11,6,4,20,19,49,-30,22
Crusaders,7897,1,18,7,5,65,34,31,61
Cliftonville,7897,2,17,6,7,56,34,22,57
Linfield,7897,3,14,10,6,54,30,24,52
Ballymena,7897,4,14,5,11,54,53,1,47
Coleraine,7897,5,12,9,9,37,35,2,45
Ards,7897,6,12,5,13,37,43,-6,41
Glenavon,7897,7,10,10,10,48,42,6,40
Dungannon,7897,8,9,11,10,49,47,2,38
Glentoran,7897,9,7,7,16,28,48,-20,28
Portadown,7897,10,6,5,19,18,52,-34,23
Ballinamalla,7897,11,4,9,17,26,54,-28,21
Ballymena,7898,1,17,8,5,60,50,10,59
Crusaders,7898,2,17,7,6,61,29,32,58
Cliftonville,7898,3,17,5,8,52,34,18,56
Linfield,7898,4,15,7,8,53,32,21,52
Glenavon,7898,5,10,11,9,48,45,3,41
Coleraine,7898,6,9,11,10,38,36,2,38
Dungannon,7898,7,9,9,12,47,51,-4,36
Glentoran,7898,8,7,10,13,24,42,-18,31
Portadown,7898,9,9,4,17,22,43,-21,31
Ards,7898,10,7,8,15,40,54,-14,29
Ballinamalla,7898,11,7,2,21,25,54,-29,23
Linfield,7899,1,17,8,5,69,35,34,59
Coleraine,7899,2,15,10,5,47,31,16,55
Ballymena,7899,3,15,6,9,58,53,5,51
Glenavon,7899,4,14,7,9,54,49,5,49
Cliftonville,7899,5,14,5,11,50,38,12,47
Crusaders,7899,6,13,6,11,52,43,9,45
Dungannon,7899,7,11,8,11,56,53,3,41
Portadown,7899,8,9,4,17,32,52,-20,31
Ballinamalla,7899,9,7,7,16,29,52,-23,28
Ards,7899,10,7,5,18,37,53,-16,26
Glentoran,7899,11,6,8,16,28,53,-25,26
Cliftonville,7900,1,17,5,8,59,38,21,56
Crusaders,7900,2,16,6,8,50,35,15,54
Linfield,7900,3,13,11,6,61,38,23,50
Glenavon,7900,4,13,11,6,51,41,10,50
Coleraine,7900,5,11,10,9,47,44,3,43
Ballymena,7900,6,10,12,8,61,64,-3,42
Glentoran,7900,7,9,7,14,29,44,-15,34
Portadown,7900,8,9,6,15,34,48,-14,33
Ards,7900,9,8,8,14,40,51,-11,32
Ballinamalla,7900,10,8,5,17,30,50,-20,29
Dungannon,7900,11,5,11,14,44,53,-9,26
Crusaders,7901,1,16,9,5,52,29,23,57
Cliftonville,7901,2,17,5,8,55,38,17,56
Linfield,7901,3,16,7,7,59,34,25,55
Ballymena,7901,4,15,6,9,56,50,6,51
Coleraine,7901,5,10,14,6,38,32,6,44
Glenavon,7901,6,11,11,8,48,45,3,44
Dungannon,7901,7,11,8,11,50,41,9,41
Ards,7901,8,8,7,15,31,44,-13,31
Glentoran,7901,9,7,8,15,31,52,-21,29
Ballinamalla,7901,10,7,7,16,32,54,-22,28
Portadown,7901,11,4,4,22,16,49,-33,16
Cliftonville,7902,1,15,7,8,59,44,15,52
Crusaders,7902,2,14,7,9,54,41,13,49
Ballymena,7902,3,14,6,10,57,58,-1,48
Linfield,7902,4,12,8,10,51,32,19,44
Portadown,7902,5,12,5,13,33,39,-6,41
Ards,7902,6,12,4,14,47,48,-1,40
Glenavon,7902,7,10,10,10,48,51,-3,40
Dungannon,7902,8,9,11,10,47,41,6,38
Coleraine,7902,9,9,10,11,42,45,-3,37
Ballinamalla,7902,10,10,4,16,34,50,-16,34
Glentoran,7902,11,9,6,15,29,52,-23,33
Linfield,7903,1,18,7,5,59,27,32,61
Crusaders,7903,2,16,7,7,54,32,22,55
Cliftonville,7903,3,15,4,11,50,38,12,49
Glenavon,7903,4,11,12,7,52,46,6,45
Ballymena,7903,5,13,6,11,53,63,-10,45
Coleraine,7903,6,10,12,8,42,36,6,42
Dungannon,7903,7,11,9,10,53,50,3,42
Glentoran,7903,8,9,7,14,36,49,-13,34
Ballinamalla,7903,9,8,7,15,34,47,-13,31
Portadown,7903,10,7,7,16,30,49,-19,28
Ards,7903,11,7,2,21,35,61,-26,23
Ballymena,7904,1,17,7,6,64,47,17,58
Linfield,7904,2,16,9,5,58,26,32,57
Crusaders,7904,3,16,7,7,51,34,17,55
Cliftonville,7904,4,14,5,11,48,37,11,47
Coleraine,7904,5,11,11,8,41,37,4,44
Glentoran,7904,6,12,6,12,34,44,-10,42
Glenavon,7904,7,9,11,10,39,44,-5,38
Dungannon,7904,8,8,12,10,42,40,2,36
Ards,7904,9,8,6,16,38,48,-10,30
Portadown,7904,10,6,7,17,22,49,-27,25
Ballinamalla,7904,11,5,5,20,24,55,-31,20
Crusaders,7905,1,20,6,4,63,34,29,66
Ballymena,7905,2,17,5,8,61,57,4,56
Coleraine,7905,3,15,9,6,49,34,15,54
Linfield,7905,4,12,10,8,55,34,21,46
Dungannon,7905,5,11,8,11,50,45,5,41
Glenavon,7905,6,10,11,9,48,43,5,41
Cliftonville,7905,7,11,7,12,44,46,-2,40
Glentoran,7905,8,8,9,13,35,43,-8,33
Ards,7905,9,9,5,16,37,51,-14,32
Portadown,7905,10,5,8,17,23,46,-23,23
Ballinamalla,7905,11,6,4,20,31,63,-32,22
Crusaders,7906,1,16,9,5,54,30,24,57
Linfield,7906,2,16,8,6,63,29,34,56
Cliftonville,7906,3,17,5,8,53,41,12,56
Ballymena,7906,4,13,6,11,57,58,-1,45
Dungannon,7906,5,11,10,9,50,40,10,43
Glenavon,7906,6,10,12,8,44,41,3,42
Coleraine,7906,7,9,11,10,42,47,-5,38
Portadown,7906,8,10,3,17,23,42,-19,33
Ards,7906,9,8,6,16,38,53,-15,30
Glentoran,7906,10,8,6,16,31,51,-20,30
Ballinamalla,7906,11,6,6,18,33,56,-23,24
Cliftonville,7907,1,18,4,8,50,35,15,58
Linfield,7907,2,15,8,7,61,33,28,53
Crusaders,7907,3,16,5,9,51,34,17,53
Glenavon,7907,4,12,10,8,47,45,2,46
Ballymena,7907,5,13,7,10,57,56,1,46
Coleraine,7907,6,11,11,8,37,30,7,44
Portadown,7907,7,11,5,14,28,42,-14,38
Dungannon,7907,8,10,7,13,45,47,-2,37
Glentoran,7907,9,10,6,14,31,43,-12,36
Ards,7907,10,7,5,18,33,52,-19,26
Ballinamalla,7907,11,6,4,20,22,45,-23,22
Cliftonville,7908,1,18,4,8,57,33,24,58
Linfield,7908,2,16,8,6,67,39,28,56
Crusaders,7908,3,16,7,7,57,38,19,55
Coleraine,7908,4,12,12,6,50,32,18,48
Ballymena,7908,5,14,5,11,57,61,-4,47
Glentoran,7908,6,10,9,11,32,40,-8,39
Glenavon,7908,7,9,10,11,50,60,-10,37
Dungannon,7908,8,9,8,13,52,51,1,35
Ards,7908,9,10,4,16,32,47,-15,34
Portadown,7908,10,5,8,17,22,47,-25,23
Ballinamalla,7908,11,6,5,19,26,54,-28,23
Ballymena,7909,1,16,6,8,65,56,9,54
Cliftonville,7909,2,16,5,9,56,39,17,53
Crusaders,7909,3,15,6,9,57,39,18,51
Linfield,7909,4,13,10,7,58,36,22,49
Coleraine,7909,5,13,10,7,46,36,10,49
Glenavon,7909,6,12,8,10,54,49,5,44
Glentoran,7909,7,9,7,14,31,54,-23,34
Dungannon,7909,8,8,9,13,48,51,-3,33
Ards,7909,9,7,9,14,36,52,-16,30
Ballinamalla,7909,10,7,8,15,32,49,-17,29
Portadown,7909,11,7,6,17,26,48,-22,27
Cliftonville,7910,1,19,4,7,65,37,28,61
Linfield,7910,2,16,8,6,58,28,30,56
Crusaders,7910,3,14,10,6,48,34,14,52
Glenavon,7910,4,10,11,9,46,47,-1,41
Glentoran,7910,5,11,7,12,35,44,-9,40
Dungannon,7910,6,10,9,11,48,42,6,39
Coleraine,7910,7,8,12,10,36,41,-5,36
Ards,7910,8,10,5,15,41,51,-10,35
Ballymena,7910,9,10,5,15,52,69,-17,35
Ballinamalla,7910,10,9,4,17,33,52,-19,31
Portadown,7910,11,7,7,16,20,37,-17,28
Crusaders,7911,1,18,7,5,52,26,26,61
Linfield,7911,2,15,9,6,56,28,28,54
Cliftonville,7911,3,14,7,9,49,38,11,49
Ballymena,7911,4,14,5,11,54,55,-1,47
Dungannon,7911,5,11,7,12,46,42,4,40
Coleraine,7911,6,10,9,11,40,41,-1,39
Ballinamalla,7911,7,11,4,15,30,43,-13,37
Glenavon,7911,8,8,10,12,40,46,-6,34
Ards,7911,9,9,5,16,41,54,-13,32
Glentoran,7911,10,8,8,14,29,44,-15,32
Portadown,7911,11,9,5,16,22,42,-20,32
Crusaders,7912,1,16,11,3,58,29,29,59
Linfield,7912,2,15,8,7,59,30,29,53
Cliftonville,7912,3,16,5,9,56,32,24,53
Ballymena,7912,4,15,7,8,57,51,6,52
Glenavon,7912,5,11,13,6,52,46,6,46
Dungannon,7912,6,12,9,9,53,42,11,45
Coleraine,7912,7,8,10,12,32,42,-10,34
Ards,7912,8,9,5,16,42,51,-9,32
Glentoran,7912,9,9,5,16,26,51,-25,32
Ballinamalla,7912,10,8,5,17,27,53,-26,29
Portadown,7912,11,5,4,21,23,58,-35,19
Crusaders,7913,1,17,5,8,55,38,17,56
Coleraine,7913,2,15,8,7,43,33,10,53
Ballymena,7913,3,15,7,8,61,52,9,52
Cliftonville,7913,4,15,6,9,52,35,17,51
Linfield,7913,5,14,8,8,52,30,22,50
Glenavon,7913,6,11,11,8,47,44,3,44
Glentoran,7913,7,11,8,11,35,37,-2,41
Dungannon,7913,8,8,7,15,47,56,-9,31
Ards,7913,9,8,4,18,31,48,-17,28
Ballinamalla,7913,10,7,5,18,28,51,-23,26
Portadown,7913,11,7,5,18,21,48,-27,26
Crusaders,7914,1,17,5,8,59,38,21,56
Cliftonville,7914,2,17,4,9,53,34,19,55
Coleraine,7914,3,14,10,6,45,38,7,52
Glenavon,7914,4,13,10,7,60,50,10,49
Linfield,7914,5,12,8,10,54,40,14,44
Dungannon,7914,6,11,8,11,57,47,10,41
Glentoran,7914,7,10,8,12,32,46,-14,38
Ballymena,7914,8,10,6,14,51,62,-11,36
Ballinamalla,7914,9,8,6,16,25,45,-20,30
Ards,7914,10,7,7,16,31,47,-16,28
Portadown,7914,11,7,6,17,28,48,-20,27
Linfield,7915,1,18,8,4,64,27,37,62
Crusaders,7915,2,18,8,4,58,29,29,62
Coleraine,7915,3,14,7,9,45,38,7,49
Cliftonville,7915,4,14,5,11,51,47,4,47
Glenavon,7915,5,11,10,9,44,46,-2,43
Ballymena,7915,6,11,6,13,46,54,-8,39
Dungannon,7915,7,8,10,12,47,43,4,34
Ards,7915,8,9,6,15,37,45,-8,33
Glentoran,7915,9,8,9,13,28,42,-14,33
Portadown,7915,10,8,6,16,27,47,-20,30
Ballinamalla,7915,11,7,3,20,26,55,-29,24
Crusaders,7916,1,15,8,7,57,38,19,53
Linfield,7916,2,13,11,6,51,29,22,50
Cliftonville,7916,3,15,5,10,55,45,10,50
Ballymena,7916,4,13,7,10,58,60,-2,46
Dungannon,7916,5,12,9,9,54,40,14,45
Glenavon,7916,6,10,14,6,47,44,3,44
Coleraine,7916,7,10,9,11,39,41,-2,39
Ards,7916,8,9,7,14,42,53,-11,34
Portadown,7916,9,8,9,13,38,44,-6,33
Glentoran,7916,10,7,9,14,25,41,-16,30
Ballinamalla,7916,11,5,8,17,23,54,-31,23
Crusaders,7917,1,18,6,6,63,36,27,60
Cliftonville,7917,2,18,5,7,65,40,25,59
Linfield,7917,3,15,8,7,57,31,26,53
Ballymena,7917,4,14,7,9,59,54,5,49
Glenavon,7917,5,10,11,9,44,43,1,41
Ards,7917,6,12,4,14,40,47,-7,40
Coleraine,7917,7,8,12,10,38,44,-6,36
Glentoran,7917,8,9,7,14,32,47,-15,34
Portadown,7917,9,7,8,15,23,46,-23,29
Ballinamalla,7917,10,8,4,18,33,54,-21,28
Dungannon,7917,11,6,8,16,39,51,-12,26
Crusaders,7918,1,19,7,4,57,28,29,64
Ballymena,7918,2,17,5,8,62,55,7,56
Linfield,7918,3,15,10,5,66,35,31,55
Glenavon,7918,4,13,11,6,57,43,14,50
Cliftonville,7918,5,13,7,10,46,39,7,46
Coleraine,7918,6,8,14,8,39,37,2,38
Ards,7918,7,11,5,14,43,49,-6,38
Dungannon,7918,8,9,10,11,53,50,3,37
Glentoran,7918,9,6,6,18,27,53,-26,24
Portadown,7918,10,7,3,20,23,52,-29,24
Ballinamalla,7918,11,5,6,19,29,61,-32,21
Cliftonville,7919,1,16,7,7,59,31,28,55
Linfield,7919,2,13,12,5,53,27,26,51
Crusaders,7919,3,15,6,9,51,36,15,51
Coleraine,7919,4,13,9,8,43,41,2,48
Glenavon,7919,5,11,13,6,46,43,3,46
Glentoran,7919,6,13,6,11,40,45,-5,45
Ballymena,7919,7,13,6,11,51,58,-7,45
Dungannon,7919,8,10,12,8,49,38,11,42
Ards,7919,9,6,6,18,36,57,-21,24
Portadown,7919,10,4,10,16,24,50,-26,22
Ballinamalla,7919,11,5,5,20,26,52,-26,20
Crusaders,7920,1,18,8,4,65,37,28,62
Linfield,7920,2,18,6,6,71,31,40,60
Cliftonville,7920,3,15,5,10,51,42,9,50
Ballymena,7920,4,15,3,12,70,60,10,48
Glenavon,7920,5,13,8,9,49,47,2,47
Coleraine,7920,6,10,11,9,39,40,-1,41
Dungannon,7920,7,10,9,11,50,47,3,39
Ballinamalla,7920,8,12,2,16,36,51,-15,38
Portadown,7920,9,8,4,18,23,54,-31,28
Glentoran,7920,10,7,6,17,24,47,-23,27
Ards,7920,11,7,2,21,33,55,-22,23
Crusaders,7921,1,16,5,9,49,32,17,53
Cliftonville,7921,2,15,7,8,49,38,11,52
Linfield,7921,3,13,11,6,54,31,23,50
Ballymena,7921,4,15,5,10,58,58,0,50
Coleraine,7921,5,12,10,8,45,40,5,46
Dungannon,7921,6,9,10,11,42,39,3,37
Ards,7921,7,10,7,13,39,46,-7,37
Glenavon,7921,8,8,11,11,48,55,-7,35
Ballinamalla,7921,9,10,3,17,34,50,-16,33
Glentoran,7921,10,8,8,14,29,40,-11,32
Portadown,7921,11,6,9,15,21,39,-18,27
Ballymena,7922,1,15,8,7,59,50,9,53
Glenavon,7922,2,14,10,6,55,38,17,52
Crusaders,7922,3,15,6,9,56,43,13,51
Cliftonville,7922,4,16,2,12,49,40,9,50
Linfield,7922,5,12,11,7,53,35,18,47
Coleraine,7922,6,11,12,7,45,39,6,45
Dungannon,7922,7,9,8,13,49,52,-3,35
Ards,7922,8,10,5,15,41,53,-12,35
Glentoran,7922,9,8,8,14,28,43,-15,32
Ballinamalla,7922,10,9,5,16,29,45,-16,32
Portadown,7922,11,6,5,19,21,47,-26,23
Crusaders,7923,1,18,7,5,54,27,27,61
Cliftonville,7923,2,17,3,10,52,39,13,54
Linfield,7923,3,14,7,9,59,39,20,49
Ballymena,7923,4,14,5,11,60,58,2,47
Glenavon,7923,5,11,10,9,52,43,9,43
Coleraine,7923,6,10,11,9,48,50,-2,41
Glentoran,7923,7,10,8,12,38,45,-7,38
Ards,7923,8,10,5,15,38,53,-15,35
Portadown,7923,9,10,4,16,28,43,-15,34
Dungannon,7923,10,8,8,14,47,51,-4,32
Ballinamalla,7923,11,6,6,18,24,52,-28,24
Crusaders,7924,1,16,8,6,61,36,25,56
Cliftonville,7924,2,16,4,10,45,37,8,52
Linfield,7924,3,13,9,8,59,38,21,48
Glenavon,7924,4,13,9,8,48,40,8,48
Ballymena,7924,5,13,8,9,57,52,5,47
Ards,7924,6,14,2,14,41,42,-1,44
Coleraine,7924,7,10,10,10,37,36,1,40
Dungannon,7924,8,8,10,12,44,45,-1,34
Portadown,7924,9,10,4,16,24,42,-18,34
Glentoran,7924,10,8,7,15,32,47,-15,31
Ballinamalla,7924,11,6,5,19,23,56,-33,23
Crusaders,7925,1,17,7,6,53,32,21,58
Linfield,7925,2,12,14,4,60,31,29,50
Coleraine,7925,3,13,9,8,43,34,9,48
Cliftonville,7925,4,13,6,11,48,39,9,45
Glentoran,7925,5,12,8,10,38,37,1,44
Glenavon,7925,6,10,13,7,51,43,8,43
Ballymena,7925,7,11,8,11,49,61,-12,41
Ballinamalla,7925,8,10,3,17,35,59,-24,33
Ards,7925,9,9,5,16,38,50,-12,32
Dungannon,7925,10,7,9,14,50,54,-4,30
Portadown,7925,11,7,6,17,22,47,-25,27
Crusaders,7926,1,16,7,7,50,35,15,55
Linfield,7926,2,15,9,6,57,31,26,54
Cliftonville,7926,3,14,7,9,53,39,14,49
Coleraine,7926,4,12,11,7,41,34,7,47
Ballymena,7926,5,11,9,10,54,57,-3,42
Ards,7926,6,11,7,12,40,38,2,40
Glenavon,7926,7,10,10,10,50,53,-3,40
Dungannon,7926,8,7,13,10,50,49,1,34
Glentoran,7926,9,8,7,15,32,47,-15,31
Ballinamalla,7926,10,8,6,16,33,53,-20,30
Portadown,7926,11,8,4,18,22,46,-24,28
Linfield,7927,1,17,10,3,57,22,35,61
Cliftonville,7927,2,18,4,8,57,39,18,58
Crusaders,7927,3,15,9,6,54,36,18,54
Ballymena,7927,4,15,6,9,60,56,4,51
Glenavon,7927,5,10,14,6,44,39,5,44
Coleraine,7927,6,8,14,8,36,38,-2,38
Portadown,7927,7,8,8,14,29,41,-12,32
Dungannon,7927,8,6,12,12,47,51,-4,30
Ards,7927,9,6,9,15,34,46,-12,27
Ballinamalla,7927,10,8,3,19,31,52,-21,27
Glentoran,7927,11,7,5,18,28,57,-29,26
Crusaders,7928,1,18,5,7,60,37,23,59
Cliftonville,7928,2,17,3,10,52,42,10,54
Linfield,7928,3,13,11,6,60,37,23,50
Ballymena,7928,4,13,8,9,55,56,-1,47
Dungannon,7928,5,12,10,8,51,41,10,46
Coleraine,7928,6,11,11,8,46,41,5,44
Glenavon,7928,7,10,10,10,45,46,-1,40
Glentoran,7928,8,10,7,13,36,43,-7,37
Ards,7928,9,8,6,16,37,54,-17,30
Ballinamalla,7928,10,7,4,19,29,52,-23,25
Portadown,7928,11,6,5,19,28,50,-22,23
Crusaders,7929,1,15,12,3,57,34,23,57
Cliftonville,7929,2,17,5,8,59,37,22,56
Ballymena,7929,3,16,5,9,63,54,9,53
Linfield,7929,4,14,8,8,60,43,17,50
Coleraine,7929,5,11,10,9,43,37,6,43
Glenavon,7929,6,10,10,10,44,41,3,40
Ards,7929,7,11,6,13,38,42,-4,39
Dungannon,7929,8,10,8,12,51,45,6,38
Glentoran,7929,9,9,8,13,32,50,-18,35
Ballinamalla,7929,10,6,5,19,26,53,-27,23
Portadown,7929,11,5,5,20,20,57,-37,20
Crusaders,7930,1,19,8,3,58,30,28,65
Linfield,7930,2,14,9,7,66,36,30,51
Cliftonville,7930,3,15,6,9,55,42,13,51
Glenavon,7930,4,13,11,6,53,43,10,50
Ballymena,7930,5,14,7,9,55,59,-4,49
Ards,7930,6,13,3,14,52,55,-3,42
Dungannon,7930,7,10,7,13,48,47,1,37
Coleraine,7930,8,6,12,12,40,53,-13,30
Glentoran,7930,9,7,8,15,29,45,-16,29
Portadown,7930,10,6,8,16,26,45,-19,26
Ballinamalla,7930,11,6,5,19,36,63,-27,23
Linfield,7931,1,15,9,6,55,29,26,54
Coleraine,7931,2,14,11,5,51,32,19,53
Crusaders,7931,3,14,9,7,48,35,13,51
Cliftonville,7931,4,15,6,9,55,43,12,51
Glenavon,7931,5,11,10,9,51,44,7,43
Ballymena,7931,6,12,7,11,50,58,-8,43
Dungannon,7931,7,9,10,11,42,42,0,37
Ards,7931,8,9,7,14,37,45,-8,34
Glentoran,7931,9,9,6,15,23,38,-15,33
Portadown,7931,10,7,5,18,22,43,-21,26
Ballinamalla,7931,11,6,8,16,22,47,-25,26
Crusaders,7932,1,18,8,4,52,24,28,62
Linfield,7932,2,16,9,5,59,27,32,57
Cliftonville,7932,3,15,6,9,53,38,15,51
Coleraine,7932,4,11,12,7,45,37,8,45
Ballymena,7932,5,12,7,11,55,64,-9,43
Glenavon,7932,6,9,14,7,42,42,0,41
Dungannon,7932,7,8,14,8,42,38,4,38
Glentoran,7932,8,10,6,14,35,46,-11,36
Ards,7932,9,8,6,16,37,54,-17,30
Portadown,7932,10,6,6,18,25,45,-20,24
Ballinamalla,7932,11,7,2,21,27,57,-30,23
Linfield,7933,1,16,10,4,58,24,34,58
Crusaders,7933,2,16,8,6,56,29,27,56
Coleraine,7933,3,14,13,3,47,28,19,55
Cliftonville,7933,4,14,7,9,47,39,8,49
Ballymena,7933,5,13,6,11,52,57,-5,45
Glenavon,7933,6,11,10,9,48,48,0,43
Glentoran,7933,7,8,9,13,25,44,-19,33
Dungannon,7933,8,6,12,12,43,53,-10,30
Ards,7933,9,8,6,16,37,50,-13,30
Portadown,7933,10,7,5,18,27,45,-18,26
Ballinamalla,7933,11,6,6,18,29,52,-23,24
Crusaders,7934,1,13,12,5,55,38,17,51
Coleraine,7934,2,13,9,8,42,36,6,48
Cliftonville,7934,3,14,5,11,59,47,12,47
Ards,7934,4,14,3,13,53,46,7,45
Ballymena,7934,5,12,8,10,53,54,-1,44
Linfield,7934,6,11,9,10,56,41,15,42
Glenavon,7934,7,9,12,9,46,48,-2,39
Glentoran,7934,8,8,11,11,32,46,-14,35
Dungannon,7934,9,7,13,10,44,45,-1,34
Ballinamalla,7934,10,9,5,16,33,54,-21,32
Portadown,7934,11,8,7,15,31,49,-18,31
Crusaders,7935,1,18,8,4,61,34,27,62
Linfield,7935,2,15,11,4,66,34,32,56
Ballymena,7935,3,14,8,8,54,52,2,50
Cliftonville,7935,4,13,10,7,52,37,15,49
Coleraine,7935,5,11,8,11,43,42,1,41
Glentoran,7935,6,11,7,12,35,43,-8,40
Glenavon,7935,7,7,15,8,44,48,-4,36
Dungannon,7935,8,8,9,13,48,50,-2,33
Ards,7935,9,8,7,15,33,49,-16,31
Ballinamalla,7935,10,6,10,14,30,50,-20,28
Portadown,7935,11,6,3,21,26,53,-27,21
Crusaders,7936,1,18,6,6,61,36,25,60
Cliftonville,7936,2,17,5,8,60,34,26,56
Linfield,7936,3,15,7,8,57,31,26,52
Ballymena,7936,4,15,5,10,59,57,2,50
Dungannon,7936,5,11,8,11,45,38,7,41
Glenavon,7936,6,10,10,10,46,44,2,40
Coleraine,7936,7,10,9,11,39,46,-7,39
Glentoran,7936,8,9,7,14,31,46,-15,34
Ards,7936,9,9,5,16,33,50,-17,32
Portadown,7936,10,8,5,17,23,41,-18,29
Ballinamalla,7936,11,8,3,19,26,57,-31,27
Cliftonville,7937,1,18,5,7,56,31,25,59
Linfield,7937,2,15,9,6,59,36,23,54
Dungannon,7937,3,15,8,7,63,42,21,53
Crusaders,7937,4,15,5,10,53,41,12,50
Coleraine,7937,5,11,13,6,44,33,11,46
Glenavon,7937,6,12,10,8,44,43,1,46
Ballymena,7937,7,13,5,12,63,66,-3,44
Glentoran,7937,8,8,8,14,27,46,-19,32
Ards,7937,9,7,5,18,35,53,-18,26
Portadown,7937,10,7,5,18,26,50,-24,26
Ballinamalla,7937,11,6,3,21,26,55,-29,21
Ballymena,7938,1,18,5,7,61,52,9,59
Crusaders,7938,2,17,7,6,57,33,24,58
Cliftonville,7938,3,17,7,6,59,39,20,58
Linfield,7938,4,16,9,5,57,28,29,57
Glenavon,7938,5,12,9,9,48,44,4,45
Dungannon,7938,6,10,9,11,49,44,5,39
Coleraine,7938,7,9,8,13,38,50,-12,35
Glentoran,7938,8,8,9,13,27,37,-10,33
Ards,7938,9,7,4,19,36,55,-19,25
Ballinamalla,7938,10,7,4,19,24,48,-24,25
Portadown,7938,11,7,3,20,29,55,-26,24
Cliftonville,7939,1,16,6,8,50,35,15,54
Glenavon,7939,2,13,13,4,55,38,17,52
Ballymena,7939,3,15,7,8,59,50,9,52
Linfield,7939,4,13,11,6,59,38,21,50
Crusaders,7939,5,13,7,10,49,43,6,46
Coleraine,7939,6,11,11,8,44,41,3,44
Dungannon,7939,7,9,8,13,47,45,2,35
Glentoran,7939,8,10,4,16,28,46,-18,34
Ballinamalla,7939,9,10,3,17,36,53,-17,33
Ards,7939,10,8,7,15,34,48,-14,31
Portadown,7939,11,5,7,18,17,41,-24,22
Crusaders,7940,1,17,9,4,63,35,28,60
Ballymena,7940,2,14,6,10,63,54,9,48
Linfield,7940,3,12,10,8,54,34,20,46
Cliftonville,7940,4,13,6,11,55,43,12,45
Glenavon,7940,5,10,14,6,50,48,2,44
Coleraine,7940,6,10,11,9,46,50,-4,41
Dungannon,7940,7,10,10,10,55,42,13,40
Glentoran,7940,8,10,5,15,31,46,-15,35
Ards,7940,9,9,7,14,36,51,-15,34
Ballinamalla,7940,10,8,7,15,31,54,-23,31
Portadown,7940,11,7,5,18,24,51,-27,26
Linfield,7941,1,17,9,4,62,26,36,60
Crusaders,7941,2,17,8,5,55,34,21,59
Cliftonville,7941,3,16,5,9,55,38,17,53
Ballymena,7941,4,13,6,11,58,55,3,45
Glenavon,7941,5,12,9,9,50,47,3,45
Coleraine,7941,6,12,9,9,43,44,-1,45
Dungannon,7941,7,8,11,11,49,47,2,35
Ards,7941,8,8,8,14,39,47,-8,32
Portadown,7941,9,9,5,16,28,47,-19,32
Glentoran,7941,10,8,7,15,27,44,-17,31
Ballinamalla,7941,11,3,7,20,21,58,-37,16
Coleraine,7942,1,14,10,6,51,37,14,52
Linfield,7942,2,14,8,8,52,30,22,50
Crusaders,7942,3,14,8,8,62,48,14,50
Ballymena,7942,4,15,5,10,56,56,0,50
Cliftonville,7942,5,14,4,12,51,44,7,46
Glenavon,7942,6,12,10,8,48,44,4,46
Dungannon,7942,7,9,9,12,54,48,6,36
Ards,7942,8,9,6,15,41,51,-10,33
Portadown,7942,9,10,3,17,30,49,-19,33
Glentoran,7942,10,8,8,14,29,46,-17,32
Ballinamalla,7942,11,7,7,16,30,51,-21,28
Linfield,7943,1,16,8,6,65,31,34,56
Crusaders,7943,2,17,4,9,60,42,18,55
Glenavon,7943,3,14,12,4,55,41,14,54
Cliftonville,7943,4,16,5,9,53,41,12,53
Coleraine,7943,5,12,11,7,44,32,12,47
Ballymena,7943,6,14,5,11,58,62,-4,47
Dungannon,7943,7,9,9,12,48,46,2,36
Ards,7943,8,9,3,18,38,54,-16,30
Portadown,7943,9,8,6,16,29,45,-16,30
Glentoran,7943,10,7,6,17,32,57,-25,27
Ballinamalla,7943,11,6,5,19,27,58,-31,23
Crusaders,7944,1,16,10,4,60,36,24,58
Linfield,7944,2,14,9,7,60,34,26,51
Glenavon,7944,3,13,11,6,46,40,6,50
Cliftonville,7944,4,15,4,11,46,40,6,49
Ballymena,7944,5,11,9,10,49,55,-6,42
Dungannon,7944,6,10,8,12,45,43,2,38
Coleraine,7944,7,10,8,12,43,43,0,38
Portadown,7944,8,11,5,14,31,41,-10,38
Ards,7944,9,10,5,15,36,47,-11,35
Glentoran,7944,10,6,10,14,25,42,-17,28
Ballinamalla,7944,11,7,5,18,33,53,-20,26
Crusaders,7945,1,17,8,5,57,27,30,59
Cliftonville,7945,2,17,6,7,53,36,17,57
Linfield,7945,3,14,8,8,54,31,23,50
Coleraine,7945,4,11,11,8,39,35,4,44
Ballymena,7945,5,12,7,11,52,55,-3,43
Glenavon,7945,6,9,12,9,47,46,1,39
Glentoran,7945,7,10,7,13,29,44,-15,37
Dungannon,7945,8,9,9,12,45,47,-2,36
Ards,7945,9,7,8,15,36,51,-15,29
Portadown,7945,10,8,5,17,27,48,-21,29
Ballinamalla,7945,11,6,9,15,31,50,-19,27
Crusaders,7946,1,18,8,4,64,31,33,62
Linfield,7946,2,16,8,6,60,32,28,56
Coleraine,7946,3,14,9,7,54,43,11,51
Cliftonville,7946,4,15,4,11,52,41,11,49
Dungannon,7946,5,10,10,10,59,45,14,40
Ballymena,7946,6,10,8,12,52,64,-12,38
Glenavon,7946,7,9,9,12,43,55,-12,36
Ards,7946,8,10,4,16,42,51,-9,34
Ballinamalla,7946,9,9,6,15,25,47,-22,33
Glentoran,7946,10,7,10,13,35,52,-17,31
Portadown,7946,11,6,6,18,25,50,-25,24
Cliftonville,7947,1,18,4,8,53,35,18,58
Linfield,7947,2,15,9,6,65,33,32,54
Crusaders,7947,3,15,8,7,55,38,17,53
Glenavon,7947,4,12,11,7,40,33,7,47
Ballymena,7947,5,12,9,9,58,57,1,45
Coleraine,7947,6,11,10,9,41,41,0,43
Dungannon,7947,7,10,10,10,45,42,3,40
Glentoran,7947,8,9,7,14,31,45,-14,34
Ards,7947,9,9,4,17,39,53,-14,31
Portadown,7947,10,8,2,20,29,53,-24,26
Ballinamalla,7947,11,8,2,20,28,54,-26,26
Linfield,7948,1,15,9,6,64,34,30,54
Crusaders,7948,2,16,6,8,48,33,15,54
Glenavon,7948,3,13,9,8,54,48,6,48
Cliftonville,7948,4,14,4,12,53,44,9,46
Coleraine,7948,5,12,9,9,41,36,5,45
Ballymena,7948,6,13,6,11,54,58,-4,45
Glentoran,7948,7,11,7,12,33,39,-6,40
Dungannon,7948,8,8,11,11,45,42,3,35
Portadown,7948,9,8,6,16,30,47,-17,30
Ballinamalla,7948,10,8,6,16,25,51,-26,30
Ards,7948,11,8,5,17,35,50,-15,29
Crusaders,7949,1,17,6,7,56,32,24,57
Cliftonville,7949,2,15,6,9,53,41,12,51
Glenavon,7949,3,13,11,6,51,36,15,50
Linfield,7949,4,13,9,8,58,36,22,48
Ballymena,7949,5,13,9,8,55,54,1,48
Dungannon,7949,6,12,8,10,54,47,7,44
Coleraine,7949,7,10,11,9,41,37,4,41
Ards,7949,8,10,5,15,42,53,-11,35
Glentoran,7949,9,9,7,14,25,44,-19,34
Portadown,7949,10,7,4,19,29,51,-22,25
Ballinamalla,7949,11,7,2,21,28,61,-33,23
Crusaders,7950,1,19,5,6,57,34,23,62
Cliftonville,7950,2,16,5,9,52,37,15,53
Linfield,7950,3,13,11,6,62,36,26,50
Glenavon,7950,4,12,11,7,43,37,6,47
Coleraine,7950,5,11,11,8,40,35,5,44
Dungannon,7950,6,10,10,10,55,43,12,40
Ballymena,7950,7,11,6,13,51,60,-9,39
Glentoran,7950,8,8,9,13,35,50,-15,33
Ballinamalla,7950,9,8,8,14,29,46,-17,32
Ards,7950,10,8,5,17,32,48,-16,29
Portadown,7950,11,5,7,18,21,51,-30,22
Crusaders,7951,1,16,9,5,60,35,25,57
Cliftonville,7951,2,15,5,10,48,36,12,50
Linfield,7951,3,12,12,6,56,31,25,48
Glenavon,7951,4,12,11,7,44,41,3,47
Coleraine,7951,5,10,12,8,39,37,2,42
Ballymena,7951,6,11,8,11,57,57,0,41
Portadown,7951,7,11,4,15,36,49,-13,37
Dungannon,7951,8,8,10,12,52,52,0,34
Glentoran,7951,9,9,6,15,28,44,-16,33
Ballinamalla,7951,10,9,6,15,32,50,-18,33
Ards,7951,11,7,7,16,33,53,-20,28
Cliftonville,7952,1,16,7,7,55,37,18,55
Ballymena,7952,2,15,5,10,61,55,6,50
Crusaders,7952,3,13,9,8,49,38,11,48
Linfield,7952,4,12,8,10,51,32,19,44
Glenavon,7952,5,11,11,8,50,45,5,44
Dungannon,7952,6,11,10,9,58,44,14,43
Coleraine,7952,7,10,12,8,42,42,0,42
Ards,7952,8,9,6,15,33,45,-12,33
Glentoran,7952,9,9,6,15,28,47,-19,33
Portadown,7952,10,9,5,16,24,48,-24,32
Ballinamalla,7952,11,8,5,17,35,53,-18,29
Crusaders,7953,1,21,6,3,61,22,39,69
Linfield,7953,2,14,10,6,58,34,24,52
Cliftonville,7953,3,16,2,12,55,47,8,50
Coleraine,7953,4,11,12,7,48,40,8,45
Glenavon,7953,5,10,12,8,48,45,3,42
Dungannon,7953,6,9,13,8,50,39,11,40
Ballymena,7953,7,10,9,11,53,63,-10,39
Ards,7953,8,8,7,15,37,50,-13,31
Glentoran,7953,9,7,8,15,27,52,-25,29
Ballinamalla,7953,10,8,3,19,30,55,-25,27
Portadown,7953,11,6,8,16,25,45,-20,26
Crusaders,7954,1,17,6,7,55,39,16,57
Glenavon,7954,2,15,9,6,54,40,14,54
Linfield,7954,3,14,7,9,63,41,22,49
Dungannon,7954,4,12,9,9,51,39,12,45
Cliftonville,7954,5,13,6,11,48,39,9,45
Glentoran,7954,6,13,6,11,39,42,-3,45
Ballymena,7954,7,11,6,13,62,75,-13,39
Ards,7954,8,10,7,13,41,47,-6,37
Coleraine,7954,9,8,11,11,38,44,-6,35
Portadown,7954,10,8,7,15,28,40,-12,31
Ballinamalla,7954,11,5,4,21,21,54,-33,19
Cliftonville,7955,1,19,4,7,60,38,22,61
Crusaders,7955,2,16,8,6,56,36,20,56
Linfield,7955,3,16,7,7,53,31,22,55
Ballymena,7955,4,14,7,9,49,52,-3,49
Coleraine,7955,5,11,9,10,49,40,9,42
Glenavon,7955,6,9,13,8,45,46,-1,40
Dungannon,7955,7,8,13,9,47,50,-3,37
Ards,7955,8,9,7,14,41,48,-7,34
Glentoran,7955,9,7,8,15,29,45,-16,29
Portadown,7955,10,6,8,16,26,45,-19,26
Ballinamalla,7955,11,7,2,21,31,55,-24,23
Cliftonville,7956,1,18,4,8,59,34,25,58
Crusaders,7956,2,17,6,7,60,39,21,57
Glenavon,7956,3,13,9,8,51,40,11,48
Ballymena,7956,4,14,5,11,57,59,-2,47
Linfield,7956,5,11,10,9,52,35,17,43
Dungannon,7956,6,11,8,11,46,43,3,41
Coleraine,7956,7,10,10,10,36,38,-2,40
Ards,7956,8,9,8,13,41,49,-8,35
Glentoran,7956,9,8,8,14,33,52,-19,32
Portadown,7956,10,8,5,17,26,44,-18,29
Ballinamalla,7956,11,7,5,18,21,49,-28,26
Crusaders,7957,1,19,8,3,59,30,29,65
Ballymena,7957,2,18,5,7,67,56,11,59
Linfield,7957,3,12,13,5,55,28,27,49
Coleraine,7957,4,11,12,7,44,40,4,45
Cliftonville,7957,5,11,8,11,52,46,6,41
Glenavon,7957,6,9,11,10,48,54,-6,38
Dungannon,7957,7,9,9,12,44,45,-1,36
Glentoran,7957,8,8,8,14,34,47,-13,32
Portadown,7957,9,9,5,16,36,50,-14,32
Ards,7957,10,8,5,17,34,50,-16,29
Ballinamalla,7957,11,5,8,17,30,57,-27,23
Linfield,7958,1,14,12,4,58,28,30,54
Ballymena,7958,2,14,8,8,61,55,6,50
Crusaders,7958,3,14,6,10,53,44,9,48
Dungannon,7958,4,13,8,9,58,40,18,47
Coleraine,7958,5,11,11,8,46,43,3,44
Glenavon,7958,6,11,9,10,46,47,-1,42
Cliftonville,7958,7,12,5,13,43,41,2,41
Ballinamalla,7958,8,12,2,16,32,48,-16,38
Glentoran,7958,9,10,6,14,33,43,-10,36
Ards,7958,10,7,8,15,37,50,-13,29
Portadown,7958,11,7,5,18,30,58,-28,26
Linfield,7959,1,17,9,4,64,31,33,60
Ballymena,7959,2,16,7,7,62,51,11,55
Crusaders,7959,3,14,8,8,46,31,15,50
Cliftonville,7959,4,14,7,9,48,35,13,49
Glenavon,7959,5,11,12,7,45,39,6,45
Coleraine,7959,6,12,9,9,44,40,4,45
Dungannon,7959,7,9,12,9,47,39,8,39
Glentoran,7959,8,7,9,14,28,48,-20,30
Ards,7959,9,7,8,15,34,52,-18,29
Portadown,7959,10,6,7,17,23,45,-22,25
Ballinamalla,7959,11,5,6,19,27,57,-30,21
Crusaders,7960,1,18,7,5,61,33,28,61
Glenavon,7960,2,15,8,7,61,37,24,53
Glentoran,7960,3,14,6,10,38,38,0,48
Coleraine,7960,4,13,8,9,41,43,-2,47
Ballymena,7960,5,14,4,12,59,58,1,46
Linfield,7960,6,11,11,8,55,43,12,44
Cliftonville,7960,7,13,4,13,48,46,2,43
Dungannon,7960,8,10,9,11,52,50,2,39
Ards,7960,9,8,4,18,32,52,-20,28
Ballinamalla,7960,10,8,3,19,31,52,-21,27
Portadown,7960,11,6,6,18,28,54,-26,24
Crusaders,7961,1,16,6,8,55,38,17,54
Cliftonville,7961,2,17,2,11,56,45,11,53
Linfield,7961,3,14,9,7,60,37,23,51
Ballymena,7961,4,15,4,11,63,59,4,49
Dungannon,7961,5,14,6,10,57,45,12,48
Glenavon,7961,6,12,9,9,49,47,2,45
Coleraine,7961,7,11,9,10,45,47,-2,42
Ards,7961,8,12,3,15,42,44,-2,39
Ballinamalla,7961,9,9,4,17,29,51,-22,31
Glentoran,7961,10,7,6,17,31,52,-21,27
Portadown,7961,11,6,6,18,24,46,-22,24
Crusaders,7962,1,18,5,7,58,39,19,59
Cliftonville,7962,2,17,4,9,57,37,20,55
Linfield,7962,3,13,10,7,55,34,21,49
Coleraine,7962,4,12,9,9,46,39,7,45
Ballymena,7962,5,13,5,12,60,64,-4,44
Dungannon,7962,6,11,10,9,51,43,8,43
Glenavon,7962,7,10,9,11,43,51,-8,39
Glentoran,7962,8,7,11,12,30,39,-9,32
Portadown,7962,9,8,7,15,23,40,-17,31
Ballinamalla,7962,10,9,3,18,33,52,-19,30
Ards,7962,11,8,5,17,30,48,-18,29
Crusaders,7963,1,15,8,7,64,46,18,53
Dungannon,7963,2,14,8,8,61,39,22,50
Cliftonville,7963,3,14,6,10,56,45,11,48
Glenavon,7963,4,13,8,9,51,48,3,47
Linfield,7963,5,12,10,8,56,37,19,46
Ballymena,7963,6,11,12,7,57,57,0,45
Coleraine,7963,7,11,9,10,44,43,1,42
Glentoran,7963,8,10,8,12,32,42,-10,38
Ards,7963,9,10,4,16,43,57,-14,34
Portadown,7963,10,8,6,16,27,46,-19,30
Ballinamalla,7963,11,4,7,19,29,60,-31,19
Linfield,7964,1,16,8,6,62,32,30,56
Crusaders,7964,2,16,8,6,58,33,25,56
Cliftonville,7964,3,17,4,9,53,32,21,55
Glenavon,7964,4,13,13,4,52,41,11,52
Ballymena,7964,5,15,4,11,57,53,4,49
Coleraine,7964,6,13,9,8,41,31,10,48
Dungannon,7964,7,10,9,11,48,42,6,39
Ballinamalla,7964,8,10,4,16,28,48,-20,34
Ards,7964,9,7,5,18,31,59,-28,26
Glentoran,7964,10,5,9,16,24,51,-27,24
Portadown,7964,11,5,3,22,22,54,-32,18
Cliftonville,7965,1,16,6,8,55,36,19,54
Linfield,7965,2,13,11,6,50,26,24,50
Ballymena,7965,3,15,5,10,54,52,2,50
Crusaders,7965,4,13,8,9,51,45,6,47
Glenavon,7965,5,11,11,8,51,46,5,44
Coleraine,7965,6,11,11,8,43,40,3,44
Dungannon,7965,7,11,9,10,52,42,10,42
Ballinamalla,7965,8,12,4,14,33,45,-12,40
Glentoran,7965,9,8,9,13,24,43,-19,33
Ards,7965,10,7,7,16,38,49,-11,28
Portadown,7965,11,4,7,19,17,44,-27,19
Crusaders,7966,1,21,5,4,68,35,33,68
Cliftonville,7966,2,16,5,9,59,37,22,53
Linfield,7966,3,14,7,9,51,32,19,49
Ballymena,7966,4,14,6,10,58,67,-9,48
Coleraine,7966,5,11,9,10,45,37,8,42
Glenavon,7966,6,11,9,10,48,48,0,42
Dungannon,7966,7,10,9,11,55,53,2,39
Glentoran,7966,8,10,8,12,31,44,-13,38
Ards,7966,9,9,5,16,39,49,-10,32
Portadown,7966,10,6,6,18,18,42,-24,24
Ballinamalla,7966,11,7,3,20,27,55,-28,24
Crusaders,7967,1,18,6,6,60,37,23,60
Linfield,7967,2,15,10,5,61,29,32,55
Cliftonville,7967,3,16,4,10,53,41,12,52
Ballymena,7967,4,15,7,8,59,56,3,52
Coleraine,7967,5,11,12,7,45,39,6,45
Glenavon,7967,6,10,12,8,55,47,8,42
Dungannon,7967,7,9,9,12,49,46,3,36
Ards,7967,8,9,5,16,36,50,-14,32
Ballinamalla,7967,9,8,4,18,28,55,-27,28
Portadown,7967,10,7,6,17,25,50,-25,27
Glentoran,7967,11,6,7,17,30,51,-21,25
Linfield,7968,1,14,11,5,56,26,30,53
Crusaders,7968,2,15,8,7,55,33,22,53
Cliftonville,7968,3,15,5,10,54,42,12,50
Coleraine,7968,4,12,10,8,43,40,3,46
Ballymena,7968,5,12,8,10,57,60,-3,44
Dungannon,7968,6,9,13,8,50,40,10,40
Glenavon,7968,7,10,10,10,50,48,2,40
Glentoran,7968,8,10,7,13,31,45,-14,37
Ards,7968,9,9,4,17,32,54,-22,31
Ballinamalla,7968,10,8,6,16,35,54,-19,30
Portadown,7968,11,6,8,16,22,43,-21,26
Linfield,7969,1,16,8,6,60,30,30,56
Crusaders,7969,2,16,7,7,55,34,21,55
Glenavon,7969,3,13,11,6,50,42,8,50
Ballymena,7969,4,14,8,8,57,54,3,50
Cliftonville,7969,5,14,5,11,47,38,9,47
Coleraine,7969,6,9,14,7,44,41,3,41
Dungannon,7969,7,9,9,12,49,47,2,36
Ards,7969,8,9,5,16,41,55,-14,32
Portadown,7969,9,8,6,16,26,43,-17,30
Glentoran,7969,10,7,8,15,27,47,-20,29
Ballinamalla,7969,11,7,5,18,33,58,-25,26
Crusaders,7970,1,18,8,4,58,29,29,62
Ballymena,7970,2,15,5,10,56,54,2,50
Coleraine,7970,3,13,9,8,55,46,9,48
Glenavon,7970,4,12,11,7,48,42,6,47
Dungannon,7970,5,12,9,9,50,38,12,45
Linfield,7970,6,11,10,9,57,36,21,43
Glentoran,7970,7,12,7,11,33,41,-8,43
Cliftonville,7970,8,11,8,11,45,44,1,41
Ards,7970,9,7,6,17,36,55,-19,27
Ballinamalla,7970,10,7,5,18,22,48,-26,26
Portadown,7970,11,6,4,20,23,50,-27,22
Crusaders,7971,1,18,8,4,59,36,23,62
Ballymena,7971,2,16,6,8,58,51,7,54
Cliftonville,7971,3,16,4,10,63,48,15,52
Linfield,7971,4,12,11,7,55,32,23,47
Glenavon,7971,5,11,11,8,48,40,8,44
Glentoran,7971,6,12,7,11,39,42,-3,43
Dungannon,7971,7,8,11,11,47,44,3,35
Coleraine,7971,8,8,11,11,32,40,-8,35
Portadown,7971,9,7,7,16,33,57,-24,28
Ballinamalla,7971,10,8,4,18,30,56,-26,28
Ards,7971,11,7,4,19,31,49,-18,25
Crusaders,7972,1,16,8,6,58,36,22,56
Ballymena,7972,2,15,5,10,65,57,8,50
Dungannon,7972,3,14,7,9,58,38,20,49
Cliftonville,7972,4,14,6,10,50,44,6,48
Glentoran,7972,5,12,9,9,39,44,-5,45
Linfield,7972,6,11,9,10,52,39,13,42
Glenavon,7972,7,10,12,8,44,44,0,42
Coleraine,7972,8,8,13,9,41,43,-2,37
Ards,7972,9,9,6,15,40,47,-7,33
Ballinamalla,7972,10,7,5,18,27,52,-25,26
Portadown,7972,11,6,6,18,27,57,-30,24
Crusaders,7973,1,15,7,8,56,37,19,52
Cliftonville,7973,2,15,5,10,52,41,11,50
Linfield,7973,3,12,10,8,55,35,20,46
Glenavon,7973,4,11,11,8,46,46,0,44
Ballymena,7973,5,12,8,10,56,61,-5,44
Coleraine,7973,6,9,13,8,41,35,6,40
Glentoran,7973,7,10,10,10,29,39,-10,40
Dungannon,7973,8,10,7,13,51,45,6,37
Ards,7973,9,9,8,13,35,42,-7,35
Portadown,7973,10,8,9,13,24,40,-16,33
Ballinamalla,7973,11,7,6,17,28,52,-24,27
Crusaders,7974,1,15,9,6,55,36,19,54
Linfield,7974,2,15,8,7,55,29,26,53
Cliftonville,7974,3,16,2,12,59,46,13,50
Ballymena,7974,4,14,7,9,66,59,7,49
Coleraine,7974,5,12,9,9,43,38,5,45
Glentoran,7974,6,11,7,12,29,38,-9,40
Glenavon,7974,7,10,9,11,45,49,-4,39
Dungannon,7974,8,9,9,12,46,41,5,36
Ballinamalla,7974,9,10,5,15,31,48,-17,35
Ards,7974,10,8,5,17,38,57,-19,29
Portadown,7974,11,8,4,18,26,52,-26,28
Crusaders,7975,1,14,11,5,48,32,16,53
Linfield,7975,2,14,10,6,64,36,28,52
Coleraine,7975,3,12,13,5,45,31,14,49
Ballymena,7975,4,14,6,10,61,69,-8,48
Cliftonville,7975,5,13,5,12,52,41,11,44
Glenavon,7975,6,11,11,8,51,51,0,44
Ards,7975,7,12,2,16,43,49,-6,38
Ballinamalla,7975,8,11,5,14,37,48,-11,38
Dungannon,7975,9,8,10,12,46,46,0,34
Portadown,7975,10,8,4,18,24,47,-23,28
Glentoran,7975,11,6,7,17,26,47,-21,25
Linfield,7976,1,16,9,5,68,36,32,57
Crusaders,7976,2,16,7,7,56,34,22,55
Glenavon,7976,3,15,8,7,53,43,10,53
Cliftonville,7976,4,14,8,8,48,35,13,50
Ballymena,7976,5,11,8,11,62,67,-5,41
Coleraine,7976,6,11,7,12,40,39,1,40
Glentoran,7976,7,11,6,13,34,40,-6,39
Dungannon,7976,8,10,8,12,48,47,1,38
Portadown,7976,9,7,8,15,23,44,-21,29
Ards,7976,10,7,6,17,33,52,-19,27
Ballinamalla,7976,11,7,5,18,25,53,-28,26
Crusaders,7977,1,18,8,4,55,35,20,62
Linfield,7977,2,15,10,5,74,29,45,55
Coleraine,7977,3,13,11,6,48,34,14,50
Cliftonville,7977,4,13,4,13,49,40,9,43
Ballymena,7977,5,12,6,12,49,66,-17,42
Dungannon,7977,6,10,8,12,53,49,4,38
Glentoran,7977,7,10,6,14,43,50,-7,36
Ards,7977,8,10,6,14,40,51,-11,36
Glenavon,7977,9,7,13,10,40,47,-7,34
Portadown,7977,10,9,7,14,24,46,-22,34
Ballinamalla,7977,11,8,1,21,30,58,-28,25
Linfield,7978,1,17,8,5,58,28,30,59
Crusaders,7978,2,16,8,6,58,32,26,56
Dungannon,7978,3,14,8,8,62,37,25,50
Coleraine,7978,4,12,12,6,45,34,11,48
Cliftonville,7978,5,13,8,9,49,36,13,47
Ballymena,7978,6,11,8,11,52,57,-5,41
Ards,7978,7,11,6,13,43,53,-10,39
Glenavon,7978,8,7,11,12,39,49,-10,32
Portadown,7978,9,9,4,17,25,53,-28,31
Glentoran,7978,10,7,7,16,24,46,-22,28
Ballinamalla,7978,11,6,4,20,22,52,-30,22
Linfield,7979,1,16,8,6,61,29,32,56
Crusaders,7979,2,15,9,6,49,31,18,54
Ballymena,7979,3,16,5,9,62,59,3,53
Cliftonville,7979,4,13,5,12,49,47,2,44
Coleraine,7979,5,11,10,9,45,39,6,43
Glenavon,7979,6,11,10,9,42,46,-4,43
Ballinamalla,7979,7,12,2,16,36,42,-6,38
Dungannon,7979,8,9,9,12,46,46,0,36
Glentoran,7979,9,7,12,11,31,40,-9,33
Portadown,7979,10,8,6,16,30,47,-17,30
Ards,7979,11,7,4,19,33,58,-25,25
Crusaders,7980,1,18,7,5,63,34,29,61
Linfield,7980,2,12,12,6,58,34,24,48
Cliftonville,7980,3,15,3,12,56,43,13,48
Glenavon,7980,4,12,10,8,37,37,0,46
Ballymena,7980,5,13,7,10,52,53,-1,46
Coleraine,7980,6,10,11,9,42,42,0,41
Ards,7980,7,10,7,13,44,48,-4,37
Glentoran,7980,8,7,13,10,33,46,-13,34
Ballinamalla,7980,9,9,5,16,34,49,-15,32
Portadown,7980,10,9,5,16,28,51,-23,32
Dungannon,7980,11,5,10,15,39,49,-10,25
Cliftonville,7981,1,18,4,8,52,34,18,58
Crusaders,7981,2,16,7,7,58,36,22,55
Linfield,7981,3,15,8,7,53,32,21,53
Ballymena,7981,4,13,5,12,53,60,-7,44
Dungannon,7981,5,11,9,10,48,39,9,42
Glenavon,7981,6,9,12,9,46,45,1,39
Coleraine,7981,7,9,12,9,34,36,-2,39
Ards,7981,8,11,5,14,41,45,-4,38
Glentoran,7981,9,11,5,14,33,44,-11,38
Ballinamalla,7981,10,7,4,19,28,55,-27,25
Portadown,7981,11,4,11,15,25,45,-20,23
Crusaders,7982,1,19,5,6,57,30,27,62
Linfield,7982,2,16,8,6,66,31,35,56
Cliftonville,7982,3,17,5,8,48,33,15,56
Coleraine,7982,4,13,9,8,49,37,12,48
Ballymena,7982,5,12,5,13,55,68,-13,41
Glenavon,7982,6,10,10,10,49,51,-2,40
Dungannon,7982,7,9,9,12,50,51,-1,36
Portadown,7982,8,10,4,16,29,50,-21,34
Ballinamalla,7982,9,10,3,17,34,51,-17,33
Glentoran,7982,10,9,5,16,31,44,-13,32
Ards,7982,11,6,5,19,40,62,-22,23
Crusaders,7983,1,16,9,5,56,35,21,57
Cliftonville,7983,2,16,5,9,54,38,16,53
Linfield,7983,3,14,10,6,62,32,30,52
Ballymena,7983,4,15,5,10,57,57,0,50
Coleraine,7983,5,11,13,6,41,31,10,46
Glenavon,7983,6,11,10,9,45,44,1,43
Glentoran,7983,7,10,7,13,33,42,-9,37
Dungannon,7983,8,8,12,10,48,45,3,36
Portadown,7983,9,8,3,19,19,46,-27,27
Ballinamalla,7983,10,7,5,18,30,56,-26,26
Ards,7983,11,5,9,16,30,49,-19,24
Crusaders,7984,1,20,5,5,56,27,29,65
Ballymena,7984,2,14,8,8,61,55,6,50
Cliftonville,7984,3,13,9,8,52,44,8,48
Coleraine,7984,4,12,11,7,44,40,4,47
Linfield,7984,5,10,13,7,55,36,19,43
Ards,7984,6,11,6,13,40,43,-3,39
Glenavon,7984,7,8,12,10,44,44,0,36
Glentoran,7984,8,9,7,14,29,43,-14,34
Ballinamalla,7984,9,10,4,16,31,48,-17,34
Dungannon,7984,10,7,10,13,40,44,-4,31
Portadown,7984,11,6,5,19,21,49,-28,23
Crusaders,7985,1,17,7,6,60,39,21,58
Linfield,7985,2,14,9,7,57,34,23,51
Ballymena,7985,3,15,4,11,60,59,1,49
Coleraine,7985,4,13,8,9,42,37,5,47
Cliftonville,7985,5,13,7,10,50,46,4,46
Dungannon,7985,6,12,7,11,52,40,12,43
Ards,7985,7,12,6,12,46,45,1,42
Glenavon,7985,8,10,11,9,48,48,0,41
Glentoran,7985,9,7,7,16,32,48,-16,28
Ballinamalla,7985,10,8,4,18,33,56,-23,28
Portadown,7985,11,6,6,18,24,52,-28,24
Crusaders,7986,1,20,7,3,64,30,34,67
Cliftonville,7986,2,14,8,8,55,42,13,50
Ballymena,7986,3,15,5,10,56,59,-3,50
Linfield,7986,4,12,9,9,58,36,22,45
Dungannon,7986,5,12,9,9,58,42,16,45
Coleraine,7986,6,12,8,10,39,38,1,44
Glenavon,7986,7,11,10,9,44,43,1,43
Ards,7986,8,9,7,14,43,54,-11,34
Glentoran,7986,9,8,7,15,35,50,-15,31
Ballinamalla,7986,10,8,4,18,31,56,-25,28
Portadown,7986,11,4,6,20,19,52,-33,18
Linfield,7987,1,17,7,6,53,25,28,58
Crusaders,7987,2,15,7,8,55,38,17,52
Cliftonville,7987,3,15,6,9,50,38,12,51
Ballymena,7987,4,15,6,9,62,53,9,51
Glenavon,7987,5,12,11,7,46,40,6,47
Dungannon,7987,6,11,9,10,51,40,11,42
Coleraine,7987,7,10,9,11,38,45,-7,39
Ards,7987,8,10,7,13,40,46,-6,37
Ballinamalla,7987,9,9,4,17,29,46,-17,31
Glentoran,7987,10,7,7,16,27,48,-21,28
Portadown,7987,11,5,5,20,22,54,-32,20
Cliftonville,7988,1,18,3,9,52,33,19,57
Crusaders,7988,2,16,8,6,53,30,23,56
Ballymena,7988,3,15,6,9,56,52,4,51
Linfield,7988,4,12,11,7,60,43,17,47
Glenavon,7988,5,12,10,8,48,49,-1,46
Coleraine,7988,6,9,14,7,42,38,4,41
Glentoran,7988,7,11,7,12,38,42,-4,40
Dungannon,7988,8,9,8,13,53,52,1,35
Portadown,7988,9,8,4,18,28,47,-19,28
Ballinamalla,7988,10,8,4,18,32,55,-23,28
Ards,7988,11,7,5,18,41,62,-21,26
Crusaders,7989,1,16,9,5,62,36,26,57
Linfield,7989,2,12,11,7,59,35,24,47
Glenavon,7989,3,12,11,7,50,47,3,47
Coleraine,7989,4,12,10,8,39,35,4,46
Ballymena,7989,5,13,6,11,55,58,-3,45
Dungannon,7989,6,11,11,8,55,42,13,44
Cliftonville,7989,7,12,4,14,45,48,-3,40
Ards,7989,8,11,6,13,37,43,-6,39
Glentoran,7989,9,8,6,16,32,47,-15,30
Ballinamalla,7989,10,9,3,18,30,55,-25,30
Portadown,7989,11,7,7,16,25,43,-18,28
Crusaders,7990,1,15,8,7,53,35,18,53
Linfield,7990,2,14,10,6,62,37,25,52
Ballymena,7990,3,14,8,8,63,61,2,50
Coleraine,7990,4,12,12,6,51,36,15,48
Cliftonville,7990,5,14,5,11,52,43,9,47
Dungannon,7990,6,10,12,8,55,46,9,42
Glenavon,7990,7,7,15,8,47,50,-3,36
Glentoran,7990,8,9,7,14,29,42,-13,34
Ballinamalla,7990,9,9,6,15,27,45,-18,33
Ards,7990,10,6,8,16,32,53,-21,26
Portadown,7990,11,6,7,17,20,43,-23,25
Crusaders,7991,1,16,8,6,64,41,23,56
Linfield,7991,2,15,9,6,60,32,28,54
Cliftonville,7991,3,16,6,8,53,38,15,54
Dungannon,7991,4,14,8,8,50,35,15,50
Ballymena,7991,5,13,8,9,59,62,-3,47
Coleraine,7991,6,12,10,8,45,38,7,46
Glenavon,7991,7,9,9,12,43,47,-4,36
Ards,7991,8,10,3,17,33,47,-14,33
Glentoran,7991,9,8,5,17,22,38,-16,29
Ballinamalla,7991,10,8,4,18,25,49,-24,28
Portadown,7991,11,7,4,19,23,50,-27,25
Crusaders,7992,1,16,6,8,57,45,12,54
Cliftonville,7992,2,15,6,9,56,37,19,51
Ballymena,7992,3,15,5,10,57,60,-3,50
Coleraine,7992,4,13,9,8,43,38,5,48
Linfield,7992,5,11,10,9,48,35,13,43
Glenavon,7992,6,11,10,9,44,35,9,43
Glentoran,7992,7,11,7,12,39,44,-5,40
Ards,7992,8,9,9,12,39,46,-7,36
Dungannon,7992,9,7,11,12,40,41,-1,32
Portadown,7992,10,6,11,13,27,40,-13,29
Ballinamalla,7992,11,6,6,18,24,53,-29,24
Crusaders,7993,1,18,6,6,54,35,19,60
Ballymena,7993,2,16,8,6,65,56,9,56
Linfield,7993,3,12,13,5,58,31,27,49
Cliftonville,7993,4,15,3,12,48,41,7,48
Dungannon,7993,5,11,9,10,47,36,11,42
Coleraine,7993,6,11,9,10,42,39,3,42
Glenavon,7993,7,10,11,9,44,41,3,41
Glentoran,7993,8,8,10,12,37,48,-11,34
Ards,7993,9,9,5,16,43,55,-12,32
Portadown,7993,10,6,7,17,21,47,-26,25
Ballinamalla,7993,11,6,5,19,23,53,-30,23
Crusaders,7994,1,18,7,5,53,30,23,61
Cliftonville,7994,2,18,2,10,56,36,20,56
Linfield,7994,3,14,8,8,60,37,23,50
Ballymena,7994,4,13,8,9,52,52,0,47
Dungannon,7994,5,11,8,11,45,42,3,41
Glenavon,7994,6,10,11,9,43,46,-3,41
Coleraine,7994,7,9,12,9,38,43,-5,39
Glentoran,7994,8,8,8,14,30,44,-14,32
Ballinamalla,7994,9,9,5,16,38,53,-15,32
Portadown,7994,10,8,5,17,31,46,-15,29
Ards,7994,11,7,6,17,40,57,-17,27
Crusaders,7995,1,17,9,4,60,30,30,60
Linfield,7995,2,15,9,6,63,33,30,54
Coleraine,7995,3,13,9,8,51,38,13,48
Cliftonville,7995,4,12,6,12,48,48,0,42
Ballymena,7995,5,12,6,12,51,58,-7,42
Glentoran,7995,6,12,4,14,32,45,-13,40
Ards,7995,7,11,5,14,45,50,-5,38
Dungannon,7995,8,9,10,11,46,42,4,37
Glenavon,7995,9,9,8,13,41,52,-11,35
Ballinamalla,7995,10,9,4,17,31,51,-20,31
Portadown,7995,11,7,8,15,19,40,-21,29
Cliftonville,7996,1,19,5,6,58,32,26,62
Crusaders,7996,2,16,7,7,54,31,23,55
Glenavon,7996,3,15,10,5,57,44,13,55
Ballymena,7996,4,15,7,8,61,54,7,52
Linfield,7996,5,10,11,9,57,45,12,41
Glentoran,7996,6,10,10,10,31,41,-10,40
Coleraine,7996,7,8,11,11,32,43,-11,35
Dungannon,7996,8,8,10,12,46,45,1,34
Ards,7996,9,7,8,15,39,51,-12,29
Ballinamalla,7996,10,6,6,18,26,51,-25,24
Portadown,7996,11,6,5,19,25,49,-24,23
Crusaders,7997,1,18,6,6,62,30,32,60
Ballymena,7997,2,15,6,9,54,53,1,51
Cliftonville,7997,3,14,6,10,48,41,7,48
Glenavon,7997,4,12,9,9,53,48,5,45
Dungannon,7997,5,12,8,10,52,41,11,44
Linfield,7997,6,10,11,9,52,44,8,41
Coleraine,7997,7,10,10,10,36,38,-2,40
Glentoran,7997,8,9,8,13,35,50,-15,35
Ballinamalla,7997,9,7,9,14,38,54,-16,30
Ards,7997,10,7,8,15,35,45,-10,29
Portadown,7997,11,7,7,16,25,46,-21,28
Linfield,7998,1,15,11,4,60,29,31,56
Crusaders,7998,2,16,7,7,51,34,17,55
Cliftonville,7998,3,14,7,9,54,43,11,49
Coleraine,7998,4,11,12,7,42,40,2,45
Ballymena,7998,5,12,9,9,54,57,-3,45
Dungannon,7998,6,10,11,9,53,42,11,41
Ards,7998,7,11,5,14,43,46,-3,38
Glenavon,7998,8,9,10,11,45,47,-2,37
Ballinamalla,7998,9,9,5,16,32,51,-19,32
Portadown,7998,10,6,8,16,24,46,-22,26
Glentoran,7998,11,5,9,16,26,49,-23,24
Crusaders,7999,1,14,10,6,56,39,17,52
Coleraine,7999,2,13,12,5,49,30,19,51
Ballymena,7999,3,13,7,10,56,61,-5,46
Cliftonville,7999,4,13,6,11,51,41,10,45
Dungannon,7999,5,12,6,12,55,43,12,42
Linfield,7999,6,11,8,11,51,40,11,41
Ards,7999,7,12,5,13,41,47,-6,41
Glenavon,7999,8,9,13,8,49,50,-1,40
Portadown,7999,9,11,7,12,31,41,-10,40
Glentoran,7999,10,7,8,15,29,47,-18,29
Ballinamalla,7999,11,6,6,18,29,58,-29,24
Cliftonville,8000,1,16,7,7,57,43,14,55
Crusaders,8000,2,13,12,5,54,38,16,51
Ballymena,8000,3,15,5,10,58,53,5,50
Coleraine,8000,4,13,10,7,48,41,7,49
Linfield,8000,5,12,10,8,53,34,19,46
Glenavon,8000,6,11,13,6,47,39,8,46
Glentoran,8000,7,8,11,11,35,42,-7,35
Dungannon,8000,8,7,13,10,46,44,2,34
Portadown,8000,9,6,9,15,21,40,-19,27
Ballinamalla,8000,10,6,8,16,29,54,-25,26
Ards,8000,11,5,8,17,33,53,-20,23
Linfield,8001,1,15,9,6,68,33,35,54
Cliftonville,8001,2,16,5,9,56,39,17,53
Crusaders,8001,2,15,8,7,56,39,17,53
Glenavon,8001,4,13,11,6,51,39,12,50
Ballymena,8001,5,15,4,11,52,59,-7,49
Coleraine,8001,6,11,10,9,37,40,-3,43
Dungannon,8001,7,10,10,10,48,42,6,40
Ards,8001,8,11,6,13,45,47,-2,39
Glentoran,8001,9,9,7,14,32,46,-14,34
Portadown,8001,10,5,7,18,23,53,-30,22
Ballinamalla,8001,11,4,5,21,26,57,-31,17
Linfield,8002,1,18,7,5,63,29,34,61
Crusaders,8002,2,17,6,7,56,33,23,57
Cliftonville,8002,3,16,4,10,52,40,12,52
Ballymena,8002,4,15,6,9,56,49,7,51
Dungannon,8002,5,13,7,10,55,42,13,46
Coleraine,8002,6,10,9,11,40,38,2,39
Glenavon,8002,7,9,11,10,42,45,-3,38
Glentoran,8002,8,9,7,14,28,48,-20,34
Portadown,8002,9,10,2,18,30,49,-19,32
Ards,8002,10,8,5,17,40,57,-17,29
Ballinamalla,8002,11,6,4,20,26,58,-32,22
Cliftonville,8003,1,16,6,8,58,40,18,54
Ballymena,8003,2,15,7,8,65,60,5,52
Coleraine,8003,3,13,10,7,44,33,11,49
Crusaders,8003,4,13,9,8,54,44,10,48
Linfield,8003,5,13,8,9,56,32,24,47
Glenavon,8003,6,9,14,7,48,48,0,41
Dungannon,8003,7,10,8,12,53,55,-2,38
Ards,8003,8,8,9,13,32,42,-10,33
Glentoran,8003,9,7,8,15,29,45,-16,29
Portadown,8003,10,7,8,15,31,49,-18,29
Ballinamalla,8003,11,8,5,17,29,51,-22,29
Linfield,8004,1,16,10,4,63,28,35,58
Crusaders,8004,2,14,9,7,56,44,12,51
Cliftonville,8004,3,14,8,8,53,37,16,50
Glenavon,8004,4,13,8,9,47,47,0,47
Ballymena,8004,5,13,5,12,59,64,-5,44
Dungannon,8004,6,10,12,8,55,41,14,42
Glentoran,8004,7,11,9,10,35,37,-2,42
Coleraine,8004,8,9,9,12,39,43,-4,36
Portadown,8004,9,9,4,17,28,47,-19,31
Ballinamalla,8004,10,6,7,17,25,55,-30,25
Ards,8004,11,5,9,16,34,51,-17,24
Cliftonville,8005,1,18,4,8,58,36,22,58
Linfield,8005,2,16,8,6,62,25,37,56
Crusaders,8005,3,15,9,6,57,43,14,54
Glenavon,8005,4,12,10,8,46,44,2,46
Ballymena,8005,5,13,4,13,54,61,-7,43
Coleraine,8005,6,9,11,10,45,48,-3,38
Dungannon,8005,7,8,13,9,50,45,5,37
Portadown,8005,8,10,6,14,31,45,-14,36
Ards,8005,9,8,6,16,40,51,-11,30
Glentoran,8005,10,6,9,15,24,46,-22,27
Ballinamalla,8005,11,6,8,16,32,55,-23,26
Crusaders,8006,1,19,7,4,59,35,24,64
Cliftonville,8006,2,15,6,9,51,39,12,51
Linfield,8006,3,12,12,6,64,36,28,48
Coleraine,8006,4,11,12,7,51,42,9,45
Ballymena,8006,5,11,11,8,62,57,5,44
Ards,8006,6,12,6,12,34,41,-7,42
Dungannon,8006,7,9,12,9,49,44,5,39
Glenavon,8006,8,8,12,10,46,50,-4,36
Portadown,8006,9,6,9,15,22,43,-21,27
Glentoran,8006,10,6,8,16,27,52,-25,26
Ballinamalla,8006,11,3,11,16,27,53,-26,20
Glenavon,8007,1,17,8,5,58,43,15,59
Crusaders,8007,2,13,11,6,58,42,16,50
Ballymena,8007,3,14,7,9,64,62,2,49
Cliftonville,8007,4,15,3,12,60,42,18,48
Linfield,8007,5,13,9,8,58,41,17,48
Dungannon,8007,6,11,8,11,51,44,7,41
Coleraine,8007,7,10,9,11,40,43,-3,39
Glentoran,8007,8,9,8,13,31,42,-11,35
Ards,8007,9,9,7,14,37,47,-10,34
Portadown,8007,10,7,6,17,29,52,-23,27
Ballinamalla,8007,11,7,4,19,30,58,-28,25
Crusaders,8008,1,16,9,5,65,36,29,57
Cliftonville,8008,2,16,6,8,55,39,16,54
Dungannon,8008,3,13,9,8,57,40,17,48
Linfield,8008,4,11,13,6,56,35,21,46
Coleraine,8008,5,12,10,8,40,33,7,46
Ballymena,8008,6,12,7,11,57,56,1,43
Glenavon,8008,7,10,12,8,47,50,-3,42
Ards,8008,8,11,3,16,39,51,-12,36
Glentoran,8008,9,6,9,15,26,53,-27,27
Ballinamalla,8008,10,7,5,18,28,55,-27,26
Portadown,8008,11,5,9,16,30,52,-22,24
Crusaders,8009,1,17,9,4,64,30,34,60
Cliftonville,8009,2,15,8,7,48,34,14,53
Linfield,8009,3,14,9,7,56,34,22,51
Glentoran,8009,4,14,8,8,45,40,5,50
Glenavon,8009,5,13,9,8,48,44,4,48
Coleraine,8009,6,11,11,8,38,37,1,44
Ballymena,8009,7,11,9,10,54,61,-7,42
Dungannon,8009,8,8,10,12,45,45,0,34
Ards,8009,9,8,5,17,37,54,-17,29
Ballinamalla,8009,10,7,2,21,32,61,-29,23
Portadown,8009,11,5,4,21,30,57,-27,19
Crusaders,8010,1,18,8,4,54,31,23,62
Ballymena,8010,2,16,5,9,61,56,5,53
Linfield,8010,3,13,10,7,55,31,24,49
Cliftonville,8010,4,15,2,13,45,39,6,47
Glenavon,8010,5,11,11,8,46,45,1,44
Coleraine,8010,6,10,11,9,41,39,2,41
Glentoran,8010,7,11,6,13,32,42,-10,39
Dungannon,8010,8,9,8,13,50,47,3,35
Ards,8010,9,9,4,17,36,51,-15,31
Ballinamalla,8010,10,9,4,17,33,51,-18,31
Portadown,8010,11,7,5,18,23,44,-21,26
Cliftonville,8011,1,20,2,8,55,32,23,62
Linfield,8011,2,14,10,6,57,29,28,52
Crusaders,8011,3,14,8,8,57,36,21,50
Glenavon,8011,4,13,8,9,48,51,-3,47
Coleraine,8011,5,13,7,10,38,32,6,46
Ballymena,8011,6,12,6,12,50,57,-7,42
Ards,8011,7,12,3,15,35,46,-11,39
Dungannon,8011,8,8,10,12,46,43,3,34
Portadown,8011,9,8,6,16,27,44,-17,30
Ballinamalla,8011,10,8,5,17,29,52,-23,29
Glentoran,8011,11,7,7,16,31,51,-20,28
Crusaders,8012,1,17,8,5,57,35,22,59
Linfield,8012,2,16,9,5,59,30,29,57
Glenavon,8012,3,14,10,6,55,42,13,52
Coleraine,8012,4,12,12,6,40,31,9,48
Cliftonville,8012,5,12,7,11,40,37,3,43
Ballymena,8012,6,11,10,9,56,58,-2,43
Dungannon,8012,7,11,8,11,61,49,12,41
Ards,8012,8,10,6,14,37,45,-8,36
Glentoran,8012,9,6,8,16,30,48,-18,26
Ballinamalla,8012,10,7,4,19,27,57,-30,25
Portadown,8012,11,6,4,20,21,51,-30,22
Cliftonville,8013,1,16,5,9,58,40,18,53
Linfield,8013,2,14,9,7,56,33,23,51
Ballymena,8013,3,15,5,10,67,63,4,50
Crusaders,8013,4,13,7,10,52,41,11,46
Coleraine,8013,5,11,11,8,43,44,-1,44
Portadown,8013,6,12,5,13,31,37,-6,41
Dungannon,8013,7,9,11,10,49,49,0,38
Glentoran,8013,8,10,7,13,29,44,-15,37
Glenavon,8013,9,9,9,12,46,44,2,36
Ards,8013,10,6,10,14,33,49,-16,28
Ballinamalla,8013,11,7,7,16,27,47,-20,28
Linfield,8014,1,16,9,5,72,38,34,57
Cliftonville,8014,2,17,5,8,57,42,15,56
Crusaders,8014,3,16,7,7,60,40,20,55
Ballymena,8014,4,14,7,9,66,60,6,49
Dungannon,8014,5,12,8,10,57,45,12,44
Glenavon,8014,6,10,14,6,49,47,2,44
Coleraine,8014,7,9,14,7,39,34,5,41
Ards,8014,8,9,6,15,38,48,-10,33
Glentoran,8014,9,7,8,15,35,54,-19,29
Ballinamalla,8014,10,7,5,18,31,55,-24,26
Portadown,8014,11,3,7,20,21,62,-41,16
Crusaders,8015,1,17,9,4,62,29,33,60
Cliftonville,8015,2,17,3,10,55,44,11,54
Glenavon,8015,3,14,11,5,48,36,12,53
Linfield,8015,4,13,10,7,50,28,22,49
Ballymena,8015,5,14,6,10,58,60,-2,48
Dungannon,8015,6,10,6,14,45,48,-3,36
Glentoran,8015,7,9,9,12,30,42,-12,36
Portadown,8015,8,10,3,17,24,47,-23,33
Coleraine,8015,9,7,9,14,35,43,-8,30
Ards,8015,10,9,3,18,35,47,-12,30
Ballinamalla,8015,11,8,5,17,35,53,-18,29
Linfield,8016,1,16,10,4,61,34,27,58
Ballymena,8016,2,15,5,10,65,63,2,50
Crusaders,8016,3,13,10,7,50,33,17,49
Cliftonville,8016,4,15,3,12,54,43,11,48
Glenavon,8016,5,11,11,8,49,42,7,44
Coleraine,8016,6,12,8,10,45,43,2,44
Ballinamalla,8016,7,10,4,16,30,50,-20,34
Dungannon,8016,8,8,9,13,50,54,-4,33
Ards,8016,9,10,3,17,42,52,-10,33
Glentoran,8016,10,8,8,14,33,48,-15,32
Portadown,8016,11,9,5,16,27,44,-17,32
Crusaders,8017,1,16,5,9,55,35,20,53
Ballymena,8017,2,16,5,9,60,58,2,53
Cliftonville,8017,3,13,8,9,49,40,9,47
Linfield,8017,4,11,12,7,52,32,20,45
Coleraine,8017,5,11,9,10,45,44,1,42
Dungannon,8017,6,11,7,12,57,50,7,40
Glenavon,8017,7,10,10,10,43,45,-2,40
Glentoran,8017,8,10,8,12,35,45,-10,38
Ballinamalla,8017,9,10,5,15,35,50,-15,35
Ards,8017,10,9,5,16,39,53,-14,32
Portadown,8017,11,8,6,16,23,41,-18,30
Crusaders,8018,1,14,9,7,53,34,19,51
Coleraine,8018,2,14,9,7,46,36,10,51
Ballymena,8018,3,14,9,7,58,56,2,51
Glenavon,8018,4,13,9,8,51,41,10,48
Linfield,8018,5,12,11,7,56,35,21,47
Cliftonville,8018,6,13,8,9,47,34,13,47
Dungannon,8018,7,12,8,10,56,41,15,44
Ards,8018,8,12,5,13,47,50,-3,41
Portadown,8018,9,8,3,19,17,51,-34,27
Ballinamalla,8018,10,7,3,20,32,61,-29,24
Glentoran,8018,11,5,8,17,26,50,-24,23
Cliftonville,8019,1,17,5,8,59,36,23,56
Linfield,8019,2,14,10,6,59,25,34,52
Crusaders,8019,3,15,7,8,52,38,14,52
Coleraine,8019,4,13,10,7,45,36,9,49
Glenavon,8019,5,11,11,8,45,44,1,44
Glentoran,8019,6,12,8,10,42,43,-1,44
Ballymena,8019,7,12,6,12,53,61,-8,42
Dungannon,8019,8,9,12,9,43,36,7,39
Ballinamalla,8019,9,7,5,18,25,51,-26,26
Ards,8019,10,7,4,19,30,49,-19,25
Portadown,8019,11,7,4,19,20,54,-34,25
Crusaders,8020,1,19,5,6,61,35,26,62
Linfield,8020,2,14,11,5,56,28,28,53
Cliftonville,8020,3,13,7,10,49,44,5,46
Coleraine,8020,4,12,9,9,43,36,7,45
Ballymena,8020,5,12,5,13,57,62,-5,41
Glenavon,8020,6,9,13,8,38,36,2,40
Glentoran,8020,7,10,8,12,35,43,-8,38
Ards,8020,8,9,8,13,35,44,-9,35
Ballinamalla,8020,9,10,4,16,35,51,-16,34
Dungannon,8020,10,6,10,14,40,50,-10,28
Portadown,8020,11,6,10,14,29,49,-20,28
Crusaders,8021,1,17,7,6,56,36,20,58
Cliftonville,8021,2,17,4,9,64,48,16,55
Linfield,8021,3,14,8,8,51,30,21,50
Coleraine,8021,4,13,10,7,49,40,9,49
Glenavon,8021,5,13,9,8,56,48,8,48
Ballymena,8021,6,14,5,11,53,60,-7,47
Dungannon,8021,7,9,9,12,53,49,4,36
Glentoran,8021,8,8,8,14,29,43,-14,32
Ballinamalla,8021,9,9,3,18,37,57,-20,30
Portadown,8021,10,8,5,17,26,42,-16,29
Ards,8021,11,6,6,18,33,54,-21,24
Crusaders,8022,1,15,7,8,53,38,15,52
Cliftonville,8022,2,15,5,10,53,38,15,50
Linfield,8022,3,13,10,7,62,35,27,49
Coleraine,8022,4,12,12,6,50,37,13,48
Ballymena,8022,5,11,11,8,52,57,-5,44
Dungannon,8022,6,10,11,9,41,34,7,41
Glenavon,8022,7,9,12,9,45,44,1,39
Glentoran,8022,8,9,8,13,33,47,-14,35
Portadown,8022,9,8,8,14,28,48,-20,32
Ards,8022,10,7,7,16,37,53,-16,28
Ballinamalla,8022,11,7,7,16,29,52,-23,28
Crusaders,8023,1,17,7,6,58,31,27,58
Linfield,8023,2,15,12,3,74,38,36,57
Ballymena,8023,3,17,3,10,60,57,3,54
Cliftonville,8023,4,13,7,10,49,43,6,46
Coleraine,8023,5,11,11,8,45,42,3,44
Dungannon,8023,6,11,10,9,52,40,12,43
Glenavon,8023,7,9,9,12,43,57,-14,36
Ards,8023,8,10,5,15,42,50,-8,35
Portadown,8023,9,9,4,17,26,43,-17,31
Glentoran,8023,10,8,5,17,33,51,-18,29
Ballinamalla,8023,11,7,3,20,32,62,-30,24
Cliftonville,8024,1,18,4,8,52,36,16,58
Crusaders,8024,2,16,8,6,57,36,21,56
Glenavon,8024,3,13,11,6,48,37,11,50
Linfield,8024,4,14,7,9,54,34,20,49
Coleraine,8024,5,13,10,7,47,36,11,49
Ballymena,8024,6,12,5,13,52,58,-6,41
Ards,8024,7,9,7,14,36,43,-7,34
Portadown,8024,8,10,3,17,31,51,-20,33
Dungannon,8024,9,8,8,14,53,57,-4,32
Glentoran,8024,10,7,9,14,30,46,-16,30
Ballinamalla,8024,11,6,6,18,31,57,-26,24
Crusaders,8025,1,19,5,6,63,36,27,62
Linfield,8025,2,15,9,6,65,35,30,54
Cliftonville,8025,3,16,6,8,48,39,9,54
Ballymena,8025,4,14,6,10,56,57,-1,48
Glenavon,8025,5,13,8,9,51,45,6,47
Coleraine,8025,6,11,10,9,42,42,0,43
Glentoran,8025,7,11,7,12,36,43,-7,40
Portadown,8025,8,9,3,18,29,50,-21,30
Dungannon,8025,9,6,9,15,46,52,-6,27
Ballinamalla,8025,10,7,5,18,33,54,-21,26
Ards,8025,11,5,10,15,34,50,-16,25
Glenavon,8026,1,14,11,5,55,42,13,53
Linfield,8026,2,14,9,7,56,33,23,51
Crusaders,8026,3,14,9,7,54,38,16,51
Cliftonville,8026,4,15,5,10,50,37,13,50
Coleraine,8026,5,12,11,7,49,36,13,47
Ballymena,8026,6,11,8,11,54,59,-5,41
Dungannon,8026,7,10,9,11,50,45,5,39
Glentoran,8026,8,10,7,13,35,44,-9,37
Ards,8026,9,11,4,15,33,48,-15,37
Portadown,8026,10,8,6,16,22,39,-17,30
Ballinamalla,8026,11,5,3,22,25,62,-37,18
Cliftonville,8027,1,18,3,9,58,39,19,57
Crusaders,8027,2,16,6,8,61,44,17,54
Linfield,8027,3,13,11,6,62,38,24,50
Dungannon,8027,4,12,9,9,54,39,15,45
Ballymena,8027,5,13,6,11,62,61,1,45
Glenavon,8027,6,10,10,10,45,49,-4,40
Glentoran,8027,7,11,7,12,36,42,-6,40
Coleraine,8027,8,9,10,11,41,50,-9,37
Ballinamalla,8027,9,11,3,16,30,47,-17,36
Ards,8027,10,10,2,18,40,49,-9,32
Portadown,8027,11,6,5,19,29,60,-31,23
Crusaders,8028,1,19,7,4,57,30,27,64
Cliftonville,8028,2,16,3,11,58,43,15,51
Linfield,8028,3,14,7,9,58,33,25,49
Glenavon,8028,4,12,10,8,46,42,4,46
Coleraine,8028,5,12,9,9,43,39,4,45
Ballymena,8028,6,12,7,11,59,63,-4,43
Dungannon,8028,7,9,9,12,46,50,-4,36
Ards,8028,8,10,6,14,43,49,-6,36
Glentoran,8028,9,10,5,15,37,52,-15,35
Portadown,8028,10,8,8,14,34,49,-15,32
Ballinamalla,8028,11,5,5,20,24,55,-31,20
Linfield,8029,1,18,6,6,61,33,28,60
Crusaders,8029,2,17,5,8,63,44,19,56
Ballymena,8029,3,15,5,10,54,53,1,50
Glenavon,8029,4,13,8,9,52,44,8,47
Cliftonville,8029,5,14,3,13,48,49,-1,45
Ards,8029,6,13,4,13,43,46,-3,43
Coleraine,8029,7,11,9,10,36,35,1,42
Dungannon,8029,8,9,11,10,49,45,4,38
Glentoran,8029,9,9,6,15,39,47,-8,33
Portadown,8029,10,7,6,17,22,42,-20,27
Ballinamalla,8029,11,7,1,22,32,61,-29,22
Crusaders,8030,1,18,8,4,63,31,32,62
Coleraine,8030,2,13,13,4,53,38,15,52
Cliftonville,8030,3,13,9,8,54,39,15,48
Linfield,8030,4,13,8,9,49,34,15,47
Ballymena,8030,5,12,9,9,58,54,4,45
Glenavon,8030,6,9,12,9,51,46,5,39
Dungannon,8030,7,10,8,12,53,52,1,38
Glentoran,8030,8,10,7,13,36,49,-13,37
Ards,8030,9,9,4,17,36,54,-18,31
Ballinamalla,8030,10,8,4,18,35,59,-24,28
Portadown,8030,11,7,4,19,24,56,-32,25
Ballymena,8031,1,17,7,6,69,52,17,58
Crusaders,8031,2,16,8,6,55,37,18,56
Linfield,8031,3,14,12,4,65,37,28,54
Cliftonville,8031,4,16,4,10,51,41,10,52
Glenavon,8031,5,11,11,8,44,46,-2,44
Coleraine,8031,6,11,8,11,44,44,0,41
Dungannon,8031,7,9,9,12,53,49,4,36
Ards,8031,8,9,6,15,41,53,-12,33
Glentoran,8031,9,8,6,16,33,50,-17,30
Ballinamalla,8031,10,8,3,19,32,52,-20,27
Portadown,8031,11,7,4,19,23,49,-26,25
Crusaders,8032,1,18,6,6,54,32,22,60
Ballymena,8032,2,17,4,9,53,49,4,55
Cliftonville,8032,3,17,3,10,59,43,16,54
Linfield,8032,4,15,6,9,53,33,20,51
Glenavon,8032,5,12,8,10,43,46,-3,44
Coleraine,8032,6,11,10,9,40,38,2,43
Dungannon,8032,7,11,8,11,51,41,10,41
Portadown,8032,8,9,4,17,30,43,-13,31
Glentoran,8032,9,8,6,16,29,44,-15,30
Ards,8032,10,7,8,15,32,45,-13,29
Ballinamalla,8032,11,5,7,18,26,56,-30,22
Ballymena,8033,1,16,6,8,58,52,6,54
Coleraine,8033,2,14,10,6,45,35,10,52
Glenavon,8033,3,13,12,5,52,35,17,51
Crusaders,8033,4,14,8,8,60,45,15,50
Linfield,8033,5,12,11,7,55,36,19,47
Cliftonville,8033,6,14,3,13,54,46,8,45
Glentoran,8033,7,9,7,14,39,50,-11,34
Ards,8033,8,9,5,16,33,51,-18,32
Dungannon,8033,9,6,13,11,43,47,-4,31
Portadown,8033,10,8,6,16,24,43,-19,30
Ballinamalla,8033,11,7,5,18,33,56,-23,26
Ballymena,8034,1,16,6,8,52,49,3,54
Coleraine,8034,2,13,11,6,43,33,10,50
Crusaders,8034,3,13,9,8,48,35,13,48
Linfield,8034,4,13,8,9,58,39,19,47
Cliftonville,8034,5,14,4,12,51,41,10,46
Glenavon,8034,6,12,10,8,54,47,7,46
Glentoran,8034,7,13,6,11,39,37,2,45
Dungannon,8034,8,10,10,10,55,41,14,40
Ards,8034,9,8,5,17,38,58,-20,29
Portadown,8034,10,7,5,18,29,52,-23,26
Ballinamalla,8034,11,7,4,19,30,65,-35,25
Crusaders,8035,1,15,8,7,51,36,15,53
Linfield,8035,2,14,9,7,57,37,20,51
Coleraine,8035,3,14,9,7,47,33,14,51
Cliftonville,8035,4,13,8,9,48,40,8,47
Ballymena,8035,5,12,9,9,57,55,2,45
Glenavon,8035,6,11,10,9,50,48,2,43
Glentoran,8035,7,10,7,13,27,41,-14,37
Ards,8035,8,9,7,14,42,51,-9,34
Ballinamalla,8035,9,9,5,16,31,49,-18,32
Dungannon,8035,10,7,10,13,46,46,0,31
Portadown,8035,11,6,8,16,20,40,-20,26
Glenavon,8036,1,14,11,5,51,37,14,53
Crusaders,8036,2,15,8,7,50,38,12,53
Ballymena,8036,3,15,7,8,62,57,5,52
Linfield,8036,4,14,8,8,60,33,27,50
Cliftonville,8036,5,14,5,11,54,35,19,47
Coleraine,8036,6,10,9,11,35,39,-4,39
Dungannon,8036,7,9,8,13,51,53,-2,35
Ballinamalla,8036,8,10,5,15,38,54,-16,35
Glentoran,8036,9,9,7,14,33,47,-14,34
Portadown,8036,10,8,6,16,23,43,-20,30
Ards,8036,11,8,4,18,36,57,-21,28
Linfield,8037,1,16,8,6,58,30,28,56
Crusaders,8037,2,15,8,7,55,39,16,53
Glenavon,8037,3,13,11,6,53,46,7,50
Coleraine,8037,4,13,9,8,45,38,7,48
Cliftonville,8037,5,14,4,12,46,41,5,46
Ballymena,8037,6,12,7,11,56,62,-6,43
Ards,8037,7,11,5,14,40,45,-5,38
Dungannon,8037,8,10,7,13,52,48,4,37
Portadown,8037,9,8,7,15,26,40,-14,31
Glentoran,8037,10,6,9,15,31,49,-18,27
Ballinamalla,8037,11,7,5,18,28,52,-24,26
Crusaders,8038,1,18,7,5,60,34,26,61
Linfield,8038,2,15,8,7,63,36,27,53
Ballymena,8038,3,15,6,9,65,64,1,51
Cliftonville,8038,4,15,5,10,63,52,11,50
Glenavon,8038,5,11,9,10,44,46,-2,42
Glentoran,8038,6,12,6,12,40,47,-7,42
Coleraine,8038,7,10,10,10,46,43,3,40
Dungannon,8038,8,8,9,13,44,47,-3,33
Ards,8038,9,9,5,16,33,46,-13,32
Ballinamalla,8038,10,9,4,17,31,48,-17,31
Portadown,8038,11,6,5,19,27,53,-26,23
Ballymena,8039,1,16,8,6,58,46,12,56
Coleraine,8039,2,14,11,5,43,30,13,53
Crusaders,8039,3,15,7,8,53,36,17,52
Linfield,8039,4,13,8,9,55,36,19,47
Dungannon,8039,5,13,8,9,51,40,11,47
Cliftonville,8039,6,14,5,11,53,44,9,47
Glenavon,8039,7,12,11,7,50,49,1,47
Ballinamalla,8039,8,9,4,17,34,55,-21,31
Portadown,8039,9,7,6,17,25,44,-19,27
Glentoran,8039,10,7,6,17,26,50,-24,27
Ards,8039,11,5,6,19,39,57,-18,21
Linfield,8040,1,15,9,6,62,33,29,54
Crusaders,8040,2,15,7,8,62,42,20,52
Cliftonville,8040,3,15,6,9,53,40,13,51
Ballymena,8040,4,13,8,9,59,59,0,47
Glenavon,8040,5,12,10,8,47,44,3,46
Coleraine,8040,6,12,9,9,48,43,5,45
Dungannon,8040,7,9,10,11,49,50,-1,37
Ards,8040,8,11,4,15,45,54,-9,37
Glentoran,8040,9,8,9,13,33,45,-12,33
Portadown,8040,10,7,5,18,26,51,-25,26
Ballinamalla,8040,11,6,7,17,27,50,-23,25
Cliftonville,8041,1,18,4,8,58,39,19,58
Linfield,8041,2,15,8,7,60,31,29,53
Crusaders,8041,3,13,8,9,45,35,10,47
Glenavon,8041,4,12,10,8,44,45,-1,46
Ballymena,8041,5,13,6,11,52,56,-4,45
Dungannon,8041,6,11,11,8,58,43,15,44
Coleraine,8041,7,11,9,10,42,39,3,42
Ards,8041,8,11,4,15,44,53,-9,37
Portadown,8041,9,8,10,12,30,41,-11,34
Glentoran,8041,10,7,8,15,28,46,-18,29
Ballinamalla,8041,11,5,4,21,21,54,-33,19
Linfield,8042,1,14,10,6,56,31,25,52
Coleraine,8042,2,12,12,6,51,40,11,48
Ballymena,8042,3,12,12,6,57,53,4,48
Cliftonville,8042,4,14,5,11,56,45,11,47
Crusaders,8042,5,13,6,11,54,44,10,45
Glentoran,8042,6,10,10,10,37,39,-2,40
Glenavon,8042,7,9,12,9,43,50,-7,39
Dungannon,8042,8,9,11,10,50,46,4,38
Ballinamalla,8042,9,9,5,16,37,53,-16,32
Ards,8042,10,9,5,16,30,50,-20,32
Portadown,8042,11,7,6,17,29,49,-20,27
Crusaders,8043,1,19,7,4,53,28,25,64
Linfield,8043,2,14,8,8,59,33,26,50
Coleraine,8043,3,13,10,7,40,36,4,49
Cliftonville,8043,4,14,6,10,56,41,15,48
Dungannon,8043,5,12,10,8,49,38,11,46
Ballymena,8043,6,12,5,13,53,63,-10,41
Glenavon,8043,7,9,10,11,41,47,-6,37
Glentoran,8043,8,10,6,14,29,40,-11,36
Ards,8043,9,10,5,15,35,42,-7,35
Portadown,8043,10,7,7,16,27,45,-18,28
Ballinamalla,8043,11,6,4,20,28,57,-29,22
Crusaders,8044,1,18,7,5,59,30,29,61
Linfield,8044,2,15,9,6,54,25,29,54
Cliftonville,8044,3,13,7,10,50,45,5,46
Glenavon,8044,4,11,13,6,47,43,4,46
Ballymena,8044,5,11,10,9,60,62,-2,43
Coleraine,8044,6,10,12,8,49,40,9,42
Dungannon,8044,7,10,12,8,50,43,7,42
Ards,8044,8,9,3,18,29,49,-20,30
Glentoran,8044,9,8,5,17,30,50,-20,29
Ballinamalla,8044,10,8,5,17,32,54,-22,29
Portadown,8044,11,6,9,15,28,47,-19,27
Linfield,8045,1,15,11,4,60,28,32,56
Crusaders,8045,2,15,5,10,54,41,13,50
Cliftonville,8045,3,14,7,9,47,35,12,49
Ballymena,8045,4,14,6,10,54,50,4,48
Dungannon,8045,5,12,9,9,51,38,13,45
Ards,8045,6,13,4,13,39,48,-9,43
Glenavon,8045,7,11,8,11,43,45,-2,41
Coleraine,8045,8,9,11,10,41,48,-7,38
Glentoran,8045,9,8,9,13,35,49,-14,33
Portadown,8045,10,6,8,16,22,39,-17,26
Ballinamalla,8045,11,6,6,18,26,51,-25,24
Cliftonville,8046,1,18,5,7,59,35,24,59
Linfield,8046,2,15,8,7,73,40,33,53
Crusaders,8046,3,15,7,8,47,30,17,52
Ballymena,8046,4,14,6,10,63,65,-2,48
Coleraine,8046,5,10,14,6,42,34,8,44
Dungannon,8046,6,11,10,9,53,43,10,43
Glenavon,8046,7,8,13,9,38,48,-10,37
Ards,8046,8,10,4,16,41,49,-8,34
Glentoran,8046,9,8,8,14,27,50,-23,32
Portadown,8046,10,7,5,18,27,48,-21,26
Ballinamalla,8046,11,7,4,19,22,50,-28,25
Linfield,8047,1,17,8,5,63,30,33,59
Cliftonville,8047,2,15,6,9,52,38,14,51
Ballymena,8047,3,14,9,7,59,55,4,51
Crusaders,8047,4,14,7,9,48,34,14,49
Dungannon,8047,5,11,10,9,57,48,9,43
Coleraine,8047,6,8,14,8,42,44,-2,38
Glentoran,8047,7,10,8,12,40,49,-9,38
Glenavon,8047,8,8,12,10,50,51,-1,36
Ards,8047,9,8,6,16,39,54,-15,30
Ballinamalla,8047,10,9,3,18,30,56,-26,30
Portadown,8047,11,5,9,16,29,50,-21,24
Linfield,8048,1,17,8,5,61,26,35,59
Dungannon,8048,2,15,7,8,64,44,20,52
Coleraine,8048,3,14,9,7,42,34,8,51
Crusaders,8048,4,12,9,9,53,45,8,45
Ballymena,8048,5,13,6,11,58,61,-3,45
Cliftonville,8048,6,13,5,12,55,45,10,44
Glenavon,8048,7,10,10,10,52,58,-6,40
Ards,8048,8,10,4,16,35,50,-15,34
Ballinamalla,8048,9,9,5,16,29,49,-20,32
Portadown,8048,10,8,4,18,31,50,-19,28
Glentoran,8048,11,6,9,15,25,43,-18,27
Ballymena,8049,1,16,6,8,62,55,7,54
Crusaders,8049,2,14,7,9,53,40,13,49
Linfield,8049,3,13,9,8,55,40,15,48
Cliftonville,8049,4,14,5,11,48,40,8,47
Coleraine,8049,5,12,9,9,48,42,6,45
Ards,8049,6,13,5,12,49,43,6,44
Dungannon,8049,7,12,6,12,49,44,5,42
Glentoran,8049,8,12,6,12,35,43,-8,42
Glenavon,8049,9,11,8,11,45,47,-2,41
Portadown,8049,10,9,5,16,28,45,-17,32
Ballinamalla,8049,11,4,4,22,26,59,-33,16
Crusaders,8050,1,17,7,6,66,34,32,58
Glenavon,8050,2,14,9,7,52,48,4,51
Cliftonville,8050,3,14,7,9,51,41,10,49
Linfield,8050,4,12,12,6,56,33,23,48
Coleraine,8050,5,12,11,7,42,33,9,47
Ards,8050,6,13,4,13,46,45,1,43
Ballymena,8050,7,11,6,13,54,62,-8,39
Dungannon,8050,8,7,11,12,44,46,-2,32
Glentoran,8050,9,8,7,15,29,44,-15,31
Ballinamalla,8050,10,8,5,17,30,54,-24,29
Portadown,8050,11,6,7,17,28,58,-30,25
Crusaders,8051,1,16,8,6,55,35,20,56
Cliftonville,8051,2,15,8,7,49,41,8,53
Linfield,8051,3,14,9,7,65,36,29,51
Ballymena,8051,4,11,8,11,52,60,-8,41
Glenavon,8051,5,10,10,10,51,49,2,40
Coleraine,8051,6,9,13,8,40,41,-1,40
Dungannon,8051,7,9,11,10,51,46,5,38
Ballinamalla,8051,8,11,5,14,37,44,-7,38
Glentoran,8051,9,9,9,12,30,37,-7,36
Ards,8051,10,7,8,15,32,50,-18,29
Portadown,8051,11,5,9,16,26,49,-23,24
Cliftonville,8052,1,16,6,8,60,42,18,54
Linfield,8052,2,14,9,7,50,31,19,51
Crusaders,8052,3,15,6,9,50,37,13,51
Coleraine,8052,4,12,10,8,48,41,7,46
Ballymena,8052,5,14,4,12,64,61,3,46
Glenavon,8052,6,12,9,9,50,43,7,45
Dungannon,8052,7,10,10,10,50,46,4,40
Ards,8052,8,10,4,16,35,49,-14,34
Portadown,8052,9,10,4,16,31,47,-16,34
Glentoran,8052,10,8,6,16,31,52,-21,30
Ballinamalla,8052,11,9,2,19,28,48,-20,29
Linfield,8053,1,17,8,5,64,32,32,59
Crusaders,8053,2,16,7,7,61,40,21,55
Cliftonville,8053,3,16,4,10,53,34,19,52
Ballymena,8053,4,16,4,10,54,53,1,52
Glenavon,8053,5,13,9,8,49,42,7,48
Coleraine,8053,6,12,10,8,44,35,9,46
Dungannon,8053,7,12,8,10,52,39,13,44
Ards,8053,8,8,6,16,44,52,-8,30
Portadown,8053,9,7,6,17,18,43,-25,27
Glentoran,8053,10,7,5,18,24,55,-31,26
Ballinamalla,8053,11,6,3,21,21,59,-38,21
Crusaders,8054,1,18,8,4,69,37,32,62
Linfield,8054,2,14,12,4,63,32,31,54
Cliftonville,8054,3,15,5,10,54,45,9,50
Ballymena,8054,4,14,6,10,63,66,-3,48
Coleraine,8054,5,12,11,7,41,31,10,47
Dungannon,8054,6,10,11,9,52,45,7,41
Glenavon,8054,7,9,13,8,43,43,0,40
Glentoran,8054,8,7,9,14,32,54,-22,30
Portadown,8054,9,8,5,17,25,49,-24,29
Ards,8054,10,7,4,19,37,55,-18,25
Ballinamalla,8054,11,5,8,17,28,50,-22,23
Crusaders,8055,1,18,6,6,55,34,21,60
Linfield,8055,2,16,8,6,60,28,32,56
Ballymena,8055,3,16,6,8,59,61,-2,54
Cliftonville,8055,4,16,5,9,54,37,17,53
Coleraine,8055,5,11,11,8,40,31,9,44
Glenavon,8055,6,10,10,10,36,38,-2,40
Glentoran,8055,7,11,6,13,34,41,-7,39
Dungannon,8055,8,8,10,12,43,45,-2,34
Ballinamalla,8055,9,8,4,18,26,49,-23,28
Portadown,8055,10,7,6,17,21,42,-21,27
Ards,8055,11,5,6,19,28,50,-22,21
Cliftonville,8056,1,17,4,9,57,38,19,55
Linfield,8056,2,15,9,6,61,35,26,54
Crusaders,8056,3,13,10,7,53,41,12,49
Coleraine,8056,4,11,12,7,40,31,9,45
Glenavon,8056,5,11,10,9,44,42,2,43
Ballymena,8056,6,11,6,13,49,59,-10,39
Dungannon,8056,7,9,9,12,48,43,5,36
Glentoran,8056,8,9,9,12,31,41,-10,36
Portadown,8056,9,9,6,15,24,41,-17,33
Ards,8056,10,9,5,16,37,53,-16,32
Ballinamalla,8056,11,9,4,17,33,53,-20,31
Crusaders,8057,1,20,6,4,65,31,34,66
Coleraine,8057,2,14,11,5,43,30,13,53
Linfield,8057,3,14,10,6,55,31,24,52
Cliftonville,8057,4,15,6,9,59,45,14,51
Ballymena,8057,5,13,9,8,54,54,0,48
Glenavon,8057,6,9,13,8,46,44,2,40
Dungannon,8057,7,8,10,12,54,50,4,34
Glentoran,8057,8,9,5,16,29,52,-23,32
Ballinamalla,8057,9,7,6,17,33,56,-23,27
Ards,8057,10,6,6,18,34,58,-24,24
Portadown,8057,11,5,8,17,28,49,-21,23
Glenavon,8058,1,16,9,5,56,39,17,57
Cliftonville,8058,2,15,9,6,61,42,19,54
Coleraine,8058,3,15,9,6,52,40,12,54
Crusaders,8058,4,15,7,8,66,43,23,52
Linfield,8058,5,13,7,10,53,37,16,46
Portadown,8058,6,10,7,13,28,41,-13,37
Ballymena,8058,7,10,6,14,46,64,-18,36
Ards,8058,8,10,4,16,45,51,-6,34
Glentoran,8058,9,8,7,15,31,54,-23,31
Dungannon,8058,10,6,10,14,43,49,-6,28
Ballinamalla,8058,11,8,3,19,31,52,-21,27
Crusaders,8059,1,18,6,6,49,27,22,60
Ballymena,8059,2,17,6,7,62,50,12,57
Linfield,8059,3,14,10,6,59,30,29,52
Cliftonville,8059,4,14,7,9,47,35,12,49
Glenavon,8059,5,11,12,7,52,47,5,45
Dungannon,8059,6,10,10,10,45,40,5,40
Coleraine,8059,7,9,8,13,43,49,-6,35
Ards,8059,8,8,9,13,35,46,-11,33
Portadown,8059,9,9,5,16,29,52,-23,32
Ballinamalla,8059,10,8,6,16,30,47,-17,30
Glentoran,8059,11,4,7,19,20,48,-28,19
Crusaders,8060,1,15,12,3,54,30,24,57
Linfield,8060,2,15,10,5,63,35,28,55
Cliftonville,8060,3,15,6,9,54,38,16,51
Ballymena,8060,4,13,5,12,53,66,-13,44
Glenavon,8060,5,10,12,8,48,42,6,42
Dungannon,8060,6,10,11,9,51,41,10,41
Glentoran,8060,7,10,7,13,29,43,-14,37
Coleraine,8060,8,8,9,13,40,49,-9,33
Ards,8060,9,8,7,15,43,52,-9,31
Portadown,8060,10,9,4,17,35,49,-14,31
Ballinamalla,8060,11,7,7,16,30,55,-25,28
Crusaders,8061,1,15,8,7,47,29,18,53
Cliftonville,8061,2,16,4,10,55,41,14,52
Linfield,8061,3,14,8,8,57,37,20,50
Ballymena,8061,4,15,5,10,60,59,1,50
Glenavon,8061,5,13,9,8,51,49,2,48
Dungannon,8061,6,10,11,9,55,42,13,41
Coleraine,8061,7,10,10,10,42,42,0,40
Glentoran,8061,8,11,5,14,38,52,-14,38
Ards,8061,9,10,4,16,41,50,-9,34
Ballinamalla,8061,10,10,4,16,31,44,-13,34
Portadown,8061,11,5,4,21,24,56,-32,19
Linfield,8062,1,16,10,4,62,27,35,58
Glenavon,8062,2,15,10,5,52,38,14,55
Cliftonville,8062,3,16,4,10,55,38,17,52
Ballymena,8062,4,15,7,8,61,53,8,52
Crusaders,8062,5,14,8,8,54,37,17,50
Coleraine,8062,6,11,11,8,48,38,10,44
Dungannon,8062,7,9,7,14,48,50,-2,34
Ards,8062,8,8,7,15,35,49,-14,31
Glentoran,8062,9,7,7,16,29,56,-27,28
Portadown,8062,10,6,7,17,21,48,-27,25
Ballinamalla,8062,11,6,6,18,23,54,-31,24
Linfield,8063,1,15,11,4,62,32,30,56
Crusaders,8063,2,16,7,7,60,42,18,55
Cliftonville,8063,3,15,3,12,55,49,6,48
Ballymena,8063,4,13,7,10,56,57,-1,46
Glenavon,8063,5,10,11,9,45,48,-3,41
Dungannon,8063,6,10,9,11,47,46,1,39
Portadown,8063,7,11,5,14,28,42,-14,38
Glentoran,8063,8,9,9,12,38,42,-4,36
Coleraine,8063,9,8,9,13,34,42,-8,33
Ards,8063,10,9,5,16,38,49,-11,32
Ballinamalla,8063,11,8,6,16,37,51,-14,30
Crusaders,8064,1,18,7,5,58,33,25,61
Linfield,8064,2,15,10,5,56,28,28,55
Ballymena,8064,3,15,6,9,67,64,3,51
Cliftonville,8064,4,13,8,9,55,43,12,47
Coleraine,8064,5,9,14,7,42,35,7,41
Glenavon,8064,6,10,10,10,50,54,-4,40
Ards,8064,7,11,6,13,40,45,-5,39
Glentoran,8064,8,10,7,13,36,48,-12,37
Dungannon,8064,9,7,9,14,42,53,-11,30
Ballinamalla,8064,10,6,7,17,36,58,-22,25
Portadown,8064,11,5,8,17,32,53,-21,23
Crusaders,8065,1,17,7,6,61,40,21,58
Linfield,8065,2,16,8,6,68,35,33,56
Ballymena,8065,3,15,5,10,57,55,2,50
Glenavon,8065,4,12,10,8,48,35,13,46
Cliftonville,8065,5,13,7,10,60,50,10,46
Glentoran,8065,6,12,5,13,32,42,-10,41
Dungannon,8065,7,10,9,11,45,42,3,39
Coleraine,8065,8,9,9,12,37,42,-5,36
Ballinamalla,8065,9,11,2,17,30,51,-21,35
Ards,8065,10,7,5,18,28,52,-24,26
Portadown,8065,11,6,7,17,25,47,-22,25
Crusaders,8066,1,17,8,5,58,35,23,59
Linfield,8066,2,15,8,7,58,35,23,53
Glenavon,8066,3,14,10,6,49,34,15,52
Ballymena,8066,4,16,4,10,60,61,-1,52
Cliftonville,8066,5,15,3,12,49,41,8,48
Coleraine,8066,6,11,10,9,43,46,-3,43
Dungannon,8066,7,9,11,10,52,43,9,38
Ards,8066,8,9,3,18,40,55,-15,30
Glentoran,8066,9,7,8,15,33,51,-18,29
Ballinamalla,8066,10,8,4,18,27,46,-19,28
Portadown,8066,11,7,5,18,24,46,-22,26
Crusaders,8067,1,17,5,8,53,39,14,56
Linfield,8067,2,15,9,6,59,30,29,54
Cliftonville,8067,3,15,6,9,55,40,15,51
Ballymena,8067,4,14,6,10,56,58,-2,48
Dungannon,8067,5,12,9,9,56,43,13,45
Coleraine,8067,6,10,12,8,46,41,5,42
Glenavon,8067,7,10,12,8,39,41,-2,42
Glentoran,8067,8,10,8,12,31,39,-8,38
Ards,8067,9,7,6,17,37,53,-16,27
Ballinamalla,8067,10,7,6,17,26,48,-22,27
Portadown,8067,11,6,5,19,25,51,-26,23
Linfield,8068,1,18,8,4,66,29,37,62
Crusaders,8068,2,16,8,6,52,32,20,56
Cliftonville,8068,3,17,2,11,60,36,24,53
Ballymena,8068,4,15,8,7,61,54,7,53
Glenavon,8068,5,11,11,8,43,43,0,44
Coleraine,8068,6,10,12,8,39,37,2,42
Dungannon,8068,7,8,10,12,49,47,2,34
Glentoran,8068,8,7,9,14,31,54,-23,30
Ards,8068,9,7,7,16,38,57,-19,28
Portadown,8068,10,7,6,17,21,45,-24,27
Ballinamalla,8068,11,5,7,18,29,55,-26,22
Crusaders,8069,1,16,9,5,56,35,21,57
Coleraine,8069,2,15,9,6,44,31,13,54
Linfield,8069,3,14,8,8,57,39,18,50
Cliftonville,8069,4,13,9,8,55,39,16,48
Ballymena,8069,5,12,6,12,51,60,-9,42
Dungannon,8069,6,11,8,11,51,50,1,41
Glenavon,8069,7,9,11,10,49,51,-2,38
Ards,8069,8,11,4,15,43,46,-3,37
Ballinamalla,8069,9,9,5,16,32,51,-19,32
Portadown,8069,10,9,4,17,26,46,-20,31
Glentoran,8069,11,6,7,17,28,44,-16,25
Ballymena,8070,1,15,7,8,60,52,8,52
Crusaders,8070,2,14,9,7,52,38,14,51
Cliftonville,8070,3,15,5,10,49,34,15,50
Dungannon,8070,4,13,10,7,55,38,17,49
Linfield,8070,5,12,8,10,49,33,16,44
Coleraine,8070,6,9,16,5,44,37,7,43
Ards,8070,7,12,7,11,43,40,3,43
Glenavon,8070,8,9,11,10,40,45,-5,38
Glentoran,8070,9,8,8,14,22,42,-20,32
Ballinamalla,8070,10,8,2,20,37,61,-24,26
Portadown,8070,11,6,5,19,22,53,-31,23
Cliftonville,8071,1,16,6,8,54,38,16,54
Linfield,8071,2,14,11,5,56,30,26,53
Glenavon,8071,3,14,9,7,54,39,15,51
Crusaders,8071,4,14,8,8,56,38,18,50
Ballymena,8071,5,14,6,10,63,58,5,48
Coleraine,8071,6,10,11,9,43,40,3,41
Dungannon,8071,7,11,8,11,48,47,1,41
Ards,8071,8,9,7,14,41,49,-8,34
Ballinamalla,8071,9,9,6,15,35,55,-20,33
Portadown,8071,10,7,6,17,29,56,-27,27
Glentoran,8071,11,5,6,19,23,52,-29,21
Linfield,8072,1,15,8,7,59,29,30,53
Cliftonville,8072,2,15,8,7,57,37,20,53
Crusaders,8072,3,16,4,10,62,44,18,52
Ballymena,8072,4,14,7,9,62,66,-4,49
Coleraine,8072,5,12,11,7,47,38,9,47
Dungannon,8072,6,10,10,10,48,43,5,40
Glenavon,8072,7,9,11,10,42,46,-4,38
Glentoran,8072,8,8,12,10,29,38,-9,36
Ballinamalla,8072,9,9,6,15,27,48,-21,33
Ards,8072,10,8,4,18,32,53,-21,28
Portadown,8072,11,6,5,19,28,51,-23,23
Crusaders,8073,1,16,8,6,58,40,18,56
Cliftonville,8073,2,17,5,8,57,39,18,56
Ballymena,8073,3,16,7,7,62,53,9,55
Linfield,8073,4,15,9,6,58,33,25,54
Glenavon,8073,5,11,9,10,44,46,-2,42
Coleraine,8073,6,10,10,10,42,38,4,40
Dungannon,8073,7,10,8,12,63,54,9,38
Glentoran,8073,8,10,6,14,35,43,-8,36
Ards,8073,9,8,7,15,38,51,-13,31
Portadown,8073,10,8,5,17,28,49,-21,29
Ballinamalla,8073,11,5,4,21,25,64,-39,19
Cliftonville,8074,1,18,4,8,60,33,27,58
Linfield,8074,2,16,7,7,63,30,33,55
Crusaders,8074,3,15,9,6,51,34,17,54
Coleraine,8074,4,14,9,7,44,33,11,51
Glenavon,8074,5,11,11,8,47,47,0,44
Ballymena,8074,6,12,6,12,56,64,-8,42
Dungannon,8074,7,10,9,11,49,43,6,39
Glentoran,8074,8,9,11,10,37,46,-9,38
Ballinamalla,8074,9,8,5,17,31,52,-21,29
Ards,8074,10,6,5,19,29,55,-26,23
Portadown,8074,11,5,6,19,22,52,-30,21
Crusaders,8075,1,17,9,4,58,31,27,60
Linfield,8075,2,16,9,5,59,29,30,57
Ballymena,8075,3,14,7,9,61,56,5,49
Cliftonville,8075,4,14,6,10,53,41,12,48
Dungannon,8075,5,12,10,8,51,39,12,46
Glenavon,8075,6,12,8,10,48,44,4,44
Coleraine,8075,7,10,10,10,38,41,-3,40
Glentoran,8075,8,11,4,15,34,44,-10,37
Ballinamalla,8075,9,8,5,17,30,53,-23,29
Ards,8075,10,7,6,17,32,49,-17,27
Portadown,8075,11,4,6,20,17,54,-37,18
Cliftonville,8076,1,18,4,8,57,35,22,58
Crusaders,8076,2,17,5,8,60,37,23,56
Ballymena,8076,3,14,9,7,55,53,2,51
Coleraine,8076,4,13,10,7,47,33,14,49
Linfield,8076,5,11,15,4,54,31,23,48
Glenavon,8076,6,9,9,12,42,52,-10,36
Dungannon,8076,7,8,11,11,51,48,3,35
Glentoran,8076,8,8,10,12,32,47,-15,34
Ards,8076,9,9,6,15,34,44,-10,33
Ballinamalla,8076,10,8,5,17,31,54,-23,29
Portadown,8076,11,5,6,19,22,51,-29,21
Crusaders,8077,1,19,7,4,56,30,26,64
Linfield,8077,2,15,8,7,60,33,27,53
Ballymena,8077,3,13,8,9,57,58,-1,47
Cliftonville,8077,4,12,9,9,49,39,10,45
Coleraine,8077,5,12,9,9,42,36,6,45
Glenavon,8077,6,9,13,8,46,50,-4,40
Ards,8077,7,12,4,14,38,45,-7,40
Dungannon,8077,8,8,9,13,45,45,0,33
Glentoran,8077,9,7,9,14,29,43,-14,30
Portadown,8077,10,7,7,16,27,46,-19,28
Ballinamalla,8077,11,6,7,17,31,55,-24,25
Ballymena,8078,1,15,8,7,60,52,8,53
Cliftonville,8078,2,16,4,10,59,44,15,52
Coleraine,8078,3,13,12,5,47,31,16,51
Linfield,8078,4,12,12,6,55,34,21,48
Crusaders,8078,5,13,7,10,48,41,7,46
Glenavon,8078,6,11,10,9,47,47,0,43
Dungannon,8078,7,10,8,12,53,49,4,38
Ards,8078,8,8,9,13,38,45,-7,33
Glentoran,8078,9,9,6,15,28,44,-16,33
Ballinamalla,8078,10,9,2,19,32,58,-26,29
Portadown,8078,11,6,8,16,23,45,-22,26
Glenavon,8079,1,16,10,4,60,35,25,58
Linfield,8079,2,14,9,7,63,34,29,51
Crusaders,8079,3,14,8,8,50,38,12,50
Ballymena,8079,4,15,5,10,55,53,2,50
Cliftonville,8079,5,13,5,12,53,45,8,44
Coleraine,8079,6,10,9,11,44,46,-2,39
Dungannon,8079,7,8,12,10,48,47,1,36
Ards,8079,8,9,7,14,38,47,-9,34
Glentoran,8079,9,9,6,15,29,49,-20,33
Portadown,8079,10,9,6,15,25,49,-24,33
Ballinamalla,8079,11,6,7,17,32,54,-22,25
Crusaders,8080,1,18,5,7,59,29,30,59
Cliftonville,8080,2,16,5,9,51,36,15,53
Coleraine,8080,3,13,10,7,48,39,9,49
Linfield,8080,4,13,9,8,58,39,19,48
Ballymena,8080,5,14,6,10,58,59,-1,48
Dungannon,8080,6,10,10,10,49,46,3,40
Glenavon,8080,7,9,10,11,44,44,0,37
Ards,8080,8,9,7,14,38,49,-11,34
Glentoran,8080,9,9,6,15,32,50,-18,33
Ballinamalla,8080,10,8,6,16,27,48,-21,30
Portadown,8080,11,6,6,18,18,43,-25,24
Crusaders,8081,1,16,6,8,60,40,20,54
Linfield,8081,2,14,11,5,64,33,31,53
Ballymena,8081,3,14,8,8,55,53,2,50
Glenavon,8081,4,12,11,7,48,44,4,47
Cliftonville,8081,5,13,7,10,50,44,6,46
Dungannon,8081,6,10,11,9,50,37,13,41
Coleraine,8081,7,11,7,12,43,41,2,40
Glentoran,8081,8,9,9,12,30,42,-12,36
Ballinamalla,8081,9,8,7,15,32,52,-20,31
Ards,8081,10,7,6,17,36,55,-19,27
Portadown,8081,11,6,7,17,24,51,-27,25
Crusaders,8082,1,18,10,2,60,31,29,64
Cliftonville,8082,2,16,7,7,55,39,16,55
Ballymena,8082,3,15,4,11,59,58,1,49
Dungannon,8082,4,12,10,8,57,39,18,46
Coleraine,8082,5,12,10,8,39,36,3,46
Linfield,8082,6,11,10,9,51,34,17,43
Glentoran,8082,7,12,6,12,37,43,-6,42
Glenavon,8082,8,6,13,11,39,48,-9,31
Portadown,8082,9,8,6,16,28,47,-19,30
Ards,8082,10,7,3,20,35,57,-22,24
Ballinamalla,8082,11,6,5,19,29,57,-28,23
Crusaders,8083,1,18,6,6,55,32,23,60
Ballymena,8083,2,16,4,10,62,57,5,52
Coleraine,8083,3,14,9,7,49,35,14,51
Cliftonville,8083,4,15,4,11,47,45,2,49
Linfield,8083,5,13,9,8,60,36,24,48
Dungannon,8083,6,13,8,9,58,42,16,47
Glenavon,8083,7,9,11,10,50,54,-4,38
Glentoran,8083,8,7,10,13,26,42,-16,31
Ballinamalla,8083,9,8,6,16,30,55,-25,30
Ards,8083,10,7,5,18,33,48,-15,26
Portadown,8083,11,5,8,17,23,47,-24,23
Crusaders,8084,1,19,6,5,64,37,27,63
Linfield,8084,2,17,8,5,69,26,43,59
Glenavon,8084,3,14,10,6,49,38,11,52
Cliftonville,8084,4,15,5,10,51,42,9,50
Ballymena,8084,5,13,7,10,54,57,-3,46
Coleraine,8084,6,10,10,10,46,44,2,40
Dungannon,8084,7,8,11,11,48,45,3,35
Glentoran,8084,8,8,5,17,31,57,-26,29
Ards,8084,9,7,7,16,34,50,-16,28
Ballinamalla,8084,10,7,6,17,28,53,-25,27
Portadown,8084,11,6,7,17,22,47,-25,25
Crusaders,8085,1,16,6,8,61,38,23,54
Linfield,8085,2,14,9,7,55,37,18,51
Glenavon,8085,3,12,12,6,51,44,7,48
Cliftonville,8085,4,12,8,10,50,42,8,44
Coleraine,8085,5,11,10,9,41,36,5,43
Ards,8085,6,13,4,13,38,44,-6,43
Dungannon,8085,7,11,9,10,53,46,7,42
Ballymena,8085,8,12,6,12,60,63,-3,42
Portadown,8085,9,11,5,14,38,44,-6,38
Glentoran,8085,10,5,9,16,28,54,-26,24
Ballinamalla,8085,11,6,6,18,24,51,-27,24
Crusaders,8086,1,18,8,4,67,29,38,62
Linfield,8086,2,16,9,5,59,30,29,57
Coleraine,8086,3,13,11,6,50,35,15,50
Ballymena,8086,4,15,5,10,61,60,1,50
Cliftonville,8086,5,13,4,13,47,45,2,43
Glenavon,8086,6,10,11,9,47,46,1,41
Dungannon,8086,7,11,7,12,50,54,-4,40
Ards,8086,8,10,4,16,35,47,-12,34
Glentoran,8086,9,8,8,14,32,50,-18,32
Portadown,8086,10,8,4,18,32,52,-20,28
Ballinamalla,8086,11,6,3,21,26,58,-32,21
Crusaders,8087,1,17,8,5,56,29,27,59
Linfield,8087,2,16,8,6,61,32,29,56
Cliftonville,8087,3,16,5,9,53,40,13,53
Dungannon,8087,4,12,7,11,48,38,10,43
Coleraine,8087,5,11,10,9,40,42,-2,43
Glenavon,8087,6,10,12,8,44,44,0,42
Ballymena,8087,7,12,4,14,52,63,-11,40
Ards,8087,8,10,7,13,37,44,-7,37
Ballinamalla,8087,9,9,6,15,31,45,-14,33
Portadown,8087,10,7,5,18,23,45,-22,26
Glentoran,8087,11,7,4,19,27,50,-23,25
Cliftonville,8088,1,18,5,7,54,33,21,59
Crusaders,8088,2,16,7,7,52,31,21,55
Linfield,8088,3,15,7,8,53,39,14,52
Coleraine,8088,4,14,9,7,50,35,15,51
Glenavon,8088,5,11,12,7,46,41,5,45
Ballymena,8088,6,13,4,13,54,60,-6,43
Dungannon,8088,7,11,7,12,51,46,5,40
Portadown,8088,8,8,8,14,22,37,-15,32
Glentoran,8088,9,8,5,17,26,47,-21,29
Ballinamalla,8088,10,7,6,17,30,51,-21,27
Ards,8088,11,7,4,19,35,53,-18,25
Glenavon,8089,1,14,9,7,46,40,6,51
Linfield,8089,2,14,8,8,58,31,27,50
Cliftonville,8089,3,15,5,10,56,42,14,50
Dungannon,8089,4,13,8,9,53,39,14,47
Crusaders,8089,5,12,10,8,47,37,10,46
Ballymena,8089,6,13,7,10,55,63,-8,46
Coleraine,8089,7,11,10,9,49,42,7,43
Glentoran,8089,8,9,9,12,28,37,-9,36
Ballinamalla,8089,9,9,5,16,34,50,-16,32
Ards,8089,10,7,9,14,41,55,-14,30
Portadown,8089,11,5,6,19,24,55,-31,21
Crusaders,8090,1,17,8,5,52,26,26,59
Cliftonville,8090,2,15,4,11,64,46,18,49
Ballymena,8090,3,14,7,9,54,52,2,49
Linfield,8090,4,13,9,8,56,33,23,48
Coleraine,8090,5,12,9,9,42,41,1,45
Dungannon,8090,6,9,11,10,48,49,-1,38
Glenavon,8090,7,8,11,11,50,52,-2,35
Ards,8090,8,9,7,14,42,50,-8,34
Glentoran,8090,9,8,9,13,31,50,-19,33
Portadown,8090,10,9,5,16,25,47,-22,32
Ballinamalla,8090,11,9,4,17,36,54,-18,31
Crusaders,8091,1,17,5,8,57,36,21,56
Ballymena,8091,2,15,6,9,62,56,6,51
Cliftonville,8091,3,15,5,10,56,43,13,50
Glenavon,8091,4,12,10,8,54,49,5,46
Dungannon,8091,5,11,10,9,55,48,7,43
Ards,8091,6,13,4,13,49,45,4,43
Coleraine,8091,7,11,10,9,45,42,3,43
Linfield,8091,8,10,9,11,45,40,5,39
Ballinamalla,8091,9,10,3,17,38,55,-17,33
Glentoran,8091,10,7,7,16,27,48,-21,28
Portadown,8091,11,7,5,18,23,49,-26,26
Crusaders,8092,1,16,6,8,54,38,16,54
Coleraine,8092,2,15,9,6,44,28,16,54
Ballymena,8092,3,15,8,7,54,46,8,53
Linfield,8092,4,15,6,9,57,34,23,51
Cliftonville,8092,5,15,4,11,54,40,14,49
Glenavon,8092,6,13,9,8,52,52,0,48
Dungannon,8092,7,10,10,10,44,36,8,40
Glentoran,8092,8,8,10,12,30,40,-10,34
Ards,8092,9,8,5,17,37,57,-20,29
Portadown,8092,10,6,5,19,24,51,-27,23
Ballinamalla,8092,11,6,4,20,27,55,-28,22
Crusaders,8093,1,17,8,5,50,24,26,59
Ballymena,8093,2,16,5,9,59,57,2,53
Linfield,8093,3,14,9,7,56,29,27,51
Cliftonville,8093,4,14,8,8,53,33,20,50
Glenavon,8093,5,11,11,8,50,44,6,44
Coleraine,8093,6,10,10,10,41,41,0,40
Ards,8093,7,11,2,17,32,47,-15,35
Dungannon,8093,8,8,9,13,46,46,0,33
Portadown,8093,9,10,3,17,28,50,-22,33
Glentoran,8093,10,8,8,14,28,42,-14,32
Ballinamalla,8093,11,7,5,18,28,58,-30,26
Crusaders,8094,1,17,5,8,64,40,24,56
Cliftonville,8094,2,15,5,10,51,44,7,50
Linfield,8094,3,12,11,7,61,32,29,47
Coleraine,8094,4,13,8,9,42,38,4,47
Ballymena,8094,5,13,7,10,55,54,1,46
Glenavon,8094,6,11,11,8,48,46,2,44
Ballinamalla,8094,7,13,2,15,41,54,-13,41
Dungannon,8094,8,10,7,13,47,44,3,37
Glentoran,8094,9,7,11,12,28,45,-17,32
Ards,8094,10,8,5,17,34,51,-17,29
Portadown,8094,11,6,8,16,20,43,-23,26
Crusaders,8095,1,18,8,4,60,29,31,62
Cliftonville,8095,2,17,5,8,55,39,16,56
Coleraine,8095,3,13,10,7,50,38,12,49
Linfield,8095,4,13,9,8,50,33,17,48
Glenavon,8095,5,11,11,8,50,46,4,44
Ballymena,8095,6,13,4,13,54,55,-1,43
Glentoran,8095,7,11,6,13,37,47,-10,39
Dungannon,8095,8,7,9,14,44,49,-5,30
Ards,8095,9,8,5,17,32,53,-21,29
Ballinamalla,8095,10,8,4,18,37,58,-21,28
Portadown,8095,11,7,7,16,32,54,-22,28
Linfield,8096,1,17,7,6,63,26,37,58
Crusaders,8096,2,15,8,7,57,42,15,53
Cliftonville,8096,3,13,9,8,49,36,13,48
Dungannon,8096,4,13,7,10,52,42,10,46
Glenavon,8096,5,12,10,8,46,40,6,46
Ballymena,8096,6,13,6,11,56,61,-5,45
Ards,8096,7,12,4,14,38,42,-4,40
Coleraine,8096,8,9,11,10,37,43,-6,38
Portadown,8096,9,9,4,17,30,43,-13,31
Glentoran,8096,10,7,8,15,27,43,-16,29
Ballinamalla,8096,11,6,4,20,29,66,-37,22
Crusaders,8097,1,16,8,6,57,38,19,56
Linfield,8097,2,14,8,8,55,31,24,50
Cliftonville,8097,3,13,7,10,50,38,12,46
Glenavon,8097,4,12,10,8,49,46,3,46
Ballymena,8097,5,13,7,10,52,52,0,46
Dungannon,8097,6,10,11,9,49,41,8,41
Coleraine,8097,7,9,10,11,34,37,-3,37
Ards,8097,8,11,4,15,36,45,-9,37
Glentoran,8097,9,9,7,14,30,44,-14,34
Ballinamalla,8097,10,10,2,18,32,51,-19,32
Portadown,8097,11,8,6,16,26,47,-21,30
Crusaders,8098,1,17,9,4,55,33,22,60
Coleraine,8098,2,14,9,7,44,36,8,51
Ballymena,8098,3,14,9,7,63,57,6,51
Linfield,8098,4,13,11,6,57,32,25,50
Glenavon,8098,5,12,12,6,53,42,11,48
Cliftonville,8098,6,15,3,12,53,43,10,48
Dungannon,8098,7,11,8,11,56,52,4,41
Glentoran,8098,8,9,6,15,28,45,-17,33
Ards,8098,9,7,6,17,39,54,-15,27
Ballinamalla,8098,10,7,3,20,33,58,-25,24
Portadown,8098,11,5,6,19,18,47,-29,21
Linfield,8099,1,16,10,4,61,29,32,58
Crusaders,8099,2,15,9,6,56,39,17,54
Cliftonville,8099,3,16,5,9,53,35,18,53
Dungannon,8099,4,14,7,9,51,47,4,49
Coleraine,8099,5,12,11,7,45,39,6,47
Ballymena,8099,6,13,5,12,50,55,-5,44
Ballinamalla,8099,7,11,5,14,34,43,-9,38
Glenavon,8099,8,8,12,10,46,46,0,36
Glentoran,8099,9,8,6,16,32,43,-11,30
Ards,8099,10,7,5,18,37,60,-23,26
Portadown,8099,11,4,7,19,23,52,-29,19
Crusaders,8100,1,17,6,7,58,35,23,57
Glenavon,8100,2,13,11,6,45,37,8,50
Cliftonville,8100,3,14,6,10,56,41,15,48
Coleraine,8100,4,12,12,6,46,34,12,48
Linfield,8100,5,13,8,9,57,35,22,47
Ballymena,8100,6,11,8,11,54,65,-11,41
Dungannon,8100,7,9,10,11,48,46,2,37
Glentoran,8100,8,9,8,13,26,44,-18,35
Ards,8100,9,9,7,14,32,43,-11,34
Portadown,8100,10,9,4,17,25,43,-18,31
Ballinamalla,8100,11,7,4,19,24,48,-24,25
Cliftonville,8101,1,19,5,6,62,35,27,62
Linfield,8101,2,17,10,3,62,27,35,61
Crusaders,8101,3,16,7,7,54,39,15,55
Coleraine,8101,4,13,9,8,50,33,17,48
Dungannon,8101,5,12,9,9,49,38,11,45
Ballymena,8101,6,11,5,14,48,60,-12,38
Glenavon,8101,7,9,10,11,43,47,-4,37
Glentoran,8101,8,7,10,13,30,43,-13,31
Portadown,8101,9,9,4,17,27,48,-21,31
Ballinamalla,8101,10,8,3,19,28,55,-27,27
Ards,8101,11,6,4,20,28,56,-28,22
Glenavon,8102,1,16,10,4,49,35,14,58
Linfield,8102,2,14,11,5,58,29,29,53
Cliftonville,8102,3,16,4,10,55,43,12,52
Crusaders,8102,4,12,11,7,46,36,10,47
Coleraine,8102,5,11,9,10,41,38,3,42
Ballymena,8102,6,11,9,10,53,54,-1,42
Dungannon,8102,7,10,10,10,52,40,12,40
Glentoran,8102,8,9,6,15,29,43,-14,33
Ards,8102,9,8,6,16,43,54,-11,30
Portadown,8102,10,5,12,13,23,42,-19,27
Ballinamalla,8102,11,7,4,19,26,61,-35,25
Crusaders,8103,1,18,6,6,56,30,26,60
Linfield,8103,2,13,11,6,55,28,27,50
Coleraine,8103,3,13,9,8,47,40,7,48
Glenavon,8103,4,13,9,8,49,43,6,48
Ballymena,8103,5,12,9,9,51,51,0,45
Dungannon,8103,6,9,12,9,50,45,5,39
Cliftonville,8103,7,11,6,13,44,48,-4,39
Glentoran,8103,8,8,9,13,31,52,-21,33
Ards,8103,9,8,7,15,38,48,-10,31
Ballinamalla,8103,10,8,5,17,36,52,-16,29
Portadown,8103,11,7,7,16,24,44,-20,28
Crusaders,8104,1,16,9,5,61,35,26,57
Linfield,8104,2,15,9,6,55,32,23,54
Ballymena,8104,3,15,6,9,64,57,7,51
Cliftonville,8104,4,13,5,12,45,46,-1,44
Dungannon,8104,5,11,10,9,60,45,15,43
Coleraine,8104,6,10,13,7,48,42,6,43
Glenavon,8104,7,10,10,10,43,43,0,40
Ards,8104,8,10,4,16,39,51,-12,34
Glentoran,8104,9,8,8,14,24,44,-20,32
Ballinamalla,8104,10,8,7,15,29,45,-16,31
Portadown,8104,11,6,5,19,23,51,-28,23
Linfield,8105,1,16,9,5,57,28,29,57
Cliftonville,8105,2,17,4,9,57,32,25,55
Crusaders,8105,3,15,7,8,48,35,13,52
Ballymena,8105,4,15,7,8,52,53,-1,52
Glenavon,8105,5,12,12,6,48,39,9,48
Coleraine,8105,6,9,11,10,36,39,-3,38
Dungannon,8105,7,9,10,11,43,41,2,37
Ballinamalla,8105,8,11,4,15,31,44,-13,37
Ards,8105,9,8,9,13,35,45,-10,33
Glentoran,8105,10,7,6,17,28,45,-17,27
Portadown,8105,11,4,5,21,17,51,-34,17
Cliftonville,8106,1,19,4,7,64,34,30,61
Coleraine,8106,2,14,9,7,45,36,9,51
Glenavon,8106,3,13,10,7,53,48,5,49
Crusaders,8106,4,14,6,10,53,42,11,48
Linfield,8106,5,11,14,5,56,34,22,47
Ballymena,8106,6,14,4,12,63,62,1,46
Glentoran,8106,7,11,9,10,37,41,-4,42
Ards,8106,8,8,7,15,36,48,-12,31
Dungannon,8106,9,7,8,15,43,52,-9,29
Ballinamalla,8106,10,7,7,16,23,44,-21,28
Portadown,8106,11,6,4,20,26,58,-32,22
Cliftonville,8107,1,16,7,7,56,34,22,55
Crusaders,8107,2,15,10,5,48,30,18,55
Coleraine,8107,3,12,12,6,45,36,9,48
Glenavon,8107,4,12,12,6,51,43,8,48
Linfield,8107,5,12,10,8,55,31,24,46
Ballymena,8107,6,12,10,8,59,56,3,46
Ballinamalla,8107,7,10,3,17,30,52,-22,33
Dungannon,8107,8,7,11,12,47,47,0,32
Glentoran,8107,9,8,8,14,27,45,-18,32
Ards,8107,10,7,6,17,34,54,-20,27
Portadown,8107,11,7,5,18,25,49,-24,26
Crusaders,8108,1,16,10,4,58,33,25,58
Ballymena,8108,2,18,4,8,74,54,20,58
Linfield,8108,3,14,13,3,53,25,28,55
Glenavon,8108,4,12,12,6,46,42,4,48
Coleraine,8108,5,11,10,9,47,42,5,43
Dungannon,8108,6,9,9,12,46,49,-3,36
Cliftonville,8108,7,9,9,12,43,48,-5,36
Glentoran,8108,8,8,7,15,30,45,-15,31
Portadown,8108,9,7,9,14,28,45,-17,30
Ballinamalla,8108,10,9,2,19,28,51,-23,29
Ards,8108,11,7,5,18,39,58,-19,26
Crusaders,8109,1,16,10,4,56,30,26,58
Cliftonville,8109,2,15,7,8,53,40,13,52
Ballymena,8109,3,15,4,11,56,51,5,49
Linfield,8109,4,10,12,8,47,34,13,42
Glenavon,8109,5,10,11,9,55,48,7,41
Glentoran,8109,6,11,8,11,28,33,-5,41
Coleraine,8109,7,9,10,11,34,41,-7,37
Dungannon,8109,8,7,13,10,48,50,-2,34
Ards,8109,9,8,9,13,37,47,-10,33
Ballinamalla,8109,10,9,6,15,31,50,-19,33
Portadown,8109,11,6,8,16,19,40,-21,26
Crusaders,8110,1,16,8,6,53,32,21,56
Coleraine,8110,2,16,8,6,51,37,14,56
Linfield,8110,3,13,13,4,57,29,28,52
Cliftonville,8110,4,16,3,11,55,43,12,51
Ballymena,8110,5,13,4,13,50,61,-11,43
Dungannon,8110,6,10,12,8,58,43,15,42
Glenavon,8110,7,9,12,9,45,49,-4,39
Ards,8110,8,9,5,16,36,52,-16,32
Ballinamalla,8110,9,7,7,16,30,48,-18,28
Portadown,8110,10,7,6,17,26,47,-21,27
Glentoran,8110,11,5,10,15,23,43,-20,25
Linfield,8111,1,18,9,3,63,25,38,63
Crusaders,8111,2,15,10,5,54,33,21,55
Cliftonville,8111,3,14,6,10,59,45,14,48
Ballymena,8111,4,13,6,11,50,59,-9,45
Glenavon,8111,5,11,9,10,54,58,-4,42
Dungannon,8111,6,10,10,10,50,44,6,40
Coleraine,8111,7,10,8,12,39,42,-3,38
Glentoran,8111,8,8,11,11,31,43,-12,35
Portadown,8111,9,8,7,15,30,49,-19,31
Ards,8111,10,8,4,18,41,53,-12,28
Ballinamalla,8111,11,8,4,18,27,47,-20,28
Crusaders,8112,1,18,9,3,61,34,27,63
Linfield,8112,2,13,14,3,52,26,26,53
Ballymena,8112,3,13,7,10,50,56,-6,46
Cliftonville,8112,4,12,6,12,47,39,8,42
Coleraine,8112,5,10,10,10,38,38,0,40
Glenavon,8112,6,9,12,9,45,45,0,39
Glentoran,8112,7,10,9,11,31,36,-5,39
Dungannon,8112,8,10,8,12,49,43,6,38
Ards,8112,9,11,4,15,43,46,-3,37
Portadown,8112,10,7,6,17,22,49,-27,27
Ballinamalla,8112,11,7,5,18,27,53,-26,26
Cliftonville,8113,1,16,6,8,51,37,14,54
Crusaders,8113,2,15,8,7,54,34,20,53
Linfield,8113,3,14,9,7,55,29,26,51
Ballymena,8113,4,12,8,10,49,55,-6,44
Glenavon,8113,5,11,9,10,44,40,4,42
Ards,8113,6,12,4,14,35,47,-12,40
Dungannon,8113,7,9,11,10,50,43,7,38
Ballinamalla,8113,8,11,3,16,40,46,-6,36
Glentoran,8113,9,9,8,13,28,46,-18,35
Portadown,8113,10,8,7,15,33,46,-13,31
Coleraine,8113,11,6,11,13,37,53,-16,29
Cliftonville,8114,1,17,6,7,56,39,17,57
Linfield,8114,2,15,8,7,59,30,29,53
Crusaders,8114,3,15,7,8,53,37,16,52
Ballymena,8114,4,16,4,10,64,60,4,52
Glentoran,8114,5,13,6,11,38,41,-3,45
Glenavon,8114,6,10,11,9,46,42,4,41
Coleraine,8114,7,10,11,9,40,44,-4,41
Dungannon,8114,8,11,7,12,56,47,9,40
Ards,8114,9,9,4,17,37,54,-17,31
Portadown,8114,10,5,8,17,25,49,-24,23
Ballinamalla,8114,11,6,4,20,27,58,-31,22
Cliftonville,8115,1,17,3,10,51,40,11,54
Linfield,8115,2,14,9,7,60,38,22,51
Ballymena,8115,3,13,9,8,59,60,-1,48
Crusaders,8115,4,13,8,9,48,39,9,47
Glenavon,8115,5,11,12,7,53,43,10,45
Coleraine,8115,6,11,12,7,46,37,9,45
Dungannon,8115,7,10,10,10,44,38,6,40
Ballinamalla,8115,8,10,7,13,39,49,-10,37
Ards,8115,9,10,4,16,33,45,-12,34
Glentoran,8115,10,7,8,15,26,45,-19,29
Portadown,8115,11,6,4,20,22,47,-25,22
Crusaders,8116,1,14,11,5,58,33,25,53
Cliftonville,8116,2,13,9,8,48,36,12,48
Linfield,8116,3,13,8,9,55,32,23,47
Glenavon,8116,4,11,11,8,47,40,7,44
Ballymena,8116,5,11,11,8,53,54,-1,44
Coleraine,8116,6,10,11,9,38,42,-4,41
Portadown,8116,7,11,6,13,29,35,-6,39
Ards,8116,8,10,7,13,33,45,-12,37
Dungannon,8116,9,8,11,11,48,46,2,35
Glentoran,8116,10,9,4,17,30,51,-21,31
Ballinamalla,8116,11,8,5,17,28,53,-25,29
Cliftonville,8117,1,16,5,9,61,43,18,53
Linfield,8117,2,13,8,9,60,39,21,47
Crusaders,8117,3,13,8,9,57,45,12,47
Glenavon,8117,4,13,8,9,49,42,7,47
Ballymena,8117,5,12,8,10,48,58,-10,44
Dungannon,8117,6,11,9,10,53,42,11,42
Coleraine,8117,7,10,12,8,37,32,5,42
Glentoran,8117,8,10,8,12,37,45,-8,38
Ballinamalla,8117,9,11,2,17,26,46,-20,35
Portadown,8117,10,9,5,16,22,41,-19,32
Ards,8117,11,8,5,17,35,52,-17,29
Crusaders,8118,1,16,6,8,57,37,20,54
Linfield,8118,2,15,8,7,56,29,27,53
Cliftonville,8118,3,15,5,10,50,33,17,50
Ballymena,8118,4,15,4,11,58,59,-1,49
Coleraine,8118,5,12,10,8,41,37,4,46
Glenavon,8118,6,10,12,8,46,49,-3,42
Dungannon,8118,7,8,12,10,45,41,4,36
Glentoran,8118,8,9,8,13,32,46,-14,35
Portadown,8118,9,9,7,14,32,48,-16,34
Ballinamalla,8118,10,9,3,18,30,51,-21,30
Ards,8118,11,6,7,17,33,50,-17,25
Crusaders,8119,1,16,8,6,52,32,20,56
Cliftonville,8119,2,14,6,10,50,41,9,48
Linfield,8119,3,12,9,9,50,31,19,45
Ballymena,8119,4,12,8,10,55,62,-7,44
Coleraine,8119,5,11,10,9,41,37,4,43
Glentoran,8119,6,12,6,12,34,40,-6,42
Dungannon,8119,7,10,11,9,57,45,12,41
Glenavon,8119,8,9,12,9,42,46,-4,39
Portadown,8119,9,11,4,15,29,42,-13,37
Ards,8119,10,7,8,15,29,43,-14,29
Ballinamalla,8119,11,7,6,17,32,52,-20,27
Crusaders,8120,1,20,6,4,62,32,30,66
Cliftonville,8120,2,16,5,9,64,46,18,53
Linfield,8120,3,13,9,8,55,33,22,48
Dungannon,8120,4,13,9,8,52,33,19,48
Ballymena,8120,5,11,8,11,49,57,-8,41
Coleraine,8120,6,10,10,10,40,42,-2,40
Glenavon,8120,7,10,10,10,45,48,-3,40
Glentoran,8120,8,9,9,12,30,44,-14,36
Ards,8120,9,10,5,15,36,47,-11,35
Ballinamalla,8120,10,7,4,19,28,54,-26,25
Portadown,8120,11,6,5,19,31,56,-25,23
Cliftonville,8121,1,22,2,6,63,35,28,68
Linfield,8121,2,15,9,6,57,26,31,54
Crusaders,8121,3,15,6,9,53,36,17,51
Glenavon,8121,4,13,11,6,51,41,10,50
Coleraine,8121,5,12,9,9,48,39,9,45
Ballymena,8121,6,11,8,11,54,60,-6,41
Glentoran,8121,7,11,6,13,34,44,-10,39
Dungannon,8121,8,9,7,14,55,58,-3,34
Ards,8121,9,10,4,16,34,47,-13,34
Ballinamalla,8121,10,8,4,18,26,51,-25,28
Portadown,8121,11,3,6,21,18,56,-38,15
Crusaders,8122,1,19,5,6,61,33,28,62
Linfield,8122,2,16,10,4,60,27,33,58
Cliftonville,8122,3,14,4,12,50,48,2,46
Coleraine,8122,4,12,9,9,48,38,10,45
Glentoran,8122,5,12,8,10,37,41,-4,44
Ballymena,8122,6,11,9,10,53,56,-3,42
Glenavon,8122,7,10,10,10,50,52,-2,40
Dungannon,8122,8,8,8,14,46,52,-6,32
Ards,8122,9,8,7,15,40,52,-12,31
Ballinamalla,8122,10,8,5,17,36,55,-19,29
Portadown,8122,11,7,5,18,18,45,-27,26
Crusaders,8123,1,19,6,5,53,30,23,63
Linfield,8123,2,15,10,5,58,25,33,55
Cliftonville,8123,3,17,4,9,53,38,15,55
Ballymena,8123,4,14,5,11,55,51,4,47
Coleraine,8123,5,11,10,9,33,35,-2,43
Dungannon,8123,6,10,8,12,52,47,5,38
Ballinamalla,8123,7,11,5,14,34,45,-11,38
Glenavon,8123,8,8,12,10,43,49,-6,36
Glentoran,8123,9,6,12,12,26,44,-18,30
Portadown,8123,10,6,7,17,21,46,-25,25
Ards,8123,11,6,5,19,35,53,-18,23
Linfield,8124,1,16,9,5,58,24,34,57
Crusaders,8124,2,17,5,8,53,36,17,56
Coleraine,8124,3,14,10,6,50,33,17,52
Cliftonville,8124,4,14,5,11,51,42,9,47
Ballymena,8124,5,12,6,12,53,61,-8,42
Glenavon,8124,6,9,13,8,49,45,4,40
Ards,8124,7,10,6,14,36,48,-12,36
Dungannon,8124,8,9,8,13,50,52,-2,35
Ballinamalla,8124,9,8,7,15,35,49,-14,31
Portadown,8124,10,8,6,16,21,41,-20,30
Glentoran,8124,11,7,7,16,30,55,-25,28
Crusaders,8125,1,17,7,6,57,31,26,58
Ballymena,8125,2,15,5,10,61,54,7,50
Cliftonville,8125,3,14,7,9,52,43,9,49
Glentoran,8125,4,13,7,10,37,38,-1,46
Linfield,8125,5,10,13,7,49,29,20,43
Coleraine,8125,6,10,9,11,48,44,4,39
Dungannon,8125,7,9,12,9,48,49,-1,39
Glenavon,8125,8,9,11,10,51,55,-4,38
Ards,8125,9,10,5,15,41,49,-8,35
Portadown,8125,10,7,9,14,29,43,-14,30
Ballinamalla,8125,11,6,5,19,24,62,-38,23
Cliftonville,8126,1,16,7,7,58,33,25,55
Crusaders,8126,2,16,7,7,54,32,22,55
Linfield,8126,3,14,9,7,59,34,25,51
Glenavon,8126,4,13,10,7,50,47,3,49
Coleraine,8126,5,12,10,8,46,37,9,46
Ballymena,8126,6,13,5,12,53,61,-8,44
Dungannon,8126,7,11,9,10,53,44,9,42
Glentoran,8126,8,8,7,15,26,46,-20,31
Portadown,8126,9,8,6,16,25,54,-29,30
Ards,8126,10,8,5,17,37,51,-14,29
Ballinamalla,8126,11,7,3,20,34,56,-22,24
Linfield,8127,1,18,6,6,57,27,30,60
Cliftonville,8127,2,17,4,9,57,31,26,55
Crusaders,8127,3,14,6,10,49,42,7,48
Coleraine,8127,4,12,11,7,40,34,6,47
Glenavon,8127,5,13,7,10,49,48,1,46
Dungannon,8127,6,9,11,10,51,46,5,38
Ballymena,8127,7,11,5,14,51,61,-10,38
Glentoran,8127,8,10,6,14,29,38,-9,36
Ballinamalla,8127,9,10,4,16,23,45,-22,34
Ards,8127,10,8,5,17,35,52,-17,29
Portadown,8127,11,8,5,17,29,46,-17,29
Crusaders,8128,1,16,10,4,53,28,25,58
Glenavon,8128,2,15,9,6,55,42,13,54
Linfield,8128,3,14,9,7,53,33,20,51
Coleraine,8128,4,13,10,7,49,34,15,49
Ballymena,8128,5,14,5,11,59,60,-1,47
Cliftonville,8128,6,13,7,10,49,37,12,46
Dungannon,8128,7,9,11,10,48,43,5,38
Ards,8128,8,9,7,14,38,48,-10,34
Glentoran,8128,9,7,9,14,29,46,-17,30
Ballinamalla,8128,10,7,7,16,26,51,-25,28
Portadown,8128,11,4,4,22,22,59,-37,16
Crusaders,8129,1,17,7,6,64,40,24,58
Cliftonville,8129,2,17,5,8,60,44,16,56
Linfield,8129,3,14,11,5,56,32,24,53
Glenavon,8129,4,11,12,7,46,42,4,45
Dungannon,8129,5,12,8,10,48,43,5,44
Ballymena,8129,6,12,8,10,57,54,3,44
Glentoran,8129,7,10,8,12,37,44,-7,38
Coleraine,8129,8,9,10,11,40,44,-4,37
Ards,8129,9,9,7,14,37,44,-7,34
Portadown,8129,10,8,5,17,22,45,-23,29
Ballinamalla,8129,11,4,3,23,20,55,-35,15
Crusaders,8130,1,16,7,7,53,34,19,55
Ballymena,8130,2,16,7,7,62,54,8,55
Glenavon,8130,3,12,13,5,54,43,11,49
Linfield,8130,4,12,10,8,56,34,22,46
Cliftonville,8130,5,14,4,12,52,44,8,46
Coleraine,8130,6,10,10,10,41,47,-6,40
Glentoran,8130,7,10,6,14,40,52,-12,36
Ballinamalla,8130,8,9,7,14,34,46,-12,34
Dungannon,8130,9,7,12,11,43,42,1,33
Ards,8130,10,10,3,17,36,46,-10,33
Portadown,8130,11,6,7,17,23,52,-29,25
Cliftonville,8131,1,17,4,9,55,36,19,55
Crusaders,8131,2,16,7,7,56,40,16,55
Linfield,8131,3,14,9,7,59,37,22,51
Coleraine,8131,4,13,10,7,45,35,10,49
Dungannon,8131,5,12,8,10,59,41,18,44
Glenavon,8131,6,10,10,10,52,54,-2,40
Ballymena,8131,7,11,5,14,58,65,-7,38
Glentoran,8131,8,10,6,14,24,47,-23,36
Ballinamalla,8131,9,11,1,18,35,54,-19,34
Ards,8131,10,8,6,16,40,49,-9,30
Portadown,8131,11,7,6,17,23,48,-25,27
Ballymena,8132,1,17,7,6,68,49,19,58
Glenavon,8132,2,15,10,5,53,39,14,55
Crusaders,8132,3,14,6,10,60,43,17,48
Cliftonville,8132,4,14,6,10,50,41,9,48
Linfield,8132,5,11,12,7,55,40,15,45
Coleraine,8132,6,10,11,9,43,41,2,41
Dungannon,8132,7,10,9,11,51,44,7,39
Portadown,8132,8,9,5,16,28,50,-22,32
Ards,8132,9,8,6,16,40,57,-17,30
Ballinamalla,8132,10,9,3,18,32,54,-22,30
Glentoran,8132,11,7,7,16,28,50,-22,28
Ballymena,8133,1,17,4,9,59,58,1,55
Linfield,8133,2,15,6,9,55,36,19,51
Crusaders,8133,3,14,6,10,51,42,9,48
Cliftonville,8133,4,14,5,11,62,46,16,47
Coleraine,8133,5,13,8,9,44,40,4,47
Glenavon,8133,6,11,11,8,45,41,4,44
Glentoran,8133,7,12,5,13,39,43,-4,41
Dungannon,8133,8,11,7,12,52,48,4,40
Ards,8133,9,10,7,13,50,49,1,37
Portadown,8133,10,8,4,18,28,52,-24,28
Ballinamalla,8133,11,6,5,19,28,58,-30,23
Crusaders,8134,1,17,6,7,56,34,22,57
Cliftonville,8134,2,17,5,8,50,28,22,56
Glenavon,8134,3,14,10,6,52,41,11,52
Coleraine,8134,4,12,11,7,42,36,6,47
Linfield,8134,5,12,10,8,58,37,21,46
Glentoran,8134,6,10,9,11,34,40,-6,39
Ards,8134,7,10,6,14,40,48,-8,36
Ballymena,8134,8,10,6,14,50,69,-19,36
Portadown,8134,9,9,6,15,25,39,-14,33
Dungannon,8134,10,6,11,13,50,53,-3,29
Ballinamalla,8134,11,5,6,19,29,61,-32,21
Linfield,8135,1,15,11,4,60,24,36,56
Cliftonville,8135,2,17,3,10,48,38,10,54
Crusaders,8135,3,14,6,10,46,38,8,48
Ballymena,8135,4,14,5,11,57,57,0,47
Coleraine,8135,5,12,10,8,48,39,9,46
Glenavon,8135,6,9,12,9,42,46,-4,39
Ards,8135,7,9,8,13,32,43,-11,35
Ballinamalla,8135,8,10,4,16,29,44,-15,34
Dungannon,8135,9,7,11,12,44,43,1,32
Glentoran,8135,10,8,8,14,28,45,-17,32
Portadown,8135,11,7,8,15,26,43,-17,29
Glenavon,8136,1,17,9,4,55,33,22,60
Linfield,8136,2,16,11,3,63,26,37,59
Crusaders,8136,3,15,9,6,53,38,15,54
Ballymena,8136,4,15,6,9,59,48,11,51
Cliftonville,8136,5,14,5,11,49,39,10,47
Dungannon,8136,6,10,10,10,49,41,8,40
Coleraine,8136,7,9,13,8,34,33,1,40
Ards,8136,8,10,7,13,36,46,-10,37
Glentoran,8136,9,6,8,16,33,53,-20,26
Ballinamalla,8136,10,7,4,19,30,62,-32,25
Portadown,8136,11,3,4,23,14,56,-42,13
Crusaders,8137,1,17,9,4,53,28,25,60
Cliftonville,8137,2,16,6,8,54,33,21,54
Ballymena,8137,3,16,5,9,56,55,1,53
Linfield,8137,4,15,7,8,68,38,30,52
Coleraine,8137,5,12,10,8,50,40,10,46
Dungannon,8137,6,10,9,11,46,41,5,39
Glenavon,8137,7,8,13,9,44,49,-5,37
Glentoran,8137,8,8,9,13,34,44,-10,33
Ballinamalla,8137,9,10,2,18,31,53,-22,32
Portadown,8137,10,6,7,17,27,50,-23,25
Ards,8137,11,7,3,20,35,67,-32,24
Ballymena,8138,1,18,4,8,58,47,11,58
Linfield,8138,2,15,11,4,58,26,32,56
Crusaders,8138,3,15,8,7,53,32,21,53
Glenavon,8138,4,12,10,8,44,40,4,46
Cliftonville,8138,5,13,6,11,48,41,7,45
Dungannon,8138,6,10,12,8,49,43,6,42
Coleraine,8138,7,7,11,12,38,47,-9,32
Ballinamalla,8138,8,8,7,15,29,49,-20,31
Ards,8138,9,8,6,16,33,47,-14,30
Glentoran,8138,10,8,6,16,28,47,-19,30
Portadown,8138,11,6,9,15,23,42,-19,27
Crusaders,8139,1,17,7,6,50,27,23,58
Cliftonville,8139,2,17,4,9,59,39,20,55
Linfield,8139,3,13,12,5,61,34,27,51
Coleraine,8139,4,14,9,7,42,35,7,51
Ballymena,8139,5,13,5,12,57,60,-3,44
Glenavon,8139,6,11,10,9,48,49,-1,43
Dungannon,8139,7,10,12,8,49,40,9,42
Glentoran,8139,8,8,7,15,33,52,-19,31
Ballinamalla,8139,9,9,3,18,34,51,-17,30
Ards,8139,10,8,4,18,35,53,-18,28
Portadown,8139,11,7,3,20,28,56,-28,24
Crusaders,8140,1,16,7,7,53,32,21,55
Ballymena,8140,2,15,6,9,52,50,2,51
Cliftonville,8140,3,15,5,10,43,34,9,50
Linfield,8140,4,13,10,7,51,29,22,49
Glenavon,8140,5,11,11,8,50,40,10,44
Coleraine,8140,6,11,11,8,37,37,0,44
Dungannon,8140,7,9,10,11,48,43,5,37
Ards,8140,8,8,8,14,33,45,-12,32
Portadown,8140,9,9,4,17,28,44,-16,31
Ballinamalla,8140,10,9,4,17,35,52,-17,31
Glentoran,8140,11,6,10,14,27,51,-24,28
Cliftonville,8141,1,17,4,9,51,33,18,55
Coleraine,8141,2,12,14,4,43,34,9,50
Linfield,8141,3,13,9,8,54,31,23,48
Ballymena,8141,4,14,6,10,54,54,0,48
Crusaders,8141,5,11,11,8,46,38,8,44
Glenavon,8141,6,9,12,9,47,48,-1,39
Ards,8141,7,11,6,13,39,44,-5,39
Dungannon,8141,8,8,10,12,52,51,1,34
Ballinamalla,8141,9,10,3,17,33,52,-19,33
Portadown,8141,10,8,8,14,30,45,-15,32
Glentoran,8141,11,7,7,16,26,45,-19,28
Crusaders,8142,1,19,7,4,65,31,34,64
Linfield,8142,2,16,7,7,54,29,25,55
Coleraine,8142,3,12,12,6,48,38,10,48
Ballymena,8142,4,13,7,10,57,58,-1,46
Dungannon,8142,5,11,9,10,52,42,10,42
Glenavon,8142,6,10,11,9,48,46,2,41
Cliftonville,8142,7,12,5,13,48,49,-1,41
Glentoran,8142,8,10,9,11,29,34,-5,39
Ards,8142,9,9,4,17,33,52,-19,31
Ballinamalla,8142,10,8,2,20,24,56,-32,26
Portadown,8142,11,5,7,18,24,47,-23,22
Cliftonville,8143,1,17,6,7,63,36,27,57
Crusaders,8143,2,16,7,7,62,42,20,55
Ballymena,8143,3,15,6,9,60,54,6,51
Linfield,8143,4,13,8,9,59,43,16,47
Glenavon,8143,5,11,10,9,48,45,3,43
Coleraine,8143,6,10,13,7,41,40,1,43
Glentoran,8143,7,10,7,13,33,43,-10,37
Dungannon,8143,8,7,11,12,46,44,2,32
Portadown,8143,9,8,6,16,20,42,-22,30
Ballinamalla,8143,10,8,6,16,28,53,-25,30
Ards,8143,11,8,4,18,30,48,-18,28
Cliftonville,8144,1,19,4,7,59,32,27,61
Crusaders,8144,2,17,6,7,57,36,21,57
Linfield,8144,3,13,9,8,54,29,25,48
Coleraine,8144,4,13,9,8,47,36,11,48
Dungannon,8144,5,12,9,9,54,43,11,45
Ballymena,8144,6,13,6,11,65,67,-2,45
Glenavon,8144,7,11,11,8,44,43,1,44
Ards,8144,8,9,6,15,37,49,-12,33
Glentoran,8144,9,9,5,16,30,47,-17,32
Portadown,8144,10,7,4,19,23,53,-30,25
Ballinamalla,8144,11,6,3,21,23,58,-35,21
Crusaders,8145,1,19,5,6,51,28,23,62
Ballymena,8145,2,16,7,7,62,52,10,55
Linfield,8145,3,15,9,6,59,32,27,54
Cliftonville,8145,4,14,5,11,51,36,15,47
Dungannon,8145,5,12,10,8,54,38,16,46
Coleraine,8145,6,10,10,10,40,45,-5,40
Glenavon,8145,7,9,9,12,38,44,-6,36
Ards,8145,8,10,6,14,39,46,-7,36
Ballinamalla,8145,9,7,6,17,22,44,-22,27
Glentoran,8145,10,6,9,15,25,48,-23,27
Portadown,8145,11,6,6,18,18,46,-28,24
Coleraine,8146,1,14,10,6,47,36,11,52
Linfield,8146,2,14,9,7,60,36,24,51
Crusaders,8146,3,14,9,7,57,40,17,51
Dungannon,8146,4,13,8,9,49,39,10,47
Cliftonville,8146,5,12,8,10,52,43,9,44
Ballymena,8146,6,12,7,11,64,65,-1,43
Glenavon,8146,7,10,9,11,46,44,2,39
Ards,8146,8,11,6,13,43,48,-5,39
Glentoran,8146,9,8,9,13,32,49,-17,33
Ballinamalla,8146,10,7,7,16,31,52,-21,28
Portadown,8146,11,6,6,18,24,53,-29,24
Cliftonville,8147,1,18,3,9,60,37,23,57
Linfield,8147,2,15,10,5,55,27,28,55
Crusaders,8147,3,15,9,6,56,40,16,54
Ballymena,8147,4,15,6,9,54,56,-2,51
Glenavon,8147,5,11,10,9,43,44,-1,43
Glentoran,8147,6,9,11,10,34,37,-3,38
Coleraine,8147,7,9,9,12,44,41,3,36
Dungannon,8147,8,8,9,13,48,49,-1,33
Ards,8147,9,9,5,16,36,55,-19,32
Portadown,8147,10,7,10,13,29,45,-16,31
Ballinamalla,8147,11,6,4,20,27,55,-28,22
Crusaders,8148,1,17,7,6,60,34,26,58
Linfield,8148,2,15,7,8,60,38,22,52
Cliftonville,8148,3,15,7,8,58,38,20,52
Ballymena,8148,4,14,6,10,59,56,3,48
Coleraine,8148,5,12,11,7,44,35,9,47
Glenavon,8148,6,13,8,9,48,48,0,47
Glentoran,8148,7,10,8,12,36,48,-12,38
Dungannon,8148,8,8,10,12,49,52,-3,34
Ards,8148,9,9,4,17,39,58,-19,31
Portadown,8148,10,8,3,19,37,57,-20,27
Ballinamalla,8148,11,7,3,20,28,54,-26,24
Cliftonville,8149,1,18,4,8,58,36,22,58
Linfield,8149,2,15,9,6,64,33,31,54
Crusaders,8149,3,15,8,7,58,42,16,53
Glenavon,8149,4,15,7,8,52,44,8,52
Ballymena,8149,5,14,7,9,66,65,1,49
Dungannon,8149,6,11,9,10,53,47,6,42
Coleraine,8149,7,11,8,11,43,44,-1,41
Ballinamalla,8149,8,9,5,16,32,46,-14,32
Ards,8149,9,7,6,17,37,53,-16,27
Glentoran,8149,10,6,7,17,28,50,-22,25
Portadown,8149,11,6,6,18,26,57,-31,24
Crusaders,8150,1,21,5,4,65,28,37,68
Linfield,8150,2,15,10,5,56,33,23,55
Cliftonville,8150,3,15,4,11,54,44,10,49
Glenavon,8150,4,11,12,7,49,44,5,45
Coleraine,8150,5,12,9,9,42,40,2,45
Ballymena,8150,6,13,6,11,54,57,-3,45
Dungannon,8150,7,11,9,10,50,39,11,42
Glentoran,8150,8,8,10,12,38,49,-11,34
Ards,8150,9,8,4,18,31,50,-19,28
Portadown,8150,10,8,4,18,24,46,-22,28
Ballinamalla,8150,11,5,3,22,24,57,-33,18
Cliftonville,8151,1,14,10,6,46,32,14,52
Crusaders,8151,2,13,11,6,53,33,20,50
Coleraine,8151,3,13,10,7,52,37,15,49
Linfield,8151,4,13,9,8,57,35,22,48
Glenavon,8151,5,11,12,7,55,50,5,45
Ballymena,8151,6,12,7,11,60,58,2,43
Dungannon,8151,7,11,9,10,58,51,7,42
Ards,8151,8,11,5,14,44,49,-5,38
Glentoran,8151,9,10,6,14,26,48,-22,36
Portadown,8151,10,8,5,17,28,51,-23,29
Ballinamalla,8151,11,5,4,21,24,59,-35,19
Cliftonville,8152,1,16,7,7,58,36,22,55
Linfield,8152,2,13,13,4,55,28,27,52
Crusaders,8152,3,13,12,5,52,37,15,51
Ballymena,8152,4,14,5,11,62,62,0,47
Ballinamalla,8152,5,12,4,14,38,45,-7,40
Glenavon,8152,6,9,12,9,44,40,4,39
Dungannon,8152,7,10,9,11,49,53,-4,39
Coleraine,8152,8,9,11,10,44,45,-1,38
Glentoran,8152,9,8,9,13,28,42,-14,33
Ards,8152,10,6,9,15,33,52,-19,27
Portadown,8152,11,5,9,16,25,48,-23,24
Cliftonville,8153,1,19,3,8,68,42,26,60
Crusaders,8153,2,16,9,5,56,34,22,57
Ballymena,8153,3,16,6,8,59,52,7,54
Linfield,8153,4,13,7,10,49,36,13,46
Glenavon,8153,5,11,13,6,51,42,9,46
Coleraine,8153,6,10,9,11,41,44,-3,39
Dungannon,8153,7,7,16,7,45,37,8,37
Ards,8153,8,8,6,16,35,52,-17,30
Glentoran,8153,9,7,9,14,28,47,-19,30
Portadown,8153,10,8,3,19,23,45,-22,27
Ballinamalla,8153,11,7,5,18,27,51,-24,26
Crusaders,8154,1,16,7,7,51,32,19,55
Linfield,8154,2,14,8,8,58,37,21,50
Cliftonville,8154,3,14,6,10,45,31,14,48
Ballymena,8154,4,14,6,10,57,58,-1,48
Coleraine,8154,5,11,12,7,39,33,6,45
Dungannon,8154,6,11,11,8,55,43,12,44
Glenavon,8154,7,11,9,10,49,45,4,42
Glentoran,8154,8,11,5,14,35,46,-11,38
Ards,8154,9,9,5,16,36,49,-13,32
Ballinamalla,8154,10,8,5,17,27,50,-23,29
Portadown,8154,11,6,6,18,20,48,-28,24
Crusaders,8155,1,18,6,6,59,31,28,60
Linfield,8155,2,14,10,6,55,23,32,52
Cliftonville,8155,3,15,6,9,58,45,13,51
Ballymena,8155,4,12,8,10,56,58,-2,44
Coleraine,8155,5,9,15,6,44,44,0,42
Dungannon,8155,6,10,9,11,55,45,10,39
Glenavon,8155,7,8,13,9,38,50,-12,37
Ards,8155,8,10,6,14,38,46,-8,36
Glentoran,8155,9,9,9,12,31,42,-11,36
Portadown,8155,10,7,6,17,24,46,-22,27
Ballinamalla,8155,11,7,4,19,29,57,-28,25
Linfield,8156,1,19,7,4,65,28,37,64
Cliftonville,8156,2,17,3,10,54,44,10,54
Ballymena,8156,3,15,6,9,65,59,6,51
Crusaders,8156,4,13,8,9,51,39,12,47
Coleraine,8156,5,12,10,8,45,39,6,46
Dungannon,8156,6,12,9,9,55,39,16,45
Glenavon,8156,7,10,12,8,47,49,-2,42
Ards,8156,8,8,5,17,34,47,-13,29
Portadown,8156,9,7,7,16,24,46,-22,28
Glentoran,8156,10,5,10,15,21,41,-20,25
Ballinamalla,8156,11,5,7,18,25,55,-30,22
Cliftonville,8157,1,19,3,8,65,37,28,60
Ballymena,8157,2,17,5,8,70,54,16,56
Crusaders,8157,3,15,8,7,46,30,16,53
Dungannon,8157,4,12,9,9,50,40,10,45
Coleraine,8157,5,11,11,8,44,38,6,44
Linfield,8157,6,12,7,11,53,44,9,43
Glenavon,8157,7,10,9,11,40,44,-4,39
Glentoran,8157,8,8,8,14,32,46,-14,32
Ballinamalla,8157,9,9,3,18,31,54,-23,30
Ards,8157,10,8,5,17,37,53,-16,29
Portadown,8157,11,8,4,18,26,54,-28,28
Crusaders,8158,1,16,8,6,54,35,19,56
Linfield,8158,2,14,10,6,53,26,27,52
Cliftonville,8158,3,15,5,10,51,40,11,50
Glenavon,8158,4,10,12,8,41,39,2,42
Ballymena,8158,5,12,6,12,58,57,1,42
Coleraine,8158,6,11,9,10,38,38,0,42
Dungannon,8158,7,10,9,11,46,40,6,39
Glentoran,8158,8,9,10,11,33,42,-9,37
Portadown,8158,9,8,8,14,32,52,-20,32
Ballinamalla,8158,10,7,9,14,27,47,-20,30
Ards,8158,11,6,8,16,31,48,-17,26
Crusaders,8159,1,19,7,4,59,33,26,64
Linfield,8159,2,16,7,7,60,33,27,55
Coleraine,8159,3,14,8,8,49,43,6,50
Glenavon,8159,4,12,9,9,50,46,4,45
Glentoran,8159,5,13,6,11,37,37,0,45
Ballymena,8159,6,12,6,12,48,57,-9,42
Cliftonville,8159,7,12,5,13,48,44,4,41
Dungannon,8159,8,9,11,10,48,40,8,38
Ballinamalla,8159,9,8,5,17,33,53,-20,29
Ards,8159,10,7,6,17,32,52,-20,27
Portadown,8159,11,5,6,19,27,53,-26,21
Crusaders,8160,1,17,8,5,55,31,24,59
Coleraine,8160,2,16,10,4,55,33,22,58
Cliftonville,8160,3,16,5,9,52,34,18,53
Glenavon,8160,4,13,10,7,45,42,3,49
Linfield,8160,5,13,8,9,51,38,13,47
Ballymena,8160,6,14,5,11,54,60,-6,47
Dungannon,8160,7,8,10,12,48,42,6,34
Glentoran,8160,8,9,7,14,30,42,-12,34
Ards,8160,9,8,7,15,30,44,-14,31
Ballinamalla,8160,10,6,4,20,22,48,-26,22
Portadown,8160,11,5,6,19,24,52,-28,21
Crusaders,8161,1,20,7,3,64,33,31,67
Linfield,8161,2,15,8,7,67,37,30,53
Dungannon,8161,3,14,8,8,56,40,16,50
Cliftonville,8161,4,14,5,11,52,39,13,47
Coleraine,8161,5,11,10,9,44,39,5,43
Glenavon,8161,6,11,10,9,54,53,1,43
Ballymena,8161,7,11,9,10,54,61,-7,42
Glentoran,8161,8,7,9,14,22,47,-25,30
Ards,8161,9,7,6,17,35,53,-18,27
Portadown,8161,10,6,8,16,26,48,-22,26
Ballinamalla,8161,11,7,4,19,29,53,-24,25
Linfield,8162,1,17,7,6,60,26,34,58
Ballymena,8162,2,15,7,8,56,50,6,52
Crusaders,8162,3,13,7,10,43,35,8,46
Cliftonville,8162,4,13,6,11,46,42,4,45
Dungannon,8162,5,11,10,9,55,43,12,43
Coleraine,8162,6,10,10,10,40,41,-1,40
Glenavon,8162,7,9,12,9,50,57,-7,39
Portadown,8162,8,11,5,14,36,42,-6,38
Glentoran,8162,9,9,6,15,28,44,-16,33
Ards,8162,10,9,4,17,38,51,-13,31
Ballinamalla,8162,11,8,6,16,31,52,-21,30
Linfield,8163,1,18,8,4,70,26,44,62
Ballymena,8163,2,15,6,9,57,56,1,51
Crusaders,8163,3,14,6,10,54,45,9,48
Coleraine,8163,4,11,11,8,47,44,3,44
Glenavon,8163,5,10,12,8,49,44,5,42
Cliftonville,8163,6,11,7,12,49,50,-1,40
Dungannon,8163,7,9,11,10,51,48,3,38
Glentoran,8163,8,10,6,14,33,44,-11,36
Portadown,8163,9,7,11,12,26,42,-16,32
Ards,8163,10,8,7,15,38,51,-13,31
Ballinamalla,8163,11,7,5,18,32,56,-24,26
Crusaders,8164,1,17,7,6,56,31,25,58
Ballymena,8164,2,16,5,9,62,61,1,53
Linfield,8164,3,13,11,6,55,28,27,50
Coleraine,8164,4,13,10,7,47,38,9,49
Cliftonville,8164,5,13,5,12,58,47,11,44
Glenavon,8164,6,11,11,8,50,49,1,44
Dungannon,8164,7,8,10,12,46,51,-5,34
Portadown,8164,8,9,6,15,30,43,-13,33
Ballinamalla,8164,9,9,6,15,32,52,-20,33
Ards,8164,10,9,4,17,35,53,-18,31
Glentoran,8164,11,6,7,17,30,48,-18,25
Crusaders,8165,1,17,8,5,61,37,24,59
Cliftonville,8165,2,17,4,9,62,43,19,55
Ballymena,8165,3,15,6,9,54,52,2,51
Linfield,8165,4,13,10,7,57,33,24,49
Coleraine,8165,5,11,12,7,45,37,8,45
Glenavon,8165,6,10,12,8,51,41,10,42
Dungannon,8165,7,9,9,12,52,56,-4,36
Ards,8165,8,8,8,14,40,48,-8,32
Ballinamalla,8165,9,9,4,17,26,49,-23,31
Glentoran,8165,10,8,5,17,31,52,-21,29
Portadown,8165,11,7,4,19,22,53,-31,25
Linfield,8166,1,16,11,3,52,22,30,59
Crusaders,8166,2,17,8,5,60,39,21,59
Ballymena,8166,3,15,6,9,58,52,6,51
Cliftonville,8166,4,14,3,13,45,39,6,45
Dungannon,8166,5,11,10,9,50,40,10,43
Coleraine,8166,6,11,10,9,44,36,8,43
Glenavon,8166,7,9,10,11,51,50,1,37
Ards,8166,8,9,6,15,33,45,-12,33
Glentoran,8166,9,8,7,15,31,48,-17,31
Ballinamalla,8166,10,9,4,17,28,50,-22,31
Portadown,8166,11,5,7,18,26,57,-31,22
Crusaders,8167,1,20,6,4,64,31,33,66
Ballymena,8167,2,14,7,9,58,55,3,49
Cliftonville,8167,3,14,6,10,51,42,9,48
Dungannon,8167,4,12,9,9,48,36,12,45
Coleraine,8167,5,10,12,8,43,36,7,42
Glenavon,8167,6,9,14,7,44,42,2,41
Linfield,8167,7,11,7,12,47,37,10,40
Glentoran,8167,8,9,8,13,39,50,-11,35
Ballinamalla,8167,9,8,6,16,31,53,-22,30
Ards,8167,10,7,7,16,29,48,-19,28
Portadown,8167,11,7,6,17,22,46,-24,27
Crusaders,8168,1,17,9,4,63,37,26,60
Linfield,8168,2,14,10,6,58,29,29,52
Coleraine,8168,3,13,11,6,48,40,8,50
Cliftonville,8168,4,13,7,10,60,44,16,46
Ballymena,8168,5,12,9,9,51,52,-1,45
Dungannon,8168,6,9,11,10,51,45,6,38
Glenavon,8168,7,9,11,10,53,53,0,38
Glentoran,8168,8,9,8,13,25,45,-20,35
Ballinamalla,8168,9,7,8,15,31,52,-21,29
Ards,8168,10,6,9,15,32,48,-16,27
Portadown,8168,11,6,7,17,25,52,-27,25
Cliftonville,8169,1,18,4,8,59,40,19,58
Linfield,8169,2,16,9,5,64,28,36,57
Crusaders,8169,3,13,9,8,54,40,14,48
Dungannon,8169,4,12,9,9,60,46,14,45
Ballymena,8169,5,12,6,12,54,62,-8,42
Coleraine,8169,6,9,11,10,38,40,-2,38
Glenavon,8169,7,9,10,11,40,49,-9,37
Portadown,8169,8,10,6,14,28,41,-13,36
Ards,8169,9,9,6,15,41,49,-8,33
Glentoran,8169,10,9,6,15,26,43,-17,33
Ballinamalla,8169,11,7,6,17,25,51,-26,27
Crusaders,8170,1,20,6,4,59,30,29,66
Linfield,8170,2,16,8,6,66,35,31,56
Ballymena,8170,3,15,5,10,63,63,0,50
Cliftonville,8170,4,14,5,11,47,42,5,47
Glenavon,8170,5,10,13,7,41,38,3,43
Dungannon,8170,6,11,9,10,54,42,12,42
Coleraine,8170,7,10,9,11,37,42,-5,39
Glentoran,8170,8,8,6,16,24,49,-25,30
Ards,8170,9,8,5,17,37,51,-14,29
Portadown,8170,10,6,10,14,25,41,-16,28
Ballinamalla,8170,11,6,6,18,32,52,-20,24
Crusaders,8171,1,17,8,5,58,32,26,59
Cliftonville,8171,2,17,5,8,60,38,22,56
Linfield,8171,3,13,14,3,64,33,31,53
Glenavon,8171,4,12,11,7,51,43,8,47
Ballymena,8171,5,13,8,9,59,63,-4,47
Ards,8171,6,11,5,14,41,44,-3,38
Dungannon,8171,7,9,10,11,50,46,4,37
Coleraine,8171,8,9,10,11,38,44,-6,37
Glentoran,8171,9,7,7,16,29,53,-24,28
Ballinamalla,8171,10,6,6,18,24,52,-28,24
Portadown,8171,11,5,8,17,21,47,-26,23
Crusaders,8172,1,17,6,7,59,36,23,57
Linfield,8172,2,15,9,6,54,29,25,54
Cliftonville,8172,3,15,6,9,55,43,12,51
Glenavon,8172,4,13,8,9,48,41,7,47
Ballymena,8172,5,13,7,10,51,48,3,46
Glentoran,8172,6,13,5,12,30,42,-12,44
Dungannon,8172,7,11,8,11,49,45,4,41
Coleraine,8172,8,8,12,10,33,32,1,36
Ards,8172,9,8,5,17,30,48,-18,29
Portadown,8172,10,7,6,17,22,44,-22,27
Ballinamalla,8172,11,7,4,19,35,58,-23,25
Cliftonville,8173,1,15,7,8,57,45,12,52
Crusaders,8173,2,14,9,7,50,35,15,51
Glenavon,8173,3,13,10,7,51,42,9,49
Linfield,8173,4,12,9,9,59,37,22,45
Coleraine,8173,5,11,12,7,44,38,6,45
Ballymena,8173,6,13,4,13,56,66,-10,43
Dungannon,8173,7,11,9,10,53,46,7,42
Ards,8173,8,11,4,15,41,47,-6,37
Portadown,8173,9,11,4,15,33,42,-9,37
Glentoran,8173,10,8,6,16,26,47,-21,30
Ballinamalla,8173,11,6,6,18,30,55,-25,24
Linfield,8174,1,16,10,4,54,25,29,58
Crusaders,8174,2,15,9,6,54,34,20,54
Coleraine,8174,3,14,10,6,41,31,10,52
Cliftonville,8174,4,15,5,10,48,36,12,50
Glenavon,8174,5,9,15,6,49,43,6,42
Ballymena,8174,6,10,9,11,50,55,-5,39
Dungannon,8174,7,8,12,10,45,40,5,36
Ards,8174,8,8,8,14,37,47,-10,32
Glentoran,8174,9,6,10,14,27,46,-19,28
Portadown,8174,10,7,6,17,21,48,-27,27
Ballinamalla,8174,11,6,8,16,26,47,-21,26
Linfield,8175,1,14,10,6,65,36,29,52
Crusaders,8175,2,14,9,7,48,30,18,51
Cliftonville,8175,3,16,3,11,55,41,14,51
Coleraine,8175,4,13,8,9,43,36,7,47
Glenavon,8175,5,12,9,9,54,48,6,45
Ballymena,8175,6,11,7,12,52,63,-11,40
Dungannon,8175,7,10,8,12,40,43,-3,38
Ards,8175,8,11,3,16,38,55,-17,36
Portadown,8175,9,10,5,15,32,42,-10,35
Ballinamalla,8175,10,9,7,14,34,47,-13,34
Glentoran,8175,11,7,7,16,25,45,-20,28
Crusaders,8176,1,16,9,5,52,31,21,57
Linfield,8176,2,15,11,4,60,28,32,56
Cliftonville,8176,3,14,8,8,50,32,18,50
Glenavon,8176,4,11,13,6,49,45,4,46
Coleraine,8176,5,12,9,9,42,44,-2,45
Ballymena,8176,6,12,6,12,56,59,-3,42
Ards,8176,7,9,7,14,38,46,-8,34
Glentoran,8176,8,8,8,14,35,47,-12,32
Dungannon,8176,9,7,10,13,46,51,-5,31
Ballinamalla,8176,10,7,7,16,28,51,-23,28
Portadown,8176,11,6,8,16,26,48,-22,26
Linfield,8177,1,15,11,4,64,31,33,56
Crusaders,8177,2,14,10,6,52,34,18,52
Cliftonville,8177,3,14,8,8,60,41,19,50
Glenavon,8177,4,11,11,8,48,45,3,44
Ballymena,8177,5,13,5,12,55,63,-8,44
Ballinamalla,8177,6,13,3,14,35,42,-7,42
Glentoran,8177,7,12,4,14,30,41,-11,40
Coleraine,8177,8,9,12,9,40,42,-2,39
Ards,8177,9,8,8,14,35,47,-12,32
Dungannon,8177,10,6,10,14,47,51,-4,28
Portadown,8177,11,7,4,19,24,53,-29,25
Crusaders,8178,1,16,5,9,52,36,16,53
Ballymena,8178,2,14,8,8,60,57,3,50
Linfield,8178,3,13,10,7,54,35,19,49
Cliftonville,8178,4,15,4,11,54,44,10,49
Glenavon,8178,5,13,9,8,50,42,8,48
Coleraine,8178,6,10,11,9,40,40,0,41
Dungannon,8178,7,9,10,11,48,44,4,37
Ards,8178,8,10,7,13,34,43,-9,37
Portadown,8178,9,9,6,15,32,48,-16,33
Glentoran,8178,10,6,11,13,28,41,-13,29
Ballinamalla,8178,11,7,5,18,25,47,-22,26
Crusaders,8179,1,18,6,6,60,40,20,60
Cliftonville,8179,2,16,5,9,64,44,20,53
Linfield,8179,3,14,7,9,56,30,26,49
Glenavon,8179,4,13,10,7,54,46,8,49
Dungannon,8179,5,12,9,9,59,44,15,45
Coleraine,8179,6,10,12,8,43,31,12,42
Ballymena,8179,7,10,9,11,47,60,-13,39
Portadown,8179,8,10,5,15,33,50,-17,35
Glentoran,8179,9,9,6,15,29,46,-17,33
Ards,8179,10,9,4,17,37,61,-24,31
Ballinamalla,8179,11,5,5,20,26,56,-30,20
Cliftonville,8180,1,17,4,9,56,36,20,55
Linfield,8180,2,14,10,6,61,32,29,52
Dungannon,8180,3,14,7,9,58,39,19,49
Crusaders,8180,4,14,7,9,50,40,10,49
Glenavon,8180,4,13,10,7,50,40,10,49
Ballymena,8180,6,14,6,10,56,59,-3,48
Coleraine,8180,7,11,9,10,37,33,4,42
Ballinamalla,8180,8,9,5,16,29,48,-19,32
Glentoran,8180,9,8,8,14,26,46,-20,32
Ards,8180,10,7,5,18,31,52,-21,26
Portadown,8180,11,6,5,19,22,51,-29,23
Crusaders,8181,1,16,8,6,53,29,24,56
Ballymena,8181,2,16,6,8,63,50,13,54
Linfield,8181,3,14,8,8,61,37,24,50
Cliftonville,8181,4,15,5,10,47,39,8,50
Coleraine,8181,5,12,13,5,47,34,13,49
Glenavon,8181,6,12,13,5,52,43,9,49
Dungannon,8181,7,9,8,13,46,50,-4,35
Glentoran,8181,8,8,7,15,29,43,-14,31
Ballinamalla,8181,9,8,6,16,32,48,-16,30
Portadown,8181,10,8,6,16,27,48,-21,30
Ards,8181,11,5,4,21,28,64,-36,19
Linfield,8182,1,17,9,4,61,25,36,60
Cliftonville,8182,2,17,4,9,54,35,19,55
Crusaders,8182,3,14,10,6,50,34,16,52
Coleraine,8182,4,12,10,8,38,36,2,46
Glentoran,8182,5,11,8,11,34,38,-4,41
Ballymena,8182,6,12,5,13,55,60,-5,41
Dungannon,8182,7,10,8,12,54,51,3,38
Glenavon,8182,8,9,10,11,40,46,-6,37
Ards,8182,9,9,5,16,34,48,-14,32
Ballinamalla,8182,10,6,8,16,26,48,-22,26
Portadown,8182,11,6,7,17,21,46,-25,25
Crusaders,8183,1,17,8,5,56,29,27,59
Ballymena,8183,2,16,6,8,65,58,7,54
Linfield,8183,3,14,11,5,56,25,31,53
Cliftonville,8183,4,15,6,9,44,31,13,51
Glenavon,8183,5,11,12,7,48,46,2,45
Dungannon,8183,6,11,8,11,53,44,9,41
Coleraine,8183,7,11,8,11,39,42,-3,41
Glentoran,8183,8,10,5,15,37,47,-10,35
Ards,8183,9,8,3,19,30,50,-20,27
Ballinamalla,8183,10,7,5,18,26,54,-28,26
Portadown,8183,11,7,4,19,20,48,-28,25
Coleraine,8184,1,15,10,5,42,28,14,55
Linfield,8184,2,15,8,7,60,32,28,53
Crusaders,8184,3,14,7,9,52,38,14,49
Cliftonville,8184,4,13,8,9,54,43,11,47
Glenavon,8184,5,12,10,8,47,41,6,46
Dungannon,8184,6,10,11,9,54,44,10,41
Ballymena,8184,7,11,7,12,55,60,-5,40
Glentoran,8184,8,10,6,14,35,50,-15,36
Ards,8184,9,10,3,17,43,52,-9,33
Portadown,8184,10,9,4,17,35,59,-24,31
Ballinamalla,8184,11,8,2,20,29,59,-30,26
Crusaders,8185,1,16,8,6,55,32,23,56
Ballymena,8185,2,17,5,8,67,51,16,56
Linfield,8185,3,13,10,7,53,30,23,49
Glenavon,8185,4,13,10,7,47,39,8,49
Cliftonville,8185,5,13,5,12,50,45,5,44
Glentoran,8185,6,13,5,12,31,39,-8,44
Coleraine,8185,7,10,10,10,45,42,3,40
Ards,8185,8,10,6,14,41,50,-9,36
Dungannon,8185,9,8,10,12,41,42,-1,34
Ballinamalla,8185,10,9,2,19,33,57,-24,29
Portadown,8185,11,4,7,19,18,54,-36,19
Crusaders,8186,1,17,6,7,57,36,21,57
Linfield,8186,2,16,8,6,60,31,29,56
Cliftonville,8186,3,17,4,9,58,41,17,55
Ballymena,8186,4,14,7,9,62,52,10,49
Coleraine,8186,5,14,7,9,45,43,2,49
Glenavon,8186,6,10,9,11,42,51,-9,39
Dungannon,8186,7,9,7,14,46,50,-4,34
Portadown,8186,8,10,4,16,31,42,-11,34
Ards,8186,9,8,8,14,38,41,-3,32
Glentoran,8186,10,8,8,14,25,48,-23,32
Ballinamalla,8186,11,6,4,20,27,56,-29,22
Linfield,8187,1,16,10,4,59,28,31,58
Cliftonville,8187,2,17,5,8,57,37,20,56
Crusaders,8187,3,15,7,8,54,38,16,52
Ballymena,8187,4,15,6,9,61,64,-3,51
Glenavon,8187,5,10,11,9,49,49,0,41
Glentoran,8187,6,10,8,12,35,42,-7,38
Coleraine,8187,7,9,11,10,36,45,-9,38
Dungannon,8187,8,9,7,14,55,50,5,34
Ards,8187,9,9,5,16,38,55,-17,32
Ballinamalla,8187,10,8,4,18,31,50,-19,28
Portadown,8187,11,7,6,17,30,47,-17,27
Ballymena,8188,1,16,7,7,62,51,11,55
Cliftonville,8188,2,16,4,10,63,50,13,52
Crusaders,8188,3,13,8,9,52,40,12,47
Linfield,8188,4,12,9,9,56,44,12,45
Coleraine,8188,5,11,11,8,42,34,8,44
Dungannon,8188,6,11,9,10,48,39,9,42
Glenavon,8188,7,10,12,8,44,45,-1,42
Portadown,8188,8,9,8,13,27,37,-10,35
Glentoran,8188,9,9,8,13,29,40,-11,35
Ards,8188,10,9,5,16,41,50,-9,32
Ballinamalla,8188,11,6,5,19,21,55,-34,23
Linfield,8189,1,18,7,5,65,23,42,61
Crusaders,8189,2,15,9,6,58,37,21,54
Cliftonville,8189,3,16,2,12,55,38,17,50
Ballymena,8189,4,14,6,10,55,59,-4,48
Coleraine,8189,5,12,10,8,47,45,2,46
Glenavon,8189,6,10,12,8,49,46,3,42
Dungannon,8189,7,9,11,10,46,42,4,38
Ballinamalla,8189,8,9,4,17,29,51,-22,31
Ards,8189,9,8,6,16,37,48,-11,30
Portadown,8189,10,8,5,17,22,47,-25,29
Glentoran,8189,11,5,10,15,25,52,-27,25
Linfield,8190,1,15,9,6,54,26,28,54
Crusaders,8190,2,13,9,8,44,31,13,48
Ballymena,8190,3,14,6,10,57,60,-3,48
Coleraine,8190,4,11,13,6,48,35,13,46
Glenavon,8190,5,11,10,9,45,46,-1,43
Cliftonville,8190,6,12,6,12,52,42,10,42
Glentoran,8190,7,12,5,13,37,41,-4,41
Portadown,8190,8,10,6,14,31,46,-15,36
Ballinamalla,8190,9,9,7,14,33,49,-16,34
Dungannon,8190,10,8,9,13,42,44,-2,33
Ards,8190,11,7,6,17,34,57,-23,27
Cliftonville,8191,1,19,3,8,64,39,25,60
Linfield,8191,2,15,10,5,69,35,34,55
Crusaders,8191,3,15,8,7,53,36,17,53
Ballymena,8191,4,13,7,10,55,54,1,46
Dungannon,8191,5,11,10,9,54,46,8,43
Coleraine,8191,6,11,9,10,41,43,-2,42
Ards,8191,7,11,4,15,40,48,-8,37
Glenavon,8191,8,8,12,10,46,50,-4,36
Glentoran,8191,9,8,8,14,28,52,-24,32
Portadown,8191,10,8,6,16,33,51,-18,30
Ballinamalla,8191,11,4,7,19,23,52,-29,19
Crusaders,8192,1,18,7,5,57,32,25,61
Cliftonville,8192,2,17,5,8,57,33,24,56
Linfield,8192,3,16,7,7,57,28,29,55
Dungannon,8192,4,12,9,9,56,40,16,45
Glenavon,8192,5,11,10,9,46,44,2,43
Ballymena,8192,6,11,8,11,48,59,-11,41
Coleraine,8192,7,10,10,10,43,41,2,40
Glentoran,8192,8,11,6,13,32,47,-15,39
Ards,8192,9,8,5,17,30,47,-17,29
Ballinamalla,8192,10,7,4,19,23,49,-26,25
Portadown,8192,11,6,5,19,23,52,-29,23
Crusaders,8193,1,15,7,8,51,40,11,52
Linfield,8193,2,14,7,9,62,34,28,49
Cliftonville,8193,3,15,4,11,53,44,9,49
Coleraine,8193,4,12,10,8,49,35,14,46
Ballymena,8193,5,13,7,10,51,56,-5,46
Glentoran,8193,6,12,8,10,43,44,-1,44
Dungannon,8193,7,11,10,9,52,37,15,43
Glenavon,8193,8,10,10,10,50,52,-2,40
Ballinamalla,8193,9,11,3,16,36,56,-20,36
Ards,8193,10,9,4,17,36,54,-18,31
Portadown,8193,11,5,6,19,21,52,-31,21
Crusaders,8194,1,19,7,4,54,25,29,64
Cliftonville,8194,2,17,5,8,51,31,20,56
Linfield,8194,3,15,10,5,57,32,25,55
Ballymena,8194,4,15,6,9,57,53,4,51
Glenavon,8194,5,12,11,7,46,42,4,47
Dungannon,8194,6,8,11,11,45,40,5,35
Coleraine,8194,7,8,9,13,32,42,-10,33
Ards,8194,8,10,3,17,38,51,-13,33
Portadown,8194,9,8,7,15,30,43,-13,31
Glentoran,8194,10,8,7,15,28,45,-17,31
Ballinamalla,8194,11,4,6,20,27,61,-34,18
Linfield,8195,1,16,10,4,63,32,31,58
Crusaders,8195,2,16,7,7,54,34,20,55
Coleraine,8195,3,13,11,6,44,36,8,50
Dungannon,8195,4,13,7,10,52,42,10,46
Glenavon,8195,5,11,12,7,49,43,6,45
Cliftonville,8195,6,13,5,12,50,41,9,44
Glentoran,8195,7,11,7,12,31,40,-9,40
Ballymena,8195,8,10,8,12,52,61,-9,38
Portadown,8195,9,9,6,15,25,43,-18,33
Ards,8195,10,8,4,18,32,51,-19,28
Ballinamalla,8195,11,4,5,21,24,53,-29,17
Cliftonville,8196,1,18,4,8,60,34,26,58
Crusaders,8196,2,14,8,8,50,37,13,50
Linfield,8196,3,13,9,8,58,39,19,48
Glenavon,8196,4,12,8,10,47,45,2,44
Coleraine,8196,5,11,10,9,45,40,5,43
Glentoran,8196,6,11,8,11,38,42,-4,41
Ballymena,8196,7,11,8,11,49,61,-12,41
Ballinamalla,8196,8,11,5,14,35,43,-8,38
Ards,8196,9,8,7,15,38,54,-16,31
Portadown,8196,10,8,7,15,24,45,-21,31
Dungannon,8196,11,7,8,15,38,42,-4,29
Ballymena,8197,1,17,7,6,64,50,14,58
Glenavon,8197,2,14,11,5,53,37,16,53
Crusaders,8197,3,14,10,6,54,41,13,52
Linfield,8197,4,13,10,7,60,39,21,49
Cliftonville,8197,5,13,7,10,43,43,0,46
Coleraine,8197,6,11,11,8,40,37,3,44
Dungannon,8197,7,8,10,12,46,42,4,34
Ards,8197,8,9,7,14,36,46,-10,34
Ballinamalla,8197,9,7,8,15,28,46,-18,29
Portadown,8197,10,6,8,16,28,47,-19,26
Glentoran,8197,11,5,7,18,26,50,-24,22
Crusaders,8198,1,17,9,4,56,30,26,60
Linfield,8198,2,15,9,6,62,35,27,54
Coleraine,8198,3,15,9,6,52,32,20,54
Cliftonville,8198,4,15,3,12,56,43,13,48
Ballymena,8198,5,13,9,8,61,53,8,48
Glenavon,8198,6,11,9,10,44,44,0,42
Dungannon,8198,7,9,9,12,43,44,-1,36
Portadown,8198,8,10,5,15,30,49,-19,35
Glentoran,8198,9,8,5,17,25,54,-29,29
Ballinamalla,8198,10,6,7,17,29,50,-21,25
Ards,8198,11,7,4,19,31,55,-24,25
Ballymena,8199,1,18,6,6,56,43,13,60
Linfield,8199,2,16,9,5,62,31,31,57
Cliftonville,8199,3,15,9,6,51,35,16,54
Crusaders,8199,4,15,5,10,52,38,14,50
Glenavon,8199,5,12,8,10,37,39,-2,44
Coleraine,8199,6,12,7,11,37,42,-5,43
Dungannon,8199,7,9,10,11,45,39,6,37
Glentoran,8199,8,9,8,13,30,42,-12,35
Ards,8199,9,9,6,15,43,49,-6,33
Portadown,8199,10,5,6,19,20,46,-26,21
Ballinamalla,8199,11,5,6,19,27,56,-29,21
Crusaders,8200,1,18,8,4,69,36,33,62
Cliftonville,8200,2,17,7,6,54,34,20,58
Linfield,8200,3,13,10,7,54,31,23,49
Ballymena,8200,4,12,9,9,54,56,-2,45
Coleraine,8200,5,12,8,10,42,37,5,44
Glenavon,8200,6,11,11,8,45,41,4,44
Glentoran,8200,7,8,9,13,33,50,-17,33
Ards,8200,8,7,8,15,33,45,-12,29
Dungannon,8200,9,6,10,14,43,52,-9,28
Ballinamalla,8200,10,7,7,16,31,59,-28,28
Portadown,8200,11,6,9,15,28,45,-17,27
Linfield,8201,1,18,7,5,70,27,43,61
Crusaders,8201,2,17,8,5,59,32,27,59
Cliftonville,8201,3,15,5,10,52,43,9,50
Ballymena,8201,4,14,6,10,62,58,4,48
Dungannon,8201,5,11,9,10,53,47,6,42
Coleraine,8201,6,9,12,9,42,44,-2,39
Glenavon,8201,7,7,15,8,39,44,-5,36
Ards,8201,8,10,4,16,37,47,-10,34
Glentoran,8201,9,8,9,13,26,41,-15,33
Ballinamalla,8201,10,6,7,17,25,54,-29,25
Portadown,8201,11,5,8,17,20,48,-28,23
Crusaders,8202,1,19,10,1,59,23,36,67
Linfield,8202,2,14,9,7,62,32,30,51
Glenavon,8202,3,13,9,8,49,44,5,48
Cliftonville,8202,4,13,7,10,46,37,9,46
Ballymena,8202,5,12,5,13,50,58,-8,41
Coleraine,8202,6,9,12,9,39,40,-1,39
Glentoran,8202,7,9,10,11,26,33,-7,37
Dungannon,8202,8,7,13,10,47,48,-1,34
Ards,8202,9,8,8,14,37,49,-12,32
Ballinamalla,8202,10,7,6,17,25,51,-26,27
Portadown,8202,11,7,5,18,20,45,-25,26
Crusaders,8203,1,15,9,6,60,34,26,54
Ballymena,8203,2,16,5,9,58,52,6,53
Cliftonville,8203,3,16,4,10,66,47,19,52
Linfield,8203,4,14,9,7,61,36,25,51
Glenavon,8203,5,12,11,7,49,41,8,47
Coleraine,8203,6,11,11,8,46,41,5,44
Dungannon,8203,7,10,8,12,47,44,3,38
Ards,8203,8,11,5,14,40,48,-8,38
Glentoran,8203,9,8,4,18,26,52,-26,28
Portadown,8203,10,7,6,17,20,46,-26,27
Ballinamalla,8203,11,6,6,18,26,58,-32,24
Crusaders,8204,1,19,5,6,57,29,28,62
Ballymena,8204,2,15,6,9,60,60,0,51
Linfield,8204,3,14,7,9,53,31,22,49
Cliftonville,8204,4,14,6,10,52,40,12,48
Glenavon,8204,5,12,10,8,54,47,7,46
Coleraine,8204,6,11,9,10,44,42,2,42
Dungannon,8204,7,10,8,12,50,46,4,38
Ballinamalla,8204,8,11,2,17,32,53,-21,35
Ards,8204,9,10,4,16,38,44,-6,34
Glentoran,8204,10,9,7,14,31,46,-15,34
Portadown,8204,11,5,6,19,19,52,-33,21
Linfield,8205,1,16,7,7,61,33,28,55
Cliftonville,8205,2,16,4,10,50,39,11,52
Crusaders,8205,3,15,6,9,47,34,13,51
Coleraine,8205,4,13,10,7,46,36,10,49
Ballymena,8205,5,15,4,11,59,57,2,49
Glenavon,8205,6,12,10,8,48,46,2,46
Dungannon,8205,7,11,8,11,45,35,10,41
Ards,8205,8,10,4,16,40,46,-6,34
Glentoran,8205,9,8,7,15,24,47,-23,31
Portadown,8205,10,8,6,16,22,38,-16,30
Ballinamalla,8205,11,4,8,18,24,55,-31,20
Crusaders,8206,1,16,7,7,59,37,22,55
Linfield,8206,2,13,11,6,58,36,22,50
Ballymena,8206,3,15,4,11,65,63,2,49
Glenavon,8206,4,10,13,7,47,42,5,43
Cliftonville,8206,5,12,6,12,50,43,7,42
Coleraine,8206,6,10,9,11,38,43,-5,39
Dungannon,8206,7,9,11,10,52,45,7,38
Glentoran,8206,8,8,11,11,34,44,-10,35
Portadown,8206,9,9,8,13,27,40,-13,35
Ballinamalla,8206,10,10,3,17,33,53,-20,33
Ards,8206,11,8,7,15,36,53,-17,31
Crusaders,8207,1,16,7,7,57,34,23,55
Cliftonville,8207,2,16,4,10,53,40,13,52
Linfield,8207,3,14,8,8,61,36,25,50
Ballymena,8207,4,14,7,9,62,66,-4,49
Glenavon,8207,5,12,7,11,50,46,4,43
Coleraine,8207,6,11,8,11,41,43,-2,41
Glentoran,8207,7,11,5,14,38,46,-8,38
Dungannon,8207,8,9,10,11,46,42,4,37
Ards,8207,9,11,4,15,37,47,-10,37
Ballinamalla,8207,10,9,5,16,25,42,-17,32
Portadown,8207,11,8,3,19,23,51,-28,27
Cliftonville,8208,1,17,6,7,58,33,25,57
Linfield,8208,2,15,11,4,58,30,28,56
Ballymena,8208,3,15,6,9,58,57,1,51
Crusaders,8208,4,13,11,6,55,36,19,50
Coleraine,8208,5,13,11,6,48,38,10,50
Dungannon,8208,6,11,9,10,44,37,7,42
Glenavon,8208,7,9,13,8,42,41,1,40
Glentoran,8208,8,7,12,11,29,40,-11,33
Ards,8208,9,7,4,19,34,57,-23,25
Portadown,8208,10,5,7,18,18,46,-28,22
Ballinamalla,8208,11,6,4,20,24,53,-29,22
Linfield,8209,1,17,7,6,63,33,30,58
Cliftonville,8209,2,17,3,10,58,37,21,54
Crusaders,8209,3,15,9,6,54,37,17,54
Glenavon,8209,4,14,10,6,48,39,9,52
Dungannon,8209,5,12,9,9,60,42,18,45
Ballymena,8209,6,11,5,14,56,65,-9,38
Coleraine,8209,7,9,10,11,41,49,-8,37
Ballinamalla,8209,8,11,3,16,33,55,-22,36
Ards,8209,9,10,4,16,41,48,-7,34
Glentoran,8209,10,7,8,15,27,45,-18,29
Portadown,8209,11,6,4,20,17,48,-31,22
Linfield,8210,1,15,8,7,62,30,32,53
Crusaders,8210,2,15,7,8,59,42,17,52
Cliftonville,8210,3,15,5,10,50,40,10,50
Dungannon,8210,4,13,9,8,61,43,18,48
Ballymena,8210,5,14,6,10,57,62,-5,48
Coleraine,8210,6,10,9,11,37,36,1,39
Glenavon,8210,7,10,8,12,49,55,-6,38
Glentoran,8210,8,10,6,14,32,49,-17,36
Portadown,8210,9,8,9,13,22,38,-16,33
Ballinamalla,8210,10,9,4,17,38,54,-16,31
Ards,8210,11,7,7,16,35,53,-18,28
Cliftonville,8211,1,19,4,7,58,35,23,61
Crusaders,8211,2,16,10,4,62,32,30,58
Linfield,8211,3,14,9,7,61,34,27,51
Ballymena,8211,4,14,4,12,55,61,-6,46
Dungannon,8211,5,11,9,10,48,41,7,42
Coleraine,8211,6,10,10,10,38,38,0,40
Glenavon,8211,7,8,13,9,42,53,-11,37
Glentoran,8211,8,9,7,14,27,44,-17,34
Portadown,8211,9,7,8,15,25,45,-20,29
Ards,8211,10,7,6,17,38,49,-11,27
Ballinamalla,8211,11,7,6,17,30,52,-22,27
Crusaders,8212,1,18,7,5,60,32,28,61
Linfield,8212,2,14,10,6,60,27,33,52
Ballymena,8212,3,15,7,8,58,60,-2,52
Dungannon,8212,4,13,7,10,53,37,16,46
Cliftonville,8212,5,14,4,12,48,43,5,46
Glenavon,8212,6,9,12,9,44,42,2,39
Ards,8212,7,10,7,13,42,53,-11,37
Coleraine,8212,8,8,10,12,33,39,-6,34
Glentoran,8212,9,9,6,15,31,44,-13,33
Portadown,8212,10,9,5,16,22,41,-19,32
Ballinamalla,8212,11,4,9,17,31,64,-33,21
Ballymena,8213,1,17,5,8,66,54,12,56
Crusaders,8213,2,15,9,6,52,30,22,54
Linfield,8213,3,14,9,7,59,35,24,51
Coleraine,8213,4,12,11,7,42,38,4,47
Dungannon,8213,5,12,7,11,57,43,14,43
Cliftonville,8213,6,11,6,13,43,45,-2,39
Glenavon,8213,7,8,12,10,47,51,-4,36
Ballinamalla,8213,8,11,3,16,30,48,-18,36
Glentoran,8213,9,8,8,14,27,43,-16,32
Ards,8213,10,8,6,16,38,52,-14,30
Portadown,8213,11,8,6,16,29,51,-22,30
Linfield,8214,1,17,8,5,63,27,36,59
Crusaders,8214,2,15,11,4,51,30,21,56
Coleraine,8214,3,14,10,6,49,37,12,52
Ballymena,8214,4,13,9,8,57,51,6,48
Cliftonville,8214,5,14,5,11,53,40,13,47
Dungannon,8214,6,10,9,11,48,47,1,39
Ards,8214,7,9,7,14,42,51,-9,34
Portadown,8214,8,9,6,15,25,46,-21,33
Glenavon,8214,9,7,11,12,42,56,-14,32
Glentoran,8214,10,6,8,16,29,51,-22,26
Ballinamalla,8214,11,8,2,20,33,56,-23,26
Linfield,8215,1,15,12,3,64,23,41,57
Cliftonville,8215,2,15,7,8,56,37,19,52
Crusaders,8215,3,14,10,6,50,36,14,52
Coleraine,8215,4,12,10,8,43,37,6,46
Glenavon,8215,5,8,16,6,42,39,3,40
Dungannon,8215,6,9,11,10,48,41,7,38
Ards,8215,7,9,8,13,37,43,-6,35
Ballymena,8215,8,8,10,12,46,63,-17,34
Ballinamalla,8215,9,8,9,13,33,45,-12,33
Glentoran,8215,10,6,10,14,30,52,-22,28
Portadown,8215,11,7,5,18,21,54,-33,26
Crusaders,8216,1,19,6,5,58,29,29,63
Cliftonville,8216,2,18,2,10,61,36,25,56
Linfield,8216,3,14,10,6,59,30,29,52
Ballymena,8216,4,13,9,8,65,55,10,48
Glenavon,8216,5,13,8,9,50,43,7,47
Coleraine,8216,6,11,8,11,35,39,-4,41
Ards,8216,7,11,3,16,34,49,-15,36
Ballinamalla,8216,8,11,3,16,31,47,-16,36
Glentoran,8216,9,9,5,16,30,45,-15,32
Dungannon,8216,10,6,10,14,41,58,-17,28
Portadown,8216,11,6,4,20,21,54,-33,22
Ballymena,8217,1,17,6,7,70,58,12,57
Crusaders,8217,2,13,10,7,46,31,15,49
Dungannon,8217,3,14,6,10,56,39,17,48
Linfield,8217,4,12,10,8,54,36,18,46
Cliftonville,8217,5,13,6,11,49,43,6,45
Coleraine,8217,6,11,10,9,42,39,3,43
Glenavon,8217,7,8,15,7,42,43,-1,39
Glentoran,8217,8,10,9,11,30,38,-8,39
Portadown,8217,9,9,3,18,30,48,-18,30
Ballinamalla,8217,10,9,3,18,30,59,-29,30
Ards,8217,11,7,6,17,36,51,-15,27
Crusaders,8218,1,17,8,5,54,31,23,59
Linfield,8218,2,14,11,5,57,27,30,53
Cliftonville,8218,3,15,6,9,57,42,15,51
Ballymena,8218,4,12,8,10,54,57,-3,44
Coleraine,8218,5,9,14,7,37,35,2,41
Glenavon,8218,6,10,11,9,45,44,1,41
Glentoran,8218,7,11,6,13,33,38,-5,39
Ards,8218,8,10,3,17,32,53,-21,33
Dungannon,8218,9,7,11,12,44,42,2,32
Ballinamalla,8218,10,9,3,18,30,49,-19,30
Portadown,8218,11,6,9,15,23,48,-25,27
Linfield,8219,1,14,10,6,57,26,31,52
Crusaders,8219,2,15,7,8,48,32,16,52
Coleraine,8219,3,14,10,6,43,31,12,52
Cliftonville,8219,4,14,4,12,46,39,7,46
Ballymena,8219,5,12,8,10,53,55,-2,44
Glenavon,8219,6,11,10,9,48,51,-3,43
Dungannon,8219,7,11,8,11,50,44,6,41
Ards,8219,8,9,8,13,37,43,-6,35
Ballinamalla,8219,9,9,4,17,31,47,-16,31
Portadown,8219,10,9,4,17,24,48,-24,31
Glentoran,8219,11,7,7,16,28,49,-21,28
Linfield,8220,1,15,8,7,61,28,33,53
Ballymena,8220,2,16,5,9,63,61,2,53
Crusaders,8220,3,14,8,8,53,38,15,50
Glenavon,8220,4,14,8,8,43,44,-1,50
Coleraine,8220,5,11,10,9,36,33,3,43
Portadown,8220,6,12,5,13,31,36,-5,41
Dungannon,8220,7,10,8,12,51,49,2,38
Glentoran,8220,8,10,7,13,40,44,-4,37
Cliftonville,8220,9,10,6,14,43,47,-4,36
Ards,8220,10,9,6,15,35,44,-9,33
Ballinamalla,8220,11,6,5,19,20,52,-32,23
Cliftonville,8221,1,19,3,8,65,35,30,60
Crusaders,8221,2,14,11,5,55,39,16,53
Linfield,8221,3,13,9,8,59,37,22,48
Coleraine,8221,4,12,8,10,40,38,2,44
Glenavon,8221,5,11,10,9,49,45,4,43
Ballymena,8221,6,12,6,12,55,66,-11,42
Dungannon,8221,7,10,10,10,56,48,8,40
Glentoran,8221,8,11,6,13,31,45,-14,39
Ards,8221,9,10,3,17,33,50,-17,33
Ballinamalla,8221,10,9,4,17,40,52,-12,31
Portadown,8221,11,7,4,19,19,47,-28,25
Linfield,8222,1,18,9,3,58,22,36,63
Crusaders,8222,2,18,9,3,65,33,32,63
Cliftonville,8222,3,18,4,8,57,37,20,58
Glenavon,8222,4,11,11,8,43,41,2,44
Coleraine,8222,5,11,10,9,38,37,1,43
Ballymena,8222,6,13,4,13,55,59,-4,43
Dungannon,8222,7,8,10,12,47,47,0,34
Glentoran,8222,8,9,6,15,29,45,-16,33
Portadown,8222,9,7,8,15,27,45,-18,29
Ards,8222,10,7,4,19,31,53,-22,25
Ballinamalla,8222,11,6,3,21,26,57,-31,21
Crusaders,8223,1,15,10,5,54,29,25,55
Cliftonville,8223,2,16,7,7,53,34,19,55
Linfield,8223,3,14,9,7,54,34,20,51
Ballymena,8223,4,13,7,10,57,58,-1,46
Glenavon,8223,5,11,11,8,50,49,1,44
Dungannon,8223,6,10,10,10,47,38,9,40
Ards,8223,7,12,4,14,41,51,-10,40
Coleraine,8223,8,9,12,9,39,39,0,39
Glentoran,8223,9,7,9,14,29,47,-18,30
Ballinamalla,8223,10,7,8,15,29,51,-22,29
Portadown,8223,11,5,5,20,24,47,-23,20
Cliftonville,8224,1,16,6,8,57,39,18,54
Linfield,8224,2,14,10,6,62,34,28,52
Crusaders,8224,3,14,10,6,50,34,16,52
Ballymena,8224,4,12,6,12,56,66,-10,42
Glenavon,8224,5,10,11,9,40,40,0,41
Ards,8224,6,12,4,14,43,47,-4,40
Coleraine,8224,7,9,11,10,38,37,1,38
Glentoran,8224,8,9,9,12,31,43,-12,36
Portadown,8224,9,9,7,14,38,48,-10,34
Dungannon,8224,10,7,10,13,41,45,-4,31
Ballinamalla,8224,11,8,6,16,25,48,-23,30
Crusaders,8225,1,17,7,6,54,36,18,58
Ballymena,8225,2,13,7,10,57,59,-2,46
Linfield,8225,3,12,9,9,55,35,20,45
Cliftonville,8225,4,12,8,10,53,43,10,44
Coleraine,8225,5,11,11,8,38,34,4,44
Glentoran,8225,6,12,8,10,38,36,2,44
Glenavon,8225,7,11,10,9,47,48,-1,43
Dungannon,8225,8,9,9,12,46,42,4,36
Ards,8225,9,9,6,15,35,51,-16,33
Ballinamalla,8225,10,10,2,18,34,52,-18,32
Portadown,8225,11,8,5,17,25,46,-21,29
Crusaders,8226,1,15,8,7,56,34,22,53
Ballymena,8226,2,15,7,8,63,52,11,52
Linfield,8226,3,13,9,8,52,34,18,48
Ards,8226,4,14,4,12,39,39,0,46
Coleraine,8226,5,12,9,9,42,41,1,45
Glenavon,8226,6,12,8,10,47,50,-3,44
Cliftonville,8226,7,12,5,13,48,45,3,41
Dungannon,8226,8,11,7,12,56,51,5,40
Portadown,8226,9,10,4,16,21,36,-15,34
Glentoran,8226,10,6,9,15,31,49,-18,27
Ballinamalla,8226,11,7,6,17,29,53,-24,27
Cliftonville,8227,1,16,6,8,56,35,21,54
Ballymena,8227,2,14,10,6,59,50,9,52
Crusaders,8227,3,14,9,7,55,35,20,51
Linfield,8227,4,13,10,7,57,29,28,49
Glenavon,8227,5,13,9,8,50,47,3,48
Coleraine,8227,6,13,9,8,40,38,2,48
Glentoran,8227,7,9,8,13,30,54,-24,35
Dungannon,8227,8,8,9,13,45,49,-4,33
Ballinamalla,8227,9,8,7,15,28,46,-18,31
Ards,8227,10,6,7,17,37,51,-14,25
Portadown,8227,11,6,6,18,22,45,-23,24
Cliftonville,8228,1,16,6,8,55,36,19,54
Linfield,8228,2,13,13,4,60,29,31,52
Crusaders,8228,3,15,6,9,57,45,12,51
Glenavon,8228,4,12,9,9,51,48,3,45
Coleraine,8228,5,10,13,7,50,45,5,43
Glentoran,8228,6,11,8,11,36,44,-8,41
Ballymena,8228,7,11,7,12,58,63,-5,40
Dungannon,8228,8,9,10,11,51,46,5,37
Portadown,8228,9,9,6,15,26,45,-19,33
Ballinamalla,8228,10,9,3,18,30,54,-24,30
Ards,8228,11,6,7,17,35,54,-19,25
Cliftonville,8229,1,18,4,8,59,42,17,58
Linfield,8229,2,16,7,7,56,31,25,55
Coleraine,8229,3,14,8,8,45,37,8,50
Crusaders,8229,4,14,7,9,51,42,9,49
Dungannon,8229,5,13,9,8,56,40,16,48
Glenavon,8229,6,11,11,8,48,42,6,44
Ballymena,8229,7,13,5,12,56,62,-6,44
Glentoran,8229,8,11,6,13,28,40,-12,39
Ards,8229,9,5,9,16,37,55,-18,24
Portadown,8229,10,6,6,18,29,52,-23,24
Ballinamalla,8229,11,6,4,20,25,47,-22,22
Cliftonville,8230,1,19,6,5,57,31,26,63
Crusaders,8230,2,17,9,4,57,31,26,60
Linfield,8230,3,14,9,7,57,31,26,51
Glenavon,8230,4,12,13,5,45,36,9,49
Ballymena,8230,5,12,8,10,53,56,-3,44
Coleraine,8230,6,9,10,11,32,33,-1,37
Dungannon,8230,7,8,10,12,43,45,-2,34
Ards,8230,8,10,3,17,39,50,-11,33
Portadown,8230,9,9,4,17,24,44,-20,31
Glentoran,8230,10,8,4,18,21,50,-29,28
Ballinamalla,8230,11,7,4,19,26,47,-21,25
Crusaders,8231,1,19,4,7,61,37,24,61
Linfield,8231,2,16,7,7,59,27,32,55
Cliftonville,8231,3,16,6,8,54,36,18,54
Dungannon,8231,4,13,7,10,56,47,9,46
Glenavon,8231,5,11,10,9,51,46,5,43
Glentoran,8231,6,12,7,11,37,42,-5,43
Ballymena,8231,7,12,7,11,51,58,-7,43
Coleraine,8231,8,9,10,11,35,43,-8,37
Portadown,8231,9,7,6,17,25,48,-23,27
Ards,8231,10,7,5,18,35,56,-21,26
Ballinamalla,8231,11,6,5,19,32,56,-24,23
Linfield,8232,1,15,8,7,56,29,27,53
Crusaders,8232,2,15,7,8,52,35,17,52
Glenavon,8232,3,13,11,6,52,42,10,50
Cliftonville,8232,4,15,4,11,47,37,10,49
Dungannon,8232,5,12,11,7,57,40,17,47
Coleraine,8232,6,11,12,7,46,39,7,45
Ballymena,8232,7,13,6,11,54,57,-3,45
Glentoran,8232,8,7,12,11,30,41,-11,33
Ballinamalla,8232,9,10,3,17,31,55,-24,33
Ards,8232,10,9,5,16,36,50,-14,32
Portadown,8232,11,3,5,22,20,56,-36,14
Crusaders,8233,1,18,10,2,61,33,28,64
Linfield,8233,2,13,10,7,63,38,25,49
Ballymena,8233,3,13,8,9,64,66,-2,47
Cliftonville,8233,4,13,5,12,48,41,7,44
Dungannon,8233,5,10,11,9,51,43,8,41
Coleraine,8233,6,10,10,10,35,41,-6,40
Glentoran,8233,7,10,8,12,45,44,1,38
Glenavon,8233,8,8,14,8,47,49,-2,38
Ards,8233,9,8,9,13,38,45,-7,33
Ballinamalla,8233,10,10,2,18,30,51,-21,32
Portadown,8233,11,6,5,19,25,56,-31,23
Ballymena,8234,1,17,6,7,59,46,13,57
Crusaders,8234,2,16,7,7,57,36,21,55
Cliftonville,8234,3,15,6,9,51,40,11,51
Linfield,8234,4,13,9,8,59,36,23,48
Glentoran,8234,5,12,8,10,34,36,-2,44
Dungannon,8234,6,11,8,11,50,47,3,41
Coleraine,8234,7,10,10,10,42,47,-5,40
Ards,8234,8,10,6,14,37,43,-6,36
Glenavon,8234,9,8,11,11,47,55,-8,35
Ballinamalla,8234,10,7,3,20,29,56,-27,24
Portadown,8234,11,5,8,17,23,46,-23,23
Linfield,8235,1,17,9,4,66,26,40,60
Cliftonville,8235,2,16,6,8,53,36,17,54
Glenavon,8235,3,15,9,6,49,35,14,54
Crusaders,8235,4,15,6,9,53,35,18,51
Coleraine,8235,5,14,7,9,45,37,8,49
Ballymena,8235,6,12,5,13,51,66,-15,41
Ballinamalla,8235,7,10,2,18,34,49,-15,32
Glentoran,8235,8,8,8,14,26,46,-20,32
Dungannon,8235,9,7,9,14,41,45,-4,30
Portadown,8235,10,8,6,16,28,51,-23,30
Ards,8235,11,7,5,18,31,51,-20,26
Crusaders,8236,1,18,5,7,61,33,28,59
Linfield,8236,2,15,8,7,59,32,27,53
Ballymena,8236,3,14,9,7,57,54,3,51
Glenavon,8236,4,12,10,8,46,43,3,46
Cliftonville,8236,5,13,5,12,54,44,10,44
Coleraine,8236,6,9,11,10,39,42,-3,38
Ballinamalla,8236,7,11,3,16,32,46,-14,36
Portadown,8236,8,9,8,13,30,44,-14,35
Dungannon,8236,9,8,9,13,41,43,-2,33
Ards,8236,10,8,6,16,40,55,-15,30
Glentoran,8236,11,7,8,15,25,48,-23,29
Crusaders,8237,1,18,9,3,65,26,39,63
Linfield,8237,2,15,9,6,63,32,31,54
Cliftonville,8237,3,16,6,8,53,36,17,54
Glenavon,8237,4,13,12,5,55,40,15,51
Ballymena,8237,5,14,5,11,55,60,-5,47
Dungannon,8237,6,10,8,12,46,43,3,38
Coleraine,8237,7,9,11,10,40,45,-5,38
Ards,8237,8,8,5,17,38,57,-19,29
Glentoran,8237,9,7,8,15,36,59,-23,29
Ballinamalla,8237,10,8,4,18,32,61,-29,28
Portadown,8237,11,4,9,17,22,46,-24,21
Cliftonville,8238,1,17,6,7,59,36,23,57
Linfield,8238,2,14,11,5,70,38,32,53
Crusaders,8238,3,15,8,7,58,35,23,53
Coleraine,8238,4,13,9,8,49,41,8,48
Ballymena,8238,5,13,6,11,51,62,-11,45
Dungannon,8238,6,11,10,9,60,42,18,43
Glentoran,8238,7,10,8,12,40,45,-5,38
Glenavon,8238,8,9,10,11,42,50,-8,37
Ards,8238,9,8,7,15,39,54,-15,31
Ballinamalla,8238,10,6,7,17,25,58,-33,25
Portadown,8238,11,5,6,19,18,50,-32,21
Linfield,8239,1,13,14,3,61,31,30,53
Crusaders,8239,2,15,7,8,51,34,17,52
Ballymena,8239,3,14,7,9,62,60,2,49
Cliftonville,8239,4,13,9,8,54,40,14,48
Glenavon,8239,5,12,10,8,53,47,6,46
Coleraine,8239,6,10,13,7,40,36,4,43
Dungannon,8239,7,11,9,10,56,43,13,42
Ards,8239,8,12,6,12,42,41,1,42
Glentoran,8239,9,8,7,15,31,51,-20,31
Portadown,8239,10,7,3,20,23,59,-36,24
Ballinamalla,8239,11,6,3,21,24,55,-31,21
Crusaders,8240,1,18,8,4,64,30,34,62
Cliftonville,8240,2,17,5,8,61,45,16,56
Glenavon,8240,3,13,10,7,46,41,5,49
Dungannon,8240,4,13,9,8,59,40,19,48
Linfield,8240,5,12,8,10,59,40,19,44
Ballymena,8240,6,11,9,10,56,64,-8,42
Coleraine,8240,7,9,10,11,37,38,-1,37
Ards,8240,8,11,4,15,41,49,-8,37
Glentoran,8240,9,9,6,15,33,54,-21,33
Ballinamalla,8240,10,7,4,19,23,50,-27,25
Portadown,8240,11,6,5,19,22,50,-28,23
Crusaders,8241,1,20,7,3,62,29,33,67
Linfield,8241,2,13,12,5,57,32,25,51
Ballymena,8241,3,15,5,10,52,48,4,50
Cliftonville,8241,4,14,6,10,50,40,10,48
Coleraine,8241,5,13,9,8,44,34,10,48
Glenavon,8241,6,11,12,7,48,44,4,45
Glentoran,8241,7,10,6,14,30,49,-19,36
Dungannon,8241,8,8,10,12,46,43,3,34
Ards,8241,9,7,5,18,28,44,-16,26
Portadown,8241,10,7,5,18,23,52,-29,26
Ballinamalla,8241,11,5,7,18,28,53,-25,22
Cliftonville,8242,1,18,4,8,60,44,16,58
Linfield,8242,2,16,9,5,66,33,33,57
Crusaders,8242,3,13,10,7,46,32,14,49
Glenavon,8242,4,12,12,6,52,43,9,48
Dungannon,8242,5,12,8,10,58,42,16,44
Ballymena,8242,6,12,6,12,64,62,2,42
Coleraine,8242,7,9,10,11,44,45,-1,37
Portadown,8242,8,9,5,16,24,54,-30,32
Glentoran,8242,9,7,9,14,30,47,-17,30
Ballinamalla,8242,10,8,6,16,24,47,-23,30
Ards,8242,11,6,7,17,25,44,-19,25
Ballymena,8243,1,18,5,7,62,47,15,59
Crusaders,8243,2,15,11,4,57,33,24,56
Linfield,8243,3,14,9,7,57,29,28,51
Cliftonville,8243,4,15,5,10,51,39,12,50
Glenavon,8243,5,11,15,4,44,36,8,48
Coleraine,8243,6,10,11,9,36,37,-1,41
Dungannon,8243,7,8,14,8,48,39,9,38
Glentoran,8243,8,10,8,12,30,42,-12,38
Ards,8243,9,7,7,16,33,51,-18,28
Ballinamalla,8243,10,6,5,19,24,53,-29,23
Portadown,8243,11,3,6,21,14,50,-36,15
Linfield,8244,1,17,7,6,65,31,34,58
Crusaders,8244,2,15,11,4,61,37,24,56
Ballymena,8244,3,15,6,9,55,49,6,51
Coleraine,8244,4,11,13,6,44,36,8,46
Cliftonville,8244,5,13,7,10,47,41,6,46
Glenavon,8244,6,12,10,8,50,45,5,46
Glentoran,8244,7,9,8,13,30,43,-13,35
Dungannon,8244,8,7,10,13,45,50,-5,31
Ards,8244,9,8,5,17,38,52,-14,29
Portadown,8244,10,7,7,16,20,40,-20,28
Ballinamalla,8244,11,7,4,19,23,54,-31,25
Linfield,8245,1,16,9,5,60,31,29,57
Crusaders,8245,2,16,9,5,58,36,22,57
Glenavon,8245,3,13,11,6,42,36,6,50
Ballymena,8245,4,13,7,10,63,63,0,46
Glentoran,8245,5,12,7,11,40,43,-3,43
Dungannon,8245,6,10,9,11,50,48,2,39
Cliftonville,8245,7,11,5,14,51,53,-2,38
Ards,8245,8,10,6,14,42,48,-6,36
Coleraine,8245,9,8,11,11,42,46,-4,35
Ballinamalla,8245,10,7,6,17,32,52,-20,27
Portadown,8245,11,7,4,19,22,46,-24,25
Cliftonville,8246,1,16,7,7,56,40,16,55
Crusaders,8246,2,16,7,7,51,36,15,55
Linfield,8246,3,13,11,6,55,31,24,50
Coleraine,8246,4,12,10,8,53,37,16,46
Glenavon,8246,5,11,10,9,48,48,0,43
Dungannon,8246,6,10,9,11,48,48,0,39
Glentoran,8246,7,10,9,11,37,44,-7,39
Ards,8246,8,11,5,14,40,45,-5,38
Ballymena,8246,9,10,7,13,52,67,-15,37
Ballinamalla,8246,10,7,5,18,27,52,-25,26
Portadown,8246,11,5,8,17,25,44,-19,23
Linfield,8247,1,17,9,4,59,26,33,60
Crusaders,8247,2,17,8,5,61,34,27,59
Coleraine,8247,3,13,9,8,47,37,10,48
Dungannon,8247,4,13,8,9,59,41,18,47
Cliftonville,8247,5,13,6,11,48,42,6,45
Ballymena,8247,6,12,5,13,46,58,-12,41
Glenavon,8247,7,9,9,12,39,49,-10,36
Portadown,8247,8,9,7,14,23,37,-14,34
Ballinamalla,8247,9,9,4,17,30,49,-19,31
Glentoran,8247,10,6,9,15,32,47,-15,27
Ards,8247,11,7,6,17,33,57,-24,27
Crusaders,8248,1,16,8,6,56,37,19,56
Cliftonville,8248,2,16,3,11,50,38,12,51
Coleraine,8248,3,13,11,6,50,45,5,50
Ballymena,8248,4,14,5,11,56,56,0,47
Linfield,8248,5,11,9,10,54,34,20,42
Glenavon,8248,6,11,9,10,44,45,-1,42
Dungannon,8248,7,9,13,8,48,38,10,40
Ards,8248,8,11,4,15,48,53,-5,37
Portadown,8248,9,10,4,16,31,43,-12,34
Glentoran,8248,10,9,5,16,27,45,-18,32
Ballinamalla,8248,11,7,5,18,23,53,-30,26
Linfield,8249,1,17,8,5,69,29,40,59
Crusaders,8249,2,15,5,10,56,45,11,50
Coleraine,8249,3,13,10,7,39,30,9,49
Glenavon,8249,4,13,9,8,50,41,9,48
Ballymena,8249,5,13,6,11,57,60,-3,45
Cliftonville,8249,6,11,7,12,48,46,2,40
Ards,8249,7,11,4,15,43,49,-6,37
Glentoran,8249,8,9,9,12,40,50,-10,36
Dungannon,8249,9,8,8,14,51,51,0,32
Ballinamalla,8249,10,9,5,16,29,55,-26,32
Portadown,8249,11,8,5,17,26,52,-26,29
Linfield,8250,1,17,10,3,61,25,36,61
Crusaders,8250,2,17,7,6,57,38,19,58
Ballymena,8250,3,13,9,8,58,55,3,48
Cliftonville,8250,4,15,2,13,55,42,13,47
Glenavon,8250,5,11,9,10,44,50,-6,42
Dungannon,8250,6,10,10,10,53,45,8,40
Coleraine,8250,7,10,8,12,40,43,-3,38
Ards,8250,8,9,6,15,33,44,-11,33
Portadown,8250,9,8,7,15,31,47,-16,31
Glentoran,8250,10,8,6,16,32,51,-19,30
Ballinamalla,8250,11,8,4,18,26,50,-24,28
Cliftonville,8251,1,16,6,8,61,37,24,54
Crusaders,8251,2,15,8,7,51,32,19,53
Coleraine,8251,3,14,11,5,45,30,15,53
Linfield,8251,4,14,9,7,53,32,21,51
Glenavon,8251,5,13,9,8,45,36,9,48
Ballymena,8251,6,14,5,11,54,60,-6,47
Dungannon,8251,7,11,8,11,50,44,6,41
Glentoran,8251,8,10,7,13,27,37,-10,37
Ards,8251,9,8,7,15,32,45,-13,31
Ballinamalla,8251,10,6,3,21,25,54,-29,21
Portadown,8251,11,4,7,19,18,54,-36,19
Cliftonville,8252,1,16,7,7,53,34,19,55
Crusaders,8252,2,15,7,8,54,34,20,52
Ballymena,8252,3,14,6,10,54,54,0,48
Linfield,8252,4,13,8,9,55,39,16,47
Dungannon,8252,5,12,8,10,56,43,13,44
Coleraine,8252,6,11,11,8,40,35,5,44
Glenavon,8252,7,11,10,9,56,56,0,43
Portadown,8252,8,11,7,12,27,39,-12,40
Glentoran,8252,9,6,11,13,33,55,-22,29
Ballinamalla,8252,10,7,7,16,35,52,-17,28
Ards,8252,11,6,4,20,32,54,-22,22
Crusaders,8253,1,20,7,3,66,31,35,67
Linfield,8253,2,14,8,8,58,34,24,50
Coleraine,8253,3,12,11,7,50,40,10,47
Glenavon,8253,4,12,9,9,48,48,0,45
Cliftonville,8253,5,12,8,10,45,41,4,44
Ballymena,8253,6,12,6,12,55,64,-9,42
Dungannon,8253,7,9,8,13,47,43,4,35
Ards,8253,8,10,5,15,38,56,-18,35
Ballinamalla,8253,9,10,3,17,32,46,-14,33
Glentoran,8253,10,8,6,16,26,43,-17,30
Portadown,8253,11,8,5,17,30,49,-19,29
Crusaders,8254,1,18,6,6,64,37,27,60
Ballymena,8254,2,14,8,8,56,54,2,50
Linfield,8254,3,12,13,5,54,31,23,49
Cliftonville,8254,4,13,7,10,47,40,7,46
Ards,8254,5,13,4,13,40,41,-1,43
Coleraine,8254,6,9,14,7,42,35,7,41
Glenavon,8254,7,10,11,9,49,51,-2,41
Dungannon,8254,8,11,6,13,52,46,6,39
Ballinamalla,8254,9,8,5,17,32,54,-22,29
Glentoran,8254,10,6,8,16,28,50,-22,26
Portadown,8254,11,6,8,16,26,51,-25,26
Crusaders,8255,1,16,9,5,51,32,19,57
Linfield,8255,2,16,8,6,59,28,31,56
Cliftonville,8255,3,15,4,11,51,38,13,49
Glenavon,8255,4,13,10,7,49,44,5,49
Ballymena,8255,5,14,6,10,61,59,2,48
Coleraine,8255,6,12,8,10,39,36,3,44
Glentoran,8255,7,10,8,12,37,42,-5,38
Ards,8255,8,10,3,17,42,53,-11,33
Dungannon,8255,9,6,14,10,44,44,0,32
Portadown,8255,10,7,5,18,29,58,-29,26
Ballinamalla,8255,11,6,5,19,27,55,-28,23
Linfield,8256,1,16,8,6,61,28,33,56
Crusaders,8256,2,15,10,5,56,33,23,55
Ballymena,8256,3,14,7,9,55,56,-1,49
Glentoran,8256,4,12,7,11,37,41,-4,43
Glenavon,8256,5,10,12,8,53,49,4,42
Coleraine,8256,6,11,9,10,41,41,0,42
Cliftonville,8256,7,12,5,13,49,41,8,41
Dungannon,8256,8,11,8,11,54,47,7,41
Ballinamalla,8256,9,11,1,18,29,53,-24,34
Ards,8256,10,9,5,16,40,53,-13,32
Portadown,8256,11,5,6,19,19,52,-33,21
Crusaders,8257,1,19,6,5,55,25,30,63
Cliftonville,8257,2,15,6,9,51,38,13,51
Linfield,8257,3,13,10,7,58,32,26,49
Ballymena,8257,4,13,7,10,52,53,-1,46
Dungannon,8257,5,10,11,9,49,41,8,41
Glenavon,8257,6,10,10,10,44,42,2,40
Coleraine,8257,7,10,9,11,35,40,-5,39
Glentoran,8257,8,9,10,11,31,43,-12,37
Portadown,8257,9,9,5,16,27,45,-18,32
Ards,8257,10,8,5,17,31,51,-20,29
Ballinamalla,8257,11,5,9,16,27,50,-23,24
Crusaders,8258,1,15,8,7,57,35,22,53
Cliftonville,8258,2,14,6,10,56,45,11,48
Linfield,8258,3,12,10,8,52,34,18,46
Glenavon,8258,4,12,10,8,46,43,3,46
Ballymena,8258,5,13,7,10,59,64,-5,46
Coleraine,8258,6,10,12,8,35,34,1,42
Dungannon,8258,7,10,9,11,44,39,5,39
Glentoran,8258,8,10,8,12,37,42,-5,38
Ards,8258,9,10,6,14,42,45,-3,36
Portadown,8258,10,8,5,17,30,50,-20,29
Ballinamalla,8258,11,7,7,16,30,57,-27,28
Cliftonville,8259,1,17,6,7,61,38,23,57
Coleraine,8259,2,13,12,5,44,34,10,51
Crusaders,8259,3,15,5,10,57,44,13,50
Dungannon,8259,4,12,8,10,49,42,7,44
Linfield,8259,5,10,12,8,60,40,20,42
Ballymena,8259,6,12,5,13,56,65,-9,41
Glenavon,8259,7,9,10,11,46,50,-4,37
Ballinamalla,8259,8,10,6,14,31,44,-13,36
Ards,8259,9,10,4,16,44,56,-12,34
Glentoran,8259,10,8,8,14,31,45,-14,32
Portadown,8259,11,7,8,15,24,45,-21,29
Crusaders,8260,1,19,6,5,60,36,24,63
Cliftonville,8260,2,16,7,7,53,34,19,55
Linfield,8260,3,13,9,8,58,36,22,48
Glenavon,8260,4,13,9,8,54,46,8,48
Coleraine,8260,5,12,9,9,45,37,8,45
Ballymena,8260,6,12,7,11,50,59,-9,43
Dungannon,8260,7,11,9,10,49,40,9,42
Ards,8260,8,8,7,15,33,44,-11,31
Glentoran,8260,9,7,9,14,28,49,-21,30
Portadown,8260,10,7,5,18,26,48,-22,26
Ballinamalla,8260,11,7,3,20,27,54,-27,24
Crusaders,8261,1,19,7,4,66,35,31,64
Ballymena,8261,2,16,6,8,73,61,12,54
Linfield,8261,3,13,10,7,65,44,21,49
Cliftonville,8261,4,14,6,10,52,41,11,48
Dungannon,8261,5,11,9,10,48,39,9,42
Glenavon,8261,6,10,12,8,47,44,3,42
Coleraine,8261,7,11,9,10,41,41,0,42
Ards,8261,8,10,4,16,35,52,-17,34
Glentoran,8261,9,8,8,14,31,48,-17,32
Portadown,8261,10,6,9,15,26,47,-21,27
Ballinamalla,8261,11,4,6,20,26,58,-32,18
Crusaders,8262,1,17,8,5,54,31,23,59
Ballymena,8262,2,17,5,8,64,55,9,56
Linfield,8262,3,14,7,9,59,39,20,49
Glenavon,8262,4,13,9,8,46,46,0,48
Cliftonville,8262,5,13,6,11,49,41,8,45
Coleraine,8262,6,10,13,7,44,40,4,43
Dungannon,8262,7,9,8,13,47,49,-2,35
Ballinamalla,8262,8,10,4,16,32,48,-16,34
Ards,8262,9,9,4,17,45,54,-9,31
Portadown,8262,10,7,7,16,25,43,-18,28
Glentoran,8262,11,6,9,15,29,48,-19,27
Crusaders,8263,1,20,8,2,62,26,36,68
Linfield,8263,2,17,7,6,61,31,30,58
Glenavon,8263,3,15,9,6,54,39,15,54
Cliftonville,8263,4,15,5,10,52,38,14,50
Ballymena,8263,5,14,7,9,51,54,-3,49
Coleraine,8263,6,10,13,7,41,37,4,43
Ards,8263,7,9,5,16,35,48,-13,32
Dungannon,8263,8,6,10,14,43,50,-7,28
Glentoran,8263,9,6,9,15,25,44,-19,27
Portadown,8263,10,6,6,18,23,51,-28,24
Ballinamalla,8263,11,5,5,20,26,55,-29,20
Crusaders,8264,1,17,7,6,51,36,15,58
Linfield,8264,2,14,10,6,55,28,27,52
Glenavon,8264,3,14,10,6,56,39,17,52
Cliftonville,8264,4,13,6,11,54,42,12,45
Ballymena,8264,5,12,8,10,51,57,-6,44
Glentoran,8264,6,11,7,12,39,44,-5,40
Dungannon,8264,7,10,9,11,50,44,6,39
Coleraine,8264,8,8,12,10,38,40,-2,36
Ards,8264,9,9,5,16,34,49,-15,32
Ballinamalla,8264,10,9,3,18,33,61,-28,30
Portadown,8264,11,5,9,16,26,47,-21,24
Linfield,8265,1,16,7,7,71,33,38,55
Cliftonville,8265,2,17,4,9,50,37,13,55
Crusaders,8265,3,15,6,9,53,35,18,51
Coleraine,8265,4,13,10,7,48,38,10,49
Dungannon,8265,5,12,9,9,47,39,8,45
Ballymena,8265,6,13,6,11,51,56,-5,45
Ballinamalla,8265,7,11,5,14,36,44,-8,38
Glenavon,8265,8,10,8,12,42,54,-12,38
Glentoran,8265,9,8,7,15,28,48,-20,31
Portadown,8265,10,8,4,18,30,55,-25,28
Ards,8265,11,7,4,19,37,54,-17,25
Linfield,8266,1,17,10,3,65,28,37,61
Coleraine,8266,2,15,9,6,54,39,15,54
Crusaders,8266,3,14,8,8,47,33,14,50
Cliftonville,8266,4,15,4,11,50,43,7,49
Ballymena,8266,5,14,4,12,65,59,6,46
Glenavon,8266,6,10,11,9,44,41,3,41
Dungannon,8266,7,8,10,12,42,43,-1,34
Ards,8266,8,9,5,16,38,50,-12,32
Portadown,8266,9,8,7,15,26,48,-22,31
Glentoran,8266,10,7,8,15,22,47,-25,29
Ballinamalla,8266,11,8,4,18,29,51,-22,28
Crusaders,8267,1,16,7,7,57,40,17,55
Linfield,8267,2,15,9,6,59,34,25,54
Cliftonville,8267,3,14,7,9,51,37,14,49
Ballymena,8267,4,13,8,9,64,62,2,47
Ards,8267,5,12,4,14,41,46,-5,40
Dungannon,8267,6,9,10,11,55,50,5,37
Glenavon,8267,7,9,10,11,47,55,-8,37
Coleraine,8267,8,8,11,11,40,43,-3,35
Portadown,8267,9,9,7,14,27,43,-16,34
Glentoran,8267,10,7,12,11,30,44,-14,33
Ballinamalla,8267,11,9,3,18,36,53,-17,30
Crusaders,8268,1,17,6,7,54,34,20,57
Ballymena,8268,2,17,5,8,55,49,6,56
Coleraine,8268,3,14,11,5,50,33,17,53
Cliftonville,8268,4,16,2,12,54,44,10,50
Glenavon,8268,5,13,11,6,48,39,9,50
Linfield,8268,6,12,9,9,57,34,23,45
Dungannon,8268,7,10,10,10,49,44,5,40
Glentoran,8268,8,9,10,11,28,38,-10,37
Ards,8268,9,7,5,18,29,50,-21,26
Portadown,8268,10,6,5,19,21,47,-26,23
Ballinamalla,8268,11,5,4,21,22,55,-33,19
Crusaders,8269,1,16,10,4,55,26,29,58
Linfield,8269,2,15,12,3,64,29,35,57
Coleraine,8269,3,14,10,6,52,37,15,52
Cliftonville,8269,4,15,6,9,59,38,21,51
Glenavon,8269,5,13,11,6,53,46,7,50
Ballymena,8269,6,12,6,12,56,64,-8,42
Dungannon,8269,7,10,7,13,52,50,2,37
Glentoran,8269,8,7,9,14,32,53,-21,30
Ards,8269,9,7,7,16,38,53,-15,28
Ballinamalla,8269,10,7,4,19,28,56,-28,25
Portadown,8269,11,6,4,20,29,66,-37,22
Crusaders,8270,1,18,4,8,53,34,19,58
Ballymena,8270,2,17,5,8,63,54,9,56
Linfield,8270,3,15,10,5,62,31,31,55
Cliftonville,8270,4,15,6,9,53,39,14,51
Coleraine,8270,5,11,11,8,40,41,-1,44
Glenavon,8270,6,11,10,9,45,43,2,43
Dungannon,8270,7,11,9,10,52,43,9,42
Ards,8270,8,10,6,14,36,44,-8,36
Glentoran,8270,9,7,6,17,30,50,-20,27
Ballinamalla,8270,10,7,3,20,27,57,-30,24
Portadown,8270,11,6,4,20,22,47,-25,22
Linfield,8271,1,15,10,5,63,32,31,55
Crusaders,8271,2,15,9,6,53,34,19,54
Cliftonville,8271,3,14,9,7,54,41,13,51
Coleraine,8271,4,11,12,7,49,36,13,45
Ballymena,8271,5,11,7,12,54,66,-12,40
Dungannon,8271,6,10,9,11,49,43,6,39
Ards,8271,7,10,7,13,39,47,-8,37
Glenavon,8271,8,8,12,10,35,39,-4,36
Ballinamalla,8271,9,11,3,16,31,49,-18,36
Portadown,8271,10,7,8,15,24,43,-19,29
Glentoran,8271,11,7,6,17,33,54,-21,27
Crusaders,8272,1,18,7,5,59,37,22,61
Linfield,8272,2,15,8,7,50,29,21,53
Ballymena,8272,3,14,9,7,55,53,2,51
Dungannon,8272,4,13,9,8,63,38,25,48
Cliftonville,8272,5,14,4,12,46,38,8,46
Glenavon,8272,6,10,12,8,50,47,3,42
Coleraine,8272,7,10,12,8,38,38,0,42
Ards,8272,8,9,5,16,39,49,-10,32
Glentoran,8272,9,7,8,15,28,46,-18,29
Portadown,8272,10,6,6,18,25,49,-24,24
Ballinamalla,8272,11,6,6,18,27,56,-29,24
Crusaders,8273,1,16,7,7,56,39,17,55
Linfield,8273,2,15,9,6,59,30,29,54
Cliftonville,8273,3,15,5,10,49,35,14,50
Ballymena,8273,4,14,5,11,59,57,2,47
Dungannon,8273,5,12,9,9,53,44,9,45
Coleraine,8273,6,10,13,7,39,35,4,43
Glentoran,8273,7,10,9,11,34,40,-6,39
Glenavon,8273,8,8,13,9,43,48,-5,37
Ballinamalla,8273,9,10,2,18,35,52,-17,32
Ards,8273,10,8,5,17,32,51,-19,29
Portadown,8273,11,6,5,19,25,53,-28,23
Crusaders,8274,1,20,7,3,65,32,33,67
Linfield,8274,2,15,10,5,60,29,31,55
Glenavon,8274,3,12,11,7,48,39,9,47
Cliftonville,8274,4,14,4,12,44,40,4,46
Ballymena,8274,5,14,4,12,53,57,-4,46
Coleraine,8274,6,11,11,8,47,40,7,44
Glentoran,8274,7,9,8,13,33,48,-15,35
Ards,8274,8,9,6,15,37,52,-15,33
Dungannon,8274,9,8,8,14,45,47,-2,32
Portadown,8274,10,7,7,16,20,43,-23,28
Ballinamalla,8274,11,6,4,20,27,52,-25,22
Crusaders,8275,1,18,8,4,55,30,25,62
Linfield,8275,2,15,10,5,61,30,31,55
Ballymena,8275,3,16,7,7,63,54,9,55
Cliftonville,8275,4,12,6,12,56,51,5,42
Glenavon,8275,5,10,11,9,46,46,0,41
Coleraine,8275,6,9,11,10,37,41,-4,38
Ballinamalla,8275,7,9,7,14,33,50,-17,34
Ards,8275,8,9,6,15,37,50,-13,33
Portadown,8275,9,9,5,16,29,45,-16,32
Dungannon,8275,10,6,11,13,43,44,-1,29
Glentoran,8275,11,7,8,15,30,49,-19,29
Crusaders,8276,1,20,7,3,59,25,34,67
Linfield,8276,2,17,7,6,59,33,26,58
Ballymena,8276,3,14,8,8,59,61,-2,50
Cliftonville,8276,4,14,6,10,59,44,15,48
Coleraine,8276,5,12,12,6,41,32,9,48
Dungannon,8276,6,11,8,11,52,46,6,41
Glenavon,8276,7,9,10,11,45,53,-8,37
Ards,8276,8,9,6,15,35,46,-11,33
Ballinamalla,8276,9,8,4,18,32,46,-14,28
Glentoran,8276,10,5,8,17,22,47,-25,23
Portadown,8276,11,6,4,20,20,50,-30,22
Crusaders,8277,1,20,4,6,60,34,26,64
Cliftonville,8277,2,17,5,8,53,33,20,56
Glenavon,8277,3,13,11,6,59,50,9,50
Ballymena,8277,4,14,6,10,55,53,2,48
Linfield,8277,5,12,10,8,54,35,19,46
Coleraine,8277,6,10,14,6,39,34,5,44
Dungannon,8277,7,11,9,10,54,47,7,42
Ards,8277,8,8,8,14,38,45,-7,32
Glentoran,8277,9,7,8,15,25,43,-18,29
Ballinamalla,8277,10,7,4,19,26,54,-28,25
Portadown,8277,11,3,7,20,22,57,-35,16
Crusaders,8278,1,22,4,4,67,26,41,70
Cliftonville,8278,2,16,5,9,54,36,18,53
Linfield,8278,3,14,10,6,56,29,27,52
Ballymena,8278,4,15,7,8,58,58,0,52
Glenavon,8278,5,11,11,8,44,46,-2,44
Coleraine,8278,6,11,9,10,45,43,2,42
Dungannon,8278,7,11,8,11,47,40,7,41
Ards,8278,8,9,6,15,37,48,-11,33
Glentoran,8278,9,5,9,16,26,51,-25,24
Ballinamalla,8278,10,7,3,20,25,56,-31,24
Portadown,8278,11,5,6,19,20,46,-26,21
Crusaders,8279,1,19,7,4,58,31,27,64
Cliftonville,8279,2,18,3,9,49,33,16,57
Linfield,8279,3,14,11,5,65,32,33,53
Ballymena,8279,4,13,6,11,59,61,-2,45
Coleraine,8279,5,11,11,8,47,39,8,44
Dungannon,8279,6,10,8,12,53,45,8,38
Glenavon,8279,7,8,11,11,44,59,-15,35
Ballinamalla,8279,8,10,3,17,34,52,-18,33
Portadown,8279,9,8,6,16,25,44,-19,30
Ards,8279,10,7,8,15,39,53,-14,29
Glentoran,8279,11,7,6,17,29,53,-24,27
Ballymena,8280,1,17,5,8,58,51,7,56
Crusaders,8280,2,16,6,8,56,34,22,54
Coleraine,8280,3,12,11,7,41,32,9,47
Cliftonville,8280,4,15,2,13,51,54,-3,47
Glenavon,8280,5,11,12,7,50,39,11,45
Linfield,8280,6,11,11,8,54,35,19,44
Dungannon,8280,7,11,9,10,55,42,13,42
Portadown,8280,8,9,6,15,35,46,-11,33
Ards,8280,9,9,4,17,31,53,-22,31
Ballinamalla,8280,10,8,5,17,29,53,-24,29
Glentoran,8280,11,7,7,16,32,53,-21,28
Linfield,8281,1,14,12,4,58,31,27,54
Crusaders,8281,2,15,9,6,50,32,18,54
Cliftonville,8281,3,15,6,9,55,36,19,51
Glenavon,8281,4,12,12,6,53,43,10,48
Coleraine,8281,5,12,11,7,41,33,8,47
Ballymena,8281,6,13,6,11,56,59,-3,45
Dungannon,8281,7,8,10,12,40,47,-7,34
Glentoran,8281,8,7,11,12,27,41,-14,32
Ards,8281,9,8,4,18,32,49,-17,28
Ballinamalla,8281,10,8,4,18,34,53,-19,28
Portadown,8281,11,7,7,16,26,48,-22,28
Crusaders,8282,1,17,8,5,58,32,26,59
Linfield,8282,2,15,10,5,59,29,30,55
Coleraine,8282,3,11,13,6,44,34,10,46
Cliftonville,8282,4,13,6,11,56,53,3,45
Glenavon,8282,5,10,14,6,44,42,2,44
Ballymena,8282,6,11,8,11,49,56,-7,41
Glentoran,8282,7,9,8,13,37,49,-12,35
Ards,8282,8,8,8,14,41,50,-9,32
Dungannon,8282,9,6,13,11,44,45,-1,31
Ballinamalla,8282,10,9,3,18,36,58,-22,30
Portadown,8282,11,7,7,16,25,45,-20,28
Linfield,8283,1,16,9,5,61,30,31,57
Crusaders,8283,2,16,9,5,52,29,23,57
Cliftonville,8283,3,14,7,9,55,40,15,49
Coleraine,8283,4,11,13,6,42,35,7,46
Ballymena,8283,5,13,7,10,59,57,2,46
Dungannon,8283,6,11,10,9,52,43,9,43
Glenavon,8283,7,10,12,8,40,41,-1,42
Ards,8283,8,8,6,16,38,51,-13,30
Portadown,8283,9,7,8,15,27,44,-17,29
Glentoran,8283,10,7,7,16,28,49,-21,28
Ballinamalla,8283,11,4,8,18,23,58,-35,20
Crusaders,8284,1,20,8,2,66,27,39,68
Linfield,8284,2,14,10,6,66,39,27,52
Cliftonville,8284,3,15,5,10,47,39,8,50
Glenavon,8284,4,11,12,7,55,45,10,45
Ballymena,8284,5,11,7,12,52,67,-15,40
Dungannon,8284,6,10,9,11,52,49,3,39
Coleraine,8284,7,9,11,10,39,39,0,38
Ards,8284,8,10,4,16,37,43,-6,34
Glentoran,8284,9,9,7,14,36,50,-14,34
Portadown,8284,10,8,6,16,27,49,-22,30
Ballinamalla,8284,11,7,3,20,26,56,-30,24
Linfield,8285,1,14,11,5,59,37,22,53
Crusaders,8285,2,15,8,7,51,39,12,53
Cliftonville,8285,3,14,7,9,51,42,9,49
Ballymena,8285,4,13,7,10,55,51,4,46
Glenavon,8285,5,10,13,7,51,44,7,43
Coleraine,8285,6,11,10,9,42,40,2,43
Dungannon,8285,7,8,14,8,56,46,10,38
Ards,8285,8,11,5,14,46,53,-7,38
Glentoran,8285,9,9,6,15,36,47,-11,33
Ballinamalla,8285,10,7,7,16,33,58,-25,28
Portadown,8285,11,6,6,18,26,49,-23,24
Crusaders,8286,1,17,6,7,57,38,19,57
Cliftonville,8286,2,17,5,8,57,36,21,56
Ballymena,8286,3,13,9,8,65,56,9,48
Linfield,8286,4,12,10,8,58,42,16,46
Glenavon,8286,5,12,10,8,53,49,4,46
Coleraine,8286,6,12,8,10,39,37,2,44
Dungannon,8286,7,11,7,12,54,52,2,40
Ards,8286,8,11,5,14,38,46,-8,38
Portadown,8286,9,9,5,16,29,48,-19,32
Glentoran,8286,10,7,9,14,31,49,-18,30
Ballinamalla,8286,11,6,2,22,25,53,-28,20
Crusaders,8287,1,18,5,7,60,36,24,59
Linfield,8287,2,14,8,8,58,41,17,50
Glenavon,8287,3,13,11,6,49,37,12,50
Ballymena,8287,4,15,5,10,59,62,-3,50
Cliftonville,8287,5,15,4,11,53,42,11,49
Dungannon,8287,6,12,8,10,55,43,12,44
Coleraine,8287,7,10,11,9,36,34,2,41
Ballinamalla,8287,8,10,3,17,32,52,-20,33
Ards,8287,9,9,4,17,45,51,-6,31
Glentoran,8287,10,7,7,16,27,48,-21,28
Portadown,8287,11,5,8,17,25,53,-28,23
Ballymena,8288,1,17,6,7,70,56,14,57
Linfield,8288,2,14,8,8,54,32,22,50
Cliftonville,8288,3,14,5,11,48,43,5,47
Glenavon,8288,4,12,9,9,52,41,11,45
Dungannon,8288,5,11,11,8,51,40,11,44
Crusaders,8288,6,12,8,10,47,47,0,44
Ards,8288,7,12,6,12,42,41,1,42
Coleraine,8288,8,9,11,10,37,45,-8,38
Glentoran,8288,9,10,6,14,27,37,-10,36
Ballinamalla,8288,10,9,3,18,32,54,-22,30
Portadown,8288,11,6,5,19,24,48,-24,23
Crusaders,8289,1,16,7,7,57,36,21,55
Linfield,8289,2,12,15,3,61,33,28,51
Cliftonville,8289,3,14,6,10,46,37,9,48
Ballymena,8289,4,14,6,10,52,54,-2,48
Glenavon,8289,5,11,12,7,50,45,5,45
Coleraine,8289,6,11,12,7,44,39,5,45
Glentoran,8289,7,10,9,11,27,35,-8,39
Dungannon,8289,8,8,12,10,47,41,6,36
Ards,8289,9,9,7,14,33,45,-12,34
Portadown,8289,10,6,7,17,26,47,-21,25
Ballinamalla,8289,11,6,3,21,21,52,-31,21
Crusaders,8290,1,16,9,5,60,29,31,57
Linfield,8290,2,15,8,7,59,32,27,53
Coleraine,8290,3,14,10,6,49,35,14,52
Glenavon,8290,4,12,11,7,49,49,0,47
Cliftonville,8290,5,13,7,10,51,45,6,46
Ballymena,8290,6,11,9,10,56,65,-9,42
Dungannon,8290,7,10,8,12,48,42,6,38
Portadown,8290,8,8,7,15,30,45,-15,31
Ballinamalla,8290,9,9,3,18,30,51,-21,30
Glentoran,8290,10,8,6,16,29,51,-22,30
Ards,8290,11,7,6,17,38,55,-17,27
Linfield,8291,1,17,8,5,72,31,41,59
Cliftonville,8291,2,17,4,9,58,42,16,55
Crusaders,8291,3,15,9,6,58,40,18,54
Glenavon,8291,4,11,11,8,55,50,5,44
Ballymena,8291,5,12,8,10,58,61,-3,44
Coleraine,8291,6,10,12,8,43,37,6,42
Portadown,8291,7,11,3,16,29,47,-18,36
Dungannon,8291,8,8,9,13,46,52,-6,33
Ballinamalla,8291,9,9,5,16,36,52,-16,32
Glentoran,8291,10,8,7,15,34,58,-24,31
Ards,8291,11,6,6,18,36,55,-19,24
Cliftonville,8292,1,17,4,9,60,33,27,55
Linfield,8292,2,14,9,7,56,26,30,51
Dungannon,8292,3,14,8,8,55,42,13,50
Crusaders,8292,4,13,9,8,47,37,10,48
Coleraine,8292,5,12,9,9,45,46,-1,45
Glenavon,8292,6,9,13,8,47,46,1,40
Glentoran,8292,7,10,8,12,29,41,-12,38
Ballymena,8292,8,10,6,14,49,59,-10,36
Ballinamalla,8292,9,10,3,17,33,48,-15,33
Portadown,8292,10,8,7,15,22,42,-20,31
Ards,8292,11,8,4,18,33,56,-23,28
Ballymena,8293,1,17,7,6,62,52,10,58
Crusaders,8293,2,16,6,8,54,35,19,54
Linfield,8293,3,14,9,7,64,34,30,51
Dungannon,8293,4,12,11,7,58,46,12,47
Coleraine,8293,5,11,11,8,36,33,3,44
Cliftonville,8293,6,13,4,13,42,35,7,43
Glenavon,8293,7,10,10,10,41,55,-14,40
Ards,8293,8,9,7,14,37,48,-11,34
Portadown,8293,9,9,7,14,27,40,-13,34
Glentoran,8293,10,7,6,17,30,48,-18,27
Ballinamalla,8293,11,7,2,21,37,62,-25,23
Crusaders,8294,1,16,10,4,58,28,30,58
Linfield,8294,2,16,9,5,72,29,43,57
Ballymena,8294,3,15,8,7,66,59,7,53
Coleraine,8294,4,11,13,6,45,41,4,46
Cliftonville,8294,5,11,8,11,45,45,0,41
Glentoran,8294,6,10,8,12,31,39,-8,38
Dungannon,8294,7,9,10,11,48,45,3,37
Portadown,8294,8,9,7,14,28,48,-20,34
Glenavon,8294,9,7,12,11,38,53,-15,33
Ards,8294,10,7,6,17,45,58,-13,27
Ballinamalla,8294,11,7,3,20,28,59,-31,24
Crusaders,8295,1,16,8,6,63,39,24,56
Cliftonville,8295,2,16,5,9,59,42,17,53
Linfield,8295,3,14,9,7,60,35,25,51
Ballymena,8295,4,14,6,10,57,59,-2,48
Coleraine,8295,5,11,11,8,47,38,9,44
Dungannon,8295,6,11,9,10,68,52,16,42
Glenavon,8295,7,9,14,7,41,45,-4,41
Glentoran,8295,8,10,7,13,32,45,-13,37
Ballinamalla,8295,9,9,4,17,27,50,-23,31
Ards,8295,10,7,6,17,37,58,-21,27
Portadown,8295,11,5,7,18,25,53,-28,22
Crusaders,8296,1,18,8,4,52,23,29,62
Linfield,8296,2,13,10,7,58,37,21,49
Glenavon,8296,3,12,13,5,46,36,10,49
Cliftonville,8296,4,14,4,12,51,40,11,46
Ballymena,8296,5,13,7,10,62,62,0,46
Glentoran,8296,6,11,7,12,27,41,-14,40
Coleraine,8296,7,10,9,11,39,41,-2,39
Dungannon,8296,8,10,8,12,48,47,1,38
Ards,8296,9,9,3,18,37,50,-13,30
Portadown,8296,10,8,5,17,29,51,-22,29
Ballinamalla,8296,11,6,8,16,23,44,-21,26
Crusaders,8297,1,19,7,4,67,33,34,64
Cliftonville,8297,2,14,8,8,54,45,9,50
Ballymena,8297,3,14,5,11,59,64,-5,47
Linfield,8297,4,10,13,7,52,36,16,43
Glenavon,8297,5,10,10,10,48,47,1,40
Coleraine,8297,6,9,12,9,47,44,3,39
Dungannon,8297,7,9,10,11,49,47,2,37
Glentoran,8297,8,10,7,13,33,43,-10,37
Ards,8297,9,10,5,15,36,47,-11,35
Ballinamalla,8297,10,10,3,17,34,49,-15,33
Portadown,8297,11,7,6,17,30,54,-24,27
Cliftonville,8298,1,17,6,7,65,40,25,57
Ballymena,8298,2,15,6,9,61,54,7,51
Crusaders,8298,3,14,8,8,49,40,9,50
Coleraine,8298,4,13,11,6,43,35,8,50
Linfield,8298,5,11,10,9,52,35,17,43
Glenavon,8298,6,10,10,10,45,54,-9,40
Dungannon,8298,7,11,6,13,53,47,6,39
Ards,8298,8,9,9,12,43,48,-5,36
Portadown,8298,9,8,6,16,36,47,-11,30
Glentoran,8298,10,6,10,14,27,51,-24,28
Ballinamalla,8298,11,7,6,17,33,56,-23,27
Crusaders,8299,1,17,9,4,55,26,29,60
Linfield,8299,2,16,10,4,58,23,35,58
Ballymena,8299,3,14,7,9,49,54,-5,49
Glenavon,8299,4,10,14,6,47,43,4,44
Dungannon,8299,5,11,10,9,50,42,8,43
Cliftonville,8299,6,13,4,13,49,44,5,43
Coleraine,8299,7,9,11,10,41,43,-2,38
Glentoran,8299,8,7,10,13,29,47,-18,31
Ards,8299,9,8,6,16,35,46,-11,30
Ballinamalla,8299,10,8,5,17,29,51,-22,29
Portadown,8299,11,6,6,18,22,45,-23,24
Crusaders,8300,1,16,8,6,56,38,18,56
Linfield,8300,2,14,11,5,65,40,25,53
Cliftonville,8300,3,14,7,9,55,45,10,49
Glenavon,8300,4,11,12,7,44,38,6,45
Ballymena,8300,5,12,7,11,58,61,-3,43
Coleraine,8300,6,10,11,9,49,42,7,41
Glentoran,8300,7,10,7,13,27,41,-14,37
Dungannon,8300,8,8,11,11,48,45,3,35
Ballinamalla,8300,9,9,7,14,30,43,-13,34
Ards,8300,10,7,7,16,31,47,-16,28
Portadown,8300,11,7,6,17,27,50,-23,27
Linfield,8301,1,14,10,6,58,29,29,52
Crusaders,8301,2,15,7,8,43,27,16,52
Glenavon,8301,3,14,9,7,56,44,12,51
Coleraine,8301,4,13,10,7,47,39,8,49
Cliftonville,8301,5,13,6,11,46,40,6,45
Ballymena,8301,6,11,10,9,60,60,0,43
Dungannon,8301,7,9,9,12,45,42,3,36
Ards,8301,8,9,7,14,36,44,-8,34
Glentoran,8301,9,8,8,14,24,42,-18,32
Ballinamalla,8301,10,8,6,16,29,54,-25,30
Portadown,8301,11,8,4,18,28,51,-23,28
Crusaders,8302,1,15,7,8,55,38,17,52
Cliftonville,8302,2,16,4,10,53,36,17,52
Ballymena,8302,3,14,6,10,60,63,-3,48
Linfield,8302,4,12,11,7,55,30,25,47
Glenavon,8302,5,11,11,8,47,44,3,44
Coleraine,8302,6,10,11,9,45,43,2,41
Glentoran,8302,7,10,9,11,32,43,-11,39
Ards,8302,8,10,6,14,36,49,-13,36
Portadown,8302,9,10,4,16,38,49,-11,34
Ballinamalla,8302,10,9,5,16,32,51,-19,32
Dungannon,8302,11,6,10,14,42,49,-7,28
Crusaders,8303,1,20,4,6,71,39,32,64
Linfield,8303,2,18,9,3,58,22,36,63
Cliftonville,8303,3,15,5,10,61,40,21,50
Glenavon,8303,4,12,11,7,54,39,15,47
Ballymena,8303,5,13,8,9,52,51,1,47
Dungannon,8303,6,11,8,11,48,41,7,41
Coleraine,8303,7,9,11,10,41,45,-4,38
Glentoran,8303,8,8,7,15,28,52,-24,31
Ards,8303,9,7,6,17,34,57,-23,27
Ballinamalla,8303,10,7,4,19,31,61,-30,25
Portadown,8303,11,6,5,19,19,50,-31,23
Cliftonville,8304,1,18,5,7,60,35,25,59
Linfield,8304,2,16,9,5,61,32,29,57
Dungannon,8304,3,14,8,8,50,35,15,50
Crusaders,8304,4,15,5,10,48,36,12,50
Coleraine,8304,5,11,13,6,46,34,12,46
Glenavon,8304,6,11,10,9,43,44,-1,43
Ballymena,8304,7,10,8,12,52,60,-8,38
Glentoran,8304,8,9,6,15,27,48,-21,33
Ballinamalla,8304,9,8,5,17,28,48,-20,29
Ards,8304,10,7,4,19,39,58,-19,25
Portadown,8304,11,5,9,16,20,44,-24,24
Ballymena,8305,1,16,6,8,62,52,10,54
Crusaders,8305,2,16,5,9,56,38,18,53
Glenavon,8305,3,14,10,6,49,35,14,52
Linfield,8305,4,13,10,7,54,34,20,49
Cliftonville,8305,5,14,4,12,50,48,2,46
Glentoran,8305,6,14,4,12,41,44,-3,46
Coleraine,8305,7,11,11,8,49,45,4,44
Dungannon,8305,8,11,8,11,50,45,5,41
Ballinamalla,8305,9,9,3,18,34,54,-20,30
Portadown,8305,10,7,4,19,28,49,-21,25
Ards,8305,11,5,5,20,30,59,-29,20
Linfield,8306,1,19,8,3,68,29,39,65
Crusaders,8306,2,17,6,7,64,35,29,57
Ballymena,8306,3,16,5,9,67,62,5,53
Cliftonville,8306,4,15,5,10,56,43,13,50
Coleraine,8306,5,12,10,8,50,43,7,46
Glenavon,8306,6,10,10,10,45,46,-1,40
Ards,8306,7,10,6,14,38,49,-11,36
Dungannon,8306,8,7,11,12,49,52,-3,32
Glentoran,8306,9,6,12,12,31,48,-17,30
Portadown,8306,10,7,6,17,27,51,-24,27
Ballinamalla,8306,11,4,5,21,26,63,-37,17
Linfield,8307,1,17,7,6,60,25,35,58
Crusaders,8307,2,15,7,8,53,39,14,52
Cliftonville,8307,3,16,3,11,55,41,14,51
Ballymena,8307,4,15,4,11,60,58,2,49
Glenavon,8307,5,11,13,6,47,46,1,46
Coleraine,8307,6,10,12,8,40,36,4,42
Dungannon,8307,7,10,8,12,48,46,2,38
Glentoran,8307,8,10,7,13,30,45,-15,37
Ballinamalla,8307,9,9,3,18,25,49,-24,30
Portadown,8307,10,8,5,17,31,49,-18,29
Ards,8307,11,7,5,18,37,52,-15,26
Linfield,8308,1,16,8,6,58,31,27,56
Coleraine,8308,2,15,8,7,50,35,15,53
Cliftonville,8308,3,17,2,11,54,42,12,53
Crusaders,8308,4,14,8,8,58,40,18,50
Glenavon,8308,5,11,12,7,51,45,6,45
Ballymena,8308,6,13,6,11,55,58,-3,45
Glentoran,8308,7,11,7,12,31,39,-8,40
Dungannon,8308,8,8,11,11,54,52,2,35
Ards,8308,9,10,3,17,35,46,-11,33
Ballinamalla,8308,10,9,3,18,32,55,-23,30
Portadown,8308,11,5,4,21,19,54,-35,19
Cliftonville,8309,1,17,5,8,55,32,23,56
Crusaders,8309,2,17,5,8,52,35,17,56
Linfield,8309,3,13,10,7,57,32,25,49
Glenavon,8309,4,12,10,8,47,42,5,46
Dungannon,8309,5,12,8,10,52,40,12,44
Coleraine,8309,6,9,14,7,37,38,-1,41
Ballymena,8309,7,12,4,14,49,62,-13,40
Ards,8309,8,9,7,14,37,50,-13,34
Ballinamalla,8309,9,10,4,16,33,50,-17,34
Glentoran,8309,10,8,5,17,27,46,-19,29
Portadown,8309,11,7,6,17,23,42,-19,27
Linfield,8310,1,15,11,4,63,32,31,56
Crusaders,8310,2,17,5,8,59,38,21,56
Cliftonville,8310,3,16,5,9,51,36,15,53
Ballymena,8310,4,12,8,10,52,58,-6,44
Dungannon,8310,5,11,9,10,49,45,4,42
Coleraine,8310,6,10,11,9,44,40,4,41
Glentoran,8310,7,10,6,14,30,45,-15,36
Glenavon,8310,8,8,11,11,45,51,-6,35
Ards,8310,9,9,7,14,37,47,-10,34
Portadown,8310,10,7,7,16,29,47,-18,28
Ballinamalla,8310,11,7,6,17,29,49,-20,27
Crusaders,8311,1,18,7,5,55,30,25,61
Linfield,8311,2,14,11,5,61,33,28,53
Cliftonville,8311,3,13,9,8,48,38,10,48
Glenavon,8311,4,13,9,8,47,38,9,48
Coleraine,8311,5,12,10,8,44,37,7,46
Ballymena,8311,6,12,7,11,56,62,-6,43
Dungannon,8311,7,9,9,12,48,47,1,36
Portadown,8311,8,9,4,17,31,47,-16,31
Ballinamalla,8311,9,8,6,16,30,48,-18,30
Ards,8311,10,8,5,17,36,51,-15,29
Glentoran,8311,11,6,9,15,27,52,-25,27
Linfield,8312,1,17,8,5,66,32,34,59
Cliftonville,8312,2,18,5,7,62,41,21,59
Crusaders,8312,3,15,6,9,51,34,17,51
Glenavon,8312,4,12,13,5,52,41,11,49
Dungannon,8312,5,11,10,9,50,39,11,43
Ballymena,8312,6,12,5,13,50,62,-12,41
Ards,8312,7,11,6,13,49,48,1,39
Coleraine,8312,8,9,11,10,35,38,-3,38
Glentoran,8312,9,7,5,18,21,51,-30,26
Portadown,8312,10,6,7,17,27,49,-22,25
Ballinamalla,8312,11,7,4,19,32,60,-28,25
Crusaders,8313,1,15,10,5,60,33,27,55
Linfield,8313,2,14,11,5,62,29,33,53
Cliftonville,8313,3,15,5,10,55,45,10,50
Ballymena,8313,4,14,4,12,63,59,4,46
Glenavon,8313,5,11,11,8,50,54,-4,44
Dungannon,8313,6,10,11,9,48,41,7,41
Glentoran,8313,7,10,8,12,36,51,-15,38
Coleraine,8313,8,9,10,11,40,41,-1,37
Portadown,8313,9,8,8,14,33,48,-15,32
Ards,8313,10,9,4,17,36,56,-20,31
Ballinamalla,8313,11,7,4,19,34,60,-26,25
Ballymena,8314,1,19,5,6,64,47,17,62
Cliftonville,8314,2,18,3,9,52,34,18,57
Crusaders,8314,3,15,9,6,53,36,17,54
Glenavon,8314,4,11,11,8,51,43,8,44
Linfield,8314,5,11,10,9,50,34,16,43
Ballinamalla,8314,6,12,5,13,35,42,-7,41
Coleraine,8314,7,10,8,12,34,43,-9,38
Dungannon,8314,8,7,12,11,43,44,-1,33
Glentoran,8314,9,8,9,13,32,42,-10,33
Ards,8314,10,7,4,19,28,51,-23,25
Portadown,8314,11,5,8,17,21,47,-26,23
Crusaders,8315,1,19,6,5,55,28,27,63
Cliftonville,8315,2,16,4,10,51,38,13,52
Linfield,8315,3,13,11,6,53,29,24,50
Ballymena,8315,4,14,5,11,57,60,-3,47
Coleraine,8315,5,10,12,8,46,43,3,42
Glenavon,8315,6,9,12,9,46,46,0,39
Ards,8315,7,11,5,14,41,45,-4,38
Dungannon,8315,8,9,10,11,46,45,1,37
Glentoran,8315,9,8,10,12,29,41,-12,34
Portadown,8315,10,6,7,17,22,45,-23,25
Ballinamalla,8315,11,5,8,17,30,56,-26,23
Linfield,8316,1,18,8,4,67,30,37,62
Crusaders,8316,2,16,8,6,57,37,20,56
Cliftonville,8316,3,16,6,8,57,38,19,54
Glenavon,8316,4,11,12,7,50,47,3,45
Ballymena,8316,5,13,4,13,59,61,-2,43
Glentoran,8316,6,10,9,11,37,47,-10,39
Dungannon,8316,7,9,10,11,48,49,-1,37
Coleraine,8316,8,9,9,12,40,40,0,36
Portadown,8316,9,7,8,15,28,48,-20,29
Ballinamalla,8316,10,7,6,17,30,51,-21,27
Ards,8316,11,5,8,17,31,56,-25,23
Coleraine,8317,1,14,10,6,44,34,10,52
Crusaders,8317,2,15,7,8,47,39,8,52
Linfield,8317,3,13,12,5,62,38,24,51
Cliftonville,8317,4,15,6,9,53,38,15,51
Ballymena,8317,5,14,8,8,60,56,4,50
Glenavon,8317,6,12,10,8,53,43,10,46
Dungannon,8317,7,10,10,10,57,47,10,40
Ards,8317,8,8,6,16,37,45,-8,30
Ballinamalla,8317,9,8,5,17,31,52,-21,29
Glentoran,8317,10,7,7,16,31,55,-24,28
Portadown,8317,11,5,7,18,18,46,-28,22
Crusaders,8318,1,15,7,8,52,36,16,52
Cliftonville,8318,2,15,6,9,51,38,13,51
Glenavon,8318,3,12,11,7,52,48,4,47
Linfield,8318,4,13,7,10,58,36,22,46
Ballymena,8318,5,13,7,10,57,58,-1,46
Coleraine,8318,6,11,12,7,41,36,5,45
Dungannon,8318,7,11,7,12,54,47,7,40
Ballinamalla,8318,8,11,2,17,33,46,-13,35
Glentoran,8318,9,9,7,14,34,46,-12,34
Ards,8318,10,8,6,16,33,54,-21,30
Portadown,8318,11,7,8,15,29,49,-20,29
Cliftonville,8319,1,17,4,9,62,40,22,55
Linfield,8319,2,14,10,6,57,32,25,52
Crusaders,8319,3,15,7,8,56,41,15,52
Dungannon,8319,4,12,11,7,49,35,14,47
Ballymena,8319,5,14,5,11,59,62,-3,47
Glenavon,8319,6,11,11,8,46,38,8,44
Coleraine,8319,7,9,14,7,38,34,4,41
Ards,8319,8,10,6,14,31,43,-12,36
Portadown,8319,9,7,6,17,23,49,-26,27
Glentoran,8319,10,5,10,15,25,46,-21,25
Ballinamalla,8319,11,7,4,19,25,51,-26,25
Linfield,8320,1,15,8,7,63,35,28,53
Crusaders,8320,2,15,8,7,54,38,16,53
Ballymena,8320,3,15,6,9,66,59,7,51
Coleraine,8320,4,12,11,7,56,46,10,47
Glenavon,8320,5,12,11,7,51,43,8,47
Glentoran,8320,6,14,5,11,35,38,-3,47
Cliftonville,8320,7,12,8,10,57,54,3,44
Dungannon,8320,8,8,11,11,51,51,0,35
Ards,8320,9,8,6,16,35,49,-14,30
Portadown,8320,10,6,7,17,26,50,-24,25
Ballinamalla,8320,11,7,1,22,26,57,-31,22
Cliftonville,8321,1,19,4,7,57,35,22,61
Crusaders,8321,2,16,7,7,57,41,16,55
Dungannon,8321,3,13,8,9,53,39,14,47
Ballymena,8321,4,13,8,9,62,57,5,47
Coleraine,8321,5,12,10,8,43,37,6,46
Linfield,8321,6,11,11,8,56,38,18,44
Glentoran,8321,7,10,9,11,34,39,-5,39
Ards,8321,8,9,5,16,38,54,-16,32
Glenavon,8321,9,7,9,14,40,51,-11,30
Ballinamalla,8321,10,8,4,18,33,56,-23,28
Portadown,8321,11,6,7,17,26,52,-26,25
Linfield,8322,1,15,9,6,62,31,31,54
Crusaders,8322,2,15,9,6,60,39,21,54
Cliftonville,8322,3,15,5,10,54,41,13,50
Coleraine,8322,4,13,11,6,44,33,11,50
Ballymena,8322,5,14,4,12,57,60,-3,46
Glenavon,8322,6,9,11,10,48,53,-5,38
Glentoran,8322,7,10,8,12,33,43,-10,38
Ards,8322,8,10,7,13,41,51,-10,37
Dungannon,8322,9,9,9,12,53,48,5,36
Ballinamalla,8322,10,7,6,17,28,50,-22,27
Portadown,8322,11,6,5,19,26,57,-31,23
Crusaders,8323,1,14,10,6,49,32,17,52
Coleraine,8323,2,15,7,8,49,33,16,52
Linfield,8323,3,13,10,7,59,35,24,49
Ballymena,8323,4,14,7,9,63,58,5,49
Cliftonville,8323,5,14,5,11,53,41,12,47
Glenavon,8323,6,10,10,10,43,46,-3,40
Glentoran,8323,7,10,10,10,30,41,-11,40
Portadown,8323,8,9,6,15,30,51,-21,33
Dungannon,8323,9,6,12,12,45,49,-4,30
Ards,8323,10,8,6,16,42,51,-9,30
Ballinamalla,8323,11,8,5,17,30,56,-26,29
Crusaders,8324,1,16,8,6,54,31,23,56
Linfield,8324,2,13,11,6,54,29,25,50
Ballymena,8324,3,13,8,9,56,58,-2,47
Cliftonville,8324,4,13,6,11,43,34,9,45
Ards,8324,5,14,3,13,43,43,0,45
Dungannon,8324,6,12,8,10,53,45,8,44
Glenavon,8324,7,11,10,9,47,45,2,43
Coleraine,8324,8,9,12,9,36,34,2,39
Glentoran,8324,9,8,8,14,25,43,-18,32
Portadown,8324,10,7,9,14,26,40,-14,30
Ballinamalla,8324,11,6,3,21,23,58,-35,21
Linfield,8325,1,17,10,3,61,26,35,61
Glenavon,8325,2,13,14,3,55,38,17,53
Ballymena,8325,3,16,5,9,68,55,13,53
Cliftonville,8325,4,15,6,9,55,43,12,51
Crusaders,8325,5,12,7,11,51,49,2,43
Coleraine,8325,6,9,13,8,46,47,-1,40
Dungannon,8325,7,9,8,13,50,48,2,35
Ards,8325,8,8,9,13,40,53,-13,33
Glentoran,8325,9,8,7,15,36,54,-18,31
Ballinamalla,8325,10,7,5,18,26,50,-24,26
Portadown,8325,11,7,4,19,30,55,-25,25
Dungannon,8326,1,14,9,7,58,42,16,51
Cliftonville,8326,2,14,9,7,49,34,15,51
Ballymena,8326,3,14,8,8,58,51,7,50
Linfield,8326,4,12,11,7,57,37,20,47
Crusaders,8326,5,12,9,9,51,39,12,45
Coleraine,8326,6,9,14,7,38,37,1,41
Glentoran,8326,7,9,10,11,30,39,-9,37
Glenavon,8326,8,8,12,10,37,43,-6,36
Portadown,8326,9,10,5,15,26,40,-14,35
Ballinamalla,8326,10,9,5,16,34,51,-17,32
Ards,8326,11,4,8,18,32,57,-25,20
Crusaders,8327,1,16,5,9,63,44,19,53
Cliftonville,8327,2,16,4,10,49,38,11,52
Ballymena,8327,3,13,7,10,54,53,1,46
Coleraine,8327,4,11,12,7,41,36,5,45
Dungannon,8327,5,12,8,10,55,45,10,44
Glenavon,8327,6,11,10,9,46,45,1,43
Glentoran,8327,7,12,7,11,37,38,-1,43
Linfield,8327,8,10,11,9,47,35,12,41
Ards,8327,9,10,6,14,37,48,-11,36
Portadown,8327,10,8,4,18,27,48,-21,28
Ballinamalla,8327,11,6,6,18,28,54,-26,24
Crusaders,8328,1,15,6,9,49,35,14,51
Ballymena,8328,2,15,6,9,66,59,7,51
Linfield,8328,3,13,11,6,61,42,19,50
Glenavon,8328,4,13,11,6,49,42,7,50
Cliftonville,8328,5,13,8,9,49,35,14,47
Coleraine,8328,6,12,9,9,40,39,1,45
Dungannon,8328,7,10,10,10,50,44,6,40
Glentoran,8328,8,10,8,12,35,46,-11,38
Ballinamalla,8328,9,10,4,16,31,44,-13,34
Ards,8328,10,9,5,16,32,44,-12,32
Portadown,8328,11,3,6,21,16,48,-32,15
Linfield,8329,1,18,10,2,60,21,39,64
Crusaders,8329,2,17,8,5,56,34,22,59
Coleraine,8329,3,14,10,6,44,32,12,52
Cliftonville,8329,4,15,6,9,53,39,14,51
Ballymena,8329,5,13,4,13,56,60,-4,43
Glenavon,8329,6,11,9,10,45,41,4,42
Dungannon,8329,7,9,9,12,43,45,-2,36
Ards,8329,8,9,6,15,37,47,-10,33
Glentoran,8329,9,9,5,16,28,44,-16,32
Ballinamalla,8329,10,7,4,19,25,53,-28,25
Portadown,8329,11,6,3,21,21,52,-31,21
Crusaders,8330,1,15,12,3,53,32,21,57
Coleraine,8330,2,13,8,9,40,32,8,47
Glenavon,8330,3,12,11,7,48,42,6,47
Cliftonville,8330,4,14,5,11,47,41,6,47
Linfield,8330,5,12,10,8,51,29,22,46
Dungannon,8330,6,12,10,8,58,40,18,46
Ballymena,8330,7,12,4,14,53,60,-7,40
Glentoran,8330,8,9,7,14,26,44,-18,34
Portadown,8330,9,9,5,16,27,43,-16,32
Ards,8330,10,8,6,16,31,49,-18,30
Ballinamalla,8330,11,7,6,17,29,51,-22,27
Cliftonville,8331,1,17,4,9,59,39,20,55
Crusaders,8331,2,14,8,8,52,39,13,50
Glenavon,8331,3,11,15,4,50,47,3,48
Linfield,8331,4,12,11,7,50,28,22,47
Coleraine,8331,5,12,10,8,42,37,5,46
Dungannon,8331,6,12,9,9,56,44,12,45
Ballymena,8331,7,13,5,12,62,59,3,44
Glentoran,8331,8,10,6,14,33,43,-10,36
Ballinamalla,8331,9,7,8,15,30,50,-20,29
Ards,8331,10,7,5,18,37,59,-22,26
Portadown,8331,11,6,7,17,26,52,-26,25
Cliftonville,8332,1,18,6,6,59,39,20,60
Crusaders,8332,2,16,9,5,59,31,28,57
Linfield,8332,3,12,12,6,54,34,20,48
Coleraine,8332,4,12,12,6,47,38,9,48
Ballymena,8332,5,12,10,8,54,55,-1,46
Glenavon,8332,6,9,10,11,40,45,-5,37
Glentoran,8332,7,9,8,13,32,44,-12,35
Dungannon,8332,8,8,8,14,41,43,-2,32
Portadown,8332,9,9,5,16,28,45,-17,32
Ballinamalla,8332,10,8,5,17,32,53,-21,29
Ards,8332,11,6,7,17,34,53,-19,25
Linfield,8333,1,17,8,5,63,30,33,59
Cliftonville,8333,2,17,5,8,62,39,23,56
Crusaders,8333,3,15,8,7,52,34,18,53
Coleraine,8333,4,12,10,8,48,48,0,46
Ballymena,8333,5,10,10,10,60,68,-8,40
Ards,8333,6,11,6,13,45,49,-4,39
Glenavon,8333,7,8,14,8,43,46,-3,38
Dungannon,8333,8,9,10,11,44,39,5,37
Glentoran,8333,9,8,11,11,36,47,-11,35
Portadown,8333,10,5,9,16,25,45,-20,24
Ballinamalla,8333,11,4,7,19,24,57,-33,19
Cliftonville,8334,1,16,7,7,56,36,20,55
Linfield,8334,2,14,10,6,61,36,25,52
Ballymena,8334,3,15,5,10,67,62,5,50
Crusaders,8334,4,13,7,10,52,43,9,46
Glenavon,8334,5,11,9,10,46,49,-3,42
Dungannon,8334,6,10,10,10,56,49,7,40
Coleraine,8334,7,9,11,10,41,45,-4,38
Ballinamalla,8334,8,11,5,14,37,47,-10,38
Ards,8334,9,10,7,13,45,48,-3,37
Glentoran,8334,10,8,9,13,31,43,-12,33
Portadown,8334,11,5,6,19,28,62,-34,21
Crusaders,8335,1,16,8,6,55,33,22,56
Coleraine,8335,2,13,11,6,47,37,10,50
Cliftonville,8335,3,14,5,11,48,43,5,47
Linfield,8335,4,12,9,9,51,31,20,45
Ballymena,8335,5,13,4,13,50,53,-3,43
Portadown,8335,6,13,4,13,37,43,-6,43
Glenavon,8335,7,10,10,10,47,48,-1,40
Ards,8335,8,11,5,14,41,45,-4,38
Dungannon,8335,9,8,10,12,51,50,1,34
Glentoran,8335,10,7,9,14,25,44,-19,30
Ballinamalla,8335,11,9,3,18,28,53,-25,30
Crusaders,8336,1,16,10,4,63,41,22,58
Linfield,8336,2,15,11,4,61,31,30,56
Cliftonville,8336,3,15,6,9,59,40,19,51
Ballymena,8336,4,14,6,10,55,56,-1,48
Glenavon,8336,5,12,8,10,45,48,-3,44
Dungannon,8336,6,11,10,9,58,40,18,43
Coleraine,8336,7,9,12,9,44,47,-3,39
Glentoran,8336,8,9,8,13,31,45,-14,35
Ards,8336,9,8,5,17,34,53,-19,29
Ballinamalla,8336,10,8,2,20,33,55,-22,26
Portadown,8336,11,6,6,18,22,49,-27,24
Crusaders,8337,1,17,7,6,60,34,26,58
Linfield,8337,2,15,10,5,59,29,30,55
Cliftonville,8337,3,15,4,11,45,34,11,49
Glenavon,8337,4,12,10,8,53,42,11,46
Coleraine,8337,5,11,12,7,42,36,6,45
Ballymena,8337,6,13,5,12,49,58,-9,44
Dungannon,8337,7,10,9,11,44,45,-1,39
Ards,8337,8,9,7,14,36,45,-9,34
Glentoran,8337,9,7,10,13,33,51,-18,31
Portadown,8337,10,7,7,16,22,42,-20,28
Ballinamalla,8337,11,7,3,20,24,51,-27,24
Crusaders,8338,1,17,9,4,59,29,30,60
Cliftonville,8338,2,14,7,9,47,38,9,49
Glenavon,8338,3,11,15,4,57,42,15,48
Linfield,8338,4,13,9,8,60,46,14,48
Dungannon,8338,5,13,6,11,54,47,7,45
Ballymena,8338,6,13,5,12,59,57,2,44
Coleraine,8338,7,10,11,9,40,39,1,41
Glentoran,8338,8,9,5,16,36,50,-14,32
Ards,8338,9,8,6,16,37,54,-17,30
Ballinamalla,8338,10,8,5,17,29,55,-26,29
Portadown,8338,11,8,4,18,28,49,-21,28
Linfield,8339,1,14,8,8,55,35,20,50
Crusaders,8339,2,14,8,8,57,43,14,50
Glenavon,8339,3,13,11,6,50,39,11,50
Cliftonville,8339,4,14,6,10,56,47,9,48
Coleraine,8339,5,10,12,8,44,41,3,42
Glentoran,8339,6,11,9,10,35,42,-7,42
Dungannon,8339,7,9,10,11,45,44,1,37
Ballinamalla,8339,8,10,6,14,34,47,-13,36
Ards,8339,9,10,4,16,40,49,-9,34
Portadown,8339,10,9,5,16,31,44,-13,32
Ballymena,8339,11,8,7,15,53,69,-16,31
Crusaders,8340,1,21,4,5,61,29,32,67
Linfield,8340,2,17,8,5,61,27,34,59
Cliftonville,8340,3,15,4,11,55,50,5,49
Coleraine,8340,4,11,11,8,43,36,7,44
Ballymena,8340,5,11,7,12,51,60,-9,40
Glenavon,8340,6,9,12,9,43,50,-7,39
Ards,8340,7,11,4,15,46,50,-4,37
Dungannon,8340,8,9,9,12,45,45,0,36
Glentoran,8340,9,8,8,14,33,45,-12,32
Portadown,8340,10,8,3,19,27,54,-27,27
Ballinamalla,8340,11,6,8,16,32,51,-19,26
Linfield,8341,1,16,7,7,66,35,31,55
Crusaders,8341,2,15,8,7,51,38,13,53
Ballymena,8341,3,13,10,7,62,60,2,49
Cliftonville,8341,4,14,5,11,51,44,7,47
Glenavon,8341,5,12,10,8,51,46,5,46
Coleraine,8341,6,12,9,9,47,43,4,45
Dungannon,8341,7,11,9,10,54,45,9,42
Glentoran,8341,8,10,8,12,37,43,-6,38
Ards,8341,9,9,5,16,34,49,-15,32
Ballinamalla,8341,10,7,6,17,25,49,-24,27
Portadown,8341,11,5,5,20,25,51,-26,20
Crusaders,8342,1,16,9,5,55,28,27,57
Ballymena,8342,2,17,5,8,61,48,13,56
Linfield,8342,3,15,9,6,57,33,24,54
Coleraine,8342,4,12,11,7,51,44,7,47
Cliftonville,8342,5,13,7,10,51,41,10,46
Glenavon,8342,6,11,10,9,45,40,5,43
Glentoran,8342,7,9,12,9,32,39,-7,39
Dungannon,8342,8,7,11,12,40,46,-6,32
Portadown,8342,9,8,6,16,24,45,-21,30
Ballinamalla,8342,10,8,5,17,27,46,-19,29
Ards,8342,11,5,3,22,29,62,-33,18
Crusaders,8343,1,17,6,7,52,36,16,57
Glenavon,8343,2,14,9,7,52,49,3,51
Linfield,8343,3,13,11,6,53,28,25,50
Coleraine,8343,4,13,10,7,51,34,17,49
Cliftonville,8343,5,14,6,10,52,37,15,48
Ballymena,8343,6,11,10,9,58,60,-2,43
Ards,8343,7,11,4,15,47,55,-8,37
Glentoran,8343,8,9,8,13,34,47,-13,35
Dungannon,8343,9,8,10,12,48,53,-5,34
Ballinamalla,8343,10,9,3,18,31,54,-23,30
Portadown,8343,11,5,5,20,27,52,-25,20
Crusaders,8344,1,17,8,5,58,33,25,59
Ballymena,8344,2,17,7,6,63,53,10,58
Linfield,8344,3,13,9,8,53,31,22,48
Cliftonville,8344,4,13,5,12,45,38,7,44
Coleraine,8344,5,10,14,6,44,38,6,44
Glenavon,8344,6,10,11,9,50,48,2,41
Glentoran,8344,7,9,10,11,31,38,-7,37
Dungannon,8344,8,9,9,12,44,44,0,36
Ards,8344,9,8,6,16,30,46,-16,30
Portadown,8344,10,8,6,16,27,46,-19,30
Ballinamalla,8344,11,6,5,19,28,58,-30,23
Linfield,8345,1,16,9,5,67,32,35,57
Ballymena,8345,2,15,6,9,59,51,8,51
Crusaders,8345,3,14,6,10,55,43,12,48
Cliftonville,8345,4,14,5,11,49,43,6,47
Coleraine,8345,5,10,13,7,42,38,4,43
Dungannon,8345,6,11,7,12,60,49,11,40
Glenavon,8345,7,9,12,9,54,58,-4,39
Ballinamalla,8345,8,11,3,16,34,54,-20,36
Glentoran,8345,9,9,8,13,35,45,-10,35
Ards,8345,10,8,7,15,35,50,-15,31
Portadown,8345,11,7,6,17,25,52,-27,27
Cliftonville,8346,1,16,4,10,54,44,10,52
Crusaders,8346,2,14,9,7,52,36,16,51
Glenavon,8346,3,11,14,5,47,41,6,47
Ballymena,8346,4,13,7,10,58,59,-1,46
Linfield,8346,5,11,11,8,53,36,17,44
Dungannon,8346,6,11,9,10,53,44,9,42
Coleraine,8346,7,8,16,6,41,39,2,40
Ards,8346,8,9,8,13,41,46,-5,35
Glentoran,8346,9,9,6,15,32,50,-18,33
Ballinamalla,8346,10,9,4,17,36,52,-16,31
Portadown,8346,11,7,6,17,25,45,-20,27
Crusaders,8347,1,16,8,6,57,40,17,56
Ballymena,8347,2,16,6,8,61,56,5,54
Linfield,8347,3,15,8,7,57,30,27,53
Coleraine,8347,4,12,9,9,48,39,9,45
Cliftonville,8347,5,11,7,12,53,50,3,40
Glenavon,8347,6,9,10,11,40,47,-7,37
Portadown,8347,7,11,4,15,29,45,-16,37
Dungannon,8347,8,9,9,12,45,46,-1,36
Ards,8347,9,10,4,16,41,50,-9,34
Ballinamalla,8347,10,8,8,14,30,43,-13,32
Glentoran,8347,11,7,9,14,27,42,-15,30
Crusaders,8348,1,19,4,7,60,37,23,61
Linfield,8348,2,14,10,6,64,32,32,52
Ballymena,8348,3,15,6,9,55,52,3,51
Coleraine,8348,4,11,11,8,38,34,4,44
Glenavon,8348,5,10,13,7,47,41,6,43
Cliftonville,8348,6,13,4,13,51,51,0,43
Portadown,8348,7,11,6,13,34,45,-11,39
Dungannon,8348,8,8,10,12,47,45,2,34
Ballinamalla,8348,9,8,6,16,30,43,-13,30
Glentoran,8348,10,8,6,16,24,50,-26,30
Ards,8348,11,7,6,17,31,51,-20,27
Crusaders,8349,1,17,7,6,59,36,23,58
Linfield,8349,2,14,10,6,66,37,29,52
Cliftonville,8349,3,16,4,10,58,41,17,52
Coleraine,8349,4,12,10,8,43,39,4,46
Ballymena,8349,5,12,7,11,57,61,-4,43
Dungannon,8349,6,9,13,8,50,40,10,40
Glentoran,8349,7,11,6,13,40,49,-9,39
Ards,8349,8,11,5,14,39,46,-7,38
Glenavon,8349,9,8,13,9,42,49,-7,37
Ballinamalla,8349,10,7,6,17,27,50,-23,27
Portadown,8349,11,4,7,19,19,52,-33,19
Crusaders,8350,1,18,6,6,59,31,28,60
Linfield,8350,2,15,9,6,63,29,34,54
Cliftonville,8350,3,15,6,9,57,41,16,51
Coleraine,8350,4,12,10,8,40,39,1,46
Ards,8350,5,12,3,15,42,46,-4,39
Glenavon,8350,6,8,13,9,42,47,-5,37
Glentoran,8350,7,9,10,11,33,44,-11,37
Ballymena,8350,8,10,6,14,47,64,-17,36
Dungannon,8350,9,9,8,13,47,53,-6,35
Portadown,8350,10,9,4,17,32,52,-20,31
Ballinamalla,8350,11,9,3,18,34,50,-16,30
Crusaders,8351,1,18,9,3,62,32,30,63
Linfield,8351,2,15,10,5,64,31,33,55
Cliftonville,8351,3,13,10,7,51,38,13,49
Ballymena,8351,4,13,7,10,59,61,-2,46
Glenavon,8351,5,10,12,8,44,43,1,42
Ards,8351,6,12,3,15,43,44,-1,39
Coleraine,8351,7,9,12,9,38,41,-3,39
Glentoran,8351,8,8,7,15,34,53,-19,31
Ballinamalla,8351,9,8,6,16,32,54,-22,30
Dungannon,8351,10,6,11,13,42,48,-6,29
Portadown,8351,11,7,5,18,25,49,-24,26
Linfield,8352,1,14,12,4,56,30,26,54
Crusaders,8352,2,16,6,8,49,28,21,54
Coleraine,8352,3,11,12,7,43,38,5,45
Cliftonville,8352,4,12,8,10,47,40,7,44
Glenavon,8352,5,11,11,8,48,47,1,44
Glentoran,8352,6,12,8,10,43,42,1,44
Ballymena,8352,7,13,5,12,54,60,-6,44
Dungannon,8352,8,11,10,9,52,48,4,43
Ards,8352,9,9,6,15,40,50,-10,33
Portadown,8352,10,7,5,18,24,43,-19,26
Ballinamalla,8352,11,6,3,21,30,60,-30,21
Crusaders,8353,1,16,8,6,57,37,20,56
Linfield,8353,2,15,9,6,67,38,29,54
Glenavon,8353,3,14,11,5,58,42,16,53
Cliftonville,8353,4,16,4,10,55,43,12,52
Coleraine,8353,5,11,9,10,47,45,2,42
Ballymena,8353,6,11,7,12,59,66,-7,40
Dungannon,8353,7,10,9,11,48,44,4,39
Portadown,8353,8,8,7,15,28,43,-15,31
Ards,8353,9,7,8,15,36,54,-18,29
Glentoran,8353,10,6,10,14,33,52,-19,28
Ballinamalla,8353,11,7,6,17,29,53,-24,27
Linfield,8354,1,16,11,3,67,28,39,59
Cliftonville,8354,2,19,2,9,60,35,25,59
Crusaders,8354,3,18,5,7,58,34,24,59
Coleraine,8354,4,11,9,10,37,37,0,42
Glenavon,8354,5,10,11,9,48,45,3,41
Ballymena,8354,6,10,9,11,54,63,-9,39
Glentoran,8354,7,11,6,13,35,47,-12,39
Dungannon,8354,8,9,11,10,45,42,3,38
Ballinamalla,8354,9,10,4,16,30,54,-24,34
Ards,8354,10,7,4,19,30,55,-25,25
Portadown,8354,11,5,6,19,26,50,-24,21
Crusaders,8355,1,17,6,7,55,33,22,57
Ballymena,8355,2,16,6,8,61,55,6,54
Linfield,8355,3,13,12,5,62,33,29,51
Cliftonville,8355,4,15,3,12,52,45,7,48
Coleraine,8355,5,11,10,9,41,39,2,43
Glenavon,8355,6,10,9,11,53,54,-1,39
Ballinamalla,8355,7,11,5,14,36,48,-12,38
Dungannon,8355,8,10,7,13,51,52,-1,37
Glentoran,8355,9,7,10,13,31,47,-16,31
Ards,8355,10,8,5,17,36,52,-16,29
Portadown,8355,11,8,5,17,33,53,-20,29
Linfield,8356,1,17,9,4,56,21,35,60
Crusaders,8356,2,18,6,6,68,35,33,60
Cliftonville,8356,3,17,3,10,60,42,18,54
Coleraine,8356,4,13,8,9,46,36,10,47
Ballymena,8356,5,13,4,13,61,66,-5,43
Glenavon,8356,6,10,10,10,43,46,-3,40
Portadown,8356,7,10,6,14,26,40,-14,36
Dungannon,8356,8,8,11,11,46,48,-2,35
Ards,8356,9,10,5,15,39,54,-15,35
Glentoran,8356,10,7,5,18,28,54,-26,26
Ballinamalla,8356,11,6,5,19,29,60,-31,23
Linfield,8357,1,14,11,5,61,30,31,53
Cliftonville,8357,2,14,8,8,49,41,8,50
Crusaders,8357,3,13,9,8,52,32,20,48
Coleraine,8357,4,10,15,5,41,33,8,45
Dungannon,8357,5,10,12,8,46,37,9,42
Ballymena,8357,6,11,8,11,52,60,-8,41
Glenavon,8357,7,10,10,10,47,49,-2,40
Ards,8357,8,10,6,14,38,47,-9,36
Glentoran,8357,9,9,8,13,36,47,-11,35
Ballinamalla,8357,10,9,4,17,30,55,-25,31
Portadown,8357,11,8,3,19,28,49,-21,27
Crusaders,8358,1,18,6,6,54,36,18,60
Cliftonville,8358,2,15,7,8,48,33,15,52
Glenavon,8358,3,13,12,5,54,46,8,51
Linfield,8358,4,14,8,8,58,38,20,50
Ballymena,8358,5,13,8,9,61,57,4,47
Dungannon,8358,6,8,13,9,47,41,6,37
Glentoran,8358,7,9,8,13,31,45,-14,35
Coleraine,8358,8,9,7,14,34,40,-6,34
Ballinamalla,8358,9,9,5,16,38,53,-15,32
Portadown,8358,10,7,7,16,29,47,-18,28
Ards,8358,11,7,5,18,33,51,-18,26
Crusaders,8359,1,16,6,8,53,34,19,54
Cliftonville,8359,2,16,6,8,48,32,16,54
Glenavon,8359,3,13,12,5,48,40,8,51
Linfield,8359,4,13,11,6,53,32,21,50
Coleraine,8359,5,13,10,7,44,33,11,49
Ballymena,8359,6,11,8,11,54,56,-2,41
Dungannon,8359,7,8,12,10,46,43,3,36
Glentoran,8359,8,8,9,13,30,47,-17,33
Ballinamalla,8359,9,9,4,17,31,47,-16,31
Ards,8359,10,7,5,18,28,47,-19,26
Portadown,8359,11,6,7,17,17,41,-24,25
Crusaders,8360,1,14,10,6,52,37,15,52
Cliftonville,8360,2,16,4,10,48,37,11,52
Linfield,8360,3,13,10,7,60,32,28,49
Glentoran,8360,4,13,8,9,36,34,2,47
Coleraine,8360,5,11,10,9,35,34,1,43
Glenavon,8360,6,10,11,9,45,47,-2,41
Dungannon,8360,7,10,8,12,51,44,7,38
Ballymena,8360,8,10,7,13,52,55,-3,37
Ards,8360,9,10,6,14,35,45,-10,36
Ballinamalla,8360,10,9,4,17,34,53,-19,31
Portadown,8360,11,7,6,17,24,54,-30,27
Linfield,8361,1,15,11,4,58,25,33,56
Crusaders,8361,2,16,6,8,55,46,9,54
Glenavon,8361,3,13,11,6,51,43,8,50
Cliftonville,8361,4,14,5,11,50,38,12,47
Coleraine,8361,5,13,8,9,46,43,3,47
Ballymena,8361,6,12,5,13,55,58,-3,41
Glentoran,8361,7,9,10,11,37,46,-9,37
Portadown,8361,8,10,6,14,32,44,-12,36
Ards,8361,9,9,7,14,37,47,-10,34
Dungannon,8361,10,6,10,14,43,50,-7,28
Ballinamalla,8361,11,6,5,19,27,51,-24,23
Cliftonville,8362,1,17,5,8,58,37,21,56
Linfield,8362,2,15,9,6,61,31,30,54
Ballymena,8362,3,14,9,7,61,55,6,51
Crusaders,8362,4,12,11,7,53,39,14,47
Coleraine,8362,5,12,10,8,49,42,7,46
Glenavon,8362,6,10,9,11,42,50,-8,39
Ards,8362,7,11,5,14,41,47,-6,38
Dungannon,8362,8,7,10,13,52,54,-2,31
Glentoran,8362,9,7,10,13,28,45,-17,31
Portadown,8362,10,9,4,17,25,50,-25,31
Ballinamalla,8362,11,7,6,17,28,48,-20,27
Crusaders,8363,1,19,6,5,62,33,29,63
Cliftonville,8363,2,16,2,12,51,43,8,50
Linfield,8363,3,13,8,9,52,32,20,47
Coleraine,8363,4,12,10,8,39,35,4,46
Ballymena,8363,5,13,5,12,56,64,-8,44
Dungannon,8363,6,10,9,11,54,46,8,39
Glentoran,8363,7,11,6,13,31,38,-7,39
Glenavon,8363,8,8,12,10,44,46,-2,36
Ballinamalla,8363,9,10,5,15,34,52,-18,35
Ards,8363,10,9,4,17,36,52,-16,31
Portadown,8363,11,7,7,16,25,43,-18,28
Crusaders,8364,1,16,7,7,57,36,21,55
Linfield,8364,2,15,9,6,66,33,33,54
Cliftonville,8364,3,15,3,12,49,42,7,48
Coleraine,8364,4,12,10,8,44,39,5,46
Ballymena,8364,5,12,6,12,56,66,-10,42
Dungannon,8364,6,9,9,12,55,51,4,36
Glenavon,8364,7,8,12,10,40,45,-5,36
Ards,8364,8,9,9,12,42,49,-7,36
Ballinamalla,8364,9,10,5,15,35,52,-17,35
Portadown,8364,10,9,7,14,36,50,-14,34
Glentoran,8364,11,7,9,14,25,42,-17,30
Crusaders,8365,1,18,8,4,58,30,28,62
Linfield,8365,2,13,11,6,61,34,27,50
Cliftonville,8365,3,15,4,11,52,38,14,49
Glenavon,8365,4,13,9,8,42,36,6,48
Ballymena,8365,5,14,5,11,58,63,-5,47
Ards,8365,6,12,5,13,42,44,-2,41
Coleraine,8365,7,10,10,10,40,40,0,40
Glentoran,8365,8,10,6,14,28,42,-14,36
Portadown,8365,9,9,5,16,28,49,-21,32
Dungannon,8365,10,6,10,14,41,49,-8,28
Ballinamalla,8365,11,7,3,20,25,50,-25,24
Crusaders,8366,1,18,7,5,58,33,25,61
Coleraine,8366,2,14,8,8,48,40,8,50
Linfield,8366,3,12,10,8,60,40,20,46
Cliftonville,8366,4,13,5,12,51,48,3,44
Ballymena,8366,5,12,7,11,55,61,-6,43
Ards,8366,6,12,6,12,44,45,-1,42
Glenavon,8366,7,10,11,9,50,46,4,41
Dungannon,8366,8,9,10,11,47,45,2,37
Glentoran,8366,9,9,10,11,35,42,-7,37
Ballinamalla,8366,10,7,6,17,27,49,-22,27
Portadown,8366,11,7,4,19,21,47,-26,25
Glenavon,8367,1,16,7,7,57,44,13,55
Cliftonville,8367,2,16,5,9,58,38,20,53
Crusaders,8367,3,14,8,8,52,33,19,50
Ballymena,8367,4,13,8,9,56,57,-1,47
Linfield,8367,5,12,9,9,59,42,17,45
Coleraine,8367,6,10,14,6,44,39,5,44
Dungannon,8367,7,11,8,11,47,43,4,41
Ards,8367,8,11,4,15,40,44,-4,37
Glentoran,8367,9,9,10,11,33,46,-13,37
Portadown,8367,10,7,5,18,29,52,-23,26
Ballinamalla,8367,11,6,2,22,27,64,-37,20
Linfield,8368,1,15,10,5,59,32,27,55
Cliftonville,8368,2,17,3,10,54,36,18,54
Crusaders,8368,3,15,8,7,53,36,17,53
Ballymena,8368,4,15,4,11,58,56,2,49
Glentoran,8368,5,12,7,11,41,42,-1,43
Coleraine,8368,6,11,8,11,41,48,-7,41
Glenavon,8368,7,10,8,12,55,60,-5,38
Ards,8368,8,10,6,14,38,46,-8,36
Dungannon,8368,9,8,9,13,49,53,-4,33
Portadown,8368,10,9,4,17,26,40,-14,31
Ballinamalla,8368,11,7,5,18,30,55,-25,26
Crusaders,8369,1,18,8,4,60,29,31,62
Linfield,8369,2,17,8,5,60,25,35,59
Cliftonville,8369,3,17,5,8,62,42,20,56
Ballymena,8369,4,12,8,10,55,57,-2,44
Dungannon,8369,5,10,12,8,53,40,13,42
Coleraine,8369,6,9,13,8,49,45,4,40
Glenavon,8369,7,8,11,11,44,53,-9,35
Glentoran,8369,8,8,7,15,26,48,-22,31
Portadown,8369,9,6,10,14,21,41,-20,28
Ballinamalla,8369,10,7,7,16,29,51,-22,28
Ards,8369,11,6,5,19,34,62,-28,23
Cliftonville,8370,1,17,3,10,55,41,14,54
Linfield,8370,2,14,10,6,58,34,24,52
Crusaders,8370,3,13,11,6,48,35,13,50
Ballymena,8370,4,12,8,10,53,60,-7,44
Coleraine,8370,5,11,10,9,46,37,9,43
Glenavon,8370,6,9,13,8,43,42,1,40
Portadown,8370,7,11,7,12,37,39,-2,40
Ballinamalla,8370,8,10,4,16,34,48,-14,34
Dungannon,8370,9,8,9,13,50,58,-8,33
Glentoran,8370,10,8,8,14,31,45,-14,32
Ards,8370,11,7,7,16,34,50,-16,28
Crusaders,8371,1,15,10,5,55,36,19,55
Glenavon,8371,2,14,11,5,57,38,19,53
Linfield,8371,3,14,8,8,56,33,23,50
Dungannon,8371,4,14,8,8,54,36,18,50
Ballymena,8371,5,13,8,9,59,54,5,47
Cliftonville,8371,6,13,5,12,50,39,11,44
Coleraine,8371,7,11,10,9,42,49,-7,43
Glentoran,8371,8,8,10,12,41,47,-6,34
Portadown,8371,9,7,6,17,23,50,-27,27
Ballinamalla,8371,10,7,5,18,29,56,-27,26
Ards,8371,11,6,5,19,31,59,-28,23
Cliftonville,8372,1,17,4,9,57,39,18,55
Crusaders,8372,2,16,6,8,56,44,12,54
Glenavon,8372,3,13,8,9,54,41,13,47
Linfield,8372,4,12,9,9,54,34,20,45
Coleraine,8372,5,11,12,7,40,35,5,45
Ballymena,8372,6,12,8,10,55,61,-6,44
Dungannon,8372,7,10,8,12,50,42,8,38
Glentoran,8372,8,10,6,14,32,44,-12,36
Ards,8372,9,9,6,15,45,57,-12,33
Portadown,8372,10,8,8,14,28,49,-21,32
Ballinamalla,8372,11,8,3,19,31,56,-25,27
Crusaders,8373,1,18,6,6,60,40,20,60
Linfield,8373,2,12,13,5,56,33,23,49
Glenavon,8373,3,12,12,6,50,37,13,48
Ballymena,8373,4,13,7,10,52,54,-2,46
Coleraine,8373,5,11,10,9,48,40,8,43
Dungannon,8373,6,10,10,10,53,47,6,40
Cliftonville,8373,7,12,4,14,52,53,-1,40
Ballinamalla,8373,8,10,4,16,37,52,-15,34
Glentoran,8373,9,9,5,16,29,39,-10,32
Ards,8373,10,9,5,16,34,48,-14,32
Portadown,8373,11,8,6,16,25,53,-28,30
Linfield,8374,1,16,10,4,60,28,32,58
Crusaders,8374,2,17,7,6,49,34,15,58
Cliftonville,8374,3,15,2,13,49,40,9,47
Ballymena,8374,4,14,5,11,58,54,4,47
Glenavon,8374,5,11,12,7,43,41,2,45
Coleraine,8374,6,12,8,10,41,41,0,44
Glentoran,8374,7,9,8,13,27,38,-11,35
Portadown,8374,8,10,3,17,26,39,-13,33
Ballinamalla,8374,9,9,5,16,31,49,-18,32
Dungannon,8374,10,7,9,14,40,45,-5,30
Ards,8374,11,8,5,17,36,51,-15,29
Cliftonville,8375,1,19,3,8,62,32,30,60
Crusaders,8375,2,14,7,9,55,43,12,49
Linfield,8375,3,13,8,9,55,35,20,47
Glenavon,8375,4,12,11,7,47,44,3,47
Ballymena,8375,5,13,5,12,56,65,-9,44
Coleraine,8375,6,12,7,11,42,41,1,43
Ards,8375,7,13,2,15,42,45,-3,41
Dungannon,8375,8,9,9,12,47,47,0,36
Glentoran,8375,9,10,5,15,37,51,-14,35
Ballinamalla,8375,10,9,4,17,26,47,-21,31
Portadown,8375,11,8,5,17,30,49,-19,29
Ballymena,8376,1,16,8,6,69,58,11,56
Crusaders,8376,2,15,8,7,58,38,20,53
Cliftonville,8376,3,15,6,9,57,37,20,51
Linfield,8376,4,12,10,8,58,39,19,46
Dungannon,8376,5,10,10,10,48,42,6,40
Coleraine,8376,6,9,10,11,40,47,-7,37
Portadown,8376,7,9,8,13,29,43,-14,35
Glenavon,8376,8,8,10,12,40,47,-7,34
Ards,8376,9,10,4,16,32,44,-12,34
Ballinamalla,8376,10,9,6,15,31,51,-20,33
Glentoran,8376,11,8,8,14,38,54,-16,32
Cliftonville,8377,1,16,5,9,53,39,14,53
Linfield,8377,2,13,10,7,55,37,18,49
Ballymena,8377,3,14,7,9,59,58,1,49
Dungannon,8377,4,13,9,8,57,45,12,48
Coleraine,8377,5,13,8,9,46,33,13,47
Glenavon,8377,6,11,12,7,42,41,1,45
Crusaders,8377,7,12,8,10,51,41,10,44
Ballinamalla,8377,8,10,4,16,39,49,-10,34
Ards,8377,9,7,9,14,33,45,-12,30
Glentoran,8377,10,6,10,14,24,44,-20,28
Portadown,8377,11,4,10,16,21,48,-27,22
Crusaders,8378,1,16,9,5,64,37,27,57
Linfield,8378,2,15,11,4,61,24,37,56
Glenavon,8378,3,12,10,8,46,40,6,46
Coleraine,8378,4,11,13,6,43,37,6,46
Cliftonville,8378,5,13,6,11,52,44,8,45
Ballymena,8378,6,12,7,11,55,63,-8,43
Dungannon,8378,7,9,12,9,48,46,2,39
Ards,8378,8,9,6,15,36,44,-8,33
Portadown,8378,9,6,10,14,21,42,-21,28
Glentoran,8378,10,6,9,15,28,50,-22,27
Ballinamalla,8378,11,7,5,18,25,52,-27,26
Crusaders,8379,1,17,9,4,54,27,27,60
Ballymena,8379,2,16,7,7,55,52,3,55
Linfield,8379,3,14,7,9,57,34,23,49
Cliftonville,8379,4,14,6,10,51,37,14,48
Glenavon,8379,5,12,10,8,48,43,5,46
Dungannon,8379,6,9,10,11,47,43,4,37
Glentoran,8379,7,9,8,13,33,43,-10,35
Coleraine,8379,8,7,12,11,38,43,-5,33
Ards,8379,9,9,6,15,39,52,-13,33
Ballinamalla,8379,10,9,6,15,29,46,-17,33
Portadown,8379,11,7,3,20,19,50,-31,24
Crusaders,8380,1,16,10,4,55,28,27,58
Linfield,8380,2,15,10,5,59,28,31,55
Cliftonville,8380,3,16,4,10,61,40,21,52
Coleraine,8380,4,11,11,8,42,39,3,44
Glenavon,8380,5,11,10,9,44,46,-2,43
Ballymena,8380,6,12,7,11,57,65,-8,43
Ballinamalla,8380,7,9,7,14,33,44,-11,34
Dungannon,8380,8,7,11,12,43,44,-1,32
Portadown,8380,9,8,7,15,27,44,-17,31
Glentoran,8380,10,8,7,15,32,56,-24,31
Ards,8380,11,7,6,17,36,55,-19,27
Cliftonville,8381,1,18,4,8,61,39,22,58
Coleraine,8381,2,14,10,6,48,35,13,52
Glenavon,8381,3,14,9,7,53,45,8,51
Crusaders,8381,4,14,8,8,57,45,12,50
Ballymena,8381,5,12,11,7,59,57,2,47
Linfield,8381,6,12,8,10,57,39,18,44
Dungannon,8381,7,10,10,10,57,47,10,40
Ards,8381,8,8,7,15,43,52,-9,31
Ballinamalla,8381,9,9,4,17,32,58,-26,31
Glentoran,8381,10,6,8,16,25,49,-24,26
Portadown,8381,11,7,3,20,28,54,-26,24
Crusaders,8382,1,18,7,5,61,40,21,61
Linfield,8382,2,16,7,7,61,32,29,55
Cliftonville,8382,3,15,6,9,55,38,17,51
Glenavon,8382,4,12,13,5,50,43,7,49
Dungannon,8382,5,10,11,9,48,38,10,41
Ballymena,8382,6,11,8,11,55,63,-8,41
Coleraine,8382,7,10,10,10,33,36,-3,40
Glentoran,8382,8,10,6,14,39,50,-11,36
Ards,8382,9,10,2,18,41,54,-13,32
Ballinamalla,8382,10,9,4,17,34,50,-16,31
Portadown,8382,11,5,4,21,19,52,-33,19
Crusaders,8383,1,18,7,5,59,34,25,61
Coleraine,8383,2,14,13,3,55,32,23,55
Linfield,8383,3,13,10,7,56,35,21,49
Cliftonville,8383,4,14,5,11,51,40,11,47
Glenavon,8383,5,11,13,6,44,40,4,46
Ballymena,8383,6,12,8,10,57,60,-3,44
Glentoran,8383,7,10,8,12,30,41,-11,38
Dungannon,8383,8,8,9,13,50,43,7,33
Ards,8383,9,8,7,15,37,46,-9,31
Portadown,8383,10,6,8,16,26,51,-25,26
Ballinamalla,8383,11,5,4,21,19,62,-43,19
Crusaders,8384,1,16,8,6,60,35,25,56
Linfield,8384,2,12,12,6,56,35,21,48
Ballymena,8384,3,14,6,10,57,56,1,48
Cliftonville,8384,4,13,8,9,53,37,16,47
Coleraine,8384,5,13,8,9,44,37,7,47
Glenavon,8384,6,12,11,7,41,39,2,47
Dungannon,8384,7,10,8,12,41,41,0,38
Glentoran,8384,8,8,10,12,30,43,-13,34
Ards,8384,9,9,4,17,37,52,-15,31
Ballinamalla,8384,10,9,2,19,29,54,-25,29
Portadown,8384,11,7,7,16,27,46,-19,28
Crusaders,8385,1,15,8,7,56,40,16,53
Coleraine,8385,2,14,10,6,47,37,10,52
Linfield,8385,3,13,9,8,63,42,21,48
Cliftonville,8385,4,14,6,10,52,42,10,48
Ballymena,8385,5,13,9,8,55,57,-2,48
Dungannon,8385,6,12,8,10,52,42,10,44
Glenavon,8385,7,11,11,8,56,50,6,44
Glentoran,8385,8,12,7,11,43,45,-2,43
Ards,8385,9,9,5,16,42,51,-9,32
Ballinamalla,8385,10,5,6,19,31,56,-25,21
Portadown,8385,11,5,5,20,21,56,-35,20
Cliftonville,8386,1,17,4,9,57,36,21,55
Crusaders,8386,2,15,10,5,56,35,21,55
Coleraine,8386,3,14,10,6,52,37,15,52
Ballymena,8386,4,15,6,9,63,57,6,51
Glenavon,8386,5,12,10,8,47,43,4,46
Dungannon,8386,6,11,9,10,61,49,12,42
Linfield,8386,7,10,8,12,49,44,5,38
Portadown,8386,8,9,6,15,28,43,-15,33
Glentoran,8386,9,8,8,14,34,48,-14,32
Ards,8386,10,8,4,18,36,62,-26,28
Ballinamalla,8386,11,6,5,19,28,57,-29,23
Crusaders,8387,1,17,6,7,55,33,22,57
Coleraine,8387,2,15,9,6,46,35,11,54
Ballymena,8387,3,15,6,9,61,52,9,51
Cliftonville,8387,4,15,5,10,52,39,13,50
Glenavon,8387,5,13,9,8,45,40,5,48
Linfield,8387,6,13,8,9,49,29,20,47
Dungannon,8387,7,8,10,12,49,46,3,34
Ards,8387,8,9,7,14,38,46,-8,34
Glentoran,8387,9,10,4,16,24,42,-18,34
Ballinamalla,8387,10,8,5,17,27,50,-23,29
Portadown,8387,11,6,3,21,22,56,-34,21
Crusaders,8388,1,16,9,5,55,39,16,57
Ballymena,8388,2,14,8,8,59,53,6,50
Cliftonville,8388,3,14,7,9,54,42,12,49
Linfield,8388,4,11,13,6,56,38,18,46
Coleraine,8388,5,12,10,8,44,43,1,46
Glenavon,8388,6,10,11,9,49,40,9,41
Dungannon,8388,7,9,11,10,52,43,9,38
Ards,8388,8,10,8,12,46,48,-2,38
Glentoran,8388,9,6,10,14,26,43,-17,28
Ballinamalla,8388,10,7,7,16,29,52,-23,28
Portadown,8388,11,5,8,17,24,53,-29,23
Crusaders,8389,1,16,11,3,59,35,24,59
Cliftonville,8389,2,16,5,9,62,40,22,53
Linfield,8389,3,14,9,7,58,43,15,51
Coleraine,8389,4,13,8,9,36,36,0,47
Ballymena,8389,5,13,6,11,53,55,-2,45
Glenavon,8389,6,11,11,8,49,46,3,44
Dungannon,8389,7,8,10,12,46,51,-5,34
Portadown,8389,8,9,6,15,30,39,-9,33
Glentoran,8389,9,8,6,16,41,48,-7,30
Ballinamalla,8389,10,8,6,16,33,55,-22,30
Ards,8389,11,7,6,17,38,57,-19,27
Linfield,8390,1,16,7,7,59,29,30,55
Crusaders,8390,2,16,6,8,50,30,20,54
Coleraine,8390,3,15,8,7,43,33,10,53
Cliftonville,8390,4,16,3,11,50,41,9,51
Ballymena,8390,5,12,5,13,55,59,-4,41
Dungannon,8390,6,11,7,12,56,47,9,40
Glentoran,8390,7,10,7,13,25,37,-12,37
Glenavon,8390,8,9,9,12,39,49,-10,36
Portadown,8390,9,9,7,14,26,41,-15,34
Ballinamalla,8390,10,9,4,17,28,45,-17,31
Ards,8390,11,8,5,17,32,52,-20,29
Cliftonville,8391,1,18,4,8,53,36,17,58
Crusaders,8391,2,16,8,6,55,38,17,56
Coleraine,8391,3,14,9,7,46,31,15,51
Ballymena,8391,4,15,4,11,60,52,8,49
Ards,8391,5,14,4,12,48,51,-3,46
Linfield,8391,6,12,8,10,52,37,15,44
Glenavon,8391,7,10,9,11,48,48,0,39
Dungannon,8391,8,8,9,13,44,50,-6,33
Portadown,8391,9,9,4,17,31,51,-20,31
Glentoran,8391,10,7,7,16,28,48,-20,28
Ballinamalla,8391,11,7,4,19,25,48,-23,25
Linfield,8392,1,15,8,7,64,36,28,53
Crusaders,8392,2,14,9,7,51,39,12,51
Glenavon,8392,3,13,11,6,52,41,11,50
Ballymena,8392,4,13,7,10,51,57,-6,46
Coleraine,8392,5,11,12,7,41,35,6,45
Cliftonville,8392,6,12,5,13,50,42,8,41
Glentoran,8392,7,10,10,10,35,38,-3,40
Dungannon,8392,8,8,11,11,42,44,-2,35
Ballinamalla,8392,9,9,4,17,35,55,-20,31
Ards,8392,10,7,8,15,34,48,-14,29
Portadown,8392,11,8,5,17,32,52,-20,29
Cliftonville,8393,1,16,6,8,56,38,18,54
Linfield,8393,2,14,11,5,60,29,31,53
Ballymena,8393,3,15,7,8,54,54,0,52
Coleraine,8393,4,14,8,8,46,39,7,50
Glenavon,8393,5,13,9,8,52,43,9,48
Dungannon,8393,6,11,9,10,56,45,11,42
Crusaders,8393,7,10,12,8,48,42,6,42
Glentoran,8393,8,7,10,13,33,43,-10,31
Ards,8393,9,6,9,15,39,57,-18,27
Ballinamalla,8393,10,8,3,19,25,55,-30,27
Portadown,8393,11,7,4,19,25,49,-24,25
Crusaders,8394,1,19,7,4,64,29,35,64
Cliftonville,8394,2,17,3,10,58,41,17,54
Glenavon,8394,3,14,9,7,61,47,14,51
Linfield,8394,4,14,8,8,60,35,25,50
Ballymena,8394,5,13,5,12,59,58,1,44
Coleraine,8394,6,10,10,10,41,43,-2,40
Dungannon,8394,7,9,10,11,53,49,4,37
Ards,8394,8,10,6,14,37,51,-14,36
Glentoran,8394,9,8,8,14,32,54,-22,32
Ballinamalla,8394,10,8,4,18,26,53,-27,28
Portadown,8394,11,5,6,19,25,56,-31,21
Ballymena,8395,1,16,6,8,60,54,6,54
Cliftonville,8395,2,15,5,10,51,39,12,50
Crusaders,8395,3,14,8,8,50,38,12,50
Linfield,8395,4,13,8,9,56,34,22,47
Coleraine,8395,5,12,11,7,41,32,9,47
Glenavon,8395,6,11,9,10,44,43,1,42
Dungannon,8395,7,10,9,11,47,42,5,39
Glentoran,8395,8,11,6,13,35,43,-8,39
Ards,8395,9,10,5,15,42,49,-7,35
Portadown,8395,10,8,3,19,23,47,-24,27
Ballinamalla,8395,11,7,6,17,26,54,-28,27
Crusaders,8396,1,15,12,3,55,34,21,57
Glenavon,8396,2,13,11,6,52,46,6,50
Linfield,8396,3,13,10,7,52,29,23,49
Cliftonville,8396,4,13,6,11,53,40,13,45
Dungannon,8396,5,12,9,9,59,47,12,45
Ballymena,8396,6,12,7,11,53,61,-8,43
Coleraine,8396,7,10,12,8,43,39,4,42
Glentoran,8396,8,10,8,12,37,45,-8,38
Ards,8396,9,8,7,15,40,47,-7,31
Portadown,8396,10,8,7,15,32,49,-17,31
Ballinamalla,8396,11,4,5,21,21,60,-39,17
Linfield,8397,1,17,10,3,62,23,39,61
Crusaders,8397,2,14,7,9,62,45,17,49
Glenavon,8397,3,11,13,6,47,42,5,46
Cliftonville,8397,4,13,6,11,60,54,6,45
Ballymena,8397,5,13,6,11,60,57,3,45
Coleraine,8397,6,10,11,9,45,47,-2,41
Dungannon,8397,7,10,10,10,50,45,5,40
Glentoran,8397,8,9,9,12,32,43,-11,36
Portadown,8397,9,8,9,13,28,41,-13,33
Ards,8397,10,9,5,16,34,51,-17,32
Ballinamalla,8397,11,6,4,20,28,60,-32,22
Crusaders,8398,1,15,10,5,60,36,24,55
Linfield,8398,2,14,12,4,68,40,28,54
Cliftonville,8398,3,16,5,9,60,40,20,53
Glenavon,8398,4,12,12,6,51,47,4,48
Ballymena,8398,5,14,6,10,52,55,-3,48
Coleraine,8398,6,11,13,6,44,35,9,46
Dungannon,8398,7,10,9,11,54,43,11,39
Ballinamalla,8398,8,9,4,17,24,51,-27,31
Glentoran,8398,9,6,10,14,31,51,-20,28
Ards,8398,10,7,6,17,36,52,-16,27
Portadown,8398,11,5,5,20,17,47,-30,20
Linfield,8399,1,15,8,7,60,35,25,53
Crusaders,8399,2,15,8,7,55,38,17,53
Ballymena,8399,3,15,7,8,65,56,9,52
Cliftonville,8399,4,13,5,12,52,50,2,44
Coleraine,8399,5,11,9,10,50,49,1,42
Glenavon,8399,6,9,14,7,49,51,-2,41
Glentoran,8399,7,10,9,11,30,39,-9,39
Dungannon,8399,8,10,8,12,49,45,4,38
Ballinamalla,8399,9,10,6,14,41,49,-8,36
Portadown,8399,10,8,6,16,28,46,-18,30
Ards,8399,11,5,8,17,33,54,-21,23
Linfield,8400,1,18,9,3,71,27,44,63
Cliftonville,8400,2,15,7,8,53,37,16,52
Glenavon,8400,3,14,10,6,52,38,14,52
Crusaders,8400,4,14,9,7,55,37,18,51
Ballymena,8400,5,15,5,10,60,60,0,50
Coleraine,8400,6,12,11,7,49,47,2,47
Dungannon,8400,7,9,8,13,52,55,-3,35
Glentoran,8400,8,9,7,14,32,43,-11,34
Ballinamalla,8400,9,9,3,18,29,53,-24,30
Ards,8400,10,7,6,17,35,50,-15,27
Portadown,8400,11,3,5,22,15,56,-41,14
Linfield,8401,1,15,8,7,61,31,30,53
Ballymena,8401,2,14,7,9,67,60,7,49
Crusaders,8401,3,14,7,9,50,44,6,49
Cliftonville,8401,4,13,6,11,55,46,9,45
Glentoran,8401,5,12,9,9,41,40,1,45
Glenavon,8401,6,12,8,10,42,44,-2,44
Coleraine,8401,7,11,9,10,39,38,1,42
Dungannon,8401,8,10,8,12,47,40,7,38
Portadown,8401,9,9,6,15,26,45,-19,33
Ballinamalla,8401,10,9,3,18,27,50,-23,30
Ards,8401,11,8,5,17,38,55,-17,29
Crusaders,8402,1,19,6,5,58,27,31,63
Cliftonville,8402,2,18,2,10,53,36,17,56
Linfield,8402,3,14,10,6,53,31,22,52
Glenavon,8402,4,14,9,7,50,40,10,51
Ballymena,8402,5,14,6,10,62,62,0,48
Coleraine,8402,6,11,10,9,45,40,5,43
Glentoran,8402,7,8,10,12,29,38,-9,34
Dungannon,8402,8,8,9,13,44,50,-6,33
Ards,8402,9,9,6,15,36,45,-9,33
Portadown,8402,10,6,4,20,27,51,-24,22
Ballinamalla,8402,11,6,4,20,23,60,-37,22
Cliftonville,8403,1,17,4,9,68,39,29,55
Linfield,8403,2,15,10,5,58,31,27,55
Crusaders,8403,3,16,7,7,54,35,19,55
Ballymena,8403,4,14,8,8,61,56,5,50
Dungannon,8403,5,10,12,8,52,45,7,42
Glentoran,8403,6,10,7,13,35,42,-7,37
Coleraine,8403,7,9,9,12,41,41,0,36
Glenavon,8403,8,9,9,12,48,57,-9,36
Portadown,8403,9,9,7,14,29,45,-16,34
Ards,8403,10,8,6,16,35,54,-19,30
Ballinamalla,8403,11,7,3,20,23,59,-36,24
Linfield,8404,1,16,9,5,60,31,29,57
Crusaders,8404,2,16,9,5,59,37,22,57
Cliftonville,8404,3,18,3,9,56,42,14,57
Dungannon,8404,4,12,10,8,50,37,13,46
Ballymena,8404,5,12,10,8,54,53,1,46
Coleraine,8404,6,9,11,10,36,37,-1,38
Glenavon,8404,7,9,10,11,49,60,-11,37
Ards,8404,8,9,6,15,42,46,-4,33
Glentoran,8404,9,8,8,14,27,42,-15,32
Ballinamalla,8404,10,6,8,16,31,51,-20,26
Portadown,8404,11,5,6,19,22,50,-28,21
Cliftonville,8405,1,16,5,9,59,44,15,53
Ballymena,8405,2,15,8,7,65,51,14,53
Linfield,8405,3,14,10,6,61,35,26,52
Crusaders,8405,4,15,7,8,53,38,15,52
Glenavon,8405,5,14,10,6,54,41,13,52
Coleraine,8405,6,11,10,9,42,36,6,43
Ballinamalla,8405,7,11,2,17,39,50,-11,35
Ards,8405,8,9,4,17,37,57,-20,31
Dungannon,8405,9,6,11,13,46,49,-3,29
Glentoran,8405,10,6,9,15,22,44,-22,27
Portadown,8405,11,7,6,17,25,58,-33,27
Crusaders,8406,1,18,6,6,59,34,25,60
Cliftonville,8406,2,17,5,8,56,36,20,56
Linfield,8406,3,13,7,10,54,34,20,46
Coleraine,8406,4,12,8,10,43,38,5,44
Ballymena,8406,5,12,8,10,58,58,0,44
Glenavon,8406,6,9,13,8,43,42,1,40
Dungannon,8406,7,9,8,13,43,46,-3,35
Ards,8406,8,10,5,15,40,44,-4,35
Portadown,8406,9,9,6,15,32,55,-23,33
Ballinamalla,8406,10,9,5,16,28,46,-18,32
Glentoran,8406,11,8,7,15,26,49,-23,31
Crusaders,8407,1,19,7,4,65,30,35,64
Cliftonville,8407,2,16,7,7,54,35,19,55
Linfield,8407,3,14,11,5,51,28,23,53
Glenavon,8407,4,11,14,5,46,42,4,47
Ballymena,8407,5,13,8,9,59,59,0,47
Coleraine,8407,6,8,13,9,41,44,-3,37
Dungannon,8407,7,8,9,13,51,50,1,33
Ballinamalla,8407,8,10,2,18,37,58,-21,32
Ards,8407,9,7,9,14,31,42,-11,30
Portadown,8407,10,5,9,16,24,43,-19,24
Glentoran,8407,11,5,9,16,23,51,-28,24
Crusaders,8408,1,18,7,5,63,34,29,61
Linfield,8408,2,16,8,6,65,35,30,56
Cliftonville,8408,3,16,5,9,47,31,16,53
Ballymena,8408,4,14,5,11,58,62,-4,47
Glenavon,8408,5,12,9,9,50,47,3,45
Coleraine,8408,6,10,14,6,38,33,5,44
Dungannon,8408,7,9,10,11,50,45,5,37
Ards,8408,8,10,5,15,42,50,-8,35
Glentoran,8408,9,6,9,15,27,50,-23,27
Ballinamalla,8408,10,7,5,18,30,57,-27,26
Portadown,8408,11,5,7,18,23,49,-26,22
Ballymena,8409,1,17,6,7,64,56,8,57
Crusaders,8409,2,16,7,7,55,38,17,55
Linfield,8409,3,14,10,6,57,26,31,52
Glenavon,8409,4,11,12,7,41,38,3,45
Cliftonville,8409,5,13,5,12,47,41,6,44
Coleraine,8409,6,9,14,7,37,34,3,41
Dungannon,8409,7,10,10,10,48,40,8,40
Glentoran,8409,8,6,13,11,27,39,-12,31
Ballinamalla,8409,9,8,7,15,27,47,-20,31
Ards,8409,10,8,6,16,40,58,-18,30
Portadown,8409,11,7,2,21,26,52,-26,23
Cliftonville,8410,1,17,4,9,51,36,15,55
Crusaders,8410,2,15,6,9,51,32,19,51
Linfield,8410,3,14,8,8,63,37,26,50
Ballymena,8410,4,15,5,10,57,54,3,50
Glenavon,8410,5,13,9,8,53,44,9,48
Coleraine,8410,6,13,9,8,43,35,8,48
Dungannon,8410,7,9,10,11,48,46,2,37
Glentoran,8410,8,9,9,12,37,48,-11,36
Ards,8410,9,8,5,17,40,60,-20,29
Ballinamalla,8410,10,9,2,19,34,61,-27,29
Portadown,8410,11,6,7,17,18,42,-24,25
Crusaders,8411,1,16,9,5,61,36,25,57
Glenavon,8411,2,14,9,7,57,47,10,51
Dungannon,8411,3,14,8,8,56,40,16,50
Cliftonville,8411,4,15,5,10,57,45,12,50
Linfield,8411,5,13,10,7,62,35,27,49
Ballymena,8411,6,14,6,10,61,58,3,48
Coleraine,8411,7,9,9,12,41,51,-10,36
Ards,8411,8,9,5,16,35,46,-11,32
Glentoran,8411,9,7,10,13,34,51,-17,31
Ballinamalla,8411,10,7,5,18,30,61,-31,26
Portadown,8411,11,7,4,19,28,52,-24,25
Linfield,8412,1,17,7,6,65,31,34,58
Cliftonville,8412,2,16,5,9,56,43,13,53
Crusaders,8412,3,13,9,8,52,37,15,48
Glenavon,8412,4,12,10,8,49,39,10,46
Ballymena,8412,5,13,5,12,55,60,-5,44
Coleraine,8412,6,11,9,10,34,34,0,42
Dungannon,8412,7,9,11,10,42,37,5,38
Glentoran,8412,8,10,5,15,29,44,-15,35
Portadown,8412,9,9,5,16,27,45,-18,32
Ballinamalla,8412,10,9,4,17,31,48,-17,31
Ards,8412,11,9,4,17,39,61,-22,31
Crusaders,8413,1,16,8,6,61,40,21,56
Linfield,8413,2,15,10,5,57,28,29,55
Cliftonville,8413,3,16,4,10,53,45,8,52
Coleraine,8413,4,12,11,7,43,37,6,47
Glenavon,8413,5,11,12,7,53,46,7,45
Dungannon,8413,6,10,10,10,53,45,8,40
Ballymena,8413,7,11,7,12,50,61,-11,40
Portadown,8413,8,11,4,15,30,38,-8,37
Glentoran,8413,9,9,7,14,32,42,-10,34
Ards,8413,10,8,4,18,40,61,-21,28
Ballinamalla,8413,11,6,3,21,23,52,-29,21
Cliftonville,8414,1,17,4,9,56,38,18,55
Linfield,8414,2,14,11,5,60,32,28,53
Crusaders,8414,3,14,7,9,48,35,13,49
Dungannon,8414,4,11,11,8,47,32,15,44
Coleraine,8414,5,11,10,9,44,37,7,43
Ballymena,8414,6,12,5,13,51,57,-6,41
Glentoran,8414,7,10,10,10,29,35,-6,40
Glenavon,8414,8,10,8,12,41,51,-10,38
Ards,8414,9,10,7,13,38,47,-9,37
Ballinamalla,8414,10,8,9,13,27,42,-15,33
Portadown,8414,11,6,2,22,22,57,-35,20
Cliftonville,8415,1,21,3,6,63,32,31,66
Crusaders,8415,2,18,7,5,64,37,27,61
Linfield,8415,3,16,8,6,64,30,34,56
Coleraine,8415,4,15,9,6,43,31,12,54
Ballymena,8415,5,14,3,13,55,60,-5,45
Dungannon,8415,6,11,8,11,53,45,8,41
Glenavon,8415,7,8,10,12,40,50,-10,34
Glentoran,8415,8,9,7,14,26,46,-20,34
Ards,8415,9,8,5,17,33,48,-15,29
Ballinamalla,8415,10,7,2,21,26,54,-28,23
Portadown,8415,11,5,4,21,20,54,-34,19
Crusaders,8416,1,17,8,5,56,33,23,59
Dungannon,8416,2,14,6,10,57,46,11,48
Coleraine,8416,3,13,9,8,45,34,11,48
Cliftonville,8416,4,14,5,11,51,43,8,47
Linfield,8416,5,12,9,9,56,33,23,45
Ballymena,8416,6,12,8,10,53,62,-9,44
Ards,8416,7,11,6,13,41,43,-2,39
Glenavon,8416,8,10,7,13,45,48,-3,37
Glentoran,8416,9,10,6,14,32,44,-12,36
Portadown,8416,10,7,7,16,30,50,-20,28
Ballinamalla,8416,11,7,5,18,32,62,-30,26
Cliftonville,8417,1,19,4,7,60,34,26,61
Linfield,8417,2,16,7,7,54,32,22,55
Crusaders,8417,3,16,7,7,47,29,18,55
Ballymena,8417,4,14,5,11,55,55,0,47
Glenavon,8417,5,12,9,9,48,45,3,45
Dungannon,8417,6,11,9,10,48,42,6,42
Glentoran,8417,7,11,7,12,29,39,-10,40
Coleraine,8417,8,10,9,11,40,41,-1,39
Portadown,8417,9,7,5,18,20,45,-25,26
Ballinamalla,8417,10,7,4,19,29,51,-22,25
Ards,8417,11,6,6,18,35,52,-17,24
Cliftonville,8418,1,16,5,9,55,36,19,53
Linfield,8418,2,14,10,6,60,31,29,52
Crusaders,8418,3,14,9,7,56,40,16,51
Coleraine,8418,4,14,9,7,49,38,11,51
Ballymena,8418,5,12,5,13,57,69,-12,41
Glenavon,8418,6,10,10,10,47,47,0,40
Dungannon,8418,7,10,9,11,53,49,4,39
Ballinamalla,8418,8,9,8,13,32,49,-17,35
Ards,8418,9,8,9,13,38,47,-9,33
Glentoran,8418,10,8,9,13,31,45,-14,33
Portadown,8418,11,6,5,19,28,55,-27,23
Crusaders,8419,1,16,8,6,57,34,23,56
Ballymena,8419,2,17,5,8,63,53,10,56
Coleraine,8419,3,13,9,8,49,48,1,48
Linfield,8419,4,13,8,9,52,37,15,47
Cliftonville,8419,5,13,4,13,48,41,7,43
Dungannon,8419,6,10,9,11,52,45,7,39
Ballinamalla,8419,7,10,6,14,38,50,-12,36
Glenavon,8419,8,8,11,11,46,49,-3,35
Glentoran,8419,9,9,8,13,26,44,-18,35
Ards,8419,10,9,5,16,41,54,-13,32
Portadown,8419,11,8,5,17,31,48,-17,29
Crusaders,8420,1,17,9,4,57,31,26,60
Linfield,8420,2,17,7,6,61,30,31,58
Cliftonville,8420,3,17,5,8,53,36,17,56
Ballymena,8420,4,14,5,11,56,57,-1,47
Coleraine,8420,5,10,10,10,44,41,3,40
Glentoran,8420,6,11,7,12,36,41,-5,40
Dungannon,8420,7,9,10,11,54,53,1,37
Glenavon,8420,8,9,10,11,41,50,-9,37
Ballinamalla,8420,9,9,3,18,30,54,-24,30
Portadown,8420,10,7,5,18,23,43,-20,26
Ards,8420,11,6,7,17,32,51,-19,25
Linfield,8421,1,15,9,6,57,32,25,54
Ballymena,8421,2,16,5,9,68,57,11,53
Crusaders,8421,3,15,6,9,55,43,12,51
Coleraine,8421,4,13,9,8,46,43,3,48
Cliftonville,8421,5,14,4,12,57,43,14,46
Glenavon,8421,6,12,10,8,48,45,3,46
Dungannon,8421,7,11,8,11,53,45,8,41
Glentoran,8421,8,8,9,13,30,45,-15,33
Ballinamalla,8421,9,10,2,18,32,55,-23,32
Ards,8421,10,7,7,16,34,53,-19,28
Portadown,8421,11,6,7,17,26,45,-19,25
Crusaders,8422,1,20,6,4,61,27,34,66
Linfield,8422,2,15,7,8,54,31,23,52
Cliftonville,8422,3,13,7,10,47,38,9,46
Dungannon,8422,4,12,9,9,55,47,8,45
Coleraine,8422,5,10,10,10,42,39,3,40
Ballymena,8422,6,11,7,12,51,57,-6,40
Glenavon,8422,7,8,14,8,41,42,-1,38
Ards,8422,8,10,7,13,41,50,-9,37
Glentoran,8422,8,10,7,13,41,50,-9,37
Portadown,8422,10,7,7,16,25,46,-21,28
Ballinamalla,8422,11,5,7,18,31,62,-31,22
Crusaders,8423,1,17,7,6,54,37,17,58
Cliftonville,8423,2,16,5,9,56,37,19,53
Linfield,8423,3,13,11,6,66,36,30,50
Ballymena,8423,4,11,10,9,57,59,-2,43
Glentoran,8423,5,11,8,11,34,38,-4,41
Dungannon,8423,6,10,10,10,49,42,7,40
Glenavon,8423,7,9,11,10,40,47,-7,38
Coleraine,8423,8,8,11,11,44,46,-2,35
Ballinamalla,8423,9,9,6,15,37,52,-15,33
Portadown,8423,10,8,6,16,24,49,-25,30
Ards,8423,11,6,9,15,35,53,-18,27
Crusaders,8424,1,21,6,3,62,29,33,69
Cliftonville,8424,2,17,3,10,65,37,28,54
Ballymena,8424,3,15,4,11,67,62,5,49
Glenavon,8424,4,13,8,9,48,46,2,47
Coleraine,8424,5,10,13,7,36,38,-2,43
Linfield,8424,6,11,8,11,55,41,14,41
Dungannon,8424,7,10,8,12,50,46,4,38
Glentoran,8424,8,10,7,13,36,46,-10,37
Ards,8424,9,10,5,15,40,54,-14,35
Portadown,8424,10,7,4,19,25,54,-29,25
Ballinamalla,8424,11,5,6,19,22,53,-31,21
Linfield,8425,1,16,11,3,66,27,39,59
Crusaders,8425,2,18,5,7,59,33,26,59
Cliftonville,8425,3,16,5,9,59,39,20,53
Ballymena,8425,4,15,5,10,55,57,-2,50
Coleraine,8425,5,11,10,9,40,35,5,43
Glenavon,8425,6,10,9,11,41,48,-7,39
Ards,8425,7,12,2,16,43,55,-12,38
Portadown,8425,8,10,5,15,31,44,-13,35
Dungannon,8425,9,8,8,14,39,44,-5,32
Glentoran,8425,10,7,6,17,26,50,-24,27
Ballinamalla,8425,11,8,2,20,30,57,-27,26
Crusaders,8426,1,19,6,5,60,27,33,63
Linfield,8426,2,17,7,6,65,34,31,58
Glenavon,8426,3,12,12,6,52,42,10,48
Cliftonville,8426,4,13,6,11,52,45,7,45
Coleraine,8426,5,11,11,8,39,33,6,44
Ballymena,8426,6,12,7,11,54,59,-5,43
Glentoran,8426,7,11,5,14,30,40,-10,38
Dungannon,8426,8,10,7,13,47,50,-3,37
Ards,8426,9,9,3,18,31,45,-14,30
Ballinamalla,8426,10,8,3,19,26,56,-30,27
Portadown,8426,11,7,5,18,26,51,-25,26
Crusaders,8427,1,18,8,4,60,31,29,62
Linfield,8427,2,16,8,6,59,29,30,56
Ballymena,8427,3,14,9,7,56,53,3,51
Coleraine,8427,4,11,12,7,39,33,6,45
Dungannon,8427,5,11,10,9,46,41,5,43
Glenavon,8427,6,9,12,9,46,49,-3,39
Cliftonville,8427,7,10,8,12,48,46,2,38
Portadown,8427,8,9,6,15,30,43,-13,33
Glentoran,8427,9,6,11,13,26,44,-18,29
Ards,8427,10,7,7,16,29,47,-18,28
Ballinamalla,8427,11,5,7,18,27,50,-23,22
Crusaders,8428,1,16,10,4,55,31,24,58
Linfield,8428,2,14,11,5,61,30,31,53
Ballymena,8428,3,13,8,9,56,57,-1,47
Cliftonville,8428,4,12,10,8,48,37,11,46
Glenavon,8428,5,10,10,10,42,45,-3,40
Coleraine,8428,6,9,11,10,42,42,0,38
Portadown,8428,7,10,7,13,31,39,-8,37
Ballinamalla,8428,8,11,4,15,34,46,-12,37
Dungannon,8428,9,10,6,14,52,53,-1,36
Glentoran,8428,10,8,6,16,26,50,-24,30
Ards,8428,11,8,5,17,37,54,-17,29
Cliftonville,8429,1,18,2,10,54,37,17,56
Glenavon,8429,2,15,9,6,51,41,10,54
Linfield,8429,3,15,8,7,67,39,28,53
Ards,8429,4,15,3,12,43,38,5,48
Crusaders,8429,5,13,8,9,46,36,10,47
Ballymena,8429,6,14,4,12,59,61,-2,46
Coleraine,8429,7,10,9,11,46,47,-1,39
Glentoran,8429,8,10,6,14,30,43,-13,36
Portadown,8429,9,9,6,15,29,47,-18,33
Dungannon,8429,10,7,7,16,47,54,-7,28
Ballinamalla,8429,11,6,4,20,25,54,-29,22
Crusaders,8430,1,20,5,5,59,24,35,65
Linfield,8430,2,14,9,7,59,36,23,51
Ballymena,8430,3,14,8,8,50,47,3,50
Cliftonville,8430,4,14,5,11,52,45,7,47
Glenavon,8430,5,11,11,8,52,52,0,44
Glentoran,8430,6,10,10,10,26,32,-6,40
Coleraine,8430,7,10,9,11,48,46,2,39
Dungannon,8430,8,9,10,11,48,50,-2,37
Ards,8430,9,8,10,12,34,46,-12,34
Portadown,8430,10,6,5,19,23,44,-21,23
Ballinamalla,8430,11,4,8,18,24,53,-29,20
Linfield,8431,1,16,11,3,59,23,36,59
Crusaders,8431,2,14,8,8,55,43,12,50
Coleraine,8431,3,13,10,7,45,31,14,49
Ballymena,8431,4,12,12,6,63,57,6,48
Glenavon,8431,5,12,11,7,50,47,3,47
Cliftonville,8431,6,13,6,11,41,39,2,45
Dungannon,8431,7,10,9,11,51,47,4,39
Glentoran,8431,8,9,10,11,33,40,-7,37
Ards,8431,9,9,4,17,37,48,-11,31
Ballinamalla,8431,10,8,2,20,26,56,-30,26
Portadown,8431,11,4,7,19,22,51,-29,19
Linfield,8432,1,14,12,4,55,25,30,54
Dungannon,8432,2,15,8,7,61,35,26,53
Crusaders,8432,3,15,8,7,55,39,16,53
Cliftonville,8432,4,15,6,9,50,34,16,51
Ballymena,8432,5,13,7,10,52,57,-5,46
Coleraine,8432,6,11,11,8,43,36,7,44
Glenavon,8432,7,9,13,8,45,48,-3,40
Glentoran,8432,8,9,6,15,24,40,-16,33
Ballinamalla,8432,9,8,4,18,30,54,-24,28
Ards,8432,10,6,8,16,32,52,-20,26
Portadown,8432,11,5,7,18,24,51,-27,22
Cliftonville,8433,1,18,5,7,53,31,22,59
Crusaders,8433,2,17,7,6,54,32,22,58
Ballymena,8433,3,14,8,8,55,50,5,50
Linfield,8433,4,12,12,6,56,37,19,48
Coleraine,8433,5,11,11,8,37,36,1,44
Dungannon,8433,6,10,13,7,47,35,12,43
Glenavon,8433,7,10,9,11,43,46,-3,39
Glentoran,8433,8,7,9,14,29,44,-15,30
Ards,8433,9,7,6,17,32,45,-13,27
Ballinamalla,8433,10,6,8,16,24,44,-20,26
Portadown,8433,11,6,6,18,20,50,-30,24
Crusaders,8434,1,17,7,6,57,34,23,58
Linfield,8434,2,14,11,5,60,30,30,53
Ballymena,8434,3,15,5,10,58,51,7,50
Cliftonville,8434,4,14,7,9,54,40,14,49
Glenavon,8434,5,12,9,9,52,53,-1,45
Coleraine,8434,6,10,11,9,47,41,6,41
Dungannon,8434,7,10,9,11,48,49,-1,39
Glentoran,8434,8,9,10,11,35,42,-7,37
Ards,8434,9,10,5,15,33,48,-15,35
Portadown,8434,10,7,5,18,29,51,-22,26
Ballinamalla,8434,11,5,5,20,24,58,-34,20
Crusaders,8435,1,17,9,4,58,32,26,60
Linfield,8435,2,15,10,5,63,30,33,55
Cliftonville,8435,3,15,6,9,53,40,13,51
Coleraine,8435,4,12,13,5,42,31,11,49
Glenavon,8435,5,11,13,6,48,44,4,46
Dungannon,8435,6,11,9,10,50,41,9,42
Ballymena,8435,7,11,7,12,44,55,-11,40
Ards,8435,8,10,3,17,36,50,-14,33
Portadown,8435,9,8,5,17,27,51,-24,29
Glentoran,8435,10,6,9,15,30,48,-18,27
Ballinamalla,8435,11,5,4,21,28,57,-29,19
Coleraine,8436,1,15,12,3,45,27,18,57
Crusaders,8436,2,16,8,6,58,35,23,56
Linfield,8436,3,13,9,8,58,36,22,48
Ballymena,8436,4,13,6,11,56,59,-3,45
Cliftonville,8436,5,13,5,12,46,37,9,44
Glenavon,8436,6,10,13,7,40,40,0,43
Dungannon,8436,7,10,11,9,50,42,8,41
Glentoran,8436,8,10,4,16,31,50,-19,34
Ards,8436,9,8,6,16,36,49,-13,30
Ballinamalla,8436,10,8,4,18,31,51,-20,28
Portadown,8436,11,8,4,18,28,53,-25,28
Cliftonville,8437,1,18,6,6,54,29,25,60
Crusaders,8437,2,15,11,4,58,41,17,56
Ballymena,8437,3,15,6,9,63,58,5,51
Linfield,8437,4,13,10,7,60,40,20,49
Dungannon,8437,5,12,8,10,57,43,14,44
Coleraine,8437,6,11,8,11,42,40,2,41
Glenavon,8437,7,10,9,11,44,47,-3,39
Glentoran,8437,8,8,11,11,38,48,-10,35
Ards,8437,9,9,3,18,40,55,-15,30
Ballinamalla,8437,10,6,7,17,29,54,-25,25
Portadown,8437,11,6,5,19,26,56,-30,23
Crusaders,8438,1,18,7,5,55,33,22,61
Cliftonville,8438,2,18,3,9,54,39,15,57
Linfield,8438,3,14,9,7,61,37,24,51
Glenavon,8438,4,13,12,5,52,42,10,51
Ballymena,8438,5,13,6,11,60,58,2,45
Coleraine,8438,6,11,10,9,50,44,6,43
Glentoran,8438,7,10,7,13,30,42,-12,37
Dungannon,8438,8,7,10,13,43,44,-1,31
Portadown,8438,9,8,7,15,30,47,-17,31
Ballinamalla,8438,10,7,4,19,29,56,-27,25
Ards,8438,11,7,3,20,29,51,-22,24
Ballymena,8439,1,17,5,8,64,54,10,56
Crusaders,8439,2,15,6,9,51,35,16,51
Linfield,8439,3,13,10,7,56,35,21,49
Cliftonville,8439,4,15,4,11,50,39,11,49
Dungannon,8439,5,12,8,10,53,44,9,44
Coleraine,8439,6,11,9,10,45,43,2,42
Glenavon,8439,7,10,9,11,50,55,-5,39
Glentoran,8439,8,10,7,13,29,39,-10,37
Ards,8439,9,11,2,17,40,57,-17,35
Ballinamalla,8439,10,9,5,16,38,53,-15,32
Portadown,8439,11,7,5,18,28,50,-22,26
Linfield,8440,1,16,8,6,58,33,25,56
Glenavon,8440,2,15,10,5,52,36,16,55
Crusaders,8440,3,15,7,8,56,37,19,52
Ballymena,8440,4,16,4,10,54,52,2,52
Cliftonville,8440,5,15,4,11,56,41,15,49
Coleraine,8440,6,12,9,9,43,40,3,45
Dungannon,8440,7,10,10,10,54,44,10,40
Portadown,8440,8,8,7,15,29,52,-23,31
Glentoran,8440,9,7,7,16,30,48,-18,28
Ards,8440,10,6,7,17,33,53,-20,25
Ballinamalla,8440,11,7,3,20,31,60,-29,24
Cliftonville,8441,1,16,4,10,46,38,8,52
Crusaders,8441,2,14,9,7,60,42,18,51
Linfield,8441,3,13,9,8,62,35,27,48
Glenavon,8441,4,12,11,7,53,46,7,47
Dungannon,8441,5,11,10,9,51,42,9,43
Coleraine,8441,6,11,10,9,38,34,4,43
Ballymena,8441,7,12,6,12,56,60,-4,42
Glentoran,8441,8,10,8,12,39,49,-10,38
Portadown,8441,9,10,4,16,29,46,-17,34
Ballinamalla,8441,10,8,6,16,31,52,-21,30
Ards,8441,11,8,3,19,35,56,-21,27
Crusaders,8442,1,16,9,5,54,29,25,57
Cliftonville,8442,2,17,5,8,51,32,19,56
Linfield,8442,3,16,6,8,56,31,25,54
Ballymena,8442,4,16,6,8,58,53,5,54
Glenavon,8442,5,12,10,8,48,47,1,46
Coleraine,8442,6,11,9,10,43,38,5,42
Glentoran,8442,7,8,8,14,40,48,-8,32
Dungannon,8442,8,6,12,12,41,49,-8,30
Ards,8442,9,8,4,18,41,61,-20,28
Ballinamalla,8442,10,7,6,17,30,51,-21,27
Portadown,8442,11,6,9,15,26,49,-23,27
Crusaders,8443,1,16,7,7,56,39,17,55
Dungannon,8443,2,14,8,8,63,45,18,50
Ballymena,8443,3,14,8,8,59,55,4,50
Linfield,8443,4,13,10,7,58,31,27,49
Glenavon,8443,5,13,10,7,51,43,8,49
Cliftonville,8443,6,14,4,12,52,46,6,46
Coleraine,8443,7,11,9,10,43,42,1,42
Ards,8443,8,8,7,15,41,51,-10,31
Glentoran,8443,9,8,6,16,29,49,-20,30
Portadown,8443,10,9,3,18,29,50,-21,30
Ballinamalla,8443,11,6,6,18,30,60,-30,24
Crusaders,8444,1,19,6,5,67,36,31,63
Cliftonville,8444,2,17,5,8,55,34,21,56
Linfield,8444,3,14,7,9,52,31,21,49
Glenavon,8444,4,12,11,7,49,42,7,47
Coleraine,8444,5,10,11,9,45,41,4,41
Ballymena,8444,6,12,4,14,51,54,-3,40
Dungannon,8444,7,9,11,10,48,48,0,38
Glentoran,8444,8,9,8,13,31,40,-9,35
Portadown,8444,9,9,4,17,24,46,-22,31
Ballinamalla,8444,10,8,5,17,28,52,-24,29
Ards,8444,11,8,4,18,31,57,-26,28
Linfield,8445,1,15,11,4,60,28,32,56
Cliftonville,8445,2,16,5,9,49,37,12,53
Crusaders,8445,3,14,9,7,47,35,12,51
Glenavon,8445,4,12,12,6,50,46,4,48
Ballymena,8445,5,13,8,9,53,51,2,47
Ards,8445,6,11,7,12,56,46,10,40
Dungannon,8445,7,11,7,12,52,45,7,40
Coleraine,8445,8,9,10,11,37,40,-3,37
Portadown,8445,9,7,7,16,28,49,-21,28
Ballinamalla,8445,10,8,3,19,25,62,-37,27
Glentoran,8445,11,6,7,17,29,47,-18,25
Cliftonville,8446,1,16,5,9,46,29,17,53
Crusaders,8446,2,15,8,7,45,33,12,53
Glenavon,8446,3,14,9,7,52,41,11,51
Linfield,8446,4,14,8,8,60,34,26,50
Coleraine,8446,5,12,9,9,39,35,4,45
Ballymena,8446,6,11,7,12,52,68,-16,40
Ards,8446,7,9,8,13,39,45,-6,35
Glentoran,8446,8,9,8,13,30,43,-13,35
Dungannon,8446,9,8,10,12,46,43,3,34
Ballinamalla,8446,10,8,6,16,29,46,-17,30
Portadown,8446,11,7,6,17,23,44,-21,27
Linfield,8447,1,14,9,7,50,26,24,51
Crusaders,8447,2,14,7,9,54,49,5,49
Cliftonville,8447,3,14,6,10,52,42,10,48
Glenavon,8447,4,13,9,8,50,45,5,48
Dungannon,8447,5,12,9,9,58,46,12,45
Coleraine,8447,6,11,9,10,48,40,8,42
Ballymena,8447,7,12,6,12,49,59,-10,42
Glentoran,8447,8,10,8,12,33,37,-4,38
Ards,8447,9,10,4,16,34,47,-13,34
Ballinamalla,8447,10,7,9,14,36,54,-18,30
Portadown,8447,11,8,4,18,29,48,-19,28
Linfield,8448,1,16,11,3,71,32,39,59
Cliftonville,8448,2,17,5,8,55,41,14,56
Crusaders,8448,3,14,9,7,52,35,17,51
Ballymena,8448,4,14,9,7,66,60,6,51
Dungannon,8448,5,11,9,10,48,39,9,42
Coleraine,8448,6,10,11,9,40,37,3,41
Glenavon,8448,7,10,11,9,43,48,-5,41
Ards,8448,8,9,5,16,38,53,-15,32
Glentoran,8448,9,8,6,16,30,46,-16,30
Ballinamalla,8448,10,8,4,18,28,51,-23,28
Portadown,8448,11,5,6,19,28,57,-29,21
Linfield,8449,1,17,7,6,61,30,31,58
Crusaders,8449,2,16,10,4,59,29,30,58
Coleraine,8449,3,12,11,7,42,36,6,47
Cliftonville,8449,4,14,4,12,56,48,8,46
Ballymena,8449,5,14,4,12,60,64,-4,46
Glenavon,8449,6,11,11,8,42,41,1,44
Dungannon,8449,7,9,11,10,48,44,4,38
Ards,8449,8,10,7,13,41,47,-6,37
Ballinamalla,8449,9,11,3,16,35,51,-16,36
Glentoran,8449,10,7,7,16,31,48,-17,28
Portadown,8449,11,4,5,21,24,61,-37,17
Crusaders,8450,1,17,6,7,56,34,22,57
Cliftonville,8450,2,16,6,8,54,35,19,54
Ballymena,8450,3,16,6,8,60,56,4,54
Glenavon,8450,4,13,11,6,53,38,15,50
Coleraine,8450,5,12,12,6,47,37,10,48
Linfield,8450,6,12,11,7,55,35,20,47
Dungannon,8450,7,8,10,12,50,49,1,34
Ballinamalla,8450,8,8,7,15,33,51,-18,31
Ards,8450,9,7,6,17,33,54,-21,27
Glentoran,8450,10,7,6,17,29,54,-25,27
Portadown,8450,11,5,7,18,27,54,-27,22
Linfield,8451,1,16,11,3,64,28,36,59
Crusaders,8451,2,16,7,7,54,34,20,55
Ballymena,8451,3,15,5,10,58,60,-2,50
Cliftonville,8451,4,14,5,11,55,43,12,47
Glenavon,8451,5,12,9,9,46,47,-1,45
Coleraine,8451,6,10,13,7,45,41,4,43
Dungannon,8451,7,7,12,11,48,49,-1,33
Portadown,8451,8,9,6,15,31,47,-16,33
Ards,8451,9,9,4,17,37,55,-18,31
Glentoran,8451,10,5,12,13,25,41,-16,27
Ballinamalla,8451,11,7,6,17,31,49,-18,27
Crusaders,8452,1,17,8,5,62,32,30,59
Coleraine,8452,2,13,10,7,46,42,4,49
Linfield,8452,3,13,8,9,56,39,17,47
Glenavon,8452,4,12,11,7,59,49,10,47
Cliftonville,8452,5,13,7,10,49,39,10,46
Ballymena,8452,6,12,8,10,55,64,-9,44
Dungannon,8452,7,10,10,10,53,42,11,40
Portadown,8452,8,11,5,14,32,46,-14,38
Glentoran,8452,9,7,9,14,29,46,-17,30
Ards,8452,10,6,7,17,30,50,-20,25
Ballinamalla,8452,11,6,7,17,34,56,-22,25
Linfield,8453,1,16,8,6,63,29,34,56
Crusaders,8453,2,15,10,5,56,33,23,55
Cliftonville,8453,3,14,5,11,51,41,10,47
Dungannon,8453,4,12,9,9,56,44,12,45
Coleraine,8453,5,11,12,7,44,35,9,45
Glenavon,8453,6,10,14,6,45,45,0,44
Ballymena,8453,7,13,4,13,54,66,-12,43
Ards,8453,8,10,3,17,39,55,-16,33
Glentoran,8453,9,9,6,15,29,47,-18,33
Portadown,8453,10,9,5,16,29,44,-15,32
Ballinamalla,8453,11,6,4,20,26,53,-27,22
Cliftonville,8454,1,16,4,10,48,34,14,52
Coleraine,8454,2,13,11,6,45,31,14,50
Crusaders,8454,3,14,8,8,49,40,9,50
Ballymena,8454,4,14,4,12,53,63,-10,46
Linfield,8454,5,12,9,9,62,40,22,45
Glentoran,8454,6,11,8,11,36,40,-4,41
Dungannon,8454,7,10,10,10,51,44,7,40
Glenavon,8454,8,10,10,10,46,50,-4,40
Ballinamalla,8454,9,9,5,16,35,52,-17,32
Ards,8454,10,9,4,17,38,51,-13,31
Portadown,8454,11,7,7,16,28,46,-18,28
Crusaders,8455,1,17,9,4,67,33,34,60
Linfield,8455,2,16,9,5,62,38,24,57
Cliftonville,8455,3,17,5,8,60,38,22,56
Ballymena,8455,4,15,6,9,63,62,1,51
Glenavon,8455,5,11,10,9,51,48,3,43
Coleraine,8455,6,10,10,10,43,45,-2,40
Dungannon,8455,7,10,9,11,60,54,6,39
Glentoran,8455,8,9,8,13,37,44,-7,35
Ballinamalla,8455,9,9,2,19,31,59,-28,29
Ards,8455,10,8,4,18,38,59,-21,28
Portadown,8455,11,4,6,20,23,55,-32,18
Linfield,8456,1,16,11,3,58,24,34,59
Coleraine,8456,2,14,10,6,52,34,18,52
Cliftonville,8456,3,16,4,10,52,41,11,52
Ballymena,8456,4,15,7,8,55,51,4,52
Crusaders,8456,5,14,8,8,55,35,20,50
Dungannon,8456,6,11,9,10,48,40,8,42
Glenavon,8456,7,11,9,10,44,43,1,42
Glentoran,8456,8,7,8,15,24,48,-24,29
Portadown,8456,9,7,6,17,26,46,-20,27
Ballinamalla,8456,10,7,6,17,28,53,-25,27
Ards,8456,11,6,4,20,27,54,-27,22
Cliftonville,8457,1,15,8,7,50,35,15,53
Crusaders,8457,2,14,9,7,51,37,14,51
Coleraine,8457,3,14,8,8,48,32,16,50
Linfield,8457,4,13,9,8,59,37,22,48
Ballymena,8457,5,14,6,10,55,57,-2,48
Dungannon,8457,6,12,9,9,48,40,8,45
Glenavon,8457,7,10,11,9,46,45,1,41
Ballinamalla,8457,8,9,4,17,35,52,-17,31
Ards,8457,9,8,6,16,33,53,-20,30
Glentoran,8457,10,7,8,15,32,46,-14,29
Portadown,8457,11,7,6,17,20,43,-23,27
Cliftonville,8458,1,17,6,7,49,30,19,57
Crusaders,8458,2,16,6,8,51,34,17,54
Ballymena,8458,3,16,5,9,62,60,2,53
Coleraine,8458,4,13,10,7,43,32,11,49
Linfield,8458,5,13,9,8,60,35,25,48
Glenavon,8458,6,13,9,8,50,49,1,48
Glentoran,8458,7,11,4,15,34,49,-15,37
Dungannon,8458,8,9,9,12,54,45,9,36
Ards,8458,9,9,4,17,38,50,-12,31
Ballinamalla,8458,10,9,3,18,27,49,-22,30
Portadown,8458,11,4,5,21,20,55,-35,17
Linfield,8459,1,17,7,6,56,26,30,58
Ballymena,8459,2,17,6,7,61,56,5,57
Glenavon,8459,3,16,8,6,57,38,19,56
Crusaders,8459,4,14,8,8,44,39,5,50
Coleraine,8459,5,12,9,9,45,34,11,45
Cliftonville,8459,6,12,9,9,46,37,9,45
Dungannon,8459,7,11,8,11,55,45,10,41
Ards,8459,8,8,6,16,34,45,-11,30
Glentoran,8459,9,7,6,17,26,48,-22,27
Portadown,8459,10,6,6,18,24,51,-27,24
Ballinamalla,8459,11,6,5,19,29,58,-29,23
Crusaders,8460,1,18,5,7,62,41,21,59
Linfield,8460,2,14,8,8,62,42,20,50
Cliftonville,8460,3,16,2,12,54,42,12,50
Ballymena,8460,4,14,6,10,61,58,3,48
Dungannon,8460,5,11,9,10,49,42,7,42
Glenavon,8460,6,9,12,9,48,51,-3,39
Coleraine,8460,7,10,8,12,41,46,-5,38
Ards,8460,8,10,6,14,38,47,-9,36
Glentoran,8460,9,9,7,14,28,41,-13,34
Ballinamalla,8460,10,10,4,16,39,57,-18,34
Portadown,8460,11,9,3,18,28,43,-15,30
Crusaders,8461,1,16,9,5,56,36,20,57
Linfield,8461,2,14,13,3,56,31,25,55
Ballymena,8461,3,16,6,8,65,51,14,54
Cliftonville,8461,4,15,5,10,46,36,10,50
Glenavon,8461,5,9,10,11,44,50,-6,37
Coleraine,8461,6,9,9,12,39,39,0,36
Ballinamalla,8461,7,11,3,16,31,47,-16,36
Dungannon,8461,8,8,10,12,46,47,-1,34
Ards,8461,9,10,4,16,38,47,-9,34
Portadown,8461,10,9,4,17,25,41,-16,31
Glentoran,8461,11,8,7,15,30,51,-21,31
Crusaders,8462,1,16,8,6,57,40,17,56
Cliftonville,8462,2,16,7,7,57,36,21,55
Glenavon,8462,3,13,10,7,47,36,11,49
Linfield,8462,4,12,11,7,58,37,21,47
Ballymena,8462,5,14,5,11,54,58,-4,47
Dungannon,8462,6,12,9,9,55,43,12,45
Coleraine,8462,7,10,10,10,41,40,1,40
Ards,8462,8,9,8,13,40,49,-9,35
Glentoran,8462,9,7,8,15,31,48,-17,29
Portadown,8462,10,7,7,16,27,51,-24,28
Ballinamalla,8462,11,4,7,19,27,56,-29,19
Crusaders,8463,1,17,6,7,59,44,15,57
Linfield,8463,2,15,11,4,59,29,30,56
Coleraine,8463,3,15,11,4,46,32,14,56
Ballymena,8463,4,16,4,10,63,57,6,52
Cliftonville,8463,5,13,5,12,51,45,6,44
Dungannon,8463,6,11,8,11,51,42,9,41
Glenavon,8463,7,10,9,11,48,47,1,39
Ards,8463,8,9,4,17,32,48,-16,31
Portadown,8463,9,9,3,18,29,46,-17,30
Glentoran,8463,10,8,5,17,28,49,-21,29
Ballinamalla,8463,11,6,6,18,29,56,-27,24
Crusaders,8464,1,20,5,5,60,31,29,65
Cliftonville,8464,2,14,6,10,54,39,15,48
Coleraine,8464,3,12,12,6,45,32,13,48
Ballymena,8464,4,13,7,10,56,57,-1,46
Glenavon,8464,5,12,8,10,52,43,9,44
Linfield,8464,6,11,10,9,47,38,9,43
Dungannon,8464,7,10,9,11,48,43,5,39
Ards,8464,8,10,6,14,45,46,-1,36
Ballinamalla,8464,9,11,2,17,30,55,-25,35
Portadown,8464,10,9,3,18,32,50,-18,30
Glentoran,8464,11,6,6,18,27,62,-35,24
Crusaders,8465,1,21,6,3,62,31,31,69
Linfield,8465,2,15,7,8,58,36,22,52
Dungannon,8465,3,14,9,7,53,37,16,51
Cliftonville,8465,4,16,3,11,56,45,11,51
Coleraine,8465,5,10,11,9,40,43,-3,41
Glenavon,8465,6,9,13,8,46,43,3,40
Ballymena,8465,7,11,6,13,53,62,-9,39
Ballinamalla,8465,8,10,2,18,30,52,-22,32
Portadown,8465,9,8,6,16,22,39,-17,30
Glentoran,8465,10,6,8,16,25,40,-15,26
Ards,8465,11,7,5,18,37,54,-17,26
Linfield,8466,1,16,9,5,68,34,34,57
Crusaders,8466,2,16,9,5,57,30,27,57
Ballymena,8466,3,14,9,7,55,53,2,51
Coleraine,8466,4,11,11,8,41,39,2,44
Cliftonville,8466,5,11,9,10,53,48,5,42
Glenavon,8466,6,10,11,9,47,45,2,41
Dungannon,8466,7,9,10,11,50,42,8,37
Portadown,8466,8,9,6,15,25,48,-23,33
Ballinamalla,8466,9,7,8,15,34,52,-18,29
Glentoran,8466,10,7,8,15,28,50,-22,29
Ards,8466,11,7,6,17,34,51,-17,27
Crusaders,8467,1,17,5,8,52,34,18,56
Linfield,8467,2,15,8,7,63,33,30,53
Ballymena,8467,3,15,7,8,66,58,8,52
Glenavon,8467,4,12,11,7,45,37,8,47
Portadown,8467,5,12,5,13,37,43,-6,41
Cliftonville,8467,6,12,4,14,45,44,1,40
Dungannon,8467,7,10,10,10,57,58,-1,40
Coleraine,8467,8,10,10,10,32,36,-4,40
Ballinamalla,8467,9,11,2,17,37,50,-13,35
Glentoran,8467,10,7,7,16,31,51,-20,28
Ards,8467,11,7,5,18,33,54,-21,26
Ballymena,8468,1,14,8,8,58,54,4,50
Cliftonville,8468,2,14,7,9,49,36,13,49
Crusaders,8468,3,13,10,7,44,31,13,49
Linfield,8468,4,12,11,7,53,29,24,47
Glenavon,8468,5,11,11,8,48,43,5,44
Coleraine,8468,6,9,15,6,41,39,2,42
Glentoran,8468,7,11,7,12,29,35,-6,40
Dungannon,8468,8,10,8,12,43,43,0,38
Ards,8468,9,9,7,14,33,43,-10,34
Ballinamalla,8468,10,9,3,18,28,48,-20,30
Portadown,8468,11,7,5,18,22,47,-25,26
Linfield,8469,1,15,8,7,57,31,26,53
Crusaders,8469,2,14,9,7,54,42,12,51
Cliftonville,8469,3,13,8,9,51,39,12,47
Glenavon,8469,4,13,8,9,50,44,6,47
Ballymena,8469,5,13,8,9,61,62,-1,47
Coleraine,8469,6,10,11,9,43,43,0,41
Ards,8469,7,11,5,14,36,43,-7,38
Dungannon,8469,8,8,12,10,50,46,4,36
Glentoran,8469,9,9,7,14,29,39,-10,34
Portadown,8469,10,7,7,16,23,44,-21,28
Ballinamalla,8469,11,6,9,15,28,49,-21,27
Coleraine,8470,1,14,8,8,46,38,8,50
Ballymena,8470,2,14,7,9,55,52,3,49
Cliftonville,8470,3,13,7,10,43,35,8,46
Crusaders,8470,4,11,11,8,49,36,13,44
Glenavon,8470,5,11,10,9,46,45,1,43
Linfield,8470,6,11,9,10,47,34,13,42
Dungannon,8470,7,10,10,10,50,43,7,40
Ards,8470,8,11,6,13,47,56,-9,39
Ballinamalla,8470,9,10,6,14,35,44,-9,36
Portadown,8470,10,8,7,15,26,46,-20,31
Glentoran,8470,11,7,9,14,29,44,-15,30
Crusaders,8471,1,17,8,5,52,30,22,59
Cliftonville,8471,2,18,4,8,56,32,24,58
Linfield,8471,3,12,10,8,61,37,24,46
Glentoran,8471,4,12,7,11,29,33,-4,43
Dungannon,8471,5,11,9,10,48,40,8,42
Ballymena,8471,6,10,8,12,51,61,-10,38
Coleraine,8471,7,8,12,10,34,37,-3,36
Glenavon,8471,8,8,11,11,38,51,-13,35
Portadown,8471,9,10,5,15,28,44,-16,35
Ards,8471,10,9,5,16,35,43,-8,32
Ballinamalla,8471,11,8,5,17,25,49,-24,29
Linfield,8472,1,16,9,5,61,34,27,57
Cliftonville,8472,2,16,5,9,50,37,13,53
Crusaders,8472,3,14,8,8,59,45,14,50
Coleraine,8472,4,11,9,10,38,38,0,42
Ballymena,8472,5,12,5,13,58,57,1,41
Dungannon,8472,6,9,11,10,48,48,0,38
Glenavon,8472,7,9,11,10,47,48,-1,38
Ards,8472,8,11,5,14,41,44,-3,38
Ballinamalla,8472,9,11,3,16,31,49,-18,36
Glentoran,8472,10,8,8,14,29,42,-13,32
Portadown,8472,11,9,4,17,27,47,-20,31
Crusaders,8473,1,17,7,6,58,34,24,58
Cliftonville,8473,2,16,5,9,54,38,16,53
Glenavon,8473,3,13,10,7,48,44,4,49
Ballymena,8473,4,13,6,11,61,59,2,45
Linfield,8473,5,11,10,9,53,43,10,43
Coleraine,8473,6,11,10,9,40,36,4,43
Glentoran,8473,7,10,9,11,35,43,-8,39
Dungannon,8473,8,10,7,13,52,51,1,37
Ballinamalla,8473,9,9,4,17,38,52,-14,31
Portadown,8473,10,9,4,17,32,51,-19,31
Ards,8473,11,6,8,16,32,52,-20,26
Linfield,8474,1,15,8,7,59,30,29,53
Crusaders,8474,2,15,8,7,60,40,20,53
Ballymena,8474,3,16,5,9,62,56,6,53
Cliftonville,8474,4,15,4,11,53,48,5,49
Glenavon,8474,5,11,13,6,50,42,8,46
Coleraine,8474,6,12,10,8,44,36,8,46
Glentoran,8474,7,12,6,12,35,42,-7,42
Dungannon,8474,8,9,7,14,45,50,-5,34
Portadown,8474,9,7,7,16,27,47,-20,28
Ards,8474,10,8,2,20,35,55,-20,26
Ballinamalla,8474,11,6,8,16,25,49,-24,26
Cliftonville,8475,1,17,3,10,55,40,15,54
Ballymena,8475,2,16,6,8,62,54,8,54
Crusaders,8475,3,14,10,6,56,41,15,52
Linfield,8475,4,14,9,7,54,30,24,51
Coleraine,8475,5,11,12,7,42,34,8,45
Glenavon,8475,6,10,12,8,49,50,-1,42
Dungannon,8475,7,10,11,9,56,46,10,41
Glentoran,8475,8,9,6,15,32,46,-14,33
Portadown,8475,9,7,7,16,25,44,-19,28
Ards,8475,10,7,6,17,31,47,-16,27
Ballinamalla,8475,11,5,8,17,24,54,-30,23
Crusaders,8476,1,17,8,5,60,42,18,59
Linfield,8476,2,17,6,7,74,37,37,57
Ballymena,8476,3,17,5,8,60,53,7,56
Glenavon,8476,4,11,10,9,53,49,4,43
Coleraine,8476,5,11,10,9,41,37,4,43
Ards,8476,6,11,5,14,35,44,-9,38
Cliftonville,8476,7,11,4,15,45,45,0,37
Portadown,8476,8,10,6,14,32,44,-12,36
Glentoran,8476,9,9,8,13,36,44,-8,35
Dungannon,8476,10,8,9,13,49,51,-2,33
Ballinamalla,8476,11,5,5,20,22,61,-39,20
Cliftonville,8477,1,17,5,8,55,39,16,56
Crusaders,8477,2,16,7,7,53,29,24,55
Linfield,8477,3,14,11,5,62,27,35,53
Coleraine,8477,4,13,11,6,43,32,11,50
Ballymena,8477,5,13,7,10,50,54,-4,46
Glenavon,8477,6,11,10,9,45,48,-3,43
Ards,8477,7,10,6,14,38,47,-9,36
Dungannon,8477,8,8,10,12,44,41,3,34
Glentoran,8477,9,5,12,13,24,42,-18,27
Portadown,8477,10,7,6,17,16,40,-24,27
Ballinamalla,8477,11,5,7,18,30,61,-31,22
Cliftonville,8478,1,18,3,9,56,41,15,57
Crusaders,8478,2,16,7,7,59,37,22,55
Ballymena,8478,3,15,9,6,67,50,17,54
Coleraine,8478,4,12,11,7,48,37,11,47
Linfield,8478,5,12,8,10,58,44,14,44
Glenavon,8478,6,10,10,10,42,44,-2,40
Dungannon,8478,7,9,12,9,53,48,5,39
Glentoran,8478,8,8,8,14,32,50,-18,32
Ballinamalla,8478,9,8,7,15,29,48,-19,31
Ards,8478,10,8,6,16,40,49,-9,30
Portadown,8478,11,4,9,17,18,54,-36,21
Crusaders,8479,1,18,6,6,61,38,23,60
Cliftonville,8479,2,17,6,7,60,33,27,57
Ballymena,8479,3,14,8,8,65,59,6,50
Linfield,8479,4,12,11,7,58,38,20,47
Coleraine,8479,5,11,8,11,37,43,-6,41
Glenavon,8479,6,8,13,9,42,50,-8,37
Dungannon,8479,7,9,9,12,50,43,7,36
Glentoran,8479,8,8,9,13,31,50,-19,33
Portadown,8479,8,9,6,15,31,50,-19,33
Ballinamalla,8479,10,9,4,17,32,52,-20,31
Ards,8479,11,7,6,17,39,50,-11,27
Linfield,8480,1,18,6,6,65,31,34,60
Cliftonville,8480,2,17,3,10,56,44,12,54
Ballymena,8480,3,15,6,9,64,61,3,51
Crusaders,8480,4,13,5,12,47,43,4,44
Glenavon,8480,5,11,10,9,49,42,7,43
Dungannon,8480,6,10,10,10,56,45,11,40
Glentoran,8480,7,10,9,11,31,42,-11,39
Coleraine,8480,8,9,11,10,35,44,-9,38
Ards,8480,9,10,2,18,36,50,-14,32
Ballinamalla,8480,10,8,5,17,36,53,-17,29
Portadown,8480,11,8,5,17,26,46,-20,29
Linfield,8481,1,18,7,5,70,34,36,61
Crusaders,8481,2,15,9,6,57,37,20,54
Cliftonville,8481,3,17,3,10,53,38,15,54
Glenavon,8481,4,12,11,7,49,41,8,47
Coleraine,8481,5,12,10,8,40,30,10,46
Dungannon,8481,6,11,11,8,57,42,15,44
Ballymena,8481,7,12,8,10,52,57,-5,44
Ards,8481,8,9,5,16,38,53,-15,32
Glentoran,8481,9,8,8,14,32,52,-20,32
Ballinamalla,8481,10,6,5,19,27,58,-31,23
Portadown,8481,11,4,5,21,20,53,-33,17
Crusaders,8482,1,17,9,4,54,31,23,60
Ballymena,8482,2,15,8,7,61,49,12,53
Coleraine,8482,3,11,13,6,46,36,10,46
Linfield,8482,4,12,9,9,52,36,16,45
Cliftonville,8482,5,13,4,13,47,48,-1,43
Dungannon,8482,6,10,9,11,49,45,4,39
Glenavon,8482,7,9,12,9,46,48,-2,39
Glentoran,8482,8,8,11,11,31,41,-10,35
Ards,8482,9,8,7,15,34,47,-13,31
Portadown,8482,10,8,7,15,26,42,-16,31
Ballinamalla,8482,11,6,7,17,28,51,-23,25
Linfield,8483,1,16,9,5,61,30,31,57
Crusaders,8483,2,16,8,6,61,36,25,56
Cliftonville,8483,3,17,5,8,57,36,21,56
Glenavon,8483,4,11,14,5,54,44,10,47
Coleraine,8483,5,10,12,8,43,41,2,42
Ards,8483,6,12,4,14,40,47,-7,40
Ballymena,8483,7,11,7,12,52,61,-9,40
Dungannon,8483,8,8,9,13,48,53,-5,33
Ballinamalla,8483,9,9,4,17,29,47,-18,31
Glentoran,8483,10,8,7,15,30,49,-19,31
Portadown,8483,11,5,5,20,22,53,-31,20
Linfield,8484,1,16,10,4,61,26,35,58
Cliftonville,8484,2,16,3,11,49,42,7,51
Ballymena,8484,3,15,6,9,62,60,2,51
Crusaders,8484,4,13,7,10,49,46,3,46
Glenavon,8484,5,12,9,9,49,44,5,45
Coleraine,8484,6,11,11,8,43,39,4,44
Dungannon,8484,7,9,8,13,42,48,-6,35
Ards,8484,8,10,5,15,36,45,-9,35
Glentoran,8484,9,9,7,14,39,43,-4,34
Ballinamalla,8484,10,9,3,18,34,53,-19,30
Portadown,8484,11,7,7,16,29,47,-18,28
Linfield,8485,1,17,8,5,63,30,33,59
Crusaders,8485,2,16,9,5,53,34,19,57
Glenavon,8485,3,12,13,5,44,35,9,49
Ballymena,8485,4,13,9,8,54,50,4,48
Coleraine,8485,5,10,10,10,38,31,7,40
Dungannon,8485,6,10,9,11,51,45,6,39
Glentoran,8485,7,9,10,11,41,45,-4,37
Cliftonville,8485,8,10,7,13,41,48,-7,37
Ballinamalla,8485,9,10,3,17,34,50,-16,33
Ards,8485,10,8,4,18,35,55,-20,28
Portadown,8485,11,5,8,17,19,50,-31,23
Linfield,8486,1,17,9,4,69,27,42,60
Cliftonville,8486,2,15,5,10,57,42,15,50
Crusaders,8486,3,14,8,8,53,42,11,50
Glenavon,8486,4,12,12,6,46,36,10,48
Ballymena,8486,5,13,7,10,58,65,-7,46
Coleraine,8486,6,11,11,8,36,33,3,44
Dungannon,8486,7,11,7,12,47,42,5,40
Ards,8486,8,9,6,15,40,49,-9,33
Ballinamalla,8486,9,10,3,17,30,47,-17,33
Glentoran,8486,10,7,9,14,25,49,-24,30
Portadown,8486,11,5,5,20,25,54,-29,20
Crusaders,8487,1,17,10,3,60,33,27,61
Glenavon,8487,2,14,10,6,56,43,13,52
Linfield,8487,3,14,9,7,58,34,24,51
Ballymena,8487,4,13,5,12,54,56,-2,44
Coleraine,8487,5,11,9,10,41,40,1,42
Dungannon,8487,6,10,11,9,53,45,8,41
Cliftonville,8487,7,11,5,14,47,52,-5,38
Ards,8487,8,11,5,14,40,46,-6,38
Portadown,8487,9,7,10,13,25,39,-14,31
Glentoran,8487,10,8,6,16,32,53,-21,30
Ballinamalla,8487,11,7,4,19,30,55,-25,25
Crusaders,8488,1,18,7,5,57,34,23,61
Linfield,8488,2,17,6,7,61,29,32,57
Ballymena,8488,3,17,5,8,71,56,15,56
Glenavon,8488,4,12,10,8,55,44,11,46
Coleraine,8488,5,12,10,8,46,44,2,46
Cliftonville,8488,6,13,5,12,55,57,-2,44
Dungannon,8488,7,9,10,11,51,49,2,37
Glentoran,8488,8,9,9,12,29,40,-11,36
Ards,8488,9,9,5,16,38,50,-12,32
Ballinamalla,8488,10,5,5,20,29,59,-30,20
Portadown,8488,11,4,8,18,24,54,-30,20
Crusaders,8489,1,17,8,5,54,30,24,59
Linfield,8489,2,15,10,5,61,34,27,55
Ballymena,8489,3,15,6,9,62,54,8,51
Cliftonville,8489,4,14,5,11,49,37,12,47
Dungannon,8489,5,12,8,10,51,43,8,44
Coleraine,8489,6,10,11,9,42,38,4,41
Glenavon,8489,7,9,14,7,44,45,-1,41
Glentoran,8489,8,10,7,13,32,43,-11,37
Ards,8489,9,9,2,19,41,59,-18,29
Ballinamalla,8489,10,8,5,17,28,50,-22,29
Portadown,8489,11,5,6,19,18,49,-31,21
Linfield,8490,1,17,7,6,66,34,32,58
Crusaders,8490,2,15,8,7,51,29,22,53
Cliftonville,8490,3,15,5,10,55,44,11,50
Ballymena,8490,4,14,5,11,65,62,3,47
Coleraine,8490,5,12,8,10,42,43,-1,44
Glentoran,8490,6,12,5,13,43,48,-5,41
Glenavon,8490,7,10,9,11,45,46,-1,39
Ards,8490,8,12,2,16,40,50,-10,38
Portadown,8490,9,8,7,15,24,50,-26,31
Dungannon,8490,10,7,9,14,42,43,-1,30
Ballinamalla,8490,11,8,5,17,27,51,-24,29
Cliftonville,8491,1,18,5,7,62,33,29,59
Crusaders,8491,2,15,7,8,56,40,16,52
Ballymena,8491,3,15,6,9,55,53,2,51
Linfield,8491,4,14,8,8,55,35,20,50
Coleraine,8491,5,11,10,9,45,38,7,43
Glenavon,8491,6,11,9,10,50,55,-5,42
Dungannon,8491,7,11,8,11,50,45,5,41
Ards,8491,8,11,6,13,38,43,-5,39
Glentoran,8491,9,7,8,15,31,51,-20,29
Ballinamalla,8491,10,7,5,18,27,50,-23,26
Portadown,8491,11,7,4,19,21,47,-26,25
Linfield,8492,1,16,9,5,63,27,36,57
Crusaders,8492,2,16,8,6,58,38,20,56
Cliftonville,8492,3,15,8,7,55,38,17,53
Ballymena,8492,4,15,5,10,63,61,2,50
Coleraine,8492,5,13,7,10,48,36,12,46
Glenavon,8492,6,12,8,10,49,50,-1,44
Dungannon,8492,7,11,10,9,51,39,12,43
Ards,8492,8,9,4,17,36,51,-15,31
Glentoran,8492,9,8,6,16,30,50,-20,30
Ballinamalla,8492,10,6,8,16,25,51,-26,26
Portadown,8492,11,5,5,20,21,58,-37,20
Linfield,8493,1,16,8,6,62,26,36,56
Coleraine,8493,2,15,9,6,53,39,14,54
Crusaders,8493,3,15,6,9,48,38,10,51
Cliftonville,8493,4,14,5,11,61,45,16,47
Ballymena,8493,5,13,7,10,61,63,-2,46
Glentoran,8493,6,12,6,12,38,48,-10,42
Dungannon,8493,7,10,8,12,51,47,4,38
Glenavon,8493,8,9,10,11,42,52,-10,37
Ballinamalla,8493,9,9,6,15,32,46,-14,33
Portadown,8493,10,8,5,17,28,48,-20,29
Ards,8493,11,6,6,18,25,49,-24,24
Crusaders,8494,1,17,8,5,60,32,28,59
Glenavon,8494,2,17,8,5,58,37,21,59
Linfield,8494,3,14,10,6,60,34,26,52
Dungannon,8494,4,12,8,10,51,43,8,44
Coleraine,8494,5,11,10,9,42,37,5,43
Cliftonville,8494,6,12,7,11,47,45,2,43
Ballymena,8494,7,11,9,10,57,58,-1,42
Glentoran,8494,8,9,6,15,28,45,-17,33
Ards,8494,9,8,4,18,36,56,-20,28
Portadown,8494,10,7,6,17,24,46,-22,27
Ballinamalla,8494,11,7,4,19,29,59,-30,25
Crusaders,8495,1,17,7,6,52,33,19,58
Cliftonville,8495,2,17,4,9,58,42,16,55
Linfield,8495,3,13,11,6,60,35,25,50
Glenavon,8495,4,13,11,6,48,40,8,50
Coleraine,8495,5,12,10,8,49,41,8,46
Ballymena,8495,6,13,7,10,54,55,-1,46
Glentoran,8495,7,9,7,14,38,47,-9,34
Ards,8495,8,9,6,15,30,44,-14,33
Dungannon,8495,9,7,9,14,53,49,4,30
Ballinamalla,8495,10,9,3,18,32,53,-21,30
Portadown,8495,11,6,5,19,21,56,-35,23
Ballymena,8496,1,17,7,6,61,50,11,58
Linfield,8496,2,15,9,6,64,31,33,54
Crusaders,8496,3,14,8,8,58,44,14,50
Glenavon,8496,4,13,9,8,47,46,1,48
Dungannon,8496,5,12,8,10,52,44,8,44
Ards,8496,6,12,6,12,39,41,-2,42
Cliftonville,8496,7,12,4,14,53,51,2,40
Coleraine,8496,8,9,12,9,41,36,5,39
Glentoran,8496,9,10,6,14,34,48,-14,36
Ballinamalla,8496,10,6,6,18,23,51,-28,24
Portadown,8496,11,6,3,21,19,49,-30,21
Linfield,8497,1,17,11,2,61,24,37,62
Crusaders,8497,2,17,10,3,63,33,30,61
Cliftonville,8497,3,17,5,8,49,33,16,56
Ballymena,8497,4,13,4,13,47,55,-8,43
Glenavon,8497,5,10,11,9,43,41,2,41
Coleraine,8497,6,8,14,8,40,42,-2,38
Portadown,8497,7,10,4,16,28,46,-18,34
Ards,8497,8,8,8,14,39,50,-11,32
Glentoran,8497,9,7,10,13,31,45,-14,31
Dungannon,8497,10,6,11,13,50,53,-3,29
Ballinamalla,8497,11,4,8,18,27,56,-29,20
Crusaders,8498,1,17,8,5,63,33,30,59
Linfield,8498,2,15,9,6,61,33,28,54
Ballymena,8498,3,12,11,7,64,61,3,47
Dungannon,8498,4,13,7,10,51,37,14,46
Cliftonville,8498,5,12,6,12,51,42,9,42
Glentoran,8498,6,12,6,12,42,48,-6,42
Glenavon,8498,7,10,11,9,49,52,-3,41
Coleraine,8498,8,9,13,8,42,41,1,40
Ards,8498,9,9,5,16,37,54,-17,32
Portadown,8498,10,7,4,19,22,48,-26,25
Ballinamalla,8498,11,7,4,19,25,58,-33,25
Linfield,8499,1,15,10,5,67,34,33,55
Crusaders,8499,2,15,10,5,53,31,22,55
Cliftonville,8499,3,16,5,9,59,43,16,53
Ballymena,8499,4,13,6,11,60,62,-2,45
Coleraine,8499,5,10,12,8,42,38,4,42
Dungannon,8499,6,9,11,10,49,45,4,38
Glenavon,8499,7,8,12,10,38,43,-5,36
Glentoran,8499,8,9,8,13,30,44,-14,35
Portadown,8499,9,9,8,13,26,44,-18,35
Ards,8499,10,9,4,17,40,54,-14,31
Ballinamalla,8499,11,5,8,17,25,51,-26,23
Linfield,8500,1,15,9,6,57,30,27,54
Ballymena,8500,2,16,6,8,60,55,5,54
Glenavon,8500,3,11,15,4,60,44,16,48
Crusaders,8500,4,13,9,8,51,39,12,48
Cliftonville,8500,5,13,3,14,52,50,2,42
Glentoran,8500,6,11,7,12,40,41,-1,40
Portadown,8500,7,11,7,12,27,37,-10,40
Dungannon,8500,8,7,13,10,48,50,-2,34
Coleraine,8500,9,8,10,12,41,47,-6,34
Ards,8500,10,9,4,17,40,57,-17,31
Ballinamalla,8500,11,7,5,18,29,55,-26,26
Crusaders,8501,1,16,9,5,58,37,21,57
Ballymena,8501,2,16,6,8,62,59,3,54
Linfield,8501,3,15,7,8,66,31,35,52
Glenavon,8501,4,13,12,5,53,41,12,51
Cliftonville,8501,5,11,9,10,49,39,10,42
Dungannon,8501,6,11,8,11,45,41,4,41
Coleraine,8501,7,10,11,9,44,48,-4,41
Glentoran,8501,8,8,9,13,34,50,-16,33
Ballinamalla,8501,9,8,6,16,32,50,-18,30
Portadown,8501,10,7,5,18,19,50,-31,26
Ards,8501,11,6,6,18,34,50,-16,24
Crusaders,8502,1,15,9,6,56,33,23,54
Linfield,8502,2,15,8,7,59,31,28,53
Cliftonville,8502,3,16,5,9,54,39,15,53
Ballymena,8502,4,15,6,9,58,53,5,51
Glenavon,8502,5,13,11,6,53,45,8,50
Coleraine,8502,6,11,11,8,47,47,0,44
Ards,8502,7,9,6,15,41,47,-6,33
Dungannon,8502,8,7,11,12,47,53,-6,32
Portadown,8502,9,9,4,17,22,41,-19,31
Glentoran,8502,10,5,11,14,23,47,-24,26
Ballinamalla,8502,11,6,6,18,30,54,-24,24
Cliftonville,8503,1,18,5,7,60,34,26,59
Crusaders,8503,2,14,11,5,53,32,21,53
Linfield,8503,3,13,11,6,56,32,24,50
Ballymena,8503,4,14,6,10,53,55,-2,48
Glenavon,8503,5,11,9,10,44,42,2,42
Coleraine,8503,6,9,12,9,35,40,-5,39
Ballinamalla,8503,7,11,4,15,35,46,-11,37
Dungannon,8503,8,8,12,10,48,40,8,36
Glentoran,8503,9,10,6,14,27,43,-16,36
Ards,8503,10,7,5,18,35,55,-20,26
Portadown,8503,11,6,7,17,26,53,-27,25
Linfield,8504,1,15,9,6,56,32,24,54
Crusaders,8504,2,15,8,7,50,30,20,53
Coleraine,8504,3,12,14,4,38,27,11,50
Cliftonville,8504,4,13,4,13,44,44,0,43
Glentoran,8504,5,11,9,10,31,34,-3,42
Ballymena,8504,6,12,5,13,57,64,-7,41
Dungannon,8504,7,9,12,9,49,43,6,39
Ards,8504,8,10,5,15,45,51,-6,35
Portadown,8504,9,10,3,17,29,44,-15,33
Glenavon,8504,10,7,11,12,37,51,-14,32
Ballinamalla,8504,11,10,2,18,28,44,-16,32
Cliftonville,8505,1,18,3,9,58,43,15,57
Crusaders,8505,2,14,11,5,54,32,22,53
Linfield,8505,3,13,10,7,52,29,23,49
Ballymena,8505,4,13,8,9,51,52,-1,47
Coleraine,8505,5,12,10,8,44,34,10,46
Glenavon,8505,6,11,11,8,48,42,6,44
Dungannon,8505,7,9,9,12,47,46,1,36
Ballinamalla,8505,8,10,5,15,29,45,-16,35
Ards,8505,9,8,8,14,31,40,-9,32
Glentoran,8505,10,7,6,17,23,46,-23,27
Portadown,8505,11,7,5,18,22,50,-28,26
Cliftonville,8506,1,17,4,9,60,37,23,55
Crusaders,8506,2,16,7,7,53,38,15,55
Linfield,8506,3,14,9,7,58,32,26,51
Ballymena,8506,4,15,5,10,63,61,2,50
Dungannon,8506,5,12,8,10,61,46,15,44
Glenavon,8506,6,10,12,8,44,38,6,42
Glentoran,8506,7,11,6,13,33,45,-12,39
Ards,8506,8,10,5,15,46,55,-9,35
Coleraine,8506,9,8,10,12,36,45,-9,34
Ballinamalla,8506,10,9,4,17,29,52,-23,31
Portadown,8506,11,6,4,20,23,57,-34,22
Crusaders,8507,1,20,6,4,56,27,29,66
Cliftonville,8507,2,16,5,9,50,34,16,53
Ballymena,8507,3,14,7,9,59,59,0,49
Coleraine,8507,4,12,10,8,42,35,7,46
Linfield,8507,5,12,9,9,53,33,20,45
Dungannon,8507,6,11,9,10,46,39,7,42
Glenavon,8507,7,10,8,12,40,45,-5,38
Glentoran,8507,8,10,8,12,32,45,-13,38
Ards,8507,9,9,8,13,35,47,-12,35
Portadown,8507,10,6,5,19,27,50,-23,23
Ballinamalla,8507,11,6,3,21,30,56,-26,21
Linfield,8508,1,18,8,4,68,29,39,62
Crusaders,8508,2,14,10,6,49,30,19,52
Coleraine,8508,3,12,12,6,48,36,12,48
Ballymena,8508,4,14,6,10,54,57,-3,48
Cliftonville,8508,5,14,5,11,55,48,7,47
Dungannon,8508,6,10,11,9,56,46,10,41
Glenavon,8508,7,10,11,9,47,49,-2,41
Glentoran,8508,8,8,8,14,31,44,-13,32
Ards,8508,9,8,5,17,34,51,-17,29
Portadown,8508,10,7,5,18,25,50,-25,26
Ballinamalla,8508,11,6,7,17,30,57,-27,25
Linfield,8509,1,16,6,8,59,32,27,54
Crusaders,8509,2,15,9,6,53,32,21,54
Ballymena,8509,3,16,6,8,60,50,10,54
Glenavon,8509,4,14,9,7,53,40,13,51
Cliftonville,8509,5,14,4,12,45,43,2,46
Coleraine,8509,6,12,9,9,42,39,3,45
Dungannon,8509,7,10,8,12,50,43,7,38
Ards,8509,8,9,4,17,35,49,-14,31
Glentoran,8509,9,8,6,16,25,49,-24,30
Ballinamalla,8509,10,9,2,19,29,48,-19,29
Portadown,8509,11,8,5,17,24,50,-26,29
Crusaders,8510,1,18,4,8,58,36,22,58
Linfield,8510,2,13,12,5,54,35,19,51
Cliftonville,8510,3,16,3,11,56,43,13,51
Ballymena,8510,4,15,5,10,56,48,8,50
Coleraine,8510,5,10,11,9,46,43,3,41
Ards,8510,6,12,4,14,48,51,-3,40
Glenavon,8510,7,9,11,10,54,52,2,38
Dungannon,8510,8,9,9,12,45,47,-2,36
Glentoran,8510,9,8,8,14,28,42,-14,32
Ballinamalla,8510,10,8,8,14,35,53,-18,32
Portadown,8510,11,6,7,17,23,53,-30,25
Crusaders,8511,1,20,5,5,66,37,29,65
Linfield,8511,2,17,8,5,67,39,28,59
Cliftonville,8511,3,16,4,10,58,42,16,52
Coleraine,8511,4,12,9,9,49,45,4,45
Dungannon,8511,5,12,8,10,53,45,8,44
Glenavon,8511,6,11,10,9,51,48,3,43
Ards,8511,7,12,5,13,42,48,-6,41
Ballymena,8511,8,12,4,14,55,64,-9,40
Glentoran,8511,9,8,6,16,40,60,-20,30
Portadown,8511,10,6,5,19,27,52,-25,23
Ballinamalla,8511,11,5,4,21,27,55,-28,19
Crusaders,8512,1,18,9,3,63,31,32,63
Cliftonville,8512,2,18,4,8,56,39,17,58
Ballymena,8512,3,15,4,11,55,55,0,49
Linfield,8512,4,13,7,10,56,35,21,46
Glenavon,8512,5,9,11,10,47,45,2,38
Dungannon,8512,6,10,8,12,45,43,2,38
Coleraine,8512,7,9,11,10,42,43,-1,38
Glentoran,8512,8,10,7,13,29,41,-12,37
Ards,8512,9,11,3,16,37,47,-10,36
Portadown,8512,10,8,4,18,25,47,-22,28
Ballinamalla,8512,11,8,4,18,26,55,-29,28
Crusaders,8513,1,17,8,5,56,32,24,59
Cliftonville,8513,2,17,3,10,57,34,23,54
Linfield,8513,3,12,12,6,53,33,20,48
Coleraine,8513,4,12,10,8,42,36,6,46
Glentoran,8513,5,12,9,9,43,41,2,45
Glenavon,8513,6,11,11,8,51,46,5,44
Ards,8513,7,12,4,14,40,50,-10,40
Dungannon,8513,8,10,9,11,48,40,8,39
Ballymena,8513,9,9,8,13,43,60,-17,35
Portadown,8513,10,6,4,20,17,50,-33,22
Ballinamalla,8513,11,5,6,19,27,55,-28,21
Cliftonville,8514,1,17,5,8,54,38,16,56
Glenavon,8514,2,15,9,6,54,36,18,54
Linfield,8514,3,15,8,7,60,37,23,53
Crusaders,8514,4,13,8,9,47,35,12,47
Ballymena,8514,5,13,8,9,55,58,-3,47
Coleraine,8514,6,11,11,8,46,35,11,44
Dungannon,8514,7,11,10,9,53,41,12,43
Glentoran,8514,8,12,7,11,34,38,-4,43
Ards,8514,9,7,4,19,36,55,-19,25
Ballinamalla,8514,10,7,3,20,27,60,-33,24
Portadown,8514,11,6,3,21,19,52,-33,21
Cliftonville,8515,1,18,4,8,53,33,20,58
Crusaders,8515,2,15,6,9,51,37,14,51
Ballymena,8515,3,14,7,9,58,56,2,49
Linfield,8515,4,13,7,10,58,42,16,46
Dungannon,8515,5,12,7,11,59,44,15,43
Glenavon,8515,6,9,11,10,49,51,-2,38
Coleraine,8515,7,9,11,10,37,43,-6,38
Portadown,8515,8,11,5,14,29,40,-11,38
Ballinamalla,8515,9,11,2,17,36,52,-16,35
Ards,8515,10,10,3,17,40,51,-11,33
Glentoran,8515,11,7,9,14,27,48,-21,30
Crusaders,8516,1,19,4,7,57,30,27,61
Cliftonville,8516,2,15,7,8,61,40,21,52
Ballymena,8516,3,13,9,8,56,52,4,48
Linfield,8516,4,13,8,9,55,36,19,47
Glentoran,8516,5,13,4,13,38,45,-7,43
Glenavon,8516,6,10,12,8,51,48,3,42
Coleraine,8516,7,10,10,10,40,47,-7,40
Ballinamalla,8516,8,12,4,14,43,53,-10,40
Dungannon,8516,9,8,7,15,49,54,-5,31
Ards,8516,10,8,5,17,36,53,-17,29
Portadown,8516,11,6,6,18,26,54,-28,24
Linfield,8517,1,17,6,7,65,32,33,57
Crusaders,8517,2,16,9,5,62,37,25,57
Ballymena,8517,3,16,5,9,58,59,-1,53
Glenavon,8517,4,13,10,7,50,40,10,49
Cliftonville,8517,5,15,3,12,49,38,11,48
Coleraine,8517,6,11,12,7,42,42,0,45
Glentoran,8517,7,9,7,14,29,43,-14,34
Ards,8517,8,9,6,15,38,49,-11,33
Dungannon,8517,9,8,8,14,44,45,-1,32
Ballinamalla,8517,10,8,3,19,24,50,-26,27
Portadown,8517,11,7,3,20,28,54,-26,24
Cliftonville,8518,1,18,5,7,55,31,24,59
Linfield,8518,2,16,6,8,55,32,23,54
Crusaders,8518,3,14,8,8,51,36,15,50
Glenavon,8518,4,11,14,5,44,37,7,47
Ards,8518,5,12,6,12,43,45,-2,42
Dungannon,8518,6,10,10,10,48,40,8,40
Ballymena,8518,7,10,10,10,55,63,-8,40
Glentoran,8518,8,8,9,13,32,43,-11,33
Coleraine,8518,9,6,11,13,34,47,-13,29
Ballinamalla,8518,10,8,4,18,31,56,-25,28
Portadown,8518,11,6,9,15,31,49,-18,27
Linfield,8519,1,18,8,4,59,25,34,62
Crusaders,8519,2,16,7,7,56,34,22,55
Ballymena,8519,3,14,7,9,52,53,-1,49
Cliftonville,8519,4,14,6,10,48,39,9,48
Coleraine,8519,5,10,13,7,43,35,8,43
Dungannon,8519,6,11,9,10,55,43,12,42
Glenavon,8519,7,9,12,9,46,48,-2,39
Ards,8519,8,10,3,17,32,48,-16,33
Glentoran,8519,9,8,7,15,32,43,-11,31
Ballinamalla,8519,10,7,6,17,26,50,-24,27
Portadown,8519,11,6,6,18,21,52,-31,24
Crusaders,8520,1,19,5,6,59,36,23,62
Linfield,8520,2,17,9,4,66,32,34,60
Cliftonville,8520,3,14,4,12,49,36,13,46
Glenavon,8520,4,12,8,10,43,47,-4,44
Coleraine,8520,5,11,8,11,43,39,4,41
Ballymena,8520,6,11,7,12,51,61,-10,40
Glentoran,8520,7,10,9,11,31,33,-2,39
Ards,8520,8,11,5,14,36,48,-12,38
Dungannon,8520,9,8,9,13,44,51,-7,33
Portadown,8520,10,9,6,15,31,45,-14,33
Ballinamalla,8520,11,6,4,20,26,51,-25,22
Crusaders,8521,1,18,8,4,63,31,32,62
Linfield,8521,2,14,8,8,58,34,24,50
Ballymena,8521,3,14,6,10,58,58,0,48
Coleraine,8521,4,12,11,7,49,37,12,47
Glenavon,8521,5,10,12,8,47,47,0,42
Cliftonville,8521,6,12,5,13,50,48,2,41
Ards,8521,7,11,5,14,37,48,-11,38
Dungannon,8521,8,8,11,11,50,50,0,35
Portadown,8521,9,9,6,15,27,46,-19,33
Glentoran,8521,10,8,5,17,30,45,-15,29
Ballinamalla,8521,11,8,5,17,22,47,-25,29
Linfield,8522,1,13,11,6,59,35,24,50
Cliftonville,8522,2,14,7,9,52,34,18,49
Crusaders,8522,3,13,10,7,54,38,16,49
Glenavon,8522,4,12,12,6,44,35,9,48
Dungannon,8522,5,13,7,10,54,42,12,46
Coleraine,8522,6,11,10,9,43,40,3,43
Ards,8522,7,13,4,13,39,44,-5,43
Ballymena,8522,8,11,9,10,51,55,-4,42
Portadown,8522,9,10,5,15,28,47,-19,35
Glentoran,8522,10,7,6,17,28,49,-21,27
Ballinamalla,8522,11,6,3,21,27,60,-33,21
Ballymena,8523,1,17,5,8,63,55,8,56
Linfield,8523,2,15,9,6,59,32,27,54
Coleraine,8523,3,14,11,5,40,28,12,53
Crusaders,8523,4,15,7,8,53,34,19,52
Dungannon,8523,5,11,8,11,50,43,7,41
Glenavon,8523,6,10,11,9,45,50,-5,41
Cliftonville,8523,7,10,8,12,50,51,-1,38
Ballinamalla,8523,8,8,9,13,35,49,-14,33
Ards,8523,9,9,5,16,37,47,-10,32
Glentoran,8523,10,6,8,16,24,43,-19,26
Portadown,8523,11,7,5,18,24,48,-24,26
Cliftonville,8524,1,17,4,9,59,39,20,55
Crusaders,8524,2,16,7,7,52,34,18,55
Linfield,8524,3,14,11,5,58,27,31,53
Ballymena,8524,4,16,3,11,61,55,6,51
Glenavon,8524,5,13,10,7,52,42,10,49
Coleraine,8524,6,10,13,7,37,35,2,43
Glentoran,8524,7,10,8,12,32,49,-17,38
Dungannon,8524,8,8,11,11,39,42,-3,35
Ards,8524,9,8,8,14,35,45,-10,32
Ballinamalla,8524,10,6,4,20,30,55,-25,22
Portadown,8524,11,5,5,20,20,52,-32,20
Crusaders,8525,1,16,7,7,60,40,20,55
Coleraine,8525,2,14,9,7,47,34,13,51
Cliftonville,8525,3,14,6,10,54,43,11,48
Linfield,8525,4,12,11,7,62,37,25,47
Glenavon,8525,5,12,8,10,44,40,4,44
Ballymena,8525,6,12,8,10,60,61,-1,44
Ballinamalla,8525,7,14,2,14,34,45,-11,44
Glentoran,8525,8,11,5,14,31,43,-12,38
Dungannon,8525,9,8,9,13,44,48,-4,33
Ards,8525,10,8,6,16,34,49,-15,30
Portadown,8525,11,6,5,19,24,54,-30,23
Cliftonville,8526,1,17,5,8,58,35,23,56
Crusaders,8526,2,16,7,7,47,28,19,55
Linfield,8526,3,11,12,7,56,35,21,45
Coleraine,8526,4,10,13,7,42,40,2,43
Glenavon,8526,5,10,12,8,50,51,-1,42
Ballymena,8526,6,13,3,14,61,69,-8,42
Dungannon,8526,7,10,8,12,42,41,1,38
Ballinamalla,8526,8,11,5,14,40,49,-9,38
Glentoran,8526,9,8,8,14,33,44,-11,32
Ards,8526,10,7,10,13,34,48,-14,31
Portadown,8526,11,6,9,15,28,51,-23,27
Crusaders,8527,1,17,10,3,61,32,29,61
Coleraine,8527,2,15,9,6,47,33,14,54
Linfield,8527,3,15,8,7,52,29,23,53
Ballymena,8527,4,15,7,8,61,53,8,52
Cliftonville,8527,5,12,6,12,44,42,2,42
Glentoran,8527,6,10,8,12,30,41,-11,38
Dungannon,8527,7,8,13,9,50,43,7,37
Glenavon,8527,8,9,10,11,48,48,0,37
Portadown,8527,9,8,8,14,28,45,-17,32
Ards,8527,10,6,6,18,31,56,-25,24
Ballinamalla,8527,11,5,5,20,23,53,-30,20
Crusaders,8528,1,17,6,7,56,37,19,57
Ballymena,8528,2,17,5,8,62,55,7,56
Cliftonville,8528,3,17,4,9,54,43,11,55
Glenavon,8528,4,13,11,6,60,46,14,50
Linfield,8528,5,13,6,11,55,34,21,45
Coleraine,8528,6,11,9,10,45,42,3,42
Glentoran,8528,7,9,9,12,35,42,-7,36
Ards,8528,8,10,5,15,41,55,-14,35
Dungannon,8528,9,8,9,13,49,50,-1,33
Portadown,8528,10,9,4,17,25,44,-19,31
Ballinamalla,8528,11,5,4,21,21,55,-34,19
Crusaders,8529,1,16,11,3,57,28,29,59
Linfield,8529,2,15,10,5,57,29,28,55
Cliftonville,8529,3,16,5,9,63,39,24,53
Ballymena,8529,4,13,7,10,59,66,-7,46
Glenavon,8529,5,10,9,11,53,54,-1,39
Dungannon,8529,6,9,10,11,46,49,-3,37
Portadown,8529,7,10,6,14,33,44,-11,36
Coleraine,8529,8,8,11,11,39,40,-1,35
Glentoran,8529,9,7,11,12,31,46,-15,32
Ards,8529,10,8,5,17,38,58,-20,29
Ballinamalla,8529,11,8,5,17,29,52,-23,29
Crusaders,8530,1,15,12,3,57,32,25,57
Ballymena,8530,2,17,4,9,58,59,-1,55
Coleraine,8530,3,12,12,6,48,32,16,48
Linfield,8530,4,13,8,9,53,34,19,47
Dungannon,8530,5,12,10,8,51,37,14,46
Glenavon,8530,6,10,15,5,47,43,4,45
Cliftonville,8530,7,12,5,13,41,40,1,41
Ards,8530,8,9,4,17,34,53,-19,31
Ballinamalla,8530,9,8,5,17,31,50,-19,29
Glentoran,8530,10,6,10,14,27,42,-15,28
Portadown,8530,11,6,5,19,22,47,-25,23
Cliftonville,8531,1,17,4,9,54,33,21,55
Ballymena,8531,2,15,7,8,51,51,0,52
Crusaders,8531,3,15,6,9,56,39,17,51
Coleraine,8531,4,14,9,7,43,37,6,51
Glenavon,8531,5,13,11,6,46,39,7,50
Linfield,8531,6,13,9,8,57,30,27,48
Ards,8531,7,12,4,14,50,50,0,40
Dungannon,8531,8,9,9,12,48,45,3,36
Glentoran,8531,9,7,7,16,30,53,-23,28
Portadown,8531,10,6,5,19,21,52,-31,23
Ballinamalla,8531,11,5,7,18,24,51,-27,22
Linfield,8532,1,18,8,4,65,28,37,62
Crusaders,8532,2,18,7,5,54,28,26,61
Ballymena,8532,3,14,5,11,54,61,-7,47
Cliftonville,8532,4,13,7,10,50,41,9,46
Coleraine,8532,5,11,11,8,42,33,9,44
Glenavon,8532,6,11,9,10,44,45,-1,42
Dungannon,8532,7,8,10,12,45,43,2,34
Ballinamalla,8532,8,9,6,15,28,49,-21,33
Ards,8532,9,9,4,17,35,48,-13,31
Glentoran,8532,10,7,9,14,29,47,-18,30
Portadown,8532,11,6,6,18,24,47,-23,24
Linfield,8533,1,15,10,5,56,27,29,55
Coleraine,8533,2,15,10,5,59,39,20,55
Crusaders,8533,3,15,7,8,55,44,11,52
Cliftonville,8533,4,16,4,10,54,46,8,52
Ballymena,8533,5,14,6,10,68,62,6,48
Glenavon,8533,6,11,8,11,51,50,1,41
Dungannon,8533,7,10,9,11,51,49,2,39
Glentoran,8533,8,9,9,12,35,47,-12,36
Ards,8533,9,8,3,19,36,52,-16,27
Ballinamalla,8533,10,6,8,16,33,56,-23,26
Portadown,8533,11,7,4,19,22,48,-26,25
Linfield,8534,1,17,9,4,62,27,35,60
Glenavon,8534,2,14,10,6,52,37,15,52
Crusaders,8534,3,15,6,9,52,32,20,51
Cliftonville,8534,4,14,7,9,55,46,9,49
Ballymena,8534,5,14,7,9,63,61,2,49
Dungannon,8534,6,11,8,11,52,39,13,41
Coleraine,8534,7,10,11,9,41,43,-2,41
Glentoran,8534,8,9,9,12,35,46,-11,36
Ards,8534,9,7,7,16,35,54,-19,28
Ballinamalla,8534,10,6,7,17,23,54,-31,25
Portadown,8534,11,4,7,19,23,54,-31,19
Crusaders,8535,1,19,7,4,59,29,30,64
Cliftonville,8535,2,16,7,7,55,35,20,55
Ballymena,8535,3,14,7,9,57,61,-4,49
Linfield,8535,4,13,9,8,59,35,24,48
Glenavon,8535,5,12,11,7,51,44,7,47
Coleraine,8535,6,10,11,9,40,39,1,41
Dungannon,8535,7,9,11,10,46,39,7,38
Ards,8535,8,9,5,16,34,46,-12,32
Ballinamalla,8535,9,9,5,16,33,49,-16,32
Glentoran,8535,10,7,6,17,28,54,-26,27
Portadown,8535,11,5,5,20,21,52,-31,20
Cliftonville,8536,1,17,4,9,55,39,16,55
Crusaders,8536,2,15,8,7,50,34,16,53
Linfield,8536,3,14,8,8,63,43,20,50
Coleraine,8536,4,11,13,6,38,32,6,46
Ballymena,8536,5,12,9,9,55,57,-2,45
Ards,8536,6,13,2,15,48,51,-3,41
Dungannon,8536,7,10,10,10,49,41,8,40
Glenavon,8536,8,10,10,10,47,44,3,40
Glentoran,8536,9,7,9,14,29,43,-14,30
Ballinamalla,8536,10,8,4,18,34,60,-26,28
Portadown,8536,11,7,5,18,30,54,-24,26
Linfield,8537,1,17,10,3,57,24,33,61
Crusaders,8537,2,18,6,6,54,31,23,60
Cliftonville,8537,3,15,4,11,60,37,23,49
Dungannon,8537,4,11,11,8,47,37,10,44
Ballymena,8537,5,11,11,8,56,57,-1,44
Glenavon,8537,6,11,10,9,48,48,0,43
Coleraine,8537,7,10,11,9,40,47,-7,41
Ballinamalla,8537,8,10,4,16,34,47,-13,34
Glentoran,8537,9,7,7,16,26,46,-20,28
Ards,8537,10,7,5,18,34,56,-22,26
Portadown,8537,11,5,7,18,29,55,-26,22
Crusaders,8538,1,16,9,5,55,31,24,57
Ballymena,8538,2,14,7,9,56,54,2,49
Coleraine,8538,3,13,9,8,49,37,12,48
Cliftonville,8538,4,14,6,10,46,35,11,48
Linfield,8538,5,13,8,9,54,38,16,47
Dungannon,8538,6,10,11,9,45,42,3,41
Glenavon,8538,7,8,15,7,45,48,-3,39
Ballinamalla,8538,8,10,5,15,36,51,-15,35
Glentoran,8538,9,8,9,13,36,47,-11,33
Portadown,8538,10,10,2,18,36,44,-8,32
Ards,8538,11,5,7,18,29,60,-31,22
Linfield,8539,1,15,9,6,57,30,27,54
Crusaders,8539,2,14,11,5,57,37,20,53
Ballymena,8539,3,15,6,9,63,53,10,51
Coleraine,8539,4,13,9,8,49,40,9,48
Glenavon,8539,5,11,11,8,50,46,4,44
Cliftonville,8539,6,13,3,14,47,44,3,42
Dungannon,8539,7,11,7,12,50,46,4,40
Ards,8539,8,12,4,14,43,47,-4,40
Glentoran,8539,9,7,10,13,32,53,-21,31
Portadown,8539,10,8,4,18,29,51,-22,28
Ballinamalla,8539,11,8,2,20,27,57,-30,26
Linfield,8540,1,16,9,5,68,33,35,57
Crusaders,8540,2,17,6,7,58,32,26,57
Cliftonville,8540,3,16,7,7,57,37,20,55
Glenavon,8540,4,14,9,7,48,42,6,51
Ballymena,8540,5,14,6,10,61,60,1,48
Coleraine,8540,6,11,10,9,39,41,-2,43
Dungannon,8540,7,9,8,13,46,42,4,35
Ards,8540,8,9,6,15,41,54,-13,33
Glentoran,8540,9,7,9,14,25,48,-23,30
Portadown,8540,10,7,5,18,28,50,-22,26
Ballinamalla,8540,11,5,5,20,26,58,-32,20
Linfield,8541,1,16,10,4,53,28,25,58
Crusaders,8541,2,17,6,7,59,37,22,57
Ballymena,8541,3,15,7,8,66,57,9,52
Cliftonville,8541,4,14,4,12,54,45,9,46
Dungannon,8541,5,10,10,10,52,44,8,40
Glenavon,8541,6,10,10,10,49,52,-3,40
Coleraine,8541,7,10,9,11,35,37,-2,39
Portadown,8541,8,9,5,16,33,48,-15,32
Glentoran,8541,9,7,10,13,31,45,-14,31
Ards,8541,10,8,6,16,34,47,-13,30
Ballinamalla,8541,11,9,3,18,33,59,-26,30
Crusaders,8542,1,19,7,4,54,26,28,64
Linfield,8542,2,13,12,5,57,35,22,51
Cliftonville,8542,3,15,6,9,50,34,16,51
Coleraine,8542,4,13,8,9,43,39,4,47
Ballymena,8542,5,13,7,10,55,55,0,46
Glenavon,8542,6,11,10,9,44,40,4,43
Dungannon,8542,7,9,10,11,49,49,0,37
Glentoran,8542,8,8,6,16,23,45,-22,30
Ballinamalla,8542,9,7,8,15,33,49,-16,29
Ards,8542,10,8,4,18,35,51,-16,28
Portadown,8542,11,6,8,16,19,39,-20,26
Crusaders,8543,1,14,11,5,54,33,21,53
Cliftonville,8543,2,16,5,9,53,44,9,53
Ballymena,8543,3,14,9,7,62,52,10,51
Glenavon,8543,4,11,14,5,53,39,14,47
Linfield,8543,5,12,9,9,55,33,22,45
Dungannon,8543,6,12,7,11,53,44,9,43
Coleraine,8543,7,11,8,11,39,43,-4,41
Ballinamalla,8543,8,10,3,17,29,51,-22,33
Ards,8543,9,9,5,16,36,49,-13,32
Glentoran,8543,10,7,8,15,30,52,-22,29
Portadown,8543,11,6,7,17,20,44,-24,25
Linfield,8544,1,16,7,7,64,26,38,55
Crusaders,8544,2,16,5,9,49,34,15,53
Cliftonville,8544,3,17,2,11,46,33,13,53
Ballymena,8544,4,15,5,10,53,55,-2,50
Coleraine,8544,5,13,9,8,47,37,10,48
Glenavon,8544,6,11,7,12,36,41,-5,40
Dungannon,8544,7,9,11,10,41,38,3,38
Glentoran,8544,8,9,9,12,32,44,-12,36
Ards,8544,9,9,6,15,35,53,-18,33
Portadown,8544,10,8,5,17,24,44,-20,29
Ballinamalla,8544,11,7,4,19,28,50,-22,25
Cliftonville,8545,1,17,4,9,49,33,16,55
Glenavon,8545,2,14,12,4,52,33,19,54
Crusaders,8545,3,16,4,10,51,36,15,52
Ballymena,8545,4,16,3,11,61,55,6,51
Linfield,8545,5,12,13,5,55,28,27,49
Glentoran,8545,6,12,5,13,34,46,-12,41
Coleraine,8545,7,9,10,11,34,45,-11,37
Ards,8545,8,10,5,15,42,54,-12,35
Dungannon,8545,9,8,9,13,44,43,1,33
Portadown,8545,10,6,7,17,20,41,-21,25
Ballinamalla,8545,11,7,4,19,33,61,-28,25
Crusaders,8546,1,16,10,4,56,36,20,58
Cliftonville,8546,2,18,3,9,68,37,31,57
Linfield,8546,3,13,8,9,55,38,17,47
Ballymena,8546,4,13,7,10,57,63,-6,46
Glenavon,8546,5,10,12,8,47,45,2,42
Dungannon,8546,6,11,8,11,55,46,9,41
Coleraine,8546,7,7,15,8,39,38,1,36
Glentoran,8546,8,9,9,12,34,48,-14,36
Ards,8546,9,9,7,14,39,55,-16,34
Portadown,8546,10,9,5,16,25,39,-14,32
Ballinamalla,8546,11,6,4,20,28,58,-30,22
Glenavon,8547,1,14,11,5,53,38,15,53
Crusaders,8547,2,15,8,7,55,41,14,53
Linfield,8547,3,14,9,7,61,35,26,51
Ballymena,8547,4,13,8,9,52,52,0,47
Coleraine,8547,5,12,10,8,42,36,6,46
Cliftonville,8547,6,12,5,13,48,45,3,41
Dungannon,8547,7,9,10,11,46,43,3,37
Glentoran,8547,8,10,5,15,32,45,-13,35
Portadown,8547,9,9,5,16,33,49,-16,32
Ards,8547,10,8,6,16,37,52,-15,30
Ballinamalla,8547,11,9,3,18,35,58,-23,30
Crusaders,8548,1,18,8,4,60,37,23,62
Cliftonville,8548,2,17,6,7,66,36,30,57
Linfield,8548,3,12,12,6,57,35,22,48
Ballymena,8548,4,13,9,8,56,49,7,48
Coleraine,8548,5,11,9,10,40,46,-6,42
Glenavon,8548,6,10,9,11,45,46,-1,39
Dungannon,8548,7,9,9,12,48,48,0,36
Glentoran,8548,8,9,7,14,30,44,-14,34
Ballinamalla,8548,9,10,3,17,32,52,-20,33
Ards,8548,10,8,5,17,40,54,-14,29
Portadown,8548,11,6,7,17,25,52,-27,25
Crusaders,8549,1,17,10,3,63,39,24,61
Cliftonville,8549,2,16,5,9,51,35,16,53
Linfield,8549,3,15,7,8,56,35,21,52
Ballymena,8549,4,14,7,9,56,50,6,49
Dungannon,8549,5,11,10,9,53,44,9,43
Glenavon,8549,6,10,13,7,47,47,0,43
Coleraine,8549,7,10,9,11,43,45,-2,39
Glentoran,8549,8,7,10,13,28,42,-14,31
Portadown,8549,9,7,7,16,25,45,-20,28
Ballinamalla,8549,10,8,3,19,32,57,-25,27
Ards,8549,11,7,5,18,37,52,-15,26
Linfield,8550,1,16,8,6,57,33,24,56
Crusaders,8550,2,16,8,6,60,38,22,56
Cliftonville,8550,3,15,8,7,56,36,20,53
Glenavon,8550,4,12,11,7,50,42,8,47
Coleraine,8550,5,11,12,7,42,35,7,45
Ballymena,8550,6,12,7,11,58,67,-9,43
Dungannon,8550,7,10,10,10,50,40,10,40
Glentoran,8550,8,10,5,15,36,49,-13,35
Ards,8550,9,9,7,14,40,48,-8,34
Ballinamalla,8550,10,6,4,20,32,65,-33,22
Portadown,8550,11,5,6,19,20,48,-28,21
Linfield,8551,1,15,8,7,65,34,31,53
Ballymena,8551,2,15,5,10,61,59,2,50
Crusaders,8551,3,13,9,8,50,34,16,48
Cliftonville,8551,4,13,8,9,51,42,9,47
Glenavon,8551,5,12,11,7,44,43,1,47
Coleraine,8551,6,13,8,9,46,46,0,47
Ards,8551,7,12,5,13,41,42,-1,41
Ballinamalla,8551,8,10,3,17,39,53,-14,33
Dungannon,8551,9,8,8,14,46,52,-6,32
Glentoran,8551,10,7,8,15,27,46,-19,29
Portadown,8551,11,6,9,15,25,44,-19,27
Cliftonville,8552,1,18,3,9,59,41,18,57
Crusaders,8552,2,15,11,4,58,34,24,56
Linfield,8552,3,12,13,5,59,28,31,49
Coleraine,8552,4,11,12,7,44,36,8,45
Dungannon,8552,5,11,11,8,60,44,16,44
Ballymena,8552,6,12,7,11,57,59,-2,43
Glenavon,8552,7,10,11,9,41,43,-2,41
Glentoran,8552,8,8,9,13,30,47,-17,33
Ards,8552,9,8,6,16,38,55,-17,30
Ballinamalla,8552,10,7,5,18,32,59,-27,26
Portadown,8552,11,8,2,20,26,58,-32,26
Linfield,8553,1,18,9,3,60,23,37,63
Crusaders,8553,2,16,9,5,52,29,23,57
Cliftonville,8553,3,16,5,9,53,33,20,53
Glenavon,8553,4,14,7,9,55,45,10,49
Coleraine,8553,5,11,10,9,47,41,6,43
Ballymena,8553,6,10,7,13,46,61,-15,37
Dungannon,8553,7,9,8,13,45,43,2,35
Ards,8553,8,10,3,17,42,58,-16,33
Ballinamalla,8553,9,10,3,17,30,46,-16,33
Portadown,8553,10,8,6,16,23,47,-24,30
Glentoran,8553,11,6,7,17,26,53,-27,25
Crusaders,8554,1,17,9,4,55,33,22,60
Linfield,8554,2,14,11,5,58,29,29,53
Cliftonville,8554,3,15,3,12,54,42,12,48
Coleraine,8554,4,11,12,7,43,37,6,45
Glenavon,8554,5,12,9,9,46,42,4,45
Ballymena,8554,6,12,6,12,53,60,-7,42
Dungannon,8554,7,11,7,12,54,48,6,40
Glentoran,8554,8,10,5,15,34,47,-13,35
Portadown,8554,9,9,6,15,25,41,-16,33
Ards,8554,10,9,5,16,32,49,-17,32
Ballinamalla,8554,11,7,3,20,22,48,-26,24
Cliftonville,8555,1,17,4,9,55,40,15,55
Crusaders,8555,2,15,9,6,54,36,18,54
Linfield,8555,3,14,11,5,63,33,30,53
Coleraine,8555,4,12,9,9,49,42,7,45
Ballymena,8555,5,11,9,10,54,65,-11,42
Glenavon,8555,6,8,14,8,47,48,-1,38
Dungannon,8555,7,9,10,11,49,42,7,37
Ards,8555,8,10,6,14,45,49,-4,36
Glentoran,8555,9,8,9,13,33,44,-11,33
Ballinamalla,8555,10,9,2,19,32,61,-29,29
Portadown,8555,11,6,9,15,25,46,-21,27
Crusaders,8556,1,17,6,7,63,35,28,57
Cliftonville,8556,2,17,2,11,52,43,9,53
Dungannon,8556,3,12,10,8,44,34,10,46
Ballymena,8556,4,13,7,10,56,52,4,46
Glenavon,8556,5,12,10,8,45,48,-3,46
Linfield,8556,6,11,11,8,56,40,16,44
Coleraine,8556,7,11,9,10,37,38,-1,42
Glentoran,8556,8,11,7,12,41,38,3,40
Ards,8556,9,10,5,15,33,48,-15,35
Ballinamalla,8556,10,7,4,19,26,53,-27,25
Portadown,8556,11,5,7,18,23,47,-24,22
Cliftonville,8557,1,18,4,8,55,40,15,58
Linfield,8557,2,16,8,6,57,32,25,56
Crusaders,8557,3,15,8,7,52,34,18,53
Glenavon,8557,4,14,7,9,50,41,9,49
Coleraine,8557,5,13,9,8,43,40,3,48
Ballymena,8557,6,12,7,11,57,59,-2,43
Dungannon,8557,7,10,7,13,50,47,3,37
Portadown,8557,8,9,4,17,29,48,-19,31
Ards,8557,9,7,8,15,39,53,-14,29
Glentoran,8557,10,7,8,15,28,45,-17,29
Ballinamalla,8557,11,6,6,18,34,55,-21,24
Linfield,8558,1,17,8,5,59,27,32,59
Crusaders,8558,2,17,6,7,56,42,14,57
Cliftonville,8558,3,17,4,9,57,39,18,55
Ballymena,8558,4,16,6,8,70,57,13,54
Dungannon,8558,5,11,8,11,47,44,3,41
Coleraine,8558,6,10,9,11,46,52,-6,39
Glentoran,8558,7,10,8,12,28,38,-10,38
Glenavon,8558,8,8,13,9,49,47,2,37
Ards,8558,9,9,3,18,38,53,-15,30
Ballinamalla,8558,10,7,4,19,35,58,-23,25
Portadown,8558,11,6,5,19,25,53,-28,23
Ballymena,8559,1,16,6,8,60,54,6,54
Crusaders,8559,2,14,9,7,53,36,17,51
Linfield,8559,3,13,10,7,56,35,21,49
Cliftonville,8559,4,13,6,11,48,39,9,45
Coleraine,8559,5,10,10,10,43,42,1,40
Glenavon,8559,6,8,15,7,41,40,1,39
Dungannon,8559,7,9,10,11,56,53,3,37
Ards,8559,8,10,6,14,40,51,-11,36
Glentoran,8559,9,9,8,13,29,40,-11,35
Portadown,8559,10,9,7,14,30,49,-19,34
Ballinamalla,8559,11,7,7,16,28,45,-17,28
Linfield,8560,1,18,7,5,63,29,34,61
Cliftonville,8560,2,19,3,8,61,31,30,60
Ballymena,8560,3,16,4,10,62,65,-3,52
Crusaders,8560,4,14,9,7,51,35,16,51
Dungannon,8560,5,11,9,10,51,42,9,42
Glenavon,8560,6,9,11,10,44,46,-2,38
Coleraine,8560,7,10,8,12,34,37,-3,38
Glentoran,8560,8,8,11,11,25,40,-15,35
Ards,8560,9,8,6,16,32,47,-15,30
Ballinamalla,8560,10,7,5,18,28,53,-25,26
Portadown,8560,11,6,5,19,18,44,-26,23
Crusaders,8561,1,16,7,7,57,39,18,55
Linfield,8561,2,15,8,7,58,29,29,53
Cliftonville,8561,3,16,5,9,55,33,22,53
Ballymena,8561,4,14,9,7,64,55,9,51
Glenavon,8561,5,12,9,9,48,43,5,45
Coleraine,8561,6,9,10,11,38,39,-1,37
Glentoran,8561,7,10,7,13,35,47,-12,37
Ards,8561,8,10,4,16,35,49,-14,34
Dungannon,8561,9,8,9,13,48,55,-7,33
Ballinamalla,8561,10,8,5,17,29,51,-22,29
Portadown,8561,11,8,5,17,25,52,-27,29
Linfield,8562,1,16,8,6,60,38,22,56
Crusaders,8562,2,15,9,6,56,35,21,54
Cliftonville,8562,3,16,5,9,57,39,18,53
Coleraine,8562,4,12,9,9,44,39,5,45
Glenavon,8562,5,12,8,10,50,49,1,44
Dungannon,8562,6,10,9,11,55,45,10,39
Ballymena,8562,7,10,7,13,52,69,-17,37
Ballinamalla,8562,8,11,3,16,34,50,-16,36
Ards,8562,9,9,6,15,42,48,-6,33
Glentoran,8562,10,9,4,17,27,51,-24,31
Portadown,8562,11,8,6,16,30,44,-14,30
Ballymena,8563,1,17,8,5,70,49,21,59
Crusaders,8563,2,13,11,6,57,38,19,50
Cliftonville,8563,3,15,4,11,52,44,8,49
Coleraine,8563,4,11,12,7,41,34,7,45
Linfield,8563,5,9,15,6,51,38,13,42
Glenavon,8563,6,9,11,10,46,46,0,38
Glentoran,8563,7,9,9,12,33,42,-9,36
Ards,8563,8,10,6,14,36,47,-11,36
Dungannon,8563,9,8,10,12,52,54,-2,34
Ballinamalla,8563,10,9,7,14,30,48,-18,34
Portadown,8563,11,5,7,18,19,47,-28,22
Crusaders,8564,1,16,9,5,55,32,23,57
Linfield,8564,2,15,7,8,55,32,23,52
Cliftonville,8564,3,15,4,11,51,42,9,49
Glenavon,8564,4,12,11,7,42,36,6,47
Coleraine,8564,5,11,11,8,38,31,7,44
Ballymena,8564,6,12,7,11,53,61,-8,43
Dungannon,8564,7,10,7,13,49,45,4,37
Glentoran,8564,8,8,11,11,27,34,-7,35
Ballinamalla,8564,9,9,5,16,29,48,-19,32
Ards,8564,10,7,8,15,35,51,-16,29
Portadown,8564,11,9,2,19,28,50,-22,29
Crusaders,8565,1,17,4,9,49,36,13,55
Cliftonville,8565,2,16,6,8,57,40,17,54
Linfield,8565,3,13,10,7,55,35,20,49
Ballymena,8565,4,14,6,10,58,62,-4,48
Glenavon,8565,5,11,10,9,43,42,1,43
Portadown,8565,6,12,4,14,32,44,-12,40
Glentoran,8565,7,11,6,13,35,38,-3,39
Coleraine,8565,8,9,11,10,44,45,-1,38
Ards,8565,9,9,6,15,43,53,-10,33
Ballinamalla,8565,10,9,3,18,34,47,-13,30
Dungannon,8565,11,6,10,14,43,51,-8,28
Cliftonville,8566,1,18,5,7,56,33,23,59
Coleraine,8566,2,16,10,4,46,32,14,58
Linfield,8566,3,13,10,7,55,35,20,49
Crusaders,8566,4,14,7,9,53,42,11,49
Glenavon,8566,5,11,11,8,50,46,4,44
Ballymena,8566,6,13,5,12,54,57,-3,44
Glentoran,8566,7,11,8,11,35,40,-5,41
Ards,8566,8,10,7,13,42,49,-7,37
Dungannon,8566,9,6,9,15,44,51,-7,27
Portadown,8566,10,8,3,19,23,42,-19,27
Ballinamalla,8566,11,4,7,19,20,51,-31,19
Linfield,8567,1,14,10,6,59,32,27,52
Crusaders,8567,2,15,5,10,49,38,11,50
Ballymena,8567,3,15,5,10,60,62,-2,50
Coleraine,8567,4,13,10,7,48,36,12,49
Cliftonville,8567,5,14,6,10,56,42,14,48
Glenavon,8567,6,11,9,10,44,46,-2,42
Glentoran,8567,7,11,7,12,33,40,-7,40
Dungannon,8567,8,9,7,14,45,47,-2,34
Ballinamalla,8567,9,9,6,15,28,46,-18,33
Portadown,8567,10,8,6,16,28,45,-17,30
Ards,8567,11,6,9,15,34,50,-16,27
Crusaders,8568,1,21,6,3,60,27,33,69
Cliftonville,8568,2,16,5,9,57,42,15,53
Ballymena,8568,3,13,6,11,56,61,-5,45
Linfield,8568,4,11,10,9,56,38,18,43
Glenavon,8568,5,11,9,10,50,53,-3,42
Coleraine,8568,6,9,12,9,41,41,0,39
Ards,8568,7,11,6,13,39,44,-5,39
Ballinamalla,8568,8,10,6,14,38,47,-9,36
Dungannon,8568,9,7,10,13,42,50,-8,31
Portadown,8568,10,7,7,16,27,45,-18,28
Glentoran,8568,11,6,9,15,28,46,-18,27
Crusaders,8569,1,16,9,5,50,28,22,57
Cliftonville,8569,2,16,3,11,50,39,11,51
Ballymena,8569,3,14,8,8,58,54,4,50
Linfield,8569,4,12,11,7,56,32,24,47
Glenavon,8569,5,12,10,8,48,41,7,46
Coleraine,8569,6,10,9,11,34,40,-6,39
Glentoran,8569,7,9,10,11,33,44,-11,37
Ballinamalla,8569,8,10,6,14,34,46,-12,36
Dungannon,8569,9,7,10,13,45,47,-2,31
Ards,8569,10,8,6,16,40,53,-13,30
Portadown,8569,11,9,2,19,23,47,-24,29
Crusaders,8570,1,17,7,6,57,35,22,58
Linfield,8570,2,13,10,7,55,35,20,49
Cliftonville,8570,3,14,5,11,51,43,8,47
Coleraine,8570,4,12,10,8,46,38,8,46
Glenavon,8570,5,12,10,8,50,46,4,46
Ballymena,8570,6,12,6,12,60,61,-1,42
Glentoran,8570,7,11,7,12,35,39,-4,40
Dungannon,8570,8,7,11,12,44,48,-4,32
Ballinamalla,8570,9,8,7,15,33,47,-14,31
Ards,8570,10,8,7,15,38,56,-18,31
Portadown,8570,11,7,8,15,24,45,-21,29
Coleraine,8571,1,14,11,5,50,35,15,53
Crusaders,8571,2,14,8,8,49,34,15,50
Ballymena,8571,3,13,7,10,61,54,7,46
Cliftonville,8571,4,13,5,12,50,45,5,44
Linfield,8571,5,11,10,9,50,30,20,43
Glenavon,8571,6,11,10,9,48,50,-2,43
Dungannon,8571,7,10,11,9,50,41,9,41
Glentoran,8571,8,10,10,10,35,45,-10,40
Portadown,8571,9,9,6,15,27,47,-20,33
Ards,8571,10,8,6,16,35,48,-13,30
Ballinamalla,8571,11,8,4,18,22,48,-26,28
Crusaders,8572,1,16,9,5,57,37,20,57
Cliftonville,8572,2,17,4,9,54,41,13,55
Linfield,8572,3,15,9,6,70,38,32,54
Glenavon,8572,4,12,9,9,48,43,5,45
Dungannon,8572,5,11,8,11,50,46,4,41
Coleraine,8572,6,10,10,10,43,42,1,40
Ballymena,8572,7,11,7,12,55,64,-9,40
Glentoran,8572,8,10,8,12,37,42,-5,38
Portadown,8572,9,8,6,16,22,40,-18,30
Ballinamalla,8572,10,7,6,17,32,53,-21,27
Ards,8572,11,6,8,16,33,55,-22,26
Cliftonville,8573,1,19,3,8,63,39,24,60
Crusaders,8573,2,16,7,7,51,38,13,55
Linfield,8573,3,15,7,8,60,36,24,52
Dungannon,8573,4,12,8,10,59,46,13,44
Glenavon,8573,5,11,10,9,48,44,4,43
Ballymena,8573,6,11,8,11,48,55,-7,41
Ards,8573,7,11,3,16,39,47,-8,36
Coleraine,8573,8,8,11,11,39,45,-6,35
Glentoran,8573,9,10,5,15,33,48,-15,35
Ballinamalla,8573,10,10,2,18,30,48,-18,32
Portadown,8573,11,8,4,18,23,47,-24,28
Crusaders,8574,1,20,7,3,62,28,34,67
Linfield,8574,2,14,8,8,62,41,21,50
Ballymena,8574,3,15,5,10,59,56,3,50
Cliftonville,8574,4,14,3,13,54,48,6,45
Coleraine,8574,5,11,11,8,47,46,1,44
Glenavon,8574,6,8,12,10,40,43,-3,36
Dungannon,8574,7,7,14,9,46,44,2,35
Ballinamalla,8574,8,10,5,15,34,50,-16,35
Portadown,8574,9,9,4,17,23,38,-15,31
Glentoran,8574,10,8,7,15,26,45,-19,31
Ards,8574,11,8,6,16,37,51,-14,30
Crusaders,8575,1,17,8,5,57,31,26,59
Linfield,8575,2,13,9,8,52,34,18,48
Ballymena,8575,3,13,8,9,60,57,3,47
Coleraine,8575,4,13,8,9,42,42,0,47
Glentoran,8575,5,13,7,10,37,35,2,46
Dungannon,8575,6,11,11,8,52,39,13,44
Glenavon,8575,7,11,11,8,45,38,7,44
Cliftonville,8575,8,12,7,11,47,47,0,43
Ards,8575,9,8,8,14,36,47,-11,32
Portadown,8575,10,5,6,19,23,49,-26,21
Ballinamalla,8575,11,5,5,20,26,58,-32,20
Linfield,8576,1,17,10,3,64,27,37,61
Crusaders,8576,2,17,5,8,55,30,25,56
Ballymena,8576,3,14,7,9,57,55,2,49
Glenavon,8576,4,11,14,5,45,40,5,47
Cliftonville,8576,5,14,4,12,46,44,2,46
Coleraine,8576,6,12,9,9,42,42,0,45
Ards,8576,7,11,2,17,38,54,-16,35
Ballinamalla,8576,8,8,6,16,29,46,-17,30
Dungannon,8576,9,7,8,15,45,46,-1,29
Portadown,8576,10,7,8,15,38,53,-15,29
Glentoran,8576,11,5,11,14,23,45,-22,26
Linfield,8577,1,16,10,4,64,29,35,58
Crusaders,8577,2,17,7,6,54,35,19,58
Ballymena,8577,3,14,5,11,55,57,-2,47
Cliftonville,8577,4,14,4,12,45,36,9,46
Coleraine,8577,5,10,14,6,40,35,5,44
Glenavon,8577,6,11,11,8,42,41,1,44
Dungannon,8577,7,12,7,11,50,43,7,43
Ards,8577,8,9,7,14,41,49,-8,34
Portadown,8577,9,8,4,18,33,55,-22,28
Ballinamalla,8577,10,8,4,18,31,55,-24,28
Glentoran,8577,11,6,7,17,26,46,-20,25
Crusaders,8578,1,18,5,7,54,34,20,59
Cliftonville,8578,2,15,5,10,53,35,18,50
Coleraine,8578,3,13,9,8,41,43,-2,48
Ballymena,8578,4,13,8,9,60,59,1,47
Glenavon,8578,5,12,10,8,50,40,10,46
Linfield,8578,6,11,10,9,59,43,16,43
Dungannon,8578,7,10,10,10,47,44,3,40
Ards,8578,8,8,8,14,42,51,-9,32
Ballinamalla,8578,9,9,5,16,38,52,-14,32
Glentoran,8578,10,7,9,14,32,54,-22,30
Portadown,8578,11,7,5,18,24,45,-21,26
Linfield,8579,1,18,7,5,65,33,32,61
Crusaders,8579,2,18,6,6,57,35,22,60
Cliftonville,8579,3,17,5,8,62,41,21,56
Coleraine,8579,4,11,11,8,47,39,8,44
Ballymena,8579,5,13,5,12,61,65,-4,44
Glenavon,8579,6,10,11,9,49,43,6,41
Dungannon,8579,7,10,9,11,52,47,5,39
Glentoran,8579,8,9,10,11,37,46,-9,37
Ards,8579,9,6,8,16,35,56,-21,26
Portadown,8579,10,5,8,17,22,49,-27,23
Ballinamalla,8579,11,7,2,21,27,60,-33,23
Crusaders,8580,1,17,9,4,59,28,31,60
Linfield,8580,2,16,9,5,59,30,29,57
Cliftonville,8580,3,16,6,8,53,37,16,54
Glenavon,8580,4,12,11,7,55,46,9,47
Dungannon,8580,5,12,7,11,52,47,5,43
Ballymena,8580,6,12,7,11,59,64,-5,43
Coleraine,8580,7,11,9,10,35,39,-4,42
Glentoran,8580,8,11,7,12,32,39,-7,40
Portadown,8580,9,7,5,18,25,46,-21,26
Ballinamalla,8580,10,7,2,21,25,53,-28,23
Ards,8580,11,6,4,20,31,56,-25,22
Crusaders,8581,1,19,9,2,60,27,33,66
Linfield,8581,2,18,9,3,73,28,45,63
Ballymena,8581,3,17,5,8,60,51,9,56
Coleraine,8581,4,12,10,8,41,36,5,46
Glenavon,8581,5,10,11,9,45,48,-3,41
Cliftonville,8581,6,11,6,13,43,46,-3,39
Ballinamalla,8581,7,10,5,15,34,49,-15,35
Dungannon,8581,8,7,11,12,49,52,-3,32
Glentoran,8581,9,7,8,15,30,49,-19,29
Ards,8581,10,6,5,19,29,53,-24,23
Portadown,8581,11,4,9,17,18,43,-25,21
Linfield,8582,1,15,8,7,53,29,24,53
Cliftonville,8582,2,15,6,9,54,43,11,51
Ballymena,8582,3,12,9,9,56,57,-1,45
Dungannon,8582,4,12,8,10,53,41,12,44
Glenavon,8582,5,11,11,8,45,42,3,44
Coleraine,8582,6,10,13,7,41,33,8,43
Crusaders,8582,7,12,6,12,51,46,5,42
Ballinamalla,8582,8,10,6,14,30,43,-13,36
Ards,8582,9,8,9,13,39,50,-11,33
Glentoran,8582,10,8,8,14,28,44,-16,32
Portadown,8582,11,7,6,17,29,51,-22,27
Linfield,8583,1,15,9,6,58,34,24,54
Crusaders,8583,2,15,7,8,56,39,17,52
Coleraine,8583,3,12,13,5,49,38,11,49
Cliftonville,8583,4,14,6,10,49,37,12,48
Ballymena,8583,5,13,9,8,53,53,0,48
Dungannon,8583,6,12,7,11,50,42,8,43
Glenavon,8583,7,9,13,8,43,44,-1,40
Glentoran,8583,8,11,5,14,37,47,-10,38
Ards,8583,9,9,4,17,36,49,-13,31
Portadown,8583,10,9,3,18,26,47,-21,30
Ballinamalla,8583,11,7,2,21,28,55,-27,23
Cliftonville,8584,1,16,7,7,53,33,20,55
Crusaders,8584,2,15,7,8,54,36,18,52
Glenavon,8584,3,13,11,6,46,36,10,50
Ballymena,8584,4,14,5,11,66,58,8,47
Linfield,8584,5,11,12,7,51,36,15,45
Glentoran,8584,6,11,10,9,40,45,-5,43
Dungannon,8584,7,10,9,11,49,43,6,39
Coleraine,8584,8,9,11,10,40,44,-4,38
Ballinamalla,8584,9,8,7,15,39,54,-15,31
Ards,8584,10,7,7,16,39,59,-20,28
Portadown,8584,11,5,6,19,25,58,-33,21
Cliftonville,8585,1,18,2,10,67,52,15,56
Glenavon,8585,2,14,11,5,57,47,10,53
Crusaders,8585,3,14,7,9,58,40,18,49
Dungannon,8585,4,13,6,11,52,47,5,45
Ballymena,8585,5,12,9,9,60,62,-2,45
Linfield,8585,6,10,14,6,58,35,23,44
Glentoran,8585,7,10,8,12,30,44,-14,38
Coleraine,8585,8,9,9,12,39,44,-5,36
Portadown,8585,9,10,5,15,36,44,-8,35
Ards,8585,10,8,8,14,33,44,-11,32
Ballinamalla,8585,11,4,7,19,24,55,-31,19
Cliftonville,8586,1,17,6,7,60,35,25,57
Crusaders,8586,2,17,5,8,56,37,19,56
Ballymena,8586,3,17,3,10,62,56,6,54
Linfield,8586,4,14,7,9,54,37,17,49
Dungannon,8586,5,13,8,9,54,47,7,47
Glenavon,8586,6,12,9,9,44,41,3,45
Coleraine,8586,7,11,11,8,46,44,2,44
Glentoran,8586,8,9,6,15,27,46,-19,33
Ards,8586,9,9,3,18,38,52,-14,30
Portadown,8586,10,6,7,17,28,51,-23,25
Ballinamalla,8586,11,5,5,20,32,55,-23,20
Crusaders,8587,1,15,6,9,60,44,16,51
Cliftonville,8587,2,15,6,9,52,38,14,51
Coleraine,8587,3,12,13,5,44,33,11,49
Ballymena,8587,4,15,3,12,55,59,-4,48
Linfield,8587,5,12,11,7,53,29,24,47
Dungannon,8587,6,11,7,12,55,46,9,40
Glenavon,8587,7,10,10,10,40,47,-7,40
Ards,8587,8,12,4,14,39,50,-11,40
Glentoran,8587,9,10,7,13,42,50,-8,37
Portadown,8587,10,7,6,17,24,45,-21,27
Ballinamalla,8587,11,7,5,18,27,50,-23,26
Cliftonville,8588,1,18,5,7,56,37,19,59
Crusaders,8588,2,17,6,7,53,41,12,57
Linfield,8588,3,14,9,7,56,30,26,51
Dungannon,8588,4,13,7,10,54,42,12,46
Coleraine,8588,5,12,9,9,47,37,10,45
Glenavon,8588,6,11,10,9,48,43,5,43
Ballymena,8588,7,10,10,10,61,65,-4,40
Ballinamalla,8588,8,10,5,15,34,50,-16,35
Glentoran,8588,9,9,6,15,35,46,-11,33
Portadown,8588,10,6,7,17,23,47,-24,25
Ards,8588,11,6,4,20,32,61,-29,22
Linfield,8589,1,18,6,6,60,33,27,60
Cliftonville,8589,2,17,3,10,60,43,17,54
Crusaders,8589,3,16,6,8,55,46,9,54
Glenavon,8589,4,14,10,6,48,38,10,52
Dungannon,8589,5,13,7,10,63,43,20,46
Coleraine,8589,6,11,11,8,40,35,5,44
Ballymena,8589,7,11,7,12,59,63,-4,40
Ards,8589,8,10,5,15,42,51,-9,35
Glentoran,8589,9,7,6,17,35,54,-19,27
Portadown,8589,10,7,4,19,19,45,-26,25
Ballinamalla,8589,11,6,5,19,30,60,-30,23
Cliftonville,8590,1,18,5,7,61,36,25,59
Crusaders,8590,2,17,8,5,60,38,22,59
Linfield,8590,3,14,10,6,62,34,28,52
Dungannon,8590,4,13,10,7,60,42,18,49
Ballymena,8590,5,14,5,11,56,63,-7,47
Coleraine,8590,6,10,10,10,41,40,1,40
Glenavon,8590,7,10,9,11,42,48,-6,39
Glentoran,8590,8,10,7,13,39,46,-7,37
Portadown,8590,9,9,3,18,23,46,-23,30
Ballinamalla,8590,10,7,3,20,30,56,-26,24
Ards,8590,11,7,2,21,36,61,-25,23
Linfield,8591,1,17,7,6,70,30,40,58
Crusaders,8591,2,17,7,6,55,39,16,58
Ballymena,8591,3,18,3,9,65,60,5,57
Cliftonville,8591,4,14,7,9,53,39,14,49
Coleraine,8591,5,12,10,8,39,32,7,46
Dungannon,8591,6,12,8,10,50,40,10,44
Ballinamalla,8591,7,10,4,16,32,44,-12,34
Glenavon,8591,8,8,8,14,41,53,-12,32
Portadown,8591,9,8,5,17,31,55,-24,29
Ards,8591,10,8,4,18,36,53,-17,28
Glentoran,8591,11,7,5,18,24,51,-27,26
Crusaders,8592,1,17,7,6,65,36,29,58
Linfield,8592,2,16,9,5,56,26,30,57
Coleraine,8592,3,13,12,5,41,30,11,51
Ballymena,8592,4,13,9,8,63,61,2,48
Cliftonville,8592,5,13,6,11,55,43,12,45
Glentoran,8592,6,12,7,11,33,39,-6,43
Glenavon,8592,7,10,9,11,44,48,-4,39
Ards,8592,8,10,5,15,38,50,-12,35
Ballinamalla,8592,9,8,4,18,25,46,-21,28
Dungannon,8592,10,5,10,15,43,58,-15,25
Portadown,8592,11,7,4,19,25,51,-26,25
Crusaders,8593,1,17,8,5,59,33,26,59
Ballymena,8593,2,16,4,10,66,55,11,52
Linfield,8593,3,14,9,7,58,32,26,51
Cliftonville,8593,4,13,5,12,44,42,2,44
Coleraine,8593,5,8,16,6,41,37,4,40
Dungannon,8593,6,10,10,10,43,41,2,40
Glentoran,8593,7,10,7,13,26,42,-16,37
Glenavon,8593,8,7,13,10,42,47,-5,34
Ards,8593,9,8,8,14,34,47,-13,32
Ballinamalla,8593,10,9,4,17,30,44,-14,31
Portadown,8593,11,9,4,17,26,49,-23,31
Cliftonville,8594,1,19,5,6,62,34,28,62
Crusaders,8594,2,17,6,7,56,35,21,57
Linfield,8594,3,16,8,6,63,31,32,56
Ballymena,8594,4,13,7,10,50,52,-2,46
Dungannon,8594,5,11,9,10,56,48,8,42
Ards,8594,6,11,4,15,40,53,-13,37
Coleraine,8594,7,9,9,12,42,48,-6,36
Glentoran,8594,8,8,8,14,35,50,-15,32
Glenavon,8594,9,7,10,13,42,54,-12,31
Ballinamalla,8594,10,9,4,17,27,48,-21,31
Portadown,8594,11,8,4,18,36,56,-20,28
Crusaders,8595,1,18,6,6,56,36,20,60
Linfield,8595,2,14,12,4,58,30,28,54
Ballymena,8595,3,16,5,9,68,60,8,53
Cliftonville,8595,4,14,8,8,56,37,19,50
Coleraine,8595,5,12,11,7,47,41,6,47
Dungannon,8595,6,10,9,11,45,39,6,39
Glenavon,8595,7,8,11,11,41,47,-6,35
Ballinamalla,8595,8,10,4,16,32,45,-13,34
Glentoran,8595,9,8,8,14,29,46,-17,32
Ards,8595,10,8,3,19,33,55,-22,27
Portadown,8595,11,6,5,19,21,50,-29,23
Linfield,8596,1,17,9,4,63,28,35,60
Crusaders,8596,2,18,6,6,63,41,22,60
Cliftonville,8596,3,19,2,9,59,40,19,59
Ballymena,8596,4,15,6,9,61,61,0,51
Glenavon,8596,5,10,11,9,49,50,-1,41
Glentoran,8596,6,11,6,13,40,49,-9,39
Coleraine,8596,7,8,10,12,42,45,-3,34
Dungannon,8596,8,8,8,14,45,48,-3,32
Portadown,8596,9,8,5,17,27,47,-20,29
Ards,8596,10,7,7,16,37,53,-16,28
Ballinamalla,8596,11,7,4,19,31,55,-24,25
Crusaders,8597,1,20,8,2,65,30,35,68
Ballymena,8597,2,16,6,8,62,53,9,54
Coleraine,8597,3,13,8,9,47,36,11,47
Linfield,8597,4,11,12,7,48,32,16,45
Glenavon,8597,5,11,12,7,49,45,4,45
Cliftonville,8597,6,13,5,12,48,42,6,44
Dungannon,8597,7,8,13,9,48,44,4,37
Ards,8597,8,10,5,15,37,48,-11,35
Glentoran,8597,9,6,9,15,27,48,-21,27
Ballinamalla,8597,10,7,5,18,31,57,-26,26
Portadown,8597,11,6,5,19,28,55,-27,23
Crusaders,8598,1,18,8,4,59,32,27,62
Cliftonville,8598,2,16,7,7,56,40,16,55
Glenavon,8598,3,13,11,6,57,47,10,50
Linfield,8598,4,13,10,7,58,33,25,49
Ballymena,8598,5,12,7,11,56,58,-2,43
Coleraine,8598,6,10,11,9,40,39,1,41
Glentoran,8598,7,11,6,13,29,41,-12,39
Dungannon,8598,8,9,9,12,44,42,2,36
Ards,8598,9,8,6,16,39,54,-15,30
Portadown,8598,10,7,8,15,25,43,-18,29
Ballinamalla,8598,11,6,1,23,26,60,-34,19
Ballymena,8599,1,18,5,7,65,52,13,59
Cliftonville,8599,2,17,5,8,50,36,14,56
Crusaders,8599,3,16,7,7,52,31,21,55
Dungannon,8599,4,14,7,9,56,39,17,49
Linfield,8599,5,13,9,8,56,33,23,48
Glenavon,8599,6,12,10,8,57,42,15,46
Coleraine,8599,7,11,8,11,45,41,4,41
Glentoran,8599,8,8,7,15,37,56,-19,31
Ballinamalla,8599,9,8,4,18,26,54,-28,28
Ards,8599,10,8,3,19,34,63,-29,27
Portadown,8599,11,6,3,21,28,59,-31,21
Crusaders,8600,1,17,9,4,59,34,25,60
Ballymena,8600,2,15,6,9,57,53,4,51
Linfield,8600,3,14,8,8,60,36,24,50
Cliftonville,8600,4,12,9,9,50,41,9,45
Coleraine,8600,5,11,10,9,37,33,4,43
Glenavon,8600,6,10,11,9,42,44,-2,41
Portadown,8600,7,11,5,14,37,47,-10,38
Ards,8600,8,10,4,16,38,51,-13,34
Ballinamalla,8600,9,7,9,14,31,58,-27,30
Dungannon,8600,10,6,11,13,47,48,-1,29
Glentoran,8600,11,7,8,15,30,43,-13,29
Crusaders,8601,1,16,9,5,57,33,24,57
Cliftonville,8601,2,16,8,6,59,37,22,56
Ballymena,8601,3,16,5,9,69,53,16,53
Linfield,8601,4,14,9,7,57,36,21,51
Coleraine,8601,5,11,9,10,46,50,-4,42
Dungannon,8601,6,11,7,12,47,48,-1,40
Glenavon,8601,7,10,9,11,46,47,-1,39
Ballinamalla,8601,8,10,7,13,31,43,-12,37
Glentoran,8601,9,8,8,14,32,49,-17,32
Ards,8601,10,7,8,15,35,54,-19,29
Portadown,8601,11,4,5,21,24,53,-29,17
Cliftonville,8602,1,17,7,6,56,32,24,58
Crusaders,8602,2,15,11,4,58,35,23,56
Glenavon,8602,3,15,9,6,50,36,14,54
Linfield,8602,4,13,10,7,54,37,17,49
Ballymena,8602,5,12,8,10,53,55,-2,44
Coleraine,8602,6,10,11,9,36,36,0,41
Glentoran,8602,7,8,10,12,32,44,-12,34
Dungannon,8602,8,8,9,13,49,50,-1,33
Ballinamalla,8602,9,7,7,16,30,52,-22,28
Ards,8602,10,7,5,18,29,46,-17,26
Portadown,8602,11,5,9,16,24,48,-24,24
Linfield,8603,1,16,9,5,57,27,30,57
Cliftonville,8603,2,17,5,8,56,36,20,56
Ballymena,8603,3,15,5,10,63,57,6,50
Crusaders,8603,4,12,8,10,44,38,6,44
Glenavon,8603,5,11,10,9,41,39,2,43
Coleraine,8603,6,11,10,9,40,39,1,43
Dungannon,8603,7,11,8,11,52,45,7,41
Ards,8603,8,10,6,14,42,48,-6,36
Ballinamalla,8603,9,8,7,15,29,45,-16,31
Glentoran,8603,10,7,8,15,23,44,-21,29
Portadown,8603,11,5,8,17,23,52,-29,23
Crusaders,8604,1,19,5,6,58,30,28,62
Cliftonville,8604,2,17,3,10,57,40,17,54
Coleraine,8604,3,13,11,6,49,38,11,50
Ballymena,8604,4,14,7,9,57,47,10,49
Linfield,8604,5,12,10,8,55,40,15,46
Dungannon,8604,6,12,9,9,51,41,10,45
Glenavon,8604,7,11,8,11,45,43,2,41
Ballinamalla,8604,8,10,2,18,37,57,-20,32
Ards,8604,9,8,5,17,39,58,-19,29
Glentoran,8604,10,6,9,15,26,52,-26,27
Portadown,8604,11,6,5,19,22,50,-28,23
Crusaders,8605,1,17,9,4,59,32,27,60
Linfield,8605,2,15,9,6,66,32,34,54
Glenavon,8605,3,12,14,4,54,47,7,50
Ballymena,8605,4,13,8,9,59,57,2,47
Cliftonville,8605,5,13,6,11,44,44,0,45
Coleraine,8605,6,10,12,8,39,34,5,42
Dungannon,8605,7,8,14,8,51,41,10,38
Ards,8605,8,10,5,15,46,52,-6,35
Glentoran,8605,9,9,8,13,32,49,-17,35
Portadown,8605,10,7,5,18,27,51,-24,26
Ballinamalla,8605,11,5,2,23,27,65,-38,17
Linfield,8606,1,17,9,4,72,36,36,60
Crusaders,8606,2,15,9,6,54,33,21,54
Coleraine,8606,3,14,9,7,51,40,11,51
Ballymena,8606,4,15,6,9,58,54,4,51
Cliftonville,8606,5,14,6,10,47,37,10,48
Dungannon,8606,6,13,7,10,48,36,12,46
Glenavon,8606,7,9,11,10,49,50,-1,38
Glentoran,8606,8,9,6,15,37,52,-15,33
Ballinamalla,8606,9,7,6,17,33,55,-22,27
Portadown,8606,10,6,6,18,32,58,-26,24
Ards,8606,11,7,3,20,29,59,-30,24
Crusaders,8607,1,14,8,8,48,34,14,50
Linfield,8607,2,13,10,7,55,31,24,49
Ballymena,8607,3,15,4,11,58,58,0,49
Cliftonville,8607,4,14,6,10,48,36,12,48
Coleraine,8607,5,11,12,7,48,44,4,45
Glentoran,8607,6,11,9,10,28,32,-4,42
Glenavon,8607,7,9,12,9,43,44,-1,39
Dungannon,8607,8,9,10,11,52,46,6,37
Ballinamalla,8607,9,11,4,15,35,46,-11,37
Ards,8607,10,6,10,14,38,58,-20,28
Portadown,8607,11,6,7,17,24,48,-24,25
Crusaders,8608,1,19,7,4,54,27,27,64
Ballymena,8608,2,17,5,8,57,48,9,56
Linfield,8608,3,15,9,6,56,27,29,54
Cliftonville,8608,4,16,6,8,56,42,14,54
Glenavon,8608,5,13,10,7,50,42,8,49
Coleraine,8608,6,10,9,11,40,37,3,39
Dungannon,8608,7,9,9,12,47,44,3,36
Ards,8608,8,8,5,17,38,50,-12,29
Ballinamalla,8608,9,7,8,15,26,49,-23,29
Portadown,8608,10,7,3,20,22,47,-25,24
Glentoran,8608,11,6,5,19,26,59,-33,23
Crusaders,8609,1,17,7,6,60,34,26,58
Cliftonville,8609,2,16,4,10,50,41,9,52
Linfield,8609,3,15,6,9,55,32,23,51
Dungannon,8609,4,13,7,10,59,45,14,46
Coleraine,8609,5,12,9,9,46,41,5,45
Ballymena,8609,6,13,6,11,52,54,-2,45
Glenavon,8609,7,11,11,8,46,41,5,44
Glentoran,8609,8,11,5,14,31,45,-14,38
Ballinamalla,8609,9,11,2,17,29,46,-17,35
Ards,8609,10,8,3,19,34,55,-21,27
Portadown,8609,11,5,6,19,21,49,-28,21
Crusaders,8610,1,18,9,3,55,27,28,63
Ballymena,8610,2,16,7,7,65,59,6,55
Cliftonville,8610,3,17,3,10,58,39,19,54
Coleraine,8610,4,14,9,7,42,32,10,51
Linfield,8610,5,12,11,7,57,36,21,47
Dungannon,8610,6,11,8,11,51,42,9,41
Ards,8610,7,9,6,15,35,45,-10,33
Glenavon,8610,8,8,9,13,45,57,-12,33
Ballinamalla,8610,9,8,4,18,27,52,-25,28
Glentoran,8610,10,6,9,15,28,48,-20,27
Portadown,8610,11,7,3,20,21,47,-26,24
Crusaders,8611,1,18,6,6,56,36,20,60
Cliftonville,8611,2,15,6,9,56,44,12,51
Linfield,8611,3,14,7,9,58,36,22,49
Coleraine,8611,4,12,11,7,46,35,11,47
Ballymena,8611,5,13,6,11,57,53,4,45
Glenavon,8611,6,9,15,6,46,42,4,42
Dungannon,8611,7,10,8,12,50,48,2,38
Glentoran,8611,8,9,7,14,29,42,-13,34
Ards,8611,9,9,5,16,34,55,-21,32
Ballinamalla,8611,10,8,7,15,37,56,-19,31
Portadown,8611,11,6,6,18,30,52,-22,24
Linfield,8612,1,17,7,6,59,29,30,58
Crusaders,8612,2,15,8,7,49,38,11,53
Ballymena,8612,3,15,6,9,61,57,4,51
Cliftonville,8612,4,15,4,11,49,44,5,49
Coleraine,8612,5,10,11,9,40,39,1,41
Dungannon,8612,6,10,10,10,43,41,2,40
Glenavon,8612,7,10,9,11,46,43,3,39
Ards,8612,8,11,6,13,47,47,0,39
Glentoran,8612,9,9,9,12,32,44,-12,36
Ballinamalla,8612,10,7,4,19,34,53,-19,25
Portadown,8612,11,5,8,17,18,43,-25,23
Crusaders,8613,1,18,8,4,59,32,27,62
Linfield,8613,2,15,10,5,60,28,32,55
Glenavon,8613,3,12,10,8,48,46,2,46
Ballymena,8613,4,12,10,8,48,51,-3,46
Cliftonville,8613,5,13,6,11,51,49,2,45
Coleraine,8613,6,10,12,8,42,37,5,42
Glentoran,8613,7,12,6,12,36,36,0,42
Portadown,8613,8,9,7,14,35,45,-10,34
Dungannon,8613,9,6,10,14,40,54,-14,28
Ballinamalla,8613,10,8,3,19,31,54,-23,27
Ards,8613,11,7,4,19,29,47,-18,25
Cliftonville,8614,1,17,5,8,51,35,16,56
Linfield,8614,2,15,10,5,51,26,25,55
Crusaders,8614,3,15,7,8,61,42,19,52
Ballymena,8614,4,15,7,8,63,54,9,52
Glenavon,8614,5,11,13,6,45,39,6,46
Coleraine,8614,6,10,12,8,39,37,2,42
Dungannon,8614,7,8,11,11,51,52,-1,35
Glentoran,8614,8,7,10,13,29,45,-16,31
Portadown,8614,9,7,7,16,29,45,-16,28
Ards,8614,10,7,7,16,31,49,-18,28
Ballinamalla,8614,11,4,9,17,25,51,-26,21
Ballymena,8615,1,19,5,6,64,50,14,62
Crusaders,8615,2,15,7,8,56,35,21,52
Glenavon,8615,3,13,11,6,52,40,12,50
Linfield,8615,4,11,11,8,50,39,11,44
Cliftonville,8615,5,13,5,12,47,42,5,44
Dungannon,8615,6,10,9,11,58,53,5,39
Coleraine,8615,7,9,10,11,40,52,-12,37
Ards,8615,8,9,7,14,43,53,-10,34
Glentoran,8615,9,8,9,13,31,45,-14,33
Portadown,8615,10,8,6,16,37,47,-10,30
Ballinamalla,8615,11,8,4,18,29,51,-22,28
Linfield,8616,1,16,6,8,61,34,27,54
Cliftonville,8616,2,15,5,10,50,34,16,50
Crusaders,8616,3,14,7,9,52,42,10,49
Ballymena,8616,4,14,7,9,59,59,0,49
Glenavon,8616,5,10,12,8,50,50,0,42
Ards,8616,6,13,3,14,43,46,-3,42
Dungannon,8616,7,10,9,11,45,40,5,39
Coleraine,8616,8,10,8,12,42,46,-4,38
Glentoran,8616,9,8,9,13,27,38,-11,33
Ballinamalla,8616,10,9,5,16,32,54,-22,32
Portadown,8616,11,7,7,16,22,40,-18,28
Linfield,8617,1,16,8,6,58,39,19,56
Cliftonville,8617,2,17,4,9,60,43,17,55
Crusaders,8617,3,15,9,6,57,38,19,54
Ballymena,8617,4,14,5,11,62,56,6,47
Dungannon,8617,5,12,10,8,63,39,24,46
Glenavon,8617,6,11,11,8,54,51,3,44
Coleraine,8617,7,11,10,9,42,45,-3,43
Ards,8617,8,10,3,17,37,50,-13,33
Glentoran,8617,9,9,5,16,33,47,-14,32
Ballinamalla,8617,10,7,6,17,27,54,-27,27
Portadown,8617,11,5,5,20,17,48,-31,20
Coleraine,8618,1,15,8,7,41,28,13,53
Linfield,8618,2,14,10,6,58,31,27,52
Dungannon,8618,3,14,7,9,52,40,12,49
Cliftonville,8618,4,15,4,11,51,43,8,49
Glenavon,8618,5,13,10,7,52,46,6,49
Crusaders,8618,6,13,7,10,49,40,9,46
Ballymena,8618,7,13,6,11,61,59,2,45
Glentoran,8618,8,8,8,14,29,46,-17,32
Ballinamalla,8618,9,9,4,17,30,49,-19,31
Ards,8618,10,8,2,20,35,54,-19,26
Portadown,8618,11,6,8,16,27,49,-22,26
Crusaders,8619,1,17,8,5,59,34,25,59
Cliftonville,8619,2,16,5,9,69,46,23,53
Linfield,8619,3,14,7,9,58,39,19,49
Glenavon,8619,4,13,9,8,50,43,7,48
Coleraine,8619,5,12,9,9,48,40,8,45
Ballymena,8619,6,12,7,11,60,70,-10,43
Ards,8619,7,10,5,15,38,46,-8,35
Glentoran,8619,8,10,5,15,39,53,-14,35
Ballinamalla,8619,9,10,4,16,35,54,-19,34
Dungannon,8619,10,8,9,13,45,46,-1,33
Portadown,8619,11,6,6,18,29,59,-30,24
Crusaders,8620,1,17,6,7,53,38,15,57
Cliftonville,8620,2,15,7,8,59,37,22,52
Linfield,8620,3,14,9,7,56,35,21,51
Coleraine,8620,4,11,14,5,45,37,8,47
Dungannon,8620,5,10,10,10,48,40,8,40
Glenavon,8620,6,10,10,10,46,43,3,40
Ballinamalla,8620,7,11,4,15,31,45,-14,37
Ballymena,8620,8,10,6,14,50,65,-15,36
Glentoran,8620,9,8,11,11,34,44,-10,35
Ards,8620,10,8,7,15,37,50,-13,31
Portadown,8620,11,7,4,19,23,48,-25,25
Linfield,8621,1,18,6,6,71,37,34,60
Coleraine,8621,2,14,10,6,48,31,17,52
Cliftonville,8621,3,16,4,10,51,36,15,52
Crusaders,8621,4,14,9,7,51,37,14,51
Dungannon,8621,5,12,9,9,51,45,6,45
Glenavon,8621,6,9,10,11,46,48,-2,37
Ballymena,8621,7,9,8,13,48,66,-18,35
Glentoran,8621,8,8,8,14,29,42,-13,32
Portadown,8621,9,9,4,17,29,44,-15,31
Ards,8621,10,9,4,17,35,55,-20,31
Ballinamalla,8621,11,8,6,16,29,47,-18,30
Ballymena,8622,1,18,4,8,68,58,10,58
Glenavon,8622,2,15,11,4,63,44,19,56
Crusaders,8622,3,15,9,6,54,37,17,54
Coleraine,8622,4,11,12,7,45,39,6,45
Linfield,8622,5,11,11,8,56,34,22,44
Cliftonville,8622,6,12,8,10,55,43,12,44
Glentoran,8622,7,8,11,11,31,41,-10,35
Ards,8622,8,10,5,15,38,52,-14,35
Dungannon,8622,9,7,11,12,44,50,-6,32
Ballinamalla,8622,10,6,6,18,32,55,-23,24
Portadown,8622,11,3,10,17,21,54,-33,19
Crusaders,8623,1,17,7,6,57,40,17,58
Cliftonville,8623,2,16,6,8,56,42,14,54
Linfield,8623,3,13,9,8,57,37,20,48
Ballymena,8623,4,14,6,10,61,59,2,48
Glenavon,8623,5,11,8,11,46,46,0,41
Coleraine,8623,6,10,8,12,40,41,-1,38
Dungannon,8623,7,9,10,11,50,46,4,37
Glentoran,8623,8,10,7,13,27,42,-15,37
Ballinamalla,8623,9,10,4,16,32,51,-19,34
Ards,8623,10,9,5,16,46,48,-2,32
Portadown,8623,11,8,6,16,24,44,-20,30
Crusaders,8624,1,18,7,5,52,29,23,61
Linfield,8624,2,16,8,6,65,24,41,56
Cliftonville,8624,3,17,5,8,57,36,21,56
Coleraine,8624,4,15,11,4,51,30,21,56
Glenavon,8624,5,12,11,7,51,44,7,47
Ballymena,8624,6,11,10,9,54,56,-2,43
Glentoran,8624,7,8,8,14,28,54,-26,32
Dungannon,8624,8,8,7,15,41,49,-8,31
Ards,8624,9,7,8,15,36,53,-17,29
Portadown,8624,10,6,7,17,21,49,-28,25
Ballinamalla,8624,11,4,4,22,24,56,-32,16
Crusaders,8625,1,18,6,6,55,30,25,60
Ballymena,8625,2,16,6,8,57,49,8,54
Coleraine,8625,3,15,8,7,44,35,9,53
Cliftonville,8625,4,15,7,8,53,35,18,52
Linfield,8625,5,14,9,7,61,34,27,51
Glenavon,8625,6,9,11,10,41,42,-1,38
Dungannon,8625,7,8,9,13,44,45,-1,33
Glentoran,8625,8,8,8,14,25,47,-22,32
Portadown,8625,9,8,6,16,28,47,-19,30
Ballinamalla,8625,10,7,6,17,26,48,-22,27
Ards,8625,11,6,6,18,36,58,-22,24
Crusaders,8626,1,17,5,8,55,31,24,56
Ballymena,8626,2,15,6,9,65,62,3,51
Cliftonville,8626,3,15,4,11,59,50,9,49
Linfield,8626,4,12,12,6,56,37,19,48
Glenavon,8626,5,12,11,7,45,39,6,47
Coleraine,8626,6,10,11,9,40,36,4,41
Glentoran,8626,7,10,9,11,34,39,-5,39
Dungannon,8626,8,9,9,12,48,47,1,36
Portadown,8626,9,8,8,14,32,44,-12,32
Ards,8626,10,9,4,17,32,52,-20,31
Ballinamalla,8626,11,7,3,20,24,53,-29,24
Linfield,8627,1,16,9,5,58,30,28,57
Glenavon,8627,2,14,10,6,49,36,13,52
Ballymena,8627,3,15,6,9,65,55,10,51
Crusaders,8627,4,13,11,6,54,42,12,50
Cliftonville,8627,5,14,7,9,55,38,17,49
Coleraine,8627,6,10,13,7,40,43,-3,43
Dungannon,8627,7,10,9,11,56,45,11,39
Ards,8627,8,9,5,16,43,52,-9,32
Glentoran,8627,9,7,7,16,22,48,-26,28
Ballinamalla,8627,10,8,3,19,29,56,-27,27
Portadown,8627,11,6,6,18,22,48,-26,24
Linfield,8628,1,16,8,6,62,34,28,56
Cliftonville,8628,2,15,4,11,56,41,15,49
Ballymena,8628,3,14,7,9,62,58,4,49
Crusaders,8628,4,13,9,8,55,40,15,48
Dungannon,8628,5,12,9,9,56,46,10,45
Coleraine,8628,6,12,9,9,45,43,2,45
Glenavon,8628,7,9,11,10,50,49,1,38
Ards,8628,8,9,7,14,41,51,-10,34
Portadown,8628,9,9,6,15,31,47,-16,33
Glentoran,8628,10,7,8,15,28,48,-20,29
Ballinamalla,8628,11,9,2,19,32,61,-29,29
Linfield,8629,1,16,11,3,59,23,36,59
Ballymena,8629,2,17,6,7,60,52,8,57
Crusaders,8629,3,15,8,7,52,30,22,53
Cliftonville,8629,4,15,6,9,49,38,11,51
Glenavon,8629,5,12,11,7,50,43,7,47
Coleraine,8629,6,11,10,9,44,36,8,43
Dungannon,8629,7,8,11,11,42,43,-1,35
Ards,8629,8,9,6,15,36,46,-10,33
Glentoran,8629,9,8,6,16,30,52,-22,30
Ballinamalla,8629,10,5,9,16,24,49,-25,24
Portadown,8629,11,5,4,21,18,52,-34,19
Crusaders,8630,1,16,10,4,58,37,21,58
Linfield,8630,2,17,6,7,65,39,26,57
Ballymena,8630,3,15,5,10,63,60,3,50
Glenavon,8630,4,13,10,7,53,42,11,49
Cliftonville,8630,5,12,5,13,49,47,2,41
Ards,8630,6,12,5,13,43,43,0,41
Coleraine,8630,7,10,10,10,39,39,0,40
Dungannon,8630,8,9,11,10,52,43,9,38
Glentoran,8630,9,11,5,14,34,45,-11,38
Portadown,8630,10,5,9,16,27,51,-24,24
Ballinamalla,8630,11,5,4,21,28,65,-37,19
Crusaders,8631,1,16,8,6,52,31,21,56
Linfield,8631,2,15,9,6,61,32,29,54
Cliftonville,8631,3,14,6,10,52,42,10,48
Dungannon,8631,4,12,10,8,47,39,8,46
Ballymena,8631,5,13,7,10,52,62,-10,46
Coleraine,8631,6,11,10,9,41,39,2,43
Glenavon,8631,7,11,9,10,52,46,6,42
Glentoran,8631,8,10,7,13,32,42,-10,37
Ards,8631,9,10,4,16,33,48,-15,34
Ballinamalla,8631,10,9,2,19,29,48,-19,29
Portadown,8631,11,6,4,20,27,49,-22,22
Glenavon,8632,1,16,8,6,59,38,21,56
Crusaders,8632,2,15,7,8,55,35,20,52
Linfield,8632,3,14,9,7,52,31,21,51
Cliftonville,8632,4,15,6,9,53,38,15,51
Ballymena,8632,5,13,8,9,59,56,3,47
Coleraine,8632,6,10,11,9,41,48,-7,41
Ballinamalla,8632,7,12,3,15,37,46,-9,39
Dungannon,8632,8,8,10,12,54,54,0,34
Ards,8632,9,7,8,15,33,51,-18,29
Portadown,8632,10,7,6,17,22,44,-22,27
Glentoran,8632,11,7,6,17,26,50,-24,27
Linfield,8633,1,16,9,5,56,28,28,57
Crusaders,8633,2,16,8,6,56,36,20,56
Glenavon,8633,3,14,9,7,53,40,13,51
Coleraine,8633,4,14,7,9,45,39,6,49
Ballymena,8633,5,11,10,9,52,56,-4,43
Cliftonville,8633,6,11,7,12,44,43,1,40
Ards,8633,7,10,5,15,43,51,-8,35
Portadown,8633,8,8,9,13,26,35,-9,33
Dungannon,8633,9,8,7,15,42,47,-5,31
Ballinamalla,8633,10,9,4,17,27,51,-24,31
Glentoran,8633,11,6,9,15,31,49,-18,27
Crusaders,8634,1,17,8,5,57,36,21,59
Cliftonville,8634,2,16,6,8,60,42,18,54
Coleraine,8634,3,15,9,6,55,39,16,54
Linfield,8634,4,15,7,8,58,35,23,52
Dungannon,8634,5,12,8,10,52,42,10,44
Glenavon,8634,6,9,11,10,41,47,-6,38
Ards,8634,7,10,6,14,36,45,-9,36
Ballymena,8634,8,10,5,15,55,70,-15,35
Glentoran,8634,9,8,8,14,33,46,-13,32
Ballinamalla,8634,10,9,3,18,34,52,-18,30
Portadown,8634,11,7,3,20,25,52,-27,24
Crusaders,8635,1,20,9,1,64,24,40,69
Cliftonville,8635,2,16,5,9,57,41,16,53
Linfield,8635,3,14,10,6,58,32,26,52
Ballymena,8635,4,13,5,12,57,58,-1,44
Coleraine,8635,5,12,7,11,39,40,-1,43
Glenavon,8635,6,10,12,8,41,46,-5,42
Dungannon,8635,7,10,9,11,51,43,8,39
Ards,8635,8,10,4,16,40,50,-10,34
Glentoran,8635,9,8,7,15,33,50,-17,31
Ballinamalla,8635,10,7,4,19,33,60,-27,25
Portadown,8635,11,5,8,17,22,51,-29,23
Crusaders,8636,1,16,7,7,56,41,15,55
Linfield,8636,2,14,7,9,52,32,20,49
Cliftonville,8636,3,15,4,11,60,42,18,49
Dungannon,8636,4,12,12,6,54,38,16,48
Glenavon,8636,5,12,11,7,52,47,5,47
Ballymena,8636,6,12,7,11,52,62,-10,43
Coleraine,8636,7,9,13,8,48,42,6,40
Glentoran,8636,8,8,9,13,33,43,-10,33
Portadown,8636,9,9,4,17,25,43,-18,31
Ards,8636,10,7,8,15,35,52,-17,29
Ballinamalla,8636,11,8,4,18,28,53,-25,28
Linfield,8637,1,18,9,3,68,30,38,63
Crusaders,8637,2,16,9,5,51,29,22,57
Coleraine,8637,3,12,11,7,43,35,8,47
Cliftonville,8637,4,14,5,11,47,41,6,47
Ballymena,8637,5,13,7,10,52,51,1,46
Glenavon,8637,6,11,12,7,50,44,6,45
Dungannon,8637,7,11,7,12,49,45,4,40
Ards,8637,8,8,6,16,36,51,-15,30
Glentoran,8637,9,7,9,14,32,47,-15,30
Portadown,8637,10,8,3,19,24,46,-22,27
Ballinamalla,8637,11,6,4,20,22,55,-33,22
Cliftonville,8638,1,17,6,7,59,37,22,57
Linfield,8638,2,15,9,6,60,29,31,54
Crusaders,8638,3,13,7,10,44,35,9,46
Glenavon,8638,4,11,13,6,47,41,6,46
Ballymena,8638,5,13,5,12,51,58,-7,44
Dungannon,8638,6,10,11,9,50,42,8,41
Glentoran,8638,7,11,8,11,39,46,-7,41
Coleraine,8638,8,9,12,9,41,39,2,39
Portadown,8638,9,10,4,16,24,46,-22,34
Ards,8638,10,8,4,18,41,56,-15,28
Ballinamalla,8638,11,6,5,19,29,56,-27,23
Cliftonville,8639,1,18,3,9,55,42,13,57
Glenavon,8639,2,15,11,4,58,37,21,56
Crusaders,8639,3,15,7,8,50,38,12,52
Ballymena,8639,4,15,6,9,60,60,0,51
Glentoran,8639,5,12,5,13,34,50,-16,41
Linfield,8639,6,10,9,11,57,42,15,39
Coleraine,8639,7,9,9,12,40,38,2,36
Ards,8639,8,10,6,14,43,47,-4,36
Dungannon,8639,9,7,11,12,45,49,-4,32
Ballinamalla,8639,10,9,2,19,33,54,-21,29
Portadown,8639,11,7,7,16,31,49,-18,28
Crusaders,8640,1,17,7,6,64,35,29,58
Linfield,8640,2,14,11,5,62,32,30,53
Cliftonville,8640,3,16,5,9,50,39,11,53
Coleraine,8640,4,11,12,7,47,39,8,45
Glenavon,8640,5,12,9,9,46,45,1,45
Glentoran,8640,6,12,5,13,31,39,-8,41
Ballymena,8640,7,11,7,12,50,61,-11,40
Portadown,8640,8,9,6,15,25,40,-15,33
Dungannon,8640,9,7,10,13,52,57,-5,31
Ballinamalla,8640,10,9,4,17,32,52,-20,31
Ards,8640,11,6,6,18,32,52,-20,24
Crusaders,8641,1,16,9,5,54,29,25,57
Linfield,8641,2,14,7,9,60,32,28,49
Cliftonville,8641,3,13,7,10,45,43,2,46
Ballymena,8641,4,13,6,11,54,57,-3,45
Dungannon,8641,5,11,10,9,49,42,7,43
Glenavon,8641,6,11,10,9,48,46,2,43
Coleraine,8641,7,11,10,9,36,34,2,43
Glentoran,8641,8,9,11,10,34,40,-6,38
Portadown,8641,9,8,7,15,30,44,-14,31
Ards,8641,10,9,3,18,33,46,-13,30
Ballinamalla,8641,11,7,6,17,28,58,-30,27
Cliftonville,8642,1,18,4,8,62,38,24,58
Ballymena,8642,2,15,6,9,60,53,7,51
Linfield,8642,3,13,10,7,59,35,24,49
Glenavon,8642,4,13,10,7,55,40,15,49
Crusaders,8642,5,14,6,10,50,42,8,48
Coleraine,8642,6,12,10,8,44,40,4,46
Dungannon,8642,7,9,10,11,43,45,-2,37
Glentoran,8642,8,9,8,13,34,47,-13,35
Ards,8642,9,9,6,15,40,47,-7,33
Ballinamalla,8642,10,9,3,18,29,52,-23,30
Portadown,8642,11,5,5,20,24,61,-37,20
Crusaders,8643,1,16,12,2,54,31,23,60
Linfield,8643,2,15,11,4,56,26,30,56
Ballymena,8643,3,17,4,9,63,49,14,55
Cliftonville,8643,4,14,6,10,56,48,8,48
Glenavon,8643,5,11,14,5,45,38,7,47
Coleraine,8643,6,9,11,10,42,43,-1,38
Glentoran,8643,7,9,7,14,37,50,-13,34
Dungannon,8643,8,6,13,11,44,46,-2,31
Ards,8643,9,7,8,15,34,49,-15,29
Portadown,8643,10,7,8,15,26,45,-19,29
Ballinamalla,8643,11,3,8,19,24,56,-32,17
Linfield,8644,1,19,7,4,71,29,42,64
Crusaders,8644,2,13,12,5,56,41,15,51
Ballymena,8644,3,14,5,11,53,59,-6,47
Glenavon,8644,4,11,13,6,54,42,12,46
Cliftonville,8644,5,13,6,11,47,38,9,45
Coleraine,8644,6,11,12,7,45,36,9,45
Dungannon,8644,7,9,8,13,43,51,-8,35
Ards,8644,8,10,5,15,40,54,-14,35
Glentoran,8644,9,8,8,14,27,42,-15,32
Ballinamalla,8644,10,7,7,16,30,53,-23,28
Portadown,8644,11,6,5,19,23,44,-21,23
Linfield,8645,1,16,7,7,62,32,30,55
Ballymena,8645,2,15,7,8,56,50,6,52
Cliftonville,8645,3,13,6,11,43,40,3,45
Crusaders,8645,4,13,6,11,47,45,2,45
Glenavon,8645,5,11,11,8,45,41,4,44
Coleraine,8645,6,11,10,9,48,45,3,43
Dungannon,8645,7,11,7,12,52,38,14,40
Ards,8645,8,11,6,13,40,49,-9,39
Glentoran,8645,9,9,8,13,35,44,-9,35
Portadown,8645,10,8,9,13,34,44,-10,33
Ballinamalla,8645,11,5,7,18,27,61,-34,22
Cliftonville,8646,1,19,4,7,62,38,24,61
Dungannon,8646,2,14,7,9,59,39,20,49
Glenavon,8646,3,13,10,7,51,45,6,49
Linfield,8646,4,12,12,6,57,32,25,48
Crusaders,8646,5,13,7,10,54,42,12,46
Coleraine,8646,6,12,8,10,43,43,0,44
Glentoran,8646,7,10,7,13,40,50,-10,37
Ballymena,8646,8,9,9,12,52,63,-11,36
Ards,8646,9,9,8,13,39,47,-8,35
Ballinamalla,8646,10,7,5,18,32,57,-25,26
Portadown,8646,11,5,7,18,25,58,-33,22
Linfield,8647,1,16,8,6,54,28,26,56
Cliftonville,8647,2,17,3,10,56,32,24,54
Crusaders,8647,3,15,5,10,46,32,14,50
Dungannon,8647,4,14,7,9,54,38,16,49
Glenavon,8647,5,12,11,7,46,40,6,47
Ballymena,8647,6,12,8,10,48,56,-8,44
Coleraine,8647,7,11,9,10,37,37,0,42
Glentoran,8647,8,8,8,14,31,45,-14,32
Portadown,8647,9,9,5,16,31,47,-16,32
Ards,8647,10,8,7,15,34,48,-14,31
Ballinamalla,8647,11,6,3,21,25,59,-34,21
Crusaders,8648,1,18,8,4,61,28,33,62
Cliftonville,8648,2,17,4,9,54,36,18,55
Ballymena,8648,3,16,5,9,58,60,-2,53
Linfield,8648,4,13,9,8,57,42,15,48
Coleraine,8648,5,11,9,10,43,39,4,42
Dungannon,8648,6,9,13,8,49,41,8,40
Ballinamalla,8648,7,10,5,15,33,50,-17,35
Glenavon,8648,8,8,10,12,34,44,-10,34
Glentoran,8648,9,8,6,16,32,46,-14,30
Ards,8648,10,9,2,19,33,51,-18,29
Portadown,8648,11,7,7,16,29,46,-17,28
Cliftonville,8649,1,16,7,7,55,34,21,55
Coleraine,8649,2,14,8,8,45,32,13,50
Ballymena,8649,3,13,9,8,56,55,1,48
Crusaders,8649,4,12,10,8,47,37,10,46
Glenavon,8649,5,12,10,8,47,43,4,46
Linfield,8649,6,11,12,7,55,36,19,45
Dungannon,8649,7,11,10,9,47,41,6,43
Ards,8649,8,10,5,15,41,51,-10,35
Glentoran,8649,9,9,5,16,35,52,-17,32
Ballinamalla,8649,10,7,5,18,23,48,-25,26
Portadown,8649,11,6,7,17,19,41,-22,25
Crusaders,8650,1,18,6,6,59,31,28,60
Cliftonville,8650,2,18,2,10,57,41,16,56
Linfield,8650,3,14,9,7,58,39,19,51
Dungannon,8650,4,12,8,10,51,44,7,44
Coleraine,8650,5,11,10,9,48,48,0,43
Ballymena,8650,6,13,4,13,63,64,-1,43
Glenavon,8650,7,10,12,8,49,47,2,42
Glentoran,8650,8,8,8,14,27,42,-15,32
Portadown,8650,9,9,5,16,35,52,-17,32
Ballinamalla,8650,10,7,7,16,28,47,-19,28
Ards,8650,11,7,5,18,40,60,-20,26
Crusaders,8651,1,19,7,4,62,29,33,64
Cliftonville,8651,2,18,4,8,55,34,21,58
Linfield,8651,3,16,8,6,56,24,32,56
Glentoran,8651,4,11,9,10,33,39,-6,42
Coleraine,8651,5,10,10,10,40,43,-3,40
Glenavon,8651,6,9,12,9,41,43,-2,39
Ballymena,8651,7,10,7,13,49,61,-12,37
Dungannon,8651,8,8,10,12,46,48,-2,34
Portadown,8651,9,9,4,17,33,47,-14,31
Ballinamalla,8651,10,7,7,16,30,54,-24,28
Ards,8651,11,7,4,19,35,58,-23,25
Linfield,8652,1,17,9,4,68,32,36,60
Crusaders,8652,2,14,11,5,56,37,19,53
Ballymena,8652,3,14,7,9,62,60,2,49
Cliftonville,8652,4,14,4,12,49,41,8,46
Coleraine,8652,5,10,12,8,41,38,3,42
Glenavon,8652,6,11,9,10,50,48,2,42
Glentoran,8652,7,9,12,9,38,41,-3,39
Dungannon,8652,8,9,11,10,53,47,6,38
Portadown,8652,9,9,4,17,34,57,-23,31
Ards,8652,10,6,7,17,32,51,-19,25
Ballinamalla,8652,11,7,4,19,26,57,-31,25
Crusaders,8653,1,19,5,6,62,31,31,62
Linfield,8653,2,16,8,6,60,30,30,56
Cliftonville,8653,3,17,4,9,52,38,14,55
Coleraine,8653,4,14,8,8,43,37,6,50
Dungannon,8653,5,13,6,11,55,43,12,45
Ballymena,8653,6,13,6,11,56,64,-8,45
Ards,8653,7,13,3,14,46,42,4,42
Glenavon,8653,8,10,10,10,50,55,-5,40
Glentoran,8653,9,8,6,16,30,46,-16,30
Portadown,8653,10,6,2,22,18,53,-35,20
Ballinamalla,8653,11,5,4,21,33,66,-33,19
Crusaders,8654,1,14,8,8,50,39,11,50
Ballymena,8654,2,15,5,10,63,55,8,50
Cliftonville,8654,3,14,7,9,53,43,10,49
Glenavon,8654,4,12,13,5,52,44,8,49
Linfield,8654,5,12,11,7,64,42,22,47
Coleraine,8654,6,9,13,8,46,44,2,40
Dungannon,8654,7,9,11,10,49,50,-1,38
Glentoran,8654,8,9,9,12,33,42,-9,36
Ards,8654,9,10,4,16,38,48,-10,34
Ballinamalla,8654,10,8,6,16,33,51,-18,30
Portadown,8654,11,5,9,16,20,43,-23,24
Crusaders,8655,1,18,7,5,63,32,31,61
Cliftonville,8655,2,17,3,10,54,41,13,54
Linfield,8655,3,14,10,6,65,37,28,52
Dungannon,8655,4,13,8,9,52,42,10,47
Ballymena,8655,5,12,9,9,62,62,0,45
Coleraine,8655,6,11,9,10,45,43,2,42
Glenavon,8655,7,9,10,11,44,55,-11,37
Ards,8655,8,11,3,16,41,48,-7,36
Glentoran,8655,9,7,7,16,34,58,-24,28
Ballinamalla,8655,10,7,6,17,27,48,-21,27
Portadown,8655,11,6,8,16,28,49,-21,26
Cliftonville,8656,1,17,5,8,60,41,19,56
Linfield,8656,2,13,11,6,53,30,23,50
Crusaders,8656,3,14,7,9,48,33,15,49
Ballymena,8656,4,14,5,11,59,62,-3,47
Glenavon,8656,5,11,12,7,51,46,5,45
Coleraine,8656,6,11,11,8,45,40,5,44
Dungannon,8656,7,9,10,11,51,47,4,37
Glentoran,8656,8,8,10,12,30,42,-12,34
Portadown,8656,9,9,5,16,28,46,-18,32
Ards,8656,10,8,7,15,38,52,-14,31
Ballinamalla,8656,11,7,5,18,32,56,-24,26
Crusaders,8657,1,17,7,6,65,36,29,58
Linfield,8657,2,15,10,5,65,36,29,55
Cliftonville,8657,3,15,7,8,53,40,13,52
Glenavon,8657,4,13,11,6,47,37,10,50
Coleraine,8657,5,10,11,9,42,44,-2,41
Ballymena,8657,6,12,4,14,55,66,-11,40
Ballinamalla,8657,7,9,6,15,29,42,-13,33
Ards,8657,8,10,2,18,40,50,-10,32
Dungannon,8657,9,7,10,13,43,50,-7,31
Glentoran,8657,10,7,10,13,25,48,-23,31
Portadown,8657,11,7,8,15,27,42,-15,29
Crusaders,8658,1,15,9,6,52,35,17,54
Linfield,8658,2,13,10,7,61,38,23,49
Cliftonville,8658,3,15,4,11,55,46,9,49
Ballymena,8658,4,14,6,10,60,60,0,48
Coleraine,8658,5,12,10,8,45,36,9,46
Glenavon,8658,6,8,14,8,46,46,0,38
Glentoran,8658,7,10,8,12,31,46,-15,38
Ards,8658,8,11,4,15,43,46,-3,37
Dungannon,8658,9,8,8,14,44,46,-2,32
Portadown,8658,10,9,5,16,27,46,-19,32
Ballinamalla,8658,11,9,4,17,33,52,-19,31
Crusaders,8659,1,18,8,4,62,29,33,62
Ballymena,8659,2,17,4,9,59,53,6,55
Linfield,8659,3,14,10,6,58,31,27,52
Cliftonville,8659,4,14,6,10,50,38,12,48
Coleraine,8659,5,12,9,9,36,41,-5,45
Glenavon,8659,6,10,12,8,49,47,2,42
Dungannon,8659,7,9,9,12,53,48,5,36
Ballinamalla,8659,8,9,5,16,31,50,-19,32
Ards,8659,9,8,7,15,35,49,-14,31
Portadown,8659,10,6,7,17,27,52,-25,25
Glentoran,8659,11,5,9,16,25,47,-22,24
Linfield,8660,1,18,7,5,68,34,34,61
Crusaders,8660,2,15,10,5,61,34,27,55
Glenavon,8660,3,13,9,8,62,44,18,48
Cliftonville,8660,4,13,5,12,46,42,4,44
Coleraine,8660,5,11,9,10,48,43,5,42
Dungannon,8660,6,11,9,10,49,45,4,42
Ballymena,8660,7,12,4,14,47,65,-18,40
Glentoran,8660,8,9,8,13,34,45,-11,35
Portadown,8660,9,10,4,16,26,44,-18,34
Ards,8660,10,9,4,17,30,54,-24,31
Ballinamalla,8660,11,8,3,19,32,53,-21,27
Crusaders,8661,1,16,6,8,56,39,17,54
Linfield,8661,2,14,9,7,63,35,28,51
Coleraine,8661,3,14,8,8,46,37,9,50
Ballymena,8661,4,14,8,8,57,57,0,50
Cliftonville,8661,5,14,6,10,52,41,11,48
Dungannon,8661,6,10,10,10,54,46,8,40
Glenavon,8661,7,9,11,10,49,49,0,38
Ards,8661,8,10,5,15,42,51,-9,35
Glentoran,8661,9,8,8,14,30,46,-16,32
Portadown,8661,10,8,5,17,30,53,-23,29
Ballinamalla,8661,11,7,6,17,33,58,-25,27
Crusaders,8662,1,19,5,6,55,34,21,62
Cliftonville,8662,2,17,4,9,62,37,25,55
Glenavon,8662,3,13,9,8,51,45,6,48
Ballymena,8662,4,14,5,11,59,60,-1,47
Linfield,8662,5,12,9,9,52,35,17,45
Coleraine,8662,6,11,8,11,41,51,-10,41
Ballinamalla,8662,7,12,1,17,30,44,-14,37
Dungannon,8662,8,9,7,14,44,46,-2,34
Portadown,8662,9,9,5,16,25,39,-14,32
Glentoran,8662,10,8,8,14,28,44,-16,32
Ards,8662,11,7,7,16,37,49,-12,28
Crusaders,8663,1,20,6,4,59,30,29,66
Cliftonville,8663,2,16,5,9,57,41,16,53
Dungannon,8663,3,13,7,10,52,45,7,46
Ballymena,8663,4,13,7,10,58,56,2,46
Linfield,8663,5,12,9,9,60,43,17,45
Glenavon,8663,6,10,10,10,59,57,2,40
Coleraine,8663,7,10,9,11,46,48,-2,39
Glentoran,8663,8,10,8,12,32,40,-8,38
Portadown,8663,9,10,4,16,30,53,-23,34
Ards,8663,10,8,5,17,48,58,-10,29
Ballinamalla,8663,11,6,4,20,24,54,-30,22
Crusaders,8664,1,16,8,6,51,33,18,56
Ballymena,8664,2,16,5,9,54,51,3,53
Cliftonville,8664,3,15,5,10,48,37,11,50
Glenavon,8664,4,13,9,8,52,46,6,48
Linfield,8664,5,12,9,9,52,33,19,45
Coleraine,8664,6,12,9,9,46,35,11,45
Dungannon,8664,7,11,9,10,52,43,9,42
Glentoran,8664,8,12,5,13,39,40,-1,41
Ards,8664,9,10,4,16,39,56,-17,34
Portadown,8664,10,7,5,18,20,48,-28,26
Ballinamalla,8664,11,6,2,22,25,56,-31,20
Cliftonville,8665,1,17,5,8,56,39,17,56
Crusaders,8665,2,14,7,9,52,39,13,49
Ballymena,8665,3,14,6,10,65,57,8,48
Linfield,8665,4,13,8,9,57,33,24,47
Dungannon,8665,5,12,10,8,54,40,14,46
Coleraine,8665,6,12,7,11,41,45,-4,43
Glenavon,8665,7,10,11,9,48,47,1,41
Glentoran,8665,8,11,8,11,34,43,-9,41
Ards,8665,9,9,3,18,37,55,-18,30
Ballinamalla,8665,10,8,5,17,26,50,-24,29
Portadown,8665,11,8,4,18,22,44,-22,28
Crusaders,8666,1,15,9,6,52,26,26,54
Cliftonville,8666,2,15,7,8,49,35,14,52
Ballymena,8666,3,15,7,8,58,52,6,52
Linfield,8666,4,14,9,7,58,33,25,51
Glenavon,8666,5,12,13,5,46,41,5,49
Coleraine,8666,6,10,12,8,38,36,2,42
Glentoran,8666,7,8,9,13,26,40,-14,33
Portadown,8666,8,9,5,16,31,47,-16,32
Dungannon,8666,9,7,10,13,44,48,-4,31
Ballinamalla,8666,10,8,4,18,25,51,-26,28
Ards,8666,11,7,5,18,35,53,-18,26
Linfield,8667,1,17,7,6,66,31,35,58
Cliftonville,8667,2,16,3,11,53,40,13,51
Coleraine,8667,3,14,9,7,49,37,12,51
Crusaders,8667,4,15,5,10,51,38,13,50
Ballymena,8667,5,15,5,10,53,58,-5,50
Glenavon,8667,6,12,9,9,50,52,-2,45
Glentoran,8667,7,11,8,11,31,37,-6,41
Dungannon,8667,8,10,9,11,54,47,7,39
Ards,8667,9,7,5,18,32,48,-16,26
Ballinamalla,8667,10,8,2,20,32,59,-27,26
Portadown,8667,11,7,4,19,23,47,-24,25
Crusaders,8668,1,15,11,4,56,33,23,56
Glenavon,8668,2,14,11,5,57,41,16,53
Ballymena,8668,3,16,5,9,59,52,7,53
Linfield,8668,4,13,9,8,48,28,20,48
Coleraine,8668,5,13,9,8,47,38,9,48
Cliftonville,8668,6,13,7,10,48,42,6,46
Dungannon,8668,7,10,7,13,46,47,-1,37
Ards,8668,8,11,2,17,38,49,-11,35
Glentoran,8668,9,8,8,14,30,44,-14,32
Portadown,8668,10,8,6,16,17,41,-24,30
Ballinamalla,8668,11,4,5,21,22,53,-31,17
Crusaders,8669,1,18,5,7,57,36,21,59
Glenavon,8669,2,14,10,6,56,43,13,52
Linfield,8669,3,14,9,7,61,35,26,51
Glentoran,8669,4,13,8,9,41,40,1,47
Dungannon,8669,5,11,9,10,52,46,6,42
Cliftonville,8669,6,12,5,13,48,45,3,41
Ballymena,8669,7,12,5,13,51,60,-9,41
Coleraine,8669,8,10,7,13,45,51,-6,37
Ards,8669,9,10,5,15,40,48,-8,35
Ballinamalla,8669,10,9,5,16,30,51,-21,32
Portadown,8669,11,5,6,19,26,52,-26,21
Crusaders,8670,1,16,12,2,62,37,25,60
Linfield,8670,2,14,9,7,60,40,20,51
Ballymena,8670,3,14,7,9,53,53,0,49
Cliftonville,8670,4,13,6,11,52,46,6,45
Glenavon,8670,5,10,12,8,48,51,-3,42
Coleraine,8670,6,8,12,10,38,40,-2,36
Ards,8670,7,10,6,14,39,43,-4,36
Dungannon,8670,8,8,11,11,53,46,7,35
Glentoran,8670,9,9,7,14,33,45,-12,34
Ballinamalla,8670,10,9,4,17,36,55,-19,31
Portadown,8670,11,8,6,16,27,45,-18,30
Crusaders,8671,1,15,9,6,55,34,21,54
Cliftonville,8671,2,16,5,9,55,38,17,53
Ballymena,8671,3,13,7,10,59,65,-6,46
Glenavon,8671,4,12,9,9,46,45,1,45
Dungannon,8671,5,12,8,10,54,44,10,44
Ards,8671,6,12,7,11,38,41,-3,43
Coleraine,8671,7,11,9,10,43,36,7,42
Linfield,8671,8,11,8,11,48,34,14,41
Glentoran,8671,9,7,10,13,26,40,-14,31
Ballinamalla,8671,10,8,6,16,28,52,-24,30
Portadown,8671,11,7,4,19,32,55,-23,25
Crusaders,8672,1,17,7,6,54,35,19,58
Ballymena,8672,2,18,4,8,57,49,8,58
Linfield,8672,3,16,8,6,59,32,27,56
Coleraine,8672,4,14,8,8,40,31,9,50
Cliftonville,8672,5,15,4,11,51,37,14,49
Glenavon,8672,6,11,11,8,38,38,0,44
Dungannon,8672,7,9,10,11,51,47,4,37
Glentoran,8672,8,9,6,15,31,49,-18,33
Ards,8672,9,8,5,17,39,51,-12,29
Portadown,8672,10,7,4,19,26,50,-24,25
Ballinamalla,8672,11,5,5,20,23,50,-27,20
Crusaders,8673,1,17,8,5,60,33,27,59
Linfield,8673,2,16,8,6,62,31,31,56
Cliftonville,8673,3,16,5,9,51,34,17,53
Ballymena,8673,4,12,8,10,51,56,-5,44
Dungannon,8673,5,11,10,9,49,42,7,43
Coleraine,8673,6,10,11,9,39,42,-3,41
Glenavon,8673,7,9,12,9,43,43,0,39
Glentoran,8673,8,11,6,13,37,47,-10,39
Portadown,8673,9,7,7,16,23,41,-18,28
Ballinamalla,8673,10,8,3,19,26,53,-27,27
Ards,8673,11,5,8,17,33,52,-19,23
Cliftonville,8674,1,17,4,9,53,34,19,55
Ballymena,8674,2,14,7,9,60,54,6,49
Linfield,8674,3,12,11,7,52,32,20,47
Dungannon,8674,4,12,9,9,55,41,14,45
Crusaders,8674,5,12,9,9,48,41,7,45
Glenavon,8674,6,11,11,8,46,42,4,44
Coleraine,8674,7,11,10,9,42,39,3,43
Glentoran,8674,8,9,6,15,29,44,-15,33
Ards,8674,9,8,8,14,32,45,-13,32
Ballinamalla,8674,10,9,3,18,29,54,-25,30
Portadown,8674,11,7,8,15,23,43,-20,29
Cliftonville,8675,1,17,5,8,54,39,15,56
Crusaders,8675,2,15,9,6,56,31,25,54
Linfield,8675,3,13,9,8,50,32,18,48
Ballymena,8675,4,13,8,9,59,60,-1,47
Glenavon,8675,5,11,12,7,51,43,8,45
Dungannon,8675,6,11,10,9,49,38,11,43
Coleraine,8675,7,11,10,9,44,39,5,43
Ards,8675,8,10,6,14,40,52,-12,36
Glentoran,8675,9,7,8,15,29,48,-19,29
Portadown,8675,10,8,4,18,21,45,-24,28
Ballinamalla,8675,11,7,3,20,26,52,-26,24
Crusaders,8676,1,17,6,7,63,36,27,57
Glenavon,8676,2,12,11,7,52,46,6,47
Coleraine,8676,3,12,11,7,48,44,4,47
Ballymena,8676,4,13,8,9,61,60,1,47
Glentoran,8676,5,13,7,10,34,41,-7,46
Linfield,8676,6,11,11,8,52,38,14,44
Cliftonville,8676,7,13,3,14,49,41,8,42
Dungannon,8676,8,9,9,12,50,44,6,36
Ards,8676,9,8,6,16,39,52,-13,30
Ballinamalla,8676,10,9,3,18,33,59,-26,30
Portadown,8676,11,7,7,16,25,45,-20,28
Crusaders,8677,1,16,11,3,61,36,25,59
Linfield,8677,2,16,9,5,60,34,26,57
Cliftonville,8677,3,14,6,10,58,42,16,48
Ballymena,8677,4,13,6,11,53,56,-3,45
Coleraine,8677,5,10,11,9,42,44,-2,41
Glenavon,8677,6,10,10,10,52,54,-2,40
Glentoran,8677,7,12,4,14,38,45,-7,40
Dungannon,8677,8,9,11,10,52,49,3,38
Ballinamalla,8677,9,9,4,17,35,53,-18,31
Ards,8677,10,7,7,16,37,54,-17,28
Portadown,8677,11,6,7,17,31,52,-21,25
Crusaders,8678,1,16,7,7,54,37,17,55
Linfield,8678,2,14,11,5,57,25,32,53
Cliftonville,8678,3,16,3,11,53,38,15,51
Glenavon,8678,4,12,11,7,52,44,8,47
Ballymena,8678,5,13,6,11,54,57,-3,45
Dungannon,8678,6,12,8,10,51,47,4,44
Coleraine,8678,7,9,9,12,41,49,-8,36
Glentoran,8678,8,7,13,10,30,41,-11,34
Ards,8678,9,9,6,15,37,47,-10,33
Ballinamalla,8678,10,7,7,16,30,53,-23,28
Portadown,8678,11,7,5,18,22,43,-21,26
Crusaders,8679,1,19,8,3,62,30,32,65
Linfield,8679,2,16,7,7,64,33,31,55
Cliftonville,8679,3,16,5,9,54,37,17,53
Glenavon,8679,4,9,13,8,46,43,3,40
Coleraine,8679,5,10,10,10,44,44,0,40
Ballymena,8679,6,11,7,12,58,67,-9,40
Ballinamalla,8679,7,10,5,15,29,45,-16,35
Ards,8679,8,10,4,16,38,49,-11,34
Dungannon,8679,9,7,11,12,45,48,-3,32
Portadown,8679,10,8,6,16,23,45,-22,30
Glentoran,8679,11,7,8,15,30,52,-22,29
Crusaders,8680,1,18,7,5,59,35,24,61
Linfield,8680,2,15,10,5,62,34,28,55
Ballymena,8680,3,17,3,10,62,53,9,54
Cliftonville,8680,4,14,6,10,47,38,9,48
Glenavon,8680,5,12,9,9,49,43,6,45
Dungannon,8680,6,12,7,11,53,47,6,43
Glentoran,8680,7,10,8,12,32,44,-12,38
Coleraine,8680,8,6,15,9,34,38,-4,33
Portadown,8680,9,8,5,17,32,54,-22,29
Ballinamalla,8680,10,7,4,19,28,56,-28,25
Ards,8680,11,6,6,18,34,50,-16,24
Crusaders,8681,1,16,9,5,53,35,18,57
Linfield,8681,2,15,9,6,59,33,26,54
Ballymena,8681,3,17,3,10,60,56,4,54
Cliftonville,8681,4,14,5,11,49,41,8,47
Coleraine,8681,5,11,12,7,45,36,9,45
Glenavon,8681,6,11,12,7,49,49,0,45
Ards,8681,7,12,6,12,50,42,8,42
Dungannon,8681,8,9,12,9,48,43,5,39
Glentoran,8681,9,7,8,15,32,47,-15,29
Portadown,8681,10,5,6,19,25,55,-30,21
Ballinamalla,8681,11,4,6,20,20,53,-33,18
Crusaders,8682,1,18,8,4,62,36,26,62
Cliftonville,8682,2,17,5,8,54,37,17,56
Linfield,8682,3,14,9,7,54,28,26,51
Ards,8682,4,13,5,12,49,43,6,44
Coleraine,8682,5,10,13,7,47,45,2,43
Ballymena,8682,6,12,7,11,55,56,-1,43
Glenavon,8682,7,10,10,10,53,52,1,40
Glentoran,8682,8,9,5,16,34,56,-22,32
Dungannon,8682,9,7,10,13,45,47,-2,31
Portadown,8682,10,7,7,16,21,43,-22,28
Ballinamalla,8682,11,8,1,21,27,58,-31,25
Linfield,8683,1,16,8,6,62,28,34,56
Crusaders,8683,2,16,8,6,55,32,23,56
Cliftonville,8683,3,16,6,8,51,35,16,54
Glenavon,8683,4,12,8,10,43,40,3,44
Ballymena,8683,5,12,7,11,48,51,-3,43
Glentoran,8683,6,11,9,10,30,32,-2,42
Coleraine,8683,7,10,9,11,37,42,-5,39
Ballinamalla,8683,8,11,3,16,33,53,-20,36
Portadown,8683,9,9,5,16,22,43,-21,32
Ards,8683,10,8,5,17,31,44,-13,29
Dungannon,8683,11,6,8,16,45,57,-12,26
Crusaders,8684,1,20,6,4,59,33,26,66
Cliftonville,8684,2,17,6,7,56,33,23,57
Glenavon,8684,3,11,13,6,47,46,1,46
Linfield,8684,4,11,10,9,48,34,14,43
Ballymena,8684,5,13,3,14,57,59,-2,42
Coleraine,8684,6,11,8,11,41,41,0,41
Glentoran,8684,7,12,5,13,33,40,-7,41
Dungannon,8684,8,10,7,13,55,50,5,37
Ards,8684,9,9,4,17,37,50,-13,31
Portadown,8684,10,8,6,16,25,48,-23,30
Ballinamalla,8684,11,8,2,20,32,56,-24,26
Crusaders,8685,1,15,9,6,56,36,20,54
Glenavon,8685,2,13,13,4,54,38,16,52
Ballymena,8685,3,15,7,8,66,56,10,52
Linfield,8685,4,14,7,9,56,37,19,49
Cliftonville,8685,5,14,5,11,51,43,8,47
Coleraine,8685,6,10,11,9,40,42,-2,41
Ards,8685,7,11,6,13,46,52,-6,39
Dungannon,8685,8,8,11,11,46,44,2,35
Portadown,8685,9,9,4,17,28,53,-25,31
Glentoran,8685,10,7,6,17,32,50,-18,27
Ballinamalla,8685,11,5,9,16,25,49,-24,24
Crusaders,8686,1,18,8,4,54,24,30,62
Linfield,8686,2,13,12,5,63,31,32,51
Coleraine,8686,3,13,12,5,47,34,13,51
Glenavon,8686,4,13,10,7,53,44,9,49
Ballymena,8686,5,13,7,10,54,54,0,46
Cliftonville,8686,6,11,9,10,49,48,1,42
Dungannon,8686,7,8,11,11,45,43,2,35
Glentoran,8686,8,6,10,14,23,41,-18,28
Portadown,8686,9,7,7,16,24,45,-21,28
Ards,8686,10,8,4,18,32,54,-22,28
Ballinamalla,8686,11,7,6,17,30,56,-26,27
Crusaders,8687,1,18,8,4,64,27,37,62
Linfield,8687,2,14,10,6,58,29,29,52
Ballymena,8687,3,14,5,11,56,51,5,47
Coleraine,8687,4,12,10,8,39,36,3,46
Cliftonville,8687,5,13,5,12,50,44,6,44
Dungannon,8687,6,11,9,10,46,43,3,42
Glenavon,8687,7,8,11,11,41,50,-9,35
Glentoran,8687,8,9,7,14,30,47,-17,34
Portadown,8687,9,9,5,16,28,50,-22,32
Ards,8687,10,7,9,14,32,47,-15,30
Ballinamalla,8687,11,8,5,17,29,49,-20,29
Crusaders,8688,1,18,6,6,54,28,26,60
Ballymena,8688,2,17,5,8,66,60,6,56
Linfield,8688,3,14,11,5,55,30,25,53
Cliftonville,8688,4,15,7,8,59,41,18,52
Glenavon,8688,5,14,10,6,51,40,11,52
Coleraine,8688,6,13,9,8,45,33,12,48
Dungannon,8688,7,7,9,14,38,52,-14,30
Glentoran,8688,8,8,6,16,22,46,-24,30
Portadown,8688,9,7,6,17,24,43,-19,27
Ballinamalla,8688,10,6,6,18,28,53,-25,24
Ards,8688,11,6,5,19,41,57,-16,23
Cliftonville,8689,1,16,5,9,48,36,12,53
Linfield,8689,2,14,10,6,63,35,28,52
Coleraine,8689,3,14,9,7,46,33,13,51
Glenavon,8689,4,13,11,6,56,41,15,50
Dungannon,8689,5,13,9,8,61,43,18,48
Ballymena,8689,6,14,5,11,56,59,-3,47
Crusaders,8689,7,11,11,8,50,39,11,44
Ards,8689,8,11,2,17,40,54,-14,35
Glentoran,8689,9,8,6,16,27,48,-21,30
Ballinamalla,8689,10,8,4,18,29,56,-27,28
Portadown,8689,11,5,4,21,22,54,-32,19
Linfield,8690,1,17,6,7,64,33,31,57
Crusaders,8690,2,16,8,6,57,40,17,56
Glenavon,8690,3,13,11,6,51,42,9,50
Cliftonville,8690,4,14,5,11,45,37,8,47
Ballymena,8690,5,13,7,10,61,59,2,46
Dungannon,8690,6,11,8,11,54,45,9,41
Coleraine,8690,7,9,14,7,41,38,3,41
Ards,8690,8,10,4,16,38,51,-13,34
Ballinamalla,8690,9,9,6,15,28,46,-18,33
Portadown,8690,10,7,5,18,23,49,-26,26
Glentoran,8690,11,6,6,18,29,51,-22,24
Crusaders,8691,1,18,4,8,59,31,28,58
Ballymena,8691,2,16,7,7,62,51,11,55
Linfield,8691,3,14,9,7,60,37,23,51
Dungannon,8691,4,13,8,9,47,39,8,47
Cliftonville,8691,5,13,5,12,43,40,3,44
Glenavon,8691,6,10,9,11,46,49,-3,39
Coleraine,8691,7,9,10,11,37,42,-5,37
Ards,8691,8,9,6,15,42,50,-8,33
Glentoran,8691,9,9,6,15,28,48,-20,33
Portadown,8691,10,8,6,16,29,45,-16,30
Ballinamalla,8691,11,8,6,16,32,53,-21,30
Ballymena,8692,1,17,5,8,65,55,10,56
Crusaders,8692,2,16,7,7,54,30,24,55
Glenavon,8692,3,14,9,7,53,44,9,51
Linfield,8692,4,13,8,9,59,36,23,47
Coleraine,8692,5,12,11,7,44,38,6,47
Dungannon,8692,6,10,12,8,58,39,19,42
Cliftonville,8692,7,12,5,13,54,51,3,41
Glentoran,8692,8,8,10,12,30,42,-12,34
Ballinamalla,8692,9,8,4,18,27,55,-28,28
Ards,8692,10,6,8,16,29,49,-20,26
Portadown,8692,11,7,5,18,25,59,-34,26
Crusaders,8693,1,17,9,4,59,27,32,60
Linfield,8693,2,15,9,6,65,38,27,54
Coleraine,8693,3,15,8,7,47,42,5,53
Ballymena,8693,4,15,6,9,65,60,5,51
Glenavon,8693,5,13,9,8,52,50,2,48
Cliftonville,8693,6,13,2,15,47,49,-2,41
Dungannon,8693,7,10,9,11,52,46,6,39
Glentoran,8693,8,9,6,15,37,51,-14,33
Ballinamalla,8693,9,9,4,17,31,50,-19,31
Ards,8693,10,6,6,18,34,52,-18,24
Portadown,8693,11,5,8,17,33,57,-24,23
Crusaders,8694,1,19,6,5,67,33,34,63
Linfield,8694,2,14,10,6,56,31,25,52
Cliftonville,8694,3,15,5,10,49,37,12,50
Ballymena,8694,4,14,6,10,57,55,2,48
Dungannon,8694,5,12,8,10,56,41,15,44
Glenavon,8694,6,10,13,7,44,42,2,43
Coleraine,8694,7,11,10,9,40,38,2,43
Glentoran,8694,8,10,7,13,32,46,-14,37
Ards,8694,9,8,5,17,34,53,-19,29
Portadown,8694,10,6,6,18,22,49,-27,24
Ballinamalla,8694,11,7,2,21,26,58,-32,23
Crusaders,8695,1,21,6,3,61,29,32,69
Coleraine,8695,2,14,9,7,41,32,9,51
Ballymena,8695,3,14,7,9,58,57,1,49
Linfield,8695,4,13,9,8,52,28,24,48
Cliftonville,8695,5,14,6,10,49,37,12,48
Glenavon,8695,6,12,12,6,48,41,7,48
Dungannon,8695,7,11,9,10,50,42,8,42
Glentoran,8695,8,9,8,13,32,44,-12,35
Ards,8695,9,8,3,19,34,53,-19,27
Ballinamalla,8695,10,8,2,20,36,65,-29,26
Portadown,8695,11,4,3,23,22,55,-33,15
Linfield,8696,1,16,9,5,58,30,28,57
Glenavon,8696,2,14,8,8,49,45,4,50
Ballymena,8696,3,14,7,9,53,51,2,49
Crusaders,8696,4,13,9,8,50,37,13,48
Coleraine,8696,5,11,11,8,40,33,7,44
Cliftonville,8696,6,12,7,11,46,42,4,43
Dungannon,8696,7,11,9,10,48,39,9,42
Portadown,8696,8,10,5,15,25,40,-15,35
Ards,8696,9,9,5,16,42,50,-8,32
Glentoran,8696,10,7,8,15,26,43,-17,29
Ballinamalla,8696,11,7,4,19,25,52,-27,25
Linfield,8697,1,17,7,6,63,22,41,58
Cliftonville,8697,2,17,7,6,54,34,20,58
Crusaders,8697,3,16,9,5,54,32,22,57
Coleraine,8697,4,13,10,7,40,34,6,49
Ballymena,8697,5,13,4,13,57,66,-9,43
Glenavon,8697,6,11,9,10,46,47,-1,42
Dungannon,8697,7,9,8,13,46,46,0,35
Ballinamalla,8697,8,9,4,17,32,50,-18,31
Glentoran,8697,9,9,4,17,28,50,-22,31
Ards,8697,10,8,4,18,34,52,-18,28
Portadown,8697,11,8,4,18,29,50,-21,28
Crusaders,8698,1,17,6,7,50,28,22,57
Linfield,8698,2,15,10,5,57,29,28,55
Coleraine,8698,3,13,10,7,48,35,13,49
Cliftonville,8698,4,14,4,12,42,39,3,46
Ballymena,8698,5,13,5,12,52,63,-11,44
Dungannon,8698,6,10,12,8,49,41,8,42
Glenavon,8698,7,11,8,11,40,42,-2,41
Portadown,8698,8,11,4,15,30,35,-5,37
Ards,8698,9,9,5,16,39,52,-13,32
Glentoran,8698,10,8,5,17,30,49,-19,29
Ballinamalla,8698,11,7,5,18,27,51,-24,26
Crusaders,8699,1,16,8,6,57,35,22,56
Cliftonville,8699,2,16,7,7,63,41,22,55
Linfield,8699,3,15,8,7,57,29,28,53
Coleraine,8699,4,13,9,8,44,33,11,48
Ballymena,8699,5,13,5,12,57,55,2,44
Glenavon,8699,6,11,9,10,39,48,-9,42
Glentoran,8699,7,11,6,13,33,41,-8,39
Dungannon,8699,8,9,9,12,47,49,-2,36
Ards,8699,9,8,7,15,37,56,-19,31
Portadown,8699,10,8,5,17,31,52,-21,29
Ballinamalla,8699,11,7,3,20,26,52,-26,24
Crusaders,8700,1,17,9,4,58,30,28,60
Ballymena,8700,2,17,5,8,66,54,12,56
Linfield,8700,3,14,8,8,57,40,17,50
Cliftonville,8700,4,15,5,10,50,39,11,50
Coleraine,8700,5,13,10,7,45,35,10,49
Glenavon,8700,6,10,14,6,50,47,3,44
Dungannon,8700,7,7,11,12,41,42,-1,32
Glentoran,8700,8,8,8,14,29,43,-14,32
Ballinamalla,8700,9,9,4,17,28,49,-21,31
Portadown,8700,10,8,5,17,28,49,-21,29
Ards,8700,11,5,5,20,28,52,-24,20
Linfield,8701,1,16,7,7,58,35,23,55
Crusaders,8701,2,16,6,8,57,38,19,54
Ballymena,8701,3,15,8,7,57,54,3,53
Cliftonville,8701,4,15,5,10,50,37,13,50
Coleraine,8701,5,10,12,8,42,39,3,42
Dungannon,8701,6,11,8,11,49,42,7,41
Ards,8701,7,12,3,15,44,45,-1,39
Glenavon,8701,8,9,12,9,44,46,-2,39
Glentoran,8701,9,8,8,14,32,45,-13,32
Ballinamalla,8701,10,8,4,18,30,56,-26,28
Portadown,8701,11,7,3,20,24,50,-26,24
Crusaders,8702,1,19,7,4,54,27,27,64
Linfield,8702,2,14,10,6,57,28,29,52
Cliftonville,8702,3,15,6,9,54,37,17,51
Ballymena,8702,4,13,5,12,65,70,-5,44
Coleraine,8702,5,12,7,11,36,40,-4,43
Glenavon,8702,6,10,10,10,43,45,-2,40
Dungannon,8702,7,10,9,11,51,43,8,39
Ballinamalla,8702,8,9,5,16,29,53,-24,32
Ards,8702,9,8,7,15,37,49,-12,31
Glentoran,8702,10,7,9,14,31,46,-15,30
Portadown,8702,11,6,9,15,25,44,-19,27
Crusaders,8703,1,15,9,6,54,34,20,54
Cliftonville,8703,2,15,8,7,54,32,22,53
Linfield,8703,3,13,9,8,56,35,21,48
Ballymena,8703,4,13,9,8,60,56,4,48
Glenavon,8703,5,12,10,8,53,49,4,46
Coleraine,8703,6,11,12,7,46,39,7,45
Dungannon,8703,7,10,8,12,50,53,-3,38
Glentoran,8703,8,9,6,15,34,50,-16,33
Ballinamalla,8703,9,9,5,16,36,53,-17,32
Ards,8703,10,7,8,15,35,49,-14,29
Portadown,8703,11,7,4,19,25,53,-28,25
Ballymena,8704,1,16,7,7,66,56,10,55
Cliftonville,8704,2,16,4,10,53,38,15,52
Linfield,8704,3,14,9,7,55,34,21,51
Crusaders,8704,4,14,8,8,52,37,15,50
Glenavon,8704,5,11,11,8,43,39,4,44
Coleraine,8704,6,10,10,10,40,40,0,40
Dungannon,8704,7,10,8,12,50,46,4,38
Ards,8704,8,10,6,14,41,50,-9,36
Ballinamalla,8704,9,8,6,16,29,47,-18,30
Portadown,8704,10,7,7,16,26,47,-21,28
Glentoran,8704,11,6,10,14,23,44,-21,28
Linfield,8705,1,17,8,5,65,27,38,59
Glenavon,8705,2,15,8,7,63,42,21,53
Crusaders,8705,3,16,4,10,57,40,17,52
Cliftonville,8705,4,14,5,11,51,42,9,47
Ballymena,8705,5,14,4,12,58,60,-2,46
Glentoran,8705,6,12,6,12,40,43,-3,42
Coleraine,8705,7,11,7,12,43,48,-5,40
Dungannon,8705,8,9,7,14,52,61,-9,34
Ballinamalla,8705,9,10,3,17,37,55,-18,33
Portadown,8705,10,8,7,15,28,52,-24,31
Ards,8705,11,8,3,19,29,53,-24,27
Linfield,8706,1,16,11,3,55,23,32,59
Crusaders,8706,2,16,8,6,54,34,20,56
Ballymena,8706,3,15,5,10,60,55,5,50
Cliftonville,8706,4,14,7,9,55,39,16,49
Coleraine,8706,5,10,12,8,45,42,3,42
Glenavon,8706,6,11,9,10,50,50,0,42
Dungannon,8706,7,10,10,10,48,43,5,40
Ards,8706,8,10,8,12,42,49,-7,38
Glentoran,8706,9,7,7,16,28,42,-14,28
Ballinamalla,8706,10,6,6,18,30,59,-29,24
Portadown,8706,11,6,5,19,23,54,-31,23
Crusaders,8707,1,17,8,5,61,35,26,59
Linfield,8707,2,15,9,6,61,35,26,54
Cliftonville,8707,3,15,6,9,54,40,14,51
Coleraine,8707,4,12,8,10,42,42,0,44
Ballymena,8707,5,12,7,11,52,56,-4,43
Glentoran,8707,6,11,7,12,32,40,-8,40
Glenavon,8707,7,10,9,11,47,47,0,39
Ballinamalla,8707,8,10,5,15,35,51,-16,35
Ards,8707,9,9,4,17,38,53,-15,31
Dungannon,8707,10,6,12,12,47,48,-1,30
Portadown,8707,11,9,3,18,28,50,-22,30
Crusaders,8708,1,19,6,5,57,28,29,63
Linfield,8708,2,14,10,6,60,30,30,52
Cliftonville,8708,3,15,7,8,55,40,15,52
Ballymena,8708,4,13,8,9,62,62,0,47
Coleraine,8708,5,12,9,9,50,40,10,45
Ards,8708,6,12,4,14,38,42,-4,40
Glentoran,8708,7,11,7,12,30,39,-9,40
Glenavon,8708,8,10,8,12,42,46,-4,38
Dungannon,8708,9,6,11,13,40,50,-10,29
Ballinamalla,8708,10,8,4,18,25,49,-24,28
Portadown,8708,11,5,6,19,18,51,-33,21
Crusaders,8709,1,15,7,8,54,37,17,52
Cliftonville,8709,2,15,5,10,56,42,14,50
Linfield,8709,3,12,11,7,50,31,19,47
Glenavon,8709,4,12,11,7,54,43,11,47
Ballymena,8709,5,12,9,9,54,57,-3,45
Coleraine,8709,6,11,10,9,42,41,1,43
Dungannon,8709,7,9,10,11,48,44,4,37
Glentoran,8709,8,7,13,10,31,40,-9,34
Ards,8709,9,8,7,15,38,51,-13,31
Portadown,8709,10,8,7,15,27,45,-18,31
Ballinamalla,8709,11,8,6,16,30,53,-23,30
Crusaders,8710,1,16,6,8,53,41,12,54
Linfield,8710,2,14,11,5,61,33,28,53
Ballymena,8710,3,13,8,9,57,55,2,47
Cliftonville,8710,4,13,7,10,51,42,9,46
Dungannon,8710,5,12,7,11,53,46,7,43
Glentoran,8710,6,11,9,10,38,40,-2,42
Glenavon,8710,7,9,10,11,46,47,-1,37
Coleraine,8710,8,9,9,12,38,41,-3,36
Ards,8710,9,10,6,14,41,52,-11,36
Ballinamalla,8710,10,11,1,18,39,59,-20,34
Portadown,8710,11,7,6,17,25,46,-21,27
Crusaders,8711,1,19,9,2,58,29,29,66
Linfield,8711,2,15,11,4,66,30,36,56
Cliftonville,8711,3,15,4,11,44,37,7,49
Ballymena,8711,4,13,7,10,51,54,-3,46
Dungannon,8711,5,12,9,9,52,36,16,45
Glenavon,8711,6,10,11,9,46,50,-4,41
Coleraine,8711,7,9,11,10,38,40,-2,38
Ballinamalla,8711,8,9,5,16,33,53,-20,32
Ards,8711,9,8,7,15,34,48,-14,31
Glentoran,8711,10,5,9,16,29,50,-21,24
Portadown,8711,11,6,5,19,21,45,-24,23
Crusaders,8712,1,16,6,8,61,38,23,54
Linfield,8712,2,14,11,5,60,25,35,53
Coleraine,8712,3,12,13,5,45,36,9,49
Ballymena,8712,4,11,12,7,59,55,4,45
Cliftonville,8712,5,12,6,12,48,47,1,42
Dungannon,8712,6,10,9,11,48,41,7,39
Ards,8712,7,11,6,13,40,44,-4,39
Glenavon,8712,8,9,12,9,45,51,-6,39
Portadown,8712,9,9,4,17,25,47,-22,31
Glentoran,8712,10,7,9,14,26,48,-22,30
Ballinamalla,8712,11,7,6,17,30,55,-25,27
Crusaders,8713,1,19,7,4,56,30,26,64
Ballymena,8713,2,16,6,8,66,58,8,54
Linfield,8713,3,14,9,7,53,30,23,51
Glenavon,8713,4,13,10,7,54,45,9,49
Coleraine,8713,5,10,11,9,41,37,4,41
Dungannon,8713,6,10,10,10,53,44,9,40
Cliftonville,8713,7,11,7,12,50,46,4,40
Ards,8713,8,8,7,15,35,49,-14,31
Glentoran,8713,9,8,7,15,29,44,-15,31
Ballinamalla,8713,10,9,4,17,35,59,-24,31
Portadown,8713,11,5,6,19,27,57,-30,21
Crusaders,8714,1,17,8,5,61,30,31,59
Linfield,8714,2,13,11,6,56,34,22,50
Cliftonville,8714,3,14,7,9,49,37,12,49
Coleraine,8714,4,13,10,7,42,34,8,49
Ballymena,8714,5,13,4,13,56,70,-14,43
Dungannon,8714,6,10,11,9,54,41,13,41
Portadown,8714,7,10,6,14,30,42,-12,36
Glenavon,8714,8,8,11,11,42,50,-8,35
Glentoran,8714,9,8,8,14,31,47,-16,32
Ballinamalla,8714,10,9,3,18,34,53,-19,30
Ards,8714,11,8,5,17,35,52,-17,29
Crusaders,8715,1,17,7,6,58,29,29,58
Cliftonville,8715,2,16,5,9,59,42,17,53
Dungannon,8715,3,13,9,8,55,39,16,48
Ballymena,8715,4,14,6,10,57,60,-3,48
Glenavon,8715,5,12,10,8,46,42,4,46
Linfield,8715,6,12,9,9,55,32,23,45
Coleraine,8715,7,10,10,10,43,43,0,40
Ards,8715,8,12,4,14,42,54,-12,40
Glentoran,8715,9,7,12,11,28,45,-17,33
Portadown,8715,10,6,4,20,28,54,-26,22
Ballinamalla,8715,11,6,4,20,29,60,-31,22
Cliftonville,8716,1,20,2,8,61,33,28,62
Crusaders,8716,2,17,7,6,60,40,20,58
Linfield,8716,3,14,10,6,63,37,26,52
Ballymena,8716,4,15,4,11,61,59,2,49
Coleraine,8716,5,12,8,10,39,40,-1,44
Glenavon,8716,6,9,12,9,53,52,1,39
Dungannon,8716,7,9,11,10,47,45,2,38
Portadown,8716,8,8,7,15,30,44,-14,31
Ards,8716,9,9,4,17,31,47,-16,31
Glentoran,8716,10,8,6,16,30,50,-20,30
Ballinamalla,8716,11,5,7,18,30,58,-28,22
Crusaders,8717,1,19,6,5,63,32,31,63
Ballymena,8717,2,14,7,9,62,58,4,49
Cliftonville,8717,3,14,5,11,52,49,3,47
Glenavon,8717,4,11,12,7,50,46,4,45
Coleraine,8717,5,11,10,9,44,37,7,43
Dungannon,8717,6,11,10,9,52,47,5,43
Linfield,8717,7,10,10,10,56,43,13,40
Ballinamalla,8717,8,9,5,16,31,48,-17,32
Portadown,8717,9,8,7,15,31,52,-21,31
Glentoran,8717,10,7,9,14,28,44,-16,30
Ards,8717,11,8,5,17,37,50,-13,29
Crusaders,8718,1,18,8,4,64,31,33,62
Linfield,8718,2,14,10,6,54,29,25,52
Cliftonville,8718,3,14,7,9,54,41,13,49
Coleraine,8718,4,11,12,7,39,33,6,45
Ballymena,8718,5,12,7,11,53,60,-7,43
Dungannon,8718,6,11,9,10,48,46,2,42
Glenavon,8718,7,11,8,11,50,46,4,41
Ards,8718,8,10,5,15,36,47,-11,35
Ballinamalla,8718,9,11,1,18,31,54,-23,34
Portadown,8718,10,7,6,17,27,48,-21,27
Glentoran,8718,11,6,7,17,29,50,-21,25
Crusaders,8719,1,17,7,6,58,37,21,58
Cliftonville,8719,2,16,8,6,56,36,20,56
Linfield,8719,3,14,8,8,57,29,28,50
Glenavon,8719,4,11,12,7,47,44,3,45
Ballymena,8719,5,12,8,10,56,58,-2,44
Dungannon,8719,6,11,8,11,51,49,2,41
Coleraine,8719,7,10,10,10,40,41,-1,40
Portadown,8719,8,10,5,15,28,42,-14,35
Ards,8719,9,9,6,15,40,47,-7,33
Glentoran,8719,10,8,8,14,27,42,-15,32
Ballinamalla,8719,11,5,4,21,25,60,-35,19
Crusaders,8720,1,18,7,5,54,28,26,61
Ballymena,8720,2,18,5,7,69,51,18,59
Glenavon,8720,3,16,10,4,60,36,24,58
Linfield,8720,4,14,9,7,59,35,24,51
Cliftonville,8720,5,15,5,10,52,37,15,50
Coleraine,8720,6,9,11,10,44,44,0,38
Dungannon,8720,7,10,8,12,49,56,-7,38
Glentoran,8720,8,9,6,15,34,50,-16,33
Portadown,8720,9,8,3,19,22,45,-23,27
Ards,8720,10,6,5,19,31,57,-26,23
Ballinamalla,8720,11,4,7,19,27,62,-35,19
Crusaders,8721,1,16,8,6,57,37,20,56
Linfield,8721,2,15,8,7,60,35,25,53
Cliftonville,8721,3,15,8,7,59,39,20,53
Ballymena,8721,4,13,7,10,60,57,3,46
Glenavon,8721,5,9,15,6,52,41,11,42
Coleraine,8721,6,9,14,7,43,43,0,41
Ards,8721,7,10,8,12,42,44,-2,38
Glentoran,8721,8,8,8,14,33,52,-19,32
Portadown,8721,9,8,7,15,26,50,-24,31
Dungannon,8721,10,6,11,13,41,44,-3,29
Ballinamalla,8721,11,5,8,17,29,60,-31,23
Coleraine,8722,1,15,10,5,47,31,16,55
Ballymena,8722,2,16,6,8,60,55,5,54
Cliftonville,8722,3,14,7,9,59,43,16,49
Crusaders,8722,4,14,7,9,53,42,11,49
Linfield,8722,5,12,9,9,52,37,15,45
Glenavon,8722,6,11,11,8,44,39,5,44
Glentoran,8722,7,12,7,11,32,39,-7,43
Dungannon,8722,8,8,11,11,53,47,6,35
Ballinamalla,8722,9,9,3,18,26,47,-21,30
Portadown,8722,10,6,9,15,31,53,-22,27
Ards,8722,11,6,4,20,31,55,-24,22
Crusaders,8723,1,16,7,7,58,40,18,55
Linfield,8723,2,15,9,6,62,33,29,54
Cliftonville,8723,3,16,4,10,57,40,17,52
Ballymena,8723,4,13,8,9,63,60,3,47
Coleraine,8723,5,11,10,9,40,34,6,43
Dungannon,8723,6,10,10,10,50,43,7,40
Glenavon,8723,7,10,9,11,47,49,-2,39
Glentoran,8723,8,9,7,14,34,46,-12,34
Ards,8723,9,9,4,17,34,54,-20,31
Portadown,8723,10,9,4,17,19,46,-27,31
Ballinamalla,8723,11,8,6,16,33,52,-19,30
Crusaders,8724,1,19,5,6,63,34,29,62
Linfield,8724,2,13,11,6,59,36,23,50
Ballymena,8724,3,13,8,9,57,57,0,47
Glenavon,8724,4,11,11,8,39,37,2,44
Cliftonville,8724,5,12,6,12,45,43,2,42
Coleraine,8724,6,10,11,9,38,34,4,41
Glentoran,8724,7,10,8,12,32,44,-12,38
Dungannon,8724,8,9,8,13,44,44,0,35
Portadown,8724,9,9,8,13,29,41,-12,35
Ballinamalla,8724,10,9,5,16,31,48,-17,32
Ards,8724,11,7,5,18,31,50,-19,26
Crusaders,8725,1,15,9,6,58,43,15,54
Cliftonville,8725,2,16,4,10,58,40,18,52
Ballymena,8725,3,14,7,9,52,50,2,49
Dungannon,8725,4,12,9,9,52,39,13,45
Linfield,8725,5,12,8,10,59,41,18,44
Glenavon,8725,6,9,16,5,45,38,7,43
Coleraine,8725,7,10,11,9,41,44,-3,41
Glentoran,8725,8,10,8,12,40,48,-8,38
Ballinamalla,8725,9,11,5,14,42,53,-11,38
Portadown,8725,10,7,5,18,25,52,-27,26
Ards,8725,11,5,6,19,35,59,-24,21
Cliftonville,8726,1,15,6,9,54,37,17,51
Crusaders,8726,2,14,8,8,56,38,18,50
Linfield,8726,3,13,10,7,61,40,21,49
Glenavon,8726,4,13,10,7,54,42,12,49
Ballymena,8726,5,14,7,9,53,50,3,49
Coleraine,8726,6,11,13,6,48,40,8,46
Glentoran,8726,7,13,6,11,33,40,-7,45
Ballinamalla,8726,8,11,5,14,34,50,-16,38
Dungannon,8726,9,7,9,14,40,43,-3,30
Portadown,8726,10,6,8,16,22,46,-24,26
Ards,8726,11,5,4,21,29,58,-29,19
Cliftonville,8727,1,17,6,7,62,39,23,57
Ballymena,8727,2,16,6,8,64,53,11,54
Linfield,8727,3,14,10,6,62,35,27,52
Crusaders,8727,4,14,7,9,48,36,12,49
Glenavon,8727,5,12,11,7,48,40,8,47
Coleraine,8727,6,10,15,5,38,30,8,45
Dungannon,8727,7,7,15,8,43,42,1,36
Glentoran,8727,8,8,10,12,30,45,-15,34
Portadown,8727,9,6,7,17,28,51,-23,25
Ards,8727,10,6,6,18,32,52,-20,24
Ballinamalla,8727,11,6,5,19,26,58,-32,23
Cliftonville,8728,1,15,7,8,51,34,17,52
Glenavon,8728,2,13,12,5,49,39,10,51
Linfield,8728,3,13,11,6,58,32,26,50
Ballymena,8728,4,13,9,8,61,61,0,48
Crusaders,8728,5,12,8,10,48,42,6,44
Coleraine,8728,6,9,11,10,36,36,0,38
Dungannon,8728,7,9,10,11,50,48,2,37
Glentoran,8728,8,8,10,12,25,35,-10,34
Ards,8728,9,9,4,17,40,52,-12,31
Portadown,8728,10,7,10,13,28,46,-18,31
Ballinamalla,8728,11,8,6,16,29,50,-21,30
Crusaders,8729,1,17,6,7,55,31,24,57
Linfield,8729,2,14,10,6,57,30,27,52
Cliftonville,8729,3,15,4,11,56,44,12,49
Ballymena,8729,4,14,5,11,54,56,-2,47
Dungannon,8729,5,12,9,9,54,44,10,45
Coleraine,8729,6,12,9,9,45,42,3,45
Glenavon,8729,7,10,10,10,43,43,0,40
Ards,8729,8,9,8,13,40,45,-5,35
Portadown,8729,9,9,5,16,29,48,-19,32
Glentoran,8729,10,8,6,16,29,52,-23,30
Ballinamalla,8729,11,7,4,19,30,57,-27,25
Crusaders,8730,1,15,9,6,54,34,20,54
Coleraine,8730,2,15,9,6,54,37,17,54
Linfield,8730,3,14,10,6,66,40,26,52
Cliftonville,8730,4,15,5,10,54,44,10,50
Glenavon,8730,5,12,9,9,44,46,-2,45
Ballymena,8730,6,13,5,12,62,62,0,44
Dungannon,8730,7,8,12,10,53,48,5,36
Glentoran,8730,8,8,9,13,30,45,-15,33
Portadown,8730,9,8,5,17,23,48,-25,29
Ards,8730,10,8,4,18,37,54,-17,28
Ballinamalla,8730,11,7,7,16,29,48,-19,28
Crusaders,8731,1,20,5,5,64,29,35,65
Linfield,8731,2,17,7,6,65,32,33,58
Cliftonville,8731,3,15,7,8,50,35,15,52
Glenavon,8731,4,13,10,7,50,43,7,49
Ballymena,8731,5,15,3,12,62,62,0,48
Coleraine,8731,6,9,11,10,37,40,-3,38
Dungannon,8731,7,10,6,14,49,45,4,36
Glentoran,8731,8,8,7,15,30,47,-17,31
Portadown,8731,9,8,6,16,28,51,-23,30
Ards,8731,10,8,4,18,34,58,-24,28
Ballinamalla,8731,11,7,4,19,27,54,-27,25
Linfield,8732,1,15,8,7,66,34,32,53
Crusaders,8732,2,15,7,8,52,40,12,52
Cliftonville,8732,3,15,4,11,59,42,17,49
Glenavon,8732,4,13,10,7,46,45,1,49
Coleraine,8732,5,12,10,8,44,31,13,46
Ballymena,8732,6,13,7,10,62,63,-1,46
Ards,8732,7,10,7,13,41,48,-7,37
Dungannon,8732,8,8,10,12,49,50,-1,34
Glentoran,8732,9,8,10,12,29,42,-13,34
Ballinamalla,8732,10,7,6,17,24,46,-22,27
Portadown,8732,11,7,5,18,26,57,-31,26
Crusaders,8733,1,16,6,8,50,37,13,54
Linfield,8733,2,12,10,8,47,32,15,46
Cliftonville,8733,3,14,4,12,47,38,9,46
Glenavon,8733,4,12,9,9,44,40,4,45
Coleraine,8733,5,12,9,9,38,35,3,45
Ballymena,8733,6,13,5,12,48,54,-6,44
Ards,8733,7,13,4,13,43,41,2,43
Dungannon,8733,8,10,10,10,50,44,6,40
Portadown,8733,9,9,8,13,26,37,-11,35
Ballinamalla,8733,10,9,3,18,32,50,-18,30
Glentoran,8733,11,6,10,14,28,45,-17,28
Cliftonville,8734,1,14,7,9,50,36,14,49
Crusaders,8734,2,14,7,9,52,42,10,49
Ballymena,8734,3,14,6,10,56,55,1,48
Coleraine,8734,4,13,9,8,39,39,0,48
Linfield,8734,5,11,13,6,51,30,21,46
Dungannon,8734,6,11,9,10,53,43,10,42
Glenavon,8734,7,9,12,9,48,53,-5,39
Glentoran,8734,8,10,7,13,33,40,-7,37
Ards,8734,9,9,7,14,44,44,0,34
Ballinamalla,8734,10,9,4,17,30,52,-22,31
Portadown,8734,11,7,7,16,25,47,-22,28
Crusaders,8735,1,17,8,5,58,34,24,59
Cliftonville,8735,2,17,6,7,53,31,22,57
Linfield,8735,3,15,8,7,60,34,26,53
Glenavon,8735,4,13,9,8,54,46,8,48
Ballymena,8735,5,13,6,11,62,66,-4,45
Coleraine,8735,6,10,10,10,35,37,-2,40
Glentoran,8735,7,11,7,12,37,43,-6,40
Dungannon,8735,8,9,11,10,51,42,9,38
Ards,8735,9,8,5,17,42,56,-14,29
Ballinamalla,8735,10,7,4,19,24,59,-35,25
Portadown,8735,11,6,4,20,25,53,-28,22
Crusaders,8736,1,17,5,8,58,38,20,56
Cliftonville,8736,2,14,9,7,52,38,14,51
Glenavon,8736,3,13,11,6,57,42,15,50
Linfield,8736,4,14,7,9,58,34,24,49
Ballymena,8736,5,12,10,8,53,57,-4,46
Coleraine,8736,6,11,8,11,46,44,2,41
Dungannon,8736,7,8,15,7,46,42,4,39
Glentoran,8736,8,10,7,13,29,40,-11,37
Ards,8736,9,9,6,15,37,48,-11,33
Ballinamalla,8736,10,8,5,17,31,54,-23,29
Portadown,8736,11,4,7,19,18,48,-30,19
Crusaders,8737,1,18,6,6,59,33,26,60
Cliftonville,8737,2,15,7,8,53,40,13,52
Glenavon,8737,3,12,11,7,47,39,8,47
Coleraine,8737,4,12,10,8,40,37,3,46
Ballymena,8737,5,13,7,10,55,55,0,46
Linfield,8737,6,11,12,7,49,31,18,45
Dungannon,8737,7,10,9,11,45,42,3,39
Ards,8737,8,9,4,17,35,46,-11,31
Glentoran,8737,9,7,8,15,28,47,-19,29
Portadown,8737,10,6,10,14,25,44,-19,28
Ballinamalla,8737,11,8,4,18,34,56,-22,28
Crusaders,8738,1,16,7,7,53,36,17,55
Ballymena,8738,2,15,7,8,61,58,3,52
Linfield,8738,3,13,10,7,59,37,22,49
Glenavon,8738,4,12,10,8,53,48,5,46
Coleraine,8738,5,11,12,7,46,37,9,45
Dungannon,8738,6,12,8,10,56,41,15,44
Cliftonville,8738,7,12,4,14,45,45,0,40
Portadown,8738,8,10,7,13,31,43,-12,37
Ards,8738,9,10,3,17,40,54,-14,33
Glentoran,8738,10,7,8,15,24,41,-17,29
Ballinamalla,8738,11,7,4,19,22,50,-28,25
Crusaders,8739,1,16,9,5,54,28,26,57
Linfield,8739,2,15,10,5,62,34,28,55
Cliftonville,8739,3,17,4,9,54,36,18,55
Ballymena,8739,4,13,8,9,57,54,3,47
Dungannon,8739,5,12,9,9,52,40,12,45
Coleraine,8739,6,12,9,9,44,42,2,45
Glenavon,8739,7,11,9,10,47,45,2,42
Ards,8739,8,12,3,15,39,44,-5,39
Ballinamalla,8739,9,8,6,16,30,50,-20,30
Glentoran,8739,10,5,8,17,21,49,-28,23
Portadown,8739,11,4,5,21,21,59,-38,17
Crusaders,8740,1,16,9,5,55,33,22,57
Ballymena,8740,2,16,3,11,70,61,9,51
Cliftonville,8740,3,15,5,10,47,38,9,50
Linfield,8740,4,13,10,7,62,41,21,49
Glenavon,8740,5,11,10,9,52,48,4,43
Dungannon,8740,6,10,10,10,51,49,2,40
Glentoran,8740,7,9,12,9,38,38,0,39
Portadown,8740,8,10,5,15,29,44,-15,35
Coleraine,8740,9,8,10,12,34,41,-7,34
Ballinamalla,8740,10,6,9,15,26,48,-22,27
Ards,8740,11,7,5,18,31,54,-23,26
Crusaders,8741,1,16,6,8,51,35,16,54
Glenavon,8741,2,14,10,6,51,40,11,52
Ballymena,8741,3,14,9,7,62,52,10,51
Cliftonville,8741,4,14,7,9,49,38,11,49
Linfield,8741,5,12,12,6,53,30,23,48
Coleraine,8741,6,11,9,10,48,45,3,42
Dungannon,8741,7,9,10,11,48,42,6,37
Ballinamalla,8741,8,9,6,15,30,48,-18,33
Ards,8741,9,7,10,13,37,49,-12,31
Glentoran,8741,10,6,8,16,27,53,-26,26
Portadown,8741,11,6,7,17,22,46,-24,25
Cliftonville,8742,1,19,2,9,52,38,14,59
Crusaders,8742,2,17,7,6,51,28,23,58
Ballymena,8742,3,16,7,7,60,50,10,55
Linfield,8742,4,15,8,7,56,32,24,53
Coleraine,8742,5,11,13,6,40,27,13,46
Glenavon,8742,6,11,10,9,44,42,2,43
Dungannon,8742,7,10,9,11,40,36,4,39
Glentoran,8742,8,8,6,16,26,43,-17,30
Ards,8742,9,7,5,18,36,52,-16,26
Portadown,8742,10,6,7,17,28,49,-21,25
Ballinamalla,8742,11,6,4,20,26,62,-36,22
Crusaders,8743,1,21,5,4,54,26,28,68
Linfield,8743,2,14,9,7,61,37,24,51
Cliftonville,8743,3,15,4,11,56,47,9,49
Coleraine,8743,4,13,8,9,46,38,8,47
Glenavon,8743,5,12,8,10,49,46,3,44
Dungannon,8743,6,11,8,11,58,45,13,41
Ballymena,8743,7,11,7,12,51,65,-14,40
Glentoran,8743,8,9,8,13,31,44,-13,35
Ards,8743,9,7,8,15,35,49,-14,29
Ballinamalla,8743,10,7,6,17,32,55,-23,27
Portadown,8743,11,7,5,18,28,49,-21,26
Crusaders,8744,1,17,7,6,57,31,26,58
Linfield,8744,2,16,9,5,60,29,31,57
Cliftonville,8744,3,17,5,8,52,35,17,56
Ballymena,8744,4,13,8,9,51,48,3,47
Coleraine,8744,5,11,10,9,44,39,5,43
Glenavon,8744,6,10,8,12,54,60,-6,38
Dungannon,8744,7,10,7,13,55,48,7,37
Glentoran,8744,8,10,7,13,35,45,-10,37
Ards,8744,9,10,3,17,39,54,-15,33
Ballinamalla,8744,10,9,5,16,27,47,-20,32
Portadown,8744,11,5,5,20,21,59,-38,20
Crusaders,8745,1,17,9,4,62,35,27,60
Ballymena,8745,2,17,3,10,67,57,10,54
Linfield,8745,3,13,9,8,58,36,22,48
Cliftonville,8745,4,13,6,11,52,48,4,45
Glenavon,8745,5,11,10,9,47,46,1,43
Dungannon,8745,6,10,7,13,43,42,1,37
Coleraine,8745,7,9,10,11,38,49,-11,37
Ards,8745,8,11,3,16,40,49,-9,36
Ballinamalla,8745,9,11,3,16,40,50,-10,36
Glentoran,8745,10,9,7,14,30,45,-15,34
Portadown,8745,11,7,7,16,27,47,-20,28
Crusaders,8746,1,22,5,3,70,29,41,71
Coleraine,8746,2,14,9,7,43,31,12,51
Cliftonville,8746,3,16,3,11,53,44,9,51
Linfield,8746,4,14,8,8,68,39,29,50
Ballymena,8746,5,15,5,10,62,51,11,50
Glenavon,8746,6,12,7,11,48,52,-4,43
Dungannon,8746,7,10,6,14,48,50,-2,36
Ards,8746,8,9,6,15,37,47,-10,33
Ballinamalla,8746,9,8,4,18,33,55,-22,28
Glentoran,8746,10,7,6,17,25,58,-33,27
Portadown,8746,11,6,5,19,28,59,-31,23
Crusaders,8747,1,17,10,3,51,25,26,61
Linfield,8747,2,14,11,5,60,33,27,53
Ballymena,8747,3,14,6,10,62,62,0,48
Cliftonville,8747,4,14,5,11,49,42,7,47
Glenavon,8747,5,12,11,7,53,47,6,47
Coleraine,8747,6,9,10,11,36,39,-3,37
Dungannon,8747,7,9,10,11,51,55,-4,37
Portadown,8747,8,8,8,14,36,48,-12,32
Ards,8747,9,8,7,15,36,49,-13,31
Glentoran,8747,10,7,8,15,23,37,-14,29
Ballinamalla,8747,11,7,6,17,37,57,-20,27
Cliftonville,8748,1,20,3,7,61,36,25,63
Linfield,8748,2,15,10,5,58,27,31,55
Glenavon,8748,3,15,9,6,61,41,20,54
Crusaders,8748,4,14,7,9,47,35,12,49
Ballymena,8748,5,12,6,12,50,57,-7,42
Coleraine,8748,6,10,9,11,36,39,-3,39
Dungannon,8748,7,10,8,12,47,47,0,38
Ards,8748,8,10,5,15,36,51,-15,35
Portadown,8748,9,9,5,16,25,43,-18,32
Ballinamalla,8748,10,8,5,17,32,52,-20,29
Glentoran,8748,11,4,9,17,26,51,-25,21
Linfield,8749,1,15,8,7,60,30,30,53
Crusaders,8749,2,15,8,7,58,47,11,53
Glenavon,8749,3,13,9,8,44,39,5,48
Ballymena,8749,4,14,6,10,61,61,0,48
Coleraine,8749,5,11,11,8,45,36,9,44
Dungannon,8749,6,12,7,11,50,41,9,43
Cliftonville,8749,7,13,4,13,48,47,1,43
Ards,8749,8,9,6,15,40,51,-11,33
Glentoran,8749,9,9,5,16,34,52,-18,32
Portadown,8749,10,9,5,16,24,42,-18,32
Ballinamalla,8749,11,10,1,19,33,51,-18,31
Linfield,8750,1,18,8,4,62,23,39,62
Crusaders,8750,2,17,6,7,53,30,23,57
Cliftonville,8750,3,14,6,10,51,44,7,48
Glenavon,8750,4,12,10,8,48,42,6,46
Coleraine,8750,5,11,12,7,44,36,8,45
Ballymena,8750,6,12,9,9,60,57,3,45
Ards,8750,7,10,6,14,45,50,-5,36
Dungannon,8750,8,8,11,11,46,46,0,35
Glentoran,8750,9,8,9,13,27,42,-15,33
Ballinamalla,8750,10,6,4,20,27,60,-33,22
Portadown,8750,11,4,9,17,21,54,-33,21
Linfield,8751,1,15,8,7,58,29,29,53
Crusaders,8751,2,14,11,5,51,35,16,53
Cliftonville,8751,3,15,6,9,52,37,15,51
Glenavon,8751,4,13,11,6,48,36,12,50
Ballymena,8751,5,14,7,9,57,55,2,49
Dungannon,8751,6,11,8,11,55,43,12,41
Coleraine,8751,7,9,13,8,40,36,4,40
Glentoran,8751,8,8,9,13,26,47,-21,33
Ards,8751,9,8,4,18,36,51,-15,28
Ballinamalla,8751,10,7,6,17,24,56,-32,27
Portadown,8751,11,7,5,18,23,45,-22,26
Cliftonville,8752,1,18,4,8,50,32,18,58
Linfield,8752,2,14,10,6,52,31,21,52
Crusaders,8752,3,14,8,8,56,38,18,50
Ballymena,8752,4,15,4,11,63,58,5,49
Glenavon,8752,5,11,12,7,51,42,9,45
Dungannon,8752,6,10,11,9,46,41,5,41
Coleraine,8752,7,9,10,11,39,42,-3,37
Ards,8752,8,9,8,13,36,43,-7,35
Portadown,8752,9,7,9,14,23,40,-17,30
Ballinamalla,8752,10,7,6,17,28,54,-26,27
Glentoran,8752,11,6,8,16,24,47,-23,26
Crusaders,8753,1,15,9,6,52,36,16,54
Cliftonville,8753,2,16,5,9,61,43,18,53
Ballymena,8753,3,15,5,10,60,53,7,50
Glenavon,8753,4,12,12,6,45,39,6,48
Linfield,8753,5,12,9,9,52,35,17,45
Coleraine,8753,6,12,9,9,43,38,5,45
Dungannon,8753,7,10,9,11,50,42,8,39
Ards,8753,8,10,6,14,39,45,-6,36
Glentoran,8753,9,9,7,14,28,46,-18,34
Ballinamalla,8753,10,7,5,18,30,51,-21,26
Portadown,8753,11,6,6,18,24,56,-32,24
Crusaders,8754,1,16,7,7,54,35,19,55
Ballymena,8754,2,16,5,9,58,52,6,53
Linfield,8754,3,14,9,7,61,39,22,51
Coleraine,8754,4,13,9,8,42,34,8,48
Glenavon,8754,5,10,14,6,50,45,5,44
Cliftonville,8754,6,12,7,11,50,40,10,43
Dungannon,8754,7,10,8,12,47,41,6,38
Glentoran,8754,8,9,7,14,29,43,-14,34
Ballinamalla,8754,9,8,8,14,27,46,-19,32
Ards,8754,10,8,7,15,40,52,-12,31
Portadown,8754,11,4,9,17,25,56,-31,21
Linfield,8755,1,18,9,3,69,27,42,63
Crusaders,8755,2,17,9,4,55,30,25,60
Cliftonville,8755,3,15,5,10,57,41,16,50
Glenavon,8755,4,11,14,5,40,36,4,47
Ballymena,8755,5,11,8,11,58,67,-9,41
Dungannon,8755,6,10,9,11,46,42,4,39
Coleraine,8755,7,10,8,12,39,41,-2,38
Ballinamalla,8755,8,9,4,17,32,53,-21,31
Ards,8755,9,8,6,16,35,52,-17,30
Glentoran,8755,10,6,9,15,33,51,-18,27
Portadown,8755,11,8,3,19,28,52,-24,27
Crusaders,8756,1,18,6,6,58,30,28,60
Linfield,8756,2,16,9,5,60,30,30,57
Cliftonville,8756,3,17,4,9,61,43,18,55
Coleraine,8756,4,13,11,6,47,36,11,50
Ballymena,8756,5,13,8,9,59,57,2,47
Ards,8756,6,11,4,15,41,51,-10,37
Dungannon,8756,7,8,9,13,49,50,-1,33
Glenavon,8756,8,7,11,12,36,51,-15,32
Ballinamalla,8756,9,7,7,16,30,52,-22,28
Portadown,8756,10,7,6,17,29,47,-18,27
Glentoran,8756,11,6,9,15,25,48,-23,27
Crusaders,8757,1,16,8,6,53,32,21,56
Linfield,8757,2,15,9,6,60,29,31,54
Cliftonville,8757,3,15,6,9,57,40,17,51
Ballymena,8757,4,14,7,9,60,64,-4,49
Coleraine,8757,5,10,9,11,37,40,-3,39
Glenavon,8757,6,9,11,10,45,45,0,38
Dungannon,8757,7,9,10,11,48,44,4,37
Glentoran,8757,8,10,7,13,32,45,-13,37
Ards,8757,9,8,9,13,35,43,-8,33
Portadown,8757,10,8,6,16,21,43,-22,30
Ballinamalla,8757,11,7,6,17,28,51,-23,27
Cliftonville,8758,1,18,3,9,59,39,20,57
Ballymena,8758,2,17,6,7,70,59,11,57
Crusaders,8758,3,17,5,8,61,41,20,56
Linfield,8758,4,14,8,8,61,34,27,50
Glenavon,8758,5,13,10,7,50,43,7,49
Coleraine,8758,6,9,12,9,44,44,0,39
Glentoran,8758,7,9,8,13,31,48,-17,35
Dungannon,8758,8,8,10,12,49,45,4,34
Portadown,8758,9,9,5,16,28,48,-20,32
Ards,8758,10,7,5,18,37,60,-23,26
Ballinamalla,8758,11,6,4,20,23,52,-29,22
Ballymena,8759,1,16,6,8,61,57,4,54
Linfield,8759,2,14,10,6,58,32,26,52
Crusaders,8759,3,14,10,6,52,36,16,52
Cliftonville,8759,4,14,5,11,57,42,15,47
Glenavon,8759,5,11,12,7,45,42,3,45
Coleraine,8759,6,10,11,9,42,38,4,41
Dungannon,8759,7,11,7,12,52,46,6,40
Portadown,8759,8,9,5,16,27,43,-16,32
Ards,8759,9,7,9,14,37,51,-14,30
Ballinamalla,8759,10,8,6,16,28,50,-22,30
Glentoran,8759,11,7,7,16,30,52,-22,28
Linfield,8760,1,15,9,6,53,29,24,54
Crusaders,8760,2,14,10,6,54,39,15,52
Cliftonville,8760,3,16,3,11,51,32,19,51
Ballymena,8760,4,13,7,10,59,58,1,46
Glenavon,8760,5,11,10,9,49,45,4,43
Dungannon,8760,6,9,13,8,50,40,10,40
Ards,8760,7,10,7,13,37,45,-8,37
Glentoran,8760,8,10,7,13,32,43,-11,37
Coleraine,8760,9,8,12,10,39,43,-4,36
Ballinamalla,8760,10,9,4,17,26,50,-24,31
Portadown,8760,11,7,4,19,26,52,-26,25
Linfield,8761,1,15,9,6,56,31,25,54
Coleraine,8761,2,14,10,6,52,40,12,52
Dungannon,8761,3,15,6,9,62,43,19,51
Crusaders,8761,4,14,9,7,59,45,14,51
Cliftonville,8761,5,15,4,11,55,46,9,49
Ballymena,8761,6,14,6,10,59,52,7,48
Glenavon,8761,7,10,8,12,41,45,-4,38
Ballinamalla,8761,8,9,5,16,28,45,-17,32
Glentoran,8761,9,8,7,15,28,45,-17,31
Ards,8761,10,7,8,15,39,54,-15,29
Portadown,8761,11,5,6,19,20,53,-33,21
Cliftonville,8762,1,19,4,7,57,36,21,61
Crusaders,8762,2,17,9,4,51,26,25,60
Linfield,8762,3,17,8,5,64,29,35,59
Coleraine,8762,4,12,9,9,37,33,4,45
Glenavon,8762,5,12,8,10,46,46,0,44
Ballymena,8762,6,12,5,13,53,65,-12,41
Ballinamalla,8762,7,8,8,14,29,42,-13,32
Dungannon,8762,8,7,10,13,40,43,-3,31
Glentoran,8762,9,7,10,13,25,39,-14,31
Ards,8762,10,8,5,17,33,50,-17,29
Portadown,8762,11,6,4,20,21,47,-26,22
Crusaders,8763,1,17,7,6,63,32,31,58
Linfield,8763,2,16,8,6,69,33,36,56
Cliftonville,8763,3,13,8,9,51,40,11,47
Ballymena,8763,4,14,5,11,51,54,-3,47
Dungannon,8763,5,11,9,10,54,50,4,42
Coleraine,8763,6,9,12,9,40,38,2,39
Glenavon,8763,7,9,12,9,44,47,-3,39
Glentoran,8763,8,10,7,13,34,44,-10,37
Ards,8763,9,11,4,15,37,52,-15,37
Ballinamalla,8763,10,8,5,17,33,54,-21,29
Portadown,8763,11,6,5,19,23,55,-32,23
Crusaders,8764,1,15,10,5,55,32,23,55
Linfield,8764,2,15,8,7,62,34,28,53
Cliftonville,8764,3,15,6,9,56,37,19,51
Coleraine,8764,4,12,10,8,49,46,3,46
Ballymena,8764,5,13,6,11,52,60,-8,45
Glenavon,8764,6,11,9,10,41,49,-8,42
Dungannon,8764,7,10,8,12,48,42,6,38
Ballinamalla,8764,8,10,5,15,35,50,-15,35
Ards,8764,9,8,7,15,34,45,-11,31
Glentoran,8764,10,8,7,15,30,44,-14,31
Portadown,8764,11,8,4,18,20,43,-23,28
Cliftonville,8765,1,17,5,8,62,38,24,56
Linfield,8765,2,15,8,7,57,37,20,53
Crusaders,8765,3,14,10,6,47,30,17,52
Coleraine,8765,4,12,10,8,47,40,7,46
Glenavon,8765,5,9,14,7,48,47,1,41
Ballymena,8765,6,11,8,11,59,64,-5,41
Dungannon,8765,7,9,11,10,52,47,5,38
Ards,8765,8,10,6,14,43,52,-9,36
Glentoran,8765,9,8,9,13,28,44,-16,33
Ballinamalla,8765,10,5,10,15,32,53,-21,25
Portadown,8765,11,6,7,17,21,44,-23,25
Linfield,8766,1,13,12,5,64,36,28,51
Crusaders,8766,2,14,8,8,50,39,11,50
Cliftonville,8766,3,15,5,10,54,45,9,50
Glentoran,8766,4,13,7,10,38,36,2,46
Ballymena,8766,5,12,7,11,57,60,-3,43
Glenavon,8766,6,11,9,10,46,45,1,42
Coleraine,8766,7,10,11,9,38,42,-4,41
Dungannon,8766,8,9,9,12,53,48,5,36
Ballinamalla,8766,9,10,5,15,40,54,-14,35
Portadown,8766,10,8,9,13,34,47,-13,33
Ards,8766,11,7,4,19,31,53,-22,25
Ballymena,8767,1,16,6,8,60,55,5,54
Linfield,8767,2,15,8,7,66,38,28,53
Cliftonville,8767,3,15,4,11,55,42,13,49
Crusaders,8767,4,14,6,10,60,47,13,48
Coleraine,8767,5,13,9,8,47,38,9,48
Glenavon,8767,6,12,9,9,47,43,4,45
Dungannon,8767,7,11,8,11,54,44,10,41
Glentoran,8767,8,11,8,11,31,40,-9,41
Ards,8767,9,9,6,15,38,48,-10,33
Portadown,8767,10,8,4,18,29,53,-24,28
Ballinamalla,8767,11,4,6,20,22,61,-39,18
Crusaders,8768,1,18,8,4,64,39,25,62
Linfield,8768,2,16,9,5,62,29,33,57
Cliftonville,8768,3,15,7,8,56,40,16,52
Ballymena,8768,4,13,7,10,57,62,-5,46
Dungannon,8768,5,10,8,12,46,42,4,38
Coleraine,8768,6,9,11,10,35,35,0,38
Glenavon,8768,7,9,10,11,42,42,0,37
Portadown,8768,8,10,4,16,25,45,-20,34
Glentoran,8768,9,8,8,14,33,47,-14,32
Ards,8768,10,7,8,15,32,48,-16,29
Ballinamalla,8768,11,8,4,18,28,51,-23,28
Crusaders,8769,1,18,8,4,54,28,26,62
Cliftonville,8769,2,16,5,9,55,36,19,53
Linfield,8769,3,14,8,8,59,36,23,50
Ballymena,8769,4,14,8,8,59,55,4,50
Coleraine,8769,5,10,12,8,40,41,-1,42
Glenavon,8769,6,9,12,9,45,47,-2,39
Dungannon,8769,7,9,11,10,49,44,5,38
Ards,8769,8,10,7,13,38,48,-10,37
Ballinamalla,8769,9,8,5,17,33,55,-22,29
Portadown,8769,10,7,5,18,25,43,-18,26
Glentoran,8769,11,6,7,17,25,49,-24,25
Linfield,8770,1,16,10,4,63,30,33,58
Crusaders,8770,2,17,6,7,59,32,27,57
Ballymena,8770,3,16,5,9,69,59,10,53
Coleraine,8770,4,13,9,8,42,36,6,48
Cliftonville,8770,5,14,5,11,56,45,11,47
Dungannon,8770,6,10,10,10,49,40,9,40
Glenavon,8770,7,10,9,11,42,48,-6,39
Ards,8770,8,9,6,15,34,44,-10,33
Ballinamalla,8770,9,8,6,16,26,53,-27,30
Glentoran,8770,10,7,7,16,33,54,-21,28
Portadown,8770,11,7,3,20,25,57,-32,24
Crusaders,8771,1,16,7,7,54,34,20,55
Linfield,8771,2,15,8,7,63,36,27,53
Cliftonville,8771,3,16,3,11,53,41,12,51
Coleraine,8771,4,13,8,9,46,42,4,47
Ballymena,8771,5,12,4,14,54,64,-10,40
Dungannon,8771,6,9,10,11,52,46,6,37
Ballinamalla,8771,7,11,4,15,33,43,-10,37
Glenavon,8771,8,9,9,12,40,52,-12,36
Portadown,8771,9,10,5,15,28,45,-17,35
Glentoran,8771,10,8,10,12,34,45,-11,34
Ards,8771,11,9,6,15,40,49,-9,33
Linfield,8772,1,17,9,4,59,21,38,60
Cliftonville,8772,2,17,5,8,53,33,20,56
Crusaders,8772,3,16,7,7,62,37,25,55
Glenavon,8772,4,13,11,6,47,39,8,50
Coleraine,8772,5,11,9,10,40,38,2,42
Ballymena,8772,6,11,7,12,50,58,-8,40
Ards,8772,7,10,5,15,32,46,-14,35
Dungannon,8772,8,8,10,12,45,49,-4,34
Portadown,8772,9,9,5,16,29,45,-16,32
Ballinamalla,8772,10,7,4,19,28,52,-24,25
Glentoran,8772,11,5,10,15,25,52,-27,25
Cliftonville,8773,1,17,5,8,58,33,25,56
Crusaders,8773,2,16,7,7,54,33,21,55
Glenavon,8773,3,13,13,4,57,41,16,52
Ballymena,8773,4,15,6,9,58,48,10,51
Linfield,8773,5,12,9,9,55,38,17,45
Ards,8773,6,12,7,11,39,41,-2,43
Coleraine,8773,7,10,11,9,42,42,0,41
Glentoran,8773,8,10,6,14,33,46,-13,36
Dungannon,8773,9,8,9,13,44,47,-3,33
Portadown,8773,10,6,4,20,26,64,-38,22
Ballinamalla,8773,11,4,7,19,21,54,-33,19
Crusaders,8774,1,17,7,6,55,28,27,58
Cliftonville,8774,2,16,5,9,53,34,19,53
Ballymena,8774,3,15,7,8,55,51,4,52
Glenavon,8774,4,12,13,5,53,38,15,49
Linfield,8774,5,11,10,9,53,42,11,43
Glentoran,8774,6,12,7,11,41,40,1,43
Dungannon,8774,7,9,10,11,49,48,1,37
Coleraine,8774,8,8,11,11,35,44,-9,35
Portadown,8774,9,8,5,17,25,49,-24,29
Ards,8774,10,7,7,16,36,51,-15,28
Ballinamalla,8774,11,7,4,19,26,56,-30,25
Crusaders,8775,1,19,6,5,61,30,31,63
Linfield,8775,2,17,9,4,65,33,32,60
Cliftonville,8775,3,15,6,9,56,44,12,51
Ballymena,8775,4,16,3,11,63,61,2,51
Coleraine,8775,5,12,10,8,43,36,7,46
Glenavon,8775,6,12,10,8,46,41,5,46
Ballinamalla,8775,7,8,6,16,35,53,-18,30
Glentoran,8775,8,8,6,16,33,55,-22,30
Dungannon,8775,9,6,11,13,47,52,-5,29
Portadown,8775,10,8,4,18,28,52,-24,28
Ards,8775,11,7,3,20,35,55,-20,24
Crusaders,8776,1,18,6,6,56,38,18,60
Linfield,8776,2,14,10,6,56,29,27,52
Cliftonville,8776,3,14,5,11,54,41,13,47
Glenavon,8776,4,13,8,9,49,45,4,47
Ballymena,8776,5,12,6,12,52,54,-2,42
Coleraine,8776,6,11,8,11,46,41,5,41
Glentoran,8776,7,10,8,12,36,47,-11,38
Portadown,8776,8,10,4,16,29,46,-17,34
Ards,8776,9,10,4,16,41,59,-18,34
Dungannon,8776,10,8,9,13,41,43,-2,33
Ballinamalla,8776,11,9,4,17,35,52,-17,31
Crusaders,8777,1,15,10,5,54,32,22,55
Glenavon,8777,2,14,10,6,51,39,12,52
Cliftonville,8777,3,14,7,9,44,32,12,49
Linfield,8777,4,12,11,7,58,37,21,47
Coleraine,8777,5,11,11,8,45,40,5,44
Ballymena,8777,6,11,8,11,49,54,-5,41
Dungannon,8777,7,10,10,10,43,39,4,40
Glentoran,8777,8,10,8,12,37,47,-10,38
Ards,8777,9,9,8,13,38,46,-8,35
Ballinamalla,8777,10,7,6,17,34,57,-23,27
Portadown,8777,11,4,7,19,18,48,-30,19
Cliftonville,8778,1,17,6,7,58,39,19,57
Linfield,8778,2,15,8,7,62,33,29,53
Crusaders,8778,3,14,10,6,51,33,18,52
Ballymena,8778,4,13,8,9,64,59,5,47
Dungannon,8778,5,11,10,9,56,46,10,43
Glenavon,8778,6,10,13,7,44,42,2,43
Coleraine,8778,7,9,9,12,40,43,-3,36
Ards,8778,8,9,7,14,39,55,-16,34
Ballinamalla,8778,9,9,5,16,28,46,-18,32
Portadown,8778,10,7,7,16,24,43,-19,28
Glentoran,8778,11,7,5,18,26,53,-27,26
Cliftonville,8779,1,18,5,7,58,36,22,59
Crusaders,8779,2,16,10,4,59,34,25,58
Coleraine,8779,3,13,10,7,45,34,11,49
Ballymena,8779,4,12,8,10,58,58,0,44
Linfield,8779,5,11,10,9,54,33,21,43
Glenavon,8779,6,11,10,9,48,48,0,43
Dungannon,8779,7,9,11,10,46,44,2,38
Glentoran,8779,8,10,6,14,35,49,-14,36
Ards,8779,9,9,3,18,32,49,-17,30
Ballinamalla,8779,10,8,5,17,28,52,-24,29
Portadown,8779,11,5,8,17,20,46,-26,23
Linfield,8780,1,15,11,4,62,27,35,56
Crusaders,8780,2,17,5,8,60,37,23,56
Cliftonville,8780,3,15,7,8,48,34,14,52
Glenavon,8780,4,13,11,6,53,42,11,50
Ballymena,8780,5,14,7,9,69,61,8,49
Coleraine,8780,6,13,8,9,48,39,9,47
Dungannon,8780,7,11,8,11,49,42,7,41
Ards,8780,8,8,8,14,37,53,-16,32
Glentoran,8780,9,8,8,14,32,52,-20,32
Ballinamalla,8780,10,6,4,20,21,50,-29,22
Portadown,8780,11,4,5,21,18,60,-42,17
Crusaders,8781,1,16,12,2,54,29,25,60
Linfield,8781,2,14,10,6,59,34,25,52
Glenavon,8781,3,14,10,6,55,44,11,52
Cliftonville,8781,4,13,9,8,55,42,13,48
Ballymena,8781,5,13,7,10,54,56,-2,46
Dungannon,8781,6,9,11,10,54,48,6,38
Coleraine,8781,7,8,10,12,37,44,-7,34
Glentoran,8781,8,9,7,14,27,39,-12,34
Ards,8781,9,8,7,15,41,49,-8,31
Ballinamalla,8781,10,8,5,17,32,54,-22,29
Portadown,8781,11,6,6,18,22,51,-29,24
Ballymena,8782,1,17,5,8,57,49,8,56
Cliftonville,8782,2,17,4,9,54,35,19,55
Linfield,8782,3,14,10,6,62,40,22,52
Crusaders,8782,4,14,8,8,51,39,12,50
Dungannon,8782,5,11,9,10,50,40,10,42
Coleraine,8782,6,11,9,10,41,40,1,42
Glenavon,8782,7,8,11,11,39,45,-6,35
Glentoran,8782,8,9,8,13,35,47,-12,35
Ballinamalla,8782,9,9,6,15,32,46,-14,33
Ards,8782,10,6,10,14,35,49,-14,28
Portadown,8782,11,7,4,19,29,55,-26,25
Linfield,8783,1,15,11,4,57,27,30,56
Glenavon,8783,2,13,12,5,50,41,9,51
Cliftonville,8783,3,15,5,10,55,43,12,50
Crusaders,8783,4,14,6,10,48,40,8,48
Ballymena,8783,5,13,7,10,55,60,-5,46
Ards,8783,6,11,7,12,47,44,3,40
Dungannon,8783,7,9,12,9,53,46,7,39
Coleraine,8783,8,9,9,12,39,45,-6,36
Glentoran,8783,9,7,12,11,31,43,-12,33
Ballinamalla,8783,10,8,6,16,33,47,-14,30
Portadown,8783,11,6,3,21,20,52,-32,21
Ballymena,8784,1,18,5,7,65,48,17,59
Crusaders,8784,2,17,6,7,54,33,21,57
Linfield,8784,3,14,9,7,61,44,17,51
Cliftonville,8784,4,13,8,9,50,43,7,47
Glenavon,8784,5,10,12,8,45,44,1,42
Dungannon,8784,6,10,11,9,54,45,9,41
Glentoran,8784,7,11,7,12,35,41,-6,40
Coleraine,8784,8,7,10,13,36,45,-9,31
Ards,8784,9,8,6,16,41,54,-13,30
Portadown,8784,10,9,3,18,31,49,-18,30
Ballinamalla,8784,11,6,7,17,28,54,-26,25
Crusaders,8785,1,21,7,2,73,29,44,70
Cliftonville,8785,2,15,5,10,46,41,5,50
Ballymena,8785,3,14,5,11,60,61,-1,47
Linfield,8785,4,13,7,10,55,35,20,46
Glenavon,8785,5,12,10,8,47,46,1,46
Coleraine,8785,6,12,7,11,42,41,1,43
Dungannon,8785,7,10,12,8,47,37,10,42
Glentoran,8785,8,8,8,14,34,52,-18,32
Ards,8785,9,8,5,17,34,48,-14,29
Ballinamalla,8785,10,8,3,19,30,57,-27,27
Portadown,8785,11,7,5,18,26,47,-21,26
Linfield,8786,1,16,11,3,57,23,34,59
Crusaders,8786,2,17,7,6,55,34,21,58
Cliftonville,8786,3,15,7,8,56,37,19,52
Glenavon,8786,4,11,9,10,50,47,3,42
Coleraine,8786,5,10,12,8,49,46,3,42
Glentoran,8786,6,10,8,12,31,47,-16,38
Ballymena,8786,7,9,10,11,52,61,-9,37
Dungannon,8786,8,9,9,12,46,40,6,36
Portadown,8786,9,9,5,16,31,47,-16,32
Ards,8786,10,7,7,16,34,51,-17,28
Ballinamalla,8786,11,8,3,19,27,55,-28,27
Linfield,8787,1,17,9,4,65,27,38,60
Coleraine,8787,2,14,9,7,50,31,19,51
Crusaders,8787,3,14,7,9,58,42,16,49
Cliftonville,8787,4,15,4,11,47,36,11,49
Glentoran,8787,5,11,11,8,34,38,-4,44
Ballymena,8787,6,12,6,12,49,61,-12,42
Dungannon,8787,7,10,10,10,53,47,6,40
Glenavon,8787,8,9,9,12,43,56,-13,36
Ards,8787,9,10,3,17,40,54,-14,33
Portadown,8787,10,8,5,17,25,42,-17,29
Ballinamalla,8787,11,6,5,19,23,53,-30,23
Linfield,8788,1,15,9,6,59,31,28,54
Glenavon,8788,2,14,11,5,53,39,14,53
Crusaders,8788,3,15,8,7,47,33,14,53
Coleraine,8788,4,12,8,10,42,36,6,44
Cliftonville,8788,5,13,5,12,46,41,5,44
Ballymena,8788,6,11,6,13,50,60,-10,39
Dungannon,8788,7,9,10,11,48,44,4,37
Ballinamalla,8788,8,10,6,14,32,44,-12,36
Ards,8788,9,10,5,15,42,48,-6,35
Glentoran,8788,10,7,9,14,27,44,-17,30
Portadown,8788,11,8,5,17,23,49,-26,29
Crusaders,8789,1,18,8,4,64,36,28,62
Linfield,8789,2,14,11,5,62,34,28,53
Cliftonville,8789,3,15,4,11,53,37,16,49
Coleraine,8789,4,13,9,8,49,42,7,48
Ballymena,8789,5,12,8,10,52,63,-11,44
Glenavon,8789,6,9,12,9,43,48,-5,39
Dungannon,8789,7,8,9,13,47,50,-3,33
Ards,8789,8,10,3,17,47,55,-8,33
Glentoran,8789,9,9,6,15,31,42,-11,33
Portadown,8789,10,9,5,16,32,47,-15,32
Ballinamalla,8789,11,9,3,18,32,58,-26,30
Cliftonville,8790,1,18,5,7,59,40,19,59
Crusaders,8790,2,17,7,6,64,40,24,58
Linfield,8790,3,15,9,6,62,35,27,54
Glenavon,8790,4,11,10,9,53,51,2,43
Coleraine,8790,5,11,8,11,46,44,2,41
Ballymena,8790,6,11,8,11,58,58,0,41
Glentoran,8790,7,10,8,12,45,51,-6,38
Ards,8790,8,10,5,15,38,49,-11,35
Dungannon,8790,9,7,9,14,45,53,-8,30
Ballinamalla,8790,10,8,4,18,29,52,-23,28
Portadown,8790,11,7,7,16,24,50,-26,28
Cliftonville,8791,1,17,6,7,57,35,22,57
Crusaders,8791,2,17,5,8,57,32,25,56
Linfield,8791,3,15,7,8,58,39,19,52
Glenavon,8791,4,12,10,8,48,45,3,46
Ballymena,8791,5,13,4,13,56,61,-5,43
Coleraine,8791,6,11,9,10,45,42,3,42
Dungannon,8791,7,10,11,9,57,46,11,41
Ards,8791,8,10,6,14,40,51,-11,36
Glentoran,8791,9,9,5,16,25,48,-23,32
Ballinamalla,8791,10,8,5,17,32,53,-21,29
Portadown,8791,11,6,6,18,24,47,-23,24
Crusaders,8792,1,15,9,6,51,35,16,54
Glenavon,8792,2,14,10,6,54,47,7,52
Coleraine,8792,3,13,11,6,51,42,9,50
Ballymena,8792,4,14,7,9,61,55,6,49
Cliftonville,8792,5,14,6,10,51,39,12,48
Linfield,8792,6,12,10,8,55,39,16,46
Glentoran,8792,7,10,8,12,29,40,-11,38
Dungannon,8792,8,8,9,13,52,54,-2,33
Ards,8792,9,8,6,16,40,49,-9,30
Portadown,8792,10,6,9,15,25,45,-20,27
Ballinamalla,8792,11,7,3,20,33,57,-24,24
Crusaders,8793,1,19,6,5,61,34,27,63
Linfield,8793,2,14,10,6,60,34,26,52
Cliftonville,8793,3,15,3,12,49,39,10,48
Coleraine,8793,4,12,10,8,44,36,8,46
Ballymena,8793,5,13,6,11,51,59,-8,45
Glenavon,8793,6,10,13,7,49,47,2,43
Ards,8793,7,12,5,13,39,46,-7,41
Dungannon,8793,8,8,11,11,49,44,5,35
Glentoran,8793,9,9,5,16,31,49,-18,32
Portadown,8793,10,6,7,17,19,41,-22,25
Ballinamalla,8793,11,7,4,19,23,46,-23,25
Crusaders,8794,1,16,8,6,54,32,22,56
Linfield,8794,2,15,10,5,67,32,35,55
Cliftonville,8794,3,17,4,9,58,43,15,55
Ballymena,8794,4,17,4,9,61,57,4,55
Coleraine,8794,5,12,9,9,38,34,4,45
Dungannon,8794,6,10,9,11,53,49,4,39
Glenavon,8794,7,10,7,13,46,50,-4,37
Ballinamalla,8794,8,9,7,14,36,49,-13,34
Glentoran,8794,9,9,6,15,26,43,-17,33
Ards,8794,10,7,5,18,33,53,-20,26
Portadown,8794,11,6,5,19,28,58,-30,23
Linfield,8795,1,16,10,4,65,32,33,58
Crusaders,8795,2,16,8,6,56,36,20,56
Ballymena,8795,3,17,4,9,64,52,12,55
Cliftonville,8795,4,16,5,9,53,42,11,53
Coleraine,8795,5,12,9,9,43,41,2,45
Glenavon,8795,6,10,12,8,43,42,1,42
Dungannon,8795,7,9,11,10,48,44,4,38
Glentoran,8795,8,10,8,12,32,42,-10,38
Portadown,8795,9,7,6,17,24,43,-19,27
Ards,8795,10,5,6,19,31,55,-24,21
Ballinamalla,8795,11,6,3,21,27,57,-30,21
Crusaders,8796,1,19,6,5,57,29,28,63
Linfield,8796,2,13,13,4,53,26,27,52
Ballymena,8796,3,14,8,8,63,54,9,50
Cliftonville,8796,4,14,2,14,54,48,6,44
Portadown,8796,5,13,4,13,36,44,-8,43
Glentoran,8796,6,11,9,10,31,35,-4,42
Glenavon,8796,7,10,10,10,43,41,2,40
Dungannon,8796,8,9,9,12,43,47,-4,36
Coleraine,8796,9,8,11,11,37,45,-8,35
Ards,8796,10,7,4,19,31,52,-21,25
Ballinamalla,8796,11,6,6,18,28,55,-27,24
Crusaders,8797,1,17,7,6,53,33,20,58
Cliftonville,8797,2,18,3,9,55,37,18,57
Linfield,8797,3,13,9,8,61,37,24,48
Ballymena,8797,4,13,8,9,56,54,2,47
Glenavon,8797,5,12,9,9,46,40,6,45
Coleraine,8797,6,12,8,10,45,37,8,44
Ards,8797,7,12,4,14,48,48,0,40
Glentoran,8797,8,11,6,13,35,46,-11,39
Portadown,8797,9,10,5,15,32,57,-25,35
Dungannon,8797,10,8,7,15,48,53,-5,31
Ballinamalla,8797,11,4,4,22,24,61,-37,16
Linfield,8798,1,18,7,5,61,24,37,61
Crusaders,8798,2,15,7,8,47,36,11,52
Cliftonville,8798,3,14,6,10,56,43,13,48
Ballymena,8798,4,14,5,11,69,62,7,47
Coleraine,8798,5,11,10,9,42,41,1,43
Dungannon,8798,6,11,8,11,51,45,6,41
Ards,8798,7,12,5,13,43,48,-5,41
Glenavon,8798,8,9,10,11,38,47,-9,37
Portadown,8798,9,9,5,16,29,49,-20,32
Ballinamalla,8798,10,9,4,17,35,54,-19,31
Glentoran,8798,11,7,5,18,33,55,-22,26
Linfield,8799,1,15,10,5,60,31,29,55
Ballymena,8799,2,16,6,8,56,51,5,54
Crusaders,8799,3,15,8,7,52,36,16,53
Cliftonville,8799,4,15,6,9,53,40,13,51
Coleraine,8799,5,11,10,9,45,38,7,43
Dungannon,8799,6,10,12,8,52,46,6,42
Glenavon,8799,7,10,11,9,43,39,4,41
Ards,8799,8,9,5,16,37,48,-11,32
Portadown,8799,9,8,7,15,27,43,-16,31
Ballinamalla,8799,10,7,4,19,28,55,-27,25
Glentoran,8799,11,5,9,16,22,48,-26,24
Crusaders,8800,1,17,6,7,58,36,22,57
Cliftonville,8800,2,16,4,10,56,42,14,52
Ballymena,8800,3,14,10,6,59,51,8,52
Linfield,8800,4,12,13,5,61,36,25,49
Glenavon,8800,5,11,12,7,42,35,7,45
Coleraine,8800,6,11,8,11,48,44,4,41
Dungannon,8800,7,9,10,11,42,45,-3,37
Ards,8800,8,11,2,17,39,50,-11,35
Portadown,8800,9,9,6,15,26,38,-12,33
Glentoran,8800,10,8,5,17,31,56,-25,29
Ballinamalla,8800,11,6,6,18,26,55,-29,24
Ballymena,8801,1,14,9,7,55,48,7,51
Cliftonville,8801,2,15,5,10,49,41,8,50
Crusaders,8801,3,12,12,6,49,34,15,48
Linfield,8801,4,12,9,9,57,43,14,45
Coleraine,8801,5,12,9,9,41,35,6,45
Dungannon,8801,6,11,9,10,48,43,5,42
Glenavon,8801,7,11,9,10,46,44,2,42
Ards,8801,8,10,6,14,41,49,-8,36
Ballinamalla,8801,9,9,7,14,34,47,-13,34
Glentoran,8801,10,8,7,15,32,48,-16,31
Portadown,8801,11,7,6,17,26,46,-20,27
Crusaders,8802,1,19,8,3,64,25,39,65
Cliftonville,8802,2,15,7,8,45,34,11,52
Ballymena,8802,3,15,6,9,60,55,5,51
Linfield,8802,4,12,8,10,53,37,16,44
Glenavon,8802,5,12,8,10,46,41,5,44
Coleraine,8802,6,10,13,7,39,33,6,43
Dungannon,8802,7,10,9,11,44,40,4,39
Ballinamalla,8802,8,12,1,17,37,50,-13,37
Glentoran,8802,9,9,6,15,32,48,-16,33
Ards,8802,10,9,6,15,35,55,-20,33
Portadown,8802,11,4,4,22,19,56,-37,16
Linfield,8803,1,14,11,5,59,31,28,53
Crusaders,8803,2,15,8,7,61,44,17,53
Cliftonville,8803,3,15,5,10,57,44,13,50
Ballymena,8803,4,14,7,9,62,65,-3,49
Glenavon,8803,5,11,13,6,50,42,8,46
Coleraine,8803,6,10,11,9,51,47,4,41
Dungannon,8803,7,8,9,13,53,53,0,33
Ards,8803,8,9,5,16,39,51,-12,32
Ballinamalla,8803,9,9,5,16,35,48,-13,32
Glentoran,8803,10,8,8,14,29,50,-21,32
Portadown,8803,11,9,4,17,28,49,-21,31
Crusaders,8804,1,18,8,4,57,31,26,62
Linfield,8804,2,14,9,7,61,35,26,51
Ballymena,8804,3,15,6,9,61,56,5,51
Cliftonville,8804,4,14,3,13,48,42,6,45
Glenavon,8804,5,11,9,10,42,45,-3,42
Coleraine,8804,6,10,9,11,40,42,-2,39
Dungannon,8804,7,10,8,12,46,43,3,38
Portadown,8804,8,10,5,15,24,42,-18,35
Glentoran,8804,9,8,8,14,30,44,-14,32
Ards,8804,10,9,4,17,38,50,-12,31
Ballinamalla,8804,11,8,7,15,29,46,-17,31
Linfield,8805,1,16,7,7,65,31,34,55
Crusaders,8805,2,15,8,7,51,31,20,53
Coleraine,8805,3,13,10,7,52,41,11,49
Ballymena,8805,4,14,7,9,61,62,-1,49
Glenavon,8805,5,13,9,8,52,45,7,48
Dungannon,8805,6,10,9,11,52,48,4,39
Cliftonville,8805,7,12,3,15,47,52,-5,39
Glentoran,8805,8,9,9,12,30,40,-10,36
Portadown,8805,9,9,4,17,25,47,-22,31
Ballinamalla,8805,10,8,5,17,36,55,-19,29
Ards,8805,11,7,7,16,35,54,-19,28
Crusaders,8806,1,21,6,3,69,29,40,69
Cliftonville,8806,2,15,9,6,55,38,17,54
Linfield,8806,3,14,9,7,58,32,26,51
Coleraine,8806,4,14,9,7,46,37,9,51
Dungannon,8806,5,10,8,12,55,47,8,38
Ballymena,8806,6,10,8,12,50,58,-8,38
Glenavon,8806,7,9,9,12,47,56,-9,36
Ards,8806,8,10,5,15,35,49,-14,35
Glentoran,8806,9,9,8,13,30,46,-16,35
Portadown,8806,10,7,5,18,30,54,-24,26
Ballinamalla,8806,11,6,4,20,29,58,-29,22
Ballymena,8807,1,16,6,8,62,52,10,54
Crusaders,8807,2,15,8,7,49,35,14,53
Cliftonville,8807,3,15,5,10,52,39,13,50
Linfield,8807,4,13,10,7,53,31,22,49
Coleraine,8807,5,11,11,8,44,39,5,44
Dungannon,8807,6,11,9,10,54,44,10,42
Glenavon,8807,7,10,12,8,50,45,5,42
Ards,8807,8,11,4,15,34,45,-11,37
Ballinamalla,8807,9,8,7,15,28,44,-16,31
Portadown,8807,10,7,7,16,29,52,-23,28
Glentoran,8807,11,5,7,18,22,51,-29,22
Linfield,8808,1,16,10,4,67,31,36,58
Cliftonville,8808,2,17,5,8,55,36,19,56
Crusaders,8808,3,15,10,5,58,39,19,55
Ballymena,8808,4,14,6,10,54,55,-1,48
Glenavon,8808,5,12,10,8,44,41,3,46
Coleraine,8808,6,9,10,11,39,40,-1,37
Dungannon,8808,7,8,9,13,45,43,2,33
Ballinamalla,8808,8,8,9,13,27,44,-17,33
Portadown,8808,9,8,5,17,24,44,-20,29
Ards,8808,10,7,6,17,35,54,-19,27
Glentoran,8808,11,5,12,13,27,48,-21,27
Cliftonville,8809,1,20,2,8,56,35,21,62
Crusaders,8809,2,17,8,5,55,32,23,59
Linfield,8809,3,14,9,7,57,32,25,51
Ballymena,8809,4,15,6,9,53,46,7,51
Dungannon,8809,5,11,11,8,51,40,11,44
Glenavon,8809,6,9,11,10,51,50,1,38
Coleraine,8809,7,9,10,11,40,43,-3,37
Glentoran,8809,8,8,10,12,26,37,-11,34
Portadown,8809,9,7,7,16,26,52,-26,28
Ards,8809,10,8,3,19,32,51,-19,27
Ballinamalla,8809,11,6,5,19,32,61,-29,23
Cliftonville,8810,1,16,6,8,53,33,20,54
Crusaders,8810,2,15,9,6,55,37,18,54
Linfield,8810,3,15,7,8,64,35,29,52
Ballymena,8810,4,16,4,10,58,59,-1,52
Dungannon,8810,5,13,7,10,58,51,7,46
Coleraine,8810,6,11,11,8,39,37,2,44
Ards,8810,7,13,3,14,45,48,-3,42
Glenavon,8810,8,9,10,11,42,48,-6,37
Glentoran,8810,9,10,5,15,33,47,-14,35
Ballinamalla,8810,10,6,6,18,34,59,-25,24
Portadown,8810,11,5,4,21,24,51,-27,19
Crusaders,8811,1,17,9,4,62,31,31,60
Linfield,8811,2,16,8,6,68,34,34,56
Coleraine,8811,3,14,9,7,55,40,15,51
Glenavon,8811,4,13,10,7,48,45,3,49
Cliftonville,8811,5,14,6,10,53,42,11,48
Ballymena,8811,6,12,7,11,57,61,-4,43
Dungannon,8811,7,11,7,12,53,50,3,40
Ards,8811,8,8,7,15,42,53,-11,31
Glentoran,8811,9,7,9,14,29,51,-22,30
Ballinamalla,8811,10,8,4,18,30,56,-26,28
Portadown,8811,11,5,4,21,20,54,-34,19
Ballymena,8812,1,15,10,5,58,50,8,55
Glenavon,8812,2,14,12,4,52,41,11,54
Linfield,8812,3,13,11,6,65,36,29,50
Crusaders,8812,4,11,14,5,53,40,13,47
Cliftonville,8812,5,12,8,10,45,38,7,44
Ards,8812,6,10,7,13,41,50,-9,37
Dungannon,8812,7,8,9,13,45,47,-2,33
Coleraine,8812,8,8,9,13,35,42,-7,33
Portadown,8812,9,9,6,15,30,44,-14,33
Glentoran,8812,10,7,10,13,33,50,-17,31
Ballinamalla,8812,11,6,8,16,31,50,-19,26
Crusaders,8813,1,18,8,4,58,26,32,62
Cliftonville,8813,2,17,5,8,59,40,19,56
Glenavon,8813,3,13,10,7,52,46,6,49
Ballymena,8813,4,14,6,10,54,56,-2,48
Linfield,8813,5,12,10,8,54,37,17,46
Coleraine,8813,6,10,11,9,35,35,0,41
Dungannon,8813,7,10,8,12,48,42,6,38
Ards,8813,8,7,9,14,35,47,-12,30
Ballinamalla,8813,9,6,10,14,28,47,-19,28
Glentoran,8813,10,6,8,16,30,55,-25,26
Portadown,8813,11,6,7,17,24,46,-22,25
Crusaders,8814,1,16,8,6,55,37,18,56
Linfield,8814,2,14,10,6,61,36,25,52
Cliftonville,8814,3,16,4,10,53,42,11,52
Coleraine,8814,4,12,11,7,47,37,10,47
Glenavon,8814,5,12,11,7,49,41,8,47
Ballymena,8814,6,13,6,11,68,59,9,45
Dungannon,8814,7,10,9,11,48,48,0,39
Ards,8814,8,9,7,14,44,52,-8,34
Glentoran,8814,9,8,7,15,33,54,-21,31
Ballinamalla,8814,10,7,6,17,32,52,-20,27
Portadown,8814,11,5,7,18,24,56,-32,22
Cliftonville,8815,1,18,4,8,58,40,18,58
Linfield,8815,2,16,8,6,68,37,31,56
Crusaders,8815,3,14,9,7,55,37,18,51
Glenavon,8815,4,13,12,5,51,38,13,51
Ballymena,8815,5,15,4,11,69,61,8,49
Coleraine,8815,6,12,11,7,44,34,10,47
Glentoran,8815,7,8,8,14,33,54,-21,32
Dungannon,8815,8,7,9,14,47,58,-11,30
Ballinamalla,8815,9,8,5,17,31,49,-18,29
Ards,8815,10,7,6,17,33,51,-18,27
Portadown,8815,11,7,4,19,25,55,-30,25
Crusaders,8816,1,18,8,4,62,28,34,62
Linfield,8816,2,13,10,7,56,36,20,49
Cliftonville,8816,3,15,3,12,53,35,18,48
Glenavon,8816,4,11,11,8,42,41,1,44
Ballymena,8816,5,13,4,13,57,69,-12,43
Coleraine,8816,6,10,12,8,41,40,1,42
Dungannon,8816,7,10,8,12,49,50,-1,38
Ards,8816,8,9,7,14,35,47,-12,34
Glentoran,8816,9,9,7,14,32,44,-12,34
Ballinamalla,8816,10,9,5,16,36,51,-15,32
Portadown,8816,11,9,3,18,28,50,-22,30
Linfield,8817,1,15,9,6,61,35,26,54
Glenavon,8817,2,14,10,6,55,42,13,52
Dungannon,8817,3,14,8,8,56,37,19,50
Ballymena,8817,4,15,5,10,60,61,-1,50
Cliftonville,8817,5,15,2,13,56,47,9,47
Coleraine,8817,6,13,8,9,47,41,6,47
Crusaders,8817,7,12,6,12,47,42,5,42
Ards,8817,8,10,3,17,38,52,-14,33
Glentoran,8817,9,8,6,16,28,44,-16,30
Portadown,8817,10,9,3,18,27,52,-25,30
Ballinamalla,8817,11,7,6,17,28,50,-22,27
Crusaders,8818,1,18,7,5,59,32,27,61
Coleraine,8818,2,16,8,6,45,34,11,56
Linfield,8818,3,14,10,6,60,31,29,52
Cliftonville,8818,4,15,3,12,49,41,8,48
Ballymena,8818,5,14,5,11,59,58,1,47
Dungannon,8818,6,11,7,12,54,47,7,40
Glenavon,8818,7,8,13,9,50,52,-2,37
Glentoran,8818,8,7,12,11,25,38,-13,33
Ards,8818,9,9,4,17,41,54,-13,31
Ballinamalla,8818,10,8,5,17,27,53,-26,29
Portadown,8818,11,6,4,20,24,53,-29,22
Ballymena,8819,1,17,5,8,61,55,6,56
Crusaders,8819,2,13,9,8,53,40,13,48
Linfield,8819,3,12,10,8,55,34,21,46
Glenavon,8819,4,12,10,8,56,52,4,46
Cliftonville,8819,5,13,5,12,52,41,11,44
Coleraine,8819,6,11,11,8,44,39,5,44
Dungannon,8819,7,10,10,10,43,42,1,40
Glentoran,8819,8,9,9,12,33,47,-14,36
Ballinamalla,8819,9,10,4,16,32,47,-15,34
Ards,8819,10,8,6,16,38,53,-15,30
Portadown,8819,11,7,7,16,26,43,-17,28
Crusaders,8820,1,16,6,8,59,37,22,54
Cliftonville,8820,2,16,5,9,55,42,13,53
Linfield,8820,3,14,10,6,61,32,29,52
Ballymena,8820,4,14,8,8,57,60,-3,50
Glenavon,8820,5,11,12,7,45,43,2,45
Dungannon,8820,6,11,11,8,57,39,18,44
Glentoran,8820,7,10,9,11,31,41,-10,39
Coleraine,8820,8,10,8,12,44,45,-1,38
Ards,8820,9,7,11,12,35,45,-10,32
Portadown,8820,10,6,5,19,22,48,-26,23
Ballinamalla,8820,11,5,5,20,31,65,-34,20
Crusaders,8821,1,17,8,5,63,34,29,59
Ballymena,8821,2,15,5,10,68,61,7,50
Cliftonville,8821,3,15,3,12,57,42,15,48
Linfield,8821,4,12,10,8,50,31,19,46
Coleraine,8821,5,12,9,9,45,42,3,45
Dungannon,8821,6,11,9,10,54,42,12,42
Glentoran,8821,7,11,9,10,38,40,-2,42
Glenavon,8821,8,8,11,11,42,58,-16,35
Ards,8821,9,9,6,15,41,52,-11,33
Ballinamalla,8821,10,9,5,16,31,45,-14,32
Portadown,8821,11,5,7,18,23,65,-42,22
Crusaders,8822,1,16,6,8,60,42,18,54
Glenavon,8822,2,13,11,6,51,46,5,50
Linfield,8822,3,12,13,5,54,34,20,49
Coleraine,8822,4,11,10,9,44,36,8,43
Ballymena,8822,5,12,6,12,55,60,-5,42
Cliftonville,8822,6,12,5,13,47,47,0,41
Ards,8822,7,11,7,12,42,45,-3,40
Glentoran,8822,8,10,9,11,38,45,-7,39
Dungannon,8822,9,9,10,11,54,44,10,37
Portadown,8822,10,10,7,13,31,43,-12,37
Ballinamalla,8822,11,5,4,21,26,60,-34,19
Linfield,8823,1,17,6,7,60,36,24,57
Ballymena,8823,2,17,6,7,57,48,9,57
Crusaders,8823,3,14,11,5,52,35,17,53
Cliftonville,8823,4,13,8,9,51,37,14,47
Glenavon,8823,5,12,10,8,58,44,14,46
Coleraine,8823,6,10,13,7,45,41,4,43
Dungannon,8823,7,10,9,11,52,42,10,39
Glentoran,8823,8,7,10,13,26,40,-14,31
Ards,8823,9,7,5,18,32,55,-23,26
Portadown,8823,10,7,5,18,27,54,-27,26
Ballinamalla,8823,11,6,7,17,24,52,-28,25
Crusaders,8824,1,16,10,4,56,31,25,58
Linfield,8824,2,15,11,4,56,29,27,56
Cliftonville,8824,3,14,6,10,50,38,12,48
Coleraine,8824,4,11,13,6,51,42,9,46
Ballymena,8824,5,13,6,11,52,58,-6,45
Dungannon,8824,6,12,8,10,54,41,13,44
Glenavon,8824,7,11,11,8,53,44,9,44
Glentoran,8824,8,9,8,13,34,46,-12,35
Ards,8824,9,9,5,16,34,50,-16,32
Ballinamalla,8824,10,6,5,19,25,52,-27,23
Portadown,8824,11,5,5,20,18,52,-34,20
Linfield,8825,1,18,7,5,62,26,36,61
Crusaders,8825,2,17,6,7,54,39,15,57
Cliftonville,8825,3,18,2,10,52,34,18,56
Coleraine,8825,4,13,8,9,46,39,7,47
Glenavon,8825,5,10,12,8,43,44,-1,42
Ballymena,8825,6,12,5,13,58,66,-8,41
Dungannon,8825,7,10,10,10,52,43,9,40
Glentoran,8825,8,10,7,13,31,44,-13,37
Ards,8825,9,10,4,16,38,47,-9,34
Portadown,8825,10,7,6,17,30,50,-20,27
Ballinamalla,8825,11,4,5,21,24,58,-34,17
Linfield,8826,1,15,9,6,56,36,20,54
Crusaders,8826,2,15,7,8,47,33,14,52
Cliftonville,8826,3,15,5,10,52,40,12,50
Ballymena,8826,4,13,8,9,54,53,1,47
Dungannon,8826,5,12,8,10,53,44,9,44
Coleraine,8826,6,12,8,10,44,35,9,44
Glenavon,8826,7,10,11,9,42,43,-1,41
Ards,8826,8,11,4,15,46,51,-5,37
Glentoran,8826,9,9,9,12,35,45,-10,36
Portadown,8826,10,7,4,19,21,44,-23,25
Ballinamalla,8826,11,6,7,17,29,55,-26,25
Cliftonville,8827,1,17,5,8,58,39,19,56
Ballymena,8827,2,14,9,7,60,54,6,51
Coleraine,8827,3,14,7,9,50,39,11,49
Glenavon,8827,4,13,9,8,50,39,11,48
Linfield,8827,5,13,8,9,55,34,21,47
Crusaders,8827,6,12,8,10,57,45,12,44
Portadown,8827,7,11,6,13,29,38,-9,39
Dungannon,8827,8,8,9,13,45,49,-4,33
Glentoran,8827,9,8,7,15,33,54,-21,31
Ards,8827,10,8,6,16,35,55,-20,30
Ballinamalla,8827,11,8,4,18,32,58,-26,28
Crusaders,8828,1,17,7,6,57,33,24,58
Cliftonville,8828,2,15,6,9,54,40,14,51
Linfield,8828,3,13,8,9,66,44,22,47
Ballymena,8828,4,13,8,9,59,60,-1,47
Glenavon,8828,5,11,10,9,45,44,1,43
Coleraine,8828,6,9,14,7,42,43,-1,41
Dungannon,8828,7,9,12,9,50,45,5,39
Glentoran,8828,8,10,7,13,36,46,-10,37
Portadown,8828,9,7,9,14,28,47,-19,30
Ards,8828,10,8,5,17,37,54,-17,29
Ballinamalla,8828,11,8,4,18,38,56,-18,28
Linfield,8829,1,16,10,4,66,32,34,58
Crusaders,8829,2,16,9,5,65,42,23,57
Ballymena,8829,3,12,12,6,61,59,2,48
Cliftonville,8829,4,12,8,10,51,46,5,44
Glenavon,8829,5,11,11,8,55,53,2,44
Coleraine,8829,6,10,11,9,43,42,1,41
Dungannon,8829,7,9,8,13,47,47,0,35
Ballinamalla,8829,8,8,8,14,33,47,-14,32
Glentoran,8829,9,8,8,14,27,48,-21,32
Portadown,8829,10,7,7,16,25,41,-16,28
Ards,8829,11,7,6,17,32,48,-16,27
Crusaders,8830,1,16,8,6,64,39,25,56
Glenavon,8830,2,14,9,7,50,45,5,51
Linfield,8830,3,13,11,6,56,29,27,50
Cliftonville,8830,4,14,7,9,50,41,9,49
Coleraine,8830,5,12,11,7,45,35,10,47
Ballymena,8830,6,12,6,12,53,63,-10,42
Ards,8830,7,12,4,14,47,47,0,40
Portadown,8830,8,10,6,14,33,47,-14,36
Glentoran,8830,9,7,11,12,27,40,-13,32
Dungannon,8830,10,6,12,12,45,52,-7,30
Ballinamalla,8830,11,4,5,21,24,56,-32,17
Crusaders,8831,1,16,9,5,60,37,23,57
Glenavon,8831,2,12,13,5,53,39,14,49
Ballymena,8831,3,14,7,9,57,57,0,49
Linfield,8831,4,12,10,8,59,40,19,46
Cliftonville,8831,5,12,10,8,52,41,11,46
Coleraine,8831,6,10,11,9,38,42,-4,41
Dungannon,8831,7,9,10,11,51,46,5,37
Glentoran,8831,8,10,5,15,32,47,-15,35
Ards,8831,9,9,6,15,44,52,-8,33
Portadown,8831,10,6,9,15,26,44,-18,27
Ballinamalla,8831,11,7,6,17,29,56,-27,27
Crusaders,8832,1,17,6,7,61,35,26,57
Linfield,8832,2,14,11,5,62,32,30,53
Cliftonville,8832,3,15,6,9,55,38,17,51
Coleraine,8832,4,11,13,6,39,33,6,46
Ballymena,8832,5,13,7,10,52,52,0,46
Dungannon,8832,6,10,9,11,49,45,4,39
Glentoran,8832,7,8,10,12,30,42,-12,34
Portadown,8832,8,9,7,14,27,41,-14,34
Glenavon,8832,9,8,9,13,40,52,-12,33
Ards,8832,10,9,5,16,39,55,-16,32
Ballinamalla,8832,11,8,3,19,26,55,-29,27
Crusaders,8833,1,17,8,5,53,31,22,59
Linfield,8833,2,14,12,4,62,32,30,54
Glenavon,8833,3,13,11,6,49,41,8,50
Ballymena,8833,4,14,7,9,64,58,6,49
Cliftonville,8833,5,13,4,13,52,44,8,43
Dungannon,8833,6,10,12,8,50,37,13,42
Glentoran,8833,7,9,9,12,36,50,-14,36
Coleraine,8833,8,8,9,13,38,54,-16,33
Portadown,8833,9,9,5,16,29,45,-16,32
Ballinamalla,8833,10,7,6,17,27,48,-21,27
Ards,8833,11,7,5,18,37,57,-20,26
Linfield,8834,1,15,11,4,65,29,36,56
Crusaders,8834,2,15,11,4,58,37,21,56
Cliftonville,8834,3,17,4,9,55,35,20,55
Ballymena,8834,4,15,5,10,62,62,0,50
Coleraine,8834,5,11,10,9,41,43,-2,43
Dungannon,8834,6,10,10,10,53,46,7,40
Glenavon,8834,7,9,13,8,50,46,4,40
Ards,8834,8,9,7,14,38,51,-13,34
Glentoran,8834,9,8,7,15,32,46,-14,31
Portadown,8834,10,8,5,17,24,50,-26,29
Ballinamalla,8834,11,4,5,21,27,60,-33,17
Crusaders,8835,1,17,9,4,60,35,25,60
Cliftonville,8835,2,14,6,10,53,42,11,48
Ballymena,8835,3,13,9,8,59,52,7,48
Coleraine,8835,4,11,13,6,34,30,4,46
Glenavon,8835,5,12,8,10,54,49,5,44
Linfield,8835,6,11,10,9,53,39,14,43
Ards,8835,7,11,5,14,45,49,-4,38
Dungannon,8835,8,10,7,13,47,49,-2,37
Glentoran,8835,9,7,10,13,28,45,-17,31
Portadown,8835,10,8,5,17,27,52,-25,29
Ballinamalla,8835,11,8,4,18,36,54,-18,28
Linfield,8836,1,16,10,4,63,31,32,58
Cliftonville,8836,2,16,5,9,57,36,21,53
Glenavon,8836,3,12,12,6,50,44,6,48
Crusaders,8836,4,12,9,9,47,35,12,45
Dungannon,8836,5,12,9,9,46,38,8,45
Ballymena,8836,6,11,8,11,52,61,-9,41
Coleraine,8836,7,9,12,9,39,41,-2,39
Glentoran,8836,8,8,9,13,30,45,-15,33
Ards,8836,9,8,6,16,35,49,-14,30
Portadown,8836,10,6,10,14,22,39,-17,28
Ballinamalla,8836,11,6,8,16,33,55,-22,26
Crusaders,8837,1,18,5,7,57,30,27,59
Linfield,8837,2,15,10,5,56,27,29,55
Glenavon,8837,3,15,8,7,48,37,11,53
Cliftonville,8837,4,16,4,10,50,38,12,52
Ballymena,8837,5,12,8,10,54,58,-4,44
Dungannon,8837,6,10,9,11,47,42,5,39
Coleraine,8837,7,9,9,12,41,43,-2,36
Ards,8837,8,10,4,16,37,52,-15,34
Glentoran,8837,9,7,8,15,25,45,-20,29
Ballinamalla,8837,10,9,2,19,28,52,-24,29
Portadown,8837,11,7,7,16,25,44,-19,28
Crusaders,8838,1,19,8,3,65,32,33,65
Cliftonville,8838,2,16,7,7,49,34,15,55
Ballymena,8838,3,15,6,9,57,51,6,51
Linfield,8838,4,14,8,8,58,36,22,50
Glenavon,8838,5,12,11,7,53,48,5,47
Coleraine,8838,6,10,11,9,38,37,1,41
Glentoran,8838,7,9,11,10,33,40,-7,38
Ards,8838,8,9,7,14,44,51,-7,34
Ballinamalla,8838,9,7,3,20,31,64,-33,24
Dungannon,8838,10,4,11,15,46,57,-11,23
Portadown,8838,11,6,5,19,25,49,-24,23
Cliftonville,8839,1,20,4,6,59,31,28,64
Crusaders,8839,2,14,8,8,51,36,15,50
Linfield,8839,3,13,9,8,49,30,19,48
Glenavon,8839,4,10,13,7,49,49,0,43
Dungannon,8839,5,11,9,10,50,40,10,42
Ballymena,8839,6,13,3,14,55,55,0,42
Portadown,8839,7,12,4,14,31,46,-15,40
Coleraine,8839,8,9,10,11,43,43,0,37
Glentoran,8839,9,9,10,11,35,44,-9,37
Ards,8839,10,8,8,14,32,47,-15,32
Ballinamalla,8839,11,4,6,20,25,58,-33,18
Crusaders,8840,1,20,6,4,66,30,36,66
Ballymena,8840,2,17,4,9,57,53,4,55
Cliftonville,8840,3,15,6,9,51,29,22,51
Linfield,8840,4,13,7,10,52,42,10,46
Glenavon,8840,5,11,11,8,46,44,2,44
Coleraine,8840,6,11,9,10,37,37,0,42
Ards,8840,7,10,8,12,47,46,1,38
Dungannon,8840,8,9,9,12,44,44,0,36
Portadown,8840,9,7,6,17,24,47,-23,27
Glentoran,8840,10,6,8,16,25,51,-26,26
Ballinamalla,8840,11,6,6,18,27,53,-26,24
Crusaders,8841,1,17,6,7,56,39,17,57
Glenavon,8841,2,15,9,6,54,41,13,54
Linfield,8841,3,14,11,5,52,29,23,53
Cliftonville,8841,4,16,5,9,49,40,9,53
Ballymena,8841,5,12,6,12,64,59,5,42
Coleraine,8841,6,10,12,8,39,34,5,42
Dungannon,8841,7,10,9,11,53,46,7,39
Glentoran,8841,8,8,9,13,36,47,-11,33
Ards,8841,9,8,7,15,38,50,-12,31
Portadown,8841,10,6,8,16,21,45,-24,26
Ballinamalla,8841,11,5,6,19,26,58,-32,21
Crusaders,8842,1,19,7,4,60,31,29,64
Linfield,8842,2,13,11,6,54,24,30,50
Cliftonville,8842,3,15,5,10,52,44,8,50
Ballymena,8842,4,12,8,10,59,58,1,44
Glenavon,8842,5,10,11,9,42,52,-10,41
Glentoran,8842,6,12,4,14,38,46,-8,40
Dungannon,8842,7,9,12,9,51,46,5,39
Coleraine,8842,8,10,9,11,41,39,2,39
Ards,8842,9,9,6,15,39,47,-8,33
Portadown,8842,10,7,8,15,31,50,-19,29
Ballinamalla,8842,11,5,7,18,25,55,-30,22
Crusaders,8843,1,16,6,8,53,38,15,54
Cliftonville,8843,2,15,7,8,57,43,14,52
Ballymena,8843,3,14,6,10,59,54,5,48
Linfield,8843,4,11,13,6,56,32,24,46
Coleraine,8843,5,10,12,8,46,43,3,42
Portadown,8843,6,12,5,13,37,42,-5,41
Glenavon,8843,7,9,11,10,45,46,-1,38
Ballinamalla,8843,8,11,3,16,33,51,-18,36
Glentoran,8843,9,8,9,13,28,45,-17,33
Dungannon,8843,10,8,8,14,42,48,-6,32
Ards,8843,11,7,8,15,34,48,-14,29
Linfield,8844,1,16,8,6,64,31,33,56
Crusaders,8844,2,17,5,8,49,29,20,56
Ballymena,8844,3,16,5,9,60,52,8,53
Glenavon,8844,4,14,10,6,49,39,10,52
Cliftonville,8844,5,14,4,12,51,47,4,46
Coleraine,8844,6,11,10,9,39,33,6,43
Dungannon,8844,7,11,9,10,48,39,9,42
Glentoran,8844,8,9,9,12,24,38,-14,36
Ards,8844,9,7,6,17,34,52,-18,27
Ballinamalla,8844,10,8,2,20,31,53,-22,26
Portadown,8844,11,5,6,19,16,52,-36,21
Cliftonville,8845,1,18,3,9,69,41,28,57
Linfield,8845,2,15,9,6,61,31,30,54
Crusaders,8845,3,14,8,8,53,38,15,50
Coleraine,8845,4,12,13,5,45,40,5,49
Ballymena,8845,5,13,7,10,56,63,-7,46
Glenavon,8845,6,10,12,8,48,46,2,42
Dungannon,8845,7,10,6,14,46,47,-1,36
Ards,8845,8,10,4,16,38,47,-9,34
Portadown,8845,9,9,7,14,28,45,-17,34
Glentoran,8845,10,6,11,13,25,40,-15,29
Ballinamalla,8845,11,6,4,20,24,55,-31,22
Crusaders,8846,1,17,8,5,53,33,20,59
Linfield,8846,2,13,12,5,60,34,26,51
Glenavon,8846,3,13,12,5,54,40,14,51
Cliftonville,8846,4,14,8,8,61,42,19,50
Ballymena,8846,5,12,11,7,61,61,0,47
Coleraine,8846,6,9,10,11,35,41,-6,37
Dungannon,8846,7,8,11,11,47,48,-1,35
Ards,8846,8,8,6,16,37,51,-14,30
Portadown,8846,9,8,6,16,30,48,-18,30
Ballinamalla,8846,10,8,6,16,39,58,-19,30
Glentoran,8846,11,6,8,16,30,51,-21,26
Linfield,8847,1,17,8,5,68,34,34,59
Cliftonville,8847,2,17,7,6,59,35,24,58
Crusaders,8847,3,16,7,7,62,43,19,55
Ballymena,8847,4,15,6,9,61,54,7,51
Coleraine,8847,5,12,9,9,41,37,4,45
Glenavon,8847,6,10,10,10,51,53,-2,40
Ards,8847,7,12,3,15,40,45,-5,39
Dungannon,8847,8,8,9,13,49,51,-2,33
Glentoran,8847,9,8,6,16,28,46,-18,30
Ballinamalla,8847,10,7,4,19,26,54,-28,25
Portadown,8847,11,7,3,20,23,56,-33,24
Crusaders,8848,1,17,6,7,57,41,16,57
Cliftonville,8848,2,16,4,10,58,35,23,52
Linfield,8848,3,14,8,8,60,29,31,50
Ballymena,8848,4,14,7,9,53,58,-5,49
Coleraine,8848,5,10,11,9,44,44,0,41
Dungannon,8848,6,11,7,12,51,42,9,40
Ards,8848,7,12,4,14,42,44,-2,40
Glenavon,8848,8,10,9,11,45,53,-8,39
Glentoran,8848,9,9,8,13,35,48,-13,35
Portadown,8848,10,8,8,14,24,42,-18,32
Ballinamalla,8848,11,6,4,20,22,55,-33,22
Ballymena,8849,1,17,6,7,69,52,17,57
Crusaders,8849,2,15,11,4,52,30,22,56
Linfield,8849,3,15,10,5,59,34,25,55
Glenavon,8849,4,14,8,8,57,44,13,50
Cliftonville,8849,5,15,5,10,49,38,11,50
Coleraine,8849,6,9,8,13,38,43,-5,35
Dungannon,8849,7,8,10,12,51,48,3,34
Ballinamalla,8849,8,9,4,17,25,49,-24,31
Portadown,8849,9,8,6,16,30,49,-19,30
Ards,8849,10,8,5,17,34,56,-22,29
Glentoran,8849,11,6,9,15,24,45,-21,27
Crusaders,8850,1,16,9,5,55,32,23,57
Linfield,8850,2,15,11,4,60,28,32,56
Cliftonville,8850,3,16,5,9,59,40,19,53
Ballymena,8850,4,15,6,9,59,56,3,51
Dungannon,8850,5,12,9,9,53,40,13,45
Coleraine,8850,6,9,12,9,45,42,3,39
Glentoran,8850,7,9,8,13,26,39,-13,35
Glenavon,8850,8,7,13,10,39,49,-10,34
Ards,8850,9,9,5,16,42,56,-14,32
Portadown,8850,10,8,5,17,28,49,-21,29
Ballinamalla,8850,11,5,5,20,24,59,-35,20
Crusaders,8851,1,20,4,6,67,36,31,64
Linfield,8851,2,12,12,6,62,36,26,48
Cliftonville,8851,3,14,5,11,53,46,7,47
Dungannon,8851,4,12,9,9,56,41,15,45
Ballymena,8851,5,12,7,11,49,59,-10,43
Coleraine,8851,6,10,8,12,50,46,4,38
Glenavon,8851,7,9,11,10,51,56,-5,38
Ards,8851,8,10,7,13,40,49,-9,37
Glentoran,8851,9,10,6,14,29,49,-20,36
Ballinamalla,8851,10,10,5,15,33,46,-13,35
Portadown,8851,11,5,8,17,23,49,-26,23
Crusaders,8852,1,16,9,5,53,35,18,57
Linfield,8852,2,15,9,6,57,28,29,54
Cliftonville,8852,3,15,6,9,56,37,19,51
Glenavon,8852,4,12,13,5,46,36,10,49
Ballymena,8852,5,14,5,11,56,56,0,47
Dungannon,8852,6,9,11,10,43,41,2,38
Coleraine,8852,7,8,11,11,33,41,-8,35
Ards,8852,8,9,6,15,48,50,-2,33
Portadown,8852,9,8,7,15,29,46,-17,31
Glentoran,8852,10,6,9,15,29,51,-22,27
Ballinamalla,8852,11,7,6,17,30,59,-29,27
Crusaders,8853,1,16,7,7,52,36,16,55
Linfield,8853,2,15,9,6,60,35,25,54
Coleraine,8853,3,15,9,6,47,31,16,54
Cliftonville,8853,4,15,5,10,49,37,12,50
Ballymena,8853,5,14,5,11,65,59,6,47
Glenavon,8853,6,12,10,8,43,41,2,46
Dungannon,8853,7,12,8,10,52,41,11,44
Ballinamalla,8853,8,8,5,17,30,50,-20,29
Ards,8853,9,6,8,16,36,55,-19,26
Portadown,8853,10,7,5,18,23,50,-27,26
Glentoran,8853,11,5,9,16,28,50,-22,24
Linfield,8854,1,17,7,6,65,30,35,58
Coleraine,8854,2,15,8,7,53,39,14,53
Crusaders,8854,3,14,9,7,53,37,16,51
Cliftonville,8854,4,15,5,10,56,45,11,50
Glenavon,8854,5,12,10,8,47,48,-1,46
Ballinamalla,8854,6,11,3,16,38,46,-8,36
Glentoran,8854,7,9,9,12,36,46,-10,36
Portadown,8854,8,10,5,15,30,42,-12,35
Ballymena,8854,9,10,5,15,49,63,-14,35
Dungannon,8854,10,7,9,14,43,49,-6,30
Ards,8854,11,7,6,17,29,54,-25,27
Crusaders,8855,1,16,9,5,60,31,29,57
Linfield,8855,2,15,9,6,57,31,26,54
Coleraine,8855,3,11,14,5,42,32,10,47
Cliftonville,8855,4,13,7,10,45,37,8,46
Ballymena,8855,5,12,9,9,53,55,-2,45
Glenavon,8855,6,11,10,9,40,43,-3,43
Dungannon,8855,7,9,10,11,45,40,5,37
Glentoran,8855,8,9,8,13,29,44,-15,35
Ballinamalla,8855,9,8,5,17,26,46,-20,29
Ards,8855,10,6,9,15,33,48,-15,27
Portadown,8855,11,6,8,16,24,47,-23,26
Crusaders,8856,1,15,9,6,57,37,20,54
Glenavon,8856,2,14,8,8,50,44,6,50
Linfield,8856,3,12,12,6,56,42,14,48
Ballymena,8856,4,13,8,9,59,55,4,47
Cliftonville,8856,5,13,5,12,48,41,7,44
Glentoran,8856,6,11,8,11,42,44,-2,41
Ards,8856,7,11,6,13,39,47,-8,39
Dungannon,8856,8,9,11,10,53,49,4,38
Coleraine,8856,9,9,10,11,38,43,-5,37
Ballinamalla,8856,10,10,2,18,31,50,-19,32
Portadown,8856,11,5,7,18,23,44,-21,22
Ballymena,8857,1,15,8,7,71,49,22,53
Linfield,8857,2,14,9,7,57,32,25,51
Cliftonville,8857,3,14,6,10,46,35,11,48
Crusaders,8857,4,13,7,10,52,42,10,46
Dungannon,8857,5,13,7,10,53,46,7,46
Coleraine,8857,6,11,9,10,42,40,2,42
Glenavon,8857,7,10,11,9,50,59,-9,41
Ards,8857,8,11,5,14,38,48,-10,38
Ballinamalla,8857,9,10,2,18,35,48,-13,32
Portadown,8857,10,8,6,16,29,52,-23,30
Glentoran,8857,11,7,8,15,27,49,-22,29
Linfield,8858,1,15,8,7,63,33,30,53
Glenavon,8858,2,14,11,5,52,40,12,53
Cliftonville,8858,3,14,7,9,56,43,13,49
Dungannon,8858,4,12,10,8,60,45,15,46
Crusaders,8858,5,13,7,10,45,39,6,46
Ballymena,8858,6,12,10,8,58,58,0,46
Coleraine,8858,7,9,14,7,47,43,4,41
Portadown,8858,8,10,6,14,34,45,-11,36
Glentoran,8858,9,8,9,13,22,37,-15,33
Ballinamalla,8858,10,8,2,20,27,56,-29,26
Ards,8858,11,6,4,20,29,54,-25,22
Linfield,8859,1,16,8,6,54,26,28,56
Crusaders,8859,2,16,7,7,60,36,24,55
Ballymena,8859,3,15,6,9,61,55,6,51
Glenavon,8859,4,13,10,7,57,47,10,49
Coleraine,8859,5,12,10,8,47,39,8,46
Cliftonville,8859,6,13,5,12,45,43,2,44
Dungannon,8859,7,10,9,11,50,47,3,39
Ards,8859,8,8,7,15,33,49,-16,31
Portadown,8859,9,7,8,15,29,48,-19,29
Glentoran,8859,10,7,7,16,30,51,-21,28
Ballinamalla,8859,11,8,3,19,25,50,-25,27
Crusaders,8860,1,19,7,4,60,31,29,64
Ballymena,8860,2,16,7,7,59,49,10,55
Linfield,8860,3,13,9,8,57,36,21,48
Coleraine,8860,4,13,8,9,48,38,10,47
Glenavon,8860,5,12,9,9,46,49,-3,45
Cliftonville,8860,6,13,4,13,47,47,0,43
Dungannon,8860,7,10,10,10,49,43,6,40
Glentoran,8860,8,11,6,13,33,37,-4,39
Ards,8860,9,7,5,18,34,52,-18,26
Ballinamalla,8860,10,7,5,18,35,62,-27,26
Portadown,8860,11,7,4,19,22,46,-24,25
Crusaders,8861,1,16,11,3,59,35,24,59
Cliftonville,8861,2,16,8,6,52,30,22,56
Linfield,8861,3,15,8,7,65,35,30,53
Glenavon,8861,4,13,10,7,53,40,13,49
Coleraine,8861,5,11,9,10,42,41,1,42
Ballymena,8861,6,12,4,14,53,62,-9,40
Glentoran,8861,7,8,10,12,27,44,-17,34
Ards,8861,8,10,2,18,35,51,-16,32
Portadown,8861,9,9,5,16,28,54,-26,32
Dungannon,8861,10,8,7,15,48,48,0,31
Ballinamalla,8861,11,8,4,18,34,56,-22,28
Linfield,8862,1,16,9,5,66,28,38,57
Ballymena,8862,2,15,8,7,64,53,11,53
Crusaders,8862,3,15,7,8,48,31,17,52
Glenavon,8862,4,13,8,9,40,40,0,47
Coleraine,8862,5,11,12,7,45,39,6,45
Cliftonville,8862,6,11,9,10,42,40,2,42
Dungannon,8862,7,9,9,12,41,42,-1,36
Glentoran,8862,8,9,9,12,31,42,-11,36
Ballinamalla,8862,9,9,3,18,32,51,-19,30
Portadown,8862,10,7,8,15,27,47,-20,29
Ards,8862,11,7,4,19,29,52,-23,25
Cliftonville,8863,1,20,3,7,60,29,31,63
Crusaders,8863,2,14,9,7,54,37,17,51
Linfield,8863,3,13,10,7,60,36,24,49
Ballymena,8863,4,14,5,11,64,63,1,47
Coleraine,8863,5,12,10,8,38,37,1,46
Ballinamalla,8863,6,11,4,15,28,41,-13,37
Dungannon,8863,7,9,9,12,50,54,-4,36
Glenavon,8863,8,7,14,9,40,45,-5,35
Ards,8863,9,9,7,14,35,47,-12,34
Glentoran,8863,10,8,7,15,27,44,-17,31
Portadown,8863,11,6,6,18,23,46,-23,24
Crusaders,8864,1,19,8,3,64,30,34,65
Ballymena,8864,2,16,6,8,65,61,4,54
Linfield,8864,3,14,9,7,65,39,26,51
Cliftonville,8864,4,15,6,9,57,42,15,51
Coleraine,8864,5,11,11,8,46,42,4,44
Glenavon,8864,6,10,12,8,45,44,1,42
Glentoran,8864,7,9,10,11,34,42,-8,37
Dungannon,8864,8,8,11,11,44,46,-2,35
Ards,8864,9,6,7,17,33,50,-17,25
Portadown,8864,10,5,8,17,21,49,-28,23
Ballinamalla,8864,11,6,4,20,24,53,-29,22
Ballymena,8865,1,17,5,8,58,49,9,56
Crusaders,8865,2,16,7,7,50,35,15,55
Linfield,8865,3,13,11,6,59,28,31,50
Coleraine,8865,4,13,10,7,47,42,5,49
Glenavon,8865,5,12,8,10,55,47,8,44
Cliftonville,8865,6,12,5,13,45,45,0,41
Dungannon,8865,7,8,11,11,41,42,-1,35
Portadown,8865,8,8,8,14,27,44,-17,32
Ards,8865,9,8,7,15,31,46,-15,31
Glentoran,8865,10,7,9,14,26,41,-15,30
Ballinamalla,8865,11,7,7,16,31,51,-20,28
Cliftonville,8866,1,17,3,10,56,37,19,54
Linfield,8866,2,14,11,5,56,29,27,53
Glenavon,8866,3,14,8,8,45,39,6,50
Coleraine,8866,4,12,9,9,40,37,3,45
Ballymena,8866,5,13,5,12,51,59,-8,44
Crusaders,8866,6,12,7,11,47,38,9,43
Dungannon,8866,7,11,8,11,53,45,8,41
Glentoran,8866,8,10,8,12,32,45,-13,38
Ards,8866,9,11,4,15,36,43,-7,37
Portadown,8866,10,8,4,18,28,48,-20,28
Ballinamalla,8866,11,8,3,19,30,54,-24,27
Crusaders,8867,1,17,7,6,63,40,23,58
Linfield,8867,2,14,11,5,58,31,27,53
Coleraine,8867,3,12,10,8,43,42,1,46
Cliftonville,8867,4,13,6,11,50,46,4,45
Ballymena,8867,5,12,9,9,61,60,1,45
Glenavon,8867,6,11,10,9,49,44,5,43
Ards,8867,7,12,4,14,41,46,-5,40
Dungannon,8867,8,9,8,13,49,50,-1,35
Glentoran,8867,9,9,8,13,36,46,-10,35
Ballinamalla,8867,10,8,4,18,35,54,-19,28
Portadown,8867,11,7,5,18,26,52,-26,26
Cliftonville,8868,1,17,7,6,54,30,24,58
Linfield,8868,2,14,9,7,58,38,20,51
Crusaders,8868,3,14,6,10,57,45,12,48
Coleraine,8868,4,12,11,7,43,37,6,47
Dungannon,8868,5,12,8,10,55,48,7,44
Ballymena,8868,6,12,6,12,53,57,-4,42
Glentoran,8868,7,11,8,11,39,43,-4,41
Glenavon,8868,8,10,8,12,41,50,-9,38
Ballinamalla,8868,9,11,3,16,40,49,-9,36
Portadown,8868,10,6,7,17,25,48,-23,25
Ards,8868,11,5,9,16,34,54,-20,24
Ballymena,8869,1,16,6,8,61,59,2,54
Cliftonville,8869,2,16,5,9,53,39,14,53
Crusaders,8869,3,15,8,7,55,43,12,53
Linfield,8869,4,14,9,7,64,32,32,51
Glenavon,8869,5,13,9,8,57,42,15,48
Dungannon,8869,6,12,9,9,55,42,13,45
Coleraine,8869,7,10,10,10,38,40,-2,40
Ballinamalla,8869,8,9,6,15,33,50,-17,33
Glentoran,8869,9,7,9,14,39,54,-15,30
Portadown,8869,10,7,3,20,26,52,-26,24
Ards,8869,11,6,6,18,33,61,-28,24
Linfield,8870,1,17,9,4,65,26,39,60
Cliftonville,8870,2,15,4,11,50,38,12,49
Crusaders,8870,3,12,12,6,44,32,12,48
Coleraine,8870,4,12,12,6,45,38,7,48
Ballymena,8870,5,11,10,9,49,51,-2,43
Dungannon,8870,6,10,9,11,51,43,8,39
Glenavon,8870,7,9,12,9,43,48,-5,39
Portadown,8870,8,11,4,15,33,44,-11,37
Ards,8870,9,9,6,15,39,54,-15,33
Ballinamalla,8870,10,8,5,17,25,47,-22,29
Glentoran,8870,11,5,9,16,25,48,-23,24
Crusaders,8871,1,16,7,7,54,31,23,55
Linfield,8871,2,15,9,6,60,32,28,54
Glenavon,8871,3,11,13,6,43,42,1,46
Cliftonville,8871,4,12,8,10,51,44,7,44
Coleraine,8871,5,11,11,8,43,36,7,44
Ballymena,8871,6,13,5,12,55,60,-5,44
Dungannon,8871,7,10,9,11,54,45,9,39
Portadown,8871,8,10,7,13,30,41,-11,37
Glentoran,8871,9,10,5,15,26,40,-14,35
Ballinamalla,8871,10,8,5,17,28,50,-22,29
Ards,8871,11,7,5,18,32,55,-23,26
Linfield,8872,1,17,7,6,56,26,30,58
Crusaders,8872,2,16,5,9,56,33,23,53
Ballymena,8872,3,14,6,10,54,49,5,48
Cliftonville,8872,4,14,4,12,51,43,8,46
Coleraine,8872,5,11,9,10,40,44,-4,42
Dungannon,8872,6,8,12,10,47,46,1,36
Portadown,8872,7,10,6,14,25,37,-12,36
Ballinamalla,8872,8,10,5,15,33,44,-11,35
Ards,8872,9,10,5,15,33,46,-13,35
Glenavon,8872,10,8,10,12,34,46,-12,34
Glentoran,8872,11,9,7,14,31,46,-15,34
Cliftonville,8873,1,14,10,6,51,35,16,52
Crusaders,8873,2,14,10,6,52,38,14,52
Linfield,8873,3,13,10,7,51,27,24,49
Ballymena,8873,4,13,8,9,58,55,3,47
Coleraine,8873,5,11,10,9,48,40,8,43
Glenavon,8873,6,10,12,8,42,40,2,42
Ards,8873,7,12,5,13,42,48,-6,41
Dungannon,8873,8,10,10,10,47,38,9,40
Glentoran,8873,9,7,9,14,27,51,-24,30
Ballinamalla,8873,10,8,3,19,31,51,-20,27
Portadown,8873,11,6,7,17,22,48,-26,25
Cliftonville,8874,1,16,5,9,54,38,16,53
Linfield,8874,2,13,12,5,59,31,28,51
Glenavon,8874,3,14,9,7,51,38,13,51
Ballymena,8874,4,13,9,8,55,59,-4,48
Crusaders,8874,5,13,7,10,46,33,13,46
Dungannon,8874,6,12,8,10,48,42,6,44
Coleraine,8874,7,11,10,9,40,39,1,43
Glentoran,8874,8,9,9,12,31,43,-12,36
Ards,8874,9,10,3,17,37,46,-9,33
Ballinamalla,8874,10,7,5,18,26,51,-25,26
Portadown,8874,11,6,5,19,21,48,-27,23
Crusaders,8875,1,20,4,6,51,21,30,64
Ballymena,8875,2,14,7,9,61,56,5,49
Glenavon,8875,3,11,13,6,54,51,3,46
Linfield,8875,4,11,10,9,52,35,17,43
Glentoran,8875,5,11,10,9,30,34,-4,43
Coleraine,8875,6,9,13,8,44,41,3,40
Ards,8875,7,12,4,14,38,46,-8,40
Dungannon,8875,8,9,10,11,48,46,2,37
Cliftonville,8875,9,11,4,15,51,52,-1,37
Portadown,8875,10,8,5,17,25,47,-22,29
Ballinamalla,8875,11,6,6,18,26,51,-25,24
Cliftonville,8876,1,18,5,7,55,33,22,59
Crusaders,8876,2,13,12,5,52,36,16,51
Glenavon,8876,3,13,11,6,48,39,9,50
Linfield,8876,4,12,10,8,48,30,18,46
Ballymena,8876,5,11,8,11,56,64,-8,41
Coleraine,8876,6,9,11,10,37,38,-1,38
Glentoran,8876,7,10,7,13,36,43,-7,37
Dungannon,8876,8,7,11,12,44,44,0,32
Portadown,8876,9,9,5,16,22,39,-17,32
Ards,8876,10,8,7,15,36,48,-12,31
Ballinamalla,8876,11,8,7,15,27,47,-20,31
Crusaders,8877,1,19,5,6,62,36,26,62
Linfield,8877,2,13,12,5,56,36,20,51
Glenavon,8877,3,12,11,7,46,40,6,47
Ballymena,8877,4,14,5,11,55,61,-6,47
Cliftonville,8877,5,13,4,13,53,45,8,43
Dungannon,8877,6,10,8,12,50,44,6,38
Coleraine,8877,7,8,12,10,45,43,2,36
Portadown,8877,8,10,6,14,28,42,-14,36
Glentoran,8877,9,9,7,14,35,49,-14,34
Ballinamalla,8877,10,8,7,15,32,48,-16,31
Ards,8877,11,7,7,16,41,59,-18,28
Linfield,8878,1,17,6,7,58,27,31,57
Crusaders,8878,2,16,7,7,58,36,22,55
Coleraine,8878,3,14,10,6,44,31,13,52
Cliftonville,8878,4,14,5,11,51,41,10,47
Glenavon,8878,5,11,10,9,43,44,-1,43
Ballymena,8878,6,11,8,11,47,57,-10,41
Ards,8878,7,11,5,14,38,45,-7,38
Dungannon,8878,8,9,10,11,47,42,5,37
Glentoran,8878,9,9,6,15,27,42,-15,33
Ballinamalla,8878,10,8,5,17,29,51,-22,29
Portadown,8878,11,6,6,18,23,49,-26,24
Crusaders,8879,1,18,8,4,59,31,28,62
Linfield,8879,2,15,10,5,61,33,28,55
Cliftonville,8879,3,17,4,9,63,38,25,55
Glenavon,8879,4,14,10,6,50,38,12,52
Ballymena,8879,5,15,6,9,61,61,0,51
Dungannon,8879,6,9,12,9,49,43,6,39
Coleraine,8879,7,10,8,12,35,40,-5,38
Glentoran,8879,8,8,9,13,30,43,-13,33
Ards,8879,9,9,3,18,35,54,-19,30
Ballinamalla,8879,10,6,3,21,24,58,-34,21
Portadown,8879,11,5,5,20,24,52,-28,20
Crusaders,8880,1,19,5,6,53,32,21,62
Cliftonville,8880,2,16,6,8,52,39,13,54
Linfield,8880,3,15,7,8,61,33,28,52
Ballymena,8880,4,15,6,9,57,52,5,51
Coleraine,8880,5,12,9,9,42,37,5,45
Glenavon,8880,6,11,12,7,44,41,3,45
Dungannon,8880,7,11,8,11,51,40,11,41
Glentoran,8880,8,8,8,14,28,43,-15,32
Portadown,8880,9,8,6,16,24,41,-17,30
Ards,8880,10,8,5,17,37,51,-14,29
Ballinamalla,8880,11,5,2,23,22,62,-40,17
Linfield,8881,1,17,7,6,58,27,31,58
Crusaders,8881,2,14,10,6,52,35,17,52
Cliftonville,8881,3,15,6,9,54,41,13,51
Dungannon,8881,4,14,8,8,54,40,14,50
Coleraine,8881,5,12,8,10,36,33,3,44
Glenavon,8881,6,9,12,9,40,41,-1,39
Portadown,8881,7,11,4,15,27,42,-15,37
Ballymena,8881,8,10,6,14,52,66,-14,36
Ards,8881,9,8,7,15,39,52,-13,31
Glentoran,8881,10,8,6,16,23,42,-19,30
Ballinamalla,8881,11,8,4,18,33,49,-16,28
Crusaders,8882,1,18,5,7,50,30,20,59
Cliftonville,8882,2,18,4,8,59,34,25,58
Linfield,8882,3,14,8,8,57,36,21,50
Coleraine,8882,4,12,11,7,47,38,9,47
Glenavon,8882,5,11,12,7,48,40,8,45
Ballymena,8882,6,12,7,11,56,60,-4,43
Glentoran,8882,7,10,7,13,34,47,-13,37
Dungannon,8882,8,8,9,13,41,43,-2,33
Ards,8882,9,9,5,16,34,49,-15,32
Ballinamalla,8882,10,8,7,15,31,52,-21,31
Portadown,8882,11,5,5,20,26,54,-28,20
Crusaders,8883,1,17,6,7,62,37,25,57
Ballymena,8883,2,17,6,7,67,55,12,57
Linfield,8883,3,15,9,6,54,25,29,54
Cliftonville,8883,4,16,4,10,49,40,9,52
Coleraine,8883,5,10,13,7,49,41,8,43
Glenavon,8883,6,10,11,9,45,46,-1,41
Dungannon,8883,7,8,9,13,41,51,-10,33
Glentoran,8883,8,8,9,13,29,46,-17,33
Ballinamalla,8883,9,9,3,18,29,51,-22,30
Ards,8883,10,6,10,14,39,52,-13,28
Portadown,8883,11,7,4,19,25,45,-20,25
Crusaders,8884,1,15,8,7,59,38,21,53
Linfield,8884,2,13,12,5,53,29,24,51
Glenavon,8884,3,13,10,7,58,46,12,49
Ballymena,8884,4,14,6,10,56,60,-4,48
Cliftonville,8884,5,12,6,12,55,52,3,42
Dungannon,8884,6,9,13,8,48,40,8,40
Ards,8884,7,11,6,13,37,44,-7,39
Coleraine,8884,8,10,8,12,38,38,0,38
Glentoran,8884,9,10,7,13,33,43,-10,37
Ballinamalla,8884,10,9,4,17,34,56,-22,31
Portadown,8884,11,7,4,19,25,50,-25,25
Linfield,8885,1,18,7,5,65,30,35,61
Cliftonville,8885,2,16,5,9,53,37,16,53
Glenavon,8885,3,14,9,7,47,41,6,51
Crusaders,8885,4,14,8,8,56,41,15,50
Ballymena,8885,5,12,9,9,58,59,-1,45
Coleraine,8885,6,9,9,12,35,39,-4,36
Glentoran,8885,7,9,9,12,28,43,-15,36
Dungannon,8885,8,9,7,14,50,49,1,34
Ards,8885,9,9,6,15,36,50,-14,33
Portadown,8885,10,9,5,16,24,39,-15,32
Ballinamalla,8885,11,6,6,18,27,51,-24,24
Crusaders,8886,1,19,5,6,52,31,21,62
Glenavon,8886,2,15,10,5,50,38,12,55
Coleraine,8886,3,14,10,6,50,34,16,52
Linfield,8886,4,14,8,8,61,34,27,50
Cliftonville,8886,5,14,6,10,50,41,9,48
Ballymena,8886,6,13,6,11,54,53,1,45
Ards,8886,7,10,5,15,37,48,-11,35
Ballinamalla,8886,8,9,4,17,27,50,-23,31
Dungannon,8886,9,6,10,14,42,53,-11,28
Glentoran,8886,10,6,8,16,31,52,-21,26
Portadown,8886,11,6,6,18,33,53,-20,24
Crusaders,8887,1,17,7,6,56,33,23,58
Glenavon,8887,2,14,10,6,48,40,8,52
Linfield,8887,3,14,9,7,51,26,25,51
Cliftonville,8887,4,15,5,10,51,33,18,50
Ballymena,8887,5,13,9,8,51,52,-1,48
Dungannon,8887,6,12,8,10,55,41,14,44
Coleraine,8887,7,10,11,9,43,44,-1,41
Glentoran,8887,8,9,7,14,30,45,-15,34
Ards,8887,9,8,5,17,28,52,-24,29
Portadown,8887,10,7,6,17,28,47,-19,27
Ballinamalla,8887,11,6,3,21,26,54,-28,21
Cliftonville,8888,1,16,4,10,58,42,16,52
Linfield,8888,2,13,11,6,61,41,20,50
Crusaders,8888,3,14,8,8,57,41,16,50
Ballymena,8888,4,14,8,8,58,58,0,50
Glenavon,8888,5,13,9,8,50,43,7,48
Coleraine,8888,6,11,11,8,45,37,8,44
Dungannon,8888,7,10,9,11,57,51,6,39
Ards,8888,8,11,5,14,38,46,-8,38
Portadown,8888,9,8,5,17,28,54,-26,29
Ballinamalla,8888,10,7,6,17,29,49,-20,27
Glentoran,8888,11,6,8,16,27,46,-19,26
Crusaders,8889,1,17,7,6,57,34,23,58
Coleraine,8889,2,15,10,5,38,25,13,55
Cliftonville,8889,3,15,6,9,54,38,16,51
Ballymena,8889,4,14,6,10,57,56,1,48
Linfield,8889,5,12,10,8,55,33,22,46
Glenavon,8889,6,11,9,10,50,47,3,42
Dungannon,8889,7,9,10,11,54,45,9,37
Ards,8889,8,9,4,17,32,50,-18,31
Portadown,8889,9,7,9,14,29,49,-20,30
Glentoran,8889,10,7,8,15,32,54,-22,29
Ballinamalla,8889,11,7,5,18,29,56,-27,26
Crusaders,8890,1,17,8,5,54,36,18,59
Cliftonville,8890,2,16,5,9,56,42,14,53
Linfield,8890,3,13,12,5,67,35,32,51
Coleraine,8890,4,14,8,8,43,37,6,50
Ballymena,8890,5,14,7,9,61,57,4,49
Glenavon,8890,6,9,14,7,43,41,2,41
Dungannon,8890,7,9,11,10,52,45,7,38
Ards,8890,8,8,6,16,38,48,-10,30
Portadown,8890,9,7,7,16,22,46,-24,28
Ballinamalla,8890,10,6,7,17,25,52,-27,25
Glentoran,8890,11,5,9,16,26,48,-22,24
Crusaders,8891,1,18,9,3,61,33,28,63
Linfield,8891,2,14,12,4,55,30,25,54
Cliftonville,8891,3,15,5,10,50,38,12,50
Coleraine,8891,4,13,11,6,41,35,6,50
Ballymena,8891,5,13,9,8,56,49,7,48
Dungannon,8891,6,13,8,9,54,44,10,47
Glenavon,8891,7,7,11,12,42,50,-8,32
Ards,8891,8,8,4,18,30,46,-16,28
Glentoran,8891,9,7,7,16,28,48,-20,28
Ballinamalla,8891,10,7,5,18,23,48,-25,26
Portadown,8891,11,6,7,17,29,48,-19,25
Linfield,8892,1,17,9,4,63,28,35,60
Cliftonville,8892,2,16,4,10,55,41,14,52
Ballymena,8892,3,16,4,10,57,53,4,52
Crusaders,8892,4,14,9,7,52,36,16,51
Glenavon,8892,5,12,11,7,52,41,11,47
Dungannon,8892,6,11,9,10,47,44,3,42
Coleraine,8892,7,10,10,10,36,38,-2,40
Ards,8892,8,9,6,15,36,49,-13,33
Portadown,8892,9,8,5,17,24,43,-19,29
Glentoran,8892,10,5,9,16,22,44,-22,24
Ballinamalla,8892,11,6,6,18,30,57,-27,24
Linfield,8893,1,16,8,6,69,36,33,56
Crusaders,8893,2,15,7,8,52,36,16,52
Ballymena,8893,3,16,4,10,57,54,3,52
Dungannon,8893,4,13,7,10,61,45,16,46
Cliftonville,8893,5,14,4,12,51,40,11,46
Coleraine,8893,6,12,9,9,45,37,8,45
Glenavon,8893,7,11,8,11,41,49,-8,41
Ballinamalla,8893,8,10,3,17,32,52,-20,33
Glentoran,8893,9,8,8,14,26,44,-18,32
Portadown,8893,10,9,4,17,27,44,-17,31
Ards,8893,11,7,6,17,34,58,-24,27
Linfield,8894,1,19,8,3,68,27,41,65
Ballymena,8894,2,15,7,8,55,52,3,52
Crusaders,8894,3,13,8,9,52,37,15,47
Cliftonville,8894,4,13,5,12,45,39,6,44
Glenavon,8894,5,11,10,9,45,43,2,43
Coleraine,8894,6,10,12,8,39,35,4,42
Dungannon,8894,7,9,8,13,45,48,-3,35
Ballinamalla,8894,8,10,4,16,32,49,-17,34
Portadown,8894,9,10,4,16,25,45,-20,34
Glentoran,8894,10,8,8,14,32,47,-15,32
Ards,8894,11,7,6,17,30,46,-16,27
Crusaders,8895,1,18,8,4,60,31,29,62
Cliftonville,8895,2,15,6,9,57,36,21,51
Coleraine,8895,3,13,9,8,46,35,11,48
Ballymena,8895,4,14,6,10,57,58,-1,48
Linfield,8895,5,12,8,10,55,45,10,44
Dungannon,8895,6,8,12,10,46,40,6,36
Glenavon,8895,7,7,14,9,39,42,-3,35
Ards,8895,8,10,4,16,40,53,-13,34
Portadown,8895,9,9,6,15,30,46,-16,33
Glentoran,8895,10,9,6,15,29,50,-21,33
Ballinamalla,8895,11,7,7,16,29,52,-23,28
Crusaders,8896,1,16,9,5,55,30,25,57
Cliftonville,8896,2,16,7,7,54,37,17,55
Glenavon,8896,3,15,9,6,61,40,21,54
Linfield,8896,4,15,8,7,74,36,38,53
Ballymena,8896,5,13,5,12,57,63,-6,44
Coleraine,8896,6,10,13,7,41,43,-2,43
Dungannon,8896,7,8,12,10,49,50,-1,36
Glentoran,8896,8,7,12,11,30,38,-8,33
Portadown,8896,9,6,8,16,29,53,-24,26
Ards,8896,10,6,7,17,35,63,-28,25
Ballinamalla,8896,11,6,4,20,25,57,-32,22
Cliftonville,8897,1,19,5,6,61,35,26,62
Ballymena,8897,2,18,3,9,67,51,16,57
Linfield,8897,3,16,8,6,56,26,30,56
Crusaders,8897,4,16,8,6,57,37,20,56
Glenavon,8897,5,11,13,6,50,46,4,46
Coleraine,8897,6,8,12,10,39,40,-1,36
Dungannon,8897,7,8,11,11,45,43,2,35
Portadown,8897,8,9,4,17,23,43,-20,31
Ards,8897,9,8,6,16,32,45,-13,30
Ballinamalla,8897,10,7,5,18,26,54,-28,26
Glentoran,8897,11,4,7,19,22,58,-36,19
Cliftonville,8898,1,19,4,7,66,38,28,61
Linfield,8898,2,16,9,5,59,31,28,57
Crusaders,8898,3,12,13,5,49,31,18,49
Ballymena,8898,4,13,7,10,51,60,-9,46
Glentoran,8898,5,12,8,10,40,43,-3,44
Dungannon,8898,6,9,10,11,41,41,0,37
Coleraine,8898,7,9,9,12,40,48,-8,36
Glenavon,8898,8,8,11,11,38,44,-6,35
Ards,8898,9,9,7,14,38,45,-7,34
Ballinamalla,8898,10,9,3,18,33,51,-18,30
Portadown,8898,11,5,7,18,26,49,-23,22
Cliftonville,8899,1,16,7,7,60,44,16,55
Crusaders,8899,2,15,8,7,55,34,21,53
Coleraine,8899,3,13,9,8,47,38,9,48
Linfield,8899,4,12,11,7,58,36,22,47
Ballymena,8899,5,14,5,11,56,57,-1,47
Glenavon,8899,6,11,10,9,51,48,3,43
Dungannon,8899,7,9,10,11,46,47,-1,37
Glentoran,8899,8,8,9,13,33,48,-15,33
Portadown,8899,9,9,6,15,27,42,-15,33
Ballinamalla,8899,10,9,3,18,32,55,-23,30
Ards,8899,11,7,6,17,29,45,-16,27
Crusaders,8900,1,17,6,7,58,37,21,57
Cliftonville,8900,2,16,2,12,55,37,18,50
Linfield,8900,3,13,9,8,55,40,15,48
Ballymena,8900,4,13,6,11,53,57,-4,45
Ards,8900,5,12,6,12,41,44,-3,42
Glenavon,8900,6,11,8,11,44,49,-5,41
Dungannon,8900,7,11,7,12,54,46,8,40
Coleraine,8900,8,10,8,12,40,45,-5,38
Portadown,8900,9,10,4,16,27,42,-15,34
Ballinamalla,8900,10,10,4,16,33,52,-19,34
Glentoran,8900,11,9,6,15,31,42,-11,33
Linfield,8901,1,16,10,4,56,21,35,58
Crusaders,8901,2,14,7,9,49,37,12,49
Coleraine,8901,3,13,10,7,48,39,9,49
Glenavon,8901,4,11,13,6,47,42,5,46
Ballymena,8901,5,13,7,10,57,62,-5,46
Glentoran,8901,6,13,6,11,36,38,-2,45
Cliftonville,8901,7,13,5,12,52,42,10,44
Ards,8901,8,10,6,14,40,50,-10,36
Dungannon,8901,9,7,9,14,45,49,-4,30
Portadown,8901,10,8,4,18,20,41,-21,28
Ballinamalla,8901,11,7,3,20,29,58,-29,24
Crusaders,8902,1,17,6,7,55,31,24,57
Cliftonville,8902,2,16,5,9,49,35,14,53
Linfield,8902,3,13,10,7,51,31,20,49
Coleraine,8902,4,12,11,7,41,30,11,47
Dungannon,8902,5,12,8,10,48,41,7,44
Glenavon,8902,6,11,10,9,39,38,1,43
Ballymena,8902,7,11,7,12,47,55,-8,40
Portadown,8902,8,10,4,16,25,40,-15,34
Ards,8902,9,8,9,13,36,43,-7,33
Glentoran,8902,10,7,7,16,22,47,-25,28
Ballinamalla,8902,11,6,7,17,26,48,-22,25
Crusaders,8903,1,16,10,4,62,35,27,58
Linfield,8903,2,16,8,6,60,33,27,56
Cliftonville,8903,3,16,5,9,59,42,17,53
Ballymena,8903,4,15,4,11,56,57,-1,49
Coleraine,8903,5,11,9,10,42,37,5,42
Glenavon,8903,6,10,10,10,49,46,3,40
Glentoran,8903,7,10,8,12,39,48,-9,38
Dungannon,8903,8,8,12,10,46,45,1,36
Ballinamalla,8903,9,9,4,17,28,51,-23,31
Ards,8903,10,9,3,18,39,58,-19,30
Portadown,8903,11,6,5,19,22,50,-28,23
Ballymena,8904,1,16,6,8,65,51,14,54
Crusaders,8904,2,14,10,6,51,33,18,52
Coleraine,8904,3,12,11,7,40,33,7,47
Linfield,8904,4,12,10,8,55,32,23,46
Cliftonville,8904,5,13,7,10,53,41,12,46
Dungannon,8904,6,11,8,11,51,46,5,41
Ards,8904,7,11,6,13,42,49,-7,39
Ballinamalla,8904,8,11,5,14,33,47,-14,38
Glenavon,8904,9,8,11,11,37,44,-7,35
Glentoran,8904,10,9,7,14,25,43,-18,34
Portadown,8904,11,4,7,19,20,53,-33,19
Crusaders,8905,1,15,10,5,52,33,19,55
Linfield,8905,2,14,9,7,61,35,26,51
Cliftonville,8905,3,15,6,9,51,40,11,51
Coleraine,8905,4,13,11,6,46,34,12,50
Glenavon,8905,5,11,13,6,52,47,5,46
Dungannon,8905,6,12,8,10,58,47,11,44
Ballymena,8905,7,10,6,14,50,66,-16,36
Glentoran,8905,8,8,9,13,32,42,-10,33
Ards,8905,9,8,7,15,34,45,-11,31
Portadown,8905,10,6,10,14,27,43,-16,28
Ballinamalla,8905,11,7,3,20,27,58,-31,24
Cliftonville,8906,1,16,6,8,50,32,18,54
Crusaders,8906,2,14,7,9,54,37,17,49
Coleraine,8906,3,12,12,6,51,44,7,48
Dungannon,8906,4,11,10,9,46,36,10,43
Linfield,8906,5,10,12,8,43,33,10,42
Ards,8906,6,12,6,12,47,44,3,42
Ballymena,8906,7,11,7,12,50,55,-5,40
Glentoran,8906,8,11,6,13,32,42,-10,39
Glenavon,8906,9,7,15,8,43,44,-1,36
Ballinamalla,8906,10,10,5,15,32,53,-21,35
Portadown,8906,11,5,6,19,21,49,-28,21
Crusaders,8907,1,16,8,6,52,34,18,56
Ballymena,8907,2,16,6,8,62,58,4,54
Cliftonville,8907,3,16,5,9,54,36,18,53
Linfield,8907,4,13,11,6,63,36,27,50
Glenavon,8907,5,12,8,10,50,48,2,44
Dungannon,8907,6,11,7,12,54,52,2,40
Coleraine,8907,7,9,10,11,48,51,-3,37
Ballinamalla,8907,8,10,4,16,36,51,-15,34
Ards,8907,9,9,6,15,41,54,-13,33
Portadown,8907,10,7,7,16,29,49,-20,28
Glentoran,8907,11,6,8,16,30,50,-20,26
Crusaders,8908,1,18,6,6,63,34,29,60
Linfield,8908,2,14,10,6,58,30,28,52
Glenavon,8908,3,13,12,5,54,43,11,51
Coleraine,8908,4,12,9,9,45,40,5,45
Cliftonville,8908,5,12,7,11,46,43,3,43
Ballymena,8908,6,12,7,11,55,57,-2,43
Ards,8908,7,12,2,16,34,47,-13,38
Dungannon,8908,8,9,8,13,46,48,-2,35
Glentoran,8908,9,8,10,12,31,43,-12,34
Portadown,8908,10,7,7,16,23,42,-19,28
Ballinamalla,8908,11,6,6,18,27,55,-28,24
Crusaders,8909,1,18,9,3,54,24,30,63
Ballymena,8909,2,16,6,8,62,51,11,54
Linfield,8909,3,15,8,7,55,36,19,53
Cliftonville,8909,4,13,5,12,42,44,-2,44
Glenavon,8909,5,10,10,10,51,51,0,40
Ballinamalla,8909,6,12,3,15,41,49,-8,39
Dungannon,8909,7,9,11,10,49,41,8,38
Coleraine,8909,8,8,10,12,39,48,-9,34
Ards,8909,9,10,3,17,36,50,-14,33
Portadown,8909,10,9,4,17,27,45,-18,31
Glentoran,8909,11,8,5,17,25,42,-17,29
Crusaders,8910,1,19,9,2,60,26,34,66
Linfield,8910,2,14,8,8,63,35,28,50
Ballymena,8910,3,15,4,11,59,58,1,49
Coleraine,8910,4,13,8,9,40,40,0,47
Glenavon,8910,5,12,10,8,49,43,6,46
Cliftonville,8910,6,13,4,13,49,48,1,43
Dungannon,8910,7,10,9,11,45,42,3,39
Glentoran,8910,8,10,5,15,30,46,-16,35
Portadown,8910,9,9,5,16,28,48,-20,32
Ballinamalla,8910,10,9,4,17,34,48,-14,31
Ards,8910,11,6,4,20,32,55,-23,22
Linfield,8911,1,14,10,6,61,33,28,52
Cliftonville,8911,2,15,4,11,60,45,15,49
Ballymena,8911,3,15,4,11,62,61,1,49
Crusaders,8911,4,14,6,10,53,37,16,48
Dungannon,8911,5,13,9,8,51,38,13,48
Glenavon,8911,6,12,8,10,47,48,-1,44
Coleraine,8911,7,10,11,9,41,44,-3,41
Portadown,8911,8,11,4,15,31,44,-13,37
Glentoran,8911,9,9,6,15,35,52,-17,33
Ballinamalla,8911,10,8,7,15,32,53,-21,31
Ards,8911,11,6,7,17,31,49,-18,25
Crusaders,8912,1,17,9,4,64,30,34,60
Cliftonville,8912,2,16,6,8,56,42,14,54
Ballymena,8912,3,14,9,7,60,55,5,51
Linfield,8912,4,14,8,8,58,32,26,50
Dungannon,8912,5,11,9,10,50,40,10,42
Glenavon,8912,6,10,12,8,41,42,-1,42
Coleraine,8912,7,9,11,10,36,38,-2,38
Glentoran,8912,8,10,6,14,24,41,-17,36
Portadown,8912,9,8,4,18,21,44,-23,28
Ards,8912,10,7,5,18,31,54,-23,26
Ballinamalla,8912,11,6,7,17,27,50,-23,25
Crusaders,8913,1,16,11,3,53,29,24,59
Ballymena,8913,2,17,6,7,68,48,20,57
Linfield,8913,3,16,8,6,63,31,32,56
Cliftonville,8913,4,14,7,9,52,41,11,49
Glenavon,8913,5,11,12,7,49,43,6,45
Dungannon,8913,6,10,8,12,51,52,-1,38
Coleraine,8913,7,8,11,11,34,42,-8,35
Glentoran,8913,8,9,7,14,29,42,-13,34
Ards,8913,9,8,8,14,38,54,-16,32
Portadown,8913,10,8,4,18,27,50,-23,28
Ballinamalla,8913,11,4,6,20,28,60,-32,18
Cliftonville,8914,1,16,6,8,59,43,16,54
Crusaders,8914,2,15,8,7,59,39,20,53
Linfield,8914,3,13,11,6,63,33,30,50
Ballymena,8914,4,15,4,11,57,55,2,49
Coleraine,8914,5,12,11,7,40,33,7,47
Glenavon,8914,6,11,11,8,45,44,1,44
Dungannon,8914,7,11,9,10,48,42,6,42
Ballinamalla,8914,8,9,6,15,32,45,-13,33
Ards,8914,9,9,6,15,35,49,-14,33
Glentoran,8914,10,8,7,15,31,50,-19,31
Portadown,8914,11,5,3,22,21,57,-36,18
Cliftonville,8915,1,16,6,8,47,29,18,54
Ballymena,8915,2,16,5,9,62,56,6,53
Crusaders,8915,3,14,8,8,50,38,12,50
Linfield,8915,4,13,9,8,60,46,14,48
Glenavon,8915,5,12,9,9,52,49,3,45
Dungannon,8915,6,11,11,8,54,45,9,44
Ards,8915,7,12,5,13,40,43,-3,41
Coleraine,8915,8,9,9,12,38,45,-7,36
Portadown,8915,9,8,5,17,23,41,-18,29
Ballinamalla,8915,10,7,7,16,28,47,-19,28
Glentoran,8915,11,6,8,16,28,43,-15,26
Crusaders,8916,1,19,7,4,60,27,33,64
Ballymena,8916,2,16,5,9,62,57,5,53
Cliftonville,8916,3,14,5,11,54,46,8,47
Linfield,8916,4,12,9,9,58,42,16,45
Coleraine,8916,5,12,9,9,50,43,7,45
Glenavon,8916,6,10,12,8,47,50,-3,42
Ballinamalla,8916,7,11,5,14,43,54,-11,38
Ards,8916,8,11,4,15,42,47,-5,37
Dungannon,8916,9,9,7,14,45,44,1,34
Glentoran,8916,10,9,4,17,30,53,-23,31
Portadown,8916,11,5,7,18,27,55,-28,22
Linfield,8917,1,18,7,5,67,27,40,61
Crusaders,8917,2,17,7,6,59,35,24,58
Cliftonville,8917,3,15,7,8,48,36,12,52
Glenavon,8917,4,14,9,7,55,46,9,51
Ballymena,8917,5,13,4,13,54,68,-14,43
Coleraine,8917,6,9,13,8,45,42,3,40
Portadown,8917,7,11,6,13,29,33,-4,39
Dungannon,8917,8,8,7,15,47,51,-4,31
Ards,8917,9,8,6,16,35,50,-15,30
Glentoran,8917,10,7,6,17,25,52,-27,27
Ballinamalla,8917,11,7,4,19,29,53,-24,25
Crusaders,8918,1,17,7,6,52,37,15,58
Linfield,8918,2,15,8,7,58,28,30,53
Glenavon,8918,3,14,10,6,54,39,15,52
Cliftonville,8918,4,14,5,11,49,46,3,47
Coleraine,8918,5,11,10,9,45,38,7,43
Ballymena,8918,6,11,10,9,53,56,-3,43
Dungannon,8918,7,9,10,11,57,51,6,37
Ards,8918,8,10,4,16,35,49,-14,34
Portadown,8918,9,9,7,14,28,43,-15,34
Glentoran,8918,10,7,7,16,29,50,-21,28
Ballinamalla,8918,11,7,4,19,36,59,-23,25
Linfield,8919,1,17,8,5,54,25,29,59
Crusaders,8919,2,15,9,6,54,37,17,54
Coleraine,8919,3,13,12,5,45,31,14,51
Cliftonville,8919,4,15,4,11,54,41,13,49
Ballymena,8919,5,13,5,12,57,56,1,44
Ards,8919,6,10,6,14,32,41,-9,36
Glentoran,8919,7,9,8,13,28,42,-14,35
Dungannon,8919,8,7,11,12,45,43,2,32
Glenavon,8919,9,7,11,12,43,57,-14,32
Ballinamalla,8919,10,9,5,16,27,48,-21,32
Portadown,8919,11,8,5,17,31,49,-18,29
Cliftonville,8920,1,17,6,7,59,33,26,57
Crusaders,8920,2,16,9,5,58,35,23,57
Coleraine,8920,3,14,9,7,47,38,9,51
Linfield,8920,4,13,11,6,60,39,21,50
Ballymena,8920,5,15,5,10,57,57,0,50
Glenavon,8920,6,12,11,7,49,45,4,47
Dungannon,8920,7,10,7,13,52,50,2,37
Glentoran,8920,8,7,10,13,28,43,-15,31
Ards,8920,9,7,7,16,35,53,-18,28
Portadown,8920,10,5,7,18,33,54,-21,22
Ballinamalla,8920,11,6,4,20,30,61,-31,22
Crusaders,8921,1,20,6,4,63,21,42,66
Linfield,8921,2,15,8,7,63,37,26,53
Cliftonville,8921,3,15,3,12,55,43,12,48
Dungannon,8921,4,10,12,8,50,42,8,42
Coleraine,8921,5,10,11,9,36,38,-2,41
Ballymena,8921,6,11,5,14,54,64,-10,38
Glenavon,8921,7,8,12,10,40,51,-11,36
Portadown,8921,8,9,8,13,35,45,-10,35
Ards,8921,9,9,6,15,35,49,-14,33
Glentoran,8921,10,9,5,16,34,53,-19,32
Ballinamalla,8921,11,8,6,16,32,54,-22,30
Linfield,8922,1,13,12,5,54,30,24,51
Cliftonville,8922,2,15,6,9,52,41,11,51
Coleraine,8922,3,12,13,5,41,29,12,49
Crusaders,8922,4,14,7,9,55,44,11,49
Glenavon,8922,5,13,9,8,51,41,10,48
Ballymena,8922,6,14,6,10,55,53,2,48
Glentoran,8922,7,9,8,13,27,41,-14,35
Portadown,8922,8,9,6,15,21,38,-17,33
Ballinamalla,8922,9,9,5,16,34,53,-19,32
Dungannon,8922,10,8,7,15,45,45,0,31
Ards,8922,11,6,7,17,29,49,-20,25
Linfield,8923,1,15,8,7,54,29,25,53
Cliftonville,8923,2,15,6,9,51,37,14,51
Crusaders,8923,3,15,5,10,54,36,18,50
Coleraine,8923,4,13,9,8,43,33,10,48
Ballymena,8923,5,14,6,10,52,53,-1,48
Glenavon,8923,6,12,9,9,53,47,6,45
Portadown,8923,7,10,5,15,29,42,-13,35
Ards,8923,8,10,4,16,42,53,-11,34
Dungannon,8923,9,8,9,13,48,53,-5,33
Ballinamalla,8923,10,10,2,18,31,55,-24,32
Glentoran,8923,11,8,7,15,26,45,-19,31
Crusaders,8924,1,17,8,5,60,33,27,59
Ballymena,8924,2,18,5,7,70,49,21,59
Cliftonville,8924,3,15,5,10,47,40,7,50
Linfield,8924,4,12,9,9,60,46,14,45
Coleraine,8924,5,11,11,8,39,33,6,44
Dungannon,8924,6,9,11,10,52,52,0,38
Glenavon,8924,7,8,14,8,44,47,-3,38
Glentoran,8924,8,8,8,14,32,46,-14,32
Ballinamalla,8924,9,9,4,17,30,49,-19,31
Portadown,8924,10,9,4,17,33,53,-20,31
Ards,8924,11,7,5,18,37,56,-19,26
Crusaders,8925,1,16,6,8,60,40,20,54
Ballymena,8925,2,16,5,9,60,54,6,53
Linfield,8925,3,14,10,6,56,30,26,52
Cliftonville,8925,4,15,4,11,53,41,12,49
Glenavon,8925,5,12,10,8,48,41,7,46
Glentoran,8925,6,12,9,9,37,41,-4,45
Coleraine,8925,7,9,12,9,36,37,-1,39
Dungannon,8925,8,8,8,14,40,44,-4,32
Ballinamalla,8925,9,8,5,17,30,51,-21,29
Portadown,8925,10,7,8,15,24,46,-22,29
Ards,8925,11,6,7,17,30,49,-19,25
Linfield,8926,1,18,6,6,54,23,31,60
Cliftonville,8926,2,18,4,8,57,37,20,58
Crusaders,8926,3,15,7,8,52,33,19,52
Ballymena,8926,4,15,4,11,57,56,1,49
Glenavon,8926,5,13,9,8,51,43,8,48
Coleraine,8926,6,12,10,8,45,37,8,46
Glentoran,8926,7,8,7,15,31,47,-16,31
Ballinamalla,8926,8,8,7,15,34,51,-17,31
Dungannon,8926,9,7,9,14,44,50,-6,30
Portadown,8926,10,9,3,18,28,50,-22,30
Ards,8926,11,7,4,19,31,57,-26,25
Crusaders,8927,1,17,7,6,51,31,20,58
Linfield,8927,2,14,10,6,59,35,24,52
Glenavon,8927,3,13,10,7,46,39,7,49
Cliftonville,8927,4,15,3,12,50,38,12,48
Ballymena,8927,5,13,9,8,56,58,-2,48
Coleraine,8927,6,10,9,11,43,40,3,39
Dungannon,8927,7,7,14,9,44,39,5,35
Glentoran,8927,8,8,10,12,31,47,-16,34
Ballinamalla,8927,9,7,10,13,30,44,-14,31
Ards,8927,10,8,6,16,37,46,-9,30
Portadown,8927,11,6,6,18,20,50,-30,24
Coleraine,8928,1,14,12,4,47,28,19,54
Linfield,8928,2,14,11,5,67,35,32,53
Ballymena,8928,3,15,6,9,63,59,4,51
Crusaders,8928,4,14,7,9,53,39,14,49
Glenavon,8928,5,12,11,7,52,44,8,47
Cliftonville,8928,6,12,6,12,46,43,3,42
Dungannon,8928,7,9,8,13,45,51,-6,35
Glentoran,8928,8,7,13,10,26,38,-12,34
Ards,8928,9,10,3,17,34,51,-17,33
Portadown,8928,10,8,7,15,31,47,-16,31
Ballinamalla,8928,11,6,4,20,23,52,-29,22
Cliftonville,8929,1,16,5,9,56,37,19,53
Crusaders,8929,2,16,5,9,48,34,14,53
Coleraine,8929,3,13,9,8,44,41,3,48
Glenavon,8929,4,12,10,8,53,49,4,46
Linfield,8929,5,12,9,9,58,39,19,45
Dungannon,8929,6,12,8,10,50,40,10,44
Ballymena,8929,7,12,6,12,61,61,0,42
Glentoran,8929,8,10,7,13,34,43,-9,37
Ards,8929,9,11,4,15,36,51,-15,37
Portadown,8929,10,8,4,18,29,47,-18,28
Ballinamalla,8929,11,8,3,19,28,55,-27,27
Coleraine,8930,1,14,10,6,48,35,13,52
Crusaders,8930,2,15,6,9,57,46,11,51
Linfield,8930,3,14,8,8,55,33,22,50
Cliftonville,8930,4,15,5,10,56,36,20,50
Glenavon,8930,5,10,12,8,54,53,1,42
Ballymena,8930,6,11,7,12,55,59,-4,40
Ballinamalla,8930,7,12,3,15,41,53,-12,39
Dungannon,8930,8,10,8,12,52,43,9,38
Ards,8930,9,10,4,16,38,50,-12,34
Glentoran,8930,10,9,7,14,26,46,-20,34
Portadown,8930,11,8,4,18,25,53,-28,28
Linfield,8931,1,14,10,6,59,29,30,52
Crusaders,8931,2,13,8,9,51,39,12,47
Cliftonville,8931,3,14,5,11,49,40,9,47
Coleraine,8931,4,12,11,7,40,35,5,47
Ballymena,8931,5,14,5,11,60,67,-7,47
Dungannon,8931,6,11,11,8,53,38,15,44
Glenavon,8931,7,9,12,9,44,47,-3,39
Ballinamalla,8931,8,9,9,12,34,42,-8,36
Glentoran,8931,9,9,8,13,30,45,-15,35
Ards,8931,10,8,8,14,35,47,-12,32
Portadown,8931,11,6,5,19,25,51,-26,23
Crusaders,8932,1,17,6,7,58,35,23,57
Linfield,8932,2,15,10,5,58,28,30,55
Cliftonville,8932,3,16,5,9,46,32,14,53
Glenavon,8932,4,14,9,7,48,40,8,51
Ballymena,8932,5,14,8,8,55,46,9,50
Coleraine,8932,6,12,9,9,43,35,8,45
Dungannon,8932,7,8,8,14,49,51,-2,32
Ards,8932,8,9,5,16,34,49,-15,32
Ballinamalla,8932,9,7,9,14,33,50,-17,30
Portadown,8932,10,8,4,18,26,50,-24,28
Glentoran,8932,11,5,7,18,21,55,-34,22
Cliftonville,8933,1,21,3,6,62,34,28,66
Linfield,8933,2,16,8,6,66,35,31,56
Crusaders,8933,3,14,7,9,51,42,9,49
Ballymena,8933,4,12,6,12,49,61,-12,42
Glenavon,8933,5,10,10,10,55,60,-5,40
Coleraine,8933,6,9,11,10,41,41,0,38
Dungannon,8933,7,10,7,13,55,49,6,37
Ards,8933,8,8,10,12,39,45,-6,34
Glentoran,8933,9,8,8,14,33,41,-8,32
Ballinamalla,8933,10,9,5,16,37,55,-18,32
Portadown,8933,11,7,7,16,25,50,-25,28
Crusaders,8934,1,15,7,8,49,35,14,52
Linfield,8934,2,14,9,7,62,30,32,51
Cliftonville,8934,3,15,3,12,52,44,8,48
Dungannon,8934,4,13,8,9,50,40,10,47
Glenavon,8934,5,12,11,7,50,44,6,47
Ballymena,8934,6,13,8,9,56,63,-7,47
Coleraine,8934,7,10,12,8,53,40,13,42
Ards,8934,8,11,4,15,39,50,-11,37
Glentoran,8934,9,8,8,14,32,47,-15,32
Ballinamalla,8934,10,6,9,15,28,47,-19,27
Portadown,8934,11,7,3,20,24,55,-31,24
Crusaders,8935,1,17,8,5,55,30,25,59
Cliftonville,8935,2,17,4,9,57,38,19,55
Ballymena,8935,3,16,6,8,55,53,2,54
Coleraine,8935,4,11,12,7,41,37,4,45
Glenavon,8935,5,11,10,9,48,47,1,43
Linfield,8935,6,11,9,10,51,35,16,42
Dungannon,8935,7,9,9,12,48,45,3,36
Ards,8935,8,10,6,14,40,44,-4,36
Portadown,8935,9,10,4,16,26,43,-17,34
Glentoran,8935,10,9,5,16,26,45,-19,32
Ballinamalla,8935,11,6,3,21,26,56,-30,21
Crusaders,8936,1,17,7,6,57,33,24,58
Linfield,8936,2,16,9,5,62,31,31,57
Cliftonville,8936,3,16,5,9,54,40,14,53
Ballymena,8936,4,14,6,10,51,52,-1,48
Dungannon,8936,5,12,8,10,51,43,8,44
Coleraine,8936,6,11,10,9,43,36,7,43
Portadown,8936,7,11,4,15,30,39,-9,37
Glenavon,8936,8,8,9,13,46,54,-8,33
Glentoran,8936,9,7,8,15,31,52,-21,29
Ballinamalla,8936,10,8,4,18,33,55,-22,28
Ards,8936,11,7,6,17,33,56,-23,27
Linfield,8937,1,15,8,7,54,34,20,53
Ballymena,8937,2,16,5,9,57,56,1,53
Cliftonville,8937,3,15,6,9,59,36,23,51
Crusaders,8937,4,14,8,8,55,36,19,50
Coleraine,8937,5,10,11,9,41,39,2,41
Glenavon,8937,6,11,8,11,40,42,-2,41
Glentoran,8937,7,11,8,11,34,43,-9,41
Dungannon,8937,8,10,9,11,53,42,11,39
Ards,8937,9,8,7,15,34,50,-16,31
Ballinamalla,8937,10,8,6,16,30,52,-22,30
Portadown,8937,11,6,6,18,21,48,-27,24
Linfield,8938,1,17,8,5,66,36,30,59
Cliftonville,8938,2,17,6,7,61,35,26,57
Crusaders,8938,3,13,11,6,47,32,15,50
Coleraine,8938,4,13,7,10,45,40,5,46
Ballymena,8938,5,14,4,12,53,62,-9,46
Glenavon,8938,6,12,9,9,44,41,3,45
Dungannon,8938,7,9,11,10,53,47,6,38
Ards,8938,8,10,4,16,35,45,-10,34
Ballinamalla,8938,9,9,3,18,30,53,-23,30
Glentoran,8938,10,7,7,16,32,51,-19,28
Portadown,8938,11,5,8,17,25,49,-24,23
Crusaders,8939,1,16,8,6,53,33,20,56
Cliftonville,8939,2,16,5,9,50,39,11,53
Glenavon,8939,3,14,9,7,54,47,7,51
Coleraine,8939,4,13,10,7,47,37,10,49
Linfield,8939,5,12,11,7,53,33,20,47
Ballymena,8939,6,12,7,11,53,56,-3,43
Ards,8939,7,11,6,13,45,47,-2,39
Dungannon,8939,8,8,10,12,49,50,-1,34
Glentoran,8939,9,7,7,16,35,54,-19,28
Ballinamalla,8939,10,7,6,17,33,55,-22,27
Portadown,8939,11,7,5,18,28,49,-21,26
Crusaders,8940,1,18,8,4,59,29,30,62
Ballymena,8940,2,16,6,8,55,47,8,54
Cliftonville,8940,3,15,5,10,51,37,14,50
Linfield,8940,4,12,13,5,60,34,26,49
Coleraine,8940,5,9,11,10,46,43,3,38
Dungannon,8940,6,8,12,10,48,50,-2,36
Ards,8940,7,10,6,14,38,49,-11,36
Glenavon,8940,8,7,14,9,45,51,-6,35
Glentoran,8940,9,8,11,11,27,40,-13,35
Ballinamalla,8940,10,8,3,19,31,55,-24,27
Portadown,8940,11,6,7,17,25,50,-25,25
Crusaders,8941,1,16,11,3,55,25,30,59
Cliftonville,8941,2,17,5,8,52,37,15,56
Linfield,8941,3,15,7,8,65,35,30,52
Dungannon,8941,4,13,8,9,54,42,12,47
Coleraine,8941,5,12,11,7,40,35,5,47
Glenavon,8941,6,10,12,8,43,38,5,42
Ballymena,8941,7,9,10,11,50,62,-12,37
Glentoran,8941,8,7,12,11,30,40,-10,33
Ards,8941,9,9,4,17,36,53,-17,31
Portadown,8941,10,7,6,17,21,45,-24,27
Ballinamalla,8941,11,5,4,21,24,58,-34,19
Cliftonville,8942,1,15,8,7,57,36,21,53
Crusaders,8942,2,15,7,8,54,42,12,52
Ballymena,8942,3,14,7,9,53,50,3,49
Linfield,8942,4,13,8,9,51,36,15,47
Glenavon,8942,5,12,10,8,51,40,11,46
Dungannon,8942,6,10,9,11,47,42,5,39
Coleraine,8942,7,8,14,8,45,45,0,38
Ards,8942,8,10,6,14,38,45,-7,36
Glentoran,8942,9,9,7,14,28,40,-12,34
Ballinamalla,8942,10,7,8,15,33,54,-21,29
Portadown,8942,11,7,6,17,22,49,-27,27
Crusaders,8943,1,18,4,8,54,34,20,58
Cliftonville,8943,2,16,5,9,64,44,20,53
Linfield,8943,3,13,11,6,52,27,25,50
Glenavon,8943,4,11,10,9,42,43,-1,43
Dungannon,8943,5,11,8,11,52,47,5,41
Coleraine,8943,6,10,11,9,42,40,2,41
Ards,8943,7,11,5,14,42,48,-6,38
Ballymena,8943,8,11,5,14,47,58,-11,38
Glentoran,8943,9,10,8,12,34,46,-12,38
Ballinamalla,8943,10,10,2,18,29,53,-24,32
Portadown,8943,11,6,7,17,23,41,-18,25
Linfield,8944,1,17,6,7,67,30,37,57
Crusaders,8944,2,16,8,6,58,36,22,56
Cliftonville,8944,3,16,5,9,56,40,16,53
Glenavon,8944,4,12,13,5,49,38,11,49
Coleraine,8944,5,10,10,10,42,50,-8,40
Ballymena,8944,6,10,9,11,56,65,-9,39
Dungannon,8944,7,8,14,8,42,38,4,38
Glentoran,8944,8,9,9,12,28,39,-11,36
Ballinamalla,8944,9,9,5,16,30,47,-17,32
Ards,8944,10,6,6,18,37,56,-19,24
Portadown,8944,11,5,9,16,25,51,-26,24
Crusaders,8945,1,16,7,7,56,37,19,55
Linfield,8945,2,15,7,8,66,33,33,52
Cliftonville,8945,3,16,4,10,49,38,11,52
Coleraine,8945,4,13,10,7,48,41,7,49
Dungannon,8945,5,13,9,8,61,40,21,48
Ballymena,8945,6,14,4,12,53,61,-8,46
Glentoran,8945,7,10,8,12,30,42,-12,38
Ards,8945,8,9,5,16,42,55,-13,32
Glenavon,8945,9,7,11,12,41,54,-13,32
Ballinamalla,8945,10,8,4,18,32,56,-24,28
Portadown,8945,11,7,5,18,23,44,-21,26
Crusaders,8946,1,19,7,4,61,31,30,64
Ballymena,8946,2,15,7,8,60,52,8,52
Linfield,8946,3,13,11,6,53,32,21,50
Cliftonville,8946,4,13,5,12,51,42,9,44
Dungannon,8946,5,11,10,9,52,44,8,43
Coleraine,8946,6,11,10,9,46,45,1,43
Glenavon,8946,7,9,12,9,48,46,2,39
Ballinamalla,8946,8,10,3,17,34,46,-12,33
Glentoran,8946,9,9,6,15,32,50,-18,33
Ards,8946,10,7,5,18,30,53,-23,26
Portadown,8946,11,6,8,16,26,52,-26,26
Linfield,8947,1,17,9,4,61,24,37,60
Crusaders,8947,2,18,4,8,62,34,28,58
Ballymena,8947,3,15,6,9,55,53,2,51
Cliftonville,8947,4,15,3,12,57,45,12,48
Coleraine,8947,5,12,10,8,40,43,-3,46
Dungannon,8947,6,12,8,10,51,43,8,44
Glenavon,8947,7,10,9,11,38,44,-6,39
Ballinamalla,8947,8,10,4,16,32,52,-20,34
Ards,8947,9,9,5,16,41,49,-8,32
Glentoran,8947,10,8,7,15,27,44,-17,31
Portadown,8947,11,5,3,22,16,49,-33,18
Crusaders,8948,1,17,5,8,50,36,14,56
Ballymena,8948,2,16,6,8,58,52,6,54
Linfield,8948,3,15,8,7,56,30,26,53
Cliftonville,8948,4,16,3,11,52,40,12,51
Glenavon,8948,5,13,8,9,48,47,1,47
Coleraine,8948,6,9,10,11,31,35,-4,37
Dungannon,8948,7,9,8,13,48,49,-1,35
Ards,8948,8,9,7,14,42,45,-3,34
Glentoran,8948,9,8,10,12,28,40,-12,34
Portadown,8948,10,9,4,17,29,43,-14,31
Ballinamalla,8948,11,7,5,18,28,53,-25,26
Cliftonville,8949,1,19,4,7,64,40,24,61
Ballymena,8949,2,15,6,9,58,56,2,51
Coleraine,8949,3,14,7,9,43,33,10,49
Glenavon,8949,4,13,10,7,51,43,8,49
Linfield,8949,5,12,10,8,46,31,15,46
Crusaders,8949,6,13,5,12,52,40,12,44
Dungannon,8949,7,12,8,10,55,48,7,44
Glentoran,8949,8,9,10,11,31,45,-14,37
Ards,8949,9,9,3,18,40,54,-14,30
Portadown,8949,10,7,4,19,26,47,-21,25
Ballinamalla,8949,11,7,3,20,23,52,-29,24
Linfield,8950,1,15,10,5,70,36,34,55
Glenavon,8950,2,13,12,5,53,41,12,51
Cliftonville,8950,3,14,5,11,47,41,6,47
Dungannon,8950,4,12,9,9,56,42,14,45
Ballymena,8950,5,11,10,9,52,54,-2,43
Coleraine,8950,6,11,10,9,45,47,-2,43
Crusaders,8950,7,12,6,12,42,43,-1,42
Ards,8950,8,12,5,13,44,41,3,41
Portadown,8950,9,8,7,15,27,42,-15,31
Glentoran,8950,10,8,7,15,28,51,-23,31
Ballinamalla,8950,11,6,5,19,24,50,-26,23
Linfield,8951,1,16,9,5,66,29,37,57
Crusaders,8951,2,15,9,6,56,35,21,54
Cliftonville,8951,3,13,6,11,51,45,6,45
Glenavon,8951,4,11,12,7,50,44,6,45
Coleraine,8951,5,10,12,8,46,43,3,42
Ballymena,8951,6,11,8,11,53,65,-12,41
Ards,8951,7,12,4,14,44,48,-4,40
Dungannon,8951,8,8,12,10,50,47,3,36
Glentoran,8951,9,8,9,13,29,44,-15,33
Ballinamalla,8951,10,9,5,16,33,51,-18,32
Portadown,8951,11,5,8,17,22,49,-27,23
Crusaders,8952,1,20,8,2,68,26,42,68
Linfield,8952,2,16,6,8,59,30,29,54
Cliftonville,8952,3,16,5,9,56,41,15,53
Ballymena,8952,4,14,5,11,57,59,-2,47
Glenavon,8952,5,10,10,10,45,52,-7,40
Coleraine,8952,6,10,9,11,39,46,-7,39
Ards,8952,7,11,5,14,42,48,-6,38
Glentoran,8952,8,9,8,13,31,47,-16,35
Dungannon,8952,9,9,7,14,48,50,-2,34
Ballinamalla,8952,10,9,5,16,35,50,-15,32
Portadown,8952,11,4,6,20,20,51,-31,18
Linfield,8953,1,16,8,6,68,34,34,56
Crusaders,8953,2,15,7,8,55,43,12,52
Ballymena,8953,3,15,6,9,59,55,4,51
Cliftonville,8953,4,15,4,11,52,39,13,49
Glenavon,8953,5,12,12,6,51,45,6,48
Coleraine,8953,6,13,8,9,43,32,11,47
Dungannon,8953,7,11,7,12,48,44,4,40
Glentoran,8953,8,11,5,14,34,46,-12,38
Portadown,8953,9,8,6,16,36,55,-19,30
Ards,8953,10,7,3,20,32,57,-25,24
Ballinamalla,8953,11,6,6,18,31,59,-28,24
Crusaders,8954,1,16,10,4,57,33,24,58
Linfield,8954,2,14,10,6,59,33,26,52
Glenavon,8954,3,12,12,6,47,40,7,48
Cliftonville,8954,4,14,4,12,52,43,9,46
Coleraine,8954,5,11,11,8,39,33,6,44
Ballymena,8954,6,13,5,12,50,61,-11,44
Ards,8954,7,10,8,12,44,46,-2,38
Glentoran,8954,8,8,11,11,26,35,-9,35
Dungannon,8954,9,7,10,13,44,46,-2,31
Portadown,8954,10,7,7,16,23,46,-23,28
Ballinamalla,8954,11,6,6,18,23,48,-25,24
Crusaders,8955,1,18,5,7,57,39,18,59
Cliftonville,8955,2,15,8,7,52,33,19,53
Linfield,8955,3,12,12,6,56,31,25,48
Ballymena,8955,4,12,9,9,50,56,-6,45
Dungannon,8955,5,10,11,9,54,40,14,41
Coleraine,8955,6,9,14,7,43,37,6,41
Glenavon,8955,7,8,12,10,42,51,-9,36
Ards,8955,8,8,9,13,37,46,-9,33
Glentoran,8955,9,6,12,12,27,41,-14,30
Portadown,8955,10,9,3,18,26,46,-20,30
Ballinamalla,8955,11,8,5,17,31,55,-24,29
Crusaders,8956,1,17,7,6,60,32,28,58
Cliftonville,8956,2,18,3,9,55,38,17,57
Ballymena,8956,3,16,4,10,55,60,-5,52
Linfield,8956,4,12,9,9,54,39,15,45
Coleraine,8956,5,10,11,9,45,40,5,41
Glentoran,8956,6,11,7,12,37,42,-5,40
Dungannon,8956,7,10,9,11,51,46,5,39
Glenavon,8956,8,10,8,12,52,52,0,38
Portadown,8956,9,11,4,15,33,46,-13,37
Ballinamalla,8956,10,9,3,18,30,53,-23,30
Ards,8956,11,6,5,19,33,57,-24,23
Crusaders,8957,1,16,6,8,50,33,17,54
Linfield,8957,2,14,10,6,55,31,24,52
Glenavon,8957,3,12,12,6,51,37,14,48
Ballymena,8957,4,13,7,10,53,57,-4,46
Cliftonville,8957,5,13,4,13,50,48,2,43
Coleraine,8957,6,12,7,11,39,41,-2,43
Glentoran,8957,7,11,7,12,29,37,-8,40
Dungannon,8957,8,10,7,13,47,44,3,37
Ards,8957,9,9,7,14,38,45,-7,34
Portadown,8957,10,8,6,16,29,46,-17,30
Ballinamalla,8957,11,9,3,18,26,48,-22,30
Crusaders,8958,1,18,9,3,64,33,31,63
Ballymena,8958,2,17,6,7,64,52,12,57
Cliftonville,8958,3,16,4,10,56,41,15,52
Linfield,8958,4,14,8,8,51,33,18,50
Coleraine,8958,5,12,9,9,46,44,2,45
Glentoran,8958,6,11,6,13,37,48,-11,39
Glenavon,8958,7,10,8,12,43,46,-3,38
Dungannon,8958,8,6,11,13,48,47,1,29
Ballinamalla,8958,9,9,2,19,31,54,-23,29
Ards,8958,10,8,4,18,30,49,-19,28
Portadown,8958,11,7,7,16,18,41,-23,28
Crusaders,8959,1,14,12,4,53,32,21,54
Linfield,8959,2,14,8,8,55,32,23,50
Dungannon,8959,3,12,10,8,53,39,14,46
Cliftonville,8959,4,12,10,8,53,43,10,46
Ballymena,8959,5,13,6,11,66,69,-3,45
Coleraine,8959,6,8,16,6,37,34,3,40
Glenavon,8959,7,10,10,10,42,42,0,40
Glentoran,8959,8,10,9,11,39,44,-5,39
Ards,8959,9,6,10,14,28,44,-16,28
Portadown,8959,10,7,7,16,28,51,-23,28
Ballinamalla,8959,11,5,10,15,31,55,-24,25
Cliftonville,8960,1,17,8,5,56,32,24,59
Crusaders,8960,2,17,7,6,53,31,22,58
Linfield,8960,3,15,9,6,62,33,29,54
Ballymena,8960,4,13,7,10,61,66,-5,46
Coleraine,8960,5,11,11,8,43,34,9,44
Glenavon,8960,6,9,12,9,34,44,-10,39
Glentoran,8960,7,8,9,13,30,39,-9,33
Dungannon,8960,8,7,11,12,45,47,-2,32
Ards,8960,9,8,6,16,34,50,-16,30
Portadown,8960,10,7,7,16,25,48,-23,28
Ballinamalla,8960,11,6,7,17,28,47,-19,25
Crusaders,8961,1,15,8,7,57,42,15,53
Ballymena,8961,2,15,6,9,59,54,5,51
Linfield,8961,3,13,11,6,53,34,19,50
Glenavon,8961,4,13,9,8,48,43,5,48
Cliftonville,8961,5,14,4,12,44,40,4,46
Dungannon,8961,6,12,9,9,52,39,13,45
Glentoran,8961,7,11,8,11,31,37,-6,41
Ards,8961,8,11,5,14,43,45,-2,38
Coleraine,8961,9,9,9,12,39,46,-7,36
Ballinamalla,8961,10,9,4,17,36,52,-16,31
Portadown,8961,11,4,5,21,20,50,-30,17
Crusaders,8962,1,20,8,2,59,27,32,68
Ballymena,8962,2,14,7,9,58,57,1,49
Cliftonville,8962,3,14,6,10,50,35,15,48
Linfield,8962,4,13,7,10,55,40,15,46
Coleraine,8962,5,10,11,9,43,42,1,41
Glenavon,8962,6,10,10,10,43,45,-2,40
Ards,8962,7,12,3,15,37,48,-11,39
Dungannon,8962,8,7,12,11,53,52,1,33
Portadown,8962,9,8,8,14,28,42,-14,32
Glentoran,8962,10,7,10,13,30,44,-14,31
Ballinamalla,8962,11,6,6,18,32,56,-24,24
Linfield,8963,1,16,10,4,58,27,31,58
Cliftonville,8963,2,16,3,11,49,38,11,51
Crusaders,8963,3,15,5,10,45,36,9,50
Glenavon,8963,4,14,8,8,54,46,8,50
Ballymena,8963,5,15,5,10,56,53,3,50
Coleraine,8963,6,12,9,9,39,35,4,45
Portadown,8963,7,11,3,16,35,43,-8,36
Glentoran,8963,8,10,6,14,30,43,-13,36
Dungannon,8963,9,9,8,13,50,48,2,35
Ballinamalla,8963,10,9,1,20,25,54,-29,28
Ards,8963,11,7,4,19,35,53,-18,25
Cliftonville,8964,1,18,4,8,57,34,23,58
Linfield,8964,2,14,9,7,55,33,22,51
Crusaders,8964,3,13,12,5,47,29,18,51
Ballymena,8964,4,14,7,9,58,46,12,49
Coleraine,8964,5,12,10,8,42,39,3,46
Glenavon,8964,6,9,11,10,46,54,-8,38
Dungannon,8964,7,9,9,12,43,42,1,36
Ards,8964,8,9,5,16,31,48,-17,32
Portadown,8964,9,9,5,16,22,43,-21,32
Glentoran,8964,10,8,7,15,29,43,-14,31
Ballinamalla,8964,11,7,7,16,26,45,-19,28
Crusaders,8965,1,19,6,5,60,30,30,63
Linfield,8965,2,16,6,8,66,37,29,54
Cliftonville,8965,3,17,3,10,59,45,14,54
Glenavon,8965,4,12,11,7,47,43,4,47
Coleraine,8965,5,12,8,10,35,32,3,44
Ballymena,8965,6,13,4,13,58,64,-6,43
Dungannon,8965,7,9,10,11,52,42,10,37
Glentoran,8965,8,10,6,14,36,47,-11,36
Ballinamalla,8965,9,9,4,17,32,55,-23,31
Portadown,8965,10,7,7,16,28,51,-23,28
Ards,8965,11,6,5,19,27,54,-27,23
Cliftonville,8966,1,20,4,6,53,28,25,64
Linfield,8966,2,15,11,4,65,30,35,56
Crusaders,8966,3,15,7,8,56,40,16,52
Ballymena,8966,4,13,6,11,56,60,-4,45
Glenavon,8966,5,11,11,8,42,41,1,44
Coleraine,8966,6,10,9,11,38,39,-1,39
Glentoran,8966,7,10,8,12,31,45,-14,38
Dungannon,8966,8,8,9,13,48,47,1,33
Ards,8966,9,9,4,17,33,46,-13,31
Ballinamalla,8966,10,8,5,17,26,49,-23,29
Portadown,8966,11,7,4,19,23,46,-23,25
Cliftonville,8967,1,18,5,7,60,34,26,59
Crusaders,8967,2,17,7,6,59,34,25,58
Linfield,8967,3,14,10,6,58,32,26,52
Ballymena,8967,4,13,7,10,60,62,-2,46
Glenavon,8967,5,9,11,10,43,45,-2,38
Dungannon,8967,6,9,10,11,43,42,1,37
Coleraine,8967,7,8,13,9,37,41,-4,37
Ards,8967,8,9,7,14,42,52,-10,34
Portadown,8967,9,8,8,14,32,44,-12,32
Glentoran,8967,10,7,8,15,27,49,-22,29
Ballinamalla,8967,11,6,8,16,27,53,-26,26
Crusaders,8968,1,16,9,5,59,35,24,57
Ballymena,8968,2,17,6,7,70,57,13,57
Linfield,8968,3,13,9,8,59,39,20,48
Cliftonville,8968,4,13,6,11,53,48,5,45
Glenavon,8968,5,11,10,9,52,44,8,43
Coleraine,8968,6,11,10,9,45,44,1,43
Ballinamalla,8968,7,11,2,17,39,55,-16,35
Dungannon,8968,8,8,10,12,42,49,-7,34
Ards,8968,9,8,8,14,37,50,-13,32
Portadown,8968,10,8,6,16,31,51,-20,30
Glentoran,8968,11,7,8,15,29,44,-15,29
Linfield,8969,1,15,9,6,57,37,20,54
Cliftonville,8969,2,15,7,8,49,35,14,52
Crusaders,8969,3,14,7,9,51,43,8,49
Ballymena,8969,4,13,5,12,53,56,-3,44
Coleraine,8969,5,11,10,9,47,41,6,43
Dungannon,8969,6,11,8,11,51,43,8,41
Glenavon,8969,7,10,10,10,49,48,1,40
Ballinamalla,8969,8,11,4,15,34,45,-11,37
Glentoran,8969,9,9,8,13,32,45,-13,35
Ards,8969,10,9,6,15,41,47,-6,33
Portadown,8969,11,8,4,18,22,46,-24,28
Ballymena,8970,1,16,5,9,60,49,11,53
Cliftonville,8970,2,15,7,8,47,35,12,52
Crusaders,8970,3,13,10,7,52,37,15,49
Glenavon,8970,4,13,9,8,40,40,0,48
Linfield,8970,5,11,13,6,53,31,22,46
Ards,8970,6,12,6,12,42,43,-1,42
Coleraine,8970,7,9,12,9,36,39,-3,39
Dungannon,8970,8,9,10,11,46,43,3,37
Ballinamalla,8970,9,10,4,16,31,47,-16,34
Glentoran,8970,10,5,11,14,30,47,-17,26
Portadown,8970,11,5,7,18,17,43,-26,22
Cliftonville,8971,1,19,2,9,54,40,14,59
Linfield,8971,2,15,9,6,62,30,32,54
Ballymena,8971,3,17,3,10,62,53,9,54
Crusaders,8971,4,15,8,7,50,32,18,53
Coleraine,8971,5,11,9,10,42,42,0,42
Dungannon,8971,6,10,10,10,49,41,8,40
Glenavon,8971,7,10,9,11,53,48,5,39
Ballinamalla,8971,8,10,3,17,34,56,-22,33
Glentoran,8971,9,8,8,14,29,49,-20,32
Portadown,8971,10,7,6,17,29,57,-28,27
Ards,8971,11,7,5,18,35,51,-16,26
Linfield,8972,1,14,10,6,62,35,27,52
Coleraine,8972,2,14,10,6,44,31,13,52
Crusaders,8972,3,15,7,8,54,42,12,52
Ballymena,8972,4,15,6,9,63,63,0,51
Cliftonville,8972,5,14,8,8,49,36,13,50
Glenavon,8972,6,11,10,9,49,48,1,43
Dungannon,8972,7,10,11,9,51,42,9,41
Ards,8972,8,8,6,16,40,53,-13,30
Portadown,8972,9,8,5,17,34,49,-15,29
Glentoran,8972,10,6,8,16,30,49,-19,26
Ballinamalla,8972,11,7,5,18,24,52,-28,26
Crusaders,8973,1,17,7,6,57,33,24,58
Cliftonville,8973,2,16,6,8,50,38,12,54
Linfield,8973,3,15,8,7,53,27,26,53
Ballymena,8973,4,15,5,10,51,56,-5,50
Dungannon,8973,5,12,9,9,53,42,11,45
Coleraine,8973,6,11,9,10,40,40,0,42
Glenavon,8973,7,9,12,9,45,42,3,39
Glentoran,8973,8,8,9,13,32,41,-9,33
Ballinamalla,8973,9,7,8,15,26,47,-21,29
Ards,8973,10,6,7,17,35,52,-17,25
Portadown,8973,11,5,8,17,23,47,-24,23
Ballymena,8974,1,16,6,8,58,53,5,54
Crusaders,8974,2,15,8,7,53,31,22,53
Linfield,8974,3,13,9,8,50,31,19,48
Glenavon,8974,4,11,12,7,41,41,0,45
Dungannon,8974,5,12,7,11,48,43,5,43
Coleraine,8974,6,10,12,8,45,38,7,42
Cliftonville,8974,7,12,6,12,43,42,1,42
Glentoran,8974,8,9,10,11,27,35,-8,37
Portadown,8974,9,9,5,16,27,42,-15,32
Ards,8974,10,8,5,17,38,47,-9,29
Ballinamalla,8974,11,8,4,18,31,58,-27,28
Crusaders,8975,1,16,7,7,52,35,17,55
Linfield,8975,2,14,10,6,59,35,24,52
Ballymena,8975,3,14,8,8,48,48,0,50
Cliftonville,8975,4,13,8,9,49,37,12,47
Coleraine,8975,5,11,13,6,42,34,8,46
Glenavon,8975,6,10,10,10,47,48,-1,40
Glentoran,8975,7,9,9,12,30,36,-6,36
Ballinamalla,8975,8,11,3,16,33,46,-13,36
Ards,8975,9,7,8,15,33,46,-13,29
Portadown,8975,10,7,8,15,24,47,-23,29
Dungannon,8975,11,6,10,14,46,51,-5,28
Crusaders,8976,1,15,9,6,51,29,22,54
Linfield,8976,2,14,10,6,56,31,25,52
Ballymena,8976,3,13,9,8,62,55,7,48
Glenavon,8976,4,11,12,7,44,41,3,45
Cliftonville,8976,5,12,7,11,39,36,3,43
Coleraine,8976,6,11,9,10,37,44,-7,42
Dungannon,8976,7,8,12,10,44,41,3,36
Ballinamalla,8976,8,10,6,14,31,44,-13,36
Ards,8976,9,10,5,15,35,41,-6,35
Glentoran,8976,10,9,7,14,28,40,-12,34
Portadown,8976,11,6,6,18,19,44,-25,24
Crusaders,8977,1,17,7,6,54,36,18,58
Cliftonville,8977,2,17,5,8,58,38,20,56
Linfield,8977,3,14,9,7,55,32,23,51
Ballymena,8977,4,13,7,10,54,57,-3,46
Dungannon,8977,5,11,9,10,56,45,11,42
Coleraine,8977,6,11,9,10,36,32,4,42
Glenavon,8977,7,10,11,9,45,46,-1,41
Glentoran,8977,8,8,11,11,30,35,-5,35
Ballinamalla,8977,9,9,5,16,30,47,-17,32
Portadown,8977,10,6,7,17,26,49,-23,25
Ards,8977,11,6,6,18,32,59,-27,24
Linfield,8978,1,17,7,6,61,28,33,58
Cliftonville,8978,2,15,7,8,56,40,16,52
Glenavon,8978,3,14,10,6,50,39,11,52
Crusaders,8978,4,14,8,8,49,39,10,50
Glentoran,8978,5,11,8,11,41,48,-7,41
Ballinamalla,8978,6,13,2,15,38,46,-8,41
Coleraine,8978,7,10,8,12,36,47,-11,38
Ballymena,8978,8,10,6,14,53,62,-9,36
Dungannon,8978,9,9,8,13,44,43,1,35
Ards,8978,10,8,6,16,36,49,-13,30
Portadown,8978,11,6,6,18,19,42,-23,24
Linfield,8979,1,15,9,6,55,29,26,54
Crusaders,8979,2,14,9,7,54,35,19,51
Coleraine,8979,3,13,9,8,45,35,10,48
Glenavon,8979,4,13,9,8,44,39,5,48
Cliftonville,8979,5,13,8,9,53,43,10,47
Ballymena,8979,6,14,5,11,57,60,-3,47
Dungannon,8979,7,9,12,9,51,42,9,39
Glentoran,8979,8,8,10,12,24,36,-12,34
Portadown,8979,9,9,4,17,27,42,-15,31
Ards,8979,10,7,8,15,35,52,-17,29
Ballinamalla,8979,11,7,3,20,21,53,-32,24
Ballymena,8980,1,17,5,8,63,55,8,56
Linfield,8980,2,14,9,7,57,35,22,51
Crusaders,8980,3,14,8,8,54,41,13,50
Glenavon,8980,4,12,10,8,43,44,-1,46
Cliftonville,8980,5,13,5,12,51,45,6,44
Coleraine,8980,6,10,11,9,40,37,3,41
Ballinamalla,8980,7,10,6,14,33,46,-13,36
Dungannon,8980,8,8,11,11,49,44,5,35
Glentoran,8980,9,9,6,15,32,45,-13,33
Ards,8980,10,9,5,16,35,47,-12,32
Portadown,8980,11,6,10,14,22,40,-18,28
Linfield,8981,1,17,8,5,71,28,43,59
Crusaders,8981,2,18,5,7,61,34,27,59
Cliftonville,8981,3,15,5,10,50,44,6,50
Glenavon,8981,4,12,13,5,49,44,5,49
Ballymena,8981,5,14,6,10,61,68,-7,48
Dungannon,8981,6,10,8,12,47,43,4,38
Coleraine,8981,7,8,11,11,40,45,-5,35
Ballinamalla,8981,8,9,6,15,41,54,-13,33
Ards,8981,9,9,4,17,39,55,-16,31
Portadown,8981,10,7,6,17,25,48,-23,27
Glentoran,8981,11,6,8,16,28,49,-21,26
Crusaders,8982,1,18,8,4,58,33,25,62
Linfield,8982,2,15,9,6,65,32,33,54
Cliftonville,8982,3,14,6,10,46,37,9,48
Glenavon,8982,4,12,11,7,48,39,9,47
Ards,8982,5,13,5,12,39,39,0,44
Dungannon,8982,6,10,8,12,53,40,13,38
Ballymena,8982,7,11,5,14,52,64,-12,38
Coleraine,8982,8,9,9,12,35,43,-8,36
Glentoran,8982,9,9,7,14,32,48,-16,34
Portadown,8982,10,8,5,17,25,48,-23,29
Ballinamalla,8982,11,8,3,19,28,58,-30,27
Linfield,8983,1,15,8,7,60,31,29,53
Crusaders,8983,2,15,6,9,57,44,13,51
Cliftonville,8983,3,15,5,10,48,35,13,50
Glenavon,8983,4,12,8,10,48,44,4,44
Ballymena,8983,5,12,8,10,55,62,-7,44
Portadown,8983,6,13,3,14,29,39,-10,42
Dungannon,8983,7,11,7,12,56,51,5,40
Ards,8983,8,11,4,15,45,47,-2,37
Coleraine,8983,9,9,10,11,40,49,-9,37
Glentoran,8983,10,8,8,14,30,46,-16,32
Ballinamalla,8983,11,9,3,18,35,55,-20,30
Crusaders,8984,1,17,11,2,60,30,30,62
Linfield,8984,2,17,9,4,61,27,34,60
Cliftonville,8984,3,16,4,10,54,37,17,52
Ballymena,8984,4,13,7,10,65,60,5,46
Coleraine,8984,5,12,10,8,49,44,5,46
Glenavon,8984,6,11,11,8,52,45,7,44
Dungannon,8984,7,9,9,12,45,49,-4,36
Ards,8984,8,9,6,15,45,54,-9,33
Glentoran,8984,9,5,10,15,28,51,-23,25
Ballinamalla,8984,10,7,4,19,34,62,-28,25
Portadown,8984,11,7,3,20,20,54,-34,24
Crusaders,8985,1,17,9,4,57,30,27,60
Cliftonville,8985,2,17,5,8,58,42,16,56
Glenavon,8985,3,11,13,6,47,35,12,46
Coleraine,8985,4,11,11,8,46,37,9,44
Linfield,8985,5,11,9,10,51,37,14,42
Ballymena,8985,6,12,6,12,51,58,-7,42
Dungannon,8985,7,9,12,9,50,47,3,39
Glentoran,8985,8,8,9,13,31,44,-13,33
Ards,8985,9,9,4,17,40,53,-13,31
Portadown,8985,10,8,6,16,28,49,-21,30
Ballinamalla,8985,11,8,4,18,32,59,-27,28
Linfield,8986,1,15,9,6,60,30,30,54
Crusaders,8986,2,14,10,6,51,35,16,52
Coleraine,8986,3,12,10,8,48,39,9,46
Glenavon,8986,4,12,10,8,52,45,7,46
Cliftonville,8986,5,13,7,10,49,44,5,46
Ballymena,8986,6,13,7,10,58,62,-4,46
Ards,8986,7,12,7,11,45,44,1,43
Dungannon,8986,8,8,9,13,46,44,2,33
Ballinamalla,8986,9,9,4,17,28,44,-16,31
Portadown,8986,10,7,7,16,25,47,-22,28
Glentoran,8986,11,6,8,16,24,52,-28,26
Crusaders,8987,1,17,8,5,57,34,23,59
Cliftonville,8987,2,16,5,9,56,34,22,53
Ballymena,8987,3,13,8,9,61,64,-3,47
Linfield,8987,4,12,10,8,54,30,24,46
Glenavon,8987,5,12,9,9,53,45,8,45
Glentoran,8987,6,10,9,11,31,37,-6,39
Coleraine,8987,7,8,14,8,39,39,0,38
Dungannon,8987,8,10,7,13,48,51,-3,37
Portadown,8987,9,8,8,14,26,41,-15,32
Ards,8987,10,7,8,15,36,51,-15,29
Ballinamalla,8987,11,8,2,20,29,64,-35,26
Coleraine,8988,1,16,9,5,50,34,16,57
Cliftonville,8988,2,17,4,9,57,34,23,55
Crusaders,8988,3,14,8,8,49,35,14,50
Linfield,8988,4,12,10,8,49,34,15,46
Ballymena,8988,5,13,7,10,58,58,0,46
Dungannon,8988,6,12,9,9,52,41,11,45
Glenavon,8988,7,11,10,9,46,43,3,43
Portadown,8988,8,10,3,17,35,47,-12,33
Glentoran,8988,9,8,7,15,28,44,-16,31
Ballinamalla,8988,10,8,4,18,32,61,-29,28
Ards,8988,11,5,7,18,28,53,-25,22
Crusaders,8989,1,18,8,4,61,30,31,62
Linfield,8989,2,15,11,4,62,31,31,56
Cliftonville,8989,3,15,9,6,55,32,23,54
Glenavon,8989,4,11,11,8,43,43,0,44
Coleraine,8989,5,11,10,9,41,37,4,43
Ballymena,8989,6,12,7,11,50,57,-7,43
Dungannon,8989,7,10,8,12,46,42,4,38
Ballinamalla,8989,8,12,2,16,35,51,-16,38
Ards,8989,9,9,5,16,33,55,-22,32
Glentoran,8989,10,6,9,15,26,44,-18,27
Portadown,8989,11,3,6,21,18,48,-30,15
Crusaders,8990,1,16,6,8,58,41,17,54
Cliftonville,8990,2,16,5,9,58,39,19,53
Glenavon,8990,3,14,10,6,50,38,12,52
Ballymena,8990,4,15,5,10,56,55,1,50
Linfield,8990,5,13,10,7,57,35,22,49
Coleraine,8990,6,10,10,10,41,41,0,40
Glentoran,8990,7,10,9,11,33,44,-11,39
Ards,8990,8,12,2,16,42,50,-8,38
Portadown,8990,9,10,3,17,27,48,-21,33
Dungannon,8990,10,6,9,15,50,58,-8,27
Ballinamalla,8990,11,6,5,19,32,55,-23,23
Coleraine,8991,1,14,12,4,51,31,20,54
Linfield,8991,2,13,13,4,56,28,28,52
Cliftonville,8991,3,16,4,10,56,36,20,52
Crusaders,8991,4,15,7,8,56,43,13,52
Ballymena,8991,5,11,11,8,65,64,1,44
Dungannon,8991,6,10,9,11,52,48,4,39
Glenavon,8991,7,9,12,9,39,44,-5,39
Ards,8991,8,7,10,13,36,50,-14,31
Ballinamalla,8991,9,7,8,15,29,51,-22,29
Glentoran,8991,10,6,10,14,29,52,-23,28
Portadown,8991,11,8,2,20,27,49,-22,26
Crusaders,8992,1,18,6,6,62,41,21,60
Linfield,8992,2,15,9,6,65,38,27,54
Coleraine,8992,3,12,13,5,47,33,14,49
Cliftonville,8992,4,13,5,12,51,45,6,44
Glenavon,8992,5,10,12,8,50,51,-1,42
Ballymena,8992,6,12,6,12,49,58,-9,42
Dungannon,8992,7,9,14,7,49,35,14,41
Ards,8992,8,8,6,16,41,54,-13,30
Portadown,8992,9,7,8,15,30,46,-16,29
Glentoran,8992,10,6,11,13,27,45,-18,29
Ballinamalla,8992,11,8,4,18,29,54,-25,28
Glenavon,8993,1,15,10,5,54,36,18,55
Linfield,8993,2,15,9,6,62,33,29,54
Crusaders,8993,3,15,7,8,48,32,16,52
Coleraine,8993,4,13,9,8,39,37,2,48
Cliftonville,8993,5,14,5,11,49,39,10,47
Dungannon,8993,6,12,8,10,54,43,11,44
Ballymena,8993,7,11,8,11,48,55,-7,41
Ards,8993,8,10,6,14,36,45,-9,36
Glentoran,8993,9,6,10,14,21,41,-20,28
Ballinamalla,8993,10,7,4,19,27,52,-25,25
Portadown,8993,11,6,6,18,20,45,-25,24
Crusaders,8994,1,18,6,6,53,28,25,60
Linfield,8994,2,16,7,7,57,27,30,55
Ballymena,8994,3,16,6,8,66,59,7,54
Cliftonville,8994,4,13,8,9,49,36,13,47
Glenavon,8994,5,12,7,11,46,45,1,43
Coleraine,8994,6,11,9,10,37,37,0,42
Dungannon,8994,7,9,11,10,49,44,5,38
Ballinamalla,8994,8,10,6,14,32,46,-14,36
Glentoran,8994,9,7,8,15,29,49,-20,29
Ards,8994,10,7,7,16,30,50,-20,28
Portadown,8994,11,6,5,19,29,56,-27,23
Crusaders,8995,1,18,7,5,61,34,27,61
Linfield,8995,2,16,7,7,61,32,29,55
Glenavon,8995,3,13,10,7,54,47,7,49
Cliftonville,8995,4,13,6,11,43,37,6,45
Ballymena,8995,5,12,6,12,54,64,-10,42
Ards,8995,6,12,4,14,43,46,-3,40
Glentoran,8995,7,9,10,11,26,37,-11,37
Dungannon,8995,8,9,9,12,54,48,6,36
Coleraine,8995,9,8,11,11,37,43,-6,35
Ballinamalla,8995,10,9,3,18,38,59,-21,30
Portadown,8995,11,6,7,17,18,42,-24,25
Crusaders,8996,1,18,6,6,63,42,21,60
Cliftonville,8996,2,16,5,9,54,41,13,53
Coleraine,8996,3,13,11,6,50,39,11,50
Linfield,8996,4,13,9,8,63,40,23,48
Glenavon,8996,5,12,10,8,44,42,2,46
Ballymena,8996,6,12,9,9,46,52,-6,45
Dungannon,8996,7,11,7,12,57,47,10,40
Glentoran,8996,8,10,7,13,35,44,-9,37
Ards,8996,9,9,6,15,36,49,-13,33
Portadown,8996,10,6,5,19,24,48,-24,23
Ballinamalla,8996,11,6,3,21,28,56,-28,21
Linfield,8997,1,15,10,5,64,31,33,55
Cliftonville,8997,2,15,7,8,60,40,20,52
Crusaders,8997,3,15,6,9,55,40,15,51
Coleraine,8997,4,14,9,7,45,37,8,51
Ballymena,8997,5,15,5,10,65,61,4,50
Ards,8997,6,11,4,15,39,46,-7,37
Glenavon,8997,7,9,9,12,45,47,-2,36
Dungannon,8997,8,8,11,11,47,48,-1,35
Portadown,8997,9,9,4,17,28,56,-28,31
Ballinamalla,8997,10,9,3,18,33,54,-21,30
Glentoran,8997,11,8,6,16,27,48,-21,30
Crusaders,8998,1,15,9,6,53,34,19,54
Cliftonville,8998,2,17,3,10,60,42,18,54
Linfield,8998,3,14,10,6,58,29,29,52
Coleraine,8998,4,13,8,9,42,39,3,47
Glenavon,8998,5,10,12,8,51,50,1,42
Dungannon,8998,6,11,8,11,49,44,5,41
Ballymena,8998,7,11,8,11,53,62,-9,41
Ballinamalla,8998,8,10,5,15,32,45,-13,35
Ards,8998,9,9,6,15,35,50,-15,33
Glentoran,8998,10,6,10,14,28,44,-16,28
Portadown,8998,11,6,7,17,30,52,-22,25
Linfield,8999,1,14,12,4,57,24,33,54
Crusaders,8999,2,15,8,7,47,30,17,53
Glentoran,8999,3,14,7,9,42,41,1,49
Cliftonville,8999,4,14,4,12,53,47,6,46
Coleraine,8999,5,11,12,7,38,34,4,45
Dungannon,8999,6,11,10,9,55,43,12,43
Ballymena,8999,7,11,10,9,58,59,-1,43
Glenavon,8999,8,9,11,10,42,52,-10,38
Ards,8999,9,7,8,15,36,45,-9,29
Portadown,8999,10,6,7,17,22,46,-24,25
Ballinamalla,8999,11,7,3,20,31,60,-29,24
Cliftonville,9000,1,17,3,10,54,35,19,54
Crusaders,9000,2,14,10,6,53,34,19,52
Ballymena,9000,3,15,6,9,59,55,4,51
Linfield,9000,4,14,8,8,57,36,21,50
Dungannon,9000,5,12,7,11,51,46,5,43
Glenavon,9000,6,11,9,10,39,38,1,42
Coleraine,9000,7,10,11,9,43,43,0,41
Glentoran,9000,8,11,7,12,35,43,-8,40
Ards,9000,9,9,6,15,38,48,-10,33
Portadown,9000,10,8,6,16,22,39,-17,30
Ballinamalla,9000,11,5,5,20,22,56,-34,20
Crusaders,9001,1,16,9,5,58,32,26,57
Linfield,9001,2,15,9,6,56,27,29,54
Glenavon,9001,3,12,13,5,46,37,9,49
Ballymena,9001,4,14,7,9,58,51,7,49
Cliftonville,9001,5,15,4,11,43,40,3,49
Ards,9001,6,10,6,14,42,45,-3,36
Ballinamalla,9001,7,11,3,16,32,48,-16,36
Coleraine,9001,8,7,12,11,35,46,-11,33
Dungannon,9001,9,7,11,12,41,45,-4,32
Glentoran,9001,10,6,10,14,24,40,-16,28
Portadown,9001,11,7,6,17,18,42,-24,27
Crusaders,9002,1,16,8,6,59,34,25,56
Linfield,9002,2,12,13,5,54,31,23,49
Ballymena,9002,3,13,7,10,56,62,-6,46
Cliftonville,9002,4,12,9,9,49,43,6,45
Glenavon,9002,5,11,11,8,52,50,2,44
Coleraine,9002,6,9,12,9,39,38,1,39
Dungannon,9002,7,9,10,11,48,46,2,37
Glentoran,9002,8,8,10,12,31,39,-8,34
Ballinamalla,9002,9,10,3,17,33,52,-19,33
Ards,9002,10,9,5,16,39,50,-11,32
Portadown,9002,11,6,12,12,25,40,-15,30
Coleraine,9003,1,16,8,6,53,34,19,56
Linfield,9003,2,16,7,7,61,35,26,55
Crusaders,9003,3,14,9,7,53,32,21,51
Cliftonville,9003,4,14,4,12,51,45,6,46
Dungannon,9003,5,12,9,9,54,41,13,45
Ballymena,9003,6,13,6,11,54,59,-5,45
Glentoran,9003,7,11,7,12,44,42,2,40
Glenavon,9003,8,9,13,8,41,43,-2,40
Ards,9003,9,10,3,17,36,50,-14,33
Portadown,9003,10,7,4,19,23,48,-25,25
Ballinamalla,9003,11,5,6,19,25,66,-41,21
Crusaders,9004,1,19,5,6,58,34,24,62
Linfield,9004,2,16,8,6,67,33,34,56
Cliftonville,9004,3,16,6,8,60,42,18,54
Glenavon,9004,4,14,10,6,51,37,14,52
Ballymena,9004,5,13,5,12,52,62,-10,44
Coleraine,9004,6,11,9,10,41,40,1,42
Dungannon,9004,7,8,9,13,44,50,-6,33
Ards,9004,8,9,4,17,31,43,-12,31
Ballinamalla,9004,9,9,3,18,32,50,-18,30
Glentoran,9004,10,8,6,16,26,46,-20,30
Portadown,9004,11,7,5,18,21,46,-25,26
Crusaders,9005,1,16,9,5,61,34,27,57
Glenavon,9005,2,16,9,5,59,43,16,57
Linfield,9005,3,15,9,6,59,30,29,54
Cliftonville,9005,4,16,4,10,53,36,17,52
Ballymena,9005,5,14,6,10,48,52,-4,48
Coleraine,9005,6,10,10,10,38,38,0,40
Ballinamalla,9005,7,11,5,14,33,47,-14,38
Dungannon,9005,8,9,8,13,53,50,3,35
Portadown,9005,9,8,3,19,24,46,-22,27
Ards,9005,10,7,5,18,36,58,-22,26
Glentoran,9005,11,6,6,18,21,51,-30,24
Crusaders,9006,1,15,10,5,55,34,21,55
Linfield,9006,2,14,10,6,56,25,31,52
Glenavon,9006,3,13,9,8,46,39,7,48
Ballymena,9006,4,13,7,10,55,60,-5,46
Dungannon,9006,5,12,8,10,56,50,6,44
Cliftonville,9006,6,12,7,11,46,43,3,43
Coleraine,9006,7,10,10,10,40,39,1,40
Ards,9006,8,11,2,17,34,45,-11,35
Ballinamalla,9006,9,10,3,17,30,50,-20,33
Portadown,9006,10,8,6,16,28,41,-13,30
Glentoran,9006,11,7,8,15,26,46,-20,29
Crusaders,9007,1,18,7,5,50,29,21,61
Linfield,9007,2,16,7,7,62,31,31,55
Ballymena,9007,3,15,7,8,64,56,8,52
Coleraine,9007,4,13,10,7,44,31,13,49
Cliftonville,9007,5,15,3,12,53,42,11,48
Glenavon,9007,6,10,14,6,49,43,6,44
Dungannon,9007,7,9,11,10,46,39,7,38
Ards,9007,8,9,5,16,39,51,-12,32
Glentoran,9007,9,8,7,15,29,52,-23,31
Ballinamalla,9007,10,7,6,17,30,52,-22,27
Portadown,9007,11,5,3,22,24,64,-40,18
Crusaders,9008,1,16,7,7,57,38,19,55
Cliftonville,9008,2,17,4,9,57,43,14,55
Coleraine,9008,3,14,10,6,43,32,11,52
Linfield,9008,4,14,8,8,54,30,24,50
Ballymena,9008,5,14,6,10,60,61,-1,48
Dungannon,9008,6,10,10,10,54,42,12,40
Glentoran,9008,7,9,13,8,33,36,-3,40
Glenavon,9008,8,9,10,11,49,50,-1,37
Ards,9008,9,7,6,17,35,52,-17,27
Portadown,9008,10,7,5,18,29,57,-28,26
Ballinamalla,9008,11,5,7,18,25,55,-30,22
Linfield,9009,1,18,7,5,64,28,36,61
Crusaders,9009,2,14,10,6,49,30,19,52
Glenavon,9009,3,14,9,7,49,47,2,51
Cliftonville,9009,4,15,3,12,48,37,11,48
Dungannon,9009,5,12,8,10,52,42,10,44
Coleraine,9009,6,11,11,8,42,37,5,44
Ballymena,9009,7,12,4,14,55,68,-13,40
Ards,9009,8,10,5,15,40,46,-6,35
Ballinamalla,9009,9,10,3,17,31,45,-14,33
Glentoran,9009,10,9,5,16,40,56,-16,32
Portadown,9009,11,5,5,20,26,60,-34,20
Crusaders,9010,1,17,6,7,56,40,16,57
Linfield,9010,2,13,9,8,55,37,18,48
Ballymena,9010,3,14,6,10,60,55,5,48
Coleraine,9010,4,12,11,7,40,36,4,47
Dungannon,9010,5,12,10,8,55,37,18,46
Cliftonville,9010,6,13,7,10,49,37,12,46
Glenavon,9010,7,11,12,7,55,51,4,45
Ards,9010,8,11,5,14,36,43,-7,38
Glentoran,9010,9,9,7,14,34,44,-10,34
Ballinamalla,9010,10,8,3,19,33,57,-24,27
Portadown,9010,11,4,6,20,19,55,-36,18
Crusaders,9011,1,18,6,6,59,34,25,60
Cliftonville,9011,2,15,7,8,54,40,14,52
Ballymena,9011,3,14,6,10,57,54,3,48
Linfield,9011,4,12,8,10,52,35,17,44
Glentoran,9011,5,12,7,11,33,41,-8,43
Dungannon,9011,6,10,9,11,53,45,8,39
Ballinamalla,9011,7,10,8,12,37,46,-9,38
Coleraine,9011,8,9,10,11,45,45,0,37
Glenavon,9011,9,8,10,12,43,51,-8,34
Ards,9011,10,8,9,13,31,44,-13,33
Portadown,9011,11,7,4,19,25,54,-29,25
Crusaders,9012,1,18,6,6,63,40,23,60
Linfield,9012,2,16,8,6,67,29,38,56
Coleraine,9012,3,14,11,5,52,34,18,53
Ballymena,9012,4,15,4,11,60,63,-3,49
Dungannon,9012,5,12,8,10,65,46,19,44
Cliftonville,9012,6,12,7,11,45,41,4,43
Glenavon,9012,7,10,10,10,50,51,-1,40
Glentoran,9012,8,10,7,13,34,45,-11,37
Portadown,9012,9,7,7,16,27,56,-29,28
Ards,9012,10,7,3,20,31,65,-34,24
Ballinamalla,9012,11,6,5,19,31,55,-24,23
Linfield,9013,1,16,7,7,63,34,29,55
Crusaders,9013,2,15,7,8,52,34,18,52
Ballymena,9013,3,15,6,9,58,56,2,51
Cliftonville,9013,4,14,6,10,52,39,13,48
Glenavon,9013,5,11,13,6,45,44,1,46
Ards,9013,6,14,3,13,44,44,0,45
Dungannon,9013,7,11,9,10,43,38,5,42
Coleraine,9013,8,11,8,11,46,43,3,41
Ballinamalla,9013,9,8,4,18,29,51,-22,28
Glentoran,9013,10,7,6,17,29,55,-26,27
Portadown,9013,11,5,7,18,24,47,-23,22
Glenavon,9014,1,16,9,5,57,37,20,57
Crusaders,9014,2,15,7,8,50,33,17,52
Linfield,9014,3,15,6,9,61,40,21,51
Coleraine,9014,4,13,8,9,46,38,8,47
Dungannon,9014,5,12,8,10,55,45,10,44
Glentoran,9014,6,13,5,12,35,35,0,44
Cliftonville,9014,7,13,4,13,51,50,1,43
Ballymena,9014,8,13,3,14,61,64,-3,42
Portadown,9014,9,7,8,15,27,48,-21,29
Ards,9014,10,8,4,18,28,46,-18,28
Ballinamalla,9014,11,8,2,20,25,60,-35,26
Linfield,9015,1,18,7,5,65,32,33,61
Ballymena,9015,2,17,5,8,67,57,10,56
Crusaders,9015,3,15,7,8,54,35,19,52
Cliftonville,9015,4,16,4,10,56,42,14,52
Glenavon,9015,5,12,11,7,46,38,8,47
Dungannon,9015,6,11,9,10,52,45,7,42
Ards,9015,7,10,6,14,39,44,-5,36
Coleraine,9015,8,7,10,13,36,46,-10,31
Ballinamalla,9015,9,7,8,15,28,53,-25,29
Glentoran,9015,10,6,9,15,24,47,-23,27
Portadown,9015,11,6,4,20,20,48,-28,22
Coleraine,9016,1,15,8,7,45,31,14,53
Ballymena,9016,2,15,8,7,63,56,7,53
Crusaders,9016,3,15,7,8,47,40,7,52
Dungannon,9016,4,12,10,8,56,38,18,46
Glenavon,9016,5,11,12,7,46,39,7,45
Linfield,9016,6,11,11,8,57,37,20,44
Cliftonville,9016,7,13,5,12,46,39,7,44
Glentoran,9016,8,10,5,15,27,38,-11,35
Ballinamalla,9016,9,9,5,16,25,45,-20,32
Ards,9016,10,7,5,18,31,50,-19,26
Portadown,9016,11,5,8,17,25,55,-30,23
Ballymena,9017,1,18,4,8,69,53,16,58
Crusaders,9017,2,16,9,5,49,25,24,57
Linfield,9017,3,13,11,6,54,30,24,50
Cliftonville,9017,4,14,6,10,56,40,16,48
Coleraine,9017,5,13,7,10,46,43,3,46
Glenavon,9017,6,11,10,9,39,44,-5,43
Dungannon,9017,7,9,9,12,50,45,5,36
Ards,9017,8,9,7,14,41,49,-8,34
Portadown,9017,9,9,4,17,36,57,-21,31
Glentoran,9017,10,7,7,16,23,48,-25,28
Ballinamalla,9017,11,5,8,17,21,50,-29,23
Cliftonville,9018,1,17,6,7,59,38,21,57
Linfield,9018,2,14,10,6,62,33,29,52
Ballymena,9018,3,15,7,8,61,56,5,52
Crusaders,9018,4,14,8,8,54,38,16,50
Ards,9018,5,12,5,13,40,46,-6,41
Dungannon,9018,6,10,10,10,48,41,7,40
Coleraine,9018,7,9,12,9,40,39,1,39
Glenavon,9018,8,8,12,10,47,53,-6,36
Glentoran,9018,9,6,13,11,27,44,-17,31
Ballinamalla,9018,10,8,6,16,27,50,-23,30
Portadown,9018,11,6,3,21,22,49,-27,21
Crusaders,9019,1,18,9,3,52,22,30,63
Cliftonville,9019,2,16,5,9,50,34,16,53
Linfield,9019,3,14,9,7,57,34,23,51
Glenavon,9019,4,14,9,7,51,39,12,51
Ballymena,9019,5,12,6,12,49,58,-9,42
Coleraine,9019,6,10,10,10,38,39,-1,40
Portadown,9019,7,10,4,16,32,50,-18,34
Ballinamalla,9019,8,10,3,17,36,58,-22,33
Ards,9019,9,8,8,14,40,48,-8,32
Glentoran,9019,10,7,8,15,24,44,-20,29
Dungannon,9019,11,7,7,16,40,43,-3,28
Linfield,9020,1,15,10,5,64,29,35,55
Crusaders,9020,2,15,9,6,61,37,24,54
Cliftonville,9020,3,14,8,8,52,38,14,50
Ballymena,9020,4,13,7,10,56,58,-2,46
Coleraine,9020,5,11,11,8,45,39,6,44
Dungannon,9020,6,11,10,9,55,48,7,43
Glenavon,9020,7,10,13,7,51,44,7,43
Glentoran,9020,8,6,12,12,29,44,-15,30
Ballinamalla,9020,9,8,5,17,24,50,-26,29
Ards,9020,10,8,3,19,30,56,-26,27
Portadown,9020,11,6,8,16,22,46,-24,26
Linfield,9021,1,16,8,6,60,34,26,56
Crusaders,9021,2,16,7,7,52,34,18,55
Cliftonville,9021,3,15,4,11,45,33,12,49
Coleraine,9021,4,12,11,7,44,37,7,47
Dungannon,9021,5,12,8,10,53,40,13,44
Glenavon,9021,6,11,11,8,47,45,2,44
Ballymena,9021,7,12,8,10,54,55,-1,44
Glentoran,9021,8,10,8,12,31,42,-11,38
Ards,9021,9,9,4,17,33,47,-14,31
Ballinamalla,9021,10,7,4,19,30,57,-27,25
Portadown,9021,11,6,5,19,25,50,-25,23
Ballymena,9022,1,20,3,7,76,59,17,63
Crusaders,9022,2,17,7,6,64,37,27,58
Cliftonville,9022,3,16,2,12,61,44,17,50
Ards,9022,4,13,5,12,49,43,6,44
Glenavon,9022,5,10,13,7,46,44,2,43
Linfield,9022,6,11,9,10,52,37,15,42
Coleraine,9022,7,9,10,11,35,44,-9,37
Ballinamalla,9022,8,10,2,18,35,51,-16,32
Dungannon,9022,9,7,10,13,42,50,-8,31
Portadown,9022,10,8,7,15,24,42,-18,31
Glentoran,9022,11,6,8,16,22,55,-33,26
Crusaders,9023,1,17,7,6,53,35,18,58
Cliftonville,9023,2,16,5,9,50,39,11,53
Linfield,9023,3,15,7,8,57,31,26,52
Ballymena,9023,4,14,6,10,59,56,3,48
Dungannon,9023,5,12,9,9,50,41,9,45
Glenavon,9023,6,12,9,9,47,44,3,45
Coleraine,9023,7,12,8,10,43,37,6,44
Glentoran,9023,8,8,7,15,30,45,-15,31
Ards,9023,9,9,2,19,33,50,-17,29
Portadown,9023,10,8,5,17,22,45,-23,29
Ballinamalla,9023,11,7,5,18,30,51,-21,26
Cliftonville,9024,1,19,4,7,65,38,27,61
Crusaders,9024,2,15,6,9,56,44,12,51
Linfield,9024,3,12,12,6,55,35,20,48
Ballymena,9024,4,13,8,9,52,48,4,47
Dungannon,9024,5,11,8,11,49,44,5,41
Ards,9024,6,12,5,13,45,48,-3,41
Coleraine,9024,7,10,10,10,39,39,0,40
Glenavon,9024,8,8,14,8,44,46,-2,38
Glentoran,9024,9,10,7,13,33,40,-7,37
Portadown,9024,10,8,5,17,29,51,-22,29
Ballinamalla,9024,11,5,5,20,26,60,-34,20
Linfield,9025,1,16,9,5,60,29,31,57
Cliftonville,9025,2,16,7,7,55,33,22,55
Crusaders,9025,3,15,9,6,53,33,20,54
Ballymena,9025,4,12,8,10,55,61,-6,44
Glenavon,9025,5,10,11,9,42,43,-1,41
Coleraine,9025,6,9,13,8,37,32,5,40
Glentoran,9025,7,10,8,12,35,42,-7,38
Ards,9025,8,10,4,16,38,49,-11,34
Dungannon,9025,9,8,9,13,43,47,-4,33
Portadown,9025,10,8,6,16,27,52,-25,30
Ballinamalla,9025,11,6,6,18,33,57,-24,24
Crusaders,9026,1,17,7,6,63,39,24,58
Cliftonville,9026,2,17,4,9,56,36,20,55
Ballymena,9026,3,15,5,10,58,52,6,50
Linfield,9026,4,12,12,6,54,30,24,48
Coleraine,9026,5,11,11,8,48,41,7,44
Glentoran,9026,6,9,12,9,36,38,-2,39
Dungannon,9026,7,9,9,12,48,49,-1,36
Glenavon,9026,8,8,12,10,43,48,-5,36
Ards,9026,9,9,6,15,39,53,-14,33
Ballinamalla,9026,10,7,6,17,32,62,-30,27
Portadown,9026,11,6,6,18,20,49,-29,24
Crusaders,9027,1,17,8,5,60,33,27,59
Cliftonville,9027,2,17,6,7,60,37,23,57
Linfield,9027,3,14,6,10,53,34,19,48
Coleraine,9027,4,12,10,8,43,41,2,46
Glenavon,9027,5,11,11,8,55,47,8,44
Ballymena,9027,6,13,5,12,57,62,-5,44
Ballinamalla,9027,7,11,4,15,31,47,-16,37
Dungannon,9027,8,8,9,13,44,51,-7,33
Ards,9027,9,9,5,16,35,45,-10,32
Portadown,9027,10,8,7,15,29,42,-13,31
Glentoran,9027,11,7,5,18,29,57,-28,26
Cliftonville,9028,1,16,5,9,60,40,20,53
Glenavon,9028,2,14,11,5,54,42,12,53
Linfield,9028,3,14,10,6,52,29,23,52
Crusaders,9028,4,14,9,7,53,40,13,51
Ballymena,9028,5,13,8,9,64,60,4,47
Coleraine,9028,6,10,12,8,42,45,-3,42
Dungannon,9028,7,9,11,10,49,42,7,38
Glentoran,9028,8,10,6,14,41,52,-11,36
Ards,9028,9,6,11,13,38,52,-14,29
Ballinamalla,9028,10,7,5,18,31,50,-19,26
Portadown,9028,11,5,6,19,24,56,-32,21
Crusaders,9029,1,18,7,5,55,31,24,61
Ballymena,9029,2,18,5,7,63,50,13,59
Cliftonville,9029,3,17,5,8,60,38,22,56
Linfield,9029,4,13,8,9,57,39,18,47
Coleraine,9029,5,10,12,8,41,42,-1,42
Glenavon,9029,6,9,12,9,48,45,3,39
Dungannon,9029,7,9,8,13,47,45,2,35
Glentoran,9029,8,8,6,16,29,47,-18,30
Ballinamalla,9029,9,8,6,16,30,50,-20,30
Ards,9029,10,7,7,16,35,52,-17,28
Portadown,9029,11,7,6,17,30,56,-26,27
Crusaders,9030,1,16,8,6,53,31,22,56
Coleraine,9030,2,13,10,7,48,35,13,49
Linfield,9030,3,12,11,7,57,37,20,47
Glenavon,9030,4,12,11,7,50,42,8,47
Cliftonville,9030,5,13,6,11,49,46,3,45
Ballymena,9030,6,12,8,10,56,59,-3,44
Ards,9030,7,10,8,12,38,48,-10,38
Dungannon,9030,8,8,13,9,45,43,2,37
Ballinamalla,9030,9,8,6,16,30,49,-19,30
Glentoran,9030,10,6,11,13,25,41,-16,29
Portadown,9030,11,5,8,17,24,44,-20,23
Ballymena,9031,1,15,6,9,62,59,3,51
Coleraine,9031,2,13,11,6,47,35,12,50
Crusaders,9031,3,13,10,7,53,39,14,49
Dungannon,9031,4,13,9,8,61,40,21,48
Glenavon,9031,5,11,14,5,52,41,11,47
Linfield,9031,6,13,7,10,55,35,20,46
Cliftonville,9031,7,13,6,11,47,43,4,45
Glentoran,9031,8,10,7,13,36,45,-9,37
Ballinamalla,9031,9,8,4,18,33,63,-30,28
Ards,9031,10,7,6,17,35,54,-19,27
Portadown,9031,11,7,4,19,25,52,-27,25
Crusaders,9032,1,19,7,4,63,30,33,64
Cliftonville,9032,2,17,3,10,62,47,15,54
Ballymena,9032,3,15,8,7,58,53,5,53
Linfield,9032,4,14,9,7,54,33,21,51
Glenavon,9032,5,11,10,9,49,47,2,43
Dungannon,9032,6,10,9,11,47,44,3,39
Coleraine,9032,7,9,8,13,37,40,-3,35
Ballinamalla,9032,8,9,5,16,31,56,-25,32
Ards,9032,9,9,4,17,40,53,-13,31
Glentoran,9032,10,8,7,15,30,45,-15,31
Portadown,9032,11,6,6,18,22,45,-23,24
Linfield,9033,1,15,12,3,65,34,31,57
Crusaders,9033,2,15,10,5,57,34,23,55
Cliftonville,9033,3,14,6,10,55,40,15,48
Ballymena,9033,4,12,9,9,58,59,-1,45
Glenavon,9033,5,9,13,8,44,47,-3,40
Coleraine,9033,6,9,12,9,41,40,1,39
Ballinamalla,9033,7,10,6,14,32,50,-18,36
Dungannon,9033,8,8,9,13,48,49,-1,33
Portadown,9033,9,9,5,16,27,46,-19,32
Glentoran,9033,10,7,10,13,35,47,-12,31
Ards,9033,11,7,8,15,39,55,-16,29
Crusaders,9034,1,15,10,5,58,34,24,55
Ballymena,9034,2,16,5,9,60,54,6,53
Dungannon,9034,3,14,8,8,49,36,13,50
Linfield,9034,4,13,10,7,57,32,25,49
Glenavon,9034,5,12,11,7,40,34,6,47
Coleraine,9034,6,12,9,9,43,32,11,45
Cliftonville,9034,7,12,6,12,47,48,-1,42
Ballinamalla,9034,8,9,5,16,30,49,-19,32
Glentoran,9034,9,6,9,15,26,44,-18,27
Portadown,9034,10,7,6,17,23,50,-27,27
Ards,9034,11,6,7,17,32,52,-20,25
Cliftonville,9035,1,20,3,7,55,34,21,63
Coleraine,9035,2,16,7,7,58,39,19,55
Crusaders,9035,3,14,6,10,50,38,12,48
Linfield,9035,4,13,8,9,51,30,21,47
Ballymena,9035,5,12,9,9,62,63,-1,45
Dungannon,9035,6,10,8,12,51,49,2,38
Ballinamalla,9035,7,11,4,15,30,47,-17,37
Glenavon,9035,8,9,8,13,38,48,-10,35
Ards,9035,9,9,6,15,42,54,-12,33
Portadown,9035,10,8,5,17,20,37,-17,29
Glentoran,9035,11,6,10,14,30,48,-18,28
Glenavon,9036,1,15,9,6,54,41,13,54
Linfield,9036,2,15,8,7,63,35,28,53
Cliftonville,9036,3,16,4,10,62,40,22,52
Ballymena,9036,4,14,7,9,59,60,-1,49
Crusaders,9036,5,13,5,12,48,49,-1,44
Glentoran,9036,6,12,5,13,33,39,-6,41
Coleraine,9036,7,10,10,10,39,41,-2,40
Dungannon,9036,8,8,8,14,47,47,0,32
Ards,9036,9,8,8,14,38,54,-16,32
Ballinamalla,9036,10,9,4,17,32,51,-19,31
Portadown,9036,11,6,10,14,24,42,-18,28
Crusaders,9037,1,17,10,3,70,31,39,61
Linfield,9037,2,17,6,7,70,40,30,57
Cliftonville,9037,3,17,5,8,59,44,15,56
Coleraine,9037,4,13,9,8,43,39,4,48
Ballymena,9037,5,12,7,11,57,56,1,43
Glentoran,9037,6,11,6,13,36,42,-6,39
Glenavon,9037,7,9,12,9,52,60,-8,39
Dungannon,9037,8,9,9,12,51,52,-1,36
Ards,9037,9,7,8,15,35,49,-14,29
Portadown,9037,10,5,8,17,28,52,-24,23
Ballinamalla,9037,11,4,8,18,22,58,-36,20
Crusaders,9038,1,19,6,5,63,35,28,63
Ballymena,9038,2,14,8,8,56,57,-1,50
Glenavon,9038,3,13,10,7,53,42,11,49
Linfield,9038,4,12,12,6,53,32,21,48
Cliftonville,9038,5,14,5,11,52,44,8,47
Coleraine,9038,6,11,9,10,40,42,-2,42
Dungannon,9038,7,11,7,12,47,41,6,40
Ards,9038,8,10,5,15,36,49,-13,35
Glentoran,9038,9,9,6,15,33,44,-11,33
Ballinamalla,9038,10,8,3,19,34,56,-22,27
Portadown,9038,11,5,7,18,23,48,-25,22
Crusaders,9039,1,16,4,10,56,46,10,52
Cliftonville,9039,2,15,6,9,55,42,13,51
Ballymena,9039,3,15,6,9,61,56,5,51
Linfield,9039,4,13,10,7,62,39,23,49
Glenavon,9039,5,11,12,7,49,40,9,45
Dungannon,9039,6,11,10,9,56,50,6,43
Coleraine,9039,7,10,11,9,44,46,-2,41
Ards,9039,8,11,3,16,49,54,-5,36
Glentoran,9039,9,8,7,15,31,50,-19,31
Ballinamalla,9039,10,8,6,16,29,48,-19,30
Portadown,9039,11,6,7,17,26,47,-21,25
Linfield,9040,1,17,7,6,64,38,26,58
Crusaders,9040,2,16,6,8,50,32,18,54
Cliftonville,9040,3,15,6,9,50,35,15,51
Ballymena,9040,4,15,5,10,56,55,1,50
Ards,9040,5,12,6,12,43,44,-1,42
Dungannon,9040,6,10,11,9,42,34,8,41
Coleraine,9040,7,10,9,11,35,38,-3,39
Glenavon,9040,8,9,10,11,41,47,-6,37
Ballinamalla,9040,9,10,2,18,37,51,-14,32
Glentoran,9040,9,9,5,16,37,51,-14,32
Portadown,9040,11,6,5,19,20,50,-30,23
Crusaders,9041,1,16,8,6,54,32,22,56
Linfield,9041,2,15,9,6,60,34,26,54
Cliftonville,9041,3,16,4,10,58,40,18,52
Coleraine,9041,4,12,12,6,46,35,11,48
Glenavon,9041,5,11,11,8,44,44,0,44
Dungannon,9041,6,11,9,10,55,42,13,42
Ballymena,9041,7,10,8,12,54,61,-7,38
Glentoran,9041,8,10,5,15,33,55,-22,35
Ballinamalla,9041,9,9,4,17,34,49,-15,31
Ards,9041,10,9,4,17,35,51,-16,31
Portadown,9041,11,5,8,17,31,61,-30,23
Crusaders,9042,1,17,9,4,62,34,28,60
Ballymena,9042,2,16,6,8,53,47,6,54
Cliftonville,9042,3,16,5,9,59,40,19,53
Linfield,9042,4,12,11,7,53,31,22,47
Dungannon,9042,5,11,10,9,45,42,3,43
Coleraine,9042,6,9,12,9,43,42,1,39
Glenavon,9042,7,9,11,10,42,40,2,38
Glentoran,9042,8,10,8,12,31,41,-10,38
Portadown,9042,9,8,5,17,26,47,-21,29
Ards,9042,10,7,5,18,31,56,-25,26
Ballinamalla,9042,11,6,6,18,27,52,-25,24
Linfield,9043,1,14,9,7,57,37,20,51
Cliftonville,9043,2,15,5,10,56,43,13,50
Crusaders,9043,3,12,11,7,48,36,12,47
Coleraine,9043,4,12,10,8,41,34,7,46
Ballymena,9043,5,12,8,10,58,61,-3,44
Glenavon,9043,6,11,10,9,45,40,5,43
Glentoran,9043,7,11,10,9,40,40,0,43
Ards,9043,8,11,4,15,38,46,-8,37
Dungannon,9043,9,9,9,12,46,46,0,36
Ballinamalla,9043,10,8,6,16,31,53,-22,30
Portadown,9043,11,6,6,18,24,48,-24,24
Linfield,9044,1,15,10,5,67,38,29,55
Cliftonville,9044,2,15,7,8,56,42,14,52
Crusaders,9044,3,13,10,7,54,40,14,49
Glenavon,9044,4,12,11,7,49,43,6,47
Ballymena,9044,5,14,4,12,57,59,-2,46
Coleraine,9044,6,11,10,9,46,38,8,43
Ards,9044,7,13,2,15,42,50,-8,41
Dungannon,9044,8,10,8,12,46,43,3,38
Glentoran,9044,9,10,6,14,39,48,-9,36
Ballinamalla,9044,10,8,3,19,31,58,-27,27
Portadown,9044,11,6,5,19,19,47,-28,23
Ballymena,9045,1,16,6,8,67,59,8,54
Linfield,9045,2,14,11,5,60,28,32,53
Coleraine,9045,3,14,8,8,46,39,7,50
Crusaders,9045,4,14,7,9,54,44,10,49
Cliftonville,9045,5,14,5,11,54,44,10,47
Glenavon,9045,6,12,9,9,53,48,5,45
Ards,9045,7,10,7,13,40,46,-6,37
Portadown,9045,8,10,6,14,33,47,-14,36
Glentoran,9045,9,8,8,14,27,46,-19,32
Dungannon,9045,10,7,8,15,40,44,-4,29
Ballinamalla,9045,11,6,5,19,25,54,-29,23
Crusaders,9046,1,17,8,5,57,33,24,59
Cliftonville,9046,2,17,4,9,57,41,16,55
Linfield,9046,3,15,9,6,53,29,24,54
Glentoran,9046,4,13,6,11,33,35,-2,45
Ballymena,9046,5,12,8,10,55,53,2,44
Glenavon,9046,6,11,10,9,42,40,2,43
Coleraine,9046,7,9,11,10,37,36,1,38
Dungannon,9046,8,10,7,13,48,45,3,37
Ards,9046,9,8,6,16,34,51,-17,30
Ballinamalla,9046,10,7,5,18,26,52,-26,26
Portadown,9046,11,7,4,19,21,48,-27,25
Crusaders,9047,1,17,7,6,56,33,23,58
Cliftonville,9047,2,16,7,7,59,40,19,55
Linfield,9047,3,14,10,6,55,30,25,52
Ballymena,9047,4,14,6,10,62,60,2,48
Glenavon,9047,5,10,8,12,46,52,-6,38
Ards,9047,6,10,7,13,44,46,-2,37
Glentoran,9047,7,9,10,11,31,40,-9,37
Dungannon,9047,8,8,11,11,46,42,4,35
Coleraine,9047,9,7,11,12,41,51,-10,32
Portadown,9047,10,8,7,15,27,48,-21,31
Ballinamalla,9047,11,8,4,18,22,47,-25,28
Crusaders,9048,1,15,8,7,53,40,13,53
Linfield,9048,2,14,10,6,69,37,32,52
Cliftonville,9048,3,16,3,11,54,39,15,51
Coleraine,9048,4,14,8,8,52,37,15,50
Glenavon,9048,5,11,12,7,43,42,1,45
Ballymena,9048,6,12,6,12,61,69,-8,42
Dungannon,9048,7,9,11,10,51,44,7,38
Glentoran,9048,8,9,8,13,35,44,-9,35
Portadown,9048,9,9,5,16,34,57,-23,32
Ballinamalla,9048,10,9,4,17,35,51,-16,31
Ards,9048,11,7,5,18,38,65,-27,26
Linfield,9049,1,16,8,6,58,32,26,56
Cliftonville,9049,2,17,5,8,56,41,15,56
Crusaders,9049,3,16,6,8,55,33,22,54
Ballymena,9049,4,14,9,7,75,60,15,51
Coleraine,9049,5,12,8,10,39,40,-1,44
Ards,9049,6,13,4,13,42,44,-2,43
Dungannon,9049,7,11,9,10,46,43,3,42
Glenavon,9049,8,8,12,10,42,49,-7,36
Glentoran,9049,9,8,7,15,37,52,-15,31
Portadown,9049,10,6,7,17,30,52,-22,25
Ballinamalla,9049,11,4,5,21,24,58,-34,17
Crusaders,9050,1,16,7,7,64,50,14,55
Linfield,9050,2,15,8,7,59,33,26,53
Ballymena,9050,3,16,5,9,59,52,7,53
Cliftonville,9050,4,15,4,11,54,41,13,49
Glenavon,9050,5,12,9,9,58,50,8,45
Coleraine,9050,6,11,11,8,46,46,0,44
Glentoran,9050,7,9,9,12,41,44,-3,36
Portadown,9050,8,10,4,16,26,44,-18,34
Dungannon,9050,9,8,7,15,48,51,-3,31
Ards,9050,10,8,7,15,34,47,-13,31
Ballinamalla,9050,11,7,5,18,32,63,-31,26
Linfield,9051,1,15,9,6,55,26,29,54
Cliftonville,9051,2,16,4,10,55,41,14,52
Crusaders,9051,3,15,6,9,51,34,17,51
Ballymena,9051,4,14,8,8,58,61,-3,50
Glentoran,9051,5,11,10,9,40,35,5,43
Dungannon,9051,6,11,9,10,53,45,8,42
Coleraine,9051,7,10,10,10,44,49,-5,40
Glenavon,9051,8,9,12,9,44,46,-2,39
Ards,9051,9,8,6,16,34,46,-12,30
Ballinamalla,9051,10,8,6,16,31,55,-24,30
Portadown,9051,11,6,4,20,21,48,-27,22
Crusaders,9052,1,17,7,6,55,34,21,58
Cliftonville,9052,2,15,4,11,51,41,10,49
Dungannon,9052,3,12,10,8,64,38,26,46
Linfield,9052,4,11,11,8,53,39,14,44
Coleraine,9052,5,10,14,6,44,41,3,44
Ballymena,9052,6,13,5,12,58,64,-6,44
Glenavon,9052,7,11,10,9,47,50,-3,43
Glentoran,9052,8,8,10,12,30,41,-11,34
Ballinamalla,9052,9,7,9,14,30,48,-18,30
Ards,9052,10,8,5,17,39,58,-19,29
Portadown,9052,11,7,7,16,28,45,-17,28
Linfield,9053,1,15,10,5,57,30,27,55
Crusaders,9053,2,15,9,6,57,38,19,54
Cliftonville,9053,3,15,3,12,55,40,15,48
Ballymena,9053,4,14,6,10,60,57,3,48
Dungannon,9053,5,12,8,10,57,47,10,44
Glenavon,9053,6,11,10,9,44,46,-2,43
Coleraine,9053,7,10,10,10,43,43,0,40
Ards,9053,8,11,6,13,38,47,-9,39
Glentoran,9053,9,8,9,13,33,49,-16,33
Ballinamalla,9053,10,8,4,18,29,49,-20,28
Portadown,9053,11,6,5,19,24,51,-27,23
Ballymena,9054,1,18,6,6,61,52,9,60
Linfield,9054,2,16,7,7,62,35,27,55
Cliftonville,9054,3,14,5,11,45,37,8,47
Crusaders,9054,4,13,7,10,49,39,10,46
Glenavon,9054,5,10,13,7,40,38,2,43
Coleraine,9054,6,10,11,9,38,38,0,41
Dungannon,9054,7,9,12,9,52,43,9,39
Ards,9054,8,9,5,16,30,47,-17,32
Glentoran,9054,9,8,7,15,34,42,-8,31
Portadown,9054,10,7,8,15,26,44,-18,29
Ballinamalla,9054,11,7,7,16,24,46,-22,28
Cliftonville,9055,1,16,6,8,62,43,19,54
Crusaders,9055,2,16,5,9,57,37,20,53
Linfield,9055,3,14,8,8,49,32,17,50
Ballymena,9055,4,13,7,10,60,59,1,46
Glentoran,9055,5,12,7,11,38,43,-5,43
Coleraine,9055,6,11,9,10,46,41,5,42
Glenavon,9055,7,10,12,8,46,43,3,42
Dungannon,9055,8,10,9,11,51,47,4,39
Portadown,9055,9,8,6,16,20,43,-23,30
Ballinamalla,9055,10,8,5,17,31,54,-23,29
Ards,9055,11,8,4,18,42,60,-18,28
Crusaders,9056,1,21,6,3,63,26,37,69
Glenavon,9056,2,15,8,7,49,43,6,53
Linfield,9056,3,13,10,7,55,34,21,49
Cliftonville,9056,4,13,6,11,52,47,5,45
Coleraine,9056,5,10,10,10,37,40,-3,40
Ballymena,9056,6,9,10,11,48,59,-11,37
Dungannon,9056,7,9,8,13,50,46,4,35
Ards,9056,8,10,5,15,47,53,-6,35
Glentoran,9056,9,9,6,15,32,49,-17,33
Ballinamalla,9056,10,9,5,16,32,49,-17,32
Portadown,9056,11,7,6,17,29,48,-19,27
Linfield,9057,1,15,10,5,61,28,33,55
Cliftonville,9057,2,14,8,8,56,43,13,50
Ballymena,9057,3,14,8,8,56,57,-1,50
Crusaders,9057,4,14,7,9,52,36,16,49
Coleraine,9057,5,11,11,8,43,42,1,44
Glenavon,9057,6,10,10,10,43,47,-4,40
Portadown,9057,7,11,6,13,32,41,-9,39
Dungannon,9057,8,8,10,12,43,41,2,34
Ballinamalla,9057,9,10,2,18,41,60,-19,32
Ards,9057,10,8,6,16,40,51,-11,30
Glentoran,9057,11,7,8,15,30,51,-21,29
Crusaders,9058,1,19,6,5,59,29,30,63
Linfield,9058,2,16,6,8,62,36,26,54
Coleraine,9058,3,13,11,6,42,38,4,50
Cliftonville,9058,4,14,5,11,52,40,12,47
Ballymena,9058,5,14,5,11,60,59,1,47
Glenavon,9058,6,9,12,9,49,54,-5,39
Dungannon,9058,7,10,8,12,53,50,3,38
Ards,9058,8,10,3,17,41,53,-12,33
Portadown,9058,9,9,5,16,29,49,-20,32
Glentoran,9058,10,8,5,17,29,46,-17,29
Ballinamalla,9058,11,8,4,18,33,55,-22,28
Crusaders,9059,1,16,10,4,63,35,28,58
Linfield,9059,2,16,7,7,56,30,26,55
Cliftonville,9059,3,14,7,9,55,44,11,49
Coleraine,9059,4,11,13,6,47,39,8,46
Ballymena,9059,5,12,7,11,60,61,-1,43
Dungannon,9059,6,11,8,11,51,44,7,41
Glenavon,9059,7,8,15,7,46,47,-1,39
Glentoran,9059,8,9,7,14,36,51,-15,34
Ards,9059,9,9,6,15,37,47,-10,33
Ballinamalla,9059,10,7,5,18,31,57,-26,26
Portadown,9059,11,7,5,18,22,49,-27,26
Linfield,9060,1,17,7,6,58,26,32,58
Crusaders,9060,2,16,7,7,48,35,13,55
Cliftonville,9060,3,15,7,8,56,42,14,52
Coleraine,9060,4,13,9,8,42,33,9,48
Glenavon,9060,5,11,11,8,47,41,6,44
Ballymena,9060,6,12,8,10,60,60,0,44
Dungannon,9060,7,9,10,11,46,41,5,37
Ards,9060,8,10,5,15,37,47,-10,35
Glentoran,9060,9,8,7,15,28,48,-20,31
Ballinamalla,9060,10,6,8,16,22,45,-23,26
Portadown,9060,11,6,5,19,21,47,-26,23
Crusaders,9061,1,22,5,3,66,24,42,71
Linfield,9061,2,14,8,8,49,28,21,50
Cliftonville,9061,3,13,6,11,52,43,9,45
Dungannon,9061,4,12,8,10,50,42,8,44
Glenavon,9061,5,11,10,9,49,46,3,43
Coleraine,9061,6,11,9,10,38,40,-2,42
Ballymena,9061,7,12,6,12,54,60,-6,42
Ards,9061,8,11,2,17,40,50,-10,35
Portadown,9061,9,9,4,17,27,47,-20,31
Glentoran,9061,10,7,8,15,26,48,-22,29
Ballinamalla,9061,11,8,4,18,30,53,-23,28
Crusaders,9062,1,16,6,8,51,35,16,54
Linfield,9062,2,13,11,6,55,30,25,50
Cliftonville,9062,3,14,6,10,53,43,10,48
Glenavon,9062,4,12,11,7,48,44,4,47
Dungannon,9062,5,12,9,9,53,36,17,45
Coleraine,9062,6,11,11,8,43,35,8,44
Ballymena,9062,7,12,7,11,56,63,-7,43
Ards,9062,8,10,6,14,44,52,-8,36
Glentoran,9062,9,7,10,13,30,46,-16,31
Portadown,9062,10,8,5,17,29,49,-20,29
Ballinamalla,9062,11,7,4,19,30,59,-29,25
Cliftonville,9063,1,17,5,8,55,35,20,56
Glenavon,9063,2,16,8,6,56,41,15,56
Linfield,9063,3,15,6,9,60,35,25,51
Crusaders,9063,4,14,7,9,54,44,10,49
Coleraine,9063,5,12,10,8,45,36,9,46
Ballymena,9063,6,13,5,12,58,54,4,44
Glentoran,9063,7,11,6,13,35,45,-10,39
Dungannon,9063,8,9,10,11,43,43,0,37
Ards,9063,9,10,4,16,37,52,-15,34
Portadown,9063,10,7,6,17,18,42,-24,27
Ballinamalla,9063,11,6,3,21,22,56,-34,21
Crusaders,9064,1,15,6,9,52,36,16,51
Glenavon,9064,2,13,12,5,54,40,14,51
Linfield,9064,3,14,8,8,62,37,25,50
Cliftonville,9064,4,15,5,10,56,41,15,50
Coleraine,9064,5,12,10,8,43,39,4,46
Ballymena,9064,6,13,5,12,60,68,-8,44
Glentoran,9064,7,11,6,13,37,45,-8,39
Dungannon,9064,8,9,11,10,50,41,9,38
Ards,9064,9,8,7,15,43,58,-15,31
Ballinamalla,9064,10,9,4,17,33,58,-25,31
Portadown,9064,11,6,6,18,25,52,-27,24
Crusaders,9065,1,15,10,5,50,27,23,55
Linfield,9065,2,15,9,6,63,35,28,54
Glenavon,9065,3,14,10,6,54,44,10,52
Ballymena,9065,4,14,6,10,59,55,4,48
Cliftonville,9065,5,13,7,10,50,41,9,46
Coleraine,9065,6,12,10,8,41,37,4,46
Glentoran,9065,7,10,10,10,30,38,-8,40
Dungannon,9065,8,8,10,12,43,43,0,34
Ballinamalla,9065,9,8,6,16,38,58,-20,30
Portadown,9065,10,6,6,18,25,51,-26,24
Ards,9065,11,4,8,18,31,55,-24,20
Linfield,9066,1,13,10,7,59,36,23,49
Crusaders,9066,2,13,10,7,54,42,12,49
Ballymena,9066,3,13,8,9,57,52,5,47
Dungannon,9066,4,13,7,10,62,48,14,46
Coleraine,9066,5,12,10,8,44,34,10,46
Glenavon,9066,6,12,10,8,50,50,0,46
Cliftonville,9066,7,12,8,10,45,37,8,44
Ards,9066,8,10,6,14,38,48,-10,36
Glentoran,9066,9,9,9,12,31,44,-13,36
Portadown,9066,10,7,5,18,30,55,-25,26
Ballinamalla,9066,11,6,7,17,26,50,-24,25
Linfield,9067,1,17,7,6,63,26,37,58
Cliftonville,9067,2,16,6,8,53,35,18,54
Glenavon,9067,3,14,9,7,51,42,9,51
Crusaders,9067,4,14,4,12,48,38,10,46
Ballymena,9067,5,13,7,10,49,53,-4,46
Dungannon,9067,6,11,7,12,48,43,5,40
Coleraine,9067,7,9,12,9,38,44,-6,39
Glentoran,9067,8,9,8,13,38,49,-11,35
Ards,9067,9,9,6,15,41,48,-7,33
Ballinamalla,9067,10,10,3,17,34,59,-25,33
Portadown,9067,11,7,3,20,19,45,-26,24
Crusaders,9068,1,17,7,6,58,38,20,58
Linfield,9068,2,15,11,4,59,31,28,56
Cliftonville,9068,3,17,4,9,56,37,19,55
Coleraine,9068,4,11,11,8,40,41,-1,44
Ballymena,9068,5,11,9,10,55,58,-3,42
Glenavon,9068,6,11,8,11,47,46,1,41
Glentoran,9068,7,11,7,12,36,45,-9,40
Dungannon,9068,8,9,12,9,53,43,10,39
Portadown,9068,9,6,9,15,23,43,-20,27
Ards,9068,10,7,4,19,31,52,-21,25
Ballinamalla,9068,11,6,6,18,22,46,-24,24
Cliftonville,9069,1,19,3,8,56,31,25,60
Linfield,9069,2,17,8,5,62,31,31,59
Crusaders,9069,3,14,11,5,48,29,19,53
Glenavon,9069,4,11,13,6,50,43,7,46
Dungannon,9069,5,9,13,8,49,38,11,40
Ards,9069,6,10,8,12,40,44,-4,38
Ballymena,9069,7,10,7,13,48,62,-14,37
Coleraine,9069,8,9,9,12,36,41,-5,36
Glentoran,9069,9,7,9,14,24,45,-21,30
Ballinamalla,9069,10,8,6,16,29,52,-23,30
Portadown,9069,11,4,7,19,27,53,-26,19
Linfield,9070,1,19,8,3,76,29,47,65
Crusaders,9070,2,18,7,5,60,32,28,61
Cliftonville,9070,3,15,4,11,62,46,16,49
Ballymena,9070,4,13,7,10,54,62,-8,46
Coleraine,9070,5,10,11,9,41,39,2,41
Glenavon,9070,6,10,9,11,44,50,-6,39
Portadown,9070,7,11,5,14,30,42,-12,38
Glentoran,9070,8,11,4,15,41,51,-10,37
Ballinamalla,9070,9,11,3,16,29,47,-18,36
Dungannon,9070,10,6,8,16,42,52,-10,26
Ards,9070,11,6,4,20,32,61,-29,22
Coleraine,9071,1,17,8,5,47,31,16,59
Cliftonville,9071,2,17,5,8,50,31,19,56
Crusaders,9071,3,15,8,7,59,35,24,53
Linfield,9071,4,13,8,9,53,39,14,47
Ballymena,9071,5,13,5,12,56,61,-5,44
Glentoran,9071,6,11,7,12,36,41,-5,40
Glenavon,9071,7,10,10,10,47,53,-6,40
Dungannon,9071,8,10,7,13,52,53,-1,37
Ards,9071,9,9,3,18,40,50,-10,30
Ballinamalla,9071,10,8,6,16,32,50,-18,30
Portadown,9071,11,5,7,18,22,50,-28,22
Crusaders,9072,1,18,6,6,51,27,24,60
Cliftonville,9072,2,15,4,11,49,40,9,49
Linfield,9072,3,12,11,7,57,34,23,47
Glenavon,9072,4,11,11,8,44,40,4,44
Dungannon,9072,5,11,9,10,52,42,10,42
Coleraine,9072,6,11,9,10,38,35,3,42
Ballymena,9072,7,10,9,11,53,53,0,39
Glentoran,9072,8,10,6,14,26,51,-25,36
Ards,9072,9,10,5,15,33,46,-13,35
Portadown,9072,10,9,7,14,30,42,-12,34
Ballinamalla,9072,11,8,3,19,30,53,-23,27
Crusaders,9073,1,18,5,7,59,38,21,59
Cliftonville,9073,2,18,4,8,54,30,24,58
Ballymena,9073,3,14,8,8,57,53,4,50
Linfield,9073,4,11,13,6,52,33,19,46
Glenavon,9073,5,12,9,9,48,41,7,45
Coleraine,9073,6,11,10,9,36,34,2,43
Portadown,9073,7,10,6,14,26,43,-17,36
Glentoran,9073,8,9,6,15,29,41,-12,33
Dungannon,9073,9,8,8,14,48,57,-9,32
Ballinamalla,9073,10,8,5,17,31,53,-22,29
Ards,9073,11,7,4,19,37,54,-17,25
Cliftonville,9074,1,18,3,9,59,40,19,57
Crusaders,9074,2,16,6,8,53,32,21,54
Linfield,9074,3,13,11,6,61,32,29,50
Glenavon,9074,4,13,10,7,43,37,6,49
Ballymena,9074,5,13,7,10,54,59,-5,46
Dungannon,9074,6,11,9,10,46,38,8,42
Coleraine,9074,7,10,12,8,39,35,4,42
Ards,9074,8,9,6,15,38,46,-8,33
Ballinamalla,9074,9,8,4,18,29,56,-27,28
Glentoran,9074,10,6,9,15,27,47,-20,27
Portadown,9074,11,6,7,17,20,47,-27,25
Crusaders,9075,1,17,6,7,54,39,15,57
Linfield,9075,2,16,8,6,57,31,26,56
Glenavon,9075,3,14,8,8,50,49,1,50
Coleraine,9075,4,11,12,7,48,41,7,45
Ballymena,9075,5,12,9,9,54,54,0,45
Glentoran,9075,6,12,7,11,41,39,2,43
Cliftonville,9075,7,13,3,14,45,42,3,42
Dungannon,9075,8,11,8,11,57,48,9,41
Ballinamalla,9075,9,8,5,17,26,48,-22,29
Portadown,9075,10,8,4,18,30,46,-16,28
Ards,9075,11,4,8,18,30,55,-25,20
Linfield,9076,1,17,10,3,62,30,32,61
Crusaders,9076,2,16,9,5,60,35,25,57
Cliftonville,9076,3,16,6,8,52,37,15,54
Ballymena,9076,4,16,6,8,57,51,6,54
Coleraine,9076,5,12,9,9,51,41,10,45
Dungannon,9076,6,11,9,10,50,42,8,42
Glenavon,9076,7,10,10,10,49,52,-3,40
Ballinamalla,9076,8,11,1,18,38,55,-17,34
Glentoran,9076,9,7,7,16,28,49,-21,28
Ards,9076,10,7,5,18,31,54,-23,26
Portadown,9076,11,4,4,22,16,48,-32,16
Crusaders,9077,1,17,7,6,62,40,22,58
Linfield,9077,2,16,9,5,64,32,32,57
Glenavon,9077,3,14,10,6,44,37,7,52
Ballymena,9077,4,14,8,8,67,58,9,50
Cliftonville,9077,5,15,4,11,51,44,7,49
Coleraine,9077,6,11,10,9,44,45,-1,43
Dungannon,9077,7,10,7,13,49,46,3,37
Glentoran,9077,8,8,6,16,33,49,-16,30
Ards,9077,9,8,5,17,32,51,-19,29
Ballinamalla,9077,10,8,5,17,30,49,-19,29
Portadown,9077,11,5,7,18,26,51,-25,22
Linfield,9078,1,13,11,6,64,37,27,50
Crusaders,9078,2,13,9,8,50,37,13,48
Ballymena,9078,3,13,9,8,56,52,4,48
Coleraine,9078,4,12,10,8,44,40,4,46
Cliftonville,9078,5,13,7,10,46,44,2,46
Dungannon,9078,6,12,7,11,51,37,14,43
Glenavon,9078,7,11,10,9,45,44,1,43
Ards,9078,8,12,4,14,38,47,-9,40
Glentoran,9078,9,9,9,12,36,47,-11,36
Ballinamalla,9078,10,9,4,17,31,52,-21,31
Portadown,9078,11,5,6,19,26,50,-24,21
Linfield,9079,1,19,7,4,66,26,40,64
Crusaders,9079,2,19,6,5,59,30,29,63
Ballymena,9079,3,17,7,6,57,48,9,58
Glenavon,9079,4,14,9,7,49,39,10,51
Cliftonville,9079,5,13,6,11,48,39,9,45
Coleraine,9079,6,9,14,7,37,31,6,41
Glentoran,9079,7,8,8,14,30,45,-15,32
Dungannon,9079,8,6,11,13,41,51,-10,29
Portadown,9079,9,7,4,19,21,49,-28,25
Ards,9079,10,5,8,17,33,53,-20,23
Ballinamalla,9079,11,6,4,20,27,57,-30,22
Cliftonville,9080,1,14,8,8,63,47,16,50
Linfield,9080,2,13,10,7,58,35,23,49
Crusaders,9080,3,14,7,9,55,39,16,49
Coleraine,9080,4,10,12,8,47,37,10,42
Ballymena,9080,5,11,9,10,58,61,-3,42
Dungannon,9080,6,10,10,10,45,39,6,40
Glenavon,9080,7,9,12,9,46,51,-5,39
Ards,9080,8,11,5,14,45,48,-3,38
Ballinamalla,9080,9,11,4,15,31,44,-13,37
Glentoran,9080,10,9,8,13,31,49,-18,35
Portadown,9080,11,6,9,15,22,51,-29,27
Linfield,9081,1,17,8,5,58,24,34,59
Cliftonville,9081,2,18,3,9,59,34,25,57
Crusaders,9081,3,17,4,9,57,37,20,55
Ballymena,9081,4,15,5,10,54,50,4,50
Coleraine,9081,5,12,9,9,45,43,2,45
Glenavon,9081,6,10,10,10,43,45,-2,40
Dungannon,9081,7,10,8,12,51,55,-4,38
Ards,9081,8,9,5,16,33,49,-16,32
Ballinamalla,9081,9,8,7,15,31,53,-22,31
Glentoran,9081,10,7,7,16,30,47,-17,28
Portadown,9081,11,7,4,19,27,51,-24,25
Crusaders,9082,1,16,9,5,55,30,25,57
Linfield,9082,2,15,8,7,59,31,28,53
Cliftonville,9082,3,13,7,10,47,40,7,46
Ballymena,9082,4,11,12,7,59,59,0,45
Dungannon,9082,5,12,8,10,51,45,6,44
Coleraine,9082,6,9,14,7,44,43,1,41
Glentoran,9082,7,10,9,11,37,45,-8,39
Glenavon,9082,8,8,14,8,40,44,-4,38
Portadown,9082,9,8,5,17,21,38,-17,29
Ards,9082,10,7,6,17,31,47,-16,27
Ballinamalla,9082,11,7,6,17,32,54,-22,27
Cliftonville,9083,1,20,2,8,59,32,27,62
Linfield,9083,2,15,9,6,56,29,27,54
Crusaders,9083,3,14,9,7,52,39,13,51
Ballymena,9083,4,15,3,12,63,59,4,48
Glenavon,9083,5,12,10,8,52,49,3,46
Coleraine,9083,6,10,11,9,41,38,3,41
Glentoran,9083,7,9,8,13,32,46,-14,35
Ards,9083,8,9,5,16,34,51,-17,32
Dungannon,9083,9,7,10,13,43,49,-6,31
Ballinamalla,9083,10,7,8,15,34,52,-18,29
Portadown,9083,11,6,7,17,25,47,-22,25
Linfield,9084,1,17,9,4,62,30,32,60
Cliftonville,9084,2,18,4,8,65,37,28,58
Crusaders,9084,3,16,5,9,54,37,17,53
Glenavon,9084,4,14,8,8,56,49,7,50
Glentoran,9084,5,12,9,9,39,38,1,45
Ballymena,9084,6,12,7,11,55,62,-7,43
Dungannon,9084,7,10,8,12,44,43,1,38
Coleraine,9084,8,9,9,12,34,40,-6,36
Ards,9084,9,7,8,15,31,51,-20,29
Portadown,9084,10,6,6,18,25,51,-26,24
Ballinamalla,9084,11,5,5,20,26,53,-27,20
Crusaders,9085,1,19,7,4,53,30,23,64
Cliftonville,9085,2,16,6,8,49,35,14,54
Glenavon,9085,3,14,10,6,51,41,10,52
Ballymena,9085,4,14,6,10,69,59,10,48
Coleraine,9085,5,12,11,7,43,34,9,47
Linfield,9085,6,11,11,8,50,33,17,44
Glentoran,9085,7,9,9,12,33,44,-11,36
Dungannon,9085,8,8,9,13,53,49,4,33
Ards,9085,9,6,8,16,30,51,-21,26
Portadown,9085,10,4,10,16,16,42,-26,22
Ballinamalla,9085,11,5,7,18,20,49,-29,22
Ballymena,9086,1,17,6,7,63,50,13,57
Crusaders,9086,2,17,5,8,56,36,20,56
Cliftonville,9086,3,16,4,10,54,41,13,52
Coleraine,9086,4,11,11,8,45,42,3,44
Dungannon,9086,5,11,9,10,46,39,7,42
Linfield,9086,6,9,13,8,49,36,13,40
Glenavon,9086,7,8,11,11,44,49,-5,35
Glentoran,9086,8,8,10,12,37,45,-8,34
Ards,9086,9,9,6,15,37,51,-14,33
Portadown,9086,10,8,6,16,29,51,-22,30
Ballinamalla,9086,11,6,9,15,33,53,-20,27
Crusaders,9087,1,19,7,4,63,33,30,64
Linfield,9087,2,15,7,8,59,34,25,52
Glenavon,9087,3,12,11,7,50,41,9,47
Dungannon,9087,4,13,7,10,59,48,11,46
Cliftonville,9087,5,14,4,12,57,49,8,46
Coleraine,9087,6,12,9,9,44,38,6,45
Ballymena,9087,7,12,8,10,49,50,-1,44
Ards,9087,8,8,5,17,32,48,-16,29
Glentoran,9087,9,7,8,15,32,56,-24,29
Ballinamalla,9087,10,8,4,18,27,54,-27,28
Portadown,9087,11,7,6,17,28,49,-21,27
Crusaders,9088,1,19,5,6,56,30,26,62
Linfield,9088,2,16,9,5,61,28,33,57
Cliftonville,9088,3,15,6,9,49,39,10,51
Ballymena,9088,4,15,6,9,59,51,8,51
Glenavon,9088,5,12,11,7,52,46,6,47
Coleraine,9088,6,8,11,11,39,47,-8,35
Glentoran,9088,7,9,5,16,28,51,-23,32
Dungannon,9088,8,7,10,13,46,46,0,31
Ballinamalla,9088,9,9,4,17,34,52,-18,31
Portadown,9088,10,8,6,16,24,39,-15,30
Ards,9088,11,8,5,17,33,52,-19,29
Cliftonville,9089,1,17,7,6,56,32,24,58
Crusaders,9089,2,17,7,6,57,36,21,58
Coleraine,9089,3,13,9,8,50,39,11,48
Linfield,9089,4,12,10,8,53,36,17,46
Glenavon,9089,5,10,11,9,49,46,3,41
Glentoran,9089,6,10,9,11,34,38,-4,39
Dungannon,9089,7,9,9,12,55,59,-4,36
Ards,9089,8,10,6,14,39,45,-6,36
Ballymena,9089,9,10,6,14,53,68,-15,36
Portadown,9089,10,7,8,15,27,49,-22,29
Ballinamalla,9089,11,5,8,17,23,48,-25,23
Crusaders,9090,1,18,7,5,59,33,26,61
Cliftonville,9090,2,16,5,9,47,31,16,53
Linfield,9090,3,11,12,7,47,32,15,45
Dungannon,9090,4,11,10,9,55,46,9,43
Ballymena,9090,5,12,7,11,53,53,0,43
Coleraine,9090,6,10,12,8,42,40,2,42
Glenavon,9090,7,10,11,9,46,46,0,41
Ards,9090,8,10,6,14,32,42,-10,36
Glentoran,9090,9,7,10,13,29,46,-17,31
Ballinamalla,9090,10,8,5,17,28,49,-21,29
Portadown,9090,11,6,7,17,20,40,-20,25
Crusaders,9091,1,16,8,6,56,42,14,56
Linfield,9091,2,14,10,6,59,28,31,52
Cliftonville,9091,3,15,7,8,54,33,21,52
Coleraine,9091,4,11,12,7,40,40,0,45
Ards,9091,5,13,6,11,40,41,-1,45
Glentoran,9091,6,11,7,12,36,39,-3,40
Glenavon,9091,7,9,11,10,48,49,-1,38
Ballymena,9091,8,10,8,12,50,58,-8,38
Dungannon,9091,9,10,6,14,52,50,2,36
Ballinamalla,9091,10,8,5,17,27,54,-27,29
Portadown,9091,11,4,8,18,21,49,-28,20
Cliftonville,9092,1,19,3,8,58,37,21,60
Crusaders,9092,2,16,7,7,52,30,22,55
Linfield,9092,3,14,10,6,60,34,26,52
Glenavon,9092,4,14,8,8,50,40,10,50
Dungannon,9092,5,11,8,11,46,41,5,41
Coleraine,9092,6,10,9,11,40,46,-6,39
Glentoran,9092,7,10,7,13,28,36,-8,37
Ballymena,9092,8,10,7,13,55,67,-12,37
Ards,9092,9,11,4,15,39,52,-13,37
Ballinamalla,9092,10,8,4,18,31,53,-22,28
Portadown,9092,11,6,5,19,20,43,-23,23
Linfield,9093,1,14,10,6,59,29,30,52
Cliftonville,9093,2,16,4,10,50,39,11,52
Glenavon,9093,3,12,14,4,48,34,14,50
Crusaders,9093,4,14,6,10,56,40,16,48
Ballymena,9093,5,13,7,10,47,52,-5,46
Glentoran,9093,6,11,6,13,28,43,-15,39
Coleraine,9093,7,9,10,11,33,32,1,37
Portadown,9093,8,10,7,13,31,40,-9,37
Dungannon,9093,9,9,9,12,46,44,2,36
Ballinamalla,9093,10,8,5,17,32,58,-26,29
Ards,9093,11,6,8,16,32,51,-19,26
Linfield,9094,1,15,10,5,59,30,29,55
Crusaders,9094,2,15,7,8,52,36,16,52
Cliftonville,9094,3,15,6,9,56,40,16,51
Glenavon,9094,4,11,12,7,51,48,3,45
Coleraine,9094,5,10,12,8,40,37,3,42
Dungannon,9094,6,9,11,10,51,46,5,38
Ballymena,9094,7,10,8,12,51,61,-10,38
Ballinamalla,9094,8,11,5,14,37,51,-14,38
Portadown,9094,9,9,6,15,32,42,-10,33
Glentoran,9094,10,8,7,15,27,48,-21,31
Ards,9094,11,7,6,17,30,47,-17,27
Crusaders,9095,1,19,7,4,56,30,26,64
Cliftonville,9095,2,17,5,8,51,37,14,56
Linfield,9095,3,14,8,8,59,39,20,50
Glenavon,9095,4,11,13,6,43,37,6,46
Coleraine,9095,5,11,8,11,35,37,-2,41
Ballymena,9095,6,11,7,12,54,61,-7,40
Dungannon,9095,7,8,9,13,44,41,3,33
Ballinamalla,9095,8,10,3,17,34,49,-15,33
Ards,9095,9,9,5,16,39,46,-7,32
Portadown,9095,10,9,5,16,30,46,-16,32
Glentoran,9095,11,8,6,16,29,51,-22,30
Crusaders,9096,1,19,7,4,61,30,31,64
Linfield,9096,2,16,9,5,63,30,33,57
Cliftonville,9096,3,15,6,9,55,37,18,51
Ballymena,9096,4,14,6,10,59,65,-6,48
Glentoran,9096,5,12,7,11,35,37,-2,43
Coleraine,9096,6,10,11,9,44,44,0,41
Glenavon,9096,7,10,10,10,50,50,0,40
Ards,9096,8,9,5,16,43,53,-10,32
Portadown,9096,9,8,6,16,28,49,-21,30
Dungannon,9096,10,5,11,14,39,51,-12,26
Ballinamalla,9096,11,6,4,20,27,58,-31,22
Crusaders,9097,1,21,7,2,67,26,41,70
Cliftonville,9097,2,14,10,6,50,35,15,52
Dungannon,9097,3,12,9,9,52,40,12,45
Ballymena,9097,4,12,7,11,56,59,-3,43
Linfield,9097,5,10,10,10,52,41,11,40
Coleraine,9097,6,8,13,9,39,40,-1,37
Glentoran,9097,7,9,10,11,34,43,-9,37
Glenavon,9097,8,9,8,13,45,56,-11,35
Ballinamalla,9097,9,10,4,16,32,51,-19,34
Ards,9097,10,9,6,15,34,45,-11,33
Portadown,9097,11,6,6,18,25,50,-25,24
Linfield,9098,1,16,11,3,68,31,37,59
Cliftonville,9098,2,17,3,10,56,36,20,54
Crusaders,9098,3,14,9,7,63,37,26,51
Coleraine,9098,4,12,9,9,45,36,9,45
Ballymena,9098,5,13,5,12,54,68,-14,44
Dungannon,9098,6,11,9,10,45,40,5,42
Glentoran,9098,7,10,6,14,35,55,-20,36
Glenavon,9098,8,7,13,10,48,55,-7,34
Ards,9098,9,8,7,15,36,51,-15,31
Ballinamalla,9098,10,7,8,15,31,50,-19,29
Portadown,9098,11,7,6,17,26,48,-22,27
Coleraine,9099,1,13,11,6,48,34,14,50
Crusaders,9099,2,14,7,9,53,39,14,49
Cliftonville,9099,3,15,4,11,53,49,4,49
Linfield,9099,4,13,8,9,57,37,20,47
Ballymena,9099,5,13,6,11,55,58,-3,45
Dungannon,9099,6,11,9,10,52,43,9,42
Portadown,9099,7,13,3,14,34,40,-6,42
Glenavon,9099,8,10,10,10,46,49,-3,40
Ards,9099,9,9,7,14,36,45,-9,34
Glentoran,9099,10,8,8,14,31,49,-18,32
Ballinamalla,9099,11,6,7,17,30,52,-22,25
Crusaders,9100,1,15,8,7,56,39,17,53
Linfield,9100,2,13,12,5,64,33,31,51
Cliftonville,9100,3,15,6,9,50,33,17,51
Ballymena,9100,4,14,8,8,62,55,7,50
Glenavon,9100,5,13,9,8,52,46,6,48
Glentoran,9100,6,10,8,12,33,45,-12,38
Dungannon,9100,7,9,9,12,50,53,-3,36
Coleraine,9100,8,9,9,12,37,44,-7,36
Ards,9100,9,9,6,15,35,47,-12,33
Portadown,9100,10,6,9,15,28,46,-18,27
Ballinamalla,9100,11,7,6,17,28,54,-26,27
Crusaders,9101,1,19,6,5,56,32,24,63
Ballymena,9101,2,16,7,7,60,53,7,55
Linfield,9101,3,12,10,8,55,30,25,46
Glenavon,9101,4,10,13,7,51,45,6,43
Cliftonville,9101,5,12,6,12,43,40,3,42
Coleraine,9101,6,11,9,10,39,39,0,42
Ards,9101,7,9,9,12,41,47,-6,36
Ballinamalla,9101,8,9,6,15,38,48,-10,33
Glentoran,9101,9,8,8,14,29,48,-19,32
Dungannon,9101,10,7,10,13,42,53,-11,31
Portadown,9101,11,8,4,18,27,46,-19,28
Crusaders,9102,1,17,8,5,63,37,26,59
Linfield,9102,2,14,11,5,59,34,25,53
Ballymena,9102,3,13,9,8,57,57,0,48
Cliftonville,9102,4,13,6,11,52,44,8,45
Coleraine,9102,5,11,10,9,39,40,-1,43
Dungannon,9102,6,10,10,10,47,41,6,40
Glenavon,9102,7,10,10,10,41,46,-5,40
Glentoran,9102,8,9,9,12,31,40,-9,36
Portadown,9102,9,9,7,14,39,45,-6,34
Ards,9102,10,9,6,15,46,56,-10,33
Ballinamalla,9102,11,6,2,22,23,57,-34,20
Ballymena,9103,1,19,3,8,69,53,16,60
Crusaders,9103,2,17,7,6,61,36,25,58
Cliftonville,9103,3,15,4,11,57,44,13,49
Linfield,9103,4,13,8,9,53,26,27,47
Coleraine,9103,5,12,9,9,44,41,3,45
Glenavon,9103,6,10,12,8,48,49,-1,42
Dungannon,9103,7,10,10,10,54,47,7,40
Glentoran,9103,8,9,7,14,27,41,-14,34
Ards,9103,9,8,6,16,32,53,-21,30
Ballinamalla,9103,10,7,5,18,31,55,-24,26
Portadown,9103,11,7,5,18,24,55,-31,26
Crusaders,9104,1,16,9,5,61,38,23,57
Cliftonville,9104,2,16,3,11,48,43,5,51
Linfield,9104,3,14,8,8,63,36,27,50
Ballymena,9104,4,14,8,8,65,59,6,50
Coleraine,9104,5,13,10,7,51,34,17,49
Glenavon,9104,6,13,10,7,53,43,10,49
Ards,9104,7,12,3,15,38,43,-5,39
Ballinamalla,9104,8,10,6,14,34,49,-15,36
Glentoran,9104,9,8,7,15,27,45,-18,31
Dungannon,9104,10,5,9,16,40,58,-18,24
Portadown,9104,11,5,5,20,22,54,-32,20
Cliftonville,9105,1,15,7,8,57,39,18,52
Linfield,9105,2,12,11,7,50,30,20,47
Coleraine,9105,3,12,11,7,43,37,6,47
Crusaders,9105,4,12,10,8,51,42,9,46
Glenavon,9105,5,10,12,8,47,47,0,42
Glentoran,9105,6,11,9,10,26,34,-8,42
Dungannon,9105,7,10,10,10,53,43,10,40
Ballymena,9105,8,10,7,13,47,61,-14,37
Ballinamalla,9105,9,9,7,14,37,46,-9,34
Ards,9105,10,9,7,14,34,43,-9,34
Portadown,9105,11,5,9,16,28,51,-23,24
Crusaders,9106,1,20,6,4,61,28,33,66
Ballymena,9106,2,16,6,8,68,58,10,54
Cliftonville,9106,3,16,5,9,55,40,15,53
Coleraine,9106,4,12,11,7,40,36,4,47
Linfield,9106,5,10,11,9,53,38,15,41
Glenavon,9106,6,10,10,10,44,44,0,40
Dungannon,9106,7,10,9,11,46,43,3,39
Ards,9106,8,9,5,16,36,47,-11,32
Glentoran,9106,9,7,10,13,27,49,-22,31
Portadown,9106,10,8,5,17,25,44,-19,29
Ballinamalla,9106,11,7,2,21,24,52,-28,23
Crusaders,9107,1,16,9,5,55,28,27,57
Cliftonville,9107,2,16,5,9,54,35,19,53
Glenavon,9107,3,13,10,7,46,45,1,49
Linfield,9107,4,11,13,6,57,34,23,46
Ballymena,9107,5,13,7,10,58,58,0,46
Dungannon,9107,6,11,10,9,49,39,10,43
Coleraine,9107,7,9,12,9,43,44,-1,39
Glentoran,9107,8,8,11,11,27,42,-15,35
Ards,9107,9,8,7,15,36,48,-12,31
Ballinamalla,9107,10,6,9,15,25,44,-19,27
Portadown,9107,11,4,7,19,21,54,-33,19
Crusaders,9108,1,16,9,5,59,34,25,57
Linfield,9108,2,15,9,6,61,32,29,54
Cliftonville,9108,3,15,7,8,53,39,14,52
Ballymena,9108,4,14,8,8,55,51,4,50
Glentoran,9108,5,13,9,8,40,33,7,48
Coleraine,9108,6,10,13,7,46,41,5,43
Glenavon,9108,7,10,12,8,53,53,0,42
Dungannon,9108,8,9,8,13,45,53,-8,35
Ards,9108,9,8,3,19,36,55,-19,27
Portadown,9108,10,5,7,18,31,55,-24,22
Ballinamalla,9108,11,5,5,20,24,57,-33,20
Crusaders,9109,1,16,7,7,53,37,16,55
Linfield,9109,2,13,12,5,57,36,21,51
Cliftonville,9109,3,15,6,9,49,36,13,51
Glenavon,9109,4,14,9,7,58,46,12,51
Ballymena,9109,5,15,5,10,61,54,7,50
Coleraine,9109,6,9,12,9,37,39,-2,39
Glentoran,9109,7,9,10,11,38,45,-7,37
Ards,9109,8,9,8,13,37,47,-10,35
Dungannon,9109,9,8,9,13,49,50,-1,33
Ballinamalla,9109,10,8,2,20,36,58,-22,26
Portadown,9109,11,6,6,18,24,51,-27,24
Crusaders,9110,1,16,8,6,55,35,20,56
Ballymena,9110,2,16,7,7,67,52,15,55
Cliftonville,9110,3,14,8,8,55,40,15,50
Coleraine,9110,4,12,12,6,47,39,8,48
Linfield,9110,5,12,9,9,53,30,23,45
Glenavon,9110,6,12,8,10,43,40,3,44
Glentoran,9110,7,10,6,14,27,43,-16,36
Dungannon,9110,8,8,10,12,47,51,-4,34
Ards,9110,9,8,6,16,32,45,-13,30
Ballinamalla,9110,10,7,7,16,26,52,-26,28
Portadown,9110,11,8,3,19,21,46,-25,27
Crusaders,9111,1,19,8,3,61,28,33,65
Ballymena,9111,2,16,6,8,64,58,6,54
Coleraine,9111,3,14,10,6,46,29,17,52
Linfield,9111,4,14,9,7,53,31,22,51
Cliftonville,9111,5,12,5,13,43,45,-2,41
Glenavon,9111,6,10,10,10,51,51,0,40
Dungannon,9111,7,10,9,11,44,39,5,39
Ards,9111,8,9,6,15,45,50,-5,33
Glentoran,9111,9,6,11,13,21,39,-18,29
Portadown,9111,10,8,5,17,26,51,-25,29
Ballinamalla,9111,11,5,5,20,23,56,-33,20
Crusaders,9112,1,21,5,4,68,25,43,68
Cliftonville,9112,2,16,5,9,55,37,18,53
Linfield,9112,3,14,7,9,57,39,18,49
Ballymena,9112,4,12,8,10,53,57,-4,44
Glenavon,9112,5,11,9,10,49,48,1,42
Coleraine,9112,6,10,10,10,41,57,-16,40
Ballinamalla,9112,7,12,3,15,39,48,-9,39
Glentoran,9112,8,10,7,13,33,42,-9,37
Ards,9112,9,9,4,17,44,58,-14,31
Portadown,9112,10,8,5,17,24,42,-18,29
Dungannon,9112,11,6,9,15,42,52,-10,27
Crusaders,9113,1,15,8,7,51,40,11,53
Linfield,9113,2,13,10,7,60,31,29,49
Ballymena,9113,3,12,8,10,53,57,-4,44
Dungannon,9113,4,12,7,11,54,41,13,43
Glenavon,9113,5,11,10,9,53,45,8,43
Cliftonville,9113,6,12,7,11,42,41,1,43
Coleraine,9113,7,10,12,8,40,38,2,42
Ards,9113,8,12,3,15,35,50,-15,39
Glentoran,9113,9,10,8,12,30,37,-7,38
Ballinamalla,9113,10,9,5,16,37,52,-15,32
Portadown,9113,11,8,4,18,22,45,-23,28
Crusaders,9114,1,18,8,4,55,31,24,62
Glenavon,9114,2,13,10,7,61,45,16,49
Linfield,9114,3,12,9,9,53,32,21,45
Cliftonville,9114,4,12,7,11,43,42,1,43
Ballymena,9114,5,12,6,12,53,60,-7,42
Dungannon,9114,6,11,7,12,49,45,4,40
Glentoran,9114,7,11,7,12,32,39,-7,40
Coleraine,9114,8,9,11,10,43,48,-5,38
Ards,9114,9,9,7,14,38,46,-8,34
Ballinamalla,9114,10,10,2,18,34,57,-23,32
Portadown,9114,11,8,6,16,29,45,-16,30
Crusaders,9115,1,17,7,6,52,26,26,58
Cliftonville,9115,2,18,3,9,59,38,21,57
Glenavon,9115,3,14,10,6,54,37,17,52
Linfield,9115,4,13,9,8,52,31,21,48
Coleraine,9115,5,11,9,10,41,42,-1,42
Ballymena,9115,6,12,3,15,51,64,-13,39
Ards,9115,7,10,7,13,38,44,-6,37
Glentoran,9115,8,10,7,13,25,41,-16,37
Dungannon,9115,9,7,10,13,41,45,-4,31
Ballinamalla,9115,10,8,6,16,28,49,-21,30
Portadown,9115,11,6,7,17,23,47,-24,25
Linfield,9116,1,17,7,6,60,33,27,58
Cliftonville,9116,2,15,4,11,57,46,11,49
Coleraine,9116,3,12,12,6,42,32,10,48
Glenavon,9116,4,13,8,9,54,48,6,47
Crusaders,9116,5,13,6,11,49,41,8,45
Dungannon,9116,6,11,9,10,49,45,4,42
Ballymena,9116,7,11,7,12,59,64,-5,40
Glentoran,9116,8,11,6,13,36,46,-10,39
Ballinamalla,9116,9,11,4,15,41,50,-9,37
Portadown,9116,10,8,4,18,29,50,-21,28
Ards,9116,11,8,3,19,36,57,-21,27
Crusaders,9117,1,16,9,5,51,28,23,57
Ballymena,9117,2,15,7,8,62,58,4,52
Linfield,9117,3,13,11,6,62,28,34,50
Cliftonville,9117,4,13,9,8,47,35,12,48
Coleraine,9117,5,13,9,8,41,36,5,48
Glenavon,9117,6,11,9,10,47,53,-6,42
Glentoran,9117,7,11,7,12,34,40,-6,40
Ballinamalla,9117,8,10,6,14,39,53,-14,36
Dungannon,9117,9,8,10,12,42,43,-1,34
Portadown,9117,10,7,4,19,28,52,-24,25
Ards,9117,11,4,7,19,29,56,-27,19
Crusaders,9118,1,17,7,6,61,40,21,58
Linfield,9118,2,15,10,5,55,29,26,55
Glenavon,9118,3,13,9,8,55,47,8,48
Cliftonville,9118,4,14,5,11,46,37,9,47
Ballymena,9118,5,13,8,9,49,52,-3,47
Coleraine,9118,6,11,10,9,40,38,2,43
Dungannon,9118,7,10,9,11,53,48,5,39
Glentoran,9118,8,8,10,12,31,41,-10,34
Portadown,9118,9,7,7,16,27,43,-16,28
Ards,9118,10,8,3,19,37,57,-20,27
Ballinamalla,9118,11,6,8,16,29,51,-22,26
Ballymena,9119,1,18,6,6,66,48,18,60
Linfield,9119,2,14,10,6,51,30,21,52
Coleraine,9119,3,13,11,6,48,33,15,50
Crusaders,9119,4,13,8,9,46,36,10,47
Cliftonville,9119,5,13,6,11,49,40,9,45
Dungannon,9119,6,11,7,12,47,42,5,40
Glenavon,9119,7,9,12,9,39,41,-2,39
Glentoran,9119,8,10,7,13,42,52,-10,37
Ballinamalla,9119,9,9,5,16,30,48,-18,32
Ards,9119,10,7,8,15,31,49,-18,29
Portadown,9119,11,4,8,18,19,49,-30,20
Crusaders,9120,1,20,6,4,70,31,39,66
Linfield,9120,2,15,10,5,58,28,30,55
Cliftonville,9120,3,16,5,9,57,39,18,53
Ballymena,9120,4,14,5,11,57,59,-2,47
Glenavon,9120,5,9,12,9,42,46,-4,39
Glentoran,9120,6,10,9,11,31,37,-6,39
Dungannon,9120,7,10,8,12,45,46,-1,38
Coleraine,9120,8,8,11,11,38,40,-2,35
Portadown,9120,9,8,6,16,22,44,-22,30
Ballinamalla,9120,10,6,8,16,26,49,-23,26
Ards,9120,11,6,6,18,31,58,-27,24
Crusaders,9121,1,19,6,5,58,24,34,63
Linfield,9121,2,15,9,6,57,30,27,54
Cliftonville,9121,3,14,6,10,48,37,11,48
Ballymena,9121,4,13,9,8,63,62,1,48
Glenavon,9121,5,11,10,9,40,42,-2,43
Coleraine,9121,6,9,11,10,38,37,1,38
Dungannon,9121,7,10,8,12,48,48,0,38
Glentoran,9121,8,9,7,14,24,37,-13,34
Ards,9121,9,9,4,17,31,47,-16,31
Ballinamalla,9121,10,9,4,17,33,52,-19,31
Portadown,9121,11,8,4,18,23,47,-24,28
Linfield,9122,1,16,8,6,62,34,28,56
Cliftonville,9122,2,16,4,10,57,40,17,52
Coleraine,9122,3,14,10,6,44,32,12,52
Crusaders,9122,4,14,8,8,49,36,13,50
Glenavon,9122,5,14,8,8,55,45,10,50
Glentoran,9122,6,12,6,12,35,44,-9,42
Ballymena,9122,7,11,5,14,47,59,-12,38
Dungannon,9122,8,9,9,12,54,48,6,36
Ards,9122,9,9,4,17,40,54,-14,31
Ballinamalla,9122,10,9,3,18,34,53,-19,30
Portadown,9122,11,6,5,19,19,51,-32,23
Cliftonville,9123,1,17,6,7,60,41,19,57
Crusaders,9123,2,13,12,5,51,32,19,51
Dungannon,9123,3,13,9,8,58,42,16,48
Glenavon,9123,4,12,11,7,50,40,10,47
Linfield,9123,5,12,9,9,60,42,18,45
Ballymena,9123,6,12,6,12,54,62,-8,42
Coleraine,9123,7,9,12,9,39,38,1,39
Glentoran,9123,8,11,5,14,33,43,-10,38
Portadown,9123,9,9,6,15,32,50,-18,33
Ards,9123,10,7,5,18,34,56,-22,26
Ballinamalla,9123,11,7,5,18,31,56,-25,26
Linfield,9124,1,14,12,4,67,36,31,54
Crusaders,9124,2,14,10,6,57,36,21,52
Cliftonville,9124,3,15,6,9,60,40,20,51
Glenavon,9124,4,13,9,8,49,42,7,48
Ballymena,9124,5,12,8,10,56,61,-5,44
Ards,9124,6,12,3,15,43,46,-3,39
Dungannon,9124,7,10,8,12,48,52,-4,38
Portadown,9124,8,9,7,14,31,49,-18,34
Coleraine,9124,9,7,10,13,38,51,-13,31
Ballinamalla,9124,10,9,4,17,32,54,-22,31
Glentoran,9124,11,6,11,13,31,45,-14,29
Crusaders,9125,1,16,9,5,54,32,22,57
Cliftonville,9125,2,17,5,8,62,37,25,56
Linfield,9125,3,14,11,5,54,31,23,53
Ballymena,9125,4,15,6,9,58,51,7,51
Coleraine,9125,5,13,9,8,39,32,7,48
Glenavon,9125,6,10,12,8,45,41,4,42
Dungannon,9125,7,9,8,13,51,50,1,35
Ards,9125,8,10,4,16,36,48,-12,34
Glentoran,9125,9,8,7,15,31,54,-23,31
Portadown,9125,10,7,4,19,25,56,-31,25
Ballinamalla,9125,11,5,7,18,28,51,-23,22
Crusaders,9126,1,16,11,3,64,34,30,59
Linfield,9126,2,16,7,7,63,36,27,55
Cliftonville,9126,3,17,4,9,61,40,21,55
Coleraine,9126,4,14,10,6,49,33,16,52
Ballymena,9126,5,14,6,10,60,64,-4,48
Dungannon,9126,6,11,9,10,55,48,7,42
Glenavon,9126,7,8,10,12,50,55,-5,34
Portadown,9126,8,10,3,17,39,51,-12,33
Glentoran,9126,9,8,9,13,36,51,-15,33
Ballinamalla,9126,10,7,3,20,31,65,-34,24
Ards,9126,11,7,2,21,26,57,-31,23
Crusaders,9127,1,18,7,5,66,38,28,61
Linfield,9127,2,17,8,5,59,27,32,59
Cliftonville,9127,3,14,4,12,46,36,10,46
Dungannon,9127,4,12,9,9,57,46,11,45
Ballymena,9127,5,13,5,12,59,58,1,44
Glenavon,9127,6,11,10,9,47,49,-2,43
Coleraine,9127,7,9,10,11,42,47,-5,37
Ards,9127,8,10,6,14,35,43,-8,36
Ballinamalla,9127,9,9,3,18,33,58,-25,30
Portadown,9127,10,7,8,15,20,38,-18,29
Glentoran,9127,11,8,4,18,30,54,-24,28
Ballymena,9128,1,17,5,8,62,52,10,56
Crusaders,9128,2,15,9,6,52,32,20,54
Coleraine,9128,3,14,10,6,52,33,19,52
Cliftonville,9128,4,14,6,10,51,39,12,48
Linfield,9128,5,12,11,7,56,32,24,47
Glenavon,9128,6,9,14,7,43,42,1,41
Glentoran,9128,7,8,10,12,23,43,-20,34
Dungannon,9128,8,7,12,11,45,52,-7,33
Ards,9128,9,9,6,15,35,50,-15,33
Ballinamalla,9128,10,8,2,20,29,53,-24,26
Portadown,9128,11,6,7,17,29,49,-20,25
Cliftonville,9129,1,19,3,8,59,38,21,60
Crusaders,9129,2,16,6,8,50,33,17,54
Linfield,9129,3,14,9,7,58,32,26,51
Coleraine,9129,4,13,9,8,41,38,3,48
Glenavon,9129,5,12,10,8,50,49,1,46
Ballymena,9129,6,12,7,11,60,65,-5,43
Dungannon,9129,7,10,8,12,51,45,6,38
Glentoran,9129,8,9,9,12,30,40,-10,36
Ballinamalla,9129,9,8,5,17,35,55,-20,29
Portadown,9129,10,7,5,18,24,48,-24,26
Ards,9129,11,5,9,16,34,49,-15,24
Crusaders,9130,1,18,6,6,56,34,22,60
Cliftonville,9130,2,15,5,10,52,41,11,50
Linfield,9130,3,12,10,8,53,37,16,46
Glenavon,9130,4,11,11,8,50,48,2,44
Ballymena,9130,5,12,7,11,54,57,-3,43
Dungannon,9130,6,11,9,10,54,44,10,42
Coleraine,9130,7,10,12,8,42,42,0,42
Portadown,9130,8,10,6,14,31,41,-10,36
Glentoran,9130,9,10,6,14,30,42,-12,36
Ards,9130,10,7,9,14,35,47,-12,30
Ballinamalla,9130,11,6,5,19,27,51,-24,23
Crusaders,9131,1,19,7,4,54,29,25,64
Linfield,9131,2,12,12,6,52,27,25,48
Cliftonville,9131,3,13,6,11,50,40,10,45
Coleraine,9131,4,11,12,7,43,35,8,45
Ballymena,9131,5,12,9,9,51,52,-1,45
Glenavon,9131,6,11,9,10,46,45,1,42
Glentoran,9131,7,10,8,12,33,40,-7,38
Dungannon,9131,8,9,10,11,42,41,1,37
Portadown,9131,9,7,8,15,23,43,-20,29
Ards,9131,10,8,5,17,28,49,-21,29
Ballinamalla,9131,11,7,6,17,31,52,-21,27
Crusaders,9132,1,17,6,7,54,40,14,57
Linfield,9132,2,15,8,7,61,38,23,53
Cliftonville,9132,3,15,6,9,61,39,22,51
Glentoran,9132,4,13,5,12,41,43,-2,44
Coleraine,9132,5,11,10,9,41,37,4,43
Glenavon,9132,6,10,12,8,47,49,-2,42
Ballymena,9132,7,12,6,12,58,62,-4,42
Ballinamalla,9132,8,12,1,17,36,49,-13,37
Ards,9132,9,11,3,16,39,48,-9,36
Dungannon,9132,10,6,11,13,46,52,-6,29
Portadown,9132,11,6,6,18,19,46,-27,24
Cliftonville,9133,1,17,6,7,53,35,18,57
Crusaders,9133,2,15,6,9,49,33,16,51
Linfield,9133,3,14,8,8,63,36,27,50
Glenavon,9133,4,13,10,7,47,39,8,49
Coleraine,9133,5,11,11,8,42,38,4,44
Glentoran,9133,6,12,7,11,36,37,-1,43
Dungannon,9133,7,11,7,12,51,42,9,40
Ballymena,9133,8,11,5,14,45,58,-13,38
Portadown,9133,9,10,4,16,31,55,-24,34
Ards,9133,10,7,5,18,37,49,-12,26
Ballinamalla,9133,11,7,5,18,23,55,-32,26
Crusaders,9134,1,15,11,4,59,35,24,56
Linfield,9134,2,14,12,4,61,35,26,54
Coleraine,9134,3,13,12,5,44,32,12,51
Cliftonville,9134,4,15,4,11,52,47,5,49
Dungannon,9134,5,11,11,8,54,40,14,44
Ballymena,9134,6,11,11,8,56,56,0,44
Glenavon,9134,7,7,12,11,43,51,-8,33
Glentoran,9134,8,7,10,13,33,46,-13,31
Ballinamalla,9134,9,8,5,17,28,49,-21,29
Portadown,9134,10,7,7,16,24,49,-25,28
Ards,9134,11,6,7,17,34,48,-14,25
Linfield,9135,1,14,11,5,56,31,25,53
Crusaders,9135,2,15,7,8,58,40,18,52
Glenavon,9135,3,14,9,7,46,40,6,51
Ballymena,9135,4,13,7,10,56,59,-3,46
Coleraine,9135,5,12,8,10,37,36,1,44
Cliftonville,9135,6,12,7,11,49,44,5,43
Portadown,9135,7,11,5,14,33,44,-11,38
Ballinamalla,9135,8,10,4,16,36,49,-13,34
Dungannon,9135,9,7,11,12,51,49,2,32
Glentoran,9135,10,7,11,12,34,50,-16,32
Ards,9135,11,7,6,17,31,45,-14,27
Crusaders,9136,1,18,6,6,59,35,24,60
Cliftonville,9136,2,17,5,8,55,35,20,56
Glenavon,9136,3,12,13,5,47,39,8,49
Linfield,9136,4,12,11,7,56,36,20,47
Coleraine,9136,5,11,9,10,44,39,5,42
Ballymena,9136,6,12,6,12,58,64,-6,42
Dungannon,9136,7,10,7,13,47,48,-1,37
Glentoran,9136,8,8,11,11,32,42,-10,35
Ballinamalla,9136,9,9,5,16,30,47,-17,32
Ards,9136,10,8,4,18,35,55,-20,28
Portadown,9136,11,7,5,18,23,46,-23,26
Cliftonville,9137,1,18,4,8,61,35,26,58
Crusaders,9137,2,16,7,7,58,38,20,55
Glenavon,9137,3,14,11,5,51,36,15,53
Linfield,9137,4,14,10,6,55,27,28,52
Coleraine,9137,5,11,10,9,44,38,6,43
Dungannon,9137,6,10,10,10,46,41,5,40
Ballymena,9137,7,10,7,13,50,66,-16,37
Glentoran,9137,8,8,9,13,26,40,-14,33
Ards,9137,9,9,4,17,42,61,-19,31
Ballinamalla,9137,10,8,4,18,23,48,-25,28
Portadown,9137,11,7,4,19,22,48,-26,25
Cliftonville,9138,1,18,5,7,56,33,23,59
Linfield,9138,2,14,10,6,59,30,29,52
Crusaders,9138,3,14,6,10,54,43,11,48
Ballymena,9138,4,14,6,10,57,56,1,48
Coleraine,9138,5,12,8,10,39,34,5,44
Glentoran,9138,6,12,7,11,36,36,0,43
Glenavon,9138,7,10,11,9,48,50,-2,41
Dungannon,9138,8,10,10,10,51,44,7,40
Ards,9138,9,11,4,15,39,50,-11,37
Portadown,9138,10,7,5,18,24,50,-26,26
Ballinamalla,9138,11,5,4,21,21,58,-37,19
Linfield,9139,1,16,8,6,61,32,29,56
Crusaders,9139,2,15,9,6,64,41,23,54
Cliftonville,9139,3,16,6,8,58,40,18,54
Glenavon,9139,4,13,9,8,52,43,9,48
Ballymena,9139,5,14,5,11,60,61,-1,47
Coleraine,9139,6,10,11,9,38,38,0,41
Glentoran,9139,7,9,10,11,30,42,-12,37
Dungannon,9139,8,8,11,11,50,51,-1,35
Portadown,9139,9,6,9,15,19,45,-26,27
Ards,9139,10,7,5,18,32,47,-15,26
Ballinamalla,9139,11,7,5,18,29,53,-24,26
Linfield,9140,1,16,7,7,55,27,28,55
Ballymena,9140,2,16,6,8,57,55,2,54
Cliftonville,9140,3,15,6,9,55,35,20,51
Glenavon,9140,4,13,11,6,49,38,11,50
Crusaders,9140,5,13,10,7,54,45,9,49
Coleraine,9140,6,12,8,10,45,39,6,44
Glentoran,9140,7,8,9,13,26,37,-11,33
Portadown,9140,8,9,6,15,27,40,-13,33
Dungannon,9140,9,7,10,13,50,54,-4,31
Ards,9140,10,9,4,17,35,55,-20,31
Ballinamalla,9140,11,7,3,20,22,50,-28,24
Cliftonville,9141,1,17,6,7,61,34,27,57
Linfield,9141,2,14,10,6,63,36,27,52
Crusaders,9141,3,15,4,11,49,44,5,49
Ballymena,9141,4,14,7,9,50,57,-7,49
Dungannon,9141,5,12,10,8,62,44,18,46
Coleraine,9141,6,11,12,7,38,33,5,45
Ards,9141,7,12,4,14,42,46,-4,40
Glenavon,9141,8,9,11,10,40,45,-5,38
Ballinamalla,9141,9,7,6,17,26,51,-25,27
Glentoran,9141,10,6,7,17,22,44,-22,25
Portadown,9141,11,5,9,16,20,39,-19,24
Linfield,9142,1,15,8,7,57,32,25,53
Crusaders,9142,2,14,7,9,49,41,8,49
Ballymena,9142,3,14,6,10,61,58,3,48
Glenavon,9142,4,12,9,9,48,48,0,45
Coleraine,9142,5,11,11,8,35,31,4,44
Cliftonville,9142,6,12,5,13,52,45,7,41
Ards,9142,7,12,5,13,41,42,-1,41
Glentoran,9142,8,10,6,14,38,47,-9,36
Portadown,9142,9,10,6,14,32,48,-16,36
Dungannon,9142,10,9,8,13,48,47,1,35
Ballinamalla,9142,11,6,9,15,34,56,-22,27
Linfield,9143,1,16,8,6,67,30,37,56
Crusaders,9143,2,14,8,8,51,38,13,50
Coleraine,9143,3,13,10,7,53,40,13,49
Cliftonville,9143,4,15,4,11,48,40,8,49
Glenavon,9143,5,11,9,10,57,55,2,42
Ards,9143,6,12,6,12,41,45,-4,42
Dungannon,9143,7,11,8,11,48,46,2,41
Ballymena,9143,8,11,7,12,48,61,-13,40
Ballinamalla,9143,9,10,4,16,32,43,-11,34
Portadown,9143,10,7,6,17,28,47,-19,27
Glentoran,9143,11,7,6,17,25,53,-28,27
Linfield,9144,1,19,8,3,69,25,44,65
Crusaders,9144,2,16,6,8,55,38,17,54
Cliftonville,9144,3,16,4,10,52,38,14,52
Ballymena,9144,4,13,6,11,56,56,0,45
Glenavon,9144,5,11,10,9,43,44,-1,43
Coleraine,9144,6,10,12,8,40,36,4,42
Dungannon,9144,7,9,9,12,50,42,8,36
Ards,9144,8,9,7,14,39,50,-11,34
Glentoran,9144,9,8,7,15,28,55,-27,31
Portadown,9144,10,6,9,15,25,43,-18,27
Ballinamalla,9144,11,7,4,19,30,60,-30,25
Linfield,9145,1,18,9,3,68,30,38,63
Cliftonville,9145,2,17,5,8,64,38,26,56
Crusaders,9145,3,15,8,7,57,36,21,53
Glenavon,9145,4,12,9,9,50,47,3,45
Coleraine,9145,5,11,9,10,44,38,6,42
Ballymena,9145,6,11,9,10,48,59,-11,42
Dungannon,9145,7,9,8,13,49,51,-2,35
Glentoran,9145,8,9,8,13,33,45,-12,35
Portadown,9145,9,9,7,14,28,41,-13,34
Ballinamalla,9145,10,8,3,19,28,57,-29,27
Ards,9145,11,7,3,20,30,57,-27,24
Glenavon,9146,1,16,9,5,54,36,18,57
Crusaders,9146,2,16,7,7,58,35,23,55
Linfield,9146,3,15,7,8,61,34,27,52
Cliftonville,9146,4,16,3,11,56,42,14,51
Ballymena,9146,5,13,6,11,63,66,-3,45
Coleraine,9146,6,10,11,9,33,32,1,41
Ards,9146,7,12,3,15,39,48,-9,39
Dungannon,9146,8,9,7,14,46,46,0,34
Ballinamalla,9146,9,9,5,16,30,49,-19,32
Glentoran,9146,10,8,7,15,25,46,-21,31
Portadown,9146,11,7,3,20,28,59,-31,24
Crusaders,9147,1,19,7,4,56,28,28,64
Cliftonville,9147,2,17,3,10,46,36,10,54
Coleraine,9147,3,14,7,9,55,36,19,49
Ballymena,9147,4,14,6,10,54,54,0,48
Dungannon,9147,5,12,9,9,53,41,12,45
Linfield,9147,6,12,8,10,57,38,19,44
Glenavon,9147,7,11,7,12,43,48,-5,40
Glentoran,9147,8,9,8,13,34,44,-10,35
Ballinamalla,9147,9,9,5,16,25,47,-22,32
Ards,9147,10,7,5,18,37,57,-20,26
Portadown,9147,11,6,5,19,22,53,-31,23
Cliftonville,9148,1,16,8,6,53,33,20,56
Linfield,9148,2,13,10,7,53,32,21,49
Crusaders,9148,3,13,10,7,51,36,15,49
Coleraine,9148,4,11,12,7,44,36,8,45
Ballymena,9148,5,13,6,11,53,56,-3,45
Dungannon,9148,6,11,9,10,55,44,11,42
Ards,9148,7,10,5,15,39,49,-10,35
Glentoran,9148,8,9,8,13,30,47,-17,35
Ballinamalla,9148,9,10,5,15,28,45,-17,35
Glenavon,9148,10,7,13,10,40,44,-4,34
Portadown,9148,11,6,6,18,26,50,-24,24
Crusaders,9149,1,14,13,3,51,29,22,55
Linfield,9149,2,14,8,8,55,32,23,50
Cliftonville,9149,3,14,8,8,51,39,12,50
Ballymena,9149,4,15,5,10,56,56,0,50
Glenavon,9149,5,11,12,7,53,46,7,45
Dungannon,9149,6,11,10,9,49,39,10,43
Ards,9149,7,12,5,13,41,44,-3,41
Coleraine,9149,8,8,11,11,39,47,-8,35
Glentoran,9149,9,9,6,15,34,47,-13,33
Ballinamalla,9149,10,8,8,14,28,46,-18,32
Portadown,9149,11,4,4,22,20,52,-32,16
Linfield,9150,1,16,9,5,70,34,36,57
Cliftonville,9150,2,17,4,9,52,43,9,55
Crusaders,9150,3,13,10,7,58,44,14,49
Ballymena,9150,4,14,7,9,50,50,0,49
Coleraine,9150,5,11,12,7,51,36,15,45
Glenavon,9150,6,10,13,7,43,45,-2,43
Dungannon,9150,7,11,8,11,56,43,13,41
Glentoran,9150,8,9,10,11,34,44,-10,37
Ards,9150,9,7,6,17,40,61,-21,27
Ballinamalla,9150,10,8,2,20,27,51,-24,26
Portadown,9150,11,5,7,18,29,59,-30,22
Cliftonville,9151,1,18,3,9,60,38,22,57
Linfield,9151,2,15,7,8,60,35,25,52
Crusaders,9151,3,14,7,9,51,41,10,49
Coleraine,9151,4,12,10,8,39,33,6,46
Ballymena,9151,5,13,5,12,52,61,-9,44
Dungannon,9151,6,12,7,11,51,43,8,43
Glenavon,9151,7,10,11,9,43,39,4,41
Glentoran,9151,8,10,7,13,36,42,-6,37
Ards,9151,9,9,5,16,49,56,-7,32
Portadown,9151,10,9,5,16,25,48,-23,32
Ballinamalla,9151,11,7,5,18,28,58,-30,26
Cliftonville,9152,1,17,5,8,52,34,18,56
Crusaders,9152,2,15,9,6,55,35,20,54
Linfield,9152,3,13,10,7,55,31,24,49
Ballymena,9152,4,13,6,11,52,54,-2,45
Coleraine,9152,5,11,11,8,43,39,4,44
Dungannon,9152,6,10,11,9,49,44,5,41
Glenavon,9152,7,8,16,6,44,38,6,40
Ards,9152,8,10,5,15,43,60,-17,35
Glentoran,9152,9,6,11,13,30,48,-18,29
Ballinamalla,9152,10,7,7,16,33,52,-19,28
Portadown,9152,11,6,7,17,21,42,-21,25
Linfield,9153,1,15,10,5,57,30,27,55
Ballymena,9153,2,16,4,10,60,51,9,52
Cliftonville,9153,3,15,6,9,59,43,16,51
Crusaders,9153,4,13,11,6,52,36,16,50
Coleraine,9153,5,12,10,8,39,33,6,46
Glenavon,9153,6,11,13,6,48,44,4,46
Dungannon,9153,7,9,10,11,48,44,4,37
Ballinamalla,9153,8,8,8,14,37,52,-15,32
Glentoran,9153,9,5,11,14,31,51,-20,26
Portadown,9153,10,6,8,16,21,42,-21,26
Ards,9153,11,7,5,18,36,62,-26,26
Crusaders,9154,1,18,6,6,56,32,24,60
Linfield,9154,2,13,12,5,58,33,25,51
Cliftonville,9154,3,14,8,8,54,40,14,50
Glenavon,9154,4,13,11,6,44,37,7,50
Ballymena,9154,5,14,6,10,57,55,2,48
Coleraine,9154,6,12,10,8,39,38,1,46
Ards,9154,7,8,9,13,34,42,-8,33
Dungannon,9154,8,8,8,14,48,46,2,32
Portadown,9154,9,7,7,16,24,41,-17,28
Glentoran,9154,10,7,7,16,24,45,-21,28
Ballinamalla,9154,11,5,8,17,26,55,-29,23
Ballymena,9155,1,16,6,8,67,55,12,54
Crusaders,9155,2,15,6,9,55,44,11,51
Linfield,9155,3,14,7,9,61,46,15,49
Coleraine,9155,4,13,9,8,50,38,12,48
Glenavon,9155,5,11,10,9,54,45,9,43
Cliftonville,9155,6,13,4,13,46,43,3,43
Dungannon,9155,7,10,11,9,50,44,6,41
Ards,9155,8,10,5,15,39,47,-8,35
Ballinamalla,9155,9,10,4,16,34,55,-21,34
Portadown,9155,10,9,4,17,30,50,-20,31
Glentoran,9155,11,8,6,16,29,48,-19,30
Crusaders,9156,1,16,9,5,55,32,23,57
Ballymena,9156,2,16,5,9,62,55,7,53
Linfield,9156,3,14,8,8,53,32,21,50
Cliftonville,9156,4,14,6,10,51,46,5,48
Dungannon,9156,5,12,9,9,50,37,13,45
Glenavon,9156,6,11,8,11,44,43,1,41
Coleraine,9156,7,10,10,10,48,42,6,40
Ards,9156,8,9,8,13,40,47,-7,35
Portadown,9156,9,8,6,16,25,48,-23,30
Glentoran,9156,10,7,8,15,29,46,-17,29
Ballinamalla,9156,11,8,3,19,27,56,-29,27
Crusaders,9157,1,17,7,6,55,29,26,58
Cliftonville,9157,2,18,3,9,56,37,19,57
Ballymena,9157,3,18,3,9,66,59,7,57
Linfield,9157,4,14,9,7,59,34,25,51
Dungannon,9157,5,13,8,9,55,40,15,47
Coleraine,9157,6,11,10,9,43,40,3,43
Glenavon,9157,7,10,9,11,49,51,-2,39
Glentoran,9157,8,8,7,15,32,49,-17,31
Portadown,9157,9,8,6,16,24,45,-21,30
Ballinamalla,9157,10,8,2,20,28,55,-27,26
Ards,9157,11,6,4,20,30,58,-28,22
Crusaders,9158,1,17,7,6,54,34,20,58
Cliftonville,9158,2,16,6,8,51,32,19,54
Linfield,9158,3,14,8,8,51,30,21,50
Glenavon,9158,4,12,11,7,50,43,7,47
Coleraine,9158,5,12,9,9,41,39,2,45
Ballymena,9158,6,13,6,11,50,56,-6,45
Glentoran,9158,7,11,8,11,34,39,-5,41
Dungannon,9158,8,9,11,10,51,44,7,38
Ards,9158,9,7,6,17,33,50,-17,27
Portadown,9158,10,7,5,18,23,48,-25,26
Ballinamalla,9158,11,7,3,20,34,57,-23,24
Crusaders,9159,1,14,9,7,50,33,17,51
Ballymena,9159,2,14,7,9,55,56,-1,49
Linfield,9159,3,11,14,5,58,35,23,47
Coleraine,9159,4,11,11,8,41,38,3,44
Cliftonville,9159,5,12,8,10,43,42,1,44
Dungannon,9159,6,10,11,9,51,39,12,41
Glentoran,9159,7,10,8,12,35,37,-2,38
Ards,9159,8,11,5,14,42,51,-9,38
Glenavon,9159,9,9,10,11,37,44,-7,37
Portadown,9159,10,7,8,15,28,43,-15,29
Ballinamalla,9159,11,7,7,16,27,49,-22,28
Crusaders,9160,1,18,9,3,54,29,25,63
Linfield,9160,2,15,7,8,59,33,26,52
Cliftonville,9160,3,12,10,8,47,38,9,46
Ballymena,9160,4,13,5,12,58,60,-2,44
Coleraine,9160,5,11,10,9,41,36,5,43
Dungannon,9160,6,11,8,11,50,45,5,41
Glenavon,9160,7,9,13,8,44,42,2,40
Glentoran,9160,8,8,10,12,31,41,-10,34
Ards,9160,9,9,7,14,43,55,-12,34
Ballinamalla,9160,10,9,6,15,33,51,-18,33
Portadown,9160,11,4,7,19,20,50,-30,19
Linfield,9161,1,16,8,6,61,33,28,56
Crusaders,9161,2,16,8,6,61,35,26,56
Cliftonville,9161,3,15,7,8,54,42,12,52
Ballymena,9161,4,15,5,10,62,59,3,50
Dungannon,9161,5,11,11,8,55,44,11,44
Coleraine,9161,6,11,10,9,44,42,2,43
Glenavon,9161,7,10,12,8,46,43,3,42
Glentoran,9161,8,7,10,13,31,46,-15,31
Ards,9161,9,7,5,18,35,57,-22,26
Ballinamalla,9161,10,7,5,18,33,58,-25,26
Portadown,9161,11,5,9,16,27,50,-23,24
Cliftonville,9162,1,16,6,8,49,35,14,54
Crusaders,9162,2,16,5,9,56,41,15,53
Linfield,9162,3,14,10,6,62,24,38,52
Ballymena,9162,4,13,8,9,55,55,0,47
Coleraine,9162,5,11,8,11,49,48,1,41
Glenavon,9162,6,10,10,10,43,46,-3,40
Ards,9162,7,12,4,14,41,44,-3,40
Dungannon,9162,8,8,10,12,47,47,0,34
Glentoran,9162,9,7,12,11,35,53,-18,33
Ballinamalla,9162,10,10,3,17,35,56,-21,33
Portadown,9162,11,8,4,18,24,47,-23,28
Linfield,9163,1,14,11,5,58,31,27,53
Coleraine,9163,2,14,9,7,42,31,11,51
Crusaders,9163,3,14,7,9,45,31,14,49
Ballymena,9163,4,13,6,11,57,58,-1,45
Glenavon,9163,5,12,9,9,45,49,-4,45
Cliftonville,9163,6,12,5,13,43,42,1,41
Glentoran,9163,7,10,8,12,34,41,-7,38
Dungannon,9163,8,9,10,11,47,42,5,37
Ballinamalla,9163,9,9,6,15,35,51,-16,33
Portadown,9163,10,9,6,15,31,49,-18,33
Ards,9163,11,7,7,16,34,46,-12,28
Crusaders,9164,1,18,7,5,59,32,27,61
Cliftonville,9164,2,16,7,7,55,36,19,55
Linfield,9164,3,15,6,9,60,37,23,51
Ballymena,9164,4,12,10,8,49,47,2,46
Glenavon,9164,5,11,11,8,47,47,0,44
Dungannon,9164,6,12,6,12,48,44,4,42
Coleraine,9164,7,8,13,9,38,42,-4,37
Glentoran,9164,8,8,9,13,30,46,-16,33
Portadown,9164,9,9,4,17,25,44,-19,31
Ards,9164,10,7,7,16,34,45,-11,28
Ballinamalla,9164,11,7,4,19,26,51,-25,25
Cliftonville,9165,1,17,4,9,60,43,17,55
Ballymena,9165,2,15,8,7,68,56,12,53
Linfield,9165,3,14,10,6,63,34,29,52
Crusaders,9165,4,14,9,7,52,37,15,51
Coleraine,9165,5,12,10,8,51,47,4,46
Dungannon,9165,6,11,8,11,57,45,12,41
Glenavon,9165,7,8,12,10,47,56,-9,36
Glentoran,9165,8,8,10,12,29,45,-16,34
Ards,9165,9,9,5,16,42,60,-18,32
Ballinamalla,9165,10,7,6,17,42,59,-17,27
Portadown,9165,11,6,6,18,24,53,-29,24
Cliftonville,9166,1,18,6,6,57,32,25,60
Linfield,9166,2,14,8,8,58,35,23,50
Crusaders,9166,3,13,11,6,54,44,10,50
Ballymena,9166,4,14,5,11,58,60,-2,47
Glenavon,9166,5,11,13,6,52,43,9,46
Dungannon,9166,6,10,11,9,50,39,11,41
Coleraine,9166,7,9,11,10,42,45,-3,38
Glentoran,9166,8,10,7,13,42,50,-8,37
Ballinamalla,9166,9,9,4,17,29,48,-19,31
Ards,9166,10,7,7,16,29,46,-17,28
Portadown,9166,11,7,3,20,24,53,-29,24
Linfield,9167,1,16,8,6,65,36,29,56
Coleraine,9167,2,15,10,5,50,33,17,55
Cliftonville,9167,3,15,7,8,60,45,15,52
Crusaders,9167,4,14,7,9,55,41,14,49
Glenavon,9167,5,12,10,8,51,45,6,46
Ballymena,9167,6,12,5,13,55,68,-13,41
Dungannon,9167,7,8,11,11,52,47,5,35
Glentoran,9167,8,9,7,14,31,44,-13,34
Portadown,9167,9,9,5,16,31,50,-19,32
Ballinamalla,9167,10,8,6,16,41,61,-20,30
Ards,9167,11,7,4,19,33,54,-21,25
Crusaders,9168,1,17,9,4,56,26,30,60
Cliftonville,9168,2,15,5,10,49,39,10,50
Glenavon,9168,3,11,16,3,51,38,13,49
Ballymena,9168,4,14,6,10,61,57,4,48
Linfield,9168,5,12,9,9,56,41,15,45
Coleraine,9168,6,12,9,9,36,36,0,45
Glentoran,9168,7,10,10,10,33,37,-4,40
Dungannon,9168,8,9,11,10,48,40,8,38
Ards,9168,9,6,9,15,33,46,-13,27
Ballinamalla,9168,10,6,6,18,27,58,-31,24
Portadown,9168,11,5,6,19,21,53,-32,21
Crusaders,9169,1,19,6,5,59,34,25,63
Coleraine,9169,2,16,8,6,49,32,17,56
Cliftonville,9169,3,16,5,9,54,31,23,53
Glenavon,9169,4,13,10,7,49,42,7,49
Linfield,9169,5,13,9,8,58,41,17,48
Dungannon,9169,6,12,10,8,58,38,20,46
Ballymena,9169,7,9,8,13,50,63,-13,35
Portadown,9169,8,9,5,16,28,44,-16,32
Ards,9169,9,8,4,18,30,53,-23,28
Glentoran,9169,10,7,6,17,22,47,-25,27
Ballinamalla,9169,11,4,7,19,24,56,-32,19
Linfield,9170,1,16,8,6,57,29,28,56
Cliftonville,9170,2,17,4,9,49,31,18,55
Crusaders,9170,3,14,7,9,54,43,11,49
Coleraine,9170,4,12,11,7,42,33,9,47
Glenavon,9170,5,12,10,8,41,40,1,46
Dungannon,9170,6,11,9,10,55,46,9,42
Ballymena,9170,7,11,7,12,49,58,-9,40
Glentoran,9170,8,10,8,12,26,36,-10,38
Ards,9170,9,7,7,16,33,48,-15,28
Ballinamalla,9170,10,7,7,16,29,49,-20,28
Portadown,9170,11,6,6,18,26,48,-22,24
Crusaders,9171,1,17,9,4,60,33,27,60
Ballymena,9171,2,17,6,7,61,51,10,57
Linfield,9171,3,15,8,7,56,34,22,53
Glenavon,9171,4,11,11,8,48,45,3,44
Cliftonville,9171,5,13,5,12,50,48,2,44
Dungannon,9171,6,12,7,11,51,42,9,43
Coleraine,9171,7,10,9,11,47,46,1,39
Glentoran,9171,8,10,7,13,30,42,-12,37
Ards,9171,9,8,4,18,35,52,-17,28
Ballinamalla,9171,10,8,3,19,33,55,-22,27
Portadown,9171,11,7,5,18,24,47,-23,26
Crusaders,9172,1,17,9,4,59,27,32,60
Cliftonville,9172,2,16,6,8,53,40,13,54
Linfield,9172,3,14,10,6,55,29,26,52
Ballymena,9172,4,13,6,11,59,55,4,45
Coleraine,9172,5,10,12,8,39,40,-1,42
Glenavon,9172,6,10,11,9,43,46,-3,41
Dungannon,9172,7,8,13,9,49,45,4,37
Ards,9172,8,9,9,12,38,42,-4,36
Glentoran,9172,9,8,10,12,27,41,-14,34
Portadown,9172,10,5,8,17,24,45,-21,23
Ballinamalla,9172,11,6,4,20,26,62,-36,22
Linfield,9173,1,16,9,5,62,26,36,57
Crusaders,9173,2,15,8,7,53,35,18,53
Cliftonville,9173,3,15,5,10,49,40,9,50
Dungannon,9173,4,13,10,7,55,34,21,49
Coleraine,9173,5,11,10,9,43,39,4,43
Glenavon,9173,6,10,13,7,46,45,1,43
Ballymena,9173,7,12,6,12,54,66,-12,42
Ards,9173,8,12,3,15,46,53,-7,39
Glentoran,9173,9,8,7,15,28,44,-16,31
Ballinamalla,9173,10,9,3,18,32,51,-19,30
Portadown,9173,11,4,6,20,24,59,-35,18
Crusaders,9174,1,17,9,4,64,33,31,60
Linfield,9174,2,15,10,5,64,34,30,55
Cliftonville,9174,3,16,6,8,59,42,17,54
Coleraine,9174,4,12,10,8,46,38,8,46
Glenavon,9174,5,11,9,10,50,53,-3,42
Dungannon,9174,6,10,10,10,46,46,0,40
Ballymena,9174,7,11,7,12,48,58,-10,40
Ards,9174,8,9,6,15,36,49,-13,33
Glentoran,9174,9,8,8,14,31,43,-12,32
Ballinamalla,9174,10,9,3,18,34,51,-17,30
Portadown,9174,11,5,6,19,25,56,-31,21
Crusaders,9175,1,18,7,5,64,37,27,61
Cliftonville,9175,2,19,3,8,60,32,28,60
Linfield,9175,3,15,9,6,61,38,23,54
Glenavon,9175,4,11,11,8,54,47,7,44
Ballymena,9175,5,11,8,11,54,59,-5,41
Coleraine,9175,6,9,10,11,41,51,-10,37
Portadown,9175,7,10,4,16,29,45,-16,34
Ballinamalla,9175,8,9,6,15,39,53,-14,33
Ards,9175,9,9,5,16,37,56,-19,32
Dungannon,9175,10,6,11,13,44,47,-3,29
Glentoran,9175,11,6,10,14,33,51,-18,28
Crusaders,9176,1,20,4,6,69,43,26,64
Glenavon,9176,2,15,10,5,53,40,13,55
Ballymena,9176,3,16,4,10,59,54,5,52
Linfield,9176,4,14,9,7,59,33,26,51
Dungannon,9176,5,13,8,9,53,37,16,47
Cliftonville,9176,6,13,3,14,56,51,5,42
Coleraine,9176,7,9,11,10,42,41,1,38
Glentoran,9176,8,10,6,14,37,52,-15,36
Ards,9176,9,9,4,17,36,52,-16,31
Portadown,9176,10,7,6,17,24,51,-27,27
Ballinamalla,9176,11,5,3,22,33,67,-34,18
Crusaders,9177,1,17,7,6,50,30,20,58
Cliftonville,9177,2,16,4,10,48,37,11,52
Ballymena,9177,3,15,6,9,60,52,8,51
Glenavon,9177,4,12,9,9,41,37,4,45
Linfield,9177,5,11,10,9,50,36,14,43
Dungannon,9177,6,10,12,8,48,38,10,42
Coleraine,9177,7,8,14,8,40,40,0,38
Glentoran,9177,8,8,10,12,30,42,-12,34
Ards,9177,9,8,6,16,31,44,-13,30
Portadown,9177,10,7,8,15,24,44,-20,29
Ballinamalla,9177,11,7,6,17,27,49,-22,27
Linfield,9178,1,15,8,7,56,28,28,53
Crusaders,9178,2,16,4,10,52,33,19,52
Cliftonville,9178,3,15,5,10,46,35,11,50
Coleraine,9178,4,12,12,6,46,34,12,48
Glenavon,9178,5,11,11,8,49,51,-2,44
Ballymena,9178,6,12,8,10,52,57,-5,44
Dungannon,9178,7,11,8,11,53,43,10,41
Ards,9178,8,11,5,14,39,45,-6,38
Glentoran,9178,9,10,5,15,30,43,-13,35
Ballinamalla,9178,10,8,4,18,35,60,-25,28
Portadown,9178,11,6,6,18,23,52,-29,24
Ballymena,9179,1,18,5,7,60,49,11,59
Cliftonville,9179,2,16,5,9,56,41,15,53
Coleraine,9179,3,14,9,7,45,33,12,51
Linfield,9179,4,14,8,8,58,39,19,50
Crusaders,9179,5,14,6,10,50,42,8,48
Dungannon,9179,6,10,11,9,57,44,13,41
Glenavon,9179,7,8,12,10,40,49,-9,36
Glentoran,9179,8,9,9,12,26,37,-11,36
Ballinamalla,9179,9,9,4,17,29,46,-17,31
Portadown,9179,10,7,5,18,30,51,-21,26
Ards,9179,11,7,4,19,30,50,-20,25
Crusaders,9180,1,15,7,8,58,37,21,52
Cliftonville,9180,2,15,5,10,56,35,21,50
Linfield,9180,3,13,9,8,57,37,20,48
Ballymena,9180,4,14,5,11,59,56,3,47
Coleraine,9180,5,12,10,8,46,42,4,46
Dungannon,9180,6,11,9,10,49,39,10,42
Ards,9180,7,12,5,13,37,45,-8,41
Glenavon,9180,8,10,8,12,46,49,-3,38
Portadown,9180,9,11,4,15,35,49,-14,37
Ballinamalla,9180,10,8,5,17,33,59,-26,29
Glentoran,9180,11,7,7,16,27,55,-28,28
Crusaders,9181,1,16,7,7,55,33,22,55
Linfield,9181,2,14,7,9,56,35,21,49
Coleraine,9181,3,13,9,8,52,37,15,48
Dungannon,9181,4,13,7,10,52,44,8,46
Glenavon,9181,5,12,10,8,56,54,2,46
Cliftonville,9181,6,13,6,11,47,44,3,45
Ballymena,9181,7,12,7,11,49,58,-9,43
Glentoran,9181,8,10,8,12,31,38,-7,38
Ballinamalla,9181,9,10,5,15,31,43,-12,35
Ards,9181,10,7,6,17,36,56,-20,27
Portadown,9181,11,4,10,16,17,40,-23,22
Crusaders,9182,1,18,7,5,54,29,25,61
Cliftonville,9182,2,17,4,9,54,38,16,55
Linfield,9182,3,15,8,7,58,30,28,53
Coleraine,9182,4,12,11,7,44,36,8,47
Glenavon,9182,5,12,8,10,39,42,-3,44
Ballymena,9182,6,11,8,11,54,60,-6,41
Dungannon,9182,7,11,6,13,51,51,0,39
Glentoran,9182,8,9,9,12,27,38,-11,36
Ballinamalla,9182,9,7,7,16,29,46,-17,28
Portadown,9182,10,7,6,17,25,47,-22,27
Ards,9182,11,6,6,18,31,49,-18,24
Crusaders,9183,1,17,8,5,55,35,20,59
Linfield,9183,2,16,8,6,63,35,28,56
Ballymena,9183,3,17,5,8,70,60,10,56
Cliftonville,9183,4,16,4,10,52,40,12,52
Glenavon,9183,5,12,10,8,54,46,8,46
Dungannon,9183,6,11,7,12,51,44,7,40
Coleraine,9183,7,9,9,12,41,44,-3,36
Ards,9183,8,11,3,16,39,46,-7,36
Portadown,9183,9,8,4,18,27,53,-26,28
Ballinamalla,9183,10,8,3,19,28,54,-26,27
Glentoran,9183,11,4,11,15,22,45,-23,23
Crusaders,9184,1,16,9,5,59,34,25,57
Linfield,9184,2,14,12,4,59,27,32,54
Cliftonville,9184,3,14,6,10,52,44,8,48
Coleraine,9184,4,12,12,6,48,40,8,48
Ballymena,9184,5,14,6,10,72,68,4,48
Glenavon,9184,6,9,14,7,47,44,3,41
Dungannon,9184,7,10,8,12,49,48,1,38
Portadown,9184,8,9,5,16,24,41,-17,32
Ards,9184,9,9,4,17,38,53,-15,31
Glentoran,9184,10,6,10,14,25,47,-22,28
Ballinamalla,9184,11,5,8,17,25,52,-27,23
Cliftonville,9185,1,16,6,8,58,36,22,54
Linfield,9185,2,14,9,7,53,28,25,51
Ballymena,9185,3,14,9,7,58,54,4,51
Crusaders,9185,4,12,12,6,49,38,11,48
Glenavon,9185,5,12,12,6,47,41,6,48
Dungannon,9185,6,12,11,7,50,34,16,47
Coleraine,9185,7,8,9,13,37,42,-5,33
Glentoran,9185,8,8,8,14,29,44,-15,32
Ards,9185,9,8,5,17,34,51,-17,29
Ballinamalla,9185,10,8,5,17,31,53,-22,29
Portadown,9185,11,7,6,17,21,46,-25,27
Ballymena,9186,1,16,6,8,61,52,9,54
Cliftonville,9186,2,16,4,10,53,35,18,52
Crusaders,9186,3,13,8,9,47,37,10,47
Linfield,9186,4,11,13,6,51,30,21,46
Glenavon,9186,5,12,10,8,50,48,2,46
Dungannon,9186,6,11,10,9,50,40,10,43
Coleraine,9186,7,8,12,10,40,38,2,36
Ballinamalla,9186,8,10,5,15,31,47,-16,35
Ards,9186,9,9,7,14,34,45,-11,34
Glentoran,9186,10,7,9,14,21,41,-20,30
Portadown,9186,11,6,8,16,18,43,-25,26
Crusaders,9187,1,19,5,6,55,32,23,62
Cliftonville,9187,2,15,6,9,52,42,10,51
Linfield,9187,3,12,10,8,52,33,19,46
Coleraine,9187,4,11,11,8,55,40,15,44
Ballymena,9187,5,12,8,10,54,58,-4,44
Glenavon,9187,6,11,10,9,47,44,3,43
Glentoran,9187,7,10,8,12,31,37,-6,38
Dungannon,9187,8,8,10,12,46,43,3,34
Ballinamalla,9187,9,9,4,17,31,52,-21,31
Ards,9187,10,7,9,14,35,53,-18,30
Portadown,9187,11,7,7,16,21,45,-24,28
Crusaders,9188,1,15,9,6,56,34,22,54
Cliftonville,9188,2,16,5,9,59,36,23,53
Linfield,9188,3,13,11,6,57,32,25,50
Coleraine,9188,4,13,10,7,49,37,12,49
Glenavon,9188,5,13,10,7,46,41,5,49
Ballymena,9188,6,13,6,11,52,58,-6,45
Dungannon,9188,7,10,11,9,51,44,7,41
Glentoran,9188,8,10,8,12,35,43,-8,38
Ards,9188,9,9,2,19,35,56,-21,29
Ballinamalla,9188,10,6,8,16,33,59,-26,26
Portadown,9188,11,5,4,21,22,55,-33,19
Glenavon,9189,1,14,11,5,55,38,17,53
Crusaders,9189,2,14,10,6,52,34,18,52
Cliftonville,9189,3,14,7,9,58,41,17,49
Ballymena,9189,4,13,7,10,49,53,-4,46
Linfield,9189,5,10,15,5,56,33,23,45
Coleraine,9189,6,10,12,8,43,40,3,42
Dungannon,9189,7,9,13,8,50,46,4,40
Ballinamalla,9189,8,10,4,16,35,54,-19,34
Glentoran,9189,9,8,7,15,30,47,-17,31
Ards,9189,10,8,5,17,40,51,-11,29
Portadown,9189,11,6,7,17,18,49,-31,25
Coleraine,9190,1,15,9,6,55,38,17,54
Linfield,9190,2,14,8,8,58,34,24,50
Dungannon,9190,3,14,8,8,61,39,22,50
Cliftonville,9190,4,15,5,10,53,42,11,50
Crusaders,9190,5,14,7,9,49,45,4,49
Ballymena,9190,6,13,6,11,50,61,-11,45
Glenavon,9190,7,10,12,8,53,51,2,42
Ballinamalla,9190,8,10,4,16,38,47,-9,34
Glentoran,9190,9,8,8,14,30,42,-12,32
Ards,9190,10,7,6,17,35,54,-19,27
Portadown,9190,11,6,5,19,29,58,-29,23
Crusaders,9191,1,18,8,4,63,32,31,62
Cliftonville,9191,2,20,2,8,61,37,24,62
Linfield,9191,3,14,10,6,54,27,27,52
Coleraine,9191,4,11,11,8,42,33,9,44
Glenavon,9191,5,10,13,7,46,41,5,43
Ballymena,9191,6,10,7,13,49,60,-11,37
Ards,9191,7,11,4,15,46,57,-11,37
Dungannon,9191,8,8,9,13,42,48,-6,33
Glentoran,9191,9,8,9,13,25,39,-14,33
Portadown,9191,10,7,5,18,23,46,-23,26
Ballinamalla,9191,11,7,4,19,25,56,-31,25
Ballymena,9192,1,16,5,9,59,53,6,53
Crusaders,9192,2,15,7,8,49,33,16,52
Cliftonville,9192,3,15,4,11,53,47,6,49
Linfield,9192,4,12,8,10,56,35,21,44
Glenavon,9192,5,12,8,10,45,45,0,44
Coleraine,9192,6,11,10,9,49,42,7,43
Glentoran,9192,7,11,7,12,34,43,-9,40
Dungannon,9192,8,9,10,11,49,43,6,37
Ballinamalla,9192,9,10,4,16,28,48,-20,34
Ards,9192,10,8,7,15,41,54,-13,31
Portadown,9192,11,8,6,16,27,47,-20,30
Crusaders,9193,1,16,8,6,53,31,22,56
Cliftonville,9193,2,15,8,7,56,38,18,53
Linfield,9193,3,12,12,6,54,35,19,48
Glenavon,9193,4,12,10,8,48,44,4,46
Coleraine,9193,5,11,10,9,42,36,6,43
Ballymena,9193,6,11,10,9,54,58,-4,43
Ards,9193,7,11,5,14,38,44,-6,38
Dungannon,9193,8,8,11,11,48,46,2,35
Glentoran,9193,9,7,10,13,31,45,-14,31
Portadown,9193,10,8,6,16,24,44,-20,30
Ballinamalla,9193,11,6,6,18,28,55,-27,24
Linfield,9194,1,20,7,3,68,29,39,67
Cliftonville,9194,2,14,10,6,62,37,25,52
Crusaders,9194,3,13,10,7,47,38,9,49
Ballymena,9194,4,13,9,8,62,54,8,48
Glenavon,9194,5,10,11,9,45,43,2,41
Coleraine,9194,6,9,12,9,37,38,-1,39
Ards,9194,7,10,6,14,47,55,-8,36
Dungannon,9194,8,8,11,11,55,49,6,35
Glentoran,9194,9,7,8,15,34,53,-19,29
Ballinamalla,9194,10,6,8,16,28,57,-29,26
Portadown,9194,11,6,6,18,28,60,-32,24
Linfield,9195,1,16,9,5,62,29,33,57
Crusaders,9195,2,14,10,6,62,43,19,52
Ballymena,9195,3,16,4,10,56,57,-1,52
Coleraine,9195,4,13,11,6,48,41,7,50
Cliftonville,9195,5,14,5,11,47,38,9,47
Glenavon,9195,6,11,11,8,45,41,4,44
Ards,9195,7,9,6,15,33,43,-10,33
Dungannon,9195,8,7,11,12,43,46,-3,32
Glentoran,9195,9,7,9,14,30,46,-16,30
Ballinamalla,9195,10,9,3,18,33,52,-19,30
Portadown,9195,11,6,7,17,19,42,-23,25
Linfield,9196,1,13,12,5,57,31,26,51
Cliftonville,9196,2,14,9,7,59,44,15,51
Crusaders,9196,3,14,8,8,46,30,16,50
Ballymena,9196,4,15,4,11,67,65,2,49
Dungannon,9196,5,13,7,10,48,39,9,46
Coleraine,9196,6,11,10,9,41,40,1,43
Glenavon,9196,7,9,9,12,45,52,-7,36
Glentoran,9196,8,9,9,12,29,38,-9,36
Ards,9196,9,10,3,17,38,50,-12,33
Ballinamalla,9196,10,9,6,15,28,45,-17,33
Portadown,9196,11,7,5,18,26,50,-24,26
Cliftonville,9197,1,16,6,8,63,40,23,54
Crusaders,9197,2,15,8,7,51,35,16,53
Ballymena,9197,3,13,10,7,59,57,2,49
Dungannon,9197,4,13,9,8,50,36,14,48
Linfield,9197,5,11,11,8,56,43,13,44
Coleraine,9197,6,10,12,8,41,33,8,42
Glenavon,9197,7,9,14,7,49,49,0,41
Portadown,9197,8,8,8,14,28,46,-18,32
Ards,9197,9,7,7,16,40,52,-12,28
Glentoran,9197,10,7,7,16,28,50,-22,28
Ballinamalla,9197,11,8,4,18,33,57,-24,28
Ballymena,9198,1,17,5,8,63,50,13,56
Crusaders,9198,2,15,7,8,53,37,16,52
Cliftonville,9198,3,15,5,10,57,39,18,50
Linfield,9198,4,13,7,10,58,36,22,46
Glenavon,9198,5,11,11,8,47,44,3,44
Coleraine,9198,6,11,11,8,36,36,0,44
Dungannon,9198,7,10,11,9,54,43,11,41
Glentoran,9198,8,10,6,14,29,43,-14,36
Ards,9198,9,7,9,14,33,53,-20,30
Ballinamalla,9198,10,6,9,15,36,58,-22,27
Portadown,9198,11,6,7,17,25,52,-27,25
Linfield,9199,1,16,9,5,64,28,36,57
Crusaders,9199,2,16,8,6,59,38,21,56
Cliftonville,9199,3,15,6,9,54,39,15,51
Glenavon,9199,4,11,11,8,48,45,3,44
Ballymena,9199,5,13,5,12,62,67,-5,44
Coleraine,9199,6,11,8,11,42,41,1,41
Dungannon,9199,7,8,13,9,47,43,4,37
Glentoran,9199,8,7,11,12,34,46,-12,32
Portadown,9199,9,8,8,14,25,42,-17,32
Ards,9199,10,9,3,18,33,50,-17,30
Ballinamalla,9199,11,7,6,17,28,57,-29,27
Crusaders,9200,1,16,8,6,55,35,20,56
Glenavon,9200,2,14,9,7,48,42,6,51
Cliftonville,9200,3,14,7,9,52,39,13,49
Linfield,9200,4,12,10,8,53,34,19,46
Coleraine,9200,5,10,12,8,40,31,9,42
Dungannon,9200,6,10,11,9,50,44,6,41
Ballymena,9200,7,10,9,11,48,54,-6,39
Glentoran,9200,8,10,7,13,37,47,-10,37
Ards,9200,9,11,4,15,37,49,-12,37
Ballinamalla,9200,10,9,2,19,30,52,-22,29
Portadown,9200,11,6,7,17,22,45,-23,25
Crusaders,9201,1,15,7,8,53,41,12,52
Ballymena,9201,2,15,4,11,56,59,-3,49
Cliftonville,9201,3,14,5,11,48,39,9,47
Glenavon,9201,4,12,10,8,55,48,7,46
Coleraine,9201,5,12,10,8,41,35,6,46
Linfield,9201,6,11,10,9,55,35,20,43
Dungannon,9201,7,12,7,11,47,39,8,43
Glentoran,9201,8,10,8,12,36,40,-4,38
Ards,9201,9,10,6,14,38,45,-7,36
Portadown,9201,10,9,6,15,26,45,-19,33
Ballinamalla,9201,11,7,3,20,26,55,-29,24
Crusaders,9202,1,18,7,5,59,33,26,61
Cliftonville,9202,2,17,7,6,61,36,25,58
Linfield,9202,3,15,8,7,65,33,32,53
Ballymena,9202,4,14,5,11,56,59,-3,47
Coleraine,9202,5,10,12,8,43,43,0,42
Glenavon,9202,6,10,10,10,49,48,1,40
Glentoran,9202,7,10,8,12,28,44,-16,38
Ards,9202,8,10,5,15,36,43,-7,35
Dungannon,9202,9,7,10,13,44,47,-3,31
Portadown,9202,10,9,2,19,25,50,-25,29
Ballinamalla,9202,11,6,4,20,24,54,-30,22
Cliftonville,9203,1,17,6,7,55,38,17,57
Crusaders,9203,2,16,8,6,52,31,21,56
Coleraine,9203,3,15,7,8,48,34,14,52
Glenavon,9203,4,14,9,7,45,39,6,51
Linfield,9203,5,13,9,8,63,37,26,48
Ballymena,9203,6,14,5,11,62,64,-2,47
Dungannon,9203,7,10,11,9,53,44,9,41
Glentoran,9203,8,9,8,13,27,39,-12,35
Ards,9203,9,7,5,18,39,56,-17,26
Portadown,9203,10,6,6,18,30,57,-27,24
Ballinamalla,9203,11,4,6,20,23,58,-35,18
Linfield,9204,1,14,13,3,58,28,30,55
Crusaders,9204,2,15,9,6,51,35,16,54
Cliftonville,9204,3,16,4,10,58,40,18,52
Coleraine,9204,4,10,12,8,43,38,5,42
Ballymena,9204,5,12,6,12,50,58,-8,42
Glenavon,9204,6,9,13,8,49,46,3,40
Dungannon,9204,7,10,7,13,47,40,7,37
Ards,9204,8,11,3,16,41,55,-14,36
Ballinamalla,9204,9,9,8,13,35,44,-9,35
Glentoran,9204,10,7,10,13,32,50,-18,31
Portadown,9204,11,7,5,18,21,51,-30,26
Crusaders,9205,1,17,5,8,53,35,18,56
Ballymena,9205,2,15,7,8,64,54,10,52
Cliftonville,9205,3,15,5,10,53,38,15,50
Linfield,9205,4,11,13,6,57,34,23,46
Dungannon,9205,5,12,7,11,44,38,6,43
Coleraine,9205,6,11,10,9,36,36,0,43
Glenavon,9205,7,11,8,11,46,54,-8,41
Ards,9205,8,10,6,14,38,46,-8,36
Portadown,9205,9,10,5,15,37,49,-12,35
Glentoran,9205,10,8,7,15,26,44,-18,31
Ballinamalla,9205,11,6,5,19,25,51,-26,23
Crusaders,9206,1,18,6,6,61,36,25,60
Glenavon,9206,2,17,7,6,54,39,15,58
Linfield,9206,3,15,10,5,61,31,30,55
Cliftonville,9206,4,16,4,10,48,41,7,52
Ballymena,9206,5,14,5,11,54,63,-9,47
Coleraine,9206,6,10,10,10,38,38,0,40
Glentoran,9206,7,10,7,13,37,44,-7,37
Dungannon,9206,8,9,8,13,52,48,4,35
Ards,9206,9,9,6,15,36,45,-9,33
Portadown,9206,10,7,8,15,24,41,-17,29
Ballinamalla,9206,11,3,3,24,23,62,-39,12
Crusaders,9207,1,13,12,5,45,29,16,51
Coleraine,9207,2,14,9,7,44,38,6,51
Ballymena,9207,3,14,6,10,55,59,-4,48
Linfield,9207,4,12,11,7,54,32,22,47
Dungannon,9207,5,13,8,9,51,35,16,47
Cliftonville,9207,6,13,6,11,48,38,10,45
Glenavon,9207,7,10,9,11,33,40,-7,39
Ards,9207,8,10,6,14,42,49,-7,36
Ballinamalla,9207,9,8,7,15,30,46,-16,31
Portadown,9207,10,8,6,16,21,40,-19,30
Glentoran,9207,11,6,8,16,30,47,-17,26
Crusaders,9208,1,16,8,6,59,42,17,56
Ballymena,9208,2,16,5,9,70,56,14,53
Cliftonville,9208,3,16,5,9,51,39,12,53
Linfield,9208,4,14,10,6,59,36,23,52
Glentoran,9208,5,12,7,11,34,37,-3,43
Dungannon,9208,6,11,7,12,54,50,4,40
Coleraine,9208,7,10,9,11,45,48,-3,39
Glenavon,9208,8,7,13,10,46,54,-8,34
Portadown,9208,9,9,4,17,26,43,-17,31
Ards,9208,10,8,5,17,42,57,-15,29
Ballinamalla,9208,11,7,5,18,29,53,-24,26
Crusaders,9209,1,18,8,4,65,38,27,62
Linfield,9209,2,15,9,6,58,28,30,54
Cliftonville,9209,3,16,6,8,59,41,18,54
Ballymena,9209,4,14,5,11,69,69,0,47
Coleraine,9209,5,12,10,8,47,43,4,46
Glenavon,9209,6,12,9,9,58,53,5,45
Glentoran,9209,7,10,5,15,31,49,-18,35
Dungannon,9209,8,8,10,12,55,54,1,34
Portadown,9209,9,9,4,17,26,47,-21,31
Ards,9209,10,7,8,15,38,55,-17,29
Ballinamalla,9209,11,4,6,20,26,55,-29,18
Crusaders,9210,1,16,9,5,57,39,18,57
Linfield,9210,2,14,11,5,62,29,33,53
Coleraine,9210,3,14,10,6,47,34,13,52
Cliftonville,9210,4,16,3,11,52,38,14,51
Ards,9210,5,14,5,11,41,37,4,47
Glenavon,9210,6,11,12,7,52,47,5,45
Ballymena,9210,7,12,5,13,53,60,-7,41
Dungannon,9210,8,11,7,12,50,49,1,40
Glentoran,9210,9,9,6,15,31,47,-16,33
Portadown,9210,10,5,4,21,21,55,-34,19
Ballinamalla,9210,11,4,6,20,22,53,-31,18
Cliftonville,9211,1,17,4,9,55,35,20,55
Crusaders,9211,2,16,7,7,51,34,17,55
Linfield,9211,3,14,12,4,57,27,30,54
Ballymena,9211,4,15,7,8,56,51,5,52
Coleraine,9211,5,12,12,6,47,35,12,48
Dungannon,9211,6,8,11,11,42,49,-7,35
Glenavon,9211,7,8,10,12,44,49,-5,34
Ballinamalla,9211,8,8,8,14,34,51,-17,32
Ards,9211,9,8,6,16,41,54,-13,30
Glentoran,9211,10,7,8,15,25,45,-20,29
Portadown,9211,11,8,3,19,28,50,-22,27
Cliftonville,9212,1,17,5,8,63,37,26,56
Linfield,9212,2,13,11,6,62,32,30,50
Crusaders,9212,3,13,11,6,53,35,18,50
Ballymena,9212,4,15,4,11,56,61,-5,49
Ards,9212,5,13,3,14,46,50,-4,42
Dungannon,9212,6,10,10,10,47,43,4,40
Glenavon,9212,7,10,9,11,41,48,-7,39
Glentoran,9212,8,9,10,11,36,45,-9,37
Coleraine,9212,9,9,9,12,38,44,-6,36
Portadown,9212,10,9,3,18,30,47,-17,30
Ballinamalla,9212,11,8,3,19,25,55,-30,27
Crusaders,9213,1,18,7,5,59,30,29,61
Cliftonville,9213,2,16,5,9,53,36,17,53
Linfield,9213,3,15,7,8,60,35,25,52
Glenavon,9213,4,14,9,7,48,42,6,51
Dungannon,9213,5,12,8,10,55,46,9,44
Coleraine,9213,6,10,12,8,39,37,2,42
Ballymena,9213,7,12,6,12,56,59,-3,42
Glentoran,9213,8,10,7,13,30,42,-12,37
Ards,9213,9,10,6,14,39,46,-7,36
Ballinamalla,9213,10,6,3,21,27,55,-28,21
Portadown,9213,11,4,6,20,21,59,-38,18
Linfield,9214,1,16,8,6,61,25,36,56
Crusaders,9214,2,13,11,6,61,41,20,50
Cliftonville,9214,3,15,5,10,48,43,5,50
Dungannon,9214,4,13,10,7,60,44,16,49
Glenavon,9214,5,10,12,8,43,39,4,42
Ballymena,9214,6,11,9,10,51,56,-5,42
Coleraine,9214,7,10,11,9,39,46,-7,41
Glentoran,9214,8,10,8,12,36,48,-12,38
Ballinamalla,9214,9,9,5,16,34,49,-15,32
Ards,9214,10,7,6,17,33,53,-20,27
Portadown,9214,11,7,3,20,30,52,-22,24
Linfield,9215,1,15,9,6,61,31,30,54
Cliftonville,9215,2,16,5,9,50,37,13,53
Crusaders,9215,3,15,7,8,53,35,18,52
Coleraine,9215,4,13,9,8,41,34,7,48
Ballymena,9215,5,13,9,8,51,53,-2,48
Glenavon,9215,6,13,8,9,45,39,6,47
Dungannon,9215,7,8,10,12,46,47,-1,34
Glentoran,9215,8,8,6,16,27,46,-19,30
Ards,9215,9,8,5,17,38,52,-14,29
Portadown,9215,10,6,11,13,25,43,-18,29
Ballinamalla,9215,11,8,5,17,21,41,-20,29
Crusaders,9216,1,17,7,6,62,32,30,58
Ballymena,9216,2,16,6,8,57,52,5,54
Glenavon,9216,3,13,10,7,48,43,5,49
Cliftonville,9216,4,13,8,9,53,41,12,47
Coleraine,9216,5,11,11,8,38,36,2,44
Linfield,9216,6,11,8,11,47,34,13,41
Dungannon,9216,7,9,9,12,49,51,-2,36
Ards,9216,8,10,6,14,42,49,-7,36
Ballinamalla,9216,9,8,8,14,34,50,-16,32
Portadown,9216,10,7,7,16,26,44,-18,28
Glentoran,9216,11,7,6,17,30,54,-24,27
Linfield,9217,1,15,8,7,59,34,25,53
Cliftonville,9217,2,16,4,10,47,37,10,52
Crusaders,9217,3,15,6,9,50,41,9,51
Glenavon,9217,4,13,8,9,54,49,5,47
Dungannon,9217,5,12,9,9,55,36,19,45
Coleraine,9217,6,11,10,9,46,40,6,43
Ballymena,9217,7,11,8,11,53,56,-3,41
Ards,9217,8,12,2,16,41,51,-10,38
Glentoran,9217,9,10,7,13,30,40,-10,37
Portadown,9217,10,9,5,16,27,45,-18,32
Ballinamalla,9217,11,7,1,22,26,59,-33,22
Cliftonville,9218,1,19,5,6,60,33,27,62
Crusaders,9218,2,14,9,7,54,41,13,51
Linfield,9218,3,13,9,8,58,27,31,48
Glentoran,9218,4,13,8,9,34,35,-1,47
Glenavon,9218,5,10,13,7,43,39,4,43
Ballymena,9218,6,12,5,13,58,65,-7,41
Dungannon,9218,7,9,8,13,52,47,5,35
Ards,9218,8,10,5,15,40,57,-17,35
Coleraine,9218,9,7,11,12,38,53,-15,32
Ballinamalla,9218,10,9,5,16,37,53,-16,32
Portadown,9218,11,6,8,16,26,50,-24,26
Crusaders,9219,1,19,7,4,62,34,28,64
Ballymena,9219,2,16,5,9,55,52,3,53
Cliftonville,9219,3,14,5,11,56,48,8,47
Coleraine,9219,4,12,11,7,46,41,5,47
Glenavon,9219,5,10,13,7,54,45,9,43
Linfield,9219,6,11,9,10,54,38,16,42
Dungannon,9219,7,10,8,12,44,43,1,38
Glentoran,9219,8,10,7,13,32,47,-15,37
Ards,9219,9,9,9,12,41,44,-3,36
Portadown,9219,10,6,7,17,26,48,-22,25
Ballinamalla,9219,11,4,7,19,32,62,-30,19
Crusaders,9220,1,18,9,3,59,29,30,63
Linfield,9220,2,16,8,6,64,31,33,56
Ballymena,9220,3,15,5,10,64,66,-2,50
Cliftonville,9220,4,14,6,10,54,42,12,48
Coleraine,9220,5,11,10,9,41,43,-2,43
Glenavon,9220,6,10,9,11,43,45,-2,39
Glentoran,9220,7,8,10,12,29,42,-13,34
Dungannon,9220,8,8,9,13,49,46,3,33
Ards,9220,9,9,5,16,39,47,-8,32
Portadown,9220,10,9,4,17,27,52,-25,31
Ballinamalla,9220,11,7,5,18,30,56,-26,26
Crusaders,9221,1,14,10,6,62,41,21,52
Coleraine,9221,2,13,11,6,52,34,18,50
Cliftonville,9221,3,14,8,8,51,41,10,50
Linfield,9221,4,13,10,7,57,40,17,49
Glenavon,9221,5,10,12,8,53,53,0,42
Ballymena,9221,6,10,10,10,54,61,-7,40
Dungannon,9221,7,8,12,10,47,47,0,36
Ballinamalla,9221,8,9,6,15,43,58,-15,33
Portadown,9221,9,9,5,16,30,43,-13,32
Glentoran,9221,10,8,8,14,31,48,-17,32
Ards,9221,11,7,8,15,35,49,-14,29
Linfield,9222,1,16,9,5,59,27,32,57
Crusaders,9222,2,16,5,9,55,37,18,53
Cliftonville,9222,3,15,6,9,53,39,14,51
Dungannon,9222,4,14,8,8,51,38,13,50
Ballymena,9222,5,14,7,9,57,56,1,49
Glenavon,9222,6,12,9,9,53,48,5,45
Coleraine,9222,7,11,11,8,41,35,6,44
Glentoran,9222,8,12,7,11,36,47,-11,43
Ballinamalla,9222,9,7,6,17,33,51,-18,27
Ards,9222,10,6,4,20,29,54,-25,22
Portadown,9222,11,4,4,22,23,58,-35,16
Crusaders,9223,1,20,6,4,59,26,33,66
Linfield,9223,2,13,11,6,57,33,24,50
Cliftonville,9223,3,14,6,10,51,43,8,48
Coleraine,9223,4,12,10,8,41,39,2,46
Ballymena,9223,5,11,10,9,53,55,-2,43
Glenavon,9223,6,10,11,9,51,47,4,41
Glentoran,9223,7,10,6,14,29,46,-17,36
Ballinamalla,9223,8,9,5,16,28,44,-16,32
Dungannon,9223,9,7,10,13,43,43,0,31
Ards,9223,10,8,7,15,32,45,-13,31
Portadown,9223,11,8,4,18,25,48,-23,28
Crusaders,9224,1,19,5,6,62,28,34,62
Linfield,9224,2,15,8,7,60,41,19,53
Ballymena,9224,3,15,5,10,55,53,2,50
Coleraine,9224,4,12,12,6,47,35,12,48
Cliftonville,9224,5,14,4,12,45,39,6,46
Ards,9224,6,11,6,13,43,50,-7,39
Glenavon,9224,7,10,8,12,41,41,0,38
Glentoran,9224,8,9,8,13,33,46,-13,35
Dungannon,9224,9,9,7,14,40,47,-7,34
Portadown,9224,10,8,6,16,27,45,-18,30
Ballinamalla,9224,11,6,5,19,26,54,-28,23
Crusaders,9225,1,17,8,5,60,30,30,59
Linfield,9225,2,14,10,6,55,31,24,52
Cliftonville,9225,3,14,9,7,52,39,13,51
Ballymena,9225,4,15,5,10,62,56,6,50
Coleraine,9225,5,11,13,6,40,34,6,46
Glenavon,9225,6,10,11,9,46,46,0,41
Dungannon,9225,7,9,9,12,49,48,1,36
Portadown,9225,8,10,4,16,34,47,-13,34
Ballinamalla,9225,9,8,7,15,26,48,-22,31
Glentoran,9225,10,5,10,15,24,44,-20,25
Ards,9225,11,5,8,17,36,61,-25,23
Ballymena,9226,1,16,7,7,67,52,15,55
Crusaders,9226,2,15,7,8,59,38,21,52
Linfield,9226,3,14,9,7,59,32,27,51
Cliftonville,9226,4,14,7,9,57,47,10,49
Glenavon,9226,5,11,10,9,49,46,3,43
Coleraine,9226,6,11,10,9,41,38,3,43
Dungannon,9226,7,10,9,11,50,54,-4,39
Ards,9226,8,10,6,14,36,47,-11,36
Glentoran,9226,9,8,7,15,29,47,-18,31
Portadown,9226,10,8,5,17,28,53,-25,29
Ballinamalla,9226,11,6,7,17,28,49,-21,25
Linfield,9227,1,17,8,5,61,31,30,59
Ballymena,9227,2,16,8,6,60,46,14,56
Crusaders,9227,3,15,9,6,58,41,17,54
Cliftonville,9227,4,15,5,10,54,43,11,50
Coleraine,9227,5,11,10,9,46,47,-1,43
Glenavon,9227,6,10,11,9,49,49,0,41
Ards,9227,7,11,3,16,43,50,-7,36
Dungannon,9227,8,7,10,13,44,45,-1,31
Glentoran,9227,9,8,7,15,34,48,-14,31
Ballinamalla,9227,10,7,7,16,33,57,-24,28
Portadown,9227,11,7,4,19,26,51,-25,25
Cliftonville,9228,1,15,8,7,52,33,19,53
Linfield,9228,2,14,10,6,55,29,26,52
Coleraine,9228,3,14,9,7,47,31,16,51
Crusaders,9228,4,14,8,8,50,39,11,50
Ballymena,9228,5,13,8,9,58,57,1,47
Glenavon,9228,6,10,10,10,42,45,-3,40
Glentoran,9228,7,9,9,12,36,51,-15,36
Ards,9228,8,9,6,15,37,52,-15,33
Dungannon,9228,9,7,11,12,49,45,4,32
Ballinamalla,9228,10,7,7,16,31,55,-24,28
Portadown,9228,11,7,6,17,26,46,-20,27
Crusaders,9229,1,17,11,2,61,34,27,62
Coleraine,9229,2,16,8,6,54,34,20,56
Cliftonville,9229,3,15,4,11,50,40,10,49
Linfield,9229,4,13,7,10,54,34,20,46
Ballymena,9229,5,12,8,10,51,57,-6,44
Glenavon,9229,6,10,11,9,48,52,-4,41
Dungannon,9229,7,7,12,11,51,48,3,33
Ards,9229,8,8,7,15,39,54,-15,31
Glentoran,9229,9,7,10,13,28,43,-15,31
Ballinamalla,9229,10,8,5,17,32,50,-18,29
Portadown,9229,11,7,7,16,27,49,-22,28
Linfield,9230,1,17,7,6,63,32,31,58
Crusaders,9230,2,15,11,4,57,31,26,56
Cliftonville,9230,3,16,5,9,54,44,10,53
Ballymena,9230,4,14,7,9,56,56,0,49
Dungannon,9230,5,10,12,8,50,38,12,42
Glenavon,9230,6,10,11,9,47,43,4,41
Coleraine,9230,7,10,11,9,39,37,2,41
Glentoran,9230,8,11,6,13,41,45,-4,39
Ards,9230,9,9,4,17,39,50,-11,31
Ballinamalla,9230,10,8,5,17,25,58,-33,29
Portadown,9230,11,3,5,22,17,54,-37,14
Crusaders,9231,1,16,7,7,60,36,24,55
Linfield,9231,2,14,7,9,55,33,22,49
Coleraine,9231,3,12,13,5,47,33,14,49
Ballymena,9231,4,14,7,9,56,54,2,49
Cliftonville,9231,5,11,7,12,47,48,-1,40
Glenavon,9231,6,9,13,8,45,47,-2,40
Dungannon,9231,7,10,9,11,50,45,5,39
Glentoran,9231,8,10,6,14,27,40,-13,36
Ballinamalla,9231,9,9,6,15,31,52,-21,33
Portadown,9231,10,7,9,14,27,42,-15,30
Ards,9231,11,6,10,14,37,52,-15,28
Linfield,9232,1,14,12,4,54,25,29,54
Crusaders,9232,2,15,7,8,51,40,11,52
Coleraine,9232,3,14,9,7,46,32,14,51
Dungannon,9232,4,14,8,8,53,40,13,50
Cliftonville,9232,5,14,7,9,53,40,13,49
Ballymena,9232,6,14,7,9,61,53,8,49
Glenavon,9232,7,9,11,10,47,49,-2,38
Ards,9232,8,9,6,15,36,49,-13,33
Portadown,9232,9,9,4,17,27,45,-18,31
Glentoran,9232,10,8,7,15,36,58,-22,31
Ballinamalla,9232,11,5,2,23,23,56,-33,17
Crusaders,9233,1,17,8,5,57,34,23,59
Cliftonville,9233,2,15,6,9,47,37,10,51
Ballymena,9233,3,14,9,7,60,52,8,51
Dungannon,9233,4,14,6,10,55,38,17,48
Linfield,9233,5,12,10,8,46,30,16,46
Glenavon,9233,6,10,13,7,44,40,4,43
Glentoran,9233,7,10,8,12,35,39,-4,38
Coleraine,9233,8,9,8,13,40,49,-9,35
Ards,9233,9,10,5,15,46,57,-11,35
Portadown,9233,10,7,5,18,22,47,-25,26
Ballinamalla,9233,11,4,8,18,29,58,-29,20
Linfield,9234,1,16,11,3,63,28,35,59
Crusaders,9234,2,17,8,5,58,33,25,59
Glenavon,9234,3,15,9,6,50,39,11,54
Cliftonville,9234,4,14,6,10,47,44,3,48
Coleraine,9234,5,13,8,9,50,42,8,47
Glentoran,9234,6,10,7,13,31,39,-8,37
Ballymena,9234,7,11,3,16,54,66,-12,36
Dungannon,9234,8,9,8,13,39,42,-3,35
Ards,9234,9,10,4,16,37,45,-8,34
Portadown,9234,10,7,5,18,21,42,-21,26
Ballinamalla,9234,11,7,3,20,31,61,-30,24
Crusaders,9235,1,18,7,5,63,37,26,61
Ballymena,9235,2,15,6,9,60,60,0,51
Cliftonville,9235,3,14,7,9,51,41,10,49
Linfield,9235,4,13,9,8,59,38,21,48
Glenavon,9235,5,11,11,8,45,45,0,44
Coleraine,9235,6,10,13,7,43,33,10,43
Dungannon,9235,7,9,7,14,42,40,2,34
Glentoran,9235,8,7,12,11,30,45,-15,33
Ballinamalla,9235,9,9,6,15,31,48,-17,33
Ards,9235,10,8,8,14,37,46,-9,32
Portadown,9235,11,4,8,18,20,48,-28,20
Crusaders,9236,1,19,6,5,60,36,24,63
Linfield,9236,2,18,7,5,65,32,33,61
Ballymena,9236,3,17,5,8,64,53,11,56
Coleraine,9236,4,14,8,8,49,44,5,50
Cliftonville,9236,5,14,2,14,56,54,2,44
Glenavon,9236,6,10,10,10,45,48,-3,40
Ballinamalla,9236,7,12,4,14,30,42,-12,40
Dungannon,9236,8,8,11,11,47,38,9,35
Ards,9236,9,9,4,17,44,53,-9,31
Glentoran,9236,10,6,7,17,33,60,-27,25
Portadown,9236,11,3,6,21,20,53,-33,15
Cliftonville,9237,1,16,6,8,49,30,19,54
Crusaders,9237,2,14,11,5,53,34,19,53
Coleraine,9237,3,11,13,6,42,33,9,46
Linfield,9237,4,13,6,11,55,35,20,45
Glenavon,9237,5,11,12,7,48,41,7,45
Ballymena,9237,6,11,10,9,55,60,-5,43
Glentoran,9237,7,10,9,11,30,41,-11,39
Dungannon,9237,8,7,14,9,51,48,3,35
Ards,9237,9,8,7,15,36,48,-12,31
Ballinamalla,9237,10,8,6,16,32,51,-19,30
Portadown,9237,11,5,8,17,24,54,-30,23
Crusaders,9238,1,17,8,5,57,29,28,59
Glenavon,9238,2,16,9,5,52,35,17,57
Linfield,9238,3,14,9,7,53,29,24,51
Coleraine,9238,4,13,9,8,41,39,2,48
Cliftonville,9238,5,14,5,11,51,41,10,47
Ballymena,9238,6,13,6,11,55,57,-2,45
Ballinamalla,9238,7,11,3,16,33,49,-16,36
Dungannon,9238,8,9,8,13,48,51,-3,35
Glentoran,9238,9,10,5,15,27,41,-14,35
Ards,9238,10,6,5,19,35,54,-19,23
Portadown,9238,11,6,5,19,26,53,-27,23
Crusaders,9239,1,16,8,6,52,39,13,56
Linfield,9239,2,13,10,7,61,41,20,49
Cliftonville,9239,3,13,6,11,48,42,6,45
Ballymena,9239,4,12,8,10,53,55,-2,44
Coleraine,9239,5,9,14,7,39,31,8,41
Glenavon,9239,6,10,10,10,49,49,0,40
Ballinamalla,9239,7,10,7,13,29,47,-18,37
Ards,9239,8,9,9,12,41,44,-3,36
Glentoran,9239,9,9,9,12,30,39,-9,36
Dungannon,9239,10,9,8,13,46,41,5,35
Portadown,9239,11,6,9,15,23,43,-20,27
Crusaders,9240,1,16,7,7,59,37,22,55
Ballymena,9240,2,16,6,8,60,56,4,54
Cliftonville,9240,3,14,7,9,50,35,15,49
Linfield,9240,4,12,11,7,56,34,22,47
Glenavon,9240,5,10,13,7,48,47,1,43
Coleraine,9240,6,9,11,10,35,41,-6,38
Portadown,9240,7,10,8,12,30,38,-8,38
Dungannon,9240,8,8,12,10,49,48,1,36
Ards,9240,9,9,5,16,40,46,-6,32
Glentoran,9240,10,7,10,13,31,48,-17,31
Ballinamalla,9240,11,6,6,18,32,60,-28,24
Cliftonville,9241,1,17,4,9,54,39,15,55
Ballymena,9241,2,16,6,8,70,64,6,54
Linfield,9241,3,15,8,7,65,35,30,53
Crusaders,9241,4,15,5,10,47,37,10,50
Coleraine,9241,5,11,11,8,42,38,4,44
Glenavon,9241,6,10,12,8,56,46,10,42
Dungannon,9241,7,10,10,10,44,41,3,40
Ards,9241,8,11,7,12,40,44,-4,40
Ballinamalla,9241,9,8,5,17,37,54,-17,29
Glentoran,9241,10,7,8,15,26,45,-19,29
Portadown,9241,11,4,6,20,24,62,-38,18
Linfield,9242,1,15,10,5,52,26,26,55
Cliftonville,9242,2,16,7,7,51,35,16,55
Glenavon,9242,3,15,8,7,52,41,11,53
Crusaders,9242,4,14,9,7,49,37,12,51
Ballymena,9242,5,14,4,12,53,55,-2,46
Coleraine,9242,6,10,12,8,41,38,3,42
Dungannon,9242,7,10,10,10,52,44,8,40
Ballinamalla,9242,8,8,6,16,35,51,-16,30
Glentoran,9242,9,6,11,13,23,39,-16,29
Portadown,9242,10,7,6,17,26,46,-20,27
Ards,9242,11,5,7,18,30,52,-22,22
Crusaders,9243,1,17,8,5,56,35,21,59
Linfield,9243,2,15,10,5,66,25,41,55
Ballymena,9243,3,15,6,9,59,63,-4,51
Glenavon,9243,4,13,10,7,54,45,9,49
Cliftonville,9243,5,14,5,11,50,40,10,47
Coleraine,9243,6,9,11,10,37,46,-9,38
Portadown,9243,7,9,7,14,30,37,-7,34
Ards,9243,8,8,8,14,30,48,-18,32
Glentoran,9243,9,8,7,15,32,47,-15,31
Dungannon,9243,10,6,12,12,41,45,-4,30
Ballinamalla,9243,11,6,6,18,34,58,-24,24
Crusaders,9244,1,18,6,6,54,34,20,60
Cliftonville,9244,2,18,4,8,57,35,22,58
Coleraine,9244,3,13,9,8,42,36,6,48
Ballymena,9244,4,13,9,8,52,49,3,48
Linfield,9244,5,12,10,8,51,33,18,46
Dungannon,9244,6,11,8,11,49,39,10,41
Glenavon,9244,7,9,12,9,49,52,-3,39
Ballinamalla,9244,8,10,2,18,27,52,-25,32
Glentoran,9244,9,8,6,16,25,42,-17,30
Ards,9244,10,8,4,18,40,52,-12,28
Portadown,9244,11,8,4,18,26,48,-22,28
Linfield,9245,1,16,10,4,65,31,34,58
Crusaders,9245,2,16,7,7,51,36,15,55
Glenavon,9245,3,12,12,6,43,37,6,48
Ballymena,9245,4,13,8,9,55,57,-2,47
Cliftonville,9245,5,13,7,10,53,43,10,46
Dungannon,9245,6,12,9,9,56,45,11,45
Coleraine,9245,7,11,11,8,42,37,5,44
Glentoran,9245,8,9,9,12,31,40,-9,36
Ards,9245,9,6,7,17,35,52,-17,25
Ballinamalla,9245,10,6,5,19,26,52,-26,23
Portadown,9245,11,6,5,19,25,52,-27,23
Crusaders,9246,1,16,6,8,56,40,16,54
Linfield,9246,2,13,9,8,62,44,18,48
Cliftonville,9246,3,14,6,10,50,40,10,48
Ballymena,9246,4,14,6,10,66,62,4,48
Coleraine,9246,5,12,11,7,45,36,9,47
Glenavon,9246,6,13,8,9,51,47,4,47
Dungannon,9246,7,12,6,12,52,44,8,42
Portadown,9246,8,11,2,17,25,39,-14,35
Ards,9246,9,10,4,16,35,45,-10,34
Glentoran,9246,10,8,6,16,28,51,-23,30
Ballinamalla,9246,11,7,6,17,28,50,-22,27
Crusaders,9247,1,17,7,6,58,35,23,58
Cliftonville,9247,2,16,6,8,53,37,16,54
Ballymena,9247,3,15,8,7,68,59,9,53
Linfield,9247,4,14,10,6,53,28,25,52
Coleraine,9247,5,8,13,9,45,49,-4,37
Glenavon,9247,6,9,10,11,43,49,-6,37
Dungannon,9247,7,9,9,12,49,46,3,36
Ards,9247,8,10,6,14,40,49,-9,36
Glentoran,9247,9,7,8,15,29,43,-14,29
Portadown,9247,10,7,8,15,25,44,-19,29
Ballinamalla,9247,11,8,5,17,30,54,-24,29
Crusaders,9248,1,16,9,5,59,31,28,57
Linfield,9248,2,13,12,5,62,34,28,51
Cliftonville,9248,3,14,5,11,50,42,8,47
Ballymena,9248,4,13,8,9,52,48,4,47
Coleraine,9248,5,11,10,9,47,37,10,43
Glenavon,9248,6,9,14,7,46,44,2,41
Glentoran,9248,7,10,7,13,38,47,-9,37
Portadown,9248,8,10,7,13,26,45,-19,37
Dungannon,9248,9,9,9,12,50,51,-1,36
Ards,9248,10,8,6,16,36,55,-19,30
Ballinamalla,9248,11,6,5,19,29,61,-32,23
Linfield,9249,1,16,9,5,62,29,33,57
Coleraine,9249,2,13,10,7,46,37,9,49
Cliftonville,9249,3,15,3,12,51,40,11,48
Crusaders,9249,4,13,8,9,47,38,9,47
Ballymena,9249,5,13,6,11,55,64,-9,45
Dungannon,9249,6,11,9,10,49,36,13,42
Glenavon,9249,7,8,14,8,43,45,-2,38
Ballinamalla,9249,8,11,3,16,33,51,-18,36
Glentoran,9249,9,9,6,15,30,44,-14,33
Ards,9249,10,10,3,17,36,51,-15,33
Portadown,9249,11,8,5,17,26,43,-17,29
Ballymena,9250,1,19,4,7,68,48,20,61
Cliftonville,9250,2,15,5,10,53,38,15,50
Linfield,9250,3,14,7,9,57,38,19,49
Crusaders,9250,4,13,9,8,51,40,11,48
Glentoran,9250,5,13,6,11,36,45,-9,45
Glenavon,9250,6,11,11,8,52,51,1,44
Coleraine,9250,7,10,12,8,43,40,3,42
Dungannon,9250,8,10,9,11,46,43,3,39
Ards,9250,9,8,3,19,36,51,-15,27
Ballinamalla,9250,10,7,5,18,30,54,-24,26
Portadown,9250,11,6,7,17,25,49,-24,25
Crusaders,9251,1,19,7,4,62,28,34,64
Linfield,9251,2,17,10,3,59,25,34,61
Glenavon,9251,3,14,9,7,52,42,10,51
Cliftonville,9251,4,13,9,8,46,38,8,48
Ballymena,9251,5,11,10,9,57,56,1,43
Dungannon,9251,6,10,10,10,47,40,7,40
Coleraine,9251,7,9,8,13,36,43,-7,35
Glentoran,9251,8,7,8,15,26,46,-20,29
Ards,9251,9,8,5,17,35,56,-21,29
Portadown,9251,10,6,9,15,26,48,-22,27
Ballinamalla,9251,11,7,3,20,28,52,-24,24
Crusaders,9252,1,19,6,5,58,28,30,63
Linfield,9252,2,15,11,4,65,32,33,56
Cliftonville,9252,3,16,5,9,57,40,17,53
Coleraine,9252,4,11,10,9,41,41,0,43
Ballymena,9252,5,13,4,13,63,67,-4,43
Dungannon,9252,6,8,13,9,48,45,3,37
Ards,9252,7,10,7,13,42,49,-7,37
Glenavon,9252,8,8,13,9,42,50,-8,37
Glentoran,9252,9,7,10,13,28,42,-14,31
Portadown,9252,10,8,4,18,22,44,-22,28
Ballinamalla,9252,11,5,7,18,26,54,-28,22
Crusaders,9253,1,19,7,4,66,36,30,64
Linfield,9253,2,13,10,7,57,38,19,49
Dungannon,9253,3,13,7,10,51,41,10,46
Coleraine,9253,4,11,13,6,43,36,7,46
Cliftonville,9253,5,13,6,11,50,42,8,45
Glenavon,9253,6,11,12,7,53,49,4,45
Ballymena,9253,7,12,9,9,56,54,2,45
Ards,9253,8,9,4,17,35,52,-17,31
Glentoran,9253,9,8,6,16,29,46,-17,30
Portadown,9253,10,6,7,17,27,49,-22,25
Ballinamalla,9253,11,6,7,17,29,53,-24,25
Linfield,9254,1,19,9,2,72,28,44,66
Cliftonville,9254,2,15,5,10,55,42,13,50
Crusaders,9254,3,12,9,9,53,46,7,45
Coleraine,9254,4,11,11,8,44,44,0,44
Ballymena,9254,5,12,6,12,60,62,-2,42
Dungannon,9254,6,11,8,11,44,38,6,41
Glenavon,9254,7,9,11,10,44,48,-4,38
Ards,9254,8,10,6,14,35,42,-7,36
Glentoran,9254,9,10,6,14,33,48,-15,36
Ballinamalla,9254,10,9,2,19,32,52,-20,29
Portadown,9254,11,8,5,17,28,50,-22,29
Crusaders,9255,1,18,7,5,65,33,32,61
Linfield,9255,2,17,9,4,69,29,40,60
Cliftonville,9255,3,16,4,10,53,42,11,52
Ballymena,9255,4,14,4,12,54,61,-7,46
Coleraine,9255,5,11,12,7,43,38,5,45
Glenavon,9255,6,11,11,8,51,51,0,44
Dungannon,9255,7,7,14,9,49,45,4,35
Ballinamalla,9255,8,7,8,15,30,51,-21,29
Ards,9255,9,7,6,17,38,56,-18,27
Glentoran,9255,10,7,6,17,28,51,-23,27
Portadown,9255,11,6,7,17,23,46,-23,25
Crusaders,9256,1,18,7,5,61,30,31,61
Glenavon,9256,2,13,13,4,49,33,16,52
Linfield,9256,3,14,8,8,55,33,22,50
Ballymena,9256,4,15,4,11,55,56,-1,49
Coleraine,9256,5,12,9,9,41,37,4,45
Cliftonville,9256,6,11,8,11,42,37,5,41
Dungannon,9256,7,8,10,12,48,49,-1,34
Ards,9256,8,9,7,14,38,43,-5,34
Portadown,9256,9,9,7,14,28,37,-9,34
Glentoran,9256,10,9,7,14,27,52,-25,34
Ballinamalla,9256,11,5,4,21,22,59,-37,19
Crusaders,9257,1,17,5,8,51,30,21,56
Linfield,9257,2,16,7,7,57,26,31,55
Ballymena,9257,3,16,3,11,58,56,2,51
Cliftonville,9257,4,14,7,9,48,38,10,49
Glenavon,9257,5,11,10,9,50,47,3,43
Coleraine,9257,6,11,10,9,38,39,-1,43
Dungannon,9257,7,10,9,11,51,46,5,39
Ards,9257,8,9,6,15,37,45,-8,33
Glentoran,9257,9,9,6,15,24,41,-17,33
Ballinamalla,9257,10,8,5,17,24,46,-22,29
Portadown,9257,11,9,2,19,26,50,-24,29
Crusaders,9258,1,17,6,7,63,37,26,57
Cliftonville,9258,2,16,5,9,56,46,10,53
Linfield,9258,3,14,9,7,60,33,27,51
Ballymena,9258,4,15,5,10,59,55,4,50
Glenavon,9258,5,11,10,9,45,46,-1,43
Dungannon,9258,6,11,7,12,57,48,9,40
Glentoran,9258,7,11,7,12,34,45,-11,40
Coleraine,9258,8,8,13,9,40,40,0,37
Portadown,9258,9,8,7,15,32,49,-17,31
Ballinamalla,9258,10,10,1,19,27,52,-25,31
Ards,9258,11,6,6,18,33,55,-22,24
Crusaders,9259,1,16,8,6,52,36,16,56
Ballymena,9259,2,14,9,7,58,56,2,51
Cliftonville,9259,3,15,4,11,50,35,15,49
Coleraine,9259,4,12,11,7,47,35,12,47
Linfield,9259,5,10,12,8,56,41,15,42
Glenavon,9259,6,10,11,9,49,53,-4,41
Ards,9259,7,11,6,13,44,51,-7,39
Dungannon,9259,8,6,15,9,48,46,2,33
Portadown,9259,9,9,6,15,32,46,-14,33
Glentoran,9259,10,6,10,14,32,49,-17,28
Ballinamalla,9259,11,8,4,18,30,50,-20,28
Linfield,9260,1,16,6,8,57,28,29,54
Ballymena,9260,2,16,6,8,65,54,11,54
Crusaders,9260,3,15,8,7,50,38,12,53
Glenavon,9260,4,12,9,9,44,44,0,45
Cliftonville,9260,5,13,5,12,49,42,7,44
Coleraine,9260,6,12,8,10,42,38,4,44
Glentoran,9260,7,10,7,13,30,42,-12,37
Ards,9260,8,10,6,14,39,54,-15,36
Dungannon,9260,9,8,11,11,47,41,6,35
Ballinamalla,9260,10,8,4,18,27,45,-18,28
Portadown,9260,11,8,4,18,29,53,-24,28
Linfield,9261,1,17,8,5,57,28,29,59
Coleraine,9261,2,14,9,7,41,29,12,51
Ballymena,9261,3,14,7,9,59,52,7,49
Crusaders,9261,4,13,8,9,50,39,11,47
Glenavon,9261,5,10,12,8,46,47,-1,42
Cliftonville,9261,6,12,5,13,42,37,5,41
Dungannon,9261,7,9,11,10,51,47,4,38
Ballinamalla,9261,8,12,1,17,33,49,-16,37
Glentoran,9261,9,9,9,12,29,35,-6,36
Ards,9261,10,8,4,18,37,60,-23,28
Portadown,9261,11,6,8,16,23,45,-22,26
Ballymena,9262,1,20,5,5,72,50,22,65
Crusaders,9262,2,16,6,8,62,40,22,54
Cliftonville,9262,3,16,4,10,52,43,9,52
Glenavon,9262,4,12,12,6,51,43,8,48
Linfield,9262,5,12,10,8,56,37,19,46
Coleraine,9262,6,13,7,10,46,40,6,46
Dungannon,9262,7,10,8,12,51,54,-3,38
Ards,9262,8,10,4,16,34,52,-18,34
Glentoran,9262,9,7,10,13,35,49,-14,31
Ballinamalla,9262,10,5,6,19,29,53,-24,21
Portadown,9262,11,5,6,19,24,51,-27,21
Linfield,9263,1,15,10,5,66,31,35,55
Cliftonville,9263,2,15,6,9,62,43,19,51
Crusaders,9263,3,14,8,8,53,42,11,50
Glenavon,9263,4,13,10,7,53,45,8,49
Ballymena,9263,5,13,8,9,65,65,0,47
Coleraine,9263,6,10,11,9,45,44,1,41
Dungannon,9263,7,9,11,10,49,49,0,38
Ards,9263,8,8,7,15,38,55,-17,31
Glentoran,9263,9,8,6,16,22,46,-24,30
Portadown,9263,10,7,8,15,28,45,-17,29
Ballinamalla,9263,11,7,7,16,34,50,-16,28
Linfield,9264,1,15,9,6,60,32,28,54
Crusaders,9264,2,15,9,6,50,32,18,54
Glenavon,9264,3,13,11,6,49,40,9,50
Cliftonville,9264,4,15,4,11,51,36,15,49
Dungannon,9264,5,12,8,10,49,34,15,44
Coleraine,9264,6,10,10,10,40,46,-6,40
Ballymena,9264,7,11,7,12,49,60,-11,40
Ards,9264,8,10,5,15,44,52,-8,35
Glentoran,9264,9,8,7,15,34,49,-15,31
Portadown,9264,10,8,7,15,25,40,-15,31
Ballinamalla,9264,11,7,5,18,28,58,-30,26
Crusaders,9265,1,16,8,6,53,32,21,56
Linfield,9265,2,15,9,6,56,29,27,54
Dungannon,9265,3,12,9,9,52,40,12,45
Cliftonville,9265,4,13,6,11,46,42,4,45
Ballymena,9265,5,12,9,9,52,55,-3,45
Coleraine,9265,6,11,11,8,44,38,6,44
Glentoran,9265,7,11,8,11,35,39,-4,41
Glenavon,9265,8,10,10,10,46,44,2,40
Ards,9265,9,9,5,16,31,44,-13,32
Portadown,9265,10,8,6,16,21,39,-18,30
Ballinamalla,9265,11,6,3,21,23,57,-34,21
Cliftonville,9266,1,15,6,9,51,41,10,51
Coleraine,9266,2,13,12,5,48,38,10,51
Crusaders,9266,2,15,6,9,48,38,10,51
Ballymena,9266,4,13,8,9,54,52,2,47
Linfield,9266,5,12,10,8,58,33,25,46
Glenavon,9266,6,9,11,10,40,39,1,38
Ards,9266,7,11,5,14,39,49,-10,38
Glentoran,9266,8,9,8,13,33,42,-9,35
Dungannon,9266,9,7,11,12,41,43,-2,32
Ballinamalla,9266,10,9,4,17,34,52,-18,31
Portadown,9266,11,6,11,13,20,39,-19,29
Linfield,9267,1,14,11,5,58,29,29,53
Crusaders,9267,2,15,6,9,52,36,16,51
Cliftonville,9267,3,15,6,9,48,36,12,51
Glenavon,9267,4,12,13,5,47,41,6,49
Ballymena,9267,5,13,7,10,60,61,-1,46
Dungannon,9267,6,11,8,11,56,42,14,41
Coleraine,9267,7,10,7,13,41,47,-6,37
Portadown,9267,8,9,6,15,29,44,-15,33
Ards,9267,9,10,3,17,33,49,-16,33
Glentoran,9267,10,6,12,12,25,43,-18,30
Ballinamalla,9267,11,9,3,18,33,54,-21,30
Crusaders,9268,1,17,8,5,59,36,23,59
Linfield,9268,2,16,8,6,60,33,27,56
Dungannon,9268,3,13,10,7,56,38,18,49
Cliftonville,9268,4,14,4,12,55,48,7,46
Glenavon,9268,5,10,14,6,39,35,4,44
Ballymena,9268,6,12,8,10,54,57,-3,44
Coleraine,9268,7,11,10,9,45,41,4,43
Ards,9268,8,9,5,16,39,56,-17,32
Ballinamalla,9268,9,9,3,18,32,49,-17,30
Glentoran,9268,10,6,7,17,22,43,-21,25
Portadown,9268,11,5,9,16,19,44,-25,24
Linfield,9269,1,17,9,4,68,32,36,60
Crusaders,9269,2,16,7,7,58,39,19,55
Cliftonville,9269,3,17,4,9,54,39,15,55
Ballymena,9269,4,16,6,8,60,59,1,54
Coleraine,9269,5,10,11,9,46,43,3,41
Glenavon,9269,6,9,12,9,47,48,-1,39
Dungannon,9269,7,9,9,12,50,47,3,36
Ards,9269,8,9,8,13,44,52,-8,35
Glentoran,9269,9,6,10,14,34,51,-17,28
Ballinamalla,9269,10,6,7,17,32,56,-24,25
Portadown,9269,11,4,9,17,24,51,-27,21
Crusaders,9270,1,17,10,3,56,29,27,61
Cliftonville,9270,2,16,6,8,55,38,17,54
Linfield,9270,3,14,10,6,57,27,30,52
Ballymena,9270,4,12,10,8,55,54,1,46
Glenavon,9270,5,11,12,7,46,42,4,45
Coleraine,9270,6,11,11,8,47,41,6,44
Dungannon,9270,7,8,12,10,46,43,3,36
Glentoran,9270,8,8,8,14,29,46,-17,32
Portadown,9270,9,6,10,14,27,48,-21,28
Ballinamalla,9270,10,7,4,19,27,57,-30,25
Ards,9270,11,5,7,18,34,54,-20,22
Crusaders,9271,1,16,7,7,57,35,22,55
Cliftonville,9271,2,16,5,9,51,36,15,53
Linfield,9271,3,14,10,6,57,31,26,52
Ballymena,9271,4,14,6,10,63,59,4,48
Coleraine,9271,5,11,11,8,40,37,3,44
Dungannon,9271,6,11,7,12,56,56,0,40
Glenavon,9271,7,10,10,10,48,55,-7,40
Ards,9271,8,10,8,12,37,41,-4,38
Portadown,9271,9,9,4,17,25,41,-16,31
Ballinamalla,9271,10,9,4,17,28,47,-19,31
Glentoran,9271,11,5,8,17,22,46,-24,23
Linfield,9272,1,15,7,8,63,35,28,52
Cliftonville,9272,2,15,7,8,55,44,11,52
Crusaders,9272,3,14,9,7,55,38,17,51
Coleraine,9272,4,12,10,8,44,38,6,46
Dungannon,9272,5,10,12,8,50,39,11,42
Glentoran,9272,6,12,6,12,33,41,-8,42
Glenavon,9272,7,10,11,9,41,42,-1,41
Ballymena,9272,8,12,5,13,57,64,-7,41
Portadown,9272,9,10,3,17,37,51,-14,33
Ballinamalla,9272,10,8,4,18,31,49,-18,28
Ards,9272,11,7,6,17,38,63,-25,27
Glenavon,9273,1,15,10,5,51,34,17,55
Crusaders,9273,2,15,6,9,50,38,12,51
Ballymena,9273,3,14,9,7,60,57,3,51
Linfield,9273,4,12,11,7,56,37,19,47
Dungannon,9273,5,13,8,9,57,44,13,47
Cliftonville,9273,6,13,6,11,44,36,8,45
Coleraine,9273,7,11,12,7,39,33,6,45
Glentoran,9273,8,8,8,14,32,46,-14,32
Ards,9273,9,9,4,17,38,49,-11,31
Ballinamalla,9273,10,7,4,19,25,53,-28,25
Portadown,9273,11,6,6,18,22,47,-25,24
Linfield,9274,1,17,6,7,64,34,30,57
Crusaders,9274,2,15,10,5,54,32,22,55
Cliftonville,9274,3,15,6,9,53,36,17,51
Ballymena,9274,4,13,7,10,55,57,-2,46
Glenavon,9274,5,10,11,9,52,47,5,41
Coleraine,9274,6,9,13,8,37,40,-3,40
Ards,9274,7,9,7,14,31,41,-10,34
Dungannon,9274,8,7,12,11,47,53,-6,33
Glentoran,9274,9,9,6,15,30,46,-16,33
Portadown,9274,10,9,4,17,26,43,-17,31
Ballinamalla,9274,11,7,8,15,32,52,-20,29
Linfield,9275,1,18,8,4,59,23,36,62
Crusaders,9275,2,14,9,7,47,29,18,51
Glenavon,9275,3,13,10,7,54,46,8,49
Cliftonville,9275,4,14,5,11,49,40,9,47
Ballymena,9275,5,13,6,11,52,56,-4,45
Coleraine,9275,6,11,9,10,37,38,-1,42
Dungannon,9275,7,9,13,8,52,44,8,40
Portadown,9275,8,9,5,16,22,40,-18,32
Ballinamalla,9275,9,7,8,15,30,50,-20,29
Ards,9275,10,6,9,15,31,46,-15,27
Glentoran,9275,11,5,10,15,21,42,-21,25
Crusaders,9276,1,15,9,6,51,32,19,54
Linfield,9276,2,14,8,8,67,38,29,50
Cliftonville,9276,3,14,5,11,59,44,15,47
Ballymena,9276,4,13,7,10,58,59,-1,46
Glenavon,9276,5,11,12,7,49,43,6,45
Coleraine,9276,6,11,10,9,43,42,1,43
Dungannon,9276,7,10,12,8,49,41,8,42
Ards,9276,8,8,8,14,42,56,-14,32
Ballinamalla,9276,9,9,5,16,28,45,-17,32
Glentoran,9276,10,8,6,16,29,50,-21,30
Portadown,9276,11,8,6,16,25,50,-25,30
Crusaders,9277,1,19,7,4,65,35,30,64
Linfield,9277,2,15,10,5,67,36,31,55
Cliftonville,9277,3,13,7,10,54,44,10,46
Ballymena,9277,4,13,6,11,65,65,0,45
Glenavon,9277,5,12,8,10,44,46,-2,44
Coleraine,9277,6,11,10,9,47,43,4,43
Glentoran,9277,7,9,9,12,38,49,-11,36
Ards,9277,8,10,3,17,37,51,-14,33
Ballinamalla,9277,9,9,4,17,32,54,-22,31
Dungannon,9277,10,6,11,13,47,51,-4,29
Portadown,9277,11,8,5,17,33,55,-22,29
Crusaders,9278,1,17,10,3,59,31,28,61
Linfield,9278,2,17,8,5,64,26,38,59
Cliftonville,9278,3,17,5,8,56,38,18,56
Ballymena,9278,4,11,9,10,50,58,-8,42
Dungannon,9278,5,11,7,12,51,46,5,40
Glenavon,9278,6,10,10,10,44,43,1,40
Coleraine,9278,7,10,9,11,41,42,-1,39
Glentoran,9278,8,7,9,14,28,49,-21,30
Ards,9278,9,7,8,15,34,47,-13,29
Ballinamalla,9278,10,6,9,15,27,48,-21,27
Portadown,9278,11,7,6,17,26,52,-26,27
Linfield,9279,1,16,8,6,59,27,32,56
Crusaders,9279,2,16,8,6,52,40,12,56
Ballymena,9279,3,15,6,9,53,52,1,51
Coleraine,9279,4,12,9,9,45,38,7,45
Cliftonville,9279,5,13,5,12,44,37,7,44
Glenavon,9279,6,12,8,10,47,46,1,44
Ards,9279,7,12,4,14,41,40,1,40
Dungannon,9279,8,9,10,11,53,53,0,37
Glentoran,9279,9,9,7,14,29,42,-13,34
Ballinamalla,9279,10,9,2,19,30,52,-22,29
Portadown,9279,11,6,5,19,24,50,-26,23
Crusaders,9280,1,16,8,6,62,44,18,56
Cliftonville,9280,2,15,4,11,58,46,12,49
Linfield,9280,3,13,9,8,50,32,18,48
Glenavon,9280,4,13,8,9,52,43,9,47
Ballymena,9280,5,13,6,11,58,57,1,45
Coleraine,9280,6,10,11,9,42,41,1,41
Portadown,9280,7,11,4,15,32,45,-13,37
Ards,9280,8,10,5,15,43,51,-8,35
Dungannon,9280,9,8,10,12,46,49,-3,34
Ballinamalla,9280,10,8,8,14,29,47,-18,32
Glentoran,9280,11,8,7,15,26,43,-17,31
Crusaders,9281,1,18,5,7,56,37,19,59
Cliftonville,9281,2,16,6,8,64,40,24,54
Linfield,9281,3,14,9,7,56,33,23,51
Glenavon,9281,4,13,9,8,46,42,4,48
Ballymena,9281,5,13,7,10,56,61,-5,46
Portadown,9281,6,11,6,13,31,44,-13,39
Dungannon,9281,7,10,8,12,49,45,4,38
Coleraine,9281,8,9,11,10,45,47,-2,38
Glentoran,9281,9,9,6,15,29,44,-15,33
Ards,9281,10,8,5,17,38,51,-13,29
Ballinamalla,9281,11,5,6,19,24,50,-26,21
Linfield,9282,1,14,11,5,56,32,24,53
Coleraine,9282,2,14,11,5,49,32,17,53
Crusaders,9282,3,14,8,8,52,37,15,50
Glenavon,9282,4,12,13,5,50,40,10,49
Ballymena,9282,5,14,6,10,62,56,6,48
Cliftonville,9282,6,14,5,11,53,41,12,47
Dungannon,9282,7,8,10,12,45,48,-3,34
Portadown,9282,8,9,6,15,26,41,-15,33
Glentoran,9282,9,7,9,14,30,50,-20,30
Ballinamalla,9282,10,7,6,17,25,48,-23,27
Ards,9282,11,7,5,18,33,56,-23,26
Linfield,9283,1,17,8,5,64,31,33,59
Glenavon,9283,2,14,11,5,54,44,10,53
Cliftonville,9283,3,16,4,10,58,37,21,52
Ballymena,9283,4,15,4,11,58,57,1,49
Crusaders,9283,5,14,5,11,51,49,2,47
Coleraine,9283,6,11,11,8,40,32,8,44
Glentoran,9283,7,10,9,11,36,41,-5,39
Dungannon,9283,8,8,10,12,52,48,4,34
Ards,9283,9,9,3,18,38,57,-19,30
Ballinamalla,9283,10,8,4,18,29,54,-25,28
Portadown,9283,11,5,7,18,26,56,-30,22
Crusaders,9284,1,17,9,4,57,28,29,60
Glenavon,9284,2,17,8,5,62,40,22,59
Cliftonville,9284,3,15,6,9,51,39,12,51
Linfield,9284,4,13,9,8,55,33,22,48
Ballymena,9284,5,14,6,10,61,60,1,48
Dungannon,9284,6,12,8,10,59,50,9,44
Glentoran,9284,7,9,8,13,37,49,-12,35
Coleraine,9284,8,7,11,12,37,46,-9,32
Ards,9284,9,8,5,17,34,49,-15,29
Portadown,9284,10,8,5,17,29,52,-23,29
Ballinamalla,9284,11,5,5,20,32,68,-36,20
Crusaders,9285,1,18,8,4,58,29,29,62
Cliftonville,9285,2,16,5,9,49,33,16,53
Linfield,9285,3,13,11,6,56,35,21,50
Coleraine,9285,4,11,10,9,40,36,4,43
Ballymena,9285,5,12,7,11,51,51,0,43
Glenavon,9285,6,11,8,11,46,50,-4,41
Ards,9285,7,11,4,15,43,51,-8,37
Glentoran,9285,8,10,7,13,33,46,-13,37
Dungannon,9285,9,7,13,10,48,48,0,34
Ballinamalla,9285,10,7,6,17,32,55,-23,27
Portadown,9285,11,6,7,17,29,51,-22,25
Crusaders,9286,1,14,12,4,52,34,18,54
Linfield,9286,2,14,8,8,58,37,21,50
Coleraine,9286,3,12,11,7,45,35,10,47
Ballymena,9286,4,13,7,10,58,52,6,46
Cliftonville,9286,5,12,7,11,47,44,3,43
Glentoran,9286,6,12,6,12,34,41,-7,42
Glenavon,9286,7,9,12,9,47,44,3,39
Dungannon,9286,8,9,9,12,46,43,3,36
Portadown,9286,9,10,4,16,22,43,-21,34
Ards,9286,10,8,9,13,40,56,-16,33
Ballinamalla,9286,11,6,7,17,31,51,-20,25
Crusaders,9287,1,17,7,6,65,39,26,58
Linfield,9287,2,15,8,7,61,36,25,53
Cliftonville,9287,3,15,6,9,54,38,16,51
Coleraine,9287,4,14,9,7,47,32,15,51
Glenavon,9287,5,10,14,6,48,42,6,44
Ballymena,9287,6,12,7,11,50,59,-9,43
Dungannon,9287,7,9,11,10,54,43,11,38
Glentoran,9287,8,8,9,13,34,53,-19,33
Portadown,9287,9,7,8,15,26,46,-20,29
Ards,9287,10,5,10,15,29,51,-22,25
Ballinamalla,9287,11,5,7,18,27,56,-29,22
Linfield,9288,1,17,8,5,70,28,42,59
Cliftonville,9288,2,16,5,9,51,40,11,53
Crusaders,9288,3,15,7,8,51,41,10,52
Ballymena,9288,4,15,3,12,63,63,0,48
Dungannon,9288,5,13,7,10,61,49,12,46
Glenavon,9288,6,10,10,10,48,45,3,40
Coleraine,9288,7,9,9,12,38,42,-4,36
Ards,9288,8,10,5,15,35,49,-14,35
Ballinamalla,9288,9,10,4,16,32,47,-15,34
Portadown,9288,10,8,5,17,26,47,-21,29
Glentoran,9288,11,8,5,17,26,50,-24,29
Crusaders,9289,1,18,9,3,62,31,31,63
Cliftonville,9289,2,16,6,8,61,49,12,54
Linfield,9289,3,13,11,6,65,36,29,50
Glenavon,9289,4,12,11,7,45,39,6,47
Ards,9289,5,11,7,12,45,44,1,40
Ballymena,9289,6,10,8,12,46,59,-13,38
Glentoran,9289,7,9,8,13,30,43,-13,35
Coleraine,9289,8,8,10,12,45,54,-9,34
Dungannon,9289,9,8,9,13,44,42,2,33
Ballinamalla,9289,10,9,3,18,31,54,-23,30
Portadown,9289,11,7,6,17,28,51,-23,27
Crusaders,9290,1,16,5,9,52,33,19,53
Linfield,9290,2,14,9,7,55,30,25,51
Dungannon,9290,3,13,8,9,56,41,15,47
Ballymena,9290,4,14,5,11,53,59,-6,47
Glenavon,9290,5,12,10,8,45,44,1,46
Coleraine,9290,6,12,8,10,41,38,3,44
Cliftonville,9290,7,12,5,13,47,43,4,41
Glentoran,9290,8,11,4,15,32,44,-12,37
Ballinamalla,9290,9,11,2,17,32,48,-16,35
Ards,9290,10,9,4,17,30,46,-16,31
Portadown,9290,11,9,4,17,27,44,-17,31
Crusaders,9291,1,20,7,3,64,30,34,67
Linfield,9291,2,15,9,6,61,29,32,54
Ballymena,9291,3,15,6,9,54,53,1,51
Glenavon,9291,4,14,8,8,50,44,6,50
Cliftonville,9291,5,13,7,10,49,38,11,46
Coleraine,9291,6,10,10,10,41,39,2,40
Portadown,9291,7,11,3,16,33,51,-18,36
Dungannon,9291,8,9,8,13,45,47,-2,35
Ards,9291,9,8,4,18,30,54,-24,28
Ballinamalla,9291,10,6,8,16,33,55,-22,26
Glentoran,9291,11,6,6,18,29,49,-20,24
Linfield,9292,1,14,11,5,61,33,28,53
Cliftonville,9292,2,15,6,9,52,40,12,51
Glenavon,9292,3,11,14,5,48,41,7,47
Crusaders,9292,4,13,7,10,57,41,16,46
Coleraine,9292,5,10,14,6,44,37,7,44
Ballymena,9292,6,11,7,12,51,59,-8,40
Dungannon,9292,7,9,10,11,49,48,1,37
Ballinamalla,9292,8,9,8,13,34,50,-16,35
Portadown,9292,9,8,9,13,34,46,-12,33
Ards,9292,10,7,8,15,36,50,-14,29
Glentoran,9292,11,6,10,14,25,46,-21,28
Crusaders,9293,1,17,7,6,53,32,21,58
Linfield,9293,2,13,12,5,53,28,25,51
Glenavon,9293,3,13,11,6,50,35,15,50
Cliftonville,9293,4,15,5,10,52,38,14,50
Coleraine,9293,5,11,9,10,42,37,5,42
Ballymena,9293,6,12,6,12,55,59,-4,42
Portadown,9293,7,10,6,14,27,44,-17,36
Ards,9293,8,10,5,15,34,45,-11,35
Dungannon,9293,9,8,9,13,43,49,-6,33
Glentoran,9293,10,7,9,14,21,41,-20,30
Ballinamalla,9293,11,8,3,19,28,50,-22,27
Linfield,9294,1,17,8,5,64,29,35,59
Crusaders,9294,2,17,7,6,59,35,24,58
Cliftonville,9294,3,16,5,9,48,36,12,53
Glenavon,9294,4,12,13,5,45,37,8,49
Coleraine,9294,5,12,10,8,42,36,6,46
Dungannon,9294,6,10,9,11,45,42,3,39
Ballymena,9294,7,11,6,13,53,62,-9,39
Ballinamalla,9294,8,8,7,15,32,49,-17,31
Glentoran,9294,9,7,10,13,26,48,-22,31
Ards,9294,10,8,4,18,42,56,-14,28
Portadown,9294,11,5,5,20,22,48,-26,20
Linfield,9295,1,17,9,4,62,31,31,60
Crusaders,9295,2,17,5,8,64,39,25,56
Ballymena,9295,3,17,5,8,74,58,16,56
Dungannon,9295,4,12,9,9,53,44,9,45
Cliftonville,9295,5,13,6,11,57,50,7,45
Glenavon,9295,6,10,11,9,47,41,6,41
Coleraine,9295,7,9,10,11,37,41,-4,37
Ards,9295,8,9,6,15,35,47,-12,33
Glentoran,9295,9,7,11,12,26,44,-18,32
Ballinamalla,9295,10,8,4,18,33,59,-26,28
Portadown,9295,11,5,6,19,25,59,-34,21
Crusaders,9296,1,17,8,5,61,32,29,59
Ballymena,9296,2,15,5,10,58,56,2,50
Linfield,9296,3,12,11,7,58,39,19,47
Cliftonville,9296,4,14,5,11,48,41,7,47
Coleraine,9296,5,11,12,7,52,42,10,45
Glenavon,9296,6,11,12,7,46,44,2,45
Dungannon,9296,7,9,10,11,45,44,1,37
Ards,9296,8,10,6,14,41,48,-7,36
Glentoran,9296,9,8,7,15,25,40,-15,31
Ballinamalla,9296,10,9,3,18,31,55,-24,30
Portadown,9296,11,6,7,17,28,52,-24,25
Linfield,9297,1,15,10,5,67,34,33,55
Crusaders,9297,2,16,5,9,49,38,11,53
Cliftonville,9297,3,15,5,10,51,36,15,50
Ballymena,9297,4,13,4,13,52,57,-5,43
Glenavon,9297,5,10,12,8,47,42,5,42
Dungannon,9297,6,11,8,11,58,47,11,41
Glentoran,9297,7,12,5,13,33,44,-11,41
Coleraine,9297,8,9,12,9,39,36,3,39
Ballinamalla,9297,9,9,5,16,32,54,-22,32
Ards,9297,10,9,4,17,32,52,-20,31
Portadown,9297,11,8,6,16,28,48,-20,30
Cliftonville,9298,1,18,4,8,61,35,26,58
Crusaders,9298,2,17,6,7,61,38,23,57
Linfield,9298,3,15,9,6,54,29,25,54
Coleraine,9298,4,13,9,8,48,35,13,48
Ballymena,9298,5,12,6,12,52,62,-10,42
Glenavon,9298,6,10,10,10,41,46,-5,40
Ards,9298,7,10,7,13,39,45,-6,37
Dungannon,9298,8,8,10,12,48,50,-2,34
Glentoran,9298,9,9,7,14,35,52,-17,34
Portadown,9298,10,8,4,18,24,47,-23,28
Ballinamalla,9298,11,6,6,18,32,56,-24,24
Cliftonville,9299,1,17,5,8,56,37,19,56
Linfield,9299,2,15,9,6,59,28,31,54
Crusaders,9299,3,15,7,8,56,32,24,52
Coleraine,9299,4,12,9,9,44,39,5,45
Glenavon,9299,5,11,11,8,43,46,-3,44
Ballymena,9299,6,11,8,11,53,58,-5,41
Portadown,9299,7,11,6,13,28,36,-8,39
Dungannon,9299,8,5,15,10,46,51,-5,30
Ballinamalla,9299,9,8,6,16,25,47,-22,30
Ards,9299,10,7,8,15,38,53,-15,29
Glentoran,9299,11,7,8,15,25,46,-21,29
Crusaders,9300,1,17,9,4,60,33,27,60
Linfield,9300,2,16,8,6,58,26,32,56
Coleraine,9300,3,16,8,6,55,36,19,56
Ballymena,9300,4,14,7,9,56,53,3,49
Glenavon,9300,5,12,9,9,48,39,9,45
Cliftonville,9300,6,14,3,13,45,42,3,45
Glentoran,9300,7,9,7,14,29,43,-14,34
Dungannon,9300,8,8,9,13,54,63,-9,33
Ballinamalla,9300,9,7,7,16,29,48,-19,28
Ards,9300,10,8,3,19,33,54,-21,27
Portadown,9300,11,4,10,16,24,54,-30,22
Crusaders,9301,1,20,9,1,68,28,40,69
Ballymena,9301,2,17,5,8,67,55,12,56
Linfield,9301,3,14,6,10,56,36,20,48
Glenavon,9301,4,12,11,7,49,40,9,47
Cliftonville,9301,5,14,5,11,48,40,8,47
Ards,9301,6,10,7,13,39,46,-7,37
Coleraine,9301,7,8,10,12,44,48,-4,34
Dungannon,9301,8,8,10,12,47,52,-5,34
Glentoran,9301,9,8,8,14,27,48,-21,32
Portadown,9301,10,7,6,17,23,48,-25,27
Ballinamalla,9301,11,6,5,19,26,53,-27,23
Crusaders,9302,1,17,8,5,56,37,19,59
Cliftonville,9302,2,15,6,9,50,35,15,51
Linfield,9302,3,13,11,6,63,39,24,50
Glenavon,9302,4,12,12,6,54,44,10,48
Ballymena,9302,5,14,4,12,58,61,-3,46
Glentoran,9302,6,13,5,12,41,46,-5,44
Coleraine,9302,7,10,10,10,40,47,-7,40
Dungannon,9302,8,10,8,12,52,48,4,38
Portadown,9302,9,7,7,16,26,47,-21,28
Ballinamalla,9302,10,8,4,18,34,56,-22,28
Ards,9302,11,6,5,19,39,53,-14,23
Crusaders,9303,1,20,6,4,66,33,33,66
Dungannon,9303,2,13,8,9,61,44,17,47
Ballymena,9303,3,13,7,10,59,62,-3,46
Linfield,9303,4,12,9,9,58,38,20,45
Coleraine,9303,5,12,8,10,46,43,3,44
Glenavon,9303,6,10,12,8,51,49,2,42
Cliftonville,9303,7,12,4,14,48,52,-4,40
Ballinamalla,9303,8,10,5,15,36,51,-15,35
Glentoran,9303,9,8,8,14,32,45,-13,32
Portadown,9303,10,8,6,16,29,50,-21,30
Ards,9303,11,7,7,16,41,60,-19,28
Ballymena,9304,1,17,7,6,60,50,10,58
Linfield,9304,2,13,10,7,54,33,21,49
Cliftonville,9304,3,15,4,11,53,41,12,49
Crusaders,9304,4,14,6,10,53,40,13,48
Glenavon,9304,5,11,13,6,52,48,4,46
Dungannon,9304,6,13,6,11,58,49,9,45
Coleraine,9304,7,9,12,9,47,46,1,39
Ballinamalla,9304,8,12,2,16,37,51,-14,38
Glentoran,9304,9,7,9,14,26,42,-16,30
Portadown,9304,10,8,5,17,25,44,-19,29
Ards,9304,11,7,4,19,30,51,-21,25
Cliftonville,9305,1,17,5,8,60,40,20,56
Crusaders,9305,2,16,6,8,57,36,21,54
Linfield,9305,3,12,10,8,54,37,17,46
Ballymena,9305,4,13,6,11,63,61,2,45
Coleraine,9305,5,10,13,7,42,43,-1,43
Dungannon,9305,6,11,9,10,55,43,12,42
Ards,9305,7,11,6,13,40,47,-7,39
Glenavon,9305,8,9,11,10,51,51,0,38
Glentoran,9305,9,9,10,11,34,44,-10,37
Portadown,9305,10,8,3,19,22,52,-30,27
Ballinamalla,9305,11,7,5,18,25,49,-24,26
Crusaders,9306,1,19,7,4,60,26,34,64
Linfield,9306,2,16,7,7,61,31,30,55
Ballymena,9306,3,13,7,10,52,58,-6,46
Dungannon,9306,4,11,11,8,54,42,12,44
Glenavon,9306,5,12,8,10,50,39,11,44
Cliftonville,9306,6,13,5,12,45,41,4,44
Coleraine,9306,7,11,10,9,42,40,2,43
Glentoran,9306,8,8,7,15,26,50,-24,31
Ballinamalla,9306,9,8,5,17,25,49,-24,29
Ards,9306,10,8,4,18,36,52,-16,28
Portadown,9306,11,7,7,16,24,47,-23,28
Linfield,9307,1,18,8,4,64,24,40,62
Crusaders,9307,2,17,9,4,54,31,23,60
Cliftonville,9307,3,13,9,8,50,34,16,48
Ballymena,9307,4,14,6,10,55,53,2,48
Coleraine,9307,5,11,11,8,41,37,4,44
Glenavon,9307,6,10,10,10,39,47,-8,40
Glentoran,9307,7,10,8,12,35,43,-8,38
Dungannon,9307,8,8,8,14,40,41,-1,32
Ards,9307,9,8,5,17,33,50,-17,29
Portadown,9307,10,7,5,18,28,52,-24,26
Ballinamalla,9307,11,7,5,18,27,54,-27,26
Cliftonville,9308,1,17,3,10,57,40,17,54
Crusaders,9308,2,14,7,9,55,45,10,49
Ballymena,9308,3,13,9,8,61,55,6,48
Coleraine,9308,4,11,13,6,42,33,9,46
Linfield,9308,5,11,12,7,50,33,17,45
Dungannon,9308,6,10,11,9,48,37,11,41
Glenavon,9308,7,10,11,9,42,46,-4,41
Ards,9308,8,9,6,15,35,47,-12,33
Glentoran,9308,9,8,8,14,28,45,-17,32
Portadown,9308,10,8,7,15,23,44,-21,31
Ballinamalla,9308,11,8,5,17,29,45,-16,29
Cliftonville,9309,1,17,5,8,52,35,17,56
Crusaders,9309,2,16,8,6,50,33,17,56
Dungannon,9309,3,13,8,9,58,41,17,47
Ballymena,9309,4,13,7,10,57,62,-5,46
Linfield,9309,5,11,12,7,54,32,22,45
Coleraine,9309,6,10,11,9,41,35,6,41
Ards,9309,7,10,5,15,41,56,-15,35
Glenavon,9309,8,8,10,12,42,49,-7,34
Ballinamalla,9309,9,10,4,16,35,48,-13,34
Glentoran,9309,10,8,9,13,28,43,-15,33
Portadown,9309,11,7,5,18,27,51,-24,26
Cliftonville,9310,1,19,4,7,51,29,22,61
Linfield,9310,2,17,8,5,67,28,39,59
Crusaders,9310,3,16,8,6,50,29,21,56
Coleraine,9310,4,12,11,7,43,35,8,47
Ballymena,9310,5,13,6,11,52,59,-7,45
Glentoran,9310,6,11,8,11,32,40,-8,41
Dungannon,9310,7,10,9,11,47,43,4,39
Glenavon,9310,8,7,11,12,41,48,-7,32
Ballinamalla,9310,9,7,6,17,26,50,-24,27
Ards,9310,10,6,7,17,28,45,-17,25
Portadown,9310,11,6,4,20,22,53,-31,22
Crusaders,9311,1,18,9,3,56,26,30,63
Cliftonville,9311,2,17,5,8,59,38,21,56
Linfield,9311,3,14,8,8,54,28,26,50
Ballymena,9311,4,14,6,10,56,59,-3,48
Ballinamalla,9311,5,11,6,13,30,41,-11,39
Glenavon,9311,6,9,11,10,47,50,-3,38
Coleraine,9311,7,9,10,11,40,50,-10,37
Ards,9311,8,9,8,13,35,39,-4,35
Glentoran,9311,9,8,9,13,30,44,-14,33
Portadown,9311,10,8,4,18,28,46,-18,28
Dungannon,9311,11,5,10,15,37,51,-14,25
Crusaders,9312,1,17,7,6,59,34,25,58
Cliftonville,9312,2,16,6,8,54,34,20,54
Linfield,9312,3,14,11,5,60,34,26,53
Coleraine,9312,4,11,11,8,40,39,1,44
Ballymena,9312,5,12,6,12,58,62,-4,42
Glenavon,9312,6,10,11,9,45,51,-6,41
Ards,9312,7,12,4,14,42,47,-5,40
Dungannon,9312,8,9,10,11,44,37,7,37
Ballinamalla,9312,9,10,3,17,32,45,-13,33
Glentoran,9312,10,6,8,16,32,55,-23,26
Portadown,9312,11,5,9,16,19,47,-28,24
Glenavon,9313,1,16,8,6,55,39,16,56
Crusaders,9313,2,15,9,6,57,38,19,54
Ballymena,9313,3,15,7,8,58,51,7,52
Coleraine,9313,4,13,8,9,46,37,9,47
Linfield,9313,5,11,11,8,56,36,20,44
Cliftonville,9313,6,13,5,12,43,40,3,44
Dungannon,9313,7,11,8,11,60,45,15,41
Ards,9313,8,11,7,12,40,43,-3,40
Portadown,9313,9,6,8,16,24,46,-22,26
Ballinamalla,9313,10,7,5,18,30,61,-31,26
Glentoran,9313,11,5,8,17,20,53,-33,23
Ballymena,9314,1,17,4,9,61,54,7,55
Crusaders,9314,2,16,6,8,68,42,26,54
Linfield,9314,3,15,8,7,65,35,30,53
Cliftonville,9314,4,15,4,11,61,48,13,49
Glenavon,9314,5,12,12,6,46,42,4,48
Dungannon,9314,6,10,9,11,57,52,5,39
Coleraine,9314,7,9,12,9,40,42,-2,39
Ards,9314,8,10,7,13,42,46,-4,37
Glentoran,9314,9,9,10,11,39,54,-15,37
Ballinamalla,9314,10,7,3,20,29,62,-33,24
Portadown,9314,11,5,5,20,27,58,-31,20
Crusaders,9315,1,17,8,5,57,30,27,59
Cliftonville,9315,2,16,3,11,51,37,14,51
Coleraine,9315,3,13,9,8,45,33,12,48
Dungannon,9315,4,13,8,9,64,49,15,47
Ballymena,9315,5,12,9,9,52,52,0,45
Glenavon,9315,6,11,8,11,49,54,-5,41
Glentoran,9315,7,10,8,12,31,48,-17,38
Linfield,9315,8,8,13,9,48,40,8,37
Ards,9315,9,10,6,14,39,46,-7,36
Portadown,9315,10,8,5,17,27,48,-21,29
Ballinamalla,9315,11,7,3,20,28,54,-26,24
Crusaders,9316,1,18,6,6,54,24,30,60
Ballymena,9316,2,17,5,8,55,50,5,56
Coleraine,9316,3,13,10,7,40,31,9,49
Cliftonville,9316,4,14,3,13,52,44,8,45
Linfield,9316,5,11,9,10,51,42,9,42
Glenavon,9316,6,10,11,9,47,47,0,41
Dungannon,9316,7,10,10,10,45,39,6,40
Ballinamalla,9316,8,11,2,17,33,47,-14,35
Glentoran,9316,9,9,5,16,26,42,-16,32
Portadown,9316,10,9,4,17,20,41,-21,31
Ards,9316,11,8,5,17,37,53,-16,29
Crusaders,9317,1,17,7,6,61,30,31,58
Linfield,9317,2,16,7,7,61,32,29,55
Dungannon,9317,3,14,7,9,57,40,17,49
Coleraine,9317,4,11,13,6,47,38,9,46
Glenavon,9317,5,12,10,8,55,51,4,46
Ballymena,9317,6,13,7,10,56,63,-7,46
Cliftonville,9317,7,12,6,12,49,50,-1,42
Ards,9317,8,9,4,17,38,52,-14,31
Ballinamalla,9317,9,8,6,16,37,54,-17,30
Portadown,9317,10,7,7,16,28,49,-21,28
Glentoran,9317,11,6,6,18,25,55,-30,24
Crusaders,9318,1,17,10,3,56,27,29,61
Ballymena,9318,2,15,8,7,56,52,4,53
Cliftonville,9318,3,13,9,8,52,40,12,48
Linfield,9318,4,12,11,7,57,37,20,47
Coleraine,9318,5,12,11,7,46,36,10,47
Glenavon,9318,6,11,12,7,44,43,1,45
Dungannon,9318,7,11,9,10,47,43,4,42
Ards,9318,8,9,7,14,36,43,-7,34
Glentoran,9318,9,7,6,17,26,49,-23,27
Ballinamalla,9318,10,5,7,18,25,50,-25,22
Portadown,9318,11,5,6,19,30,55,-25,21
Crusaders,9319,1,16,9,5,55,35,20,57
Cliftonville,9319,2,16,5,9,49,36,13,53
Linfield,9319,3,13,12,5,60,36,24,51
Glenavon,9319,4,12,11,7,49,43,6,47
Ballymena,9319,5,13,6,11,52,56,-4,45
Coleraine,9319,6,12,8,10,46,39,7,44
Dungannon,9319,7,9,9,12,55,49,6,36
Glentoran,9319,8,8,8,14,32,45,-13,32
Ballinamalla,9319,9,8,6,16,34,54,-20,30
Portadown,9319,10,9,3,18,33,53,-20,30
Ards,9319,11,6,9,15,35,54,-19,27
Linfield,9320,1,14,14,2,56,23,33,56
Cliftonville,9320,2,15,6,9,50,35,15,51
Crusaders,9320,3,13,10,7,49,34,15,49
Ballymena,9320,4,13,7,10,58,60,-2,46
Glenavon,9320,5,11,11,8,45,46,-1,44
Coleraine,9320,6,10,13,7,43,37,6,43
Dungannon,9320,7,11,9,10,53,49,4,42
Glentoran,9320,8,8,9,13,27,41,-14,33
Ards,9320,9,8,6,16,38,52,-14,30
Ballinamalla,9320,10,7,6,17,29,49,-20,27
Portadown,9320,11,6,7,17,25,47,-22,25
Cliftonville,9321,1,17,4,9,51,33,18,55
Crusaders,9321,2,13,12,5,52,36,16,51
Linfield,9321,3,12,10,8,53,30,23,46
Ballymena,9321,4,13,7,10,58,62,-4,46
Coleraine,9321,5,9,15,6,48,44,4,42
Dungannon,9321,6,10,10,10,46,42,4,40
Glenavon,9321,7,9,12,9,46,48,-2,39
Glentoran,9321,8,8,11,11,27,38,-11,35
Portadown,9321,9,7,10,13,28,44,-16,31
Ards,9321,10,7,8,15,34,47,-13,29
Ballinamalla,9321,11,7,7,16,38,57,-19,28
Crusaders,9322,1,17,8,5,55,33,22,59
Cliftonville,9322,2,16,6,8,55,38,17,54
Ballymena,9322,3,16,4,10,55,53,2,52
Linfield,9322,4,14,8,8,51,33,18,50
Coleraine,9322,5,14,8,8,50,35,15,50
Dungannon,9322,6,13,9,8,64,39,25,48
Glentoran,9322,7,9,8,13,36,46,-10,35
Glenavon,9322,8,8,10,12,44,52,-8,34
Ards,9322,9,10,4,16,38,56,-18,34
Portadown,9322,10,7,2,21,21,51,-30,23
Ballinamalla,9322,11,5,5,20,28,61,-33,20
Linfield,9323,1,15,11,4,65,31,34,56
Crusaders,9323,2,15,6,9,49,39,10,51
Coleraine,9323,3,11,14,5,49,38,11,47
Cliftonville,9323,4,13,6,11,49,42,7,45
Ballymena,9323,5,12,7,11,51,60,-9,43
Glenavon,9323,6,9,13,8,49,50,-1,40
Dungannon,9323,7,9,12,9,48,41,7,39
Ards,9323,8,10,6,14,37,48,-11,36
Glentoran,9323,9,8,9,13,33,43,-10,33
Ballinamalla,9323,10,9,4,17,29,46,-17,31
Portadown,9323,11,7,6,17,26,47,-21,27
Cliftonville,9324,1,16,5,9,52,36,16,53
Ballymena,9324,2,15,6,9,57,53,4,51
Linfield,9324,3,14,8,8,57,34,23,50
Crusaders,9324,4,15,5,10,52,39,13,50
Glentoran,9324,5,13,8,9,38,37,1,47
Glenavon,9324,6,11,9,10,45,49,-4,42
Coleraine,9324,7,11,8,11,39,40,-1,41
Dungannon,9324,8,10,8,12,43,42,1,38
Ards,9324,9,11,4,15,34,42,-8,37
Portadown,9324,10,7,6,17,22,44,-22,27
Ballinamalla,9324,11,7,3,20,30,53,-23,24
Linfield,9325,1,15,9,6,57,28,29,54
Cliftonville,9325,2,15,9,6,58,36,22,54
Crusaders,9325,3,14,11,5,46,28,18,53
Ballymena,9325,4,15,7,8,58,56,2,52
Dungannon,9325,5,11,9,10,54,45,9,42
Coleraine,9325,6,11,8,11,44,46,-2,41
Ards,9325,7,9,8,13,40,48,-8,35
Glenavon,9325,8,9,8,13,44,54,-10,35
Ballinamalla,9325,9,9,5,16,28,45,-17,32
Glentoran,9325,10,6,9,15,24,48,-24,27
Portadown,9325,11,6,7,17,23,42,-19,25
Crusaders,9326,1,17,6,7,60,39,21,57
Cliftonville,9326,2,17,4,9,53,40,13,55
Ballymena,9326,3,15,7,8,57,54,3,52
Linfield,9326,4,12,12,6,58,31,27,48
Glenavon,9326,5,12,10,8,51,48,3,46
Coleraine,9326,6,11,11,8,44,39,5,44
Dungannon,9326,7,11,9,10,57,44,13,42
Portadown,9326,8,8,9,13,30,40,-10,33
Glentoran,9326,9,7,8,15,33,51,-18,29
Ballinamalla,9326,10,9,2,19,34,58,-24,29
Ards,9326,11,5,4,21,28,61,-33,19
Linfield,9327,1,16,9,5,62,31,31,57
Ballymena,9327,2,14,8,8,65,58,7,50
Crusaders,9327,3,14,7,9,50,37,13,49
Coleraine,9327,4,12,11,7,51,42,9,47
Glenavon,9327,5,12,11,7,49,43,6,47
Cliftonville,9327,6,14,4,12,48,45,3,46
Dungannon,9327,7,11,10,9,53,47,6,43
Ards,9327,8,9,7,14,42,51,-9,34
Portadown,9327,9,9,7,14,30,42,-12,34
Glentoran,9327,10,6,6,18,23,49,-26,24
Ballinamalla,9327,11,6,4,20,27,55,-28,22
Cliftonville,9328,1,18,3,9,60,39,21,57
Crusaders,9328,2,16,8,6,55,33,22,56
Ballymena,9328,3,14,7,9,63,50,13,49
Linfield,9328,4,12,12,6,56,35,21,48
Glenavon,9328,5,12,12,6,52,44,8,48
Dungannon,9328,6,12,9,9,50,42,8,45
Coleraine,9328,7,10,11,9,41,45,-4,41
Ards,9328,8,8,7,15,38,47,-9,31
Glentoran,9328,9,7,8,15,27,47,-20,29
Portadown,9328,10,7,4,19,23,51,-28,25
Ballinamalla,9328,11,6,5,19,27,59,-32,23
Cliftonville,9329,1,18,6,6,61,31,30,60
Crusaders,9329,2,14,11,5,53,34,19,53
Linfield,9329,3,14,9,7,61,33,28,51
Ballymena,9329,4,15,3,12,61,59,2,48
Coleraine,9329,5,13,7,10,47,39,8,46
Glentoran,9329,6,13,5,12,34,35,-1,44
Glenavon,9329,7,10,12,8,44,44,0,42
Dungannon,9329,8,11,8,11,57,53,4,41
Ards,9329,9,8,7,15,37,53,-16,31
Ballinamalla,9329,10,7,3,20,25,64,-39,24
Portadown,9329,11,5,3,22,22,57,-35,18
Crusaders,9330,1,18,7,5,58,30,28,61
Linfield,9330,2,15,8,7,61,32,29,53
Ballymena,9330,3,13,9,8,56,54,2,48
Glenavon,9330,4,12,9,9,45,47,-2,45
Dungannon,9330,5,12,7,11,56,46,10,43
Cliftonville,9330,6,12,5,13,51,44,7,41
Glentoran,9330,7,11,8,11,32,38,-6,41
Coleraine,9330,8,8,13,9,40,42,-2,37
Portadown,9330,9,10,4,16,28,43,-15,34
Ards,9330,10,8,6,16,38,51,-13,30
Ballinamalla,9330,11,7,2,21,30,68,-38,23
Crusaders,9331,1,17,7,6,56,31,25,58
Ballymena,9331,2,17,7,6,66,49,17,58
Linfield,9331,3,16,9,5,65,32,33,57
Cliftonville,9331,4,16,3,11,56,40,16,51
Coleraine,9331,5,14,9,7,44,35,9,51
Dungannon,9331,6,11,8,11,55,49,6,41
Glenavon,9331,7,11,7,12,39,42,-3,40
Ards,9331,8,8,5,17,37,56,-19,29
Portadown,9331,9,8,5,17,27,48,-21,29
Ballinamalla,9331,10,7,3,20,24,54,-30,24
Glentoran,9331,11,5,7,18,25,58,-33,22
Cliftonville,9332,1,17,6,7,56,33,23,57
Linfield,9332,2,14,9,7,55,29,26,51
Coleraine,9332,3,13,12,5,41,29,12,51
Crusaders,9332,4,14,7,9,55,36,19,49
Glenavon,9332,5,13,10,7,52,42,10,49
Ballymena,9332,6,11,7,12,54,66,-12,40
Glentoran,9332,7,10,8,12,32,45,-13,38
Ards,9332,8,9,6,15,32,43,-11,33
Portadown,9332,9,9,6,15,26,43,-17,33
Dungannon,9332,10,8,8,14,46,53,-7,32
Ballinamalla,9332,11,4,7,19,31,61,-30,19
Linfield,9333,1,16,8,6,59,29,30,56
Cliftonville,9333,2,17,3,10,49,41,8,54
Crusaders,9333,3,14,10,6,50,29,21,52
Coleraine,9333,4,13,10,7,46,37,9,49
Ballymena,9333,5,14,4,12,52,62,-10,46
Glenavon,9333,6,10,12,8,47,45,2,42
Ards,9333,7,11,4,15,40,46,-6,37
Dungannon,9333,8,9,7,14,51,51,0,34
Ballinamalla,9333,9,9,5,16,33,44,-11,32
Glentoran,9333,10,8,7,15,32,48,-16,31
Portadown,9333,11,6,6,18,20,47,-27,24
Crusaders,9334,1,17,10,3,58,34,24,61
Cliftonville,9334,2,15,7,8,56,38,18,52
Ballymena,9334,3,15,6,9,59,55,4,51
Linfield,9334,4,12,12,6,55,33,22,48
Dungannon,9334,5,11,9,10,54,37,17,42
Coleraine,9334,6,11,9,10,41,40,1,42
Glenavon,9334,7,10,11,9,43,43,0,41
Ballinamalla,9334,8,10,6,14,36,45,-9,36
Ards,9334,9,8,5,17,32,55,-23,29
Portadown,9334,10,7,5,18,20,46,-26,26
Glentoran,9334,11,6,6,18,24,52,-28,24
Linfield,9335,1,15,9,6,58,32,26,54
Crusaders,9335,2,15,9,6,47,29,18,54
Cliftonville,9335,3,14,8,8,49,36,13,50
Ballymena,9335,4,15,5,10,57,53,4,50
Coleraine,9335,5,13,8,9,43,41,2,47
Glenavon,9335,6,12,9,9,46,46,0,45
Dungannon,9335,7,9,11,10,53,48,5,38
Glentoran,9335,8,10,8,12,33,37,-4,38
Ards,9335,9,9,3,18,38,52,-14,30
Portadown,9335,10,7,6,17,28,48,-20,27
Ballinamalla,9335,11,6,4,20,29,59,-30,22
Crusaders,9336,1,18,6,6,60,31,29,60
Linfield,9336,2,14,8,8,58,32,26,50
Dungannon,9336,3,13,9,8,56,44,12,48
Cliftonville,9336,4,14,5,11,51,44,7,47
Coleraine,9336,5,12,10,8,43,37,6,46
Glenavon,9336,6,12,9,9,46,49,-3,45
Ballymena,9336,7,12,6,12,56,61,-5,42
Ards,9336,8,11,4,15,44,50,-6,37
Glentoran,9336,9,9,8,13,36,50,-14,35
Portadown,9336,10,6,7,17,24,46,-22,25
Ballinamalla,9336,11,6,4,20,23,53,-30,22
Cliftonville,9337,1,16,5,9,51,36,15,53
Coleraine,9337,2,14,10,6,52,40,12,52
Glenavon,9337,3,13,10,7,56,43,13,49
Crusaders,9337,4,14,7,9,54,42,12,49
Linfield,9337,5,12,12,6,50,32,18,48
Glentoran,9337,6,11,7,12,39,45,-6,40
Ballymena,9337,7,12,4,14,55,64,-9,40
Ards,9337,8,9,6,15,35,48,-13,33
Dungannon,9337,9,8,8,14,45,49,-4,32
Ballinamalla,9337,10,8,6,16,31,53,-22,30
Portadown,9337,11,7,7,16,26,42,-16,28
Linfield,9338,1,16,9,5,65,31,34,57
Crusaders,9338,2,16,7,7,59,43,16,55
Coleraine,9338,3,13,11,6,43,37,6,50
Glenavon,9338,4,12,10,8,47,43,4,46
Ballymena,9338,5,11,9,10,45,52,-7,42
Cliftonville,9338,6,12,5,13,49,46,3,41
Glentoran,9338,7,10,9,11,30,41,-11,39
Dungannon,9338,8,8,10,12,50,50,0,34
Ards,9338,9,8,6,16,32,46,-14,30
Ballinamalla,9338,10,7,7,16,27,44,-17,28
Portadown,9338,11,6,9,15,24,38,-14,27
Crusaders,9339,1,17,5,8,62,38,24,56
Linfield,9339,2,14,9,7,60,38,22,51
Ballymena,9339,3,13,10,7,58,58,0,49
Cliftonville,9339,4,15,3,12,49,49,0,48
Dungannon,9339,5,11,10,9,49,40,9,43
Coleraine,9339,6,11,10,9,44,43,1,43
Ards,9339,7,10,7,13,40,40,0,37
Glenavon,9339,8,8,11,11,52,55,-3,35
Glentoran,9339,9,9,7,14,31,47,-16,34
Portadown,9339,10,9,5,16,35,49,-14,32
Ballinamalla,9339,11,8,3,19,28,51,-23,27
Linfield,9340,1,17,11,2,67,26,41,62
Glenavon,9340,2,14,11,5,50,34,16,53
Crusaders,9340,3,14,9,7,52,37,15,51
Cliftonville,9340,4,15,5,10,50,38,12,50
Ballymena,9340,5,12,5,13,53,66,-13,41
Dungannon,9340,6,9,10,11,50,44,6,37
Coleraine,9340,7,9,8,13,39,46,-7,35
Ballinamalla,9340,8,10,3,17,35,56,-21,33
Ards,9340,9,8,7,15,39,49,-10,31
Glentoran,9340,10,8,7,15,26,44,-18,31
Portadown,9340,11,7,8,15,18,39,-21,29
Crusaders,9341,1,21,6,3,69,33,36,69
Linfield,9341,2,15,7,8,59,35,24,52
Cliftonville,9341,3,15,6,9,53,40,13,51
Dungannon,9341,4,13,9,8,60,47,13,48
Coleraine,9341,5,11,11,8,39,35,4,44
Ballymena,9341,6,12,7,11,56,61,-5,43
Glenavon,9341,7,10,12,8,44,45,-1,42
Portadown,9341,8,7,6,17,25,42,-17,27
Ballinamalla,9341,9,7,6,17,29,48,-19,27
Glentoran,9341,10,6,9,15,28,50,-22,27
Ards,9341,11,7,3,20,32,58,-26,24
Crusaders,9342,1,16,7,7,52,41,11,55
Cliftonville,9342,2,16,4,10,48,32,16,52
Coleraine,9342,3,14,10,6,48,33,15,52
Linfield,9342,4,14,8,8,57,36,21,50
Ballymena,9342,5,12,7,11,54,54,0,43
Glenavon,9342,6,10,10,10,45,51,-6,40
Dungannon,9342,7,9,10,11,47,43,4,37
Ards,9342,8,11,3,16,49,50,-1,36
Portadown,9342,9,10,3,17,28,48,-20,33
Glentoran,9342,10,8,7,15,30,47,-17,31
Ballinamalla,9342,11,8,5,17,30,53,-23,29
Crusaders,9343,1,16,8,6,50,29,21,56
Linfield,9343,2,16,7,7,66,34,32,55
Glenavon,9343,3,13,11,6,50,44,6,50
Ballymena,9343,4,14,7,9,58,58,0,49
Cliftonville,9343,5,13,4,13,56,52,4,43
Dungannon,9343,6,10,9,11,49,40,9,39
Ards,9343,7,11,5,14,44,53,-9,38
Coleraine,9343,8,8,11,11,35,43,-8,35
Portadown,9343,9,10,4,16,24,38,-14,34
Glentoran,9343,10,8,8,14,39,49,-10,32
Ballinamalla,9343,11,7,4,19,28,59,-31,25
Crusaders,9344,1,18,7,5,57,31,26,61
Linfield,9344,2,16,9,5,59,30,29,57
Glenavon,9344,3,15,8,7,55,36,19,53
Cliftonville,9344,4,13,7,10,48,39,9,46
Ballymena,9344,5,13,7,10,51,60,-9,46
Coleraine,9344,6,12,9,9,48,36,12,45
Dungannon,9344,7,10,9,11,44,40,4,39
Glentoran,9344,8,9,7,14,31,43,-12,34
Ards,9344,9,9,6,15,37,48,-11,33
Ballinamalla,9344,10,7,3,20,34,63,-29,24
Portadown,9344,11,4,6,20,18,56,-38,18
Crusaders,9345,1,19,6,5,56,28,28,63
Coleraine,9345,2,15,7,8,51,38,13,52
Linfield,9345,3,13,10,7,57,32,25,49
Dungannon,9345,4,11,10,9,52,47,5,43
Glenavon,9345,5,11,9,10,43,45,-2,42
Cliftonville,9345,6,12,3,15,45,47,-2,39
Ballymena,9345,7,10,9,11,48,55,-7,39
Portadown,9345,8,10,6,14,32,38,-6,36
Glentoran,9345,9,9,8,13,29,45,-16,35
Ards,9345,10,10,3,17,38,51,-13,33
Ballinamalla,9345,11,7,5,18,23,48,-25,26
Linfield,9346,1,18,8,4,65,27,38,62
Cliftonville,9346,2,19,5,6,66,37,29,62
Crusaders,9346,3,14,10,6,51,34,17,52
Ballymena,9346,4,14,7,9,59,54,5,49
Glenavon,9346,5,8,14,8,41,45,-4,38
Dungannon,9346,6,9,10,11,55,50,5,37
Coleraine,9346,7,8,12,10,37,40,-3,36
Glentoran,9346,8,8,8,14,26,46,-20,32
Portadown,9346,9,8,5,17,28,48,-20,29
Ballinamalla,9346,10,7,6,17,28,53,-25,27
Ards,9346,11,7,5,18,33,55,-22,26
Crusaders,9347,1,19,7,4,71,42,29,64
Ballymena,9347,2,14,7,9,64,56,8,49
Cliftonville,9347,3,14,6,10,47,39,8,48
Linfield,9347,4,12,10,8,51,33,18,46
Coleraine,9347,5,12,8,10,43,43,0,44
Glenavon,9347,6,10,11,9,48,47,1,41
Dungannon,9347,7,11,7,12,51,44,7,40
Glentoran,9347,8,10,6,14,33,41,-8,36
Ballinamalla,9347,9,9,5,16,30,52,-22,32
Portadown,9347,10,7,8,15,24,46,-22,29
Ards,9347,11,7,5,18,34,53,-19,26
Crusaders,9348,1,18,7,5,57,30,27,61
Linfield,9348,2,16,10,4,59,26,33,58
Coleraine,9348,3,12,10,8,40,38,2,46
Glenavon,9348,4,12,9,9,45,46,-1,45
Cliftonville,9348,5,12,8,10,57,50,7,44
Dungannon,9348,6,11,8,11,55,46,9,41
Ballymena,9348,7,11,7,12,53,62,-9,40
Ards,9348,8,10,5,15,41,48,-7,35
Portadown,9348,9,9,5,16,27,45,-18,32
Glentoran,9348,10,7,8,15,31,48,-17,29
Ballinamalla,9348,11,7,3,20,29,55,-26,24
Linfield,9349,1,15,11,4,60,28,32,56
Ballymena,9349,2,16,5,9,65,55,10,53
Cliftonville,9349,3,15,7,8,52,35,17,52
Crusaders,9349,4,14,6,10,45,36,9,48
Coleraine,9349,5,10,13,7,40,39,1,43
Glenavon,9349,6,10,13,7,41,41,0,43
Dungannon,9349,7,10,11,9,40,36,4,41
Glentoran,9349,8,9,8,13,33,42,-9,35
Ards,9349,9,7,8,15,35,51,-16,29
Ballinamalla,9349,10,8,4,18,29,50,-21,28
Portadown,9349,11,6,4,20,22,49,-27,22
Crusaders,9350,1,15,9,6,53,36,17,54
Cliftonville,9350,2,16,6,8,51,36,15,54
Coleraine,9350,3,14,10,6,50,31,19,52
Ballymena,9350,4,13,6,11,54,60,-6,45
Linfield,9350,5,11,11,8,53,34,19,44
Glenavon,9350,6,11,9,10,41,38,3,42
Glentoran,9350,7,10,8,12,33,45,-12,38
Ballinamalla,9350,8,10,3,17,33,50,-17,33
Dungannon,9350,9,7,11,12,43,48,-5,32
Portadown,9350,10,7,9,14,29,45,-16,30
Ards,9350,11,7,6,17,34,51,-17,27
Crusaders,9351,1,19,5,6,59,34,25,62
Cliftonville,9351,2,16,7,7,51,34,17,55
Dungannon,9351,3,15,6,9,58,37,21,51
Ballymena,9351,4,15,6,9,63,55,8,51
Linfield,9351,5,11,9,10,50,35,15,42
Coleraine,9351,6,10,12,8,39,40,-1,42
Glenavon,9351,7,10,11,9,39,46,-7,41
Glentoran,9351,8,9,7,14,29,43,-14,34
Ards,9351,9,9,5,16,32,45,-13,32
Ballinamalla,9351,10,7,5,18,28,48,-20,26
Portadown,9351,11,6,3,21,22,53,-31,21
Crusaders,9352,1,15,8,7,58,37,21,53
Linfield,9352,2,13,11,6,56,34,22,50
Glenavon,9352,3,12,11,7,52,41,11,47
Ballymena,9352,4,13,8,9,59,57,2,47
Cliftonville,9352,5,13,5,12,54,52,2,44
Dungannon,9352,6,9,12,9,48,46,2,39
Coleraine,9352,7,9,11,10,38,45,-7,38
Ards,9352,8,9,8,13,44,46,-2,35
Ballinamalla,9352,9,9,7,14,36,49,-13,34
Portadown,9352,10,7,9,14,29,46,-17,30
Glentoran,9352,11,8,6,16,22,43,-21,30
Crusaders,9353,1,16,7,7,57,36,21,55
Cliftonville,9353,2,16,6,8,61,45,16,54
Glenavon,9353,3,13,9,8,48,42,6,48
Linfield,9353,4,13,7,10,53,34,19,46
Coleraine,9353,5,11,12,7,50,38,12,45
Ballymena,9353,6,12,9,9,50,53,-3,45
Ballinamalla,9353,7,12,5,13,37,44,-7,41
Glentoran,9353,8,9,7,14,27,46,-19,34
Dungannon,9353,9,7,11,12,50,51,-1,32
Portadown,9353,10,9,4,17,36,54,-18,31
Ards,9353,11,5,7,18,30,56,-26,22
Cliftonville,9354,1,15,8,7,55,42,13,53
Coleraine,9354,2,14,10,6,51,35,16,52
Crusaders,9354,3,14,8,8,50,42,8,50
Ballymena,9354,4,14,7,9,59,59,0,49
Linfield,9354,5,12,8,10,51,38,13,44
Dungannon,9354,6,11,9,10,51,42,9,42
Glenavon,9354,7,10,7,13,44,49,-5,37
Ards,9354,8,10,5,15,37,46,-9,35
Glentoran,9354,9,9,7,14,33,43,-10,34
Portadown,9354,10,8,7,15,31,44,-13,31
Ballinamalla,9354,11,7,6,17,24,46,-22,27
Crusaders,9355,1,15,9,6,46,29,17,54
Ballymena,9355,2,15,9,6,65,58,7,54
Glenavon,9355,3,14,9,7,46,39,7,51
Dungannon,9355,4,14,7,9,55,40,15,49
Cliftonville,9355,5,14,4,12,52,41,11,46
Linfield,9355,6,12,8,10,50,38,12,44
Coleraine,9355,7,10,12,8,43,39,4,42
Glentoran,9355,8,9,8,13,29,41,-12,35
Portadown,9355,9,9,7,14,34,40,-6,34
Ballinamalla,9355,10,5,8,17,27,56,-29,23
Ards,9355,11,5,5,20,33,59,-26,20
Linfield,9356,1,15,7,8,60,32,28,52
Crusaders,9356,2,14,9,7,51,35,16,51
Cliftonville,9356,3,15,5,10,50,36,14,50
Ballymena,9356,4,12,9,9,55,64,-9,45
Glenavon,9356,5,10,14,6,47,42,5,44
Dungannon,9356,6,10,11,9,50,45,5,41
Coleraine,9356,7,8,13,9,38,34,4,37
Glentoran,9356,8,10,5,15,25,41,-16,35
Ballinamalla,9356,9,9,7,14,27,42,-15,34
Ards,9356,10,8,7,15,35,49,-14,31
Portadown,9356,11,8,5,17,28,46,-18,29
Crusaders,9357,1,20,6,4,63,29,34,66
Linfield,9357,2,18,9,3,68,29,39,63
Ballymena,9357,3,15,7,8,58,52,6,52
Glenavon,9357,4,13,9,8,54,44,10,48
Cliftonville,9357,5,14,2,14,54,55,-1,44
Dungannon,9357,6,11,9,10,53,43,10,42
Coleraine,9357,7,9,8,13,37,43,-6,35
Portadown,9357,8,10,4,16,36,50,-14,34
Ards,9357,9,7,6,17,33,53,-20,27
Glentoran,9357,10,7,6,17,21,48,-27,27
Ballinamalla,9357,11,6,4,20,26,57,-31,22
Crusaders,9358,1,19,7,4,55,27,28,64
Linfield,9358,2,15,8,7,56,37,19,53
Cliftonville,9358,3,15,4,11,52,38,14,49
Dungannon,9358,4,13,7,10,48,33,15,46
Ballymena,9358,5,13,7,10,51,53,-2,46
Coleraine,9358,6,9,13,8,43,35,8,40
Glenavon,9358,7,10,9,11,43,44,-1,39
Ards,9358,8,10,6,14,39,50,-11,36
Portadown,9358,9,8,5,17,23,45,-22,29
Ballinamalla,9358,10,7,6,17,24,48,-24,27
Glentoran,9358,11,7,6,17,21,45,-24,27
Cliftonville,9359,1,19,4,7,57,32,25,61
Linfield,9359,2,16,8,6,59,32,27,56
Crusaders,9359,3,15,10,5,53,30,23,55
Ballymena,9359,4,13,8,9,55,51,4,47
Dungannon,9359,5,12,10,8,52,38,14,46
Glenavon,9359,6,11,9,10,47,50,-3,42
Glentoran,9359,7,7,12,11,26,39,-13,33
Coleraine,9359,8,7,11,12,34,43,-9,32
Ards,9359,9,8,7,15,33,49,-16,31
Ballinamalla,9359,10,6,6,18,24,45,-21,24
Portadown,9359,11,7,3,20,26,57,-31,24
Coleraine,9360,1,16,10,4,52,30,22,58
Crusaders,9360,2,16,8,6,55,33,22,56
Linfield,9360,3,15,8,7,63,35,28,53
Ballymena,9360,4,15,4,11,57,60,-3,49
Cliftonville,9360,5,14,5,11,54,44,10,47
Glenavon,9360,6,8,12,10,39,46,-7,36
Dungannon,9360,7,8,10,12,50,46,4,34
Portadown,9360,8,9,6,15,29,42,-13,33
Glentoran,9360,9,9,6,15,30,46,-16,33
Ards,9360,10,8,6,16,32,52,-20,30
Ballinamalla,9360,11,7,5,18,26,53,-27,26
Ballymena,9361,1,17,6,7,58,53,5,57
Linfield,9361,2,15,9,6,63,30,33,54
Crusaders,9361,3,15,7,8,52,37,15,52
Cliftonville,9361,4,15,6,9,52,35,17,51
Glenavon,9361,5,14,9,7,56,45,11,51
Dungannon,9361,6,12,6,12,49,43,6,42
Coleraine,9361,7,10,11,9,36,40,-4,41
Glentoran,9361,8,8,6,16,26,43,-17,30
Ards,9361,9,8,5,17,41,56,-15,29
Ballinamalla,9361,10,8,3,19,25,52,-27,27
Portadown,9361,11,6,6,18,23,47,-24,24
Crusaders,9362,1,18,8,4,64,32,32,62
Linfield,9362,2,15,9,6,66,39,27,54
Cliftonville,9362,3,16,4,10,48,33,15,52
Glenavon,9362,4,12,11,7,48,47,1,47
Coleraine,9362,5,12,10,8,48,40,8,46
Ballymena,9362,6,12,6,12,60,63,-3,42
Dungannon,9362,7,11,8,11,56,46,10,41
Ards,9362,8,11,3,16,46,54,-8,36
Glentoran,9362,9,9,6,15,33,53,-20,33
Portadown,9362,10,6,5,19,25,50,-25,23
Ballinamalla,9362,11,5,6,19,27,64,-37,21
Linfield,9363,1,16,9,5,60,29,31,57
Crusaders,9363,2,14,8,8,51,35,16,50
Glenavon,9363,3,13,11,6,52,44,8,50
Ballymena,9363,4,14,7,9,56,51,5,49
Dungannon,9363,5,12,9,9,57,44,13,45
Cliftonville,9363,6,13,5,12,51,44,7,44
Coleraine,9363,7,10,12,8,38,38,0,42
Ards,9363,8,7,9,14,33,47,-14,30
Portadown,9363,9,9,3,18,32,51,-19,30
Glentoran,9363,10,7,8,15,33,52,-19,29
Ballinamalla,9363,11,6,7,17,22,50,-28,25
Linfield,9364,1,16,11,3,69,30,39,59
Ballymena,9364,2,15,8,7,61,53,8,53
Crusaders,9364,3,14,10,6,54,38,16,52
Coleraine,9364,4,10,14,6,38,34,4,44
Glenavon,9364,5,11,11,8,51,49,2,44
Cliftonville,9364,6,12,6,12,49,45,4,42
Ballinamalla,9364,7,13,3,14,45,46,-1,42
Dungannon,9364,8,9,7,14,42,40,2,34
Glentoran,9364,9,9,6,15,36,56,-20,33
Ards,9364,10,7,6,17,36,52,-16,27
Portadown,9364,11,4,8,18,26,64,-38,20
Crusaders,9365,1,17,8,5,58,33,25,59
Ballymena,9365,2,16,5,9,61,52,9,53
Cliftonville,9365,3,15,6,9,49,38,11,51
Coleraine,9365,4,12,10,8,44,41,3,46
Linfield,9365,5,11,11,8,53,33,20,44
Glenavon,9365,6,11,11,8,43,42,1,44
Ards,9365,7,10,6,14,36,42,-6,36
Glentoran,9365,8,9,5,16,33,50,-17,32
Portadown,9365,9,7,9,14,29,40,-11,30
Dungannon,9365,10,8,6,16,46,59,-13,30
Ballinamalla,9365,11,8,5,17,34,56,-22,29
Ballymena,9366,1,16,6,8,57,54,3,54
Crusaders,9366,2,15,8,7,59,42,17,53
Cliftonville,9366,3,15,5,10,52,37,15,50
Linfield,9366,4,12,9,9,50,30,20,45
Coleraine,9366,5,10,12,8,46,40,6,42
Dungannon,9366,6,10,10,10,45,42,3,40
Glenavon,9366,7,9,12,9,43,45,-2,39
Ballinamalla,9366,8,12,2,16,36,44,-8,38
Glentoran,9366,9,9,9,12,35,49,-14,36
Ards,9366,10,8,7,15,33,48,-15,31
Portadown,9366,11,6,6,18,28,53,-25,24
Crusaders,9367,1,16,9,5,54,31,23,57
Ballymena,9367,2,16,5,9,60,55,5,53
Linfield,9367,3,14,9,7,61,38,23,51
Cliftonville,9367,4,14,5,11,47,47,0,47
Glenavon,9367,5,12,10,8,48,43,5,46
Dungannon,9367,6,11,11,8,47,38,9,44
Coleraine,9367,7,10,13,7,43,39,4,43
Glentoran,9367,8,8,9,13,34,46,-12,33
Ards,9367,9,8,8,14,37,45,-8,32
Portadown,9367,10,6,5,19,26,48,-22,23
Ballinamalla,9367,11,5,6,19,28,55,-27,21
Crusaders,9368,1,20,7,3,66,34,32,67
Cliftonville,9368,2,17,3,10,51,37,14,54
Ballymena,9368,3,14,9,7,61,54,7,51
Linfield,9368,4,14,8,8,65,42,23,50
Glenavon,9368,5,13,10,7,53,45,8,49
Dungannon,9368,6,11,8,11,56,47,9,41
Coleraine,9368,7,10,8,12,39,39,0,38
Ballinamalla,9368,8,9,5,16,36,54,-18,32
Ards,9368,9,9,3,18,39,57,-18,30
Glentoran,9368,10,5,8,17,27,54,-27,23
Portadown,9368,11,5,7,18,21,51,-30,22
Crusaders,9369,1,16,8,6,57,34,23,56
Coleraine,9369,2,14,10,6,42,31,11,52
Ballymena,9369,3,15,7,8,57,55,2,52
Cliftonville,9369,4,13,8,9,48,38,10,47
Linfield,9369,5,12,8,10,60,43,17,44
Glentoran,9369,6,12,8,10,34,34,0,44
Glenavon,9369,7,11,9,10,47,50,-3,42
Dungannon,9369,8,8,10,12,47,51,-4,34
Ballinamalla,9369,9,8,5,17,32,51,-19,29
Ards,9369,10,8,4,18,38,54,-16,28
Portadown,9369,11,5,9,16,24,45,-21,24
Crusaders,9370,1,17,6,7,52,35,17,57
Cliftonville,9370,2,17,4,9,53,38,15,55
Linfield,9370,3,14,7,9,56,32,24,49
Ballymena,9370,4,15,4,11,58,57,1,49
Coleraine,9370,5,11,9,10,44,45,-1,42
Dungannon,9370,6,10,10,10,50,39,11,40
Glenavon,9370,7,9,11,10,42,42,0,38
Glentoran,9370,8,11,5,14,29,47,-18,38
Portadown,9370,9,10,3,17,26,50,-24,33
Ballinamalla,9370,10,8,8,14,35,46,-11,32
Ards,9370,11,7,5,18,39,53,-14,26
Crusaders,9371,1,19,8,3,63,27,36,65
Cliftonville,9371,2,15,7,8,51,36,15,52
Linfield,9371,3,13,11,6,59,34,25,50
Ballymena,9371,4,12,9,9,54,52,2,45
Coleraine,9371,5,11,9,10,44,46,-2,42
Dungannon,9371,6,10,11,9,51,42,9,41
Glenavon,9371,7,10,9,11,48,52,-4,39
Ards,9371,8,9,6,15,30,46,-16,33
Glentoran,9371,9,7,8,15,31,51,-20,29
Ballinamalla,9371,10,9,2,19,32,58,-26,29
Portadown,9371,11,8,4,18,29,48,-19,28
Crusaders,9372,1,16,7,7,63,36,27,55
Ballymena,9372,2,17,3,10,66,56,10,54
Cliftonville,9372,3,16,4,10,51,41,10,52
Linfield,9372,4,14,8,8,64,42,22,50
Glenavon,9372,5,13,10,7,49,41,8,49
Coleraine,9372,6,11,9,10,42,41,1,42
Dungannon,9372,7,9,9,12,54,54,0,36
Ards,9372,8,10,4,16,38,51,-13,34
Glentoran,9372,9,7,8,15,31,50,-19,29
Portadown,9372,10,7,8,15,27,47,-20,29
Ballinamalla,9372,11,9,2,19,30,56,-26,29
Coleraine,9373,1,15,10,5,49,30,19,55
Crusaders,9373,2,15,9,6,55,32,23,54
Linfield,9373,3,14,10,6,52,28,24,52
Cliftonville,9373,4,13,6,11,50,36,14,45
Glenavon,9373,5,11,11,8,47,49,-2,44
Dungannon,9373,6,11,10,9,53,43,10,43
Ballymena,9373,7,11,7,12,45,55,-10,40
Ards,9373,8,10,5,15,41,51,-10,35
Glentoran,9373,9,5,13,12,26,44,-18,28
Portadown,9373,10,6,8,16,22,46,-24,26
Ballinamalla,9373,11,6,7,17,31,57,-26,25
Crusaders,9374,1,17,7,6,57,34,23,58
Linfield,9374,2,16,9,5,60,30,30,57
Ballymena,9374,3,16,5,9,65,57,8,53
Coleraine,9374,4,14,9,7,45,36,9,51
Cliftonville,9374,5,14,6,10,49,37,12,48
Glenavon,9374,6,11,10,9,42,43,-1,43
Dungannon,9374,7,10,8,12,43,40,3,38
Ards,9374,8,8,6,16,38,52,-14,30
Glentoran,9374,9,7,9,14,34,48,-14,30
Portadown,9374,10,7,7,16,25,49,-24,28
Ballinamalla,9374,11,6,2,22,23,55,-32,20
Crusaders,9375,1,19,5,6,53,29,24,62
Ballymena,9375,2,15,6,9,67,57,10,51
Cliftonville,9375,3,14,7,9,54,44,10,49
Linfield,9375,4,13,9,8,54,30,24,48
Coleraine,9375,5,12,11,7,46,41,5,47
Glenavon,9375,6,11,10,9,49,41,8,43
Dungannon,9375,7,12,7,11,55,48,7,43
Ards,9375,8,11,3,16,40,48,-8,36
Glentoran,9375,9,8,7,15,30,50,-20,31
Ballinamalla,9375,10,8,4,18,27,51,-24,28
Portadown,9375,11,5,5,20,21,57,-36,20
Linfield,9376,1,15,11,4,65,30,35,56
Cliftonville,9376,2,17,3,10,56,39,17,54
Crusaders,9376,3,15,7,8,49,32,17,52
Glenavon,9376,4,13,9,8,48,40,8,48
Ballymena,9376,5,14,6,10,64,61,3,48
Coleraine,9376,6,12,10,8,44,39,5,46
Ards,9376,7,10,6,14,42,55,-13,36
Ballinamalla,9376,8,8,6,16,28,50,-22,30
Portadown,9376,9,7,8,15,28,47,-19,29
Dungannon,9376,10,6,10,14,46,51,-5,28
Glentoran,9376,11,7,6,17,32,58,-26,27
Linfield,9377,1,17,9,4,66,29,37,60
Cliftonville,9377,2,15,9,6,51,31,20,54
Crusaders,9377,3,15,7,8,52,34,18,52
Glenavon,9377,4,11,13,6,49,42,7,46
Ballymena,9377,5,12,6,12,53,65,-12,42
Dungannon,9377,6,10,10,10,47,44,3,40
Coleraine,9377,7,10,10,10,38,43,-5,40
Ards,9377,8,9,5,16,37,44,-7,32
Ballinamalla,9377,9,7,9,14,33,47,-14,30
Glentoran,9377,10,8,6,16,29,52,-23,30
Portadown,9377,11,6,6,18,22,46,-24,24
Linfield,9378,1,15,9,6,59,28,31,54
Crusaders,9378,2,15,7,8,52,38,14,52
Cliftonville,9378,3,15,5,10,52,41,11,50
Glenavon,9378,4,10,16,4,47,34,13,46
Coleraine,9378,5,11,11,8,40,36,4,44
Ballymena,9378,6,13,5,12,56,61,-5,44
Dungannon,9378,7,10,9,11,51,48,3,39
Ballinamalla,9378,8,10,6,14,33,46,-13,36
Ards,9378,9,8,7,15,33,49,-16,31
Glentoran,9378,10,6,9,15,26,47,-21,27
Portadown,9378,11,6,8,16,24,45,-21,26
Cliftonville,9379,1,18,5,7,67,42,25,59
Crusaders,9379,2,17,7,6,62,37,25,58
Linfield,9379,3,15,8,7,65,45,20,53
Ballymena,9379,4,13,5,12,52,63,-11,44
Glenavon,9379,5,10,11,9,56,51,5,41
Coleraine,9379,6,10,9,11,43,49,-6,39
Dungannon,9379,7,9,11,10,56,50,6,38
Glentoran,9379,8,10,5,15,41,49,-8,35
Ards,9379,9,10,5,15,43,54,-11,35
Ballinamalla,9379,10,8,8,14,33,49,-16,32
Portadown,9379,11,6,4,20,29,58,-29,22
Crusaders,9380,1,21,5,4,62,24,38,68
Linfield,9380,2,14,11,5,64,38,26,53
Dungannon,9380,3,13,10,7,54,37,17,49
Ballymena,9380,4,14,6,10,62,58,4,48
Cliftonville,9380,5,13,6,11,46,39,7,45
Glenavon,9380,6,10,13,7,39,39,0,43
Coleraine,9380,7,10,12,8,36,36,0,42
Ards,9380,8,10,5,15,41,53,-12,35
Glentoran,9380,9,9,7,14,30,44,-14,34
Ballinamalla,9380,10,5,4,21,25,54,-29,19
Portadown,9380,11,3,7,20,19,56,-37,16
Ballymena,9381,1,16,7,7,64,56,8,55
Linfield,9381,2,14,11,5,57,33,24,53
Crusaders,9381,3,15,8,7,52,35,17,53
Glenavon,9381,4,12,12,6,55,46,9,48
Cliftonville,9381,5,12,5,13,52,49,3,41
Glentoran,9381,6,11,8,11,33,39,-6,41
Dungannon,9381,7,10,8,12,54,50,4,38
Coleraine,9381,8,8,11,11,36,42,-6,35
Ards,9381,9,10,3,17,36,46,-10,33
Portadown,9381,10,7,8,15,30,44,-14,29
Ballinamalla,9381,11,9,1,20,26,55,-29,28
Crusaders,9382,1,17,8,5,64,45,19,59
Linfield,9382,2,14,11,5,61,32,29,53
Cliftonville,9382,3,16,5,9,63,40,23,53
Glenavon,9382,4,11,11,8,55,45,10,44
Coleraine,9382,5,12,8,10,38,36,2,44
Ballymena,9382,6,11,11,8,55,56,-1,44
Dungannon,9382,7,8,11,11,49,48,1,35
Ballinamalla,9382,8,10,3,17,32,52,-20,33
Glentoran,9382,9,9,5,16,30,52,-22,32
Portadown,9382,10,8,7,15,39,56,-17,31
Ards,9382,11,7,4,19,28,52,-24,25
Crusaders,9383,1,17,6,7,57,33,24,57
Linfield,9383,2,16,6,8,52,29,23,54
Glenavon,9383,3,14,9,7,52,46,6,51
Cliftonville,9383,4,15,5,10,53,43,10,50
Coleraine,9383,5,12,11,7,45,35,10,47
Ballymena,9383,6,13,6,11,63,65,-2,45
Dungannon,9383,7,9,9,12,49,51,-2,36
Ards,9383,8,10,4,16,36,47,-11,34
Glentoran,9383,9,9,6,15,28,44,-16,33
Ballinamalla,9383,10,7,5,18,27,48,-21,26
Portadown,9383,11,7,5,18,24,45,-21,26
Crusaders,9384,1,17,7,6,60,39,21,58
Ballymena,9384,2,17,5,8,63,52,11,56
Linfield,9384,3,14,9,7,56,35,21,51
Cliftonville,9384,4,12,7,11,48,42,6,43
Dungannon,9384,5,11,9,10,54,49,5,42
Coleraine,9384,6,10,11,9,45,41,4,41
Ards,9384,7,11,5,14,38,45,-7,38
Glenavon,9384,8,7,14,9,46,49,-3,35
Glentoran,9384,9,8,7,15,28,48,-20,31
Ballinamalla,9384,10,7,8,15,33,52,-19,29
Portadown,9384,11,7,6,17,24,43,-19,27
Cliftonville,9385,1,18,3,9,62,40,22,57
Linfield,9385,2,16,7,7,61,32,29,55
Crusaders,9385,3,15,6,9,55,36,19,51
Ballymena,9385,4,14,7,9,62,57,5,49
Glenavon,9385,5,12,11,7,49,44,5,47
Coleraine,9385,6,11,8,11,44,47,-3,41
Dungannon,9385,7,11,7,12,56,53,3,40
Glentoran,9385,8,10,7,13,34,49,-15,37
Ballinamalla,9385,9,9,4,17,33,52,-19,31
Ards,9385,10,9,2,19,34,48,-14,29
Portadown,9385,11,6,6,18,21,53,-32,24
Crusaders,9386,1,17,9,4,55,28,27,60
Cliftonville,9386,2,16,3,11,54,41,13,51
Linfield,9386,3,13,8,9,54,32,22,47
Ballymena,9386,4,13,8,9,55,57,-2,47
Dungannon,9386,5,13,7,10,47,36,11,46
Glenavon,9386,6,12,9,9,49,49,0,45
Coleraine,9386,7,10,12,8,41,39,2,42
Glentoran,9386,8,8,8,14,31,45,-14,32
Portadown,9386,9,9,4,17,32,54,-22,31
Ards,9386,10,7,8,15,35,46,-11,29
Ballinamalla,9386,11,7,4,19,29,55,-26,25
Linfield,9387,1,15,12,3,59,28,31,57
Crusaders,9387,2,17,6,7,62,33,29,57
Coleraine,9387,3,14,9,7,52,38,14,51
Cliftonville,9387,4,15,4,11,52,43,9,49
Glenavon,9387,5,11,10,9,50,47,3,43
Ballymena,9387,6,11,7,12,53,66,-13,40
Ballinamalla,9387,7,11,3,16,34,50,-16,36
Ards,9387,8,10,5,15,35,47,-12,35
Portadown,9387,9,8,7,15,30,41,-11,31
Dungannon,9387,10,8,6,16,41,53,-12,30
Glentoran,9387,11,8,5,17,27,49,-22,29
Crusaders,9388,1,17,10,3,58,31,27,61
Ballymena,9388,2,17,7,6,63,50,13,58
Linfield,9388,3,15,12,3,54,26,28,57
Glenavon,9388,4,13,11,6,50,40,10,50
Cliftonville,9388,5,14,5,11,49,37,12,47
Coleraine,9388,6,11,10,9,40,37,3,43
Dungannon,9388,7,7,8,15,46,54,-8,29
Ards,9388,8,7,8,15,32,45,-13,29
Glentoran,9388,9,7,8,15,31,56,-25,29
Portadown,9388,10,6,6,18,25,48,-23,24
Ballinamalla,9388,11,5,7,18,30,54,-24,22
Cliftonville,9389,1,16,7,7,57,35,22,55
Ballymena,9389,2,16,7,7,67,55,12,55
Crusaders,9389,3,13,10,7,53,41,12,49
Glenavon,9389,4,13,10,7,50,46,4,49
Coleraine,9389,5,12,9,9,46,39,7,45
Linfield,9389,6,12,8,10,59,39,20,44
Dungannon,9389,7,12,8,10,57,41,16,44
Ards,9389,8,9,7,14,40,47,-7,34
Glentoran,9389,9,7,8,15,24,53,-29,29
Portadown,9389,10,7,6,17,25,54,-29,27
Ballinamalla,9389,11,5,6,19,26,54,-28,21
Linfield,9390,1,16,9,5,62,26,36,57
Cliftonville,9390,2,17,4,9,52,33,19,55
Glenavon,9390,3,13,10,7,50,46,4,49
Crusaders,9390,4,13,9,8,48,37,11,48
Ballymena,9390,5,14,5,11,58,56,2,47
Dungannon,9390,6,10,8,12,46,44,2,38
Glentoran,9390,7,9,9,12,32,41,-9,36
Coleraine,9390,8,8,11,11,39,46,-7,35
Ballinamalla,9390,9,11,2,17,30,48,-18,35
Portadown,9390,10,7,7,16,20,39,-19,28
Ards,9390,11,8,4,18,38,59,-21,28
Crusaders,9391,1,16,11,3,55,27,28,59
Cliftonville,9391,2,16,6,8,56,37,19,54
Glenavon,9391,3,13,9,8,53,44,9,48
Linfield,9391,4,13,8,9,52,33,19,47
Ballymena,9391,5,13,5,12,50,61,-11,44
Ards,9391,6,12,6,12,39,45,-6,42
Coleraine,9391,7,10,10,10,37,38,-1,40
Dungannon,9391,8,9,10,11,46,44,2,37
Glentoran,9391,9,9,10,11,29,36,-7,37
Portadown,9391,10,7,5,18,32,53,-21,26
Ballinamalla,9391,11,4,6,20,20,51,-31,18
Cliftonville,9392,1,18,6,6,56,33,23,60
Crusaders,9392,2,16,6,8,52,35,17,54
Glentoran,9392,3,13,6,11,31,35,-4,45
Linfield,9392,4,11,11,8,51,34,17,44
Ballymena,9392,5,13,5,12,56,60,-4,44
Coleraine,9392,6,12,7,11,42,35,7,43
Dungannon,9392,7,9,9,12,46,42,4,36
Glenavon,9392,8,8,11,11,43,48,-5,35
Ballinamalla,9392,9,9,6,15,33,49,-16,33
Ards,9392,10,9,4,17,29,48,-19,31
Portadown,9392,11,8,7,15,31,51,-20,31
Crusaders,9393,1,16,7,7,55,36,19,55
Ballymena,9393,2,15,7,8,59,51,8,52
Linfield,9393,3,14,9,7,52,31,21,51
Cliftonville,9393,4,15,2,13,45,47,-2,47
Glenavon,9393,5,11,11,8,49,48,1,44
Coleraine,9393,6,11,9,10,46,37,9,42
Dungannon,9393,7,10,10,10,53,48,5,40
Glentoran,9393,8,11,7,12,29,39,-10,40
Ards,9393,9,10,5,15,41,49,-8,35
Ballinamalla,9393,10,8,4,18,27,48,-21,28
Portadown,9393,11,5,7,18,20,42,-22,22
Crusaders,9394,1,19,5,6,63,37,26,62
Glenavon,9394,2,11,14,5,50,36,14,47
Coleraine,9394,3,12,11,7,42,42,0,47
Ballymena,9394,4,14,5,11,59,65,-6,47
Dungannon,9394,5,12,9,9,57,43,14,45
Cliftonville,9394,6,14,3,13,54,44,10,45
Linfield,9394,7,11,10,9,56,37,19,43
Glentoran,9394,8,8,8,14,31,45,-14,32
Ards,9394,9,7,8,15,38,52,-14,29
Portadown,9394,10,7,8,15,31,54,-23,29
Ballinamalla,9394,11,7,5,18,29,55,-26,26
Cliftonville,9395,1,16,7,7,58,39,19,55
Crusaders,9395,2,16,6,8,60,44,16,54
Linfield,9395,3,13,10,7,57,36,21,49
Ballymena,9395,4,13,9,8,60,55,5,48
Coleraine,9395,5,11,10,9,37,37,0,43
Glenavon,9395,6,10,11,9,46,48,-2,41
Dungannon,9395,7,10,9,11,57,47,10,39
Glentoran,9395,8,8,9,13,34,45,-11,33
Ballinamalla,9395,9,8,7,15,30,51,-21,31
Ards,9395,10,7,8,15,37,51,-14,29
Portadown,9395,11,5,10,15,25,48,-23,25
Crusaders,9396,1,21,7,2,65,24,41,70
Cliftonville,9396,2,17,5,8,54,36,18,56
Ballymena,9396,3,16,6,8,61,55,6,54
Linfield,9396,4,13,10,7,59,31,28,49
Glenavon,9396,5,11,11,8,51,50,1,44
Coleraine,9396,6,11,10,9,43,39,4,43
Dungannon,9396,7,11,7,12,47,40,7,40
Glentoran,9396,8,11,5,14,31,48,-17,38
Ards,9396,9,8,2,20,28,59,-31,26
Portadown,9396,10,6,5,19,25,46,-21,23
Ballinamalla,9396,11,5,2,23,23,59,-36,17
Crusaders,9397,1,19,5,6,63,36,27,62
Linfield,9397,2,14,11,5,52,24,28,53
Cliftonville,9397,3,16,4,10,55,39,16,52
Ballymena,9397,4,14,5,11,55,55,0,47
Coleraine,9397,5,12,9,9,39,42,-3,45
Glenavon,9397,6,10,12,8,48,43,5,42
Dungannon,9397,7,10,8,12,48,51,-3,38
Ards,9397,8,11,4,15,42,44,-2,37
Glentoran,9397,9,8,9,13,27,41,-14,33
Ballinamalla,9397,10,8,6,16,30,52,-22,30
Portadown,9397,11,4,5,21,23,55,-32,17
Crusaders,9398,1,17,8,5,65,43,22,59
Cliftonville,9398,2,18,2,10,62,48,14,56
Linfield,9398,3,15,10,5,59,31,28,55
Dungannon,9398,4,12,10,8,60,43,17,46
Glenavon,9398,5,12,9,9,46,40,6,45
Coleraine,9398,6,10,10,10,37,42,-5,40
Glentoran,9398,7,10,7,13,38,47,-9,37
Ballymena,9398,8,9,8,13,51,70,-19,35
Portadown,9398,9,9,4,17,25,42,-17,31
Ards,9398,10,6,8,16,32,50,-18,26
Ballinamalla,9398,11,8,2,20,37,56,-19,26
Linfield,9399,1,15,10,5,64,29,35,55
Ballymena,9399,2,15,6,9,59,58,1,51
Cliftonville,9399,3,15,5,10,54,37,17,50
Crusaders,9399,4,12,12,6,43,31,12,48
Coleraine,9399,5,11,10,9,44,39,5,43
Ards,9399,6,11,5,14,39,46,-7,38
Dungannon,9399,7,8,11,11,46,47,-1,35
Glenavon,9399,8,8,10,12,44,50,-6,34
Ballinamalla,9399,9,9,7,14,28,46,-18,34
Glentoran,9399,10,8,9,13,23,40,-17,33
Portadown,9399,11,7,7,16,27,48,-21,28
Cliftonville,9400,1,17,4,9,55,36,19,55
Crusaders,9400,2,16,5,9,60,39,21,53
Linfield,9400,3,15,7,8,65,38,27,52
Glenavon,9400,4,14,9,7,50,42,8,51
Coleraine,9400,5,13,8,9,45,43,2,47
Ballymena,9400,6,13,5,12,57,62,-5,44
Dungannon,9400,7,9,10,11,45,44,1,37
Ards,9400,8,9,5,16,44,52,-8,32
Ballinamalla,9400,9,9,5,16,32,57,-25,32
Glentoran,9400,10,8,5,17,30,48,-18,29
Portadown,9400,11,8,5,17,26,48,-22,29
Linfield,9401,1,18,8,4,68,28,40,62
Crusaders,9401,2,15,7,8,45,32,13,52
Glenavon,9401,3,14,7,9,42,35,7,49
Coleraine,9401,4,12,10,8,37,36,1,46
Ballymena,9401,5,13,6,11,50,59,-9,45
Cliftonville,9401,6,13,4,13,49,41,8,43
Portadown,9401,7,10,4,16,34,51,-17,34
Dungannon,9401,8,8,9,13,44,44,0,33
Ards,9401,9,9,6,15,40,47,-7,33
Glentoran,9401,10,8,8,14,34,46,-12,32
Ballinamalla,9401,11,7,7,16,29,53,-24,28
Crusaders,9402,1,19,7,4,57,25,32,64
Cliftonville,9402,2,14,5,11,43,33,10,47
Glenavon,9402,3,12,10,8,51,42,9,46
Coleraine,9402,4,12,10,8,44,36,8,46
Linfield,9402,5,12,8,10,51,36,15,44
Portadown,9402,6,12,3,15,29,42,-13,39
Ballymena,9402,7,10,7,13,50,59,-9,37
Glentoran,9402,8,9,9,12,26,35,-9,36
Dungannon,9402,9,8,10,12,43,47,-4,34
Ards,9402,10,9,6,15,34,47,-13,33
Ballinamalla,9402,11,8,5,17,26,52,-26,29
Linfield,9403,1,15,7,8,56,32,24,52
Ballymena,9403,2,14,6,10,60,53,7,48
Glenavon,9403,3,12,12,6,47,42,5,48
Cliftonville,9403,4,14,5,11,47,37,10,47
Crusaders,9403,5,13,8,9,48,41,7,47
Coleraine,9403,6,11,12,7,44,35,9,45
Glentoran,9403,7,12,7,11,37,38,-1,43
Dungannon,9403,8,11,8,11,52,45,7,41
Ards,9403,9,10,4,16,35,49,-14,34
Portadown,9403,10,6,7,17,25,51,-26,25
Ballinamalla,9403,11,7,4,19,27,55,-28,25
Dungannon,9404,1,15,8,7,61,37,24,53
Crusaders,9404,2,14,10,6,52,36,16,52
Linfield,9404,3,15,6,9,62,36,26,51
Coleraine,9404,4,13,9,8,49,37,12,48
Cliftonville,9404,5,14,5,11,51,46,5,47
Ballymena,9404,6,13,7,10,58,61,-3,46
Glenavon,9404,7,9,13,8,44,41,3,40
Glentoran,9404,8,10,9,11,34,44,-10,39
Ards,9404,9,10,5,15,39,50,-11,35
Ballinamalla,9404,10,7,5,18,31,56,-25,26
Portadown,9404,11,4,5,21,19,56,-37,17
Crusaders,9405,1,14,9,7,51,35,16,51
Linfield,9405,2,13,11,6,59,34,25,50
Cliftonville,9405,3,13,7,10,47,39,8,46
Coleraine,9405,4,11,13,6,40,33,7,46
Glenavon,9405,5,12,9,9,45,41,4,45
Ballymena,9405,6,13,5,12,52,56,-4,44
Dungannon,9405,7,11,10,9,50,40,10,43
Ards,9405,8,12,5,13,42,47,-5,41
Portadown,9405,9,8,5,17,28,49,-21,29
Ballinamalla,9405,10,8,5,17,29,51,-22,29
Glentoran,9405,11,7,7,16,27,45,-18,28
Linfield,9406,1,14,11,5,61,34,27,53
Ballymena,9406,2,15,6,9,59,62,-3,51
Crusaders,9406,3,14,8,8,46,29,17,50
Cliftonville,9406,4,14,6,10,62,44,18,48
Coleraine,9406,5,12,8,10,49,41,8,44
Glentoran,9406,6,12,8,10,31,36,-5,44
Glenavon,9406,7,10,10,10,44,47,-3,40
Dungannon,9406,8,10,9,11,51,43,8,39
Ards,9406,9,11,6,13,42,44,-2,39
Portadown,9406,10,7,5,18,28,60,-32,26
Ballinamalla,9406,11,6,3,21,26,59,-33,21
Crusaders,9407,1,18,7,5,61,36,25,61
Linfield,9407,2,15,10,5,62,29,33,55
Coleraine,9407,3,13,12,5,45,34,11,51
Ballymena,9407,4,15,4,11,60,54,6,49
Glenavon,9407,5,11,10,9,44,48,-4,43
Dungannon,9407,6,10,8,12,55,48,7,38
Cliftonville,9407,7,10,7,13,44,41,3,37
Ards,9407,8,10,7,13,43,46,-3,37
Glentoran,9407,9,9,7,14,30,56,-26,34
Ballinamalla,9407,10,7,5,18,26,50,-24,26
Portadown,9407,11,6,5,19,24,52,-28,23
Cliftonville,9408,1,17,4,9,61,41,20,55
Linfield,9408,2,15,7,8,63,34,29,52
Crusaders,9408,3,14,10,6,53,35,18,52
Coleraine,9408,4,13,11,6,46,35,11,50
Glenavon,9408,5,11,11,8,43,38,5,44
Ballymena,9408,6,12,7,11,56,59,-3,43
Glentoran,9408,7,12,6,12,34,41,-7,42
Dungannon,9408,8,9,7,14,47,57,-10,34
Portadown,9408,9,8,6,16,25,48,-23,30
Ards,9408,10,7,7,16,37,55,-18,28
Ballinamalla,9408,11,7,4,19,26,48,-22,25
Crusaders,9409,1,18,5,7,58,32,26,59
Linfield,9409,2,15,11,4,60,30,30,56
Ballymena,9409,3,14,7,9,63,59,4,49
Coleraine,9409,4,13,9,8,46,38,8,48
Cliftonville,9409,5,14,5,11,51,45,6,47
Dungannon,9409,6,12,9,9,55,41,14,45
Glenavon,9409,7,11,8,11,44,46,-2,41
Ards,9409,8,9,8,13,40,47,-7,35
Glentoran,9409,9,6,9,15,24,45,-21,27
Portadown,9409,10,7,5,18,21,48,-27,26
Ballinamalla,9409,11,6,4,20,27,58,-31,22
Crusaders,9410,1,18,7,5,58,31,27,61
Ballymena,9410,2,17,4,9,63,55,8,55
Linfield,9410,3,14,12,4,63,37,26,54
Cliftonville,9410,4,14,5,11,49,38,11,47
Dungannon,9410,5,13,7,10,55,41,14,46
Glenavon,9410,6,11,13,6,47,43,4,46
Coleraine,9410,7,11,12,7,41,35,6,45
Ards,9410,8,10,5,15,37,50,-13,35
Ballinamalla,9410,9,6,6,18,23,50,-27,24
Glentoran,9410,10,6,5,19,27,54,-27,23
Portadown,9410,11,4,6,20,21,50,-29,18
Linfield,9411,1,16,10,4,56,28,28,58
Crusaders,9411,2,16,8,6,59,39,20,56
Glenavon,9411,3,13,10,7,45,40,5,49
Cliftonville,9411,4,15,3,12,52,42,10,48
Coleraine,9411,5,12,10,8,43,38,5,46
Ballymena,9411,6,12,9,9,55,58,-3,45
Dungannon,9411,7,8,10,12,49,42,7,34
Portadown,9411,8,7,10,13,28,40,-12,31
Glentoran,9411,9,6,11,13,31,46,-15,29
Ards,9411,10,8,4,18,32,51,-19,28
Ballinamalla,9411,11,7,5,18,31,57,-26,26
Crusaders,9412,1,18,5,7,65,39,26,59
Linfield,9412,2,13,9,8,60,33,27,48
Ballymena,9412,3,14,6,10,61,58,3,48
Coleraine,9412,4,12,11,7,38,29,9,47
Glenavon,9412,5,11,11,8,47,44,3,44
Cliftonville,9412,6,12,6,12,54,55,-1,42
Dungannon,9412,7,11,8,11,48,41,7,41
Glentoran,9412,8,10,9,11,35,46,-11,39
Ards,9412,9,9,6,15,40,49,-9,33
Ballinamalla,9412,10,9,3,18,36,56,-20,30
Portadown,9412,11,7,4,19,28,62,-34,25
Crusaders,9413,1,16,9,5,55,35,20,57
Linfield,9413,2,15,9,6,64,32,32,54
Cliftonville,9413,3,16,6,8,52,33,19,54
Coleraine,9413,4,11,12,7,41,39,2,45
Glenavon,9413,5,11,9,10,46,48,-2,42
Ards,9413,6,11,5,14,44,47,-3,38
Ballymena,9413,7,10,8,12,47,57,-10,38
Dungannon,9413,8,9,7,14,51,51,0,34
Glentoran,9413,9,9,7,14,30,46,-16,34
Portadown,9413,10,8,6,16,27,46,-19,30
Ballinamalla,9413,11,8,4,18,29,52,-23,28
Crusaders,9414,1,15,11,4,51,32,19,56
Linfield,9414,2,15,9,6,56,29,27,54
Cliftonville,9414,3,15,5,10,50,35,15,50
Dungannon,9414,4,14,7,9,58,38,20,49
Ballymena,9414,5,14,6,10,65,61,4,48
Glenavon,9414,6,12,10,8,44,43,1,46
Ards,9414,7,10,7,13,41,48,-7,37
Coleraine,9414,8,7,11,12,36,47,-11,32
Glentoran,9414,9,7,9,14,25,43,-18,30
Portadown,9414,10,8,6,16,28,47,-19,30
Ballinamalla,9414,11,4,7,19,24,55,-31,19
Linfield,9415,1,17,10,3,62,23,39,61
Ballymena,9415,2,15,7,8,62,60,2,52
Cliftonville,9415,3,15,6,9,58,43,15,51
Crusaders,9415,4,13,11,6,47,33,14,50
Coleraine,9415,5,12,11,7,46,40,6,47
Glenavon,9415,6,10,12,8,43,43,0,42
Dungannon,9415,7,9,11,10,46,47,-1,38
Glentoran,9415,8,8,8,14,30,45,-15,32
Ards,9415,9,7,7,16,35,49,-14,28
Ballinamalla,9415,10,7,6,17,30,49,-19,27
Portadown,9415,11,4,7,19,25,52,-27,19
Linfield,9416,1,16,10,4,61,33,28,58
Crusaders,9416,2,16,8,6,54,36,18,56
Glenavon,9416,3,13,11,6,56,45,11,50
Ballymena,9416,4,14,7,9,60,53,7,49
Cliftonville,9416,5,14,4,12,56,42,14,46
Coleraine,9416,6,10,12,8,43,43,0,42
Dungannon,9416,7,9,11,10,51,44,7,38
Ards,9416,8,8,7,15,32,42,-10,31
Portadown,9416,9,9,4,17,27,48,-21,31
Glentoran,9416,10,7,7,16,27,53,-26,28
Ballinamalla,9416,11,7,3,20,29,57,-28,24
Glenavon,9417,1,15,9,6,53,37,16,54
Ballymena,9417,2,16,4,10,62,57,5,52
Crusaders,9417,3,15,6,9,53,42,11,51
Linfield,9417,4,14,8,8,51,30,21,50
Ards,9417,5,13,4,13,39,48,-9,43
Dungannon,9417,6,11,8,11,54,41,13,41
Cliftonville,9417,7,12,5,13,45,41,4,41
Coleraine,9417,8,10,10,10,36,38,-2,40
Glentoran,9417,9,10,6,14,27,41,-14,36
Portadown,9417,10,6,7,17,27,49,-22,25
Ballinamalla,9417,11,6,7,17,25,48,-23,25
Linfield,9418,1,14,10,6,57,31,26,52
Cliftonville,9418,2,15,5,10,58,49,9,50
Ballymena,9418,3,14,6,10,56,56,0,48
Crusaders,9418,4,12,11,7,47,33,14,47
Glenavon,9418,5,10,13,7,44,40,4,43
Dungannon,9418,6,11,9,10,50,41,9,42
Coleraine,9418,7,10,11,9,42,37,5,41
Ballinamalla,9418,8,9,5,16,38,54,-16,32
Glentoran,9418,9,8,8,14,31,47,-16,32
Portadown,9418,10,8,7,15,29,51,-22,31
Ards,9418,11,6,11,13,34,47,-13,29
Crusaders,9419,1,17,7,6,59,35,24,58
Ballymena,9419,2,16,6,8,62,56,6,54
Linfield,9419,3,14,9,7,63,33,30,51
Cliftonville,9419,4,14,7,9,55,43,12,49
Coleraine,9419,5,11,12,7,43,38,5,45
Glenavon,9419,6,12,8,10,46,47,-1,44
Ards,9419,7,9,9,12,39,42,-3,36
Dungannon,9419,8,8,9,13,47,45,2,33
Glentoran,9419,9,9,5,16,30,53,-23,32
Portadown,9419,10,8,6,16,26,50,-24,30
Ballinamalla,9419,11,6,4,20,26,54,-28,22
Linfield,9420,1,16,9,5,67,30,37,57
Crusaders,9420,2,14,9,7,56,37,19,51
Cliftonville,9420,3,14,5,11,51,43,8,47
Coleraine,9420,4,12,10,8,45,42,3,46
Ballymena,9420,5,13,7,10,58,57,1,46
Glenavon,9420,6,12,9,9,53,47,6,45
Dungannon,9420,7,10,9,11,50,48,2,39
Glentoran,9420,8,10,8,12,33,42,-9,38
Ards,9420,9,10,4,16,38,53,-15,34
Ballinamalla,9420,10,8,5,17,32,54,-22,29
Portadown,9420,11,6,5,19,19,49,-30,23
Crusaders,9421,1,16,9,5,59,33,26,57
Linfield,9421,2,16,7,7,57,33,24,55
Glenavon,9421,3,13,10,7,49,41,8,49
Ballymena,9421,4,13,9,8,62,60,2,48
Cliftonville,9421,5,12,7,11,49,47,2,43
Coleraine,9421,6,10,11,9,46,42,4,41
Dungannon,9421,7,9,12,9,48,39,9,39
Ards,9421,8,9,6,15,43,54,-11,33
Ballinamalla,9421,9,10,3,17,34,51,-17,33
Glentoran,9421,10,7,10,13,37,52,-15,31
Portadown,9421,11,6,4,20,26,58,-32,22
Crusaders,9422,1,17,9,4,56,32,24,60
Ballymena,9422,2,15,7,8,57,49,8,52
Cliftonville,9422,3,14,7,9,52,41,11,49
Linfield,9422,4,11,12,7,58,36,22,45
Coleraine,9422,5,11,11,8,40,36,4,44
Glentoran,9422,6,10,9,11,34,42,-8,39
Dungannon,9422,7,9,10,11,53,51,2,37
Ards,9422,8,10,7,13,41,45,-4,37
Glenavon,9422,9,5,15,10,38,46,-8,30
Ballinamalla,9422,10,8,6,16,32,53,-21,30
Portadown,9422,11,5,7,18,22,52,-30,22
Linfield,9423,1,16,8,6,60,30,30,56
Crusaders,9423,2,14,9,7,51,40,11,51
Cliftonville,9423,3,16,2,12,57,43,14,50
Glenavon,9423,4,12,12,6,58,45,13,48
Ballymena,9423,5,14,5,11,61,59,2,47
Coleraine,9423,6,12,10,8,50,44,6,46
Ards,9423,7,9,7,14,40,51,-11,34
Glentoran,9423,8,8,10,12,28,44,-16,34
Ballinamalla,9423,9,7,8,15,38,56,-18,29
Portadown,9423,10,7,7,16,26,48,-22,28
Dungannon,9423,11,5,12,13,38,47,-9,27
Crusaders,9424,1,19,7,4,52,30,22,64
Linfield,9424,2,16,9,5,60,32,28,57
Cliftonville,9424,3,12,9,9,48,37,11,45
Glenavon,9424,4,10,13,7,53,47,6,43
Ballymena,9424,5,12,7,11,49,52,-3,43
Dungannon,9424,6,10,10,10,53,43,10,40
Coleraine,9424,7,8,12,10,40,45,-5,36
Glentoran,9424,8,9,5,16,27,40,-13,32
Ards,9424,9,8,7,15,35,48,-13,31
Portadown,9424,10,8,6,16,29,50,-21,30
Ballinamalla,9424,11,9,3,18,28,50,-22,30
Crusaders,9425,1,18,6,6,63,36,27,60
Ballymena,9425,2,15,6,9,67,53,14,51
Cliftonville,9425,3,15,5,10,59,40,19,50
Linfield,9425,4,12,13,5,58,28,30,49
Coleraine,9425,5,10,13,7,42,36,6,43
Glenavon,9425,6,11,9,10,48,54,-6,42
Glentoran,9425,7,10,7,13,31,51,-20,37
Dungannon,9425,8,8,10,12,47,46,1,34
Portadown,9425,9,8,8,14,26,45,-19,32
Ards,9425,10,8,6,16,35,51,-16,30
Ballinamalla,9425,11,6,5,19,25,61,-36,23
Crusaders,9426,1,21,5,4,63,33,30,68
Linfield,9426,2,16,9,5,57,27,30,57
Glenavon,9426,3,12,10,8,51,52,-1,46
Ballymena,9426,4,14,4,12,55,60,-5,46
Cliftonville,9426,5,13,5,12,52,45,7,44
Glentoran,9426,6,11,7,12,30,38,-8,40
Coleraine,9426,7,8,11,11,36,40,-4,35
Dungannon,9426,8,8,9,13,55,55,0,33
Ballinamalla,9426,9,9,4,17,27,49,-22,31
Ards,9426,10,7,8,15,38,51,-13,29
Portadown,9426,11,7,6,17,32,46,-14,27
Crusaders,9427,1,21,6,3,56,25,31,69
Linfield,9427,2,16,10,4,66,27,39,58
Cliftonville,9427,3,14,7,9,51,34,17,49
Dungannon,9427,4,12,8,10,55,45,10,44
Coleraine,9427,5,10,12,8,40,37,3,42
Glenavon,9427,6,9,11,10,40,43,-3,38
Ballymena,9427,7,9,8,13,47,67,-20,35
Glentoran,9427,8,8,9,13,35,45,-10,33
Ballinamalla,9427,9,9,3,18,30,56,-26,30
Portadown,9427,10,6,9,15,30,49,-19,27
Ards,9427,11,5,9,16,31,53,-22,24
Crusaders,9428,1,18,5,7,60,44,16,59
Linfield,9428,2,13,12,5,67,39,28,51
Cliftonville,9428,3,15,6,9,52,31,21,51
Coleraine,9428,4,11,13,6,45,39,6,46
Ballymena,9428,5,12,8,10,54,58,-4,44
Glenavon,9428,6,11,10,9,45,45,0,43
Dungannon,9428,7,9,9,12,49,46,3,36
Glentoran,9428,8,9,8,13,30,43,-13,35
Ards,9428,9,9,6,15,40,51,-11,33
Ballinamalla,9428,10,7,7,16,29,48,-19,28
Portadown,9428,11,6,6,18,26,53,-27,24
Crusaders,9429,1,18,8,4,50,25,25,62
Cliftonville,9429,2,16,6,8,55,36,19,54
Linfield,9429,3,14,10,6,63,33,30,52
Ballymena,9429,4,14,6,10,57,60,-3,48
Coleraine,9429,5,12,10,8,41,33,8,46
Dungannon,9429,6,11,10,9,51,42,9,43
Glenavon,9429,7,10,11,9,43,45,-2,41
Glentoran,9429,8,10,5,15,31,44,-13,35
Ballinamalla,9429,9,9,3,18,30,50,-20,30
Ards,9429,10,7,3,20,31,58,-27,24
Portadown,9429,11,4,8,18,22,48,-26,20
Cliftonville,9430,1,15,8,7,57,39,18,53
Crusaders,9430,2,15,6,9,51,40,11,51
Linfield,9430,3,12,13,5,55,33,22,49
Dungannon,9430,4,11,10,9,50,40,10,43
Coleraine,9430,5,11,10,9,47,45,2,43
Ballymena,9430,6,12,7,11,58,63,-5,43
Glenavon,9430,7,11,8,11,46,45,1,41
Glentoran,9430,8,10,9,11,36,40,-4,39
Ards,9430,9,8,9,13,36,47,-11,33
Portadown,9430,10,8,6,16,23,41,-18,30
Ballinamalla,9430,11,6,6,18,24,50,-26,24
Crusaders,9431,1,18,8,4,57,26,31,62
Linfield,9431,2,15,10,5,63,28,35,55
Cliftonville,9431,3,13,9,8,42,32,10,48
Dungannon,9431,4,12,10,8,48,39,9,46
Coleraine,9431,5,12,8,10,40,44,-4,44
Ballymena,9431,6,11,8,11,55,58,-3,41
Glenavon,9431,7,9,12,9,46,47,-1,39
Glentoran,9431,8,10,9,11,33,42,-9,39
Portadown,9431,9,9,6,15,26,42,-16,33
Ards,9431,10,7,6,17,32,49,-17,27
Ballinamalla,9431,11,5,2,23,22,57,-35,17
Crusaders,9432,1,15,10,5,51,32,19,55
Glenavon,9432,2,15,9,6,56,40,16,54
Ballymena,9432,3,16,4,10,63,58,5,52
Linfield,9432,4,13,10,7,58,30,28,49
Cliftonville,9432,5,13,7,10,52,42,10,46
Coleraine,9432,6,10,9,11,34,40,-6,39
Ards,9432,7,11,5,14,45,43,2,38
Dungannon,9432,8,10,8,12,47,47,0,38
Portadown,9432,9,9,5,16,25,42,-17,32
Glentoran,9432,10,7,7,16,24,54,-30,28
Ballinamalla,9432,11,7,4,19,34,61,-27,25
Linfield,9433,1,19,8,3,72,29,43,65
Crusaders,9433,2,16,8,6,57,38,19,56
Dungannon,9433,3,14,7,9,57,38,19,49
Cliftonville,9433,4,14,4,12,55,43,12,46
Coleraine,9433,5,12,10,8,43,36,7,46
Ballymena,9433,6,12,6,12,57,66,-9,42
Glenavon,9433,7,10,11,9,46,49,-3,41
Ards,9433,8,10,5,15,41,54,-13,35
Glentoran,9433,9,9,7,14,39,47,-8,34
Ballinamalla,9433,10,8,2,20,35,61,-26,26
Portadown,9433,11,4,6,20,19,60,-41,18
Crusaders,9434,1,18,8,4,61,28,33,62
Linfield,9434,2,17,9,4,66,29,37,60
Cliftonville,9434,3,16,4,10,54,40,14,52
Glenavon,9434,4,12,10,8,46,37,9,46
Ballymena,9434,5,13,5,12,55,69,-14,44
Coleraine,9434,6,9,14,7,38,39,-1,41
Glentoran,9434,7,9,7,14,32,47,-15,34
Ballinamalla,9434,8,9,5,16,30,52,-22,32
Dungannon,9434,9,7,10,13,48,50,-2,31
Ards,9434,10,7,7,16,35,51,-16,28
Portadown,9434,11,6,5,19,24,47,-23,23
Linfield,9435,1,17,9,4,72,31,41,60
Crusaders,9435,2,17,7,6,54,34,20,58
Cliftonville,9435,3,16,5,9,51,39,12,53
Glenavon,9435,4,13,11,6,58,43,15,50
Ballymena,9435,5,13,7,10,59,66,-7,46
Coleraine,9435,6,11,10,9,47,41,6,43
Dungannon,9435,7,9,10,11,45,45,0,37
Ards,9435,8,10,6,14,42,47,-5,36
Glentoran,9435,9,8,6,16,37,56,-19,30
Portadown,9435,10,6,5,19,22,52,-30,23
Ballinamalla,9435,11,5,4,21,22,55,-33,19
Crusaders,9436,1,18,5,7,57,38,19,59
Glenavon,9436,2,14,10,6,53,38,15,52
Linfield,9436,3,14,9,7,60,36,24,51
Cliftonville,9436,4,15,3,12,53,42,11,48
Coleraine,9436,5,12,9,9,48,44,4,45
Ballymena,9436,6,13,5,12,56,57,-1,44
Ards,9436,7,10,5,15,40,60,-20,35
Glentoran,9436,8,9,7,14,33,45,-12,34
Ballinamalla,9436,9,10,4,16,37,51,-14,34
Dungannon,9436,10,8,8,14,45,50,-5,32
Portadown,9436,11,8,3,19,31,52,-21,27
Cliftonville,9437,1,19,4,7,66,39,27,61
Crusaders,9437,2,18,5,7,54,35,19,59
Linfield,9437,3,13,7,10,60,40,20,46
Ballymena,9437,4,13,7,10,60,61,-1,46
Glenavon,9437,5,11,10,9,49,53,-4,43
Ballinamalla,9437,6,11,6,13,40,44,-4,39
Coleraine,9437,7,9,12,9,42,50,-8,39
Glentoran,9437,8,10,8,12,32,40,-8,38
Ards,9437,9,8,6,16,35,52,-17,30
Dungannon,9437,10,6,10,14,47,50,-3,28
Portadown,9437,11,6,7,17,25,46,-21,25
Linfield,9438,1,18,7,5,65,36,29,61
Crusaders,9438,2,16,6,8,58,44,14,54
Cliftonville,9438,3,16,2,12,62,51,11,50
Coleraine,9438,4,13,8,9,48,45,3,47
Glenavon,9438,5,12,10,8,46,47,-1,46
Ards,9438,6,13,3,14,41,44,-3,42
Ballymena,9438,7,12,5,13,58,59,-1,41
Ballinamalla,9438,8,11,3,16,38,52,-14,36
Dungannon,9438,9,9,7,14,54,46,8,34
Glentoran,9438,10,8,7,15,28,47,-19,31
Portadown,9438,11,6,4,20,21,48,-27,22
Linfield,9439,1,17,10,3,68,24,44,61
Crusaders,9439,2,14,10,6,47,31,16,52
Cliftonville,9439,3,14,4,12,46,42,4,46
Dungannon,9439,4,12,8,10,49,42,7,44
Coleraine,9439,5,11,11,8,46,40,6,44
Ballymena,9439,6,12,7,11,53,60,-7,43
Glenavon,9439,7,9,11,10,47,51,-4,38
Glentoran,9439,8,9,9,12,27,39,-12,36
Ballinamalla,9439,9,10,5,15,35,49,-14,35
Ards,9439,10,8,7,15,36,46,-10,31
Portadown,9439,11,5,6,19,18,48,-30,21
Linfield,9440,1,17,10,3,66,31,35,61
Crusaders,9440,2,16,7,7,58,39,19,55
Coleraine,9440,3,14,11,5,44,29,15,53
Cliftonville,9440,4,14,6,10,50,44,6,48
Glenavon,9440,5,11,10,9,53,53,0,43
Ballymena,9440,6,11,8,11,45,54,-9,41
Dungannon,9440,7,9,10,11,56,47,9,37
Ards,9440,8,9,5,16,40,51,-11,32
Glentoran,9440,9,7,8,15,33,48,-15,29
Ballinamalla,9440,10,9,2,19,33,60,-27,29
Portadown,9440,11,6,7,17,25,47,-22,25
Cliftonville,9441,1,18,5,7,55,31,24,59
Crusaders,9441,2,17,7,6,57,36,21,58
Linfield,9441,3,13,9,8,63,41,22,48
Ballymena,9441,4,13,9,8,62,59,3,48
Glenavon,9441,5,12,11,7,51,43,8,47
Coleraine,9441,6,10,8,12,38,44,-6,38
Ards,9441,7,11,4,15,40,49,-9,37
Glentoran,9441,8,9,8,13,34,48,-14,35
Dungannon,9441,9,9,7,14,42,40,2,34
Portadown,9441,10,7,6,17,27,52,-25,27
Ballinamalla,9441,11,6,6,18,33,59,-26,24
Crusaders,9442,1,19,5,6,58,34,24,62
Linfield,9442,2,16,10,4,66,28,38,58
Cliftonville,9442,3,17,4,9,55,42,13,55
Ballymena,9442,4,16,5,9,57,52,5,53
Glenavon,9442,5,11,10,9,50,47,3,43
Coleraine,9442,6,9,11,10,37,42,-5,38
Dungannon,9442,7,9,7,14,55,53,2,34
Ballinamalla,9442,8,10,4,16,36,48,-12,34
Glentoran,9442,9,9,7,14,31,48,-17,34
Ards,9442,10,6,5,19,30,54,-24,23
Portadown,9442,11,5,8,17,24,51,-27,23
Linfield,9443,1,17,8,5,58,27,31,59
Crusaders,9443,2,16,6,8,51,36,15,54
Ballymena,9443,3,16,6,8,61,51,10,54
Coleraine,9443,4,11,13,6,45,36,9,46
Cliftonville,9443,5,13,6,11,47,42,5,45
Glenavon,9443,6,11,10,9,47,38,9,43
Dungannon,9443,7,11,7,12,57,47,10,40
Portadown,9443,8,9,6,15,29,45,-16,33
Ards,9443,9,9,4,17,35,48,-13,31
Ballinamalla,9443,10,8,4,18,25,54,-29,28
Glentoran,9443,11,6,6,18,29,60,-31,24
Linfield,9444,1,16,8,6,64,28,36,56
Crusaders,9444,2,17,5,8,59,37,22,56
Cliftonville,9444,3,15,7,8,46,35,11,52
Ballymena,9444,4,13,7,10,57,59,-2,46
Coleraine,9444,5,11,9,10,41,42,-1,42
Dungannon,9444,6,10,11,9,52,43,9,41
Glenavon,9444,7,10,11,9,44,47,-3,41
Ballinamalla,9444,8,12,3,15,38,45,-7,39
Ards,9444,9,10,3,17,38,50,-12,33
Portadown,9444,10,7,5,18,25,50,-25,26
Glentoran,9444,11,7,5,18,27,55,-28,26
Linfield,9445,1,17,6,7,68,33,35,57
Coleraine,9445,2,13,11,6,51,34,17,50
Cliftonville,9445,3,15,5,10,52,42,10,50
Ballymena,9445,4,15,5,10,66,63,3,50
Crusaders,9445,5,12,9,9,54,41,13,45
Glenavon,9445,6,11,12,7,51,46,5,45
Dungannon,9445,7,10,11,9,49,46,3,41
Ballinamalla,9445,8,10,4,16,32,50,-18,34
Ards,9445,9,8,6,16,34,51,-17,30
Glentoran,9445,10,8,5,17,32,59,-27,29
Portadown,9445,11,6,6,18,24,48,-24,24
Crusaders,9446,1,18,7,5,49,31,18,61
Linfield,9446,2,17,9,4,66,33,33,60
Glenavon,9446,3,15,10,5,53,39,14,55
Cliftonville,9446,4,14,5,11,56,42,14,47
Ballymena,9446,5,13,8,9,56,51,5,47
Coleraine,9446,6,10,8,12,37,41,-4,38
Ards,9446,7,11,2,17,33,46,-13,35
Glentoran,9446,8,9,8,13,30,43,-13,35
Dungannon,9446,9,8,8,14,42,49,-7,32
Portadown,9446,10,9,4,17,24,42,-18,31
Ballinamalla,9446,11,4,5,21,28,57,-29,17
Linfield,9447,1,15,7,8,58,32,26,52
Glenavon,9447,2,14,10,6,55,39,16,52
Cliftonville,9447,3,16,4,10,54,41,13,52
Crusaders,9447,4,15,5,10,48,40,8,50
Ballymena,9447,5,13,5,12,59,58,1,44
Dungannon,9447,6,11,9,10,53,42,11,42
Ards,9447,7,13,2,15,39,47,-8,41
Coleraine,9447,8,10,8,12,40,46,-6,38
Ballinamalla,9447,9,9,5,16,34,53,-19,32
Glentoran,9447,10,8,7,15,27,46,-19,31
Portadown,9447,11,7,6,17,27,50,-23,27
Crusaders,9448,1,17,7,6,54,30,24,58
Cliftonville,9448,2,17,4,9,60,40,20,55
Coleraine,9448,3,13,8,9,45,37,8,47
Linfield,9448,4,12,9,9,58,37,21,45
Ballymena,9448,5,13,6,11,54,58,-4,45
Dungannon,9448,6,11,10,9,50,41,9,43
Glenavon,9448,7,9,13,8,42,46,-4,40
Ards,9448,8,10,5,15,40,48,-8,35
Glentoran,9448,9,8,8,14,30,47,-17,32
Portadown,9448,10,6,9,15,23,46,-23,27
Ballinamalla,9448,11,7,5,18,30,56,-26,26
Cliftonville,9449,1,19,3,8,66,39,27,60
Crusaders,9449,2,17,6,7,57,37,20,57
Ballymena,9449,3,14,6,10,50,52,-2,48
Linfield,9449,4,12,11,7,55,33,22,47
Dungannon,9449,5,12,10,8,53,44,9,46
Coleraine,9449,6,9,14,7,38,35,3,41
Glenavon,9449,7,9,10,11,51,54,-3,37
Ards,9449,8,10,7,13,37,46,-9,37
Ballinamalla,9449,9,9,7,14,32,48,-16,34
Portadown,9449,10,6,6,18,23,48,-25,24
Glentoran,9449,11,5,6,19,28,54,-26,21
Crusaders,9450,1,16,9,5,59,39,20,57
Linfield,9450,2,14,7,9,58,39,19,49
Cliftonville,9450,3,13,6,11,55,42,13,45
Coleraine,9450,4,11,12,7,49,40,9,45
Glenavon,9450,5,10,12,8,53,49,4,42
Ards,9450,6,12,6,12,37,39,-2,42
Ballymena,9450,7,12,6,12,54,63,-9,42
Dungannon,9450,8,11,7,12,54,51,3,40
Glentoran,9450,9,9,8,13,30,42,-12,35
Portadown,9450,10,8,5,17,31,52,-21,29
Ballinamalla,9450,11,8,4,18,29,53,-24,28
Cliftonville,9451,1,17,4,9,53,38,15,55
Crusaders,9451,2,14,10,6,54,37,17,52
Ballymena,9451,3,16,4,10,59,53,6,52
Linfield,9451,4,12,9,9,58,36,22,45
Glenavon,9451,5,11,10,9,43,44,-1,43
Coleraine,9451,6,11,9,10,36,37,-1,42
Ards,9451,7,9,8,13,38,49,-11,35
Dungannon,9451,8,6,15,9,43,42,1,33
Glentoran,9451,9,8,9,13,36,45,-9,33
Ballinamalla,9451,10,9,5,16,30,50,-20,32
Portadown,9451,11,8,5,17,23,42,-19,29
Cliftonville,9452,1,18,4,8,60,37,23,58
Linfield,9452,2,14,10,6,57,33,24,52
Crusaders,9452,3,15,7,8,48,33,15,52
Coleraine,9452,4,12,11,7,46,34,12,47
Ballymena,9452,5,14,4,12,63,57,6,46
Glenavon,9452,6,12,9,9,43,42,1,45
Glentoran,9452,7,11,5,14,34,48,-14,38
Ballinamalla,9452,8,11,4,15,36,45,-9,37
Dungannon,9452,9,8,12,10,44,41,3,36
Ards,9452,10,7,7,16,33,54,-21,28
Portadown,9452,11,4,5,21,23,63,-40,17
Cliftonville,9453,1,17,4,9,55,39,16,55
Linfield,9453,2,14,11,5,67,35,32,53
Coleraine,9453,3,13,12,5,52,32,20,51
Crusaders,9453,4,14,8,8,51,36,15,50
Ballymena,9453,5,13,9,8,55,52,3,48
Glenavon,9453,6,9,13,8,48,51,-3,40
Glentoran,9453,7,10,8,12,34,44,-10,38
Dungannon,9453,8,7,12,11,47,48,-1,33
Portadown,9453,9,7,9,14,21,40,-19,30
Ballinamalla,9453,10,6,6,18,24,56,-32,24
Ards,9453,11,5,8,17,37,58,-21,23
Crusaders,9454,1,17,7,6,66,33,33,58
Linfield,9454,2,15,11,4,62,29,33,56
Ballymena,9454,3,16,5,9,62,56,6,53
Cliftonville,9454,4,14,4,12,47,44,3,46
Dungannon,9454,5,11,9,10,50,43,7,42
Coleraine,9454,6,11,9,10,42,41,1,42
Ards,9454,7,10,7,13,38,44,-6,37
Glentoran,9454,8,9,8,13,31,42,-11,35
Glenavon,9454,9,8,10,12,37,47,-10,34
Ballinamalla,9454,10,9,4,17,29,52,-23,31
Portadown,9454,11,6,4,20,23,56,-33,22
Crusaders,9455,1,17,8,5,57,32,25,59
Linfield,9455,2,14,10,6,62,34,28,52
Ballymena,9455,3,14,6,10,66,61,5,48
Coleraine,9455,4,11,12,7,44,41,3,45
Cliftonville,9455,5,13,5,12,50,45,5,44
Glenavon,9455,6,10,12,8,53,49,4,42
Dungannon,9455,7,10,8,12,50,47,3,38
Ballinamalla,9455,8,10,4,16,33,51,-18,34
Portadown,9455,9,8,8,14,27,43,-16,32
Glentoran,9455,10,7,10,13,26,45,-19,31
Ards,9455,11,7,5,18,35,55,-20,26
Crusaders,9456,1,19,6,5,62,35,27,63
Cliftonville,9456,2,17,4,9,57,43,14,55
Ballymena,9456,3,13,9,8,56,56,0,48
Linfield,9456,4,12,10,8,51,33,18,46
Glenavon,9456,5,11,7,12,49,47,2,40
Coleraine,9456,6,9,13,8,45,43,2,40
Dungannon,9456,7,8,12,10,46,44,2,36
Glentoran,9456,8,9,9,12,32,43,-11,36
Ards,9456,9,9,5,16,38,51,-13,32
Portadown,9456,10,8,6,16,29,48,-19,30
Ballinamalla,9456,11,7,5,18,32,54,-22,26
Crusaders,9457,1,21,5,4,62,28,34,68
Cliftonville,9457,2,17,4,9,55,39,16,55
Ballymena,9457,3,15,6,9,67,60,7,51
Glenavon,9457,4,12,12,6,49,40,9,48
Coleraine,9457,5,12,8,10,41,33,8,44
Linfield,9457,6,11,8,11,53,42,11,41
Glentoran,9457,7,10,7,13,35,45,-10,37
Dungannon,9457,8,6,11,13,46,49,-3,29
Portadown,9457,9,7,8,15,28,51,-23,29
Ards,9457,10,8,4,18,38,60,-22,28
Ballinamalla,9457,11,6,7,17,29,56,-27,25
Linfield,9458,1,17,8,5,62,29,33,59
Crusaders,9458,2,13,10,7,51,39,12,49
Cliftonville,9458,3,13,10,7,49,37,12,49
Ballymena,9458,4,12,8,10,55,55,0,44
Glenavon,9458,5,10,13,7,45,42,3,43
Dungannon,9458,6,11,9,10,47,39,8,42
Coleraine,9458,7,10,11,9,42,41,1,41
Glentoran,9458,8,10,8,12,39,44,-5,38
Ards,9458,9,8,5,17,37,50,-13,29
Portadown,9458,10,8,4,18,27,54,-27,28
Ballinamalla,9458,11,7,6,17,29,53,-24,27
Crusaders,9459,1,16,9,5,59,31,28,57
Linfield,9459,2,14,9,7,66,37,29,51
Cliftonville,9459,3,15,4,11,52,38,14,49
Dungannon,9459,4,13,7,10,58,48,10,46
Coleraine,9459,5,11,13,6,48,40,8,46
Ballymena,9459,6,12,6,12,55,63,-8,42
Glenavon,9459,7,9,11,10,44,48,-4,38
Glentoran,9459,8,11,5,14,31,46,-15,38
Ballinamalla,9459,9,9,5,16,34,57,-23,32
Ards,9459,10,7,7,16,31,48,-17,28
Portadown,9459,11,8,4,18,29,51,-22,28
Ballymena,9460,1,17,7,6,61,49,12,58
Cliftonville,9460,2,15,5,10,45,38,7,50
Linfield,9460,3,13,10,7,58,32,26,49
Crusaders,9460,4,11,11,8,40,33,7,44
Coleraine,9460,5,12,8,10,51,48,3,44
Dungannon,9460,6,11,9,10,52,43,9,42
Glenavon,9460,7,11,9,10,48,43,5,42
Glentoran,9460,8,10,8,12,32,42,-10,38
Ards,9460,9,8,7,15,38,51,-13,31
Portadown,9460,10,6,9,15,24,47,-23,27
Ballinamalla,9460,11,6,7,17,26,49,-23,25
Crusaders,9461,1,19,7,4,62,31,31,64
Ballymena,9461,2,15,7,8,63,56,7,52
Glenavon,9461,3,12,10,8,47,39,8,46
Glentoran,9461,4,11,10,9,37,40,-3,43
Linfield,9461,5,10,11,9,54,40,14,41
Coleraine,9461,6,10,11,9,41,40,1,41
Cliftonville,9461,7,11,6,13,53,50,3,39
Ards,9461,8,11,4,15,41,54,-13,37
Dungannon,9461,9,7,12,11,53,53,0,33
Portadown,9461,10,8,6,16,21,41,-20,30
Ballinamalla,9461,11,8,2,20,31,59,-28,26
Linfield,9462,1,15,11,4,66,30,36,56
Cliftonville,9462,2,16,4,10,59,41,18,52
Crusaders,9462,3,14,7,9,52,34,18,49
Dungannon,9462,4,13,10,7,53,37,16,49
Glenavon,9462,5,13,7,10,50,45,5,46
Ballymena,9462,6,13,7,10,55,55,0,46
Coleraine,9462,7,10,10,10,46,48,-2,40
Glentoran,9462,8,9,8,13,36,52,-16,35
Ards,9462,9,9,6,15,38,53,-15,33
Ballinamalla,9462,10,7,7,16,29,49,-20,28
Portadown,9462,11,5,5,20,26,66,-40,20
Crusaders,9463,1,19,6,5,59,31,28,63
Cliftonville,9463,2,16,6,8,52,35,17,54
Linfield,9463,3,15,8,7,57,35,22,53
Ballymena,9463,4,13,9,8,59,57,2,48
Dungannon,9463,5,12,8,10,53,43,10,44
Coleraine,9463,6,11,10,9,41,39,2,43
Glenavon,9463,7,10,10,10,45,48,-3,40
Glentoran,9463,8,9,7,14,34,45,-11,34
Portadown,9463,9,8,7,15,23,41,-18,31
Ards,9463,10,8,3,19,37,46,-9,27
Ballinamalla,9463,11,5,4,21,19,59,-40,19
Crusaders,9464,1,21,6,3,59,29,30,69
Coleraine,9464,2,13,11,6,52,39,13,50
Linfield,9464,3,13,10,7,50,30,20,49
Glenavon,9464,4,11,12,7,42,38,4,45
Ballymena,9464,5,12,7,11,54,53,1,43
Dungannon,9464,6,11,8,11,49,41,8,41
Cliftonville,9464,7,12,4,14,39,42,-3,40
Ards,9464,8,9,7,14,40,44,-4,34
Glentoran,9464,9,7,10,13,26,44,-18,31
Ballinamalla,9464,10,7,6,17,28,51,-23,27
Portadown,9464,11,6,5,19,27,55,-28,23
Crusaders,9465,1,17,7,6,56,33,23,58
Cliftonville,9465,2,17,5,8,59,36,23,56
Linfield,9465,3,16,6,8,57,31,26,54
Ballymena,9465,4,14,8,8,64,54,10,50
Coleraine,9465,5,10,12,8,39,37,2,42
Glenavon,9465,6,10,12,8,43,48,-5,42
Glentoran,9465,7,8,12,10,32,42,-10,36
Dungannon,9465,8,7,10,13,42,47,-5,31
Ballinamalla,9465,9,9,3,18,37,54,-17,30
Ards,9465,10,7,6,17,35,52,-17,27
Portadown,9465,11,7,5,18,24,54,-30,26
Crusaders,9466,1,19,7,4,59,35,24,64
Linfield,9466,2,16,8,6,61,33,28,56
Coleraine,9466,3,13,9,8,44,34,10,48
Glenavon,9466,4,12,10,8,52,48,4,46
Cliftonville,9466,5,14,3,13,49,44,5,45
Ballymena,9466,6,12,5,13,55,57,-2,41
Dungannon,9466,7,9,9,12,54,49,5,36
Ards,9466,8,10,5,15,40,50,-10,35
Ballinamalla,9466,9,8,7,15,31,49,-18,31
Glentoran,9466,10,7,10,13,26,45,-19,31
Portadown,9466,11,5,7,18,23,50,-27,22
Linfield,9467,1,15,11,4,58,29,29,56
Crusaders,9467,2,13,13,4,55,33,22,52
Cliftonville,9467,3,14,9,7,53,33,20,51
Ballymena,9467,4,14,8,8,59,55,4,50
Glenavon,9467,5,11,13,6,45,41,4,46
Dungannon,9467,6,11,8,11,48,45,3,41
Coleraine,9467,7,10,11,9,41,42,-1,41
Ards,9467,8,11,4,15,40,49,-9,37
Glentoran,9467,9,7,11,12,24,39,-15,32
Portadown,9467,10,7,4,19,22,45,-23,25
Ballinamalla,9467,11,4,4,22,25,59,-34,16
Linfield,9468,1,16,7,7,57,28,29,55
Crusaders,9468,2,15,8,7,57,44,13,53
Cliftonville,9468,3,15,7,8,57,41,16,52
Coleraine,9468,4,13,13,4,47,36,11,52
Ballymena,9468,5,14,6,10,60,59,1,48
Dungannon,9468,6,12,8,10,51,37,14,44
Glenavon,9468,7,11,11,8,45,41,4,44
Glentoran,9468,8,8,10,12,30,42,-12,34
Ballinamalla,9468,9,8,3,19,27,53,-26,27
Ards,9468,10,6,5,19,29,50,-21,23
Portadown,9468,11,4,8,18,23,52,-29,20
Crusaders,9469,1,17,9,4,55,26,29,60
Linfield,9469,2,17,8,5,62,27,35,59
Cliftonville,9469,3,15,6,9,49,35,14,51
Dungannon,9469,4,11,11,8,55,38,17,44
Glenavon,9469,5,9,16,5,42,40,2,43
Ballymena,9469,6,12,7,11,55,63,-8,43
Coleraine,9469,7,10,10,10,38,34,4,40
Ards,9469,8,10,4,16,40,51,-11,34
Glentoran,9469,9,8,7,15,24,53,-29,31
Ballinamalla,9469,10,7,5,18,29,55,-26,26
Portadown,9469,11,4,7,19,19,46,-27,19
Ballymena,9470,1,17,6,7,55,50,5,57
Crusaders,9470,2,16,7,7,56,31,25,55
Cliftonville,9470,3,17,3,10,57,41,16,54
Linfield,9470,4,14,10,6,62,35,27,52
Coleraine,9470,5,10,12,8,46,44,2,42
Glentoran,9470,6,10,10,10,30,35,-5,40
Glenavon,9470,7,10,9,11,51,45,6,39
Dungannon,9470,8,9,9,12,48,47,1,36
Ballinamalla,9470,9,7,7,16,28,52,-24,28
Portadown,9470,10,7,6,17,27,59,-32,27
Ards,9470,11,5,7,18,29,50,-21,22
Linfield,9471,1,15,11,4,63,28,35,56
Crusaders,9471,2,14,9,7,55,33,22,51
Glenavon,9471,3,13,12,5,52,45,7,51
Dungannon,9471,4,12,10,8,53,38,15,46
Coleraine,9471,5,12,10,8,46,39,7,46
Cliftonville,9471,6,11,8,11,47,43,4,41
Ballymena,9471,7,9,11,10,47,53,-6,38
Glentoran,9471,8,8,9,13,28,46,-18,33
Ards,9471,9,9,4,17,32,50,-18,31
Portadown,9471,10,7,7,16,28,49,-21,28
Ballinamalla,9471,11,7,5,18,28,55,-27,26
Linfield,9472,1,16,7,7,61,35,26,55
Cliftonville,9472,2,17,4,9,54,39,15,55
Crusaders,9472,3,14,12,4,60,36,24,54
Ballymena,9472,4,16,4,10,59,52,7,52
Dungannon,9472,5,10,10,10,55,45,10,40
Glenavon,9472,6,9,13,8,45,44,1,40
Coleraine,9472,7,9,9,12,41,45,-4,36
Ards,9472,8,10,6,14,40,46,-6,36
Glentoran,9472,9,9,8,13,33,47,-14,35
Ballinamalla,9472,10,8,5,17,31,54,-23,29
Portadown,9472,11,7,2,21,24,60,-36,23
Cliftonville,9473,1,16,5,9,58,39,19,53
Linfield,9473,2,14,10,6,58,30,28,52
Ballymena,9473,3,16,4,10,63,62,1,52
Crusaders,9473,4,13,10,7,54,39,15,49
Coleraine,9473,5,12,13,5,49,37,12,49
Glenavon,9473,6,9,14,7,48,48,0,41
Dungannon,9473,7,10,10,10,54,56,-2,40
Portadown,9473,8,8,6,16,29,46,-17,30
Glentoran,9473,9,7,9,14,27,44,-17,30
Ards,9473,10,7,7,16,34,47,-13,28
Ballinamalla,9473,11,7,4,19,29,55,-26,25
Crusaders,9474,1,17,6,7,53,37,16,57
Cliftonville,9474,2,16,6,8,56,35,21,54
Coleraine,9474,3,14,11,5,46,32,14,53
Linfield,9474,4,14,8,8,58,34,24,50
Glenavon,9474,5,11,12,7,56,45,11,45
Dungannon,9474,6,11,8,11,55,48,7,41
Ballymena,9474,7,12,5,13,53,63,-10,41
Portadown,9474,8,9,8,13,34,44,-10,35
Ards,9474,9,7,7,16,38,51,-13,28
Ballinamalla,9474,10,7,7,16,30,58,-28,28
Glentoran,9474,11,4,8,18,21,53,-32,20
Crusaders,9475,1,20,5,5,56,26,30,65
Linfield,9475,2,12,15,3,54,27,27,51
Cliftonville,9475,3,14,5,11,49,45,4,47
Coleraine,9475,4,11,10,9,44,38,6,43
Ballymena,9475,5,12,7,11,56,59,-3,43
Dungannon,9475,6,11,8,11,44,38,6,41
Ards,9475,7,10,6,14,37,47,-10,36
Glenavon,9475,8,9,8,13,46,56,-10,35
Ballinamalla,9475,9,10,4,16,37,50,-13,34
Portadown,9475,10,7,8,15,23,43,-20,29
Glentoran,9475,11,6,10,14,23,40,-17,28
Crusaders,9476,1,20,6,4,59,25,34,66
Ballymena,9476,2,17,4,9,57,55,2,55
Linfield,9476,3,15,7,8,59,33,26,52
Coleraine,9476,4,13,9,8,42,33,9,48
Dungannon,9476,5,12,9,9,56,44,12,45
Cliftonville,9476,6,12,5,13,53,46,7,41
Glenavon,9476,7,10,9,11,49,52,-3,39
Glentoran,9476,8,9,7,14,29,46,-17,34
Portadown,9476,9,8,6,16,23,40,-17,30
Ards,9476,10,8,4,18,35,54,-19,28
Ballinamalla,9476,11,5,6,19,31,65,-34,21
Ballymena,9477,1,18,4,8,67,53,14,58
Crusaders,9477,2,15,8,7,52,37,15,53
Cliftonville,9477,3,14,7,9,48,35,13,49
Linfield,9477,4,12,11,7,54,33,21,47
Dungannon,9477,5,12,11,7,59,42,17,47
Coleraine,9477,6,10,12,8,39,37,2,42
Glenavon,9477,7,9,10,11,45,50,-5,37
Ards,9477,8,10,7,13,42,51,-9,37
Glentoran,9477,9,7,8,15,25,52,-27,29
Portadown,9477,10,6,8,16,30,47,-17,26
Ballinamalla,9477,11,7,4,19,27,51,-24,25
Crusaders,9478,1,17,11,2,56,31,25,62
Ballymena,9478,2,14,7,9,61,55,6,49
Dungannon,9478,3,12,10,8,53,39,14,46
Cliftonville,9478,4,12,9,9,49,39,10,45
Glentoran,9478,5,13,5,12,39,42,-3,44
Linfield,9478,6,11,10,9,50,33,17,43
Coleraine,9478,7,11,10,9,49,46,3,43
Ards,9478,8,10,8,12,45,48,-3,38
Glenavon,9478,9,5,13,12,41,53,-12,28
Ballinamalla,9478,10,7,7,16,26,47,-21,28
Portadown,9478,11,4,8,18,19,55,-36,20
Linfield,9479,1,17,8,5,62,28,34,59
Crusaders,9479,2,16,7,7,52,33,19,55
Ballymena,9479,3,16,5,9,64,54,10,53
Dungannon,9479,4,13,8,9,54,39,15,47
Cliftonville,9479,5,13,6,11,54,45,9,45
Coleraine,9479,6,11,10,9,37,36,1,43
Glenavon,9479,7,10,12,8,45,44,1,42
Glentoran,9479,8,9,5,16,28,52,-24,32
Ards,9479,9,9,2,19,32,53,-21,29
Portadown,9479,10,7,6,17,21,44,-23,27
Ballinamalla,9479,11,7,5,18,31,52,-21,26
Linfield,9480,1,17,8,5,59,24,35,59
Cliftonville,9480,2,13,10,7,57,40,17,49
Glenavon,9480,3,11,15,4,50,39,11,48
Crusaders,9480,4,12,11,7,47,37,10,47
Ballymena,9480,5,13,6,11,59,66,-7,45
Dungannon,9480,6,10,9,11,56,48,8,39
Coleraine,9480,7,9,10,11,37,44,-7,37
Glentoran,9480,8,9,7,14,32,47,-15,34
Ards,9480,9,8,8,14,44,56,-12,32
Ballinamalla,9480,10,7,9,14,30,47,-17,30
Portadown,9480,11,6,7,17,28,51,-23,25
Linfield,9481,1,16,9,5,61,29,32,57
Crusaders,9481,2,17,5,8,52,35,17,56
Coleraine,9481,3,13,11,6,48,37,11,50
Glenavon,9481,4,12,11,7,53,43,10,47
Cliftonville,9481,5,13,7,10,55,42,13,46
Ballymena,9481,6,13,5,12,53,62,-9,44
Dungannon,9481,7,9,10,11,46,46,0,37
Portadown,9481,8,10,4,16,29,41,-12,34
Ballinamalla,9481,9,10,4,16,29,48,-19,34
Ards,9481,10,7,5,18,34,53,-19,26
Glentoran,9481,11,6,7,17,22,46,-24,25
Crusaders,9482,1,18,7,5,56,30,26,61
Ballymena,9482,2,15,8,7,68,52,16,53
Cliftonville,9482,3,15,6,9,52,38,14,51
Linfield,9482,4,12,12,6,61,36,25,48
Glenavon,9482,5,11,11,8,51,48,3,44
Coleraine,9482,6,11,10,9,42,39,3,43
Dungannon,9482,7,7,12,11,51,48,3,33
Ards,9482,8,8,6,16,36,54,-18,30
Glentoran,9482,9,7,8,15,29,52,-23,29
Ballinamalla,9482,10,9,2,19,27,63,-36,29
Portadown,9482,11,5,12,13,24,37,-13,27
Cliftonville,9483,1,18,4,8,57,36,21,58
Crusaders,9483,2,16,7,7,52,37,15,55
Ballymena,9483,3,14,8,8,57,58,-1,50
Linfield,9483,4,13,7,10,55,34,21,46
Glenavon,9483,5,10,13,7,47,45,2,43
Coleraine,9483,6,10,12,8,46,44,2,42
Portadown,9483,7,12,3,15,35,44,-9,39
Glentoran,9483,8,10,8,12,35,46,-11,38
Dungannon,9483,9,8,8,14,45,46,-1,32
Ards,9483,10,9,4,17,45,55,-10,31
Ballinamalla,9483,11,7,2,21,31,60,-29,23
Crusaders,9484,1,18,7,5,66,35,31,61
Linfield,9484,2,15,11,4,65,31,34,56
Cliftonville,9484,3,14,8,8,53,44,9,50
Ballymena,9484,4,14,8,8,62,58,4,50
Dungannon,9484,5,11,9,10,62,51,11,42
Coleraine,9484,6,10,10,10,40,39,1,40
Glenavon,9484,7,10,10,10,40,49,-9,40
Glentoran,9484,8,8,8,14,27,40,-13,32
Ards,9484,9,8,7,15,40,52,-12,31
Portadown,9484,10,7,8,15,28,44,-16,29
Ballinamalla,9484,11,5,4,21,22,62,-40,19
Crusaders,9485,1,20,6,4,63,28,35,66
Linfield,9485,2,19,7,4,67,28,39,64
Cliftonville,9485,3,17,6,7,54,32,22,57
Ballymena,9485,4,13,6,11,53,61,-8,45
Coleraine,9485,5,9,11,10,36,44,-8,38
Dungannon,9485,6,8,11,11,48,43,5,35
Glenavon,9485,7,7,14,9,38,46,-8,35
Ards,9485,8,8,7,15,34,44,-10,31
Glentoran,9485,9,7,9,14,34,49,-15,30
Portadown,9485,10,7,6,17,24,43,-19,27
Ballinamalla,9485,11,6,5,19,28,61,-33,23
Cliftonville,9486,1,19,4,7,64,39,25,61
Linfield,9486,2,16,10,4,61,28,33,58
Ballymena,9486,3,14,4,12,58,63,-5,46
Glenavon,9486,4,11,12,7,45,43,2,45
Crusaders,9486,5,12,8,10,48,37,11,44
Coleraine,9486,6,11,9,10,40,34,6,42
Dungannon,9486,7,11,9,10,46,41,5,42
Glentoran,9486,8,8,10,12,34,49,-15,34
Ballinamalla,9486,9,9,3,18,37,56,-19,30
Ards,9486,10,7,7,16,36,51,-15,28
Portadown,9486,11,7,4,19,22,50,-28,25
Linfield,9487,1,15,9,6,60,29,31,54
Glenavon,9487,2,15,9,6,49,39,10,54
Crusaders,9487,3,15,6,9,52,33,19,51
Cliftonville,9487,4,16,3,11,56,47,9,51
Ballymena,9487,5,14,7,9,56,54,2,49
Dungannon,9487,6,12,10,8,50,43,7,46
Coleraine,9487,7,11,9,10,34,35,-1,42
Ards,9487,8,10,5,15,39,49,-10,35
Glentoran,9487,9,9,7,14,29,44,-15,34
Portadown,9487,10,7,4,19,20,43,-23,25
Ballinamalla,9487,11,4,5,21,29,58,-29,17
Cliftonville,9488,1,17,4,9,53,40,13,55
Crusaders,9488,2,15,8,7,52,38,14,53
Linfield,9488,3,14,10,6,59,29,30,52
Dungannon,9488,4,13,8,9,55,38,17,47
Ballymena,9488,5,13,8,9,58,57,1,47
Coleraine,9488,6,11,10,9,42,35,7,43
Glenavon,9488,7,9,13,8,44,47,-3,40
Ballinamalla,9488,8,9,7,14,30,47,-17,34
Ards,9488,9,8,6,16,34,48,-14,30
Glentoran,9488,10,7,7,16,30,50,-20,28
Portadown,9488,11,6,5,19,19,47,-28,23
Crusaders,9489,1,18,9,3,62,32,30,63
Linfield,9489,2,18,7,5,64,28,36,61
Cliftonville,9489,3,14,7,9,52,40,12,49
Coleraine,9489,4,12,10,8,42,34,8,46
Ballymena,9489,5,12,6,12,56,63,-7,42
Dungannon,9489,6,10,10,10,46,41,5,40
Glenavon,9489,7,10,8,12,44,54,-10,38
Ballinamalla,9489,8,11,2,17,33,47,-14,35
Glentoran,9489,9,8,8,14,31,48,-17,32
Ards,9489,10,8,6,16,38,53,-15,30
Portadown,9489,11,6,3,21,23,51,-28,21
Crusaders,9490,1,16,8,6,50,30,20,56
Linfield,9490,2,15,9,6,59,30,29,54
Coleraine,9490,3,13,10,7,51,43,8,49
Ballymena,9490,4,12,12,6,56,54,2,48
Cliftonville,9490,5,13,7,10,49,35,14,46
Glenavon,9490,6,12,9,9,55,49,6,45
Ards,9490,7,12,5,13,44,48,-4,41
Dungannon,9490,8,10,10,10,47,42,5,40
Glentoran,9490,9,9,7,14,29,47,-18,34
Ballinamalla,9490,10,7,3,20,28,56,-28,24
Portadown,9490,11,4,4,22,19,53,-34,16
Crusaders,9491,1,19,6,5,62,32,30,63
Cliftonville,9491,2,18,3,9,56,36,20,57
Linfield,9491,3,16,8,6,64,32,32,56
Glenavon,9491,4,13,11,6,46,38,8,50
Ballymena,9491,5,15,4,11,60,53,7,49
Coleraine,9491,6,12,9,9,36,37,-1,45
Dungannon,9491,7,9,10,11,45,45,0,37
Glentoran,9491,8,7,6,17,21,46,-25,27
Portadown,9491,9,6,8,16,23,46,-23,26
Ballinamalla,9491,10,6,6,18,23,47,-24,24
Ards,9491,11,6,5,19,33,57,-24,23
Crusaders,9492,1,16,9,5,57,32,25,57
Linfield,9492,2,15,8,7,55,29,26,53
Glenavon,9492,3,14,10,6,59,45,14,52
Ballymena,9492,4,14,5,11,56,52,4,47
Cliftonville,9492,5,13,5,12,43,40,3,44
Coleraine,9492,6,11,11,8,40,42,-2,44
Dungannon,9492,7,11,10,9,49,40,9,43
Ards,9492,8,10,3,17,34,47,-13,33
Portadown,9492,9,9,5,16,28,48,-20,32
Glentoran,9492,10,7,7,16,28,49,-21,28
Ballinamalla,9492,11,7,3,20,26,51,-25,24
Cliftonville,9493,1,16,8,6,63,40,23,56
Crusaders,9493,2,15,9,6,56,38,18,54
Glenavon,9493,3,13,11,6,50,38,12,50
Linfield,9493,4,11,12,7,52,34,18,45
Coleraine,9493,5,11,10,9,42,37,5,43
Glentoran,9493,6,11,8,11,40,42,-2,41
Ballymena,9493,7,10,7,13,51,65,-14,37
Dungannon,9493,8,9,9,12,45,47,-2,36
Portadown,9493,9,9,5,16,29,48,-19,32
Ards,9493,10,9,3,18,33,50,-17,30
Ballinamalla,9493,11,8,4,18,31,53,-22,28
Linfield,9494,1,18,7,5,61,27,34,61
Crusaders,9494,2,16,9,5,53,30,23,57
Glenavon,9494,3,14,12,4,55,40,15,54
Ballymena,9494,4,13,8,9,58,53,5,47
Dungannon,9494,5,11,10,9,55,42,13,43
Coleraine,9494,6,12,7,11,42,42,0,43
Cliftonville,9494,7,12,4,14,41,42,-1,40
Glentoran,9494,8,8,7,15,24,46,-22,31
Ards,9494,9,8,5,17,35,54,-19,29
Portadown,9494,10,7,5,18,28,54,-26,26
Ballinamalla,9494,11,6,6,18,30,52,-22,24
Crusaders,9495,1,18,6,6,63,36,27,60
Linfield,9495,2,14,8,8,58,32,26,50
Coleraine,9495,3,13,9,8,47,38,9,48
Cliftonville,9495,4,14,4,12,54,45,9,46
Dungannon,9495,5,11,9,10,53,45,8,42
Glenavon,9495,6,11,9,10,47,51,-4,42
Ballymena,9495,7,13,3,14,52,59,-7,42
Ballinamalla,9495,8,11,3,16,36,48,-12,36
Portadown,9495,9,10,6,14,31,43,-12,36
Glentoran,9495,10,9,6,15,27,49,-22,33
Ards,9495,11,7,5,18,29,51,-22,26
Crusaders,9496,1,15,12,3,57,34,23,57
Cliftonville,9496,2,18,3,9,56,37,19,57
Linfield,9496,3,13,10,7,60,38,22,49
Glenavon,9496,4,13,10,7,47,38,9,49
Ballymena,9496,5,13,4,13,56,61,-5,43
Coleraine,9496,6,11,9,10,40,35,5,42
Dungannon,9496,7,10,11,9,49,44,5,41
Ards,9496,8,7,9,14,39,51,-12,30
Glentoran,9496,9,6,12,12,28,44,-16,30
Ballinamalla,9496,10,7,5,18,30,54,-24,26
Portadown,9496,11,7,5,18,27,53,-26,26
Crusaders,9497,1,18,7,5,63,38,25,61
Cliftonville,9497,2,17,5,8,58,40,18,56
Linfield,9497,3,14,9,7,53,29,24,51
Ards,9497,4,14,4,12,43,41,2,46
Coleraine,9497,5,12,9,9,43,39,4,45
Glenavon,9497,6,11,8,11,51,50,1,41
Ballymena,9497,7,11,6,13,58,67,-9,39
Glentoran,9497,8,10,7,13,35,44,-9,37
Portadown,9497,9,8,7,15,25,41,-16,31
Dungannon,9497,10,6,10,14,42,46,-4,28
Ballinamalla,9497,11,4,8,18,28,64,-36,20
Linfield,9498,1,14,11,5,65,33,32,53
Crusaders,9498,2,14,11,5,48,27,21,53
Coleraine,9498,3,14,9,7,52,37,15,51
Cliftonville,9498,4,14,6,10,49,38,11,48
Ballymena,9498,5,13,7,10,50,55,-5,46
Glenavon,9498,6,10,13,7,47,43,4,43
Portadown,9498,7,10,6,14,36,50,-14,36
Dungannon,9498,8,8,10,12,47,44,3,34
Glentoran,9498,9,8,8,14,24,42,-18,32
Ballinamalla,9498,10,7,7,16,23,47,-24,28
Ards,9498,11,7,4,19,32,57,-25,25
Crusaders,9499,1,19,8,3,65,30,35,65
Cliftonville,9499,2,14,6,10,51,38,13,48
Ballymena,9499,3,14,5,11,56,56,0,47
Linfield,9499,4,12,10,8,52,32,20,46
Coleraine,9499,5,12,10,8,41,38,3,46
Glenavon,9499,6,9,15,6,50,48,2,42
Dungannon,9499,7,10,8,12,52,46,6,38
Glentoran,9499,8,9,10,11,35,42,-7,37
Ards,9499,9,8,6,16,37,54,-17,30
Ballinamalla,9499,10,6,8,16,29,57,-28,26
Portadown,9499,11,6,6,18,19,46,-27,24
Cliftonville,9500,1,18,5,7,65,38,27,59
Glenavon,9500,2,14,11,5,51,38,13,53
Ballymena,9500,3,16,4,10,59,53,6,52
Linfield,9500,4,13,9,8,56,34,22,48
Crusaders,9500,5,13,8,9,51,45,6,47
Coleraine,9500,6,12,8,10,44,41,3,44
Ballinamalla,9500,7,11,2,17,35,50,-15,35
Glentoran,9500,8,10,5,15,31,49,-18,35
Ards,9500,9,10,4,16,35,46,-11,34
Dungannon,9500,10,7,10,13,43,49,-6,31
Portadown,9500,11,6,4,20,27,54,-27,22
Crusaders,9501,1,18,8,4,60,31,29,62
Ballymena,9501,2,14,7,9,55,54,1,49
Cliftonville,9501,3,15,3,12,53,42,11,48
Coleraine,9501,4,12,12,6,51,41,10,48
Linfield,9501,5,12,10,8,56,37,19,46
Glenavon,9501,6,11,11,8,47,47,0,44
Glentoran,9501,7,12,4,14,33,40,-7,40
Dungannon,9501,8,9,6,15,40,46,-6,33
Ards,9501,9,7,9,14,38,49,-11,30
Portadown,9501,10,8,6,16,22,42,-20,30
Ballinamalla,9501,11,6,6,18,27,53,-26,24
Linfield,9502,1,17,9,4,55,23,32,60
Cliftonville,9502,2,18,5,7,57,28,29,59
Crusaders,9502,3,15,7,8,53,37,16,52
Ballymena,9502,4,12,9,9,58,63,-5,45
Coleraine,9502,5,11,9,10,45,44,1,42
Dungannon,9502,6,11,8,11,45,44,1,41
Portadown,9502,7,11,8,11,34,39,-5,41
Glenavon,9502,8,7,14,9,41,48,-7,35
Ards,9502,9,7,6,17,35,48,-13,27
Ballinamalla,9502,10,8,3,19,31,53,-22,27
Glentoran,9502,11,5,8,17,23,50,-27,23
Cliftonville,9503,1,16,4,10,50,35,15,52
Crusaders,9503,2,15,6,9,55,41,14,51
Dungannon,9503,3,14,7,9,57,40,17,49
Coleraine,9503,4,13,9,8,46,43,3,48
Linfield,9503,5,12,11,7,55,36,19,47
Ballymena,9503,6,14,5,11,54,53,1,47
Glenavon,9503,7,11,10,9,40,41,-1,43
Glentoran,9503,8,10,7,13,30,39,-9,37
Ards,9503,9,8,9,13,37,47,-10,33
Ballinamalla,9503,10,7,5,18,30,54,-24,26
Portadown,9503,11,6,5,19,21,46,-25,23
Linfield,9504,1,15,9,6,61,32,29,54
Crusaders,9504,2,16,6,8,55,34,21,54
Cliftonville,9504,3,15,4,11,53,43,10,49
Glenavon,9504,4,11,13,6,48,41,7,46
Coleraine,9504,5,11,12,7,40,32,8,45
Ballymena,9504,6,13,6,11,55,58,-3,45
Glentoran,9504,7,10,8,12,31,39,-8,38
Dungannon,9504,8,9,8,13,49,52,-3,35
Ards,9504,9,9,5,16,40,54,-14,32
Portadown,9504,10,8,6,16,34,52,-18,30
Ballinamalla,9504,11,7,5,18,31,60,-29,26
Crusaders,9505,1,16,8,6,62,40,22,56
Cliftonville,9505,2,16,7,7,52,36,16,55
Linfield,9505,3,12,12,6,60,34,26,48
Glenavon,9505,4,11,9,10,51,48,3,42
Ballymena,9505,5,11,7,12,48,60,-12,40
Dungannon,9505,6,10,8,12,54,47,7,38
Coleraine,9505,7,8,12,10,39,41,-2,36
Glentoran,9505,8,9,8,13,32,43,-11,35
Ards,9505,9,9,7,14,33,45,-12,34
Portadown,9505,10,9,6,15,33,48,-15,33
Ballinamalla,9505,11,9,6,15,34,56,-22,33
Crusaders,9506,1,18,7,5,66,31,35,61
Linfield,9506,2,17,7,6,59,29,30,58
Cliftonville,9506,3,17,4,9,63,45,18,55
Coleraine,9506,4,10,13,7,39,31,8,43
Ballymena,9506,5,12,6,12,50,63,-13,42
Glenavon,9506,6,10,11,9,47,44,3,41
Dungannon,9506,7,9,13,8,48,43,5,40
Ards,9506,8,10,5,15,43,56,-13,35
Glentoran,9506,9,6,9,15,27,44,-17,27
Portadown,9506,10,7,6,17,23,44,-21,27
Ballinamalla,9506,11,6,5,19,27,62,-35,23
Crusaders,9507,1,18,7,5,54,31,23,61
Linfield,9507,2,16,10,4,66,27,39,58
Ballymena,9507,3,18,4,8,63,56,7,58
Cliftonville,9507,4,15,6,9,60,46,14,51
Coleraine,9507,5,11,11,8,46,35,11,44
Dungannon,9507,6,9,10,11,45,43,2,37
Glenavon,9507,7,8,10,12,42,49,-7,34
Glentoran,9507,8,8,7,15,27,43,-16,31
Ards,9507,9,7,7,16,31,51,-20,28
Ballinamalla,9507,10,7,5,18,29,54,-25,26
Portadown,9507,11,6,7,17,23,51,-28,25
Linfield,9508,1,16,10,4,66,31,35,58
Cliftonville,9508,2,16,5,9,52,35,17,53
Coleraine,9508,3,14,9,7,42,32,10,51
Crusaders,9508,4,13,10,7,53,37,16,49
Ballymena,9508,5,12,6,12,57,60,-3,42
Dungannon,9508,6,10,9,11,49,44,5,39
Glentoran,9508,7,10,9,11,34,42,-8,39
Glenavon,9508,8,9,10,11,42,51,-9,37
Ards,9508,9,9,4,17,35,50,-15,31
Ballinamalla,9508,10,9,4,17,29,53,-24,31
Portadown,9508,11,6,6,18,22,46,-24,24
Crusaders,9509,1,15,12,3,56,37,19,57
Linfield,9509,2,14,13,3,50,22,28,55
Ballymena,9509,3,14,8,8,55,51,4,50
Glenavon,9509,4,12,11,7,50,45,5,47
Dungannon,9509,5,12,9,9,50,37,13,45
Cliftonville,9509,6,13,6,11,49,43,6,45
Coleraine,9509,7,9,11,10,40,45,-5,38
Ards,9509,8,10,4,16,36,49,-13,34
Portadown,9509,9,7,8,15,26,41,-15,29
Glentoran,9509,10,7,4,19,28,46,-18,25
Ballinamalla,9509,11,6,6,18,29,53,-24,24
Linfield,9510,1,15,11,4,65,30,35,56
Crusaders,9510,2,15,10,5,55,31,24,55
Ballymena,9510,3,12,10,8,60,58,2,46
Coleraine,9510,4,11,12,7,43,36,7,45
Glenavon,9510,5,11,11,8,51,45,6,44
Glentoran,9510,6,12,8,10,34,38,-4,44
Cliftonville,9510,7,12,5,13,51,57,-6,41
Dungannon,9510,8,9,9,12,53,47,6,36
Ards,9510,9,10,5,15,35,52,-17,35
Portadown,9510,10,5,10,15,21,43,-22,25
Ballinamalla,9510,11,6,3,21,31,62,-31,21
Crusaders,9511,1,16,9,5,52,35,17,57
Ballymena,9511,2,16,5,9,62,58,4,53
Cliftonville,9511,3,16,3,11,66,45,21,51
Glenavon,9511,4,12,14,4,57,40,17,50
Linfield,9511,5,13,8,9,60,39,21,47
Coleraine,9511,6,10,10,10,45,44,1,40
Dungannon,9511,7,9,11,10,52,48,4,38
Glentoran,9511,8,9,9,12,31,44,-13,36
Ballinamalla,9511,9,10,3,17,36,52,-16,33
Ards,9511,10,8,7,15,34,54,-20,31
Portadown,9511,11,3,7,20,21,57,-36,16
Linfield,9512,1,16,9,5,62,35,27,57
Ballymena,9512,2,16,6,8,64,57,7,54
Cliftonville,9512,3,15,7,8,55,39,16,52
Glenavon,9512,4,13,12,5,58,45,13,51
Dungannon,9512,5,11,8,11,56,45,11,41
Crusaders,9512,6,11,8,11,43,39,4,41
Coleraine,9512,7,9,11,10,42,48,-6,38
Ards,9512,8,9,7,14,37,47,-10,34
Glentoran,9512,9,8,10,12,29,41,-12,34
Ballinamalla,9512,10,6,7,17,30,51,-21,25
Portadown,9512,11,6,5,19,25,54,-29,23
Linfield,9513,1,17,8,5,69,33,36,59
Crusaders,9513,2,15,8,7,49,32,17,53
Ballymena,9513,3,15,6,9,60,58,2,51
Cliftonville,9513,4,14,8,8,55,40,15,50
Coleraine,9513,5,13,11,6,43,37,6,50
Glentoran,9513,6,13,5,12,37,39,-2,44
Glenavon,9513,7,11,8,11,42,47,-5,41
Ards,9513,8,11,3,16,47,56,-9,36
Dungannon,9513,9,8,8,14,42,46,-4,32
Portadown,9513,10,6,4,20,26,52,-26,22
Ballinamalla,9513,11,6,3,21,28,58,-30,21
Crusaders,9514,1,16,8,6,57,37,20,56
Linfield,9514,2,14,9,7,59,39,20,51
Cliftonville,9514,3,16,3,11,58,38,20,51
Ballymena,9514,4,13,7,10,54,58,-4,46
Glenavon,9514,5,11,11,8,49,44,5,44
Coleraine,9514,6,11,10,9,42,45,-3,43
Dungannon,9514,7,10,12,8,63,50,13,42
Glentoran,9514,8,9,10,11,36,46,-10,37
Ards,9514,9,8,4,18,35,50,-15,28
Portadown,9514,10,8,4,18,27,46,-19,28
Ballinamalla,9514,11,7,6,17,34,61,-27,27
Crusaders,9515,1,18,6,6,61,35,26,60
Linfield,9515,2,15,9,6,56,30,26,54
Ballymena,9515,3,14,8,8,55,56,-1,50
Glenavon,9515,4,12,11,7,48,44,4,47
Coleraine,9515,5,11,11,8,41,37,4,44
Portadown,9515,6,11,7,12,29,36,-7,40
Cliftonville,9515,7,11,4,15,49,47,2,37
Glentoran,9515,8,9,8,13,34,45,-11,35
Dungannon,9515,9,8,9,13,46,47,-1,33
Ards,9515,10,10,3,17,35,48,-13,33
Ballinamalla,9515,11,5,6,19,26,55,-29,21
Linfield,9516,1,17,8,5,67,27,40,59
Crusaders,9516,2,15,8,7,50,33,17,53
Ballymena,9516,3,15,3,12,57,56,1,48
Cliftonville,9516,4,14,5,11,51,36,15,47
Coleraine,9516,5,12,11,7,48,41,7,47
Dungannon,9516,6,11,8,11,52,46,6,41
Glenavon,9516,7,10,11,9,43,43,0,41
Glentoran,9516,8,10,7,13,34,46,-12,37
Ballinamalla,9516,9,8,5,17,30,51,-21,29
Ards,9516,10,8,5,17,37,60,-23,29
Portadown,9516,11,7,5,18,24,54,-30,26
Linfield,9517,1,17,8,5,59,25,34,59
Cliftonville,9517,2,16,6,8,54,37,17,54
Crusaders,9517,3,14,8,8,46,31,15,50
Ballymena,9517,4,14,7,9,62,58,4,49
Dungannon,9517,5,12,8,10,52,41,11,44
Coleraine,9517,6,10,12,8,43,36,7,42
Glenavon,9517,7,10,11,9,46,49,-3,41
Portadown,9517,8,9,6,15,27,46,-19,33
Glentoran,9517,9,7,9,14,25,48,-23,30
Ards,9517,10,7,6,17,38,55,-17,27
Ballinamalla,9517,11,7,3,20,27,53,-26,24
Crusaders,9518,1,16,9,5,54,27,27,57
Linfield,9518,2,14,12,4,66,34,32,54
Coleraine,9518,3,13,12,5,48,38,10,51
Cliftonville,9518,4,14,6,10,50,41,9,48
Ballymena,9518,5,11,10,9,60,61,-1,43
Glenavon,9518,6,8,14,8,40,41,-1,38
Glentoran,9518,7,10,7,13,32,45,-13,37
Dungannon,9518,8,8,12,10,49,44,5,36
Ards,9518,9,7,6,17,37,53,-16,27
Ballinamalla,9518,10,7,6,17,27,52,-25,27
Portadown,9518,11,7,6,17,19,46,-27,27
Linfield,9519,1,16,8,6,70,35,35,56
Cliftonville,9519,2,17,4,9,54,36,18,55
Crusaders,9519,3,16,6,8,55,34,21,54
Coleraine,9519,4,13,10,7,45,40,5,49
Ballymena,9519,5,14,6,10,54,55,-1,48
Glentoran,9519,6,13,7,10,41,43,-2,46
Glenavon,9519,7,10,10,10,49,50,-1,40
Dungannon,9519,8,8,10,12,45,47,-2,34
Ballinamalla,9519,9,6,7,17,24,49,-25,25
Ards,9519,10,5,8,17,32,54,-22,23
Portadown,9519,11,4,10,16,25,51,-26,22
Crusaders,9520,1,16,10,4,58,32,26,58
Linfield,9520,2,16,8,6,61,32,29,56
Cliftonville,9520,3,14,4,12,48,39,9,46
Glenavon,9520,4,10,14,6,53,47,6,44
Ballymena,9520,5,12,6,12,47,53,-6,42
Coleraine,9520,6,10,9,11,41,48,-7,39
Dungannon,9520,7,9,11,10,44,40,4,38
Ards,9520,8,9,7,14,41,49,-8,34
Portadown,9520,9,8,9,13,29,38,-9,33
Glentoran,9520,10,8,6,16,26,53,-27,30
Ballinamalla,9520,11,7,8,15,30,47,-17,29
Crusaders,9521,1,20,7,3,61,30,31,67
Cliftonville,9521,2,18,4,8,60,37,23,58
Ballymena,9521,3,15,8,7,63,55,8,53
Linfield,9521,4,13,10,7,55,33,22,49
Ards,9521,5,10,7,13,40,45,-5,37
Glenavon,9521,6,9,10,11,51,58,-7,37
Dungannon,9521,7,8,9,13,48,44,4,33
Coleraine,9521,8,8,9,13,35,50,-15,33
Glentoran,9521,9,8,8,14,32,49,-17,32
Portadown,9521,10,8,5,17,27,48,-21,29
Ballinamalla,9521,11,7,5,18,31,54,-23,26
Crusaders,9522,1,20,6,4,64,30,34,66
Ballymena,9522,2,15,7,8,62,58,4,52
Linfield,9522,3,14,8,8,53,36,17,50
Coleraine,9522,4,12,11,7,47,33,14,47
Cliftonville,9522,5,14,3,13,49,43,6,45
Glenavon,9522,6,12,9,9,46,45,1,45
Ards,9522,7,12,6,12,47,46,1,42
Glentoran,9522,8,7,10,13,31,52,-21,31
Dungannon,9522,9,7,9,14,42,48,-6,30
Ballinamalla,9522,10,7,5,18,28,48,-20,26
Portadown,9522,11,6,4,20,22,52,-30,22
Crusaders,9523,1,19,8,3,61,32,29,65
Linfield,9523,2,15,12,3,61,30,31,57
Cliftonville,9523,3,13,7,10,48,35,13,46
Ballymena,9523,4,13,6,11,55,57,-2,45
Coleraine,9523,5,10,13,7,40,36,4,43
Glenavon,9523,6,9,11,10,43,47,-4,38
Ards,9523,7,10,6,14,34,44,-10,36
Dungannon,9523,8,9,6,15,48,54,-6,33
Glentoran,9523,9,8,8,14,30,42,-12,32
Ballinamalla,9523,10,9,3,18,38,59,-21,30
Portadown,9523,11,7,6,17,24,46,-22,27
Cliftonville,9524,1,17,5,8,63,38,25,56
Crusaders,9524,2,16,8,6,48,33,15,56
Glenavon,9524,3,12,10,8,51,42,9,46
Ballymena,9524,4,13,6,11,49,53,-4,45
Dungannon,9524,5,12,8,10,53,47,6,44
Coleraine,9524,6,11,10,9,42,39,3,43
Linfield,9524,7,11,9,10,55,36,19,42
Glentoran,9524,8,8,10,12,29,40,-11,34
Ards,9524,9,7,9,14,32,46,-14,30
Portadown,9524,10,6,10,14,24,43,-19,28
Ballinamalla,9524,11,5,9,16,26,55,-29,24
Linfield,9525,1,15,8,7,54,31,23,53
Crusaders,9525,2,15,6,9,61,46,15,51
Coleraine,9525,3,14,7,9,46,36,10,49
Glenavon,9525,4,12,12,6,42,41,1,48
Cliftonville,9525,5,14,4,12,52,45,7,46
Ballymena,9525,6,13,6,11,48,51,-3,45
Dungannon,9525,7,9,11,10,54,45,9,38
Glentoran,9525,8,9,8,13,35,45,-10,35
Portadown,9525,9,9,6,15,26,41,-15,33
Ards,9525,10,7,8,15,38,56,-18,29
Ballinamalla,9525,11,6,8,16,26,45,-19,26
Linfield,9526,1,18,7,5,58,26,32,61
Cliftonville,9526,2,17,4,9,58,40,18,55
Dungannon,9526,3,12,10,8,50,36,14,46
Ballymena,9526,4,14,4,12,57,60,-3,46
Crusaders,9526,5,11,9,10,48,41,7,42
Glenavon,9526,6,10,11,9,48,49,-1,41
Coleraine,9526,7,11,8,11,41,46,-5,41
Ards,9526,8,11,4,15,39,48,-9,37
Portadown,9526,9,8,8,14,29,43,-14,32
Glentoran,9526,10,7,9,14,23,39,-16,30
Ballinamalla,9526,11,6,6,18,30,53,-23,24
Linfield,9527,1,16,6,8,64,29,35,54
Crusaders,9527,2,15,8,7,52,33,19,53
Coleraine,9527,3,14,7,9,47,37,10,49
Glenavon,9527,4,13,10,7,49,43,6,49
Ballymena,9527,5,13,5,12,59,58,1,44
Cliftonville,9527,6,12,7,11,43,41,2,43
Dungannon,9527,7,11,9,10,55,47,8,42
Glentoran,9527,8,11,5,14,30,43,-13,38
Ards,9527,9,9,5,16,40,56,-16,32
Ballinamalla,9527,10,8,5,17,29,55,-26,29
Portadown,9527,11,8,3,19,25,51,-26,27
Crusaders,9528,1,16,8,6,54,34,20,56
Linfield,9528,2,14,10,6,57,38,19,52
Coleraine,9528,3,11,15,4,48,39,9,48
Ballymena,9528,4,13,9,8,60,57,3,48
Dungannon,9528,5,12,9,9,54,45,9,45
Cliftonville,9528,6,11,11,8,52,44,8,44
Glenavon,9528,7,9,13,8,43,42,1,40
Glentoran,9528,8,7,8,15,34,49,-15,29
Ards,9528,9,7,8,15,30,46,-16,29
Ballinamalla,9528,10,8,3,19,32,50,-18,27
Portadown,9528,11,6,8,16,28,48,-20,26
Crusaders,9529,1,15,9,6,57,37,20,54
Ballymena,9529,2,14,8,8,64,53,11,50
Cliftonville,9529,3,15,3,12,56,42,14,48
Coleraine,9529,4,12,11,7,46,37,9,47
Linfield,9529,5,11,10,9,57,40,17,43
Dungannon,9529,6,11,7,12,53,50,3,40
Glentoran,9529,7,10,10,10,30,37,-7,40
Glenavon,9529,8,9,12,9,44,53,-9,39
Ballinamalla,9529,9,9,5,16,32,50,-18,32
Ards,9529,10,8,7,15,35,50,-15,31
Portadown,9529,11,8,4,18,32,57,-25,28
Crusaders,9530,1,16,8,6,51,34,17,56
Cliftonville,9530,2,16,5,9,53,36,17,53
Linfield,9530,3,15,7,8,61,40,21,52
Coleraine,9530,4,12,12,6,44,32,12,48
Glenavon,9530,5,12,11,7,52,43,9,47
Glentoran,9530,6,11,8,11,34,40,-6,41
Dungannon,9530,7,9,9,12,48,46,2,36
Ballymena,9530,8,10,6,14,53,67,-14,36
Ards,9530,9,9,6,15,39,52,-13,33
Portadown,9530,10,8,6,16,31,45,-14,30
Ballinamalla,9530,11,7,2,21,25,56,-31,23
Crusaders,9531,1,18,6,6,56,33,23,60
Ballymena,9531,2,18,3,9,54,47,7,57
Cliftonville,9531,3,17,3,10,56,37,19,54
Linfield,9531,4,13,10,7,48,27,21,49
Glenavon,9531,5,11,10,9,46,44,2,43
Dungannon,9531,6,11,8,11,53,48,5,41
Coleraine,9531,7,10,10,10,34,40,-6,40
Glentoran,9531,8,9,6,15,33,41,-8,33
Ballinamalla,9531,9,9,4,17,30,50,-20,31
Ards,9531,10,8,6,16,34,43,-9,30
Portadown,9531,11,6,4,20,20,54,-34,22
Crusaders,9532,1,18,5,7,60,31,29,59
Linfield,9532,2,15,13,2,59,26,33,58
Cliftonville,9532,3,13,5,12,50,43,7,44
Glenavon,9532,4,11,11,8,51,46,5,44
Coleraine,9532,5,11,11,8,42,44,-2,44
Ballymena,9532,6,12,7,11,54,53,1,43
Glentoran,9532,7,9,8,13,29,43,-14,35
Ballinamalla,9532,8,10,3,17,30,53,-23,33
Dungannon,9532,9,7,10,13,39,41,-2,31
Ards,9532,10,9,4,17,41,52,-11,31
Portadown,9532,11,8,7,15,24,47,-23,31
Linfield,9533,1,14,10,6,56,30,26,52
Ballymena,9533,2,14,8,8,56,56,0,50
Cliftonville,9533,3,14,7,9,48,41,7,49
Crusaders,9533,4,14,6,10,53,37,16,48
Glenavon,9533,5,13,7,10,45,43,2,46
Coleraine,9533,6,8,13,9,38,40,-2,37
Glentoran,9533,7,10,7,13,33,44,-11,37
Ballinamalla,9533,8,12,1,17,37,50,-13,37
Ards,9533,9,10,5,15,40,50,-10,35
Dungannon,9533,10,8,10,12,43,42,1,34
Portadown,9533,11,8,6,16,27,43,-16,30
Crusaders,9534,1,16,8,6,54,31,23,56
Cliftonville,9534,2,17,3,10,55,40,15,54
Ballymena,9534,3,15,6,9,67,56,11,51
Glenavon,9534,4,11,13,6,39,41,-2,46
Linfield,9534,5,12,8,10,53,36,17,44
Dungannon,9534,6,10,10,10,44,39,5,40
Ballinamalla,9534,7,12,4,14,36,42,-6,40
Coleraine,9534,8,10,9,11,43,43,0,39
Portadown,9534,9,9,4,17,25,47,-22,31
Ards,9534,10,7,6,17,39,55,-16,27
Glentoran,9534,11,6,9,15,27,52,-25,27
Crusaders,9535,1,17,8,5,57,29,28,59
Linfield,9535,2,15,9,6,60,27,33,54
Cliftonville,9535,3,14,6,10,52,45,7,48
Glentoran,9535,4,13,8,9,40,42,-2,47
Glenavon,9535,5,12,7,11,55,54,1,43
Coleraine,9535,6,11,10,9,42,43,-1,43
Ballymena,9535,7,11,7,12,52,57,-5,40
Dungannon,9535,8,9,9,12,45,43,2,36
Ballinamalla,9535,9,11,3,16,35,48,-13,36
Portadown,9535,10,8,6,16,26,48,-22,30
Ards,9535,11,6,3,21,35,63,-28,21
Crusaders,9536,1,16,8,6,63,34,29,56
Linfield,9536,2,15,10,5,64,32,32,55
Ballymena,9536,3,13,8,9,57,63,-6,47
Coleraine,9536,4,11,11,8,50,47,3,44
Cliftonville,9536,5,13,4,13,48,47,1,43
Glenavon,9536,6,9,14,7,53,52,1,41
Glentoran,9536,7,10,7,13,28,40,-12,37
Portadown,9536,8,10,5,15,38,48,-10,35
Dungannon,9536,9,7,12,11,46,46,0,33
Ards,9536,10,9,4,17,39,53,-14,31
Ballinamalla,9536,11,8,5,17,35,59,-24,29
Crusaders,9537,1,15,8,7,53,39,14,53
Linfield,9537,2,14,8,8,58,35,23,50
Cliftonville,9537,3,15,5,10,59,47,12,50
Dungannon,9537,4,12,11,7,60,42,18,47
Glenavon,9537,5,11,11,8,51,47,4,44
Coleraine,9537,6,11,11,8,50,48,2,44
Ballymena,9537,7,11,6,13,62,64,-2,39
Glentoran,9537,8,9,7,14,31,47,-16,34
Ards,9537,9,9,6,15,38,51,-13,33
Portadown,9537,10,8,6,16,29,52,-23,30
Ballinamalla,9537,11,8,5,17,29,48,-19,29
Linfield,9538,1,16,10,4,60,28,32,58
Crusaders,9538,2,16,7,7,50,32,18,55
Cliftonville,9538,3,15,8,7,54,37,17,53
Ballymena,9538,4,14,9,7,55,53,2,51
Coleraine,9538,5,11,10,9,35,31,4,43
Dungannon,9538,6,10,8,12,46,45,1,38
Glenavon,9538,7,8,13,9,44,50,-6,37
Ards,9538,8,8,7,15,36,48,-12,31
Ballinamalla,9538,9,7,7,16,25,41,-16,28
Portadown,9538,10,6,9,15,20,42,-22,27
Glentoran,9538,11,6,8,16,33,51,-18,26
Cliftonville,9539,1,19,3,8,56,32,24,60
Linfield,9539,2,14,11,5,59,28,31,53
Crusaders,9539,3,15,7,8,55,36,19,52
Ballymena,9539,4,12,8,10,66,62,4,44
Dungannon,9539,5,10,10,10,48,41,7,40
Coleraine,9539,6,9,13,8,40,41,-1,40
Glenavon,9539,7,8,12,10,41,49,-8,36
Ards,9539,8,9,8,13,38,46,-8,35
Glentoran,9539,9,8,8,14,24,45,-21,32
Portadown,9539,10,8,7,15,23,43,-20,31
Ballinamalla,9539,11,8,3,19,31,58,-27,27
Linfield,9540,1,16,8,6,63,33,30,56
Crusaders,9540,2,15,7,8,49,30,19,52
Glenavon,9540,3,13,11,6,48,40,8,50
Cliftonville,9540,4,13,8,9,47,37,10,47
Coleraine,9540,5,12,8,10,42,40,2,44
Ballymena,9540,6,11,11,8,60,62,-2,44
Portadown,9540,7,10,7,13,29,40,-11,37
Dungannon,9540,8,8,12,10,47,46,1,36
Glentoran,9540,9,8,7,15,29,45,-16,31
Ballinamalla,9540,10,7,6,17,32,51,-19,27
Ards,9540,11,8,3,19,32,54,-22,27
Linfield,9541,1,16,8,6,64,30,34,56
Crusaders,9541,2,15,9,6,56,35,21,54
Glenavon,9541,3,14,10,6,52,42,10,52
Ballymena,9541,4,15,3,12,63,67,-4,48
Cliftonville,9541,5,14,3,13,56,50,6,45
Dungannon,9541,6,12,8,10,60,42,18,44
Coleraine,9541,7,11,10,9,46,45,1,43
Ballinamalla,9541,8,11,3,16,31,53,-22,36
Glentoran,9541,9,9,6,15,31,48,-17,33
Portadown,9541,10,7,5,18,23,49,-26,26
Ards,9541,11,6,5,19,32,53,-21,23
Cliftonville,9542,1,17,5,8,62,41,21,56
Ballymena,9542,2,17,4,9,68,58,10,55
Crusaders,9542,3,14,8,8,53,40,13,50
Ards,9542,4,13,5,12,44,49,-5,44
Glenavon,9542,5,11,10,9,50,49,1,43
Coleraine,9542,6,10,10,10,43,46,-3,40
Linfield,9542,7,10,8,12,51,42,9,38
Glentoran,9542,8,11,5,14,38,53,-15,38
Dungannon,9542,9,9,9,12,42,38,4,36
Portadown,9542,10,8,6,16,30,46,-16,30
Ballinamalla,9542,11,9,2,19,30,49,-19,29
Crusaders,9543,1,20,6,4,64,31,33,66
Ballymena,9543,2,14,7,9,59,57,2,49
Cliftonville,9543,3,14,6,10,48,42,6,48
Linfield,9543,4,12,11,7,57,33,24,47
Coleraine,9543,5,11,10,9,50,49,1,43
Glenavon,9543,6,8,14,8,44,46,-2,38
Dungannon,9543,7,9,9,12,50,50,0,36
Ards,9543,8,11,3,16,32,44,-12,36
Glentoran,9543,9,8,7,15,34,49,-15,31
Portadown,9543,10,8,7,15,28,44,-16,31
Ballinamalla,9543,11,8,4,18,34,55,-21,28
Crusaders,9544,1,17,6,7,55,35,20,57
Linfield,9544,2,15,9,6,63,28,35,54
Dungannon,9544,3,14,8,8,57,38,19,50
Glenavon,9544,4,13,9,8,43,39,4,48
Coleraine,9544,5,11,12,7,48,37,11,45
Ballymena,9544,6,13,6,11,54,59,-5,45
Cliftonville,9544,7,13,4,13,48,44,4,43
Ards,9544,8,10,5,15,36,46,-10,35
Glentoran,9544,9,9,6,15,28,46,-18,33
Ballinamalla,9544,10,7,4,19,24,53,-29,25
Portadown,9544,11,7,3,20,24,55,-31,24
Crusaders,9545,1,21,7,2,67,28,39,70
Linfield,9545,2,14,11,5,63,30,33,53
Cliftonville,9545,3,15,4,11,53,45,8,49
Ballymena,9545,4,13,7,10,53,59,-6,46
Coleraine,9545,5,12,9,9,43,39,4,45
Glenavon,9545,6,10,10,10,44,46,-2,40
Dungannon,9545,7,9,11,10,44,42,2,38
Glentoran,9545,8,8,10,12,35,46,-11,34
Ards,9545,9,8,5,17,38,55,-17,29
Portadown,9545,10,7,5,18,27,50,-23,26
Ballinamalla,9545,11,6,5,19,27,54,-27,23
Linfield,9546,1,17,8,5,58,30,28,59
Ballymena,9546,2,18,4,8,57,46,11,58
Glenavon,9546,3,13,10,7,50,42,8,49
Crusaders,9546,4,13,9,8,53,38,15,48
Cliftonville,9546,5,13,4,13,41,37,4,43
Dungannon,9546,6,10,10,10,51,42,9,40
Ards,9546,7,9,6,15,39,46,-7,33
Ballinamalla,9546,8,9,6,15,32,49,-17,33
Coleraine,9546,9,7,11,12,38,46,-8,32
Portadown,9546,10,9,5,16,26,45,-19,32
Glentoran,9546,11,8,5,17,29,53,-24,29
Crusaders,9547,1,18,9,3,53,25,28,63
Linfield,9547,2,15,9,6,54,29,25,54
Cliftonville,9547,3,16,4,10,53,36,17,52
Glenavon,9547,4,13,9,8,46,40,6,48
Ballymena,9547,5,13,8,9,55,56,-1,47
Coleraine,9547,6,12,9,9,40,36,4,45
Dungannon,9547,7,8,10,12,42,44,-2,34
Ards,9547,8,9,5,16,36,49,-13,32
Ballinamalla,9547,9,9,5,16,28,47,-19,32
Glentoran,9547,10,6,9,15,27,44,-17,27
Portadown,9547,11,5,5,20,21,49,-28,20
Cliftonville,9548,1,18,3,9,53,38,15,57
Linfield,9548,2,16,7,7,61,30,31,55
Ballymena,9548,3,16,5,9,67,60,7,53
Glenavon,9548,4,14,9,7,52,43,9,51
Crusaders,9548,5,13,5,12,49,44,5,44
Coleraine,9548,6,11,10,9,47,38,9,43
Glentoran,9548,7,11,7,12,33,47,-14,40
Dungannon,9548,8,8,9,13,49,51,-2,33
Ards,9548,9,9,5,16,45,57,-12,32
Portadown,9548,10,8,6,16,29,48,-19,30
Ballinamalla,9548,11,6,4,20,31,60,-29,22
Crusaders,9549,1,17,6,7,58,38,20,57
Linfield,9549,2,15,10,5,56,28,28,55
Cliftonville,9549,3,16,4,10,59,42,17,52
Coleraine,9549,4,12,10,8,43,36,7,46
Ballymena,9549,5,13,7,10,54,59,-5,46
Glenavon,9549,6,11,7,12,51,52,-1,40
Dungannon,9549,7,9,11,10,48,43,5,38
Portadown,9549,8,12,2,16,28,37,-9,38
Ards,9549,9,8,6,16,38,50,-12,30
Ballinamalla,9549,10,8,6,16,28,49,-21,30
Glentoran,9549,11,6,7,17,25,54,-29,25
Crusaders,9550,1,18,6,6,54,33,21,60
Ballymena,9550,2,18,4,8,67,57,10,58
Glenavon,9550,3,12,10,8,51,50,1,46
Linfield,9550,4,12,9,9,52,33,19,45
Coleraine,9550,5,10,12,8,44,43,1,42
Dungannon,9550,6,9,12,9,50,42,8,39
Cliftonville,9550,7,11,6,13,44,45,-1,39
Glentoran,9550,8,9,8,13,30,39,-9,35
Ards,9550,9,9,7,14,37,51,-14,34
Portadown,9550,10,8,5,17,24,45,-21,29
Ballinamalla,9550,11,7,5,18,36,51,-15,26
Crusaders,9551,1,18,5,7,59,31,28,59
Linfield,9551,2,14,12,4,61,35,26,54
Cliftonville,9551,3,15,4,11,52,40,12,49
Dungannon,9551,4,13,6,11,47,42,5,45
Glentoran,9551,5,11,9,10,37,40,-3,42
Ballymena,9551,6,12,6,12,55,61,-6,42
Glenavon,9551,7,10,8,12,40,50,-10,38
Coleraine,9551,8,8,13,9,40,39,1,37
Ards,9551,9,9,6,15,36,51,-15,33
Ballinamalla,9551,10,9,4,17,30,49,-19,31
Portadown,9551,11,6,7,17,23,42,-19,25
Crusaders,9552,1,17,6,7,53,33,20,57
Linfield,9552,2,13,11,6,59,31,28,50
Cliftonville,9552,3,15,5,10,46,30,16,50
Coleraine,9552,4,13,10,7,40,33,7,49
Ballymena,9552,5,12,7,11,45,55,-10,43
Ards,9552,6,10,7,13,35,43,-8,37
Glenavon,9552,7,9,9,12,40,46,-6,36
Glentoran,9552,8,8,10,12,33,41,-8,34
Portadown,9552,9,9,7,14,28,43,-15,34
Dungannon,9552,10,8,9,13,43,43,0,33
Ballinamalla,9552,11,7,7,16,26,50,-24,28
Crusaders,9553,1,16,7,7,56,33,23,55
Ballymena,9553,2,17,4,9,62,55,7,55
Glenavon,9553,3,15,9,6,56,44,12,54
Linfield,9553,4,13,9,8,60,35,25,48
Glentoran,9553,5,12,8,10,40,41,-1,44
Coleraine,9553,6,11,9,10,38,36,2,42
Cliftonville,9553,7,11,5,14,44,47,-3,38
Ards,9553,8,11,4,15,36,44,-8,37
Dungannon,9553,9,8,9,13,41,45,-4,33
Portadown,9553,10,8,6,16,28,49,-21,30
Ballinamalla,9553,11,6,4,20,26,58,-32,22
Crusaders,9554,1,20,5,5,58,24,34,65
Cliftonville,9554,2,17,6,7,57,39,18,57
Ballymena,9554,3,15,9,6,63,51,12,54
Linfield,9554,4,12,11,7,55,35,20,47
Coleraine,9554,5,10,11,9,44,43,1,41
Glenavon,9554,6,9,10,11,42,50,-8,37
Glentoran,9554,7,7,10,13,29,45,-16,31
Ards,9554,8,8,7,15,31,50,-19,31
Dungannon,9554,9,6,12,12,44,45,-1,30
Ballinamalla,9554,10,7,7,16,35,55,-20,28
Portadown,9554,11,6,8,16,26,47,-21,26
Crusaders,9555,1,20,6,4,61,31,30,66
Cliftonville,9555,2,18,3,9,61,40,21,57
Glenavon,9555,3,11,14,5,48,41,7,47
Linfield,9555,4,11,9,10,58,41,17,42
Ballymena,9555,5,11,8,11,52,61,-9,41
Coleraine,9555,6,9,11,10,40,44,-4,38
Ards,9555,7,11,4,15,45,51,-6,37
Dungannon,9555,8,8,11,11,49,48,1,35
Glentoran,9555,9,8,9,13,32,44,-12,33
Portadown,9555,10,7,7,16,24,46,-22,28
Ballinamalla,9555,11,8,4,18,28,51,-23,28
Crusaders,9556,1,17,8,5,54,32,22,59
Linfield,9556,2,15,9,6,60,33,27,54
Cliftonville,9556,3,16,2,12,59,49,10,50
Ballymena,9556,4,13,5,12,55,61,-6,44
Glenavon,9556,5,10,11,9,48,43,5,41
Coleraine,9556,6,9,11,10,42,41,1,38
Dungannon,9556,7,9,10,11,49,45,4,37
Ards,9556,8,10,6,14,38,46,-8,36
Glentoran,9556,9,9,9,12,27,45,-18,36
Ballinamalla,9556,10,10,3,17,33,49,-16,33
Portadown,9556,11,6,8,16,31,52,-21,26
Crusaders,9557,1,18,7,5,58,28,30,61
Cliftonville,9557,2,15,6,9,54,37,17,51
Ballymena,9557,3,13,9,8,57,53,4,48
Linfield,9557,4,12,10,8,54,39,15,46
Coleraine,9557,5,10,9,11,44,50,-6,39
Portadown,9557,6,11,6,13,33,42,-9,39
Ballinamalla,9557,7,12,3,15,38,50,-12,39
Glentoran,9557,8,10,7,13,40,48,-8,37
Dungannon,9557,9,9,9,12,43,39,4,36
Ards,9557,10,8,6,16,39,55,-16,30
Glenavon,9557,11,7,8,15,37,56,-19,29
Crusaders,9558,1,14,12,4,54,38,16,54
Ballymena,9558,2,15,6,9,57,55,2,51
Cliftonville,9558,3,15,5,10,56,44,12,50
Glenavon,9558,4,12,10,8,52,41,11,46
Linfield,9558,5,12,9,9,53,36,17,45
Coleraine,9558,6,11,9,10,42,41,1,42
Glentoran,9558,7,10,9,11,29,42,-13,39
Dungannon,9558,8,9,10,11,49,42,7,37
Portadown,9558,9,7,9,14,31,47,-16,30
Ballinamalla,9558,10,7,7,16,30,53,-23,28
Ards,9558,11,7,6,17,36,50,-14,27
Crusaders,9559,1,17,8,5,63,33,30,59
Linfield,9559,2,15,10,5,65,36,29,55
Cliftonville,9559,3,16,2,12,53,46,7,50
Ballymena,9559,4,15,5,10,60,55,5,50
Glenavon,9559,5,11,12,7,44,43,1,45
Coleraine,9559,6,10,9,11,39,44,-5,39
Glentoran,9559,7,10,7,13,30,44,-14,37
Portadown,9559,8,9,5,16,25,40,-15,32
Ards,9559,9,8,7,15,34,46,-12,31
Dungannon,9559,10,7,8,15,40,48,-8,29
Ballinamalla,9559,11,8,5,17,26,44,-18,29
Cliftonville,9560,1,16,5,9,55,37,18,53
Crusaders,9560,2,14,10,6,55,41,14,52
Ballymena,9560,3,13,6,11,53,54,-1,45
Linfield,9560,4,11,11,8,53,34,19,44
Coleraine,9560,5,10,14,6,45,43,2,44
Glenavon,9560,6,9,15,6,40,40,0,42
Dungannon,9560,7,9,12,9,52,42,10,39
Glentoran,9560,8,10,7,13,35,44,-9,37
Ards,9560,9,11,4,15,42,52,-10,37
Portadown,9560,10,5,11,14,24,45,-21,26
Ballinamalla,9560,11,6,7,17,25,47,-22,25
Linfield,9561,1,18,9,3,71,30,41,63
Crusaders,9561,2,17,7,6,51,35,16,58
Coleraine,9561,3,15,10,5,46,33,13,55
Glenavon,9561,4,11,10,9,42,40,2,43
Ballymena,9561,5,11,8,11,55,58,-3,41
Glentoran,9561,6,11,7,12,40,39,1,40
Cliftonville,9561,7,11,6,13,51,50,1,39
Dungannon,9561,8,8,8,14,42,49,-7,32
Ballinamalla,9561,9,8,5,17,34,56,-22,29
Ards,9561,10,7,6,17,38,56,-18,27
Portadown,9561,11,7,6,17,26,50,-24,27
Crusaders,9562,1,17,5,8,47,33,14,56
Linfield,9562,2,14,12,4,59,28,31,54
Cliftonville,9562,3,13,7,10,54,40,14,46
Glenavon,9562,4,10,12,8,45,45,0,42
Coleraine,9562,5,11,8,11,39,44,-5,41
Ballymena,9562,6,10,10,10,51,56,-5,40
Portadown,9562,7,11,6,13,27,39,-12,39
Dungannon,9562,8,9,10,11,47,44,3,37
Ards,9562,9,9,6,15,38,49,-11,33
Glentoran,9562,10,8,8,14,28,46,-18,32
Ballinamalla,9562,11,9,4,17,37,48,-11,31
Crusaders,9563,1,17,7,6,53,29,24,58
Ballymena,9563,2,16,8,6,62,51,11,56
Cliftonville,9563,3,15,6,9,48,35,13,51
Glenavon,9563,4,11,11,8,53,49,4,44
Linfield,9563,5,11,10,9,53,32,21,43
Coleraine,9563,6,9,13,8,37,38,-1,40
Glentoran,9563,7,10,7,13,33,44,-11,37
Dungannon,9563,8,8,9,13,44,51,-7,33
Ards,9563,9,8,9,13,38,47,-9,33
Portadown,9563,10,7,7,16,29,49,-20,28
Ballinamalla,9563,11,6,7,17,27,52,-25,25
Linfield,9564,1,14,9,7,60,35,25,51
Crusaders,9564,2,14,9,7,46,29,17,51
Cliftonville,9564,3,14,7,9,54,39,15,49
Coleraine,9564,4,13,8,9,42,43,-1,47
Glenavon,9564,5,10,11,9,50,50,0,41
Ballymena,9564,6,12,5,13,57,61,-4,41
Dungannon,9564,7,10,10,10,49,44,5,40
Glentoran,9564,8,10,7,13,35,43,-8,37
Ards,9564,9,10,5,15,40,54,-14,35
Portadown,9564,10,8,7,15,28,43,-15,31
Ballinamalla,9564,11,9,4,17,36,56,-20,31
Linfield,9565,1,17,7,6,65,36,29,58
Ballymena,9565,2,15,7,8,63,63,0,52
Cliftonville,9565,3,15,6,9,49,33,16,51
Dungannon,9565,4,12,9,9,53,41,12,45
Crusaders,9565,5,12,8,10,49,44,5,44
Glenavon,9565,6,9,13,8,48,46,2,40
Coleraine,9565,7,8,15,7,40,39,1,39
Glentoran,9565,8,10,8,12,32,37,-5,38
Ballinamalla,9565,9,9,6,15,27,44,-17,33
Ards,9565,10,8,5,17,34,51,-17,29
Portadown,9565,11,5,6,19,26,52,-26,21
Crusaders,9566,1,20,7,3,58,23,35,67
Cliftonville,9566,2,20,3,7,56,29,27,63
Linfield,9566,3,13,9,8,57,38,19,48
Ballymena,9566,4,12,7,11,51,53,-2,43
Dungannon,9566,5,11,9,10,54,43,11,42
Glentoran,9566,6,12,6,12,36,44,-8,42
Glenavon,9566,7,10,11,9,41,39,2,41
Coleraine,9566,8,7,10,13,35,46,-11,31
Ards,9566,9,9,3,18,35,53,-18,30
Portadown,9566,10,7,5,18,24,50,-26,26
Ballinamalla,9566,11,8,2,20,31,60,-29,26
Crusaders,9567,1,18,6,6,62,28,34,60
Linfield,9567,2,14,10,6,60,31,29,52
Cliftonville,9567,3,15,6,9,50,39,11,51
Dungannon,9567,4,13,8,9,53,39,14,47
Ballymena,9567,5,12,8,10,53,57,-4,44
Glenavon,9567,6,11,10,9,49,52,-3,43
Ards,9567,7,12,3,15,45,53,-8,39
Coleraine,9567,8,8,10,12,39,45,-6,34
Glentoran,9567,9,8,9,13,30,43,-13,33
Ballinamalla,9567,10,8,4,18,33,58,-25,28
Portadown,9567,11,7,4,19,21,50,-29,25
Linfield,9568,1,15,12,3,57,21,36,57
Crusaders,9568,2,15,9,6,58,38,20,54
Cliftonville,9568,3,14,9,7,56,40,16,51
Ballymena,9568,4,12,8,10,54,56,-2,44
Coleraine,9568,5,11,10,9,43,44,-1,43
Glenavon,9568,6,9,11,10,39,41,-2,38
Dungannon,9568,7,8,12,10,52,45,7,36
Ards,9568,8,9,7,14,39,50,-11,34
Ballinamalla,9568,9,8,6,16,33,56,-23,30
Glentoran,9568,10,7,8,15,28,48,-20,29
Portadown,9568,11,6,10,14,25,45,-20,28
Crusaders,9569,1,15,10,5,56,32,24,55
Cliftonville,9569,2,16,5,9,55,35,20,53
Linfield,9569,3,15,7,8,62,41,21,52
Ballymena,9569,4,14,6,10,61,62,-1,48
Coleraine,9569,5,12,9,9,44,43,1,45
Dungannon,9569,6,11,6,13,58,53,5,39
Glentoran,9569,7,10,8,12,38,46,-8,38
Glenavon,9569,8,8,10,12,39,52,-13,34
Ards,9569,9,8,8,14,41,50,-9,32
Portadown,9569,10,9,4,17,28,46,-18,31
Ballinamalla,9569,11,8,5,17,32,54,-22,29
Cliftonville,9570,1,16,5,9,59,42,17,53
Crusaders,9570,2,14,10,6,58,32,26,52
Linfield,9570,3,13,9,8,50,34,16,48
Ballymena,9570,4,14,6,10,56,55,1,48
Glenavon,9570,5,11,13,6,47,40,7,46
Coleraine,9570,6,12,10,8,36,36,0,46
Dungannon,9570,7,9,12,9,52,42,10,39
Ards,9570,8,8,7,15,35,48,-13,31
Glentoran,9570,9,7,10,13,28,44,-16,31
Ballinamalla,9570,10,7,10,13,27,44,-17,31
Portadown,9570,11,5,6,19,22,53,-31,21
Linfield,9571,1,17,7,6,56,28,28,58
Ballymena,9571,2,17,5,8,68,58,10,56
Cliftonville,9571,3,16,5,9,60,41,19,53
Glenavon,9571,4,13,11,6,52,44,8,50
Crusaders,9571,5,14,7,9,46,40,6,49
Coleraine,9571,6,10,13,7,43,40,3,43
Dungannon,9571,7,8,13,9,53,45,8,37
Glentoran,9571,8,8,8,14,26,45,-19,32
Ballinamalla,9571,9,9,3,18,33,54,-21,30
Ards,9571,10,8,5,17,41,54,-13,29
Portadown,9571,11,4,5,21,24,53,-29,17
Cliftonville,9572,1,17,4,9,52,31,21,55
Linfield,9572,2,14,11,5,62,36,26,53
Glenavon,9572,3,14,9,7,51,42,9,51
Crusaders,9572,4,14,8,8,50,32,18,50
Ballymena,9572,5,14,5,11,65,60,5,47
Dungannon,9572,6,12,9,9,56,48,8,45
Ards,9572,7,10,6,14,38,48,-10,36
Glentoran,9572,8,8,8,14,28,50,-22,32
Ballinamalla,9572,9,9,4,17,30,48,-18,31
Coleraine,9572,10,6,10,14,32,48,-16,28
Portadown,9572,11,7,6,17,24,45,-21,27
Cliftonville,9573,1,16,5,9,61,45,16,53
Linfield,9573,2,14,8,8,56,30,26,50
Crusaders,9573,3,14,8,8,51,37,14,50
Dungannon,9573,4,13,8,9,56,41,15,47
Glenavon,9573,5,11,11,8,47,43,4,44
Ballymena,9573,6,13,4,13,56,63,-7,43
Coleraine,9573,7,10,8,12,43,48,-5,38
Ards,9573,8,10,5,15,38,50,-12,35
Glentoran,9573,9,9,8,13,25,41,-16,35
Ballinamalla,9573,10,10,3,17,37,50,-13,33
Portadown,9573,11,8,6,16,26,48,-22,30
Linfield,9574,1,18,7,5,68,31,37,61
Cliftonville,9574,2,18,4,8,55,40,15,58
Crusaders,9574,3,16,6,8,60,38,22,54
Dungannon,9574,4,13,8,9,56,41,15,47
Ballymena,9574,5,13,5,12,54,59,-5,44
Coleraine,9574,6,10,9,11,44,42,2,39
Glenavon,9574,7,9,11,10,44,49,-5,38
Ards,9574,8,8,6,16,36,54,-18,30
Ballinamalla,9574,9,8,5,17,31,51,-20,29
Glentoran,9574,10,7,8,15,29,52,-23,29
Portadown,9574,11,7,7,16,24,44,-20,28
Cliftonville,9575,1,17,4,9,55,38,17,55
Ballymena,9575,2,15,6,9,63,55,8,51
Linfield,9575,3,13,10,7,55,33,22,49
Coleraine,9575,4,11,12,7,40,35,5,45
Glenavon,9575,5,11,11,8,46,45,1,44
Crusaders,9575,6,10,12,8,45,38,7,42
Dungannon,9575,7,9,10,11,44,45,-1,37
Glentoran,9575,8,10,7,13,32,44,-12,37
Ballinamalla,9575,9,9,5,16,45,60,-15,32
Ards,9575,10,8,6,16,38,50,-12,30
Portadown,9575,11,9,3,18,25,45,-20,30
Crusaders,9576,1,19,8,3,65,31,34,65
Ballymena,9576,2,17,6,7,56,50,6,57
Cliftonville,9576,3,16,7,7,61,35,26,55
Linfield,9576,4,14,9,7,60,34,26,51
Dungannon,9576,5,11,9,10,52,42,10,42
Coleraine,9576,6,9,12,9,38,39,-1,39
Ards,9576,7,10,3,17,38,55,-17,33
Glenavon,9576,8,6,14,10,37,45,-8,32
Glentoran,9576,9,7,10,13,27,45,-18,31
Ballinamalla,9576,10,6,5,19,22,52,-30,23
Portadown,9576,11,5,7,18,19,47,-28,22
Cliftonville,9577,1,18,3,9,53,34,19,57
Crusaders,9577,2,15,9,6,56,35,21,54
Linfield,9577,3,13,11,6,59,33,26,50
Ballymena,9577,4,13,7,10,59,64,-5,46
Glenavon,9577,5,11,11,8,45,41,4,44
Coleraine,9577,6,11,10,9,41,36,5,43
Dungannon,9577,7,10,8,12,49,49,0,38
Glentoran,9577,8,9,8,13,29,42,-13,35
Ards,9577,9,9,5,16,34,46,-12,32
Portadown,9577,10,8,6,16,23,45,-22,30
Ballinamalla,9577,11,7,4,19,28,51,-23,25
Crusaders,9578,1,18,7,5,58,33,25,61
Ballymena,9578,2,18,5,7,70,53,17,59
Cliftonville,9578,3,17,3,10,59,36,23,54
Linfield,9578,4,14,9,7,59,34,25,51
Coleraine,9578,5,11,10,9,39,39,0,43
Glentoran,9578,6,12,5,13,33,43,-10,41
Dungannon,9578,7,10,9,11,56,49,7,39
Glenavon,9578,8,8,9,13,41,53,-12,33
Ards,9578,9,8,6,16,42,55,-13,30
Portadown,9578,10,6,6,18,24,51,-27,24
Ballinamalla,9578,11,7,3,20,30,65,-35,24
Crusaders,9579,1,17,4,9,63,39,24,55
Cliftonville,9579,2,17,2,11,55,35,20,53
Linfield,9579,3,14,8,8,55,40,15,50
Dungannon,9579,4,13,9,8,59,40,19,48
Coleraine,9579,5,11,12,7,45,37,8,45
Glenavon,9579,6,11,10,9,47,47,0,43
Glentoran,9579,7,10,6,14,33,48,-15,36
Ballymena,9579,8,10,6,14,45,61,-16,36
Ballinamalla,9579,9,10,3,17,40,51,-11,33
Portadown,9579,10,9,4,17,29,52,-23,31
Ards,9579,11,8,6,16,30,51,-21,30
Linfield,9580,1,17,8,5,68,28,40,59
Glenavon,9580,2,14,9,7,55,40,15,51
Cliftonville,9580,3,14,6,10,50,44,6,48
Crusaders,9580,4,13,7,10,50,43,7,46
Coleraine,9580,5,11,10,9,43,42,1,43
Ballymena,9580,6,11,10,9,54,59,-5,43
Glentoran,9580,7,12,4,14,33,45,-12,40
Dungannon,9580,8,10,8,12,53,46,7,38
Ballinamalla,9580,9,10,3,17,40,58,-18,33
Ards,9580,10,9,4,17,40,56,-16,31
Portadown,9580,11,6,7,17,22,47,-25,25
Crusaders,9581,1,16,7,7,60,31,29,55
Dungannon,9581,2,16,6,8,57,36,21,54
Linfield,9581,3,14,8,8,63,39,24,50
Coleraine,9581,4,13,8,9,43,37,6,47
Ballymena,9581,5,14,5,11,56,58,-2,47
Cliftonville,9581,6,14,4,12,51,48,3,46
Glenavon,9581,7,11,10,9,41,46,-5,43
Ballinamalla,9581,8,11,3,16,35,47,-12,36
Ards,9581,9,10,4,16,34,50,-16,34
Portadown,9581,10,7,4,19,21,47,-26,25
Glentoran,9581,11,5,9,16,28,50,-22,24
Crusaders,9582,1,18,6,6,60,34,26,60
Cliftonville,9582,2,17,4,9,54,37,17,55
Linfield,9582,3,15,7,8,58,37,21,52
Coleraine,9582,4,14,9,7,49,36,13,51
Glenavon,9582,5,13,9,8,53,46,7,48
Ballymena,9582,6,13,6,11,54,58,-4,45
Glentoran,9582,7,10,7,13,36,48,-12,37
Ards,9582,8,8,7,15,34,44,-10,31
Dungannon,9582,9,6,11,13,42,44,-2,29
Ballinamalla,9582,10,7,4,19,28,55,-27,25
Portadown,9582,11,6,6,18,26,55,-29,24
Crusaders,9583,1,18,8,4,65,32,33,62
Linfield,9583,2,13,9,8,55,36,19,48
Cliftonville,9583,3,14,4,12,43,40,3,46
Coleraine,9583,4,12,10,8,41,38,3,46
Dungannon,9583,5,11,10,9,50,39,11,43
Ballymena,9583,6,12,6,12,55,57,-2,42
Glenavon,9583,7,9,14,7,42,46,-4,41
Glentoran,9583,8,9,10,11,34,39,-5,37
Ards,9583,9,10,3,17,36,47,-11,33
Portadown,9583,10,6,9,15,23,45,-22,27
Ballinamalla,9583,11,6,7,17,23,48,-25,25
Crusaders,9584,1,16,10,4,56,31,25,58
Linfield,9584,2,15,6,9,57,36,21,51
Cliftonville,9584,3,15,6,9,54,36,18,51
Ballymena,9584,4,13,7,10,57,56,1,46
Coleraine,9584,5,12,9,9,41,35,6,45
Glenavon,9584,6,12,9,9,51,46,5,45
Dungannon,9584,7,12,6,12,51,50,1,42
Glentoran,9584,8,9,8,13,34,44,-10,35
Ards,9584,9,9,3,18,34,50,-16,30
Portadown,9584,10,6,9,15,22,47,-25,27
Ballinamalla,9584,11,7,5,18,29,55,-26,26
Crusaders,9585,1,16,10,4,54,30,24,58
Linfield,9585,2,15,10,5,58,31,27,55
Cliftonville,9585,3,14,8,8,50,34,16,50
Ballymena,9585,4,12,7,11,53,64,-11,43
Coleraine,9585,5,10,9,11,40,39,1,39
Dungannon,9585,6,9,9,12,44,47,-3,36
Ballinamalla,9585,7,11,3,16,40,49,-9,36
Portadown,9585,8,9,9,12,36,46,-10,36
Glenavon,9585,9,7,13,10,47,53,-6,34
Ards,9585,10,8,7,15,36,49,-13,31
Glentoran,9585,11,7,9,14,30,46,-16,30
Linfield,9586,1,16,8,6,57,29,28,56
Crusaders,9586,2,15,9,6,58,34,24,54
Cliftonville,9586,3,16,4,10,50,36,14,52
Ballymena,9586,4,14,6,10,62,61,1,48
Coleraine,9586,5,12,11,7,49,41,8,47
Glentoran,9586,6,12,7,11,33,41,-8,43
Dungannon,9586,7,10,10,10,46,41,5,40
Glenavon,9586,8,7,14,9,50,54,-4,35
Portadown,9586,9,8,4,18,27,50,-23,28
Ards,9586,10,7,6,17,36,53,-17,27
Ballinamalla,9586,11,8,1,21,28,56,-28,25
Linfield,9587,1,15,10,5,62,27,35,55
Crusaders,9587,2,15,9,6,53,30,23,54
Ballymena,9587,3,15,7,8,57,52,5,52
Cliftonville,9587,4,15,6,9,55,40,15,51
Glenavon,9587,5,12,10,8,53,47,6,46
Dungannon,9587,6,12,8,10,59,51,8,44
Coleraine,9587,7,9,9,12,41,50,-9,36
Glentoran,9587,8,10,6,14,29,42,-13,36
Ballinamalla,9587,9,8,5,17,37,59,-22,29
Portadown,9587,10,8,5,17,26,49,-23,29
Ards,9587,11,6,5,19,37,62,-25,23
Crusaders,9588,1,17,7,6,58,29,29,58
Cliftonville,9588,2,17,5,8,56,35,21,56
Glenavon,9588,3,15,11,4,57,40,17,56
Ballymena,9588,4,15,4,11,62,67,-5,49
Linfield,9588,5,13,8,9,56,37,19,47
Coleraine,9588,6,10,12,8,44,37,7,42
Dungannon,9588,7,11,7,12,45,43,2,40
Ards,9588,8,9,4,17,35,53,-18,31
Glentoran,9588,9,7,8,15,32,50,-18,29
Portadown,9588,10,7,5,18,20,46,-26,26
Ballinamalla,9588,11,8,1,21,32,60,-28,25
Linfield,9589,1,17,6,7,63,35,28,57
Cliftonville,9589,2,16,6,8,56,35,21,54
Crusaders,9589,3,14,8,8,55,46,9,50
Ballymena,9589,4,14,7,9,64,59,5,49
Glenavon,9589,5,11,10,9,43,41,2,43
Ards,9589,6,11,6,13,43,45,-2,39
Coleraine,9589,7,9,12,9,35,38,-3,39
Dungannon,9589,8,10,8,12,50,45,5,38
Glentoran,9589,9,8,7,15,26,48,-22,31
Ballinamalla,9589,10,8,4,18,28,54,-26,28
Portadown,9589,11,7,6,17,22,39,-17,27
Linfield,9590,1,16,9,5,63,33,30,57
Cliftonville,9590,2,16,5,9,54,42,12,53
Crusaders,9590,3,14,9,7,58,39,19,51
Dungannon,9590,4,14,8,8,62,47,15,50
Ballymena,9590,5,14,4,12,63,62,1,46
Coleraine,9590,6,11,11,8,41,39,2,44
Glenavon,9590,7,10,10,10,51,50,1,40
Glentoran,9590,8,9,7,14,32,55,-23,34
Portadown,9590,9,8,5,17,27,46,-19,29
Ballinamalla,9590,10,7,6,17,34,59,-25,27
Ards,9590,11,7,4,19,38,51,-13,25
Coleraine,9591,1,14,10,6,49,35,14,52
Ballymena,9591,2,14,9,7,58,54,4,51
Cliftonville,9591,3,14,7,9,47,35,12,49
Crusaders,9591,4,13,9,8,49,37,12,48
Glenavon,9591,5,11,12,7,45,44,1,45
Linfield,9591,6,10,11,9,51,38,13,41
Ards,9591,7,12,5,13,41,46,-5,41
Dungannon,9591,8,7,13,10,42,40,2,34
Glentoran,9591,9,7,12,11,33,43,-10,33
Portadown,9591,10,6,9,15,26,44,-18,27
Ballinamalla,9591,11,5,7,18,28,53,-25,22
Crusaders,9592,1,17,7,6,63,36,27,58
Linfield,9592,2,17,6,7,65,33,32,57
Ballymena,9592,3,14,8,8,65,54,11,50
Coleraine,9592,4,12,12,6,41,30,11,48
Cliftonville,9592,5,13,5,12,47,45,2,44
Glenavon,9592,6,11,10,9,49,50,-1,43
Dungannon,9592,7,10,9,11,48,43,5,39
Ards,9592,8,9,5,16,36,50,-14,32
Glentoran,9592,9,8,7,15,26,48,-22,31
Portadown,9592,10,9,2,19,25,49,-24,29
Ballinamalla,9592,11,6,7,17,30,57,-27,25
Cliftonville,9593,1,17,7,6,53,29,24,58
Crusaders,9593,2,16,7,7,57,39,18,55
Linfield,9593,3,15,9,6,61,32,29,54
Glenavon,9593,4,12,11,7,47,43,4,47
Ballymena,9593,5,14,5,11,56,60,-4,47
Coleraine,9593,6,12,9,9,44,38,6,45
Dungannon,9593,7,10,8,12,49,47,2,38
Glentoran,9593,8,10,6,14,36,48,-12,36
Portadown,9593,9,10,2,18,32,49,-17,32
Ards,9593,10,8,5,17,31,46,-15,29
Ballinamalla,9593,11,5,3,22,24,59,-35,18
Crusaders,9594,1,17,4,9,51,36,15,55
Cliftonville,9594,2,16,5,9,58,36,22,53
Ballymena,9594,3,16,5,9,62,55,7,53
Linfield,9594,4,14,10,6,59,34,25,52
Glenavon,9594,5,13,9,8,50,43,7,48
Coleraine,9594,6,9,13,8,40,43,-3,40
Dungannon,9594,7,9,10,11,52,44,8,37
Ards,9594,8,9,7,14,42,54,-12,34
Glentoran,9594,9,8,6,16,26,46,-20,30
Ballinamalla,9594,10,7,6,17,35,55,-20,27
Portadown,9594,11,8,3,19,20,49,-29,27
Crusaders,9595,1,18,8,4,60,30,30,62
Linfield,9595,2,16,9,5,66,30,36,57
Cliftonville,9595,3,15,5,10,49,46,3,50
Coleraine,9595,4,12,10,8,48,42,6,46
Glenavon,9595,5,12,10,8,52,47,5,46
Ballymena,9595,6,11,9,10,55,61,-6,42
Glentoran,9595,7,10,8,12,32,42,-10,38
Dungannon,9595,8,8,12,10,46,41,5,36
Ballinamalla,9595,9,7,6,17,28,52,-24,27
Ards,9595,10,7,4,19,33,55,-22,25
Portadown,9595,11,7,3,20,26,49,-23,24
Linfield,9596,1,18,7,5,62,32,30,61
Ballymena,9596,2,15,4,11,61,62,-1,49
Crusaders,9596,3,13,8,9,49,38,11,47
Cliftonville,9596,4,14,4,12,47,40,7,46
Glenavon,9596,5,11,12,7,47,47,0,45
Coleraine,9596,6,10,11,9,40,38,2,41
Dungannon,9596,7,9,9,12,48,47,1,36
Glentoran,9596,8,9,7,14,34,46,-12,34
Ballinamalla,9596,9,10,4,16,39,53,-14,34
Portadown,9596,10,9,6,15,32,46,-14,33
Ards,9596,11,8,6,16,37,47,-10,30
Linfield,9597,1,16,9,5,57,26,31,57
Cliftonville,9597,2,18,3,9,53,37,16,57
Crusaders,9597,3,13,10,7,53,37,16,49
Glenavon,9597,4,13,10,7,55,43,12,49
Coleraine,9597,5,11,10,9,44,45,-1,43
Ballymena,9597,6,12,6,12,54,63,-9,42
Dungannon,9597,7,9,8,13,50,50,0,35
Ards,9597,8,10,4,16,34,47,-13,34
Glentoran,9597,9,7,11,12,25,39,-14,32
Portadown,9597,10,6,10,14,30,41,-11,28
Ballinamalla,9597,11,7,5,18,30,57,-27,26
Crusaders,9598,1,18,4,8,51,31,20,58
Ballymena,9598,2,18,4,8,59,55,4,58
Linfield,9598,3,15,7,8,60,32,28,52
Cliftonville,9598,4,16,4,10,57,41,16,52
Coleraine,9598,5,13,9,8,44,33,11,48
Glenavon,9598,6,13,9,8,49,44,5,48
Dungannon,9598,7,11,7,12,51,51,0,40
Glentoran,9598,8,11,7,12,31,39,-8,40
Ards,9598,9,7,4,19,36,55,-19,25
Ballinamalla,9598,10,6,5,19,31,58,-27,23
Portadown,9598,11,5,4,21,21,51,-30,19
Crusaders,9599,1,17,8,5,60,31,29,59
Ballymena,9599,2,14,7,9,57,56,1,49
Linfield,9599,3,13,8,9,59,36,23,47
Coleraine,9599,4,12,8,10,43,39,4,44
Cliftonville,9599,5,12,6,12,42,39,3,42
Glenavon,9599,6,10,11,9,42,40,2,41
Portadown,9599,7,12,3,15,34,46,-12,39
Dungannon,9599,8,9,10,11,54,51,3,37
Glentoran,9599,9,9,7,14,35,50,-15,34
Ballinamalla,9599,10,9,5,16,29,51,-22,32
Ards,9599,11,8,7,15,36,52,-16,31
Crusaders,9600,1,17,7,6,53,32,21,58
Linfield,9600,2,14,11,5,58,33,25,53
Cliftonville,9600,3,16,5,9,55,39,16,53
Coleraine,9600,4,12,10,8,45,36,9,46
Glenavon,9600,5,11,12,7,48,41,7,45
Ballymena,9600,6,13,6,11,49,55,-6,45
Dungannon,9600,7,9,10,11,50,45,5,37
Ballinamalla,9600,8,11,3,16,34,47,-13,36
Ards,9600,9,9,5,16,40,52,-12,32
Glentoran,9600,10,7,8,15,27,43,-16,29
Portadown,9600,11,6,3,21,19,55,-36,21
Crusaders,9601,1,19,5,6,62,34,28,62
Coleraine,9601,2,13,10,7,45,35,10,49
Ballymena,9601,3,13,9,8,56,60,-4,48
Cliftonville,9601,4,13,7,10,49,39,10,46
Linfield,9601,5,12,9,9,54,32,22,45
Glentoran,9601,6,10,10,10,36,40,-4,40
Ards,9601,7,11,6,13,40,46,-6,39
Glenavon,9601,8,8,11,11,44,51,-7,35
Dungannon,9601,9,8,8,14,42,42,0,32
Portadown,9601,10,8,8,14,29,49,-20,32
Ballinamalla,9601,11,5,7,18,25,54,-29,22
Crusaders,9602,1,18,7,5,66,29,37,61
Cliftonville,9602,2,17,3,10,54,39,15,54
Glenavon,9602,3,14,9,7,54,46,8,51
Ballymena,9602,4,15,5,10,58,58,0,50
Linfield,9602,5,12,9,9,54,35,19,45
Dungannon,9602,6,11,10,9,51,42,9,43
Coleraine,9602,7,10,9,11,41,39,2,39
Glentoran,9602,8,11,6,13,39,53,-14,39
Ards,9602,9,9,3,18,30,49,-19,30
Ballinamalla,9602,10,6,6,18,25,53,-28,24
Portadown,9602,11,6,5,19,22,51,-29,23
Crusaders,9603,1,16,6,8,56,42,14,54
Linfield,9603,2,14,11,5,59,32,27,53
Cliftonville,9603,3,15,8,7,60,41,19,53
Glenavon,9603,4,11,13,6,48,40,8,46
Ballymena,9603,5,13,7,10,57,56,1,46
Coleraine,9603,6,11,12,7,49,38,11,45
Dungannon,9603,7,11,9,10,55,48,7,42
Ards,9603,8,8,7,15,33,48,-15,31
Ballinamalla,9603,9,8,7,15,29,48,-19,31
Portadown,9603,10,7,4,19,24,51,-27,25
Glentoran,9603,11,5,8,17,23,49,-26,23
Crusaders,9604,1,19,5,6,62,32,30,62
Linfield,9604,2,16,7,7,54,33,21,55
Cliftonville,9604,3,16,5,9,51,36,15,53
Coleraine,9604,4,11,11,8,44,38,6,44
Glenavon,9604,5,11,11,8,45,42,3,44
Ballymena,9604,6,13,4,13,51,57,-6,43
Glentoran,9604,7,11,6,13,32,50,-18,39
Dungannon,9604,8,10,8,12,48,38,10,38
Portadown,9604,9,8,5,17,26,44,-18,29
Ards,9604,10,7,5,18,32,53,-21,26
Ballinamalla,9604,11,6,7,17,26,48,-22,25
Crusaders,9605,1,19,8,3,60,31,29,65
Linfield,9605,2,18,6,6,56,31,25,60
Cliftonville,9605,3,18,2,10,61,37,24,56
Ballymena,9605,4,15,5,10,58,55,3,50
Coleraine,9605,5,11,12,7,46,41,5,45
Glenavon,9605,6,11,9,10,51,51,0,42
Dungannon,9605,7,11,8,11,48,45,3,41
Glentoran,9605,8,8,5,17,33,51,-18,29
Portadown,9605,9,8,2,20,23,50,-27,26
Ards,9605,10,6,7,17,31,50,-19,25
Ballinamalla,9605,11,5,6,19,27,52,-25,21
Crusaders,9606,1,20,5,5,49,24,25,65
Glenavon,9606,2,14,13,3,60,37,23,55
Ballymena,9606,3,16,4,10,64,57,7,52
Cliftonville,9606,4,15,5,10,50,39,11,50
Coleraine,9606,5,11,12,7,43,43,0,45
Linfield,9606,6,10,13,7,54,38,16,43
Dungannon,9606,7,8,14,8,49,41,8,38
Ards,9606,8,9,5,16,36,48,-12,32
Glentoran,9606,9,6,9,15,25,45,-20,27
Portadown,9606,10,6,6,18,23,46,-23,24
Ballinamalla,9606,11,5,4,21,22,57,-35,19
Crusaders,9607,1,19,8,3,62,29,33,65
Cliftonville,9607,2,15,6,9,51,39,12,51
Ballymena,9607,3,14,6,10,59,58,1,48
Linfield,9607,4,11,12,7,52,33,19,45
Coleraine,9607,5,11,11,8,36,35,1,44
Glentoran,9607,6,9,10,11,33,41,-8,37
Ballinamalla,9607,7,10,7,13,38,51,-13,37
Ards,9607,8,10,6,14,44,51,-7,36
Glenavon,9607,9,8,10,12,40,48,-8,34
Dungannon,9607,10,8,9,13,50,50,0,33
Portadown,9607,11,5,5,20,23,53,-30,20
Cliftonville,9608,1,18,2,10,55,37,18,56
Linfield,9608,2,16,7,7,66,38,28,55
Crusaders,9608,3,15,8,7,59,40,19,53
Ballymena,9608,4,14,5,11,57,62,-5,47
Glenavon,9608,5,11,13,6,52,47,5,46
Coleraine,9608,6,11,11,8,41,37,4,44
Dungannon,9608,7,11,8,11,55,47,8,41
Glentoran,9608,8,10,5,15,37,51,-14,35
Ballinamalla,9608,9,9,2,19,34,57,-23,29
Ards,9608,10,7,7,16,35,53,-18,28
Portadown,9608,11,7,4,19,32,54,-22,25
Linfield,9609,1,14,10,6,58,29,29,52
Cliftonville,9609,2,16,4,10,58,38,20,52
Coleraine,9609,3,13,13,4,48,31,17,52
Crusaders,9609,4,15,5,10,56,36,20,50
Dungannon,9609,5,11,9,10,53,47,6,42
Ballymena,9609,6,11,9,10,53,64,-11,42
Glenavon,9609,7,11,8,11,45,52,-7,41
Glentoran,9609,8,10,9,11,33,45,-12,39
Ballinamalla,9609,9,10,3,17,33,48,-15,33
Ards,9609,10,7,5,18,27,46,-19,26
Portadown,9609,11,7,5,18,23,51,-28,26
Crusaders,9610,1,20,4,6,61,32,29,64
Cliftonville,9610,2,17,7,6,59,38,21,58
Linfield,9610,3,11,13,6,55,30,25,46
Dungannon,9610,4,11,11,8,50,35,15,44
Ballymena,9610,5,12,6,12,52,63,-11,42
Glenavon,9610,6,10,11,9,43,45,-2,41
Coleraine,9610,7,10,10,10,42,44,-2,40
Glentoran,9610,8,10,8,12,30,39,-9,38
Ards,9610,9,8,7,15,42,54,-12,31
Portadown,9610,10,6,7,17,23,47,-24,25
Ballinamalla,9610,11,5,6,19,22,52,-30,21
Glenavon,9611,1,15,11,4,63,43,20,56
Linfield,9611,2,16,7,7,58,28,30,55
Crusaders,9611,3,16,7,7,54,36,18,55
Cliftonville,9611,4,16,4,10,57,43,14,52
Coleraine,9611,5,13,13,4,44,31,13,52
Dungannon,9611,6,11,8,11,54,48,6,41
Ballymena,9611,7,11,5,14,48,59,-11,38
Ards,9611,8,9,4,17,40,59,-19,31
Glentoran,9611,9,8,5,17,32,48,-16,29
Portadown,9611,10,6,6,18,23,50,-27,24
Ballinamalla,9611,11,6,6,18,27,55,-28,24
Glenavon,9612,1,16,9,5,55,42,13,57
Crusaders,9612,2,17,5,8,56,37,19,56
Linfield,9612,3,13,10,7,55,34,21,49
Coleraine,9612,4,13,10,7,45,37,8,49
Cliftonville,9612,5,14,4,12,49,37,12,46
Ballymena,9612,6,13,7,10,60,58,2,46
Dungannon,9612,7,8,9,13,48,47,1,33
Ballinamalla,9612,8,9,5,16,30,47,-17,32
Ards,9612,9,9,4,17,40,57,-17,31
Portadown,9612,10,8,5,17,33,52,-19,29
Glentoran,9612,11,6,10,14,29,52,-23,28
Crusaders,9613,1,16,8,6,55,36,19,56
Ballymena,9613,2,15,8,7,62,53,9,53
Cliftonville,9613,3,16,3,11,53,41,12,51
Coleraine,9613,4,13,8,9,42,38,4,47
Glenavon,9613,5,11,11,8,48,52,-4,44
Dungannon,9613,6,11,7,12,53,43,10,40
Linfield,9613,7,11,7,12,52,43,9,40
Glentoran,9613,8,10,8,12,34,42,-8,38
Ballinamalla,9613,9,10,3,17,35,48,-13,33
Portadown,9613,10,8,7,15,29,48,-19,31
Ards,9613,11,6,6,18,31,50,-19,24
Crusaders,9614,1,15,9,6,50,34,16,54
Cliftonville,9614,2,16,5,9,58,37,21,53
Coleraine,9614,3,13,10,7,50,39,11,49
Glenavon,9614,4,13,9,8,46,40,6,48
Ballymena,9614,5,14,5,11,52,56,-4,47
Linfield,9614,6,13,7,10,46,35,11,46
Ards,9614,7,12,6,12,40,45,-5,42
Dungannon,9614,8,8,12,10,45,40,5,36
Ballinamalla,9614,9,7,6,17,31,50,-19,27
Portadown,9614,10,6,8,16,24,44,-20,26
Glentoran,9614,11,6,7,17,25,47,-22,25
Crusaders,9615,1,18,7,5,61,34,27,61
Cliftonville,9615,2,15,6,9,53,38,15,51
Linfield,9615,3,12,11,7,56,34,22,47
Glenavon,9615,4,11,12,7,46,45,1,45
Coleraine,9615,5,11,9,10,40,40,0,42
Ballymena,9615,6,12,6,12,57,65,-8,42
Dungannon,9615,7,10,9,11,51,44,7,39
Glentoran,9615,8,10,8,12,37,47,-10,38
Ballinamalla,9615,9,11,3,16,34,48,-14,36
Portadown,9615,10,7,6,17,27,50,-23,27
Ards,9615,11,7,5,18,35,52,-17,26
Crusaders,9616,1,15,9,6,50,33,17,54
Cliftonville,9616,2,15,6,9,53,37,16,51
Ballymena,9616,3,15,4,11,68,65,3,49
Linfield,9616,4,13,9,8,56,37,19,48
Dungannon,9616,5,10,11,9,46,37,9,41
Coleraine,9616,6,10,10,10,38,43,-5,40
Ballinamalla,9616,7,11,5,14,36,44,-8,38
Glenavon,9616,8,7,12,11,42,53,-11,33
Glentoran,9616,9,8,9,13,35,46,-11,33
Portadown,9616,10,9,6,15,32,47,-15,33
Ards,9616,11,9,5,16,32,46,-14,32
Crusaders,9617,1,19,5,6,57,36,21,62
Linfield,9617,2,16,8,6,62,29,33,56
Cliftonville,9617,3,14,4,12,49,41,8,46
Ballymena,9617,4,14,4,12,57,65,-8,46
Glenavon,9617,5,12,9,9,51,46,5,45
Glentoran,9617,6,12,7,11,36,40,-4,43
Coleraine,9617,7,10,11,9,41,40,1,41
Dungannon,9617,8,9,9,12,49,47,2,36
Ballinamalla,9617,9,9,3,18,31,49,-18,30
Ards,9617,10,7,7,16,31,48,-17,28
Portadown,9617,11,7,5,18,29,52,-23,26
Crusaders,9618,1,17,7,6,54,32,22,58
Cliftonville,9618,2,17,6,7,50,37,13,57
Ballymena,9618,3,15,6,9,56,50,6,51
Linfield,9618,4,13,8,9,57,40,17,47
Coleraine,9618,5,10,12,8,40,36,4,42
Dungannon,9618,6,10,9,11,53,49,4,39
Glenavon,9618,7,9,11,10,44,46,-2,38
Portadown,9618,8,9,7,14,33,45,-12,34
Glentoran,9618,9,9,7,14,30,44,-14,34
Ards,9618,10,8,6,16,32,43,-11,30
Ballinamalla,9618,11,7,3,20,28,55,-27,24
Crusaders,9619,1,19,8,3,54,27,27,65
Linfield,9619,2,15,8,7,60,29,31,53
Cliftonville,9619,3,16,4,10,59,46,13,52
Ballymena,9619,4,14,6,10,66,67,-1,48
Glenavon,9619,5,10,16,4,50,38,12,46
Dungannon,9619,6,9,12,9,48,45,3,39
Coleraine,9619,7,10,8,12,42,44,-2,38
Portadown,9619,8,7,8,15,29,46,-17,29
Ards,9619,9,7,7,16,33,50,-17,28
Ballinamalla,9619,10,7,6,17,25,47,-22,27
Glentoran,9619,11,5,9,16,21,48,-27,24
Cliftonville,9620,1,17,6,7,55,39,16,57
Linfield,9620,2,15,10,5,56,24,32,55
Crusaders,9620,3,15,10,5,55,31,24,55
Ballymena,9620,4,14,7,9,55,54,1,49
Coleraine,9620,5,12,10,8,40,31,9,46
Glenavon,9620,6,13,7,10,47,42,5,46
Ards,9620,7,12,4,14,32,37,-5,40
Dungannon,9620,8,8,9,13,41,47,-6,33
Glentoran,9620,9,7,8,15,27,43,-16,29
Ballinamalla,9620,10,8,5,17,25,50,-25,29
Portadown,9620,11,4,4,22,21,56,-35,16
Cliftonville,9621,1,17,6,7,63,41,22,57
Crusaders,9621,2,16,7,7,52,35,17,55
Linfield,9621,3,14,9,7,60,34,26,51
Glenavon,9621,4,12,11,7,53,46,7,47
Ballymena,9621,5,14,4,12,53,59,-6,46
Coleraine,9621,6,9,12,9,43,44,-1,39
Dungannon,9621,7,9,10,11,50,45,5,37
Glentoran,9621,8,9,10,11,36,41,-5,37
Ards,9621,9,10,5,15,43,49,-6,35
Portadown,9621,10,7,6,17,25,52,-27,27
Ballinamalla,9621,11,7,2,21,28,60,-32,23
Linfield,9622,1,15,9,6,50,25,25,54
Cliftonville,9622,2,15,7,8,54,38,16,52
Ballymena,9622,3,14,10,6,61,56,5,52
Crusaders,9622,4,14,8,8,48,40,8,50
Glenavon,9622,5,13,10,7,53,49,4,49
Coleraine,9622,6,12,10,8,45,35,10,46
Dungannon,9622,7,8,12,10,52,43,9,36
Ards,9622,8,10,4,16,36,47,-11,34
Glentoran,9622,9,9,6,15,29,42,-13,33
Portadown,9622,10,6,5,19,22,48,-26,23
Ballinamalla,9622,11,5,7,18,27,54,-27,22
Linfield,9623,1,16,7,7,59,33,26,55
Cliftonville,9623,2,15,8,7,55,35,20,53
Glenavon,9623,3,12,12,6,46,39,7,48
Crusaders,9623,4,12,8,10,51,41,10,44
Ballymena,9623,5,13,4,13,53,68,-15,43
Coleraine,9623,6,10,12,8,42,43,-1,42
Ards,9623,7,9,8,13,37,45,-8,35
Ballinamalla,9623,8,10,5,15,25,44,-19,35
Glentoran,9623,9,9,6,15,38,45,-7,33
Portadown,9623,10,9,6,15,32,43,-11,33
Dungannon,9623,11,8,8,14,46,48,-2,32
Linfield,9624,1,17,10,3,59,27,32,61
Cliftonville,9624,2,18,4,8,51,35,16,58
Glenavon,9624,3,13,11,6,50,38,12,50
Crusaders,9624,4,14,6,10,47,37,10,48
Glentoran,9624,5,11,8,11,36,37,-1,41
Coleraine,9624,6,9,13,8,43,40,3,40
Ballymena,9624,7,11,6,13,51,61,-10,39
Dungannon,9624,8,8,9,13,46,47,-1,33
Ballinamalla,9624,9,10,3,17,30,47,-17,33
Ards,9624,10,7,6,17,32,53,-21,27
Portadown,9624,11,6,6,18,21,44,-23,24
Crusaders,9625,1,15,11,4,56,38,18,56
Linfield,9625,2,15,9,6,64,35,29,54
Coleraine,9625,3,14,10,6,49,30,19,52
Cliftonville,9625,4,13,7,10,50,43,7,46
Ballymena,9625,5,12,7,11,55,60,-5,43
Glenavon,9625,6,11,9,10,46,46,0,42
Dungannon,9625,7,10,10,10,46,44,2,40
Ards,9625,8,10,4,16,38,51,-13,34
Ballinamalla,9625,9,10,3,17,31,50,-19,33
Glentoran,9625,10,8,6,16,29,43,-14,30
Portadown,9625,11,6,6,18,27,51,-24,24
Cliftonville,9626,1,17,5,8,61,36,25,56
Crusaders,9626,2,16,7,7,62,40,22,55
Dungannon,9626,3,14,9,7,57,40,17,51
Coleraine,9626,4,11,14,5,43,32,11,47
Linfield,9626,5,11,11,8,56,38,18,44
Glenavon,9626,6,10,12,8,44,44,0,42
Ballymena,9626,7,11,8,11,53,61,-8,41
Glentoran,9626,8,9,8,13,28,41,-13,35
Ballinamalla,9626,9,9,3,18,29,51,-22,30
Ards,9626,10,7,8,15,34,52,-18,29
Portadown,9626,11,5,5,20,24,56,-32,20
Crusaders,9627,1,15,11,4,53,30,23,56
Glenavon,9627,2,15,9,6,60,44,16,54
Ballymena,9627,3,15,7,8,64,55,9,52
Linfield,9627,4,13,10,7,54,39,15,49
Coleraine,9627,5,12,13,5,49,38,11,49
Cliftonville,9627,6,13,8,9,50,40,10,47
Ards,9627,7,9,6,15,44,57,-13,33
Ballinamalla,9627,8,8,7,15,38,56,-18,31
Portadown,9627,9,7,6,17,25,46,-21,27
Dungannon,9627,10,6,8,16,44,52,-8,26
Glentoran,9627,11,6,7,17,30,54,-24,25
Crusaders,9628,1,17,8,5,55,27,28,59
Linfield,9628,2,14,7,9,60,32,28,49
Portadown,9628,3,14,5,11,37,43,-6,47
Glenavon,9628,4,11,12,7,53,48,5,45
Cliftonville,9628,5,12,7,11,52,46,6,43
Coleraine,9628,6,12,7,11,42,41,1,43
Ballymena,9628,7,11,7,12,48,58,-10,40
Ards,9628,8,11,5,14,39,49,-10,38
Glentoran,9628,9,10,6,14,37,49,-12,36
Dungannon,9628,10,8,9,13,49,49,0,33
Ballinamalla,9628,11,6,5,19,30,60,-30,23
Crusaders,9629,1,16,11,3,56,33,23,59
Cliftonville,9629,2,16,8,6,51,30,21,56
Linfield,9629,3,15,9,6,56,33,23,54
Glenavon,9629,4,11,10,9,57,54,3,43
Coleraine,9629,5,10,13,7,42,39,3,43
Ballymena,9629,6,12,7,11,59,57,2,43
Glentoran,9629,7,10,10,10,33,38,-5,40
Dungannon,9629,8,7,10,13,40,50,-10,31
Ards,9629,9,7,6,17,35,53,-18,27
Portadown,9629,10,7,5,18,27,49,-22,26
Ballinamalla,9629,11,6,7,17,32,52,-20,25
Cliftonville,9630,1,18,3,9,59,44,15,57
Crusaders,9630,2,15,11,4,58,33,25,56
Ballymena,9630,3,16,4,10,64,60,4,52
Linfield,9630,4,13,9,8,54,34,20,48
Glenavon,9630,5,12,8,10,49,46,3,44
Dungannon,9630,6,12,7,11,55,48,7,43
Coleraine,9630,7,10,12,8,44,42,2,42
Ballinamalla,9630,8,10,2,18,36,54,-18,32
Ards,9630,9,9,4,17,34,46,-12,31
Glentoran,9630,10,7,8,15,27,49,-22,29
Portadown,9630,11,6,6,18,32,56,-24,24
Cliftonville,9631,1,17,5,8,57,41,16,56
Crusaders,9631,2,16,6,8,52,37,15,54
Linfield,9631,3,14,11,5,59,29,30,53
Glenavon,9631,4,11,11,8,49,49,0,44
Dungannon,9631,5,11,10,9,54,42,12,43
Ballymena,9631,6,12,7,11,58,59,-1,43
Coleraine,9631,7,10,10,10,40,37,3,40
Ards,9631,8,9,5,16,41,57,-16,32
Glentoran,9631,9,6,11,13,25,43,-18,29
Ballinamalla,9631,10,8,5,17,34,56,-22,29
Portadown,9631,11,7,7,16,27,46,-19,28
Crusaders,9632,1,17,10,3,52,25,27,61
Linfield,9632,2,13,9,8,64,37,27,48
Cliftonville,9632,3,14,6,10,53,42,11,48
Glenavon,9632,4,13,9,8,48,45,3,48
Coleraine,9632,5,12,9,9,45,39,6,45
Ballymena,9632,6,13,5,12,52,58,-6,44
Dungannon,9632,7,9,9,12,48,47,1,36
Glentoran,9632,8,9,7,14,30,45,-15,34
Portadown,9632,9,9,5,16,32,52,-20,32
Ballinamalla,9632,10,8,6,16,35,53,-18,30
Ards,9632,11,7,7,16,29,45,-16,28
Crusaders,9633,1,20,7,3,55,24,31,67
Linfield,9633,2,16,9,5,59,29,30,57
Ballymena,9633,3,14,6,10,57,58,-1,48
Coleraine,9633,4,12,9,9,44,40,4,45
Cliftonville,9633,5,11,8,11,44,41,3,41
Glenavon,9633,6,10,10,10,45,48,-3,40
Dungannon,9633,7,8,12,10,45,43,2,36
Portadown,9633,8,9,5,16,31,44,-13,32
Glentoran,9633,9,7,10,13,30,40,-10,31
Ballinamalla,9633,10,8,5,17,33,55,-22,29
Ards,9633,11,7,5,18,25,46,-21,26
Crusaders,9634,1,17,9,4,54,26,28,60
Linfield,9634,2,15,12,3,59,26,33,57
Cliftonville,9634,3,16,5,9,60,42,18,53
Ballymena,9634,4,14,5,11,55,57,-2,47
Coleraine,9634,5,10,11,9,35,34,1,41
Glenavon,9634,6,10,11,9,44,45,-1,41
Glentoran,9634,7,10,6,14,37,49,-12,36
Dungannon,9634,8,9,8,13,48,50,-2,35
Ballinamalla,9634,9,10,5,15,35,50,-15,35
Ards,9634,10,10,3,17,32,46,-14,33
Portadown,9634,11,4,5,21,18,52,-34,17
Crusaders,9635,1,18,7,5,52,29,23,61
Linfield,9635,2,16,10,4,65,31,34,58
Ballymena,9635,3,14,7,9,52,53,-1,49
Coleraine,9635,4,12,8,10,38,33,5,44
Cliftonville,9635,5,12,7,11,42,34,8,43
Glenavon,9635,6,10,12,8,48,44,4,42
Dungannon,9635,7,10,10,10,50,47,3,40
Portadown,9635,8,8,7,15,27,44,-17,31
Ballinamalla,9635,9,8,6,16,28,45,-17,30
Ards,9635,10,8,4,18,28,47,-19,28
Glentoran,9635,11,7,6,17,24,47,-23,27
Crusaders,9636,1,15,7,8,55,42,13,52
Linfield,9636,2,13,12,5,55,31,24,51
Cliftonville,9636,3,15,6,9,53,39,14,51
Ballymena,9636,4,15,5,10,61,57,4,50
Dungannon,9636,5,12,9,9,46,36,10,45
Glenavon,9636,6,10,11,9,42,43,-1,41
Coleraine,9636,7,8,14,8,38,40,-2,38
Glentoran,9636,8,8,11,11,27,38,-11,35
Ards,9636,9,9,7,14,36,45,-9,34
Ballinamalla,9636,10,7,6,17,28,49,-21,27
Portadown,9636,11,7,4,19,31,52,-21,25
Crusaders,9637,1,15,9,6,55,40,15,54
Cliftonville,9637,2,15,5,10,52,37,15,50
Ballymena,9637,3,15,5,10,56,53,3,50
Coleraine,9637,4,13,9,8,54,42,12,48
Linfield,9637,5,12,10,8,53,33,20,46
Dungannon,9637,6,9,10,11,47,45,2,37
Glenavon,9637,7,8,13,9,41,48,-7,37
Ards,9637,8,8,9,13,37,48,-11,33
Glentoran,9637,9,8,9,13,30,42,-12,33
Ballinamalla,9637,10,9,5,16,35,47,-12,32
Portadown,9637,11,8,6,16,26,51,-25,30
Crusaders,9638,1,19,5,6,55,30,25,62
Linfield,9638,2,17,9,4,67,37,30,60
Ballymena,9638,3,16,4,10,58,53,5,52
Glenavon,9638,4,13,9,8,50,43,7,48
Coleraine,9638,5,11,11,8,50,45,5,44
Cliftonville,9638,6,12,7,11,52,49,3,43
Dungannon,9638,7,8,11,11,48,47,1,35
Ballinamalla,9638,8,9,6,15,37,52,-15,33
Glentoran,9638,9,8,6,16,29,50,-21,30
Ards,9638,10,6,6,18,37,56,-19,24
Portadown,9638,11,6,6,18,27,48,-21,24
Cliftonville,9639,1,21,3,6,58,29,29,66
Ballymena,9639,2,17,6,7,65,57,8,57
Crusaders,9639,3,15,6,9,50,36,14,51
Glenavon,9639,4,13,8,9,46,35,11,47
Linfield,9639,5,12,8,10,55,42,13,44
Coleraine,9639,6,11,10,9,44,40,4,43
Dungannon,9639,7,10,9,11,49,50,-1,39
Ards,9639,8,12,3,15,47,54,-7,39
Glentoran,9639,9,7,7,16,25,47,-22,28
Ballinamalla,9639,10,8,2,20,29,53,-24,26
Portadown,9639,11,6,4,20,27,52,-25,22
Cliftonville,9640,1,19,4,7,53,29,24,61
Crusaders,9640,2,15,7,8,51,36,15,52
Linfield,9640,3,13,11,6,63,44,19,50
Ballymena,9640,4,15,5,10,55,55,0,50
Coleraine,9640,5,13,8,9,46,39,7,47
Dungannon,9640,6,11,8,11,55,43,12,41
Glentoran,9640,7,11,7,12,37,42,-5,40
Glenavon,9640,8,9,9,12,40,49,-9,36
Portadown,9640,9,7,8,15,25,43,-18,29
Ards,9640,10,8,4,18,42,57,-15,28
Ballinamalla,9640,11,7,3,20,30,60,-30,24
Crusaders,9641,1,18,8,4,61,36,25,62
Linfield,9641,2,14,9,7,64,35,29,51
Cliftonville,9641,3,15,2,13,46,41,5,47
Coleraine,9641,4,12,10,8,37,33,4,46
Ballymena,9641,5,13,6,11,58,62,-4,45
Glenavon,9641,6,11,11,8,50,42,8,44
Dungannon,9641,7,9,11,10,47,43,4,38
Ards,9641,8,9,7,14,39,48,-9,34
Ballinamalla,9641,9,9,4,17,39,58,-19,31
Glentoran,9641,10,8,7,15,35,54,-19,31
Portadown,9641,11,7,5,18,23,47,-24,26
Crusaders,9642,1,19,4,7,63,31,32,61
Cliftonville,9642,2,16,5,9,49,33,16,53
Linfield,9642,3,15,7,8,58,38,20,52
Coleraine,9642,4,14,9,7,55,38,17,51
Ballymena,9642,5,14,6,10,55,55,0,48
Glenavon,9642,6,11,11,8,53,45,8,44
Dungannon,9642,7,9,9,12,47,47,0,36
Ards,9642,8,8,7,15,37,53,-16,31
Ballinamalla,9642,9,8,5,17,34,54,-20,29
Glentoran,9642,10,7,6,17,22,50,-28,27
Portadown,9642,11,7,5,18,23,52,-29,26
Linfield,9643,1,16,9,5,59,32,27,57
Crusaders,9643,2,15,9,6,56,35,21,54
Glenavon,9643,3,15,9,6,55,43,12,54
Cliftonville,9643,4,15,6,9,55,44,11,51
Ballymena,9643,5,15,4,11,58,57,1,49
Dungannon,9643,6,9,12,9,48,46,2,39
Coleraine,9643,7,8,10,12,38,47,-9,34
Ards,9643,8,9,4,17,37,46,-9,31
Ballinamalla,9643,9,9,4,17,35,55,-20,31
Glentoran,9643,10,8,6,16,31,51,-20,30
Portadown,9643,11,7,5,18,33,49,-16,26
Crusaders,9644,1,18,9,3,60,31,29,63
Ballymena,9644,2,16,5,9,65,59,6,53
Linfield,9644,3,14,10,6,61,36,25,52
Glenavon,9644,4,13,8,9,51,42,9,47
Coleraine,9644,5,11,12,7,43,32,11,45
Cliftonville,9644,6,12,7,11,50,43,7,43
Ards,9644,7,10,6,14,38,46,-8,36
Dungannon,9644,8,8,10,12,47,50,-3,34
Ballinamalla,9644,9,7,8,15,35,53,-18,29
Glentoran,9644,10,6,8,16,24,50,-26,26
Portadown,9644,11,5,7,18,24,56,-32,22
Linfield,9645,1,17,11,2,70,24,46,62
Crusaders,9645,2,16,8,6,55,36,19,56
Cliftonville,9645,3,16,4,10,51,39,12,52
Coleraine,9645,4,10,13,7,43,34,9,43
Dungannon,9645,5,10,11,9,51,43,8,41
Ballymena,9645,6,12,5,13,59,68,-9,41
Glenavon,9645,7,8,15,7,42,40,2,39
Glentoran,9645,8,8,10,12,28,41,-13,34
Portadown,9645,9,8,6,16,24,41,-17,30
Ards,9645,10,6,8,16,26,52,-26,26
Ballinamalla,9645,11,6,5,19,26,57,-31,23
Linfield,9646,1,17,9,4,64,28,36,60
Crusaders,9646,2,17,7,6,55,32,23,58
Cliftonville,9646,3,14,9,7,51,37,14,51
Dungannon,9646,4,10,11,9,53,43,10,41
Coleraine,9646,5,10,11,9,50,41,9,41
Ballymena,9646,6,11,8,11,61,61,0,41
Glenavon,9646,7,9,11,10,46,48,-2,38
Glentoran,9646,8,9,8,13,32,42,-10,35
Ballinamalla,9646,9,10,3,17,33,56,-23,33
Ards,9646,10,8,5,17,36,58,-22,29
Portadown,9646,11,6,6,18,21,56,-35,24
Crusaders,9647,1,19,6,5,60,31,29,63
Linfield,9647,2,13,8,9,60,42,18,47
Dungannon,9647,3,12,10,8,56,43,13,46
Cliftonville,9647,4,14,4,12,48,43,5,46
Ballymena,9647,5,13,6,11,55,58,-3,45
Coleraine,9647,6,12,7,11,42,40,2,43
Ards,9647,7,13,4,13,46,47,-1,43
Glenavon,9647,8,11,9,10,44,44,0,42
Portadown,9647,9,7,9,14,17,36,-19,30
Ballinamalla,9647,10,8,4,18,29,49,-20,28
Glentoran,9647,11,6,7,17,24,48,-24,25
Linfield,9648,1,16,9,5,57,28,29,57
Crusaders,9648,2,15,10,5,55,31,24,55
Ballymena,9648,3,17,4,9,59,54,5,55
Coleraine,9648,4,12,11,7,42,33,9,47
Glenavon,9648,5,11,13,6,48,47,1,46
Cliftonville,9648,6,13,4,13,54,47,7,43
Glentoran,9648,7,9,8,13,31,41,-10,35
Dungannon,9648,8,8,10,12,49,47,2,34
Portadown,9648,9,7,8,15,26,49,-23,29
Ards,9648,10,8,4,18,34,51,-17,28
Ballinamalla,9648,11,6,5,19,28,55,-27,23
Crusaders,9649,1,15,8,7,60,46,14,53
Coleraine,9649,2,14,8,8,48,42,6,50
Cliftonville,9649,3,15,4,11,53,38,15,49
Linfield,9649,4,13,9,8,62,43,19,48
Glenavon,9649,5,12,11,7,49,41,8,47
Dungannon,9649,6,11,9,10,53,44,9,42
Ballymena,9649,7,12,6,12,52,57,-5,42
Glentoran,9649,8,11,5,14,35,45,-10,38
Portadown,9649,9,9,6,15,30,45,-15,33
Ards,9649,10,9,3,18,39,53,-14,30
Ballinamalla,9649,11,8,3,19,30,57,-27,27
Linfield,9650,1,15,11,4,56,24,32,56
Cliftonville,9650,2,15,6,9,50,43,7,51
Crusaders,9650,3,13,6,11,49,46,3,45
Ballymena,9650,4,13,6,11,60,62,-2,45
Coleraine,9650,5,11,10,9,41,36,5,43
Glenavon,9650,6,10,12,8,45,42,3,42
Dungannon,9650,7,10,9,11,50,45,5,39
Glentoran,9650,8,9,7,14,24,41,-17,34
Portadown,9650,9,8,9,13,29,37,-8,33
Ballinamalla,9650,10,10,3,17,31,49,-18,33
Ards,9650,11,7,9,14,34,44,-10,30
Crusaders,9651,1,15,10,5,52,33,19,55
Ballymena,9651,2,16,6,8,65,56,9,54
Cliftonville,9651,3,16,5,9,55,35,20,53
Linfield,9651,4,13,9,8,64,43,21,48
Coleraine,9651,5,13,9,8,40,36,4,48
Glenavon,9651,6,11,11,8,49,54,-5,44
Dungannon,9651,7,11,9,10,51,39,12,42
Glentoran,9651,8,8,6,16,31,49,-18,30
Portadown,9651,9,8,6,16,27,49,-22,30
Ballinamalla,9651,10,8,4,18,29,54,-25,28
Ards,9651,11,7,3,20,34,49,-15,24
Cliftonville,9652,1,19,5,6,65,36,29,62
Linfield,9652,2,15,10,5,56,25,31,55
Crusaders,9652,3,16,6,8,59,35,24,54
Ballymena,9652,4,15,6,9,61,52,9,51
Glenavon,9652,5,12,9,9,49,46,3,45
Dungannon,9652,6,11,10,9,56,45,11,43
Glentoran,9652,7,8,11,11,29,40,-11,35
Ards,9652,8,10,3,17,44,60,-16,33
Coleraine,9652,9,8,8,14,34,53,-19,32
Ballinamalla,9652,10,6,5,19,23,51,-28,23
Portadown,9652,11,6,5,19,23,56,-33,23
Cliftonville,9653,1,17,7,6,60,38,22,58
Crusaders,9653,2,15,11,4,52,28,24,56
Linfield,9653,3,15,10,5,53,28,25,55
Coleraine,9653,4,9,14,7,43,40,3,41
Glenavon,9653,5,10,10,10,49,46,3,40
Ballymena,9653,6,11,7,12,54,63,-9,40
Glentoran,9653,7,11,6,13,37,40,-3,39
Dungannon,9653,8,9,10,11,43,48,-5,37
Ards,9653,9,7,9,14,34,50,-16,30
Portadown,9653,10,8,4,18,21,41,-20,28
Ballinamalla,9653,11,5,8,17,28,52,-24,23
Crusaders,9654,1,16,9,5,54,29,25,57
Ballymena,9654,2,14,8,8,57,51,6,50
Linfield,9654,3,14,7,9,53,37,16,49
Cliftonville,9654,4,15,4,11,50,41,9,49
Dungannon,9654,5,11,9,10,51,38,13,42
Coleraine,9654,6,10,10,10,39,39,0,40
Glenavon,9654,7,8,15,7,41,44,-3,39
Ards,9654,8,10,4,16,36,48,-12,34
Portadown,9654,9,8,8,14,24,40,-16,32
Ballinamalla,9654,10,8,7,15,29,48,-19,31
Glentoran,9654,11,7,7,16,26,45,-19,28
Crusaders,9655,1,20,6,4,52,28,24,66
Cliftonville,9655,2,18,5,7,67,37,30,59
Linfield,9655,3,15,6,9,66,42,24,51
Ballymena,9655,4,15,4,11,55,60,-5,49
Coleraine,9655,5,11,9,10,40,37,3,42
Glenavon,9655,6,11,9,10,41,45,-4,42
Ards,9655,7,12,5,13,38,43,-5,41
Dungannon,9655,8,9,8,13,46,40,6,35
Portadown,9655,9,8,5,17,20,40,-20,29
Glentoran,9655,10,6,6,18,25,51,-26,24
Ballinamalla,9655,11,6,5,19,27,54,-27,23
Crusaders,9656,1,17,8,5,54,34,20,59
Ballymena,9656,2,17,5,8,67,56,11,56
Cliftonville,9656,3,14,5,11,55,47,8,47
Coleraine,9656,4,13,8,9,45,39,6,47
Linfield,9656,5,11,9,10,48,38,10,42
Dungannon,9656,6,11,8,11,53,45,8,41
Glenavon,9656,7,8,11,11,38,45,-7,35
Glentoran,9656,8,9,8,13,28,39,-11,35
Ballinamalla,9656,9,10,3,17,32,51,-19,33
Ards,9656,10,9,5,16,34,46,-12,32
Portadown,9656,11,8,6,16,35,49,-14,30
Crusaders,9657,1,17,7,6,62,41,21,58
Glenavon,9657,2,14,10,6,55,41,14,52
Ballymena,9657,3,15,6,9,58,57,1,51
Coleraine,9657,4,14,7,9,41,35,6,49
Linfield,9657,5,14,6,10,61,43,18,48
Cliftonville,9657,6,15,2,13,50,48,2,47
Dungannon,9657,7,11,11,8,56,41,15,44
Glentoran,9657,8,8,7,15,32,43,-11,31
Ballinamalla,9657,9,9,3,18,34,57,-23,30
Ards,9657,10,8,3,19,35,54,-19,27
Portadown,9657,11,8,2,20,27,51,-24,26
Crusaders,9658,1,14,8,8,47,32,15,50
Linfield,9658,2,12,11,7,59,38,21,47
Cliftonville,9658,3,13,8,9,57,43,14,47
Coleraine,9658,4,12,11,7,49,38,11,47
Ballymena,9658,5,14,5,11,59,64,-5,47
Glentoran,9658,6,10,8,12,31,41,-10,38
Dungannon,9658,7,9,10,11,47,44,3,37
Glenavon,9658,8,7,15,8,43,45,-2,36
Ballinamalla,9658,9,11,2,17,33,52,-19,35
Ards,9658,10,8,8,14,38,49,-11,32
Portadown,9658,11,8,8,14,32,49,-17,32
Linfield,9659,1,16,7,7,63,31,32,55
Cliftonville,9659,2,17,4,9,52,34,18,55
Crusaders,9659,3,14,10,6,54,42,12,52
Glenavon,9659,4,13,12,5,56,40,16,51
Dungannon,9659,5,13,8,9,57,40,17,47
Ballymena,9659,6,13,6,11,51,58,-7,45
Glentoran,9659,7,12,7,11,35,47,-12,43
Coleraine,9659,8,8,7,15,39,51,-12,31
Ards,9659,9,9,3,18,40,52,-12,30
Portadown,9659,10,7,5,18,24,50,-26,26
Ballinamalla,9659,11,6,5,19,30,56,-26,23
Linfield,9660,1,17,8,5,67,29,38,59
Cliftonville,9660,2,17,4,9,51,35,16,55
Crusaders,9660,3,13,10,7,43,32,11,49
Coleraine,9660,4,11,10,9,42,36,6,43
Ballymena,9660,5,12,7,11,57,60,-3,43
Dungannon,9660,6,10,7,13,39,41,-2,37
Ards,9660,7,9,9,12,36,43,-7,36
Ballinamalla,9660,8,10,5,15,38,51,-13,35
Glenavon,9660,8,8,11,11,38,51,-13,35
Glentoran,9660,10,7,11,12,30,40,-10,32
Portadown,9660,11,8,4,18,25,48,-23,28
Linfield,9661,1,16,10,4,63,27,36,58
Crusaders,9661,2,16,7,7,53,36,17,55
Ballymena,9661,3,16,7,7,56,50,6,55
Dungannon,9661,4,13,9,8,58,42,16,48
Cliftonville,9661,5,13,5,12,46,38,8,44
Coleraine,9661,6,11,10,9,44,43,1,43
Glenavon,9661,7,8,13,9,48,46,2,37
Ballinamalla,9661,8,9,3,18,33,51,-18,30
Ards,9661,9,8,5,17,36,55,-19,29
Portadown,9661,10,8,5,17,28,49,-21,29
Glentoran,9661,11,7,6,17,22,50,-28,27
Crusaders,9662,1,18,9,3,53,29,24,63
Linfield,9662,2,17,6,7,62,34,28,57
Cliftonville,9662,3,15,6,9,56,40,16,51
Ballymena,9662,4,15,6,9,59,54,5,51
Glenavon,9662,5,13,11,6,50,38,12,50
Coleraine,9662,6,9,11,10,35,46,-11,38
Dungannon,9662,7,9,10,11,51,48,3,37
Ballinamalla,9662,8,10,4,16,36,48,-12,34
Glentoran,9662,9,6,10,14,23,39,-16,28
Portadown,9662,10,7,3,20,25,52,-27,24
Ards,9662,11,6,4,20,31,53,-22,22
Crusaders,9663,1,17,9,4,63,36,27,60
Linfield,9663,2,15,9,6,58,30,28,54
Cliftonville,9663,3,14,6,10,50,37,13,48
Coleraine,9663,4,12,10,8,43,37,6,46
Ballymena,9663,5,12,8,10,50,53,-3,44
Dungannon,9663,6,10,12,8,48,38,10,42
Glentoran,9663,7,11,7,12,31,43,-12,40
Portadown,9663,8,9,6,15,26,42,-16,33
Ards,9663,9,9,5,16,38,49,-11,32
Glenavon,9663,10,6,14,10,36,47,-11,32
Ballinamalla,9663,11,5,4,21,25,56,-31,19
Ballymena,9664,1,17,7,6,58,47,11,58
Crusaders,9664,2,16,5,9,53,43,10,53
Glenavon,9664,3,13,11,6,51,37,14,50
Cliftonville,9664,4,15,4,11,52,36,16,49
Coleraine,9664,5,13,8,9,49,38,11,47
Linfield,9664,6,13,7,10,54,34,20,46
Dungannon,9664,7,9,11,10,46,46,0,38
Ards,9664,8,10,3,17,36,52,-16,33
Glentoran,9664,9,8,7,15,30,46,-16,31
Ballinamalla,9664,10,9,3,18,33,54,-21,30
Portadown,9664,11,6,6,18,24,53,-29,24
Linfield,9665,1,18,8,4,68,27,41,62
Crusaders,9665,2,18,5,7,63,34,29,59
Cliftonville,9665,3,14,4,12,44,39,5,46
Glenavon,9665,4,12,9,9,46,44,2,45
Ballymena,9665,5,13,6,11,59,66,-7,45
Ballinamalla,9665,6,14,3,13,35,44,-9,45
Coleraine,9665,7,9,9,12,39,40,-1,36
Ards,9665,8,10,5,15,35,47,-12,35
Dungannon,9665,9,9,7,14,45,45,0,34
Portadown,9665,10,10,3,17,26,49,-23,33
Glentoran,9665,11,5,7,18,24,49,-25,22
Crusaders,9666,1,16,5,9,53,35,18,53
Linfield,9666,2,14,10,6,60,34,26,52
Coleraine,9666,3,14,9,7,49,37,12,51
Ballymena,9666,4,16,3,11,57,60,-3,51
Cliftonville,9666,5,14,4,12,48,48,0,46
Glenavon,9666,6,8,12,10,41,45,-4,36
Portadown,9666,7,10,6,14,30,37,-7,36
Ards,9666,8,9,7,14,39,46,-7,34
Dungannon,9666,9,8,9,13,52,52,0,33
Ballinamalla,9666,10,9,5,16,34,53,-19,32
Glentoran,9666,11,7,10,13,28,44,-16,31
Crusaders,9667,1,15,9,6,54,37,17,54
Cliftonville,9667,2,15,8,7,58,37,21,53
Linfield,9667,3,13,10,7,48,28,20,49
Coleraine,9667,4,12,10,8,47,44,3,46
Ballymena,9667,5,12,8,10,57,56,1,44
Glenavon,9667,6,11,11,8,44,45,-1,44
Dungannon,9667,7,8,12,10,43,39,4,36
Glentoran,9667,8,9,8,13,37,49,-12,35
Portadown,9667,9,10,4,16,32,45,-13,34
Ards,9667,10,7,7,16,33,48,-15,28
Ballinamalla,9667,11,8,3,19,24,49,-25,27
Linfield,9668,1,17,9,4,65,26,39,60
Crusaders,9668,2,16,10,4,61,33,28,58
Coleraine,9668,3,12,9,9,46,43,3,45
Ballymena,9668,4,13,6,11,59,63,-4,45
Cliftonville,9668,5,13,5,12,49,45,4,44
Glentoran,9668,6,10,7,13,41,59,-18,37
Dungannon,9668,7,8,12,10,52,48,4,36
Glenavon,9668,8,8,11,11,46,52,-6,35
Ards,9668,9,9,7,14,38,43,-5,34
Portadown,9668,10,9,5,16,23,42,-19,32
Ballinamalla,9668,11,6,7,17,28,54,-26,25
Linfield,9669,1,14,10,6,60,34,26,52
Coleraine,9669,2,14,10,6,51,36,15,52
Crusaders,9669,3,14,8,8,48,32,16,50
Glenavon,9669,4,12,12,6,58,46,12,48
Ballymena,9669,5,13,6,11,59,63,-4,45
Dungannon,9669,6,11,9,10,54,43,11,42
Cliftonville,9669,7,11,8,11,51,50,1,41
Glentoran,9669,8,7,12,11,30,44,-14,33
Ards,9669,9,9,5,16,42,54,-12,32
Portadown,9669,10,9,4,17,32,57,-25,31
Ballinamalla,9669,11,8,2,20,27,53,-26,26
Cliftonville,9670,1,14,8,8,56,44,12,50
Crusaders,9670,2,15,5,10,50,42,8,50
Ballymena,9670,3,15,5,10,56,50,6,50
Linfield,9670,4,13,9,8,53,28,25,48
Dungannon,9670,5,12,9,9,55,42,13,45
Coleraine,9670,6,11,11,8,40,41,-1,44
Glenavon,9670,7,9,10,11,44,48,-4,37
Glentoran,9670,8,9,8,13,36,43,-7,35
Ballinamalla,9670,9,10,5,15,33,50,-17,35
Ards,9670,10,10,4,16,36,52,-16,34
Portadown,9670,11,8,4,18,25,44,-19,28
Cliftonville,9671,1,16,5,9,54,40,14,53
Crusaders,9671,2,14,10,6,52,36,16,52
Linfield,9671,3,14,9,7,62,39,23,51
Coleraine,9671,4,12,9,9,50,42,8,45
Glenavon,9671,5,9,15,6,48,46,2,42
Ballymena,9671,6,12,6,12,56,62,-6,42
Ards,9671,7,11,6,13,51,58,-7,39
Dungannon,9671,8,10,7,13,46,41,5,37
Ballinamalla,9671,9,11,2,17,33,53,-20,35
Glentoran,9671,10,8,6,16,29,45,-16,30
Portadown,9671,11,8,5,17,26,45,-19,29
Crusaders,9672,1,16,7,7,55,42,13,55
Linfield,9672,2,15,8,7,62,32,30,53
Ballymena,9672,3,14,6,10,60,62,-2,48
Coleraine,9672,4,11,12,7,44,40,4,45
Dungannon,9672,5,11,11,8,52,41,11,44
Cliftonville,9672,6,11,7,12,44,36,8,40
Glentoran,9672,7,9,10,11,37,40,-3,37
Glenavon,9672,8,8,11,11,41,49,-8,35
Ballinamalla,9672,9,10,5,15,36,47,-11,35
Portadown,9672,10,10,4,16,28,45,-17,34
Ards,9672,11,6,7,17,31,56,-25,25
Crusaders,9673,1,19,5,6,64,37,27,62
Linfield,9673,2,16,7,7,69,41,28,55
Ballymena,9673,3,17,4,9,60,56,4,55
Cliftonville,9673,4,16,5,9,57,36,21,53
Glenavon,9673,5,14,11,5,49,38,11,53
Dungannon,9673,6,12,8,10,53,39,14,44
Coleraine,9673,7,11,9,10,46,43,3,42
Ards,9673,8,8,4,18,37,57,-20,28
Glentoran,9673,9,6,6,18,25,54,-29,24
Ballinamalla,9673,10,5,7,18,25,52,-27,22
Portadown,9673,11,5,6,19,17,49,-32,21
Crusaders,9674,1,19,6,5,61,32,29,63
Cliftonville,9674,2,16,4,10,54,39,15,52
Linfield,9674,3,14,9,7,63,35,28,51
Glenavon,9674,4,13,9,8,51,46,5,48
Ballymena,9674,5,13,5,12,59,60,-1,44
Coleraine,9674,6,10,11,9,40,44,-4,41
Dungannon,9674,7,8,11,11,52,47,5,35
Ards,9674,8,9,7,14,40,51,-11,34
Glentoran,9674,9,9,7,14,34,47,-13,34
Ballinamalla,9674,10,9,4,17,30,51,-21,31
Portadown,9674,11,6,5,19,25,57,-32,23
Linfield,9675,1,18,8,4,55,25,30,62
Crusaders,9675,2,16,6,8,61,40,21,54
Cliftonville,9675,3,15,5,10,54,36,18,50
Glenavon,9675,4,11,10,9,47,46,1,43
Coleraine,9675,5,10,11,9,41,39,2,41
Glentoran,9675,6,10,9,11,37,42,-5,39
Dungannon,9675,7,9,11,10,47,38,9,38
Ballymena,9675,8,10,8,12,51,65,-14,38
Ards,9675,9,8,9,13,40,51,-11,33
Portadown,9675,10,6,8,16,25,46,-21,26
Ballinamalla,9675,11,5,9,16,28,58,-30,24
Ballymena,9676,1,19,5,6,62,47,15,62
Linfield,9676,2,16,6,8,58,32,26,54
Coleraine,9676,3,13,9,8,41,30,11,48
Crusaders,9676,4,14,5,11,52,39,13,47
Cliftonville,9676,5,14,5,11,51,38,13,47
Glenavon,9676,6,11,11,8,44,41,3,44
Ballinamalla,9676,7,13,2,15,31,43,-12,41
Dungannon,9676,8,8,10,12,47,49,-2,34
Ards,9676,9,9,6,15,43,48,-5,33
Glentoran,9676,10,7,7,16,27,54,-27,28
Portadown,9676,11,5,6,19,22,57,-35,21
Crusaders,9677,1,17,10,3,57,33,24,61
Linfield,9677,2,15,9,6,54,31,23,54
Cliftonville,9677,3,15,8,7,53,33,20,53
Ballymena,9677,4,12,10,8,55,55,0,46
Coleraine,9677,5,10,13,7,39,38,1,43
Glenavon,9677,6,10,11,9,42,39,3,41
Dungannon,9677,7,9,10,11,44,39,5,37
Glentoran,9677,8,8,9,13,30,46,-16,33
Ballinamalla,9677,9,8,6,16,34,47,-13,30
Ards,9677,10,6,7,17,31,49,-18,25
Portadown,9677,11,6,5,19,21,50,-29,23
Cliftonville,9678,1,19,2,9,53,36,17,59
Crusaders,9678,2,16,9,5,47,28,19,57
Ballymena,9678,3,17,4,9,61,55,6,55
Linfield,9678,4,14,11,5,59,29,30,53
Glenavon,9678,5,13,11,6,54,46,8,50
Dungannon,9678,6,11,8,11,53,43,10,41
Coleraine,9678,7,9,8,13,37,45,-8,35
Glentoran,9678,8,8,7,15,33,47,-14,31
Ballinamalla,9678,9,9,3,18,32,56,-24,30
Ards,9678,10,7,4,19,39,59,-20,25
Portadown,9678,11,6,5,19,23,47,-24,23
Crusaders,9679,1,17,7,6,60,33,27,58
Linfield,9679,2,14,9,7,59,34,25,51
Ballymena,9679,3,15,4,11,64,62,2,49
Cliftonville,9679,4,14,6,10,59,48,11,48
Glenavon,9679,5,11,14,5,52,45,7,47
Dungannon,9679,6,11,11,8,53,44,9,44
Ards,9679,7,10,7,13,35,43,-8,37
Coleraine,9679,8,7,11,12,42,54,-12,32
Glentoran,9679,9,8,7,15,23,45,-22,31
Portadown,9679,10,9,3,18,34,53,-19,30
Ballinamalla,9679,11,6,7,17,30,50,-20,25
Crusaders,9680,1,18,8,4,61,28,33,62
Linfield,9680,2,15,9,6,53,28,25,54
Cliftonville,9680,3,16,6,8,58,37,21,54
Glenavon,9680,4,11,10,9,49,45,4,43
Ballymena,9680,5,12,5,13,54,67,-13,41
Coleraine,9680,6,10,9,11,43,44,-1,39
Glentoran,9680,7,11,5,14,30,44,-14,38
Ards,9680,8,10,4,16,39,46,-7,34
Dungannon,9680,9,8,9,13,47,51,-4,33
Portadown,9680,10,8,6,16,22,39,-17,30
Ballinamalla,9680,11,8,5,17,24,51,-27,29
Cliftonville,9681,1,17,6,7,63,41,22,57
Crusaders,9681,2,17,6,7,54,33,21,57
Glenavon,9681,3,15,11,4,49,31,18,56
Linfield,9681,4,15,10,5,61,34,27,55
Coleraine,9681,5,11,9,10,42,39,3,42
Ballymena,9681,6,12,4,14,53,65,-12,40
Glentoran,9681,7,10,9,11,34,40,-6,39
Dungannon,9681,8,6,12,12,43,46,-3,30
Portadown,9681,9,8,5,17,28,53,-25,29
Ards,9681,10,6,7,17,41,58,-17,25
Ballinamalla,9681,11,7,3,20,31,59,-28,24
Cliftonville,9682,1,16,8,6,62,35,27,56
Crusaders,9682,2,16,7,7,52,35,17,55
Ballymena,9682,3,16,6,8,60,57,3,54
Linfield,9682,4,13,10,7,60,38,22,49
Coleraine,9682,5,11,10,9,42,45,-3,43
Glentoran,9682,6,12,5,13,45,54,-9,41
Glenavon,9682,7,10,10,10,50,48,2,40
Dungannon,9682,8,8,11,11,49,49,0,35
Ards,9682,9,9,3,18,43,58,-15,30
Portadown,9682,10,7,7,16,32,50,-18,28
Ballinamalla,9682,11,6,5,19,29,55,-26,23
Crusaders,9683,1,17,8,5,56,29,27,59
Linfield,9683,2,15,8,7,61,33,28,53
Coleraine,9683,3,12,12,6,51,37,14,48
Cliftonville,9683,4,13,8,9,53,43,10,47
Glenavon,9683,5,11,14,5,47,40,7,47
Ballymena,9683,6,11,9,10,54,58,-4,42
Dungannon,9683,7,9,11,10,48,45,3,38
Glentoran,9683,8,9,7,14,26,44,-18,34
Ards,9683,9,7,6,17,29,47,-18,27
Portadown,9683,10,7,6,17,25,48,-23,27
Ballinamalla,9683,11,6,7,17,26,52,-26,25
Crusaders,9684,1,15,10,5,58,33,25,55
Cliftonville,9684,2,17,4,9,58,38,20,55
Coleraine,9684,3,13,8,9,47,40,7,47
Ballymena,9684,4,14,5,11,59,53,6,47
Glentoran,9684,5,13,7,10,36,36,0,46
Linfield,9684,6,11,10,9,57,37,20,43
Glenavon,9684,7,10,9,11,49,52,-3,39
Ards,9684,8,11,4,15,37,57,-20,37
Dungannon,9684,9,7,9,14,39,45,-6,30
Ballinamalla,9684,10,8,6,16,31,55,-24,30
Portadown,9684,11,7,6,17,27,52,-25,27
Crusaders,9685,1,18,8,4,58,32,26,62
Linfield,9685,2,17,8,5,61,27,34,59
Glenavon,9685,3,13,11,6,56,42,14,50
Cliftonville,9685,4,14,6,10,47,33,14,48
Dungannon,9685,5,11,8,11,54,48,6,41
Ballymena,9685,6,11,8,11,49,59,-10,41
Glentoran,9685,7,11,7,12,31,38,-7,40
Coleraine,9685,8,9,11,10,41,44,-3,38
Portadown,9685,9,8,6,16,32,48,-16,30
Ards,9685,10,8,5,17,34,54,-20,29
Ballinamalla,9685,11,4,4,22,26,64,-38,16
Crusaders,9686,1,15,7,8,52,38,14,52
Linfield,9686,2,13,11,6,54,36,18,50
Cliftonville,9686,3,15,4,11,50,41,9,49
Coleraine,9686,4,12,12,6,48,34,14,48
Ballymena,9686,5,13,8,9,57,55,2,47
Glenavon,9686,6,11,11,8,48,46,2,44
Glentoran,9686,7,12,7,11,39,35,4,43
Ards,9686,8,11,6,13,45,53,-8,39
Dungannon,9686,9,9,11,10,49,42,7,38
Ballinamalla,9686,10,6,4,20,28,55,-27,22
Portadown,9686,11,6,3,21,21,56,-35,21
Crusaders,9687,1,16,7,7,53,29,24,55
Cliftonville,9687,2,17,4,9,50,36,14,55
Ballymena,9687,3,17,4,9,61,55,6,55
Coleraine,9687,4,12,10,8,46,36,10,46
Dungannon,9687,5,11,10,9,52,43,9,43
Linfield,9687,6,11,9,10,51,34,17,42
Glenavon,9687,7,9,9,12,43,49,-6,36
Glentoran,9687,8,8,10,12,28,42,-14,34
Portadown,9687,9,10,4,16,32,48,-16,34
Ballinamalla,9687,10,9,4,17,30,51,-21,31
Ards,9687,11,7,5,18,33,56,-23,26
Crusaders,9688,1,17,9,4,57,34,23,60
Cliftonville,9688,2,17,4,9,60,41,19,55
Linfield,9688,3,15,7,8,58,33,25,52
Coleraine,9688,4,13,10,7,46,37,9,49
Glenavon,9688,5,12,11,7,44,38,6,47
Dungannon,9688,6,11,9,10,54,43,11,42
Ballymena,9688,7,11,7,12,56,61,-5,40
Glentoran,9688,8,10,6,14,36,51,-15,36
Ards,9688,9,9,4,17,35,52,-17,31
Ballinamalla,9688,10,8,4,18,27,49,-22,28
Portadown,9688,11,5,3,22,19,53,-34,18
Cliftonville,9689,1,18,4,8,60,39,21,58
Crusaders,9689,2,16,7,7,54,36,18,55
Linfield,9689,3,15,8,7,56,34,22,53
Ballymena,9689,4,16,5,9,51,55,-4,53
Dungannon,9689,5,11,11,8,51,37,14,44
Coleraine,9689,6,10,10,10,41,37,4,40
Glenavon,9689,7,8,11,11,43,48,-5,35
Glentoran,9689,8,9,6,15,27,42,-15,33
Ballinamalla,9689,9,9,4,17,32,51,-19,31
Ards,9689,10,8,6,16,30,44,-14,30
Portadown,9689,11,8,2,20,25,47,-22,26
Ballymena,9690,1,16,5,9,56,54,2,53
Crusaders,9690,2,15,7,8,50,32,18,52
Linfield,9690,3,14,9,7,54,26,28,51
Dungannon,9690,4,13,9,8,50,39,11,48
Cliftonville,9690,5,14,4,12,48,43,5,46
Glenavon,9690,6,11,9,10,52,44,8,42
Coleraine,9690,7,10,11,9,41,34,7,41
Ards,9690,8,10,5,15,39,52,-13,35
Glentoran,9690,9,9,7,14,26,40,-14,34
Portadown,9690,10,8,4,18,24,52,-28,28
Ballinamalla,9690,11,7,6,17,23,47,-24,27
Crusaders,9691,1,17,6,7,60,37,23,57
Ballymena,9691,2,16,6,8,59,53,6,54
Linfield,9691,3,14,11,5,61,32,29,53
Cliftonville,9691,4,14,8,8,54,42,12,50
Coleraine,9691,5,13,10,7,47,35,12,49
Glenavon,9691,6,11,9,10,48,46,2,42
Portadown,9691,7,11,4,15,32,40,-8,37
Dungannon,9691,8,9,8,13,49,55,-6,35
Ballinamalla,9691,9,10,3,17,31,51,-20,33
Ards,9691,10,7,4,19,31,53,-22,25
Glentoran,9691,11,6,5,19,26,54,-28,23
Linfield,9692,1,15,10,5,68,37,31,55
Crusaders,9692,2,16,6,8,68,46,22,54
Ballymena,9692,3,14,8,8,57,53,4,50
Cliftonville,9692,4,15,4,11,51,41,10,49
Glenavon,9692,5,12,13,5,48,41,7,49
Coleraine,9692,6,10,11,9,47,43,4,41
Dungannon,9692,7,9,8,13,55,56,-1,35
Portadown,9692,8,9,8,13,30,37,-7,35
Glentoran,9692,9,8,7,15,28,48,-20,31
Ballinamalla,9692,10,8,6,16,33,56,-23,30
Ards,9692,11,6,5,19,38,65,-27,23
Crusaders,9693,1,19,6,5,62,31,31,63
Linfield,9693,2,15,7,8,64,34,30,52
Ballymena,9693,3,13,8,9,59,58,1,47
Cliftonville,9693,4,14,4,12,50,42,8,46
Glenavon,9693,5,10,14,6,51,50,1,44
Coleraine,9693,6,10,11,9,47,35,12,41
Dungannon,9693,7,11,8,11,58,53,5,41
Glentoran,9693,8,9,9,12,29,43,-14,36
Ballinamalla,9693,9,10,3,17,34,53,-19,33
Ards,9693,10,8,6,16,33,50,-17,30
Portadown,9693,11,6,4,20,23,61,-38,22
Crusaders,9694,1,17,6,7,59,31,28,57
Linfield,9694,2,16,7,7,68,37,31,55
Cliftonville,9694,3,17,4,9,55,37,18,55
Ballymena,9694,4,16,4,10,57,62,-5,52
Coleraine,9694,5,14,9,7,47,35,12,51
Glenavon,9694,6,11,8,11,43,46,-3,41
Ards,9694,7,10,7,13,44,49,-5,37
Ballinamalla,9694,8,10,4,16,30,46,-16,34
Portadown,9694,9,8,6,16,23,45,-22,30
Glentoran,9694,10,5,10,15,26,50,-24,25
Dungannon,9694,11,4,9,17,39,53,-14,21
Linfield,9695,1,15,10,5,64,33,31,55
Crusaders,9695,2,14,11,5,58,33,25,53
Cliftonville,9695,3,14,7,9,62,44,18,49
Coleraine,9695,4,13,10,7,52,43,9,49
Ballymena,9695,5,12,7,11,55,63,-8,43
Dungannon,9695,6,10,9,11,52,50,2,39
Glenavon,9695,7,7,15,8,42,43,-1,36
Portadown,9695,8,10,6,14,31,42,-11,36
Ballinamalla,9695,9,10,6,14,30,47,-17,36
Ards,9695,10,6,8,16,30,57,-27,26
Glentoran,9695,11,5,9,16,27,48,-21,24
Crusaders,9696,1,16,9,5,58,31,27,57
Cliftonville,9696,2,16,4,10,53,36,17,52
Coleraine,9696,3,14,10,6,52,37,15,52
Linfield,9696,4,12,12,6,59,33,26,48
Ballymena,9696,5,12,9,9,55,61,-6,45
Glenavon,9696,6,10,12,8,53,50,3,42
Ards,9696,7,9,7,14,35,44,-9,34
Dungannon,9696,8,8,9,13,38,43,-5,33
Ballinamalla,9696,9,9,6,15,26,47,-21,33
Glentoran,9696,10,8,8,14,29,49,-20,32
Portadown,9696,11,6,4,20,25,52,-27,22
Linfield,9697,1,17,8,5,64,28,36,59
Cliftonville,9697,2,16,6,8,52,36,16,54
Crusaders,9697,3,14,11,5,51,30,21,53
Glenavon,9697,4,12,12,6,51,42,9,48
Ballymena,9697,5,12,9,9,44,50,-6,45
Coleraine,9697,6,9,11,10,43,41,2,38
Dungannon,9697,7,9,11,10,46,45,1,38
Ards,9697,8,9,5,16,37,47,-10,32
Portadown,9697,9,8,7,15,25,39,-14,31
Glentoran,9697,10,6,8,16,27,54,-27,26
Ballinamalla,9697,11,6,6,18,23,51,-28,24
Crusaders,9698,1,18,7,5,47,25,22,61
Linfield,9698,2,16,9,5,59,30,29,57
Cliftonville,9698,3,16,5,9,55,36,19,53
Glenavon,9698,4,12,13,5,46,36,10,49
Ballymena,9698,5,13,8,9,56,54,2,47
Glentoran,9698,6,9,11,10,27,36,-9,38
Coleraine,9698,7,8,11,11,30,38,-8,35
Dungannon,9698,8,8,9,13,47,48,-1,33
Portadown,9698,9,7,9,14,27,43,-16,30
Ballinamalla,9698,10,6,7,17,22,47,-25,25
Ards,9698,11,6,3,21,27,50,-23,21
Linfield,9699,1,15,9,6,64,39,25,54
Cliftonville,9699,2,16,4,10,58,43,15,52
Crusaders,9699,3,13,8,9,53,42,11,47
Coleraine,9699,4,13,8,9,49,39,10,47
Ballymena,9699,5,14,5,11,57,58,-1,47
Dungannon,9699,6,11,11,8,48,40,8,44
Glenavon,9699,7,11,10,9,46,45,1,43
Ballinamalla,9699,8,11,4,15,33,46,-13,37
Glentoran,9699,9,8,8,14,25,42,-17,32
Ards,9699,10,8,4,18,35,50,-15,28
Portadown,9699,11,6,7,17,23,47,-24,25
Crusaders,9700,1,21,7,2,67,32,35,70
Coleraine,9700,2,13,10,7,52,39,13,49
Cliftonville,9700,3,14,4,12,55,45,10,46
Dungannon,9700,4,12,8,10,53,48,5,44
Ballymena,9700,5,12,6,12,55,55,0,42
Linfield,9700,6,9,10,11,49,45,4,37
Ards,9700,7,11,3,16,42,51,-9,36
Glenavon,9700,8,8,11,11,43,49,-6,35
Portadown,9700,9,9,7,14,25,42,-17,34
Glentoran,9700,10,8,8,14,28,40,-12,32
Ballinamalla,9700,11,9,4,17,32,55,-23,31
Linfield,9701,1,16,11,3,67,27,40,59
Crusaders,9701,2,16,8,6,54,35,19,56
Cliftonville,9701,3,16,6,8,55,36,19,54
Ballymena,9701,4,14,8,8,56,53,3,50
Glenavon,9701,5,11,11,8,47,42,5,44
Dungannon,9701,6,10,11,9,48,43,5,41
Coleraine,9701,7,9,12,9,37,44,-7,39
Ards,9701,8,10,4,16,41,55,-14,34
Glentoran,9701,9,7,8,15,31,45,-14,29
Portadown,9701,10,7,5,18,24,50,-26,26
Ballinamalla,9701,11,6,2,22,24,54,-30,20
Crusaders,9702,1,19,7,4,57,28,29,64
Cliftonville,9702,2,17,3,10,51,35,16,54
Linfield,9702,3,14,9,7,55,33,22,51
Ballymena,9702,4,13,6,11,58,63,-5,45
Coleraine,9702,5,10,12,8,40,38,2,42
Glenavon,9702,6,9,12,9,48,46,2,39
Ards,9702,7,11,6,13,38,42,-4,39
Glentoran,9702,8,9,9,12,31,44,-13,36
Portadown,9702,9,9,8,13,24,35,-11,35
Dungannon,9702,10,4,13,13,35,42,-7,25
Ballinamalla,9702,11,6,3,21,21,52,-31,21
Crusaders,9703,1,20,5,5,59,34,25,65
Ballymena,9703,2,17,5,8,64,53,11,56
Linfield,9703,3,14,9,7,58,34,24,51
Coleraine,9703,4,13,10,7,52,40,12,49
Cliftonville,9703,5,14,4,12,47,41,6,46
Dungannon,9703,6,10,9,11,49,44,5,39
Glenavon,9703,7,8,11,11,39,48,-9,35
Ards,9703,8,9,5,16,38,49,-11,32
Glentoran,9703,9,7,9,14,27,48,-21,30
Ballinamalla,9703,10,8,4,18,31,51,-20,28
Portadown,9703,11,8,3,19,25,47,-22,27
Crusaders,9704,1,20,5,5,65,37,28,65
Ballymena,9704,2,15,8,7,61,51,10,53
Linfield,9704,3,13,11,6,54,32,22,50
Cliftonville,9704,4,14,4,12,41,38,3,46
Glenavon,9704,5,11,11,8,47,43,4,44
Dungannon,9704,6,10,10,10,52,43,9,40
Coleraine,9704,7,10,10,10,41,42,-1,40
Ards,9704,8,11,5,14,43,49,-6,38
Portadown,9704,9,8,8,14,28,44,-16,32
Glentoran,9704,10,6,8,16,31,53,-22,26
Ballinamalla,9704,11,5,4,21,24,55,-31,19
Crusaders,9705,1,20,5,5,57,32,25,65
Cliftonville,9705,2,15,6,9,58,44,14,51
Linfield,9705,3,12,11,7,61,37,24,47
Ballymena,9705,4,13,7,10,63,63,0,46
Coleraine,9705,5,11,10,9,42,40,2,43
Dungannon,9705,6,11,8,11,58,46,12,41
Glenavon,9705,7,9,13,8,43,45,-2,40
Glentoran,9705,8,11,6,13,38,49,-11,39
Portadown,9705,9,7,8,15,31,44,-13,29
Ballinamalla,9705,10,8,4,18,25,49,-24,28
Ards,9705,11,6,6,18,30,57,-27,24
Crusaders,9706,1,18,6,6,61,39,22,60
Ballymena,9706,2,16,5,9,65,65,0,53
Linfield,9706,3,14,10,6,69,41,28,52
Cliftonville,9706,4,15,7,8,57,36,21,52
Coleraine,9706,5,12,11,7,52,42,10,47
Dungannon,9706,6,10,10,10,49,43,6,40
Glenavon,9706,7,10,8,12,46,53,-7,38
Ards,9706,8,9,8,13,43,52,-9,35
Portadown,9706,9,9,4,17,33,51,-18,31
Glentoran,9706,10,6,6,18,31,56,-25,24
Ballinamalla,9706,11,6,5,19,29,57,-28,23
Crusaders,9707,1,16,8,6,55,34,21,56
Linfield,9707,2,15,8,7,58,31,27,53
Glenavon,9707,3,15,8,7,46,35,11,53
Cliftonville,9707,4,14,5,11,48,38,10,47
Ballymena,9707,5,13,7,10,55,60,-5,46
Dungannon,9707,6,12,9,9,46,38,8,45
Coleraine,9707,7,10,10,10,44,42,2,40
Ards,9707,8,9,4,17,37,52,-15,31
Glentoran,9707,9,8,6,16,33,50,-17,30
Portadown,9707,10,8,5,17,25,43,-18,29
Ballinamalla,9707,11,6,8,16,28,52,-24,26
Crusaders,9708,1,18,8,4,61,33,28,62
Linfield,9708,2,16,10,4,63,27,36,58
Cliftonville,9708,3,14,7,9,50,38,12,49
Glenavon,9708,4,12,12,6,55,43,12,48
Ballymena,9708,5,13,9,8,62,62,0,48
Coleraine,9708,6,11,10,9,41,38,3,43
Dungannon,9708,7,11,8,11,54,44,10,41
Ards,9708,8,9,5,16,38,52,-14,32
Glentoran,9708,9,8,7,15,33,49,-16,31
Ballinamalla,9708,10,6,3,21,26,61,-35,21
Portadown,9708,11,5,5,20,24,60,-36,20
Cliftonville,9709,1,18,5,7,53,28,25,59
Crusaders,9709,2,17,6,7,60,34,26,57
Linfield,9709,3,14,9,7,59,32,27,51
Glenavon,9709,4,14,9,7,51,43,8,51
Ballymena,9709,5,14,5,11,52,55,-3,47
Glentoran,9709,6,10,7,13,34,45,-11,37
Ards,9709,7,11,3,16,49,53,-4,36
Coleraine,9709,8,9,7,14,37,49,-12,34
Dungannon,9709,9,7,12,11,50,43,7,33
Portadown,9709,10,9,5,16,26,46,-20,32
Ballinamalla,9709,11,6,4,20,23,66,-43,22
Cliftonville,9710,1,17,4,9,58,42,16,55
Crusaders,9710,2,15,8,7,63,46,17,53
Ballymena,9710,3,15,7,8,71,63,8,52
Glenavon,9710,4,13,7,10,49,45,4,46
Linfield,9710,5,12,9,9,53,34,19,45
Dungannon,9710,6,10,11,9,50,44,6,41
Coleraine,9710,7,10,9,11,48,45,3,39
Glentoran,9710,8,10,7,13,37,50,-13,37
Portadown,9710,9,10,2,18,22,41,-19,32
Ballinamalla,9710,10,10,1,19,35,57,-22,31
Ards,9710,11,8,5,17,32,51,-19,29
Crusaders,9711,1,17,8,5,66,39,27,59
Cliftonville,9711,2,14,6,10,52,45,7,48
Ballymena,9711,3,12,8,10,50,57,-7,44
Linfield,9711,4,10,13,7,47,34,13,43
Glenavon,9711,5,10,13,7,49,44,5,43
Coleraine,9711,6,10,12,8,42,39,3,42
Dungannon,9711,7,11,8,11,57,43,14,41
Glentoran,9711,8,8,10,12,28,40,-12,34
Portadown,9711,9,8,9,13,23,39,-16,33
Ballinamalla,9711,10,9,5,16,38,54,-16,32
Ards,9711,11,7,6,17,38,56,-18,27
Cliftonville,9712,1,17,4,9,57,36,21,55
Linfield,9712,2,15,9,6,57,29,28,54
Dungannon,9712,3,15,7,8,62,42,20,52
Ballymena,9712,4,15,6,9,61,56,5,51
Crusaders,9712,5,14,7,9,54,44,10,49
Glenavon,9712,6,12,9,9,47,48,-1,45
Coleraine,9712,7,10,11,9,48,48,0,41
Ards,9712,8,9,6,15,32,43,-11,33
Ballinamalla,9712,9,9,4,17,32,53,-21,31
Glentoran,9712,10,5,9,16,26,49,-23,24
Portadown,9712,11,4,8,18,22,50,-28,20
Crusaders,9713,1,19,7,4,55,27,28,64
Linfield,9713,2,18,9,3,61,23,38,63
Ballymena,9713,3,15,6,9,59,52,7,51
Coleraine,9713,4,12,8,10,43,37,6,44
Cliftonville,9713,5,13,4,13,50,42,8,43
Dungannon,9713,6,10,9,11,45,39,6,39
Glentoran,9713,7,11,6,13,32,46,-14,39
Glenavon,9713,8,9,9,12,45,50,-5,36
Ballinamalla,9713,9,6,9,15,32,52,-20,27
Portadown,9713,10,8,3,19,23,52,-29,27
Ards,9713,11,6,6,18,34,59,-25,24
Linfield,9714,1,16,10,4,65,29,36,58
Crusaders,9714,2,17,6,7,58,37,21,57
Ballymena,9714,3,16,5,9,65,57,8,53
Cliftonville,9714,4,14,4,12,48,43,5,46
Coleraine,9714,5,12,9,9,41,37,4,45
Dungannon,9714,6,11,10,9,45,36,9,43
Glentoran,9714,7,11,6,13,33,43,-10,39
Glenavon,9714,8,9,11,10,46,50,-4,38
Portadown,9714,9,9,6,15,30,47,-17,33
Ards,9714,10,7,6,17,32,50,-18,27
Ballinamalla,9714,11,3,7,20,21,55,-34,16
Crusaders,9715,1,15,9,6,58,37,21,54
Ballymena,9715,2,15,7,8,60,51,9,52
Linfield,9715,3,12,8,10,53,39,14,44
Cliftonville,9715,4,13,5,12,60,52,8,44
Dungannon,9715,5,12,8,10,51,44,7,44
Ards,9715,6,13,5,12,45,46,-1,44
Glenavon,9715,7,9,15,6,47,47,0,42
Coleraine,9715,8,11,9,10,41,43,-2,42
Glentoran,9715,9,8,8,14,31,46,-15,32
Portadown,9715,10,9,4,17,29,45,-16,31
Ballinamalla,9715,11,7,4,19,34,59,-25,25
Cliftonville,9716,1,18,2,10,56,40,16,56
Linfield,9716,2,14,10,6,57,29,28,52
Crusaders,9716,3,14,5,11,54,42,12,47
Ballymena,9716,4,14,5,11,59,54,5,47
Coleraine,9716,5,12,10,8,40,39,1,46
Glenavon,9716,6,11,10,9,46,53,-7,43
Glentoran,9716,7,11,7,12,36,45,-9,40
Dungannon,9716,8,10,9,11,58,50,8,39
Ards,9716,9,10,6,14,37,44,-7,36
Ballinamalla,9716,10,9,7,14,35,52,-17,34
Portadown,9716,11,4,5,21,26,56,-30,17
Crusaders,9717,1,18,6,6,58,36,22,60
Linfield,9717,2,16,9,5,58,34,24,57
Dungannon,9717,3,13,10,7,58,38,20,49
Cliftonville,9717,4,14,5,11,52,40,12,47
Glenavon,9717,5,13,7,10,52,51,1,46
Ballymena,9717,6,12,7,11,60,56,4,43
Coleraine,9717,7,9,11,10,40,40,0,38
Portadown,9717,8,10,4,16,26,47,-21,34
Ballinamalla,9717,9,10,2,18,36,55,-19,32
Glentoran,9717,10,8,6,16,24,42,-18,30
Ards,9717,11,6,5,19,33,58,-25,23
Cliftonville,9718,1,18,5,7,53,33,20,59
Linfield,9718,2,15,9,6,58,28,30,54
Crusaders,9718,3,16,6,8,55,32,23,54
Coleraine,9718,4,13,9,8,48,34,14,48
Glenavon,9718,5,11,11,8,40,51,-11,44
Ballymena,9718,6,12,7,11,54,55,-1,43
Dungannon,9718,7,10,8,12,46,39,7,38
Ballinamalla,9718,8,10,6,14,30,43,-13,36
Ards,9718,9,9,4,17,39,52,-13,31
Glentoran,9718,10,8,7,15,26,49,-23,31
Portadown,9718,11,3,8,19,18,51,-33,17
Crusaders,9719,1,16,7,7,51,35,16,55
Linfield,9719,2,15,9,6,58,29,29,54
Cliftonville,9719,3,15,5,10,45,31,14,50
Coleraine,9719,4,11,10,9,42,37,5,43
Glenavon,9719,5,10,13,7,42,42,0,43
Dungannon,9719,6,10,10,10,47,42,5,40
Ballymena,9719,7,11,7,12,46,58,-12,40
Ards,9719,8,10,6,14,35,42,-7,36
Ballinamalla,9719,9,10,3,17,34,50,-16,33
Portadown,9719,10,9,4,17,32,45,-13,31
Glentoran,9719,11,7,8,15,22,43,-21,29
Cliftonville,9720,1,16,6,8,62,39,23,54
Ballymena,9720,2,15,8,7,57,51,6,53
Glenavon,9720,3,14,10,6,46,38,8,52
Coleraine,9720,4,13,8,9,46,38,8,47
Crusaders,9720,5,13,6,11,54,49,5,45
Linfield,9720,6,10,9,11,51,41,10,39
Dungannon,9720,7,9,8,13,49,48,1,35
Glentoran,9720,8,9,8,13,28,44,-16,35
Ards,9720,9,10,4,16,35,45,-10,34
Ballinamalla,9720,10,10,3,17,33,51,-18,33
Portadown,9720,11,9,4,17,30,47,-17,31
Crusaders,9721,1,15,8,7,58,41,17,53
Linfield,9721,2,14,10,6,61,30,31,52
Coleraine,9721,3,13,13,4,47,33,14,52
Cliftonville,9721,4,14,7,9,52,43,9,49
Dungannon,9721,5,10,11,9,56,46,10,41
Glenavon,9721,6,9,13,8,41,43,-2,40
Ballymena,9721,7,11,6,13,51,59,-8,39
Ards,9721,8,11,3,16,40,47,-7,36
Glentoran,9721,9,9,7,14,31,46,-15,34
Ballinamalla,9721,10,7,6,17,29,52,-23,27
Portadown,9721,11,7,6,17,20,46,-26,27
Linfield,9722,1,17,10,3,64,24,40,61
Crusaders,9722,2,17,7,6,60,35,25,58
Glenavon,9722,3,13,10,7,57,42,15,49
Cliftonville,9722,4,15,3,12,54,44,10,48
Ballymena,9722,5,13,7,10,59,60,-1,46
Coleraine,9722,6,12,9,9,44,41,3,45
Dungannon,9722,7,10,10,10,52,49,3,40
Ballinamalla,9722,8,10,4,16,33,56,-23,34
Ards,9722,9,8,4,18,41,57,-16,28
Glentoran,9722,10,7,7,16,26,47,-21,28
Portadown,9722,11,4,7,19,19,54,-35,19
Linfield,9723,1,18,9,3,67,26,41,63
Crusaders,9723,2,17,5,8,64,39,25,56
Cliftonville,9723,3,17,4,9,56,40,16,55
Glenavon,9723,4,14,9,7,54,46,8,51
Ballymena,9723,5,15,5,10,59,62,-3,50
Coleraine,9723,6,13,8,9,40,36,4,47
Dungannon,9723,7,10,8,12,47,41,6,38
Ards,9723,8,7,5,18,34,55,-21,26
Glentoran,9723,9,6,8,16,21,47,-26,26
Ballinamalla,9723,10,6,6,18,37,63,-26,24
Portadown,9723,11,6,5,19,25,49,-24,23
Crusaders,9724,1,18,5,7,64,38,26,59
Glenavon,9724,2,14,12,4,55,39,16,54
Linfield,9724,3,15,8,7,58,27,31,53
Cliftonville,9724,4,16,4,10,60,45,15,52
Ballymena,9724,5,13,5,12,52,66,-14,44
Glentoran,9724,6,11,6,13,34,40,-6,39
Ballinamalla,9724,7,11,6,13,38,48,-10,39
Coleraine,9724,8,10,8,12,41,45,-4,38
Portadown,9724,9,11,4,15,30,45,-15,37
Dungannon,9724,10,5,8,17,45,58,-13,23
Ards,9724,11,7,2,21,28,54,-26,23
Crusaders,9725,1,17,7,6,55,26,29,58
Cliftonville,9725,2,17,4,9,50,31,19,55
Ballymena,9725,3,15,8,7,67,54,13,53
Linfield,9725,4,11,11,8,53,39,14,44
Coleraine,9725,5,10,14,6,40,33,7,44
Glenavon,9725,6,9,11,10,43,54,-11,38
Dungannon,9725,7,9,10,11,49,47,2,37
Ards,9725,8,10,6,14,43,49,-6,36
Ballinamalla,9725,9,8,6,16,37,54,-17,30
Glentoran,9725,10,7,7,16,28,53,-25,28
Portadown,9725,11,7,6,17,27,52,-25,27
Crusaders,9726,1,15,8,7,53,35,18,53
Cliftonville,9726,2,16,4,10,54,39,15,52
Ballymena,9726,3,14,9,7,62,55,7,51
Coleraine,9726,4,13,10,7,43,35,8,49
Linfield,9726,5,13,8,9,58,46,12,47
Glenavon,9726,6,11,9,10,40,42,-2,42
Dungannon,9726,7,10,9,11,54,43,11,39
Glentoran,9726,8,11,6,13,38,44,-6,39
Ballinamalla,9726,9,10,2,18,31,56,-25,32
Ards,9726,10,7,6,17,38,53,-15,27
Portadown,9726,11,6,7,17,26,49,-23,25
Crusaders,9727,1,19,7,4,66,32,34,64
Linfield,9727,2,17,10,3,63,26,37,61
Cliftonville,9727,3,16,4,10,59,42,17,52
Ballymena,9727,4,13,6,11,55,58,-3,45
Dungannon,9727,5,12,8,10,58,46,12,44
Glenavon,9727,6,10,12,8,47,48,-1,42
Coleraine,9727,7,10,9,11,46,45,1,39
Glentoran,9727,8,8,7,15,30,47,-17,31
Ards,9727,9,8,6,16,32,53,-21,30
Ballinamalla,9727,10,7,6,17,29,53,-24,27
Portadown,9727,11,6,3,21,20,55,-35,21
Ballymena,9728,1,18,4,8,58,47,11,58
Crusaders,9728,2,16,5,9,59,43,16,53
Cliftonville,9728,3,15,5,10,46,35,11,50
Linfield,9728,4,13,9,8,56,36,20,48
Coleraine,9728,5,12,9,9,42,42,0,45
Dungannon,9728,6,11,8,11,51,40,11,41
Glenavon,9728,7,11,8,11,50,48,2,41
Glentoran,9728,8,9,8,13,37,45,-8,35
Ballinamalla,9728,9,8,7,15,30,51,-21,31
Ards,9728,10,7,8,15,39,54,-15,29
Portadown,9728,11,5,9,16,21,48,-27,24
Crusaders,9729,1,16,7,7,52,34,18,55
Linfield,9729,2,15,8,7,60,30,30,53
Glenavon,9729,3,11,11,8,44,43,1,44
Ballymena,9729,4,11,10,9,53,56,-3,43
Cliftonville,9729,5,12,6,12,43,40,3,42
Glentoran,9729,6,11,9,10,36,38,-2,42
Portadown,9729,7,12,5,13,30,40,-10,41
Dungannon,9729,8,10,10,10,57,46,11,40
Coleraine,9729,9,9,9,12,33,38,-5,36
Ards,9729,10,8,7,15,39,53,-14,31
Ballinamalla,9729,11,5,8,17,26,55,-29,23
Crusaders,9730,1,17,6,7,52,32,20,57
Ballymena,9730,2,16,4,10,63,54,9,52
Cliftonville,9730,3,15,5,10,50,38,12,50
Glenavon,9730,4,14,8,8,54,47,7,50
Coleraine,9730,5,12,11,7,42,38,4,47
Linfield,9730,6,12,10,8,50,30,20,46
Dungannon,9730,7,11,8,11,52,43,9,41
Glentoran,9730,8,8,10,12,32,45,-13,34
Ards,9730,9,7,9,14,37,52,-15,30
Ballinamalla,9730,10,7,3,20,32,57,-25,24
Portadown,9730,11,5,8,17,23,51,-28,23
Cliftonville,9731,1,17,6,7,57,35,22,57
Linfield,9731,2,15,10,5,58,25,33,55
Crusaders,9731,3,15,7,8,56,38,18,52
Glenavon,9731,4,13,9,8,47,43,4,48
Glentoran,9731,5,11,7,12,32,43,-11,40
Coleraine,9731,6,8,12,10,34,35,-1,36
Ballymena,9731,7,10,6,14,48,61,-13,36
Dungannon,9731,8,7,13,10,43,44,-1,34
Ards,9731,9,8,9,13,40,49,-9,33
Ballinamalla,9731,10,8,6,16,29,50,-21,30
Portadown,9731,11,8,5,17,24,45,-21,29
Crusaders,9732,1,18,4,8,56,34,22,58
Linfield,9732,2,16,8,6,55,26,29,56
Glenavon,9732,3,14,9,7,57,47,10,51
Ballymena,9732,4,13,6,11,51,59,-8,45
Coleraine,9732,5,10,13,7,44,37,7,43
Cliftonville,9732,6,13,4,13,43,41,2,43
Dungannon,9732,7,11,9,10,54,40,14,42
Glentoran,9732,8,12,6,12,35,47,-12,42
Ballinamalla,9732,9,10,2,18,35,55,-20,32
Ards,9732,10,6,6,18,30,51,-21,24
Portadown,9732,11,7,3,20,23,46,-23,24
Linfield,9733,1,16,11,3,62,27,35,59
Glenavon,9733,2,14,11,5,49,35,14,53
Cliftonville,9733,3,15,7,8,52,39,13,52
Crusaders,9733,4,14,8,8,54,41,13,50
Ballymena,9733,5,14,5,11,60,61,-1,47
Dungannon,9733,6,13,7,10,55,39,16,46
Coleraine,9733,7,10,12,8,42,38,4,42
Glentoran,9733,8,8,9,13,30,44,-14,33
Ards,9733,9,8,5,17,29,46,-17,29
Ballinamalla,9733,10,6,5,19,25,57,-32,23
Portadown,9733,11,5,4,21,20,51,-31,19
Cliftonville,9734,1,16,5,9,57,36,21,53
Crusaders,9734,2,15,7,8,56,37,19,52
Linfield,9734,3,14,8,8,57,42,15,50
Glenavon,9734,4,14,8,8,55,45,10,50
Ballymena,9734,5,12,10,8,52,56,-4,46
Dungannon,9734,6,11,8,11,52,45,7,41
Coleraine,9734,7,10,9,11,41,44,-3,39
Ballinamalla,9734,8,10,4,16,36,52,-16,34
Glentoran,9734,9,8,9,13,32,47,-15,33
Ards,9734,10,9,5,16,43,53,-10,32
Portadown,9734,11,7,5,18,26,50,-24,26
Ballymena,9735,1,18,7,5,65,48,17,61
Crusaders,9735,2,17,6,7,58,35,23,57
Linfield,9735,3,15,9,6,57,30,27,54
Cliftonville,9735,4,14,4,12,46,43,3,46
Coleraine,9735,5,11,10,9,46,41,5,43
Glenavon,9735,6,10,11,9,48,48,0,41
Dungannon,9735,7,10,10,10,53,41,12,40
Glentoran,9735,8,7,11,12,35,44,-9,32
Ards,9735,9,8,6,16,34,51,-17,30
Ballinamalla,9735,10,6,6,18,28,57,-29,24
Portadown,9735,11,6,6,18,21,53,-32,24
Crusaders,9736,1,20,7,3,56,24,32,67
Cliftonville,9736,2,18,3,9,62,41,21,57
Linfield,9736,3,14,10,6,55,30,25,52
Coleraine,9736,4,12,12,6,42,38,4,48
Glenavon,9736,5,12,10,8,50,39,11,46
Ballymena,9736,6,11,7,12,53,57,-4,40
Dungannon,9736,7,8,8,14,45,45,0,32
Glentoran,9736,8,9,5,16,33,51,-18,32
Ards,9736,9,8,5,17,32,50,-18,29
Portadown,9736,10,7,7,16,24,53,-29,28
Ballinamalla,9736,11,7,4,19,23,47,-24,25
Linfield,9737,1,17,8,5,69,30,39,59
Cliftonville,9737,2,18,3,9,61,43,18,57
Crusaders,9737,3,14,8,8,52,35,17,50
Glenavon,9737,4,12,13,5,51,37,14,49
Ballymena,9737,5,14,4,12,57,62,-5,46
Coleraine,9737,6,10,13,7,51,43,8,43
Dungannon,9737,7,10,11,9,48,43,5,41
Glentoran,9737,8,7,10,13,27,44,-17,31
Ballinamalla,9737,9,7,6,17,28,54,-26,27
Portadown,9737,10,6,7,17,24,52,-28,25
Ards,9737,11,6,5,19,34,59,-25,23
Linfield,9738,1,17,9,4,67,28,39,60
Crusaders,9738,2,16,5,9,49,31,18,53
Dungannon,9738,3,14,9,7,61,42,19,51
Coleraine,9738,4,11,11,8,42,35,7,44
Cliftonville,9738,5,13,4,13,47,47,0,43
Ballymena,9738,6,12,5,13,53,65,-12,41
Glenavon,9738,7,8,14,8,40,46,-6,38
Ards,9738,8,9,9,12,39,49,-10,36
Glentoran,9738,9,9,7,14,36,47,-11,34
Portadown,9738,10,8,5,17,31,47,-16,29
Ballinamalla,9738,11,6,6,18,25,53,-28,24
Crusaders,9739,1,16,5,9,55,40,15,53
Linfield,9739,2,15,7,8,54,33,21,52
Cliftonville,9739,3,15,5,10,49,42,7,50
Glenavon,9739,4,12,11,7,51,41,10,47
Ballymena,9739,5,13,6,11,59,59,0,45
Glentoran,9739,6,13,6,11,35,40,-5,45
Coleraine,9739,7,10,12,8,42,37,5,42
Portadown,9739,8,11,4,15,32,43,-11,37
Dungannon,9739,9,9,7,14,47,49,-2,34
Ards,9739,10,8,6,16,33,47,-14,30
Ballinamalla,9739,11,6,5,19,29,55,-26,23
Crusaders,9740,1,17,7,6,54,29,25,58
Linfield,9740,2,15,10,5,52,26,26,55
Ballymena,9740,3,15,9,6,58,46,12,54
Coleraine,9740,4,13,10,7,41,31,10,49
Cliftonville,9740,5,13,6,11,45,40,5,45
Dungannon,9740,6,10,10,10,47,44,3,40
Glenavon,9740,7,10,10,10,47,51,-4,40
Glentoran,9740,8,7,8,15,28,42,-14,29
Ballinamalla,9740,9,8,5,17,25,48,-23,29
Portadown,9740,10,7,6,17,26,48,-22,27
Ards,9740,11,6,7,17,31,49,-18,25
Crusaders,9741,1,18,7,5,59,32,27,61
Linfield,9741,2,17,7,6,69,36,33,58
Ballymena,9741,3,16,6,8,60,59,1,54
Cliftonville,9741,4,15,5,10,46,35,11,50
Glenavon,9741,5,11,9,10,43,46,-3,42
Dungannon,9741,6,11,7,12,57,46,11,40
Coleraine,9741,7,9,11,10,39,36,3,38
Ballinamalla,9741,8,11,3,16,43,55,-12,36
Ards,9741,9,7,8,15,28,46,-18,29
Glentoran,9741,10,6,7,17,23,48,-25,25
Portadown,9741,11,6,6,18,31,59,-28,24
Crusaders,9742,1,17,9,4,51,28,23,60
Linfield,9742,2,15,8,7,62,34,28,53
Cliftonville,9742,3,15,8,7,48,34,14,53
Coleraine,9742,4,12,9,9,50,41,9,45
Glenavon,9742,5,11,12,7,50,47,3,45
Ballymena,9742,6,12,6,12,54,65,-11,42
Dungannon,9742,7,8,10,12,46,45,1,34
Ards,9742,8,9,6,15,37,48,-11,33
Portadown,9742,9,8,5,17,30,44,-14,29
Glentoran,9742,10,7,8,15,37,57,-20,29
Ballinamalla,9742,11,8,5,17,30,52,-22,29
Cliftonville,9743,1,16,5,9,58,40,18,53
Ballymena,9743,2,15,7,8,58,54,4,52
Crusaders,9743,3,15,6,9,57,47,10,51
Glenavon,9743,4,13,9,8,51,45,6,48
Linfield,9743,5,12,8,10,54,38,16,44
Coleraine,9743,6,11,10,9,38,36,2,43
Dungannon,9743,7,8,11,11,45,43,2,35
Ballinamalla,9743,8,10,5,15,34,48,-14,35
Portadown,9743,9,9,6,15,34,46,-12,33
Ards,9743,10,9,5,16,32,45,-13,32
Glentoran,9743,11,7,8,15,28,47,-19,29
Linfield,9744,1,16,8,6,66,35,31,56
Crusaders,9744,2,14,11,5,56,39,17,53
Cliftonville,9744,3,15,4,11,55,48,7,49
Coleraine,9744,4,12,12,6,43,31,12,48
Glenavon,9744,5,11,11,8,51,49,2,44
Ballymena,9744,6,12,7,11,50,55,-5,43
Dungannon,9744,7,11,9,10,61,50,11,42
Glentoran,9744,8,11,8,11,38,43,-5,41
Ards,9744,9,9,4,17,36,51,-15,31
Portadown,9744,10,7,6,17,29,48,-19,27
Ballinamalla,9744,11,6,2,22,29,65,-36,20
Linfield,9745,1,17,9,4,65,32,33,60
Cliftonville,9745,2,16,6,8,55,36,19,54
Crusaders,9745,3,13,10,7,54,37,17,49
Coleraine,9745,4,12,11,7,43,40,3,47
Ballymena,9745,5,14,5,11,64,64,0,47
Glentoran,9745,6,9,9,12,32,39,-7,36
Portadown,9745,7,10,6,14,28,37,-9,36
Dungannon,9745,8,7,12,11,42,45,-3,33
Ards,9745,9,9,5,16,34,52,-18,32
Glenavon,9745,10,6,11,13,41,57,-16,29
Ballinamalla,9745,11,8,4,18,33,52,-19,28
Linfield,9746,1,16,7,7,62,29,33,55
Crusaders,9746,2,15,7,8,58,40,18,52
Cliftonville,9746,3,15,6,9,53,40,13,51
Coleraine,9746,4,12,11,7,42,35,7,47
Ballymena,9746,5,12,7,11,52,60,-8,43
Dungannon,9746,6,11,7,12,49,46,3,40
Glentoran,9746,7,10,8,12,29,37,-8,38
Ballinamalla,9746,8,10,5,15,34,49,-15,35
Glenavon,9746,9,6,14,10,40,46,-6,32
Portadown,9746,10,9,5,16,22,42,-20,32
Ards,9746,11,7,7,16,37,54,-17,28
Crusaders,9747,1,15,6,9,54,39,15,51
Linfield,9747,2,13,10,7,59,36,23,49
Cliftonville,9747,3,14,6,10,52,40,12,48
Coleraine,9747,4,11,12,7,41,40,1,45
Ballymena,9747,5,13,6,11,52,56,-4,45
Glenavon,9747,6,11,9,10,50,48,2,42
Dungannon,9747,7,10,11,9,57,48,9,41
Ards,9747,8,11,5,14,37,44,-7,38
Portadown,9747,9,9,8,13,34,46,-12,35
Glentoran,9747,10,8,7,15,32,48,-16,31
Ballinamalla,9747,11,9,2,19,26,49,-23,29
Crusaders,9748,1,17,8,5,57,33,24,59
Coleraine,9748,2,14,10,6,48,29,19,52
Linfield,9748,3,13,11,6,54,30,24,50
Cliftonville,9748,4,14,7,9,52,38,14,49
Ballymena,9748,5,12,9,9,58,63,-5,45
Glenavon,9748,6,11,10,9,44,45,-1,43
Dungannon,9748,7,10,8,12,46,46,0,38
Glentoran,9748,8,9,7,14,27,44,-17,34
Ards,9748,9,8,5,17,36,52,-16,29
Portadown,9748,10,7,6,17,26,46,-20,27
Ballinamalla,9748,11,6,7,17,34,56,-22,25
Linfield,9749,1,17,6,7,60,39,21,57
Crusaders,9749,2,16,8,6,54,41,13,56
Ballymena,9749,3,14,6,10,63,52,11,48
Coleraine,9749,4,12,11,7,43,34,9,47
Cliftonville,9749,5,13,4,13,48,46,2,43
Glenavon,9749,6,11,9,10,50,49,1,42
Dungannon,9749,7,10,9,11,56,49,7,39
Glentoran,9749,8,9,8,13,35,51,-16,35
Ards,9749,9,10,4,16,42,52,-10,34
Ballinamalla,9749,10,9,3,18,38,55,-17,30
Portadown,9749,11,8,4,18,25,46,-21,28
Cliftonville,9750,1,16,7,7,55,36,19,55
Crusaders,9750,2,14,7,9,46,37,9,49
Ballymena,9750,3,14,7,9,56,52,4,49
Linfield,9750,4,12,11,7,50,28,22,47
Dungannon,9750,5,11,11,8,53,40,13,44
Coleraine,9750,6,11,10,9,40,44,-4,43
Ards,9750,7,11,5,14,40,46,-6,38
Glenavon,9750,8,8,12,10,46,46,0,36
Glentoran,9750,9,9,8,13,25,38,-13,35
Portadown,9750,10,8,6,16,24,45,-21,30
Ballinamalla,9750,11,5,8,17,29,52,-23,23
Crusaders,9751,1,17,6,7,59,39,20,57
Cliftonville,9751,2,16,8,6,55,31,24,56
Ballymena,9751,3,16,5,9,67,53,14,53
Linfield,9751,4,13,9,8,55,39,16,48
Dungannon,9751,5,13,7,10,61,43,18,46
Glenavon,9751,6,11,10,9,40,44,-4,43
Ards,9751,7,11,5,14,43,50,-7,38
Coleraine,9751,8,8,11,11,41,46,-5,35
Glentoran,9751,9,9,5,16,30,45,-15,32
Ballinamalla,9751,10,8,4,18,30,58,-28,28
Portadown,9751,11,5,6,19,21,54,-33,21
Linfield,9752,1,16,10,4,66,33,33,58
Cliftonville,9752,2,17,4,9,59,41,18,55
Crusaders,9752,3,14,9,7,54,36,18,51
Glenavon,9752,4,13,10,7,49,40,9,49
Ballymena,9752,5,13,6,11,58,59,-1,45
Coleraine,9752,6,11,9,10,41,41,0,42
Ards,9752,7,10,6,14,39,44,-5,36
Glentoran,9752,8,9,8,13,35,50,-15,35
Portadown,9752,9,9,3,18,26,46,-20,30
Dungannon,9752,10,7,8,15,46,55,-9,29
Ballinamalla,9752,11,7,5,18,32,60,-28,26
Crusaders,9753,1,18,6,6,55,27,28,60
Ballymena,9753,2,16,6,8,63,56,7,54
Linfield,9753,3,14,8,8,56,38,18,50
Cliftonville,9753,4,14,6,10,55,48,7,48
Glenavon,9753,5,11,10,9,50,47,3,43
Coleraine,9753,6,8,16,6,43,38,5,40
Glentoran,9753,7,10,5,15,31,44,-13,35
Dungannon,9753,8,7,10,13,42,47,-5,31
Portadown,9753,9,9,4,17,32,47,-15,31
Ards,9753,10,8,6,16,35,51,-16,30
Ballinamalla,9753,11,7,9,14,28,47,-19,30
Crusaders,9754,1,17,9,4,57,29,28,60
Linfield,9754,2,14,7,9,55,35,20,49
Coleraine,9754,3,12,12,6,48,35,13,48
Ballymena,9754,4,13,7,10,52,51,1,46
Glenavon,9754,5,10,12,8,40,44,-4,42
Portadown,9754,6,12,5,13,30,38,-8,41
Cliftonville,9754,7,11,5,14,43,44,-1,38
Glentoran,9754,8,10,7,13,32,43,-11,37
Dungannon,9754,9,7,11,12,47,49,-2,32
Ballinamalla,9754,10,9,5,16,35,53,-18,32
Ards,9754,11,8,4,18,34,52,-18,28
Crusaders,9755,1,15,8,7,49,32,17,53
Cliftonville,9755,2,16,4,10,55,43,12,52
Linfield,9755,3,13,11,6,59,35,24,50
Coleraine,9755,4,13,10,7,45,39,6,49
Ballymena,9755,5,13,6,11,61,58,3,45
Dungannon,9755,6,9,11,10,47,43,4,38
Glenavon,9755,7,10,8,12,47,47,0,38
Ards,9755,8,10,5,15,41,50,-9,35
Ballinamalla,9755,9,9,6,15,26,45,-19,33
Glentoran,9755,10,8,8,14,27,41,-14,32
Portadown,9755,11,7,7,16,20,44,-24,28
Linfield,9756,1,18,8,4,72,30,42,62
Crusaders,9756,2,19,5,6,64,33,31,62
Ballymena,9756,3,16,5,9,64,59,5,53
Cliftonville,9756,4,15,4,11,52,41,11,49
Glenavon,9756,5,11,9,10,47,46,1,42
Coleraine,9756,6,11,8,11,42,45,-3,41
Dungannon,9756,7,10,7,13,48,46,2,37
Ballinamalla,9756,8,11,2,17,29,51,-22,35
Portadown,9756,9,8,5,17,22,51,-29,29
Ards,9756,10,7,5,18,34,51,-17,26
Glentoran,9756,11,6,8,16,26,47,-21,26
Linfield,9757,1,15,8,7,55,28,27,53
Cliftonville,9757,2,15,6,9,54,39,15,51
Crusaders,9757,3,15,5,10,58,42,16,50
Coleraine,9757,4,13,11,6,44,35,9,50
Ballymena,9757,5,13,6,11,60,63,-3,45
Ards,9757,6,13,4,13,42,41,1,43
Glenavon,9757,7,10,9,11,39,51,-12,39
Dungannon,9757,8,9,9,12,47,40,7,36
Portadown,9757,9,9,5,16,31,46,-15,32
Ballinamalla,9757,10,9,4,17,27,50,-23,31
Glentoran,9757,11,7,7,16,26,48,-22,28
Crusaders,9758,1,19,7,4,65,27,38,64
Linfield,9758,2,12,12,6,59,32,27,48
Ballymena,9758,3,14,6,10,56,54,2,48
Cliftonville,9758,4,13,7,10,50,41,9,46
Glenavon,9758,5,12,10,8,47,43,4,46
Coleraine,9758,6,11,10,9,42,44,-2,43
Ards,9758,7,12,5,13,41,46,-5,41
Glentoran,9758,8,10,6,14,28,45,-17,36
Dungannon,9758,9,8,11,11,47,44,3,35
Ballinamalla,9758,10,6,7,17,26,51,-25,25
Portadown,9758,11,5,5,20,21,55,-34,20
Crusaders,9759,1,16,9,5,56,30,26,57
Linfield,9759,2,16,8,6,61,30,31,56
Cliftonville,9759,3,16,8,6,53,34,19,56
Coleraine,9759,4,12,8,10,45,41,4,44
Ballymena,9759,5,12,8,10,51,57,-6,44
Dungannon,9759,6,11,9,10,51,44,7,42
Glenavon,9759,7,10,12,8,41,43,-2,42
Ards,9759,8,9,7,14,38,46,-8,34
Glentoran,9759,9,8,5,17,34,51,-17,29
Portadown,9759,10,7,7,16,23,42,-19,28
Ballinamalla,9759,11,6,3,21,33,68,-35,21
Crusaders,9760,1,19,8,3,63,30,33,65
Cliftonville,9760,2,17,6,7,49,31,18,57
Coleraine,9760,3,11,13,6,41,33,8,46
Glenavon,9760,4,11,10,9,50,46,4,43
Ballymena,9760,5,12,7,11,57,59,-2,43
Linfield,9760,6,11,9,10,49,40,9,42
Glentoran,9760,7,8,11,11,31,43,-12,35
Dungannon,9760,8,8,10,12,47,45,2,34
Ards,9760,9,10,4,16,42,47,-5,34
Portadown,9760,10,7,7,16,31,61,-30,28
Ballinamalla,9760,11,5,7,18,32,57,-25,22
Linfield,9761,1,16,8,6,56,26,30,56
Crusaders,9761,2,14,9,7,52,37,15,51
Coleraine,9761,3,14,9,7,45,36,9,51
Cliftonville,9761,4,14,5,11,54,41,13,47
Ballymena,9761,5,13,7,10,59,60,-1,46
Ards,9761,6,14,2,14,46,47,-1,44
Dungannon,9761,7,9,10,11,43,44,-1,37
Glenavon,9761,8,8,12,10,41,45,-4,36
Portadown,9761,9,9,5,16,26,43,-17,32
Ballinamalla,9761,10,8,4,18,29,49,-20,28
Glentoran,9761,11,7,7,16,27,50,-23,28
Linfield,9762,1,17,7,6,69,39,30,58
Cliftonville,9762,2,16,6,8,54,37,17,54
Ballymena,9762,3,14,6,10,58,59,-1,48
Crusaders,9762,4,14,5,11,47,36,11,47
Coleraine,9762,5,12,10,8,51,45,6,46
Dungannon,9762,6,11,7,12,52,50,2,40
Glenavon,9762,7,10,10,10,43,44,-1,40
Glentoran,9762,8,11,6,13,37,45,-8,39
Portadown,9762,9,10,4,16,35,49,-14,34
Ards,9762,10,10,3,17,48,59,-11,33
Ballinamalla,9762,11,6,4,20,27,58,-31,22
Linfield,9763,1,17,6,7,67,30,37,57
Cliftonville,9763,2,17,6,7,54,37,17,57
Crusaders,9763,3,15,11,4,53,35,18,56
Glenavon,9763,4,12,10,8,47,43,4,46
Ballymena,9763,5,12,6,12,52,61,-9,42
Portadown,9763,6,12,5,13,35,44,-9,41
Coleraine,9763,7,9,11,10,46,46,0,38
Ballinamalla,9763,8,9,4,17,31,48,-17,31
Glentoran,9763,9,7,9,14,26,46,-20,30
Dungannon,9763,10,6,11,13,48,47,1,29
Ards,9763,11,7,5,18,31,53,-22,26
Crusaders,9764,1,16,9,5,53,33,20,57
Coleraine,9764,2,14,10,6,50,33,17,52
Cliftonville,9764,3,15,5,10,46,37,9,50
Linfield,9764,4,13,10,7,54,28,26,49
Dungannon,9764,5,12,11,7,48,33,15,47
Glenavon,9764,6,10,12,8,45,47,-2,42
Glentoran,9764,7,11,7,12,32,37,-5,40
Ballymena,9764,8,10,7,13,48,57,-9,37
Portadown,9764,9,6,10,14,22,41,-19,28
Ards,9764,10,8,3,19,29,53,-24,27
Ballinamalla,9764,11,6,4,20,26,54,-28,22
Glenavon,9765,1,16,7,7,48,37,11,55
Cliftonville,9765,2,16,3,11,51,38,13,51
Ballymena,9765,3,14,8,8,53,47,6,50
Linfield,9765,4,13,10,7,53,32,21,49
Crusaders,9765,5,14,7,9,56,39,17,49
Coleraine,9765,6,13,10,7,43,35,8,49
Ballinamalla,9765,7,11,3,16,29,49,-20,36
Glentoran,9765,8,9,8,13,31,43,-12,35
Dungannon,9765,9,8,8,14,43,47,-4,32
Ards,9765,10,8,6,16,32,48,-16,30
Portadown,9765,11,5,6,19,23,47,-24,21
Crusaders,9766,1,19,5,6,55,34,21,62
Ballymena,9766,2,15,7,8,63,54,9,52
Cliftonville,9766,3,15,6,9,52,36,16,51
Dungannon,9766,4,12,8,10,50,39,11,44
Linfield,9766,5,11,9,10,48,34,14,42
Glentoran,9766,6,12,6,12,29,34,-5,42
Glenavon,9766,7,10,10,10,50,51,-1,40
Ards,9766,8,11,7,12,42,45,-3,40
Coleraine,9766,9,7,10,13,35,46,-11,31
Ballinamalla,9766,10,8,5,17,27,47,-20,29
Portadown,9766,11,5,7,18,18,49,-31,22
Linfield,9767,1,14,11,5,57,34,23,53
Crusaders,9767,2,14,7,9,47,31,16,49
Cliftonville,9767,3,14,7,9,52,43,9,49
Dungannon,9767,4,12,8,10,47,45,2,44
Ballymena,9767,5,12,6,12,51,52,-1,42
Coleraine,9767,6,9,14,7,43,38,5,41
Glenavon,9767,7,8,14,8,39,40,-1,38
Ards,9767,8,11,5,14,36,41,-5,38
Glentoran,9767,9,9,9,12,34,40,-6,36
Ballinamalla,9767,10,10,6,14,33,48,-15,36
Portadown,9767,11,7,3,20,24,51,-27,24
Linfield,9768,1,19,7,4,64,29,35,64
Crusaders,9768,2,17,8,5,59,32,27,59
Cliftonville,9768,3,18,5,7,57,32,25,59
Coleraine,9768,4,11,10,9,47,45,2,43
Ballymena,9768,5,11,10,9,58,59,-1,43
Dungannon,9768,6,10,9,11,55,45,10,39
Glenavon,9768,7,9,12,9,41,42,-1,39
Ards,9768,8,9,5,16,42,57,-15,32
Glentoran,9768,9,6,10,14,30,46,-16,28
Ballinamalla,9768,10,7,5,18,29,62,-33,26
Portadown,9768,11,6,3,21,21,54,-33,21
Crusaders,9769,1,18,8,4,59,35,24,62
Linfield,9769,2,16,8,6,62,32,30,56
Ballymena,9769,3,16,6,8,62,58,4,54
Cliftonville,9769,4,16,3,11,51,36,15,51
Coleraine,9769,5,12,9,9,41,36,5,45
Glenavon,9769,6,11,11,8,49,46,3,44
Dungannon,9769,7,8,12,10,42,42,0,36
Ards,9769,8,9,4,17,42,52,-10,31
Glentoran,9769,9,8,6,16,35,53,-18,30
Portadown,9769,10,6,6,18,23,48,-25,24
Ballinamalla,9769,11,4,9,17,33,61,-28,21
Linfield,9770,1,16,9,5,60,29,31,57
Ballymena,9770,2,15,5,10,63,57,6,50
Cliftonville,9770,3,14,6,10,54,40,14,48
Crusaders,9770,4,13,9,8,40,34,6,48
Coleraine,9770,5,12,10,8,41,35,6,46
Glenavon,9770,6,11,12,7,44,45,-1,45
Dungannon,9770,7,9,9,12,46,41,5,36
Ards,9770,8,9,8,13,38,49,-11,35
Glentoran,9770,9,7,11,12,23,35,-12,32
Portadown,9770,10,9,3,18,25,44,-19,30
Ballinamalla,9770,11,7,4,19,23,48,-25,25
Crusaders,9771,1,17,5,8,57,40,17,56
Ballymena,9771,2,15,9,6,64,55,9,54
Cliftonville,9771,3,15,5,10,56,41,15,50
Dungannon,9771,4,13,8,9,62,47,15,47
Glenavon,9771,5,12,11,7,44,38,6,47
Linfield,9771,6,12,8,10,55,34,21,44
Coleraine,9771,7,10,12,8,40,42,-2,42
Ards,9771,8,12,5,13,47,44,3,41
Glentoran,9771,9,7,9,14,32,55,-23,30
Ballinamalla,9771,10,8,3,19,32,56,-24,27
Portadown,9771,11,5,3,22,23,60,-37,18
Crusaders,9772,1,16,9,5,52,30,22,57
Linfield,9772,2,14,11,5,55,27,28,53
Cliftonville,9772,3,16,5,9,58,37,21,53
Ballymena,9772,4,14,7,9,59,62,-3,49
Glenavon,9772,5,11,12,7,41,37,4,45
Coleraine,9772,6,12,8,10,43,43,0,44
Dungannon,9772,7,9,10,11,42,39,3,37
Glentoran,9772,8,8,7,15,34,50,-16,31
Portadown,9772,9,8,7,15,26,44,-18,31
Ballinamalla,9772,10,9,2,19,30,52,-22,29
Ards,9772,11,6,6,18,34,53,-19,24
Cliftonville,9773,1,17,7,6,60,40,20,58
Linfield,9773,2,15,9,6,56,32,24,54
Crusaders,9773,3,14,8,8,51,37,14,50
Ballymena,9773,4,14,5,11,64,60,4,47
Glenavon,9773,5,11,10,9,43,46,-3,43
Coleraine,9773,6,10,10,10,43,39,4,40
Ballinamalla,9773,7,11,4,15,38,47,-9,37
Glentoran,9773,8,10,6,14,33,45,-12,36
Dungannon,9773,9,8,11,11,48,48,0,35
Ards,9773,10,8,9,13,32,45,-13,33
Portadown,9773,11,5,5,20,21,50,-29,20
Crusaders,9774,1,22,7,1,69,22,47,73
Linfield,9774,2,13,11,6,56,28,28,50
Cliftonville,9774,3,15,4,11,60,46,14,49
Coleraine,9774,4,12,11,7,44,33,11,47
Ballymena,9774,5,12,7,11,64,74,-10,43
Glenavon,9774,6,10,8,12,50,54,-4,38
Portadown,9774,7,8,9,13,23,40,-17,33
Glentoran,9774,8,8,9,13,34,53,-19,33
Dungannon,9774,9,7,9,14,45,52,-7,30
Ards,9774,10,8,5,17,41,61,-20,29
Ballinamalla,9774,11,8,4,18,33,56,-23,28
Linfield,9775,1,18,7,5,66,27,39,61
Cliftonville,9775,2,16,6,8,54,36,18,54
Crusaders,9775,3,14,7,9,49,34,15,49
Dungannon,9775,4,13,7,10,55,49,6,46
Glenavon,9775,5,11,10,9,46,44,2,43
Ards,9775,6,12,5,13,44,43,1,41
Coleraine,9775,7,11,7,12,34,43,-9,40
Portadown,9775,8,11,5,14,35,44,-9,38
Ballymena,9775,9,10,6,14,49,62,-13,36
Glentoran,9775,10,7,7,16,25,48,-23,28
Ballinamalla,9775,11,6,5,19,28,55,-27,23
Crusaders,9776,1,17,8,5,52,28,24,59
Cliftonville,9776,2,17,5,8,58,36,22,56
Linfield,9776,3,14,9,7,61,33,28,51
Ballymena,9776,4,13,7,10,57,61,-4,46
Coleraine,9776,5,11,12,7,45,42,3,45
Dungannon,9776,6,11,8,11,49,51,-2,41
Glenavon,9776,7,10,10,10,53,51,2,40
Glentoran,9776,8,11,5,14,38,44,-6,38
Ballinamalla,9776,9,10,2,18,29,52,-23,32
Portadown,9776,10,7,4,19,23,49,-26,25
Ards,9776,11,6,6,18,31,49,-18,24
Coleraine,9777,1,15,9,6,44,32,12,54
Crusaders,9777,2,15,7,8,50,35,15,52
Glenavon,9777,3,13,12,5,47,33,14,51
Cliftonville,9777,4,16,3,11,50,40,10,51
Linfield,9777,5,13,11,6,58,28,30,50
Ballymena,9777,6,13,4,13,50,61,-11,43
Ballinamalla,9777,7,9,6,15,24,43,-19,33
Dungannon,9777,8,7,11,12,43,41,2,32
Glentoran,9777,9,6,12,12,24,38,-14,30
Ards,9777,10,7,7,16,24,40,-16,28
Portadown,9777,11,8,4,18,28,51,-23,28
Crusaders,9778,1,18,7,5,61,34,27,61
Cliftonville,9778,2,17,2,11,56,41,15,53
Linfield,9778,3,13,7,10,62,42,20,46
Dungannon,9778,4,12,10,8,53,42,11,46
Coleraine,9778,5,12,9,9,41,44,-3,45
Glenavon,9778,6,11,11,8,49,43,6,44
Ballymena,9778,7,11,5,14,50,58,-8,38
Glentoran,9778,8,10,6,14,36,52,-16,36
Ballinamalla,9778,9,10,4,16,35,51,-16,34
Ards,9778,10,7,6,17,39,54,-15,27
Portadown,9778,11,5,11,14,23,44,-21,26
Crusaders,9779,1,16,10,4,54,29,25,58
Ballymena,9779,2,17,5,8,60,50,10,56
Linfield,9779,3,12,12,6,51,32,19,48
Ards,9779,4,14,4,12,51,42,9,46
Cliftonville,9779,5,13,6,11,47,43,4,45
Dungannon,9779,6,11,9,10,50,40,10,42
Glenavon,9779,7,10,11,9,52,52,0,41
Coleraine,9779,8,7,9,14,38,46,-8,30
Portadown,9779,9,8,6,16,27,48,-21,30
Ballinamalla,9779,10,8,5,17,26,53,-27,29
Glentoran,9779,11,7,7,16,28,49,-21,28
Ballymena,9780,1,19,5,6,68,53,15,62
Crusaders,9780,2,16,6,8,54,37,17,54
Linfield,9780,3,14,8,8,57,34,23,50
Cliftonville,9780,4,15,4,11,47,37,10,49
Coleraine,9780,5,12,11,7,50,38,12,47
Dungannon,9780,6,11,10,9,47,42,5,43
Glenavon,9780,7,11,9,10,49,51,-2,42
Ards,9780,8,10,4,16,38,48,-10,34
Glentoran,9780,9,8,6,16,29,48,-19,30
Portadown,9780,10,7,5,18,25,51,-26,26
Ballinamalla,9780,11,6,4,20,25,50,-25,22
Cliftonville,9781,1,16,6,8,51,38,13,54
Linfield,9781,2,14,10,6,63,34,29,52
Crusaders,9781,3,14,10,6,52,40,12,52
Dungannon,9781,4,11,9,10,51,45,6,42
Glenavon,9781,5,11,9,10,46,41,5,42
Ballymena,9781,6,11,9,10,56,59,-3,42
Coleraine,9781,7,9,13,8,32,30,2,40
Ards,9781,8,11,4,15,33,39,-6,37
Glentoran,9781,9,9,8,13,32,45,-13,35
Portadown,9781,10,8,6,16,29,49,-20,30
Ballinamalla,9781,11,6,6,18,29,54,-25,24
Ballymena,9782,1,17,4,9,57,55,2,55
Linfield,9782,2,15,8,7,56,30,26,53
Crusaders,9782,3,16,4,10,58,37,21,52
Glenavon,9782,4,14,8,8,57,46,11,50
Cliftonville,9782,5,15,4,11,56,47,9,49
Coleraine,9782,6,13,9,8,42,33,9,48
Dungannon,9782,7,12,8,10,53,43,10,44
Glentoran,9782,8,8,8,14,25,42,-17,32
Portadown,9782,9,9,4,17,24,43,-19,31
Ards,9782,10,8,4,18,36,52,-16,28
Ballinamalla,9782,11,6,3,21,23,59,-36,21
Crusaders,9783,1,17,8,5,60,35,25,59
Linfield,9783,2,14,10,6,61,31,30,52
Coleraine,9783,3,13,9,8,46,41,5,48
Glenavon,9783,4,11,12,7,50,50,0,45
Dungannon,9783,5,12,8,10,55,41,14,44
Cliftonville,9783,6,11,6,13,48,48,0,39
Glentoran,9783,7,9,9,12,27,39,-12,36
Ballymena,9783,8,11,3,16,49,66,-17,36
Ards,9783,9,10,4,16,40,52,-12,34
Portadown,9783,10,9,6,15,32,45,-13,33
Ballinamalla,9783,11,8,5,17,34,54,-20,29
Crusaders,9784,1,16,7,7,54,33,21,55
Linfield,9784,2,14,8,8,52,34,18,50
Glenavon,9784,3,14,8,8,56,47,9,50
Cliftonville,9784,4,15,4,11,43,39,4,49
Ballymena,9784,5,13,8,9,55,54,1,47
Coleraine,9784,6,11,9,10,40,37,3,42
Glentoran,9784,7,11,6,13,35,41,-6,39
Dungannon,9784,8,9,11,10,52,50,2,38
Ards,9784,9,7,9,14,37,49,-12,30
Ballinamalla,9784,10,8,5,17,30,48,-18,29
Portadown,9784,11,7,5,18,23,45,-22,26
Crusaders,9785,1,16,8,6,55,32,23,56
Linfield,9785,2,14,9,7,58,33,25,51
Glenavon,9785,3,13,12,5,53,40,13,51
Cliftonville,9785,4,14,8,8,49,38,11,50
Ballymena,9785,5,14,6,10,57,55,2,48
Coleraine,9785,6,11,7,12,41,40,1,40
Ards,9785,7,11,6,13,41,49,-8,39
Dungannon,9785,8,8,11,11,47,49,-2,35
Glentoran,9785,9,8,9,13,28,48,-20,33
Ballinamalla,9785,10,7,4,19,29,52,-23,25
Portadown,9785,11,6,6,18,22,44,-22,24
Crusaders,9786,1,19,6,5,60,34,26,63
Cliftonville,9786,2,19,5,6,70,38,32,62
Coleraine,9786,3,14,10,6,52,33,19,52
Linfield,9786,4,13,10,7,52,30,22,49
Ballymena,9786,5,13,6,11,56,63,-7,45
Glenavon,9786,6,9,9,12,46,53,-7,36
Dungannon,9786,7,8,7,15,45,48,-3,31
Ards,9786,8,9,4,17,37,55,-18,31
Ballinamalla,9786,9,9,4,17,28,49,-21,31
Portadown,9786,10,9,4,17,25,47,-22,31
Glentoran,9786,11,8,5,17,31,52,-21,29
Crusaders,9787,1,18,7,5,68,37,31,61
Cliftonville,9787,2,16,6,8,53,39,14,54
Linfield,9787,3,13,11,6,57,31,26,50
Glenavon,9787,4,12,12,6,57,52,5,48
Ballymena,9787,5,12,6,12,60,69,-9,42
Dungannon,9787,6,10,8,12,54,48,6,38
Coleraine,9787,7,9,9,12,38,43,-5,36
Glentoran,9787,8,9,8,13,32,42,-10,35
Ards,9787,9,10,4,16,39,51,-12,34
Ballinamalla,9787,10,9,2,19,28,56,-28,29
Portadown,9787,11,7,7,16,32,50,-18,28
Crusaders,9788,1,20,7,3,62,30,32,67
Cliftonville,9788,2,13,8,9,55,46,9,47
Glenavon,9788,3,12,10,8,55,46,9,46
Linfield,9788,4,12,9,9,54,38,16,45
Coleraine,9788,5,12,9,9,42,41,1,45
Dungannon,9788,6,12,7,11,54,43,11,43
Ballymena,9788,7,12,7,11,61,61,0,43
Glentoran,9788,8,9,9,12,32,48,-16,36
Ballinamalla,9788,9,9,2,19,37,55,-18,29
Portadown,9788,10,8,4,18,24,50,-26,28
Ards,9788,11,7,6,17,32,50,-18,27
Crusaders,9789,1,16,8,6,61,38,23,56
Linfield,9789,2,16,7,7,65,34,31,55
Cliftonville,9789,3,16,3,11,57,47,10,51
Glenavon,9789,4,13,10,7,58,44,14,49
Ballymena,9789,5,14,6,10,57,58,-1,48
Coleraine,9789,6,10,10,10,40,38,2,40
Dungannon,9789,7,10,9,11,45,40,5,39
Ards,9789,8,9,6,15,38,52,-14,33
Glentoran,9789,9,9,5,16,33,52,-19,32
Ballinamalla,9789,10,8,4,18,29,51,-22,28
Portadown,9789,11,7,6,17,28,57,-29,27
Crusaders,9790,1,16,7,7,59,40,19,55
Cliftonville,9790,2,16,6,8,59,36,23,54
Glenavon,9790,3,13,12,5,51,42,9,51
Linfield,9790,4,13,11,6,60,35,25,50
Ballymena,9790,5,14,7,9,66,57,9,49
Coleraine,9790,6,13,10,7,47,38,9,49
Ards,9790,7,9,8,13,34,47,-13,35
Dungannon,9790,8,8,10,12,46,49,-3,34
Glentoran,9790,9,8,9,13,30,44,-14,33
Ballinamalla,9790,10,7,4,19,24,50,-26,25
Portadown,9790,11,4,4,22,24,62,-38,16
Linfield,9791,1,15,11,4,59,26,33,56
Cliftonville,9791,2,16,5,9,51,37,14,53
Crusaders,9791,3,15,7,8,54,33,21,52
Glenavon,9791,4,13,11,6,47,42,5,50
Ballymena,9791,5,12,7,11,56,59,-3,43
Ards,9791,6,11,8,11,40,44,-4,41
Dungannon,9791,7,10,10,10,51,46,5,40
Coleraine,9791,8,8,13,9,40,41,-1,37
Glentoran,9791,9,7,9,14,30,48,-18,30
Portadown,9791,10,5,8,17,21,45,-24,23
Ballinamalla,9791,11,5,7,18,29,57,-28,22
Cliftonville,9792,1,17,6,7,55,31,24,57
Crusaders,9792,2,16,7,7,53,39,14,55
Linfield,9792,3,13,9,8,57,31,26,48
Dungannon,9792,4,12,7,11,49,38,11,43
Glenavon,9792,5,11,10,9,42,46,-4,43
Ballymena,9792,6,12,7,11,56,62,-6,43
Glentoran,9792,7,12,6,12,29,39,-10,42
Coleraine,9792,8,9,10,11,39,41,-2,37
Ards,9792,9,10,4,16,41,51,-10,34
Ballinamalla,9792,10,7,7,16,28,49,-21,28
Portadown,9792,11,8,3,19,33,55,-22,27
Crusaders,9793,1,17,7,6,51,31,20,58
Linfield,9793,2,15,8,7,56,30,26,53
Cliftonville,9793,3,16,5,9,51,35,16,53
Glenavon,9793,4,12,9,9,48,47,1,45
Coleraine,9793,5,11,10,9,39,41,-2,43
Ballymena,9793,6,12,5,13,51,58,-7,41
Glentoran,9793,7,11,8,11,31,39,-8,41
Dungannon,9793,8,9,10,11,49,46,3,37
Portadown,9793,9,9,3,18,26,41,-15,30
Ballinamalla,9793,10,9,2,19,30,49,-19,29
Ards,9793,11,7,7,16,36,51,-15,28
Crusaders,9794,1,18,9,3,62,31,31,63
Glenavon,9794,2,14,9,7,47,40,7,51
Cliftonville,9794,3,16,3,11,50,46,4,51
Ballymena,9794,4,14,7,9,65,59,6,49
Linfield,9794,5,12,10,8,56,35,21,46
Coleraine,9794,6,10,12,8,33,32,1,42
Dungannon,9794,7,8,11,11,46,39,7,35
Ards,9794,8,10,5,15,40,46,-6,35
Glentoran,9794,9,9,6,15,26,47,-21,33
Portadown,9794,10,7,5,18,20,43,-23,26
Ballinamalla,9794,11,7,3,20,23,50,-27,24
Crusaders,9795,1,15,9,6,55,41,14,54
Glenavon,9795,2,14,11,5,52,38,14,53
Linfield,9795,3,14,9,7,62,35,27,51
Cliftonville,9795,4,14,7,9,52,42,10,49
Coleraine,9795,5,12,13,5,48,38,10,49
Ballymena,9795,6,12,6,12,57,63,-6,42
Dungannon,9795,7,9,13,8,49,41,8,40
Ballinamalla,9795,8,8,5,17,33,51,-18,29
Glentoran,9795,9,7,8,15,29,49,-20,29
Ards,9795,10,8,3,19,38,55,-17,27
Portadown,9795,11,7,6,17,22,44,-22,27
Crusaders,9796,1,15,6,9,53,34,19,51
Linfield,9796,2,12,11,7,53,36,17,47
Glenavon,9796,3,12,11,7,46,41,5,47
Coleraine,9796,4,11,11,8,44,40,4,44
Cliftonville,9796,5,13,4,13,53,47,6,43
Ballymena,9796,6,12,6,12,51,59,-8,42
Dungannon,9796,7,11,8,11,51,44,7,41
Ballinamalla,9796,8,12,4,14,36,47,-11,40
Glentoran,9796,9,11,6,13,37,39,-2,39
Ards,9796,10,9,7,14,40,53,-13,34
Portadown,9796,11,7,6,17,25,49,-24,27
Crusaders,9797,1,17,8,5,53,28,25,59
Cliftonville,9797,2,18,5,7,60,38,22,59
Glenavon,9797,3,15,7,8,48,39,9,52
Linfield,9797,4,13,9,8,61,34,27,48
Ballinamalla,9797,5,11,5,14,33,43,-10,38
Ballymena,9797,6,10,8,12,56,71,-15,38
Coleraine,9797,7,8,12,10,34,40,-6,36
Glentoran,9797,8,9,6,15,29,45,-16,33
Dungannon,9797,9,7,11,12,46,49,-3,32
Ards,9797,10,8,6,16,37,49,-12,30
Portadown,9797,11,7,7,16,29,50,-21,28
Linfield,9798,1,17,9,4,59,28,31,60
Crusaders,9798,2,15,8,7,48,35,13,53
Cliftonville,9798,3,14,6,10,46,39,7,48
Coleraine,9798,4,12,10,8,43,40,3,46
Ballymena,9798,5,12,8,10,52,56,-4,44
Glenavon,9798,6,10,10,10,49,42,7,40
Glentoran,9798,7,9,11,10,40,42,-2,38
Ards,9798,8,10,7,13,42,47,-5,37
Ballinamalla,9798,9,11,3,16,35,52,-17,36
Dungannon,9798,10,7,8,15,43,52,-9,29
Portadown,9798,11,5,6,19,19,43,-24,21
Linfield,9799,1,16,8,6,58,28,30,56
Crusaders,9799,2,14,10,6,51,39,12,52
Coleraine,9799,3,14,9,7,49,39,10,51
Cliftonville,9799,4,15,5,10,50,38,12,50
Dungannon,9799,5,12,9,9,59,43,16,45
Ballymena,9799,6,12,7,11,54,60,-6,43
Glenavon,9799,7,11,9,10,48,50,-2,42
Ards,9799,8,9,8,13,41,48,-7,35
Ballinamalla,9799,9,7,7,16,31,52,-21,28
Glentoran,9799,10,6,8,16,32,51,-19,26
Portadown,9799,11,8,2,20,23,48,-25,26
Crusaders,9800,1,17,10,3,57,31,26,61
Cliftonville,9800,2,16,4,10,52,38,14,52
Linfield,9800,3,11,13,6,53,31,22,46
Ballymena,9800,4,12,10,8,52,53,-1,46
Glenavon,9800,5,11,10,9,46,44,2,43
Coleraine,9800,6,10,10,10,45,42,3,40
Dungannon,9800,7,9,10,11,47,44,3,37
Ards,9800,8,10,6,14,44,50,-6,36
Ballinamalla,9800,9,8,8,14,31,50,-19,32
Glentoran,9800,10,6,10,14,26,46,-20,28
Portadown,9800,11,7,5,18,20,44,-24,26
Crusaders,9801,1,18,7,5,57,29,28,61
Linfield,9801,2,17,7,6,64,31,33,58
Ballymena,9801,3,16,5,9,56,51,5,53
Cliftonville,9801,4,15,3,12,46,40,6,48
Coleraine,9801,5,11,10,9,44,40,4,43
Glenavon,9801,6,10,10,10,43,45,-2,40
Dungannon,9801,7,10,9,11,58,53,5,39
Ards,9801,8,11,4,15,38,46,-8,37
Glentoran,9801,9,9,5,16,28,48,-20,32
Ballinamalla,9801,10,6,7,17,30,52,-22,25
Portadown,9801,11,7,3,20,27,56,-29,24
Linfield,9802,1,14,12,4,61,26,35,54
Crusaders,9802,2,15,8,7,54,32,22,53
Cliftonville,9802,3,15,6,9,50,40,10,51
Ballymena,9802,4,15,6,9,54,54,0,51
Coleraine,9802,5,14,8,8,49,40,9,50
Glenavon,9802,6,12,11,7,46,37,9,47
Portadown,9802,7,9,9,12,35,40,-5,36
Glentoran,9802,8,7,9,14,28,47,-19,30
Dungannon,9802,9,5,13,12,48,53,-5,28
Ards,9802,10,7,5,18,29,51,-22,26
Ballinamalla,9802,11,5,7,18,26,60,-34,22
Crusaders,9803,1,17,8,5,52,29,23,59
Ballymena,9803,2,15,8,7,64,58,6,53
Linfield,9803,3,13,10,7,65,43,22,49
Cliftonville,9803,4,15,4,11,52,40,12,49
Dungannon,9803,5,11,12,7,51,40,11,45
Glenavon,9803,6,10,11,9,50,50,0,41
Ards,9803,7,11,4,15,45,55,-10,37
Glentoran,9803,8,9,8,13,29,39,-10,35
Coleraine,9803,9,7,9,14,40,47,-7,30
Ballinamalla,9803,10,8,5,17,32,55,-23,29
Portadown,9803,11,6,7,17,27,51,-24,25
Ballymena,9804,1,20,4,6,64,46,18,64
Crusaders,9804,2,17,8,5,66,41,25,59
Linfield,9804,3,15,10,5,67,37,30,55
Coleraine,9804,4,15,7,8,49,41,8,52
Cliftonville,9804,5,15,6,9,60,44,16,51
Glenavon,9804,6,12,8,10,56,53,3,44
Dungannon,9804,7,6,12,12,44,51,-7,30
Ards,9804,8,9,3,18,42,58,-16,30
Portadown,9804,9,8,5,17,26,50,-24,29
Glentoran,9804,10,7,7,16,30,49,-19,28
Ballinamalla,9804,11,5,2,23,24,58,-34,17
Crusaders,9805,1,17,8,5,58,32,26,59
Cliftonville,9805,2,18,3,9,53,37,16,57
Linfield,9805,3,15,10,5,56,28,28,55
Dungannon,9805,4,12,10,8,49,35,14,46
Ballymena,9805,5,14,4,12,56,55,1,46
Glenavon,9805,6,11,10,9,48,42,6,43
Coleraine,9805,7,8,14,8,31,33,-2,38
Ballinamalla,9805,8,10,5,15,35,51,-16,35
Portadown,9805,9,9,3,18,23,45,-22,30
Glentoran,9805,10,4,11,15,22,50,-28,23
Ards,9805,11,5,6,19,28,51,-23,21
Crusaders,9806,1,16,8,6,50,31,19,56
Ballymena,9806,2,16,7,7,61,54,7,55
Linfield,9806,3,13,11,6,53,28,25,50
Cliftonville,9806,4,15,5,10,58,41,17,50
Glenavon,9806,5,10,14,6,45,43,2,44
Coleraine,9806,6,10,10,10,47,42,5,40
Dungannon,9806,7,10,9,11,56,47,9,39
Ards,9806,8,9,7,14,36,47,-11,34
Ballinamalla,9806,9,9,5,16,33,56,-23,32
Portadown,9806,10,7,6,17,28,51,-23,27
Glentoran,9806,11,5,8,17,27,54,-27,23
Cliftonville,9807,1,17,2,11,56,38,18,53
Linfield,9807,2,14,9,7,55,30,25,51
Crusaders,9807,3,14,8,8,51,38,13,50
Glenavon,9807,4,11,11,8,48,43,5,44
Dungannon,9807,5,11,10,9,49,41,8,43
Ballymena,9807,6,11,7,12,52,66,-14,40
Coleraine,9807,7,10,9,11,41,39,2,39
Glentoran,9807,8,11,6,13,36,43,-7,39
Ballinamalla,9807,9,10,3,17,34,51,-17,33
Ards,9807,10,8,8,14,37,52,-15,32
Portadown,9807,11,8,7,15,22,40,-18,31
Crusaders,9808,1,19,6,5,54,29,25,63
Linfield,9808,2,17,9,4,61,25,36,60
Ballymena,9808,3,11,11,8,58,53,5,44
Cliftonville,9808,4,13,5,12,47,47,0,44
Dungannon,9808,5,11,8,11,53,45,8,41
Coleraine,9808,6,9,12,9,42,44,-2,39
Portadown,9808,7,11,6,13,32,42,-10,39
Glentoran,9808,8,9,9,12,28,39,-11,36
Glenavon,9808,9,8,11,11,41,48,-7,35
Ards,9808,10,7,5,18,32,49,-17,26
Ballinamalla,9808,11,6,6,18,26,53,-27,24
Linfield,9809,1,16,9,5,60,31,29,57
Crusaders,9809,2,16,9,5,55,30,25,57
Cliftonville,9809,3,14,8,8,58,38,20,50
Ballymena,9809,4,13,8,9,57,55,2,47
Glenavon,9809,5,12,10,8,47,46,1,46
Coleraine,9809,6,10,10,10,37,40,-3,40
Ards,9809,7,10,5,15,39,52,-13,35
Glentoran,9809,8,9,6,15,32,50,-18,33
Ballinamalla,9809,9,9,5,16,33,51,-18,32
Dungannon,9809,10,8,7,15,41,45,-4,31
Portadown,9809,11,6,7,17,21,42,-21,25
Crusaders,9810,1,18,6,6,62,28,34,60
Linfield,9810,2,15,10,5,62,31,31,55
Coleraine,9810,3,14,9,7,39,35,4,51
Glenavon,9810,4,12,11,7,52,46,6,47
Cliftonville,9810,5,14,4,12,53,50,3,46
Ballymena,9810,6,13,4,13,56,65,-9,43
Ards,9810,7,12,4,14,45,46,-1,40
Glentoran,9810,8,10,6,14,36,50,-14,36
Dungannon,9810,9,8,9,13,47,50,-3,33
Ballinamalla,9810,10,7,5,18,30,52,-22,26
Portadown,9810,11,5,6,19,18,47,-29,21
Linfield,9811,1,16,9,5,61,30,31,57
Crusaders,9811,2,17,5,8,54,43,11,56
Glenavon,9811,3,13,12,5,52,40,12,51
Coleraine,9811,4,11,10,9,44,39,5,43
Cliftonville,9811,5,12,5,13,50,45,5,41
Ballymena,9811,6,11,8,11,51,58,-7,41
Dungannon,9811,7,9,12,9,52,42,10,39
Portadown,9811,8,10,6,14,31,45,-14,36
Ards,9811,9,10,3,17,40,54,-14,33
Ballinamalla,9811,10,9,4,17,26,46,-20,31
Glentoran,9811,11,7,6,17,29,48,-19,27
Linfield,9812,1,17,6,7,63,31,32,57
Crusaders,9812,2,15,6,9,54,41,13,51
Cliftonville,9812,3,14,6,10,52,40,12,48
Coleraine,9812,4,11,11,8,41,36,5,44
Glenavon,9812,5,11,10,9,50,46,4,43
Ballymena,9812,6,12,7,11,51,58,-7,43
Dungannon,9812,7,10,7,13,50,48,2,37
Portadown,9812,8,10,6,14,29,44,-15,36
Ballinamalla,9812,9,11,2,17,35,53,-18,35
Ards,9812,10,9,6,15,39,53,-14,33
Glentoran,9812,11,9,5,16,32,46,-14,32
Linfield,9813,1,15,10,5,61,31,30,55
Crusaders,9813,2,14,8,8,57,41,16,50
Cliftonville,9813,3,14,4,12,51,47,4,46
Ballymena,9813,4,14,3,13,61,56,5,45
Glenavon,9813,5,11,11,8,48,44,4,44
Dungannon,9813,6,10,12,8,52,42,10,42
Coleraine,9813,7,9,13,8,39,44,-5,40
Ards,9813,8,9,8,13,37,45,-8,35
Glentoran,9813,9,8,9,13,31,45,-14,33
Ballinamalla,9813,10,9,4,17,32,50,-18,31
Portadown,9813,11,9,4,17,35,59,-24,31
Linfield,9814,1,16,7,7,75,38,37,55
Crusaders,9814,2,16,7,7,63,43,20,55
Cliftonville,9814,3,17,4,9,54,37,17,55
Dungannon,9814,4,12,10,8,56,41,15,46
Glenavon,9814,5,12,10,8,47,42,5,46
Ballymena,9814,6,13,6,11,58,65,-7,45
Coleraine,9814,7,10,11,9,54,43,11,41
Portadown,9814,8,10,3,17,31,51,-20,33
Ards,9814,9,8,6,16,40,58,-18,30
Glentoran,9814,10,8,6,16,28,52,-24,30
Ballinamalla,9814,11,5,6,19,26,62,-36,21
Crusaders,9815,1,18,5,7,58,35,23,59
Cliftonville,9815,2,15,6,9,45,38,7,51
Ballymena,9815,3,15,6,9,60,56,4,51
Linfield,9815,4,12,10,8,59,38,21,46
Glenavon,9815,5,11,9,10,47,42,5,42
Glentoran,9815,6,11,8,11,40,43,-3,41
Coleraine,9815,7,10,8,12,41,42,-1,38
Dungannon,9815,8,9,9,12,44,50,-6,36
Portadown,9815,9,9,5,16,25,46,-21,32
Ards,9815,10,8,6,16,42,55,-13,30
Ballinamalla,9815,11,7,8,15,29,45,-16,29
Ballymena,9816,1,17,5,8,69,57,12,56
Crusaders,9816,2,16,6,8,56,34,22,54
Cliftonville,9816,3,15,5,10,58,41,17,50
Glenavon,9816,4,12,11,7,49,44,5,47
Linfield,9816,5,12,10,8,56,37,19,46
Coleraine,9816,6,12,9,9,47,46,1,45
Portadown,9816,7,10,5,15,32,48,-16,35
Dungannon,9816,8,9,7,14,47,52,-5,34
Glentoran,9816,9,7,9,14,29,46,-17,30
Ballinamalla,9816,10,8,6,16,29,47,-18,30
Ards,9816,11,8,5,17,40,60,-20,29
Cliftonville,9817,1,19,3,8,64,35,29,60
Linfield,9817,2,15,10,5,63,32,31,55
Crusaders,9817,3,15,7,8,55,40,15,52
Coleraine,9817,4,14,9,7,52,37,15,51
Ballymena,9817,5,14,5,11,57,62,-5,47
Dungannon,9817,6,10,9,11,46,51,-5,39
Glenavon,9817,7,8,9,13,41,50,-9,33
Glentoran,9817,8,9,6,15,26,39,-13,33
Ballinamalla,9817,9,9,5,16,34,55,-21,32
Ards,9817,10,8,5,17,37,51,-14,29
Portadown,9817,11,8,4,18,24,47,-23,28
Crusaders,9818,1,18,7,5,55,30,25,61
Linfield,9818,2,16,8,6,60,29,31,56
Cliftonville,9818,3,14,8,8,54,40,14,50
Ballymena,9818,4,15,3,12,61,63,-2,48
Coleraine,9818,5,10,11,9,43,43,0,41
Glenavon,9818,6,9,13,8,41,43,-2,40
Dungannon,9818,7,9,12,9,52,45,7,39
Ards,9818,8,9,6,15,37,46,-9,33
Glentoran,9818,9,6,11,13,21,39,-18,29
Portadown,9818,10,7,7,16,27,46,-19,28
Ballinamalla,9818,11,6,6,18,27,54,-27,24
Linfield,9819,1,17,11,2,70,25,45,62
Crusaders,9819,2,18,6,6,58,30,28,60
Ballymena,9819,3,17,4,9,70,58,12,55
Cliftonville,9819,4,14,4,12,52,48,4,46
Glenavon,9819,5,11,10,9,54,55,-1,43
Coleraine,9819,6,10,7,13,36,47,-11,37
Portadown,9819,7,10,5,15,27,48,-21,35
Ards,9819,8,8,9,13,39,48,-9,33
Dungannon,9819,9,7,10,13,51,53,-2,31
Glentoran,9819,10,8,6,16,26,51,-25,30
Ballinamalla,9819,11,6,6,18,34,54,-20,24
Crusaders,9820,1,19,6,5,63,41,22,63
Linfield,9820,2,15,10,5,67,37,30,55
Ballymena,9820,3,16,5,9,61,60,1,53
Cliftonville,9820,4,15,4,11,57,41,16,49
Coleraine,9820,5,12,10,8,42,40,2,46
Glenavon,9820,6,11,11,8,49,46,3,44
Dungannon,9820,7,8,9,13,50,52,-2,33
Ards,9820,8,9,6,15,41,50,-9,33
Glentoran,9820,9,8,7,15,37,49,-12,31
Ballinamalla,9820,10,8,2,20,31,58,-27,26
Portadown,9820,11,6,6,18,26,50,-24,24
Linfield,9821,1,15,8,7,59,35,24,53
Glenavon,9821,2,14,10,6,57,40,17,52
Crusaders,9821,3,15,7,8,53,37,16,52
Coleraine,9821,4,11,11,8,43,43,0,44
Ballinamalla,9821,5,13,5,12,39,45,-6,44
Cliftonville,9821,6,12,6,12,58,47,11,42
Glentoran,9821,7,12,5,13,43,47,-4,41
Dungannon,9821,8,11,7,12,49,48,1,40
Ballymena,9821,9,10,7,13,56,68,-12,37
Ards,9821,10,9,5,16,33,49,-16,32
Portadown,9821,11,5,5,20,24,55,-31,20
Crusaders,9822,1,17,5,8,58,35,23,56
Ballymena,9822,2,16,8,6,62,51,11,56
Linfield,9822,3,15,9,6,65,36,29,54
Cliftonville,9822,4,15,8,7,58,41,17,53
Glenavon,9822,5,12,10,8,45,45,0,46
Coleraine,9822,6,10,13,7,46,43,3,43
Dungannon,9822,7,9,7,14,52,55,-3,34
Ards,9822,8,9,6,15,39,52,-13,33
Glentoran,9822,9,7,7,16,28,43,-15,28
Portadown,9822,10,8,4,18,33,56,-23,28
Ballinamalla,9822,11,6,5,19,33,62,-29,23
Crusaders,9823,1,16,8,6,57,37,20,56
Linfield,9823,2,15,10,5,72,38,34,55
Cliftonville,9823,3,16,4,10,52,44,8,52
Glenavon,9823,4,13,9,8,58,49,9,48
Coleraine,9823,5,11,12,7,41,37,4,45
Glentoran,9823,6,10,7,13,30,43,-13,37
Dungannon,9823,7,9,9,12,49,54,-5,36
Ballymena,9823,8,9,9,12,50,59,-9,36
Ballinamalla,9823,9,9,7,14,36,49,-13,34
Ards,9823,10,7,6,17,38,50,-12,27
Portadown,9823,11,8,3,19,27,50,-23,27
Crusaders,9824,1,17,9,4,63,29,34,60
Cliftonville,9824,2,16,5,9,66,44,22,53
Linfield,9824,3,14,9,7,57,33,24,51
Coleraine,9824,4,13,9,8,42,39,3,48
Ballymena,9824,5,13,7,10,54,58,-4,46
Glenavon,9824,6,11,12,7,49,50,-1,45
Dungannon,9824,7,9,10,11,56,50,6,37
Ards,9824,8,10,4,16,38,49,-11,34
Glentoran,9824,9,8,7,15,27,48,-21,31
Ballinamalla,9824,10,8,3,19,35,62,-27,27
Portadown,9824,11,6,5,19,27,52,-25,23
Crusaders,9825,1,16,10,4,55,33,22,58
Linfield,9825,2,14,11,5,64,30,34,53
Cliftonville,9825,3,16,4,10,52,38,14,52
Glenavon,9825,4,12,11,7,51,44,7,47
Ballymena,9825,5,13,7,10,56,57,-1,46
Ards,9825,6,10,6,14,42,50,-8,36
Glentoran,9825,7,8,12,10,33,44,-11,36
Dungannon,9825,8,8,11,11,50,48,2,35
Coleraine,9825,9,7,11,12,38,46,-8,32
Ballinamalla,9825,10,7,6,17,32,55,-23,27
Portadown,9825,11,6,7,17,19,47,-28,25
Crusaders,9826,1,19,8,3,62,31,31,65
Coleraine,9826,2,13,12,5,48,36,12,51
Linfield,9826,3,13,9,8,56,32,24,48
Ballymena,9826,4,13,9,8,56,56,0,48
Glenavon,9826,5,11,13,6,55,46,9,46
Cliftonville,9826,6,12,8,10,43,37,6,44
Dungannon,9826,7,10,8,12,46,48,-2,38
Glentoran,9826,8,8,9,13,38,47,-9,33
Ballinamalla,9826,9,7,6,17,33,54,-21,27
Ards,9826,10,5,8,17,35,57,-22,23
Portadown,9826,11,4,10,16,20,48,-28,22
Crusaders,9827,1,17,10,3,55,33,22,61
Cliftonville,9827,2,17,6,7,61,38,23,57
Linfield,9827,3,13,10,7,52,30,22,49
Coleraine,9827,4,10,11,9,44,42,2,41
Dungannon,9827,5,9,13,8,49,41,8,40
Glenavon,9827,6,8,14,8,45,49,-4,38
Ballymena,9827,7,10,7,13,55,65,-10,37
Ards,9827,8,10,5,15,34,45,-11,35
Ballinamalla,9827,9,7,9,14,36,50,-14,30
Glentoran,9827,10,8,6,16,31,51,-20,30
Portadown,9827,11,8,5,17,27,45,-18,29
Crusaders,9828,1,16,9,5,58,35,23,57
Cliftonville,9828,2,17,5,8,62,37,25,56
Linfield,9828,3,14,9,7,53,31,22,51
Ballymena,9828,4,13,8,9,62,59,3,47
Dungannon,9828,5,12,10,8,51,43,8,46
Glenavon,9828,6,10,10,10,42,47,-5,40
Glentoran,9828,7,10,8,12,33,43,-10,38
Coleraine,9828,8,9,8,13,38,41,-3,35
Ards,9828,9,9,7,14,40,49,-9,34
Ballinamalla,9828,10,7,4,19,28,56,-28,25
Portadown,9828,11,6,6,18,26,52,-26,24
Ballymena,9829,1,17,6,7,66,54,12,57
Glenavon,9829,2,13,11,6,48,35,13,50
Cliftonville,9829,3,15,3,12,58,44,14,48
Crusaders,9829,4,14,6,10,48,40,8,48
Linfield,9829,5,12,9,9,49,37,12,45
Ards,9829,6,12,6,12,50,48,2,42
Dungannon,9829,7,11,8,11,52,45,7,41
Glentoran,9829,8,10,10,10,34,38,-4,40
Coleraine,9829,9,9,10,11,37,44,-7,37
Portadown,9829,10,5,8,17,17,43,-26,23
Ballinamalla,9829,11,6,5,19,24,55,-31,23
Coleraine,9830,1,15,11,4,51,29,22,56
Cliftonville,9830,2,16,6,8,52,33,19,54
Linfield,9830,3,14,10,6,58,31,27,52
Ballymena,9830,4,15,4,11,62,61,1,49
Crusaders,9830,5,13,6,11,55,46,9,45
Dungannon,9830,6,10,12,8,50,42,8,42
Glenavon,9830,7,9,11,10,43,48,-5,38
Ards,9830,8,8,7,15,38,49,-11,31
Glentoran,9830,9,6,10,14,23,45,-22,28
Ballinamalla,9830,10,7,7,16,28,53,-25,28
Portadown,9830,11,7,6,17,27,50,-23,27
Ballymena,9831,1,16,7,7,59,51,8,55
Crusaders,9831,2,15,9,6,55,31,24,54
Cliftonville,9831,3,15,6,9,45,36,9,51
Glenavon,9831,4,13,9,8,54,47,7,48
Linfield,9831,5,13,8,9,54,32,22,47
Coleraine,9831,6,11,9,10,35,31,4,42
Glentoran,9831,7,11,7,12,34,44,-10,40
Dungannon,9831,8,8,10,12,47,47,0,34
Ards,9831,9,9,5,16,36,52,-16,32
Ballinamalla,9831,10,8,4,18,32,55,-23,28
Portadown,9831,11,7,4,19,29,54,-25,25
Crusaders,9832,1,17,10,3,56,32,24,61
Cliftonville,9832,2,15,6,9,55,42,13,51
Linfield,9832,3,13,10,7,58,38,20,49
Glenavon,9832,4,12,12,6,51,43,8,48
Coleraine,9832,5,12,9,9,40,37,3,45
Glentoran,9832,6,12,7,11,37,42,-5,43
Dungannon,9832,7,10,9,11,52,40,12,39
Ballymena,9832,8,11,6,13,51,60,-9,39
Ards,9832,9,9,3,18,42,60,-18,30
Portadown,9832,10,6,6,18,27,49,-22,24
Ballinamalla,9832,11,5,8,17,26,52,-26,23
Linfield,9833,1,16,9,5,64,32,32,57
Crusaders,9833,2,14,7,9,48,40,8,49
Coleraine,9833,3,12,12,6,44,36,8,48
Ballymena,9833,4,14,6,10,54,52,2,48
Cliftonville,9833,5,13,7,10,52,41,11,46
Glenavon,9833,6,10,11,9,46,47,-1,41
Dungannon,9833,7,9,12,9,53,42,11,39
Glentoran,9833,8,10,6,14,27,40,-13,36
Ards,9833,9,9,6,15,35,47,-12,33
Portadown,9833,10,7,7,16,26,46,-20,28
Ballinamalla,9833,11,7,5,18,25,51,-26,26
Crusaders,9834,1,16,10,4,59,32,27,58
Ballymena,9834,2,16,6,8,69,60,9,54
Linfield,9834,3,14,11,5,55,28,27,53
Cliftonville,9834,4,16,4,10,54,44,10,52
Coleraine,9834,5,11,10,9,41,41,0,43
Dungannon,9834,6,11,8,11,54,47,7,41
Glenavon,9834,7,10,9,11,48,52,-4,39
Ards,9834,8,10,4,16,41,50,-9,34
Glentoran,9834,9,6,11,13,26,46,-20,29
Ballinamalla,9834,10,7,5,18,39,60,-21,26
Portadown,9834,11,6,6,18,27,53,-26,24
Linfield,9835,1,15,10,5,62,32,30,55
Crusaders,9835,2,15,10,5,55,33,22,55
Glenavon,9835,3,15,8,7,52,48,4,53
Ballymena,9835,4,13,10,7,58,51,7,49
Cliftonville,9835,5,12,5,13,45,45,0,41
Dungannon,9835,6,10,10,10,50,45,5,40
Coleraine,9835,7,9,13,8,42,39,3,40
Ballinamalla,9835,8,12,3,15,30,39,-9,39
Glentoran,9835,9,10,7,13,28,41,-13,37
Ards,9835,10,6,7,17,32,51,-19,25
Portadown,9835,11,5,3,22,16,46,-30,18
Crusaders,9836,1,16,7,7,54,34,20,55
Cliftonville,9836,2,17,3,10,53,40,13,54
Linfield,9836,3,14,8,8,65,40,25,50
Ballymena,9836,4,15,5,10,53,51,2,50
Glenavon,9836,5,11,12,7,51,49,2,45
Coleraine,9836,6,11,11,8,44,43,1,44
Dungannon,9836,7,11,7,12,57,49,8,40
Ards,9836,8,9,5,16,35,53,-18,32
Glentoran,9836,9,8,7,15,28,42,-14,31
Ballinamalla,9836,10,9,4,17,36,52,-16,31
Portadown,9836,11,5,9,16,21,44,-23,24
Crusaders,9837,1,17,6,7,61,38,23,57
Linfield,9837,2,15,9,6,63,34,29,54
Cliftonville,9837,3,16,3,11,61,45,16,51
Ballymena,9837,4,14,7,9,51,50,1,49
Glenavon,9837,5,13,8,9,43,39,4,47
Coleraine,9837,6,12,10,8,42,37,5,46
Dungannon,9837,7,11,8,11,40,34,6,41
Ballinamalla,9837,8,10,5,15,29,42,-13,35
Portadown,9837,9,9,3,18,30,53,-23,30
Ards,9837,10,8,4,18,32,50,-18,28
Glentoran,9837,11,6,5,19,26,56,-30,23
Crusaders,9838,1,17,8,5,53,27,26,59
Coleraine,9838,2,13,11,6,44,31,13,50
Ballymena,9838,3,14,8,8,61,55,6,50
Cliftonville,9838,4,15,4,11,49,37,12,49
Linfield,9838,5,12,9,9,52,32,20,45
Glenavon,9838,6,10,13,7,40,38,2,43
Dungannon,9838,7,10,8,12,45,44,1,38
Ballinamalla,9838,8,9,8,13,37,47,-10,35
Glentoran,9838,9,8,8,14,25,45,-20,32
Ards,9838,10,6,7,17,32,56,-24,25
Portadown,9838,11,7,4,19,25,51,-26,25
Linfield,9839,1,16,9,5,60,25,35,57
Ballymena,9839,2,16,7,7,62,46,16,55
Crusaders,9839,3,16,5,9,57,45,12,53
Cliftonville,9839,4,15,4,11,58,42,16,49
Glenavon,9839,5,13,9,8,50,40,10,48
Coleraine,9839,6,13,9,8,38,35,3,48
Dungannon,9839,7,12,6,12,48,56,-8,42
Glentoran,9839,8,9,6,15,32,47,-15,33
Ards,9839,9,8,5,17,34,53,-19,29
Portadown,9839,10,6,6,18,26,49,-23,24
Ballinamalla,9839,11,5,6,19,28,55,-27,21
Crusaders,9840,1,16,8,6,60,38,22,56
Linfield,9840,2,12,11,7,62,40,22,47
Glenavon,9840,3,12,11,7,49,39,10,47
Ballymena,9840,4,13,8,9,70,66,4,47
Cliftonville,9840,5,13,4,13,49,50,-1,43
Coleraine,9840,6,10,9,11,43,47,-4,39
Ballinamalla,9840,7,11,6,13,40,50,-10,39
Dungannon,9840,8,9,9,12,44,43,1,36
Ards,9840,9,9,9,12,35,43,-8,36
Portadown,9840,10,10,5,15,23,37,-14,35
Glentoran,9840,11,5,10,15,27,49,-22,25
Crusaders,9841,1,16,9,5,65,40,25,57
Cliftonville,9841,2,16,7,7,56,34,22,55
Linfield,9841,3,14,11,5,63,36,27,53
Ballymena,9841,4,15,7,8,60,59,1,52
Glenavon,9841,5,14,8,8,58,43,15,50
Coleraine,9841,6,12,8,10,51,48,3,44
Glentoran,9841,7,9,10,11,29,40,-11,37
Dungannon,9841,8,7,10,13,50,56,-6,31
Ards,9841,9,7,9,14,29,46,-17,30
Ballinamalla,9841,10,6,6,18,25,53,-28,24
Portadown,9841,11,5,3,22,21,52,-31,18
Crusaders,9842,1,17,6,7,56,35,21,57
Cliftonville,9842,2,16,5,9,61,47,14,53
Ballymena,9842,3,14,7,9,61,54,7,49
Linfield,9842,4,11,12,7,52,35,17,45
Glenavon,9842,5,11,12,7,49,44,5,45
Coleraine,9842,6,12,8,10,45,39,6,44
Dungannon,9842,7,10,10,10,50,46,4,40
Glentoran,9842,8,9,8,13,30,41,-11,35
Ards,9842,9,9,6,15,43,56,-13,33
Ballinamalla,9842,10,6,8,16,30,54,-24,26
Portadown,9842,11,7,4,19,26,52,-26,25
Crusaders,9843,1,17,8,5,52,27,25,59
Linfield,9843,2,16,10,4,60,32,28,58
Ballymena,9843,3,15,6,9,61,55,6,51
Cliftonville,9843,4,14,4,12,57,43,14,46
Coleraine,9843,5,11,9,10,40,45,-5,42
Glenavon,9843,6,10,10,10,48,47,1,40
Dungannon,9843,7,10,7,13,46,48,-2,37
Ards,9843,8,9,9,12,38,44,-6,36
Ballinamalla,9843,9,9,5,16,33,51,-18,32
Glentoran,9843,10,8,7,15,37,47,-10,31
Portadown,9843,11,6,5,19,26,59,-33,23
Linfield,9844,1,17,9,4,63,30,33,60
Crusaders,9844,2,15,7,8,59,41,18,52
Cliftonville,9844,3,16,4,10,57,40,17,52
Glenavon,9844,4,12,11,7,55,48,7,47
Dungannon,9844,5,12,7,11,56,45,11,43
Coleraine,9844,6,11,8,11,42,45,-3,41
Ballymena,9844,7,12,5,13,48,59,-11,41
Glentoran,9844,8,9,8,13,31,42,-11,35
Ards,9844,9,9,6,15,37,50,-13,33
Ballinamalla,9844,10,8,5,17,32,53,-21,29
Portadown,9844,11,6,6,18,25,52,-27,24
Cliftonville,9845,1,18,3,9,57,37,20,57
Crusaders,9845,2,17,5,8,56,42,14,56
Coleraine,9845,3,12,12,6,42,32,10,48
Glenavon,9845,4,12,11,7,52,47,5,47
Ballymena,9845,5,13,6,11,52,57,-5,45
Glentoran,9845,6,11,9,10,34,38,-4,42
Linfield,9845,7,10,10,10,52,36,16,40
Dungannon,9845,8,8,11,11,48,44,4,35
Ards,9845,9,8,5,17,32,47,-15,29
Portadown,9845,10,8,4,18,21,46,-25,28
Ballinamalla,9845,11,7,6,17,30,50,-20,27
Glenavon,9846,1,15,10,5,60,41,19,55
Cliftonville,9846,2,16,4,10,59,42,17,52
Crusaders,9846,3,14,10,6,53,39,14,52
Coleraine,9846,4,14,9,7,51,38,13,51
Linfield,9846,5,11,14,5,56,38,18,47
Ballymena,9846,6,14,5,11,55,55,0,47
Dungannon,9846,7,9,10,11,44,38,6,37
Glentoran,9846,8,10,7,13,31,42,-11,37
Ards,9846,9,7,7,16,33,52,-19,28
Portadown,9846,10,8,3,19,24,47,-23,27
Ballinamalla,9846,11,6,3,21,26,60,-34,21
Linfield,9847,1,17,8,5,62,30,32,59
Crusaders,9847,2,16,9,5,57,35,22,57
Cliftonville,9847,3,16,6,8,55,36,19,54
Ballymena,9847,4,15,7,8,63,58,5,52
Glenavon,9847,5,13,10,7,51,43,8,49
Dungannon,9847,6,13,8,9,56,38,18,47
Coleraine,9847,7,7,13,10,31,44,-13,34
Ards,9847,8,6,8,16,36,52,-16,26
Glentoran,9847,9,6,8,16,27,43,-16,26
Ballinamalla,9847,10,6,7,17,22,50,-28,25
Portadown,9847,11,5,6,19,22,53,-31,21
Crusaders,9848,1,19,6,5,62,33,29,63
Cliftonville,9848,2,18,4,8,62,37,25,58
Linfield,9848,3,14,11,5,59,37,22,53
Ballymena,9848,4,15,4,11,62,56,6,49
Glenavon,9848,5,11,11,8,51,44,7,44
Coleraine,9848,6,10,11,9,40,37,3,41
Glentoran,9848,7,10,6,14,32,52,-20,36
Dungannon,9848,8,7,9,14,48,54,-6,30
Portadown,9848,9,9,3,18,30,55,-25,30
Ards,9848,10,9,2,19,32,50,-18,29
Ballinamalla,9848,11,6,7,17,29,52,-23,25
Crusaders,9849,1,16,10,4,49,24,25,58
Cliftonville,9849,2,16,5,9,57,51,6,53
Linfield,9849,3,14,8,8,55,33,22,50
Ballymena,9849,4,15,5,10,63,63,0,50
Glenavon,9849,5,11,11,8,52,44,8,44
Coleraine,9849,6,11,11,8,41,37,4,44
Ards,9849,7,12,4,14,49,46,3,40
Dungannon,9849,8,8,13,9,46,43,3,37
Glentoran,9849,9,8,6,16,35,49,-14,30
Ballinamalla,9849,10,8,3,19,33,57,-24,27
Portadown,9849,11,6,4,20,27,60,-33,22
Linfield,9850,1,16,10,4,62,30,32,58
Cliftonville,9850,2,16,5,9,54,35,19,53
Coleraine,9850,3,15,8,7,48,35,13,53
Ballymena,9850,4,15,5,10,57,55,2,50
Crusaders,9850,5,12,13,5,50,33,17,49
Glenavon,9850,6,12,9,9,49,49,0,45
Dungannon,9850,7,8,12,10,51,48,3,36
Glentoran,9850,8,7,9,14,34,49,-15,30
Portadown,9850,9,7,6,17,25,53,-28,27
Ards,9850,10,6,7,17,35,56,-21,25
Ballinamalla,9850,11,6,6,18,31,53,-22,24
Ballymena,9851,1,17,6,7,60,50,10,57
Crusaders,9851,2,15,7,8,54,37,17,52
Cliftonville,9851,3,13,8,9,49,39,10,47
Glenavon,9851,4,10,14,6,44,45,-1,44
Coleraine,9851,5,11,9,10,43,43,0,42
Glentoran,9851,6,11,8,11,34,40,-6,41
Dungannon,9851,7,10,10,10,55,48,7,40
Linfield,9851,8,9,10,11,47,45,2,37
Ards,9851,9,9,5,16,44,50,-6,32
Ballinamalla,9851,10,9,3,18,33,53,-20,30
Portadown,9851,11,7,8,15,26,39,-13,29
Crusaders,9852,1,16,6,8,52,35,17,54
Ballymena,9852,2,16,5,9,59,46,13,53
Linfield,9852,3,14,10,6,62,31,31,52
Cliftonville,9852,4,16,3,11,49,37,12,51
Dungannon,9852,5,11,9,10,55,43,12,42
Coleraine,9852,6,10,10,10,38,38,0,40
Glenavon,9852,7,8,15,7,43,47,-4,39
Ballinamalla,9852,8,10,6,14,32,45,-13,36
Glentoran,9852,9,8,8,14,30,47,-17,32
Ards,9852,10,9,4,17,35,54,-19,31
Portadown,9852,11,6,6,18,19,51,-32,24
Crusaders,9853,1,16,8,6,52,32,20,56
Ballymena,9853,2,17,4,9,70,61,9,55
Cliftonville,9853,3,15,5,10,51,42,9,50
Linfield,9853,4,12,10,8,57,37,20,46
Glenavon,9853,5,11,13,6,48,38,10,46
Coleraine,9853,6,12,10,8,40,36,4,46
Dungannon,9853,7,11,7,12,47,45,2,40
Glentoran,9853,8,7,12,11,30,43,-13,33
Ards,9853,9,8,6,16,40,52,-12,30
Portadown,9853,10,7,5,18,27,50,-23,26
Ballinamalla,9853,11,7,4,19,31,57,-26,25
Crusaders,9854,1,16,6,8,52,33,19,54
Linfield,9854,2,14,11,5,66,29,37,53
Ballymena,9854,3,14,9,7,60,55,5,51
Glenavon,9854,4,12,11,7,53,44,9,47
Cliftonville,9854,5,14,5,11,49,48,1,47
Glentoran,9854,6,12,8,10,40,42,-2,44
Coleraine,9854,7,10,12,8,44,37,7,42
Dungannon,9854,8,11,7,12,55,52,3,40
Ards,9854,9,9,8,13,36,46,-10,35
Ballinamalla,9854,10,4,8,18,22,52,-30,20
Portadown,9854,11,4,5,21,18,57,-39,17
Crusaders,9855,1,17,6,7,50,29,21,57
Ballymena,9855,2,17,5,8,61,49,12,56
Linfield,9855,3,14,12,4,59,34,25,54
Glenavon,9855,4,13,10,7,47,41,6,49
Coleraine,9855,5,11,14,5,41,34,7,47
Cliftonville,9855,6,13,6,11,58,48,10,45
Dungannon,9855,7,10,8,12,44,41,3,38
Glentoran,9855,8,9,8,13,29,37,-8,35
Ards,9855,9,5,9,16,29,47,-18,24
Portadown,9855,10,6,6,18,26,50,-24,24
Ballinamalla,9855,11,6,4,20,24,58,-34,22
Crusaders,9856,1,17,5,8,58,37,21,56
Glenavon,9856,2,16,8,6,59,43,16,56
Linfield,9856,3,15,8,7,65,35,30,53
Coleraine,9856,4,14,10,6,50,38,12,52
Ballymena,9856,5,14,5,11,60,63,-3,47
Cliftonville,9856,6,13,6,11,48,46,2,45
Dungannon,9856,7,12,6,12,53,46,7,42
Glentoran,9856,8,11,6,13,40,51,-11,39
Ards,9856,9,8,6,16,35,50,-15,30
Ballinamalla,9856,10,7,3,20,25,48,-23,24
Portadown,9856,11,4,5,21,21,57,-36,17
Crusaders,9857,1,16,8,6,58,34,24,56
Linfield,9857,2,15,10,5,55,28,27,55
Ballymena,9857,3,15,6,9,60,52,8,51
Cliftonville,9857,4,14,6,10,57,39,18,48
Glentoran,9857,5,12,8,10,33,36,-3,44
Coleraine,9857,6,10,11,9,41,42,-1,41
Glenavon,9857,7,9,11,10,44,45,-1,38
Dungannon,9857,8,9,7,14,47,51,-4,34
Ards,9857,9,10,3,17,41,54,-13,33
Ballinamalla,9857,10,8,5,17,30,56,-26,29
Portadown,9857,11,7,5,18,20,49,-29,26
Cliftonville,9858,1,18,3,9,54,37,17,57
Coleraine,9858,2,15,9,6,46,31,15,54
Crusaders,9858,3,16,5,9,54,38,16,53
Glenavon,9858,4,11,12,7,42,40,2,45
Linfield,9858,5,11,10,9,56,37,19,43
Dungannon,9858,6,12,7,11,51,45,6,43
Ballymena,9858,7,12,5,13,51,56,-5,41
Glentoran,9858,8,8,10,12,28,39,-11,34
Ards,9858,9,9,6,15,33,49,-16,33
Ballinamalla,9858,10,8,4,18,29,50,-21,28
Portadown,9858,11,7,5,18,26,48,-22,26
Cliftonville,9859,1,16,5,9,50,38,12,53
Coleraine,9859,2,13,11,6,41,30,11,50
Crusaders,9859,3,14,8,8,47,38,9,50
Linfield,9859,4,12,11,7,52,33,19,47
Dungannon,9859,5,12,10,8,59,40,19,46
Ballymena,9859,6,13,7,10,60,55,5,46
Glenavon,9859,7,10,10,10,42,46,-4,40
Ballinamalla,9859,8,11,3,16,32,45,-13,36
Glentoran,9859,9,7,8,15,27,47,-20,29
Portadown,9859,10,7,7,16,25,47,-22,28
Ards,9859,11,6,8,16,30,46,-16,26
Crusaders,9860,1,16,8,6,56,33,23,56
Ballymena,9860,2,13,10,7,56,51,5,49
Coleraine,9860,3,13,9,8,41,37,4,48
Cliftonville,9860,4,13,8,9,49,40,9,47
Linfield,9860,5,12,10,8,53,34,19,46
Dungannon,9860,6,11,9,10,53,43,10,42
Glenavon,9860,7,11,9,10,54,51,3,42
Ards,9860,8,10,6,14,42,50,-8,36
Glentoran,9860,9,8,9,13,25,41,-16,33
Ballinamalla,9860,10,7,8,15,26,50,-24,29
Portadown,9860,11,6,4,20,27,52,-25,22
Crusaders,9861,1,17,10,3,53,27,26,61
Cliftonville,9861,2,16,5,9,54,38,16,53
Ballymena,9861,3,15,6,9,63,54,9,51
Linfield,9861,4,12,11,7,60,37,23,47
Glenavon,9861,5,12,8,10,50,50,0,44
Dungannon,9861,6,11,7,12,48,45,3,40
Coleraine,9861,7,10,10,10,37,42,-5,40
Ards,9861,8,11,3,16,35,44,-9,36
Glentoran,9861,9,8,10,12,31,48,-17,34
Portadown,9861,10,7,4,19,28,48,-20,25
Ballinamalla,9861,11,7,4,19,26,52,-26,25
Crusaders,9862,1,16,9,5,46,29,17,57
Linfield,9862,2,15,9,6,66,35,31,54
Ballymena,9862,3,16,3,11,56,58,-2,51
Cliftonville,9862,4,14,3,13,56,40,16,45
Dungannon,9862,5,11,12,7,54,39,15,45
Coleraine,9862,6,12,9,9,46,41,5,45
Glentoran,9862,7,12,7,11,36,39,-3,43
Ards,9862,8,11,6,13,38,41,-3,39
Glenavon,9862,9,8,12,10,45,49,-4,36
Ballinamalla,9862,10,5,5,20,27,63,-36,20
Portadown,9862,11,4,7,19,19,55,-36,19
Crusaders,9863,1,15,8,7,50,32,18,53
Linfield,9863,2,14,10,6,53,27,26,52
Ballymena,9863,3,15,6,9,57,55,2,51
Cliftonville,9863,4,14,6,10,54,40,14,48
Coleraine,9863,5,11,10,9,39,36,3,43
Dungannon,9863,6,11,7,12,46,46,0,40
Glentoran,9863,7,10,8,12,38,45,-7,38
Ballinamalla,9863,8,11,4,15,30,43,-13,37
Ards,9863,9,11,2,17,40,56,-16,35
Glenavon,9863,10,8,10,12,45,50,-5,34
Portadown,9863,11,7,5,18,25,47,-22,26
Crusaders,9864,1,17,4,9,53,39,14,55
Cliftonville,9864,2,16,4,10,54,37,17,52
Glenavon,9864,3,14,9,7,53,46,7,51
Linfield,9864,4,14,8,8,55,27,28,50
Coleraine,9864,5,13,9,8,45,39,6,48
Ballymena,9864,6,14,5,11,58,59,-1,47
Glentoran,9864,7,9,6,15,35,46,-11,33
Dungannon,9864,8,7,11,12,47,47,0,32
Ards,9864,9,10,2,18,32,50,-18,32
Ballinamalla,9864,10,9,4,17,32,53,-21,31
Portadown,9864,11,9,4,17,22,43,-21,31
Linfield,9865,1,16,8,6,60,27,33,56
Crusaders,9865,2,15,8,7,56,36,20,53
Cliftonville,9865,3,16,3,11,49,43,6,51
Coleraine,9865,4,11,9,10,43,43,0,42
Glenavon,9865,5,11,8,11,47,47,0,41
Dungannon,9865,6,11,7,12,48,47,1,40
Ballymena,9865,7,11,6,13,58,64,-6,39
Ards,9865,8,11,5,14,39,46,-7,38
Ballinamalla,9865,9,11,4,15,33,46,-13,37
Glentoran,9865,10,8,8,14,28,47,-19,32
Portadown,9865,11,9,4,17,32,47,-15,31
Crusaders,9866,1,19,4,7,55,36,19,61
Linfield,9866,2,15,8,7,58,35,23,53
Coleraine,9866,3,15,8,7,53,34,19,53
Dungannon,9866,4,13,8,9,52,36,16,47
Ards,9866,5,13,3,14,41,46,-5,42
Cliftonville,9866,6,12,5,13,48,47,1,41
Glenavon,9866,7,10,9,11,40,46,-6,39
Ballymena,9866,8,9,7,14,51,67,-16,34
Ballinamalla,9866,9,9,5,16,34,48,-14,32
Glentoran,9866,10,7,9,14,27,44,-17,30
Portadown,9866,11,8,4,18,29,49,-20,28
Crusaders,9867,1,17,8,5,67,44,23,59
Cliftonville,9867,2,15,5,10,48,34,14,50
Glenavon,9867,3,13,10,7,52,44,8,49
Linfield,9867,4,13,8,9,51,36,15,47
Ballymena,9867,5,13,6,11,61,60,1,45
Coleraine,9867,6,10,12,8,48,43,5,42
Portadown,9867,7,10,6,14,27,41,-14,36
Dungannon,9867,8,8,11,11,54,51,3,35
Glentoran,9867,9,8,8,14,28,47,-19,32
Ards,9867,10,7,8,15,34,49,-15,29
Ballinamalla,9867,11,8,4,18,32,53,-21,28
Crusaders,9868,1,16,7,7,49,32,17,55
Glenavon,9868,2,15,8,7,52,36,16,53
Cliftonville,9868,3,16,4,10,52,39,13,52
Linfield,9868,4,14,6,10,51,35,16,48
Ballymena,9868,5,11,11,8,57,55,2,44
Coleraine,9868,6,10,9,11,39,43,-4,39
Glentoran,9868,7,11,6,13,32,44,-12,39
Dungannon,9868,8,9,10,11,47,45,2,37
Ards,9868,9,9,5,16,38,49,-11,32
Portadown,9868,10,8,6,16,28,43,-15,30
Ballinamalla,9868,11,8,4,18,27,51,-24,28
Crusaders,9869,1,19,7,4,56,30,26,64
Coleraine,9869,2,14,10,6,48,34,14,52
Glenavon,9869,3,14,8,8,58,47,11,50
Linfield,9869,4,13,10,7,56,36,20,49
Cliftonville,9869,5,14,4,12,49,42,7,46
Ballymena,9869,6,12,7,11,54,60,-6,43
Dungannon,9869,7,9,9,12,48,41,7,36
Ards,9869,8,10,4,16,39,49,-10,34
Ballinamalla,9869,9,10,4,16,35,49,-14,34
Portadown,9869,10,8,3,19,33,62,-29,27
Glentoran,9869,11,5,8,17,27,53,-26,23
Cliftonville,9870,1,16,6,8,57,41,16,54
Glenavon,9870,2,14,9,7,52,36,16,51
Coleraine,9870,3,14,8,8,48,37,11,50
Crusaders,9870,4,14,7,9,55,40,15,49
Ballymena,9870,5,13,6,11,58,59,-1,45
Linfield,9870,6,12,8,10,57,40,17,44
Dungannon,9870,7,10,9,11,54,48,6,39
Glentoran,9870,8,10,6,14,30,44,-14,36
Ballinamalla,9870,9,10,4,16,32,58,-26,34
Ards,9870,10,10,2,18,39,56,-17,32
Portadown,9870,11,7,5,18,27,50,-23,26
Crusaders,9871,1,16,7,7,50,35,15,55
Glenavon,9871,2,14,10,6,46,34,12,52
Cliftonville,9871,3,15,6,9,51,39,12,51
Ballymena,9871,4,15,5,10,53,49,4,50
Coleraine,9871,5,12,10,8,47,34,13,46
Linfield,9871,6,12,7,11,51,40,11,43
Dungannon,9871,7,7,14,9,50,44,6,35
Ballinamalla,9871,8,9,8,13,33,43,-10,35
Ards,9871,9,9,6,15,40,50,-10,33
Portadown,9871,10,7,5,18,25,50,-25,26
Glentoran,9871,11,5,10,15,18,46,-28,25
Crusaders,9872,1,17,10,3,61,32,29,61
Linfield,9872,2,16,11,3,61,26,35,59
Coleraine,9872,3,13,10,7,48,42,6,49
Cliftonville,9872,4,13,6,11,57,46,11,45
Ballymena,9872,5,13,5,12,49,57,-8,44
Dungannon,9872,6,10,11,9,58,46,12,41
Glenavon,9872,7,9,10,11,43,48,-5,37
Glentoran,9872,8,8,9,13,28,44,-16,33
Ards,9872,9,8,4,18,31,51,-20,28
Ballinamalla,9872,10,7,7,16,29,50,-21,28
Portadown,9872,11,6,7,17,27,50,-23,25
Linfield,9873,1,17,9,4,62,30,32,60
Crusaders,9873,2,16,6,8,50,31,19,54
Cliftonville,9873,3,16,5,9,60,39,21,53
Ballymena,9873,4,14,6,10,60,59,1,48
Coleraine,9873,5,10,11,9,43,43,0,41
Glenavon,9873,6,9,10,11,48,52,-4,37
Portadown,9873,7,10,6,14,32,42,-10,36
Ballinamalla,9873,8,9,8,13,30,47,-17,35
Ards,9873,9,9,6,15,43,51,-8,33
Dungannon,9873,10,7,9,14,43,54,-11,30
Glentoran,9873,11,7,6,17,27,50,-23,27
Crusaders,9874,1,19,8,3,65,26,39,65
Cliftonville,9874,2,16,5,9,58,38,20,53
Linfield,9874,3,12,11,7,49,30,19,47
Dungannon,9874,4,12,9,9,59,43,16,45
Coleraine,9874,5,11,12,7,40,38,2,45
Glenavon,9874,6,11,11,8,54,44,10,44
Ballymena,9874,7,11,8,11,51,61,-10,41
Glentoran,9874,8,9,9,12,33,53,-20,36
Ballinamalla,9874,9,6,7,17,26,57,-31,25
Portadown,9874,10,6,6,18,20,45,-25,24
Ards,9874,11,5,8,17,32,52,-20,23
Linfield,9875,1,17,8,5,67,30,37,59
Crusaders,9875,2,16,9,5,53,27,26,57
Ballymena,9875,3,15,7,8,55,50,5,52
Cliftonville,9875,4,15,5,10,50,38,12,50
Glenavon,9875,5,13,8,9,47,43,4,47
Dungannon,9875,6,11,8,11,47,42,5,41
Ballinamalla,9875,7,11,5,14,35,52,-17,38
Coleraine,9875,8,9,10,11,37,38,-1,37
Glentoran,9875,9,7,6,17,39,57,-18,27
Ards,9875,10,8,3,19,35,69,-34,27
Portadown,9875,11,6,5,19,26,45,-19,23
Crusaders,9876,1,17,7,6,57,36,21,58
Linfield,9876,2,13,10,7,60,34,26,49
Cliftonville,9876,3,15,3,12,54,48,6,48
Coleraine,9876,4,12,11,7,45,34,11,47
Ballymena,9876,5,14,5,11,56,62,-6,47
Glentoran,9876,6,12,6,12,41,47,-6,42
Portadown,9876,7,11,7,12,35,40,-5,40
Glenavon,9876,8,9,12,9,47,45,2,39
Dungannon,9876,9,9,10,11,51,47,4,37
Ards,9876,10,7,4,19,29,53,-24,25
Ballinamalla,9876,11,7,3,20,23,52,-29,24
Crusaders,9877,1,17,8,5,60,26,34,59
Cliftonville,9877,2,18,3,9,60,39,21,57
Coleraine,9877,3,13,9,8,46,38,8,48
Ballymena,9877,4,14,5,11,58,69,-11,47
Linfield,9877,5,12,9,9,54,36,18,45
Glenavon,9877,6,10,10,10,43,42,1,40
Ards,9877,7,11,3,16,42,54,-12,36
Dungannon,9877,8,7,12,11,47,45,2,33
Ballinamalla,9877,9,9,5,16,29,51,-22,32
Portadown,9877,10,7,9,14,26,42,-16,30
Glentoran,9877,11,7,7,16,28,51,-23,28
Crusaders,9878,1,16,10,4,54,33,21,58
Linfield,9878,2,14,11,5,64,30,34,53
Cliftonville,9878,3,16,4,10,55,40,15,52
Ballymena,9878,4,16,3,11,56,56,0,51
Coleraine,9878,5,12,9,9,38,39,-1,45
Glenavon,9878,6,11,10,9,43,41,2,43
Ards,9878,7,12,6,12,43,45,-2,42
Dungannon,9878,8,9,7,14,51,54,-3,34
Portadown,9878,9,9,4,17,29,44,-15,31
Ballinamalla,9878,10,6,6,18,26,52,-26,24
Glentoran,9878,11,4,10,16,27,52,-25,22
Crusaders,9879,1,17,7,6,56,32,24,58
Linfield,9879,2,16,7,7,64,30,34,55
Cliftonville,9879,3,14,6,10,55,43,12,48
Glenavon,9879,4,12,8,10,46,48,-2,44
Coleraine,9879,5,12,7,11,45,40,5,43
Ballymena,9879,6,12,6,12,57,61,-4,42
Dungannon,9879,7,10,8,12,48,49,-1,38
Glentoran,9879,8,10,8,12,34,44,-10,38
Ards,9879,9,9,5,16,40,57,-17,32
Portadown,9879,10,8,7,15,24,43,-19,31
Ballinamalla,9879,11,8,5,17,29,51,-22,29
Crusaders,9880,1,17,8,5,64,36,28,59
Glenavon,9880,2,14,10,6,57,39,18,52
Linfield,9880,3,14,8,8,62,35,27,50
Ballymena,9880,4,14,6,10,61,62,-1,48
Coleraine,9880,5,13,8,9,44,41,3,47
Cliftonville,9880,6,13,7,10,52,47,5,46
Portadown,9880,7,10,4,16,24,40,-16,34
Ards,9880,8,9,6,15,36,48,-12,33
Glentoran,9880,9,8,8,14,27,45,-18,32
Dungannon,9880,10,7,9,14,45,49,-4,30
Ballinamalla,9880,11,7,4,19,26,56,-30,25
Cliftonville,9881,1,16,4,10,51,38,13,52
Coleraine,9881,2,14,10,6,44,36,8,52
Crusaders,9881,3,14,9,7,49,37,12,51
Linfield,9881,4,11,11,8,54,39,15,44
Glenavon,9881,5,11,9,10,42,38,4,42
Glentoran,9881,6,12,6,12,33,39,-6,42
Dungannon,9881,7,11,8,11,55,45,10,41
Ballymena,9881,8,10,9,11,56,61,-5,39
Portadown,9881,9,9,7,14,27,39,-12,34
Ards,9881,10,9,5,16,35,49,-14,32
Ballinamalla,9881,11,7,4,19,31,56,-25,25
Crusaders,9882,1,17,7,6,54,30,24,58
Linfield,9882,2,12,15,3,54,29,25,51
Ballymena,9882,3,15,6,9,48,48,0,51
Cliftonville,9882,4,15,5,10,55,40,15,50
Glenavon,9882,5,13,8,9,53,39,14,47
Dungannon,9882,6,9,11,10,45,41,4,38
Ards,9882,7,11,5,14,32,37,-5,38
Coleraine,9882,8,9,9,12,36,42,-6,36
Glentoran,9882,9,10,6,14,26,37,-11,36
Portadown,9882,10,6,7,17,23,52,-29,25
Ballinamalla,9882,11,6,5,19,26,57,-31,23
Ballymena,9883,1,16,5,9,59,58,1,53
Crusaders,9883,2,14,7,9,55,45,10,49
Cliftonville,9883,3,14,6,10,55,44,11,48
Linfield,9883,4,13,8,9,54,35,19,47
Dungannon,9883,5,12,9,9,54,40,14,45
Glenavon,9883,6,12,9,9,54,49,5,45
Ards,9883,7,13,3,14,46,45,1,42
Coleraine,9883,8,9,10,11,39,38,1,37
Glentoran,9883,9,8,10,12,32,44,-12,34
Portadown,9883,10,9,4,17,36,54,-18,31
Ballinamalla,9883,11,7,5,18,25,57,-32,26
Cliftonville,9884,1,18,4,8,53,32,21,58
Linfield,9884,2,15,8,7,56,27,29,53
Crusaders,9884,3,13,10,7,53,37,16,49
Dungannon,9884,4,12,8,10,59,46,13,44
Ballymena,9884,5,12,8,10,51,56,-5,44
Coleraine,9884,6,9,11,10,36,39,-3,38
Glenavon,9884,7,8,13,9,46,49,-3,37
Ards,9884,8,9,7,14,34,42,-8,34
Glentoran,9884,9,8,8,14,24,42,-18,32
Ballinamalla,9884,10,9,5,16,26,48,-22,32
Portadown,9884,11,9,4,17,30,50,-20,31
Cliftonville,9885,1,17,4,9,51,34,17,55
Coleraine,9885,2,14,9,7,42,29,13,51
Crusaders,9885,3,14,8,8,49,33,16,50
Ballymena,9885,4,14,5,11,54,56,-2,47
Linfield,9885,5,11,12,7,50,32,18,45
Glenavon,9885,6,11,12,7,44,41,3,45
Dungannon,9885,7,10,8,12,54,45,9,38
Glentoran,9885,8,10,6,14,28,36,-8,36
Ballinamalla,9885,9,9,4,17,31,57,-26,31
Portadown,9885,10,8,6,16,23,43,-20,30
Ards,9885,11,8,4,18,36,56,-20,28
Crusaders,9886,1,20,8,2,62,31,31,68
Ballymena,9886,2,16,4,10,67,54,13,52
Coleraine,9886,3,15,7,8,55,48,7,52
Linfield,9886,4,11,10,9,51,36,15,43
Cliftonville,9886,5,12,7,11,51,45,6,43
Glenavon,9886,6,10,11,9,40,43,-3,41
Dungannon,9886,7,10,10,10,47,43,4,40
Glentoran,9886,8,9,7,14,38,50,-12,34
Ards,9886,9,10,4,16,35,50,-15,34
Portadown,9886,10,6,9,15,28,46,-18,27
Ballinamalla,9886,11,5,5,20,25,53,-28,20
Crusaders,9887,1,15,10,5,55,40,15,55
Cliftonville,9887,2,15,6,9,58,38,20,51
Linfield,9887,3,13,11,6,52,32,20,50
Ballymena,9887,4,13,6,11,53,56,-3,45
Coleraine,9887,5,11,11,8,43,39,4,44
Dungannon,9887,6,11,8,11,65,47,18,41
Glentoran,9887,7,11,6,13,31,46,-15,39
Glenavon,9887,8,8,13,9,44,44,0,37
Ards,9887,9,9,10,11,45,48,-3,37
Ballinamalla,9887,10,8,3,19,32,64,-32,27
Portadown,9887,11,6,6,18,21,45,-24,24
Linfield,9888,1,17,9,4,62,28,34,60
Cliftonville,9888,2,15,8,7,45,28,17,53
Ballymena,9888,3,14,9,7,61,54,7,51
Crusaders,9888,4,14,7,9,49,33,16,49
Glenavon,9888,5,12,11,7,43,40,3,47
Coleraine,9888,6,10,8,12,38,40,-2,38
Ards,9888,7,10,5,15,39,50,-11,35
Dungannon,9888,8,8,9,13,44,44,0,33
Portadown,9888,9,8,6,16,26,42,-16,30
Ballinamalla,9888,10,8,6,16,31,53,-22,30
Glentoran,9888,11,7,6,17,25,51,-26,27
Crusaders,9889,1,16,7,7,54,37,17,55
Ballymena,9889,2,16,6,8,63,54,9,54
Glenavon,9889,3,13,11,6,46,44,2,50
Linfield,9889,4,13,9,8,58,33,25,48
Coleraine,9889,5,12,11,7,40,34,6,47
Cliftonville,9889,6,13,7,10,51,44,7,46
Dungannon,9889,7,8,10,12,48,45,3,34
Ballinamalla,9889,8,9,4,17,27,41,-14,31
Glentoran,9889,9,8,7,15,27,48,-21,31
Ards,9889,10,9,3,18,33,48,-15,30
Portadown,9889,11,7,7,16,26,45,-19,28
Linfield,9890,1,17,8,5,66,33,33,59
Ballymena,9890,2,15,6,9,65,59,6,51
Crusaders,9890,3,14,8,8,61,44,17,50
Coleraine,9890,4,13,11,6,45,31,14,50
Dungannon,9890,5,13,8,9,52,39,13,47
Cliftonville,9890,6,13,7,10,50,42,8,46
Glenavon,9890,7,11,10,9,45,50,-5,43
Glentoran,9890,8,7,9,14,35,48,-13,30
Ards,9890,9,8,5,17,39,57,-18,29
Ballinamalla,9890,10,6,6,18,30,53,-23,24
Portadown,9890,11,5,8,17,21,53,-32,23
Crusaders,9891,1,15,11,4,55,32,23,56
Linfield,9891,2,14,12,4,59,31,28,54
Ballymena,9891,3,15,8,7,59,52,7,53
Cliftonville,9891,4,15,6,9,50,40,10,51
Coleraine,9891,5,13,8,9,44,40,4,47
Glenavon,9891,6,9,12,9,44,43,1,39
Glentoran,9891,7,10,6,14,30,42,-12,36
Dungannon,9891,8,8,10,12,48,47,1,34
Ards,9891,9,7,8,15,37,53,-16,29
Portadown,9891,10,7,6,17,26,45,-19,27
Ballinamalla,9891,11,5,7,18,25,52,-27,22
Linfield,9892,1,16,9,5,59,28,31,57
Coleraine,9892,2,15,9,6,45,30,15,54
Cliftonville,9892,3,15,5,10,52,38,14,50
Ballymena,9892,4,14,6,10,60,60,0,48
Crusaders,9892,5,14,5,11,54,46,8,47
Dungannon,9892,6,12,9,9,56,46,10,45
Glenavon,9892,7,11,12,7,52,49,3,45
Glentoran,9892,8,10,6,14,37,51,-14,36
Ards,9892,9,9,3,18,42,55,-13,30
Portadown,9892,10,9,3,18,27,47,-20,30
Ballinamalla,9892,11,5,3,22,24,58,-34,18
Crusaders,9893,1,18,6,6,60,32,28,60
Linfield,9893,2,14,11,5,56,29,27,53
Glenavon,9893,3,13,9,8,58,44,14,48
Cliftonville,9893,4,14,6,10,45,39,6,48
Dungannon,9893,5,13,8,9,48,42,6,47
Ballymena,9893,6,13,7,10,56,63,-7,46
Coleraine,9893,7,9,12,9,40,44,-4,39
Glentoran,9893,8,10,8,12,33,37,-4,38
Ards,9893,9,7,6,17,32,48,-16,27
Ballinamalla,9893,10,6,7,17,24,47,-23,25
Portadown,9893,11,6,4,20,23,50,-27,22
Crusaders,9894,1,20,6,4,63,38,25,66
Cliftonville,9894,2,18,2,10,59,43,16,56
Linfield,9894,3,15,9,6,58,31,27,54
Glenavon,9894,4,13,8,9,53,44,9,47
Coleraine,9894,5,12,10,8,47,40,7,46
Ballymena,9894,6,13,6,11,50,54,-4,45
Dungannon,9894,7,11,7,12,49,43,6,40
Ards,9894,8,10,6,14,41,45,-4,36
Portadown,9894,9,9,2,19,27,50,-23,29
Glentoran,9894,10,6,7,17,27,54,-27,25
Ballinamalla,9894,11,5,3,22,27,59,-32,18
Crusaders,9895,1,18,5,7,61,33,28,59
Cliftonville,9895,2,18,4,8,58,37,21,58
Glenavon,9895,3,12,11,7,47,41,6,47
Linfield,9895,4,11,13,6,55,30,25,46
Glentoran,9895,5,12,6,12,37,43,-6,42
Ballymena,9895,6,12,6,12,55,66,-11,42
Coleraine,9895,7,9,11,10,41,45,-4,38
Dungannon,9895,8,9,8,13,47,46,1,35
Ards,9895,9,9,7,14,37,43,-6,34
Portadown,9895,10,7,7,16,22,47,-25,28
Ballinamalla,9895,11,8,2,20,35,64,-29,26
Ballymena,9896,1,15,9,6,62,56,6,54
Crusaders,9896,2,13,13,4,50,31,19,52
Linfield,9896,3,13,12,5,61,28,33,51
Cliftonville,9896,4,13,9,8,49,37,12,48
Dungannon,9896,5,11,10,9,54,43,11,43
Coleraine,9896,6,10,11,9,41,42,-1,41
Glenavon,9896,7,9,10,11,48,47,1,37
Glentoran,9896,8,6,12,12,24,41,-17,30
Ards,9896,9,6,11,13,33,46,-13,29
Portadown,9896,10,5,11,14,26,51,-25,26
Ballinamalla,9896,11,6,8,16,26,52,-26,26
Crusaders,9897,1,20,5,5,64,36,28,65
Linfield,9897,2,13,9,8,59,38,21,48
Ballymena,9897,3,14,4,12,64,65,-1,46
Coleraine,9897,4,11,12,7,40,35,5,45
Dungannon,9897,5,12,8,10,56,45,11,44
Cliftonville,9897,6,14,2,14,45,37,8,44
Glenavon,9897,7,11,11,8,44,43,1,44
Glentoran,9897,8,10,8,12,34,44,-10,38
Ards,9897,9,11,2,17,41,51,-10,35
Ballinamalla,9897,10,6,7,17,31,54,-23,25
Portadown,9897,11,6,6,18,20,50,-30,24
Crusaders,9898,1,17,6,7,56,33,23,57
Linfield,9898,2,16,7,7,57,40,17,55
Cliftonville,9898,3,15,6,9,52,40,12,51
Dungannon,9898,4,12,10,8,53,38,15,46
Glenavon,9898,5,12,8,10,45,41,4,44
Ballymena,9898,6,12,7,11,58,64,-6,43
Coleraine,9898,7,10,10,10,40,38,2,40
Glentoran,9898,8,11,7,12,39,39,0,40
Ards,9898,9,8,4,18,36,58,-22,28
Ballinamalla,9898,10,8,4,18,29,51,-22,28
Portadown,9898,11,5,9,16,19,42,-23,24
Linfield,9899,1,15,10,5,62,27,35,55
Cliftonville,9899,2,17,4,9,58,40,18,55
Crusaders,9899,3,15,7,8,61,41,20,52
Ballymena,9899,4,13,9,8,58,55,3,48
Glenavon,9899,5,11,12,7,53,52,1,45
Dungannon,9899,6,8,11,11,52,49,3,35
Portadown,9899,7,9,7,14,30,42,-12,34
Glentoran,9899,8,9,7,14,27,48,-21,34
Ards,9899,9,9,5,16,38,49,-11,32
Coleraine,9899,10,7,10,13,41,55,-14,31
Ballinamalla,9899,11,7,8,15,33,55,-22,29
Crusaders,9900,1,18,9,3,64,30,34,63
Cliftonville,9900,2,16,4,10,55,42,13,52
Ballymena,9900,3,15,7,8,63,55,8,52
Linfield,9900,4,12,10,8,63,42,21,46
Dungannon,9900,5,12,8,10,50,46,4,44
Coleraine,9900,6,10,10,10,40,37,3,40
Glenavon,9900,7,8,14,8,47,46,1,38
Ballinamalla,9900,8,10,3,17,30,49,-19,33
Ards,9900,9,8,7,15,33,45,-12,31
Portadown,9900,10,7,7,16,31,50,-19,28
Glentoran,9900,11,7,5,18,26,60,-34,26
Crusaders,9901,1,17,5,8,54,38,16,56
Linfield,9901,2,15,9,6,54,28,26,54
Cliftonville,9901,3,13,10,7,56,38,18,49
Coleraine,9901,4,12,11,7,39,35,4,47
Dungannon,9901,5,13,7,10,50,43,7,46
Ballymena,9901,6,12,8,10,58,60,-2,44
Glenavon,9901,7,10,10,10,39,38,1,40
Glentoran,9901,8,10,6,14,30,43,-13,36
Ards,9901,9,9,6,15,36,46,-10,33
Ballinamalla,9901,10,8,5,17,30,51,-21,29
Portadown,9901,11,4,7,19,25,51,-26,19
Crusaders,9902,1,17,7,6,60,35,25,58
Cliftonville,9902,2,18,4,8,49,36,13,58
Linfield,9902,3,14,7,9,62,37,25,49
Glenavon,9902,4,12,9,9,49,44,5,45
Ballymena,9902,5,12,6,12,53,58,-5,42
Coleraine,9902,6,10,10,10,37,36,1,40
Portadown,9902,7,10,5,15,26,39,-13,35
Glentoran,9902,8,9,8,13,31,50,-19,35
Dungannon,9902,9,8,8,14,41,43,-2,32
Ards,9902,10,8,7,15,37,48,-11,31
Ballinamalla,9902,11,8,7,15,30,49,-19,31
Crusaders,9903,1,17,8,5,60,34,26,59
Ballymena,9903,2,16,4,10,68,53,15,52
Cliftonville,9903,3,16,4,10,54,43,11,52
Linfield,9903,4,14,8,8,62,38,24,50
Coleraine,9903,5,11,11,8,47,41,6,44
Glenavon,9903,6,10,13,7,45,47,-2,43
Dungannon,9903,7,9,8,13,42,48,-6,35
Ards,9903,8,10,5,15,40,46,-6,35
Portadown,9903,9,9,4,17,25,47,-22,31
Glentoran,9903,10,7,8,15,24,47,-23,29
Ballinamalla,9903,11,7,5,18,23,46,-23,26
Linfield,9904,1,15,8,7,57,28,29,53
Crusaders,9904,2,14,10,6,55,37,18,52
Cliftonville,9904,3,14,8,8,51,37,14,50
Ballymena,9904,4,14,6,10,55,62,-7,48
Glenavon,9904,5,12,8,10,48,49,-1,44
Dungannon,9904,6,11,10,9,52,42,10,43
Coleraine,9904,7,9,11,10,39,37,2,38
Ards,9904,8,10,5,15,38,52,-14,35
Glentoran,9904,9,9,7,14,33,42,-9,34
Ballinamalla,9904,10,10,2,18,33,52,-19,32
Portadown,9904,11,6,7,17,24,47,-23,25
Crusaders,9905,1,15,10,5,48,25,23,55
Linfield,9905,2,14,9,7,56,31,25,51
Ballymena,9905,3,13,11,6,62,53,9,50
Cliftonville,9905,4,13,8,9,51,42,9,47
Coleraine,9905,5,12,9,9,51,46,5,45
Dungannon,9905,6,10,11,9,49,38,11,41
Glentoran,9905,7,11,7,12,25,40,-15,40
Glenavon,9905,8,9,9,12,45,51,-6,36
Ards,9905,9,8,8,14,41,48,-7,32
Portadown,9905,10,5,11,14,24,46,-22,26
Ballinamalla,9905,11,5,7,18,25,57,-32,22
Crusaders,9906,1,17,5,8,63,39,24,56
Linfield,9906,2,14,10,6,58,29,29,52
Coleraine,9906,3,14,10,6,45,33,12,52
Cliftonville,9906,4,15,6,9,55,41,14,51
Ballymena,9906,5,11,9,10,65,67,-2,42
Glenavon,9906,6,8,14,8,40,41,-1,38
Glentoran,9906,7,9,9,12,26,38,-12,36
Ards,9906,8,10,4,16,34,52,-18,34
Ballinamalla,9906,9,9,6,15,31,46,-15,33
Dungannon,9906,10,7,11,12,42,44,-2,32
Portadown,9906,11,5,8,17,26,55,-29,23
Crusaders,9907,1,19,5,6,61,34,27,62
Dungannon,9907,2,14,9,7,57,38,19,51
Linfield,9907,3,13,9,8,53,32,21,48
Ballymena,9907,4,13,5,12,53,57,-4,44
Glenavon,9907,5,11,9,10,44,52,-8,42
Coleraine,9907,6,10,10,10,42,41,1,40
Glentoran,9907,7,11,7,12,32,42,-10,40
Ards,9907,8,11,5,14,42,44,-2,38
Cliftonville,9907,9,11,5,14,43,48,-5,38
Ballinamalla,9907,10,9,5,16,29,47,-18,32
Portadown,9907,11,6,5,19,26,47,-21,23
Crusaders,9908,1,20,5,5,60,32,28,65
Ballymena,9908,2,17,5,8,61,49,12,56
Cliftonville,9908,3,15,5,10,52,42,10,50
Glenavon,9908,4,14,8,8,51,44,7,50
Linfield,9908,5,13,10,7,54,34,20,49
Coleraine,9908,6,9,10,11,44,43,1,37
Dungannon,9908,7,9,9,12,45,43,2,36
Glentoran,9908,8,8,7,15,24,44,-20,31
Ards,9908,9,6,11,13,33,45,-12,29
Portadown,9908,10,6,9,15,32,59,-27,27
Ballinamalla,9908,11,7,3,20,30,51,-21,24
Crusaders,9909,1,16,9,5,62,34,28,57
Linfield,9909,2,16,8,6,57,30,27,56
Cliftonville,9909,3,16,3,11,50,38,12,51
Ballymena,9909,4,13,8,9,53,57,-4,47
Glenavon,9909,5,12,9,9,50,47,3,45
Dungannon,9909,6,10,11,9,57,43,14,41
Ards,9909,7,10,6,14,40,49,-9,36
Ballinamalla,9909,8,11,3,16,32,49,-17,36
Coleraine,9909,9,7,11,12,35,45,-10,32
Glentoran,9909,10,8,7,15,29,43,-14,31
Portadown,9909,11,6,5,19,28,58,-30,23
Linfield,9910,1,16,9,5,62,36,26,57
Coleraine,9910,2,13,12,5,50,36,14,51
Ballymena,9910,3,15,4,11,59,58,1,49
Crusaders,9910,4,13,9,8,52,39,13,48
Cliftonville,9910,5,14,5,11,46,42,4,47
Glenavon,9910,6,9,12,9,44,47,-3,39
Dungannon,9910,7,9,8,13,56,48,8,35
Ards,9910,8,9,7,14,43,51,-8,34
Glentoran,9910,9,8,8,14,33,50,-17,32
Portadown,9910,10,8,7,15,29,43,-14,31
Ballinamalla,9910,11,8,5,17,30,54,-24,29
Crusaders,9911,1,18,9,3,59,28,31,63
Linfield,9911,2,15,9,6,67,34,33,54
Glenavon,9911,3,13,12,5,57,37,20,51
Ballymena,9911,4,14,6,10,68,63,5,48
Cliftonville,9911,5,14,5,11,52,44,8,47
Coleraine,9911,6,10,12,8,43,43,0,42
Ards,9911,7,10,4,16,41,53,-12,34
Dungannon,9911,8,8,9,13,45,50,-5,33
Glentoran,9911,9,8,6,16,27,61,-34,30
Portadown,9911,10,8,3,19,31,51,-20,27
Ballinamalla,9911,11,7,5,18,30,56,-26,26
Crusaders,9912,1,16,8,6,59,31,28,56
Cliftonville,9912,2,17,4,9,49,35,14,55
Coleraine,9912,3,14,11,5,46,29,17,53
Linfield,9912,4,11,9,10,51,37,14,42
Ballymena,9912,5,12,5,13,52,58,-6,41
Glenavon,9912,6,10,10,10,46,53,-7,40
Dungannon,9912,7,10,9,11,46,36,10,39
Glentoran,9912,8,9,10,11,28,42,-14,37
Ballinamalla,9912,9,9,6,15,26,46,-20,33
Portadown,9912,10,8,6,16,24,44,-20,30
Ards,9912,11,8,4,18,31,47,-16,28
Crusaders,9913,1,18,6,6,57,32,25,60
Linfield,9913,2,16,9,5,63,26,37,57
Cliftonville,9913,3,15,6,9,53,43,10,51
Glenavon,9913,4,12,12,6,48,40,8,48
Coleraine,9913,5,12,11,7,43,31,12,47
Ballymena,9913,6,12,9,9,52,52,0,45
Dungannon,9913,7,10,7,13,45,47,-2,37
Glentoran,9913,8,10,7,13,31,48,-17,37
Ards,9913,9,9,5,16,36,52,-16,32
Portadown,9913,10,5,6,19,20,46,-26,21
Ballinamalla,9913,11,5,4,21,27,58,-31,19
Crusaders,9914,1,18,8,4,56,27,29,62
Cliftonville,9914,2,14,9,7,57,35,22,51
Linfield,9914,3,13,11,6,56,33,23,50
Ballymena,9914,4,14,5,11,58,61,-3,47
Dungannon,9914,5,10,10,10,47,42,5,40
Coleraine,9914,6,9,12,9,38,36,2,39
Glentoran,9914,7,9,10,11,27,36,-9,37
Glenavon,9914,8,8,11,11,39,50,-11,35
Ards,9914,9,8,8,14,32,47,-15,32
Portadown,9914,10,8,6,16,26,43,-17,30
Ballinamalla,9914,11,6,6,18,29,55,-26,24
Cliftonville,9915,1,17,5,8,50,32,18,56
Linfield,9915,2,15,8,7,59,28,31,53
Crusaders,9915,3,15,7,8,55,35,20,52
Glenavon,9915,4,13,9,8,52,45,7,48
Coleraine,9915,5,12,9,9,44,37,7,45
Dungannon,9915,6,12,8,10,46,41,5,44
Glentoran,9915,7,12,7,11,37,43,-6,43
Ballymena,9915,8,10,10,10,49,56,-7,40
Ards,9915,9,9,3,18,37,57,-20,30
Portadown,9915,10,6,7,17,26,49,-23,25
Ballinamalla,9915,11,7,1,22,31,63,-32,22
Crusaders,9916,1,18,8,4,59,29,30,62
Linfield,9916,2,16,9,5,64,33,31,57
Coleraine,9916,3,15,10,5,48,34,14,55
Glenavon,9916,4,13,8,9,49,47,2,47
Ballymena,9916,5,13,7,10,60,55,5,46
Cliftonville,9916,6,13,3,14,48,46,2,42
Ards,9916,7,11,4,15,48,49,-1,37
Dungannon,9916,8,8,11,11,45,50,-5,35
Glentoran,9916,9,6,9,15,27,48,-21,27
Portadown,9916,10,6,6,18,21,50,-29,24
Ballinamalla,9916,11,6,5,19,25,53,-28,23
Crusaders,9917,1,17,6,7,54,32,22,57
Linfield,9917,2,15,10,5,56,25,31,55
Ballymena,9917,3,15,5,10,59,57,2,50
Cliftonville,9917,4,15,4,11,52,41,11,49
Dungannon,9917,5,13,9,8,64,40,24,48
Glenavon,9917,6,13,9,8,55,46,9,48
Ards,9917,7,10,5,15,38,49,-11,35
Coleraine,9917,8,8,11,11,41,53,-12,35
Ballinamalla,9917,9,8,4,18,31,56,-25,28
Portadown,9917,10,8,4,18,22,49,-27,28
Glentoran,9917,11,6,7,17,27,51,-24,25
Linfield,9918,1,18,7,5,61,25,36,61
Crusaders,9918,2,16,5,9,54,37,17,53
Glenavon,9918,3,14,10,6,53,41,12,52
Coleraine,9918,4,13,11,6,44,33,11,50
Cliftonville,9918,5,14,7,9,54,41,13,49
Ballymena,9918,6,12,9,9,53,55,-2,45
Ards,9918,7,8,6,16,35,55,-20,30
Portadown,9918,8,9,3,18,27,49,-22,30
Dungannon,9918,9,6,11,13,46,49,-3,29
Glentoran,9918,10,8,5,17,29,50,-21,29
Ballinamalla,9918,11,5,10,15,30,51,-21,25
Linfield,9919,1,18,8,4,66,29,37,62
Cliftonville,9919,2,15,7,8,53,35,18,52
Coleraine,9919,3,14,10,6,47,36,11,52
Crusaders,9919,4,13,12,5,51,34,17,51
Ballymena,9919,5,11,10,9,54,61,-7,43
Glenavon,9919,6,9,11,10,46,50,-4,38
Dungannon,9919,7,8,13,9,48,43,5,37
Glentoran,9919,8,10,7,13,32,45,-13,37
Ards,9919,9,9,6,15,47,55,-8,33
Ballinamalla,9919,10,5,7,18,26,55,-29,22
Portadown,9919,11,4,7,19,18,45,-27,19
Linfield,9920,1,20,7,3,69,27,42,67
Cliftonville,9920,2,17,4,9,60,38,22,55
Crusaders,9920,3,14,10,6,48,32,16,52
Glenavon,9920,4,13,9,8,51,46,5,48
Dungannon,9920,5,10,12,8,55,42,13,42
Ballymena,9920,6,10,9,11,56,66,-10,39
Coleraine,9920,7,9,11,10,41,47,-6,38
Ards,9920,8,9,6,15,34,49,-15,33
Glentoran,9920,9,7,7,16,29,46,-17,28
Ballinamalla,9920,10,7,7,16,27,50,-23,28
Portadown,9920,11,5,6,19,29,56,-27,21
Crusaders,9921,1,17,7,6,56,32,24,58
Linfield,9921,2,15,7,8,60,34,26,52
Cliftonville,9921,3,15,4,11,52,38,14,49
Ballymena,9921,4,13,5,12,58,69,-11,44
Dungannon,9921,5,11,9,10,57,49,8,42
Ards,9921,6,12,5,13,42,44,-2,41
Coleraine,9921,7,11,8,11,38,41,-3,41
Glenavon,9921,8,9,10,11,43,48,-5,37
Portadown,9921,9,10,7,13,39,49,-10,37
Glentoran,9921,10,8,6,16,38,55,-17,30
Ballinamalla,9921,11,8,4,18,26,50,-24,28
Linfield,9922,1,15,9,6,65,35,30,54
Crusaders,9922,2,13,14,3,54,30,24,53
Ballymena,9922,3,14,9,7,61,53,8,51
Cliftonville,9922,4,14,7,9,53,41,12,49
Dungannon,9922,5,11,9,10,53,48,5,42
Glenavon,9922,6,10,10,10,45,45,0,40
Coleraine,9922,7,10,10,10,39,39,0,40
Ards,9922,8,10,3,17,32,49,-17,33
Glentoran,9922,9,7,10,13,25,44,-19,31
Portadown,9922,10,8,6,16,24,41,-17,30
Ballinamalla,9922,11,7,5,18,33,59,-26,26
Crusaders,9923,1,15,9,6,52,32,20,54
Coleraine,9923,2,13,12,5,47,31,16,51
Linfield,9923,3,14,8,8,60,34,26,50
Glenavon,9923,4,12,10,8,50,44,6,46
Ballymena,9923,5,14,4,12,53,57,-4,46
Cliftonville,9923,6,13,6,11,45,39,6,45
Dungannon,9923,7,9,10,11,45,44,1,37
Glentoran,9923,8,8,11,11,29,41,-12,35
Ards,9923,9,9,5,16,33,49,-16,32
Ballinamalla,9923,10,8,5,17,32,53,-21,29
Portadown,9923,11,7,6,17,23,45,-22,27
Crusaders,9924,1,18,8,4,62,32,30,62
Ballymena,9924,2,15,8,7,58,50,8,53
Cliftonville,9924,3,15,6,9,54,40,14,51
Coleraine,9924,4,11,12,7,44,35,9,45
Linfield,9924,5,11,11,8,49,34,15,44
Glenavon,9924,6,11,11,8,45,45,0,44
Dungannon,9924,7,9,7,14,45,49,-4,34
Ards,9924,8,8,9,13,40,47,-7,33
Glentoran,9924,9,9,6,15,29,46,-17,33
Ballinamalla,9924,10,9,3,18,34,56,-22,30
Portadown,9924,11,6,5,19,21,47,-26,23
Linfield,9925,1,17,7,6,57,26,31,58
Crusaders,9925,2,16,9,5,57,35,22,57
Ballymena,9925,3,14,9,7,54,52,2,51
Cliftonville,9925,4,15,5,10,50,37,13,50
Coleraine,9925,5,12,10,8,40,36,4,46
Glenavon,9925,6,12,10,8,49,50,-1,46
Ards,9925,7,11,6,13,37,43,-6,39
Dungannon,9925,8,9,10,11,55,50,5,37
Glentoran,9925,9,11,4,15,37,44,-7,37
Ballinamalla,9925,10,6,2,22,23,52,-29,20
Portadown,9925,11,4,4,22,18,52,-34,16
Linfield,9926,1,18,9,3,61,22,39,63
Crusaders,9926,2,17,9,4,57,29,28,60
Ballymena,9926,3,15,5,10,58,57,1,50
Cliftonville,9926,4,15,4,11,53,40,13,49
Coleraine,9926,5,11,10,9,41,36,5,43
Glenavon,9926,6,11,9,10,48,51,-3,42
Dungannon,9926,7,10,9,11,51,41,10,39
Glentoran,9926,8,10,8,12,31,42,-11,38
Portadown,9926,9,7,8,15,22,40,-18,29
Ards,9926,10,8,3,19,31,55,-24,27
Ballinamalla,9926,11,3,6,21,25,65,-40,15
Linfield,9927,1,16,9,5,58,29,29,57
Crusaders,9927,2,14,9,7,55,36,19,51
Coleraine,9927,3,12,9,9,42,39,3,45
Ballymena,9927,4,13,6,11,50,54,-4,45
Glenavon,9927,5,11,11,8,51,46,5,44
Cliftonville,9927,6,11,7,12,43,43,0,40
Dungannon,9927,7,10,7,13,48,45,3,37
Ards,9927,8,10,6,14,36,45,-9,36
Portadown,9927,9,10,4,16,29,43,-14,34
Glentoran,9927,10,8,9,13,30,46,-16,33
Ballinamalla,9927,11,9,5,16,32,48,-16,32
Crusaders,9928,1,16,8,6,64,41,23,56
Linfield,9928,2,13,9,8,56,35,21,48
Ballymena,9928,3,14,5,11,67,60,7,47
Cliftonville,9928,4,13,7,10,51,39,12,46
Coleraine,9928,5,10,14,6,45,34,11,44
Dungannon,9928,6,11,7,12,48,43,5,40
Ballinamalla,9928,7,12,4,14,37,47,-10,40
Glenavon,9928,8,9,10,11,41,43,-2,37
Ards,9928,9,11,3,16,34,52,-18,36
Glentoran,9928,10,9,6,15,31,53,-22,33
Portadown,9928,11,8,5,17,24,51,-27,29
Crusaders,9929,1,14,10,6,49,30,19,52
Cliftonville,9929,2,15,6,9,51,36,15,51
Ballymena,9929,3,14,8,8,60,61,-1,50
Linfield,9929,4,14,7,9,58,35,23,49
Glenavon,9929,5,12,9,9,45,40,5,45
Coleraine,9929,6,9,15,6,41,40,1,42
Dungannon,9929,7,10,11,9,43,40,3,41
Glentoran,9929,8,10,7,13,29,42,-13,37
Ards,9929,9,9,6,15,35,45,-10,33
Ballinamalla,9929,10,9,3,18,34,55,-21,30
Portadown,9929,11,5,6,19,25,46,-21,21
Cliftonville,9930,1,17,3,10,57,42,15,54
Linfield,9930,2,14,11,5,60,28,32,53
Crusaders,9930,3,16,5,9,52,43,9,53
Coleraine,9930,4,14,9,7,52,36,16,51
Glenavon,9930,5,13,9,8,45,39,6,48
Ballymena,9930,6,12,6,12,51,57,-6,42
Dungannon,9930,7,9,7,14,46,50,-4,34
Ards,9930,8,9,7,14,38,47,-9,34
Portadown,9930,9,10,4,16,28,48,-20,34
Ballinamalla,9930,10,9,4,17,33,48,-15,31
Glentoran,9930,11,5,9,16,19,43,-24,24
Crusaders,9931,1,18,5,7,51,31,20,59
Ballymena,9931,2,17,6,7,67,53,14,57
Linfield,9931,3,13,12,5,57,30,27,51
Coleraine,9931,4,11,11,8,44,42,2,44
Cliftonville,9931,5,12,7,11,46,39,7,43
Glenavon,9931,6,10,13,7,42,37,5,43
Dungannon,9931,7,11,8,11,45,38,7,41
Glentoran,9931,8,9,6,15,25,48,-23,33
Ards,9931,9,9,5,16,41,57,-16,32
Ballinamalla,9931,10,8,2,20,33,53,-20,26
Portadown,9931,11,6,7,17,28,51,-23,25
Crusaders,9932,1,18,6,6,58,33,25,60
Cliftonville,9932,2,17,6,7,56,33,23,57
Glenavon,9932,3,13,10,7,57,44,13,49
Ballymena,9932,4,13,9,8,60,56,4,48
Linfield,9932,5,12,11,7,55,34,21,47
Coleraine,9932,6,11,12,7,39,35,4,45
Glentoran,9932,7,12,5,13,35,46,-11,41
Dungannon,9932,8,7,10,13,47,55,-8,31
Ballinamalla,9932,9,6,8,16,36,57,-21,26
Portadown,9932,10,6,6,18,24,52,-28,24
Ards,9932,11,5,7,18,32,54,-22,22
Ballymena,9933,1,17,5,8,70,58,12,56
Linfield,9933,2,15,10,5,62,37,25,55
Crusaders,9933,3,14,9,7,52,34,18,51
Cliftonville,9933,4,13,7,10,51,41,10,46
Glenavon,9933,5,10,11,9,42,51,-9,41
Dungannon,9933,6,10,10,10,55,48,7,40
Coleraine,9933,7,8,15,7,37,35,2,39
Ballinamalla,9933,8,12,3,15,33,48,-15,39
Glentoran,9933,9,6,10,14,31,47,-16,28
Portadown,9933,10,7,6,17,33,48,-15,27
Ards,9933,11,6,8,16,33,52,-19,26
Linfield,9934,1,15,9,6,62,30,32,54
Cliftonville,9934,2,17,3,10,52,40,12,54
Crusaders,9934,3,14,9,7,51,37,14,51
Glenavon,9934,4,11,12,7,52,46,6,45
Ballymena,9934,5,13,5,12,59,64,-5,44
Dungannon,9934,6,10,10,10,45,40,5,40
Coleraine,9934,7,9,12,9,33,32,1,39
Ballinamalla,9934,8,10,5,15,31,43,-12,35
Glentoran,9934,9,8,8,14,25,42,-17,32
Portadown,9934,10,8,7,15,26,45,-19,31
Ards,9934,11,7,6,17,36,53,-17,27
Crusaders,9935,1,14,8,8,55,40,15,50
Cliftonville,9935,2,15,4,11,55,46,9,49
Coleraine,9935,3,13,9,8,44,38,6,48
Linfield,9935,4,13,8,9,55,37,18,47
Glenavon,9935,5,12,10,8,46,36,10,46
Ballymena,9935,6,12,5,13,55,65,-10,41
Dungannon,9935,7,10,9,11,47,47,0,39
Glentoran,9935,8,10,8,12,43,46,-3,38
Ards,9935,9,11,5,14,43,50,-7,38
Ballinamalla,9935,10,9,5,16,32,51,-19,32
Portadown,9935,11,7,7,16,23,42,-19,28
Crusaders,9936,1,18,4,8,60,39,21,58
Linfield,9936,2,16,9,5,69,30,39,57
Coleraine,9936,3,14,9,7,50,33,17,51
Glenavon,9936,4,13,8,9,49,49,0,47
Ballymena,9936,5,14,5,11,60,63,-3,47
Dungannon,9936,6,12,6,12,51,45,6,42
Cliftonville,9936,7,13,3,14,49,50,-1,42
Ards,9936,8,11,4,15,40,47,-7,37
Glentoran,9936,9,9,7,14,40,49,-9,34
Ballinamalla,9936,10,8,2,20,26,60,-34,26
Portadown,9936,11,7,3,20,28,57,-29,24
Linfield,9937,1,16,7,7,61,31,30,55
Coleraine,9937,2,13,12,5,51,37,14,51
Glenavon,9937,3,12,13,5,49,41,8,49
Crusaders,9937,4,13,7,10,48,43,5,46
Ballymena,9937,5,12,7,11,56,56,0,43
Cliftonville,9937,6,12,6,12,52,42,10,42
Dungannon,9937,7,11,8,11,55,46,9,41
Ballinamalla,9937,8,10,6,14,28,46,-18,36
Glentoran,9937,9,9,7,14,31,44,-13,34
Ards,9937,10,7,8,15,31,54,-23,29
Portadown,9937,11,6,7,17,22,44,-22,25
Crusaders,9938,1,16,8,6,57,38,19,56
Linfield,9938,2,13,12,5,64,33,31,51
Coleraine,9938,3,13,11,6,45,41,4,50
Glenavon,9938,4,12,12,6,52,45,7,48
Ballymena,9938,5,13,7,10,64,63,1,46
Cliftonville,9938,6,12,7,11,53,46,7,43
Dungannon,9938,7,7,14,9,48,43,5,35
Ards,9938,8,9,5,16,39,51,-12,32
Glentoran,9938,9,7,11,12,34,48,-14,32
Portadown,9938,10,8,7,15,26,43,-17,31
Ballinamalla,9938,11,4,8,18,27,58,-31,20
Coleraine,9939,1,14,10,6,52,35,17,52
Crusaders,9939,2,16,4,10,51,39,12,52
Linfield,9939,3,13,9,8,57,32,25,48
Cliftonville,9939,4,14,5,11,53,44,9,47
Glenavon,9939,5,12,11,7,43,42,1,47
Dungannon,9939,6,11,10,9,53,40,13,43
Ballymena,9939,7,12,5,13,46,56,-10,41
Glentoran,9939,8,9,10,11,31,40,-9,37
Ards,9939,9,10,4,16,35,49,-14,34
Ballinamalla,9939,10,7,6,17,28,50,-22,27
Portadown,9939,10,7,6,17,28,50,-22,27
Cliftonville,9940,1,18,5,7,51,32,19,59
Linfield,9940,2,15,8,7,57,29,28,53
Ballymena,9940,3,16,5,9,64,53,11,53
Coleraine,9940,4,11,12,7,46,42,4,45
Crusaders,9940,5,13,5,12,44,36,8,44
Glenavon,9940,6,12,7,11,42,45,-3,43
Dungannon,9940,7,11,8,11,49,47,2,41
Glentoran,9940,8,10,6,14,32,46,-14,36
Ards,9940,9,9,7,14,38,46,-8,34
Portadown,9940,10,8,3,19,33,48,-15,27
Ballinamalla,9940,11,7,4,19,29,61,-32,25
Ballymena,9941,1,16,5,9,61,53,8,53
Linfield,9941,2,14,10,6,53,26,27,52
Cliftonville,9941,3,15,4,11,52,40,12,49
Glenavon,9941,4,12,9,9,50,52,-2,45
Dungannon,9941,5,11,11,8,50,40,10,44
Coleraine,9941,6,10,11,9,44,33,11,41
Crusaders,9941,7,11,8,11,45,45,0,41
Ballinamalla,9941,8,11,7,12,32,43,-11,40
Glentoran,9941,9,10,9,11,32,37,-5,39
Ards,9941,10,6,7,17,31,53,-22,25
Portadown,9941,11,6,5,19,21,49,-28,23
Linfield,9942,1,17,8,5,68,30,38,59
Crusaders,9942,2,17,6,7,62,34,28,57
Cliftonville,9942,3,17,3,10,54,37,17,54
Glenavon,9942,4,11,12,7,50,48,2,45
Ballymena,9942,5,12,6,12,57,64,-7,42
Coleraine,9942,6,10,10,10,37,45,-8,40
Ards,9942,7,10,6,14,37,51,-14,36
Dungannon,9942,8,8,10,12,47,45,2,34
Glentoran,9942,9,8,9,13,29,42,-13,33
Portadown,9942,10,9,5,16,25,42,-17,32
Ballinamalla,9942,11,6,5,19,23,51,-28,23
Crusaders,9943,1,15,9,6,57,32,25,54
Cliftonville,9943,2,16,4,10,62,46,16,52
Ballymena,9943,3,14,7,9,62,56,6,49
Coleraine,9943,4,11,13,6,43,36,7,46
Linfield,9943,5,11,12,7,51,29,22,45
Dungannon,9943,6,10,10,10,46,47,-1,40
Glenavon,9943,7,10,8,12,43,50,-7,38
Ards,9943,8,9,7,14,40,48,-8,34
Glentoran,9943,9,9,7,14,30,48,-18,34
Portadown,9943,10,8,8,14,34,50,-16,32
Ballinamalla,9943,11,6,7,17,25,51,-26,25
Ballymena,9944,1,16,7,7,66,60,6,55
Cliftonville,9944,2,16,5,9,58,39,19,53
Linfield,9944,3,13,12,5,63,32,31,51
Crusaders,9944,4,15,6,9,50,41,9,51
Glenavon,9944,5,10,14,6,46,41,5,44
Coleraine,9944,6,11,10,9,41,36,5,43
Dungannon,9944,7,9,9,12,48,46,2,36
Portadown,9944,8,10,6,14,30,43,-13,36
Ards,9944,9,10,4,16,40,53,-13,34
Glentoran,9944,10,7,7,16,25,43,-18,28
Ballinamalla,9944,11,6,4,20,34,67,-33,22
Crusaders,9945,1,18,9,3,58,25,33,63
Linfield,9945,2,12,13,5,59,34,25,49
Ballymena,9945,3,12,8,10,53,64,-11,44
Cliftonville,9945,4,12,7,11,52,40,12,43
Coleraine,9945,5,10,12,8,38,35,3,42
Portadown,9945,6,12,5,13,28,38,-10,41
Glenavon,9945,7,8,14,8,38,43,-5,38
Dungannon,9945,8,8,9,13,40,45,-5,33
Glentoran,9945,9,8,8,14,33,47,-14,32
Ballinamalla,9945,10,9,4,17,28,45,-17,31
Ards,9945,11,6,11,13,34,45,-11,29
Crusaders,9946,1,17,6,7,61,42,19,57
Coleraine,9946,2,14,9,7,46,31,15,51
Cliftonville,9946,3,15,4,11,54,45,9,49
Ballymena,9946,4,14,6,10,59,52,7,48
Glenavon,9946,5,13,9,8,55,51,4,48
Linfield,9946,6,12,10,8,48,31,17,46
Glentoran,9946,7,9,9,12,38,49,-11,36
Portadown,9946,8,10,4,16,30,45,-15,34
Dungannon,9946,9,8,9,13,46,50,-4,33
Ballinamalla,9946,10,8,4,18,30,51,-21,28
Ards,9946,11,7,6,17,33,53,-20,27
Linfield,9947,1,16,9,5,62,33,29,57
Cliftonville,9947,2,16,6,8,56,37,19,54
Crusaders,9947,3,13,10,7,50,35,15,49
Ballymena,9947,4,13,8,9,58,59,-1,47
Coleraine,9947,5,11,11,8,41,42,-1,44
Dungannon,9947,6,11,7,12,48,45,3,40
Ards,9947,7,12,4,14,44,44,0,40
Glenavon,9947,8,10,10,10,40,48,-8,40
Portadown,9947,9,10,4,16,30,38,-8,34
Glentoran,9947,10,6,8,16,25,45,-20,26
Ballinamalla,9947,11,7,3,20,26,54,-28,24
Linfield,9948,1,14,9,7,60,34,26,51
Crusaders,9948,2,13,11,6,52,35,17,50
Glenavon,9948,3,12,12,6,50,43,7,48
Coleraine,9948,4,13,8,9,51,40,11,47
Cliftonville,9948,5,14,5,11,51,44,7,47
Ballymena,9948,6,13,6,11,55,55,0,45
Glentoran,9948,7,12,8,10,36,39,-3,44
Dungannon,9948,8,8,9,13,42,50,-8,33
Portadown,9948,9,9,6,15,29,49,-20,33
Ballinamalla,9948,10,7,7,16,34,54,-20,28
Ards,9948,11,7,5,18,44,61,-17,26
Crusaders,9949,1,16,8,6,55,32,23,56
Cliftonville,9949,2,16,5,9,51,37,14,53
Linfield,9949,3,14,7,9,57,35,22,49
Ballymena,9949,4,13,8,9,52,52,0,47
Dungannon,9949,5,11,9,10,51,40,11,42
Glenavon,9949,6,11,9,10,46,53,-7,42
Glentoran,9949,7,11,7,12,32,42,-10,40
Coleraine,9949,8,8,12,10,36,39,-3,36
Ards,9949,9,9,7,14,45,53,-8,34
Ballinamalla,9949,10,9,7,14,37,52,-15,34
Portadown,9949,11,5,5,20,29,56,-27,20
Linfield,9950,1,15,10,5,60,28,32,55
Crusaders,9950,2,13,9,8,48,41,7,48
Cliftonville,9950,3,15,2,13,48,33,15,47
Coleraine,9950,4,12,11,7,42,35,7,47
Dungannon,9950,5,11,11,8,52,38,14,44
Ballymena,9950,6,13,5,12,52,60,-8,44
Glenavon,9950,7,10,13,7,43,39,4,43
Ballinamalla,9950,8,9,7,14,31,46,-15,34
Glentoran,9950,9,9,6,15,23,41,-18,33
Ards,9950,10,9,3,18,37,50,-13,30
Portadown,9950,11,7,7,16,22,47,-25,28
Cliftonville,9951,1,17,5,8,55,35,20,56
Crusaders,9951,2,16,6,8,53,36,17,54
Ballymena,9951,3,15,5,10,57,56,1,50
Linfield,9951,4,13,9,8,59,33,26,48
Glenavon,9951,5,11,9,10,50,51,-1,42
Dungannon,9951,6,11,7,12,56,45,11,40
Coleraine,9951,7,9,11,10,39,44,-5,38
Portadown,9951,8,10,7,13,32,43,-11,37
Ards,9951,9,10,4,16,38,54,-16,34
Glentoran,9951,10,9,5,16,30,47,-17,32
Ballinamalla,9951,11,9,2,19,34,59,-25,29
Crusaders,9952,1,18,6,6,58,34,24,60
Ballymena,9952,2,17,5,8,66,55,11,56
Linfield,9952,3,14,12,4,57,30,27,54
Cliftonville,9952,4,14,7,9,58,42,16,49
Coleraine,9952,5,11,10,9,42,38,4,43
Glentoran,9952,6,11,6,13,33,42,-9,39
Glenavon,9952,7,8,11,11,42,48,-6,35
Dungannon,9952,8,8,10,12,47,46,1,34
Ards,9952,9,8,5,17,31,49,-18,29
Portadown,9952,10,7,8,15,30,50,-20,29
Ballinamalla,9952,11,7,4,19,27,57,-30,25
Crusaders,9953,1,16,10,4,54,29,25,58
Cliftonville,9953,2,15,8,7,55,35,20,53
Linfield,9953,3,13,9,8,57,34,23,48
Coleraine,9953,4,12,11,7,48,36,12,47
Dungannon,9953,5,12,10,8,60,47,13,46
Ballymena,9953,6,12,8,10,58,58,0,44
Ards,9953,7,11,7,12,41,44,-3,40
Glenavon,9953,8,8,14,8,41,50,-9,38
Ballinamalla,9953,9,7,6,17,25,53,-28,27
Portadown,9953,10,7,4,19,28,55,-27,25
Glentoran,9953,11,6,5,19,25,51,-26,23
Glenavon,9954,1,14,9,7,53,44,9,51
Crusaders,9954,2,12,13,5,53,39,14,49
Ballymena,9954,3,14,7,9,51,44,7,49
Cliftonville,9954,4,14,6,10,50,40,10,48
Linfield,9954,5,12,11,7,55,31,24,47
Coleraine,9954,6,11,11,8,43,37,6,44
Dungannon,9954,7,10,9,11,51,49,2,39
Glentoran,9954,8,9,9,12,29,43,-14,36
Ards,9954,9,9,5,16,39,55,-16,32
Ballinamalla,9954,10,7,8,15,31,50,-19,29
Portadown,9954,11,6,6,18,20,43,-23,24
Crusaders,9955,1,16,8,6,55,36,19,56
Linfield,9955,2,16,7,7,59,33,26,55
Cliftonville,9955,3,15,5,10,52,41,11,50
Ballymena,9955,4,14,7,9,59,56,3,49
Glenavon,9955,5,12,11,7,48,46,2,47
Dungannon,9955,6,9,12,9,56,48,8,39
Coleraine,9955,7,9,11,10,42,44,-2,38
Glentoran,9955,8,8,10,12,30,42,-12,34
Ards,9955,9,8,6,16,34,47,-13,30
Ballinamalla,9955,10,9,1,20,28,52,-24,28
Portadown,9955,11,6,8,16,29,47,-18,26
Linfield,9956,1,16,8,6,64,36,28,56
Crusaders,9956,2,17,5,8,50,31,19,56
Cliftonville,9956,3,16,4,10,49,41,8,52
Glenavon,9956,4,14,9,7,54,40,14,51
Ballymena,9956,5,12,5,13,55,67,-12,41
Dungannon,9956,6,11,7,12,47,44,3,40
Glentoran,9956,7,10,9,11,30,40,-10,39
Ards,9956,8,11,5,14,45,47,-2,38
Coleraine,9956,9,10,8,12,41,44,-3,38
Portadown,9956,10,7,5,18,28,48,-20,26
Ballinamalla,9956,11,8,1,21,28,53,-25,25
Linfield,9957,1,15,9,6,66,33,33,54
Crusaders,9957,2,15,6,9,62,39,23,51
Ballymena,9957,3,15,5,10,62,65,-3,50
Coleraine,9957,4,12,9,9,44,37,7,45
Dungannon,9957,5,11,9,10,43,39,4,42
Cliftonville,9957,6,12,5,13,46,44,2,41
Glenavon,9957,7,10,10,10,47,49,-2,40
Ards,9957,8,10,6,14,36,45,-9,36
Glentoran,9957,9,9,8,13,30,42,-12,35
Portadown,9957,10,9,7,14,31,48,-17,34
Ballinamalla,9957,11,8,4,18,27,53,-26,28
Crusaders,9958,1,19,6,5,64,31,33,63
Linfield,9958,2,14,9,7,52,35,17,51
Coleraine,9958,3,13,8,9,48,36,12,47
Ballymena,9958,4,14,5,11,59,65,-6,47
Cliftonville,9958,5,12,7,11,51,47,4,43
Dungannon,9958,6,10,12,8,55,42,13,42
Ards,9958,7,12,6,12,47,41,6,42
Glenavon,9958,8,9,10,11,41,52,-11,37
Glentoran,9958,9,9,7,14,29,41,-12,34
Portadown,9958,10,7,7,16,25,47,-22,28
Ballinamalla,9958,11,4,7,19,22,56,-34,19
Ballymena,9959,1,15,10,5,57,48,9,55
Crusaders,9959,2,15,8,7,51,30,21,53
Linfield,9959,3,13,11,6,54,29,25,50
Glenavon,9959,4,13,8,9,53,47,6,47
Cliftonville,9959,5,14,5,11,44,38,6,47
Coleraine,9959,6,12,10,8,43,34,9,46
Dungannon,9959,7,11,10,9,58,47,11,43
Glentoran,9959,8,10,7,13,25,41,-16,37
Ballinamalla,9959,9,8,3,19,28,51,-23,27
Ards,9959,10,6,7,17,27,48,-21,25
Portadown,9959,11,5,7,18,20,47,-27,22
Crusaders,9960,1,17,6,7,52,32,20,57
Cliftonville,9960,2,15,6,9,58,45,13,51
Linfield,9960,3,13,9,8,58,34,24,48
Dungannon,9960,4,11,10,9,54,39,15,43
Coleraine,9960,5,10,13,7,44,36,8,43
Glenavon,9960,6,10,13,7,44,46,-2,43
Ballymena,9960,7,12,7,11,50,53,-3,43
Glentoran,9960,8,10,7,13,31,44,-13,37
Ards,9960,9,9,5,16,41,51,-10,32
Ballinamalla,9960,10,8,4,18,32,56,-24,28
Portadown,9960,11,7,6,17,27,55,-28,27
Ballymena,9961,1,16,6,8,61,54,7,54
Cliftonville,9961,2,16,4,10,54,42,12,52
Crusaders,9961,3,15,6,9,46,33,13,51
Linfield,9961,4,14,8,8,56,35,21,50
Glenavon,9961,5,11,11,8,45,42,3,44
Coleraine,9961,6,11,9,10,43,41,2,42
Glentoran,9961,7,11,7,12,36,45,-9,40
Dungannon,9961,8,8,13,9,49,44,5,37
Ards,9961,9,9,6,15,38,51,-13,33
Ballinamalla,9961,10,8,4,18,37,53,-16,28
Portadown,9961,11,6,6,18,19,44,-25,24
Crusaders,9962,1,17,6,7,56,39,17,57
Glenavon,9962,2,16,7,7,55,41,14,55
Linfield,9962,3,15,8,7,52,28,24,53
Cliftonville,9962,4,16,4,10,49,36,13,52
Ballymena,9962,5,15,4,11,68,59,9,49
Coleraine,9962,6,12,9,9,49,42,7,45
Dungannon,9962,7,11,8,11,47,45,2,41
Ballinamalla,9962,8,11,3,16,47,55,-8,36
Glentoran,9962,9,5,12,13,26,45,-19,27
Ards,9962,10,6,6,18,32,57,-25,24
Portadown,9962,11,4,7,19,15,49,-34,19
Crusaders,9963,1,18,4,8,50,33,17,58
Ballymena,9963,2,17,4,9,67,56,11,55
Linfield,9963,3,15,9,6,59,29,30,54
Coleraine,9963,4,12,9,9,41,34,7,45
Glenavon,9963,5,11,11,8,44,43,1,44
Cliftonville,9963,6,12,6,12,50,44,6,42
Dungannon,9963,7,9,10,11,44,38,6,37
Glentoran,9963,8,10,6,14,31,45,-14,36
Ards,9963,9,9,6,15,38,52,-14,33
Portadown,9963,10,9,4,17,24,49,-25,31
Ballinamalla,9963,11,6,5,19,30,55,-25,23
Crusaders,9964,1,18,5,7,58,40,18,59
Linfield,9964,2,16,8,6,61,32,29,56
Cliftonville,9964,3,17,3,10,58,42,16,54
Ballymena,9964,4,15,6,9,68,55,13,51
Coleraine,9964,5,12,11,7,49,40,9,47
Glenavon,9964,6,10,12,8,40,40,0,42
Glentoran,9964,7,10,8,12,37,45,-8,38
Dungannon,9964,8,8,11,11,49,49,0,35
Portadown,9964,9,9,4,17,26,46,-20,31
Ballinamalla,9964,10,6,5,19,24,55,-31,23
Ards,9964,11,5,5,20,30,56,-26,20
Cliftonville,9965,1,20,4,6,61,34,27,64
Crusaders,9965,2,17,6,7,57,35,22,57
Linfield,9965,3,13,11,6,64,35,29,50
Glenavon,9965,4,12,12,6,47,38,9,48
Coleraine,9965,5,12,9,9,43,39,4,45
Ballymena,9965,6,12,7,11,49,59,-10,43
Dungannon,9965,7,11,7,12,49,38,11,40
Glentoran,9965,8,7,11,12,24,37,-13,32
Ballinamalla,9965,9,7,5,18,27,51,-24,26
Portadown,9965,10,7,4,19,18,49,-31,25
Ards,9965,11,6,6,18,33,57,-24,24
Crusaders,9966,1,18,9,3,63,32,31,63
Cliftonville,9966,2,16,7,7,67,44,23,55
Linfield,9966,3,14,11,5,62,39,23,53
Ballymena,9966,4,14,5,11,57,57,0,47
Dungannon,9966,5,12,9,9,55,40,15,45
Coleraine,9966,6,10,12,8,48,48,0,42
Glenavon,9966,7,9,12,9,49,51,-2,39
Glentoran,9966,8,9,7,14,32,50,-18,34
Ballinamalla,9966,9,6,7,17,29,48,-19,25
Ards,9966,10,7,4,19,36,57,-21,25
Portadown,9966,11,6,5,19,26,58,-32,23
Crusaders,9967,1,17,8,5,61,34,27,59
Linfield,9967,2,16,10,4,64,32,32,58
Ballymena,9967,3,13,8,9,60,60,0,47
Coleraine,9967,4,11,11,8,42,39,3,44
Glenavon,9967,5,10,12,8,42,39,3,42
Cliftonville,9967,6,12,6,12,50,51,-1,42
Dungannon,9967,7,9,10,11,51,49,2,37
Glentoran,9967,8,9,6,15,35,45,-10,33
Portadown,9967,9,8,9,13,27,40,-13,33
Ards,9967,10,9,4,17,35,52,-17,31
Ballinamalla,9967,11,8,2,20,25,51,-26,26
Crusaders,9968,1,17,8,5,62,35,27,59
Cliftonville,9968,2,15,8,7,54,35,19,53
Linfield,9968,3,13,8,9,57,39,18,47
Coleraine,9968,4,12,11,7,46,42,4,47
Ballymena,9968,5,14,4,12,60,61,-1,46
Glenavon,9968,6,12,9,9,47,41,6,45
Ards,9968,7,9,7,14,40,51,-11,34
Glentoran,9968,8,9,7,14,28,47,-19,34
Dungannon,9968,9,8,9,13,43,46,-3,33
Ballinamalla,9968,10,8,6,16,28,50,-22,30
Portadown,9968,11,7,5,18,30,48,-18,26
Cliftonville,9969,1,15,4,11,52,48,4,49
Ballymena,9969,2,14,6,10,49,51,-2,48
Linfield,9969,3,13,8,9,62,40,22,47
Glentoran,9969,4,13,8,9,52,39,13,47
Crusaders,9969,5,13,8,9,50,43,7,47
Glenavon,9969,6,12,8,10,47,47,0,44
Dungannon,9969,7,10,9,11,47,38,9,39
Coleraine,9969,8,9,11,10,43,44,-1,38
Ards,9969,9,10,7,13,41,53,-12,37
Ballinamalla,9969,10,9,5,16,28,44,-16,32
Portadown,9969,11,7,6,17,26,50,-24,27
Crusaders,9970,1,17,8,5,52,27,25,59
Cliftonville,9970,2,17,4,9,53,35,18,55
Linfield,9970,3,14,11,5,56,30,26,53
Ballymena,9970,4,13,7,10,47,53,-6,46
Glenavon,9970,5,12,8,10,45,41,4,44
Dungannon,9970,6,9,10,11,43,42,1,37
Coleraine,9970,7,8,13,9,37,40,-3,37
Glentoran,9970,8,9,9,12,29,37,-8,36
Ballinamalla,9970,9,11,3,16,43,54,-11,36
Ards,9970,10,8,6,16,34,48,-14,30
Portadown,9970,11,6,3,21,17,49,-32,21
Cliftonville,9971,1,18,4,8,49,36,13,58
Linfield,9971,2,15,10,5,62,31,31,55
Crusaders,9971,3,13,10,7,46,29,17,49
Dungannon,9971,4,13,9,8,60,42,18,48
Glenavon,9971,5,11,11,8,43,39,4,44
Ballymena,9971,6,13,5,12,55,56,-1,44
Coleraine,9971,7,9,10,11,38,44,-6,37
Ards,9971,8,10,3,17,38,45,-7,33
Glentoran,9971,9,8,9,13,32,46,-14,33
Ballinamalla,9971,10,9,6,15,30,50,-20,33
Portadown,9971,11,5,5,20,19,54,-35,20
Linfield,9972,1,16,9,5,62,26,36,57
Crusaders,9972,2,15,9,6,52,28,24,54
Coleraine,9972,3,13,9,8,39,34,5,48
Cliftonville,9972,4,14,5,11,51,40,11,47
Glenavon,9972,5,11,12,7,45,38,7,45
Ballymena,9972,6,12,9,9,52,63,-11,45
Dungannon,9972,7,9,8,13,48,51,-3,35
Glentoran,9972,8,7,11,12,24,37,-13,32
Ards,9972,9,8,6,16,35,53,-18,30
Ballinamalla,9972,10,8,6,16,30,49,-19,30
Portadown,9972,11,7,6,17,23,42,-19,27
Linfield,9973,1,15,11,4,58,28,30,56
Glenavon,9973,2,14,10,6,51,38,13,52
Cliftonville,9973,3,14,9,7,56,37,19,51
Crusaders,9973,4,14,9,7,50,36,14,51
Ballymena,9973,5,13,7,10,62,60,2,46
Coleraine,9973,6,11,10,9,42,45,-3,43
Dungannon,9973,7,11,9,10,51,42,9,42
Glentoran,9973,8,9,7,14,30,50,-20,34
Ards,9973,9,6,8,16,29,48,-19,26
Portadown,9973,10,7,4,19,23,43,-20,25
Ballinamalla,9973,11,6,6,18,31,56,-25,24
Crusaders,9974,1,16,6,8,57,39,18,54
Coleraine,9974,2,13,10,7,42,33,9,49
Ballymena,9974,3,14,7,9,57,52,5,49
Linfield,9974,4,13,7,10,51,40,11,46
Cliftonville,9974,5,14,4,12,50,42,8,46
Glentoran,9974,6,13,6,11,38,41,-3,45
Glenavon,9974,7,11,11,8,50,42,8,44
Portadown,9974,8,12,4,14,34,44,-10,40
Dungannon,9974,9,9,8,13,50,52,-2,35
Ards,9974,10,7,7,16,36,51,-15,28
Ballinamalla,9974,11,6,4,20,24,53,-29,22
Linfield,9975,1,16,10,4,62,31,31,58
Cliftonville,9975,2,17,3,10,52,38,14,54
Crusaders,9975,3,13,9,8,49,40,9,48
Glenavon,9975,4,12,9,9,48,44,4,45
Dungannon,9975,5,11,11,8,51,40,11,44
Coleraine,9975,6,9,12,9,35,38,-3,39
Ballymena,9975,7,10,8,12,54,61,-7,38
Portadown,9975,8,10,4,16,27,45,-18,34
Ards,9975,9,8,8,14,37,48,-11,32
Glentoran,9975,10,8,8,14,32,46,-14,32
Ballinamalla,9975,11,8,4,18,28,44,-16,28
Crusaders,9976,1,16,7,7,53,31,22,55
Ballymena,9976,2,16,7,7,60,53,7,55
Cliftonville,9976,3,16,5,9,56,38,18,53
Glenavon,9976,4,13,8,9,42,42,0,47
Linfield,9976,5,12,9,9,52,38,14,45
Coleraine,9976,6,11,11,8,50,37,13,44
Glentoran,9976,7,11,7,12,35,43,-8,40
Ballinamalla,9976,8,10,3,17,32,50,-18,33
Dungannon,9976,9,6,11,13,39,48,-9,29
Ards,9976,10,8,5,17,37,52,-15,29
Portadown,9976,11,8,3,19,23,47,-24,27
Crusaders,9977,1,15,6,9,50,37,13,51
Coleraine,9977,2,14,8,8,41,32,9,50
Cliftonville,9977,3,15,3,12,61,50,11,48
Ballymena,9977,4,14,6,10,57,57,0,48
Linfield,9977,5,12,10,8,58,36,22,46
Glenavon,9977,6,11,11,8,42,40,2,44
Dungannon,9977,7,11,9,10,56,51,5,42
Ards,9977,8,11,4,15,38,43,-5,37
Glentoran,9977,9,9,8,13,33,46,-13,35
Ballinamalla,9977,10,9,6,15,35,50,-15,33
Portadown,9977,11,6,5,19,26,55,-29,23
Crusaders,9978,1,16,9,5,61,35,26,57
Linfield,9978,2,15,8,7,54,29,25,53
Glenavon,9978,3,13,11,6,48,39,9,50
Cliftonville,9978,4,14,6,10,49,34,15,48
Ballymena,9978,5,13,9,8,50,52,-2,48
Coleraine,9978,6,12,10,8,42,39,3,46
Dungannon,9978,7,12,9,9,57,47,10,45
Glentoran,9978,8,8,8,14,28,40,-12,32
Ballinamalla,9978,9,7,6,17,26,53,-27,27
Portadown,9978,10,6,6,18,22,47,-25,24
Ards,9978,11,6,4,20,32,54,-22,22
Crusaders,9979,1,15,8,7,57,39,18,53
Linfield,9979,2,14,10,6,66,36,30,52
Cliftonville,9979,3,14,6,10,56,45,11,48
Coleraine,9979,4,11,10,9,41,38,3,43
Glenavon,9979,5,10,13,7,45,43,2,43
Dungannon,9979,6,11,8,11,57,51,6,41
Ards,9979,7,12,5,13,48,53,-5,41
Ballymena,9979,8,11,6,13,59,67,-8,39
Glentoran,9979,9,9,8,13,31,44,-13,35
Portadown,9979,10,8,6,16,23,47,-24,30
Ballinamalla,9979,11,8,4,18,36,56,-20,28
Crusaders,9980,1,19,8,3,70,32,38,65
Linfield,9980,2,15,9,6,61,35,26,54
Cliftonville,9980,3,16,3,11,48,39,9,51
Glenavon,9980,4,12,12,6,49,40,9,48
Ballymena,9980,5,12,7,11,52,59,-7,43
Dungannon,9980,6,11,9,10,55,44,11,42
Coleraine,9980,7,9,11,10,41,44,-3,38
Ards,9980,8,10,6,14,46,51,-5,36
Glentoran,9980,9,6,9,15,26,50,-24,27
Ballinamalla,9980,10,7,5,18,29,58,-29,26
Portadown,9980,11,5,7,18,27,52,-25,22
Linfield,9981,1,15,9,6,57,28,29,54
Ballymena,9981,2,16,6,8,61,53,8,54
Crusaders,9981,3,14,8,8,54,39,15,50
Glenavon,9981,4,13,10,7,50,44,6,49
Cliftonville,9981,5,13,6,11,50,43,7,45
Coleraine,9981,6,10,11,9,41,39,2,41
Dungannon,9981,7,10,10,10,48,45,3,40
Portadown,9981,8,11,4,15,36,45,-9,37
Glentoran,9981,9,10,5,15,28,43,-15,35
Ards,9981,10,8,6,16,35,48,-13,30
Ballinamalla,9981,11,5,5,20,24,57,-33,20
Crusaders,9982,1,15,7,8,56,31,25,52
Glenavon,9982,2,13,11,6,47,37,10,50
Coleraine,9982,3,12,12,6,49,43,6,48
Linfield,9982,4,12,11,7,57,38,19,47
Ballymena,9982,5,12,11,7,58,53,5,47
Cliftonville,9982,6,12,9,9,49,38,11,45
Dungannon,9982,7,10,11,9,48,42,6,41
Ards,9982,8,11,6,13,35,42,-7,39
Glentoran,9982,9,8,7,15,29,47,-18,31
Portadown,9982,10,6,6,18,22,49,-27,24
Ballinamalla,9982,11,6,5,19,33,63,-30,23
Cliftonville,9983,1,17,5,8,59,35,24,56
Crusaders,9983,2,17,5,8,55,33,22,56
Ballymena,9983,3,15,9,6,60,51,9,54
Linfield,9983,4,15,8,7,62,33,29,53
Coleraine,9983,5,12,9,9,39,41,-2,45
Dungannon,9983,6,11,9,10,49,38,11,42
Glenavon,9983,7,10,12,8,46,43,3,42
Ballinamalla,9983,8,9,4,17,29,49,-20,31
Glentoran,9983,9,7,9,14,25,42,-17,30
Ards,9983,10,7,5,18,34,58,-24,26
Portadown,9983,11,6,3,21,20,55,-35,21
Cliftonville,9984,1,18,2,10,54,37,17,56
Crusaders,9984,2,15,9,6,49,32,17,54
Coleraine,9984,3,14,9,7,43,32,11,51
Ballymena,9984,4,14,6,10,61,58,3,48
Linfield,9984,5,13,8,9,55,36,19,47
Dungannon,9984,6,9,10,11,48,44,4,37
Glenavon,9984,7,8,13,9,43,44,-1,37
Glentoran,9984,8,9,10,11,31,41,-10,37
Ards,9984,9,9,5,16,46,56,-10,32
Portadown,9984,10,7,8,15,29,52,-23,29
Ballinamalla,9984,11,5,8,17,29,56,-27,23
Crusaders,9985,1,18,9,3,64,39,25,63
Ballymena,9985,2,17,5,8,74,52,22,56
Linfield,9985,3,14,11,5,64,34,30,53
Cliftonville,9985,4,15,5,10,50,36,14,50
Coleraine,9985,5,10,9,11,40,47,-7,39
Dungannon,9985,6,8,12,10,47,44,3,36
Glenavon,9985,7,8,11,11,44,51,-7,35
Portadown,9985,8,9,6,15,31,52,-21,33
Glentoran,9985,9,7,11,12,32,42,-10,32
Ards,9985,10,7,8,15,36,53,-17,29
Ballinamalla,9985,11,6,5,19,29,61,-32,23
Crusaders,9986,1,18,7,5,56,29,27,61
Linfield,9986,2,15,8,7,61,34,27,53
Cliftonville,9986,3,15,5,10,50,35,15,50
Dungannon,9986,4,13,7,10,51,44,7,46
Ballymena,9986,5,12,8,10,65,61,4,44
Coleraine,9986,6,11,10,9,37,39,-2,43
Glentoran,9986,7,11,9,10,32,37,-5,42
Glenavon,9986,8,9,9,12,38,45,-7,36
Ards,9986,9,10,5,15,39,45,-6,35
Ballinamalla,9986,10,5,8,17,25,49,-24,23
Portadown,9986,11,5,6,19,22,58,-36,21
Cliftonville,9987,1,20,2,8,60,34,26,62
Linfield,9987,2,15,8,7,61,31,30,53
Dungannon,9987,3,15,7,8,56,37,19,52
Crusaders,9987,4,13,7,10,51,45,6,46
Ballymena,9987,5,13,4,13,55,56,-1,43
Glenavon,9987,6,10,12,8,44,43,1,42
Coleraine,9987,7,11,8,11,44,43,1,41
Glentoran,9987,8,9,9,12,36,46,-10,36
Ards,9987,9,8,6,16,36,56,-20,30
Ballinamalla,9987,10,7,7,16,31,52,-21,28
Portadown,9987,11,7,4,19,23,54,-31,25
Crusaders,9988,1,18,7,5,61,34,27,61
Linfield,9988,2,16,8,6,66,28,38,56
Coleraine,9988,3,15,9,6,49,36,13,54
Cliftonville,9988,4,14,7,9,49,39,10,49
Dungannon,9988,5,13,9,8,54,35,19,48
Ballymena,9988,6,12,6,12,52,55,-3,42
Glenavon,9988,7,9,11,10,42,49,-7,38
Ards,9988,8,10,4,16,38,49,-11,34
Glentoran,9988,9,6,9,15,27,47,-20,27
Ballinamalla,9988,10,8,3,19,27,52,-25,27
Portadown,9988,11,6,3,21,21,62,-41,21
Crusaders,9989,1,17,6,7,52,29,23,57
Linfield,9989,2,13,9,8,59,38,21,48
Cliftonville,9989,3,14,6,10,47,42,5,48
Dungannon,9989,4,12,8,10,47,37,10,44
Glenavon,9989,5,11,10,9,49,43,6,43
Ballymena,9989,6,11,9,10,60,64,-4,42
Coleraine,9989,7,10,10,10,39,40,-1,40
Glentoran,9989,8,11,6,13,36,45,-9,39
Ards,9989,9,10,3,17,37,52,-15,33
Portadown,9989,10,9,5,16,29,45,-16,32
Ballinamalla,9989,11,10,2,18,35,55,-20,32
Cliftonville,9990,1,15,3,12,55,40,15,48
Ballymena,9990,2,14,6,10,59,56,3,48
Glenavon,9990,3,11,14,5,58,44,14,47
Crusaders,9990,4,11,12,7,50,41,9,45
Linfield,9990,5,12,7,11,52,37,15,43
Dungannon,9990,6,11,9,10,50,47,3,42
Ards,9990,7,12,5,13,45,44,1,41
Glentoran,9990,8,10,9,11,30,42,-12,39
Coleraine,9990,9,9,11,10,40,47,-7,38
Ballinamalla,9990,10,8,7,15,32,51,-19,31
Portadown,9990,11,7,7,16,21,43,-22,28
Crusaders,9991,1,17,7,6,55,31,24,58
Ballymena,9991,2,17,3,10,61,53,8,54
Linfield,9991,3,14,9,7,53,30,23,51
Coleraine,9991,4,13,8,9,40,37,3,47
Glenavon,9991,5,11,11,8,54,51,3,44
Cliftonville,9991,6,12,7,11,49,41,8,43
Glentoran,9991,7,12,6,12,33,40,-7,42
Dungannon,9991,8,10,10,10,54,51,3,40
Ards,9991,9,9,4,17,37,48,-11,31
Portadown,9991,10,7,5,18,25,52,-27,26
Ballinamalla,9991,11,7,2,21,32,59,-27,23
Linfield,9992,1,15,9,6,58,31,27,54
Crusaders,9992,2,15,6,9,50,33,17,51
Glenavon,9992,3,13,11,6,45,40,5,50
Cliftonville,9992,4,14,6,10,51,38,13,48
Ballymena,9992,5,13,6,11,57,54,3,45
Dungannon,9992,6,10,9,11,49,45,4,39
Coleraine,9992,7,9,11,10,38,40,-2,38
Ballinamalla,9992,8,11,5,14,37,47,-10,38
Portadown,9992,9,10,4,16,25,44,-19,34
Ards,9992,10,9,6,15,41,54,-13,33
Glentoran,9992,11,6,7,17,28,53,-25,25
Crusaders,9993,1,18,6,6,60,27,33,60
Cliftonville,9993,2,17,7,6,47,27,20,58
Linfield,9993,3,16,7,7,61,31,30,55
Glenavon,9993,4,11,12,7,47,40,7,45
Ards,9993,5,13,5,12,43,45,-2,44
Coleraine,9993,6,7,15,8,34,37,-3,36
Ballymena,9993,7,9,8,13,46,65,-19,35
Dungannon,9993,8,8,10,12,46,48,-2,34
Ballinamalla,9993,9,8,6,16,34,54,-20,30
Glentoran,9993,10,5,11,14,27,49,-22,26
Portadown,9993,10,7,5,18,27,49,-22,26
Crusaders,9994,1,15,11,4,55,38,17,56
Linfield,9994,2,16,7,7,60,33,27,55
Cliftonville,9994,3,15,5,10,51,39,12,50
Ballymena,9994,4,13,10,7,55,50,5,49
Coleraine,9994,5,12,11,7,44,36,8,47
Dungannon,9994,6,11,9,10,53,46,7,42
Glenavon,9994,7,11,9,10,50,51,-1,42
Ards,9994,8,8,7,15,36,51,-15,31
Ballinamalla,9994,9,8,5,17,31,50,-19,29
Glentoran,9994,10,6,8,16,27,47,-20,26
Portadown,9994,11,7,4,19,29,50,-21,25
Coleraine,9995,1,17,7,6,47,36,11,58
Cliftonville,9995,2,18,3,9,60,37,23,57
Crusaders,9995,3,16,8,6,54,35,19,56
Linfield,9995,4,14,7,9,52,33,19,49
Glenavon,9995,5,12,10,8,52,48,4,46
Ballymena,9995,6,14,3,13,58,66,-8,45
Dungannon,9995,7,11,8,11,50,40,10,41
Ards,9995,8,10,4,16,41,49,-8,34
Ballinamalla,9995,9,10,3,17,40,56,-16,33
Glentoran,9995,10,5,7,18,24,50,-26,22
Portadown,9995,11,6,4,20,25,53,-28,22
Crusaders,9996,1,17,6,7,57,34,23,57
Linfield,9996,2,16,8,6,56,29,27,56
Cliftonville,9996,3,13,6,11,48,42,6,45
Coleraine,9996,4,10,14,6,38,31,7,44
Glenavon,9996,5,11,11,8,47,41,6,44
Ballymena,9996,6,12,6,12,45,56,-11,42
Ballinamalla,9996,7,12,4,14,34,43,-9,40
Glentoran,9996,8,10,5,15,30,45,-15,35
Dungannon,9996,9,8,9,13,41,44,-3,33
Ards,9996,10,9,4,17,37,51,-14,31
Portadown,9996,11,8,5,17,26,43,-17,29
Crusaders,9997,1,16,10,4,53,32,21,58
Cliftonville,9997,2,17,6,7,55,36,19,57
Linfield,9997,3,13,10,7,60,38,22,49
Dungannon,9997,4,12,9,9,54,37,17,45
Ballymena,9997,5,13,4,13,56,58,-2,43
Glenavon,9997,6,10,11,9,43,47,-4,41
Coleraine,9997,7,10,10,10,43,43,0,40
Glentoran,9997,8,9,10,11,36,40,-4,37
Ards,9997,9,9,7,14,36,50,-14,34
Portadown,9997,10,6,6,18,22,47,-25,24
Ballinamalla,9997,11,7,3,20,27,57,-30,24
Crusaders,9998,1,16,7,7,64,45,19,55
Cliftonville,9998,2,16,5,9,58,34,24,53
Linfield,9998,3,13,10,7,63,36,27,49
Glenavon,9998,4,12,11,7,51,44,7,47
Ballymena,9998,5,13,8,9,63,66,-3,47
Coleraine,9998,6,10,10,10,36,39,-3,40
Dungannon,9998,7,9,11,10,49,43,6,38
Glentoran,9998,8,9,10,11,36,47,-11,37
Portadown,9998,9,7,7,16,23,47,-24,28
Ards,9998,10,6,9,15,32,50,-18,27
Ballinamalla,9998,11,7,6,17,31,55,-24,27
Linfield,9999,1,18,6,6,70,33,37,60
Crusaders,9999,2,17,8,5,56,35,21,59
Cliftonville,9999,3,17,6,7,61,36,25,57
Glenavon,9999,4,11,13,6,51,45,6,46
Glentoran,9999,5,11,8,11,31,38,-7,41
Ballymena,9999,6,10,9,11,53,66,-13,39
Dungannon,9999,7,8,10,12,48,51,-3,34
Coleraine,9999,8,7,13,10,43,46,-3,34
Ards,9999,9,9,6,15,33,47,-14,33
Ballinamalla,9999,10,6,6,18,26,50,-24,24
Portadown,9999,11,5,7,18,22,47,-25,22
