team,n,rank,w,d,l,gf,ga,gd,pts
Alloa,0,1,18,10,8,67,39,28,64
Livingston,0,2,19,3,14,71,52,19,60
Brechin,0,3,18,5,13,50,48,2,59
Airdrieon,0,4,17,7,12,57,50,7,58
Albion,0,5,15,10,11,59,44,15,55
East Fife,0,6,14,10,12,57,40,17,52
Peterhead,0,7,12,10,14,39,47,-8,46
Stranraer,0,8,14,4,18,44,59,-15,46
Queen's Park,0,9,10,5,21,33,58,-25,35
Stenhousem'r,0,10,7,8,21,39,79,-40,29
Alloa,1,1,19,10,7,66,41,25,67
Livingston,1,2,19,4,13,71,53,18,61
Airdrieon,1,3,16,10,10,55,51,4,58
Brechin,1,4,17,5,14,44,42,2,56
Peterhead,1,5,14,10,12,39,37,2,52
Albion,1,6,13,10,13,55,49,6,49
Queen's Park,1,7,13,9,14,42,47,-5,48
Stranraer,1,8,14,6,16,52,58,-6,48
East Fife,1,9,10,9,17,44,47,-3,39
Stenhousem'r,1,10,3,11,22,37,80,-43,20
Livingston,2,1,23,3,10,79,46,33,72
Alloa,2,2,18,8,10,73,41,32,62
Peterhead,2,3,18,5,13,56,50,6,59
Airdrieon,2,4,15,11,10,58,53,5,56
Queen's Park,2,5,17,4,15,52,61,-9,55
Brechin,2,6,14,8,14,51,53,-2,50
Albion,2,7,12,9,15,56,59,-3,45
Stranraer,2,8,11,6,19,47,67,-20,39
East Fife,2,9,9,9,18,58,57,1,36
Stenhousem'r,2,10,7,9,20,40,83,-43,30
Airdrieon,3,1,19,8,9,65,51,14,65
Brechin,3,2,21,2,13,56,42,14,65
Livingston,3,3,18,4,14,70,60,10,58
Alloa,3,4,15,10,11,69,50,19,55
East Fife,3,5,14,7,15,55,49,6,49
Peterhead,3,6,14,7,15,50,53,-3,49
Queen's Park,3,7,14,4,18,38,51,-13,46
Albion,3,8,14,3,19,58,63,-5,45
Stranraer,3,9,12,7,17,45,60,-15,43
Stenhousem'r,3,10,10,6,20,51,78,-27,36
Livingston,4,1,22,5,9,83,50,33,71
Alloa,4,2,20,7,9,83,53,30,67
Airdrieon,4,3,18,8,10,60,47,13,62
Brechin,4,4,19,5,12,46,41,5,62
Albion,4,5,15,9,12,55,54,1,54
Peterhead,4,6,11,12,13,44,55,-11,45
East Fife,4,7,11,10,15,45,45,0,43
Stranraer,4,8,13,4,19,55,63,-8,43
Queen's Park,4,9,9,6,21,35,64,-29,33
Stenhousem'r,4,10,5,8,23,43,77,-34,23
Livingston,5,1,22,6,8,80,46,34,72
Alloa,5,2,19,6,11,71,46,25,63
Brechin,5,3,19,4,13,62,45,17,61
Airdrieon,5,4,15,10,11,60,56,4,55
Albion,5,5,11,14,11,51,48,3,47
Queen's Park,5,6,13,6,17,39,62,-23,45
Peterhead,5,7,12,8,16,36,52,-16,44
East Fife,5,8,8,13,15,48,49,-1,37
Stranraer,5,9,10,7,19,40,62,-22,37
Stenhousem'r,5,10,8,12,16,48,69,-21,36
Brechin,6,1,18,7,11,61,42,19,61
Livingston,6,2,18,5,13,81,62,19,59
Albion,6,3,17,8,11,54,42,12,59
Alloa,6,4,16,10,10,72,47,25,58
Airdrieon,6,5,16,6,14,56,57,-1,54
Peterhead,6,6,15,5,16,46,59,-13,50
Queen's Park,6,7,14,7,15,39,47,-8,49
Stranraer,6,8,14,5,17,58,65,-7,47
East Fife,6,9,11,7,18,47,56,-9,40
Stenhousem'r,6,10,8,6,22,52,89,-37,30
Livingston,7,1,23,5,8,78,43,35,74
Brechin,7,2,18,4,14,53,58,-5,58
East Fife,7,3,15,9,12,58,43,15,54
Alloa,7,4,16,6,14,61,48,13,54
Airdrieon,7,5,15,7,14,61,58,3,52
Peterhead,7,6,13,10,13,50,53,-3,49
Albion,7,7,12,11,13,56,57,-1,47
Queen's Park,7,8,13,7,16,37,48,-11,46
Stranraer,7,9,10,7,19,44,61,-17,37
Stenhousem'r,7,10,7,10,19,40,69,-29,31
Alloa,8,1,18,8,10,72,44,28,62
Livingston,8,2,18,7,11,68,47,21,61
Brechin,8,3,17,6,13,56,53,3,57
Albion,8,4,15,10,11,62,48,14,55
Peterhead,8,5,13,9,14,56,56,0,48
Queen's Park,8,6,13,8,15,42,52,-10,47
East Fife,8,7,12,10,14,46,49,-3,46
Airdrieon,8,8,12,10,14,52,60,-8,46
Stenhousem'r,8,9,9,13,14,52,72,-20,40
Stranraer,8,10,10,5,21,41,66,-25,35
Livingston,9,1,23,5,8,88,42,46,74
Alloa,9,2,18,9,9,71,45,26,63
Brechin,9,3,19,6,11,61,44,17,63
Airdrieon,9,4,14,10,12,56,54,2,52
Albion,9,5,11,13,12,57,57,0,46
Queen's Park,9,6,11,10,15,38,48,-10,43
Stranraer,9,7,11,7,18,52,72,-20,40
Stenhousem'r,9,8,11,7,18,46,77,-31,40
East Fife,9,9,9,12,15,41,48,-7,39
Peterhead,9,10,11,5,20,40,63,-23,38
Livingston,10,1,22,5,9,77,43,34,71
Alloa,10,2,21,8,7,76,42,34,71
Albion,10,3,17,9,10,67,49,18,60
Brechin,10,4,16,5,15,47,51,-4,53
Airdrieon,10,5,13,7,16,44,65,-21,46
Peterhead,10,6,9,15,12,43,48,-5,42
Queen's Park,10,7,11,9,16,32,50,-18,42
East Fife,10,8,9,12,15,59,58,1,39
Stenhousem'r,10,9,10,8,18,51,80,-29,38
Stranraer,10,10,11,4,21,51,61,-10,37
Alloa,11,1,20,9,7,75,43,32,69
Livingston,11,2,19,8,9,70,43,27,65
Airdrieon,11,3,17,9,10,59,54,5,60
East Fife,11,4,15,12,9,58,38,20,57
Brechin,11,5,14,11,11,53,49,4,53
Queen's Park,11,6,12,9,15,36,53,-17,45
Peterhead,11,7,10,11,15,47,54,-7,41
Albion,11,8,9,11,16,46,56,-10,38
Stranraer,11,9,9,8,19,44,59,-15,35
Stenhousem'r,11,10,7,8,21,39,78,-39,29
Alloa,12,1,24,5,7,81,35,46,77
Livingston,12,2,21,3,12,76,56,20,66
Brechin,12,3,18,5,13,50,45,5,59
Airdrieon,12,4,17,6,13,54,51,3,57
Queen's Park,12,5,14,10,12,39,45,-6,52
Albion,12,6,13,8,15,55,54,1,47
East Fife,12,7,12,9,15,53,52,1,45
Peterhead,12,8,11,10,15,47,59,-12,43
Stranraer,12,9,12,5,19,42,54,-12,41
Stenhousem'r,12,10,4,7,25,46,92,-46,19
Livingston,13,1,21,4,11,82,48,34,67
Alloa,13,2,16,11,9,68,43,25,59
Albion,13,3,16,10,10,63,51,12,58
Brechin,13,4,16,8,12,56,46,10,56
Peterhead,13,5,16,7,13,55,50,5,55
Stranraer,13,6,15,7,14,53,56,-3,52
Airdrieon,13,7,14,8,14,55,63,-8,50
East Fife,13,8,8,11,17,43,51,-8,35
Queen's Park,13,9,8,10,18,36,65,-29,34
Stenhousem'r,13,10,9,6,21,44,82,-38,33
Livingston,14,1,22,3,11,67,47,20,69
Alloa,14,2,19,7,10,72,44,28,64
Brechin,14,3,17,6,13,49,45,4,57
Airdrieon,14,4,17,5,14,56,53,3,56
Peterhead,14,5,16,7,13,55,50,5,55
Albion,14,6,14,8,14,57,54,3,50
Queen's Park,14,7,15,5,16,46,48,-2,50
Stranraer,14,8,10,8,18,43,60,-17,38
Stenhousem'r,14,9,10,8,18,52,82,-30,38
East Fife,14,10,5,13,18,40,54,-14,28
Livingston,15,1,22,6,8,86,46,40,72
Alloa,15,2,18,12,6,77,45,32,66
Stranraer,15,3,16,6,14,59,53,6,54
Airdrieon,15,4,15,7,14,51,55,-4,52
Brechin,15,5,14,9,13,43,45,-2,51
East Fife,15,6,11,13,12,52,53,-1,46
Peterhead,15,7,12,10,14,51,56,-5,46
Albion,15,8,13,7,16,46,52,-6,46
Queen's Park,15,9,11,8,17,36,56,-20,41
Stenhousem'r,15,10,3,12,21,46,86,-40,21
Alloa,16,1,20,9,7,79,45,34,69
Livingston,16,2,18,8,10,73,47,26,62
Airdrieon,16,3,17,7,12,71,56,15,58
Peterhead,16,4,17,7,12,48,41,7,58
Queen's Park,16,5,15,4,17,43,53,-10,49
Brechin,16,6,14,6,16,47,54,-7,48
Albion,16,7,12,11,13,52,52,0,47
Stranraer,16,8,13,4,19,43,61,-18,43
East Fife,16,9,9,11,16,45,49,-4,38
Stenhousem'r,16,10,8,7,21,51,94,-43,31
Alloa,17,1,22,4,10,81,48,33,70
Peterhead,17,2,17,7,12,58,53,5,58
Livingston,17,3,17,4,15,78,62,16,55
Brechin,17,4,17,4,15,58,55,3,55
Airdrieon,17,5,15,7,14,58,55,3,52
East Fife,17,6,15,6,15,53,49,4,51
Queen's Park,17,7,15,6,15,44,51,-7,51
Albion,17,8,12,6,18,49,61,-12,42
Stranraer,17,9,12,5,19,49,68,-19,41
Stenhousem'r,17,10,9,9,18,48,74,-26,36
Alloa,18,1,21,3,12,80,49,31,66
Livingston,18,2,19,7,10,74,51,23,64
Brechin,18,3,18,7,11,57,52,5,61
Peterhead,18,4,18,5,13,49,43,6,59
Airdrieon,18,5,15,7,14,59,50,9,52
Queen's Park,18,6,14,4,18,42,56,-14,46
Albion,18,7,12,9,15,52,60,-8,45
Stranraer,18,8,14,3,19,46,66,-20,45
East Fife,18,9,11,6,19,49,55,-6,39
Stenhousem'r,18,10,7,11,18,45,71,-26,32
Alloa,19,1,20,9,7,70,39,31,69
Airdrieon,19,2,19,9,8,65,43,22,66
Livingston,19,3,19,6,11,68,50,18,63
Albion,19,4,16,8,12,56,51,5,56
Brechin,19,5,14,8,14,41,40,1,50
Peterhead,19,6,13,8,15,48,55,-7,47
Queen's Park,19,7,11,12,13,35,47,-12,45
East Fife,19,8,11,9,16,49,44,5,42
Stranraer,19,9,10,6,20,39,59,-20,36
Stenhousem'r,19,10,5,9,22,42,85,-43,24
Livingston,20,1,21,3,12,82,49,33,66
Airdrieon,20,2,20,6,10,68,56,12,66
Alloa,20,3,16,8,12,57,47,10,56
Albion,20,4,15,11,10,60,52,8,56
Brechin,20,5,17,4,15,52,43,9,55
East Fife,20,6,16,6,14,54,47,7,54
Peterhead,20,7,15,5,16,45,51,-6,50
Stranraer,20,8,11,8,17,57,57,0,41
Queen's Park,20,9,9,9,18,37,67,-30,36
Stenhousem'r,20,10,6,8,22,47,90,-43,26
Alloa,21,1,20,7,9,73,49,24,67
Livingston,21,2,21,3,12,65,43,22,66
Airdrieon,21,3,16,7,13,54,60,-6,55
East Fife,21,4,15,8,13,51,42,9,53
Brechin,21,5,15,6,15,60,50,10,51
Peterhead,21,6,15,6,15,48,50,-2,51
Stranraer,21,7,15,5,16,58,55,3,50
Albion,21,8,12,8,16,50,56,-6,44
Queen's Park,21,9,10,8,18,38,61,-23,38
Stenhousem'r,21,10,9,6,21,42,73,-31,33
Livingston,22,1,22,3,11,72,47,25,69
Alloa,22,2,21,4,11,70,48,22,67
Airdrieon,22,3,17,9,10,62,50,12,60
Albion,22,4,17,7,12,55,44,11,58
Brechin,22,5,16,4,16,48,50,-2,52
Peterhead,22,6,15,6,15,53,52,1,51
Queen's Park,22,7,14,5,17,38,49,-11,47
East Fife,22,8,11,9,16,50,49,1,42
Stranraer,22,9,11,7,18,54,62,-8,40
Stenhousem'r,22,10,7,4,25,38,89,-51,25
Livingston,23,1,23,3,10,80,48,32,72
Brechin,23,2,18,9,9,49,46,3,63
Alloa,23,3,18,7,11,72,46,26,61
Airdrieon,23,4,17,6,13,61,49,12,57
Albion,23,5,14,10,12,57,50,7,52
Queen's Park,23,6,13,8,15,41,51,-10,47
Peterhead,23,7,12,5,19,48,62,-14,41
East Fife,23,8,10,9,17,48,55,-7,39
Stranraer,23,9,10,6,20,41,61,-20,36
Stenhousem'r,23,10,9,9,18,46,75,-29,36
Airdrieon,24,1,20,8,8,57,40,17,68
Alloa,24,2,18,10,8,77,47,30,64
Brechin,24,3,17,8,11,52,46,6,59
Livingston,24,4,17,5,14,68,54,14,56
Albion,24,5,14,10,12,52,48,4,52
East Fife,24,6,14,9,13,54,50,4,51
Queen's Park,24,7,13,4,19,36,50,-14,43
Stenhousem'r,24,8,10,7,19,52,76,-24,37
Peterhead,24,9,9,9,18,39,58,-19,36
Stranraer,24,10,9,8,19,39,57,-18,35
Livingston,25,1,21,3,12,72,50,22,66
Alloa,25,2,19,3,14,70,46,24,60
Brechin,25,3,19,2,15,59,52,7,59
Peterhead,25,4,17,5,14,50,51,-1,56
Stranraer,25,5,16,5,15,53,54,-1,53
Albion,25,6,15,6,15,52,53,-1,51
Airdrieon,25,7,13,7,16,57,63,-6,46
East Fife,25,8,11,11,14,52,50,2,44
Queen's Park,25,9,11,9,16,35,54,-19,42
Stenhousem'r,25,10,10,5,21,42,69,-27,35
Alloa,26,1,23,5,8,74,40,34,74
Livingston,26,2,19,6,11,66,50,16,63
Brechin,26,3,17,10,9,55,39,16,61
Airdrieon,26,4,18,6,12,58,55,3,60
Peterhead,26,5,14,7,15,57,54,3,49
Albion,26,6,13,9,14,53,49,4,48
East Fife,26,7,12,9,15,51,43,8,45
Queen's Park,26,8,10,7,19,31,52,-21,37
Stranraer,26,9,10,6,20,40,63,-23,36
Stenhousem'r,26,10,7,9,20,43,83,-40,30
Alloa,27,1,24,5,7,89,35,54,77
Airdrieon,27,2,19,7,10,70,53,17,64
Brechin,27,3,16,6,14,47,51,-4,54
Livingston,27,4,17,2,17,70,60,10,53
Albion,27,5,15,7,14,57,51,6,52
Peterhead,27,6,14,8,14,53,55,-2,50
East Fife,27,7,13,9,14,52,51,1,48
Stranraer,27,8,13,4,19,48,60,-12,43
Queen's Park,27,9,10,10,16,30,54,-24,40
Stenhousem'r,27,10,5,10,21,42,88,-46,25
Livingston,28,1,22,3,11,81,48,33,69
Alloa,28,2,18,5,13,67,51,16,59
Airdrieon,28,3,18,5,13,59,53,6,59
Brechin,28,4,18,5,13,51,45,6,59
Queen's Park,28,5,17,2,17,41,47,-6,53
Albion,28,6,15,7,14,61,54,7,52
Peterhead,28,7,14,9,13,52,53,-1,51
Stranraer,28,8,13,5,18,56,57,-1,44
East Fife,28,9,9,8,19,41,63,-22,35
Stenhousem'r,28,10,8,7,21,50,88,-38,31
Livingston,29,1,23,4,9,87,55,32,73
Alloa,29,2,20,6,10,82,49,33,66
Brechin,29,3,18,5,13,59,48,11,59
Airdrieon,29,4,17,6,13,56,47,9,57
East Fife,29,5,13,12,11,46,46,0,51
Stranraer,29,6,14,6,16,43,52,-9,48
Albion,29,7,11,11,14,50,53,-3,44
Queen's Park,29,8,11,7,18,38,54,-16,40
Peterhead,29,9,10,8,18,41,63,-22,38
Stenhousem'r,29,10,7,7,22,39,74,-35,28
Alloa,30,1,19,9,8,69,44,25,66
Airdrieon,30,2,18,8,10,57,50,7,62
Livingston,30,3,17,8,11,69,47,22,59
Albion,30,4,17,7,12,60,45,15,58
East Fife,30,5,15,6,15,53,48,5,51
Brechin,30,6,14,8,14,55,53,2,50
Queen's Park,30,7,12,10,14,43,44,-1,46
Stranraer,30,8,11,9,16,41,55,-14,42
Peterhead,30,9,12,6,18,45,61,-16,42
Stenhousem'r,30,10,7,5,24,41,86,-45,26
Livingston,31,1,21,4,11,68,39,29,67
Alloa,31,2,19,8,9,74,50,24,65
Brechin,31,3,18,5,13,54,50,4,59
Albion,31,4,16,8,12,57,52,5,56
Airdrieon,31,5,16,8,12,58,55,3,56
Stranraer,31,6,13,8,15,53,60,-7,47
Peterhead,31,7,12,8,16,48,44,4,44
Queen's Park,31,8,13,4,19,42,53,-11,43
East Fife,31,9,9,9,18,51,68,-17,36
Stenhousem'r,31,10,8,8,20,39,73,-34,32
Alloa,32,1,21,6,9,76,42,34,69
Livingston,32,2,21,5,10,70,42,28,68
Albion,32,3,18,7,11,58,46,12,61
Airdrieon,32,4,17,5,14,56,56,0,56
Peterhead,32,5,16,7,13,51,46,5,55
Brechin,32,6,16,5,15,55,54,1,53
Queen's Park,32,7,13,7,16,41,58,-17,46
Stranraer,32,8,12,5,19,47,56,-9,41
East Fife,32,9,10,8,18,39,48,-9,38
Stenhousem'r,32,10,4,9,23,30,75,-45,21
Airdrieon,33,1,21,6,9,70,50,20,69
Livingston,33,2,21,5,10,76,51,25,68
Alloa,33,3,17,9,10,66,50,16,60
Brechin,33,4,15,7,14,50,52,-2,52
Albion,33,5,14,8,14,54,51,3,50
East Fife,33,6,11,15,10,57,50,7,48
Queen's Park,33,7,13,7,16,43,50,-7,46
Peterhead,33,8,11,8,17,43,53,-10,41
Stranraer,33,9,9,8,19,40,58,-18,35
Stenhousem'r,33,10,6,11,19,49,83,-34,29
Livingston,34,1,21,4,11,78,50,28,67
Peterhead,34,2,18,7,11,60,53,7,61
Alloa,34,3,15,10,11,63,45,18,55
Airdrieon,34,4,15,9,12,65,68,-3,54
Brechin,34,5,16,5,15,58,51,7,53
Stranraer,34,6,13,9,14,55,56,-1,48
Albion,34,7,13,8,15,54,60,-6,47
Queen's Park,34,8,12,6,18,33,48,-15,42
East Fife,34,9,10,8,18,47,55,-8,38
Stenhousem'r,34,10,9,10,17,50,77,-27,37
Airdrieon,35,1,21,6,9,70,52,18,69
Livingston,35,2,21,4,11,81,53,28,67
Alloa,35,3,19,7,10,75,46,29,64
Brechin,35,4,18,6,12,57,48,9,60
Stenhousem'r,35,5,13,8,15,53,64,-11,47
Queen's Park,35,6,14,4,18,40,62,-22,46
Peterhead,35,7,11,10,15,45,53,-8,43
Albion,35,8,11,9,16,53,61,-8,42
Stranraer,35,9,12,2,22,44,65,-21,38
East Fife,35,10,8,8,20,44,58,-14,32
Airdrieon,36,1,19,7,10,69,60,9,64
Livingston,36,2,19,5,12,86,55,31,62
East Fife,36,3,17,11,8,62,38,24,62
Alloa,36,4,18,4,14,72,60,12,58
Albion,36,5,14,9,13,53,53,0,51
Peterhead,36,6,14,8,14,52,56,-4,50
Stranraer,36,7,13,8,15,51,57,-6,47
Brechin,36,8,13,5,18,55,62,-7,44
Queen's Park,36,9,11,8,17,40,54,-14,41
Stenhousem'r,36,10,5,9,22,53,98,-45,24
Livingston,37,1,19,7,10,76,57,19,64
Airdrieon,37,2,17,9,10,65,53,12,60
Brechin,37,3,18,6,12,55,51,4,60
Alloa,37,4,15,10,11,65,43,22,55
Peterhead,37,5,14,10,12,50,48,2,52
Queen's Park,37,6,14,8,14,36,46,-10,50
Albion,37,7,12,8,16,56,61,-5,44
East Fife,37,8,9,13,14,54,53,1,40
Stenhousem'r,37,9,9,10,17,53,77,-24,37
Stranraer,37,10,7,11,18,39,60,-21,32
Alloa,38,1,23,5,8,71,43,28,74
Livingston,38,2,21,1,14,74,56,18,64
Albion,38,3,18,5,13,60,43,17,59
Peterhead,38,4,17,7,12,63,52,11,58
Airdrieon,38,5,16,7,13,55,61,-6,55
Brechin,38,6,15,6,15,49,52,-3,51
Queen's Park,38,7,11,8,17,40,52,-12,41
Stranraer,38,8,11,7,18,58,66,-8,40
East Fife,38,9,8,9,19,44,59,-15,33
Stenhousem'r,38,10,6,13,17,46,76,-30,31
Livingston,39,1,25,1,10,84,51,33,76
Alloa,39,2,19,6,11,66,44,22,63
Albion,39,3,17,8,11,64,49,15,59
Peterhead,39,4,16,9,11,49,44,5,57
Airdrieon,39,5,16,7,13,55,53,2,55
Stranraer,39,6,14,4,18,53,57,-4,46
Brechin,39,7,12,9,15,45,54,-9,45
East Fife,39,8,10,9,17,44,54,-10,39
Queen's Park,39,9,10,8,18,36,54,-18,38
Stenhousem'r,39,10,7,7,22,45,81,-36,28
Airdrieon,40,1,20,6,10,63,49,14,66
Alloa,40,2,18,7,11,67,42,25,61
Livingston,40,3,17,7,12,70,51,19,58
Brechin,40,4,16,8,12,52,48,4,56
Queen's Park,40,5,16,7,13,44,44,0,55
Peterhead,40,6,14,8,14,56,63,-7,50
Stranraer,40,7,15,3,18,60,62,-2,48
East Fife,40,8,11,10,15,49,50,-1,43
Stenhousem'r,40,9,9,8,19,51,81,-30,35
Albion,40,10,7,10,19,46,68,-22,31
Livingston,41,1,21,4,11,80,59,21,67
Brechin,41,2,21,4,11,55,41,14,67
Alloa,41,3,19,9,8,68,37,31,66
Airdrieon,41,4,15,11,10,60,51,9,56
Queen's Park,41,5,12,14,10,38,44,-6,50
East Fife,41,6,13,9,14,48,48,0,48
Albion,41,7,11,10,15,58,58,0,43
Peterhead,41,8,11,7,18,45,54,-9,40
Stranraer,41,9,9,4,23,41,75,-34,31
Stenhousem'r,41,10,6,12,18,35,61,-26,30
Livingston,42,1,20,5,11,82,59,23,65
Alloa,42,2,18,7,11,69,45,24,61
Brechin,42,3,17,9,10,54,49,5,60
Airdrieon,42,4,16,6,14,60,64,-4,54
East Fife,42,5,14,10,12,61,50,11,52
Peterhead,42,6,12,13,11,52,53,-1,49
Queen's Park,42,7,12,6,18,41,49,-8,42
Albion,42,8,10,10,16,48,59,-11,40
Stranraer,42,9,11,7,18,55,72,-17,40
Stenhousem'r,42,10,9,9,18,51,73,-22,36
Livingston,43,1,25,4,7,79,38,41,79
Airdrieon,43,2,18,7,11,57,48,9,61
Alloa,43,3,16,9,11,69,53,16,57
Brechin,43,4,15,6,15,44,48,-4,51
Stranraer,43,5,14,7,15,54,57,-3,49
East Fife,43,6,13,9,14,48,44,4,48
Peterhead,43,7,13,9,14,49,56,-7,48
Albion,43,8,11,9,16,62,69,-7,42
Queen's Park,43,9,10,6,20,35,54,-19,36
Stenhousem'r,43,10,8,8,20,45,75,-30,32
Alloa,44,1,20,7,9,70,40,30,67
Livingston,44,2,19,4,13,65,47,18,61
Brechin,44,3,18,3,15,53,46,7,57
Albion,44,4,15,11,10,52,42,10,56
Airdrieon,44,5,16,7,13,59,51,8,55
Peterhead,44,6,13,10,13,48,49,-1,49
East Fife,44,7,13,7,16,50,51,-1,46
Queen's Park,44,8,13,7,16,35,51,-16,46
Stranraer,44,9,11,7,18,42,57,-15,40
Stenhousem'r,44,10,8,5,23,40,80,-40,29
Livingston,45,1,20,5,11,66,52,14,65
Peterhead,45,2,19,6,11,60,52,8,63
Brechin,45,3,18,5,13,44,41,3,59
Alloa,45,4,15,12,9,58,46,12,57
Albion,45,5,14,10,12,55,49,6,52
Airdrieon,45,6,16,4,16,60,57,3,52
Stranraer,45,7,12,8,16,59,64,-5,44
Queen's Park,45,8,11,8,17,39,50,-11,41
Stenhousem'r,45,9,11,5,20,54,74,-20,38
East Fife,45,10,6,13,17,41,51,-10,31
Livingston,46,1,17,7,12,75,59,16,58
Airdrieon,46,2,17,7,12,63,52,11,58
Brechin,46,3,18,4,14,53,49,4,58
Alloa,46,4,16,5,15,63,45,18,53
Albion,46,5,14,11,11,54,48,6,53
Stranraer,46,6,14,6,16,42,51,-9,48
Queen's Park,46,7,14,6,16,38,50,-12,48
East Fife,46,8,11,10,15,48,49,-1,43
Peterhead,46,9,12,7,17,40,54,-14,43
Stenhousem'r,46,10,9,13,14,57,76,-19,40
Alloa,47,1,21,8,7,71,37,34,71
Livingston,47,2,19,6,11,64,50,14,63
Airdrieon,47,3,18,7,11,62,56,6,61
Brechin,47,4,17,8,11,46,39,7,59
Albion,47,5,11,14,11,60,57,3,47
Peterhead,47,6,13,7,16,53,58,-5,46
Stranraer,47,7,14,4,18,52,57,-5,46
Queen's Park,47,8,10,8,18,39,57,-18,38
East Fife,47,9,9,10,17,47,52,-5,37
Stenhousem'r,47,10,9,6,21,47,78,-31,33
Livingston,48,1,20,7,9,83,42,41,67
Alloa,48,2,19,7,10,69,43,26,64
Airdrieon,48,3,18,6,12,58,50,8,60
Albion,48,4,14,11,11,61,50,11,53
Queen's Park,48,5,15,7,14,47,64,-17,52
East Fife,48,6,13,9,14,49,44,5,48
Brechin,48,7,13,8,15,41,48,-7,47
Peterhead,48,8,12,8,16,43,58,-15,44
Stranraer,48,9,12,5,19,52,67,-15,41
Stenhousem'r,48,10,6,8,22,45,82,-37,26
Alloa,49,1,18,11,7,66,35,31,65
Airdrieon,49,2,18,8,10,65,54,11,62
Albion,49,3,16,10,10,57,48,9,58
Livingston,49,4,17,6,13,61,47,14,57
Peterhead,49,5,15,11,10,48,43,5,56
Brechin,49,6,15,9,12,52,47,5,54
Queen's Park,49,7,13,6,17,41,52,-11,45
East Fife,49,8,11,6,19,46,61,-15,39
Stranraer,49,9,10,5,21,39,58,-19,35
Stenhousem'r,49,10,6,10,20,48,78,-30,28
Alloa,50,1,23,5,8,78,41,37,74
Livingston,50,2,22,2,12,87,42,45,68
Brechin,50,3,19,6,11,56,46,10,63
Albion,50,4,16,9,11,48,41,7,57
Peterhead,50,5,16,8,12,56,51,5,56
Airdrieon,50,6,13,6,17,48,57,-9,45
Queen's Park,50,7,12,4,20,39,59,-20,40
East Fife,50,8,10,8,18,52,62,-10,38
Stranraer,50,9,10,6,20,44,62,-18,36
Stenhousem'r,50,10,9,6,21,46,93,-47,33
Alloa,51,1,20,7,9,62,39,23,67
Airdrieon,51,2,18,6,12,57,50,7,60
Livingston,51,3,18,5,13,75,49,26,59
Brechin,51,4,14,9,13,44,46,-2,51
Albion,51,5,13,10,13,53,54,-1,49
Queen's Park,51,6,12,13,11,47,54,-7,49
Stranraer,51,7,14,5,17,51,53,-2,47
East Fife,51,8,12,9,15,53,48,5,45
Peterhead,51,9,11,10,15,45,55,-10,43
Stenhousem'r,51,10,7,8,21,44,83,-39,29
Livingston,52,1,23,4,9,78,51,27,73
Alloa,52,2,20,5,11,78,52,26,65
Brechin,52,3,16,7,13,54,50,4,55
Stranraer,52,4,15,5,16,57,65,-8,50
Peterhead,52,5,12,12,12,51,53,-2,48
Airdrieon,52,6,12,12,12,58,64,-6,48
East Fife,52,7,11,9,16,51,52,-1,42
Queen's Park,52,8,11,9,16,40,53,-13,42
Albion,52,9,11,8,17,45,55,-10,41
Stenhousem'r,52,10,8,11,17,56,73,-17,35
Livingston,53,1,19,8,9,78,45,33,65
Alloa,53,2,19,6,11,76,45,31,63
Brechin,53,3,17,7,12,43,41,2,58
Stranraer,53,4,16,5,15,54,60,-6,53
Peterhead,53,5,15,7,14,59,50,9,52
Queen's Park,53,6,15,5,16,40,50,-10,50
Airdrieon,53,7,13,6,17,53,67,-14,45
East Fife,53,8,12,7,17,50,58,-8,43
Albion,53,9,11,8,17,52,61,-9,41
Stenhousem'r,53,10,11,5,20,49,77,-28,38
Livingston,54,1,21,6,9,75,47,28,69
Alloa,54,2,19,10,7,83,46,37,67
Brechin,54,3,16,11,9,51,42,9,59
Queen's Park,54,4,15,9,12,42,41,1,54
Albion,54,5,15,5,16,51,57,-6,50
Airdrieon,54,6,14,7,15,54,63,-9,49
East Fife,54,7,11,11,14,46,41,5,44
Stranraer,54,8,12,6,18,53,63,-10,42
Peterhead,54,9,9,10,17,42,59,-17,37
Stenhousem'r,54,10,6,9,21,47,85,-38,27
Alloa,55,1,19,8,9,68,37,31,65
Brechin,55,2,17,8,11,56,51,5,59
Airdrieon,55,3,18,5,13,56,53,3,59
Albion,55,4,17,6,13,50,46,4,57
Livingston,55,5,17,5,14,65,48,17,56
Peterhead,55,6,15,8,13,51,52,-1,53
Stranraer,55,7,14,9,13,47,50,-3,51
Queen's Park,55,8,10,9,17,34,54,-20,39
East Fife,55,9,8,11,17,43,46,-3,35
Stenhousem'r,55,10,6,9,21,42,75,-33,27
Livingston,56,1,24,5,7,95,38,57,77
Brechin,56,2,18,11,7,70,48,22,65
Alloa,56,3,16,10,10,67,48,19,58
Airdrieon,56,4,14,12,10,64,60,4,54
Albion,56,5,13,7,16,45,60,-15,46
Queen's Park,56,6,12,10,14,51,67,-16,46
Peterhead,56,7,11,9,16,53,57,-4,42
East Fife,56,8,10,8,18,51,59,-8,38
Stenhousem'r,56,9,11,4,21,47,85,-38,37
Stranraer,56,10,10,6,20,45,66,-21,36
Airdrieon,57,1,21,5,10,66,51,15,68
Alloa,57,2,20,6,10,74,40,34,66
Livingston,57,3,19,5,12,74,45,29,62
Albion,57,4,17,5,14,59,51,8,56
Queen's Park,57,5,13,10,13,39,45,-6,49
East Fife,57,6,13,9,14,51,47,4,48
Peterhead,57,7,12,8,16,43,59,-16,44
Brechin,57,8,12,5,19,47,71,-24,41
Stenhousem'r,57,9,10,7,19,45,76,-31,37
Stranraer,57,10,9,8,19,42,55,-13,35
Alloa,58,1,22,8,6,73,38,35,74
Livingston,58,2,21,5,10,72,43,29,68
Airdrieon,58,3,18,6,12,58,57,1,60
Brechin,58,4,16,8,12,46,40,6,56
Peterhead,58,5,14,8,14,56,59,-3,50
Albion,58,6,14,7,15,46,50,-4,49
East Fife,58,7,12,7,17,61,50,11,43
Queen's Park,58,8,12,7,17,38,50,-12,43
Stranraer,58,9,10,4,22,46,64,-18,34
Stenhousem'r,58,10,6,10,20,43,88,-45,28
Livingston,59,1,22,4,10,76,44,32,70
Alloa,59,2,19,9,8,75,40,35,66
Peterhead,59,3,15,12,9,55,49,6,57
Airdrieon,59,4,16,8,12,67,58,9,56
Brechin,59,5,15,10,11,50,42,8,55
Stranraer,59,6,14,7,15,50,58,-8,49
Albion,59,7,12,10,14,56,62,-6,46
East Fife,59,8,9,14,13,52,50,2,41
Queen's Park,59,9,9,10,17,38,60,-22,37
Stenhousem'r,59,10,3,8,25,39,95,-56,17
Alloa,60,1,24,5,7,81,42,39,77
Livingston,60,2,17,7,12,74,56,18,58
Brechin,60,3,17,4,15,47,42,5,55
Stranraer,60,4,17,3,16,55,54,1,54
Airdrieon,60,5,14,10,12,53,60,-7,52
Albion,60,6,13,10,13,63,68,-5,49
Peterhead,60,7,12,7,17,58,67,-9,43
Queen's Park,60,8,11,10,15,40,52,-12,43
East Fife,60,9,10,11,15,54,53,1,41
Stenhousem'r,60,10,8,7,21,52,83,-31,31
Livingston,61,1,19,6,11,72,49,23,63
Brechin,61,2,17,8,11,53,52,1,59
Alloa,61,3,16,8,12,64,47,17,56
Airdrieon,61,4,16,6,14,52,55,-3,54
Peterhead,61,5,14,7,15,47,46,1,49
Albion,61,6,13,10,13,54,54,0,49
East Fife,61,7,13,8,15,53,48,5,47
Queen's Park,61,8,13,8,15,47,57,-10,47
Stranraer,61,9,11,6,19,50,65,-15,39
Stenhousem'r,61,10,9,11,16,49,68,-19,38
Livingston,62,1,22,7,7,87,50,37,73
Alloa,62,2,21,8,7,76,37,39,71
Airdrieon,62,3,17,5,14,55,54,1,56
Albion,62,4,14,13,9,58,49,9,55
Brechin,62,5,16,4,16,54,52,2,52
Peterhead,62,6,12,9,15,47,52,-5,45
East Fife,62,7,11,10,15,50,60,-10,43
Queen's Park,62,8,11,9,16,39,55,-16,42
Stranraer,62,9,11,6,19,53,64,-11,39
Stenhousem'r,62,10,5,9,22,40,86,-46,24
Alloa,63,1,23,5,8,68,42,26,74
Brechin,63,2,19,5,12,59,49,10,62
Airdrieon,63,3,19,5,12,61,53,8,62
Livingston,63,4,16,8,12,70,49,21,56
Albion,63,5,13,8,15,53,55,-2,47
Queen's Park,63,6,13,7,16,44,51,-7,46
Stranraer,63,7,14,4,18,42,51,-9,46
East Fife,63,8,11,10,15,51,50,1,43
Peterhead,63,9,10,11,15,38,47,-9,41
Stenhousem'r,63,10,5,11,20,39,78,-39,26
Alloa,64,1,20,8,8,78,43,35,68
Livingston,64,2,20,6,10,78,57,21,66
Brechin,64,3,19,4,13,61,51,10,61
Airdrieon,64,4,17,6,13,63,58,5,57
Albion,64,5,14,9,13,60,52,8,51
Peterhead,64,6,14,5,17,54,61,-7,47
Queen's Park,64,7,12,8,16,38,50,-12,44
East Fife,64,8,11,8,17,52,61,-9,41
Stranraer,64,9,11,5,20,48,70,-22,38
Stenhousem'r,64,10,9,7,20,49,78,-29,34
Alloa,65,1,22,8,6,90,42,48,74
Livingston,65,2,22,8,6,74,37,37,74
Brechin,65,3,14,10,12,48,43,5,52
Airdrieon,65,4,14,9,13,54,60,-6,51
Peterhead,65,5,14,7,15,52,51,1,49
Queen's Park,65,6,15,4,17,38,54,-16,49
Albion,65,7,13,5,18,50,59,-9,44
East Fife,65,8,11,8,17,43,47,-4,41
Stranraer,65,9,10,6,20,42,63,-21,36
Stenhousem'r,65,10,10,5,21,41,76,-35,35
Livingston,66,1,22,7,7,75,47,28,73
Alloa,66,2,20,7,9,74,45,29,67
Brechin,66,3,20,4,12,51,40,11,64
Airdrieon,66,4,17,4,15,61,52,9,55
Albion,66,5,13,8,15,54,54,0,47
Stranraer,66,6,13,7,16,49,52,-3,46
Peterhead,66,7,14,4,18,49,55,-6,46
Queen's Park,66,8,13,3,20,31,54,-23,42
East Fife,66,9,11,7,18,46,56,-10,40
Stenhousem'r,66,10,9,5,22,41,76,-35,32
Livingston,67,1,19,4,13,64,49,15,61
Alloa,67,2,17,8,11,63,44,19,59
Brechin,67,3,17,4,15,49,50,-1,55
Albion,67,4,14,10,12,59,49,10,52
Airdrieon,67,5,16,4,16,52,54,-2,52
East Fife,67,6,13,11,12,55,40,15,50
Peterhead,67,7,12,9,15,49,59,-10,45
Queen's Park,67,8,11,11,14,38,49,-11,44
Stranraer,67,9,12,7,17,43,58,-15,43
Stenhousem'r,67,10,11,8,17,53,73,-20,41
Livingston,68,1,19,8,9,71,42,29,65
Alloa,68,2,17,9,10,67,43,24,60
Peterhead,68,3,17,8,11,51,41,10,59
Brechin,68,4,16,9,11,46,46,0,57
Airdrieon,68,5,15,3,18,51,55,-4,48
Stranraer,68,6,13,8,15,56,58,-2,47
Albion,68,7,12,9,15,53,60,-7,45
Queen's Park,68,8,11,11,14,31,44,-13,44
East Fife,68,9,10,12,14,49,51,-2,42
Stenhousem'r,68,10,7,9,20,42,77,-35,30
Alloa,69,1,20,6,10,77,47,30,66
Airdrieon,69,2,20,4,12,60,50,10,64
Livingston,69,3,19,3,14,71,44,27,60
Queen's Park,69,4,18,4,14,51,46,5,58
Albion,69,5,17,7,12,50,49,1,58
Stranraer,69,6,15,3,18,47,55,-8,48
Brechin,69,7,13,5,18,45,57,-12,44
Peterhead,69,8,11,10,15,46,59,-13,43
East Fife,69,9,9,9,18,48,54,-6,36
Stenhousem'r,69,10,8,9,19,42,76,-34,33
Livingston,70,1,18,8,10,72,46,26,62
Airdrieon,70,2,19,5,12,51,48,3,62
Alloa,70,3,16,10,10,59,39,20,58
East Fife,70,4,17,6,13,59,48,11,57
Stranraer,70,5,14,6,16,58,62,-4,48
Queen's Park,70,6,14,6,16,44,55,-11,48
Brechin,70,7,14,4,18,44,53,-9,46
Albion,70,8,12,9,15,46,55,-9,45
Peterhead,70,9,12,8,16,47,49,-2,44
Stenhousem'r,70,10,9,8,19,47,72,-25,35
Airdrieon,71,1,21,6,9,73,62,11,69
Brechin,71,2,18,9,9,57,42,15,63
Alloa,71,3,15,13,8,70,52,18,58
Livingston,71,4,14,10,12,67,56,11,52
Albion,71,5,13,9,14,48,52,-4,48
East Fife,71,6,12,11,13,46,45,1,47
Queen's Park,71,7,12,10,14,40,48,-8,46
Stenhousem'r,71,8,10,9,17,58,72,-14,39
Peterhead,71,9,9,10,17,47,65,-18,37
Stranraer,71,10,10,5,21,49,61,-12,35
Livingston,72,1,20,6,10,79,50,29,66
Airdrieon,72,2,19,6,11,57,46,11,63
Alloa,72,3,16,10,10,71,49,22,58
Albion,72,4,14,9,13,61,49,12,51
Brechin,72,5,15,6,15,44,46,-2,51
Peterhead,72,6,14,8,14,45,49,-4,50
East Fife,72,7,13,9,14,49,51,-2,48
Stenhousem'r,72,8,11,8,17,48,73,-25,41
Queen's Park,72,9,11,7,18,35,57,-22,40
Stranraer,72,10,11,3,22,43,62,-19,36
Livingston,73,1,22,7,7,81,44,37,73
Alloa,73,2,20,7,9,70,41,29,67
Brechin,73,3,17,10,9,54,36,18,61
Airdrieon,73,4,16,7,13,57,56,1,55
Albion,73,5,15,9,12,45,42,3,54
Peterhead,73,6,14,8,14,45,59,-14,50
Queen's Park,73,7,10,8,18,40,60,-20,38
Stranraer,73,8,10,7,19,47,64,-17,37
Stenhousem'r,73,9,9,6,21,47,73,-26,33
East Fife,73,10,7,11,18,47,58,-11,32
Livingston,74,1,21,2,13,89,57,32,65
Airdrieon,74,2,19,7,10,63,46,17,64
Brechin,74,3,17,8,11,52,39,13,59
Alloa,74,4,17,6,13,68,45,23,57
Albion,74,5,15,8,13,50,50,0,53
Peterhead,74,6,15,6,15,45,48,-3,51
Queen's Park,74,7,13,5,18,38,60,-22,44
Stranraer,74,8,13,4,19,51,71,-20,43
East Fife,74,9,9,13,14,48,46,2,40
Stenhousem'r,74,10,6,11,19,38,80,-42,29
Alloa,75,1,25,5,6,94,40,54,80
Livingston,75,2,18,6,12,74,51,23,60
Brechin,75,3,16,7,13,62,60,2,55
Airdrieon,75,4,17,4,15,61,59,2,55
Albion,75,5,16,7,13,60,58,2,55
Stranraer,75,6,16,2,18,55,65,-10,50
East Fife,75,7,12,11,13,56,54,2,47
Peterhead,75,8,12,9,15,51,60,-9,45
Queen's Park,75,9,11,4,21,40,62,-22,37
Stenhousem'r,75,10,5,9,22,50,94,-44,24
Livingston,76,1,22,5,9,77,46,31,71
Airdrieon,76,2,17,7,12,56,58,-2,58
Peterhead,76,3,16,9,11,55,43,12,57
Brechin,76,4,16,9,11,51,45,6,57
Alloa,76,5,15,10,11,68,51,17,55
Queen's Park,76,6,15,5,16,40,47,-7,50
Stranraer,76,7,13,7,16,54,58,-4,46
Albion,76,8,11,8,17,50,55,-5,41
Stenhousem'r,76,9,9,7,20,50,83,-33,34
East Fife,76,10,7,11,18,36,51,-15,32
Livingston,77,1,24,2,10,86,46,40,74
Alloa,77,2,20,8,8,76,44,32,68
Brechin,77,3,16,8,12,46,43,3,56
Albion,77,4,15,7,14,58,54,4,52
East Fife,77,5,13,11,12,53,48,5,50
Airdrieon,77,6,14,7,15,57,61,-4,49
Stranraer,77,7,13,6,17,57,63,-6,45
Peterhead,77,8,11,12,13,51,57,-6,45
Queen's Park,77,9,10,8,18,32,47,-15,38
Stenhousem'r,77,10,6,7,23,42,95,-53,25
Alloa,78,1,21,8,7,83,45,38,71
Livingston,78,2,18,6,12,66,49,17,60
Brechin,78,3,18,6,12,43,43,0,60
Peterhead,78,4,13,10,13,53,55,-2,49
Queen's Park,78,5,14,7,15,35,45,-10,49
East Fife,78,6,12,10,14,52,53,-1,46
Airdrieon,78,7,13,7,16,58,63,-5,46
Stranraer,78,8,12,7,17,57,58,-1,43
Stenhousem'r,78,9,11,7,18,57,81,-24,40
Albion,78,10,10,8,18,46,58,-12,38
Alloa,79,1,22,9,5,81,34,47,75
Livingston,79,2,21,6,9,75,42,33,69
Airdrieon,79,3,18,5,13,63,54,9,59
East Fife,79,4,17,5,14,57,56,1,56
Brechin,79,5,16,3,17,47,52,-5,51
Albion,79,6,13,8,15,52,47,5,47
Queen's Park,79,7,11,6,19,31,59,-28,39
Stenhousem'r,79,8,9,11,16,61,78,-17,38
Peterhead,79,9,10,8,18,42,63,-21,38
Stranraer,79,10,10,5,21,45,69,-24,35
Livingston,80,1,21,7,8,79,50,29,70
Alloa,80,2,19,9,8,79,45,34,66
Albion,80,3,17,7,12,56,53,3,58
Brechin,80,4,15,8,13,49,43,6,53
Airdrieon,80,5,15,8,13,63,58,5,53
Peterhead,80,6,13,7,16,49,51,-2,46
Queen's Park,80,7,12,8,16,42,57,-15,44
East Fife,80,8,11,8,17,54,60,-6,41
Stranraer,80,9,10,10,16,49,63,-14,40
Stenhousem'r,80,10,8,6,22,46,86,-40,30
Alloa,81,1,20,8,8,75,42,33,68
Livingston,81,2,22,1,13,67,46,21,67
Peterhead,81,3,17,8,11,57,54,3,59
Brechin,81,4,17,5,14,49,47,2,56
Queen's Park,81,5,14,5,17,38,46,-8,47
Albion,81,6,12,10,14,46,49,-3,46
East Fife,81,7,12,8,16,50,51,-1,44
Airdrieon,81,8,13,5,18,54,65,-11,44
Stranraer,81,9,13,3,20,46,60,-14,42
Stenhousem'r,81,10,10,7,19,48,70,-22,37
Alloa,82,1,22,6,8,78,42,36,72
Livingston,82,2,19,5,12,70,50,20,62
Peterhead,82,3,16,6,14,55,44,11,54
Airdrieon,82,4,16,5,15,57,55,2,53
Queen's Park,82,5,13,12,11,45,48,-3,51
Albion,82,6,13,9,14,56,62,-6,48
East Fife,82,7,12,10,14,51,50,1,46
Brechin,82,8,13,5,18,46,63,-17,44
Stranraer,82,9,11,8,17,47,61,-14,41
Stenhousem'r,82,10,8,8,20,47,77,-30,32
Airdrieon,83,1,22,5,9,62,47,15,71
Livingston,83,2,21,4,11,72,45,27,67
Alloa,83,3,19,8,9,70,38,32,65
Brechin,83,4,16,10,10,56,43,13,58
Albion,83,5,15,8,13,52,55,-3,53
East Fife,83,6,11,10,15,43,42,1,43
Peterhead,83,7,12,6,18,43,62,-19,42
Queen's Park,83,8,10,8,18,36,58,-22,38
Stranraer,83,9,10,6,20,40,58,-18,36
Stenhousem'r,83,10,7,9,20,44,70,-26,30
Livingston,84,1,21,3,12,80,45,35,66
Airdrieon,84,2,19,7,10,59,51,8,64
Alloa,84,3,19,6,11,73,42,31,63
Brechin,84,4,17,8,11,51,45,6,59
Albion,84,5,14,8,14,48,46,2,50
Queen's Park,84,6,14,7,15,33,48,-15,49
Peterhead,84,7,12,9,15,47,54,-7,45
Stranraer,84,8,13,2,21,40,61,-21,41
East Fife,84,9,10,8,18,43,54,-11,38
Stenhousem'r,84,10,9,6,21,50,78,-28,33
Livingston,85,1,21,6,9,78,48,30,69
Alloa,85,2,18,9,9,70,42,28,63
Airdrieon,85,3,19,5,12,60,55,5,62
Albion,85,4,17,7,12,60,45,15,58
Brechin,85,5,16,3,17,49,58,-9,51
Stranraer,85,6,15,5,16,60,61,-1,50
Queen's Park,85,7,14,5,17,45,51,-6,47
Peterhead,85,8,13,7,16,38,45,-7,46
East Fife,85,9,11,8,17,46,54,-8,41
Stenhousem'r,85,10,6,5,25,39,86,-47,23
Alloa,86,1,20,8,8,81,42,39,68
Livingston,86,2,21,3,12,72,50,22,66
Stranraer,86,3,16,6,14,57,48,9,54
Peterhead,86,4,14,9,13,51,51,0,51
Brechin,86,5,15,6,15,45,49,-4,51
Airdrieon,86,6,15,6,15,53,59,-6,51
East Fife,86,7,13,10,13,43,41,2,49
Albion,86,8,13,8,15,48,56,-8,47
Queen's Park,86,9,12,7,17,35,54,-19,43
Stenhousem'r,86,10,6,7,23,41,76,-35,25
Brechin,87,1,20,6,10,59,45,14,66
Livingston,87,2,19,5,12,73,50,23,62
Alloa,87,3,17,10,9,64,44,20,61
Albion,87,4,16,8,12,60,52,8,56
Queen's Park,87,5,14,9,13,38,49,-11,51
Airdrieon,87,6,14,7,15,52,51,1,49
Peterhead,87,7,13,9,14,54,55,-1,48
Stranraer,87,8,12,4,20,49,57,-8,40
East Fife,87,9,11,7,18,53,65,-12,40
Stenhousem'r,87,10,7,9,20,45,79,-34,30
Alloa,88,1,18,8,10,76,47,29,62
Livingston,88,2,17,8,11,73,50,23,59
Airdrieon,88,3,17,8,11,56,47,9,59
Peterhead,88,4,18,5,13,57,52,5,59
Queen's Park,88,5,16,8,12,43,40,3,56
Albion,88,6,15,5,16,58,51,7,50
Brechin,88,7,15,4,17,40,54,-14,49
East Fife,88,8,13,9,14,51,53,-2,48
Stranraer,88,9,12,3,21,43,59,-16,39
Stenhousem'r,88,10,6,8,22,40,84,-44,26
Alloa,89,1,20,9,7,70,34,36,69
Livingston,89,2,19,7,10,73,46,27,64
Albion,89,3,17,7,12,56,50,6,58
Airdrieon,89,4,17,7,12,55,54,1,58
Brechin,89,5,17,5,14,46,42,4,56
Queen's Park,89,6,11,11,14,37,47,-10,44
Peterhead,89,7,11,10,15,49,62,-13,43
East Fife,89,8,11,9,16,51,50,1,42
Stenhousem'r,89,9,8,10,18,46,76,-30,34
Stranraer,89,10,9,5,22,40,62,-22,32
Livingston,90,1,19,10,7,80,50,30,67
Airdrieon,90,2,19,6,11,62,50,12,63
Alloa,90,3,17,7,12,69,44,25,58
Albion,90,4,15,10,11,56,51,5,55
Brechin,90,5,14,9,13,48,47,1,51
Peterhead,90,6,14,7,15,53,59,-6,49
East Fife,90,7,11,11,14,46,45,1,44
Stranraer,90,8,10,12,14,52,56,-4,42
Queen's Park,90,9,10,11,15,34,48,-14,41
Stenhousem'r,90,10,5,9,22,50,100,-50,24
Alloa,91,1,20,8,8,78,42,36,68
Livingston,91,2,20,6,10,77,51,26,66
Airdrieon,91,3,20,5,11,63,50,13,65
Brechin,91,4,20,4,12,51,37,14,64
Peterhead,91,5,14,8,14,46,55,-9,50
Queen's Park,91,6,15,5,16,36,45,-9,50
Stranraer,91,7,13,6,17,53,62,-9,45
East Fife,91,8,10,9,17,44,55,-11,39
Stenhousem'r,91,9,8,7,21,45,78,-33,31
Albion,91,10,7,8,21,37,55,-18,29
Livingston,92,1,21,6,9,72,39,33,69
Airdrieon,92,2,19,7,10,63,50,13,64
Alloa,92,3,17,8,11,73,51,22,59
Peterhead,92,4,17,8,11,59,52,7,59
Brechin,92,5,15,8,13,55,45,10,53
Queen's Park,92,6,11,10,15,37,47,-10,43
East Fife,92,7,11,8,17,48,54,-6,41
Albion,92,8,9,14,13,51,62,-11,41
Stenhousem'r,92,9,10,6,20,46,80,-34,36
Stranraer,92,10,9,7,20,44,68,-24,34
Livingston,93,1,24,4,8,75,42,33,76
Alloa,93,2,18,8,10,63,40,23,62
Airdrieon,93,3,17,8,11,64,52,12,59
Albion,93,4,17,5,14,50,47,3,56
Brechin,93,5,15,8,13,48,48,0,53
East Fife,93,6,12,10,14,54,48,6,46
Peterhead,93,7,12,10,14,44,47,-3,46
Stranraer,93,8,11,7,18,43,56,-13,40
Stenhousem'r,93,9,8,8,20,43,75,-32,32
Queen's Park,93,10,7,10,19,30,59,-29,31
Alloa,94,1,21,4,11,69,39,30,67
Livingston,94,2,21,1,14,77,48,29,64
Brechin,94,3,17,7,12,49,44,5,58
Airdrieon,94,4,18,4,14,61,60,1,58
Albion,94,5,16,8,12,52,47,5,56
Stranraer,94,6,17,3,16,57,57,0,54
Queen's Park,94,7,15,7,14,41,47,-6,52
Peterhead,94,8,11,8,17,46,55,-9,41
East Fife,94,9,8,10,18,41,52,-11,34
Stenhousem'r,94,10,5,10,21,40,84,-44,25
Alloa,95,1,22,5,9,70,39,31,71
Airdrieon,95,2,21,5,10,63,49,14,68
East Fife,95,3,16,10,10,57,42,15,58
Brechin,95,4,16,6,14,63,57,6,54
Livingston,95,5,14,6,16,56,50,6,48
Stranraer,95,6,13,8,15,53,58,-5,47
Queen's Park,95,7,13,8,15,47,57,-10,47
Peterhead,95,8,12,7,17,44,56,-12,43
Albion,95,9,9,11,16,49,63,-14,38
Stenhousem'r,95,10,7,8,21,47,78,-31,29
Livingston,96,1,20,8,8,83,46,37,68
Airdrieon,96,2,20,7,9,78,55,23,67
Alloa,96,3,19,5,12,76,44,32,62
Brechin,96,4,15,5,16,49,45,4,50
Stranraer,96,5,14,8,14,53,66,-13,50
Albion,96,6,14,7,15,57,55,2,49
Peterhead,96,7,14,7,15,44,63,-19,49
Queen's Park,96,8,12,8,16,38,51,-13,44
East Fife,96,9,8,10,18,40,50,-10,34
Stenhousem'r,96,10,9,5,22,44,87,-43,32
Livingston,97,1,23,4,9,84,50,34,73
Alloa,97,2,20,6,10,70,40,30,66
Airdrieon,97,3,20,4,12,61,49,12,64
Brechin,97,4,14,9,13,47,49,-2,51
Albion,97,5,14,8,14,57,51,6,50
Stranraer,97,6,13,6,17,50,60,-10,45
Peterhead,97,7,12,8,16,45,57,-12,44
East Fife,97,8,11,10,15,42,42,0,43
Queen's Park,97,9,11,8,17,37,58,-21,41
Stenhousem'r,97,10,6,9,21,46,83,-37,27
Brechin,98,1,21,3,12,59,44,15,66
Livingston,98,2,20,4,12,79,55,24,64
Airdrieon,98,3,19,7,10,62,50,12,64
Alloa,98,4,17,7,12,60,42,18,58
Albion,98,5,17,7,12,61,54,7,58
Queen's Park,98,6,15,7,14,42,43,-1,52
Peterhead,98,7,13,12,11,54,55,-1,51
Stranraer,98,8,10,7,19,57,68,-11,37
East Fife,98,9,9,9,18,55,71,-16,36
Stenhousem'r,98,10,4,7,25,35,82,-47,19
Livingston,99,1,21,4,11,75,47,28,67
Alloa,99,2,19,7,10,65,46,19,64
Airdrieon,99,3,18,5,13,57,52,5,59
Peterhead,99,4,16,6,14,55,53,2,54
Albion,99,5,16,6,14,57,58,-1,54
Brechin,99,6,14,6,16,51,53,-2,48
Stranraer,99,7,13,5,18,49,53,-4,44
Queen's Park,99,8,13,5,18,40,54,-14,44
East Fife,99,9,10,9,17,54,60,-6,39
Stenhousem'r,99,10,10,7,19,51,78,-27,37
Alloa,100,1,20,6,10,75,48,27,66
Livingston,100,2,20,3,13,82,52,30,63
Brechin,100,3,15,10,11,50,42,8,55
Airdrieon,100,4,15,9,12,51,51,0,54
Peterhead,100,5,14,11,11,54,51,3,53
Albion,100,6,13,12,11,50,41,9,51
Stranraer,100,7,15,5,16,54,57,-3,50
Queen's Park,100,8,13,8,15,32,47,-15,47
East Fife,100,9,7,11,18,49,64,-15,32
Stenhousem'r,100,10,6,9,21,42,86,-44,27
Livingston,101,1,24,3,9,91,48,43,75
Airdrieon,101,2,22,4,10,71,43,28,70
Brechin,101,3,18,9,9,62,52,10,63
Alloa,101,4,16,7,13,64,48,16,55
Albion,101,5,14,10,12,56,55,1,52
Peterhead,101,6,14,7,15,48,54,-6,49
Stranraer,101,7,14,2,20,51,66,-15,44
East Fife,101,8,12,6,18,54,50,4,42
Queen's Park,101,9,8,8,20,33,70,-37,32
Stenhousem'r,101,10,6,8,22,36,80,-44,26
Alloa,102,1,23,6,7,76,41,35,75
Livingston,102,2,18,7,11,72,49,23,61
Brechin,102,3,19,4,13,51,38,13,61
Airdrieon,102,4,16,7,13,55,50,5,55
Peterhead,102,5,13,11,12,47,42,5,50
East Fife,102,6,11,12,13,53,54,-1,45
Queen's Park,102,7,12,8,16,38,53,-15,44
Albion,102,8,10,12,14,53,59,-6,42
Stranraer,102,9,12,4,20,53,68,-15,40
Stenhousem'r,102,10,5,11,20,41,85,-44,26
Alloa,103,1,23,7,6,84,45,39,76
Livingston,103,2,18,9,9,69,49,20,63
Queen's Park,103,3,17,7,12,43,39,4,58
Brechin,103,4,16,5,15,49,49,0,53
Airdrieon,103,5,13,10,13,50,49,1,49
Peterhead,103,6,14,5,17,41,51,-10,47
East Fife,103,7,10,10,16,48,60,-12,40
Stranraer,103,8,11,6,19,43,52,-9,39
Albion,103,9,9,11,16,53,64,-11,38
Stenhousem'r,103,10,10,8,18,50,72,-22,38
Livingston,104,1,21,5,10,87,49,38,68
Alloa,104,2,19,5,12,68,51,17,62
Airdrieon,104,3,19,5,12,63,57,6,62
Albion,104,4,18,7,11,65,51,14,61
Brechin,104,5,16,4,16,51,46,5,52
Peterhead,104,6,13,9,14,58,56,2,48
East Fife,104,7,11,9,16,52,58,-6,42
Queen's Park,104,8,12,6,18,37,55,-18,42
Stenhousem'r,104,9,10,8,18,54,84,-30,38
Stranraer,104,10,8,8,20,41,69,-28,32
Brechin,105,1,25,4,7,61,39,22,79
Livingston,105,2,22,2,12,77,47,30,68
Airdrieon,105,3,18,5,13,63,55,8,59
Alloa,105,4,16,9,11,64,44,20,57
Albion,105,5,13,10,13,51,52,-1,49
Peterhead,105,6,13,6,17,51,57,-6,45
East Fife,105,7,11,10,15,54,52,2,43
Stranraer,105,8,12,6,18,51,57,-6,42
Queen's Park,105,9,11,7,18,44,59,-15,40
Stenhousem'r,105,10,7,5,24,41,95,-54,26
Alloa,106,1,19,10,7,65,34,31,67
Livingston,106,2,19,3,14,75,53,22,60
Brechin,106,3,16,6,14,48,41,7,54
Airdrieon,106,4,15,9,12,50,44,6,54
Albion,106,5,14,10,12,52,48,4,52
Peterhead,106,6,14,9,13,52,57,-5,51
East Fife,106,7,14,8,14,51,42,9,50
Stranraer,106,8,13,6,17,48,61,-13,45
Queen's Park,106,9,10,8,18,40,68,-28,38
Stenhousem'r,106,10,8,7,21,47,80,-33,31
Livingston,107,1,20,6,10,74,47,27,66
Airdrieon,107,2,19,7,10,71,50,21,64
Alloa,107,3,19,6,11,72,46,26,63
Brechin,107,4,16,7,13,58,62,-4,55
Peterhead,107,5,12,14,10,46,45,1,50
Stranraer,107,6,14,6,16,53,54,-1,48
Albion,107,7,13,7,16,56,58,-2,46
Queen's Park,107,8,13,7,16,33,51,-18,46
East Fife,107,9,7,12,17,43,51,-8,33
Stenhousem'r,107,10,7,8,21,42,84,-42,29
Livingston,108,1,23,1,12,81,47,34,70
Airdrieon,108,2,22,4,10,70,53,17,70
Alloa,108,3,21,5,10,68,44,24,68
Stranraer,108,4,16,2,18,64,60,4,50
Brechin,108,5,15,5,16,44,48,-4,50
Queen's Park,108,6,14,5,17,33,50,-17,47
Albion,108,7,13,7,16,50,52,-2,46
East Fife,108,8,12,9,15,52,53,-1,45
Peterhead,108,9,12,5,19,46,63,-17,41
Stenhousem'r,108,10,8,5,23,43,81,-38,29
Alloa,109,1,20,9,7,65,31,34,69
Livingston,109,2,19,8,9,72,42,30,65
Brechin,109,3,17,6,13,45,40,5,57
Airdrieon,109,4,15,9,12,58,56,2,54
Stranraer,109,5,13,10,13,50,50,0,49
Peterhead,109,6,14,7,15,46,51,-5,49
Albion,109,7,12,10,14,46,47,-1,46
Queen's Park,109,8,14,4,18,37,52,-15,46
East Fife,109,9,8,10,18,47,64,-17,34
Stenhousem'r,109,10,7,9,20,42,75,-33,30
Livingston,110,1,21,7,8,76,41,35,70
Alloa,110,2,16,12,8,63,41,22,60
Peterhead,110,3,17,7,12,57,49,8,58
Brechin,110,4,16,4,16,52,59,-7,52
Airdrieon,110,5,14,8,14,52,60,-8,50
Queen's Park,110,6,14,7,15,48,51,-3,49
Albion,110,7,13,9,14,52,52,0,48
Stranraer,110,8,14,5,17,52,57,-5,47
East Fife,110,9,10,13,13,52,53,-1,43
Stenhousem'r,110,10,3,12,21,45,86,-41,21
Alloa,111,1,21,6,9,83,43,40,69
Queen's Park,111,2,17,6,13,42,43,-1,57
Livingston,111,3,16,6,14,70,51,19,54
Airdrieon,111,4,17,3,16,64,67,-3,54
East Fife,111,5,16,5,15,61,54,7,53
Brechin,111,6,15,6,15,45,49,-4,51
Peterhead,111,7,14,6,16,51,55,-4,48
Stranraer,111,8,13,6,17,54,60,-6,45
Albion,111,9,11,9,16,47,60,-13,42
Stenhousem'r,111,10,10,7,19,45,80,-35,37
Alloa,112,1,20,6,10,81,52,29,66
Livingston,112,2,19,8,9,72,40,32,65
Peterhead,112,3,18,5,13,54,53,1,59
Brechin,112,4,17,8,11,48,48,0,59
Airdrieon,112,5,15,9,12,60,54,6,54
Albion,112,6,14,9,13,49,52,-3,51
East Fife,112,7,11,9,16,52,52,0,42
Queen's Park,112,8,10,8,18,32,55,-23,38
Stranraer,112,9,10,6,20,45,56,-11,36
Stenhousem'r,112,10,8,8,20,47,78,-31,32
Livingston,113,1,24,3,9,80,39,41,75
Albion,113,2,17,7,12,56,47,9,58
Airdrieon,113,3,17,6,13,52,52,0,57
Alloa,113,4,16,7,13,60,54,6,55
Stranraer,113,5,15,8,13,54,53,1,53
Brechin,113,6,16,4,16,45,49,-4,52
Peterhead,113,7,13,7,16,48,51,-3,46
East Fife,113,8,11,12,13,46,41,5,45
Queen's Park,113,9,13,6,17,34,44,-10,45
Stenhousem'r,113,10,4,8,24,39,84,-45,20
Alloa,114,1,19,8,9,71,42,29,65
Livingston,114,2,20,4,12,69,47,22,64
Airdrieon,114,3,18,8,10,55,49,6,62
Brechin,114,4,15,10,11,41,34,7,55
Albion,114,5,14,8,14,50,44,6,50
Peterhead,114,6,14,8,14,47,47,0,50
Stranraer,114,7,13,6,17,49,61,-12,45
East Fife,114,8,11,9,16,46,44,2,42
Queen's Park,114,9,10,11,15,34,50,-16,41
Stenhousem'r,114,10,7,6,23,39,83,-44,27
Livingston,115,1,21,4,11,70,48,22,67
Alloa,115,2,19,8,9,72,41,31,65
Airdrieon,115,3,19,5,12,67,56,11,62
Brechin,115,4,16,7,13,53,47,6,55
Peterhead,115,5,14,7,15,46,48,-2,49
Queen's Park,115,6,14,7,15,35,49,-14,49
East Fife,115,7,11,11,14,52,48,4,44
Stranraer,115,8,13,3,20,47,60,-13,42
Albion,115,9,10,11,15,46,57,-11,41
Stenhousem'r,115,10,7,9,20,44,78,-34,30
Livingston,116,1,22,4,10,81,45,36,70
Alloa,116,2,15,10,11,62,48,14,55
Albion,116,3,15,10,11,60,51,9,55
Airdrieon,116,4,16,7,13,56,63,-7,55
Stranraer,116,5,15,6,15,55,53,2,51
East Fife,116,6,11,13,12,55,44,11,46
Peterhead,116,7,12,10,14,46,53,-7,46
Brechin,116,8,12,8,16,46,52,-6,44
Queen's Park,116,9,12,8,16,31,52,-21,44
Stenhousem'r,116,10,7,10,19,51,82,-31,31
Livingston,117,1,21,4,11,71,45,26,67
Airdrieon,117,2,20,7,9,63,50,13,67
Alloa,117,3,19,9,8,67,37,30,66
Albion,117,4,15,8,13,48,48,0,53
Queen's Park,117,5,14,5,17,46,53,-7,47
Brechin,117,6,14,4,18,44,58,-14,46
Stranraer,117,7,13,6,17,56,59,-3,45
Peterhead,117,8,11,8,17,45,51,-6,41
East Fife,117,9,10,8,18,41,53,-12,38
Stenhousem'r,117,10,10,7,19,45,72,-27,37
Livingston,118,1,22,3,11,75,49,26,69
Alloa,118,2,20,8,8,68,36,32,68
Brechin,118,3,19,5,12,52,50,2,62
Airdrieon,118,4,16,7,13,56,52,4,55
Queen's Park,118,5,15,7,14,49,48,1,52
East Fife,118,6,13,8,15,50,49,1,47
Peterhead,118,7,13,7,16,46,48,-2,46
Albion,118,8,12,8,16,49,50,-1,44
Stranraer,118,9,11,6,19,48,65,-17,39
Stenhousem'r,118,10,6,7,23,41,87,-46,25
Livingston,119,1,21,6,9,74,48,26,69
Airdrieon,119,2,15,10,11,60,58,2,55
Brechin,119,3,15,8,13,52,50,2,53
Alloa,119,4,15,7,14,59,46,13,52
Stranraer,119,5,15,5,16,52,61,-9,50
Queen's Park,119,6,14,7,15,45,49,-4,49
Peterhead,119,7,13,7,16,50,58,-8,46
Albion,119,8,11,12,13,48,49,-1,45
East Fife,119,9,11,10,15,44,46,-2,43
Stenhousem'r,119,10,11,6,19,58,77,-19,39
Alloa,120,1,22,9,5,74,39,35,75
Livingston,120,2,17,6,13,68,56,12,57
Airdrieon,120,3,16,8,12,51,48,3,56
Peterhead,120,4,15,11,10,48,45,3,56
Albion,120,5,14,7,15,57,55,2,49
Brechin,120,6,13,7,16,42,49,-7,46
Queen's Park,120,7,11,10,15,43,52,-9,43
East Fife,120,8,10,9,17,43,51,-8,39
Stranraer,120,9,11,6,19,47,59,-12,39
Stenhousem'r,120,10,10,9,17,51,70,-19,39
Livingston,121,1,19,8,9,74,50,24,65
Stranraer,121,2,19,4,13,71,53,18,61
Airdrieon,121,3,19,4,13,63,60,3,61
Albion,121,4,16,6,14,54,55,-1,54
Alloa,121,5,15,8,13,65,55,10,53
Brechin,121,6,14,8,14,52,53,-1,50
Peterhead,121,7,14,4,18,51,58,-7,46
Queen's Park,121,8,11,11,14,45,55,-10,44
East Fife,121,9,12,7,17,53,57,-4,43
Stenhousem'r,121,10,8,6,22,52,84,-32,30
Livingston,122,1,25,2,9,82,46,36,77
Alloa,122,2,21,7,8,83,43,40,70
Airdrieon,122,3,20,7,9,68,52,16,67
Peterhead,122,4,14,10,12,51,51,0,52
Brechin,122,5,13,7,16,50,60,-10,46
Albion,122,6,11,12,13,52,56,-4,45
Stranraer,122,7,12,7,17,51,56,-5,43
East Fife,122,8,8,14,14,47,52,-5,38
Queen's Park,122,9,9,6,21,30,58,-28,33
Stenhousem'r,122,10,6,10,20,37,77,-40,28
Alloa,123,1,22,6,8,73,40,33,72
Airdrieon,123,2,19,7,10,64,47,17,64
Livingston,123,3,19,5,12,76,58,18,62
Brechin,123,4,16,8,12,52,45,7,56
Queen's Park,123,5,15,6,15,39,50,-11,51
Albion,123,6,11,13,12,48,43,5,46
Stranraer,123,7,13,6,17,51,59,-8,45
Peterhead,123,8,12,9,15,44,58,-14,45
East Fife,123,9,7,9,20,40,52,-12,30
Stenhousem'r,123,10,6,11,19,48,83,-35,29
Airdrieon,124,1,19,5,12,67,61,6,62
Livingston,124,2,19,3,14,79,55,24,60
Brechin,124,3,16,11,9,50,42,8,59
Alloa,124,4,13,13,10,62,52,10,52
Albion,124,5,13,11,12,63,48,15,50
Stranraer,124,6,14,7,15,50,56,-6,49
Peterhead,124,7,13,5,18,49,61,-12,44
Queen's Park,124,8,12,7,17,34,48,-14,43
Stenhousem'r,124,9,11,8,17,44,70,-26,41
East Fife,124,10,9,12,15,45,50,-5,39
Livingston,125,1,24,5,7,77,40,37,77
Stranraer,125,2,17,5,14,55,54,1,56
Airdrieon,125,3,16,6,14,56,56,0,54
Queen's Park,125,4,16,6,14,41,45,-4,54
Alloa,125,5,14,11,11,70,50,20,53
Brechin,125,6,14,7,15,50,57,-7,49
East Fife,125,7,14,6,16,56,46,10,48
Peterhead,125,8,13,5,18,53,65,-12,44
Albion,125,9,12,7,17,48,59,-11,43
Stenhousem'r,125,10,7,8,21,47,81,-34,29
Livingston,126,1,24,3,9,79,45,34,75
Alloa,126,2,16,11,9,62,43,19,59
Airdrieon,126,3,17,8,11,59,48,11,59
Albion,126,4,15,10,11,52,51,1,55
East Fife,126,5,14,11,11,55,43,12,53
Brechin,126,6,14,7,15,45,55,-10,49
Peterhead,126,7,13,8,15,47,53,-6,47
Stranraer,126,8,14,4,18,53,59,-6,46
Queen's Park,126,9,8,7,21,32,55,-23,31
Stenhousem'r,126,10,6,9,21,43,75,-32,27
Livingston,127,1,23,4,9,79,47,32,73
Alloa,127,2,18,10,8,69,43,26,64
Airdrieon,127,3,19,7,10,52,43,9,64
Peterhead,127,4,14,11,11,50,50,0,53
Queen's Park,127,5,14,7,15,36,47,-11,49
Albion,127,6,14,5,17,54,54,0,47
Brechin,127,7,13,5,18,45,62,-17,44
Stranraer,127,8,12,4,20,51,61,-10,40
East Fife,127,9,9,12,15,52,52,0,39
Stenhousem'r,127,10,9,5,22,48,77,-29,32
Airdrieon,128,1,19,7,10,65,56,9,64
Alloa,128,2,19,6,11,72,43,29,63
Albion,128,3,18,9,9,59,47,12,63
Livingston,128,4,17,6,13,78,57,21,57
Brechin,128,5,15,5,16,50,57,-7,50
Peterhead,128,6,13,9,14,50,49,1,48
Queen's Park,128,7,14,5,17,39,53,-14,47
Stranraer,128,8,10,11,15,53,56,-3,41
East Fife,128,9,10,9,17,44,51,-7,39
Stenhousem'r,128,10,7,9,20,46,87,-41,30
Livingston,129,1,22,6,8,80,45,35,72
Airdrieon,129,2,20,8,8,68,46,22,68
Alloa,129,3,16,10,10,66,50,16,58
Albion,129,4,15,10,11,59,49,10,55
Peterhead,129,5,12,12,12,47,53,-6,48
East Fife,129,6,12,10,14,43,48,-5,46
Queen's Park,129,7,13,7,16,31,44,-13,46
Brechin,129,8,12,6,18,49,56,-7,42
Stranraer,129,9,11,6,19,45,63,-18,39
Stenhousem'r,129,10,6,7,23,46,80,-34,25
Livingston,130,1,24,4,8,79,42,37,76
Brechin,130,2,18,8,10,57,42,15,62
Alloa,130,3,17,9,10,69,46,23,60
Albion,130,4,16,6,14,61,60,1,54
Peterhead,130,5,15,5,16,49,53,-4,50
Airdrieon,130,6,13,5,18,49,59,-10,44
East Fife,130,7,11,10,15,50,54,-4,43
Stranraer,130,8,12,5,19,44,61,-17,41
Queen's Park,130,9,11,8,17,33,54,-21,41
Stenhousem'r,130,10,9,8,19,51,71,-20,35
Livingston,131,1,23,7,6,76,39,37,76
Alloa,131,2,23,6,7,76,37,39,75
Brechin,131,3,18,5,13,48,50,-2,59
Albion,131,4,16,5,15,59,55,4,53
Queen's Park,131,5,14,6,16,43,58,-15,48
Airdrieon,131,6,14,3,19,55,68,-13,45
Peterhead,131,7,10,11,15,52,52,0,41
Stranraer,131,8,12,5,19,48,59,-11,41
East Fife,131,9,9,11,16,41,48,-7,38
Stenhousem'r,131,10,9,5,22,46,78,-32,32
Livingston,132,1,22,1,13,77,55,22,67
Peterhead,132,2,19,6,11,51,43,8,63
Alloa,132,3,18,8,10,77,45,32,62
Albion,132,4,18,6,12,56,43,13,60
Airdrieon,132,5,16,5,15,61,63,-2,53
Stranraer,132,6,16,4,16,59,55,4,52
Queen's Park,132,7,15,6,15,45,60,-15,51
Brechin,132,8,14,6,16,49,51,-2,48
Stenhousem'r,132,9,9,3,24,44,89,-45,30
East Fife,132,10,8,5,23,35,50,-15,29
Livingston,133,1,24,2,10,84,43,41,74
Brechin,133,2,21,2,13,61,48,13,65
Alloa,133,3,17,7,12,68,52,16,58
Airdrieon,133,4,17,7,12,60,56,4,58
Albion,133,5,16,7,13,58,53,5,55
Peterhead,133,6,14,8,14,50,58,-8,50
East Fife,133,7,11,8,17,42,50,-8,41
Queen's Park,133,8,12,4,20,38,51,-13,40
Stranraer,133,9,11,3,22,46,70,-24,36
Stenhousem'r,133,10,10,6,20,62,88,-26,36
Livingston,134,1,24,3,9,78,48,30,75
Albion,134,2,21,4,11,70,51,19,67
Alloa,134,3,15,11,10,66,48,18,56
Airdrieon,134,4,17,5,14,60,56,4,56
Queen's Park,134,5,15,7,14,48,54,-6,52
Stranraer,134,6,15,5,16,54,59,-5,50
Peterhead,134,7,13,7,16,54,59,-5,46
East Fife,134,8,11,9,16,45,55,-10,42
Brechin,134,9,10,7,19,43,56,-13,37
Stenhousem'r,134,10,7,6,23,48,80,-32,27
Livingston,135,1,20,6,10,72,47,25,66
Alloa,135,2,17,9,10,68,44,24,60
Brechin,135,3,18,5,13,47,40,7,59
Airdrieon,135,4,17,6,13,64,54,10,57
Peterhead,135,5,15,9,12,49,44,5,54
Albion,135,6,14,9,13,56,52,4,51
East Fife,135,7,14,8,14,56,47,9,50
Stranraer,135,8,10,6,20,51,71,-20,36
Queen's Park,135,9,9,9,18,30,56,-26,36
Stenhousem'r,135,10,8,9,19,52,90,-38,33
Livingston,136,1,21,6,9,78,40,38,69
Alloa,136,2,20,7,9,76,48,28,67
Airdrieon,136,3,15,10,11,61,52,9,55
Brechin,136,4,16,5,15,50,50,0,53
Albion,136,5,13,10,13,46,51,-5,49
East Fife,136,6,13,9,14,52,48,4,48
Peterhead,136,7,12,11,13,51,55,-4,47
Queen's Park,136,8,12,8,16,42,60,-18,44
Stranraer,136,9,12,6,18,47,57,-10,42
Stenhousem'r,136,10,6,8,22,42,84,-42,26
Livingston,137,1,25,2,9,86,42,44,77
Alloa,137,2,18,7,11,66,49,17,61
Airdrieon,137,3,18,5,13,63,60,3,59
Albion,137,4,15,9,12,54,51,3,54
Brechin,137,5,15,9,12,57,55,2,54
Peterhead,137,6,14,7,15,55,58,-3,49
East Fife,137,7,11,13,12,59,49,10,46
Queen's Park,137,8,12,7,17,42,57,-15,43
Stranraer,137,9,8,6,22,42,68,-26,30
Stenhousem'r,137,10,7,9,20,41,76,-35,30
Stranraer,138,1,20,2,14,61,51,10,62
Livingston,138,2,18,6,12,70,51,19,60
Alloa,138,3,17,9,10,65,46,19,60
Brechin,138,4,15,10,11,54,48,6,55
Stenhousem'r,138,5,14,6,16,57,71,-14,48
East Fife,138,6,14,5,17,51,53,-2,47
Airdrieon,138,7,13,8,15,50,55,-5,47
Peterhead,138,8,13,7,16,59,66,-7,46
Albion,138,9,11,8,17,49,57,-8,41
Queen's Park,138,10,10,9,17,39,57,-18,39
Alloa,139,1,23,4,9,69,34,35,73
Livingston,139,2,21,4,11,78,51,27,67
Albion,139,3,19,8,9,70,48,22,65
Airdrieon,139,4,18,7,11,58,48,10,61
Peterhead,139,5,14,7,15,49,52,-3,49
Queen's Park,139,6,14,7,15,34,50,-16,49
Brechin,139,7,12,5,19,48,61,-13,41
Stranraer,139,8,12,3,21,49,58,-9,39
East Fife,139,9,11,6,19,50,60,-10,39
Stenhousem'r,139,10,7,7,22,44,87,-43,28
Livingston,140,1,23,5,8,81,39,42,74
Stranraer,140,2,17,7,12,61,59,2,58
Alloa,140,3,16,9,11,73,46,27,57
Albion,140,4,15,12,9,49,39,10,57
Peterhead,140,5,14,11,11,55,52,3,53
Brechin,140,6,14,9,13,44,44,0,51
Airdrieon,140,7,12,9,15,51,60,-9,45
Queen's Park,140,8,12,5,19,29,54,-25,41
East Fife,140,9,7,11,18,44,53,-9,32
Stenhousem'r,140,10,7,8,21,45,86,-41,29
Airdrieon,141,1,18,7,11,65,41,24,61
Peterhead,141,2,17,9,10,59,50,9,60
Livingston,141,3,17,6,13,67,54,13,57
Alloa,141,4,15,12,9,72,60,12,57
Albion,141,5,16,5,15,56,56,0,53
Queen's Park,141,6,15,7,14,41,45,-4,52
Brechin,141,7,15,3,18,42,42,0,48
Stranraer,141,8,12,6,18,46,58,-12,42
East Fife,141,9,9,12,15,48,54,-6,39
Stenhousem'r,141,10,9,7,20,49,85,-36,34
Livingston,142,1,19,5,12,70,53,17,62
Brechin,142,2,17,10,9,52,41,11,61
Airdrieon,142,3,17,8,11,67,55,12,59
Alloa,142,4,16,9,11,64,44,20,57
Albion,142,5,14,12,10,54,48,6,54
Queen's Park,142,6,13,9,14,40,45,-5,48
Stranraer,142,7,11,9,16,52,64,-12,42
East Fife,142,8,10,10,16,50,54,-4,40
Peterhead,142,9,11,7,18,37,57,-20,40
Stenhousem'r,142,10,8,9,19,48,73,-25,33
Livingston,143,1,23,6,7,74,40,34,75
Brechin,143,2,20,7,9,55,37,18,67
Alloa,143,3,16,9,11,70,51,19,57
Airdrieon,143,4,16,5,15,57,52,5,53
Peterhead,143,5,14,7,15,49,57,-8,49
East Fife,143,6,13,9,14,49,55,-6,48
Queen's Park,143,7,12,8,16,40,55,-15,44
Stranraer,143,8,12,7,17,53,54,-1,43
Albion,143,9,11,6,19,44,58,-14,39
Stenhousem'r,143,10,8,6,22,40,72,-32,30
Livingston,144,1,23,4,9,77,43,34,73
Airdrieon,144,2,16,8,12,50,52,-2,56
Alloa,144,3,15,10,11,66,48,18,55
Peterhead,144,4,14,9,13,48,50,-2,51
Queen's Park,144,5,14,7,15,36,51,-15,49
East Fife,144,6,14,6,16,51,48,3,48
Albion,144,7,12,10,14,50,49,1,46
Brechin,144,8,12,8,16,42,52,-10,44
Stranraer,144,9,12,7,17,47,52,-5,43
Stenhousem'r,144,10,9,9,18,54,76,-22,36
Alloa,145,1,21,5,10,65,35,30,68
Livingston,145,2,18,9,9,75,48,27,63
Airdrieon,145,3,17,8,11,68,61,7,59
Peterhead,145,4,15,9,12,49,48,1,54
Albion,145,5,13,10,13,49,50,-1,49
East Fife,145,6,12,12,12,56,45,11,48
Brechin,145,7,14,5,17,46,63,-17,47
Stranraer,145,8,14,4,18,51,64,-13,46
Queen's Park,145,9,10,11,15,35,51,-16,41
Stenhousem'r,145,10,7,5,24,48,77,-29,26
Alloa,146,1,21,7,8,68,38,30,70
Livingston,146,2,20,5,11,77,48,29,65
Airdrieon,146,3,17,9,10,63,55,8,60
Brechin,146,4,16,9,11,56,46,10,57
Albion,146,5,12,12,12,45,46,-1,48
Stranraer,146,6,14,6,16,50,52,-2,48
East Fife,146,7,12,10,14,48,51,-3,46
Queen's Park,146,8,11,7,18,35,51,-16,40
Peterhead,146,9,9,9,18,36,53,-17,36
Stenhousem'r,146,10,9,4,23,49,87,-38,31
Alloa,147,1,20,7,9,69,41,28,67
Livingston,147,2,18,9,9,69,44,25,63
Airdrieon,147,3,16,9,11,57,51,6,57
Queen's Park,147,4,15,8,13,39,41,-2,53
Albion,147,5,14,10,12,52,46,6,52
Brechin,147,6,15,5,16,44,48,-4,50
Peterhead,147,7,12,7,17,44,57,-13,43
Stranraer,147,8,12,5,19,52,67,-15,41
East Fife,147,9,10,10,16,42,50,-8,40
Stenhousem'r,147,10,8,10,18,42,65,-23,34
Livingston,148,1,26,1,9,91,52,39,79
Airdrieon,148,2,18,8,10,55,54,1,62
Alloa,148,3,18,7,11,63,45,18,61
Brechin,148,4,16,6,14,52,44,8,54
East Fife,148,5,15,8,13,49,48,1,53
Albion,148,6,15,6,15,56,49,7,51
Peterhead,148,7,11,7,18,45,53,-8,40
Queen's Park,148,8,10,8,18,34,56,-22,38
Stranraer,148,9,11,3,22,41,62,-21,36
Stenhousem'r,148,10,10,6,20,51,74,-23,36
Alloa,149,1,20,7,9,78,42,36,67
Livingston,149,2,20,5,11,68,48,20,65
Brechin,149,3,16,7,13,52,55,-3,55
Airdrieon,149,4,16,6,14,54,48,6,54
Queen's Park,149,5,14,8,14,42,50,-8,50
East Fife,149,6,12,10,14,51,51,0,46
Albion,149,7,12,8,16,55,56,-1,44
Peterhead,149,8,11,11,14,47,52,-5,44
Stranraer,149,9,12,5,19,44,62,-18,41
Stenhousem'r,149,10,9,9,18,49,76,-27,36
Livingston,150,1,21,3,12,78,52,26,66
Alloa,150,2,18,10,8,66,41,25,64
Airdrieon,150,3,19,6,11,67,55,12,63
Brechin,150,4,15,8,13,50,56,-6,53
Albion,150,5,13,13,10,53,46,7,52
East Fife,150,6,12,9,15,54,60,-6,45
Peterhead,150,7,11,11,14,43,48,-5,44
Queen's Park,150,8,11,8,17,44,55,-11,41
Stranraer,150,9,11,7,18,46,58,-12,40
Stenhousem'r,150,10,6,11,19,48,78,-30,29
Livingston,151,1,23,4,9,68,39,29,73
Albion,151,2,22,3,11,69,47,22,69
Alloa,151,3,18,8,10,75,47,28,62
Airdrieon,151,4,18,8,10,52,43,9,62
Brechin,151,5,16,7,13,57,50,7,55
Peterhead,151,6,12,8,16,52,56,-4,44
Stranraer,151,7,11,10,15,53,61,-8,43
East Fife,151,8,9,11,16,47,52,-5,38
Queen's Park,151,9,10,7,19,38,64,-26,37
Stenhousem'r,151,10,5,6,25,40,92,-52,21
Livingston,152,1,24,3,9,70,39,31,75
Alloa,152,2,20,9,7,68,40,28,69
Brechin,152,3,15,9,12,46,43,3,54
Airdrieon,152,4,14,7,15,56,54,2,49
Peterhead,152,5,13,7,16,45,45,0,46
Stranraer,152,6,14,4,18,50,61,-11,46
Queen's Park,152,7,13,6,17,29,48,-19,45
East Fife,152,8,10,11,15,40,41,-1,41
Stenhousem'r,152,9,10,11,15,49,74,-25,41
Albion,152,10,11,5,20,44,52,-8,38
Livingston,153,1,21,8,7,88,41,47,71
Alloa,153,2,21,6,9,76,46,30,69
Airdrieon,153,3,18,8,10,68,58,10,62
East Fife,153,4,13,11,12,51,44,7,50
Brechin,153,5,15,5,16,52,50,2,50
Peterhead,153,6,13,11,12,43,44,-1,50
Queen's Park,153,7,12,7,17,33,50,-17,43
Albion,153,8,12,6,18,51,62,-11,42
Stranraer,153,9,11,5,20,44,65,-21,38
Stenhousem'r,153,10,7,7,22,47,93,-46,28
Airdrieon,154,1,21,7,8,64,56,8,70
Livingston,154,2,21,6,9,69,40,29,69
Alloa,154,3,19,8,9,74,44,30,65
Brechin,154,4,19,6,11,53,42,11,63
Albion,154,5,13,10,13,55,55,0,49
Peterhead,154,6,13,7,16,52,50,2,46
Stranraer,154,7,14,4,18,42,58,-16,46
East Fife,154,8,10,8,18,49,51,-2,38
Queen's Park,154,9,9,5,22,27,54,-27,32
Stenhousem'r,154,10,6,9,21,47,82,-35,27
Alloa,155,1,20,9,7,74,33,41,69
Livingston,155,2,21,4,11,76,52,24,67
Brechin,155,3,17,7,12,48,44,4,58
Airdrieon,155,4,16,8,12,57,61,-4,56
Albion,155,5,14,10,12,58,56,2,52
Queen's Park,155,6,13,8,15,44,52,-8,47
East Fife,155,7,11,11,14,58,57,1,44
Stranraer,155,8,10,8,18,48,63,-15,38
Peterhead,155,9,9,8,19,41,59,-18,35
Stenhousem'r,155,10,7,11,18,47,74,-27,32
Livingston,156,1,23,3,10,81,43,38,72
Brechin,156,2,19,7,10,56,45,11,64
Alloa,156,3,16,11,9,63,43,20,59
Airdrieon,156,4,15,10,11,56,49,7,55
Peterhead,156,5,14,9,13,50,51,-1,51
Queen's Park,156,6,13,10,13,41,53,-12,49
Albion,156,7,12,7,17,53,56,-3,43
East Fife,156,8,11,8,17,49,46,3,41
Stranraer,156,9,8,9,19,41,64,-23,33
Stenhousem'r,156,10,8,8,20,47,87,-40,32
Livingston,157,1,22,4,10,75,43,32,70
Brechin,157,2,19,8,9,52,38,14,65
Alloa,157,3,17,7,12,67,54,13,58
Peterhead,157,4,17,6,13,52,47,5,57
Airdrieon,157,5,16,7,13,53,51,2,55
Queen's Park,157,6,14,7,15,42,43,-1,49
East Fife,157,7,11,9,16,45,49,-4,42
Albion,157,8,11,8,17,51,70,-19,41
Stranraer,157,9,11,5,20,53,66,-13,38
Stenhousem'r,157,10,7,9,20,43,72,-29,30
Livingston,158,1,22,5,9,81,52,29,71
Alloa,158,2,17,13,6,70,45,25,64
Airdrieon,158,3,16,9,11,64,60,4,57
Brechin,158,4,14,7,15,47,52,-5,49
Peterhead,158,5,13,9,14,50,52,-2,48
Albion,158,6,12,11,13,56,57,-1,47
East Fife,158,7,12,9,15,50,50,0,45
Stranraer,158,8,13,6,17,49,59,-10,45
Queen's Park,158,9,13,4,19,40,51,-11,43
Stenhousem'r,158,10,7,9,20,50,79,-29,30
Livingston,159,1,25,2,9,83,44,39,77
Brechin,159,2,20,7,9,58,40,18,67
Alloa,159,3,19,7,10,69,44,25,64
Peterhead,159,4,19,5,12,53,46,7,62
Airdrieon,159,5,17,7,12,61,57,4,58
Albion,159,6,13,5,18,49,62,-13,44
East Fife,159,7,11,9,16,47,51,-4,42
Stranraer,159,8,10,6,20,46,57,-11,36
Queen's Park,159,9,8,7,21,23,55,-32,31
Stenhousem'r,159,10,7,7,22,44,77,-33,28
Livingston,160,1,21,3,12,81,50,31,66
Alloa,160,2,18,7,11,73,49,24,61
Albion,160,3,18,7,11,62,50,12,61
Peterhead,160,4,18,6,12,56,51,5,60
Airdrieon,160,5,17,7,12,52,45,7,58
Brechin,160,6,15,7,14,50,51,-1,52
East Fife,160,7,12,9,15,38,45,-7,45
Queen's Park,160,8,12,7,17,33,54,-21,43
Stranraer,160,9,12,4,20,51,60,-9,40
Stenhousem'r,160,10,5,7,24,42,83,-41,22
Livingston,161,1,23,4,9,81,45,36,73
Alloa,161,2,21,6,9,75,42,33,69
Peterhead,161,3,18,7,11,55,48,7,61
Airdrieon,161,4,17,8,11,63,51,12,59
Stranraer,161,5,15,6,15,49,56,-7,51
Albion,161,6,13,10,13,54,51,3,49
Brechin,161,7,13,7,16,47,56,-9,46
Queen's Park,161,8,9,9,18,28,54,-26,36
East Fife,161,9,8,10,18,48,57,-9,34
Stenhousem'r,161,10,6,7,23,44,84,-40,25
Livingston,162,1,21,7,8,75,46,29,70
Alloa,162,2,20,6,10,77,41,36,66
Airdrieon,162,3,17,5,14,65,70,-5,56
Peterhead,162,4,15,10,11,64,59,5,55
Brechin,162,5,16,7,13,55,53,2,55
East Fife,162,6,11,11,14,56,56,0,44
Queen's Park,162,7,11,10,15,39,53,-14,43
Stranraer,162,8,11,9,16,52,60,-8,42
Albion,162,9,10,10,16,49,63,-14,40
Stenhousem'r,162,10,6,9,21,56,87,-31,27
Livingston,163,1,20,7,9,71,47,24,67
Alloa,163,2,17,8,11,66,48,18,59
Airdrieon,163,3,17,8,11,63,56,7,59
Albion,163,4,14,9,13,56,52,4,51
Peterhead,163,5,13,12,11,53,56,-3,51
Queen's Park,163,6,14,7,15,46,52,-6,49
Stranraer,163,7,15,4,17,52,59,-7,49
East Fife,163,8,10,13,13,52,51,1,43
Brechin,163,9,10,11,15,49,57,-8,41
Stenhousem'r,163,10,6,9,21,42,72,-30,27
Livingston,164,1,23,3,10,64,45,19,72
Alloa,164,2,18,7,11,60,45,15,61
Brechin,164,3,16,6,14,49,46,3,54
Stranraer,164,4,16,5,15,53,45,8,53
Airdrieon,164,5,15,7,14,48,46,2,52
Albion,164,6,13,11,12,54,47,7,50
East Fife,164,7,12,10,14,53,51,2,46
Queen's Park,164,8,12,7,17,36,46,-10,43
Stenhousem'r,164,9,11,5,20,48,75,-27,38
Peterhead,164,10,9,9,18,48,67,-19,36
Alloa,165,1,22,9,5,76,31,45,75
Livingston,165,2,21,6,9,78,48,30,69
Brechin,165,3,15,9,12,60,56,4,54
Peterhead,165,4,14,6,16,45,58,-13,48
Stenhousem'r,165,5,12,9,15,58,71,-13,45
East Fife,165,6,11,10,15,44,46,-2,43
Airdrieon,165,7,12,7,17,50,59,-9,43
Queen's Park,165,8,12,7,17,37,50,-13,43
Stranraer,165,9,13,4,19,53,68,-15,43
Albion,165,10,10,9,17,50,64,-14,39
Alloa,166,1,20,6,10,75,49,26,66
Airdrieon,166,2,19,7,10,60,50,10,64
Albion,166,3,18,6,12,55,51,4,60
Livingston,166,4,17,4,15,78,54,24,55
Peterhead,166,5,13,12,11,52,51,1,51
Queen's Park,166,6,15,6,15,41,54,-13,51
Stranraer,166,7,15,4,17,53,51,2,49
Brechin,166,8,12,9,15,38,54,-16,45
East Fife,166,9,11,11,14,50,50,0,44
Stenhousem'r,166,10,4,7,25,36,74,-38,19
Airdrieon,167,1,21,7,8,71,54,17,70
Livingston,167,2,20,5,11,72,46,26,65
Alloa,167,3,17,10,9,81,55,26,61
East Fife,167,4,13,10,13,48,41,7,49
Queen's Park,167,5,14,7,15,41,48,-7,49
Stranraer,167,6,15,3,18,55,62,-7,48
Brechin,167,7,14,5,17,49,54,-5,47
Albion,167,8,12,10,14,49,57,-8,46
Peterhead,167,9,9,12,15,49,64,-15,39
Stenhousem'r,167,10,6,9,21,41,75,-34,27
Alloa,168,1,18,8,10,70,48,22,62
Brechin,168,2,17,8,11,60,51,9,59
Livingston,168,3,17,6,13,68,47,21,57
East Fife,168,4,15,10,11,47,36,11,55
Peterhead,168,5,16,6,14,56,56,0,54
Airdrieon,168,6,14,6,16,59,68,-9,48
Stranraer,168,7,13,7,16,53,61,-8,46
Albion,168,8,12,8,16,56,54,2,44
Queen's Park,168,9,11,10,15,39,52,-13,43
Stenhousem'r,168,10,8,9,19,45,80,-35,33
Livingston,169,1,20,9,7,77,44,33,69
Alloa,169,2,21,6,9,70,38,32,69
Queen's Park,169,3,16,10,10,46,48,-2,58
Brechin,169,4,16,5,15,44,44,0,53
Peterhead,169,5,13,11,12,60,53,7,50
Albion,169,6,12,12,12,56,50,6,48
Airdrieon,169,7,14,5,17,50,58,-8,47
Stranraer,169,8,12,6,18,49,62,-13,42
East Fife,169,9,10,7,19,51,58,-7,37
Stenhousem'r,169,10,6,9,21,45,93,-48,27
Livingston,170,1,21,4,11,78,51,27,67
Airdrieon,170,2,18,8,10,64,53,11,62
Alloa,170,3,15,13,8,67,48,19,58
Brechin,170,4,17,6,13,55,48,7,57
Stranraer,170,5,15,4,17,48,53,-5,49
East Fife,170,6,12,10,14,56,53,3,46
Peterhead,170,7,12,10,14,50,56,-6,46
Albion,170,8,12,8,16,49,55,-6,44
Queen's Park,170,9,10,8,18,36,52,-16,38
Stenhousem'r,170,10,9,7,20,46,80,-34,34
Livingston,171,1,21,8,7,78,44,34,71
Alloa,171,2,18,9,9,71,50,21,63
Brechin,171,3,17,10,9,52,40,12,61
Peterhead,171,4,16,8,12,49,46,3,56
Airdrieon,171,5,13,13,10,51,50,1,52
Albion,171,6,12,9,15,49,47,2,45
Stranraer,171,7,12,7,17,51,63,-12,43
Queen's Park,171,8,9,10,17,33,52,-19,37
Stenhousem'r,171,9,8,9,19,46,77,-31,33
East Fife,171,10,7,11,18,44,55,-11,32
Livingston,172,1,22,6,8,75,40,35,72
Airdrieon,172,2,22,4,10,67,48,19,70
Albion,172,3,19,6,11,55,49,6,63
Alloa,172,4,16,10,10,66,41,25,58
Peterhead,172,5,16,7,13,50,45,5,55
Brechin,172,6,16,7,13,54,51,3,55
Stranraer,172,7,12,6,18,57,68,-11,42
East Fife,172,8,9,11,16,48,51,-3,38
Queen's Park,172,9,8,7,21,23,49,-26,31
Stenhousem'r,172,10,4,8,24,39,92,-53,20
Alloa,173,1,20,8,8,91,49,42,68
Brechin,173,2,21,4,11,61,44,17,67
Livingston,173,3,19,6,11,68,49,19,63
Peterhead,173,4,15,7,14,55,54,1,52
Airdrieon,173,5,15,7,14,56,57,-1,52
Albion,173,6,13,8,15,50,53,-3,47
East Fife,173,7,10,13,13,49,49,0,43
Queen's Park,173,8,11,9,16,31,52,-21,42
Stenhousem'r,173,9,10,7,19,42,73,-31,37
Stranraer,173,10,9,5,22,41,64,-23,32
Alloa,174,1,22,5,9,83,40,43,71
Livingston,174,2,21,5,10,72,50,22,68
Albion,174,3,17,5,14,53,51,2,56
Brechin,174,3,16,8,12,53,51,2,56
Queen's Park,174,5,15,6,15,43,51,-8,51
Stranraer,174,6,13,6,17,45,53,-8,45
Airdrieon,174,7,12,7,17,54,65,-11,43
Peterhead,174,8,11,7,18,50,61,-11,40
East Fife,174,9,9,12,15,49,60,-11,39
Stenhousem'r,174,10,8,11,17,57,77,-20,35
Livingston,175,1,25,6,5,95,47,48,81
Alloa,175,2,20,7,9,82,47,35,67
Albion,175,3,17,8,11,70,49,21,59
Airdrieon,175,4,15,6,15,61,71,-10,51
Brechin,175,5,14,7,15,51,56,-5,49
Peterhead,175,6,13,9,14,52,59,-7,48
East Fife,175,7,13,6,17,54,56,-2,45
Queen's Park,175,8,12,8,16,44,55,-11,44
Stranraer,175,9,10,5,21,41,60,-19,35
Stenhousem'r,175,10,6,8,22,45,95,-50,26
Airdrieon,176,1,20,5,11,69,52,17,65
Livingston,176,2,19,7,10,78,48,30,64
Alloa,176,3,17,11,8,73,46,27,62
Brechin,176,4,18,5,13,62,53,9,59
East Fife,176,5,12,11,13,54,55,-1,47
Peterhead,176,6,11,11,14,50,57,-7,44
Queen's Park,176,7,12,8,16,36,45,-9,44
Stranraer,176,8,11,8,17,50,61,-11,41
Albion,176,9,9,11,16,52,67,-15,38
Stenhousem'r,176,10,8,9,19,41,81,-40,33
Alloa,177,1,22,7,7,73,41,32,73
Livingston,177,2,19,6,11,72,47,25,63
Brechin,177,3,16,11,9,56,49,7,59
Peterhead,177,4,18,5,13,54,48,6,59
Airdrieon,177,5,13,12,11,63,53,10,51
East Fife,177,6,13,11,12,50,43,7,50
Queen's Park,177,7,12,4,20,30,54,-24,40
Albion,177,8,10,9,17,51,64,-13,39
Stenhousem'r,177,9,9,9,18,51,76,-25,36
Stranraer,177,10,8,6,22,38,63,-25,30
Alloa,178,1,21,8,7,85,45,40,71
Livingston,178,2,22,2,12,76,49,27,68
Brechin,178,3,18,5,13,58,54,4,59
East Fife,178,4,12,12,12,52,43,9,48
Airdrieon,178,5,12,10,14,53,55,-2,46
Peterhead,178,6,12,10,14,53,59,-6,46
Albion,178,7,12,9,15,44,49,-5,45
Stranraer,178,8,13,3,20,47,66,-19,42
Queen's Park,178,9,12,6,18,36,57,-21,42
Stenhousem'r,178,10,9,9,18,51,78,-27,36
Airdrieon,179,1,19,8,9,67,52,15,65
Livingston,179,2,19,6,11,77,50,27,63
Alloa,179,3,17,10,9,68,52,16,61
Brechin,179,4,19,3,14,57,52,5,60
Albion,179,5,17,6,13,55,53,2,57
East Fife,179,6,11,11,14,46,44,2,44
Peterhead,179,7,11,10,15,53,62,-9,43
Stranraer,179,8,12,5,19,51,63,-12,41
Queen's Park,179,9,10,7,19,38,53,-15,37
Stenhousem'r,179,10,8,8,20,52,83,-31,32
Alloa,180,1,19,10,7,67,43,24,67
Livingston,180,2,21,2,13,77,51,26,65
Airdrieon,180,3,18,6,12,68,55,13,60
Brechin,180,4,17,9,10,57,44,13,60
Queen's Park,180,5,15,7,14,44,51,-7,52
Stranraer,180,6,14,3,19,50,60,-10,45
Albion,180,7,12,8,16,51,54,-3,44
East Fife,180,8,11,10,15,48,47,1,43
Peterhead,180,9,11,9,16,52,69,-17,42
Stenhousem'r,180,10,7,6,23,50,90,-40,27
Livingston,181,1,22,3,11,73,46,27,69
Airdrieon,181,2,19,7,10,70,54,16,64
Alloa,181,3,17,10,9,72,50,22,61
Albion,181,4,17,9,10,56,42,14,60
Peterhead,181,5,15,6,15,50,56,-6,51
East Fife,181,6,12,10,14,55,52,3,46
Brechin,181,7,14,4,18,53,55,-2,46
Queen's Park,181,8,13,4,19,30,49,-19,43
Stranraer,181,9,10,6,20,41,60,-19,36
Stenhousem'r,181,10,7,9,20,47,83,-36,30
Livingston,182,1,23,3,10,75,42,33,72
Airdrieon,182,2,17,8,11,61,52,9,59
Alloa,182,3,15,11,10,62,41,21,56
Albion,182,4,16,8,12,64,50,14,56
Brechin,182,5,16,5,15,48,54,-6,53
Peterhead,182,6,15,6,15,52,60,-8,51
East Fife,182,7,11,11,14,50,47,3,44
Stranraer,182,8,11,8,17,47,62,-15,41
Queen's Park,182,9,10,8,18,30,52,-22,38
Stenhousem'r,182,10,8,8,20,54,83,-29,32
Airdrieon,183,1,20,6,10,61,48,13,66
Alloa,183,2,18,7,11,61,41,20,61
Livingston,183,3,18,6,12,66,49,17,60
Peterhead,183,4,17,7,12,56,47,9,58
Brechin,183,5,16,5,15,43,43,0,53
East Fife,183,6,14,7,15,52,50,2,49
Albion,183,7,12,11,13,52,53,-1,47
Queen's Park,183,8,13,5,18,34,48,-14,44
Stranraer,183,9,11,7,18,47,61,-14,40
Stenhousem'r,183,10,7,7,22,44,76,-32,28
Livingston,184,1,21,5,10,71,42,29,68
Alloa,184,2,19,10,7,66,33,33,67
Airdrieon,184,3,15,10,11,52,50,2,55
Albion,184,4,15,9,12,48,52,-4,54
Peterhead,184,5,13,9,14,42,49,-7,48
East Fife,184,6,12,10,14,56,47,9,46
Brechin,184,7,13,7,16,44,43,1,46
Stranraer,184,8,11,8,17,53,69,-16,41
Queen's Park,184,9,10,10,16,36,52,-16,40
Stenhousem'r,184,10,8,8,20,52,83,-31,32
Alloa,185,1,22,8,6,76,39,37,74
Livingston,185,2,22,6,8,79,52,27,72
Brechin,185,3,18,4,14,60,53,7,58
Peterhead,185,4,16,6,14,54,63,-9,54
Albion,185,5,15,7,14,47,43,4,52
Airdrieon,185,6,15,5,16,61,64,-3,50
East Fife,185,7,10,13,13,53,49,4,43
Queen's Park,185,8,10,9,17,32,47,-15,39
Stranraer,185,9,10,2,24,47,66,-19,32
Stenhousem'r,185,10,8,8,20,44,77,-33,32
Alloa,186,1,22,5,9,71,38,33,71
Livingston,186,2,21,6,9,78,47,31,69
Brechin,186,3,18,5,13,53,49,4,59
Airdrieon,186,4,16,7,13,52,45,7,55
Queen's Park,186,5,14,9,13,44,44,0,51
Albion,186,6,12,11,13,48,54,-6,47
Peterhead,186,7,12,8,16,42,54,-12,44
Stranraer,186,8,10,6,20,40,58,-18,36
Stenhousem'r,186,9,10,6,20,51,81,-30,36
East Fife,186,10,8,11,17,46,55,-9,35
Livingston,187,1,24,5,7,83,48,35,77
Brechin,187,2,18,12,6,49,33,16,66
Alloa,187,3,16,11,9,71,49,22,59
Airdrieon,187,4,17,7,12,62,49,13,58
Albion,187,5,17,7,12,60,49,11,58
East Fife,187,6,13,9,14,45,44,1,48
Queen's Park,187,7,13,7,16,39,54,-15,46
Stranraer,187,8,11,6,19,48,60,-12,39
Peterhead,187,9,10,5,21,51,64,-13,35
Stenhousem'r,187,10,4,5,27,38,96,-58,17
Alloa,188,1,20,7,9,63,41,22,67
Livingston,188,2,19,4,13,62,43,19,61
Brechin,188,3,18,5,13,55,48,7,59
Airdrieon,188,4,15,11,10,53,50,3,56
Peterhead,188,5,16,7,13,59,57,2,55
Albion,188,6,15,8,13,46,45,1,53
East Fife,188,7,11,13,12,50,43,7,46
Queen's Park,188,8,12,5,19,31,49,-18,41
Stranraer,188,9,9,7,20,35,53,-18,34
Stenhousem'r,188,10,8,7,21,38,63,-25,31
Livingston,189,1,22,6,8,77,46,31,72
Alloa,189,2,20,7,9,65,39,26,67
Brechin,189,3,14,10,12,46,48,-2,52
East Fife,189,4,13,11,12,48,39,9,50
Queen's Park,189,5,13,10,13,45,50,-5,49
Stranraer,189,6,14,5,17,56,57,-1,47
Peterhead,189,7,12,10,14,50,50,0,46
Airdrieon,189,8,13,7,16,50,62,-12,46
Albion,189,9,10,9,17,46,55,-9,39
Stenhousem'r,189,10,9,5,22,35,72,-37,32
Livingston,190,1,22,2,12,73,46,27,68
Alloa,190,2,17,7,12,62,48,14,58
Airdrieon,190,3,17,6,13,60,44,16,57
Brechin,190,4,17,5,14,47,48,-1,56
Albion,190,5,15,8,13,54,54,0,53
East Fife,190,6,14,8,14,49,45,4,50
Peterhead,190,7,13,8,15,46,54,-8,47
Queen's Park,190,8,12,7,17,44,49,-5,43
Stranraer,190,9,12,6,18,50,65,-15,42
Stenhousem'r,190,10,8,9,19,45,77,-32,33
Livingston,191,1,21,5,10,76,43,33,68
Alloa,191,2,18,8,10,73,45,28,62
Airdrieon,191,3,18,7,11,59,53,6,61
Brechin,191,4,17,8,11,52,41,11,59
East Fife,191,5,13,10,13,52,46,6,49
Queen's Park,191,6,14,7,15,38,49,-11,49
Stranraer,191,7,14,4,18,49,56,-7,46
Albion,191,8,12,7,17,47,54,-7,43
Peterhead,191,9,9,9,18,41,62,-21,36
Stenhousem'r,191,10,6,11,19,45,83,-38,29
Alloa,192,1,21,6,9,68,37,31,69
Airdrieon,192,2,17,6,13,53,55,-2,57
Livingston,192,3,18,2,16,69,55,14,56
Brechin,192,4,16,6,14,58,51,7,54
Peterhead,192,5,15,9,12,52,47,5,54
Stranraer,192,6,15,4,17,55,61,-6,49
Stenhousem'r,192,7,13,8,15,47,59,-12,47
East Fife,192,8,12,6,18,47,53,-6,42
Albion,192,9,12,6,18,45,54,-9,42
Queen's Park,192,10,10,9,17,31,53,-22,39
Livingston,193,1,19,6,11,72,47,25,63
Brechin,193,2,18,5,13,63,55,8,59
Alloa,193,3,16,10,10,67,48,19,58
Airdrieon,193,4,15,9,12,54,53,1,54
Queen's Park,193,5,15,7,14,40,48,-8,52
Peterhead,193,6,14,4,18,46,56,-10,46
East Fife,193,7,12,9,15,50,49,1,45
Stranraer,193,8,13,5,18,52,58,-6,44
Stenhousem'r,193,9,11,9,16,50,72,-22,42
Albion,193,10,9,12,15,50,58,-8,39
Livingston,194,1,20,8,8,80,51,29,68
Alloa,194,2,19,8,9,69,47,22,65
Brechin,194,3,16,11,9,55,44,11,59
Airdrieon,194,4,15,8,13,57,53,4,53
Peterhead,194,5,13,10,13,44,47,-3,49
Albion,194,6,12,12,12,50,49,1,48
Stranraer,194,7,11,10,15,49,62,-13,43
Queen's Park,194,8,10,11,15,34,47,-13,41
East Fife,194,9,7,13,16,44,51,-7,34
Stenhousem'r,194,10,7,9,20,42,73,-31,30
Alloa,195,1,21,8,7,77,40,37,71
Airdrieon,195,2,16,8,12,60,51,9,56
Livingston,195,3,17,4,15,64,52,12,55
Albion,195,4,16,7,13,49,43,6,55
Peterhead,195,5,16,5,15,52,50,2,53
Brechin,195,6,16,5,15,53,53,0,53
Stranraer,195,7,13,4,19,44,63,-19,43
East Fife,195,8,11,9,16,47,53,-6,42
Stenhousem'r,195,9,10,10,16,41,65,-24,40
Queen's Park,195,10,10,8,18,33,50,-17,38
Alloa,196,1,22,8,6,80,41,39,74
Livingston,196,2,19,6,11,68,45,23,63
Brechin,196,3,17,8,11,52,44,8,59
Airdrieon,196,4,15,8,13,50,52,-2,53
Albion,196,5,12,12,12,51,50,1,48
Peterhead,196,6,13,9,14,52,55,-3,48
Queen's Park,196,7,13,7,16,30,48,-18,46
East Fife,196,8,9,10,17,46,54,-8,37
Stranraer,196,9,10,7,19,52,64,-12,37
Stenhousem'r,196,10,9,7,20,43,71,-28,34
Alloa,197,1,22,7,7,72,35,37,73
Livingston,197,2,20,7,9,71,46,25,67
Brechin,197,3,18,2,16,52,49,3,56
Airdrieon,197,4,16,7,13,53,55,-2,55
Albion,197,5,13,8,15,56,56,0,47
East Fife,197,6,13,7,16,54,51,3,46
Peterhead,197,7,13,6,17,48,57,-9,45
Stranraer,197,8,11,9,16,52,61,-9,42
Queen's Park,197,9,10,10,16,46,66,-20,40
Stenhousem'r,197,10,9,7,20,44,72,-28,34
Alloa,198,1,20,7,9,67,42,25,67
Livingston,198,2,20,6,10,69,48,21,66
Albion,198,3,18,8,10,57,47,10,62
Brechin,198,4,18,6,12,53,44,9,60
Airdrieon,198,5,16,7,13,58,49,9,55
Peterhead,198,6,11,12,13,47,48,-1,45
Stranraer,198,7,13,6,17,52,61,-9,45
East Fife,198,8,11,11,14,46,42,4,44
Queen's Park,198,9,10,6,20,35,53,-18,36
Stenhousem'r,198,10,5,7,24,46,96,-50,22
Livingston,199,1,23,5,8,77,43,34,74
Alloa,199,2,20,7,9,69,46,23,67
Airdrieon,199,3,19,4,13,65,55,10,61
Brechin,199,4,16,7,13,52,48,4,55
Queen's Park,199,5,12,12,12,38,47,-9,48
Albion,199,6,12,10,14,51,50,1,46
East Fife,199,7,11,11,14,51,52,-1,44
Stranraer,199,8,12,6,18,48,61,-13,42
Peterhead,199,9,9,10,17,42,55,-13,37
Stenhousem'r,199,10,6,8,22,36,72,-36,26
Livingston,200,1,28,1,7,89,36,53,85
Airdrieon,200,2,21,7,8,70,53,17,70
Alloa,200,3,14,10,12,62,48,14,52
Albion,200,4,15,7,14,57,59,-2,52
Queen's Park,200,5,14,9,13,47,46,1,51
Brechin,200,6,14,9,13,45,44,1,51
East Fife,200,7,11,10,15,50,51,-1,43
Peterhead,200,8,11,10,15,51,61,-10,43
Stranraer,200,9,7,6,23,38,67,-29,27
Stenhousem'r,200,10,5,11,20,32,76,-44,26
Airdrieon,201,1,18,9,9,60,48,12,63
Alloa,201,2,18,8,10,75,41,34,62
Livingston,201,3,16,8,12,61,49,12,56
Brechin,201,4,16,5,15,43,53,-10,53
Queen's Park,201,5,14,8,14,42,48,-6,50
East Fife,201,6,13,10,13,51,50,1,49
Peterhead,201,7,11,14,11,47,45,2,47
Albion,201,8,13,7,16,54,57,-3,46
Stranraer,201,9,11,6,19,45,57,-12,39
Stenhousem'r,201,10,8,9,19,45,75,-30,33
Livingston,202,1,22,3,11,79,49,30,69
Alloa,202,2,18,9,9,75,46,29,63
Airdrieon,202,3,17,7,12,69,57,12,58
Brechin,202,4,16,6,14,53,51,2,54
Peterhead,202,5,14,9,13,50,49,1,51
Albion,202,6,14,7,15,59,67,-8,49
East Fife,202,7,13,7,16,49,46,3,46
Stranraer,202,8,13,7,16,49,55,-6,46
Queen's Park,202,9,10,6,20,34,60,-26,36
Stenhousem'r,202,10,9,7,20,46,83,-37,34
Livingston,203,1,23,3,10,75,43,32,72
Alloa,203,2,19,6,11,79,56,23,63
Peterhead,203,3,18,6,12,52,46,6,60
Airdrieon,203,4,18,3,15,56,46,10,57
Brechin,203,5,18,2,16,55,53,2,56
Albion,203,6,16,7,13,58,52,6,55
Queen's Park,203,7,12,8,16,38,52,-14,44
East Fife,203,8,11,5,20,42,52,-10,38
Stranraer,203,9,11,3,22,40,61,-21,36
Stenhousem'r,203,10,10,5,21,43,77,-34,35
Livingston,204,1,23,4,9,74,38,36,73
Brechin,204,2,19,6,11,58,46,12,63
Albion,204,3,17,8,11,61,50,11,59
Airdrieon,204,4,15,10,11,59,46,13,55
Alloa,204,5,15,9,12,69,49,20,54
East Fife,204,6,13,11,12,52,49,3,50
Stranraer,204,7,13,7,16,47,57,-10,46
Queen's Park,204,8,11,7,18,33,53,-20,40
Peterhead,204,9,10,5,21,38,66,-28,35
Stenhousem'r,204,10,5,11,20,47,84,-37,26
Alloa,205,1,21,6,9,80,52,28,69
Livingston,205,2,22,3,11,77,51,26,69
Airdrieon,205,3,17,6,13,58,55,3,57
Brechin,205,4,15,9,12,52,46,6,54
Peterhead,205,5,13,9,14,50,51,-1,48
Stranraer,205,6,14,4,18,45,53,-8,46
East Fife,205,7,12,8,16,53,56,-3,44
Queen's Park,205,8,12,8,16,36,52,-16,44
Stenhousem'r,205,9,12,5,19,55,72,-17,41
Albion,205,10,9,8,19,45,63,-18,35
Livingston,206,1,22,3,11,85,41,44,69
Airdrieon,206,2,20,8,8,55,38,17,68
Alloa,206,3,19,7,10,76,44,32,64
Brechin,206,4,20,3,13,49,47,2,63
Peterhead,206,5,14,7,15,56,57,-1,49
Albion,206,6,13,9,14,52,58,-6,48
Stranraer,206,7,12,7,17,46,60,-14,43
East Fife,206,8,11,7,18,46,53,-7,40
Queen's Park,206,9,10,4,22,37,66,-29,34
Stenhousem'r,206,10,9,5,22,55,93,-38,32
Livingston,207,1,23,5,8,79,44,35,74
Alloa,207,2,19,8,9,73,44,29,65
Airdrieon,207,3,18,7,11,55,54,1,61
Peterhead,207,4,15,7,14,50,52,-2,52
Brechin,207,5,14,7,15,49,45,4,49
Queen's Park,207,6,13,8,15,40,47,-7,47
East Fife,207,7,12,10,14,51,53,-2,46
Albion,207,8,11,10,15,60,59,1,43
Stranraer,207,9,11,6,19,51,67,-16,39
Stenhousem'r,207,10,6,8,22,36,79,-43,26
Livingston,208,1,22,5,9,79,44,35,71
Albion,208,2,16,11,9,54,41,13,59
Alloa,208,3,15,12,9,68,49,19,57
Brechin,208,4,17,5,14,45,39,6,56
Airdrieon,208,5,16,7,13,61,58,3,55
Stranraer,208,6,14,7,15,53,52,1,49
Queen's Park,208,7,11,9,16,33,55,-22,42
Peterhead,208,8,9,9,18,41,56,-15,36
Stenhousem'r,208,9,9,9,18,51,81,-30,36
East Fife,208,10,7,14,15,42,52,-10,35
Alloa,209,1,20,7,9,83,47,36,67
Livingston,209,2,19,4,13,69,49,20,61
Brechin,209,3,17,9,10,60,45,15,60
Airdrieon,209,4,16,6,14,62,56,6,54
Peterhead,209,5,14,9,13,53,52,1,51
Albion,209,6,13,9,14,59,56,3,48
Queen's Park,209,7,10,11,15,35,55,-20,41
Stenhousem'r,209,8,12,5,19,50,73,-23,41
East Fife,209,9,9,12,15,46,57,-11,39
Stranraer,209,10,11,6,19,43,70,-27,39
Livingston,210,1,22,6,8,78,44,34,72
Alloa,210,2,17,9,10,65,49,16,60
Peterhead,210,3,17,6,13,54,47,7,57
Airdrieon,210,4,17,6,13,54,52,2,57
Queen's Park,210,5,15,7,14,45,46,-1,52
Albion,210,6,14,7,15,52,53,-1,49
Brechin,210,7,12,9,15,47,57,-10,45
Stranraer,210,8,11,7,18,45,55,-10,40
East Fife,210,9,8,12,16,44,53,-9,36
Stenhousem'r,210,10,8,9,19,47,75,-28,33
Alloa,211,1,21,7,8,88,52,36,70
Brechin,211,2,21,5,10,63,47,16,68
Livingston,211,3,21,4,11,75,50,25,67
Airdrieon,211,4,15,8,13,54,51,3,53
Peterhead,211,5,16,5,15,59,57,2,53
Albion,211,6,13,10,13,62,61,1,49
East Fife,211,7,12,7,17,53,59,-6,43
Queen's Park,211,8,10,9,17,31,49,-18,39
Stranraer,211,9,10,5,21,49,70,-21,35
Stenhousem'r,211,10,6,10,20,43,81,-38,28
Livingston,212,1,21,3,12,74,54,20,66
Airdrieon,212,2,18,7,11,53,48,5,61
Alloa,212,3,16,11,9,69,44,25,59
Brechin,212,4,15,9,12,63,54,9,54
Queen's Park,212,5,14,9,13,39,40,-1,51
Stranraer,212,6,15,3,18,58,67,-9,48
Peterhead,212,7,11,13,12,52,53,-1,46
Albion,212,8,13,7,16,52,56,-4,46
East Fife,212,9,9,13,14,48,48,0,40
Stenhousem'r,212,10,7,7,22,37,81,-44,28
Alloa,213,1,22,8,6,74,42,32,74
Airdrieon,213,2,19,7,10,63,50,13,64
Livingston,213,3,18,7,11,74,52,22,61
Brechin,213,4,14,7,15,47,49,-2,49
Albion,213,5,11,13,12,49,50,-1,46
Stenhousem'r,213,6,13,7,16,51,71,-20,46
Stranraer,213,7,14,3,19,52,59,-7,45
Peterhead,213,8,10,14,12,48,49,-1,44
East Fife,213,9,11,8,17,47,52,-5,41
Queen's Park,213,10,8,6,22,27,58,-31,30
Alloa,214,1,22,6,8,74,41,33,72
Livingston,214,2,22,3,11,76,51,25,69
Airdrieon,214,3,19,7,10,62,47,15,64
Brechin,214,4,16,7,13,47,43,4,55
Albion,214,5,14,8,14,51,50,1,50
Peterhead,214,6,13,6,17,50,53,-3,45
Stranraer,214,7,13,5,18,56,64,-8,44
Queen's Park,214,8,10,10,16,33,49,-16,40
East Fife,214,9,9,8,19,38,56,-18,35
Stenhousem'r,214,10,8,8,20,38,71,-33,32
Livingston,215,1,23,4,9,78,40,38,73
Alloa,215,2,21,7,8,75,41,34,70
Airdrieon,215,3,17,8,11,60,55,5,59
Albion,215,4,16,7,13,44,42,2,55
Queen's Park,215,5,14,7,15,41,51,-10,49
Stranraer,215,6,14,5,17,48,58,-10,47
East Fife,215,7,13,7,16,62,53,9,46
Brechin,215,8,13,4,19,42,50,-8,43
Peterhead,215,9,11,10,15,47,62,-15,43
Stenhousem'r,215,10,3,11,22,57,102,-45,20
Livingston,216,1,21,2,13,73,50,23,65
Alloa,216,2,18,9,9,67,40,27,63
Brechin,216,3,18,4,14,60,49,11,58
Peterhead,216,4,17,7,12,54,59,-5,58
Airdrieon,216,5,17,6,13,62,55,7,57
East Fife,216,6,11,12,13,47,44,3,45
Queen's Park,216,7,13,6,17,38,53,-15,45
Albion,216,8,12,8,16,55,59,-4,44
Stranraer,216,9,13,5,18,52,58,-6,44
Stenhousem'r,216,10,6,9,21,46,87,-41,27
Alloa,217,1,20,8,8,68,37,31,68
Airdrieon,217,2,19,7,10,60,54,6,64
Livingston,217,3,18,8,10,77,54,23,62
Brechin,217,4,18,8,10,61,49,12,62
Peterhead,217,5,14,9,13,52,52,0,51
Albion,217,6,11,12,13,48,47,1,45
East Fife,217,7,11,9,16,52,52,0,42
Queen's Park,217,8,11,7,18,35,56,-21,40
Stranraer,217,9,9,6,21,44,69,-25,33
Stenhousem'r,217,10,7,10,19,44,71,-27,31
Livingston,218,1,23,4,9,77,52,25,73
Alloa,218,2,18,7,11,63,45,18,61
Brechin,218,3,16,10,10,55,40,15,58
Airdrieon,218,4,16,6,14,62,55,7,54
Peterhead,218,5,15,8,13,59,52,7,53
East Fife,218,6,10,13,13,46,47,-1,43
Stranraer,218,7,12,5,19,51,66,-15,41
Queen's Park,218,8,11,7,18,37,59,-22,40
Albion,218,9,10,9,17,51,63,-12,39
Stenhousem'r,218,10,10,9,17,54,76,-22,39
Alloa,219,1,21,5,10,76,46,30,68
Livingston,219,2,18,8,10,71,45,26,62
Brechin,219,3,16,9,11,54,42,12,57
Stranraer,219,4,14,8,14,49,50,-1,50
Airdrieon,219,5,14,8,14,53,58,-5,50
Queen's Park,219,6,12,11,13,45,49,-4,47
Albion,219,7,14,5,17,55,62,-7,47
East Fife,219,8,11,9,16,51,53,-2,42
Stenhousem'r,219,9,11,9,16,50,73,-23,42
Peterhead,219,10,10,6,20,42,68,-26,36
Alloa,220,1,24,5,7,71,35,36,77
Livingston,220,2,21,4,11,77,52,25,67
Airdrieon,220,3,16,8,12,57,52,5,56
Albion,220,4,15,6,15,57,53,4,51
Peterhead,220,5,12,9,15,49,60,-11,45
Brechin,220,6,11,9,16,43,54,-11,42
East Fife,220,7,10,11,15,49,51,-2,41
Stranraer,220,8,11,8,17,53,59,-6,41
Stenhousem'r,220,9,10,11,15,55,79,-24,41
Queen's Park,220,10,11,7,18,38,54,-16,40
Livingston,221,1,22,5,9,78,47,31,71
Alloa,221,2,20,6,10,75,47,28,66
Brechin,221,3,18,7,11,59,49,10,61
Airdrieon,221,4,17,10,9,58,51,7,61
Albion,221,5,14,8,14,54,56,-2,50
Peterhead,221,6,13,7,16,38,50,-12,46
Stranraer,221,7,12,5,19,48,61,-13,41
East Fife,221,8,10,9,17,48,53,-5,39
Queen's Park,221,9,10,9,17,43,55,-12,39
Stenhousem'r,221,10,8,6,22,42,74,-32,30
Livingston,222,1,21,5,10,80,52,28,68
Alloa,222,2,17,9,10,77,51,26,60
Albion,222,3,16,11,9,62,49,13,59
Brechin,222,4,16,7,13,59,52,7,55
Peterhead,222,5,16,6,14,55,55,0,54
Airdrieon,222,6,15,6,15,60,62,-2,51
Queen's Park,222,7,12,10,14,51,63,-12,46
Stranraer,222,8,10,9,17,56,72,-16,39
East Fife,222,9,9,11,16,47,54,-7,38
Stenhousem'r,222,10,7,8,21,42,79,-37,29
Livingston,223,1,21,6,9,78,48,30,69
Brechin,223,2,19,7,10,55,44,11,64
Airdrieon,223,3,17,6,13,62,53,9,57
Alloa,223,4,15,9,12,61,56,5,54
Albion,223,5,14,6,16,48,56,-8,48
Stranraer,223,6,14,4,18,54,56,-2,46
Peterhead,223,7,13,7,16,49,51,-2,46
Queen's Park,223,8,13,5,18,41,51,-10,44
East Fife,223,9,11,10,15,47,43,4,43
Stenhousem'r,223,10,11,4,21,48,85,-37,37
Airdrieon,224,1,20,4,12,60,48,12,64
Alloa,224,2,18,7,11,66,46,20,61
Livingston,224,3,19,4,13,64,47,17,61
Brechin,224,4,17,4,15,49,43,6,55
Peterhead,224,5,15,6,15,56,58,-2,51
Albion,224,6,13,11,12,50,52,-2,50
Queen's Park,224,7,13,9,14,43,48,-5,48
Stranraer,224,8,12,7,17,53,66,-13,43
East Fife,224,9,11,7,18,52,53,-1,40
Stenhousem'r,224,10,8,9,19,40,72,-32,33
Airdrieon,225,1,21,4,11,61,51,10,67
Livingston,225,2,19,4,13,69,48,21,61
Alloa,225,3,16,10,10,63,43,20,58
Brechin,225,4,16,6,14,53,48,5,54
Queen's Park,225,5,14,7,15,47,51,-4,49
Albion,225,6,11,13,12,46,55,-9,46
Stranraer,225,7,13,5,18,53,55,-2,44
East Fife,225,8,12,7,17,49,56,-7,43
Peterhead,225,9,10,13,13,42,55,-13,43
Stenhousem'r,225,10,10,7,19,54,75,-21,37
Alloa,226,1,19,7,10,80,48,32,64
Livingston,226,2,17,8,11,72,56,16,59
Airdrieon,226,3,17,8,11,56,49,7,59
Brechin,226,4,16,6,14,52,53,-1,54
Albion,226,5,13,9,14,62,64,-2,48
Peterhead,226,6,12,12,12,48,56,-8,48
Stranraer,226,7,13,7,16,56,60,-4,46
Queen's Park,226,8,12,7,17,39,58,-19,43
East Fife,226,9,10,10,16,51,47,4,40
Stenhousem'r,226,10,11,6,19,55,80,-25,39
Airdrieon,227,1,22,5,9,68,50,18,71
Livingston,227,2,21,4,11,82,51,31,67
Alloa,227,3,16,12,8,80,48,32,60
Brechin,227,4,16,6,14,47,42,5,54
Peterhead,227,5,14,7,15,50,60,-10,49
Albion,227,6,13,8,15,58,66,-8,47
Stranraer,227,7,11,10,15,53,59,-6,43
Queen's Park,227,8,11,10,15,36,51,-15,43
East Fife,227,9,11,8,17,54,58,-4,41
Stenhousem'r,227,10,6,8,22,45,88,-43,26
Airdrieon,228,1,21,6,9,70,48,22,69
Livingston,228,2,21,2,13,78,54,24,65
Alloa,228,3,17,8,11,65,51,14,59
Peterhead,228,4,17,8,11,61,51,10,59
Albion,228,5,14,9,13,51,51,0,51
Brechin,228,6,13,9,14,55,57,-2,48
Queen's Park,228,7,13,5,18,33,55,-22,44
East Fife,228,8,11,9,16,49,51,-2,42
Stranraer,228,9,11,5,20,47,62,-15,38
Stenhousem'r,228,10,7,9,20,53,82,-29,30
Alloa,229,1,22,6,8,77,35,42,72
Livingston,229,2,22,6,8,73,44,29,72
Brechin,229,3,18,4,14,49,47,2,58
Airdrieon,229,4,16,6,14,50,50,0,54
Queen's Park,229,5,15,8,13,42,42,0,53
East Fife,229,6,13,11,12,52,42,10,50
Stranraer,229,7,14,5,17,50,55,-5,47
Peterhead,229,8,12,8,16,39,53,-14,44
Albion,229,9,10,6,20,45,63,-18,36
Stenhousem'r,229,10,5,6,25,43,89,-46,21
Livingston,230,1,24,6,6,80,44,36,78
Brechin,230,2,17,7,12,51,43,8,58
Alloa,230,3,16,8,12,65,51,14,56
Albion,230,4,15,8,13,57,49,8,53
Peterhead,230,5,14,9,13,55,52,3,51
Airdrieon,230,6,14,8,14,60,64,-4,50
Stranraer,230,7,12,8,16,51,53,-2,44
Queen's Park,230,8,12,8,16,34,47,-13,44
East Fife,230,9,12,7,17,53,58,-5,43
Stenhousem'r,230,10,7,5,24,42,87,-45,26
Livingston,231,1,21,7,8,77,40,37,70
Alloa,231,2,18,9,9,66,41,25,63
Airdrieon,231,3,15,10,11,50,45,5,55
Queen's Park,231,4,16,7,13,42,44,-2,55
Brechin,231,5,16,5,15,50,56,-6,53
Stranraer,231,6,14,7,15,48,48,0,49
Peterhead,231,7,14,7,15,46,51,-5,49
Albion,231,8,9,12,15,43,53,-10,39
East Fife,231,9,8,10,18,40,52,-12,34
Stenhousem'r,231,10,7,10,19,42,74,-32,31
Alloa,232,1,22,7,7,80,41,39,73
Livingston,232,2,20,5,11,76,45,31,65
Peterhead,232,3,14,13,9,52,45,7,55
Airdrieon,232,4,15,8,13,57,57,0,53
Brechin,232,5,14,9,13,54,56,-2,51
East Fife,232,6,12,10,14,51,48,3,46
Albion,232,7,11,13,12,43,46,-3,46
Queen's Park,232,8,12,8,16,34,50,-16,44
Stranraer,232,9,9,7,20,39,66,-27,34
Stenhousem'r,232,10,5,12,19,45,77,-32,27
Livingston,233,1,24,2,10,86,48,38,74
Brechin,233,2,21,3,12,59,42,17,66
Alloa,233,3,17,6,13,67,54,13,57
Airdrieon,233,4,15,10,11,58,53,5,55
Albion,233,5,15,6,15,58,54,4,51
Peterhead,233,6,13,10,13,51,57,-6,49
Queen's Park,233,7,14,6,16,39,49,-10,48
Stranraer,233,8,13,5,18,47,61,-14,44
East Fife,233,9,9,8,19,46,60,-14,35
Stenhousem'r,233,10,9,4,23,53,86,-33,31
Livingston,234,1,19,7,10,74,50,24,64
Alloa,234,2,18,9,9,71,46,25,63
Brechin,234,3,16,8,12,51,49,2,56
Airdrieon,234,4,16,8,12,59,59,0,56
Albion,234,5,14,9,13,54,53,1,51
Stranraer,234,6,14,7,15,55,56,-1,49
East Fife,234,7,13,8,15,54,48,6,47
Peterhead,234,8,12,9,15,52,58,-6,45
Queen's Park,234,9,9,8,19,34,53,-19,35
Stenhousem'r,234,10,10,5,21,46,78,-32,35
Livingston,235,1,21,4,11,82,56,26,67
Alloa,235,2,18,10,8,78,47,31,64
Brechin,235,3,20,4,12,66,39,27,64
Airdrieon,235,4,18,7,11,61,47,14,61
Stranraer,235,5,15,6,15,55,62,-7,51
Albion,235,6,12,9,15,47,57,-10,45
Peterhead,235,7,11,9,16,47,57,-10,42
Queen's Park,235,8,11,9,16,39,58,-19,42
East Fife,235,9,10,8,18,41,49,-8,38
Stenhousem'r,235,10,7,8,21,49,93,-44,29
Brechin,236,1,22,5,9,61,36,25,71
Alloa,236,2,20,7,9,67,42,25,67
Livingston,236,3,19,7,10,73,51,22,64
Airdrieon,236,4,14,9,13,59,56,3,51
Queen's Park,236,5,15,5,16,44,55,-11,50
Albion,236,6,13,7,16,51,55,-4,46
East Fife,236,7,12,8,16,47,52,-5,44
Stranraer,236,8,11,8,17,44,55,-11,41
Peterhead,236,9,11,6,19,43,57,-14,39
Stenhousem'r,236,10,8,8,20,51,81,-30,32
Brechin,237,1,19,9,8,62,48,14,66
Alloa,237,2,18,8,10,69,51,18,62
Airdrieon,237,3,17,8,11,62,52,10,59
Livingston,237,4,17,5,14,73,52,21,56
Albion,237,5,14,8,14,56,49,7,50
Peterhead,237,6,13,9,14,49,58,-9,48
Stranraer,237,7,12,9,15,49,53,-4,45
Queen's Park,237,8,12,5,19,34,54,-20,41
East Fife,237,9,8,12,16,48,59,-11,36
Stenhousem'r,237,10,9,9,18,46,72,-26,36
Alloa,238,1,19,6,11,62,40,22,63
Livingston,238,2,19,5,12,76,47,29,62
East Fife,238,3,17,8,11,56,37,19,59
Airdrieon,238,4,17,8,11,63,56,7,59
Albion,238,5,16,7,13,54,51,3,55
Peterhead,238,6,13,8,15,52,52,0,47
Brechin,238,7,13,6,17,49,58,-9,45
Stranraer,238,8,12,7,17,48,55,-7,43
Queen's Park,238,9,11,6,19,36,61,-25,39
Stenhousem'r,238,10,9,7,20,40,79,-39,34
Livingston,239,1,19,7,10,72,43,29,64
Airdrieon,239,2,18,8,10,53,43,10,62
Alloa,239,3,18,6,12,69,46,23,60
Brechin,239,4,17,4,15,57,62,-5,55
East Fife,239,5,13,11,12,63,51,12,50
Stenhousem'r,239,6,12,10,14,55,66,-11,46
Queen's Park,239,7,13,7,16,33,52,-19,46
Albion,239,8,12,8,16,46,55,-9,44
Peterhead,239,9,12,5,19,47,56,-9,41
Stranraer,239,10,9,8,19,42,63,-21,35
Brechin,240,1,20,3,13,59,46,13,63
Alloa,240,2,17,9,10,66,47,19,60
Albion,240,3,16,7,13,55,51,4,55
Airdrieon,240,4,16,6,14,60,58,2,54
Livingston,240,5,14,11,11,66,50,16,53
Stranraer,240,6,15,6,15,50,58,-8,51
Queen's Park,240,7,12,10,14,42,46,-4,46
Peterhead,240,8,12,10,14,48,56,-8,46
East Fife,240,9,12,8,16,52,55,-3,44
Stenhousem'r,240,10,7,8,21,43,74,-31,29
Livingston,241,1,26,3,7,84,38,46,81
Alloa,241,2,16,13,7,63,39,24,61
Airdrieon,241,3,18,6,12,62,55,7,60
Stranraer,241,4,16,3,17,55,59,-4,51
Albion,241,5,14,8,14,52,52,0,50
Peterhead,241,6,14,7,15,51,52,-1,49
Brechin,241,7,14,7,15,40,43,-3,49
Queen's Park,241,8,13,9,14,35,40,-5,48
East Fife,241,9,9,10,17,40,53,-13,37
Stenhousem'r,241,10,4,6,26,35,86,-51,18
Alloa,242,1,19,9,8,78,50,28,66
Livingston,242,2,18,7,11,69,48,21,61
Airdrieon,242,3,16,9,11,60,53,7,57
Brechin,242,4,15,8,13,49,48,1,53
Stranraer,242,5,14,8,14,59,58,1,50
Albion,242,6,13,9,14,49,48,1,48
Queen's Park,242,7,13,7,16,39,54,-15,46
Peterhead,242,8,11,10,15,47,49,-2,43
East Fife,242,9,12,7,17,48,54,-6,43
Stenhousem'r,242,10,7,10,19,44,80,-36,31
Livingston,243,1,20,8,8,77,46,31,68
Alloa,243,2,18,9,9,69,46,23,63
Brechin,243,3,16,8,12,55,50,5,56
Airdrieon,243,4,15,9,12,59,58,1,54
Albion,243,5,15,8,13,66,56,10,53
Queen's Park,243,6,15,7,14,47,53,-6,52
Peterhead,243,7,14,6,16,49,56,-7,48
East Fife,243,8,9,10,17,54,53,1,37
Stranraer,243,9,9,9,18,45,61,-16,36
Stenhousem'r,243,10,7,10,19,40,82,-42,31
Livingston,244,1,20,5,11,82,51,31,65
Alloa,244,2,17,11,8,65,41,24,62
Brechin,244,3,17,10,9,49,40,9,61
Airdrieon,244,4,17,5,14,64,56,8,56
Albion,244,5,16,6,14,53,53,0,54
Queen's Park,244,6,15,8,13,41,45,-4,53
Peterhead,244,7,13,8,15,50,58,-8,47
Stranraer,244,8,12,4,20,43,58,-15,40
East Fife,244,9,10,8,18,44,53,-9,38
Stenhousem'r,244,10,6,9,21,50,86,-36,27
Livingston,245,1,21,5,10,76,53,23,68
Alloa,245,2,19,7,10,72,41,31,64
Peterhead,245,3,18,5,13,64,54,10,59
Brechin,245,4,16,6,14,63,59,4,54
Airdrieon,245,5,17,3,16,61,74,-13,54
Stranraer,245,6,14,9,13,58,64,-6,51
Albion,245,7,15,5,16,53,55,-2,50
East Fife,245,8,9,15,12,52,46,6,42
Stenhousem'r,245,9,8,8,20,51,82,-31,32
Queen's Park,245,10,7,9,20,38,60,-22,30
Livingston,246,1,20,6,10,79,48,31,66
Alloa,246,2,17,10,9,76,45,31,61
Brechin,246,3,18,6,12,49,48,1,60
Peterhead,246,4,16,8,12,51,47,4,56
Airdrieon,246,5,16,6,14,56,65,-9,54
Queen's Park,246,6,15,6,15,45,45,0,51
Albion,246,7,10,13,13,52,57,-5,43
Stranraer,246,8,12,7,17,48,58,-10,43
East Fife,246,9,10,11,15,49,56,-7,41
Stenhousem'r,246,10,5,9,22,41,77,-36,24
Livingston,247,1,24,4,8,86,40,46,76
Alloa,247,2,21,7,8,85,44,41,70
Airdrieon,247,3,17,5,14,74,67,7,56
Brechin,247,4,16,8,12,53,55,-2,56
Peterhead,247,5,14,6,16,52,63,-11,48
Queen's Park,247,6,11,12,13,36,51,-15,45
East Fife,247,7,10,12,14,47,52,-5,42
Stranraer,247,8,12,5,19,40,55,-15,41
Albion,247,9,10,8,18,49,56,-7,38
Stenhousem'r,247,10,8,7,21,44,83,-39,31
Livingston,248,1,21,4,11,70,41,29,67
Alloa,248,2,19,9,8,71,48,23,66
Airdrieon,248,3,20,6,10,70,49,21,66
Albion,248,4,12,12,12,48,45,3,48
Queen's Park,248,5,14,4,18,36,57,-21,46
East Fife,248,6,11,11,14,45,50,-5,44
Stranraer,248,7,11,10,15,47,53,-6,43
Brechin,248,8,12,7,17,42,49,-7,43
Stenhousem'r,248,9,11,10,15,51,66,-15,43
Peterhead,248,10,8,9,19,42,64,-22,33
Alloa,249,1,20,7,9,79,40,39,67
Livingston,249,2,20,6,10,74,47,27,66
Airdrieon,249,3,16,9,11,55,51,4,57
Queen's Park,249,4,17,6,13,43,42,1,57
Brechin,249,5,16,5,15,48,49,-1,53
Stranraer,249,6,15,6,15,50,49,1,51
Albion,249,7,14,6,16,51,58,-7,48
Peterhead,249,8,12,10,14,52,60,-8,46
East Fife,249,9,9,9,18,47,59,-12,36
Stenhousem'r,249,10,5,8,23,43,87,-44,23
Alloa,250,1,22,6,8,72,43,29,72
Livingston,250,2,22,2,12,74,45,29,68
Brechin,250,3,18,5,13,62,53,9,59
Peterhead,250,4,18,4,14,56,47,9,58
Airdrieon,250,5,17,6,13,67,57,10,57
Albion,250,6,13,8,15,48,47,1,47
Queen's Park,250,7,14,3,19,37,62,-25,45
Stranraer,250,8,12,6,18,50,62,-12,42
East Fife,250,9,10,6,20,46,61,-15,36
Stenhousem'r,250,10,7,8,21,46,81,-35,29
Livingston,251,1,21,4,11,76,53,23,67
Airdrieon,251,2,19,7,10,72,53,19,64
Alloa,251,3,19,6,11,72,49,23,63
Brechin,251,4,18,8,10,64,52,12,62
Albion,251,5,17,5,14,51,52,-1,56
Peterhead,251,6,14,8,14,46,53,-7,50
Queen's Park,251,7,15,4,17,46,49,-3,49
East Fife,251,8,12,7,17,54,53,1,43
Stranraer,251,9,9,6,21,44,64,-20,33
Stenhousem'r,251,10,4,9,23,38,85,-47,21
Livingston,252,1,22,5,9,76,42,34,71
Alloa,252,2,20,8,8,62,33,29,68
Airdrieon,252,3,14,10,12,62,57,5,52
Stranraer,252,4,14,9,13,49,49,0,51
Albion,252,5,14,9,13,49,53,-4,51
Peterhead,252,6,13,7,16,44,46,-2,46
Queen's Park,252,7,12,10,14,35,45,-10,46
East Fife,252,8,10,13,13,54,53,1,43
Brechin,252,9,12,6,18,42,57,-15,42
Stenhousem'r,252,10,6,9,21,42,80,-38,27
Livingston,253,1,22,3,11,80,52,28,69
Alloa,253,2,19,6,11,68,40,28,63
Brechin,253,3,18,4,14,43,41,2,58
Albion,253,4,16,8,12,56,53,3,56
Queen's Park,253,5,16,7,13,44,46,-2,55
Peterhead,253,6,13,9,14,48,57,-9,48
Airdrieon,253,7,13,8,15,54,60,-6,47
Stranraer,253,8,11,10,15,47,56,-9,43
East Fife,253,9,12,6,18,54,50,4,42
Stenhousem'r,253,10,4,11,21,48,87,-39,23
Alloa,254,1,23,7,6,80,40,40,76
Livingston,254,2,21,1,14,74,61,13,64
Albion,254,3,16,10,10,53,42,11,58
Brechin,254,4,17,7,12,57,47,10,58
Airdrieon,254,5,16,4,16,63,63,0,52
Peterhead,254,6,15,6,15,47,51,-4,51
East Fife,254,7,14,8,14,46,42,4,50
Queen's Park,254,8,13,6,17,33,48,-15,45
Stranraer,254,9,12,5,19,51,60,-9,41
Stenhousem'r,254,10,3,6,27,31,81,-50,15
Alloa,255,1,20,9,7,70,41,29,69
Livingston,255,2,20,5,11,79,46,33,65
Brechin,255,3,15,7,14,51,51,0,52
Stranraer,255,4,15,6,15,56,47,9,51
Peterhead,255,5,14,9,13,49,49,0,51
Airdrieon,255,6,14,9,13,50,56,-6,51
Albion,255,7,12,9,15,49,56,-7,45
Queen's Park,255,8,13,6,17,39,55,-16,45
East Fife,255,9,11,10,15,57,59,-2,43
Stenhousem'r,255,10,6,10,20,35,75,-40,28
Alloa,256,1,22,8,6,80,36,44,74
Livingston,256,2,20,6,10,80,55,25,66
Airdrieon,256,3,21,2,13,84,63,21,65
Brechin,256,4,16,6,14,51,53,-2,54
Albion,256,5,15,8,13,59,57,2,53
Peterhead,256,6,14,6,16,45,52,-7,48
Stranraer,256,7,13,6,17,49,59,-10,45
Queen's Park,256,8,11,7,18,39,62,-23,40
East Fife,256,9,9,6,21,41,60,-19,33
Stenhousem'r,256,10,9,5,22,47,78,-31,32
Livingston,257,1,22,5,9,72,41,31,71
Alloa,257,2,17,9,10,70,42,28,60
Brechin,257,3,16,9,11,58,43,15,57
Albion,257,4,17,5,14,54,53,1,56
Airdrieon,257,5,16,7,13,59,56,3,55
East Fife,257,6,14,7,15,50,45,5,49
Peterhead,257,7,13,8,15,47,57,-10,47
Queen's Park,257,8,13,6,17,48,61,-13,45
Stranraer,257,9,13,2,21,45,60,-15,41
Stenhousem'r,257,10,7,6,23,43,88,-45,27
Livingston,258,1,23,3,10,83,48,35,72
Airdrieon,258,2,22,5,9,72,52,20,71
Alloa,258,3,16,8,12,67,56,11,56
Queen's Park,258,4,15,8,13,44,51,-7,53
Brechin,258,5,14,8,14,47,45,2,50
Stranraer,258,6,15,5,16,60,59,1,50
Peterhead,258,7,12,9,15,53,59,-6,45
Albion,258,8,11,8,17,59,66,-7,41
East Fife,258,9,11,7,18,53,59,-6,40
Stenhousem'r,258,10,6,9,21,45,88,-43,27
Alloa,259,1,20,6,10,59,37,22,66
Airdrieon,259,2,19,7,10,62,44,18,64
Livingston,259,3,19,4,13,87,63,24,61
Brechin,259,4,19,3,14,48,49,-1,60
Stranraer,259,5,17,5,14,66,56,10,56
Albion,259,6,16,5,15,46,55,-9,53
Peterhead,259,7,14,6,16,52,57,-5,48
East Fife,259,8,10,6,20,47,51,-4,36
Queen's Park,259,9,10,5,21,32,59,-27,35
Stenhousem'r,259,10,10,5,21,54,82,-28,35
Airdrieon,260,1,18,7,11,63,51,12,61
Livingston,260,2,19,2,15,73,54,19,59
Peterhead,260,3,16,10,10,54,46,8,58
Alloa,260,4,15,10,11,59,48,11,55
Brechin,260,5,16,4,16,53,60,-7,52
Queen's Park,260,6,14,7,15,49,57,-8,49
Stranraer,260,7,14,6,16,49,53,-4,48
East Fife,260,8,13,8,15,51,54,-3,47
Albion,260,9,11,12,13,48,49,-1,45
Stenhousem'r,260,10,8,6,22,51,78,-27,30
Airdrieon,261,1,21,7,8,64,47,17,70
Brechin,261,2,18,11,7,57,39,18,65
Alloa,261,3,17,13,6,71,44,27,64
Livingston,261,4,18,8,10,76,54,22,62
Albion,261,5,15,11,10,47,42,5,56
Peterhead,261,6,14,6,16,47,52,-5,48
East Fife,261,7,9,8,19,39,54,-15,35
Stranraer,261,8,9,7,20,48,65,-17,34
Stenhousem'r,261,9,8,9,19,52,73,-21,33
Queen's Park,261,10,6,10,20,30,61,-31,28
Alloa,262,1,18,9,9,76,42,34,63
Livingston,262,2,19,6,11,67,44,23,63
Airdrieon,262,3,16,9,11,59,55,4,57
Albion,262,4,16,8,12,58,47,11,56
Queen's Park,262,5,16,5,15,41,50,-9,53
East Fife,262,6,14,8,14,53,49,4,50
Peterhead,262,7,13,10,13,44,45,-1,49
Brechin,262,8,12,8,16,46,55,-9,44
Stranraer,262,9,9,7,20,50,74,-24,34
Stenhousem'r,262,10,8,8,20,48,81,-33,32
Brechin,263,1,18,10,8,56,43,13,64
Alloa,263,2,16,13,7,74,47,27,61
Livingston,263,3,16,7,13,70,57,13,55
Airdrieon,263,4,15,10,11,59,50,9,55
Peterhead,263,5,16,4,16,46,50,-4,52
Albion,263,6,14,9,13,54,51,3,51
Stranraer,263,7,12,6,18,47,59,-12,42
Queen's Park,263,8,12,6,18,40,56,-16,42
East Fife,263,9,9,14,13,43,42,1,41
Stenhousem'r,263,10,7,11,18,39,73,-34,32
Livingston,264,1,20,5,11,73,48,25,65
Airdrieon,264,2,19,5,12,64,55,9,62
Alloa,264,3,17,8,11,67,49,18,59
Brechin,264,4,17,5,14,51,51,0,56
Queen's Park,264,5,15,6,15,43,49,-6,51
East Fife,264,6,14,8,14,56,49,7,50
Peterhead,264,7,13,7,16,49,54,-5,46
Albion,264,8,12,7,17,44,54,-10,43
Stranraer,264,9,11,8,17,60,69,-9,41
Stenhousem'r,264,10,10,5,21,47,76,-29,35
Airdrieon,265,1,20,6,10,62,43,19,66
Livingston,265,2,20,4,12,73,44,29,64
Brechin,265,3,19,5,12,49,43,6,62
Alloa,265,4,17,5,14,69,55,14,56
Albion,265,5,15,6,15,57,60,-3,51
East Fife,265,6,14,8,14,46,44,2,50
Stranraer,265,7,14,7,15,51,52,-1,49
Peterhead,265,8,13,9,14,51,56,-5,48
Queen's Park,265,9,12,5,19,43,58,-15,41
Stenhousem'r,265,10,6,5,25,40,86,-46,23
Airdrieon,266,1,20,8,8,77,51,26,68
Livingston,266,2,19,3,14,77,56,21,60
Alloa,266,3,16,8,12,62,45,17,56
Brechin,266,4,16,6,14,52,60,-8,54
Queen's Park,266,5,14,8,14,46,55,-9,50
Albion,266,6,13,9,14,55,55,0,48
East Fife,266,7,11,12,13,50,47,3,45
Peterhead,266,8,12,9,15,51,52,-1,45
Stranraer,266,9,13,6,17,44,57,-13,45
Stenhousem'r,266,10,8,7,21,47,83,-36,31
Alloa,267,1,21,7,8,75,42,33,70
Livingston,267,2,19,7,10,76,51,25,64
Airdrieon,267,3,18,6,12,62,53,9,60
Peterhead,267,4,18,5,13,53,52,1,59
Albion,267,5,15,7,14,57,56,1,52
Queen's Park,267,6,14,7,15,44,51,-7,49
Brechin,267,7,14,6,16,51,59,-8,48
East Fife,267,8,12,10,14,57,52,5,46
Stenhousem'r,267,9,7,8,21,54,92,-38,29
Stranraer,267,10,7,7,22,43,64,-21,28
Alloa,268,1,20,8,8,68,45,23,68
Livingston,268,2,20,3,13,77,52,25,63
Airdrieon,268,3,17,9,10,66,55,11,60
Albion,268,4,17,7,12,50,46,4,58
Peterhead,268,5,15,8,13,54,47,7,53
Brechin,268,6,16,5,15,50,48,2,53
Stranraer,268,7,14,6,16,51,49,2,48
Queen's Park,268,8,12,6,18,41,60,-19,42
East Fife,268,9,10,8,18,48,54,-6,38
Stenhousem'r,268,10,6,6,24,38,87,-49,24
Livingston,269,1,24,2,10,86,47,39,74
Alloa,269,2,20,7,9,67,42,25,67
Brechin,269,3,17,6,13,56,55,1,57
Airdrieon,269,4,15,10,11,58,52,6,55
Albion,269,5,14,9,13,57,54,3,51
Queen's Park,269,6,14,6,16,40,49,-9,48
Peterhead,269,7,10,11,15,41,58,-17,41
East Fife,269,8,9,11,16,53,54,-1,38
Stranraer,269,9,11,4,21,34,57,-23,37
Stenhousem'r,269,10,9,8,19,48,72,-24,35
Alloa,270,1,20,6,10,77,47,30,66
Brechin,270,2,20,6,10,66,43,23,66
Livingston,270,3,21,2,13,84,57,27,65
Peterhead,270,4,16,10,10,55,51,4,58
Albion,270,5,16,8,12,67,55,12,56
Airdrieon,270,6,17,5,14,62,64,-2,56
Stranraer,270,7,11,6,19,50,70,-20,39
East Fife,270,8,9,11,16,48,52,-4,38
Queen's Park,270,9,10,7,19,39,60,-21,37
Stenhousem'r,270,10,5,9,22,41,90,-49,24
Alloa,271,1,23,5,8,83,42,41,74
Livingston,271,2,18,4,14,75,53,22,58
Brechin,271,3,15,10,11,55,51,4,55
Airdrieon,271,4,15,8,13,63,62,1,53
Queen's Park,271,5,16,4,16,43,56,-13,52
East Fife,271,6,14,8,14,59,43,16,50
Stranraer,271,7,14,4,18,53,66,-13,46
Peterhead,271,8,11,12,13,43,54,-11,45
Albion,271,9,11,9,16,48,54,-6,42
Stenhousem'r,271,10,6,10,20,46,87,-41,28
Livingston,272,1,22,6,8,71,44,27,72
Alloa,272,2,19,9,8,69,40,29,66
Brechin,272,3,18,9,9,60,45,15,63
Albion,272,4,15,6,15,63,56,7,51
Peterhead,272,5,14,7,15,53,59,-6,49
East Fife,272,6,12,10,14,53,53,0,46
Airdrieon,272,7,13,6,17,51,62,-11,45
Queen's Park,272,8,11,9,16,31,46,-15,42
Stranraer,272,9,10,9,17,44,53,-9,39
Stenhousem'r,272,10,6,9,21,43,80,-37,27
Livingston,273,1,24,2,10,80,48,32,74
Alloa,273,2,22,6,8,70,39,31,72
Airdrieon,273,3,18,8,10,70,52,18,62
Brechin,273,4,18,4,14,49,42,7,58
Albion,273,5,16,6,14,52,49,3,54
Peterhead,273,6,16,4,16,52,59,-7,52
East Fife,273,7,11,7,18,48,56,-8,40
Queen's Park,273,8,11,5,20,36,55,-19,38
Stranraer,273,9,9,6,21,42,64,-22,33
Stenhousem'r,273,10,8,6,22,55,90,-35,30
Airdrieon,274,1,18,8,10,68,55,13,62
Livingston,274,2,18,5,13,72,56,16,59
Alloa,274,3,17,7,12,65,52,13,58
Peterhead,274,4,18,3,15,59,49,10,57
Brechin,274,5,15,7,14,54,48,6,52
Stranraer,274,6,15,4,17,56,59,-3,49
Albion,274,7,13,7,16,53,67,-14,46
East Fife,274,8,12,9,15,47,51,-4,45
Queen's Park,274,9,12,5,19,36,50,-14,41
Stenhousem'r,274,10,10,9,17,57,80,-23,39
Livingston,275,1,25,5,6,85,44,41,80
Airdrieon,275,2,17,10,9,65,55,10,61
Alloa,275,3,18,6,12,63,48,15,60
Brechin,275,4,16,7,13,62,51,11,55
Albion,275,5,15,9,12,62,49,13,54
Peterhead,275,6,15,7,14,51,63,-12,52
East Fife,275,7,11,6,19,51,54,-3,39
Queen's Park,275,8,11,6,19,40,62,-22,39
Stenhousem'r,275,9,10,6,20,50,86,-36,36
Stranraer,275,10,10,2,24,47,64,-17,32
Livingston,276,1,23,4,9,84,50,34,73
Alloa,276,2,18,9,9,66,45,21,63
Airdrieon,276,3,16,9,11,69,53,16,57
Peterhead,276,4,14,11,11,61,60,1,53
Brechin,276,5,15,8,13,48,49,-1,53
Queen's Park,276,6,13,12,11,40,43,-3,51
Stranraer,276,7,13,5,18,53,61,-8,44
East Fife,276,8,8,12,16,44,55,-11,36
Albion,276,9,8,11,17,39,52,-13,35
Stenhousem'r,276,10,6,11,19,51,87,-36,29
Livingston,277,1,20,4,12,70,46,24,64
Airdrieon,277,2,20,4,12,67,50,17,64
Albion,277,3,18,6,12,58,51,7,60
Alloa,277,4,16,10,10,66,49,17,58
Stranraer,277,5,18,4,14,60,55,5,58
Brechin,277,6,12,10,14,51,52,-1,46
East Fife,277,7,11,10,15,51,54,-3,43
Peterhead,277,8,12,6,18,44,57,-13,42
Queen's Park,277,9,11,7,18,35,55,-20,40
Stenhousem'r,277,10,7,9,20,47,80,-33,30
Livingston,278,1,24,1,11,81,52,29,73
Alloa,278,2,18,9,9,65,42,23,63
Peterhead,278,3,18,7,11,49,40,9,61
Albion,278,4,16,11,9,56,39,17,59
Airdrieon,278,5,16,8,12,58,53,5,56
Brechin,278,6,15,6,15,48,50,-2,51
Stranraer,278,7,13,7,16,52,51,1,46
Queen's Park,278,8,13,5,18,42,59,-17,44
East Fife,278,9,8,9,19,39,53,-14,33
Stenhousem'r,278,10,3,9,24,38,89,-51,18
Livingston,279,1,23,3,10,82,43,39,72
Alloa,279,2,18,9,9,64,40,24,63
Albion,279,3,17,7,12,61,48,13,58
Brechin,279,4,17,6,13,49,42,7,57
Queen's Park,279,5,13,11,12,42,49,-7,50
Airdrieon,279,6,14,7,15,61,65,-4,49
Peterhead,279,7,12,10,14,43,53,-10,46
Stranraer,279,8,13,5,18,48,58,-10,44
East Fife,279,9,9,9,18,36,50,-14,36
Stenhousem'r,279,10,6,9,21,43,81,-38,27
Alloa,280,1,23,5,8,82,41,41,74
Livingston,280,2,20,5,11,67,42,25,65
Airdrieon,280,3,18,5,13,57,56,1,59
Brechin,280,4,17,6,13,54,49,5,57
Peterhead,280,5,16,6,14,53,48,5,54
Queen's Park,280,6,13,9,14,38,48,-10,48
East Fife,280,7,11,9,16,54,57,-3,42
Albion,280,8,10,9,17,50,59,-9,39
Stenhousem'r,280,9,9,9,18,52,79,-27,36
Stranraer,280,10,8,7,21,41,69,-28,31
Airdrieon,281,1,23,4,9,70,51,19,73
Alloa,281,2,20,5,11,72,45,27,65
Livingston,281,3,19,7,10,72,49,23,64
Brechin,281,4,16,7,13,52,44,8,55
Albion,281,5,13,8,15,50,52,-2,47
Stranraer,281,6,13,8,15,51,54,-3,47
Queen's Park,281,7,10,11,15,28,44,-16,41
East Fife,281,8,8,12,16,40,49,-9,36
Peterhead,281,9,9,9,18,48,67,-19,36
Stenhousem'r,281,10,8,11,17,47,75,-28,35
Livingston,282,1,22,2,12,79,50,29,68
Airdrieon,282,2,19,7,10,59,51,8,64
Brechin,282,3,18,6,12,57,49,8,60
Alloa,282,4,18,5,13,79,53,26,59
Peterhead,282,5,17,6,13,55,51,4,57
Albion,282,6,13,9,14,55,54,1,48
Stranraer,282,7,12,8,16,52,56,-4,44
East Fife,282,8,12,7,17,50,51,-1,43
Queen's Park,282,9,11,6,19,36,61,-25,39
Stenhousem'r,282,10,7,6,23,46,92,-46,27
Alloa,283,1,25,4,7,78,38,40,79
Livingston,283,2,22,4,10,82,46,36,70
Airdrieon,283,3,17,7,12,61,50,11,58
Brechin,283,4,17,5,14,57,50,7,56
Albion,283,5,16,7,13,51,49,2,55
Peterhead,283,6,13,8,15,44,48,-4,47
Stranraer,283,7,14,2,20,49,65,-16,44
Queen's Park,283,8,11,7,18,39,59,-20,40
Stenhousem'r,283,9,10,7,19,39,69,-30,37
East Fife,283,10,6,7,23,33,59,-26,25
Brechin,284,1,23,5,8,72,40,32,74
Airdrieon,284,2,20,6,10,74,56,18,66
Livingston,284,3,20,4,12,75,58,17,64
Alloa,284,4,17,11,8,68,42,26,62
Albion,284,5,13,11,12,54,56,-2,50
East Fife,284,6,13,9,14,49,46,3,48
Queen's Park,284,7,12,7,17,36,59,-23,43
Peterhead,284,8,9,9,18,47,65,-18,36
Stranraer,284,9,8,7,21,46,67,-21,31
Stenhousem'r,284,10,6,9,21,46,78,-32,27
Alloa,285,1,19,7,10,67,43,24,64
Livingston,285,2,19,6,11,72,55,17,63
Airdrieon,285,3,18,8,10,63,45,18,62
Albion,285,4,16,8,12,58,50,8,56
Brechin,285,5,16,8,12,49,44,5,56
East Fife,285,6,13,9,14,56,46,10,48
Peterhead,285,7,13,9,14,52,57,-5,48
Stranraer,285,8,12,3,21,55,71,-16,39
Queen's Park,285,9,10,7,19,31,58,-27,37
Stenhousem'r,285,10,8,7,21,47,81,-34,31
Livingston,286,1,23,6,7,80,45,35,75
Alloa,286,2,20,7,9,72,40,32,67
Airdrieon,286,3,16,6,14,62,55,7,54
Peterhead,286,4,13,10,13,48,51,-3,49
Queen's Park,286,5,13,10,13,41,46,-5,49
Brechin,286,6,14,6,16,44,54,-10,48
Stranraer,286,7,14,5,17,54,60,-6,47
Albion,286,8,13,7,16,47,56,-9,46
East Fife,286,9,10,7,19,44,57,-13,37
Stenhousem'r,286,10,8,8,20,45,73,-28,32
Livingston,287,1,19,9,8,77,51,26,66
Alloa,287,2,19,5,12,72,44,28,62
Airdrieon,287,3,17,7,12,62,60,2,58
Brechin,287,4,17,6,13,51,47,4,57
Albion,287,5,13,12,11,52,46,6,51
Peterhead,287,6,13,10,13,51,51,0,49
Stranraer,287,7,13,5,18,57,64,-7,44
East Fife,287,8,11,10,15,45,49,-4,43
Queen's Park,287,9,11,9,16,36,51,-15,42
Stenhousem'r,287,10,7,7,22,44,84,-40,28
Alloa,288,1,21,7,8,66,39,27,70
Airdrieon,288,2,19,8,9,64,50,14,65
Albion,288,3,18,6,12,60,46,14,60
Livingston,288,4,19,2,15,68,48,20,59
Stranraer,288,5,14,7,15,53,53,0,49
Brechin,288,6,13,8,15,44,50,-6,47
Queen's Park,288,7,14,5,17,40,52,-12,47
Peterhead,288,8,11,10,15,48,57,-9,43
East Fife,288,9,11,6,19,42,57,-15,39
Stenhousem'r,288,10,8,5,23,47,80,-33,29
Airdrieon,289,1,21,4,11,69,53,16,67
Livingston,289,2,19,8,9,71,43,28,65
Alloa,289,3,19,8,9,62,39,23,65
Brechin,289,4,19,6,11,50,38,12,63
Albion,289,5,17,8,11,54,40,14,59
Peterhead,289,6,15,6,15,40,42,-2,51
East Fife,289,7,11,10,15,42,45,-3,43
Queen's Park,289,8,11,8,17,34,52,-18,41
Stranraer,289,9,7,6,23,37,65,-28,27
Stenhousem'r,289,10,6,6,24,39,81,-42,24
Livingston,290,1,20,8,8,75,42,33,68
Airdrieon,290,2,19,8,9,57,41,16,65
Alloa,290,3,18,9,9,59,39,20,63
Brechin,290,4,15,6,15,51,46,5,51
Albion,290,5,14,7,15,53,59,-6,49
Peterhead,290,6,12,11,13,47,52,-5,47
East Fife,290,7,11,12,13,51,46,5,45
Queen's Park,290,8,11,10,15,35,47,-12,43
Stranraer,290,9,9,9,18,39,58,-19,36
Stenhousem'r,290,10,6,10,20,40,77,-37,28
Alloa,291,1,18,7,11,80,47,33,61
Airdrieon,291,2,16,8,12,58,54,4,56
Livingston,291,3,16,7,13,75,57,18,55
Brechin,291,4,16,5,15,55,54,1,53
Peterhead,291,5,14,11,11,51,53,-2,53
Stranraer,291,6,16,3,17,52,58,-6,51
East Fife,291,7,13,11,12,51,43,8,50
Albion,291,8,12,10,14,48,50,-2,46
Queen's Park,291,9,12,9,15,45,57,-12,45
Stenhousem'r,291,10,8,7,21,42,84,-42,31
Livingston,292,1,23,4,9,80,47,33,73
Alloa,292,2,19,7,10,68,51,17,64
Airdrieon,292,3,14,14,8,65,53,12,56
Brechin,292,4,17,4,15,49,54,-5,55
Albion,292,5,14,9,13,51,42,9,51
Peterhead,292,6,12,11,13,64,62,2,47
Queen's Park,292,7,14,5,17,36,46,-10,47
Stranraer,292,8,11,7,18,47,56,-9,40
East Fife,292,9,8,11,17,42,50,-8,35
Stenhousem'r,292,10,8,8,20,45,86,-41,32
Airdrieon,293,1,23,3,10,77,46,31,72
Alloa,293,2,21,6,9,81,43,38,69
Livingston,293,3,19,5,12,76,53,23,62
Brechin,293,4,17,6,13,54,50,4,57
East Fife,293,5,13,10,13,54,51,3,49
Queen's Park,293,6,14,5,17,39,52,-13,47
Peterhead,293,7,12,9,15,51,63,-12,45
Albion,293,8,11,9,16,45,62,-17,42
Stranraer,293,9,10,3,23,51,76,-25,33
Stenhousem'r,293,10,8,8,20,43,75,-32,32
Livingston,294,1,19,6,11,73,47,26,63
Alloa,294,2,16,11,9,71,50,21,59
Airdrieon,294,3,16,7,13,60,52,8,55
Albion,294,4,16,7,13,55,54,1,55
Stranraer,294,5,16,5,15,65,64,1,53
Peterhead,294,6,14,9,13,60,59,1,51
Brechin,294,7,15,4,17,49,53,-4,49
East Fife,294,8,12,8,16,54,57,-3,44
Queen's Park,294,9,13,4,19,41,60,-19,43
Stenhousem'r,294,10,9,7,20,54,86,-32,34
Livingston,295,1,23,3,10,85,44,41,72
Alloa,295,2,22,4,10,79,43,36,70
Peterhead,295,3,17,6,13,58,60,-2,57
Albion,295,4,13,12,11,63,52,11,51
Airdrieon,295,5,14,9,13,54,53,1,51
Stranraer,295,6,14,7,15,51,59,-8,49
Brechin,295,7,13,7,16,46,58,-12,46
East Fife,295,8,10,10,16,44,48,-4,40
Queen's Park,295,9,11,6,19,37,62,-25,39
Stenhousem'r,295,10,7,8,21,39,77,-38,29
Livingston,296,1,24,2,10,81,45,36,74
Airdrieon,296,2,17,7,12,63,58,5,58
Albion,296,3,17,6,13,55,47,8,57
Brechin,296,4,17,6,13,51,49,2,57
Alloa,296,5,16,7,13,62,50,12,55
East Fife,296,6,15,8,13,54,44,10,53
Queen's Park,296,7,13,8,15,48,57,-9,47
Peterhead,296,8,10,11,15,42,51,-9,41
Stranraer,296,9,11,6,19,53,62,-9,39
Stenhousem'r,296,10,5,9,22,39,85,-46,24
Livingston,297,1,23,4,9,80,45,35,73
Alloa,297,2,18,5,13,67,57,10,59
Airdrieon,297,3,17,7,12,57,51,6,58
Stranraer,297,4,16,4,16,54,60,-6,52
Brechin,297,5,14,6,16,46,55,-9,48
Queen's Park,297,6,13,9,14,38,50,-12,48
Peterhead,297,7,12,10,14,51,55,-4,46
East Fife,297,8,12,8,16,46,52,-6,44
Albion,297,9,11,7,18,53,49,4,40
Stenhousem'r,297,10,9,10,17,51,69,-18,37
Livingston,298,1,27,2,7,93,40,53,83
Alloa,298,2,19,4,13,65,43,22,61
Airdrieon,298,3,19,4,13,62,49,13,61
Brechin,298,4,18,4,14,53,45,8,58
Peterhead,298,5,14,7,15,50,50,0,49
Albion,298,6,15,4,17,47,52,-5,49
Stranraer,298,7,13,6,17,47,52,-5,45
Queen's Park,298,8,11,7,18,27,56,-29,40
Stenhousem'r,298,9,11,4,21,45,87,-42,37
East Fife,298,10,8,8,20,37,52,-15,32
Brechin,299,1,19,7,10,54,44,10,64
Livingston,299,2,18,7,11,74,47,27,61
Peterhead,299,3,16,10,10,61,51,10,58
Albion,299,4,15,9,12,56,56,0,54
Stranraer,299,5,15,6,15,66,66,0,51
Alloa,299,6,15,5,16,64,51,13,50
Queen's Park,299,7,12,10,14,33,45,-12,46
Airdrieon,299,8,13,7,16,49,66,-17,46
East Fife,299,9,12,6,18,51,47,4,42
Stenhousem'r,299,10,6,11,19,42,77,-35,29
Alloa,300,1,23,4,9,73,39,34,73
Livingston,300,2,18,7,11,79,51,28,61
Airdrieon,300,3,18,5,13,60,54,6,59
Albion,300,4,17,7,12,61,48,13,58
Brechin,300,5,17,6,13,45,42,3,57
Peterhead,300,6,16,4,16,49,53,-4,52
Stranraer,300,7,11,6,19,46,59,-13,39
Stenhousem'r,300,8,11,5,20,53,82,-29,38
East Fife,300,9,10,7,19,47,58,-11,37
Queen's Park,300,10,10,7,19,27,54,-27,37
Alloa,301,1,19,8,9,63,38,25,65
Brechin,301,2,18,10,8,54,37,17,64
Airdrieon,301,3,18,9,9,62,56,6,63
Albion,301,4,16,8,12,66,49,17,56
Livingston,301,5,16,5,15,69,56,13,53
Queen's Park,301,6,15,7,14,48,54,-6,52
Stranraer,301,7,13,8,15,50,61,-11,47
Peterhead,301,8,10,8,18,44,59,-15,38
Stenhousem'r,301,9,9,8,19,42,63,-21,35
East Fife,301,10,7,7,22,38,63,-25,28
Livingston,302,1,23,3,10,84,48,36,72
Airdrieon,302,2,18,7,11,66,50,16,61
Alloa,302,3,16,11,9,68,52,16,59
Albion,302,4,16,6,14,54,49,5,54
Brechin,302,5,15,9,12,44,44,0,54
Peterhead,302,6,13,8,15,45,51,-6,47
Stranraer,302,7,11,8,17,48,56,-8,41
Queen's Park,302,8,10,8,18,33,57,-24,38
East Fife,302,9,8,13,15,46,55,-9,37
Stenhousem'r,302,10,9,9,18,54,80,-26,36
Livingston,303,1,21,6,9,76,48,28,69
Alloa,303,2,16,11,9,71,45,26,59
Albion,303,3,16,7,13,59,53,6,55
East Fife,303,4,14,10,12,58,47,11,52
Peterhead,303,5,14,9,13,46,51,-5,51
Brechin,303,6,14,6,16,48,55,-7,48
Stranraer,303,7,14,5,17,55,58,-3,47
Airdrieon,303,8,13,8,15,52,60,-8,47
Queen's Park,303,9,13,5,18,45,57,-12,44
Stenhousem'r,303,10,8,7,21,44,80,-36,31
Alloa,304,1,18,10,8,80,38,42,64
Livingston,304,2,19,7,10,74,43,31,64
Airdrieon,304,3,19,6,11,60,50,10,63
Brechin,304,4,16,6,14,51,50,1,54
Stranraer,304,5,13,9,14,56,58,-2,48
Albion,304,6,12,11,13,55,55,0,47
East Fife,304,7,11,10,15,45,54,-9,43
Queen's Park,304,8,11,9,16,36,55,-19,42
Peterhead,304,9,9,11,16,45,68,-23,38
Stenhousem'r,304,10,9,7,20,46,77,-31,34
Livingston,305,1,23,2,11,85,52,33,71
Airdrieon,305,2,18,8,10,64,44,20,62
Brechin,305,3,18,4,14,56,46,10,58
Alloa,305,4,15,10,11,65,49,16,55
East Fife,305,5,12,12,12,50,42,8,48
Albion,305,6,13,7,16,59,57,2,46
Peterhead,305,7,13,7,16,40,50,-10,46
Stranraer,305,8,13,7,16,50,63,-13,46
Queen's Park,305,9,12,8,16,41,58,-17,44
Stenhousem'r,305,10,6,9,21,45,94,-49,27
Livingston,306,1,24,3,9,77,44,33,75
Alloa,306,2,20,6,10,73,41,32,66
Stranraer,306,3,17,6,13,63,52,11,57
Peterhead,306,4,15,7,14,54,46,8,52
Albion,306,5,14,9,13,50,44,6,51
Queen's Park,306,6,14,6,16,43,51,-8,48
Brechin,306,7,13,8,15,45,57,-12,47
East Fife,306,8,12,10,14,52,51,1,46
Airdrieon,306,9,14,4,18,64,79,-15,46
Stenhousem'r,306,10,4,7,25,37,93,-56,19
Brechin,307,1,19,4,13,54,47,7,61
Airdrieon,307,2,18,7,11,56,53,3,61
Peterhead,307,3,18,6,12,58,54,4,60
Albion,307,4,18,4,14,55,42,13,58
Alloa,307,5,17,6,13,66,46,20,57
Livingston,307,6,18,3,15,70,52,18,57
Stranraer,307,7,15,5,16,62,63,-1,50
East Fife,307,8,9,13,14,41,49,-8,40
Queen's Park,307,9,11,5,20,32,58,-26,38
Stenhousem'r,307,10,7,7,22,53,83,-30,28
Livingston,308,1,24,4,8,79,40,39,76
Alloa,308,2,19,7,10,72,46,26,64
Stranraer,308,3,18,3,15,69,51,18,57
Airdrieon,308,4,16,7,13,56,51,5,55
Brechin,308,5,14,10,12,41,47,-6,52
Albion,308,6,14,8,14,56,55,1,50
Queen's Park,308,7,14,7,15,41,51,-10,49
Peterhead,308,8,12,9,15,45,55,-10,45
East Fife,308,9,7,9,20,40,62,-22,30
Stenhousem'r,308,10,6,8,22,50,91,-41,26
Alloa,309,1,18,9,9,69,45,24,63
Livingston,309,2,18,6,12,67,46,21,60
East Fife,309,3,18,6,12,58,41,17,60
Brechin,309,4,17,8,11,50,45,5,59
Airdrieon,309,5,15,11,10,60,47,13,56
Stranraer,309,6,13,8,15,52,61,-9,47
Albion,309,7,12,7,17,42,53,-11,43
Queen's Park,309,8,10,9,17,35,58,-23,39
Peterhead,309,9,10,7,19,39,57,-18,37
Stenhousem'r,309,10,9,9,18,48,67,-19,36
Brechin,310,1,19,8,9,46,36,10,65
Alloa,310,2,17,9,10,62,44,18,60
Livingston,310,3,18,4,14,59,45,14,58
East Fife,310,4,13,12,11,48,39,9,51
Albion,310,5,13,10,13,50,45,5,49
Peterhead,310,6,11,14,11,46,47,-1,47
Airdrieon,310,7,13,7,16,43,54,-11,46
Queen's Park,310,8,11,11,14,34,45,-11,44
Stranraer,310,9,11,7,18,45,55,-10,40
Stenhousem'r,310,10,8,10,18,41,64,-23,34
Livingston,311,1,24,6,6,84,36,48,78
Alloa,311,2,19,7,10,79,46,33,64
Brechin,311,3,17,6,13,54,44,10,57
Albion,311,4,15,9,12,61,59,2,54
Peterhead,311,5,14,7,15,47,49,-2,49
Stranraer,311,6,16,1,19,55,73,-18,49
Airdrieon,311,7,13,7,16,52,60,-8,46
Queen's Park,311,8,11,10,15,31,46,-15,43
East Fife,311,9,10,11,15,47,47,0,41
Stenhousem'r,311,10,6,6,24,41,91,-50,24
Livingston,312,1,21,7,8,83,44,39,70
Alloa,312,2,20,6,10,77,51,26,66
Brechin,312,3,16,6,14,51,51,0,54
Airdrieon,312,4,15,7,14,51,56,-5,52
Peterhead,312,5,14,9,13,47,49,-2,51
Albion,312,6,14,8,14,51,54,-3,50
East Fife,312,7,13,8,15,55,56,-1,47
Stranraer,312,8,14,4,18,57,61,-4,46
Queen's Park,312,9,12,5,19,41,54,-13,41
Stenhousem'r,312,10,7,8,21,45,82,-37,29
Alloa,313,1,20,8,8,76,43,33,68
Brechin,313,2,19,5,12,58,43,15,62
Livingston,313,3,19,2,15,75,53,22,59
Airdrieon,313,4,18,3,15,57,66,-9,57
Peterhead,313,5,16,8,12,58,51,7,56
Albion,313,6,15,7,14,49,50,-1,52
Stranraer,313,7,15,5,16,52,56,-4,50
Queen's Park,313,8,10,8,18,33,56,-23,38
East Fife,313,9,8,10,18,46,56,-10,34
Stenhousem'r,313,10,7,10,19,49,79,-30,31
Brechin,314,1,18,7,11,53,44,9,61
Livingston,314,2,18,4,14,66,51,15,58
Airdrieon,314,3,17,7,12,51,46,5,58
Alloa,314,4,16,9,11,64,49,15,57
Queen's Park,314,5,15,10,11,45,41,4,55
Albion,314,6,13,10,13,46,45,1,49
East Fife,314,7,13,9,14,56,53,3,48
Peterhead,314,8,13,7,16,48,49,-1,46
Stranraer,314,9,11,9,16,50,55,-5,42
Stenhousem'r,314,10,7,6,23,35,81,-46,27
Livingston,315,1,17,8,11,72,43,29,59
Alloa,315,2,17,7,12,68,47,21,58
Airdrieon,315,3,15,9,12,52,52,0,54
Brechin,315,4,16,6,14,50,50,0,54
Albion,315,5,14,11,11,55,46,9,53
Peterhead,315,6,14,9,13,54,50,4,51
Stranraer,315,7,14,6,16,44,61,-17,48
Queen's Park,315,8,11,14,11,36,45,-9,47
East Fife,315,9,10,10,16,46,50,-4,40
Stenhousem'r,315,10,6,12,18,38,71,-33,30
Alloa,316,1,18,10,8,70,45,25,64
Livingston,316,2,19,5,12,71,53,18,62
Brechin,316,3,16,11,9,57,43,14,59
Airdrieon,316,4,17,8,11,60,54,6,59
Peterhead,316,5,16,7,13,60,53,7,55
East Fife,316,6,13,10,13,50,54,-4,49
Queen's Park,316,7,11,8,17,40,49,-9,41
Stranraer,316,8,12,5,19,51,67,-16,41
Albion,316,9,10,9,17,44,54,-10,39
Stenhousem'r,316,10,9,5,22,40,71,-31,32
Livingston,317,1,25,3,8,80,42,38,78
Brechin,317,2,22,5,9,61,43,18,71
Airdrieon,317,3,20,7,9,65,42,23,67
Alloa,317,4,19,3,14,62,41,21,60
Queen's Park,317,5,13,8,15,42,53,-11,47
Albion,317,6,13,6,17,49,59,-10,45
Peterhead,317,7,12,8,16,43,62,-19,44
East Fife,317,8,9,8,19,45,55,-10,35
Stranraer,317,9,9,8,19,52,67,-15,35
Stenhousem'r,317,10,5,10,21,44,79,-35,25
Livingston,318,1,22,5,9,75,39,36,71
Alloa,318,2,21,7,8,67,37,30,70
Brechin,318,3,18,4,14,51,40,11,58
Airdrieon,318,4,16,7,13,52,45,7,55
Albion,318,5,12,11,13,44,49,-5,47
Peterhead,318,6,13,6,17,40,52,-12,45
Stranraer,318,7,13,4,19,40,62,-22,43
Queen's Park,318,8,11,9,16,27,40,-13,42
East Fife,318,9,10,9,17,45,53,-8,39
Stenhousem'r,318,10,8,10,18,41,65,-24,34
Brechin,319,1,20,6,10,57,43,14,66
Livingston,319,2,20,5,11,66,45,21,65
Alloa,319,3,19,7,10,76,45,31,64
Airdrieon,319,4,16,6,14,56,55,1,54
Albion,319,5,14,8,14,51,46,5,50
Queen's Park,319,6,14,4,18,38,54,-16,46
Peterhead,319,7,11,11,14,44,51,-7,44
East Fife,319,8,11,10,15,51,52,-1,43
Stranraer,319,9,12,7,17,46,62,-16,43
Stenhousem'r,319,10,8,6,22,49,81,-32,30
Alloa,320,1,22,4,10,79,43,36,70
Airdrieon,320,2,21,5,10,57,35,22,68
Livingston,320,3,20,3,13,72,55,17,63
East Fife,320,4,17,6,13,62,52,10,57
Albion,320,5,13,9,14,60,55,5,48
Stranraer,320,6,14,5,17,50,55,-5,47
Queen's Park,320,7,13,6,17,42,57,-15,45
Brechin,320,8,11,7,18,49,66,-17,40
Peterhead,320,9,9,12,15,40,57,-17,39
Stenhousem'r,320,10,9,5,22,43,79,-36,32
Livingston,321,1,22,5,9,80,50,30,71
Alloa,321,2,20,9,7,66,37,29,69
Peterhead,321,3,17,9,10,61,47,14,60
Airdrieon,321,4,18,4,14,68,62,6,58
Brechin,321,5,15,8,13,55,55,0,53
East Fife,321,6,13,10,13,54,45,9,49
Albion,321,7,12,5,19,46,60,-14,41
Stranraer,321,8,10,7,19,43,58,-15,37
Stenhousem'r,321,9,10,7,19,55,81,-26,37
Queen's Park,321,10,9,4,23,31,64,-33,31
Alloa,322,1,21,7,8,73,35,38,70
Airdrieon,322,2,21,6,9,64,46,18,69
Livingston,322,3,22,2,12,73,46,27,68
Brechin,322,4,16,7,13,47,52,-5,55
Queen's Park,322,5,15,5,16,40,50,-10,50
Peterhead,322,6,13,9,14,54,48,6,48
East Fife,322,7,11,11,14,49,47,2,44
Albion,322,8,12,8,16,48,57,-9,44
Stenhousem'r,322,9,6,10,20,36,77,-41,28
Stranraer,322,10,6,9,21,40,66,-26,27
Alloa,323,1,20,6,10,72,42,30,66
Brechin,323,2,19,8,9,58,41,17,65
Airdrieon,323,3,18,6,12,72,53,19,60
East Fife,323,4,16,10,10,56,38,18,58
Livingston,323,5,17,6,13,74,59,15,57
Albion,323,6,15,10,11,53,56,-3,55
Peterhead,323,7,11,9,16,44,55,-11,42
Stranraer,323,8,10,6,20,47,68,-21,36
Queen's Park,323,9,9,6,21,32,60,-28,33
Stenhousem'r,323,10,7,9,20,52,88,-36,30
Livingston,324,1,20,3,13,81,63,18,63
Alloa,324,2,19,5,12,72,50,22,62
Airdrieon,324,3,15,8,13,50,55,-5,53
Peterhead,324,4,15,7,14,49,53,-4,52
Brechin,324,5,15,6,15,42,56,-14,51
Albion,324,6,13,8,15,64,50,14,47
East Fife,324,7,13,8,15,46,41,5,47
Queen's Park,324,8,14,5,17,44,55,-11,47
Stranraer,324,9,13,5,18,54,65,-11,44
Stenhousem'r,324,10,12,7,17,50,64,-14,43
Livingston,325,1,18,7,11,73,55,18,61
Brechin,325,2,18,7,11,57,45,12,61
Airdrieon,325,3,18,7,11,56,51,5,61
Alloa,325,4,16,10,10,64,44,20,58
East Fife,325,5,13,11,12,62,48,14,50
Stranraer,325,6,14,8,14,53,52,1,50
Albion,325,7,13,8,15,50,51,-1,47
Queen's Park,325,8,12,7,17,34,50,-16,43
Peterhead,325,9,9,12,15,44,56,-12,39
Stenhousem'r,325,10,7,7,22,44,85,-41,28
Livingston,326,1,20,7,9,75,43,32,67
Alloa,326,2,19,9,8,71,45,26,66
Airdrieon,326,3,18,4,14,55,50,5,58
East Fife,326,4,15,8,13,68,55,13,53
Peterhead,326,5,16,5,15,53,51,2,53
Brechin,326,6,17,2,17,52,53,-1,53
Albion,326,7,12,9,15,48,55,-7,45
Stranraer,326,8,14,2,20,43,62,-19,44
Queen's Park,326,9,11,10,15,37,47,-10,43
Stenhousem'r,326,10,8,4,24,45,86,-41,28
Alloa,327,1,21,8,7,78,44,34,71
Livingston,327,2,20,8,8,74,45,29,68
Airdrieon,327,3,18,5,13,64,58,6,59
Peterhead,327,4,14,8,14,60,58,2,50
Albion,327,5,14,6,16,55,56,-1,48
East Fife,327,6,13,9,14,45,49,-4,48
Brechin,327,7,11,9,16,51,61,-10,42
Stenhousem'r,327,8,11,7,18,52,70,-18,40
Queen's Park,327,9,11,6,19,43,63,-20,39
Stranraer,327,10,10,8,18,43,61,-18,38
Alloa,328,1,19,10,7,68,38,30,67
Livingston,328,2,19,8,9,71,45,26,65
Airdrieon,328,3,19,5,12,65,50,15,62
Brechin,328,4,18,5,13,52,48,4,59
Peterhead,328,5,17,6,13,55,43,12,57
East Fife,328,6,12,9,15,50,56,-6,45
Stranraer,328,7,12,6,18,44,60,-16,42
Queen's Park,328,8,11,6,19,33,51,-18,39
Stenhousem'r,328,9,8,9,19,42,70,-28,33
Albion,328,10,6,14,16,35,54,-19,32
Livingston,329,1,24,4,8,79,43,36,76
Alloa,329,2,19,8,9,72,49,23,65
Airdrieon,329,3,18,5,13,62,57,5,59
Brechin,329,4,18,5,13,53,50,3,59
Peterhead,329,5,16,4,16,50,52,-2,52
East Fife,329,6,13,6,17,47,47,0,45
Albion,329,7,12,8,16,55,59,-4,44
Stranraer,329,8,12,6,18,52,57,-5,42
Queen's Park,329,9,12,4,20,41,58,-17,40
Stenhousem'r,329,10,8,6,22,46,85,-39,30
Alloa,330,1,20,9,7,72,46,26,69
Livingston,330,2,20,6,10,90,56,34,66
Airdrieon,330,3,18,6,12,56,53,3,60
Brechin,330,4,18,4,14,58,48,10,58
Peterhead,330,5,15,7,14,45,48,-3,52
East Fife,330,6,13,7,16,53,48,5,46
Albion,330,7,12,8,16,47,57,-10,44
Stranraer,330,8,11,7,18,47,64,-17,40
Queen's Park,330,9,12,4,20,37,58,-21,40
Stenhousem'r,330,10,7,10,19,46,73,-27,31
Livingston,331,1,19,5,12,63,48,15,62
Brechin,331,2,18,7,11,49,44,5,61
Queen's Park,331,3,16,7,13,43,44,-1,55
Airdrieon,331,4,14,9,13,55,51,4,51
Peterhead,331,5,15,6,15,52,54,-2,51
Alloa,331,6,14,8,14,56,46,10,50
Stranraer,331,7,15,4,17,52,53,-1,49
Albion,331,8,13,8,15,46,54,-8,47
East Fife,331,9,12,7,17,53,48,5,43
Stenhousem'r,331,10,8,11,17,47,74,-27,35
Livingston,332,1,23,3,10,85,52,33,72
Brechin,332,2,20,5,11,61,47,14,65
Albion,332,3,17,10,9,60,44,16,61
Airdrieon,332,4,18,5,13,61,57,4,59
Alloa,332,5,14,9,13,54,46,8,51
Stranraer,332,6,13,4,19,55,68,-13,43
Peterhead,332,7,11,8,17,45,53,-8,41
East Fife,332,8,10,10,16,45,52,-7,40
Queen's Park,332,9,11,7,18,43,63,-20,40
Stenhousem'r,332,10,8,9,19,44,71,-27,33
Livingston,333,1,23,4,9,84,46,38,73
Alloa,333,2,18,9,9,79,51,28,63
Airdrieon,333,3,15,10,11,63,65,-2,55
Brechin,333,4,14,8,14,56,53,3,50
Queen's Park,333,5,13,10,13,48,54,-6,49
Peterhead,333,6,13,8,15,43,48,-5,47
Albion,333,7,13,6,17,63,71,-8,45
East Fife,333,8,11,9,16,52,59,-7,42
Stranraer,333,9,9,12,15,47,59,-12,39
Stenhousem'r,333,10,8,10,18,50,79,-29,34
Livingston,334,1,23,5,8,76,37,39,74
Alloa,334,2,18,12,6,64,39,25,66
Brechin,334,3,17,9,10,59,44,15,60
Peterhead,334,4,16,8,12,53,47,6,56
Airdrieon,334,5,13,8,15,54,61,-7,47
Stranraer,334,6,13,6,17,58,64,-6,45
East Fife,334,7,11,9,16,53,49,4,42
Albion,334,8,10,10,16,45,60,-15,40
Queen's Park,334,9,8,12,16,35,57,-22,36
Stenhousem'r,334,10,8,7,21,38,77,-39,31
Livingston,335,1,22,7,7,70,41,29,73
Alloa,335,2,17,12,7,62,36,26,63
Airdrieon,335,3,17,5,14,63,62,1,56
East Fife,335,4,15,10,11,58,43,15,55
Albion,335,5,15,7,14,59,56,3,52
Peterhead,335,6,14,6,16,48,48,0,48
Stranraer,335,7,12,5,19,50,63,-13,41
Brechin,335,8,11,8,17,55,69,-14,41
Queen's Park,335,9,11,7,18,32,49,-17,40
Stenhousem'r,335,10,7,11,18,49,79,-30,32
Livingston,336,1,23,4,9,87,40,47,73
Alloa,336,2,20,5,11,70,50,20,65
Brechin,336,3,19,5,12,52,45,7,62
Peterhead,336,4,17,6,13,53,47,6,57
Airdrieon,336,5,16,7,13,56,54,2,55
Queen's Park,336,6,14,5,17,40,49,-9,47
Stranraer,336,7,14,2,20,52,64,-12,44
East Fife,336,8,10,11,15,49,55,-6,41
Albion,336,9,10,10,16,41,57,-16,40
Stenhousem'r,336,10,6,7,23,36,75,-39,25
Airdrieon,337,1,21,5,10,72,56,16,68
Alloa,337,2,18,9,9,70,46,24,63
Livingston,337,3,18,6,12,75,61,14,60
Brechin,337,4,15,6,15,50,51,-1,51
Queen's Park,337,5,15,6,15,40,50,-10,51
Peterhead,337,6,13,9,14,51,53,-2,48
East Fife,337,7,11,9,16,52,58,-6,42
Stenhousem'r,337,8,12,6,18,52,71,-19,42
Albion,337,9,12,5,19,51,59,-8,41
Stranraer,337,10,11,7,18,57,65,-8,40
Alloa,338,1,16,12,8,69,40,29,60
Airdrieon,338,2,17,8,11,58,52,6,59
Albion,338,3,17,7,12,63,59,4,58
Livingston,338,4,17,6,13,73,48,25,57
Stranraer,338,5,16,8,12,61,50,11,56
Brechin,338,6,16,4,16,47,54,-7,52
East Fife,338,7,14,7,15,51,49,2,49
Peterhead,338,8,9,13,14,45,60,-15,40
Queen's Park,338,9,11,7,18,35,53,-18,40
Stenhousem'r,338,10,7,8,21,48,85,-37,29
Livingston,339,1,22,7,7,81,42,39,73
Alloa,339,2,21,8,7,66,39,27,71
Brechin,339,3,17,8,11,57,45,12,59
Airdrieon,339,4,16,7,13,70,60,10,55
Stranraer,339,5,14,5,17,44,61,-17,47
Peterhead,339,6,13,7,16,49,53,-4,46
East Fife,339,7,10,11,15,48,52,-4,41
Queen's Park,339,8,10,11,15,30,44,-14,41
Albion,339,9,9,11,16,48,56,-8,38
Stenhousem'r,339,10,8,5,23,46,87,-41,29
Livingston,340,1,23,5,8,77,44,33,74
Brechin,340,2,19,3,14,59,48,11,60
Alloa,340,3,15,11,10,67,50,17,56
Albion,340,4,15,9,12,50,48,2,54
Airdrieon,340,5,14,10,12,65,64,1,52
Peterhead,340,6,13,7,16,47,55,-8,46
Queen's Park,340,7,13,7,16,33,49,-16,46
East Fife,340,8,10,10,16,44,54,-10,40
Stranraer,340,9,10,8,18,60,67,-7,38
Stenhousem'r,340,10,9,8,19,48,71,-23,35
Alloa,341,1,23,6,7,79,40,39,75
Livingston,341,2,18,9,9,76,57,19,63
Airdrieon,341,3,18,7,11,59,51,8,61
Brechin,341,4,17,1,18,50,56,-6,52
Peterhead,341,5,14,9,13,57,59,-2,51
East Fife,341,6,13,8,15,51,44,7,47
Stranraer,341,7,13,7,16,46,51,-5,46
Albion,341,8,11,8,17,50,61,-11,41
Stenhousem'r,341,9,9,8,19,54,77,-23,35
Queen's Park,341,10,9,7,20,29,55,-26,34
Alloa,342,1,20,5,11,73,41,32,65
Livingston,342,2,19,3,14,65,46,19,60
Albion,342,3,16,11,9,64,46,18,59
Airdrieon,342,4,16,10,10,60,53,7,58
Brechin,342,5,15,7,14,56,58,-2,52
Queen's Park,342,6,15,5,16,40,51,-11,50
East Fife,342,7,12,12,12,55,50,5,48
Peterhead,342,8,13,9,14,50,61,-11,48
Stranraer,342,9,12,5,19,44,61,-17,41
Stenhousem'r,342,10,5,7,24,36,76,-40,22
Alloa,343,1,23,7,6,77,40,37,76
Airdrieon,343,2,20,5,11,64,55,9,65
Livingston,343,3,17,5,14,75,58,17,56
Brechin,343,4,16,8,12,49,42,7,56
Peterhead,343,5,15,6,15,52,62,-10,51
Albion,343,6,13,6,17,45,50,-5,45
Queen's Park,343,7,13,5,18,38,49,-11,44
Stranraer,343,8,11,7,18,47,58,-11,40
East Fife,343,9,9,10,17,41,51,-10,37
Stenhousem'r,343,10,10,7,19,45,68,-23,37
Alloa,344,1,19,11,6,67,34,33,68
Livingston,344,2,17,8,11,71,51,20,59
Brechin,344,3,15,9,12,43,42,1,54
Peterhead,344,4,15,9,12,43,50,-7,54
Stranraer,344,5,15,7,14,54,52,2,52
Airdrieon,344,6,14,8,14,57,61,-4,50
East Fife,344,7,12,10,14,51,49,2,46
Albion,344,8,13,7,16,45,49,-4,46
Queen's Park,344,9,11,8,17,31,42,-11,41
Stenhousem'r,344,10,7,7,22,43,75,-32,28
Livingston,345,1,21,4,11,70,49,21,67
Alloa,345,2,18,8,10,67,55,12,62
Brechin,345,3,16,9,11,53,48,5,57
Airdrieon,345,4,15,6,15,54,51,3,51
East Fife,345,5,14,8,14,52,46,6,50
Albion,345,6,14,7,15,54,52,2,49
Peterhead,345,7,14,6,16,43,55,-12,48
Queen's Park,345,8,14,5,17,41,49,-8,47
Stranraer,345,9,12,8,16,51,52,-1,44
Stenhousem'r,345,10,7,9,20,47,75,-28,30
Livingston,346,1,20,5,11,73,45,28,65
Airdrieon,346,2,18,6,12,57,54,3,60
Brechin,346,3,18,6,12,43,40,3,60
Alloa,346,4,17,7,12,67,51,16,58
Albion,346,5,15,7,14,53,46,7,52
Peterhead,346,6,14,8,14,60,60,0,50
Stranraer,346,7,15,4,17,58,56,2,49
East Fife,346,8,11,7,18,46,56,-10,40
Queen's Park,346,9,11,6,19,33,55,-22,39
Stenhousem'r,346,10,9,8,19,50,77,-27,35
Livingston,347,1,22,6,8,73,38,35,72
Alloa,347,2,16,10,10,67,49,18,58
Airdrieon,347,3,15,8,13,60,50,10,53
Brechin,347,4,15,8,13,48,48,0,53
Queen's Park,347,5,15,6,15,43,47,-4,51
Stranraer,347,6,13,9,14,53,57,-4,48
Peterhead,347,7,12,9,15,46,50,-4,45
Albion,347,8,12,8,16,53,67,-14,44
East Fife,347,9,8,14,14,46,56,-10,38
Stenhousem'r,347,10,8,10,18,56,83,-27,34
Livingston,348,1,21,6,9,79,40,39,69
Alloa,348,2,20,5,11,73,50,23,65
Peterhead,348,3,18,7,11,57,44,13,61
Airdrieon,348,4,15,8,13,54,55,-1,53
Brechin,348,5,16,3,17,52,59,-7,51
Albion,348,6,13,7,16,48,57,-9,46
Queen's Park,348,7,13,6,17,37,51,-14,45
Stranraer,348,8,12,6,18,49,59,-10,42
Stenhousem'r,348,9,12,5,19,44,70,-26,41
East Fife,348,10,9,9,18,46,54,-8,36
Livingston,349,1,21,4,11,89,53,36,67
Alloa,349,2,20,7,9,68,42,26,67
Airdrieon,349,3,18,6,12,58,49,9,60
East Fife,349,4,17,7,12,60,42,18,58
Albion,349,5,14,6,16,50,56,-6,48
Peterhead,349,6,13,6,17,42,53,-11,45
Stranraer,349,7,12,8,16,53,60,-7,44
Queen's Park,349,8,13,4,19,36,63,-27,43
Brechin,349,9,13,2,21,39,54,-15,41
Stenhousem'r,349,10,11,6,19,52,75,-23,39
Livingston,350,1,21,7,8,87,48,39,70
Alloa,350,2,19,8,9,63,38,25,65
Airdrieon,350,3,17,7,12,63,60,3,58
Brechin,350,4,15,7,14,53,52,1,52
East Fife,350,5,14,9,13,50,44,6,51
Albion,350,6,13,9,14,52,45,7,48
Queen's Park,350,7,12,10,14,45,55,-10,46
Peterhead,350,8,13,6,17,45,56,-11,45
Stranraer,350,9,10,5,21,44,67,-23,35
Stenhousem'r,350,10,9,6,21,41,78,-37,33
Livingston,351,1,22,3,11,83,54,29,69
Airdrieon,351,2,18,8,10,60,54,6,62
Alloa,351,3,17,8,11,62,42,20,59
Brechin,351,4,17,6,13,54,52,2,57
Stranraer,351,5,15,6,15,63,57,6,51
Albion,351,6,13,9,14,48,51,-3,48
Queen's Park,351,7,13,7,16,46,51,-5,46
Peterhead,351,8,13,7,16,46,54,-8,46
East Fife,351,9,9,11,16,41,55,-14,38
Stenhousem'r,351,10,7,7,22,51,84,-33,28
Livingston,352,1,22,4,10,79,45,34,70
Alloa,352,2,20,6,10,64,36,28,66
Airdrieon,352,3,19,7,10,68,48,20,64
Brechin,352,4,15,5,16,41,49,-8,50
Queen's Park,352,5,13,9,14,37,50,-13,48
Albion,352,6,13,8,15,58,59,-1,47
Stranraer,352,7,14,5,17,50,59,-9,47
East Fife,352,8,12,9,15,48,52,-4,45
Peterhead,352,9,9,9,18,36,58,-22,36
Stenhousem'r,352,10,9,6,21,53,78,-25,33
Livingston,353,1,21,4,11,79,51,28,67
Airdrieon,353,2,17,9,10,65,49,16,60
Alloa,353,3,16,8,12,75,47,28,56
Albion,353,4,14,11,11,62,56,6,53
Peterhead,353,5,12,13,11,47,53,-6,49
Stranraer,353,6,14,5,17,51,61,-10,47
Brechin,353,7,14,5,17,44,54,-10,47
East Fife,353,8,12,10,14,44,46,-2,46
Queen's Park,353,9,10,9,17,35,54,-19,39
Stenhousem'r,353,10,10,6,20,55,86,-31,36
Livingston,354,1,23,6,7,81,44,37,75
Alloa,354,2,19,8,9,68,38,30,65
Peterhead,354,3,16,10,10,59,45,14,58
Airdrieon,354,4,15,9,12,55,53,2,54
Brechin,354,5,13,7,16,38,47,-9,46
East Fife,354,6,12,9,15,47,46,1,45
Stranraer,354,7,13,4,19,46,62,-16,43
Albion,354,8,12,6,18,45,53,-8,42
Queen's Park,354,9,11,9,16,33,49,-16,42
Stenhousem'r,354,10,9,6,21,52,87,-35,33
Livingston,355,1,22,5,9,73,49,24,71
Alloa,355,2,20,8,8,71,50,21,68
Airdrieon,355,3,17,9,10,69,58,11,60
Peterhead,355,4,17,6,13,61,48,13,57
Albion,355,5,14,8,14,55,50,5,50
Brechin,355,6,14,8,14,44,50,-6,50
Stranraer,355,7,12,8,16,40,47,-7,44
East Fife,355,8,10,10,16,49,52,-3,40
Queen's Park,355,9,10,9,17,36,51,-15,39
Stenhousem'r,355,10,6,5,25,37,80,-43,23
Livingston,356,1,22,5,9,82,45,37,71
Airdrieon,356,2,19,7,10,62,53,9,64
Alloa,356,3,15,9,12,69,54,15,54
Peterhead,356,4,16,5,15,49,52,-3,53
Brechin,356,5,15,7,14,51,46,5,52
East Fife,356,6,13,10,13,55,50,5,49
Stranraer,356,7,14,5,17,58,70,-12,47
Albion,356,8,11,8,17,48,61,-13,41
Queen's Park,356,9,10,7,19,38,55,-17,37
Stenhousem'r,356,10,8,11,17,40,66,-26,35
Livingston,357,1,21,4,11,72,50,22,67
Alloa,357,2,17,10,9,65,45,20,61
Peterhead,357,3,19,4,13,63,50,13,61
Albion,357,4,16,9,11,62,50,12,57
Airdrieon,357,5,14,8,14,52,61,-9,50
Brechin,357,6,14,7,15,48,50,-2,49
Stranraer,357,7,14,6,16,52,56,-4,48
Queen's Park,357,8,12,9,15,42,49,-7,45
East Fife,357,9,10,7,19,42,55,-13,37
Stenhousem'r,357,10,7,8,21,42,74,-32,29
Livingston,358,1,21,7,8,80,48,32,70
Alloa,358,2,22,4,10,66,43,23,70
Airdrieon,358,3,19,5,12,62,50,12,62
Albion,358,4,18,7,11,62,48,14,61
Brechin,358,5,14,9,13,54,52,2,51
Stranraer,358,6,14,7,15,56,54,2,49
Peterhead,358,7,13,8,15,52,52,0,47
East Fife,358,8,7,15,14,44,54,-10,36
Queen's Park,358,9,9,7,20,36,61,-25,34
Stenhousem'r,358,10,6,5,25,43,93,-50,23
Livingston,359,1,20,6,10,71,44,27,66
Alloa,359,2,18,8,10,62,41,21,62
Airdrieon,359,3,17,9,10,57,47,10,60
East Fife,359,4,17,8,11,53,45,8,59
Albion,359,5,13,11,12,58,50,8,50
Brechin,359,6,15,4,17,47,52,-5,49
Peterhead,359,7,13,5,18,45,60,-15,44
Queen's Park,359,8,11,8,17,38,53,-15,41
Stranraer,359,9,11,7,18,52,60,-8,40
Stenhousem'r,359,10,7,10,19,42,73,-31,31
Alloa,360,1,26,3,7,79,39,40,81
Livingston,360,2,25,2,9,85,47,38,77
Brechin,360,3,17,7,12,63,50,13,58
Airdrieon,360,4,15,8,13,46,47,-1,53
Albion,360,5,14,6,16,64,61,3,48
Peterhead,360,6,12,8,16,48,61,-13,44
East Fife,360,7,10,10,16,43,51,-8,40
Stranraer,360,8,11,7,18,48,64,-16,40
Queen's Park,360,9,10,5,21,34,58,-24,35
Stenhousem'r,360,10,8,8,20,50,82,-32,32
Alloa,361,1,20,9,7,81,41,40,69
Livingston,361,2,19,5,12,73,51,22,62
East Fife,361,3,15,8,13,57,56,1,53
Brechin,361,4,16,5,15,60,68,-8,53
Queen's Park,361,5,15,7,14,33,45,-12,52
Airdrieon,361,6,13,10,13,60,57,3,49
Peterhead,361,7,12,9,15,66,64,2,45
Albion,361,8,11,11,14,55,56,-1,44
Stranraer,361,9,11,9,16,54,67,-13,42
Stenhousem'r,361,10,7,9,20,49,83,-34,30
Livingston,362,1,24,4,8,80,47,33,76
Alloa,362,2,19,7,10,68,41,27,64
Brechin,362,3,18,5,13,56,54,2,59
Albion,362,4,16,8,12,53,44,9,56
Queen's Park,362,5,16,6,14,43,45,-2,54
Peterhead,362,6,15,6,15,57,55,2,51
Stranraer,362,7,15,3,18,55,58,-3,48
Airdrieon,362,8,12,8,16,48,54,-6,44
East Fife,362,9,9,7,20,37,53,-16,34
Stenhousem'r,362,10,5,8,23,31,77,-46,23
Livingston,363,1,22,4,10,80,52,28,70
Alloa,363,2,19,7,10,74,48,26,64
Brechin,363,3,18,8,10,54,45,9,62
Airdrieon,363,4,17,4,15,56,54,2,55
Peterhead,363,5,15,9,12,56,52,4,54
Albion,363,6,16,6,14,55,54,1,54
Stranraer,363,7,13,7,16,48,58,-10,46
East Fife,363,8,10,7,19,40,51,-11,37
Queen's Park,363,9,9,9,18,39,55,-16,36
Stenhousem'r,363,10,7,7,22,46,79,-33,28
Brechin,364,1,19,5,12,49,43,6,62
Alloa,364,2,17,9,10,63,36,27,60
Albion,364,3,17,8,11,59,44,15,59
Livingston,364,4,17,5,14,67,47,20,56
Stranraer,364,5,12,11,13,47,50,-3,47
Airdrieon,364,6,13,8,15,53,60,-7,47
Peterhead,364,7,12,10,14,48,56,-8,46
East Fife,364,8,13,6,17,51,60,-9,45
Queen's Park,364,9,10,10,16,33,47,-14,40
Stenhousem'r,364,10,10,8,18,47,74,-27,38
Livingston,365,1,24,3,9,87,44,43,75
Airdrieon,365,2,17,8,11,65,53,12,59
Alloa,365,3,17,7,12,68,51,17,58
Albion,365,4,15,8,13,50,45,5,53
Brechin,365,5,15,7,14,44,44,0,52
Peterhead,365,6,12,10,14,46,52,-6,46
Stranraer,365,7,13,7,16,50,62,-12,46
Queen's Park,365,8,12,9,15,28,41,-13,45
East Fife,365,9,10,11,15,43,47,-4,41
Stenhousem'r,365,10,8,4,24,37,79,-42,28
Airdrieon,366,1,19,6,11,59,45,14,63
Livingston,366,2,18,7,11,74,50,24,61
Peterhead,366,3,18,7,11,59,51,8,61
Alloa,366,4,17,8,11,76,49,27,59
Brechin,366,5,15,6,15,50,57,-7,51
Albion,366,6,14,8,14,52,56,-4,50
Stenhousem'r,366,7,11,8,17,54,90,-36,41
Queen's Park,366,8,9,13,14,36,52,-16,40
East Fife,366,9,10,8,18,56,52,4,38
Stranraer,366,10,7,13,16,48,62,-14,34
Alloa,367,1,19,11,6,74,41,33,68
Livingston,367,2,20,5,11,78,46,32,65
Airdrieon,367,3,19,7,10,56,49,7,64
Albion,367,4,16,8,12,54,41,13,56
East Fife,367,5,11,12,13,51,51,0,45
Peterhead,367,6,12,9,15,42,47,-5,45
Stranraer,367,7,12,7,17,48,57,-9,43
Brechin,367,8,13,4,19,41,53,-12,43
Queen's Park,367,9,11,7,18,34,59,-25,40
Stenhousem'r,367,10,8,8,20,51,85,-34,32
Livingston,368,1,24,4,8,74,37,37,76
Alloa,368,2,19,7,10,73,44,29,64
Airdrieon,368,3,18,9,9,62,49,13,63
Brechin,368,4,18,4,14,46,48,-2,58
Albion,368,5,15,10,11,49,41,8,55
Peterhead,368,6,13,8,15,42,57,-15,47
Stranraer,368,7,11,10,15,56,60,-4,43
Queen's Park,368,8,11,6,19,38,56,-18,39
East Fife,368,9,9,7,20,46,54,-8,34
Stenhousem'r,368,10,6,7,23,45,85,-40,25
Alloa,369,1,22,6,8,92,42,50,72
Livingston,369,2,22,4,10,81,47,34,70
Brechin,369,3,18,6,12,52,41,11,60
Airdrieon,369,4,15,8,13,57,65,-8,53
Albion,369,5,15,7,14,51,47,4,52
Peterhead,369,6,14,7,15,49,55,-6,49
East Fife,369,7,13,8,15,49,49,0,47
Queen's Park,369,8,11,7,18,36,55,-19,40
Stranraer,369,9,10,7,19,38,62,-24,37
Stenhousem'r,369,10,7,6,23,47,89,-42,27
Alloa,370,1,19,8,9,67,41,26,65
Livingston,370,2,21,1,14,67,48,19,64
Peterhead,370,3,15,9,12,49,44,5,54
Airdrieon,370,4,15,8,13,57,56,1,53
Brechin,370,5,15,8,13,42,45,-3,53
Queen's Park,370,6,13,9,14,45,51,-6,48
East Fife,370,7,11,12,13,46,45,1,45
Albion,370,8,9,13,14,50,53,-3,40
Stranraer,370,9,10,9,17,44,60,-16,39
Stenhousem'r,370,10,9,9,18,52,76,-24,36
Livingston,371,1,25,2,9,89,44,45,77
Peterhead,371,2,18,10,8,66,44,22,64
Alloa,371,3,18,8,10,66,45,21,62
Brechin,371,4,17,8,11,45,40,5,59
Stranraer,371,5,14,4,18,54,62,-8,46
Albion,371,6,12,8,16,43,50,-7,44
East Fife,371,7,12,7,17,45,46,-1,43
Airdrieon,371,8,12,6,18,50,70,-20,42
Queen's Park,371,9,12,5,19,35,55,-20,41
Stenhousem'r,371,10,7,8,21,48,85,-37,29
Livingston,372,1,20,6,10,81,51,30,66
Alloa,372,2,15,12,9,75,55,20,57
Brechin,372,3,18,3,15,65,66,-1,57
Stranraer,372,4,16,6,14,55,51,4,54
Peterhead,372,5,12,11,13,57,55,2,47
Albion,372,6,13,8,15,50,52,-2,47
Airdrieon,372,7,13,8,15,52,56,-4,47
Queen's Park,372,8,13,8,15,40,50,-10,47
East Fife,372,9,11,10,15,47,49,-2,43
Stenhousem'r,372,10,9,8,19,51,88,-37,35
Alloa,373,1,22,7,7,81,49,32,73
Livingston,373,2,17,7,12,79,57,22,58
Airdrieon,373,3,18,4,14,60,48,12,58
Albion,373,4,13,12,11,54,43,11,51
Queen's Park,373,5,15,5,16,42,49,-7,50
Brechin,373,6,13,8,15,40,55,-15,47
East Fife,373,7,13,7,16,50,48,2,46
Stranraer,373,8,12,8,16,49,58,-9,44
Peterhead,373,9,11,11,14,46,55,-9,44
Stenhousem'r,373,10,6,11,19,48,87,-39,29
Livingston,374,1,22,6,8,64,34,30,72
Brechin,374,2,20,6,10,59,40,19,66
Alloa,374,3,17,9,10,64,45,19,60
Airdrieon,374,4,17,7,12,54,53,1,58
Peterhead,374,5,15,8,13,58,54,4,53
Queen's Park,374,6,14,9,13,38,41,-3,51
Stranraer,374,7,10,8,18,46,59,-13,38
East Fife,374,8,9,9,18,41,54,-13,36
Albion,374,9,9,7,20,48,65,-17,34
Stenhousem'r,374,10,9,7,20,49,76,-27,34
Airdrieon,375,1,22,5,9,66,44,22,71
Alloa,375,2,19,7,10,72,44,28,64
Albion,375,3,16,8,12,51,44,7,56
Livingston,375,4,15,6,15,72,65,7,51
East Fife,375,5,14,8,14,54,46,8,50
Peterhead,375,6,13,7,16,50,54,-4,46
Queen's Park,375,7,13,7,16,47,56,-9,46
Stranraer,375,8,14,3,19,49,57,-8,45
Brechin,375,9,12,8,16,46,60,-14,44
Stenhousem'r,375,10,9,7,20,42,79,-37,34
Alloa,376,1,20,7,9,75,44,31,67
Brechin,376,2,18,5,13,56,46,10,59
Airdrieon,376,3,16,11,9,59,56,3,59
East Fife,376,4,16,8,12,56,43,13,56
Livingston,376,5,16,6,14,67,62,5,54
Queen's Park,376,6,16,4,16,54,54,0,52
Albion,376,7,12,9,15,51,52,-1,45
Peterhead,376,8,12,8,16,46,51,-5,44
Stranraer,376,9,13,2,21,44,63,-19,41
Stenhousem'r,376,10,7,8,21,45,82,-37,29
Livingston,377,1,22,5,9,80,41,39,71
Alloa,377,2,18,7,11,65,42,23,61
Airdrieon,377,3,18,6,12,53,52,1,60
Brechin,377,4,16,9,11,48,44,4,57
Albion,377,5,14,11,11,45,38,7,53
Peterhead,377,6,15,7,14,54,53,1,52
East Fife,377,7,12,8,16,51,50,1,44
Queen's Park,377,8,12,5,19,36,56,-20,41
Stranraer,377,9,8,10,18,49,63,-14,34
Stenhousem'r,377,10,8,6,22,47,89,-42,30
Livingston,378,1,22,4,10,88,52,36,70
Alloa,378,2,21,7,8,71,41,30,70
Brechin,378,3,17,9,10,52,45,7,60
Airdrieon,378,4,15,8,13,55,58,-3,53
Peterhead,378,5,16,4,16,54,61,-7,52
Albion,378,6,12,11,13,61,66,-5,47
Stranraer,378,7,13,5,18,53,59,-6,44
Queen's Park,378,8,11,9,16,45,62,-17,42
East Fife,378,9,9,9,18,45,53,-8,36
Stenhousem'r,378,10,7,8,21,48,75,-27,29
Alloa,379,1,20,7,9,84,53,31,67
Livingston,379,2,19,9,8,73,44,29,66
Airdrieon,379,3,19,6,11,55,50,5,63
Brechin,379,4,16,4,16,55,55,0,52
East Fife,379,5,12,10,14,50,57,-7,46
Albion,379,6,11,12,13,55,58,-3,45
Peterhead,379,7,12,8,16,42,49,-7,44
Stranraer,379,8,11,8,17,45,50,-5,41
Queen's Park,379,9,10,8,18,40,55,-15,38
Stenhousem'r,379,10,9,10,17,52,80,-28,37
Livingston,380,1,23,5,8,82,44,38,74
Alloa,380,2,18,8,10,80,46,34,62
Airdrieon,380,3,16,7,13,52,52,0,55
Stranraer,380,4,15,8,13,58,61,-3,53
Brechin,380,5,15,6,15,54,56,-2,51
Albion,380,6,11,11,14,51,60,-9,44
East Fife,380,7,11,10,15,44,48,-4,43
Queen's Park,380,8,9,15,12,36,42,-6,42
Peterhead,380,9,12,6,18,49,60,-11,42
Stenhousem'r,380,10,7,10,19,42,79,-37,31
Alloa,381,1,19,9,8,71,42,29,66
Livingston,381,2,17,8,11,69,48,21,59
Queen's Park,381,3,16,8,12,48,43,5,56
Brechin,381,4,15,9,12,53,48,5,54
Peterhead,381,5,14,12,10,43,45,-2,54
Airdrieon,381,6,15,7,14,65,60,5,52
Albion,381,7,14,10,12,52,52,0,52
East Fife,381,8,12,10,14,48,46,2,46
Stranraer,381,9,11,8,17,48,61,-13,41
Stenhousem'r,381,10,4,5,27,36,88,-52,17
Livingston,382,1,19,7,10,68,42,26,64
Alloa,382,2,16,14,6,71,45,26,62
Brechin,382,3,17,7,12,60,47,13,58
Airdrieon,382,4,16,9,11,58,52,6,57
Peterhead,382,5,14,9,13,52,53,-1,51
Queen's Park,382,6,12,8,16,33,44,-11,44
East Fife,382,7,10,12,14,53,53,0,42
Albion,382,8,10,12,14,48,56,-8,42
Stranraer,382,9,11,7,18,49,61,-12,40
Stenhousem'r,382,10,8,9,19,48,87,-39,33
Livingston,383,1,22,5,9,85,46,39,71
Airdrieon,383,2,21,2,13,58,47,11,65
Peterhead,383,3,17,7,12,48,47,1,58
Brechin,383,4,18,3,15,48,47,1,57
Stranraer,383,5,17,4,15,54,54,0,55
Alloa,383,6,14,11,11,60,45,15,53
East Fife,383,7,13,7,16,51,51,0,46
Queen's Park,383,8,12,4,20,35,52,-17,40
Albion,383,9,9,11,16,48,58,-10,38
Stenhousem'r,383,10,7,6,23,47,87,-40,27
Alloa,384,1,20,6,10,73,51,22,66
Livingston,384,2,20,3,13,70,50,20,63
Airdrieon,384,3,17,9,10,59,48,11,60
Brechin,384,4,16,3,17,70,64,6,51
Peterhead,384,5,14,9,13,60,54,6,51
Queen's Park,384,6,14,8,14,38,50,-12,50
Stranraer,384,7,14,7,15,43,49,-6,49
East Fife,384,8,12,8,16,58,57,1,44
Albion,384,9,9,12,15,48,60,-12,39
Stenhousem'r,384,10,7,9,20,45,81,-36,30
Alloa,385,1,19,10,7,71,35,36,67
Livingston,385,2,18,7,11,69,50,19,61
Airdrieon,385,3,16,9,11,58,52,6,57
Brechin,385,4,15,8,13,50,41,9,53
Peterhead,385,5,14,10,12,52,56,-4,52
Queen's Park,385,6,16,4,16,45,58,-13,52
East Fife,385,7,14,9,13,50,43,7,51
Albion,385,8,12,8,16,47,53,-6,44
Stranraer,385,9,12,5,19,48,60,-12,41
Stenhousem'r,385,10,5,8,23,44,86,-42,23
Livingston,386,1,24,5,7,79,39,40,77
Brechin,386,2,19,8,9,58,40,18,65
Alloa,386,3,17,10,9,76,49,27,61
Airdrieon,386,4,16,7,13,57,56,1,55
Peterhead,386,5,14,5,17,48,61,-13,47
East Fife,386,6,12,9,15,51,56,-5,45
Queen's Park,386,7,10,10,16,40,54,-14,40
Albion,386,8,9,12,15,47,60,-13,39
Stranraer,386,9,10,8,18,47,63,-16,38
Stenhousem'r,386,10,7,10,19,55,80,-25,31
Alloa,387,1,19,8,9,67,41,26,65
Airdrieon,387,2,19,8,9,68,47,21,65
Brechin,387,3,17,6,13,47,49,-2,57
Albion,387,4,16,8,12,59,52,7,56
Livingston,387,5,17,4,15,65,55,10,55
Peterhead,387,6,15,9,12,48,48,0,54
Queen's Park,387,7,16,5,15,41,44,-3,53
East Fife,387,8,12,8,16,57,48,9,44
Stranraer,387,9,9,9,18,41,55,-14,36
Stenhousem'r,387,10,4,7,25,32,86,-54,19
Airdrieon,388,1,19,8,9,58,44,14,65
Alloa,388,2,17,9,10,62,44,18,60
Livingston,388,3,19,2,15,78,53,25,59
Queen's Park,388,4,17,6,13,53,58,-5,57
Brechin,388,5,15,10,11,51,44,7,55
Peterhead,388,6,13,10,13,48,45,3,49
Albion,388,7,13,10,13,53,59,-6,49
Stranraer,388,8,10,8,18,53,66,-13,38
East Fife,388,9,9,8,19,49,61,-12,35
Stenhousem'r,388,10,9,7,20,48,79,-31,34
Alloa,389,1,21,8,7,73,40,33,71
Livingston,389,2,18,6,12,76,54,22,60
Airdrieon,389,3,16,9,11,64,51,13,57
Albion,389,4,15,8,13,53,49,4,53
Brechin,389,5,16,5,15,47,48,-1,53
East Fife,389,6,12,11,13,49,50,-1,47
Peterhead,389,7,12,10,14,47,54,-7,46
Queen's Park,389,8,12,6,18,35,56,-21,42
Stenhousem'r,389,9,10,9,17,46,73,-27,39
Stranraer,389,10,9,6,21,50,65,-15,33
Livingston,390,1,23,4,9,83,52,31,73
Alloa,390,2,20,7,9,73,44,29,67
Airdrieon,390,3,17,7,12,56,51,5,58
Queen's Park,390,4,16,7,13,45,46,-1,55
Brechin,390,5,16,3,17,51,55,-4,51
Albion,390,6,14,8,14,64,60,4,50
Stranraer,390,7,13,7,16,53,57,-4,46
East Fife,390,8,10,9,17,49,57,-8,39
Peterhead,390,9,10,8,18,43,60,-17,38
Stenhousem'r,390,10,7,8,21,46,81,-35,29
Airdrieon,391,1,22,7,7,71,40,31,73
Livingston,391,2,22,6,8,86,49,37,72
Alloa,391,3,16,8,12,69,50,19,56
Brechin,391,4,15,8,13,56,65,-9,53
Albion,391,5,15,7,14,52,48,4,52
Peterhead,391,6,16,4,16,50,56,-6,52
Queen's Park,391,7,14,5,17,40,60,-20,47
East Fife,391,8,10,8,18,50,55,-5,38
Stranraer,391,9,10,7,19,53,65,-12,37
Stenhousem'r,391,10,6,8,22,50,89,-39,26
Livingston,392,1,24,5,7,75,37,38,77
Airdrieon,392,2,19,5,12,61,54,7,62
Peterhead,392,3,16,9,11,53,49,4,57
Brechin,392,4,16,8,12,56,49,7,56
Alloa,392,5,13,9,14,60,52,8,48
Albion,392,6,12,12,12,56,55,1,48
Stranraer,392,7,13,5,18,48,56,-8,44
Queen's Park,392,8,13,5,18,40,54,-14,44
East Fife,392,9,11,10,15,53,52,1,43
Stenhousem'r,392,10,4,10,22,40,84,-44,22
Airdrieon,393,1,25,4,7,73,48,25,79
Alloa,393,2,19,8,9,68,41,27,65
Livingston,393,3,18,4,14,68,54,14,58
Queen's Park,393,4,14,11,11,39,41,-2,53
Stranraer,393,5,14,7,15,48,51,-3,49
Albion,393,6,13,9,14,49,49,0,48
Brechin,393,7,13,9,14,48,51,-3,48
Peterhead,393,8,12,8,16,42,51,-9,44
Stenhousem'r,393,9,10,6,20,48,77,-29,36
East Fife,393,10,6,6,24,45,65,-20,24
Livingston,394,1,23,4,9,81,46,35,73
Alloa,394,2,19,10,7,72,41,31,67
Airdrieon,394,3,17,5,14,65,61,4,56
Brechin,394,4,16,7,13,59,56,3,55
Albion,394,5,14,11,11,46,40,6,53
Peterhead,394,6,14,10,12,55,55,0,52
East Fife,394,7,14,9,13,56,45,11,51
Queen's Park,394,8,10,8,18,35,55,-20,38
Stenhousem'r,394,9,9,4,23,51,92,-41,31
Stranraer,394,10,8,4,24,41,70,-29,28
Livingston,395,1,25,3,8,84,48,36,78
Alloa,395,2,20,7,9,64,44,20,67
Brechin,395,3,17,7,12,53,47,6,58
Albion,395,4,15,9,12,57,46,11,54
Peterhead,395,5,14,9,13,55,53,2,51
East Fife,395,6,15,5,16,51,51,0,50
Airdrieon,395,7,14,6,16,56,58,-2,48
Queen's Park,395,8,15,3,18,46,56,-10,48
Stenhousem'r,395,9,7,8,21,50,81,-31,29
Stranraer,395,10,7,5,24,39,71,-32,26
Livingston,396,1,19,4,13,73,50,23,61
Airdrieon,396,2,19,3,14,58,61,-3,60
Alloa,396,3,17,8,11,71,43,28,59
Stranraer,396,4,17,6,13,57,52,5,57
Queen's Park,396,5,15,7,14,36,43,-7,52
Brechin,396,6,14,9,13,45,50,-5,51
East Fife,396,7,13,11,12,53,41,12,50
Peterhead,396,8,14,6,16,42,51,-9,48
Albion,396,9,12,11,13,53,42,11,47
Stenhousem'r,396,10,4,7,25,36,91,-55,19
Livingston,397,1,21,3,12,65,44,21,66
Airdrieon,397,2,19,5,12,60,52,8,62
Alloa,397,3,17,9,10,67,49,18,60
Albion,397,4,15,8,13,53,49,4,53
East Fife,397,5,13,9,14,52,44,8,48
Stranraer,397,6,15,3,18,56,58,-2,48
Peterhead,397,7,13,9,14,41,43,-2,48
Stenhousem'r,397,8,11,8,17,43,63,-20,41
Brechin,397,9,11,7,18,38,57,-19,40
Queen's Park,397,10,9,11,16,36,52,-16,38
Airdrieon,398,1,22,4,10,63,49,14,70
Livingston,398,2,20,6,10,79,57,22,66
Alloa,398,3,16,10,10,73,47,26,58
Brechin,398,4,18,2,16,56,50,6,56
Albion,398,5,15,8,13,60,55,5,53
Peterhead,398,6,14,7,15,55,57,-2,49
East Fife,398,7,11,9,16,45,49,-4,42
Stranraer,398,8,13,3,20,57,74,-17,42
Queen's Park,398,9,11,7,18,47,60,-13,40
Stenhousem'r,398,10,8,8,20,48,85,-37,32
Livingston,399,1,19,5,12,72,50,22,62
Alloa,399,2,17,10,9,64,40,24,61
Airdrieon,399,3,18,6,12,55,52,3,60
Peterhead,399,4,15,9,12,57,53,4,54
Brechin,399,5,16,5,15,46,46,0,53
Queen's Park,399,6,14,7,15,32,43,-11,49
Albion,399,7,12,10,14,58,64,-6,46
Stranraer,399,8,12,6,18,48,55,-7,42
East Fife,399,9,9,14,13,46,46,0,41
Stenhousem'r,399,10,8,8,20,44,73,-29,32
Alloa,400,1,20,8,8,72,40,32,68
Livingston,400,2,20,8,8,77,51,26,68
Brechin,400,3,18,7,11,62,46,16,61
Peterhead,400,4,14,8,14,45,46,-1,50
Queen's Park,400,5,14,7,15,34,50,-16,49
Airdrieon,400,6,13,7,16,58,56,2,46
Albion,400,7,12,9,15,44,50,-6,45
East Fife,400,8,10,11,15,44,49,-5,41
Stranraer,400,9,10,8,18,45,58,-13,38
Stenhousem'r,400,10,9,7,20,43,78,-35,34
Alloa,401,1,18,11,7,69,39,30,65
Livingston,401,2,20,5,11,73,51,22,65
Airdrieon,401,3,20,4,12,60,47,13,64
Brechin,401,4,16,5,15,42,46,-4,53
Queen's Park,401,5,14,9,13,39,49,-10,51
Albion,401,6,14,8,14,57,55,2,50
East Fife,401,7,13,9,14,49,48,1,48
Peterhead,401,8,11,9,16,44,52,-8,42
Stranraer,401,9,10,7,19,45,57,-12,37
Stenhousem'r,401,10,7,7,22,46,80,-34,28
Livingston,402,1,23,3,10,84,47,37,72
Airdrieon,402,2,20,3,13,61,49,12,63
Alloa,402,3,18,8,10,69,51,18,62
East Fife,402,4,16,8,12,60,40,20,56
Albion,402,5,16,5,15,59,51,8,53
Brechin,402,6,16,3,17,47,50,-3,51
Queen's Park,402,7,12,9,15,38,58,-20,45
Stranraer,402,8,13,4,19,58,71,-13,43
Peterhead,402,9,10,10,16,40,49,-9,40
Stenhousem'r,402,10,8,3,25,45,95,-50,27
Alloa,403,1,20,6,10,73,48,25,66
Livingston,403,2,18,7,11,71,45,26,61
Airdrieon,403,3,17,7,12,54,52,2,58
Brechin,403,4,17,6,13,58,50,8,57
Peterhead,403,5,14,10,12,53,50,3,52
Stranraer,403,6,14,7,15,57,57,0,49
Albion,403,7,11,11,14,49,46,3,44
Queen's Park,403,8,11,8,17,27,53,-26,41
Stenhousem'r,403,9,10,8,18,48,74,-26,38
East Fife,403,10,8,10,18,44,59,-15,34
Alloa,404,1,21,8,7,70,37,33,71
Livingston,404,2,19,8,9,73,47,26,65
Airdrieon,404,3,19,6,11,57,46,11,63
East Fife,404,4,15,7,14,53,46,7,52
Brechin,404,5,15,7,14,45,46,-1,52
Queen's Park,404,6,14,5,17,42,52,-10,47
Peterhead,404,7,13,6,17,48,49,-1,45
Albion,404,8,12,6,18,46,63,-17,42
Stranraer,404,9,11,6,19,50,64,-14,39
Stenhousem'r,404,10,8,7,21,51,85,-34,31
Alloa,405,1,19,8,9,70,42,28,65
Livingston,405,2,19,7,10,79,53,26,64
Brechin,405,3,19,6,11,59,44,15,63
Airdrieon,405,4,17,9,10,61,54,7,60
Queen's Park,405,5,15,8,13,33,39,-6,53
Albion,405,6,14,9,13,49,42,7,51
East Fife,405,7,11,10,15,44,48,-4,43
Peterhead,405,8,11,7,18,45,56,-11,40
Stranraer,405,9,10,3,23,46,76,-30,33
Stenhousem'r,405,10,6,11,19,41,73,-32,29
Livingston,406,1,20,5,11,71,48,23,65
Alloa,406,2,18,7,11,61,43,18,61
Airdrieon,406,3,14,13,9,59,51,8,55
Brechin,406,4,15,10,11,47,43,4,55
Albion,406,5,15,8,13,62,55,7,53
East Fife,406,6,14,10,12,53,45,8,52
Peterhead,406,7,14,5,17,49,56,-7,47
Stranraer,406,8,13,6,17,45,54,-9,45
Queen's Park,406,9,12,7,17,43,53,-10,43
Stenhousem'r,406,10,6,7,23,48,90,-42,25
Albion,407,1,22,6,8,66,36,30,72
Alloa,407,2,18,8,10,66,48,18,62
Livingston,407,3,19,2,15,76,59,17,59
Brechin,407,4,17,7,12,58,54,4,58
Airdrieon,407,5,15,7,14,62,56,6,52
Peterhead,407,6,13,11,12,53,54,-1,50
Queen's Park,407,7,14,7,15,39,54,-15,49
Stranraer,407,8,11,8,17,52,64,-12,41
East Fife,407,9,7,12,17,39,51,-12,33
Stenhousem'r,407,10,7,6,23,47,82,-35,27
Airdrieon,408,1,22,5,9,58,44,14,71
Livingston,408,2,19,4,13,67,46,21,61
Alloa,408,3,17,8,11,67,47,20,59
Peterhead,408,4,16,8,12,51,48,3,56
Brechin,408,5,17,4,15,59,53,6,55
Albion,408,6,12,9,15,45,45,0,45
Queen's Park,408,7,12,7,17,35,52,-17,43
Stranraer,408,8,11,8,17,47,57,-10,41
East Fife,408,9,9,12,15,42,49,-7,39
Stenhousem'r,408,10,7,11,18,46,76,-30,32
Livingston,409,1,20,6,10,73,47,26,66
Airdrieon,409,2,19,6,11,60,48,12,63
Alloa,409,3,17,9,10,66,46,20,60
Brechin,409,4,15,9,12,48,46,2,54
Queen's Park,409,5,15,7,14,40,45,-5,52
Peterhead,409,6,15,6,15,59,57,2,51
Albion,409,7,13,8,15,50,53,-3,47
Stranraer,409,8,12,7,17,50,59,-9,43
East Fife,409,9,9,9,18,46,56,-10,36
Stenhousem'r,409,10,7,9,20,51,86,-35,30
Alloa,410,1,24,7,5,88,40,48,79
Livingston,410,2,23,3,10,83,45,38,72
Brechin,410,3,17,2,17,55,51,4,53
Airdrieon,410,4,14,7,15,53,64,-11,49
East Fife,410,5,13,9,14,49,44,5,48
Peterhead,410,6,13,8,15,57,55,2,47
Albion,410,7,13,8,15,59,69,-10,47
Stranraer,410,8,14,5,17,57,67,-10,47
Queen's Park,410,9,12,6,18,36,51,-15,42
Stenhousem'r,410,10,6,7,23,40,91,-51,25
Airdrieon,411,1,18,6,12,59,48,11,60
Brechin,411,2,18,6,12,51,44,7,60
Livingston,411,3,18,5,13,65,51,14,59
Stranraer,411,4,19,2,15,54,49,5,59
Alloa,411,5,16,7,13,59,41,18,55
East Fife,411,6,14,8,14,52,43,9,50
Albion,411,7,13,9,14,46,52,-6,48
Peterhead,411,8,12,8,16,48,56,-8,44
Queen's Park,411,9,12,5,19,31,49,-18,41
Stenhousem'r,411,10,8,8,20,44,76,-32,32
Alloa,412,1,20,7,9,71,39,32,67
Livingston,412,2,21,4,11,76,51,25,67
Airdrieon,412,3,17,7,12,65,53,12,58
Brechin,412,4,16,7,13,49,53,-4,55
Peterhead,412,5,14,8,14,50,48,2,50
Albion,412,6,11,11,14,52,57,-5,44
Queen's Park,412,7,12,7,17,36,50,-14,43
Stranraer,412,8,12,6,18,46,64,-18,42
East Fife,412,9,10,11,15,50,52,-2,41
Stenhousem'r,412,10,9,8,19,53,81,-28,35
Livingston,413,1,20,2,14,70,55,15,62
Airdrieon,413,2,19,5,12,64,53,11,62
Alloa,413,3,16,10,10,64,45,19,58
Brechin,413,4,16,6,14,58,47,11,54
Albion,413,5,14,9,13,55,52,3,51
Peterhead,413,6,14,8,14,50,53,-3,50
East Fife,413,7,14,7,15,58,56,2,49
Stranraer,413,8,12,8,16,46,56,-10,44
Queen's Park,413,9,11,9,16,41,56,-15,42
Stenhousem'r,413,10,9,6,21,53,86,-33,33
Livingston,414,1,23,3,10,84,55,29,72
Alloa,414,2,16,12,8,76,56,20,60
Albion,414,3,17,7,12,63,51,12,58
Airdrieon,414,4,16,9,11,61,52,9,57
Brechin,414,5,15,7,14,52,51,1,52
East Fife,414,6,12,10,14,57,51,6,46
Peterhead,414,7,14,4,18,47,60,-13,46
Queen's Park,414,8,11,9,16,41,59,-18,42
Stranraer,414,9,10,7,19,50,62,-12,37
Stenhousem'r,414,10,9,6,21,57,91,-34,33
Livingston,415,1,22,4,10,78,45,33,70
Alloa,415,2,19,11,6,69,37,32,68
Airdrieon,415,3,20,7,9,66,46,20,67
Albion,415,4,18,7,11,65,51,14,61
Brechin,415,5,15,6,15,47,53,-6,51
Stranraer,415,6,14,5,17,48,59,-11,47
East Fife,415,7,12,8,16,55,57,-2,44
Queen's Park,415,8,10,9,17,38,53,-15,39
Peterhead,415,9,9,8,19,38,62,-24,35
Stenhousem'r,415,10,6,5,25,43,84,-41,23
Livingston,416,1,25,3,8,82,42,40,78
Alloa,416,2,21,6,9,79,41,38,69
Brechin,416,3,19,6,11,48,33,15,63
Airdrieon,416,4,17,5,14,57,58,-1,56
East Fife,416,5,15,10,11,55,46,9,55
Queen's Park,416,6,12,10,14,44,57,-13,46
Peterhead,416,7,12,8,16,52,61,-9,44
Albion,416,8,9,7,20,51,66,-15,34
Stranraer,416,9,10,3,23,39,66,-27,33
Stenhousem'r,416,10,7,8,21,49,86,-37,29
Alloa,417,1,19,8,9,76,49,27,65
Livingston,417,2,20,5,11,72,47,25,65
Airdrieon,417,3,19,3,14,57,53,4,60
Peterhead,417,4,14,10,12,57,53,4,52
Brechin,417,5,15,6,15,50,50,0,51
Stranraer,417,6,14,5,17,54,67,-13,47
Albion,417,7,12,9,15,52,50,2,45
East Fife,417,8,12,8,16,52,53,-1,44
Queen's Park,417,9,12,7,17,35,54,-19,43
Stenhousem'r,417,10,9,7,20,50,79,-29,34
Airdrieon,418,1,20,5,11,64,52,12,65
Livingston,418,2,19,4,13,70,46,24,61
Alloa,418,3,19,4,13,63,46,17,61
Stranraer,418,4,18,3,15,59,55,4,57
Brechin,418,5,16,5,15,49,40,9,53
Peterhead,418,6,13,10,13,49,53,-4,49
Queen's Park,418,7,14,6,16,38,48,-10,48
Albion,418,8,13,7,16,49,52,-3,46
East Fife,418,9,12,7,17,54,55,-1,43
Stenhousem'r,418,10,7,7,22,38,86,-48,28
Livingston,419,1,20,2,14,80,55,25,62
Alloa,419,2,18,7,11,69,46,23,61
Brechin,419,3,16,11,9,52,46,6,59
Albion,419,4,16,9,11,58,52,6,57
Airdrieon,419,5,17,6,13,57,53,4,57
Peterhead,419,6,13,9,14,43,50,-7,48
East Fife,419,7,11,9,16,52,52,0,42
Queen's Park,419,8,11,8,17,40,54,-14,41
Stranraer,419,9,10,10,16,45,57,-12,40
Stenhousem'r,419,10,8,9,19,43,74,-31,33
Alloa,420,1,23,6,7,74,38,36,75
Airdrieon,420,2,18,7,11,50,45,5,61
Livingston,420,3,18,5,13,72,48,24,59
Albion,420,4,15,9,12,49,47,2,54
Brechin,420,5,16,6,14,53,54,-1,54
Queen's Park,420,6,15,8,13,37,42,-5,53
Peterhead,420,7,11,8,17,45,50,-5,41
East Fife,420,8,10,9,17,45,54,-9,39
Stenhousem'r,420,9,9,9,18,46,72,-26,36
Stranraer,420,10,8,7,21,37,58,-21,31
Alloa,421,1,19,8,9,68,44,24,65
Livingston,421,2,21,1,14,68,51,17,64
Airdrieon,421,3,18,7,11,66,53,13,61
Albion,421,4,17,3,16,61,49,12,54
Brechin,421,5,16,6,14,45,45,0,54
Queen's Park,421,6,14,10,12,43,44,-1,52
Peterhead,421,7,14,7,15,42,56,-14,49
East Fife,421,8,13,7,16,47,44,3,46
Stranraer,421,9,12,5,19,47,60,-13,41
Stenhousem'r,421,10,6,6,24,43,84,-41,24
Livingston,422,1,19,5,12,71,52,19,62
Alloa,422,2,18,8,10,70,51,19,62
Albion,422,3,17,5,14,61,50,11,56
Brechin,422,4,17,5,14,53,42,11,56
Peterhead,422,5,15,8,13,50,46,4,53
Airdrieon,422,6,15,7,14,59,61,-2,52
Stranraer,422,7,13,6,17,58,70,-12,45
East Fife,422,8,11,10,15,41,43,-2,43
Queen's Park,422,9,11,6,19,37,56,-19,39
Stenhousem'r,422,10,8,12,16,46,75,-29,36
Livingston,423,1,20,5,11,90,48,42,65
Alloa,423,2,19,7,10,66,46,20,64
Airdrieon,423,3,19,5,12,67,64,3,62
Brechin,423,4,18,5,13,56,50,6,59
East Fife,423,5,15,8,13,53,47,6,53
Peterhead,423,6,15,7,14,60,57,3,52
Albion,423,7,14,7,15,56,54,2,49
Queen's Park,423,8,12,7,17,40,56,-16,43
Stranraer,423,9,13,2,21,52,71,-19,41
Stenhousem'r,423,10,5,7,24,42,89,-47,22
Livingston,424,1,23,1,12,71,47,24,70
Alloa,424,2,20,7,9,81,42,39,67
Albion,424,3,17,8,11,64,46,18,59
Airdrieon,424,4,15,10,11,63,59,4,55
Queen's Park,424,5,16,4,16,43,51,-8,52
Brechin,424,6,14,8,14,49,54,-5,50
East Fife,424,7,14,6,16,43,48,-5,48
Stranraer,424,8,11,10,15,49,59,-10,43
Peterhead,424,9,9,7,20,41,60,-19,34
Stenhousem'r,424,10,6,9,21,44,82,-38,27
Airdrieon,425,1,18,9,9,70,53,17,63
Alloa,425,2,15,14,7,62,40,22,59
Livingston,425,3,17,7,12,80,64,16,58
Albion,425,4,16,10,10,61,50,11,58
Brechin,425,5,17,5,14,54,55,-1,56
Peterhead,425,6,13,10,13,46,59,-13,49
East Fife,425,7,10,12,14,53,47,6,42
Queen's Park,425,8,12,6,18,33,50,-17,42
Stranraer,425,9,10,9,17,47,56,-9,39
Stenhousem'r,425,10,7,8,21,48,80,-32,29
Alloa,426,1,19,11,6,78,42,36,68
Brechin,426,2,17,5,14,57,55,2,56
Livingston,426,3,16,7,13,66,53,13,55
Airdrieon,426,4,16,7,13,53,54,-1,55
East Fife,426,5,13,9,14,46,48,-2,48
Peterhead,426,6,13,8,15,54,55,-1,47
Stranraer,426,7,14,4,18,49,58,-9,46
Queen's Park,426,8,12,9,15,40,52,-12,45
Albion,426,9,11,9,16,46,53,-7,42
Stenhousem'r,426,10,12,5,19,52,71,-19,41
Livingston,427,1,24,4,8,89,48,41,76
Alloa,427,2,20,5,11,76,44,32,65
Albion,427,3,18,7,11,62,49,13,61
Airdrieon,427,4,17,3,16,63,58,5,54
Queen's Park,427,5,16,5,15,50,60,-10,53
East Fife,427,6,13,8,15,48,48,0,47
Brechin,427,7,13,7,16,51,55,-4,46
Peterhead,427,8,13,6,17,53,54,-1,45
Stranraer,427,9,13,5,18,41,59,-18,44
Stenhousem'r,427,10,5,6,25,33,91,-58,21
Alloa,428,1,20,10,6,69,37,32,70
Livingston,428,2,20,8,8,89,54,35,68
Airdrieon,428,3,19,6,11,71,56,15,63
Brechin,428,4,18,8,10,51,42,9,62
Albion,428,5,14,8,14,58,52,6,50
Peterhead,428,6,13,10,13,53,51,2,49
Queen's Park,428,7,13,5,18,41,45,-4,44
East Fife,428,8,7,12,17,42,54,-12,33
Stranraer,428,9,9,5,22,48,74,-26,32
Stenhousem'r,428,10,8,6,22,47,104,-57,30
Livingston,429,1,22,6,8,80,44,36,72
Airdrieon,429,2,20,6,10,77,59,18,66
Alloa,429,3,14,11,11,66,53,13,53
Stranraer,429,4,16,5,15,66,57,9,53
Brechin,429,5,15,7,14,57,53,4,52
Albion,429,6,15,5,16,48,49,-1,50
Queen's Park,429,7,11,10,15,41,62,-21,43
East Fife,429,8,11,8,17,44,53,-9,41
Peterhead,429,9,10,9,17,46,62,-16,39
Stenhousem'r,429,10,9,7,20,48,81,-33,34
Livingston,430,1,22,5,9,80,46,34,71
Alloa,430,2,18,9,9,73,48,25,63
Albion,430,3,15,8,13,55,52,3,53
Airdrieon,430,4,15,7,14,53,53,0,52
Stranraer,430,5,15,6,15,52,51,1,51
Queen's Park,430,6,15,6,15,40,47,-7,51
Peterhead,430,7,14,7,15,60,62,-2,49
Brechin,430,8,15,4,17,49,56,-7,49
East Fife,430,9,9,11,16,42,50,-8,38
Stenhousem'r,430,10,7,7,22,48,87,-39,28
Livingston,431,1,21,6,9,72,48,24,69
Alloa,431,2,18,10,8,71,42,29,64
Airdrieon,431,3,17,9,10,57,43,14,60
East Fife,431,4,17,5,14,53,48,5,56
Brechin,431,5,14,8,14,47,48,-1,50
Peterhead,431,6,14,8,14,46,48,-2,50
Queen's Park,431,7,14,6,16,34,50,-16,48
Stranraer,431,8,10,7,19,41,61,-20,37
Albion,431,9,9,8,19,45,55,-10,35
Stenhousem'r,431,10,8,9,19,47,70,-23,33
Livingston,432,1,22,3,11,92,44,48,69
Brechin,432,2,18,7,11,53,43,10,61
Alloa,432,3,17,9,10,65,44,21,60
Peterhead,432,4,17,7,12,62,55,7,58
Airdrieon,432,5,16,9,11,56,60,-4,57
Albion,432,6,14,8,14,52,52,0,50
East Fife,432,7,12,9,15,55,51,4,45
Queen's Park,432,8,11,5,20,41,63,-22,38
Stranraer,432,9,9,8,19,39,62,-23,35
Stenhousem'r,432,10,6,11,19,48,89,-41,29
Alloa,433,1,20,6,10,71,44,27,66
Livingston,433,2,20,5,11,72,47,25,65
Brechin,433,3,17,8,11,54,46,8,59
Airdrieon,433,4,17,7,12,61,59,2,58
Peterhead,433,5,15,8,13,42,45,-3,53
Stranraer,433,6,15,5,16,58,58,0,50
Queen's Park,433,7,14,4,18,46,57,-11,46
East Fife,433,8,11,9,16,53,55,-2,42
Albion,433,9,11,7,18,51,58,-7,40
Stenhousem'r,433,10,7,7,22,50,89,-39,28
Livingston,434,1,23,6,7,83,41,42,75
Alloa,434,2,20,8,8,78,45,33,68
Airdrieon,434,3,18,6,12,66,53,13,60
Queen's Park,434,4,15,6,15,46,48,-2,51
Brechin,434,5,14,7,15,55,58,-3,49
Peterhead,434,6,11,10,15,42,55,-13,43
Albion,434,7,10,12,14,49,65,-16,42
East Fife,434,8,10,11,15,55,54,1,41
Stranraer,434,9,9,9,18,47,72,-25,36
Stenhousem'r,434,10,9,7,20,40,70,-30,34
Livingston,435,1,27,2,7,86,42,44,83
Airdrieon,435,2,20,5,11,60,54,6,65
Alloa,435,3,17,10,9,68,51,17,61
Brechin,435,4,15,7,14,43,45,-2,52
Queen's Park,435,5,13,8,15,38,43,-5,47
Albion,435,6,10,13,13,52,55,-3,43
East Fife,435,7,10,13,13,49,54,-5,43
Stranraer,435,8,12,5,19,56,60,-4,41
Peterhead,435,9,10,6,20,45,70,-25,36
Stenhousem'r,435,10,7,9,20,54,77,-23,30
Livingston,436,1,23,3,10,70,37,33,72
Alloa,436,2,19,6,11,73,52,21,63
Albion,436,3,16,9,11,49,45,4,57
Airdrieon,436,4,17,5,14,60,53,7,56
Brechin,436,5,15,7,14,49,44,5,52
Peterhead,436,6,15,7,14,50,49,1,52
Stranraer,436,7,15,5,16,51,55,-4,50
East Fife,436,8,10,10,16,44,55,-11,40
Queen's Park,436,9,11,6,19,31,56,-25,39
Stenhousem'r,436,10,6,8,22,43,74,-31,26
Livingston,437,1,23,2,11,79,42,37,71
Brechin,437,2,20,5,11,57,39,18,65
Alloa,437,3,16,7,13,65,42,23,55
Queen's Park,437,4,15,9,12,38,46,-8,54
Airdrieon,437,5,14,9,13,59,62,-3,51
East Fife,437,6,11,11,14,44,46,-2,44
Peterhead,437,7,11,11,14,46,59,-13,44
Albion,437,8,11,8,17,44,54,-10,41
Stranraer,437,9,11,7,18,45,54,-9,40
Stenhousem'r,437,10,11,5,20,48,81,-33,38
Livingston,438,1,24,6,6,82,45,37,78
Brechin,438,2,18,6,12,51,43,8,60
Stranraer,438,3,16,6,14,61,52,9,54
Alloa,438,4,16,5,15,65,45,20,53
Albion,438,5,15,8,13,53,54,-1,53
Airdrieon,438,6,15,7,14,61,64,-3,52
East Fife,438,7,11,12,13,50,52,-2,45
Peterhead,438,8,10,9,17,40,54,-14,39
Queen's Park,438,9,9,9,18,33,63,-30,36
Stenhousem'r,438,10,9,6,21,52,76,-24,33
Livingston,439,1,24,2,10,77,39,38,74
Airdrieon,439,2,19,5,12,66,53,13,62
Alloa,439,3,18,7,11,68,54,14,61
Albion,439,4,14,9,13,55,52,3,51
Peterhead,439,5,14,7,15,57,58,-1,49
Brechin,439,6,15,4,17,51,63,-12,49
Queen's Park,439,7,13,6,17,44,56,-12,45
East Fife,439,8,12,8,16,47,50,-3,44
Stranraer,439,9,13,5,18,48,55,-7,44
Stenhousem'r,439,10,8,7,21,44,77,-33,31
Livingston,440,1,22,6,8,74,42,32,72
Alloa,440,2,19,7,10,65,39,26,64
Brechin,440,3,18,8,10,52,43,9,62
Airdrieon,440,4,17,7,12,58,51,7,58
East Fife,440,5,15,6,15,55,46,9,51
Albion,440,6,13,9,14,55,57,-2,48
Stranraer,440,7,14,6,16,48,57,-9,48
Peterhead,440,8,10,9,17,46,65,-19,39
Stenhousem'r,440,9,9,9,18,52,73,-21,36
Queen's Park,440,10,6,7,23,26,58,-32,25
Alloa,441,1,24,5,7,86,48,38,77
Livingston,441,2,19,5,12,78,50,28,62
Airdrieon,441,3,15,9,12,59,54,5,54
Brechin,441,4,16,5,15,52,54,-2,53
Albion,441,5,14,10,12,55,46,9,52
Peterhead,441,6,14,9,13,49,49,0,51
Stranraer,441,7,12,10,14,44,52,-8,46
East Fife,441,8,8,14,14,49,55,-6,38
Queen's Park,441,9,9,6,21,36,65,-29,33
Stenhousem'r,441,10,8,9,19,39,74,-35,33
Livingston,442,1,21,7,8,78,44,34,70
Alloa,442,2,17,10,9,62,40,22,61
Brechin,442,3,18,4,14,50,55,-5,58
Airdrieon,442,4,16,7,13,58,57,1,55
Stranraer,442,5,14,10,12,61,52,9,52
Albion,442,6,14,9,13,56,52,4,51
Peterhead,442,7,16,3,17,55,53,2,51
Queen's Park,442,8,13,4,19,41,58,-17,43
East Fife,442,9,9,8,19,50,65,-15,35
Stenhousem'r,442,10,9,4,23,52,87,-35,31
Alloa,443,1,19,11,6,65,35,30,68
Livingston,443,2,21,4,11,86,51,35,67
Airdrieon,443,3,17,7,12,60,56,4,58
Brechin,443,4,17,6,13,59,58,1,57
Stranraer,443,5,14,4,18,55,61,-6,46
Albion,443,6,12,10,14,52,63,-11,46
Queen's Park,443,7,12,9,15,39,50,-11,45
Stenhousem'r,443,8,11,7,18,69,89,-20,40
East Fife,443,9,10,9,17,47,54,-7,39
Peterhead,443,10,9,9,18,45,60,-15,36
Livingston,444,1,21,7,8,76,40,36,70
Alloa,444,2,20,7,9,86,49,37,67
Peterhead,444,3,19,6,11,62,56,6,63
Brechin,444,4,17,6,13,50,45,5,57
Albion,444,5,12,11,13,47,56,-9,47
Airdrieon,444,6,10,12,14,37,49,-12,42
East Fife,444,7,10,10,16,50,49,1,40
Stranraer,444,8,12,3,21,54,70,-16,39
Queen's Park,444,9,10,9,17,40,62,-22,39
Stenhousem'r,444,10,10,7,19,44,70,-26,37
Livingston,445,1,22,2,12,86,48,38,68
Airdrieon,445,2,19,6,11,55,53,2,63
Alloa,445,3,16,10,10,65,47,18,58
Albion,445,4,16,8,12,54,43,11,56
Brechin,445,5,16,5,15,47,50,-3,53
Peterhead,445,6,12,8,16,43,56,-13,44
East Fife,445,7,11,10,15,47,53,-6,43
Stranraer,445,8,11,9,16,59,64,-5,42
Stenhousem'r,445,9,12,5,19,46,70,-24,41
Queen's Park,445,10,8,11,17,32,50,-18,35
Livingston,446,1,24,4,8,73,39,34,76
Alloa,446,2,20,6,10,66,45,21,66
Airdrieon,446,3,16,7,13,54,54,0,55
Albion,446,4,15,8,13,45,44,1,53
East Fife,446,5,13,9,14,52,41,11,48
Stranraer,446,6,13,5,18,54,65,-11,44
Brechin,446,7,12,7,17,52,56,-4,43
Queen's Park,446,8,12,7,17,35,46,-11,43
Peterhead,446,9,12,6,18,41,61,-20,42
Stenhousem'r,446,10,9,9,18,50,71,-21,36
Alloa,447,1,18,10,8,68,42,26,64
Brechin,447,2,18,7,11,57,47,10,61
Livingston,447,3,17,6,13,69,51,18,57
Stranraer,447,4,16,5,15,49,54,-5,53
Albion,447,5,14,10,12,52,40,12,52
Peterhead,447,6,15,7,14,59,54,5,52
Airdrieon,447,7,14,7,15,55,62,-7,49
Queen's Park,447,8,13,8,15,39,50,-11,47
East Fife,447,9,10,8,18,43,54,-11,38
Stenhousem'r,447,10,7,8,21,38,75,-37,29
Airdrieon,448,1,19,8,9,66,45,21,65
Alloa,448,2,17,10,9,80,58,22,61
Peterhead,448,3,17,9,10,57,52,5,60
Livingston,448,4,18,5,13,78,54,24,59
Albion,448,5,14,10,12,55,50,5,52
Brechin,448,6,13,11,12,49,49,0,50
Queen's Park,448,7,10,10,16,44,62,-18,40
East Fife,448,8,10,9,17,48,58,-10,39
Stranraer,448,9,11,5,20,45,60,-15,38
Stenhousem'r,448,10,9,7,20,47,81,-34,34
Livingston,449,1,24,3,9,80,37,43,75
Airdrieon,449,2,20,4,12,60,51,9,64
Alloa,449,3,17,9,10,65,45,20,60
Albion,449,4,17,8,11,55,50,5,59
Brechin,449,5,17,4,15,46,44,2,55
Queen's Park,449,6,12,8,16,36,49,-13,44
East Fife,449,7,10,11,15,53,47,6,41
Peterhead,449,8,12,5,19,46,65,-19,41
Stenhousem'r,449,9,12,4,20,55,78,-23,40
Stranraer,449,10,8,6,22,37,67,-30,30
Livingston,450,1,25,4,7,88,46,42,79
Alloa,450,2,20,7,9,77,50,27,67
Albion,450,3,17,7,12,53,54,-1,58
Peterhead,450,4,16,5,15,56,55,1,53
Brechin,450,5,16,5,15,50,52,-2,53
East Fife,450,6,14,8,14,51,52,-1,50
Airdrieon,450,7,13,8,15,55,56,-1,47
Stranraer,450,8,12,3,21,49,59,-10,39
Queen's Park,450,9,11,6,19,32,51,-19,39
Stenhousem'r,450,10,4,11,21,37,73,-36,23
Alloa,451,1,20,8,8,76,44,32,68
Livingston,451,2,19,3,14,75,62,13,60
Airdrieon,451,3,15,10,11,54,48,6,55
Albion,451,4,14,8,14,52,53,-1,50
Stranraer,451,5,14,7,15,50,50,0,49
Stenhousem'r,451,6,13,8,15,66,66,0,47
Brechin,451,7,13,7,16,47,55,-8,46
East Fife,451,8,12,8,16,57,55,2,44
Peterhead,451,9,10,12,14,47,69,-22,42
Queen's Park,451,10,12,5,19,36,58,-22,41
Alloa,452,1,22,6,8,62,39,23,72
Livingston,452,2,21,5,10,82,46,36,68
Albion,452,3,19,9,8,62,41,21,66
Airdrieon,452,4,20,5,11,61,48,13,65
Brechin,452,5,18,5,13,48,47,1,59
Peterhead,452,6,14,5,17,45,53,-8,47
Stranraer,452,7,11,7,18,36,51,-15,40
East Fife,452,8,8,10,18,40,48,-8,34
Queen's Park,452,9,8,8,20,28,54,-26,32
Stenhousem'r,452,10,6,6,24,40,77,-37,24
Alloa,453,1,20,7,9,75,39,36,67
Livingston,453,2,20,4,12,69,50,19,64
Brechin,453,3,19,4,13,48,51,-3,61
Airdrieon,453,4,18,4,14,60,58,2,58
Stranraer,453,5,15,7,14,56,54,2,52
Albion,453,6,14,5,17,55,55,0,47
East Fife,453,7,11,9,16,44,48,-4,42
Stenhousem'r,453,8,12,6,18,55,78,-23,42
Peterhead,453,9,10,9,17,52,61,-9,39
Queen's Park,453,10,11,5,20,37,57,-20,38
Livingston,454,1,21,6,9,80,44,36,69
Airdrieon,454,2,21,6,9,67,46,21,69
Alloa,454,3,19,9,8,73,44,29,66
Peterhead,454,4,15,9,12,50,53,-3,54
Queen's Park,454,5,16,4,16,48,52,-4,52
East Fife,454,6,14,8,14,52,44,8,50
Brechin,454,7,14,8,14,45,52,-7,50
Albion,454,8,11,8,17,58,61,-3,41
Stranraer,454,9,9,8,19,43,65,-22,35
Stenhousem'r,454,10,4,6,26,33,88,-55,18
Livingston,455,1,21,6,9,75,47,28,69
Airdrieon,455,2,21,6,9,62,49,13,69
Alloa,455,3,18,6,12,72,46,26,60
Brechin,455,4,17,8,11,59,46,13,59
East Fife,455,5,15,7,14,66,50,16,52
Albion,455,6,14,6,16,49,57,-8,48
Queen's Park,455,7,13,6,17,38,48,-10,45
Peterhead,455,8,10,11,15,51,64,-13,41
Stranraer,455,9,9,7,20,41,63,-22,34
Stenhousem'r,455,10,8,5,23,52,95,-43,29
Airdrieon,456,1,20,10,6,67,43,24,70
Alloa,456,2,19,7,10,67,50,17,64
Livingston,456,3,18,6,12,76,54,22,60
Stranraer,456,4,15,7,14,56,52,4,52
Brechin,456,5,15,6,15,58,62,-4,51
Albion,456,6,14,7,15,59,54,5,49
East Fife,456,7,11,11,14,46,44,2,44
Peterhead,456,8,12,8,16,46,63,-17,44
Queen's Park,456,9,12,6,18,42,56,-14,42
Stenhousem'r,456,10,7,6,23,45,84,-39,27
Brechin,457,1,22,3,11,62,46,16,69
Livingston,457,2,20,3,13,74,49,25,63
Alloa,457,3,17,10,9,73,47,26,61
Airdrieon,457,4,17,5,14,57,57,0,56
Albion,457,5,13,11,12,52,47,5,50
Queen's Park,457,6,12,9,15,40,50,-10,45
Stranraer,457,7,13,6,17,52,63,-11,45
Peterhead,457,8,11,11,14,58,60,-2,44
Stenhousem'r,457,9,9,8,19,48,81,-33,35
East Fife,457,10,8,10,18,46,62,-16,34
Alloa,458,1,22,8,6,77,38,39,74
Livingston,458,2,20,6,10,74,48,26,66
Airdrieon,458,3,18,8,10,59,53,6,62
Brechin,458,4,17,6,13,47,41,6,57
Albion,458,5,12,10,14,48,56,-8,46
Stranraer,458,6,13,7,16,52,62,-10,46
Queen's Park,458,7,12,5,19,30,46,-16,41
Peterhead,458,8,9,12,15,42,57,-15,39
East Fife,458,9,9,9,18,33,42,-9,36
Stenhousem'r,458,10,7,11,18,55,74,-19,32
Livingston,459,1,19,9,8,74,51,23,66
Alloa,459,2,18,9,9,72,45,27,63
Airdrieon,459,3,18,8,10,67,54,13,62
Albion,459,4,15,12,9,74,60,14,57
Brechin,459,5,16,6,14,56,49,7,54
Stranraer,459,6,13,6,17,52,61,-9,45
East Fife,459,7,11,9,16,51,57,-6,42
Queen's Park,459,8,10,11,15,33,57,-24,41
Peterhead,459,9,10,7,19,53,67,-14,37
Stenhousem'r,459,10,7,9,20,51,82,-31,30
Alloa,460,1,21,8,7,68,36,32,71
Airdrieon,460,2,20,6,10,65,48,17,66
Livingston,460,3,20,5,11,70,40,30,65
Stranraer,460,4,15,7,14,43,47,-4,52
Brechin,460,5,13,11,12,58,57,1,50
Queen's Park,460,6,11,10,15,34,49,-15,43
Albion,460,7,10,12,14,52,59,-7,42
Stenhousem'r,460,8,10,9,17,50,74,-24,39
East Fife,460,9,9,9,18,40,52,-12,36
Peterhead,460,10,8,9,19,37,55,-18,33
Livingston,461,1,24,5,7,91,45,46,77
Alloa,461,2,19,6,11,81,47,34,63
Airdrieon,461,3,19,5,12,59,54,5,62
Brechin,461,4,16,8,12,48,41,7,56
East Fife,461,5,14,8,14,53,48,5,50
Albion,461,6,14,7,15,49,57,-8,49
Queen's Park,461,7,14,6,16,36,46,-10,48
Stenhousem'r,461,8,10,6,20,52,78,-26,36
Peterhead,461,9,9,7,20,36,60,-24,34
Stranraer,461,10,9,6,21,42,71,-29,33
Livingston,462,1,21,8,7,82,44,38,71
Alloa,462,2,18,7,11,69,48,21,61
Peterhead,462,3,17,10,9,62,44,18,61
East Fife,462,4,15,10,11,55,39,16,55
Airdrieon,462,5,14,6,16,57,69,-12,48
Albion,462,6,12,8,16,44,48,-4,44
Brechin,462,7,11,10,15,43,47,-4,43
Stranraer,462,8,12,7,17,54,70,-16,43
Queen's Park,462,9,10,10,16,38,54,-16,40
Stenhousem'r,462,10,8,8,20,43,84,-41,32
Airdrieon,463,1,20,6,10,64,47,17,66
Alloa,463,2,19,8,9,66,42,24,65
Livingston,463,3,20,5,11,67,50,17,65
Brechin,463,4,16,7,13,43,46,-3,55
East Fife,463,5,13,10,13,48,42,6,49
Albion,463,6,13,8,15,51,48,3,47
Peterhead,463,7,9,12,15,41,51,-10,39
Stranraer,463,8,11,6,19,47,62,-15,39
Queen's Park,463,9,10,9,17,35,53,-18,39
Stenhousem'r,463,10,9,9,18,52,73,-21,36
Alloa,464,1,21,8,7,71,42,29,71
Airdrieon,464,2,19,4,13,59,54,5,61
Livingston,464,3,16,7,13,72,58,14,55
Albion,464,4,15,10,11,55,46,9,55
Stranraer,464,5,15,8,13,61,56,5,53
Brechin,464,6,15,6,15,47,49,-2,51
East Fife,464,7,12,9,15,50,47,3,45
Queen's Park,464,8,13,6,17,49,56,-7,45
Peterhead,464,9,11,8,17,48,63,-15,41
Stenhousem'r,464,10,7,6,23,37,78,-41,27
Livingston,465,1,20,6,10,77,47,30,66
Alloa,465,2,19,8,9,74,44,30,65
Airdrieon,465,3,18,6,12,54,50,4,60
Brechin,465,4,17,6,13,52,58,-6,57
Stranraer,465,5,14,8,14,56,50,6,50
Albion,465,6,14,8,14,54,51,3,50
Peterhead,465,7,14,8,14,51,52,-1,50
East Fife,465,8,10,8,18,55,61,-6,38
Queen's Park,465,9,8,10,18,30,54,-24,34
Stenhousem'r,465,10,9,6,21,46,82,-36,33
Livingston,466,1,23,2,11,79,45,34,71
Alloa,466,2,21,6,9,70,43,27,69
Airdrieon,466,3,20,5,11,68,59,9,65
Queen's Park,466,4,17,6,13,48,48,0,57
Brechin,466,5,16,4,16,47,50,-3,52
East Fife,466,6,15,6,15,60,54,6,51
Peterhead,466,7,10,9,17,42,57,-15,39
Albion,466,8,9,11,16,52,57,-5,38
Stranraer,466,9,11,5,20,53,66,-13,38
Stenhousem'r,466,10,6,10,20,45,85,-40,28
Livingston,467,1,22,7,7,81,44,37,73
Alloa,467,2,17,11,8,65,43,22,62
Albion,467,3,18,4,14,66,51,15,58
Airdrieon,467,4,16,8,12,53,51,2,56
East Fife,467,5,14,10,12,59,49,10,52
Peterhead,467,6,14,10,12,49,52,-3,52
Brechin,467,7,14,7,15,43,42,1,49
Queen's Park,467,8,11,4,21,31,57,-26,37
Stranraer,467,9,10,5,21,45,62,-17,35
Stenhousem'r,467,10,7,8,21,42,83,-41,29
Livingston,468,1,21,7,8,83,45,38,70
Alloa,468,2,19,6,11,72,43,29,63
Brechin,468,3,16,9,11,55,48,7,57
Airdrieon,468,4,16,8,12,57,53,4,56
East Fife,468,5,14,9,13,57,51,6,51
Queen's Park,468,6,15,5,16,39,48,-9,50
Albion,468,7,11,12,13,49,53,-4,45
Peterhead,468,8,12,7,17,46,58,-12,43
Stranraer,468,9,12,4,20,58,75,-17,40
Stenhousem'r,468,10,8,5,23,46,88,-42,29
Brechin,469,1,22,2,12,56,48,8,68
Airdrieon,469,2,19,6,11,71,56,15,63
Alloa,469,3,18,7,11,70,48,22,61
Livingston,469,4,18,6,12,68,54,14,60
Stranraer,469,5,16,4,16,58,50,8,52
East Fife,469,6,14,8,14,47,43,4,50
Albion,469,7,14,8,14,52,49,3,50
Peterhead,469,8,10,8,18,39,52,-13,38
Queen's Park,469,9,9,8,19,27,55,-28,35
Stenhousem'r,469,10,8,7,21,42,75,-33,31
Brechin,470,1,22,3,11,60,46,14,69
Alloa,470,2,18,10,8,68,41,27,64
Livingston,470,3,19,5,12,74,53,21,62
Airdrieon,470,4,17,6,13,60,56,4,57
Peterhead,470,5,14,8,14,52,51,1,50
Stranraer,470,6,13,8,15,54,54,0,47
East Fife,470,7,12,10,14,60,50,10,46
Albion,470,8,11,13,12,55,56,-1,46
Stenhousem'r,470,9,8,8,20,52,87,-35,32
Queen's Park,470,10,7,7,22,26,67,-41,28
Alloa,471,1,18,10,8,70,38,32,64
Livingston,471,2,19,6,11,64,45,19,63
Brechin,471,3,16,9,11,51,46,5,57
Albion,471,4,16,8,12,54,48,6,56
Peterhead,471,5,15,7,14,47,49,-2,52
Airdrieon,471,6,11,13,12,53,53,0,46
East Fife,471,7,11,13,12,47,47,0,46
Queen's Park,471,8,12,7,17,33,55,-22,43
Stranraer,471,9,9,9,18,45,58,-13,36
Stenhousem'r,471,10,7,10,19,47,72,-25,31
Livingston,472,1,20,6,10,70,42,28,66
Alloa,472,2,19,5,12,64,41,23,62
Airdrieon,472,3,14,10,12,52,49,3,52
Stranraer,472,4,15,6,15,58,61,-3,51
Stenhousem'r,472,5,13,10,13,46,61,-15,49
Peterhead,472,6,13,9,14,50,54,-4,48
East Fife,472,7,11,11,14,48,43,5,44
Albion,472,8,11,11,14,39,49,-10,44
Brechin,472,9,12,6,18,44,51,-7,42
Queen's Park,472,10,10,10,16,40,60,-20,40
Alloa,473,1,23,5,8,73,45,28,74
Livingston,473,2,20,7,9,77,48,29,67
Brechin,473,3,19,2,15,60,56,4,59
Airdrieon,473,4,17,7,12,60,55,5,58
Peterhead,473,5,15,8,13,55,45,10,53
Albion,473,6,14,6,16,48,51,-3,48
Stranraer,473,7,13,5,18,51,63,-12,44
East Fife,473,8,11,7,18,50,52,-2,40
Queen's Park,473,9,11,7,18,36,54,-18,40
Stenhousem'r,473,10,7,6,23,47,88,-41,27
Airdrieon,474,1,19,8,9,70,43,27,65
Livingston,474,2,19,5,12,77,57,20,62
Alloa,474,3,18,7,11,69,49,20,61
Queen's Park,474,4,14,9,13,45,50,-5,51
Brechin,474,5,13,10,13,49,47,2,49
Stranraer,474,6,14,7,15,50,52,-2,49
Albion,474,7,14,7,15,57,62,-5,49
East Fife,474,8,13,7,16,56,53,3,46
Peterhead,474,9,11,9,16,46,59,-13,42
Stenhousem'r,474,10,7,7,22,45,92,-47,28
Airdrieon,475,1,23,4,9,73,48,25,73
Livingston,475,2,23,1,12,83,52,31,70
Alloa,475,3,18,9,9,73,52,21,63
Brechin,475,4,18,6,12,55,44,11,60
Queen's Park,475,5,15,7,14,44,45,-1,52
Albion,475,6,12,9,15,55,57,-2,45
East Fife,475,7,9,12,15,52,62,-10,39
Peterhead,475,8,10,9,17,52,64,-12,39
Stranraer,475,9,10,7,19,45,60,-15,37
Stenhousem'r,475,10,7,6,23,42,90,-48,27
Livingston,476,1,20,6,10,70,42,28,66
Airdrieon,476,2,19,6,11,59,49,10,63
Alloa,476,3,18,8,10,65,42,23,62
Brechin,476,4,17,7,12,49,45,4,58
Albion,476,5,16,5,15,64,61,3,53
Peterhead,476,6,13,8,15,52,58,-6,47
Queen's Park,476,7,12,11,13,38,47,-9,47
Stranraer,476,8,13,6,17,47,54,-7,45
East Fife,476,9,10,9,17,51,51,0,39
Stenhousem'r,476,10,4,10,22,38,84,-46,22
Alloa,477,1,22,7,7,89,40,49,73
Livingston,477,2,17,10,9,69,50,19,61
Airdrieon,477,3,18,5,13,69,59,10,59
Brechin,477,4,15,8,13,56,55,1,53
East Fife,477,5,14,6,16,47,49,-2,48
Albion,477,6,13,7,16,48,58,-10,46
Queen's Park,477,7,12,9,15,38,51,-13,45
Peterhead,477,8,12,7,17,44,52,-8,43
Stranraer,477,9,12,5,19,44,57,-13,41
Stenhousem'r,477,10,8,10,18,52,85,-33,34
Airdrieon,478,1,22,6,8,71,45,26,72
Livingston,478,2,18,6,12,70,52,18,60
Alloa,478,3,17,6,13,60,46,14,57
Brechin,478,4,17,6,13,50,45,5,57
East Fife,478,5,15,9,12,63,48,15,54
Stranraer,478,6,15,6,15,54,59,-5,51
Albion,478,7,14,7,15,59,63,-4,49
Peterhead,478,8,12,8,16,41,57,-16,44
Stenhousem'r,478,9,10,4,22,57,82,-25,34
Queen's Park,478,10,8,6,22,30,58,-28,30
Livingston,479,1,22,7,7,74,43,31,73
Alloa,479,2,21,5,10,77,43,34,68
Brechin,479,3,17,3,16,44,49,-5,54
Peterhead,479,4,15,8,13,53,49,4,53
Albion,479,5,14,9,13,52,48,4,51
Airdrieon,479,6,13,9,14,56,60,-4,48
East Fife,479,7,12,8,16,52,56,-4,44
Queen's Park,479,8,12,8,16,35,50,-15,44
Stranraer,479,9,12,5,19,46,61,-15,41
Stenhousem'r,479,10,7,8,21,47,77,-30,29
Livingston,480,1,22,4,10,80,48,32,70
Alloa,480,2,20,8,8,76,44,32,68
Brechin,480,3,16,10,10,57,44,13,58
Airdrieon,480,4,17,5,14,49,47,2,56
Albion,480,5,16,5,15,56,60,-4,53
Peterhead,480,6,12,10,14,57,59,-2,46
Stranraer,480,7,13,5,18,53,66,-13,44
East Fife,480,8,12,7,17,51,56,-5,43
Queen's Park,480,9,11,7,18,35,50,-15,40
Stenhousem'r,480,10,5,11,20,38,78,-40,26
Alloa,481,1,21,5,10,70,43,27,68
Livingston,481,2,19,5,12,76,43,33,62
Stranraer,481,3,15,7,14,59,51,8,52
Airdrieon,481,4,14,9,13,57,55,2,51
Queen's Park,481,5,13,11,12,45,57,-12,50
Albion,481,6,14,6,16,51,57,-6,48
Brechin,481,7,14,6,16,52,59,-7,48
Peterhead,481,8,12,10,14,45,52,-7,46
East Fife,481,9,11,9,16,44,50,-6,42
Stenhousem'r,481,10,9,8,19,50,82,-32,35
Livingston,482,1,20,7,9,77,46,31,67
Airdrieon,482,2,19,5,12,58,52,6,62
Alloa,482,3,17,7,12,76,48,28,58
Brechin,482,4,17,5,14,58,59,-1,56
East Fife,482,5,15,7,14,55,48,7,52
Peterhead,482,6,14,7,15,51,50,1,49
Queen's Park,482,7,13,7,16,43,60,-17,46
Stranraer,482,8,12,8,16,51,59,-8,44
Albion,482,9,10,11,15,41,52,-11,41
Stenhousem'r,482,10,9,4,23,45,81,-36,31
Livingston,483,1,20,7,9,68,47,21,67
Brechin,483,2,17,9,10,53,44,9,60
Airdrieon,483,3,18,5,13,58,54,4,59
Alloa,483,4,17,7,12,72,52,20,58
Albion,483,5,14,10,12,61,54,7,52
East Fife,483,6,12,13,11,59,47,12,49
Queen's Park,483,7,13,6,17,45,57,-12,45
Peterhead,483,8,10,11,15,42,50,-8,41
Stranraer,483,9,10,7,19,54,75,-21,37
Stenhousem'r,483,10,6,11,19,47,79,-32,29
Livingston,484,1,23,4,9,85,39,46,73
Alloa,484,2,19,8,9,74,50,24,65
Peterhead,484,3,18,6,12,51,43,8,60
Brechin,484,4,16,10,10,52,43,9,58
Airdrieon,484,5,16,7,13,58,54,4,55
Albion,484,6,13,12,11,55,49,6,51
Stranraer,484,7,13,7,16,45,58,-13,46
Queen's Park,484,8,11,7,18,34,61,-27,40
East Fife,484,9,7,10,19,38,53,-15,31
Stenhousem'r,484,10,4,9,23,44,86,-42,21
Airdrieon,485,1,20,5,11,65,48,17,65
Alloa,485,2,18,10,8,73,48,25,64
Livingston,485,3,18,8,10,79,57,22,62
Brechin,485,4,15,9,12,57,50,7,54
Albion,485,5,12,9,15,63,62,1,45
Peterhead,485,6,13,6,17,48,49,-1,45
Queen's Park,485,7,13,6,17,41,60,-19,45
Stenhousem'r,485,8,11,11,14,59,71,-12,44
East Fife,485,9,11,9,16,44,60,-16,42
Stranraer,485,10,9,7,20,51,75,-24,34
Alloa,486,1,24,4,8,80,47,33,76
Livingston,486,2,20,5,11,75,45,30,65
Peterhead,486,3,16,7,13,58,54,4,55
Airdrieon,486,4,14,7,15,52,55,-3,49
Albion,486,5,12,12,12,53,52,1,48
Brechin,486,6,13,7,16,45,50,-5,46
East Fife,486,7,11,10,15,42,48,-6,43
Queen's Park,486,8,11,9,16,41,60,-19,42
Stranraer,486,9,11,6,19,52,66,-14,39
Stenhousem'r,486,10,10,9,17,57,78,-21,39
Livingston,487,1,24,2,10,84,49,35,74
Alloa,487,2,21,7,8,80,42,38,70
Airdrieon,487,3,20,2,14,54,49,5,62
Brechin,487,4,16,4,16,49,55,-6,52
Queen's Park,487,5,15,3,18,42,53,-11,48
Albion,487,6,11,13,12,49,55,-6,46
Stranraer,487,7,14,4,18,49,56,-7,46
Peterhead,487,8,13,7,16,42,51,-9,46
East Fife,487,9,7,14,15,39,49,-10,35
Stenhousem'r,487,10,8,6,22,41,70,-29,30
Livingston,488,1,22,5,9,77,45,32,71
Alloa,488,2,17,10,9,66,43,23,61
Brechin,488,3,17,8,11,50,42,8,59
Airdrieon,488,4,18,5,13,56,57,-1,59
Albion,488,5,14,6,16,57,56,1,48
Stranraer,488,6,12,8,16,51,58,-7,44
Queen's Park,488,7,12,8,16,43,56,-13,44
Peterhead,488,8,10,13,13,43,50,-7,43
East Fife,488,9,10,11,15,54,55,-1,41
Stenhousem'r,488,10,7,8,21,39,74,-35,29
Alloa,489,1,20,8,8,69,38,31,68
Livingston,489,2,15,10,11,67,53,14,55
Albion,489,3,14,11,11,53,47,6,53
Stranraer,489,4,15,8,13,63,58,5,53
Airdrieon,489,5,14,8,14,54,64,-10,50
Brechin,489,6,14,7,15,53,53,0,49
Peterhead,489,7,13,9,14,53,57,-4,48
East Fife,489,8,11,11,14,48,47,1,44
Queen's Park,489,9,11,7,18,37,54,-17,40
Stenhousem'r,489,10,9,9,18,41,67,-26,36
Livingston,490,1,21,4,11,71,43,28,67
Airdrieon,490,2,19,8,9,53,40,13,65
Alloa,490,3,16,10,10,67,47,20,58
Albion,490,4,16,6,14,48,45,3,54
Brechin,490,5,16,6,14,47,46,1,54
Peterhead,490,6,14,9,13,47,45,2,51
Stranraer,490,7,13,5,18,48,61,-13,44
Queen's Park,490,8,11,7,18,40,52,-12,40
East Fife,490,9,9,12,15,49,47,2,39
Stenhousem'r,490,10,9,5,22,48,92,-44,32
Livingston,491,1,23,3,10,74,45,29,72
Alloa,491,2,19,6,11,63,44,19,63
Airdrieon,491,3,18,8,10,67,54,13,62
Albion,491,4,14,9,13,59,54,5,51
Brechin,491,5,15,5,16,50,52,-2,50
East Fife,491,6,13,9,14,50,45,5,48
Stranraer,491,7,13,8,15,56,59,-3,47
Peterhead,491,8,12,8,16,43,55,-12,44
Queen's Park,491,9,11,9,16,30,52,-22,42
Stenhousem'r,491,10,7,5,24,41,73,-32,26
Livingston,492,1,18,11,7,70,41,29,65
Airdrieon,492,2,18,8,10,71,46,25,62
Queen's Park,492,3,16,9,11,47,41,6,57
Peterhead,492,4,15,6,15,49,59,-10,51
Alloa,492,5,14,7,15,62,52,10,49
Brechin,492,6,13,8,15,44,54,-10,47
Albion,492,7,12,10,14,49,53,-4,46
East Fife,492,8,13,7,16,47,52,-5,46
Stranraer,492,9,12,6,18,49,62,-13,42
Stenhousem'r,492,10,8,10,18,47,75,-28,34
Livingston,493,1,21,5,10,73,38,35,68
Alloa,493,2,20,6,10,70,42,28,66
Albion,493,3,18,8,10,62,51,11,62
Brechin,493,4,17,5,14,51,46,5,56
Airdrieon,493,5,17,4,15,67,65,2,55
Stranraer,493,6,14,5,17,57,58,-1,47
East Fife,493,7,12,7,17,50,55,-5,43
Peterhead,493,8,11,7,18,42,62,-20,40
Stenhousem'r,493,9,10,8,18,46,74,-28,38
Queen's Park,493,10,8,9,19,27,54,-27,33
Livingston,494,1,18,6,12,70,51,19,60
Airdrieon,494,2,18,6,12,61,57,4,60
Alloa,494,3,16,11,9,67,49,18,59
Peterhead,494,4,17,7,12,57,56,1,58
East Fife,494,5,15,10,11,55,42,13,55
Brechin,494,6,15,10,11,46,42,4,55
Albion,494,7,14,6,16,58,59,-1,48
Stranraer,494,8,12,8,16,50,52,-2,44
Queen's Park,494,9,13,5,18,44,52,-8,44
Stenhousem'r,494,10,5,5,26,34,82,-48,20
Livingston,495,1,24,4,8,92,45,47,76
Alloa,495,2,21,6,9,73,41,32,69
Albion,495,3,15,8,13,55,53,2,53
Peterhead,495,4,14,10,12,50,52,-2,52
Queen's Park,495,5,13,9,14,33,42,-9,48
Airdrieon,495,6,14,5,17,55,68,-13,47
Brechin,495,7,13,6,17,47,55,-8,45
Stranraer,495,8,13,5,18,54,67,-13,44
East Fife,495,9,8,13,15,53,59,-6,37
Stenhousem'r,495,10,8,8,20,43,73,-30,32
Livingston,496,1,22,3,11,69,43,26,69
Airdrieon,496,2,20,8,8,65,39,26,68
Alloa,496,3,18,10,8,64,41,23,64
Brechin,496,4,16,5,15,51,44,7,53
East Fife,496,5,14,10,12,52,40,12,52
Albion,496,6,15,7,14,62,56,6,52
Stranraer,496,7,14,4,18,44,56,-12,46
Queen's Park,496,8,12,3,21,33,61,-28,39
Stenhousem'r,496,9,9,7,20,43,72,-29,34
Peterhead,496,10,8,7,21,41,72,-31,31
Livingston,497,1,24,3,9,88,46,42,75
Airdrieon,497,2,20,6,10,73,54,19,66
Alloa,497,3,19,8,9,61,41,20,65
Albion,497,4,15,9,12,57,55,2,54
Brechin,497,5,15,9,12,43,42,1,54
Peterhead,497,6,14,9,13,54,54,0,51
Stranraer,497,7,15,3,18,54,62,-8,48
East Fife,497,8,7,12,17,40,51,-11,33
Queen's Park,497,9,8,6,22,25,57,-32,30
Stenhousem'r,497,10,5,11,20,50,83,-33,26
Livingston,498,1,22,4,10,72,44,28,70
Airdrieon,498,2,20,9,7,57,43,14,69
Alloa,498,3,19,9,8,73,42,31,66
Albion,498,4,14,7,15,46,45,1,49
Queen's Park,498,5,13,9,14,44,50,-6,48
East Fife,498,6,12,10,14,50,46,4,46
Brechin,498,7,13,5,18,42,53,-11,44
Peterhead,498,8,11,10,15,49,60,-11,43
Stranraer,498,9,9,9,18,39,57,-18,36
Stenhousem'r,498,10,6,10,20,42,74,-32,28
Livingston,499,1,23,4,9,82,45,37,73
Alloa,499,2,19,8,9,74,46,28,65
Brechin,499,3,17,7,12,51,43,8,58
Albion,499,4,16,7,13,60,50,10,55
Peterhead,499,5,16,6,14,59,60,-1,54
Queen's Park,499,6,13,10,13,35,43,-8,49
Airdrieon,499,7,13,7,16,60,70,-10,46
East Fife,499,8,11,7,18,55,56,-1,40
Stranraer,499,9,11,7,18,43,66,-23,40
Stenhousem'r,499,10,6,7,23,43,83,-40,25
Livingston,500,1,21,6,9,71,47,24,69
Alloa,500,2,18,12,6,73,39,34,66
Airdrieon,500,3,16,12,8,59,44,15,60
Albion,500,4,17,7,12,62,48,14,58
Brechin,500,5,14,9,13,52,59,-7,51
Peterhead,500,6,14,8,14,50,55,-5,50
Stranraer,500,7,11,7,18,51,64,-13,40
East Fife,500,8,9,9,18,48,58,-10,36
Stenhousem'r,500,9,8,10,18,52,76,-24,34
Queen's Park,500,10,8,8,20,27,55,-28,32
Livingston,501,1,24,5,7,78,43,35,77
Alloa,501,2,19,6,11,75,43,32,63
Brechin,501,3,19,5,12,65,50,15,62
Peterhead,501,4,16,6,14,60,64,-4,54
Airdrieon,501,5,14,10,12,57,54,3,52
Stranraer,501,6,14,6,16,48,51,-3,48
Albion,501,7,12,11,13,59,54,5,47
Queen's Park,501,8,11,6,19,36,72,-36,39
East Fife,501,9,7,12,17,41,51,-10,33
Stenhousem'r,501,10,6,9,21,46,83,-37,27
Alloa,502,1,22,8,6,74,38,36,74
Livingston,502,2,20,6,10,73,48,25,66
Airdrieon,502,3,15,8,13,51,49,2,53
Brechin,502,4,15,8,13,45,47,-2,53
Albion,502,5,14,8,14,54,49,5,50
Stranraer,502,6,13,7,16,54,60,-6,46
Queen's Park,502,7,10,12,14,30,45,-15,42
East Fife,502,8,10,11,15,51,51,0,41
Peterhead,502,9,9,13,14,42,50,-8,40
Stenhousem'r,502,10,8,7,21,44,81,-37,31
Livingston,503,1,22,7,7,79,39,40,73
Alloa,503,2,19,9,8,70,42,28,66
Airdrieon,503,3,18,6,12,62,50,12,60
East Fife,503,4,16,8,12,62,45,17,56
Peterhead,503,5,15,10,11,54,54,0,55
Albion,503,6,15,6,15,55,55,0,51
Stranraer,503,7,12,4,20,44,65,-21,40
Brechin,503,8,11,6,19,36,48,-12,39
Queen's Park,503,9,9,9,18,36,60,-24,36
Stenhousem'r,503,10,7,7,22,44,84,-40,28
Livingston,504,1,22,5,9,79,44,35,71
Alloa,504,2,18,9,9,74,45,29,63
Airdrieon,504,3,18,6,12,60,51,9,60
Peterhead,504,4,17,7,12,55,48,7,58
Brechin,504,5,16,8,12,46,44,2,56
Albion,504,6,15,11,10,50,50,0,56
Stranraer,504,7,9,10,17,45,61,-16,37
East Fife,504,8,9,9,18,46,55,-9,36
Queen's Park,504,9,9,8,19,36,59,-23,35
Stenhousem'r,504,10,5,11,20,46,80,-34,26
Livingston,505,1,23,2,11,78,39,39,71
Airdrieon,505,2,19,6,11,66,53,13,63
Alloa,505,3,17,10,9,69,43,26,61
Brechin,505,4,18,7,11,52,48,4,61
Peterhead,505,5,15,9,12,46,41,5,54
Queen's Park,505,6,13,9,14,52,60,-8,48
Albion,505,7,13,6,17,54,59,-5,45
East Fife,505,8,10,12,14,46,48,-2,42
Stranraer,505,9,9,5,22,46,70,-24,32
Stenhousem'r,505,10,5,10,21,40,88,-48,25
Alloa,506,1,19,9,8,70,41,29,66
Brechin,506,2,20,6,10,56,47,9,66
Livingston,506,3,19,3,14,72,51,21,60
Peterhead,506,4,17,6,13,53,47,6,57
Albion,506,5,16,6,14,62,52,10,54
Airdrieon,506,6,14,7,15,49,62,-13,49
Queen's Park,506,7,12,7,17,32,47,-15,43
Stranraer,506,8,12,6,18,50,57,-7,42
Stenhousem'r,506,9,9,9,18,51,75,-24,36
East Fife,506,10,8,9,19,47,63,-16,33
Livingston,507,1,21,5,10,76,52,24,68
Alloa,507,2,17,10,9,64,45,19,61
Brechin,507,3,18,6,12,49,40,9,60
Albion,507,4,13,11,12,61,56,5,50
Airdrieon,507,5,14,8,14,57,62,-5,50
Queen's Park,507,6,13,8,15,36,46,-10,47
Peterhead,507,7,11,13,12,51,51,0,46
Stranraer,507,8,13,7,16,48,53,-5,46
East Fife,507,9,9,12,15,48,49,-1,39
Stenhousem'r,507,10,6,10,20,44,80,-36,28
Livingston,508,1,21,6,9,75,48,27,69
Alloa,508,2,19,7,10,67,41,26,64
Airdrieon,508,3,16,6,14,53,51,2,54
Brechin,508,4,16,6,14,46,49,-3,54
Albion,508,5,13,10,13,56,60,-4,49
Peterhead,508,6,13,9,14,38,46,-8,48
Queen's Park,508,7,12,7,17,41,54,-13,43
East Fife,508,8,10,12,14,52,49,3,42
Stranraer,508,9,10,8,18,45,58,-13,38
Stenhousem'r,508,10,8,13,15,45,62,-17,37
Livingston,509,1,21,5,10,72,45,27,68
Airdrieon,509,2,20,7,9,67,47,20,67
Alloa,509,3,16,9,11,68,53,15,57
Brechin,509,4,17,4,15,55,47,8,55
Peterhead,509,5,16,7,13,54,52,2,55
Albion,509,6,12,11,13,49,46,3,47
Queen's Park,509,7,13,4,19,33,54,-21,43
Stranraer,509,8,11,7,18,53,66,-13,40
East Fife,509,9,11,6,19,43,52,-9,39
Stenhousem'r,509,10,9,8,19,46,78,-32,35
Alloa,510,1,19,8,9,74,46,28,65
Livingston,510,2,20,5,11,71,48,23,65
Airdrieon,510,3,18,4,14,63,54,9,58
Brechin,510,4,17,4,15,54,54,0,55
Peterhead,510,5,15,8,13,52,53,-1,53
East Fife,510,6,13,10,13,60,51,9,49
Queen's Park,510,7,13,10,13,45,50,-5,49
Stranraer,510,8,13,4,19,50,65,-15,43
Albion,510,9,11,9,16,48,55,-7,42
Stenhousem'r,510,10,6,8,22,44,85,-41,26
Livingston,511,1,20,5,11,69,45,24,65
Airdrieon,511,2,19,7,10,66,51,15,64
Alloa,511,3,17,8,11,69,48,21,59
Brechin,511,4,17,8,11,55,50,5,59
Peterhead,511,5,15,6,15,48,52,-4,51
Queen's Park,511,6,13,9,14,43,44,-1,48
Albion,511,7,12,11,13,47,58,-11,47
Stranraer,511,8,12,5,19,53,66,-13,41
East Fife,511,9,8,12,16,47,50,-3,36
Stenhousem'r,511,10,8,7,21,45,78,-33,31
Livingston,512,1,21,6,9,71,40,31,69
Albion,512,2,18,4,14,56,55,1,58
Alloa,512,3,16,9,11,69,47,22,57
Airdrieon,512,4,15,12,9,65,51,14,57
Peterhead,512,5,15,6,15,53,59,-6,51
East Fife,512,6,13,8,15,54,45,9,47
Brechin,512,7,13,7,16,40,54,-14,46
Queen's Park,512,8,12,9,15,39,52,-13,45
Stranraer,512,9,10,7,19,43,58,-15,37
Stenhousem'r,512,10,9,8,19,50,79,-29,35
Alloa,513,1,20,8,8,72,45,27,68
Airdrieon,513,2,19,9,8,70,55,15,66
Livingston,513,3,20,5,11,75,48,27,65
Brechin,513,4,16,11,9,58,50,8,59
Albion,513,5,15,8,13,59,59,0,53
Peterhead,513,6,12,8,16,46,53,-7,44
East Fife,513,7,11,8,17,63,60,3,41
Queen's Park,513,8,10,9,17,42,55,-13,39
Stranraer,513,9,11,5,20,48,69,-21,38
Stenhousem'r,513,10,6,9,21,43,82,-39,27
Livingston,514,1,25,1,10,81,53,28,76
Airdrieon,514,2,19,8,9,74,58,16,65
Alloa,514,3,15,9,12,63,50,13,54
East Fife,514,4,14,10,12,53,47,6,52
Brechin,514,5,14,9,13,50,49,1,51
Albion,514,6,13,11,12,48,46,2,50
Stranraer,514,7,13,6,17,59,66,-7,45
Peterhead,514,8,11,10,15,47,52,-5,43
Queen's Park,514,9,10,9,17,31,48,-17,39
Stenhousem'r,514,10,6,7,23,42,79,-37,25
Livingston,515,1,25,4,7,89,40,49,79
Brechin,515,2,18,7,11,65,52,13,61
Airdrieon,515,3,16,8,12,54,56,-2,56
Alloa,515,4,14,10,12,55,54,1,52
Albion,515,5,13,11,12,59,51,8,50
Stenhousem'r,515,6,13,4,19,62,74,-12,43
Peterhead,515,7,12,7,17,50,62,-12,43
East Fife,515,8,12,6,18,49,56,-7,42
Stranraer,515,9,11,6,19,44,63,-19,39
Queen's Park,515,10,8,13,15,37,56,-19,37
Alloa,516,1,23,9,4,77,41,36,78
Livingston,516,2,24,2,10,83,50,33,74
Airdrieon,516,3,17,6,13,68,60,8,57
Albion,516,4,15,8,13,52,49,3,53
Brechin,516,5,16,4,16,46,53,-7,52
East Fife,516,6,11,11,14,43,41,2,44
Stranraer,516,7,13,5,18,55,59,-4,44
Peterhead,516,8,12,8,16,48,58,-10,44
Queen's Park,516,9,10,7,19,39,59,-20,37
Stenhousem'r,516,10,6,6,24,46,87,-41,24
Livingston,517,1,23,1,12,88,56,32,70
Alloa,517,2,20,8,8,73,38,35,68
Brechin,517,3,19,3,14,55,51,4,60
Airdrieon,517,4,16,6,14,58,60,-2,54
Queen's Park,517,5,13,9,14,35,47,-12,48
East Fife,517,6,11,13,12,48,45,3,46
Peterhead,517,7,12,10,14,43,51,-8,46
Albion,517,8,12,9,15,52,56,-4,45
Stranraer,517,9,9,7,20,49,69,-20,34
Stenhousem'r,517,10,8,8,20,44,72,-28,32
Airdrieon,518,1,21,8,7,69,49,20,71
Alloa,518,2,22,4,10,80,47,33,70
Livingston,518,3,20,4,12,80,53,27,64
Peterhead,518,4,15,6,15,55,56,-1,51
Brechin,518,5,14,6,16,43,48,-5,48
Albion,518,6,12,10,14,53,47,6,46
Queen's Park,518,7,13,5,18,37,64,-27,44
Stranraer,518,8,12,6,18,51,65,-14,42
East Fife,518,9,10,8,18,52,56,-4,38
Stenhousem'r,518,10,9,7,20,46,81,-35,34
Livingston,519,1,20,8,8,76,46,30,68
Airdrieon,519,2,20,5,11,62,55,7,65
Brechin,519,3,17,10,9,48,38,10,61
Alloa,519,4,18,5,13,64,53,11,59
Albion,519,5,14,9,13,60,57,3,51
Stranraer,519,6,14,8,14,57,56,1,50
Queen's Park,519,7,13,8,15,34,45,-11,47
East Fife,519,8,8,13,15,44,49,-5,37
Peterhead,519,9,10,7,19,49,62,-13,37
Stenhousem'r,519,10,6,7,23,38,71,-33,25
Livingston,520,1,22,4,10,83,46,37,70
Alloa,520,2,19,9,8,63,40,23,66
Brechin,520,3,17,5,14,47,41,6,56
Stranraer,520,4,16,7,13,61,58,3,55
Albion,520,5,12,11,13,49,54,-5,47
Airdrieon,520,6,13,8,15,52,62,-10,47
Peterhead,520,7,11,12,13,46,50,-4,45
Queen's Park,520,8,12,7,17,38,44,-6,43
East Fife,520,9,10,10,16,50,53,-3,40
Stenhousem'r,520,10,8,7,21,42,83,-41,31
Livingston,521,1,24,3,9,84,41,43,75
Airdrieon,521,2,20,5,11,63,51,12,65
Brechin,521,3,17,9,10,49,41,8,60
Alloa,521,4,14,11,11,73,57,16,53
Peterhead,521,5,15,8,13,42,40,2,53
Albion,521,6,14,5,17,50,62,-12,47
Queen's Park,521,7,12,7,17,33,46,-13,43
East Fife,521,8,10,10,16,44,50,-6,40
Stranraer,521,9,10,7,19,46,64,-18,37
Stenhousem'r,521,10,8,7,21,45,77,-32,31
Alloa,522,1,20,7,9,76,47,29,67
Livingston,522,2,20,5,11,77,60,17,65
Brechin,522,3,17,5,14,56,41,15,56
Airdrieon,522,4,15,8,13,57,61,-4,53
Stranraer,522,5,16,3,17,63,66,-3,51
Peterhead,522,6,13,7,16,49,57,-8,46
Albion,522,7,12,9,15,50,53,-3,45
Queen's Park,522,8,12,9,15,36,54,-18,45
East Fife,522,9,12,7,17,52,55,-3,43
Stenhousem'r,522,10,10,6,20,52,74,-22,36
Alloa,523,1,19,8,9,68,42,26,65
Livingston,523,2,19,5,12,74,52,22,62
Brechin,523,3,18,7,11,50,41,9,61
Airdrieon,523,4,17,8,11,59,57,2,59
Albion,523,5,15,9,12,55,52,3,54
Peterhead,523,6,12,7,17,48,53,-5,43
Queen's Park,523,7,12,6,18,42,55,-13,42
Stranraer,523,8,11,7,18,53,63,-10,40
East Fife,523,9,10,9,17,38,45,-7,39
Stenhousem'r,523,10,11,6,19,52,79,-27,39
Alloa,524,1,21,6,9,83,46,37,69
Livingston,524,2,19,7,10,71,48,23,64
Airdrieon,524,3,16,7,13,59,60,-1,55
Brechin,524,4,15,7,14,51,55,-4,52
Peterhead,524,5,14,6,16,57,63,-6,48
Queen's Park,524,6,13,9,14,39,47,-8,48
Stranraer,524,7,15,1,20,59,62,-3,46
East Fife,524,8,12,8,16,45,50,-5,44
Albion,524,9,11,8,17,47,60,-13,41
Stenhousem'r,524,10,12,5,19,49,69,-20,41
Alloa,525,1,20,7,9,73,43,30,67
Livingston,525,2,20,5,11,75,49,26,65
Airdrieon,525,3,18,7,11,67,59,8,61
Stranraer,525,4,16,5,15,59,57,2,53
Brechin,525,5,14,8,14,48,54,-6,50
Peterhead,525,6,12,10,14,49,56,-7,46
Albion,525,7,13,6,17,51,49,2,45
Queen's Park,525,8,11,12,13,38,49,-11,45
East Fife,525,9,12,7,17,52,52,0,43
Stenhousem'r,525,10,7,7,22,44,88,-44,28
Alloa,526,1,20,6,10,68,40,28,66
Albion,526,2,19,5,12,62,47,15,62
Livingston,526,3,17,9,10,71,46,25,60
Airdrieon,526,4,17,7,12,57,54,3,58
Brechin,526,5,14,8,14,55,56,-1,50
East Fife,526,6,14,7,15,52,50,2,49
Queen's Park,526,7,14,5,17,38,53,-15,47
Peterhead,526,8,12,10,14,44,49,-5,46
Stranraer,526,9,11,6,19,42,59,-17,39
Stenhousem'r,526,10,6,9,21,40,75,-35,27
Livingston,527,1,24,2,10,86,52,34,74
Alloa,527,2,17,9,10,65,44,21,60
Brechin,527,3,18,5,13,56,52,4,59
Airdrieon,527,4,16,6,14,58,56,2,54
Peterhead,527,5,14,10,12,56,49,7,52
Albion,527,6,14,8,14,51,53,-2,50
East Fife,527,7,14,7,15,48,47,1,49
Stranraer,527,8,14,2,20,57,61,-4,44
Queen's Park,527,9,11,5,20,41,66,-25,38
Stenhousem'r,527,10,8,6,22,43,81,-38,30
Livingston,528,1,22,2,12,85,45,40,68
Brechin,528,2,20,3,13,61,52,9,63
Albion,528,3,18,8,10,65,54,11,62
Peterhead,528,4,17,10,9,53,45,8,61
Queen's Park,528,5,16,3,17,44,50,-6,51
Alloa,528,6,14,7,15,65,60,5,49
Airdrieon,528,7,13,7,16,54,64,-10,46
East Fife,528,8,13,6,17,48,50,-2,45
Stranraer,528,9,10,6,20,43,65,-22,36
Stenhousem'r,528,10,8,6,22,44,77,-33,30
Alloa,529,1,21,10,5,83,41,42,73
Livingston,529,2,19,7,10,78,51,27,64
East Fife,529,3,13,12,11,54,48,6,51
Brechin,529,4,14,8,14,51,59,-8,50
Airdrieon,529,5,13,9,14,57,60,-3,48
Albion,529,6,12,11,13,53,55,-2,47
Peterhead,529,7,12,9,15,53,58,-5,45
Queen's Park,529,8,11,9,16,43,57,-14,42
Stenhousem'r,529,9,9,11,16,55,78,-23,38
Stranraer,529,10,9,8,19,52,72,-20,35
Livingston,530,1,23,4,9,82,42,40,73
Alloa,530,2,18,8,10,72,45,27,62
Brechin,530,3,17,8,11,51,49,2,59
Queen's Park,530,4,17,4,15,43,44,-1,55
Airdrieon,530,5,16,7,13,59,63,-4,55
Albion,530,6,16,5,15,57,58,-1,53
Peterhead,530,7,12,8,16,50,55,-5,44
East Fife,530,8,9,11,16,47,54,-7,38
Stranraer,530,9,11,4,21,48,69,-21,37
Stenhousem'r,530,10,8,7,21,43,73,-30,31
Livingston,531,1,24,4,8,72,36,36,76
Airdrieon,531,2,21,6,9,74,58,16,69
Brechin,531,3,19,8,9,56,36,20,65
Albion,531,4,15,9,12,57,53,4,54
Alloa,531,5,14,11,11,57,47,10,53
Stranraer,531,6,12,5,19,52,60,-8,41
Queen's Park,531,7,9,11,16,33,51,-18,38
East Fife,531,8,8,13,15,37,41,-4,37
Peterhead,531,9,11,3,22,40,59,-19,36
Stenhousem'r,531,10,8,8,20,42,79,-37,32
Alloa,532,1,19,11,6,74,40,34,68
Stranraer,532,2,18,6,12,61,53,8,60
Livingston,532,3,16,9,11,55,45,10,57
Albion,532,4,16,8,12,48,40,8,56
Airdrieon,532,5,16,6,14,54,49,5,54
Peterhead,532,6,15,9,12,51,52,-1,54
Brechin,532,7,12,8,16,38,53,-15,44
East Fife,532,8,11,9,16,55,51,4,42
Queen's Park,532,9,8,9,19,35,62,-27,33
Stenhousem'r,532,10,7,9,20,41,67,-26,30
Alloa,533,1,18,10,8,69,43,26,64
Livingston,533,2,18,8,10,70,50,20,62
Airdrieon,533,3,14,13,9,58,50,8,55
Albion,533,4,15,6,15,54,51,3,51
Stranraer,533,5,15,4,17,62,56,6,49
East Fife,533,6,14,7,15,51,48,3,49
Brechin,533,7,14,4,18,45,57,-12,46
Peterhead,533,8,10,13,13,46,63,-17,43
Stenhousem'r,533,9,11,9,16,50,69,-19,42
Queen's Park,533,10,10,8,18,32,50,-18,38
Alloa,534,1,21,9,6,61,30,31,72
Livingston,534,2,21,5,10,73,43,30,68
Airdrieon,534,3,19,4,13,54,46,8,61
Albion,534,4,14,9,13,48,46,2,51
East Fife,534,5,13,11,12,50,44,6,50
Brechin,534,6,14,7,15,43,45,-2,49
Queen's Park,534,7,14,7,15,41,49,-8,49
Peterhead,534,8,11,6,19,43,59,-16,39
Stranraer,534,9,11,5,20,46,54,-8,38
Stenhousem'r,534,10,8,5,23,41,84,-43,29
Livingston,535,1,19,7,10,72,48,24,64
Brechin,535,2,16,7,13,54,49,5,55
Alloa,535,3,14,11,11,66,52,14,53
East Fife,535,4,14,11,11,48,36,12,53
Stranraer,535,5,15,7,14,61,63,-2,52
Airdrieon,535,6,14,8,14,57,64,-7,50
Queen's Park,535,7,14,4,18,34,49,-15,46
Albion,535,8,11,11,14,52,53,-1,44
Peterhead,535,9,12,8,16,47,56,-9,44
Stenhousem'r,535,10,11,6,19,54,75,-21,39
Brechin,536,1,20,4,12,58,55,3,64
Alloa,536,2,18,9,9,71,46,25,63
Stranraer,536,3,16,7,13,63,51,12,55
Airdrieon,536,4,14,10,12,63,53,10,52
Peterhead,536,5,14,10,12,45,48,-3,52
Livingston,536,6,14,7,15,63,49,14,49
Albion,536,7,13,7,16,50,51,-1,46
Queen's Park,536,8,12,8,16,38,52,-14,44
East Fife,536,9,11,10,15,44,50,-6,43
Stenhousem'r,536,10,7,10,19,33,73,-40,31
Livingston,537,1,20,6,10,77,54,23,66
Alloa,537,2,17,11,8,76,49,27,62
Brechin,537,3,16,7,13,55,58,-3,55
Albion,537,4,15,9,12,58,50,8,54
Airdrieon,537,5,15,9,12,55,57,-2,54
Stranraer,537,6,14,5,17,47,52,-5,47
Peterhead,537,7,12,10,14,52,51,1,46
Stenhousem'r,537,8,13,6,17,56,77,-21,45
East Fife,537,9,10,8,18,56,56,0,38
Queen's Park,537,10,9,7,20,30,58,-28,34
Alloa,538,1,20,9,7,72,41,31,69
Livingston,538,2,21,5,10,79,50,29,68
Brechin,538,3,15,8,13,48,45,3,53
Albion,538,4,16,4,16,54,55,-1,52
Queen's Park,538,5,15,7,14,44,47,-3,52
Peterhead,538,6,15,6,15,47,57,-10,51
Airdrieon,538,7,13,6,17,51,58,-7,45
Stranraer,538,8,11,9,16,45,57,-12,42
East Fife,538,9,11,8,17,48,49,-1,41
Stenhousem'r,538,10,9,6,21,46,75,-29,33
Livingston,539,1,19,6,11,72,46,26,63
Alloa,539,2,18,6,12,72,53,19,60
Peterhead,539,3,16,9,11,58,48,10,57
Brechin,539,4,14,9,13,48,49,-1,51
Queen's Park,539,5,14,9,13,45,51,-6,51
Airdrieon,539,6,13,10,13,55,54,1,49
Stranraer,539,7,15,3,18,49,53,-4,48
Albion,539,8,12,11,13,50,52,-2,47
East Fife,539,9,10,9,17,44,53,-9,39
Stenhousem'r,539,10,8,10,18,50,84,-34,34
Alloa,540,1,22,4,10,84,43,41,70
Albion,540,2,19,7,10,57,41,16,64
Livingston,540,3,18,6,12,68,57,11,60
Airdrieon,540,4,18,4,14,58,61,-3,58
Stranraer,540,5,15,6,15,48,52,-4,51
East Fife,540,6,13,8,15,53,52,1,47
Peterhead,540,7,12,10,14,49,52,-3,46
Queen's Park,540,8,13,7,16,49,58,-9,46
Brechin,540,9,10,5,21,38,53,-15,35
Stenhousem'r,540,10,7,9,20,36,71,-35,30
Livingston,541,1,20,7,9,81,52,29,67
Airdrieon,541,2,18,13,5,66,46,20,67
Alloa,541,3,19,8,9,87,53,34,65
Albion,541,4,14,9,13,50,46,4,51
Peterhead,541,5,13,9,14,57,63,-6,48
Brechin,541,6,14,6,16,39,47,-8,48
Queen's Park,541,7,12,8,16,34,45,-11,44
Stranraer,541,8,11,9,16,49,69,-20,42
East Fife,541,9,9,10,17,47,52,-5,37
Stenhousem'r,541,10,5,11,20,37,74,-37,26
Livingston,542,1,23,5,8,83,43,40,74
Alloa,542,2,18,7,11,67,49,18,61
Peterhead,542,3,17,7,12,59,46,13,58
Albion,542,4,15,7,14,62,58,4,52
Brechin,542,5,16,4,16,43,59,-16,52
Airdrieon,542,6,14,5,17,59,63,-4,47
Stranraer,542,7,13,7,16,52,61,-9,46
Queen's Park,542,8,12,8,16,36,50,-14,44
East Fife,542,9,12,6,18,43,50,-7,42
Stenhousem'r,542,10,10,4,22,55,80,-25,34
Alloa,543,1,16,13,7,68,43,25,61
Livingston,543,2,17,7,12,63,49,14,58
Brechin,543,3,17,7,12,47,44,3,58
Airdrieon,543,4,16,8,12,56,53,3,56
East Fife,543,5,14,10,12,49,44,5,52
Stranraer,543,6,15,7,14,60,57,3,52
Peterhead,543,7,11,11,14,43,52,-9,44
Albion,543,8,11,10,15,52,54,-2,43
Queen's Park,543,9,11,9,16,44,55,-11,42
Stenhousem'r,543,10,7,8,21,49,80,-31,29
Livingston,544,1,20,6,10,72,48,24,66
Airdrieon,544,2,17,7,12,54,48,6,58
Stranraer,544,3,16,7,13,57,55,2,55
Alloa,544,4,14,12,10,60,44,16,54
Brechin,544,5,13,10,13,45,46,-1,49
East Fife,544,6,12,10,14,46,43,3,46
Queen's Park,544,7,11,12,13,36,45,-9,45
Peterhead,544,8,13,5,18,49,54,-5,44
Albion,544,9,9,13,14,39,52,-13,40
Stenhousem'r,544,10,9,10,17,51,74,-23,37
Livingston,545,1,23,5,8,74,41,33,74
Alloa,545,2,17,6,13,58,47,11,57
East Fife,545,3,15,10,11,52,39,13,55
Brechin,545,4,16,7,13,52,52,0,55
Albion,545,5,15,7,14,54,50,4,52
Airdrieon,545,6,15,4,17,47,56,-9,49
Queen's Park,545,7,14,6,16,45,48,-3,48
Stranraer,545,8,14,6,16,54,58,-4,48
Peterhead,545,9,12,7,17,43,50,-7,43
Stenhousem'r,545,10,8,4,24,44,82,-38,28
Livingston,546,1,23,2,11,77,44,33,71
Alloa,546,2,20,7,9,72,51,21,67
Airdrieon,546,3,18,10,8,67,54,13,64
Brechin,546,4,15,6,15,47,58,-11,51
Peterhead,546,5,13,11,12,51,49,2,50
Queen's Park,546,6,14,6,16,44,56,-12,48
East Fife,546,7,11,10,15,57,44,13,43
Albion,546,8,10,10,16,44,50,-6,40
Stranraer,546,9,12,4,20,48,60,-12,40
Stenhousem'r,546,10,8,6,22,46,87,-41,30
Alloa,547,1,23,5,8,77,42,35,74
Livingston,547,2,22,5,9,79,53,26,71
Airdrieon,547,3,16,11,9,60,46,14,59
Albion,547,4,16,6,14,62,60,2,54
Brechin,547,5,15,5,16,46,50,-4,50
Peterhead,547,6,13,9,14,50,52,-2,48
Queen's Park,547,7,13,5,18,41,52,-11,44
East Fife,547,8,11,7,18,54,56,-2,40
Stranraer,547,9,10,6,20,52,71,-19,36
Stenhousem'r,547,10,9,5,22,45,84,-39,32
Livingston,548,1,23,4,9,76,45,31,73
Brechin,548,2,21,4,11,56,41,15,67
Airdrieon,548,3,19,8,9,60,50,10,65
Alloa,548,4,18,9,9,76,46,30,63
Albion,548,5,17,5,14,61,54,7,56
Peterhead,548,6,13,7,16,41,52,-11,46
East Fife,548,7,10,8,18,46,51,-5,38
Stranraer,548,8,10,7,19,40,59,-19,37
Stenhousem'r,548,9,9,6,21,51,85,-34,33
Queen's Park,548,10,8,6,22,35,59,-24,30
Alloa,549,1,23,5,8,85,40,45,74
Livingston,549,2,19,6,11,75,52,23,63
Airdrieon,549,3,18,7,11,59,53,6,61
Albion,549,4,16,10,10,56,47,9,58
Brechin,549,5,17,6,13,54,51,3,57
Queen's Park,549,6,13,5,18,39,63,-24,44
East Fife,549,7,12,7,17,49,51,-2,43
Stranraer,549,8,13,4,19,56,64,-8,43
Peterhead,549,9,11,7,18,46,57,-11,40
Stenhousem'r,549,10,6,7,23,34,75,-41,25
Livingston,550,1,22,5,9,79,40,39,71
Alloa,550,2,21,8,7,73,39,34,71
Airdrieon,550,3,17,5,14,51,56,-5,56
Peterhead,550,4,15,8,13,53,56,-3,53
Brechin,550,5,15,6,15,49,48,1,51
Albion,550,6,13,9,14,47,48,-1,48
Stranraer,550,7,14,4,18,48,58,-10,46
East Fife,550,8,11,12,13,51,50,1,45
Queen's Park,550,9,11,6,19,33,51,-18,39
Stenhousem'r,550,10,7,5,24,40,78,-38,26
Livingston,551,1,20,6,10,74,51,23,66
Airdrieon,551,2,20,3,13,70,53,17,63
Brechin,551,3,19,4,13,44,41,3,61
Alloa,551,4,17,8,11,58,43,15,59
Albion,551,5,17,6,13,49,43,6,57
Peterhead,551,6,15,6,15,50,49,1,51
Stranraer,551,7,14,5,17,60,63,-3,47
East Fife,551,8,10,10,16,50,60,-10,40
Queen's Park,551,9,11,5,20,33,51,-18,38
Stenhousem'r,551,10,7,7,22,46,80,-34,28
Alloa,552,1,18,11,7,61,36,25,65
Livingston,552,2,20,2,14,76,55,21,62
Airdrieon,552,3,17,8,11,70,57,13,59
Peterhead,552,4,16,6,14,48,48,0,54
Albion,552,5,14,7,15,56,58,-2,49
East Fife,552,6,13,9,14,49,44,5,48
Brechin,552,7,13,8,15,47,50,-3,47
Queen's Park,552,8,13,7,16,40,51,-11,46
Stranraer,552,9,12,6,18,48,61,-13,42
Stenhousem'r,552,10,10,4,22,44,79,-35,34
Albion,553,1,19,8,9,61,43,18,65
Alloa,553,2,18,8,10,66,45,21,62
Brechin,553,3,18,7,11,54,42,12,61
Livingston,553,4,19,3,14,79,62,17,60
Airdrieon,553,5,15,5,16,56,62,-6,50
East Fife,553,6,12,10,14,53,49,4,46
Stranraer,553,7,12,8,16,58,61,-3,44
Queen's Park,553,8,13,5,18,38,51,-13,44
Peterhead,553,9,10,8,18,41,57,-16,38
Stenhousem'r,553,10,8,10,18,47,81,-34,34
Airdrieon,554,1,18,9,9,63,48,15,63
Alloa,554,2,16,9,11,65,45,20,57
Livingston,554,3,17,5,14,75,61,14,56
Albion,554,4,15,9,12,63,52,11,54
Brechin,554,5,15,7,14,54,53,1,52
East Fife,554,6,13,11,12,63,50,13,50
Peterhead,554,7,14,8,14,57,64,-7,50
Stranraer,554,8,15,4,17,55,66,-11,49
Queen's Park,554,9,10,10,16,41,58,-17,40
Stenhousem'r,554,10,7,8,21,47,86,-39,29
Livingston,555,1,24,4,8,78,36,42,76
Alloa,555,2,16,13,7,58,36,22,61
Airdrieon,555,3,16,10,10,57,50,7,58
Albion,555,4,14,10,12,50,54,-4,52
Brechin,555,5,14,8,14,50,52,-2,50
Queen's Park,555,6,13,7,16,36,45,-9,46
Stranraer,555,7,11,10,15,51,54,-3,43
Peterhead,555,8,10,11,15,38,48,-10,41
East Fife,555,9,11,7,18,46,53,-7,40
Stenhousem'r,555,10,7,8,21,44,80,-36,29
Livingston,556,1,21,4,11,82,57,25,67
Brechin,556,2,20,5,11,70,51,19,65
Airdrieon,556,3,19,7,10,73,64,9,64
Alloa,556,4,17,10,9,71,51,20,61
Peterhead,556,5,17,5,14,61,50,11,56
Albion,556,6,14,10,12,56,49,7,52
East Fife,556,7,10,11,15,44,47,-3,41
Stranraer,556,8,11,8,17,53,60,-7,41
Queen's Park,556,9,9,9,18,33,56,-23,36
Stenhousem'r,556,10,3,9,24,34,92,-58,18
Alloa,557,1,15,14,7,65,47,18,59
Livingston,557,2,17,7,12,76,53,23,58
Airdrieon,557,3,14,11,11,56,49,7,53
Brechin,557,4,14,9,13,45,48,-3,51
Albion,557,5,12,12,12,50,52,-2,48
East Fife,557,6,12,11,13,53,52,1,47
Stenhousem'r,557,7,12,10,14,57,68,-11,46
Queen's Park,557,8,12,9,15,38,52,-14,45
Peterhead,557,9,11,11,14,47,55,-8,44
Stranraer,557,10,10,8,18,50,61,-11,38
Livingston,558,1,19,6,11,78,53,25,63
Alloa,558,2,18,7,11,60,37,23,61
Brechin,558,3,19,4,13,51,39,12,61
Stranraer,558,4,15,6,15,49,55,-6,51
Airdrieon,558,5,14,8,14,49,52,-3,50
Albion,558,6,14,8,14,53,59,-6,50
Peterhead,558,7,13,10,13,47,53,-6,49
Queen's Park,558,8,13,8,15,42,48,-6,47
East Fife,558,9,11,8,17,41,41,0,41
Stenhousem'r,558,10,7,9,20,48,81,-33,30
Alloa,559,1,25,5,6,75,31,44,80
Albion,559,2,19,5,12,66,51,15,62
Livingston,559,3,19,3,14,64,53,11,60
Airdrieon,559,4,15,9,12,49,47,2,54
Peterhead,559,5,14,6,16,55,58,-3,48
East Fife,559,6,13,8,15,47,51,-4,47
Stranraer,559,7,11,9,16,46,55,-9,42
Queen's Park,559,8,11,8,17,44,59,-15,41
Brechin,559,9,10,8,18,47,59,-12,38
Stenhousem'r,559,10,8,9,19,51,80,-29,33
Alloa,560,1,20,9,7,75,42,33,69
Livingston,560,2,21,5,10,73,50,23,68
Peterhead,560,3,16,7,13,52,49,3,55
Airdrieon,560,4,15,8,13,64,57,7,53
Brechin,560,5,15,8,13,49,44,5,53
Queen's Park,560,6,15,8,13,47,47,0,53
Albion,560,7,15,4,17,49,53,-4,49
Stranraer,560,8,11,10,15,45,53,-8,43
East Fife,560,9,8,8,20,44,61,-17,32
Stenhousem'r,560,10,6,9,21,44,86,-42,27
Livingston,561,1,24,3,9,83,46,37,75
Alloa,561,2,18,9,9,56,38,18,63
Airdrieon,561,3,19,5,12,57,54,3,62
Brechin,561,4,16,5,15,49,47,2,53
Peterhead,561,5,14,9,13,53,52,1,51
East Fife,561,6,12,12,12,47,39,8,48
Stranraer,561,7,15,1,20,51,60,-9,46
Albion,561,8,11,11,14,50,48,2,44
Queen's Park,561,9,12,3,21,39,59,-20,39
Stenhousem'r,561,10,5,10,21,40,82,-42,25
Livingston,562,1,24,1,11,74,49,25,73
Alloa,562,2,19,7,10,73,46,27,64
Airdrieon,562,3,15,9,12,61,61,0,54
Peterhead,562,4,15,7,14,53,52,1,52
Queen's Park,562,5,15,6,15,38,45,-7,51
Brechin,562,6,15,6,15,57,66,-9,51
Albion,562,7,12,9,15,60,62,-2,45
Stranraer,562,8,13,5,18,51,61,-10,44
East Fife,562,9,11,7,18,51,51,0,40
Stenhousem'r,562,10,7,11,18,48,73,-25,32
Livingston,563,1,20,6,10,83,57,26,66
Alloa,563,2,18,9,9,75,47,28,63
Airdrieon,563,3,19,6,11,59,56,3,63
Albion,563,4,16,8,12,55,47,8,56
Brechin,563,5,16,8,12,50,42,8,56
East Fife,563,6,13,9,14,54,44,10,48
Peterhead,563,7,12,9,15,43,48,-5,45
Queen's Park,563,8,13,5,18,35,55,-20,44
Stranraer,563,9,8,9,19,49,69,-20,33
Stenhousem'r,563,10,8,5,23,38,76,-38,29
Alloa,564,1,19,8,9,76,47,29,65
Livingston,564,2,18,5,13,72,59,13,59
Brechin,564,3,17,7,12,54,45,9,58
East Fife,564,4,15,9,12,57,46,11,54
Queen's Park,564,5,16,5,15,44,42,2,53
Albion,564,6,15,7,14,52,55,-3,52
Airdrieon,564,7,15,6,15,51,52,-1,51
Peterhead,564,8,11,11,14,38,45,-7,44
Stranraer,564,9,12,6,18,53,64,-11,42
Stenhousem'r,564,10,7,6,23,46,88,-42,27
Livingston,565,1,23,7,6,81,43,38,76
Brechin,565,2,18,8,10,53,40,13,62
Airdrieon,565,3,18,7,11,55,47,8,61
Alloa,565,4,15,12,9,67,48,19,57
Peterhead,565,5,15,11,10,47,43,4,56
Queen's Park,565,6,16,4,16,42,47,-5,52
Albion,565,7,12,7,17,48,54,-6,43
East Fife,565,8,11,7,18,49,53,-4,40
Stranraer,565,9,10,4,22,43,61,-18,34
Stenhousem'r,565,10,6,5,25,41,90,-49,23
Livingston,566,1,20,8,8,73,49,24,68
Airdrieon,566,2,18,8,10,63,51,12,62
Alloa,566,3,17,9,10,66,42,24,60
Brechin,566,4,18,4,14,53,41,12,58
Albion,566,5,13,12,11,52,46,6,51
Peterhead,566,6,13,8,15,50,59,-9,47
Stranraer,566,7,13,7,16,46,52,-6,46
East Fife,566,8,9,12,15,40,48,-8,39
Queen's Park,566,9,10,6,20,27,50,-23,36
Stenhousem'r,566,10,8,8,20,42,74,-32,32
Brechin,567,1,22,7,7,68,44,24,73
Livingston,567,2,22,4,10,82,49,33,70
Alloa,567,3,16,13,7,75,43,32,61
Airdrieon,567,4,15,9,12,52,59,-7,54
Stranraer,567,5,14,6,16,53,58,-5,48
Peterhead,567,6,13,8,15,45,52,-7,47
Albion,567,7,11,10,15,50,54,-4,43
Queen's Park,567,8,10,10,16,30,50,-20,40
East Fife,567,9,5,17,14,35,42,-7,32
Stenhousem'r,567,10,6,8,22,43,82,-39,26
Livingston,568,1,22,5,9,81,44,37,71
Alloa,568,2,20,5,11,66,44,22,65
Airdrieon,568,3,18,6,12,59,56,3,60
Brechin,568,4,15,8,13,51,51,0,53
Peterhead,568,5,13,11,12,50,50,0,50
Stranraer,568,6,13,9,14,56,58,-2,48
Queen's Park,568,7,12,6,18,34,52,-18,42
East Fife,568,8,11,7,18,43,48,-5,40
Stenhousem'r,568,9,9,10,17,50,77,-27,37
Albion,568,10,9,9,18,42,52,-10,36
Livingston,569,1,24,2,10,82,48,34,74
Alloa,569,2,19,9,8,64,37,27,66
East Fife,569,3,17,8,11,51,41,10,59
Albion,569,4,14,10,12,56,53,3,52
Airdrieon,569,5,15,7,14,52,56,-4,52
Brechin,569,6,13,7,16,48,53,-5,46
Stranraer,569,7,12,6,18,52,59,-7,42
Peterhead,569,8,12,5,19,39,51,-12,41
Queen's Park,569,9,10,7,19,35,59,-24,37
Stenhousem'r,569,10,9,9,18,43,65,-22,36
Livingston,570,1,21,7,8,77,46,31,70
Alloa,570,2,20,8,8,70,39,31,68
Airdrieon,570,3,17,8,11,58,53,5,59
Brechin,570,4,16,5,15,59,54,5,53
Queen's Park,570,5,13,9,14,38,45,-7,48
Peterhead,570,6,12,11,13,45,50,-5,47
East Fife,570,7,12,9,15,43,52,-9,45
Albion,570,8,10,10,16,46,56,-10,40
Stranraer,570,9,11,5,20,49,67,-18,38
Stenhousem'r,570,10,10,4,22,55,78,-23,34
Alloa,571,1,22,5,9,75,45,30,71
Airdrieon,571,2,19,4,13,62,48,14,61
Livingston,571,3,16,7,13,66,54,12,55
Albion,571,4,16,6,14,59,51,8,54
Brechin,571,5,15,7,14,43,45,-2,52
Queen's Park,571,6,15,5,16,49,55,-6,50
Stranraer,571,7,16,2,18,53,60,-7,50
Peterhead,571,8,13,7,16,46,48,-2,46
East Fife,571,9,12,8,16,60,61,-1,44
Stenhousem'r,571,10,6,9,21,36,82,-46,27
Alloa,572,1,22,5,9,83,41,42,71
Livingston,572,2,21,4,11,71,48,23,67
Airdrieon,572,3,16,11,9,63,48,15,59
Albion,572,4,14,11,11,64,61,3,53
Brechin,572,5,13,10,13,54,56,-2,49
Queen's Park,572,6,14,6,16,48,60,-12,48
East Fife,572,7,13,8,15,49,46,3,47
Peterhead,572,8,13,7,16,55,62,-7,46
Stranraer,572,9,11,6,19,49,64,-15,39
Stenhousem'r,572,10,5,8,23,39,89,-50,23
Livingston,573,1,23,5,8,78,39,39,74
Brechin,573,2,18,7,11,53,48,5,61
Alloa,573,3,16,9,11,71,44,27,57
Albion,573,4,14,10,12,55,51,4,52
Airdrieon,573,5,12,12,12,46,53,-7,48
Stranraer,573,6,12,10,14,53,54,-1,46
East Fife,573,7,11,9,16,51,53,-2,42
Queen's Park,573,8,11,9,16,35,51,-16,42
Peterhead,573,9,11,8,17,38,53,-15,41
Stenhousem'r,573,10,9,7,20,41,75,-34,34
Airdrieon,574,1,19,7,10,57,44,13,64
Livingston,574,2,16,12,8,77,54,23,60
Alloa,574,3,16,5,15,71,54,17,53
Peterhead,574,4,15,6,15,50,54,-4,51
Albion,574,5,13,10,13,54,48,6,49
East Fife,574,6,14,7,15,57,53,4,49
Stranraer,574,7,14,6,16,53,57,-4,48
Queen's Park,574,8,12,10,14,44,55,-11,46
Brechin,574,9,12,9,15,42,53,-11,45
Stenhousem'r,574,10,9,8,19,46,79,-33,35
Airdrieon,575,1,17,7,12,59,59,0,58
Livingston,575,2,18,3,15,71,49,22,57
Peterhead,575,3,16,8,12,48,46,2,56
Brechin,575,4,15,9,12,54,48,6,54
Alloa,575,5,12,15,9,63,52,11,51
East Fife,575,6,14,8,14,53,45,8,50
Albion,575,7,14,8,14,50,52,-2,50
Stranraer,575,8,13,9,14,46,50,-4,48
Queen's Park,575,9,12,7,17,34,51,-17,43
Stenhousem'r,575,10,7,10,19,49,75,-26,31
Livingston,576,1,21,4,11,70,42,28,67
Alloa,576,2,19,8,9,81,46,35,65
Brechin,576,3,17,11,8,59,47,12,62
Albion,576,4,18,5,13,56,46,10,59
Airdrieon,576,5,15,9,12,56,55,1,54
Peterhead,576,6,13,9,14,41,48,-7,48
Stranraer,576,7,13,7,16,52,59,-7,46
Queen's Park,576,8,12,7,17,37,58,-21,43
East Fife,576,9,10,8,18,43,52,-9,38
Stenhousem'r,576,10,6,4,26,40,82,-42,22
Alloa,577,1,23,3,10,76,41,35,72
Livingston,577,2,22,3,11,77,46,31,69
Brechin,577,3,17,6,13,53,60,-7,57
Albion,577,4,15,7,14,52,45,7,52
Peterhead,577,5,15,7,14,57,62,-5,52
East Fife,577,6,14,6,16,57,46,11,48
Airdrieon,577,7,13,7,16,51,57,-6,46
Stranraer,577,8,13,5,18,49,67,-18,44
Queen's Park,577,9,11,7,18,43,56,-13,40
Stenhousem'r,577,10,6,11,19,39,74,-35,29
Alloa,578,1,21,6,9,77,47,30,69
Livingston,578,2,20,5,11,82,51,31,65
Brechin,578,3,19,3,14,57,52,5,60
Airdrieon,578,4,18,5,13,63,62,1,59
Peterhead,578,5,15,8,13,55,48,7,53
Stranraer,578,6,13,7,16,54,61,-7,46
Albion,578,7,12,9,15,47,64,-17,45
East Fife,578,8,12,8,16,56,58,-2,44
Queen's Park,578,9,12,6,18,39,51,-12,42
Stenhousem'r,578,10,6,7,23,47,83,-36,25
Livingston,579,1,21,9,6,81,43,38,72
Alloa,579,2,17,10,9,71,47,24,61
Brechin,579,3,15,9,12,53,47,6,54
Albion,579,4,16,5,15,57,60,-3,53
Queen's Park,579,5,15,7,14,43,48,-5,52
East Fife,579,6,13,11,12,60,48,12,50
Stranraer,579,7,14,7,15,48,51,-3,49
Peterhead,579,8,12,7,17,49,62,-13,43
Airdrieon,579,9,12,6,18,49,65,-16,42
Stenhousem'r,579,10,5,9,22,49,89,-40,24
Livingston,580,1,21,5,10,79,50,29,68
Alloa,580,2,20,7,9,78,51,27,67
Brechin,580,3,16,6,14,49,53,-4,54
East Fife,580,4,14,9,13,48,42,6,51
Peterhead,580,5,14,9,13,47,45,2,51
Albion,580,6,12,13,11,54,49,5,49
Stranraer,580,7,12,6,18,51,64,-13,42
Queen's Park,580,8,11,9,16,42,57,-15,42
Airdrieon,580,9,12,6,18,47,63,-16,42
Stenhousem'r,580,10,9,8,19,56,77,-21,35
Livingston,581,1,22,5,9,82,48,34,71
Brechin,581,2,21,3,12,63,55,8,66
Airdrieon,581,3,19,6,11,65,54,11,63
Alloa,581,4,15,11,10,62,45,17,56
Peterhead,581,5,12,12,12,56,53,3,48
Albion,581,6,12,8,16,49,58,-9,44
Queen's Park,581,7,10,10,16,39,50,-11,40
East Fife,581,8,8,15,13,46,48,-2,39
Stenhousem'r,581,9,9,9,18,52,83,-31,36
Stranraer,581,10,8,9,19,43,63,-20,33
Livingston,582,1,21,6,9,69,42,27,69
Alloa,582,2,18,10,8,74,44,30,64
Brechin,582,3,16,8,12,47,45,2,56
Airdrieon,582,4,15,8,13,47,46,1,53
East Fife,582,5,12,10,14,44,40,4,46
Peterhead,582,6,11,13,12,50,51,-1,46
Albion,582,7,11,11,14,45,53,-8,44
Queen's Park,582,8,11,8,17,38,53,-15,41
Stranraer,582,9,10,8,18,46,63,-17,38
Stenhousem'r,582,10,10,8,18,54,77,-23,38
Alloa,583,1,19,12,5,82,39,43,69
Livingston,583,2,21,5,10,83,52,31,68
Airdrieon,583,3,18,6,12,61,54,7,60
Albion,583,4,16,5,15,59,54,5,53
Brechin,583,5,15,7,14,51,48,3,52
Peterhead,583,6,12,10,14,41,54,-13,46
Stranraer,583,7,13,4,19,45,54,-9,43
Queen's Park,583,8,11,8,17,40,60,-20,41
East Fife,583,9,10,9,17,42,52,-10,39
Stenhousem'r,583,10,8,8,20,48,85,-37,32
Livingston,584,1,21,5,10,75,46,29,68
Alloa,584,2,17,10,9,70,48,22,61
Airdrieon,584,3,16,10,10,61,48,13,58
Stranraer,584,4,17,6,13,56,56,0,57
Brechin,584,5,14,8,14,55,57,-2,50
Peterhead,584,6,13,8,15,55,59,-4,47
East Fife,584,7,12,9,15,50,49,1,45
Albion,584,8,11,8,17,52,67,-15,41
Queen's Park,584,9,9,9,18,31,49,-18,36
Stenhousem'r,584,10,9,9,18,52,78,-26,36
Livingston,585,1,21,6,9,71,44,27,69
Airdrieon,585,2,20,8,8,65,47,18,68
Alloa,585,3,18,6,12,70,54,16,60
Brechin,585,4,16,7,13,53,45,8,55
Albion,585,5,14,9,13,59,60,-1,51
East Fife,585,6,13,8,15,51,49,2,47
Peterhead,585,7,13,8,15,50,56,-6,47
Stranraer,585,8,11,7,18,50,63,-13,40
Queen's Park,585,9,10,9,17,44,58,-14,39
Stenhousem'r,585,10,5,10,21,49,86,-37,25
Livingston,586,1,20,5,11,72,44,28,65
Alloa,586,2,19,7,10,68,41,27,64
Brechin,586,3,17,5,14,49,52,-3,56
Airdrieon,586,4,16,6,14,56,54,2,54
Peterhead,586,5,14,10,12,50,43,7,52
Albion,586,6,14,9,13,51,48,3,51
Queen's Park,586,7,14,8,14,41,44,-3,50
East Fife,586,8,12,8,16,57,55,2,44
Stranraer,586,9,11,9,16,44,62,-18,42
Stenhousem'r,586,10,7,5,24,41,86,-45,26
Livingston,587,1,22,1,13,88,56,32,67
Alloa,587,2,18,7,11,73,51,22,61
Airdrieon,587,3,18,5,13,60,53,7,59
Brechin,587,4,16,7,13,56,59,-3,55
Albion,587,5,15,9,12,55,47,8,54
Peterhead,587,6,13,8,15,51,58,-7,47
Stranraer,587,7,13,5,18,55,66,-11,44
East Fife,587,8,11,10,15,51,49,2,43
Queen's Park,587,9,11,8,17,38,52,-14,41
Stenhousem'r,587,10,10,6,20,47,83,-36,36
Livingston,588,1,25,2,9,85,42,43,77
Alloa,588,2,20,8,8,72,40,32,68
Brechin,588,3,19,5,12,56,46,10,62
East Fife,588,4,12,10,14,46,38,8,46
Airdrieon,588,5,12,10,14,51,55,-4,46
Stranraer,588,6,12,8,16,52,61,-9,44
Albion,588,7,12,8,16,47,58,-11,44
Peterhead,588,8,11,8,17,37,57,-20,41
Stenhousem'r,588,9,11,7,18,51,78,-27,40
Queen's Park,588,10,9,8,19,31,53,-22,35
Livingston,589,1,23,5,8,80,41,39,74
Alloa,589,2,20,8,8,70,38,32,68
Airdrieon,589,3,19,8,9,62,51,11,65
East Fife,589,4,15,9,12,58,46,12,54
Brechin,589,5,15,7,14,39,47,-8,52
Queen's Park,589,6,13,7,16,39,47,-8,46
Peterhead,589,7,11,12,13,46,52,-6,45
Albion,589,8,12,6,18,48,56,-8,42
Stenhousem'r,589,9,7,8,21,38,72,-34,29
Stranraer,589,10,7,6,23,41,71,-30,27
Livingston,590,1,22,4,10,80,47,33,70
Alloa,590,2,18,8,10,72,47,25,62
Brechin,590,3,17,10,9,54,45,9,61
Albion,590,4,12,15,9,51,51,0,51
Airdrieon,590,5,15,5,16,60,59,1,50
Stranraer,590,6,14,7,15,53,55,-2,49
Peterhead,590,7,11,9,16,48,56,-8,42
Queen's Park,590,8,11,8,17,34,47,-13,41
East Fife,590,9,9,12,15,45,48,-3,39
Stenhousem'r,590,10,9,6,21,43,85,-42,33
Livingston,591,1,24,3,9,75,41,34,75
Alloa,591,2,19,8,9,72,44,28,65
Airdrieon,591,3,16,10,10,64,54,10,58
Brechin,591,4,17,7,12,57,52,5,58
Albion,591,5,14,8,14,46,49,-3,50
Stranraer,591,6,12,7,17,48,59,-11,43
Queen's Park,591,7,12,7,17,45,58,-13,43
East Fife,591,8,11,9,16,50,50,0,42
Peterhead,591,9,9,9,18,42,55,-13,36
Stenhousem'r,591,10,8,8,20,39,76,-37,32
Livingston,592,1,26,2,8,88,49,39,80
Alloa,592,2,20,5,11,71,41,30,65
Airdrieon,592,3,18,7,11,62,47,15,61
Albion,592,4,16,8,12,55,53,2,56
Brechin,592,5,15,7,14,53,55,-2,52
East Fife,592,6,13,8,15,58,51,7,47
Queen's Park,592,7,14,3,19,45,65,-20,45
Peterhead,592,8,12,7,17,57,65,-8,43
Stenhousem'r,592,9,7,10,19,46,89,-43,31
Stranraer,592,10,8,5,23,53,73,-20,29
Livingston,593,1,24,3,9,83,47,36,75
Alloa,593,2,20,5,11,77,53,24,65
Peterhead,593,3,17,7,12,56,51,5,58
Albion,593,4,15,9,12,59,57,2,54
Brechin,593,5,16,6,14,54,53,1,54
Airdrieon,593,6,14,11,11,63,61,2,53
Queen's Park,593,7,12,6,18,39,49,-10,42
Stranraer,593,8,11,7,18,44,56,-12,40
East Fife,593,9,9,11,16,43,48,-5,38
Stenhousem'r,593,10,6,7,23,40,83,-43,25
Alloa,594,1,20,7,9,66,40,26,67
Airdrieon,594,2,17,8,11,64,50,14,59
Livingston,594,3,16,8,12,63,50,13,56
Albion,594,4,15,8,13,49,48,1,53
Brechin,594,5,16,5,15,43,48,-5,53
Queen's Park,594,6,16,4,16,41,48,-7,52
Peterhead,594,7,13,9,14,53,52,1,48
Stranraer,594,8,12,9,15,45,52,-7,45
East Fife,594,9,11,9,16,42,45,-3,42
Stenhousem'r,594,10,7,7,22,41,74,-33,28
Livingston,595,1,23,1,12,85,53,32,70
Alloa,595,2,19,9,8,68,34,34,66
Peterhead,595,3,18,9,9,54,47,7,63
Airdrieon,595,4,15,8,13,54,61,-7,53
Brechin,595,5,14,8,14,49,47,2,50
Queen's Park,595,6,14,7,15,47,53,-6,49
Albion,595,7,12,7,17,44,57,-13,43
East Fife,595,8,9,14,13,53,46,7,41
Stenhousem'r,595,9,8,10,18,42,72,-30,34
Stranraer,595,10,9,5,22,46,72,-26,32
Alloa,596,1,18,9,9,67,43,24,63
Brechin,596,2,18,9,9,49,37,12,63
Livingston,596,3,19,5,12,63,42,21,62
Airdrieon,596,4,16,8,12,55,49,6,56
Stranraer,596,5,14,8,14,51,57,-6,50
Albion,596,6,14,6,16,55,57,-2,48
East Fife,596,7,13,7,16,50,48,2,46
Peterhead,596,8,12,9,15,46,44,2,45
Queen's Park,596,9,12,6,18,39,57,-18,42
Stenhousem'r,596,10,6,9,21,44,85,-41,27
Livingston,597,1,20,5,11,68,41,27,65
Alloa,597,2,19,7,10,70,45,25,64
Brechin,597,3,17,6,13,54,51,3,57
Airdrieon,597,4,16,6,14,49,60,-11,54
Albion,597,5,13,12,11,48,44,4,51
Queen's Park,597,6,15,6,15,51,49,2,51
Stranraer,597,7,14,5,17,52,59,-7,47
Peterhead,597,8,12,10,14,58,57,1,46
East Fife,597,9,12,9,15,55,50,5,45
Stenhousem'r,597,10,5,8,23,36,85,-49,23
Livingston,598,1,22,4,10,73,49,24,70
Alloa,598,2,20,7,9,71,44,27,67
Albion,598,3,17,8,11,57,50,7,59
Airdrieon,598,4,16,6,14,54,55,-1,54
Brechin,598,5,15,7,14,56,54,2,52
East Fife,598,6,13,9,14,54,52,2,48
Peterhead,598,7,14,6,16,52,61,-9,48
Stranraer,598,8,11,7,18,55,58,-3,40
Queen's Park,598,9,11,6,19,33,48,-15,39
Stenhousem'r,598,10,5,12,19,44,78,-34,27
Alloa,599,1,20,7,9,73,46,27,67
Livingston,599,2,20,2,14,72,52,20,62
Brechin,599,3,19,4,13,52,41,11,61
Peterhead,599,4,16,4,16,48,54,-6,52
East Fife,599,5,14,8,14,51,45,6,50
Albion,599,6,13,11,12,50,47,3,50
Queen's Park,599,7,15,5,16,36,45,-9,50
Airdrieon,599,8,14,7,15,49,55,-6,49
Stranraer,599,9,14,5,17,56,61,-5,47
Stenhousem'r,599,10,5,7,24,41,82,-41,22
Alloa,600,1,19,9,8,66,41,25,66
Livingston,600,2,17,5,14,62,53,9,56
Albion,600,3,14,13,9,53,40,13,55
Airdrieon,600,4,16,7,13,57,51,6,55
East Fife,600,5,14,12,10,60,45,15,54
Brechin,600,6,15,6,15,45,43,2,51
Stranraer,600,7,13,6,17,44,51,-7,45
Peterhead,600,8,12,8,16,46,55,-9,44
Queen's Park,600,9,12,5,19,33,51,-18,41
Stenhousem'r,600,10,8,9,19,39,75,-36,33
Airdrieon,601,1,21,2,13,65,52,13,65
Alloa,601,2,19,6,11,70,44,26,63
Livingston,601,3,19,4,13,74,59,15,61
Brechin,601,4,16,6,14,49,48,1,54
Peterhead,601,5,15,8,13,55,46,9,53
Stranraer,601,6,13,8,15,51,55,-4,47
East Fife,601,7,11,12,13,51,49,2,45
Queen's Park,601,8,13,6,17,42,57,-15,45
Albion,601,9,11,11,14,45,54,-9,44
Stenhousem'r,601,10,5,11,20,42,80,-38,26
Livingston,602,1,21,6,9,76,43,33,69
Alloa,602,2,16,10,10,65,49,16,58
Albion,602,3,15,10,11,59,47,12,55
Airdrieon,602,4,16,7,13,56,54,2,55
Brechin,602,5,16,5,15,52,54,-2,53
Peterhead,602,6,12,11,13,47,51,-4,47
Queen's Park,602,7,13,6,17,35,50,-15,45
Stranraer,602,8,14,2,20,55,65,-10,44
Stenhousem'r,602,9,11,9,16,49,68,-19,42
East Fife,602,10,7,12,17,45,58,-13,33
Alloa,603,1,18,12,6,77,44,33,66
Livingston,603,2,19,7,10,63,44,19,64
Brechin,603,3,19,6,11,53,43,10,63
Airdrieon,603,4,18,8,10,62,54,8,62
Queen's Park,603,5,16,9,11,49,49,0,57
Peterhead,603,6,15,6,15,51,50,1,51
Albion,603,7,13,10,13,58,48,10,49
Stranraer,603,8,10,3,23,43,68,-25,33
East Fife,603,9,8,7,21,41,55,-14,31
Stenhousem'r,603,10,6,8,22,43,85,-42,26
Alloa,604,1,18,8,10,73,46,27,62
Airdrieon,604,2,18,8,10,57,53,4,62
Brechin,604,3,19,4,13,51,46,5,61
Livingston,604,4,19,3,14,79,51,28,60
Stranraer,604,5,16,6,14,56,55,1,54
Peterhead,604,6,14,6,16,50,55,-5,48
Queen's Park,604,7,13,6,17,36,47,-11,45
Albion,604,8,11,7,18,49,62,-13,40
East Fife,604,9,9,10,17,40,56,-16,37
Stenhousem'r,604,10,9,10,17,51,71,-20,37
Livingston,605,1,20,4,12,66,50,16,64
Alloa,605,2,18,9,9,66,41,25,63
Airdrieon,605,3,16,7,13,59,57,2,55
Brechin,605,4,16,4,16,50,49,1,52
Stranraer,605,5,15,6,15,52,48,4,51
Peterhead,605,6,13,8,15,40,49,-9,47
East Fife,605,7,12,10,14,44,44,0,46
Albion,605,8,12,9,15,54,55,-1,45
Queen's Park,605,9,9,13,14,30,45,-15,40
Stenhousem'r,605,10,8,12,16,45,68,-23,36
Alloa,606,1,18,7,11,65,46,19,61
Brechin,606,2,17,6,13,49,44,5,57
Livingston,606,3,17,5,14,77,64,13,56
Peterhead,606,4,16,8,12,45,47,-2,56
Airdrieon,606,5,15,7,14,56,52,4,52
Stranraer,606,6,15,6,15,53,55,-2,51
Albion,606,7,12,10,14,42,42,0,46
East Fife,606,8,12,9,15,51,44,7,45
Queen's Park,606,9,11,9,16,32,53,-21,42
Stenhousem'r,606,10,10,7,19,49,72,-23,37
Livingston,607,1,21,5,10,82,50,32,68
Peterhead,607,2,17,8,11,62,50,12,59
Airdrieon,607,3,17,8,11,54,49,5,59
Alloa,607,4,15,8,13,65,51,14,53
Albion,607,5,14,10,12,62,58,4,52
Brechin,607,6,14,8,14,44,46,-2,50
Stranraer,607,7,15,4,17,55,59,-4,49
Queen's Park,607,8,14,7,15,37,52,-15,49
East Fife,607,9,8,14,14,44,53,-9,38
Stenhousem'r,607,10,5,8,23,46,83,-37,23
Livingston,608,1,19,5,12,67,44,23,62
Alloa,608,2,17,9,10,63,45,18,60
Brechin,608,3,17,6,13,50,47,3,57
Albion,608,4,14,11,11,44,39,5,53
Stranraer,608,5,14,9,13,60,54,6,51
Peterhead,608,6,14,8,14,54,53,1,50
Airdrieon,608,7,14,7,15,55,66,-11,49
Queen's Park,608,8,13,6,17,43,54,-11,45
East Fife,608,9,10,8,18,41,47,-6,38
Stenhousem'r,608,10,9,9,18,46,74,-28,36
Livingston,609,1,24,4,8,77,38,39,76
Airdrieon,609,2,20,6,10,64,47,17,66
Brechin,609,3,19,4,13,52,43,9,61
Alloa,609,4,17,7,12,67,51,16,58
Albion,609,5,13,10,13,53,46,7,49
Peterhead,609,6,11,11,14,46,55,-9,44
East Fife,609,7,11,10,15,49,50,-1,43
Stranraer,609,8,10,10,16,51,65,-14,40
Queen's Park,609,9,11,7,18,32,52,-20,40
Stenhousem'r,609,10,6,7,23,39,83,-44,25
Alloa,610,1,22,8,6,73,44,29,74
Livingston,610,2,22,4,10,88,49,39,70
Brechin,610,3,17,6,13,54,42,12,57
Airdrieon,610,4,17,6,13,61,60,1,57
East Fife,610,5,13,7,16,51,53,-2,46
Queen's Park,610,6,13,7,16,36,54,-18,46
Stranraer,610,7,13,5,18,47,54,-7,44
Albion,610,8,11,9,16,50,65,-15,42
Peterhead,610,9,10,7,19,47,62,-15,37
Stenhousem'r,610,10,8,9,19,51,75,-24,33
Livingston,611,1,23,2,11,82,51,31,71
Alloa,611,2,17,12,7,79,50,29,63
Brechin,611,3,17,11,8,60,44,16,62
Albion,611,4,17,8,11,57,50,7,59
Airdrieon,611,5,14,10,12,58,52,6,52
Peterhead,611,6,12,10,14,56,54,2,46
Queen's Park,611,7,11,8,17,39,60,-21,41
East Fife,611,8,8,12,16,43,53,-10,36
Stranraer,611,9,9,8,19,52,73,-21,35
Stenhousem'r,611,10,9,5,22,50,89,-39,32
Livingston,612,1,23,2,11,79,42,37,71
Alloa,612,2,19,8,9,70,40,30,65
Airdrieon,612,3,18,7,11,68,66,2,61
Brechin,612,4,15,9,12,49,43,6,54
Albion,612,5,14,10,12,51,56,-5,52
Peterhead,612,6,13,7,16,59,61,-2,46
Queen's Park,612,7,11,8,17,37,56,-19,41
Stenhousem'r,612,8,11,6,19,52,79,-27,39
East Fife,612,9,9,11,16,47,51,-4,38
Stranraer,612,10,11,4,21,43,61,-18,37
Livingston,613,1,22,3,11,77,48,29,69
Alloa,613,2,20,6,10,70,43,27,66
Brechin,613,3,16,9,11,52,47,5,57
Peterhead,613,4,15,7,14,44,53,-9,52
Queen's Park,613,5,15,6,15,47,45,2,51
Airdrieon,613,6,14,6,16,54,63,-9,48
East Fife,613,7,12,10,14,52,47,5,46
Stranraer,613,8,13,7,16,50,55,-5,46
Albion,613,9,12,9,15,52,57,-5,45
Stenhousem'r,613,10,5,9,22,32,72,-40,24
Livingston,614,1,24,4,8,77,37,40,76
Alloa,614,2,14,14,8,56,41,15,56
Albion,614,3,15,10,11,48,41,7,55
Airdrieon,614,4,17,4,15,59,59,0,55
Brechin,614,5,15,7,14,50,47,3,52
Peterhead,614,6,15,7,14,41,48,-7,52
Stranraer,614,7,13,6,17,51,54,-3,45
Queen's Park,614,8,13,5,18,42,52,-10,44
East Fife,614,9,9,8,19,37,51,-14,35
Stenhousem'r,614,10,10,5,21,41,72,-31,35
Alloa,615,1,20,10,6,71,40,31,70
Livingston,615,2,19,2,15,65,51,14,59
Albion,615,3,16,8,12,54,47,7,56
Brechin,615,4,17,4,15,50,59,-9,55
Airdrieon,615,5,15,7,14,54,56,-2,52
Stranraer,615,6,16,3,17,49,50,-1,51
Peterhead,615,7,14,7,15,51,58,-7,49
Queen's Park,615,8,12,10,14,40,43,-3,46
East Fife,615,9,13,6,17,55,56,-1,45
Stenhousem'r,615,10,7,5,24,47,76,-29,26
Alloa,616,1,20,7,9,70,43,27,67
Livingston,616,2,18,6,12,72,47,25,60
Airdrieon,616,3,16,9,11,57,54,3,57
Stranraer,616,4,15,6,15,49,49,0,51
Peterhead,616,5,14,8,14,56,58,-2,50
Albion,616,6,13,8,15,55,64,-9,47
East Fife,616,7,11,11,14,55,51,4,44
Brechin,616,8,12,8,16,50,56,-6,44
Queen's Park,616,9,13,5,18,40,57,-17,44
Stenhousem'r,616,10,10,8,18,56,81,-25,38
Livingston,617,1,22,7,7,84,44,40,73
Alloa,617,2,19,8,9,73,46,27,65
Airdrieon,617,3,17,7,12,59,53,6,58
Peterhead,617,4,14,9,13,54,48,6,51
Queen's Park,617,5,15,5,16,48,65,-17,50
Stranraer,617,6,14,7,15,47,54,-7,49
Albion,617,7,12,10,14,55,51,4,46
Brechin,617,8,13,7,16,49,55,-6,46
East Fife,617,9,11,8,17,38,47,-9,41
Stenhousem'r,617,10,6,6,24,42,86,-44,24
Livingston,618,1,23,4,9,82,49,33,73
Alloa,618,2,20,9,7,71,40,31,69
Airdrieon,618,3,19,5,12,68,54,14,62
Brechin,618,4,18,7,11,56,46,10,61
Albion,618,5,14,7,15,54,53,1,49
East Fife,618,6,11,12,13,49,43,6,45
Stranraer,618,7,13,4,19,50,68,-18,43
Queen's Park,618,8,10,7,19,36,54,-18,37
Peterhead,618,9,11,4,21,44,63,-19,37
Stenhousem'r,618,10,7,9,20,51,91,-40,30
Livingston,619,1,22,3,11,74,48,26,69
Alloa,619,2,18,9,9,66,42,24,63
Brechin,619,3,18,4,14,53,50,3,58
Airdrieon,619,4,15,10,11,57,59,-2,55
Peterhead,619,5,15,9,12,47,39,8,54
Albion,619,6,14,8,14,51,48,3,50
East Fife,619,7,12,9,15,61,51,10,45
Queen's Park,619,8,12,9,15,43,46,-3,45
Stranraer,619,9,12,5,19,43,61,-18,41
Stenhousem'r,619,10,5,8,23,39,90,-51,23
Alloa,620,1,22,7,7,80,40,40,73
Airdrieon,620,2,17,8,11,62,56,6,59
East Fife,620,3,17,7,12,69,48,21,58
Brechin,620,4,17,4,15,58,55,3,55
Peterhead,620,5,14,11,11,57,50,7,53
Livingston,620,6,15,7,14,73,62,11,52
Stranraer,620,7,14,6,16,54,59,-5,48
Albion,620,8,11,8,17,49,66,-17,41
Queen's Park,620,9,11,4,21,34,58,-24,37
Stenhousem'r,620,10,8,6,22,46,88,-42,30
Alloa,621,1,24,7,5,82,34,48,79
Livingston,621,2,23,3,10,78,42,36,72
Brechin,621,3,16,7,13,45,47,-2,55
Airdrieon,621,4,16,4,16,59,57,2,52
Albion,621,5,13,9,14,51,63,-12,48
East Fife,621,6,12,10,14,60,60,0,46
Peterhead,621,7,13,7,16,44,56,-12,46
Stranraer,621,8,14,3,19,49,58,-9,45
Queen's Park,621,9,11,7,18,29,46,-17,40
Stenhousem'r,621,10,5,9,22,45,79,-34,24
Livingston,622,1,18,10,8,67,37,30,64
Alloa,622,2,18,9,9,63,44,19,63
Airdrieon,622,3,17,8,11,60,50,10,59
Albion,622,4,16,6,14,55,59,-4,54
Brechin,622,5,14,10,12,46,45,1,52
Queen's Park,622,6,13,9,14,43,53,-10,48
Peterhead,622,7,12,10,14,54,55,-1,46
Stranraer,622,8,12,6,18,48,57,-9,42
East Fife,622,9,9,12,15,52,52,0,39
Stenhousem'r,622,10,6,10,20,49,85,-36,28
Alloa,623,1,20,9,7,76,43,33,69
Livingston,623,2,20,4,12,74,51,23,64
Airdrieon,623,3,19,7,10,66,51,15,64
Brechin,623,4,15,11,10,59,43,16,56
Albion,623,5,14,10,12,53,46,7,52
Queen's Park,623,6,15,7,14,45,46,-1,52
Peterhead,623,7,10,11,15,40,56,-16,41
Stranraer,623,8,11,8,17,51,69,-18,41
East Fife,623,9,9,8,19,47,57,-10,35
Stenhousem'r,623,10,5,9,22,35,84,-49,24
Livingston,624,1,21,1,14,71,51,20,64
Alloa,624,2,18,7,11,71,48,23,61
Airdrieon,624,3,18,5,13,70,56,14,59
Peterhead,624,4,16,7,13,58,60,-2,55
Brechin,624,5,17,4,15,42,47,-5,55
Queen's Park,624,6,16,4,16,37,46,-9,52
Stranraer,624,7,14,3,19,48,56,-8,45
Albion,624,8,12,8,16,51,52,-1,44
Stenhousem'r,624,9,12,4,20,55,75,-20,40
East Fife,624,10,10,9,17,41,53,-12,39
Livingston,625,1,22,4,10,72,39,33,70
Brechin,625,2,19,5,12,56,44,12,62
Albion,625,3,17,7,12,59,55,4,58
Alloa,625,4,16,8,12,69,47,22,56
Peterhead,625,5,14,7,15,48,53,-5,49
East Fife,625,6,13,9,14,54,51,3,48
Queen's Park,625,7,13,7,16,33,47,-14,46
Stranraer,625,8,13,5,18,53,58,-5,44
Airdrieon,625,9,12,7,17,50,65,-15,43
Stenhousem'r,625,10,7,9,20,43,78,-35,30
Alloa,626,1,21,10,5,72,37,35,73
Livingston,626,2,22,3,11,77,48,29,69
Airdrieon,626,3,19,10,7,65,51,14,67
Brechin,626,4,20,4,12,55,46,9,64
Peterhead,626,5,15,5,16,59,55,4,50
Albion,626,6,13,6,17,50,55,-5,45
East Fife,626,7,10,9,17,45,52,-7,39
Queen's Park,626,8,10,9,17,39,58,-19,39
Stranraer,626,9,11,2,23,40,62,-22,35
Stenhousem'r,626,10,5,10,21,44,82,-38,25
Alloa,627,1,18,10,8,68,43,25,64
Airdrieon,627,2,18,9,9,61,58,3,63
Livingston,627,3,19,5,12,69,42,27,62
Stranraer,627,4,17,5,14,59,55,4,56
Brechin,627,5,15,7,14,43,45,-2,52
Albion,627,6,14,9,13,60,52,8,51
Queen's Park,627,7,13,9,14,43,47,-4,48
East Fife,627,8,12,11,13,50,44,6,47
Peterhead,627,9,12,5,19,39,56,-17,41
Stenhousem'r,627,10,4,6,26,41,91,-50,18
Alloa,628,1,20,8,8,72,44,28,68
Livingston,628,2,21,2,13,78,52,26,65
Airdrieon,628,3,17,6,13,61,65,-4,57
Albion,628,4,15,10,11,60,44,16,55
Stranraer,628,5,14,7,15,54,53,1,49
Peterhead,628,6,14,7,15,46,51,-5,49
Brechin,628,7,14,7,15,45,50,-5,49
East Fife,628,8,12,9,15,51,56,-5,45
Queen's Park,628,9,10,9,17,29,47,-18,39
Stenhousem'r,628,10,7,7,22,39,73,-34,28
Livingston,629,1,25,4,7,80,41,39,79
Alloa,629,2,17,7,12,64,49,15,58
East Fife,629,3,16,7,13,55,42,13,55
Airdrieon,629,4,17,4,15,63,55,8,55
Brechin,629,5,15,7,14,48,53,-5,52
Albion,629,6,14,8,14,51,54,-3,50
Peterhead,629,7,12,7,17,47,54,-7,43
Queen's Park,629,8,12,7,17,42,56,-14,43
Stenhousem'r,629,9,11,6,19,53,75,-22,39
Stranraer,629,10,11,3,22,50,74,-24,36
Alloa,630,1,20,6,10,67,47,20,66
Livingston,630,2,17,7,12,76,50,26,58
Brechin,630,3,16,8,12,59,50,9,56
Airdrieon,630,4,14,11,11,50,51,-1,53
Peterhead,630,5,15,6,15,49,48,1,51
Albion,630,6,13,9,14,48,52,-4,48
Queen's Park,630,7,14,6,16,42,55,-13,48
Stenhousem'r,630,8,11,8,17,50,72,-22,41
Stranraer,630,9,11,7,18,43,53,-10,40
East Fife,630,10,9,12,15,44,50,-6,39
Brechin,631,1,18,8,10,54,46,8,62
Alloa,631,2,18,7,11,76,48,28,61
Livingston,631,3,19,3,14,73,56,17,60
Airdrieon,631,4,18,5,13,63,50,13,59
Albion,631,5,17,8,11,63,51,12,59
Queen's Park,631,6,16,4,16,45,47,-2,52
Peterhead,631,7,12,7,17,46,67,-21,43
East Fife,631,8,11,9,16,54,59,-5,42
Stranraer,631,9,12,5,19,52,62,-10,41
Stenhousem'r,631,10,8,6,22,44,84,-40,30
Livingston,632,1,21,5,10,70,46,24,68
Alloa,632,2,21,4,11,76,47,29,67
Airdrieon,632,3,16,7,13,60,54,6,55
Brechin,632,4,15,8,13,58,53,5,53
Peterhead,632,5,15,7,14,50,49,1,52
Albion,632,6,13,8,15,46,47,-1,47
Stranraer,632,7,13,8,15,52,55,-3,47
Queen's Park,632,8,13,5,18,35,48,-13,44
East Fife,632,9,11,8,17,44,52,-8,41
Stenhousem'r,632,10,7,10,19,39,79,-40,31
Alloa,633,1,20,9,7,72,39,33,69
Livingston,633,2,19,5,12,71,47,24,62
Airdrieon,633,3,16,11,9,64,63,1,59
Albion,633,4,15,9,12,54,53,1,54
East Fife,633,5,14,10,12,54,46,8,52
Brechin,633,6,13,8,15,44,51,-7,47
Stranraer,633,7,12,6,18,52,67,-15,42
Peterhead,633,8,11,8,17,53,58,-5,41
Queen's Park,633,9,10,8,18,37,59,-22,38
Stenhousem'r,633,10,9,8,19,58,76,-18,35
Alloa,634,1,21,7,8,72,41,31,70
Livingston,634,2,19,5,12,79,56,23,62
Brechin,634,3,18,6,12,58,48,10,60
Airdrieon,634,4,15,7,14,51,54,-3,52
Stranraer,634,5,14,9,13,54,50,4,51
Queen's Park,634,6,15,5,16,43,54,-11,50
Albion,634,7,13,10,13,54,58,-4,49
Peterhead,634,8,12,7,17,38,45,-7,43
East Fife,634,9,10,10,16,47,49,-2,40
Stenhousem'r,634,10,6,8,22,48,89,-41,26
Livingston,635,1,21,1,14,75,59,16,64
Brechin,635,2,16,9,11,50,44,6,57
Airdrieon,635,3,16,7,13,65,58,7,55
Albion,635,4,14,10,12,57,54,3,52
Peterhead,635,5,13,10,13,47,50,-3,49
Queen's Park,635,6,14,7,15,40,45,-5,49
Alloa,635,7,14,6,16,61,55,6,48
East Fife,635,8,13,9,14,51,47,4,48
Stranraer,635,9,14,6,16,55,58,-3,48
Stenhousem'r,635,10,9,7,20,52,83,-31,34
Livingston,636,1,20,8,8,78,49,29,68
Brechin,636,2,20,4,12,54,47,7,64
Alloa,636,3,16,10,10,69,49,20,58
Peterhead,636,4,18,4,14,62,54,8,58
Airdrieon,636,5,17,4,15,60,57,3,55
East Fife,636,6,15,8,13,55,38,17,53
Albion,636,7,15,7,14,52,54,-2,52
Stranraer,636,8,13,3,20,49,65,-16,42
Queen's Park,636,9,12,4,20,40,62,-22,40
Stenhousem'r,636,10,6,4,26,52,96,-44,22
Airdrieon,637,1,21,7,8,68,51,17,70
Alloa,637,2,18,11,7,70,44,26,65
Livingston,637,3,19,7,10,83,55,28,64
Peterhead,637,4,16,8,12,60,50,10,56
Brechin,637,5,15,6,15,48,53,-5,51
Albion,637,6,12,12,12,57,53,4,48
East Fife,637,7,12,11,13,48,50,-2,47
Queen's Park,637,8,11,9,16,43,52,-9,42
Stenhousem'r,637,9,6,10,20,34,75,-41,28
Stranraer,637,10,8,3,25,41,69,-28,27
Alloa,638,1,22,6,8,79,43,36,72
Livingston,638,2,23,2,11,78,46,32,71
Airdrieon,638,3,18,7,11,72,61,11,61
Brechin,638,4,17,4,15,55,59,-4,55
Albion,638,5,14,11,11,57,45,12,53
East Fife,638,6,12,10,14,57,50,7,46
Stranraer,638,7,13,5,18,61,67,-6,44
Peterhead,638,8,12,5,19,49,73,-24,41
Queen's Park,638,9,10,6,20,40,67,-27,36
Stenhousem'r,638,10,7,8,21,42,79,-37,29
Livingston,639,1,21,2,13,74,55,19,65
Alloa,639,2,20,5,11,66,48,18,65
Albion,639,3,16,10,10,63,43,20,58
Brechin,639,4,17,7,12,64,48,16,58
Airdrieon,639,5,16,9,11,60,52,8,57
Peterhead,639,6,15,6,15,47,54,-7,51
East Fife,639,7,12,10,14,48,51,-3,46
Stranraer,639,8,14,2,20,55,64,-9,44
Queen's Park,639,9,11,8,17,45,59,-14,41
Stenhousem'r,639,10,5,7,24,40,88,-48,22
Alloa,640,1,21,7,8,82,46,36,70
Airdrieon,640,2,19,7,10,63,51,12,64
Brechin,640,3,17,7,12,46,41,5,58
Livingston,640,4,17,6,13,82,55,27,57
East Fife,640,5,13,9,14,51,50,1,48
Albion,640,6,12,11,13,50,54,-4,47
Queen's Park,640,7,13,7,16,46,48,-2,46
Stenhousem'r,640,8,10,10,16,53,74,-21,40
Stranraer,640,9,10,8,18,43,64,-21,38
Peterhead,640,10,7,10,19,31,64,-33,31
Livingston,641,1,24,5,7,84,40,44,77
Airdrieon,641,2,18,6,12,59,54,5,60
Alloa,641,3,15,11,10,60,41,19,56
Brechin,641,4,16,7,13,54,45,9,55
Albion,641,5,13,8,15,54,62,-8,47
Queen's Park,641,6,14,5,17,39,56,-17,47
Peterhead,641,7,12,10,14,44,55,-11,46
Stranraer,641,8,12,6,18,58,70,-12,42
East Fife,641,9,9,10,17,54,59,-5,37
Stenhousem'r,641,10,8,10,18,49,73,-24,34
Brechin,642,1,22,2,12,70,48,22,68
Alloa,642,2,19,7,10,73,44,29,64
Livingston,642,3,20,4,12,81,53,28,64
Airdrieon,642,4,17,5,14,61,61,0,56
Albion,642,5,15,9,12,59,62,-3,54
Peterhead,642,6,15,8,13,58,53,5,53
Stranraer,642,7,15,5,16,56,65,-9,50
Queen's Park,642,8,14,5,17,37,55,-18,47
Stenhousem'r,642,9,7,8,21,44,79,-35,29
East Fife,642,10,5,9,22,37,56,-19,24
Livingston,643,1,20,6,10,83,56,27,66
Brechin,643,2,20,2,14,61,50,11,62
Albion,643,3,17,7,12,57,46,11,58
Alloa,643,4,15,10,11,74,57,17,55
Queen's Park,643,5,15,9,12,49,50,-1,54
Airdrieon,643,6,14,11,11,61,58,3,53
Peterhead,643,7,13,9,14,63,65,-2,48
Stranraer,643,8,13,5,18,55,61,-6,44
East Fife,643,9,10,8,18,47,61,-14,38
Stenhousem'r,643,10,7,5,24,44,90,-46,26
Alloa,644,1,19,8,9,67,39,28,65
Livingston,644,2,19,5,12,72,47,25,62
Brechin,644,3,16,8,12,46,41,5,56
East Fife,644,4,13,11,12,56,49,7,50
Peterhead,644,5,12,13,11,52,52,0,49
Airdrieon,644,6,12,12,12,56,63,-7,48
Albion,644,7,11,13,12,50,51,-1,46
Queen's Park,644,8,10,12,14,31,44,-13,42
Stranraer,644,9,10,10,16,48,60,-12,40
Stenhousem'r,644,10,7,10,19,44,76,-32,31
Alloa,645,1,22,5,9,73,44,29,71
Livingston,645,2,21,5,10,83,42,41,68
Brechin,645,3,18,5,13,56,52,4,59
Airdrieon,645,4,17,5,14,57,54,3,56
Queen's Park,645,5,17,4,15,49,52,-3,55
Peterhead,645,6,14,11,11,56,52,4,53
Albion,645,7,15,7,14,53,54,-1,52
Stranraer,645,8,12,5,19,53,63,-10,41
East Fife,645,9,10,7,19,55,68,-13,37
Stenhousem'r,645,10,4,6,26,38,92,-54,18
Livingston,646,1,24,1,11,83,49,34,73
Alloa,646,2,19,9,8,70,38,32,66
Peterhead,646,3,15,11,10,55,46,9,56
Queen's Park,646,4,15,5,16,44,47,-3,50
Brechin,646,5,12,11,13,39,43,-4,47
Stranraer,646,6,14,5,17,57,69,-12,47
Airdrieon,646,7,13,7,16,51,60,-9,46
East Fife,646,8,12,7,17,49,54,-5,43
Albion,646,9,12,7,17,51,60,-9,43
Stenhousem'r,646,10,9,7,20,52,85,-33,34
Alloa,647,1,19,12,5,69,40,29,69
Livingston,647,2,22,3,11,79,58,21,69
Brechin,647,3,16,9,11,53,47,6,57
Airdrieon,647,4,17,6,13,64,63,1,57
East Fife,647,5,11,11,14,48,45,3,44
Queen's Park,647,6,11,11,14,44,55,-11,44
Peterhead,647,7,12,7,17,52,51,1,43
Stranraer,647,8,12,7,17,49,55,-6,43
Albion,647,9,11,8,17,49,60,-11,41
Stenhousem'r,647,10,10,4,22,50,83,-33,34
Alloa,648,1,21,7,8,80,47,33,70
Brechin,648,2,18,6,12,50,46,4,60
Peterhead,648,3,16,10,10,53,48,5,58
Livingston,648,4,16,9,11,77,56,21,57
Albion,648,5,15,9,12,57,58,-1,54
Airdrieon,648,6,14,5,17,67,72,-5,47
Queen's Park,648,7,13,7,16,38,50,-12,46
Stranraer,648,8,13,5,18,56,66,-10,44
East Fife,648,9,10,10,16,48,51,-3,40
Stenhousem'r,648,10,6,8,22,51,83,-32,26
Livingston,649,1,22,1,13,79,58,21,67
Alloa,649,2,19,8,9,64,34,30,65
Airdrieon,649,3,17,9,10,57,52,5,60
Brechin,649,4,17,7,12,51,40,11,58
Albion,649,5,17,7,12,49,46,3,58
Queen's Park,649,6,13,6,17,36,50,-14,45
Peterhead,649,7,11,9,16,42,52,-10,42
East Fife,649,8,10,11,15,48,49,-1,41
Stenhousem'r,649,9,8,10,18,49,75,-26,34
Stranraer,649,10,8,8,20,42,61,-19,32
Livingston,650,1,21,4,11,73,50,23,67
Airdrieon,650,2,19,3,14,59,56,3,60
Brechin,650,3,18,3,15,55,49,6,57
Alloa,650,4,17,5,14,56,45,11,56
Stranraer,650,5,17,3,16,55,57,-2,54
Peterhead,650,6,15,8,13,48,49,-1,53
Queen's Park,650,7,14,7,15,42,46,-4,49
Albion,650,8,13,7,16,62,59,3,46
Stenhousem'r,650,9,10,9,17,53,78,-25,39
East Fife,650,10,8,7,21,49,63,-14,31
Livingston,651,1,19,5,12,73,56,17,62
Alloa,651,2,19,4,13,72,50,22,61
Albion,651,3,18,6,12,55,50,5,60
Queen's Park,651,4,15,9,12,51,46,5,54
Stranraer,651,5,15,7,14,55,51,4,52
Peterhead,651,6,15,7,14,56,56,0,52
Airdrieon,651,7,15,5,16,64,71,-7,50
East Fife,651,8,12,9,15,52,53,-1,45
Brechin,651,9,12,6,18,49,53,-4,42
Stenhousem'r,651,10,7,8,21,44,85,-41,29
Alloa,652,1,20,6,10,72,45,27,66
Livingston,652,2,20,5,11,78,48,30,65
Airdrieon,652,3,18,8,10,56,50,6,62
Brechin,652,4,16,8,12,45,45,0,56
Stranraer,652,5,16,5,15,52,53,-1,53
Queen's Park,652,6,15,8,13,37,42,-5,53
Albion,652,7,14,10,12,52,43,9,52
Peterhead,652,8,10,7,19,39,50,-11,37
East Fife,652,9,7,11,18,38,55,-17,32
Stenhousem'r,652,10,6,8,22,46,84,-38,26
Livingston,653,1,20,8,8,84,52,32,68
Albion,653,2,17,9,10,61,46,15,60
Alloa,653,3,17,8,11,72,49,23,59
Airdrieon,653,4,17,7,12,60,55,5,58
Brechin,653,5,16,6,14,52,59,-7,54
Peterhead,653,6,15,7,14,49,47,2,52
East Fife,653,7,11,8,17,56,54,2,41
Queen's Park,653,8,11,8,17,41,59,-18,41
Stranraer,653,9,11,7,18,50,67,-17,40
Stenhousem'r,653,10,6,10,20,45,82,-37,28
Livingston,654,1,23,5,8,84,47,37,74
Airdrieon,654,2,19,5,12,64,52,12,62
East Fife,654,3,14,9,13,48,42,6,51
Alloa,654,4,14,9,13,49,47,2,51
Brechin,654,5,14,8,14,53,52,1,50
Peterhead,654,6,14,8,14,48,53,-5,50
Stranraer,654,7,14,7,15,49,50,-1,49
Albion,654,8,11,9,16,48,55,-7,42
Queen's Park,654,9,11,7,18,36,52,-16,40
Stenhousem'r,654,10,8,9,19,42,71,-29,33
Livingston,655,1,24,3,9,76,43,33,75
Alloa,655,2,20,5,11,79,49,30,65
Airdrieon,655,3,16,8,12,57,59,-2,56
Peterhead,655,4,15,8,13,57,47,10,53
Albion,655,5,14,11,11,54,51,3,53
Brechin,655,6,16,5,15,53,53,0,53
Stranraer,655,7,15,4,17,59,65,-6,49
Queen's Park,655,8,12,4,20,35,61,-26,40
East Fife,655,9,10,8,18,44,52,-8,38
Stenhousem'r,655,10,6,8,22,42,76,-34,26
Alloa,656,1,20,6,10,67,40,27,66
Livingston,656,2,19,6,11,66,41,25,63
Airdrieon,656,3,18,8,10,49,37,12,62
Albion,656,4,17,7,12,52,41,11,58
Brechin,656,5,17,7,12,51,43,8,58
Peterhead,656,6,12,10,14,46,54,-8,46
Stranraer,656,7,12,4,20,42,65,-23,40
East Fife,656,8,10,9,17,41,44,-3,39
Queen's Park,656,9,10,7,19,31,55,-24,37
Stenhousem'r,656,10,8,10,18,46,71,-25,34
Livingston,657,1,24,2,10,77,48,29,74
Alloa,657,2,18,10,8,70,42,28,64
Brechin,657,3,18,6,12,55,43,12,60
Peterhead,657,4,15,9,12,52,48,4,54
Airdrieon,657,5,15,6,15,54,53,1,51
Stranraer,657,6,14,6,16,52,62,-10,48
Albion,657,7,13,6,17,56,54,2,45
Queen's Park,657,8,13,6,17,39,55,-16,45
East Fife,657,9,9,10,17,42,50,-8,37
Stenhousem'r,657,10,6,9,21,46,88,-42,27
Livingston,658,1,23,3,10,73,44,29,72
Alloa,658,2,17,10,9,70,50,20,61
Airdrieon,658,3,16,8,12,59,50,9,56
Brechin,658,4,15,11,10,49,45,4,56
Albion,658,5,11,14,11,52,52,0,47
Peterhead,658,6,10,12,14,41,51,-10,42
East Fife,658,7,9,12,15,52,53,-1,39
Queen's Park,658,8,8,15,13,35,50,-15,39
Stranraer,658,9,10,8,18,42,60,-18,38
Stenhousem'r,658,10,8,13,15,50,68,-18,37
Alloa,659,1,21,3,12,83,48,35,66
Brechin,659,2,19,6,11,51,42,9,63
Airdrieon,659,3,17,10,9,67,53,14,61
Albion,659,4,17,9,10,64,40,24,60
Livingston,659,5,16,4,16,63,59,4,52
Stranraer,659,6,12,9,15,52,55,-3,45
East Fife,659,7,12,7,17,41,48,-7,43
Peterhead,659,8,12,7,17,50,60,-10,43
Queen's Park,659,9,11,7,18,29,57,-28,40
Stenhousem'r,659,10,8,8,20,46,84,-38,32
Alloa,660,1,18,9,9,70,46,24,63
Livingston,660,2,19,5,12,84,57,27,62
Airdrieon,660,3,18,6,12,64,63,1,60
Peterhead,660,4,16,10,10,49,44,5,58
Brechin,660,5,15,10,11,64,49,15,55
Queen's Park,660,6,15,8,13,46,53,-7,53
Stranraer,660,7,12,9,15,54,60,-6,45
Albion,660,8,12,6,18,56,65,-9,42
Stenhousem'r,660,9,7,9,20,55,90,-35,30
East Fife,660,10,5,14,17,39,54,-15,29
Livingston,661,1,24,2,10,69,44,25,74
Albion,661,2,19,7,10,56,41,15,64
Alloa,661,3,16,11,9,67,38,29,59
Stranraer,661,4,14,9,13,54,54,0,51
Brechin,661,5,15,4,17,50,47,3,49
Peterhead,661,6,13,10,13,47,57,-10,49
Airdrieon,661,7,13,9,14,58,63,-5,48
Queen's Park,661,8,15,3,18,44,57,-13,48
East Fife,661,9,11,5,20,49,57,-8,38
Stenhousem'r,661,10,7,6,23,43,79,-36,27
Livingston,662,1,18,9,9,73,50,23,63
Brechin,662,2,19,4,13,47,37,10,61
Alloa,662,3,15,10,11,59,48,11,55
Airdrieon,662,4,15,8,13,63,68,-5,53
Albion,662,5,14,10,12,52,47,5,52
East Fife,662,6,13,9,14,54,49,5,48
Peterhead,662,7,13,9,14,53,49,4,48
Queen's Park,662,8,12,8,16,37,51,-14,44
Stranraer,662,9,12,3,21,50,69,-19,39
Stenhousem'r,662,10,11,6,19,56,76,-20,39
Livingston,663,1,23,5,8,87,45,42,74
Alloa,663,2,20,7,9,79,40,39,67
Airdrieon,663,3,20,3,13,58,53,5,63
Albion,663,4,17,7,12,67,53,14,58
Brechin,663,5,16,4,16,50,61,-11,52
Peterhead,663,6,13,8,15,53,53,0,47
East Fife,663,7,12,10,14,41,41,0,46
Stranraer,663,8,11,6,19,44,62,-18,39
Queen's Park,663,9,8,10,18,30,58,-28,34
Stenhousem'r,663,10,6,8,22,44,87,-43,26
Livingston,664,1,21,6,9,76,49,27,69
Alloa,664,2,20,7,9,77,39,38,67
Brechin,664,3,18,3,15,51,46,5,57
Albion,664,4,15,9,12,54,46,8,54
Airdrieon,664,5,15,9,12,59,59,0,54
Queen's Park,664,6,16,4,16,43,46,-3,52
Peterhead,664,7,14,7,15,53,54,-1,49
East Fife,664,8,9,10,17,45,51,-6,37
Stranraer,664,9,10,7,19,41,65,-24,37
Stenhousem'r,664,10,7,8,21,42,86,-44,29
Alloa,665,1,21,6,9,73,40,33,69
Airdrieon,665,2,20,8,8,61,50,11,68
Livingston,665,3,18,3,15,70,55,15,57
Brechin,665,4,16,6,14,55,57,-2,54
Albion,665,5,15,5,16,51,48,3,50
Peterhead,665,6,14,8,14,57,59,-2,50
Stranraer,665,7,13,6,17,54,60,-6,45
East Fife,665,8,12,8,16,50,50,0,44
Queen's Park,665,9,10,7,19,34,54,-20,37
Stenhousem'r,665,10,9,7,20,52,84,-32,34
Alloa,666,1,21,5,10,64,38,26,68
Livingston,666,2,21,5,10,71,46,25,68
Airdrieon,666,3,21,3,12,70,49,21,66
Queen's Park,666,4,15,7,14,41,46,-5,52
Albion,666,5,14,9,13,54,53,1,51
Brechin,666,6,15,5,16,46,47,-1,50
Stranraer,666,7,14,7,15,53,56,-3,49
East Fife,666,8,10,12,14,45,46,-1,42
Peterhead,666,9,11,7,18,50,67,-17,40
Stenhousem'r,666,10,5,6,25,36,82,-46,21
Livingston,667,1,22,7,7,74,38,36,73
Alloa,667,2,15,13,8,69,45,24,58
Stranraer,667,3,17,5,14,58,58,0,56
Peterhead,667,4,13,14,9,51,44,7,53
Brechin,667,5,15,7,14,51,52,-1,52
Airdrieon,667,6,15,7,14,59,62,-3,52
Albion,667,7,12,10,14,45,47,-2,46
Queen's Park,667,8,10,9,17,39,48,-9,39
East Fife,667,9,9,10,17,44,54,-10,37
Stenhousem'r,667,10,6,10,20,40,82,-42,28
Airdrieon,668,1,19,8,9,66,54,12,65
Albion,668,2,18,7,11,57,46,11,61
Alloa,668,3,18,6,12,70,51,19,60
Peterhead,668,4,18,6,12,55,47,8,60
Stranraer,668,5,16,5,15,62,66,-4,53
Brechin,668,6,14,10,12,55,50,5,52
Livingston,668,7,13,7,16,63,60,3,46
Queen's Park,668,8,11,7,18,34,50,-16,40
Stenhousem'r,668,9,8,11,17,47,72,-25,35
East Fife,668,10,8,7,21,40,53,-13,31
Livingston,669,1,21,6,9,71,47,24,69
Airdrieon,669,2,20,4,12,56,46,10,64
Alloa,669,3,17,7,12,66,50,16,58
Peterhead,669,4,16,8,12,56,50,6,56
Albion,669,5,14,12,10,57,44,13,54
Brechin,669,6,16,6,14,51,41,10,54
East Fife,669,7,12,8,16,44,52,-8,44
Stranraer,669,8,10,9,17,49,61,-12,39
Stenhousem'r,669,9,10,7,19,51,79,-28,37
Queen's Park,669,10,8,5,23,29,60,-31,29
Alloa,670,1,23,5,8,79,36,43,74
Livingston,670,2,21,5,10,71,46,25,68
Airdrieon,670,3,17,6,13,59,52,7,57
Brechin,670,4,14,10,12,49,51,-2,52
Albion,670,5,14,9,13,54,51,3,51
East Fife,670,6,13,9,14,48,44,4,48
Peterhead,670,7,12,7,17,51,66,-15,43
Stranraer,670,8,11,9,16,53,60,-7,42
Queen's Park,670,9,10,8,18,33,54,-21,38
Stenhousem'r,670,10,7,8,21,41,78,-37,29
Livingston,671,1,22,4,10,83,54,29,70
Alloa,671,2,19,8,9,70,42,28,65
Brechin,671,3,18,8,10,58,45,13,62
Stranraer,671,4,18,2,16,58,57,1,56
Queen's Park,671,5,13,9,14,34,48,-14,48
Peterhead,671,6,13,8,15,48,52,-4,47
Airdrieon,671,7,14,4,18,58,67,-9,46
Albion,671,8,12,6,18,46,46,0,42
East Fife,671,9,10,9,17,45,55,-10,39
Stenhousem'r,671,10,9,6,21,49,83,-34,33
Livingston,672,1,21,3,12,73,42,31,66
Peterhead,672,2,17,9,10,59,42,17,60
Alloa,672,3,17,8,11,65,46,19,59
Brechin,672,4,18,4,14,48,45,3,58
Albion,672,5,15,10,11,55,43,12,55
Airdrieon,672,6,16,5,15,54,58,-4,53
Stranraer,672,7,13,5,18,46,56,-10,44
Queen's Park,672,8,12,8,16,34,49,-15,44
East Fife,672,9,9,7,20,42,65,-23,34
Stenhousem'r,672,10,8,9,19,44,74,-30,33
Livingston,673,1,24,2,10,73,44,29,74
Alloa,673,2,21,5,10,67,44,23,68
Airdrieon,673,3,16,6,14,61,61,0,54
Albion,673,4,15,8,13,51,46,5,53
Brechin,673,5,14,6,16,43,52,-9,48
Queen's Park,673,6,13,6,17,51,52,-1,45
Stenhousem'r,673,7,12,8,16,48,72,-24,44
East Fife,673,8,11,10,15,46,45,1,43
Stranraer,673,9,12,6,18,53,55,-2,42
Peterhead,673,10,9,9,18,43,65,-22,36
Alloa,674,1,19,9,8,81,47,34,66
Livingston,674,2,18,6,12,67,48,19,60
Airdrieon,674,3,18,6,12,64,54,10,60
Brechin,674,4,17,5,14,54,56,-2,56
Albion,674,5,16,7,13,50,55,-5,55
Queen's Park,674,6,14,9,13,42,54,-12,51
Stranraer,674,7,15,5,16,63,62,1,50
Peterhead,674,8,13,7,16,46,49,-3,46
East Fife,674,9,9,11,16,41,46,-5,38
Stenhousem'r,674,10,5,7,24,43,80,-37,22
Brechin,675,1,19,5,12,55,49,6,62
Queen's Park,675,2,18,7,11,50,41,9,61
Livingston,675,3,19,2,15,68,57,11,59
Alloa,675,4,17,4,15,61,47,14,55
Albion,675,5,15,7,14,54,48,6,52
Airdrieon,675,6,14,10,12,55,55,0,52
East Fife,675,7,13,9,14,49,46,3,48
Peterhead,675,8,13,7,16,44,57,-13,46
Stranraer,675,9,13,6,17,57,63,-6,45
Stenhousem'r,675,10,7,7,22,51,81,-30,28
Airdrieon,676,1,20,6,10,68,57,11,66
Alloa,676,2,17,10,9,75,47,28,61
Livingston,676,3,18,5,13,69,58,11,59
Peterhead,676,4,17,7,12,62,51,11,58
Brechin,676,5,15,11,10,54,49,5,56
Queen's Park,676,6,12,10,14,39,48,-9,46
Albion,676,7,13,7,16,46,57,-11,46
East Fife,676,8,10,11,15,48,46,2,41
Stranraer,676,9,11,6,19,42,55,-13,39
Stenhousem'r,676,10,6,9,21,49,84,-35,27
Livingston,677,1,21,4,11,92,46,46,67
Alloa,677,2,19,8,9,75,41,34,65
Brechin,677,3,18,6,12,54,52,2,60
Peterhead,677,4,16,6,14,59,52,7,54
Airdrieon,677,5,16,6,14,56,58,-2,54
Albion,677,6,12,11,13,56,58,-2,47
Stranraer,677,7,15,1,20,55,75,-20,46
East Fife,677,8,12,7,17,45,59,-14,43
Queen's Park,677,9,11,7,18,32,55,-23,40
Stenhousem'r,677,10,9,6,21,47,75,-28,33
Livingston,678,1,22,4,10,74,47,27,70
Brechin,678,2,20,3,13,59,51,8,63
Peterhead,678,3,19,4,13,64,48,16,61
Alloa,678,4,17,7,12,67,52,15,58
Albion,678,5,15,7,14,50,61,-11,52
Stranraer,678,6,14,6,16,49,48,1,48
East Fife,678,7,13,6,17,49,49,0,45
Airdrieon,678,8,13,6,17,56,63,-7,45
Queen's Park,678,9,12,7,17,37,48,-11,43
Stenhousem'r,678,10,8,4,24,39,77,-38,28
Alloa,679,1,20,4,12,73,45,28,64
Airdrieon,679,2,17,6,13,63,57,6,57
Livingston,679,3,17,5,14,72,49,23,56
Queen's Park,679,4,17,5,14,47,51,-4,56
Brechin,679,5,17,4,15,53,54,-1,55
Albion,679,6,16,5,15,54,53,1,53
Peterhead,679,7,14,8,14,49,56,-7,50
East Fife,679,8,12,8,16,53,57,-4,44
Stranraer,679,9,13,3,20,57,67,-10,42
Stenhousem'r,679,10,10,6,20,49,81,-32,36
Albion,680,1,20,8,8,63,40,23,68
Livingston,680,2,19,7,10,74,50,24,64
Alloa,680,3,17,9,10,73,47,26,60
Brechin,680,4,14,12,10,43,41,2,54
Airdrieon,680,5,13,9,14,55,57,-2,48
Queen's Park,680,6,13,8,15,37,52,-15,47
Stranraer,680,7,13,7,16,54,61,-7,46
East Fife,680,8,12,9,15,52,48,4,45
Peterhead,680,9,9,10,17,43,57,-14,37
Stenhousem'r,680,10,4,13,19,44,85,-41,25
Alloa,681,1,19,7,10,61,41,20,64
Livingston,681,2,20,4,12,75,56,19,64
Airdrieon,681,3,18,5,13,57,50,7,59
Albion,681,4,17,6,13,54,48,6,57
East Fife,681,5,16,8,12,48,38,10,56
Peterhead,681,6,15,8,13,49,45,4,53
Brechin,681,7,15,6,15,49,49,0,51
Stranraer,681,8,13,3,20,45,62,-17,42
Queen's Park,681,9,10,5,21,27,51,-24,35
Stenhousem'r,681,10,8,6,22,42,67,-25,30
Albion,682,1,19,8,9,64,48,16,65
Livingston,682,2,20,4,12,75,46,29,64
Brechin,682,3,18,5,13,49,51,-2,59
Alloa,682,4,16,9,11,65,40,25,57
Airdrieon,682,5,16,9,11,67,61,6,57
Peterhead,682,6,13,8,15,47,60,-13,47
East Fife,682,7,11,9,16,52,49,3,42
Stranraer,682,8,12,4,20,48,64,-16,40
Queen's Park,682,9,10,7,19,30,53,-23,37
Stenhousem'r,682,10,9,9,18,49,74,-25,36
Livingston,683,1,21,4,11,74,51,23,67
Alloa,683,2,18,8,10,65,46,19,62
Brechin,683,3,18,5,13,56,45,11,59
Airdrieon,683,4,17,6,13,54,56,-2,57
Queen's Park,683,5,16,8,12,54,48,6,56
Stranraer,683,6,15,6,15,62,58,4,51
Peterhead,683,7,12,9,15,48,55,-7,45
Albion,683,8,11,8,17,57,67,-10,41
East Fife,683,9,8,13,15,56,57,-1,37
Stenhousem'r,683,10,7,7,22,38,81,-43,28
Livingston,684,1,22,4,10,77,44,33,70
Alloa,684,2,19,7,10,69,40,29,64
Brechin,684,3,19,3,14,51,45,6,60
Airdrieon,684,4,19,3,14,58,57,1,60
Albion,684,5,14,8,14,51,48,3,50
Peterhead,684,6,13,7,16,47,55,-8,46
Queen's Park,684,7,13,6,17,41,59,-18,45
East Fife,684,8,9,12,15,45,56,-11,39
Stenhousem'r,684,9,11,6,19,49,71,-22,39
Stranraer,684,10,11,4,21,55,68,-13,37
Livingston,685,1,18,11,7,68,41,27,65
Brechin,685,2,17,7,12,52,48,4,58
Alloa,685,3,15,10,11,65,47,18,55
Peterhead,685,4,14,10,12,59,54,5,52
Albion,685,5,14,9,13,64,53,11,51
Queen's Park,685,6,14,9,13,46,49,-3,51
Airdrieon,685,7,15,6,15,54,61,-7,51
Stranraer,685,8,14,7,15,57,61,-4,49
Stenhousem'r,685,9,8,10,18,41,71,-30,34
East Fife,685,10,6,11,19,42,63,-21,29
Livingston,686,1,20,5,11,65,39,26,65
Alloa,686,2,19,5,12,76,43,33,62
Airdrieon,686,3,19,3,14,54,52,2,60
East Fife,686,4,17,8,11,53,40,13,59
Peterhead,686,5,16,7,13,54,47,7,55
Brechin,686,6,15,7,14,44,48,-4,52
Albion,686,7,13,10,13,47,49,-2,49
Queen's Park,686,8,11,7,18,32,51,-19,40
Stranraer,686,9,10,8,18,48,58,-10,38
Stenhousem'r,686,10,6,8,22,35,81,-46,26
Alloa,687,1,23,5,8,75,40,35,74
Livingston,687,2,22,3,11,76,45,31,69
Airdrieon,687,3,16,8,12,66,50,16,56
Brechin,687,4,15,7,14,48,50,-2,52
Albion,687,5,14,8,14,47,50,-3,50
Peterhead,687,6,12,9,15,48,57,-9,45
Queen's Park,687,7,13,3,20,39,56,-17,42
Stranraer,687,8,11,8,17,49,60,-11,41
East Fife,687,9,10,10,16,49,56,-7,40
Stenhousem'r,687,10,10,7,19,45,78,-33,37
Alloa,688,1,19,8,9,73,44,29,65
Brechin,688,2,20,3,13,64,45,19,63
Livingston,688,3,17,8,11,67,48,19,59
Albion,688,4,15,7,14,53,53,0,52
Airdrieon,688,5,13,10,13,43,51,-8,49
Stranraer,688,6,14,4,18,55,58,-3,46
Queen's Park,688,7,10,13,13,35,48,-13,43
Peterhead,688,8,10,12,14,46,57,-11,42
East Fife,688,9,9,12,15,40,48,-8,39
Stenhousem'r,688,10,10,9,17,48,72,-24,39
Brechin,689,1,23,3,10,54,33,21,72
Livingston,689,2,22,5,9,73,40,33,71
Alloa,689,3,17,7,12,67,46,21,58
Airdrieon,689,4,15,8,13,60,64,-4,53
Peterhead,689,5,13,12,11,49,49,0,51
Albion,689,6,12,11,13,54,55,-1,47
East Fife,689,7,11,9,16,53,55,-2,42
Queen's Park,689,8,10,10,16,35,53,-18,40
Stenhousem'r,689,9,10,5,21,46,74,-28,35
Stranraer,689,10,8,8,20,43,65,-22,32
Brechin,690,1,21,5,10,55,41,14,68
Livingston,690,2,20,6,10,64,43,21,66
Alloa,690,3,18,10,8,64,40,24,64
Queen's Park,690,4,13,11,12,38,49,-11,50
Airdrieon,690,5,15,4,17,57,56,1,49
Stranraer,690,6,13,6,17,47,54,-7,45
East Fife,690,7,10,13,13,49,47,2,43
Peterhead,690,8,10,13,13,42,51,-9,43
Albion,690,9,10,10,16,42,48,-6,40
Stenhousem'r,690,10,6,10,20,40,69,-29,28
Alloa,691,1,20,9,7,74,43,31,69
Livingston,691,2,21,5,10,86,51,35,68
Albion,691,3,15,8,13,53,53,0,53
Brechin,691,4,14,11,11,46,48,-2,53
Peterhead,691,5,15,5,16,51,57,-6,50
East Fife,691,6,13,8,15,61,52,9,47
Queen's Park,691,7,13,8,15,43,49,-6,47
Airdrieon,691,8,13,7,16,46,58,-12,46
Stranraer,691,9,13,4,19,49,59,-10,43
Stenhousem'r,691,10,7,7,22,36,75,-39,28
Airdrieon,692,1,21,6,9,65,50,15,69
Livingston,692,2,21,5,10,83,47,36,68
Alloa,692,3,17,9,10,72,49,23,60
East Fife,692,4,15,9,12,56,44,12,54
Albion,692,5,13,9,14,60,56,4,48
Brechin,692,6,13,6,17,44,50,-6,45
Stranraer,692,7,13,6,17,49,71,-22,45
Peterhead,692,8,11,11,14,45,54,-9,44
Queen's Park,692,9,10,9,17,37,57,-20,39
Stenhousem'r,692,10,6,10,20,44,77,-33,28
Livingston,693,1,22,5,9,85,49,36,71
Albion,693,2,20,7,9,75,49,26,67
Brechin,693,3,18,5,13,53,45,8,59
Alloa,693,4,15,10,11,64,54,10,55
Airdrieon,693,5,15,6,15,60,64,-4,51
Stranraer,693,6,14,7,15,56,54,2,49
East Fife,693,7,13,8,15,53,47,6,47
Peterhead,693,8,14,4,18,45,63,-18,46
Queen's Park,693,9,9,8,19,36,58,-22,35
Stenhousem'r,693,10,7,6,23,46,90,-44,27
Airdrieon,694,1,22,4,10,66,51,15,70
Alloa,694,2,20,8,8,74,49,25,68
Brechin,694,3,19,3,14,59,45,14,60
Livingston,694,4,18,3,15,69,56,13,57
Albion,694,5,15,7,14,53,56,-3,52
Peterhead,694,6,13,8,15,51,58,-7,47
East Fife,694,7,12,8,16,54,52,2,44
Stranraer,694,8,12,6,18,53,58,-5,42
Queen's Park,694,9,11,6,19,35,57,-22,39
Stenhousem'r,694,10,7,9,20,57,89,-32,30
Livingston,695,1,21,3,12,80,49,31,66
Brechin,695,2,19,8,9,58,46,12,65
Alloa,695,3,18,9,9,72,43,29,63
Airdrieon,695,4,18,6,12,69,53,16,60
Albion,695,5,13,8,15,57,65,-8,47
East Fife,695,6,12,10,14,42,45,-3,46
Stranraer,695,7,13,7,16,52,58,-6,46
Peterhead,695,8,12,8,16,48,56,-8,44
Queen's Park,695,9,11,8,17,35,52,-17,41
Stenhousem'r,695,10,6,7,23,39,85,-46,25
Livingston,696,1,23,5,8,68,39,29,74
Alloa,696,2,18,8,10,66,43,23,62
Airdrieon,696,3,16,8,12,50,48,2,56
Albion,696,4,14,10,12,52,45,7,52
Brechin,696,5,15,5,16,47,53,-6,50
Peterhead,696,6,13,10,13,53,51,2,49
Queen's Park,696,7,12,8,16,33,45,-12,44
East Fife,696,8,10,10,16,40,50,-10,40
Stenhousem'r,696,9,9,10,17,47,68,-21,37
Stranraer,696,10,10,6,20,45,59,-14,36
Airdrieon,697,1,22,5,9,76,58,18,71
Livingston,697,2,20,4,12,82,58,24,64
Alloa,697,3,17,9,10,62,44,18,60
Stranraer,697,4,16,6,14,64,55,9,54
Brechin,697,5,14,10,12,52,56,-4,52
Albion,697,6,14,9,13,62,52,10,51
East Fife,697,7,14,7,15,57,49,8,49
Peterhead,697,8,14,5,17,47,54,-7,47
Queen's Park,697,9,9,7,20,34,58,-24,34
Stenhousem'r,697,10,6,6,24,44,96,-52,24
Alloa,698,1,18,10,8,71,42,29,64
Livingston,698,2,19,3,14,69,48,21,60
Brechin,698,3,16,12,8,55,43,12,60
Albion,698,4,14,7,15,51,48,3,49
Airdrieon,698,5,14,7,15,55,55,0,49
Queen's Park,698,6,13,9,14,37,46,-9,48
East Fife,698,7,13,8,15,55,57,-2,47
Peterhead,698,8,13,6,17,54,63,-9,45
Stranraer,698,9,12,7,17,48,61,-13,43
Stenhousem'r,698,10,10,7,19,47,79,-32,37
Livingston,699,1,23,3,10,80,44,36,72
Alloa,699,2,19,8,9,69,43,26,65
Brechin,699,3,19,5,12,59,55,4,62
Albion,699,4,15,8,13,52,43,9,53
Queen's Park,699,5,15,6,15,40,50,-10,51
Peterhead,699,6,14,8,14,45,47,-2,50
Stranraer,699,7,14,6,16,54,62,-8,48
Airdrieon,699,8,12,5,19,45,64,-19,41
East Fife,699,9,9,9,18,45,51,-6,36
Stenhousem'r,699,10,8,6,22,46,76,-30,30
Livingston,700,1,23,5,8,78,46,32,74
Alloa,700,2,20,8,8,75,41,34,68
Brechin,700,3,20,4,12,69,53,16,64
Airdrieon,700,4,16,8,12,56,60,-4,56
East Fife,700,5,12,14,10,53,43,10,50
Peterhead,700,6,9,13,14,48,57,-9,40
Queen's Park,700,7,10,8,18,38,66,-28,38
Albion,700,8,9,10,17,44,51,-7,37
Stranraer,700,9,10,6,20,56,74,-18,36
Stenhousem'r,700,10,8,10,18,52,78,-26,34
Alloa,701,1,19,11,6,74,42,32,68
Livingston,701,2,20,4,12,75,53,22,64
Brechin,701,3,18,6,12,59,48,11,60
Airdrieon,701,4,16,4,16,62,63,-1,52
Albion,701,5,15,5,16,56,57,-1,50
Stranraer,701,6,13,9,14,56,54,2,48
Queen's Park,701,7,14,6,16,40,58,-18,48
East Fife,701,8,13,7,16,50,55,-5,46
Peterhead,701,9,12,9,15,49,53,-4,45
Stenhousem'r,701,10,7,5,24,43,81,-38,26
Livingston,702,1,20,6,10,71,46,25,66
Brechin,702,2,18,6,12,56,43,13,60
Alloa,702,3,17,8,11,69,52,17,59
Peterhead,702,4,17,7,12,55,48,7,58
East Fife,702,5,16,5,15,57,47,10,53
Albion,702,6,15,6,15,52,49,3,51
Airdrieon,702,7,13,8,15,47,59,-12,47
Stranraer,702,8,11,9,16,45,55,-10,42
Queen's Park,702,9,10,7,19,38,56,-18,37
Stenhousem'r,702,10,8,8,20,51,86,-35,32
Livingston,703,1,22,6,8,89,46,43,72
Alloa,703,2,20,5,11,74,49,25,65
Airdrieon,703,3,19,6,11,62,48,14,63
Brechin,703,4,19,5,12,52,40,12,62
East Fife,703,5,11,13,12,49,49,0,46
Peterhead,703,6,13,7,16,50,61,-11,46
Queen's Park,703,7,13,4,19,40,56,-16,43
Stranraer,703,8,11,8,17,49,61,-12,41
Albion,703,9,10,8,18,44,67,-23,38
Stenhousem'r,703,10,7,8,21,51,83,-32,29
Livingston,704,1,21,7,8,73,43,30,70
Albion,704,2,18,9,9,56,42,14,63
Alloa,704,3,18,7,11,69,48,21,61
Brechin,704,4,18,5,13,55,50,5,59
Peterhead,704,5,14,6,16,42,53,-11,48
Airdrieon,704,6,12,10,14,50,49,1,46
East Fife,704,7,11,9,16,50,50,0,42
Queen's Park,704,8,11,9,16,26,43,-17,42
Stranraer,704,9,12,5,19,50,59,-9,41
Stenhousem'r,704,10,8,7,21,40,74,-34,31
Livingston,705,1,24,4,8,78,44,34,76
Brechin,705,2,17,6,13,51,52,-1,57
Alloa,705,3,15,10,11,65,46,19,55
Peterhead,705,4,14,9,13,55,50,5,51
East Fife,705,5,14,7,15,56,47,9,49
Albion,705,6,13,8,15,53,60,-7,47
Stranraer,705,7,13,7,16,50,53,-3,46
Airdrieon,705,8,10,14,12,50,56,-6,44
Queen's Park,705,9,12,6,18,35,53,-18,42
Stenhousem'r,705,10,6,13,17,38,70,-32,31
Livingston,706,1,25,3,8,82,38,44,78
Alloa,706,2,21,8,7,71,39,32,71
Albion,706,3,16,8,12,62,53,9,56
East Fife,706,4,14,10,12,49,48,1,52
Airdrieon,706,5,15,6,15,52,55,-3,51
Peterhead,706,6,15,5,16,48,57,-9,50
Brechin,706,7,13,8,15,42,49,-7,47
Stranraer,706,8,11,10,15,51,52,-1,43
Queen's Park,706,9,9,5,22,31,61,-30,32
Stenhousem'r,706,10,5,9,22,47,83,-36,24
Livingston,707,1,21,5,10,84,41,43,68
East Fife,707,2,18,7,11,66,43,23,61
Alloa,707,3,15,13,8,68,44,24,58
Peterhead,707,4,15,9,12,56,51,5,54
Airdrieon,707,5,15,7,14,56,60,-4,52
Brechin,707,6,14,6,16,45,52,-7,48
Stranraer,707,7,13,5,18,53,63,-10,44
Albion,707,8,12,6,18,46,65,-19,42
Stenhousem'r,707,9,11,7,18,44,72,-28,40
Queen's Park,707,10,10,7,19,33,60,-27,37
Airdrieon,708,1,20,8,8,69,52,17,68
Livingston,708,2,19,6,11,71,50,21,63
Alloa,708,3,18,8,10,78,53,25,62
Brechin,708,4,20,2,14,59,59,0,62
Albion,708,5,14,6,16,66,60,6,48
Peterhead,708,6,14,5,17,43,55,-12,47
East Fife,708,7,12,10,14,50,48,2,46
Stranraer,708,8,11,6,19,46,62,-16,39
Stenhousem'r,708,9,10,9,17,48,71,-23,39
Queen's Park,708,10,9,6,21,42,62,-20,33
Alloa,709,1,24,5,7,71,34,37,77
Livingston,709,2,20,4,12,74,53,21,64
Airdrieon,709,3,18,4,14,61,58,3,58
Brechin,709,4,13,10,13,45,49,-4,49
Queen's Park,709,5,14,6,16,46,58,-12,48
East Fife,709,6,12,10,14,50,45,5,46
Albion,709,7,12,10,14,54,54,0,46
Stranraer,709,8,11,8,17,54,64,-10,41
Peterhead,709,9,11,8,17,41,56,-15,41
Stenhousem'r,709,10,7,11,18,42,67,-25,32
Livingston,710,1,19,6,11,76,44,32,63
Alloa,710,2,16,14,6,66,39,27,62
Albion,710,3,16,11,9,58,44,14,59
Peterhead,710,4,18,4,14,48,45,3,58
Airdrieon,710,5,15,9,12,57,56,1,54
Brechin,710,6,13,8,15,46,54,-8,47
Stranraer,710,7,11,11,14,45,60,-15,44
Queen's Park,710,8,12,7,17,41,51,-10,43
East Fife,710,9,8,10,18,42,52,-10,34
Stenhousem'r,710,10,8,8,20,38,72,-34,32
Livingston,711,1,22,2,12,80,47,33,68
Peterhead,711,2,18,7,11,51,41,10,61
Alloa,711,3,17,9,10,67,47,20,60
Airdrieon,711,4,17,9,10,54,51,3,60
Brechin,711,5,14,11,11,45,38,7,53
East Fife,711,6,13,10,13,40,40,0,49
Queen's Park,711,7,12,9,15,39,50,-11,45
Albion,711,8,11,9,16,43,52,-9,42
Stranraer,711,9,9,7,20,43,60,-17,34
Stenhousem'r,711,10,6,9,21,47,83,-36,27
Airdrieon,712,1,19,6,11,63,56,7,63
Alloa,712,2,17,10,9,69,41,28,61
Livingston,712,3,19,4,13,65,45,20,61
Albion,712,4,14,12,10,57,48,9,54
Brechin,712,5,14,9,13,46,47,-1,51
East Fife,712,6,13,10,13,51,43,8,49
Peterhead,712,7,14,6,16,50,62,-12,48
Queen's Park,712,8,13,6,17,35,50,-15,45
Stranraer,712,9,11,6,19,44,64,-20,39
Stenhousem'r,712,10,7,9,20,54,78,-24,30
Livingston,713,1,21,5,10,78,51,27,68
Alloa,713,2,18,4,14,72,54,18,58
Albion,713,3,17,7,12,54,45,9,58
Airdrieon,713,4,17,5,14,54,49,5,56
East Fife,713,5,15,8,13,56,45,11,53
Brechin,713,6,15,7,14,48,50,-2,52
Peterhead,713,7,12,11,13,47,54,-7,47
Stranraer,713,8,10,8,18,46,65,-19,38
Stenhousem'r,713,9,9,10,17,57,81,-24,37
Queen's Park,713,10,9,9,18,30,48,-18,36
Alloa,714,1,22,7,7,81,46,35,73
Livingston,714,2,22,5,9,86,53,33,71
Airdrieon,714,3,17,7,12,57,52,5,58
Brechin,714,4,17,5,14,63,57,6,56
Stranraer,714,5,16,5,15,59,63,-4,53
Queen's Park,714,6,12,4,20,33,51,-18,40
East Fife,714,7,10,9,17,47,53,-6,39
Peterhead,714,8,9,12,15,36,50,-14,39
Stenhousem'r,714,9,11,6,19,52,78,-26,39
Albion,714,10,10,8,18,51,62,-11,38
Livingston,715,1,25,4,7,84,44,40,79
Alloa,715,2,18,9,9,69,41,28,63
Albion,715,3,14,10,12,52,43,9,52
Airdrieon,715,4,13,12,11,56,57,-1,51
Brechin,715,5,16,2,18,51,64,-13,50
Stranraer,715,6,13,7,16,50,55,-5,46
Peterhead,715,7,12,9,15,44,52,-8,45
Queen's Park,715,8,10,12,14,32,46,-14,42
East Fife,715,9,9,11,16,45,57,-12,38
Stenhousem'r,715,10,9,6,21,45,69,-24,33
Livingston,716,1,22,5,9,83,47,36,71
Alloa,716,2,16,11,9,64,38,26,59
Brechin,716,3,18,4,14,53,49,4,58
Airdrieon,716,4,17,6,13,58,51,7,57
Queen's Park,716,5,14,8,14,39,43,-4,50
East Fife,716,6,14,7,15,53,48,5,49
Albion,716,7,12,8,16,51,58,-7,44
Stenhousem'r,716,8,12,6,18,55,83,-28,42
Stranraer,716,9,9,9,18,42,57,-15,36
Peterhead,716,10,8,12,16,45,69,-24,36
Livingston,717,1,21,1,14,83,52,31,64
Airdrieon,717,2,19,6,11,57,49,8,63
Alloa,717,3,18,5,13,72,49,23,59
Brechin,717,4,17,6,13,47,42,5,57
Peterhead,717,5,15,11,10,46,48,-2,56
Queen's Park,717,6,15,7,14,48,46,2,52
Stranraer,717,7,14,4,18,66,72,-6,46
East Fife,717,8,11,9,16,42,47,-5,42
Albion,717,9,10,9,17,41,56,-15,39
Stenhousem'r,717,10,6,10,20,39,80,-41,28
Airdrieon,718,1,26,2,8,81,50,31,80
Livingston,718,2,20,4,12,80,48,32,64
Alloa,718,3,18,8,10,73,50,23,62
Brechin,718,4,17,4,15,57,55,2,55
Albion,718,5,14,10,12,51,50,1,52
East Fife,718,6,12,10,14,47,42,5,46
Stranraer,718,7,12,8,16,56,64,-8,44
Peterhead,718,8,12,5,19,41,63,-22,41
Queen's Park,718,9,9,10,17,34,59,-25,37
Stenhousem'r,718,10,5,9,22,43,82,-39,24
Livingston,719,1,23,4,9,85,45,40,73
Albion,719,2,17,8,11,63,52,11,59
Alloa,719,3,16,10,10,67,49,18,58
Brechin,719,4,14,9,13,46,50,-4,51
Airdrieon,719,5,14,8,14,56,63,-7,50
Peterhead,719,6,14,6,16,49,55,-6,48
Stranraer,719,7,14,5,17,50,56,-6,47
East Fife,719,8,10,10,16,53,56,-3,40
Queen's Park,719,9,10,9,17,41,58,-17,39
Stenhousem'r,719,10,10,7,19,54,80,-26,37
Livingston,720,1,20,9,7,75,44,31,69
Airdrieon,720,2,20,5,11,59,47,12,65
Alloa,720,3,15,13,8,60,43,17,58
Peterhead,720,4,16,8,12,62,56,6,56
Brechin,720,5,16,8,12,49,43,6,56
East Fife,720,6,13,7,16,51,48,3,46
Queen's Park,720,7,11,8,17,37,50,-13,41
Albion,720,8,9,11,16,43,49,-6,38
Stenhousem'r,720,9,8,12,16,46,70,-24,36
Stranraer,720,10,9,5,22,44,76,-32,32
Alloa,721,1,18,8,10,69,47,22,62
Brechin,721,2,18,7,11,52,41,11,61
Airdrieon,721,3,18,7,11,53,47,6,61
Albion,721,4,18,6,12,52,42,10,60
Livingston,721,5,17,4,15,65,52,13,55
Peterhead,721,6,14,7,15,55,53,2,49
Stranraer,721,7,14,2,20,41,60,-19,44
Queen's Park,721,8,11,9,16,39,50,-11,42
East Fife,721,9,11,8,17,55,56,-1,41
Stenhousem'r,721,10,8,8,20,41,74,-33,32
Livingston,722,1,23,4,9,97,52,45,73
Brechin,722,2,19,6,11,60,52,8,63
East Fife,722,3,18,7,11,65,46,19,61
Alloa,722,4,15,9,12,69,48,21,54
Airdrieon,722,5,15,9,12,65,51,14,54
Queen's Park,722,6,14,8,14,43,52,-9,50
Albion,722,7,11,10,15,57,59,-2,43
Peterhead,722,8,11,7,18,39,62,-23,40
Stranraer,722,9,9,8,19,45,68,-23,35
Stenhousem'r,722,10,7,8,21,51,101,-50,29
Brechin,723,1,23,2,11,62,46,16,71
Airdrieon,723,2,21,2,13,68,57,11,65
Livingston,723,3,20,4,12,74,53,21,64
Alloa,723,4,18,6,12,68,47,21,60
Stranraer,723,5,17,5,14,58,55,3,56
Albion,723,6,14,10,12,65,56,9,52
East Fife,723,7,10,11,15,50,50,0,41
Peterhead,723,8,10,8,18,45,59,-14,38
Queen's Park,723,9,9,5,22,33,66,-33,32
Stenhousem'r,723,10,8,7,21,46,80,-34,31
Livingston,724,1,22,3,11,74,44,30,69
Alloa,724,2,20,7,9,77,45,32,67
Airdrieon,724,3,19,5,12,57,51,6,62
Brechin,724,4,19,2,15,54,53,1,59
Queen's Park,724,5,15,5,16,44,50,-6,50
Albion,724,6,13,8,15,52,52,0,47
East Fife,724,7,13,6,17,46,51,-5,45
Peterhead,724,8,12,7,17,43,52,-9,43
Stranraer,724,9,12,4,20,45,58,-13,40
Stenhousem'r,724,10,8,7,21,46,82,-36,31
Airdrieon,725,1,19,7,10,57,42,15,64
Alloa,725,2,17,9,10,60,44,16,60
Peterhead,725,3,18,5,13,48,48,0,59
Albion,725,4,16,8,12,53,49,4,56
Livingston,725,5,15,8,13,68,49,19,53
Brechin,725,6,15,5,16,48,60,-12,50
Stranraer,725,7,11,9,16,54,55,-1,42
Queen's Park,725,8,12,6,18,42,53,-11,42
East Fife,725,9,9,11,16,47,53,-6,38
Stenhousem'r,725,10,10,8,18,46,70,-24,38
Livingston,726,1,24,5,7,79,36,43,77
Airdrieon,726,2,21,4,11,63,51,12,67
Albion,726,3,16,9,11,52,46,6,57
Alloa,726,4,15,11,10,70,50,20,56
Peterhead,726,5,14,10,12,52,43,9,52
Brechin,726,6,14,5,17,46,56,-10,47
East Fife,726,7,12,9,15,47,49,-2,45
Queen's Park,726,8,12,8,16,37,49,-12,44
Stranraer,726,9,9,6,21,46,64,-18,33
Stenhousem'r,726,10,6,7,23,42,90,-48,25
Livingston,727,1,22,4,10,80,42,38,70
Airdrieon,727,2,20,4,12,66,49,17,64
Albion,727,3,19,6,11,62,43,19,63
Brechin,727,4,20,3,13,61,56,5,63
Alloa,727,5,16,7,13,54,41,13,55
Stranraer,727,6,13,6,17,62,64,-2,45
Peterhead,727,7,13,6,17,46,57,-11,45
Queen's Park,727,8,10,8,18,36,64,-28,38
East Fife,727,9,9,8,19,41,58,-17,35
Stenhousem'r,727,10,9,6,21,48,82,-34,33
Alloa,728,1,21,7,8,74,48,26,70
Livingston,728,2,17,8,11,70,53,17,59
East Fife,728,3,16,6,14,50,39,11,54
Airdrieon,728,4,15,9,12,56,59,-3,54
Brechin,728,5,14,10,12,47,44,3,52
Queen's Park,728,6,14,5,17,43,54,-11,47
Albion,728,7,12,10,14,55,55,0,46
Peterhead,728,8,12,7,17,47,56,-9,43
Stenhousem'r,728,9,11,6,19,55,76,-21,39
Stranraer,728,10,10,8,18,48,61,-13,38
Livingston,729,1,23,4,9,78,45,33,73
Alloa,729,2,21,7,8,77,46,31,70
Brechin,729,3,17,8,11,51,46,5,59
Airdrieon,729,4,16,6,14,57,56,1,54
Albion,729,5,13,8,15,56,63,-7,47
Stranraer,729,6,13,6,17,53,64,-11,45
East Fife,729,7,11,10,15,59,59,0,43
Peterhead,729,8,11,10,15,55,62,-7,43
Queen's Park,729,9,11,7,18,40,53,-13,40
Stenhousem'r,729,10,7,8,21,44,76,-32,29
Livingston,730,1,25,5,6,88,39,49,80
Alloa,730,2,21,7,8,72,39,33,70
Brechin,730,3,17,5,14,51,49,2,56
Airdrieon,730,4,15,6,15,49,56,-7,51
Queen's Park,730,5,13,10,13,41,49,-8,49
Albion,730,6,13,8,15,57,56,1,47
Peterhead,730,7,10,12,14,42,54,-12,42
East Fife,730,8,10,9,17,48,55,-7,39
Stranraer,730,9,9,7,20,38,57,-19,34
Stenhousem'r,730,10,8,9,19,45,77,-32,33
Livingston,731,1,24,3,9,80,48,32,75
Airdrieon,731,2,19,5,12,71,54,17,62
Alloa,731,3,18,7,11,63,40,23,61
Brechin,731,4,16,8,12,50,47,3,56
Stranraer,731,5,17,2,17,52,56,-4,53
Peterhead,731,6,12,10,14,47,57,-10,46
East Fife,731,7,11,11,14,42,39,3,44
Queen's Park,731,8,11,8,17,35,51,-16,41
Albion,731,9,10,8,18,40,49,-9,38
Stenhousem'r,731,10,7,8,21,41,80,-39,29
Livingston,732,1,20,5,11,74,51,23,65
Alloa,732,2,17,11,8,66,43,23,62
Airdrieon,732,3,17,8,11,60,45,15,59
Brechin,732,4,16,5,15,50,45,5,53
Albion,732,5,15,8,13,51,51,0,53
Peterhead,732,6,14,10,12,53,54,-1,52
Stenhousem'r,732,7,12,8,16,60,85,-25,44
East Fife,732,8,10,11,15,46,43,3,41
Queen's Park,732,9,9,10,17,36,54,-18,37
Stranraer,732,10,9,6,21,37,62,-25,33
Livingston,733,1,20,8,8,77,40,37,68
Brechin,733,2,19,8,9,57,42,15,65
Alloa,733,3,16,10,10,65,48,17,58
Airdrieon,733,4,15,7,14,54,59,-5,52
Albion,733,5,15,6,15,50,44,6,51
Stranraer,733,6,12,10,14,52,61,-9,46
Peterhead,733,7,11,11,14,49,50,-1,44
Queen's Park,733,8,12,7,17,34,52,-18,43
East Fife,733,9,9,10,17,39,47,-8,37
Stenhousem'r,733,10,8,9,19,47,81,-34,33
Livingston,734,1,20,4,12,66,47,19,64
Brechin,734,2,19,7,10,50,37,13,64
Alloa,734,3,19,6,11,70,43,27,63
Peterhead,734,4,18,7,11,54,48,6,61
Albion,734,5,16,7,13,59,50,9,55
Airdrieon,734,6,15,7,14,55,58,-3,52
East Fife,734,7,10,14,12,55,50,5,44
Stranraer,734,8,11,7,18,44,58,-14,40
Queen's Park,734,9,10,6,20,32,55,-23,36
Stenhousem'r,734,10,6,7,23,38,77,-39,25
Livingston,735,1,22,3,11,79,45,34,69
Alloa,735,2,19,10,7,77,45,32,67
East Fife,735,3,15,10,11,60,47,13,55
Albion,735,4,14,12,10,59,47,12,54
Airdrieon,735,5,16,6,14,54,53,1,54
Stranraer,735,6,14,7,15,48,50,-2,49
Brechin,735,7,13,6,17,45,56,-11,45
Peterhead,735,8,10,9,17,38,63,-25,39
Stenhousem'r,735,9,10,7,19,48,76,-28,37
Queen's Park,735,10,8,8,20,31,57,-26,32
Alloa,736,1,18,12,6,72,41,31,66
Airdrieon,736,2,20,5,11,64,52,12,65
Livingston,736,3,20,4,12,77,48,29,64
Albion,736,4,17,10,9,55,47,8,61
Peterhead,736,5,13,10,13,52,51,1,49
Brechin,736,6,14,7,15,43,54,-11,49
Stranraer,736,7,12,5,19,52,64,-12,41
Stenhousem'r,736,8,10,7,19,52,78,-26,37
East Fife,736,9,9,9,18,46,49,-3,36
Queen's Park,736,10,8,9,19,32,61,-29,33
Livingston,737,1,25,1,10,80,56,24,76
Alloa,737,2,19,8,9,74,44,30,65
Airdrieon,737,3,18,7,11,56,48,8,61
Brechin,737,4,19,4,13,60,56,4,61
East Fife,737,5,15,10,11,53,41,12,55
Peterhead,737,6,15,7,14,61,56,5,52
Albion,737,7,13,6,17,54,53,1,45
Queen's Park,737,8,11,7,18,36,52,-16,40
Stranraer,737,9,8,6,22,43,64,-21,30
Stenhousem'r,737,10,4,10,22,39,86,-47,22
Alloa,738,1,23,7,6,78,40,38,76
Livingston,738,2,21,5,10,62,45,17,68
Airdrieon,738,3,17,6,13,67,56,11,57
Brechin,738,4,15,10,11,48,38,10,55
Peterhead,738,5,13,10,13,48,49,-1,49
East Fife,738,6,12,11,13,51,43,8,47
Stranraer,738,7,13,5,18,53,68,-15,44
Albion,738,8,11,6,19,41,58,-17,39
Stenhousem'r,738,9,9,10,17,44,67,-23,37
Queen's Park,738,10,7,8,21,29,57,-28,29
Livingston,739,1,22,5,9,77,47,30,71
Alloa,739,2,22,4,10,78,49,29,70
Airdrieon,739,3,21,5,10,66,46,20,68
Brechin,739,4,14,9,13,50,55,-5,51
East Fife,739,5,12,12,12,55,49,6,48
Albion,739,6,13,8,15,46,45,1,47
Peterhead,739,7,13,7,16,49,59,-10,46
Stranraer,739,8,11,6,19,52,66,-14,39
Queen's Park,739,9,8,10,18,31,57,-26,34
Stenhousem'r,739,10,6,10,20,38,69,-31,28
Livingston,740,1,20,7,9,78,48,30,67
Alloa,740,2,18,9,9,78,47,31,63
Airdrieon,740,3,18,4,14,66,62,4,58
Brechin,740,4,16,7,13,55,55,0,55
Albion,740,5,15,4,17,52,63,-11,49
Peterhead,740,6,13,9,14,48,52,-4,48
Stranraer,740,7,14,6,16,54,64,-10,48
Queen's Park,740,8,12,7,17,42,50,-8,43
East Fife,740,9,9,11,16,43,50,-7,38
Stenhousem'r,740,10,10,6,20,42,67,-25,36
Livingston,741,1,25,4,7,87,47,40,79
Alloa,741,2,20,6,10,68,39,29,66
Airdrieon,741,3,16,9,11,55,49,6,57
Brechin,741,4,15,8,13,39,44,-5,53
Albion,741,5,14,8,14,60,55,5,50
Queen's Park,741,6,13,11,12,36,44,-8,50
Peterhead,741,7,13,7,16,48,56,-8,46
East Fife,741,8,12,7,17,48,48,0,43
Stranraer,741,9,11,8,17,48,61,-13,41
Stenhousem'r,741,10,4,6,26,37,83,-46,18
Alloa,742,1,20,8,8,80,51,29,68
Brechin,742,2,19,7,10,60,40,20,64
Airdrieon,742,3,20,3,13,61,52,9,63
Livingston,742,4,15,6,15,60,58,2,51
Peterhead,742,5,14,7,15,51,53,-2,49
East Fife,742,6,13,8,15,52,55,-3,47
Stranraer,742,7,14,4,18,52,61,-9,46
Albion,742,8,12,8,16,55,57,-2,44
Queen's Park,742,9,10,8,18,34,54,-20,38
Stenhousem'r,742,10,11,5,20,54,78,-24,38
Livingston,743,1,18,6,12,78,55,23,60
Alloa,743,2,16,11,9,67,43,24,59
Airdrieon,743,3,17,7,12,60,56,4,58
Albion,743,4,15,9,12,55,44,11,54
East Fife,743,5,14,12,10,49,40,9,54
Stranraer,743,6,15,9,12,51,50,1,54
Peterhead,743,7,16,6,14,46,45,1,54
Brechin,743,8,13,7,16,47,59,-12,46
Queen's Park,743,9,10,8,18,34,55,-21,38
Stenhousem'r,743,10,4,9,23,40,80,-40,21
Alloa,744,1,20,7,9,75,39,36,67
Livingston,744,2,19,7,10,68,46,22,64
Peterhead,744,3,16,10,10,45,41,4,58
Brechin,744,4,16,7,13,56,48,8,55
Airdrieon,744,5,15,9,12,57,49,8,54
Albion,744,6,15,9,12,53,47,6,54
Queen's Park,744,7,14,6,16,38,52,-14,48
Stranraer,744,8,12,7,17,44,61,-17,43
East Fife,744,9,7,13,16,44,51,-7,34
Stenhousem'r,744,10,4,9,23,39,85,-46,21
Alloa,745,1,22,8,6,82,39,43,74
Livingston,745,2,20,5,11,85,50,35,65
Albion,745,3,17,6,13,59,56,3,57
East Fife,745,4,14,5,17,49,47,2,47
Brechin,745,5,13,7,16,48,59,-11,46
Airdrieon,745,6,12,8,16,49,63,-14,44
Peterhead,745,7,12,8,16,41,59,-18,44
Stenhousem'r,745,8,11,10,15,55,73,-18,43
Stranraer,745,9,12,6,18,50,58,-8,42
Queen's Park,745,10,11,9,16,33,47,-14,42
Livingston,746,1,22,2,12,70,44,26,68
Alloa,746,2,19,9,8,68,39,29,66
Airdrieon,746,3,16,10,10,56,54,2,58
Brechin,746,4,15,6,15,40,46,-6,51
Albion,746,5,13,10,13,53,49,4,49
Stranraer,746,6,14,7,15,54,51,3,49
Peterhead,746,7,13,10,13,51,52,-1,49
East Fife,746,8,10,11,15,47,49,-2,41
Queen's Park,746,9,12,5,19,38,58,-20,41
Stenhousem'r,746,10,6,10,20,42,77,-35,28
Alloa,747,1,22,7,7,82,48,34,73
Livingston,747,2,23,4,9,77,46,31,73
Brechin,747,3,18,6,12,58,52,6,60
Peterhead,747,4,15,9,12,52,48,4,54
Airdrieon,747,5,14,10,12,56,59,-3,52
Albion,747,6,13,10,13,50,53,-3,49
Queen's Park,747,7,12,6,18,48,59,-11,42
Stenhousem'r,747,8,9,8,19,55,82,-27,35
East Fife,747,9,9,7,20,39,54,-15,34
Stranraer,747,10,8,7,21,47,63,-16,31
Livingston,748,1,24,0,12,82,48,34,72
Alloa,748,2,19,7,10,81,52,29,64
Albion,748,3,17,7,12,65,53,12,58
East Fife,748,4,15,8,13,52,50,2,53
Airdrieon,748,5,15,8,13,57,58,-1,53
Peterhead,748,6,15,7,14,43,46,-3,52
Queen's Park,748,7,15,5,16,41,56,-15,50
Brechin,748,8,14,4,18,52,56,-4,46
Stranraer,748,9,9,6,21,50,70,-20,33
Stenhousem'r,748,10,7,8,21,42,76,-34,29
Airdrieon,749,1,20,6,10,60,48,12,66
Livingston,749,2,19,4,13,70,47,23,61
Alloa,749,3,17,10,9,60,40,20,61
Brechin,749,4,19,4,13,56,50,6,61
Peterhead,749,5,15,7,14,51,54,-3,52
East Fife,749,6,13,10,13,51,41,10,49
Albion,749,7,13,8,15,52,49,3,47
Stranraer,749,8,14,4,18,51,58,-7,46
Queen's Park,749,9,12,6,18,46,63,-17,42
Stenhousem'r,749,10,5,7,24,40,87,-47,22
Alloa,750,1,21,8,7,69,35,34,71
Brechin,750,2,19,5,12,51,45,6,62
Livingston,750,3,16,10,10,66,49,17,58
Airdrieon,750,4,14,10,12,52,52,0,52
Queen's Park,750,5,14,9,13,39,46,-7,51
Stranraer,750,6,12,10,14,44,52,-8,46
Peterhead,750,7,12,8,16,51,52,-1,44
Albion,750,8,11,9,16,45,53,-8,42
East Fife,750,9,7,14,15,37,43,-6,35
Stenhousem'r,750,10,8,9,19,43,70,-27,33
Airdrieon,751,1,22,6,8,64,46,18,72
Brechin,751,2,17,10,9,58,43,15,61
Livingston,751,3,18,6,12,71,57,14,60
Alloa,751,4,16,11,9,63,38,25,59
Albion,751,5,13,10,13,51,52,-1,49
Stranraer,751,6,13,7,16,58,66,-8,46
Queen's Park,751,7,10,11,15,40,52,-12,41
Peterhead,751,8,9,11,16,44,64,-20,38
East Fife,751,9,8,13,15,50,48,2,37
Stenhousem'r,751,10,5,13,18,51,84,-33,28
Alloa,752,1,22,5,9,78,43,35,71
Airdrieon,752,2,18,7,11,53,48,5,61
Livingston,752,3,18,6,12,66,48,18,60
Brechin,752,4,18,5,13,51,44,7,59
East Fife,752,5,14,7,15,57,48,9,49
Albion,752,6,13,8,15,41,44,-3,47
Stranraer,752,7,13,3,20,50,59,-9,42
Queen's Park,752,8,12,6,18,33,51,-18,42
Peterhead,752,9,10,9,17,44,56,-12,39
Stenhousem'r,752,10,10,8,18,43,75,-32,38
Alloa,753,1,23,6,7,76,38,38,75
Livingston,753,2,23,5,8,93,51,42,74
Airdrieon,753,3,19,5,12,62,50,12,62
Albion,753,4,13,10,13,57,57,0,49
Brechin,753,5,13,6,17,46,50,-4,45
Stranraer,753,6,13,5,18,58,69,-11,44
Queen's Park,753,7,11,9,16,34,53,-19,42
East Fife,753,8,10,11,15,47,58,-11,41
Peterhead,753,9,9,10,17,41,61,-20,37
Stenhousem'r,753,10,6,13,17,52,79,-27,31
Alloa,754,1,20,10,6,73,42,31,70
Livingston,754,2,20,6,10,75,49,26,66
Brechin,754,3,19,6,11,56,40,16,63
East Fife,754,4,16,7,13,57,48,9,55
Airdrieon,754,5,14,7,15,55,63,-8,49
Stranraer,754,6,13,6,17,58,61,-3,45
Peterhead,754,7,11,9,16,46,53,-7,42
Albion,754,8,11,8,17,44,54,-10,41
Queen's Park,754,9,9,10,17,33,59,-26,37
Stenhousem'r,754,10,9,7,20,52,80,-28,34
Airdrieon,755,1,21,7,8,68,44,24,70
Livingston,755,2,21,6,9,83,47,36,69
Brechin,755,3,19,7,10,53,42,11,64
Alloa,755,4,16,10,10,65,46,19,58
Peterhead,755,5,14,9,13,55,60,-5,51
East Fife,755,6,11,10,15,48,51,-3,43
Albion,755,7,11,9,16,45,51,-6,42
Queen's Park,755,8,11,9,16,33,51,-18,42
Stranraer,755,9,11,4,21,46,65,-19,37
Stenhousem'r,755,10,6,7,23,44,83,-39,25
Airdrieon,756,1,22,5,9,59,44,15,71
Livingston,756,2,20,4,12,81,56,25,64
Alloa,756,3,16,10,10,67,55,12,58
Brechin,756,4,17,7,12,51,47,4,58
East Fife,756,5,14,8,14,50,44,6,50
Peterhead,756,6,13,10,13,56,45,11,49
Albion,756,7,13,6,17,55,57,-2,45
Stranraer,756,8,12,8,16,50,55,-5,44
Queen's Park,756,9,10,7,19,35,62,-27,37
Stenhousem'r,756,10,6,9,21,43,82,-39,27
Brechin,757,1,20,7,9,51,39,12,67
Airdrieon,757,2,19,6,11,64,55,9,63
Alloa,757,3,18,8,10,72,50,22,62
Albion,757,4,17,9,10,60,47,13,60
Livingston,757,5,18,4,14,77,57,20,58
East Fife,757,6,13,10,13,50,47,3,49
Queen's Park,757,7,12,9,15,42,53,-11,45
Peterhead,757,8,13,5,18,47,54,-7,44
Stranraer,757,9,11,6,19,43,58,-15,39
Stenhousem'r,757,10,3,8,25,45,91,-46,17
Livingston,758,1,23,2,11,72,40,32,71
Airdrieon,758,2,18,6,12,66,50,16,60
Albion,758,3,18,4,14,60,46,14,58
Alloa,758,4,16,7,13,59,53,6,55
Brechin,758,5,15,7,14,44,49,-5,52
Queen's Park,758,6,16,4,16,45,58,-13,52
East Fife,758,7,13,9,14,51,47,4,48
Stranraer,758,8,14,5,17,56,61,-5,47
Peterhead,758,9,10,7,19,45,61,-16,37
Stenhousem'r,758,10,8,7,21,41,74,-33,31
Brechin,759,1,20,7,9,60,41,19,67
Alloa,759,2,19,8,9,79,45,34,65
Livingston,759,3,20,5,11,75,54,21,65
Airdrieon,759,4,15,7,14,63,61,2,52
Stranraer,759,5,14,7,15,59,60,-1,49
Peterhead,759,6,14,7,15,51,61,-10,49
Albion,759,7,12,9,15,55,60,-5,45
East Fife,759,8,11,7,18,46,54,-8,40
Stenhousem'r,759,9,8,11,17,49,74,-25,35
Queen's Park,759,10,9,8,19,31,58,-27,35
Livingston,760,1,22,0,14,77,48,29,66
Brechin,760,2,18,5,13,52,47,5,59
Alloa,760,3,17,7,12,73,55,18,58
Airdrieon,760,4,17,6,13,52,54,-2,57
Albion,760,5,15,9,12,54,55,-1,54
Peterhead,760,6,12,12,12,48,48,0,48
Stranraer,760,7,12,11,13,54,51,3,47
East Fife,760,8,10,11,15,52,54,-2,41
Queen's Park,760,9,11,7,18,38,60,-22,40
Stenhousem'r,760,10,7,10,19,55,83,-28,31
Albion,761,1,17,7,12,57,47,10,58
Livingston,761,2,17,6,13,75,54,21,57
Brechin,761,3,15,7,14,41,45,-4,52
Airdrieon,761,4,15,7,14,57,66,-9,52
Peterhead,761,5,15,6,15,54,55,-1,51
Queen's Park,761,6,16,3,17,45,56,-11,51
Alloa,761,7,13,10,13,69,50,19,49
East Fife,761,8,14,6,16,46,47,-1,48
Stranraer,761,9,12,8,16,48,51,-3,44
Stenhousem'r,761,10,12,8,16,53,74,-21,44
Albion,762,1,20,8,8,57,40,17,68
Livingston,762,2,20,7,9,68,40,28,67
Alloa,762,3,17,9,10,69,48,21,60
Brechin,762,4,18,3,15,52,53,-1,57
Stranraer,762,5,16,3,17,52,47,5,51
Airdrieon,762,6,14,6,16,48,53,-5,48
Peterhead,762,7,13,7,16,49,56,-7,46
East Fife,762,8,12,9,15,51,54,-3,45
Queen's Park,762,9,10,6,20,28,53,-25,36
Stenhousem'r,762,10,7,8,21,44,74,-30,29
Livingston,763,1,22,5,9,77,45,32,71
Alloa,763,2,18,9,9,71,42,29,63
Brechin,763,3,19,6,11,56,41,15,63
Airdrieon,763,4,17,5,14,60,50,10,56
Albion,763,5,17,5,14,61,55,6,56
Peterhead,763,6,14,7,15,54,60,-6,49
Stranraer,763,7,13,4,19,47,61,-14,43
Queen's Park,763,8,13,4,19,37,61,-24,43
East Fife,763,9,10,10,16,45,57,-12,40
Stenhousem'r,763,10,6,7,23,44,80,-36,25
Livingston,764,1,22,3,11,79,44,35,69
Alloa,764,2,17,9,10,69,50,19,60
Queen's Park,764,3,16,9,11,47,45,2,57
Brechin,764,4,14,11,11,51,48,3,53
Peterhead,764,5,13,13,10,50,46,4,52
Airdrieon,764,6,14,8,14,59,52,7,50
Albion,764,7,13,8,15,48,53,-5,47
East Fife,764,8,12,8,16,45,54,-9,44
Stranraer,764,9,9,10,17,44,57,-13,37
Stenhousem'r,764,10,6,9,21,42,85,-43,27
Livingston,765,1,20,6,10,77,51,26,66
Airdrieon,765,2,18,8,10,63,49,14,62
Alloa,765,3,17,7,12,68,52,16,58
Brechin,765,4,17,6,13,51,47,4,57
Queen's Park,765,5,14,9,13,41,47,-6,51
Albion,765,6,13,10,13,58,54,4,49
Peterhead,765,7,13,6,17,49,62,-13,45
Stenhousem'r,765,8,12,6,18,61,76,-15,42
Stranraer,765,9,10,7,19,47,70,-23,37
East Fife,765,10,7,13,16,44,51,-7,34
Livingston,766,1,21,4,11,72,49,23,67
Alloa,766,2,18,7,11,69,48,21,61
Brechin,766,3,16,8,12,54,49,5,56
Airdrieon,766,4,16,6,14,61,66,-5,54
Albion,766,5,13,9,14,45,46,-1,48
Queen's Park,766,6,14,6,16,35,44,-9,48
Peterhead,766,7,13,8,15,59,52,7,47
East Fife,766,8,12,10,14,48,49,-1,46
Stranraer,766,9,13,5,18,52,58,-6,44
Stenhousem'r,766,10,8,9,19,43,77,-34,33
Alloa,767,1,21,5,10,73,46,27,68
Livingston,767,2,18,4,14,72,53,19,58
Airdrieon,767,3,15,9,12,49,51,-2,54
Brechin,767,4,16,5,15,49,51,-2,53
East Fife,767,5,13,9,14,58,49,9,48
Albion,767,6,13,8,15,56,54,2,47
Queen's Park,767,7,12,11,13,34,39,-5,47
Stranraer,767,8,14,3,19,55,66,-11,45
Peterhead,767,9,11,10,15,41,54,-13,43
Stenhousem'r,767,10,12,6,18,56,80,-24,42
Livingston,768,1,25,2,9,81,44,37,77
Alloa,768,2,20,7,9,67,37,30,67
Brechin,768,3,19,5,12,61,43,18,62
Airdrieon,768,4,18,7,11,61,52,9,61
Queen's Park,768,5,14,7,15,42,53,-11,49
Stranraer,768,6,11,11,14,58,61,-3,44
East Fife,768,7,10,10,16,50,60,-10,40
Peterhead,768,8,11,7,18,51,74,-23,40
Albion,768,9,11,6,19,47,58,-11,39
Stenhousem'r,768,10,6,8,22,43,79,-36,26
Livingston,769,1,21,8,7,76,46,30,71
Alloa,769,2,19,7,10,64,44,20,64
Airdrieon,769,3,17,8,11,58,45,13,59
Brechin,769,4,18,5,13,55,52,3,59
East Fife,769,5,11,12,13,53,52,1,45
Peterhead,769,6,11,9,16,49,50,-1,42
Stenhousem'r,769,7,12,6,18,55,75,-20,42
Albion,769,8,11,8,17,54,66,-12,41
Queen's Park,769,9,11,7,18,33,52,-19,40
Stranraer,769,10,9,10,17,42,57,-15,37
Brechin,770,1,22,4,10,48,31,17,70
Livingston,770,2,20,8,8,74,47,27,68
Alloa,770,3,18,9,9,69,43,26,63
Airdrieon,770,4,15,10,11,64,60,4,55
East Fife,770,5,13,9,14,53,47,6,48
Queen's Park,770,6,13,8,15,44,54,-10,47
Stranraer,770,7,12,8,16,50,58,-8,44
Albion,770,8,10,13,13,51,54,-3,43
Peterhead,770,9,8,9,19,46,66,-20,33
Stenhousem'r,770,10,4,12,20,43,82,-39,24
Livingston,771,1,23,7,6,80,36,44,76
Alloa,771,2,18,8,10,65,43,22,62
Airdrieon,771,3,17,8,11,72,56,16,59
Albion,771,4,16,7,13,47,45,2,55
Brechin,771,5,16,5,15,48,45,3,53
Queen's Park,771,6,13,9,14,38,46,-8,48
East Fife,771,7,11,9,16,52,54,-2,42
Stranraer,771,8,11,6,19,47,60,-13,39
Peterhead,771,9,11,6,19,48,66,-18,39
Stenhousem'r,771,10,7,9,20,40,86,-46,30
Livingston,772,1,23,4,9,79,43,36,73
Alloa,772,2,17,9,10,67,46,21,60
Brechin,772,3,16,7,13,56,49,7,55
Albion,772,4,13,12,11,55,56,-1,51
Peterhead,772,5,13,11,12,47,52,-5,50
Airdrieon,772,6,13,9,14,46,45,1,48
Stranraer,772,7,14,5,17,54,56,-2,47
Queen's Park,772,8,11,11,14,43,59,-16,44
East Fife,772,9,9,12,15,42,51,-9,39
Stenhousem'r,772,10,8,6,22,48,80,-32,30
Alloa,773,1,22,7,7,75,37,38,73
Livingston,773,2,19,5,12,80,51,29,62
Queen's Park,773,3,17,6,13,47,44,3,57
Airdrieon,773,4,15,10,11,62,54,8,55
Brechin,773,5,16,6,14,56,56,0,54
Peterhead,773,6,13,8,15,52,55,-3,47
East Fife,773,7,11,10,15,50,52,-2,43
Albion,773,8,11,8,17,45,59,-14,41
Stranraer,773,9,12,5,19,49,67,-18,41
Stenhousem'r,773,10,8,7,21,44,85,-41,31
Livingston,774,1,24,2,10,87,45,42,74
Alloa,774,2,21,7,8,78,44,34,70
Airdrieon,774,3,16,7,13,53,57,-4,55
East Fife,774,4,12,12,12,51,45,6,48
Peterhead,774,5,14,6,16,45,51,-6,48
Albion,774,6,13,8,15,49,49,0,47
Stranraer,774,7,13,7,16,51,61,-10,46
Brechin,774,8,13,6,17,47,54,-7,45
Queen's Park,774,9,12,6,18,34,55,-21,42
Stenhousem'r,774,10,7,9,20,46,80,-34,30
Livingston,775,1,23,4,9,84,49,35,73
Alloa,775,2,18,7,11,64,45,19,61
Airdrieon,775,3,16,7,13,53,54,-1,55
Brechin,775,4,16,5,15,46,48,-2,53
Stranraer,775,5,16,4,16,57,57,0,52
Peterhead,775,6,12,11,13,48,47,1,47
East Fife,775,7,11,12,13,47,42,5,45
Queen's Park,775,8,11,8,17,47,65,-18,41
Albion,775,9,10,9,17,44,61,-17,39
Stenhousem'r,775,10,9,9,18,47,69,-22,36
Alloa,776,1,19,10,7,61,38,23,67
Livingston,776,2,17,8,11,72,50,22,59
Peterhead,776,3,16,6,14,56,47,9,54
Airdrieon,776,4,15,8,13,54,51,3,53
East Fife,776,5,14,8,14,56,42,14,50
Brechin,776,6,12,12,12,44,46,-2,48
Queen's Park,776,7,12,9,15,40,53,-13,45
Albion,776,8,12,9,15,48,62,-14,45
Stranraer,776,9,12,8,16,52,62,-10,44
Stenhousem'r,776,10,7,10,19,43,75,-32,31
Livingston,777,1,20,4,12,79,52,27,64
Alloa,777,2,18,6,12,66,48,18,60
Brechin,777,3,16,8,12,54,47,7,56
East Fife,777,4,16,7,13,61,44,17,55
Peterhead,777,5,16,7,13,56,52,4,55
Airdrieon,777,6,15,9,12,55,58,-3,54
Stranraer,777,7,14,4,18,50,65,-15,46
Queen's Park,777,8,12,8,16,37,49,-12,44
Albion,777,9,10,8,18,59,77,-18,38
Stenhousem'r,777,10,9,7,20,46,71,-25,34
Alloa,778,1,22,8,6,75,36,39,74
Airdrieon,778,2,20,9,7,59,44,15,69
Albion,778,3,19,6,11,64,45,19,63
Livingston,778,4,18,6,12,61,44,17,60
Brechin,778,5,17,8,11,62,45,17,59
Peterhead,778,6,13,9,14,45,56,-11,48
Queen's Park,778,7,10,9,17,34,55,-21,39
Stenhousem'r,778,8,8,9,19,42,73,-31,33
Stranraer,778,9,8,5,23,43,71,-28,29
East Fife,778,10,7,7,22,40,56,-16,28
Alloa,779,1,23,6,7,81,45,36,75
Brechin,779,2,19,6,11,57,47,10,63
Livingston,779,3,19,4,13,72,47,25,61
Airdrieon,779,4,16,6,14,56,52,4,54
Peterhead,779,5,13,10,13,45,53,-8,49
Albion,779,6,12,8,16,51,50,1,44
East Fife,779,7,11,9,16,54,51,3,42
Stranraer,779,8,11,8,17,46,63,-17,41
Queen's Park,779,9,10,8,18,41,61,-20,38
Stenhousem'r,779,10,11,5,20,44,78,-34,38
Livingston,780,1,21,9,6,76,43,33,72
Alloa,780,2,19,6,11,71,43,28,63
Brechin,780,3,16,9,11,52,42,10,57
Airdrieon,780,4,17,5,14,60,54,6,56
East Fife,780,5,13,10,13,60,53,7,49
Stranraer,780,6,14,5,17,49,63,-14,47
Albion,780,7,11,12,13,51,55,-4,45
Peterhead,780,8,11,8,17,51,68,-17,41
Queen's Park,780,9,10,10,16,36,52,-16,40
Stenhousem'r,780,10,7,8,21,54,87,-33,29
Brechin,781,1,20,6,10,58,50,8,66
Airdrieon,781,2,19,5,12,66,54,12,62
Alloa,781,3,16,8,12,69,54,15,56
Livingston,781,4,16,5,15,66,47,19,53
Stranraer,781,5,15,4,17,52,56,-4,49
Albion,781,6,13,9,14,47,50,-3,48
East Fife,781,7,13,8,15,49,49,0,47
Stenhousem'r,781,8,12,8,16,49,63,-14,44
Queen's Park,781,9,12,7,17,32,51,-19,43
Peterhead,781,10,11,6,19,49,63,-14,39
Alloa,782,1,21,6,9,77,45,32,69
Livingston,782,2,19,4,13,72,57,15,61
Airdrieon,782,3,17,6,13,64,52,12,57
Stranraer,782,4,15,9,12,47,49,-2,54
Brechin,782,5,14,7,15,45,43,2,49
Albion,782,6,11,15,10,49,45,4,48
Peterhead,782,7,12,10,14,49,52,-3,46
Queen's Park,782,8,9,12,15,34,56,-22,39
East Fife,782,9,8,13,15,44,50,-6,37
Stenhousem'r,782,10,9,8,19,50,82,-32,35
Livingston,783,1,22,5,9,75,48,27,71
Airdrieon,783,2,21,5,10,64,44,20,68
Alloa,783,3,20,6,10,77,39,38,66
Queen's Park,783,4,16,7,13,45,52,-7,55
Albion,783,5,14,9,13,58,49,9,51
Peterhead,783,6,13,10,13,47,52,-5,49
East Fife,783,7,12,10,14,54,54,0,46
Brechin,783,8,13,6,17,43,54,-11,45
Stranraer,783,9,8,4,24,42,68,-26,28
Stenhousem'r,783,10,7,6,23,36,81,-45,27
Livingston,784,1,20,3,13,64,50,14,63
Alloa,784,2,18,8,10,73,50,23,62
Airdrieon,784,3,19,5,12,60,52,8,62
Brechin,784,4,19,4,13,48,44,4,61
East Fife,784,5,15,9,12,59,45,14,54
Peterhead,784,6,14,6,16,56,55,1,48
Stranraer,784,7,13,6,17,56,63,-7,45
Albion,784,8,10,9,17,47,54,-7,39
Queen's Park,784,9,11,5,20,37,54,-17,38
Stenhousem'r,784,10,9,9,18,45,78,-33,36
Alloa,785,1,21,10,5,77,39,38,73
Livingston,785,2,21,4,11,71,45,26,67
Brechin,785,3,15,9,12,45,45,0,54
Airdrieon,785,4,16,5,15,57,56,1,53
Peterhead,785,5,14,6,16,52,51,1,48
Queen's Park,785,6,13,9,14,37,43,-6,48
Albion,785,7,12,9,15,46,51,-5,45
Stranraer,785,8,13,5,18,55,60,-5,44
East Fife,785,9,11,9,16,45,49,-4,42
Stenhousem'r,785,10,6,10,20,37,83,-46,28
Livingston,786,1,20,2,14,78,57,21,62
Albion,786,2,16,10,10,52,47,5,58
Alloa,786,3,15,10,11,66,47,19,55
Brechin,786,4,15,10,11,54,47,7,55
Peterhead,786,5,16,7,13,52,47,5,55
Stranraer,786,6,16,6,14,61,61,0,54
Airdrieon,786,7,13,10,13,50,54,-4,49
Queen's Park,786,8,13,9,14,42,47,-5,48
East Fife,786,9,8,11,17,48,58,-10,35
Stenhousem'r,786,10,6,9,21,44,82,-38,27
Livingston,787,1,21,5,10,60,44,16,68
Alloa,787,2,18,11,7,72,45,27,65
Albion,787,3,14,10,12,53,50,3,52
Airdrieon,787,4,13,11,12,58,58,0,50
Brechin,787,5,14,6,16,49,59,-10,48
Stranraer,787,6,14,5,17,50,50,0,47
Peterhead,787,7,14,5,17,52,58,-6,47
East Fife,787,8,11,11,14,47,48,-1,44
Queen's Park,787,9,12,8,16,40,48,-8,44
Stenhousem'r,787,10,9,8,19,49,70,-21,35
Alloa,788,1,20,5,11,75,51,24,65
Airdrieon,788,2,20,5,11,67,50,17,65
Livingston,788,3,21,1,14,80,53,27,64
Brechin,788,4,18,3,15,52,50,2,57
Albion,788,5,15,9,12,50,44,6,54
Peterhead,788,6,15,6,15,53,57,-4,51
Queen's Park,788,7,14,5,17,42,54,-12,47
East Fife,788,8,11,9,16,49,60,-11,42
Stranraer,788,9,11,7,18,60,71,-11,40
Stenhousem'r,788,10,6,8,22,45,83,-38,26
Livingston,789,1,22,6,8,71,43,28,72
Alloa,789,2,21,8,7,69,32,37,71
Peterhead,789,3,14,9,13,49,53,-4,51
Airdrieon,789,4,14,9,13,58,65,-7,51
East Fife,789,5,13,11,12,60,51,9,50
Brechin,789,6,12,10,14,49,50,-1,46
Albion,789,7,12,8,16,51,51,0,44
Stranraer,789,8,12,7,17,40,48,-8,43
Queen's Park,789,9,12,6,18,35,57,-22,42
Stenhousem'r,789,10,9,4,23,49,81,-32,31
Airdrieon,790,1,20,6,10,64,52,12,66
Alloa,790,2,17,10,9,65,40,25,61
Livingston,790,3,19,4,13,67,47,20,61
Brechin,790,4,18,6,12,50,41,9,60
Peterhead,790,5,16,9,11,58,47,11,57
Albion,790,6,14,9,13,54,51,3,51
East Fife,790,7,12,9,15,47,51,-4,45
Stranraer,790,8,11,6,19,48,61,-13,39
Queen's Park,790,9,10,8,18,32,60,-28,38
Stenhousem'r,790,10,6,7,23,43,78,-35,25
Alloa,791,1,17,12,7,74,49,25,63
Livingston,791,2,20,2,14,72,50,22,62
Albion,791,3,18,7,11,57,47,10,61
Airdrieon,791,4,15,7,14,63,62,1,52
Brechin,791,5,15,7,14,53,53,0,52
Peterhead,791,6,14,9,13,59,50,9,51
Stranraer,791,7,15,4,17,51,66,-15,49
Queen's Park,791,8,13,9,14,37,46,-9,48
East Fife,791,9,12,9,15,55,50,5,45
Stenhousem'r,791,10,3,10,23,36,84,-48,19
Alloa,792,1,19,5,12,82,59,23,62
Airdrieon,792,2,19,5,12,70,50,20,62
Brechin,792,3,18,5,13,55,48,7,59
Livingston,792,4,19,1,16,71,61,10,58
Peterhead,792,5,16,7,13,54,50,4,55
Albion,792,6,14,7,15,56,63,-7,49
East Fife,792,7,13,8,15,47,43,4,47
Stranraer,792,8,15,2,19,53,59,-6,47
Queen's Park,792,9,13,7,16,33,50,-17,46
Stenhousem'r,792,10,7,7,22,35,73,-38,28
Livingston,793,1,21,4,11,79,54,25,67
Alloa,793,2,19,8,9,69,44,25,65
Airdrieon,793,3,17,6,13,63,56,7,57
Peterhead,793,4,16,8,12,55,44,11,56
Brechin,793,5,15,6,15,51,49,2,51
Albion,793,6,14,7,15,53,58,-5,49
Queen's Park,793,7,14,5,17,44,50,-6,47
East Fife,793,8,12,9,15,46,49,-3,45
Stranraer,793,9,10,9,17,40,58,-18,39
Stenhousem'r,793,10,6,10,20,45,83,-38,28
Livingston,794,1,20,9,7,80,47,33,69
Airdrieon,794,2,20,7,9,57,42,15,67
Alloa,794,3,20,6,10,69,39,30,66
Albion,794,4,16,10,10,62,48,14,58
Brechin,794,5,16,5,15,46,42,4,53
Peterhead,794,6,13,10,13,51,54,-3,49
Stranraer,794,7,13,6,17,51,64,-13,45
Queen's Park,794,8,10,7,19,29,47,-18,37
East Fife,794,9,8,10,18,43,54,-11,34
Stenhousem'r,794,10,4,10,22,35,86,-51,22
Livingston,795,1,19,6,11,80,54,26,63
Alloa,795,2,18,9,9,70,46,24,63
Brechin,795,3,18,6,12,55,45,10,60
Airdrieon,795,4,16,7,13,68,59,9,55
Stranraer,795,5,16,5,15,59,58,1,53
Queen's Park,795,6,15,8,13,39,48,-9,53
Peterhead,795,7,13,10,13,45,54,-9,49
Albion,795,8,10,10,16,41,53,-12,40
East Fife,795,9,10,8,18,50,50,0,38
Stenhousem'r,795,10,5,11,20,44,84,-40,26
Brechin,796,1,21,5,10,55,43,12,68
Alloa,796,2,18,10,8,66,42,24,64
Albion,796,3,18,6,12,55,48,7,60
Livingston,796,4,17,7,12,68,50,18,58
Airdrieon,796,5,16,9,11,65,54,11,57
Peterhead,796,6,15,5,16,47,58,-11,50
Queen's Park,796,7,12,8,16,33,40,-7,44
Stranraer,796,8,11,7,18,45,62,-17,40
East Fife,796,9,10,7,19,46,49,-3,37
Stenhousem'r,796,10,7,6,23,48,82,-34,27
Livingston,797,1,25,1,10,85,50,35,76
Airdrieon,797,2,21,6,9,67,44,23,69
Alloa,797,3,19,7,10,66,42,24,64
Brechin,797,4,17,7,12,58,45,13,58
Stranraer,797,5,16,6,14,60,59,1,54
Peterhead,797,6,12,10,14,54,57,-3,46
Albion,797,7,13,7,16,54,60,-6,46
East Fife,797,8,9,11,16,42,51,-9,38
Queen's Park,797,9,9,6,21,27,61,-34,33
Stenhousem'r,797,10,4,9,23,44,88,-44,21
Alloa,798,1,21,9,6,63,40,23,72
Livingston,798,2,19,3,14,75,56,19,60
Brechin,798,3,17,7,12,52,50,2,58
Albion,798,4,16,7,13,52,39,13,55
East Fife,798,5,15,9,12,50,44,6,54
Airdrieon,798,6,13,8,15,60,64,-4,47
Peterhead,798,7,13,7,16,51,53,-2,46
Queen's Park,798,8,13,7,16,40,46,-6,46
Stranraer,798,9,12,5,19,48,56,-8,41
Stenhousem'r,798,10,8,4,24,38,81,-43,28
Livingston,799,1,22,4,10,82,47,35,70
Airdrieon,799,2,17,9,10,59,52,7,60
Brechin,799,3,17,5,14,52,44,8,56
Alloa,799,4,16,6,14,60,55,5,54
Peterhead,799,5,14,7,15,45,53,-8,49
Albion,799,6,13,8,15,65,65,0,47
Queen's Park,799,7,13,6,17,46,61,-15,45
East Fife,799,8,12,8,16,59,57,2,44
Stranraer,799,9,11,10,15,50,54,-4,43
Stenhousem'r,799,10,10,7,19,45,75,-30,37
Alloa,800,1,21,7,8,75,44,31,70
Brechin,800,2,19,5,12,61,49,12,62
Livingston,800,3,18,4,14,64,54,10,58
Albion,800,4,14,10,12,55,52,3,52
Peterhead,800,5,15,6,15,58,54,4,51
Airdrieon,800,6,15,6,15,58,59,-1,51
East Fife,800,7,13,9,14,52,48,4,48
Queen's Park,800,8,12,7,17,34,48,-14,43
Stranraer,800,9,13,3,20,54,66,-12,42
Stenhousem'r,800,10,8,7,21,46,83,-37,31
Livingston,801,1,25,0,11,85,46,39,75
Alloa,801,2,20,6,10,70,41,29,66
Airdrieon,801,3,19,7,10,55,54,1,64
Brechin,801,4,16,5,15,47,50,-3,53
Albion,801,5,14,6,16,56,53,3,48
Stranraer,801,6,15,2,19,61,65,-4,47
Queen's Park,801,7,14,5,17,39,50,-11,47
Peterhead,801,8,12,7,17,54,63,-9,43
East Fife,801,9,10,8,18,47,60,-13,38
Stenhousem'r,801,10,8,8,20,46,78,-32,32
Alloa,802,1,19,9,8,67,45,22,66
Livingston,802,2,18,8,10,73,46,27,62
Stranraer,802,3,17,5,14,58,50,8,56
East Fife,802,4,13,11,12,46,40,6,50
Peterhead,802,5,12,13,11,48,42,6,49
Brechin,802,6,14,6,16,47,51,-4,48
Airdrieon,802,7,14,6,16,45,66,-21,48
Albion,802,8,13,7,16,50,52,-2,46
Queen's Park,802,9,12,6,18,34,49,-15,42
Stenhousem'r,802,10,10,5,21,38,65,-27,35
Livingston,803,1,21,9,6,86,44,42,72
Alloa,803,2,17,12,7,68,42,26,63
Brechin,803,3,19,5,12,52,46,6,62
Airdrieon,803,4,16,10,10,60,56,4,58
Peterhead,803,5,15,8,13,52,48,4,53
Albion,803,6,12,11,13,51,52,-1,47
East Fife,803,7,10,11,15,48,46,2,41
Queen's Park,803,8,11,8,17,38,55,-17,41
Stranraer,803,9,9,7,20,37,56,-19,34
Stenhousem'r,803,10,5,9,22,39,86,-47,24
Alloa,804,1,19,5,12,66,54,12,62
Livingston,804,2,17,8,11,72,54,18,59
Brechin,804,3,17,6,13,60,50,10,57
Airdrieon,804,4,15,8,13,60,52,8,53
Queen's Park,804,5,16,5,15,39,46,-7,53
Peterhead,804,6,13,9,14,53,56,-3,48
Albion,804,7,13,7,16,48,55,-7,46
Stenhousem'r,804,8,13,6,17,53,67,-14,45
Stranraer,804,9,13,5,18,47,60,-13,44
East Fife,804,10,9,11,16,45,49,-4,38
Livingston,805,1,23,1,12,70,50,20,70
Alloa,805,2,19,11,6,72,38,34,68
Brechin,805,3,20,6,10,51,41,10,66
Airdrieon,805,4,15,10,11,58,53,5,55
Queen's Park,805,5,12,10,14,40,46,-6,46
Albion,805,6,12,9,15,50,52,-2,45
Peterhead,805,7,12,9,15,48,54,-6,45
Stranraer,805,8,11,6,19,44,56,-12,39
East Fife,805,9,9,9,18,48,53,-5,36
Stenhousem'r,805,10,8,7,21,50,88,-38,31
Livingston,806,1,24,4,8,77,41,36,76
Brechin,806,2,22,3,11,59,43,16,69
Alloa,806,3,20,8,8,73,42,31,68
Airdrieon,806,4,19,8,9,66,50,16,65
Albion,806,5,12,8,16,44,50,-6,44
East Fife,806,6,10,11,15,42,50,-8,41
Peterhead,806,7,11,7,18,40,56,-16,40
Stenhousem'r,806,8,10,6,20,49,69,-20,36
Queen's Park,806,9,10,5,21,34,57,-23,35
Stranraer,806,10,10,4,22,33,59,-26,34
Alloa,807,1,19,10,7,76,43,33,67
Airdrieon,807,2,19,7,10,58,50,8,64
Livingston,807,3,17,7,12,72,47,25,58
Stranraer,807,4,14,11,11,50,41,9,53
Albion,807,5,13,11,12,55,56,-1,50
East Fife,807,6,11,12,13,52,47,5,45
Brechin,807,7,13,6,17,46,57,-11,45
Queen's Park,807,8,12,9,15,35,54,-19,45
Peterhead,807,9,10,10,16,41,54,-13,40
Stenhousem'r,807,10,5,11,20,48,84,-36,26
Brechin,808,1,25,2,9,62,39,23,77
Airdrieon,808,2,20,5,11,65,54,11,65
Livingston,808,3,20,3,13,74,55,19,63
Alloa,808,4,16,9,11,71,43,28,57
Albion,808,5,17,5,14,57,54,3,56
Peterhead,808,6,13,10,13,52,50,2,49
Stenhousem'r,808,7,10,7,19,44,80,-36,37
East Fife,808,8,9,9,18,54,64,-10,36
Queen's Park,808,9,9,9,18,37,55,-18,36
Stranraer,808,10,10,3,23,47,69,-22,33
Livingston,809,1,22,6,8,78,45,33,72
Alloa,809,2,20,9,7,75,43,32,69
Brechin,809,3,17,6,13,55,52,3,57
Peterhead,809,4,15,9,12,49,47,2,54
East Fife,809,5,15,7,14,48,43,5,52
Airdrieon,809,6,15,4,17,61,61,0,49
Queen's Park,809,7,14,7,15,40,45,-5,49
Albion,809,8,11,7,18,48,63,-15,40
Stranraer,809,9,9,7,20,45,66,-21,34
Stenhousem'r,809,10,6,10,20,38,72,-34,28
Livingston,810,1,23,3,10,71,46,25,72
Alloa,810,2,18,5,13,66,47,19,59
Airdrieon,810,3,18,5,13,63,56,7,59
Brechin,810,4,16,8,12,56,52,4,56
Albion,810,5,16,6,14,58,60,-2,54
East Fife,810,6,13,10,13,52,45,7,49
Peterhead,810,7,13,9,14,49,50,-1,48
Queen's Park,810,8,13,6,17,37,46,-9,45
Stranraer,810,9,11,9,16,51,60,-9,42
Stenhousem'r,810,10,5,7,24,40,81,-41,22
Livingston,811,1,23,4,9,80,45,35,73
Alloa,811,2,21,6,9,68,43,25,69
Brechin,811,3,15,11,10,54,41,13,56
Peterhead,811,4,17,4,15,48,49,-1,55
Albion,811,5,16,6,14,50,48,2,54
Airdrieon,811,6,13,7,16,51,55,-4,46
Stranraer,811,7,10,11,15,47,58,-11,41
Stenhousem'r,811,8,10,8,18,48,65,-17,38
Queen's Park,811,9,9,10,17,34,59,-25,37
East Fife,811,10,9,7,20,41,58,-17,34
Alloa,812,1,19,10,7,62,42,20,67
Airdrieon,812,2,21,4,11,69,53,16,67
Livingston,812,3,18,5,13,59,48,11,59
Peterhead,812,4,17,7,12,52,46,6,58
Brechin,812,5,16,6,14,55,57,-2,54
Albion,812,6,15,6,15,54,52,2,51
East Fife,812,7,11,8,17,52,47,5,41
Queen's Park,812,8,11,7,18,42,54,-12,40
Stranraer,812,9,10,6,20,41,59,-18,36
Stenhousem'r,812,10,8,9,19,50,78,-28,33
Alloa,813,1,21,6,9,77,40,37,69
Brechin,813,2,20,7,9,54,40,14,67
Livingston,813,3,19,8,9,67,49,18,65
Peterhead,813,4,15,8,13,53,48,5,53
Airdrieon,813,5,15,6,15,55,58,-3,51
Albion,813,6,13,11,12,49,46,3,50
Stranraer,813,7,13,6,17,43,55,-12,45
Queen's Park,813,8,11,9,16,36,52,-16,42
East Fife,813,9,9,10,17,47,53,-6,37
Stenhousem'r,813,10,4,9,23,37,77,-40,21
Airdrieon,814,1,17,12,7,62,48,14,63
Livingston,814,2,17,8,11,76,54,22,59
Alloa,814,3,16,9,11,67,54,13,57
Brechin,814,4,16,7,13,53,51,2,55
Albion,814,5,15,6,15,59,51,8,51
East Fife,814,6,12,11,13,51,49,2,47
Queen's Park,814,7,13,8,15,43,51,-8,47
Peterhead,814,8,11,12,13,35,46,-11,45
Stranraer,814,9,11,8,17,51,63,-12,41
Stenhousem'r,814,10,8,7,21,44,74,-30,31
Alloa,815,1,22,7,7,79,40,39,73
Livingston,815,2,21,4,11,74,53,21,67
Brechin,815,3,19,6,11,51,40,11,63
Airdrieon,815,4,17,8,11,73,61,12,59
Peterhead,815,5,12,11,13,53,59,-6,47
Albion,815,6,13,6,17,52,60,-8,45
Stranraer,815,7,12,7,17,47,60,-13,43
East Fife,815,8,9,11,16,54,57,-3,38
Queen's Park,815,9,10,8,18,30,49,-19,38
Stenhousem'r,815,10,7,8,21,40,74,-34,29
Livingston,816,1,18,8,10,70,46,24,62
Albion,816,2,18,7,11,63,55,8,61
Alloa,816,3,17,9,10,61,44,17,60
Brechin,816,4,15,8,13,47,44,3,53
Stranraer,816,5,14,7,15,50,55,-5,49
East Fife,816,6,13,9,14,49,46,3,48
Airdrieon,816,7,14,6,16,46,50,-4,48
Peterhead,816,8,13,7,16,50,56,-6,46
Queen's Park,816,9,13,7,16,43,49,-6,46
Stenhousem'r,816,10,7,8,21,40,74,-34,29
Livingston,817,1,21,3,12,68,42,26,66
Alloa,817,2,18,6,12,68,41,27,60
Brechin,817,3,16,6,14,50,47,3,54
Airdrieon,817,4,16,6,14,53,55,-2,54
Albion,817,5,15,6,15,56,54,2,51
Queen's Park,817,6,15,6,15,40,50,-10,51
East Fife,817,7,14,8,14,50,45,5,50
Peterhead,817,8,14,7,15,52,65,-13,49
Stenhousem'r,817,9,11,6,19,50,70,-20,39
Stranraer,817,10,11,4,21,45,63,-18,37
Alloa,818,1,18,9,9,74,45,29,63
Brechin,818,2,16,8,12,47,40,7,56
Airdrieon,818,3,15,10,11,64,51,13,55
Albion,818,4,15,10,11,51,49,2,55
East Fife,818,5,16,6,14,52,46,6,54
Livingston,818,6,16,5,15,66,56,10,53
Stranraer,818,7,14,7,15,49,50,-1,49
Queen's Park,818,8,12,9,15,41,58,-17,45
Peterhead,818,9,10,7,19,42,64,-22,37
Stenhousem'r,818,10,8,9,19,50,77,-27,33
Livingston,819,1,20,3,13,80,57,23,63
Alloa,819,2,17,9,10,66,41,25,60
Albion,819,3,17,8,11,64,57,7,59
Airdrieon,819,4,16,8,12,59,46,13,56
Stranraer,819,5,16,6,14,45,50,-5,54
East Fife,819,6,15,7,14,52,46,6,52
Peterhead,819,7,16,4,16,48,50,-2,52
Brechin,819,8,13,5,18,44,53,-9,44
Queen's Park,819,9,13,5,18,41,54,-13,44
Stenhousem'r,819,10,6,7,23,36,81,-45,25
Alloa,820,1,25,4,7,79,37,42,79
Livingston,820,2,21,5,10,88,53,35,68
Airdrieon,820,3,17,8,11,63,56,7,59
East Fife,820,4,15,11,10,59,45,14,56
Peterhead,820,5,16,8,12,54,52,2,56
Brechin,820,6,15,6,15,59,58,1,51
Albion,820,7,12,9,15,51,51,0,45
Stranraer,820,8,11,6,19,42,60,-18,39
Queen's Park,820,9,9,6,21,40,72,-32,33
Stenhousem'r,820,10,5,5,26,40,91,-51,20
Livingston,821,1,23,3,10,75,42,33,72
Alloa,821,2,21,6,9,72,41,31,69
Peterhead,821,3,17,8,11,51,46,5,59
Brechin,821,4,17,7,12,52,42,10,58
Airdrieon,821,5,15,6,15,56,58,-2,51
Stranraer,821,6,14,5,17,55,63,-8,47
Queen's Park,821,7,12,9,15,34,50,-16,45
Albion,821,8,12,6,18,49,54,-5,42
East Fife,821,9,11,8,17,54,54,0,41
Stenhousem'r,821,10,5,8,23,37,85,-48,23
Livingston,822,1,22,4,10,78,52,26,70
East Fife,822,2,16,8,12,59,42,17,56
Alloa,822,3,15,11,10,65,50,15,56
Airdrieon,822,4,15,9,12,65,60,5,54
Brechin,822,5,16,6,14,58,56,2,54
Stranraer,822,6,15,8,13,55,55,0,53
Albion,822,7,10,11,15,50,53,-3,41
Queen's Park,822,8,11,8,17,39,55,-16,41
Peterhead,822,9,10,8,18,42,58,-16,38
Stenhousem'r,822,10,9,9,18,48,78,-30,36
Livingston,823,1,20,7,9,77,50,27,67
Brechin,823,2,19,7,10,54,42,12,64
Airdrieon,823,3,18,8,10,68,50,18,62
Alloa,823,4,17,6,13,73,57,16,57
Albion,823,5,14,11,11,54,51,3,53
Queen's Park,823,6,14,10,12,53,54,-1,52
Peterhead,823,7,13,10,13,57,53,4,49
Stranraer,823,8,10,8,18,48,70,-22,38
East Fife,823,9,6,10,20,41,63,-22,28
Stenhousem'r,823,10,6,9,21,50,85,-35,27
Livingston,824,1,18,7,11,79,48,31,61
Alloa,824,2,18,7,11,73,46,27,61
Albion,824,3,17,9,10,57,51,6,60
East Fife,824,4,16,9,11,56,45,11,57
Airdrieon,824,5,16,6,14,55,50,5,54
Peterhead,824,6,13,10,13,51,56,-5,49
Brechin,824,7,14,7,15,43,50,-7,49
Stranraer,824,8,12,4,20,47,63,-16,40
Queen's Park,824,9,11,7,18,41,57,-16,40
Stenhousem'r,824,10,8,8,20,47,83,-36,32
Alloa,825,1,21,8,7,77,43,34,71
Livingston,825,2,20,9,7,71,48,23,69
Brechin,825,3,15,10,11,47,37,10,55
East Fife,825,4,15,7,14,60,48,12,52
Airdrieon,825,5,14,8,14,60,62,-2,50
Stranraer,825,6,14,4,18,62,66,-4,46
Albion,825,7,12,8,16,57,59,-2,44
Queen's Park,825,8,12,8,16,36,62,-26,44
Peterhead,825,9,11,8,17,48,56,-8,41
Stenhousem'r,825,10,7,8,21,46,83,-37,29
Livingston,826,1,21,6,9,79,50,29,69
Alloa,826,2,20,5,11,74,46,28,65
Airdrieon,826,3,16,9,11,55,45,10,57
Peterhead,826,4,16,5,15,50,48,2,53
East Fife,826,5,12,12,12,53,45,8,48
Brechin,826,6,14,6,16,47,54,-7,48
Albion,826,7,13,6,17,52,59,-7,45
Stranraer,826,8,13,5,18,47,60,-13,44
Queen's Park,826,9,11,7,18,40,59,-19,40
Stenhousem'r,826,10,11,5,20,56,87,-31,38
Livingston,827,1,21,3,12,83,49,34,66
Airdrieon,827,2,18,9,9,66,50,16,63
Alloa,827,3,17,11,8,70,44,26,62
Brechin,827,4,16,7,13,49,54,-5,55
Peterhead,827,5,14,9,13,55,57,-2,51
Stranraer,827,6,13,7,16,57,60,-3,46
East Fife,827,7,11,9,16,49,56,-7,42
Albion,827,8,11,9,16,43,56,-13,42
Queen's Park,827,9,11,8,17,37,52,-15,41
Stenhousem'r,827,10,7,10,19,50,81,-31,31
Livingston,828,1,21,4,11,77,50,27,67
Alloa,828,2,19,9,8,73,44,29,66
Airdrieon,828,3,17,7,12,55,47,8,58
Albion,828,4,16,8,12,58,47,11,56
Queen's Park,828,5,15,8,13,41,48,-7,53
Brechin,828,6,15,7,14,50,52,-2,52
East Fife,828,7,10,11,15,50,49,1,41
Peterhead,828,8,11,7,18,42,62,-20,40
Stranraer,828,9,10,6,20,41,61,-20,36
Stenhousem'r,828,10,9,7,20,51,78,-27,34
Alloa,829,1,20,8,8,79,46,33,68
Brechin,829,2,19,8,9,67,51,16,65
Livingston,829,3,19,4,13,74,51,23,61
Albion,829,4,17,8,11,62,52,10,59
Airdrieon,829,5,17,5,14,63,57,6,56
Peterhead,829,6,15,5,16,45,54,-9,50
Stranraer,829,7,12,5,19,50,65,-15,41
Queen's Park,829,8,10,8,18,38,54,-16,38
East Fife,829,9,10,7,19,42,54,-12,37
Stenhousem'r,829,10,7,10,19,52,88,-36,31
Alloa,830,1,21,5,10,78,45,33,68
Livingston,830,2,20,6,10,75,45,30,66
Airdrieon,830,3,18,5,13,55,51,4,59
Stranraer,830,4,16,8,12,55,50,5,56
East Fife,830,5,12,12,12,44,46,-2,48
Albion,830,6,13,8,15,51,56,-5,47
Brechin,830,7,13,7,16,48,58,-10,46
Peterhead,830,8,12,9,15,48,54,-6,45
Queen's Park,830,9,12,6,18,39,55,-16,42
Stenhousem'r,830,10,4,12,20,41,74,-33,24
Alloa,831,1,21,7,8,78,47,31,70
Livingston,831,2,21,5,10,74,45,29,68
Albion,831,3,18,6,12,65,53,12,60
Airdrieon,831,4,15,10,11,60,58,2,55
Brechin,831,5,13,8,15,44,52,-8,47
Stranraer,831,6,12,8,16,48,52,-4,44
Peterhead,831,7,11,11,14,52,65,-13,44
Queen's Park,831,8,13,5,18,34,48,-14,44
East Fife,831,9,12,7,17,49,47,2,43
Stenhousem'r,831,10,7,7,22,45,82,-37,28
Alloa,832,1,22,5,9,81,44,37,71
Livingston,832,2,21,6,9,75,48,27,69
Airdrieon,832,3,17,7,12,58,55,3,58
Albion,832,4,15,9,12,54,50,4,54
Brechin,832,5,15,7,14,51,48,3,52
Queen's Park,832,6,14,9,13,42,46,-4,51
East Fife,832,7,12,8,16,47,52,-5,44
Peterhead,832,8,10,11,15,43,50,-7,41
Stranraer,832,9,12,5,19,46,63,-17,41
Stenhousem'r,832,10,4,9,23,36,77,-41,21
Livingston,833,1,21,5,10,77,50,27,68
Airdrieon,833,2,19,9,8,62,48,14,66
Alloa,833,3,17,11,8,80,50,30,62
Brechin,833,4,19,4,13,55,43,12,61
Peterhead,833,5,14,7,15,52,60,-8,49
Albion,833,6,12,8,16,51,59,-8,44
Stranraer,833,7,14,2,20,53,69,-16,44
Queen's Park,833,8,11,9,16,36,51,-15,42
East Fife,833,9,10,8,18,47,55,-8,38
Stenhousem'r,833,10,8,7,21,47,75,-28,31
Livingston,834,1,25,2,9,81,47,34,77
Alloa,834,2,20,6,10,72,52,20,66
Brechin,834,3,16,9,11,51,51,0,57
Airdrieon,834,4,16,8,12,58,55,3,56
Peterhead,834,5,16,6,14,51,47,4,54
Albion,834,6,14,4,18,56,51,5,46
Stranraer,834,7,12,6,18,52,61,-9,42
East Fife,834,8,8,13,15,54,59,-5,37
Queen's Park,834,9,9,9,18,35,58,-23,36
Stenhousem'r,834,10,9,7,20,54,83,-29,34
Brechin,835,1,21,4,11,52,41,11,67
Alloa,835,2,19,7,10,69,50,19,64
Livingston,835,3,19,4,13,73,57,16,61
Airdrieon,835,4,17,6,13,58,53,5,57
Stranraer,835,5,16,3,17,58,60,-2,51
Peterhead,835,6,14,8,14,52,48,4,50
Albion,835,7,15,5,16,56,53,3,50
East Fife,835,8,11,9,16,51,51,0,42
Queen's Park,835,9,11,8,17,37,52,-15,41
Stenhousem'r,835,10,7,6,23,48,89,-41,27
Livingston,836,1,24,5,7,85,42,43,77
Alloa,836,2,19,8,9,64,43,21,65
Peterhead,836,3,18,6,12,57,47,10,60
Albion,836,4,18,5,13,53,47,6,59
Brechin,836,5,17,5,14,48,46,2,56
Airdrieon,836,6,14,10,12,60,55,5,52
Stranraer,836,7,15,4,17,51,57,-6,49
East Fife,836,8,13,6,17,51,55,-4,45
Queen's Park,836,9,8,5,23,30,62,-32,29
Stenhousem'r,836,10,5,4,27,37,82,-45,19
Livingston,837,1,23,4,9,76,49,27,73
Brechin,837,2,21,4,11,57,41,16,67
Airdrieon,837,3,21,4,11,65,50,15,67
Alloa,837,4,20,6,10,76,43,33,66
Albion,837,5,14,5,17,49,51,-2,47
East Fife,837,6,11,10,15,52,59,-7,43
Queen's Park,837,7,12,5,19,38,55,-17,41
Peterhead,837,8,12,5,19,42,61,-19,41
Stranraer,837,9,11,5,20,50,64,-14,38
Stenhousem'r,837,10,9,4,23,41,73,-32,31
Alloa,838,1,23,7,6,78,35,43,76
Livingston,838,2,21,6,9,79,51,28,69
Airdrieon,838,3,19,6,11,61,50,11,63
Brechin,838,4,17,6,13,57,45,12,57
Albion,838,5,15,7,14,53,57,-4,52
Peterhead,838,6,13,7,16,50,56,-6,46
Stranraer,838,7,12,5,19,43,61,-18,41
Queen's Park,838,8,11,7,18,37,57,-20,40
East Fife,838,9,9,8,19,43,56,-13,35
Stenhousem'r,838,10,5,11,20,45,78,-33,26
Airdrieon,839,1,19,8,9,70,48,22,65
Albion,839,2,19,8,9,62,43,19,65
Livingston,839,3,19,5,12,71,48,23,62
Alloa,839,4,17,10,9,69,49,20,61
Queen's Park,839,5,15,5,16,42,50,-8,50
Peterhead,839,6,14,7,15,48,53,-5,49
Stranraer,839,7,14,4,18,43,51,-8,46
East Fife,839,8,12,9,15,48,48,0,45
Brechin,839,9,11,5,20,41,55,-14,38
Stenhousem'r,839,10,5,9,22,42,91,-49,24
Livingston,840,1,20,4,12,94,59,35,64
Brechin,840,2,18,6,12,54,50,4,60
Alloa,840,3,16,10,10,64,46,18,58
Peterhead,840,4,16,9,11,58,48,10,57
Stranraer,840,5,15,8,13,65,54,11,53
Airdrieon,840,6,15,6,15,46,58,-12,51
Albion,840,7,13,6,17,53,61,-8,45
East Fife,840,8,9,13,14,44,54,-10,40
Queen's Park,840,9,10,7,19,31,52,-21,37
Stenhousem'r,840,10,10,7,19,47,74,-27,37
Brechin,841,1,21,2,13,57,41,16,65
Livingston,841,2,21,2,13,65,51,14,65
Alloa,841,3,17,7,12,67,48,19,58
Airdrieon,841,4,16,6,14,50,52,-2,54
Peterhead,841,5,14,11,11,53,52,1,53
East Fife,841,6,13,8,15,46,42,4,47
Queen's Park,841,7,13,6,17,38,55,-17,45
Albion,841,8,13,5,18,50,60,-10,44
Stranraer,841,9,12,6,18,52,57,-5,42
Stenhousem'r,841,10,10,7,19,52,72,-20,37
Livingston,842,1,20,7,9,71,46,25,67
Alloa,842,2,18,7,11,67,44,23,61
Albion,842,3,16,7,13,56,54,2,55
Brechin,842,4,16,5,15,49,50,-1,53
Airdrieon,842,5,15,8,13,55,58,-3,53
Peterhead,842,6,14,8,14,53,55,-2,50
Queen's Park,842,7,13,7,16,35,50,-15,46
East Fife,842,8,11,8,17,47,49,-2,41
Stranraer,842,9,12,5,19,44,48,-4,41
Stenhousem'r,842,10,10,8,18,52,75,-23,38
Livingston,843,1,20,6,10,78,46,32,66
Albion,843,2,19,6,11,59,45,14,63
Airdrieon,843,3,18,8,10,61,52,9,62
Alloa,843,4,16,8,12,64,53,11,56
Peterhead,843,5,13,15,8,55,45,10,54
Brechin,843,6,15,5,16,58,70,-12,50
Queen's Park,843,7,13,7,16,40,51,-11,46
Stranraer,843,8,12,8,16,55,57,-2,44
East Fife,843,9,10,8,18,36,49,-13,38
Stenhousem'r,843,10,4,9,23,36,74,-38,21
Livingston,844,1,22,3,11,74,45,29,69
Alloa,844,2,20,6,10,73,45,28,66
Brechin,844,3,20,5,11,53,40,13,65
Albion,844,4,18,3,15,61,54,7,57
Peterhead,844,5,17,5,14,55,53,2,56
Stranraer,844,6,15,3,18,49,63,-14,48
Airdrieon,844,7,13,7,16,42,53,-11,46
Queen's Park,844,8,13,5,18,42,54,-12,44
East Fife,844,9,7,11,18,42,52,-10,32
Stenhousem'r,844,10,7,8,21,49,81,-32,29
Livingston,845,1,21,6,9,91,56,35,69
Alloa,845,2,20,8,8,69,42,27,68
Airdrieon,845,3,19,6,11,61,49,12,63
Brechin,845,4,15,9,12,56,47,9,54
Queen's Park,845,5,14,6,16,37,44,-7,48
Stranraer,845,6,12,8,16,50,60,-10,44
Albion,845,7,12,7,17,52,63,-11,43
Peterhead,845,8,11,7,18,44,58,-14,40
East Fife,845,9,10,9,17,44,54,-10,39
Stenhousem'r,845,10,8,10,18,48,79,-31,34
Alloa,846,1,19,8,9,77,44,33,65
Livingston,846,2,19,6,11,70,47,23,63
Airdrieon,846,3,16,9,11,59,52,7,57
Brechin,846,4,17,6,13,54,52,2,57
Stranraer,846,5,15,5,16,57,65,-8,50
Queen's Park,846,6,14,7,15,40,49,-9,49
Albion,846,7,13,7,16,47,48,-1,46
Peterhead,846,8,11,8,17,50,59,-9,41
East Fife,846,9,10,9,17,41,54,-13,39
Stenhousem'r,846,10,8,11,17,46,71,-25,35
Livingston,847,1,26,0,10,89,52,37,78
Alloa,847,2,20,8,8,71,40,31,68
Airdrieon,847,3,16,7,13,54,58,-4,55
Albion,847,4,13,8,15,53,48,5,47
Peterhead,847,5,13,7,16,50,51,-1,46
East Fife,847,6,11,10,15,50,48,2,43
Stranraer,847,7,12,7,17,48,61,-13,43
Stenhousem'r,847,8,11,9,16,56,81,-25,42
Brechin,847,9,11,8,17,42,52,-10,41
Queen's Park,847,10,10,10,16,31,53,-22,40
Alloa,848,1,22,6,8,75,40,35,72
Airdrieon,848,2,20,7,9,65,44,21,67
Livingston,848,3,20,5,11,69,42,27,65
Brechin,848,4,16,5,15,52,51,1,53
Peterhead,848,5,14,7,15,53,56,-3,49
Stranraer,848,6,11,12,13,49,59,-10,45
Albion,848,7,13,5,18,51,55,-4,44
Queen's Park,848,8,12,8,16,38,54,-16,44
East Fife,848,9,10,9,17,45,58,-13,39
Stenhousem'r,848,10,8,4,24,40,78,-38,28
Livingston,849,1,20,5,11,76,55,21,65
Alloa,849,2,18,7,11,68,44,24,61
Peterhead,849,3,17,8,11,54,50,4,59
Brechin,849,4,16,11,9,51,48,3,59
East Fife,849,5,16,7,13,56,39,17,55
Albion,849,6,14,9,13,59,56,3,51
Airdrieon,849,7,13,11,12,56,54,2,50
Queen's Park,849,8,12,8,16,38,53,-15,44
Stranraer,849,9,10,7,19,58,68,-10,37
Stenhousem'r,849,10,5,5,26,39,88,-49,20
Livingston,850,1,21,5,10,76,56,20,68
Brechin,850,2,20,4,12,63,45,18,64
Airdrieon,850,3,17,8,11,60,52,8,59
Alloa,850,4,16,8,12,63,43,20,56
Albion,850,5,15,11,10,60,53,7,56
Stranraer,850,6,15,5,16,57,64,-7,50
Peterhead,850,7,14,6,16,51,54,-3,48
East Fife,850,8,12,8,16,49,50,-1,44
Queen's Park,850,9,10,6,20,34,59,-25,36
Stenhousem'r,850,10,6,7,23,36,73,-37,25
Livingston,851,1,21,5,10,77,50,27,68
Airdrieon,851,2,18,6,12,51,47,4,60
Alloa,851,3,16,10,10,72,50,22,58
East Fife,851,4,16,8,12,61,44,17,56
Brechin,851,5,16,8,12,49,51,-2,56
Peterhead,851,6,12,10,14,44,51,-7,46
Stranraer,851,7,12,8,16,58,57,1,44
Queen's Park,851,8,11,8,17,27,40,-13,41
Albion,851,9,10,9,17,46,63,-17,39
Stenhousem'r,851,10,9,6,21,52,84,-32,33
Alloa,852,1,24,5,7,74,43,31,77
Livingston,852,2,23,6,7,86,42,44,75
Airdrieon,852,3,18,7,11,56,49,7,61
Brechin,852,4,17,4,15,50,47,3,55
Peterhead,852,5,13,7,16,56,60,-4,46
Queen's Park,852,6,12,8,16,43,49,-6,44
Albion,852,7,12,7,17,45,63,-18,43
Stranraer,852,8,11,8,17,55,65,-10,41
East Fife,852,9,10,9,17,48,53,-5,39
Stenhousem'r,852,10,5,9,22,42,84,-42,24
Livingston,853,1,22,2,12,75,46,29,68
Brechin,853,2,19,10,7,52,38,14,67
Airdrieon,853,3,18,7,11,62,52,10,61
Peterhead,853,4,17,6,13,53,47,6,57
Alloa,853,5,14,11,11,54,42,12,53
Stranraer,853,6,14,5,17,45,52,-7,47
Albion,853,7,11,11,14,51,51,0,44
Queen's Park,853,8,10,12,14,37,51,-14,42
East Fife,853,9,11,7,18,41,48,-7,40
Stenhousem'r,853,10,6,5,25,35,78,-43,23
Alloa,854,1,22,6,8,77,42,35,72
Airdrieon,854,2,20,6,10,64,51,13,66
Livingston,854,3,16,10,10,74,51,23,58
Albion,854,4,13,13,10,44,42,2,52
Brechin,854,5,14,8,14,49,51,-2,50
Peterhead,854,6,12,8,16,47,52,-5,44
Stranraer,854,7,13,4,19,53,65,-12,43
Queen's Park,854,8,11,8,17,50,67,-17,41
East Fife,854,9,9,10,17,49,60,-11,37
Stenhousem'r,854,10,8,11,17,53,79,-26,35
Alloa,855,1,20,6,10,72,49,23,66
Airdrieon,855,2,18,9,9,57,39,18,63
Brechin,855,3,16,10,10,49,43,6,58
Livingston,855,4,17,6,13,71,51,20,57
Albion,855,5,15,10,11,52,44,8,55
Peterhead,855,6,13,9,14,46,55,-9,48
Stranraer,855,7,12,6,18,47,66,-19,42
East Fife,855,8,11,8,17,45,50,-5,41
Queen's Park,855,9,11,8,17,38,47,-9,41
Stenhousem'r,855,10,6,10,20,48,81,-33,28
Livingston,856,1,20,4,12,78,54,24,64
Peterhead,856,2,17,6,13,57,48,9,57
Airdrieon,856,3,15,9,12,59,50,9,54
Alloa,856,4,15,9,12,58,53,5,54
Albion,856,5,16,4,16,56,56,0,52
Brechin,856,6,14,7,15,53,51,2,49
Queen's Park,856,7,14,7,15,44,56,-12,49
East Fife,856,8,13,8,15,54,49,5,47
Stranraer,856,9,13,7,16,46,53,-7,46
Stenhousem'r,856,10,8,9,19,44,79,-35,33
Livingston,857,1,20,6,10,81,50,31,66
Brechin,857,2,17,10,9,53,36,17,61
Alloa,857,3,18,7,11,67,54,13,61
Airdrieon,857,4,14,8,14,60,57,3,50
Stranraer,857,5,14,8,14,53,55,-2,50
Albion,857,6,12,10,14,46,54,-8,46
Peterhead,857,7,11,11,14,53,56,-3,44
Queen's Park,857,8,12,8,16,32,45,-13,44
East Fife,857,9,8,14,14,49,50,-1,38
Stenhousem'r,857,10,7,12,17,37,74,-37,33
Alloa,858,1,19,9,8,66,41,25,66
Livingston,858,2,19,4,13,77,50,27,61
Albion,858,3,16,8,12,67,51,16,56
East Fife,858,4,14,12,10,58,46,12,54
Airdrieon,858,5,16,6,14,66,60,6,54
Brechin,858,6,14,6,16,51,60,-9,48
Peterhead,858,7,13,8,15,54,57,-3,47
Stranraer,858,8,12,7,17,45,57,-12,43
Queen's Park,858,9,12,7,17,36,61,-25,43
Stenhousem'r,858,10,7,9,20,43,80,-37,30
Livingston,859,1,21,3,12,75,43,32,66
Alloa,859,2,19,8,9,65,38,27,65
Airdrieon,859,3,17,7,12,59,56,3,58
Brechin,859,4,18,2,16,47,52,-5,56
Albion,859,5,16,7,13,66,57,9,55
Queen's Park,859,6,15,6,15,38,47,-9,51
Peterhead,859,7,13,7,16,48,52,-4,46
Stranraer,859,8,13,5,18,52,60,-8,44
East Fife,859,9,11,9,16,45,53,-8,42
Stenhousem'r,859,10,7,6,23,45,82,-37,27
Livingston,860,1,24,2,10,75,41,34,74
Alloa,860,2,19,6,11,73,41,32,63
Airdrieon,860,3,17,6,13,56,50,6,57
Brechin,860,4,16,5,15,52,53,-1,53
East Fife,860,5,14,10,12,50,42,8,52
Stranraer,860,6,14,9,13,58,65,-7,51
Albion,860,7,13,8,15,55,59,-4,47
Peterhead,860,8,12,8,16,43,51,-8,44
Queen's Park,860,9,10,7,19,34,61,-27,37
Stenhousem'r,860,10,5,11,20,45,78,-33,26
Alloa,861,1,20,7,9,75,51,24,67
Airdrieon,861,2,19,9,8,64,46,18,66
Livingston,861,3,17,8,11,70,46,24,59
Brechin,861,4,14,10,12,55,51,4,52
Stranraer,861,5,13,9,14,54,60,-6,48
East Fife,861,6,12,9,15,42,46,-4,45
Peterhead,861,7,13,6,17,42,51,-9,45
Albion,861,8,11,8,17,57,65,-8,41
Stenhousem'r,861,9,11,6,19,40,61,-21,39
Queen's Park,861,10,9,10,17,32,54,-22,37
Livingston,862,1,22,5,9,81,47,34,71
Airdrieon,862,2,19,8,9,66,54,12,65
Alloa,862,3,16,11,9,73,43,30,59
Stranraer,862,4,14,7,15,60,56,4,49
Albion,862,5,11,12,13,44,43,1,45
Queen's Park,862,6,13,6,17,31,51,-20,45
Brechin,862,7,12,8,16,45,59,-14,44
Peterhead,862,8,11,11,14,43,57,-14,44
East Fife,862,9,10,9,17,45,49,-4,39
Stenhousem'r,862,10,9,9,18,52,81,-29,36
Livingston,863,1,22,5,9,76,44,32,71
Alloa,863,2,19,10,7,76,45,31,67
Brechin,863,3,18,3,15,53,48,5,57
Airdrieon,863,4,15,7,14,52,54,-2,52
East Fife,863,5,14,9,13,48,40,8,51
Queen's Park,863,6,13,11,12,40,43,-3,50
Peterhead,863,7,14,6,16,52,62,-10,48
Albion,863,8,12,8,16,50,57,-7,44
Stranraer,863,9,11,6,19,44,62,-18,39
Stenhousem'r,863,10,6,7,23,45,81,-36,25
Alloa,864,1,20,7,9,79,47,32,67
Livingston,864,1,20,7,9,79,47,32,67
East Fife,864,3,16,7,13,55,43,12,55
Brechin,864,4,16,6,14,53,56,-3,54
Airdrieon,864,5,14,9,13,58,53,5,51
Albion,864,5,14,9,13,58,53,5,51
Peterhead,864,7,13,8,15,54,64,-10,47
Stranraer,864,8,12,10,14,56,64,-8,46
Queen's Park,864,9,10,8,18,33,54,-21,38
Stenhousem'r,864,10,6,7,23,42,86,-44,25
Livingston,865,1,20,4,12,67,50,17,64
Queen's Park,865,2,18,7,11,46,39,7,61
Alloa,865,3,16,9,11,72,53,19,57
Airdrieon,865,4,17,6,13,74,61,13,57
Brechin,865,5,15,5,16,50,55,-5,50
Peterhead,865,6,13,10,13,50,52,-2,49
Albion,865,7,13,10,13,49,52,-3,49
East Fife,865,8,12,10,14,49,47,2,46
Stranraer,865,9,12,7,17,56,64,-8,43
Stenhousem'r,865,10,6,8,22,43,83,-40,26
Livingston,866,1,22,3,11,74,50,24,69
Airdrieon,866,2,20,7,9,59,44,15,67
Alloa,866,3,15,12,9,70,45,25,57
Albion,866,4,14,9,13,55,52,3,51
Peterhead,866,5,13,9,14,48,57,-9,48
Brechin,866,6,13,7,16,46,51,-5,46
Queen's Park,866,7,12,9,15,37,49,-12,45
Stranraer,866,8,12,8,16,43,51,-8,44
East Fife,866,9,9,12,15,45,46,-1,39
Stenhousem'r,866,10,8,8,20,48,80,-32,32
Livingston,867,1,21,4,11,77,50,27,67
Alloa,867,2,17,10,9,71,40,31,61
Airdrieon,867,3,18,3,15,54,56,-2,57
Stranraer,867,4,16,4,16,48,51,-3,52
Albion,867,5,13,10,13,54,52,2,49
Peterhead,867,6,14,7,15,45,49,-4,49
Queen's Park,867,7,14,7,15,39,50,-11,49
Brechin,867,8,14,6,16,50,56,-6,48
East Fife,867,9,11,8,17,49,53,-4,41
Stenhousem'r,867,10,10,5,21,50,80,-30,35
Livingston,868,1,22,6,8,81,44,37,72
Airdrieon,868,2,19,6,11,64,53,11,63
Alloa,868,3,17,10,9,73,43,30,61
Brechin,868,4,15,8,13,47,52,-5,53
Albion,868,5,13,9,14,56,59,-3,48
Stranraer,868,6,12,9,15,52,52,0,45
East Fife,868,7,11,11,14,48,51,-3,44
Peterhead,868,8,12,8,16,44,53,-9,44
Queen's Park,868,9,10,10,16,33,55,-22,40
Stenhousem'r,868,10,6,9,21,42,78,-36,27
Livingston,869,1,21,3,12,73,47,26,66
Alloa,869,2,19,8,9,71,42,29,65
Peterhead,869,3,18,8,10,53,43,10,62
Airdrieon,869,4,17,7,12,63,54,9,58
Brechin,869,5,15,9,12,55,49,6,54
Stranraer,869,6,12,9,15,55,61,-6,45
Queen's Park,869,7,10,10,16,39,57,-18,40
East Fife,869,8,10,9,17,42,52,-10,39
Albion,869,9,10,8,18,47,67,-20,38
Stenhousem'r,869,10,9,7,20,47,73,-26,34
Livingston,870,1,25,3,8,88,40,48,78
Alloa,870,2,20,8,8,80,49,31,68
Brechin,870,3,15,11,10,50,41,9,56
Airdrieon,870,4,15,8,13,58,57,1,53
Stranraer,870,5,14,5,17,47,59,-12,47
East Fife,870,6,12,7,17,43,47,-4,43
Albion,870,7,11,9,16,47,48,-1,42
Peterhead,870,8,10,10,16,48,62,-14,40
Queen's Park,870,9,10,9,17,35,59,-24,39
Stenhousem'r,870,10,8,10,18,53,87,-34,34
Livingston,871,1,19,5,12,63,43,20,62
Alloa,871,2,17,7,12,73,48,25,58
Airdrieon,871,3,16,10,10,70,58,12,58
Brechin,871,4,16,9,11,51,47,4,57
Stranraer,871,5,15,6,15,55,56,-1,51
Peterhead,871,6,14,9,13,50,51,-1,51
Albion,871,7,13,10,13,46,56,-10,49
East Fife,871,8,13,8,15,53,54,-1,47
Queen's Park,871,9,9,7,20,35,52,-17,34
Stenhousem'r,871,10,9,7,20,41,72,-31,34
Livingston,872,1,24,4,8,87,54,33,76
Alloa,872,2,19,6,11,72,45,27,63
Airdrieon,872,3,16,9,11,62,59,3,57
East Fife,872,4,14,9,13,66,50,16,51
Peterhead,872,5,14,9,13,50,47,3,51
Brechin,872,6,14,8,14,50,54,-4,50
Stranraer,872,7,11,10,15,55,66,-11,43
Queen's Park,872,8,11,8,17,38,52,-14,41
Albion,872,9,10,9,17,47,58,-11,39
Stenhousem'r,872,10,9,4,23,48,90,-42,31
Livingston,873,1,21,3,12,74,54,20,66
Airdrieon,873,2,18,9,9,62,46,16,63
Brechin,873,3,18,7,11,56,46,10,61
Alloa,873,4,17,7,12,70,52,18,58
Albion,873,5,16,6,14,55,51,4,54
Stranraer,873,6,12,9,15,53,62,-9,45
Peterhead,873,7,9,12,15,42,53,-11,39
Queen's Park,873,8,10,9,17,34,47,-13,39
Stenhousem'r,873,9,10,9,17,49,75,-26,39
East Fife,873,10,8,11,17,42,51,-9,35
Livingston,874,1,24,4,8,79,36,43,76
Airdrieon,874,2,20,5,11,66,52,14,65
Brechin,874,3,17,8,11,48,41,7,59
Alloa,874,4,16,9,11,67,46,21,57
Queen's Park,874,5,14,7,15,36,48,-12,49
Stranraer,874,6,13,6,17,44,53,-9,45
East Fife,874,7,11,10,15,52,53,-1,43
Albion,874,8,11,7,18,42,59,-17,40
Peterhead,874,9,9,10,17,46,59,-13,37
Stenhousem'r,874,10,8,8,20,49,82,-33,32
Livingston,875,1,22,5,9,77,46,31,71
Airdrieon,875,2,20,5,11,65,53,12,65
Alloa,875,3,18,7,11,63,47,16,61
Brechin,875,4,16,7,13,50,44,6,55
Albion,875,5,14,10,12,58,48,10,52
Queen's Park,875,6,13,8,15,39,49,-10,47
Peterhead,875,7,12,8,16,43,57,-14,44
Stranraer,875,8,13,3,20,51,60,-9,42
Stenhousem'r,875,9,10,6,20,46,70,-24,36
East Fife,875,10,8,9,19,39,57,-18,33
Alloa,876,1,21,5,10,69,43,26,68
Brechin,876,2,19,3,14,54,46,8,60
Airdrieon,876,3,17,7,12,68,54,14,58
East Fife,876,4,15,9,12,56,47,9,54
Livingston,876,5,16,5,15,65,60,5,53
Stranraer,876,6,16,5,15,49,53,-4,53
Albion,876,7,14,8,14,64,53,11,50
Queen's Park,876,8,15,2,19,46,58,-12,47
Peterhead,876,9,10,11,15,43,58,-15,41
Stenhousem'r,876,10,6,7,23,47,89,-42,25
Livingston,877,1,24,5,7,83,45,38,77
Alloa,877,2,23,5,8,73,42,31,74
Brechin,877,3,18,10,8,50,38,12,64
Airdrieon,877,4,16,4,16,64,65,-1,52
East Fife,877,5,12,7,17,45,49,-4,43
Stranraer,877,6,11,10,15,47,56,-9,43
Peterhead,877,7,12,6,18,48,53,-5,42
Albion,877,8,10,8,18,54,64,-10,38
Queen's Park,877,9,10,8,18,38,60,-22,38
Stenhousem'r,877,10,10,5,21,54,84,-30,35
Alloa,878,1,23,5,8,75,42,33,74
Livingston,878,2,20,5,11,73,51,22,65
Airdrieon,878,3,16,7,13,63,65,-2,55
Queen's Park,878,4,16,6,14,51,50,1,54
Brechin,878,5,16,6,14,59,63,-4,54
Albion,878,6,13,7,16,60,62,-2,46
East Fife,878,7,11,10,15,53,47,6,43
Peterhead,878,8,12,7,17,50,56,-6,43
Stranraer,878,9,12,6,18,47,54,-7,42
Stenhousem'r,878,10,9,5,22,46,87,-41,32
Livingston,879,1,24,3,9,85,47,38,75
Alloa,879,2,17,9,10,62,45,17,60
East Fife,879,3,17,7,12,58,44,14,58
Airdrieon,879,4,17,7,12,57,54,3,58
Albion,879,5,14,9,13,54,52,2,51
Brechin,879,6,14,9,13,52,59,-7,51
Queen's Park,879,7,12,8,16,36,48,-12,44
Stranraer,879,8,12,6,18,52,56,-4,42
Peterhead,879,9,10,8,18,48,56,-8,38
Stenhousem'r,879,10,6,8,22,40,83,-43,26
Airdrieon,880,1,23,5,8,68,47,21,74
Alloa,880,2,21,5,10,79,46,33,68
Livingston,880,3,21,2,13,78,52,26,65
Brechin,880,4,18,4,14,54,50,4,58
Albion,880,5,16,9,11,52,47,5,57
Stranraer,880,6,14,6,16,56,63,-7,48
Peterhead,880,7,12,7,17,44,59,-15,43
Queen's Park,880,8,9,6,21,37,63,-26,33
Stenhousem'r,880,9,9,6,21,54,82,-28,33
East Fife,880,10,7,10,19,46,59,-13,31
Alloa,881,1,24,7,5,79,34,45,79
Livingston,881,2,21,5,10,73,51,22,68
Peterhead,881,3,17,5,14,55,51,4,56
Albion,881,4,15,8,13,63,54,9,53
Airdrieon,881,5,15,5,16,64,62,2,50
Brechin,881,6,13,9,14,50,50,0,48
Stranraer,881,7,11,7,18,43,60,-17,40
Queen's Park,881,8,9,11,16,33,58,-25,38
East Fife,881,9,9,10,17,43,49,-6,37
Stenhousem'r,881,10,9,7,20,57,91,-34,34
Livingston,882,1,22,3,11,77,50,27,69
Alloa,882,2,20,8,8,74,42,32,68
Airdrieon,882,3,18,7,11,58,46,12,61
East Fife,882,4,14,10,12,52,47,5,52
Peterhead,882,5,14,7,15,50,52,-2,49
Queen's Park,882,6,15,4,17,42,48,-6,49
Brechin,882,7,14,7,15,40,46,-6,49
Albion,882,8,12,5,19,51,63,-12,41
Stranraer,882,9,9,11,16,56,68,-12,38
Stenhousem'r,882,10,7,8,21,38,76,-38,29
Livingston,883,1,23,3,10,89,48,41,72
Alloa,883,2,20,8,8,70,41,29,68
Brechin,883,3,16,6,14,45,43,2,54
Airdrieon,883,4,16,6,14,52,64,-12,54
Peterhead,883,5,14,7,15,50,48,2,49
Albion,883,6,14,7,15,44,58,-14,49
Stranraer,883,7,12,9,15,47,56,-9,45
East Fife,883,8,12,7,17,51,49,2,43
Queen's Park,883,9,13,3,20,47,55,-8,42
Stenhousem'r,883,10,9,6,21,44,77,-33,33
Livingston,884,1,21,6,9,71,43,28,69
Alloa,884,2,16,10,10,63,40,23,58
Albion,884,3,16,7,13,53,46,7,55
Brechin,884,4,15,10,11,50,50,0,55
Airdrieon,884,5,15,9,12,52,46,6,54
Queen's Park,884,6,13,10,13,39,45,-6,49
Peterhead,884,7,13,8,15,42,51,-9,47
Stranraer,884,8,12,7,17,43,51,-8,43
East Fife,884,9,10,12,14,47,46,1,42
Stenhousem'r,884,10,4,11,21,38,80,-42,23
Livingston,885,1,22,7,7,77,46,31,73
Alloa,885,2,20,9,7,80,44,36,69
Brechin,885,3,19,5,12,57,48,9,62
Albion,885,4,14,11,11,56,55,1,53
East Fife,885,5,13,9,14,57,51,6,48
Airdrieon,885,6,14,6,16,60,72,-12,48
Stranraer,885,7,12,5,19,49,57,-8,41
Peterhead,885,8,10,10,16,46,55,-9,40
Queen's Park,885,9,10,8,18,32,53,-21,38
Stenhousem'r,885,10,7,8,21,48,81,-33,29
Livingston,886,1,23,4,9,80,42,38,73
Alloa,886,2,21,5,10,72,44,28,68
Albion,886,3,18,7,11,55,40,15,61
Airdrieon,886,4,14,9,13,52,54,-2,51
Brechin,886,5,16,3,17,43,52,-9,51
Peterhead,886,6,12,7,17,42,50,-8,43
Stranraer,886,7,12,7,17,46,55,-9,43
East Fife,886,8,11,9,16,42,47,-5,42
Queen's Park,886,9,12,6,18,39,58,-19,42
Stenhousem'r,886,10,8,9,19,51,80,-29,33
Livingston,887,1,22,3,11,74,47,27,69
Alloa,887,2,20,6,10,73,50,23,66
Brechin,887,3,19,6,11,56,40,16,63
Airdrieon,887,4,18,6,12,73,56,17,60
Queen's Park,887,5,16,5,15,41,49,-8,53
Peterhead,887,6,14,9,13,54,58,-4,51
Albion,887,7,11,12,13,46,50,-4,45
East Fife,887,8,9,9,18,47,60,-13,36
Stranraer,887,9,10,6,20,49,64,-15,36
Stenhousem'r,887,10,7,6,23,42,81,-39,27
Alloa,888,1,20,5,11,77,49,28,65
Airdrieon,888,2,20,5,11,65,55,10,65
Livingston,888,3,20,4,12,85,58,27,64
Brechin,888,4,17,8,11,56,42,14,59
Peterhead,888,5,15,7,14,48,50,-2,52
East Fife,888,6,13,10,13,55,49,6,49
Albion,888,7,13,7,16,59,65,-6,46
Queen's Park,888,8,13,7,16,48,64,-16,46
Stranraer,888,9,10,6,20,46,69,-23,36
Stenhousem'r,888,10,7,5,24,58,96,-38,26
Livingston,889,1,20,8,8,82,47,35,68
Peterhead,889,2,20,8,8,61,47,14,68
Alloa,889,3,20,5,11,77,44,33,65
Albion,889,4,16,9,11,57,50,7,57
Brechin,889,5,16,7,13,49,45,4,55
Airdrieon,889,6,14,7,15,56,61,-5,49
East Fife,889,7,11,10,15,43,48,-5,43
Queen's Park,889,8,9,11,16,34,53,-19,38
Stranraer,889,9,9,8,19,44,64,-20,35
Stenhousem'r,889,10,5,7,24,37,81,-44,22
Alloa,890,1,22,8,6,76,39,37,74
Livingston,890,2,23,2,11,78,50,28,71
Peterhead,890,3,18,7,11,55,46,9,61
Albion,890,4,16,6,14,56,51,5,54
East Fife,890,5,14,8,14,47,45,2,50
Brechin,890,6,14,7,15,46,42,4,49
Airdrieon,890,7,11,11,14,45,56,-11,44
Stranraer,890,8,11,6,19,47,60,-13,39
Stenhousem'r,890,9,8,8,20,40,68,-28,32
Queen's Park,890,10,8,7,21,31,64,-33,31
Livingston,891,1,19,6,11,69,46,23,63
Stranraer,891,2,17,8,11,67,55,12,59
Peterhead,891,3,17,8,11,54,48,6,59
Alloa,891,4,15,10,11,56,46,10,55
Airdrieon,891,5,14,9,13,55,57,-2,51
Albion,891,6,14,8,14,57,53,4,50
Brechin,891,7,14,6,16,50,52,-2,48
East Fife,891,8,11,12,13,55,46,9,45
Queen's Park,891,9,13,6,17,39,53,-14,45
Stenhousem'r,891,10,5,9,22,37,83,-46,24
Livingston,892,1,20,9,7,87,49,38,69
Alloa,892,2,18,10,8,60,37,23,64
Brechin,892,3,16,8,12,52,56,-4,56
Stranraer,892,4,16,6,14,56,61,-5,54
Airdrieon,892,5,15,7,14,59,56,3,52
Queen's Park,892,6,13,6,17,40,53,-13,45
Peterhead,892,7,11,10,15,43,49,-6,43
East Fife,892,8,11,9,16,46,51,-5,42
Albion,892,9,10,11,15,54,62,-8,41
Stenhousem'r,892,10,6,12,18,44,67,-23,30
Alloa,893,1,21,7,8,70,39,31,70
Livingston,893,2,20,4,12,78,47,31,64
Airdrieon,893,3,16,7,13,53,58,-5,55
Brechin,893,4,15,8,13,49,47,2,53
Albion,893,5,15,8,13,53,58,-5,53
Queen's Park,893,6,14,7,15,47,54,-7,49
Stranraer,893,7,13,5,18,52,62,-10,44
Peterhead,893,8,12,7,17,55,59,-4,43
East Fife,893,9,9,12,15,48,52,-4,39
Stenhousem'r,893,10,10,5,21,52,81,-29,35
Alloa,894,1,23,4,9,67,38,29,73
Livingston,894,2,18,11,7,73,47,26,65
Airdrieon,894,3,18,7,11,58,48,10,61
Albion,894,4,14,14,8,52,42,10,56
Queen's Park,894,5,15,6,15,41,52,-11,51
Peterhead,894,6,13,7,16,47,48,-1,46
Brechin,894,7,14,4,18,39,53,-14,46
East Fife,894,8,10,10,16,50,49,1,40
Stranraer,894,9,9,7,20,43,60,-17,34
Stenhousem'r,894,10,6,10,20,50,83,-33,28
Airdrieon,895,1,17,10,9,55,46,9,61
Livingston,895,2,18,4,14,69,56,13,58
Peterhead,895,3,15,11,10,52,48,4,56
Alloa,895,4,15,10,11,57,43,14,55
Brechin,895,5,16,6,14,47,47,0,54
East Fife,895,6,12,11,13,48,45,3,47
Albion,895,7,11,10,15,43,46,-3,43
Queen's Park,895,8,13,4,19,33,46,-13,43
Stenhousem'r,895,9,12,7,17,50,64,-14,43
Stranraer,895,10,11,7,18,50,63,-13,40
Albion,896,1,18,10,8,67,49,18,64
Alloa,896,2,17,8,11,58,38,20,59
Livingston,896,3,16,10,10,68,50,18,58
Airdrieon,896,4,16,8,12,57,48,9,56
East Fife,896,5,16,7,13,51,39,12,55
Peterhead,896,6,16,7,13,52,52,0,55
Brechin,896,7,14,7,15,50,47,3,49
Stranraer,896,8,13,8,15,48,56,-8,47
Stenhousem'r,896,9,6,11,19,42,73,-31,29
Queen's Park,896,10,8,4,24,27,68,-41,28
Livingston,897,1,22,4,10,86,44,42,70
Airdrieon,897,2,19,5,12,62,45,17,62
Albion,897,3,17,7,12,62,47,15,58
Peterhead,897,4,15,7,14,58,53,5,52
Alloa,897,5,14,10,12,54,49,5,52
Brechin,897,6,16,4,16,44,49,-5,52
Stranraer,897,7,15,4,17,53,57,-4,49
East Fife,897,8,12,7,17,44,54,-10,43
Queen's Park,897,9,10,7,19,29,60,-31,37
Stenhousem'r,897,10,9,7,20,46,80,-34,34
Livingston,898,1,22,5,9,84,48,36,71
Brechin,898,2,16,8,12,54,43,11,56
Stranraer,898,3,17,5,14,56,53,3,56
Airdrieon,898,4,16,7,13,57,52,5,55
Queen's Park,898,5,15,8,13,40,44,-4,53
Alloa,898,6,14,10,12,61,48,13,52
Peterhead,898,7,14,7,15,46,53,-7,49
East Fife,898,8,10,14,12,48,49,-1,44
Albion,898,9,10,7,19,52,69,-17,37
Stenhousem'r,898,10,6,9,21,46,85,-39,27
Livingston,899,1,20,5,11,77,54,23,65
Brechin,899,2,18,9,9,64,42,22,63
Alloa,899,3,19,5,12,78,50,28,62
Airdrieon,899,4,16,8,12,63,58,5,56
Albion,899,5,15,7,14,66,67,-1,52
Stranraer,899,6,15,5,16,52,58,-6,50
Peterhead,899,7,12,10,14,57,57,0,46
Queen's Park,899,8,12,8,16,39,58,-19,44
East Fife,899,9,9,9,18,47,63,-16,36
Stenhousem'r,899,10,6,10,20,57,93,-36,28
Livingston,900,1,21,2,13,69,49,20,65
Alloa,900,2,18,9,9,71,47,24,63
Airdrieon,900,3,19,5,12,73,63,10,62
Brechin,900,4,17,7,12,53,41,12,58
Stranraer,900,5,15,6,15,54,52,2,51
Albion,900,6,14,7,15,52,57,-5,49
East Fife,900,7,12,10,14,49,47,2,46
Queen's Park,900,8,13,5,18,41,54,-13,44
Peterhead,900,9,12,6,18,45,58,-13,42
Stenhousem'r,900,10,6,9,21,42,81,-39,27
Alloa,901,1,22,7,7,79,39,40,73
Airdrieon,901,2,17,8,11,62,49,13,59
Brechin,901,3,16,8,12,52,48,4,56
Livingston,901,4,16,6,14,68,56,12,54
Albion,901,5,15,7,14,56,51,5,52
Peterhead,901,6,14,7,15,53,56,-3,49
East Fife,901,7,12,9,15,56,58,-2,45
Queen's Park,901,8,13,6,17,36,60,-24,45
Stenhousem'r,901,9,10,8,18,57,79,-22,38
Stranraer,901,10,8,8,20,51,74,-23,32
Airdrieon,902,1,21,6,9,66,46,20,69
Livingston,902,2,20,5,11,86,54,32,65
Alloa,902,3,17,10,9,73,47,26,61
Albion,902,4,15,7,14,56,51,5,52
Brechin,902,5,15,7,14,54,58,-4,52
Stranraer,902,6,14,8,14,53,54,-1,50
Peterhead,902,7,13,7,16,49,59,-10,46
Queen's Park,902,8,13,5,18,44,58,-14,44
East Fife,902,9,9,9,18,42,55,-13,36
Stenhousem'r,902,10,9,4,23,44,85,-41,31
Peterhead,903,1,20,7,9,60,37,23,67
Alloa,903,2,17,9,10,59,40,19,60
Livingston,903,3,18,4,14,61,45,16,58
Airdrieon,903,4,18,4,14,58,55,3,58
Stranraer,903,5,15,8,13,49,47,2,53
Brechin,903,6,14,10,12,44,41,3,52
Albion,903,7,14,5,17,53,62,-9,47
Queen's Park,903,8,11,7,18,32,49,-17,40
East Fife,903,9,10,8,18,51,56,-5,38
Stenhousem'r,903,10,8,8,20,43,78,-35,32
Livingston,904,1,18,7,11,76,49,27,61
Airdrieon,904,2,18,6,12,58,54,4,60
Alloa,904,3,15,10,11,70,50,20,55
Stranraer,904,4,15,8,13,57,55,2,53
Albion,904,5,14,10,12,57,51,6,52
Brechin,904,6,14,7,15,54,52,2,49
Queen's Park,904,7,14,7,15,41,56,-15,49
East Fife,904,8,12,9,15,48,50,-2,45
Peterhead,904,9,12,7,17,45,58,-13,43
Stenhousem'r,904,10,9,7,20,49,80,-31,34
Livingston,905,1,24,2,10,74,45,29,74
Brechin,905,2,18,8,10,57,42,15,62
Alloa,905,3,17,8,11,69,54,15,59
Peterhead,905,4,18,4,14,60,52,8,58
Airdrieon,905,5,15,7,14,54,56,-2,52
Albion,905,6,12,10,14,50,51,-1,46
Queen's Park,905,7,12,7,17,31,45,-14,43
East Fife,905,8,11,8,17,44,52,-8,41
Stenhousem'r,905,9,11,6,19,53,74,-21,39
Stranraer,905,10,9,6,21,43,64,-21,33
Livingston,906,1,22,3,11,87,48,39,69
Alloa,906,2,18,7,11,66,47,19,61
Peterhead,906,3,16,8,12,56,56,0,56
Albion,906,4,16,6,14,58,59,-1,54
Stranraer,906,5,14,8,14,57,55,2,50
Brechin,906,6,15,5,16,47,57,-10,50
East Fife,906,7,13,9,14,60,49,11,48
Airdrieon,906,8,11,10,15,43,53,-10,43
Stenhousem'r,906,9,11,7,18,50,77,-27,40
Queen's Park,906,10,9,7,20,35,58,-23,34
Livingston,907,1,19,6,11,72,48,24,63
Airdrieon,907,2,17,10,9,55,42,13,61
Alloa,907,3,17,9,10,67,46,21,60
Peterhead,907,4,14,10,12,48,45,3,52
Brechin,907,5,14,7,15,52,62,-10,49
Albion,907,6,12,12,12,55,55,0,48
East Fife,907,7,11,13,12,49,43,6,46
Queen's Park,907,8,11,11,14,42,49,-7,44
Stranraer,907,9,10,7,19,49,68,-19,37
Stenhousem'r,907,10,9,7,20,40,71,-31,34
Livingston,908,1,23,3,10,72,39,33,72
Alloa,908,2,18,9,9,79,46,33,63
Airdrieon,908,3,18,9,9,60,49,11,63
Albion,908,4,14,9,13,52,49,3,51
Brechin,908,5,14,7,15,54,58,-4,49
Peterhead,908,6,13,8,15,53,55,-2,47
East Fife,908,7,12,10,14,49,47,2,46
Stranraer,908,8,12,7,17,51,62,-11,43
Queen's Park,908,9,11,9,16,37,55,-18,42
Stenhousem'r,908,10,6,7,23,37,84,-47,25
Livingston,909,1,20,7,9,72,42,30,67
Airdrieon,909,2,18,9,9,57,44,13,63
Alloa,909,3,17,11,8,70,46,24,62
Brechin,909,4,15,9,12,52,48,4,54
East Fife,909,5,14,9,13,53,45,8,51
Stranraer,909,6,14,6,16,50,58,-8,48
Peterhead,909,7,11,7,18,47,58,-11,40
Albion,909,8,10,10,16,41,54,-13,40
Queen's Park,909,9,11,5,20,33,52,-19,38
Stenhousem'r,909,10,9,9,18,50,78,-28,36
Alloa,910,1,23,4,9,75,38,37,73
Livingston,910,2,21,6,9,80,50,30,69
Brechin,910,3,18,5,13,58,53,5,59
Airdrieon,910,4,15,11,10,69,57,12,56
Stranraer,910,5,16,4,16,66,65,1,52
Peterhead,910,6,13,9,14,52,67,-15,48
Albion,910,7,11,11,14,60,64,-4,44
Queen's Park,910,8,10,11,15,38,55,-17,41
East Fife,910,9,7,11,18,44,57,-13,32
Stenhousem'r,910,10,7,6,23,50,86,-36,27
Livingston,911,1,24,4,8,90,45,45,76
Alloa,911,2,19,7,10,73,50,23,64
Albion,911,3,18,6,12,54,45,9,60
Airdrieon,911,4,17,7,12,63,57,6,58
Brechin,911,5,15,7,14,49,49,0,52
Queen's Park,911,6,12,8,16,44,61,-17,44
East Fife,911,7,11,9,16,52,52,0,42
Peterhead,911,8,10,10,16,40,56,-16,40
Stranraer,911,9,10,6,20,45,67,-22,36
Stenhousem'r,911,10,9,6,21,47,75,-28,33
Alloa,912,1,21,3,12,82,56,26,66
Airdrieon,912,2,19,6,11,69,55,14,63
Livingston,912,3,20,3,13,66,54,12,63
Albion,912,4,16,8,12,56,47,9,56
East Fife,912,5,16,8,12,55,47,8,56
Stranraer,912,6,15,3,18,64,63,1,48
Peterhead,912,7,15,3,18,43,51,-8,48
Queen's Park,912,8,12,6,18,39,54,-15,42
Brechin,912,9,12,4,20,46,56,-10,40
Stenhousem'r,912,10,7,10,19,53,90,-37,31
Livingston,913,1,20,6,10,73,47,26,66
Albion,913,2,17,9,10,56,46,10,60
Alloa,913,3,17,8,11,70,49,21,59
Airdrieon,913,4,17,6,13,60,60,0,57
Brechin,913,5,16,7,13,57,52,5,55
Stranraer,913,6,14,7,15,51,50,1,49
Peterhead,913,7,13,7,16,56,70,-14,46
East Fife,913,8,13,5,18,50,53,-3,44
Queen's Park,913,9,10,8,18,37,54,-17,38
Stenhousem'r,913,10,8,7,21,45,74,-29,31
Livingston,914,1,22,4,10,80,55,25,70
Alloa,914,2,17,9,10,69,50,19,60
Brechin,914,3,18,5,13,58,51,7,59
Albion,914,4,16,7,13,60,53,7,55
Airdrieon,914,5,14,9,13,58,60,-2,51
East Fife,914,6,13,9,14,55,51,4,48
Peterhead,914,7,14,6,16,51,56,-5,48
Stranraer,914,8,14,5,17,54,58,-4,47
Queen's Park,914,9,11,4,21,35,59,-24,37
Stenhousem'r,914,10,7,10,19,46,73,-27,31
Livingston,915,1,23,5,8,84,46,38,74
Alloa,915,2,23,4,9,77,43,34,73
Brechin,915,3,16,8,12,64,54,10,56
Peterhead,915,4,14,11,11,49,43,6,53
Airdrieon,915,5,12,11,13,60,64,-4,47
Stranraer,915,6,13,7,16,52,62,-10,46
Queen's Park,915,7,12,7,17,37,50,-13,43
East Fife,915,8,10,10,16,47,54,-7,40
Stenhousem'r,915,9,9,11,16,48,81,-33,38
Albion,915,10,7,8,21,44,65,-21,29
Livingston,916,1,22,3,11,78,46,32,69
Alloa,916,2,21,6,9,67,44,23,69
East Fife,916,3,16,7,13,55,43,12,55
Brechin,916,4,17,4,15,50,50,0,55
Stranraer,916,5,17,3,16,55,52,3,54
Airdrieon,916,6,14,9,13,56,52,4,51
Peterhead,916,7,13,9,14,46,53,-7,48
Albion,916,8,11,8,17,45,53,-8,41
Queen's Park,916,9,11,8,17,30,43,-13,41
Stenhousem'r,916,10,5,9,22,44,90,-46,24
Livingston,917,1,21,9,6,72,35,37,72
Alloa,917,2,19,8,9,67,40,27,65
Airdrieon,917,3,19,7,10,59,51,8,64
Brechin,917,4,15,9,12,43,41,2,54
Peterhead,917,5,13,9,14,42,47,-5,48
Stranraer,917,6,12,9,15,43,52,-9,45
Queen's Park,917,7,12,7,17,39,50,-11,43
Albion,917,8,10,12,14,46,47,-1,42
East Fife,917,9,9,10,17,36,48,-12,37
Stenhousem'r,917,10,6,8,22,39,75,-36,26
Livingston,918,1,21,5,10,84,50,34,68
Brechin,918,2,20,6,10,56,45,11,66
Alloa,918,3,16,13,7,64,42,22,61
Airdrieon,918,4,18,7,11,63,49,14,61
Albion,918,5,13,12,11,49,44,5,51
Peterhead,918,6,12,10,14,53,62,-9,46
Queen's Park,918,7,11,7,18,41,67,-26,40
Stranraer,918,8,10,9,17,49,59,-10,39
East Fife,918,9,9,10,17,40,44,-4,37
Stenhousem'r,918,10,7,7,22,47,84,-37,28
Livingston,919,1,22,5,9,75,43,32,71
Alloa,919,2,17,11,8,68,43,25,62
Brechin,919,3,18,7,11,48,41,7,61
Albion,919,4,16,6,14,49,48,1,54
Peterhead,919,5,14,8,14,50,51,-1,50
Airdrieon,919,6,13,11,12,51,53,-2,50
Queen's Park,919,7,12,7,17,36,54,-18,43
East Fife,919,8,10,10,16,51,53,-2,40
Stenhousem'r,919,9,8,12,16,47,67,-20,36
Stranraer,919,10,7,9,20,48,70,-22,30
Livingston,920,1,20,4,12,81,46,35,64
Alloa,920,2,18,8,10,59,37,22,62
Brechin,920,3,16,8,12,44,38,6,56
Peterhead,920,4,16,7,13,47,45,2,55
Stranraer,920,5,16,3,17,52,61,-9,51
Airdrieon,920,6,15,5,16,52,55,-3,50
East Fife,920,7,13,8,15,54,47,7,47
Albion,920,8,12,7,17,53,58,-5,43
Queen's Park,920,9,11,7,18,35,57,-22,40
Stenhousem'r,920,10,11,7,18,47,80,-33,40
Livingston,921,1,24,2,10,77,42,35,74
Alloa,921,2,19,7,10,71,43,28,64
Airdrieon,921,3,19,6,11,66,53,13,63
Brechin,921,4,17,6,13,46,45,1,57
Peterhead,921,5,15,6,15,49,56,-7,51
Albion,921,6,14,7,15,57,55,2,49
East Fife,921,7,11,11,14,45,46,-1,44
Queen's Park,921,8,13,5,18,33,52,-19,44
Stranraer,921,9,10,5,21,43,59,-16,35
Stenhousem'r,921,10,6,9,21,49,85,-36,27
Livingston,922,1,22,4,10,78,46,32,70
Brechin,922,2,19,9,8,51,38,13,66
Peterhead,922,3,19,7,10,71,51,20,64
Alloa,922,4,18,8,10,66,45,21,62
Airdrieon,922,5,15,7,14,49,56,-7,52
East Fife,922,6,13,8,15,47,43,4,47
Albion,922,7,11,8,17,46,55,-9,41
Stranraer,922,8,11,6,19,44,60,-16,39
Queen's Park,922,9,9,8,19,27,52,-25,35
Stenhousem'r,922,10,6,9,21,54,87,-33,27
Livingston,923,1,21,5,10,70,46,24,68
Airdrieon,923,2,20,6,10,61,49,12,66
Alloa,923,3,18,9,9,76,46,30,63
Brechin,923,4,17,5,14,46,49,-3,56
Albion,923,5,16,5,15,58,47,11,53
Peterhead,923,6,13,9,14,47,48,-1,48
East Fife,923,7,13,7,16,50,53,-3,46
Stranraer,923,8,13,6,17,57,58,-1,45
Queen's Park,923,9,10,7,19,30,58,-28,37
Stenhousem'r,923,10,5,9,22,42,83,-41,24
Brechin,924,1,17,9,10,48,41,7,60
Livingston,924,2,18,5,13,74,48,26,59
Alloa,924,3,15,11,10,67,43,24,56
Airdrieon,924,4,15,6,15,58,57,1,51
East Fife,924,5,13,11,12,47,47,0,50
Stranraer,924,6,14,7,15,51,51,0,49
Albion,924,7,13,10,13,48,48,0,49
Peterhead,924,8,12,9,15,47,57,-10,45
Queen's Park,924,9,10,12,14,37,54,-17,42
Stenhousem'r,924,10,9,8,19,45,76,-31,35
Airdrieon,925,1,21,6,9,57,43,14,69
Livingston,925,2,21,1,14,76,60,16,64
Alloa,925,3,18,5,13,62,46,16,59
Brechin,925,4,17,7,12,47,37,10,58
Albion,925,5,14,10,12,53,50,3,52
Peterhead,925,6,13,10,13,55,46,9,49
Stranraer,925,7,13,5,18,53,60,-7,44
Queen's Park,925,8,12,4,20,33,60,-27,40
East Fife,925,9,10,9,17,38,49,-11,39
Stenhousem'r,925,10,10,5,21,51,74,-23,35
Livingston,926,1,23,5,8,70,41,29,74
Alloa,926,2,20,9,7,81,45,36,69
Airdrieon,926,3,17,8,11,59,49,10,59
Brechin,926,4,16,9,11,55,46,9,57
Albion,926,5,12,13,11,46,47,-1,49
Peterhead,926,6,12,8,16,48,54,-6,44
Queen's Park,926,7,12,7,17,41,52,-11,43
Stranraer,926,8,10,10,16,45,53,-8,40
East Fife,926,9,9,10,17,42,61,-19,37
Stenhousem'r,926,10,5,9,22,46,85,-39,24
Livingston,927,1,20,6,10,75,45,30,66
Alloa,927,2,16,15,5,72,46,26,63
Brechin,927,3,16,8,12,51,51,0,56
East Fife,927,4,14,11,11,51,40,11,53
Peterhead,927,5,13,11,12,48,45,3,50
Airdrieon,927,6,14,6,16,50,54,-4,48
Albion,927,7,14,5,17,49,60,-11,47
Queen's Park,927,8,12,8,16,38,45,-7,44
Stranraer,927,9,13,3,20,48,66,-18,42
Stenhousem'r,927,10,6,11,19,50,80,-30,29
Brechin,928,1,24,3,9,63,46,17,75
Airdrieon,928,2,21,8,7,66,48,18,71
Livingston,928,3,21,2,13,80,50,30,65
Alloa,928,4,17,8,11,70,48,22,59
Stranraer,928,5,15,4,17,53,55,-2,49
Albion,928,6,13,8,15,52,54,-2,47
East Fife,928,7,12,8,16,52,54,-2,44
Peterhead,928,8,9,7,20,43,59,-16,34
Queen's Park,928,9,9,7,20,36,62,-26,34
Stenhousem'r,928,10,8,7,21,40,79,-39,31
Livingston,929,1,22,3,11,76,51,25,69
Airdrieon,929,2,21,5,10,63,48,15,68
Albion,929,3,17,7,12,53,44,9,58
Alloa,929,4,16,8,12,67,49,18,56
Brechin,929,5,16,7,13,54,57,-3,55
East Fife,929,6,13,9,14,54,54,0,48
Peterhead,929,7,13,7,16,51,54,-3,46
Stranraer,929,8,13,4,19,46,54,-8,43
Queen's Park,929,9,11,6,19,33,54,-21,39
Stenhousem'r,929,10,5,10,21,45,77,-32,25
Albion,930,1,18,11,7,63,46,17,65
Livingston,930,2,20,4,12,74,51,23,64
Alloa,930,3,18,8,10,71,51,20,62
East Fife,930,4,13,9,14,50,43,7,48
Brechin,930,5,14,6,16,45,55,-10,48
Airdrieon,930,6,13,8,15,53,54,-1,47
Queen's Park,930,7,12,10,14,46,54,-8,46
Stenhousem'r,930,8,12,8,16,47,67,-20,44
Peterhead,930,9,11,10,15,41,51,-10,43
Stranraer,930,10,10,4,22,41,59,-18,34
Livingston,931,1,23,6,7,72,35,37,75
Airdrieon,931,2,19,5,12,59,52,7,62
Alloa,931,3,17,8,11,70,47,23,59
Brechin,931,4,15,9,12,55,44,11,54
Albion,931,5,13,11,12,59,49,10,50
Peterhead,931,6,12,9,15,40,54,-14,45
Queen's Park,931,7,12,8,16,31,49,-18,44
East Fife,931,8,10,11,15,46,53,-7,41
Stranraer,931,9,10,8,18,39,56,-17,38
Stenhousem'r,931,10,8,7,21,47,79,-32,31
Livingston,932,1,23,5,8,81,43,38,74
Alloa,932,2,19,8,9,73,49,24,65
Brechin,932,3,18,6,12,56,45,11,60
Airdrieon,932,4,18,6,12,59,50,9,60
Stranraer,932,5,14,10,12,58,53,5,52
Albion,932,6,14,5,17,55,54,1,47
East Fife,932,7,11,9,16,50,53,-3,42
Peterhead,932,8,11,7,18,42,65,-23,40
Queen's Park,932,9,10,8,18,31,56,-25,38
Stenhousem'r,932,10,7,6,23,49,86,-37,27
Livingston,933,1,22,4,10,81,51,30,70
Alloa,933,2,18,8,10,72,49,23,62
Brechin,933,3,18,4,14,56,50,6,58
Airdrieon,933,4,17,4,15,58,59,-1,55
Albion,933,5,14,8,14,53,48,5,50
East Fife,933,6,15,5,16,42,45,-3,50
Peterhead,933,7,14,7,15,50,45,5,49
Stranraer,933,8,12,5,19,54,65,-11,41
Stenhousem'r,933,9,12,4,20,48,78,-30,40
Queen's Park,933,10,11,5,20,39,63,-24,38
Airdrieon,934,1,20,7,9,68,52,16,67
Brechin,934,2,20,6,10,55,41,14,66
Alloa,934,3,19,8,9,74,47,27,65
Livingston,934,4,18,3,15,72,56,16,57
Peterhead,934,5,16,7,13,55,51,4,55
East Fife,934,6,16,5,15,56,43,13,53
Stranraer,934,7,14,5,17,49,58,-9,47
Albion,934,8,11,8,17,49,65,-16,41
Queen's Park,934,9,8,7,21,34,60,-26,31
Stenhousem'r,934,10,6,8,22,42,81,-39,26
Alloa,935,1,21,7,8,62,34,28,70
Airdrieon,935,2,20,7,9,68,44,24,67
Brechin,935,3,19,5,12,52,47,5,62
Livingston,935,4,17,7,12,75,55,20,58
Peterhead,935,5,14,9,13,53,55,-2,51
Albion,935,6,13,10,13,53,47,6,49
Queen's Park,935,7,12,7,17,36,59,-23,43
Stranraer,935,8,12,4,20,50,66,-16,40
East Fife,935,9,7,12,17,44,53,-9,33
Stenhousem'r,935,10,7,8,21,42,75,-33,29
Alloa,936,1,23,5,8,71,38,33,74
Livingston,936,2,22,4,10,79,49,30,70
Airdrieon,936,3,16,7,13,57,55,2,55
Peterhead,936,4,15,7,14,49,56,-7,52
East Fife,936,5,14,8,14,55,45,10,50
Brechin,936,6,15,4,17,53,48,5,49
Albion,936,7,13,9,14,47,50,-3,48
Queen's Park,936,8,14,6,16,42,57,-15,48
Stranraer,936,9,8,8,20,45,62,-17,32
Stenhousem'r,936,10,7,8,21,42,80,-38,29
Livingston,937,1,21,4,11,74,50,24,67
Alloa,937,2,18,12,6,73,39,34,66
Airdrieon,937,3,18,8,10,68,52,16,62
Brechin,937,4,16,6,14,47,48,-1,54
Albion,937,5,14,6,16,47,50,-3,48
Peterhead,937,6,13,8,15,50,58,-8,47
Stranraer,937,7,14,5,17,47,61,-14,47
Queen's Park,937,8,12,7,17,38,46,-8,43
East Fife,937,9,9,15,12,47,46,1,42
Stenhousem'r,937,10,4,11,21,43,84,-41,23
Livingston,938,1,20,7,9,80,48,32,67
Airdrieon,938,2,18,8,10,63,49,14,62
Alloa,938,3,17,7,12,69,55,14,58
Brechin,938,4,13,11,12,45,42,3,50
Albion,938,5,13,11,12,52,53,-1,50
Queen's Park,938,6,13,8,15,38,47,-9,47
East Fife,938,7,12,10,14,52,51,1,46
Peterhead,938,8,13,7,16,40,54,-14,46
Stranraer,938,9,13,6,17,46,50,-4,45
Stenhousem'r,938,10,5,11,20,42,78,-36,26
Alloa,939,1,18,9,9,68,42,26,63
Livingston,939,2,19,4,13,74,48,26,61
Brechin,939,3,19,4,13,55,49,6,61
Airdrieon,939,4,15,8,13,48,49,-1,53
Albion,939,5,14,8,14,55,55,0,50
Queen's Park,939,6,13,10,13,37,49,-12,49
Stranraer,939,7,14,6,16,52,59,-7,48
Peterhead,939,8,12,11,13,49,52,-3,47
East Fife,939,9,10,7,19,46,54,-8,37
Stenhousem'r,939,10,9,7,20,43,70,-27,34
Livingston,940,1,25,3,8,90,48,42,78
Airdrieon,940,2,18,6,12,63,55,8,60
Alloa,940,3,16,9,11,62,48,14,57
East Fife,940,4,15,8,13,59,45,14,53
Queen's Park,940,5,15,5,16,37,51,-14,50
Brechin,940,6,14,7,15,49,52,-3,49
Peterhead,940,7,13,8,15,50,54,-4,47
Stranraer,940,8,13,4,19,55,65,-10,43
Albion,940,9,11,9,16,55,67,-12,42
Stenhousem'r,940,10,6,9,21,51,86,-35,27
Alloa,941,1,21,8,7,85,38,47,71
Livingston,941,2,21,7,8,80,47,33,70
Airdrieon,941,3,18,9,9,58,40,18,63
Albion,941,4,15,8,13,58,59,-1,53
East Fife,941,5,13,9,14,46,49,-3,48
Brechin,941,6,12,7,17,49,62,-13,43
Queen's Park,941,7,12,7,17,44,58,-14,43
Peterhead,941,8,10,9,17,35,51,-16,39
Stranraer,941,9,11,5,20,42,66,-24,38
Stenhousem'r,941,10,6,13,17,39,66,-27,31
Alloa,942,1,20,8,8,82,45,37,68
Livingston,942,2,19,4,13,72,55,17,61
Brechin,942,3,19,3,14,61,49,12,60
Airdrieon,942,4,17,4,15,61,59,2,55
East Fife,942,5,14,10,12,54,44,10,52
Peterhead,942,6,14,8,14,52,53,-1,50
Albion,942,7,13,7,16,56,57,-1,46
Stranraer,942,8,12,6,18,47,71,-24,42
Queen's Park,942,9,11,6,19,33,52,-19,39
Stenhousem'r,942,10,9,8,19,43,76,-33,35
Livingston,943,1,22,6,8,83,46,37,72
Airdrieon,943,2,21,4,11,72,59,13,67
Albion,943,3,19,8,9,60,46,14,65
East Fife,943,4,15,9,12,58,46,12,54
Alloa,943,5,15,8,13,65,47,18,53
Brechin,943,6,13,7,16,49,58,-9,46
Peterhead,943,7,13,6,17,57,60,-3,45
Queen's Park,943,8,11,7,18,39,59,-20,40
Stranraer,943,9,10,7,19,46,62,-16,37
Stenhousem'r,943,10,6,8,22,41,87,-46,26
Alloa,944,1,17,9,10,64,42,22,60
Airdrieon,944,2,16,10,10,60,54,6,58
Livingston,944,3,17,6,13,72,61,11,57
Peterhead,944,4,14,9,13,50,44,6,51
Stranraer,944,5,15,5,16,56,60,-4,50
Brechin,944,6,13,11,12,41,46,-5,50
Queen's Park,944,7,13,10,13,45,44,1,49
East Fife,944,8,13,9,14,48,40,8,48
Albion,944,9,12,10,14,46,53,-7,46
Stenhousem'r,944,10,6,9,21,37,75,-38,27
Alloa,945,1,21,9,6,66,33,33,72
Livingston,945,2,17,8,11,66,53,13,59
Peterhead,945,3,16,9,11,47,38,9,57
Airdrieon,945,4,15,10,11,57,51,6,55
East Fife,945,5,15,7,14,61,50,11,52
Brechin,945,6,13,11,12,42,50,-8,50
Albion,945,7,10,13,13,50,50,0,43
Queen's Park,945,8,11,6,19,38,57,-19,39
Stranraer,945,9,9,10,17,39,53,-14,37
Stenhousem'r,945,10,7,9,20,48,79,-31,30
Alloa,946,1,19,8,9,62,42,20,65
Livingston,946,2,20,2,14,76,58,18,62
Brechin,946,3,16,6,14,58,58,0,54
Queen's Park,946,4,15,7,14,46,49,-3,52
East Fife,946,5,14,9,13,59,49,10,51
Albion,946,6,14,9,13,53,52,1,51
Airdrieon,946,7,15,6,15,58,59,-1,51
Stranraer,946,8,13,5,18,49,51,-2,44
Peterhead,946,9,10,10,16,37,55,-18,40
Stenhousem'r,946,10,9,8,19,55,80,-25,35
Alloa,947,1,21,8,7,73,41,32,71
Airdrieon,947,2,17,11,8,58,46,12,62
Livingston,947,3,18,7,11,70,45,25,61
Brechin,947,4,18,4,14,51,46,5,58
Albion,947,5,15,8,13,54,50,4,53
East Fife,947,6,15,7,14,55,56,-1,52
Peterhead,947,7,12,11,13,47,51,-4,47
Queen's Park,947,8,10,9,17,35,50,-15,39
Stranraer,947,9,9,7,20,51,71,-20,34
Stenhousem'r,947,10,5,8,23,44,82,-38,23
Alloa,948,1,18,6,12,77,51,26,60
Brechin,948,2,18,6,12,60,54,6,60
Livingston,948,3,18,3,15,70,55,15,57
Airdrieon,948,4,16,6,14,67,61,6,54
East Fife,948,5,15,8,13,57,52,5,53
Albion,948,6,14,8,14,53,53,0,50
Queen's Park,948,7,14,8,14,40,49,-9,50
Peterhead,948,8,12,7,17,44,56,-12,43
Stranraer,948,9,11,9,16,52,62,-10,42
Stenhousem'r,948,10,10,7,19,46,73,-27,37
Alloa,949,1,19,7,10,75,50,25,64
Airdrieon,949,2,17,9,10,56,42,14,60
Brechin,949,3,17,7,12,61,51,10,58
Livingston,949,4,18,2,16,68,52,16,56
Peterhead,949,5,15,9,12,54,45,9,54
Queen's Park,949,6,15,7,14,42,49,-7,52
East Fife,949,7,12,10,14,51,52,-1,46
Albion,949,8,12,8,16,47,51,-4,44
Stranraer,949,9,11,7,18,53,69,-16,40
Stenhousem'r,949,10,7,8,21,42,88,-46,29
Livingston,950,1,26,2,8,87,43,44,80
Albion,950,2,17,6,13,52,51,1,57
Alloa,950,3,15,10,11,66,46,20,55
Brechin,950,4,15,7,14,49,57,-8,52
Queen's Park,950,5,14,9,13,40,47,-7,51
Airdrieon,950,6,13,10,13,55,63,-8,49
Stranraer,950,7,12,6,18,56,60,-4,42
East Fife,950,8,11,8,17,48,53,-5,41
Peterhead,950,9,10,11,15,50,56,-6,41
Stenhousem'r,950,10,9,7,20,50,77,-27,34
Livingston,951,1,22,3,11,69,49,20,69
Airdrieon,951,2,19,8,9,72,52,20,65
Alloa,951,3,19,7,10,69,40,29,64
Queen's Park,951,4,14,8,14,49,50,-1,50
Peterhead,951,5,13,9,14,45,57,-12,48
Albion,951,6,12,11,13,53,51,2,47
East Fife,951,7,10,14,12,52,45,7,44
Brechin,951,8,13,5,18,46,60,-14,44
Stranraer,951,9,12,7,17,52,59,-7,43
Stenhousem'r,951,10,7,6,23,39,83,-44,27
Livingston,952,1,22,7,7,75,41,34,73
Airdrieon,952,2,21,5,10,71,49,22,68
Alloa,952,3,18,10,8,78,48,30,64
Albion,952,4,11,16,9,53,43,10,49
Brechin,952,5,13,9,14,43,48,-5,48
Peterhead,952,6,12,10,14,45,53,-8,46
Queen's Park,952,7,12,5,19,34,54,-20,41
Stranraer,952,8,10,8,18,44,63,-19,38
East Fife,952,9,8,12,16,46,56,-10,36
Stenhousem'r,952,10,7,10,19,43,77,-34,31
Airdrieon,953,1,21,8,7,68,41,27,71
Alloa,953,2,19,7,10,66,50,16,64
Livingston,953,3,19,2,15,69,51,18,59
Brechin,953,4,15,8,13,54,54,0,53
Peterhead,953,5,14,7,15,56,55,1,49
Albion,953,6,12,12,12,55,54,1,48
Queen's Park,953,7,13,7,16,43,59,-16,46
East Fife,953,8,11,10,15,55,52,3,43
Stranraer,953,9,11,9,16,48,61,-13,42
Stenhousem'r,953,10,6,8,22,44,81,-37,26
Alloa,954,1,19,11,6,67,42,25,68
Airdrieon,954,2,15,13,8,57,40,17,58
Livingston,954,3,16,6,14,63,50,13,54
East Fife,954,4,16,4,16,50,43,7,52
Brechin,954,5,14,8,14,38,44,-6,50
Queen's Park,954,6,13,10,13,37,42,-5,49
Peterhead,954,7,13,8,15,50,56,-6,47
Albion,954,8,12,8,16,48,58,-10,44
Stranraer,954,9,12,4,20,53,61,-8,40
Stenhousem'r,954,10,10,8,18,51,78,-27,38
Livingston,955,1,21,7,8,76,43,33,70
Brechin,955,2,21,5,10,60,44,16,68
Alloa,955,3,17,11,8,71,41,30,62
Airdrieon,955,4,15,10,11,59,54,5,55
Albion,955,5,14,8,14,60,45,15,50
Peterhead,955,6,14,8,14,49,54,-5,50
East Fife,955,7,9,11,16,45,57,-12,38
Stranraer,955,8,10,7,19,44,66,-22,37
Queen's Park,955,9,10,5,21,31,58,-27,35
Stenhousem'r,955,10,9,8,19,44,77,-33,35
Livingston,956,1,21,5,10,79,47,32,68
Airdrieon,956,2,19,4,13,65,54,11,61
Alloa,956,3,17,7,12,76,53,23,58
Peterhead,956,4,16,6,14,46,50,-4,54
Stranraer,956,5,16,5,15,59,67,-8,53
Brechin,956,6,15,7,14,60,61,-1,52
Albion,956,7,14,9,13,53,55,-2,51
East Fife,956,8,13,5,18,57,55,2,44
Queen's Park,956,9,11,10,15,38,45,-7,43
Stenhousem'r,956,10,5,8,23,44,90,-46,23
Airdrieon,957,1,21,6,9,69,40,29,69
Livingston,957,2,21,4,11,77,53,24,67
Alloa,957,3,16,11,9,72,47,25,59
Brechin,957,4,15,9,12,42,43,-1,54
Peterhead,957,5,14,7,15,46,50,-4,49
Queen's Park,957,6,14,6,16,46,54,-8,48
Albion,957,7,13,8,15,50,56,-6,47
Stranraer,957,8,13,7,16,54,60,-6,46
East Fife,957,9,10,12,14,51,52,-1,42
Stenhousem'r,957,10,4,8,24,41,93,-52,20
Livingston,958,1,25,2,9,83,43,40,77
Alloa,958,2,18,8,10,61,41,20,62
Albion,958,3,16,8,12,54,56,-2,56
Brechin,958,4,16,7,13,51,42,9,55
Peterhead,958,5,16,6,14,59,51,8,54
Airdrieon,958,6,13,8,15,55,63,-8,47
Queen's Park,958,7,14,5,17,36,52,-16,47
Stranraer,958,8,12,7,17,55,62,-7,43
East Fife,958,9,10,8,18,44,53,-9,38
Stenhousem'r,958,10,8,5,23,52,87,-35,29
Brechin,959,1,18,6,12,55,48,7,60
Alloa,959,2,17,6,13,68,42,26,57
Livingston,959,3,16,9,11,69,55,14,57
Airdrieon,959,4,17,6,13,58,48,10,57
Queen's Park,959,5,16,5,15,39,45,-6,53
Peterhead,959,6,14,7,15,49,57,-8,49
East Fife,959,7,12,11,13,49,49,0,47
Stranraer,959,8,13,6,17,49,63,-14,45
Stenhousem'r,959,9,11,8,17,53,69,-16,41
Albion,959,10,8,12,16,46,59,-13,36
Livingston,960,1,22,4,10,76,53,23,70
Airdrieon,960,2,17,6,13,62,56,6,57
Brechin,960,3,17,5,14,53,51,2,56
Queen's Park,960,4,16,7,13,46,51,-5,55
Alloa,960,5,16,6,14,64,46,18,54
Stranraer,960,6,12,9,15,47,46,1,45
Albion,960,7,11,10,15,53,59,-6,43
Peterhead,960,8,11,10,15,42,56,-14,43
Stenhousem'r,960,9,10,10,16,56,73,-17,40
East Fife,960,10,9,11,16,47,55,-8,38
Livingston,961,1,20,8,8,75,43,32,68
Airdrieon,961,2,18,6,12,57,48,9,60
Alloa,961,3,16,11,9,68,46,22,59
Albion,961,4,17,8,11,58,49,9,59
Stranraer,961,5,15,5,16,59,62,-3,50
Brechin,961,6,13,10,13,44,49,-5,49
East Fife,961,7,12,10,14,52,49,3,46
Queen's Park,961,8,10,9,17,30,52,-22,39
Peterhead,961,9,10,8,18,44,55,-11,38
Stenhousem'r,961,10,8,7,21,45,79,-34,31
Alloa,962,1,21,8,7,85,45,40,71
Livingston,962,2,21,7,8,86,42,44,70
Albion,962,3,14,14,8,52,42,10,56
Brechin,962,4,15,8,13,44,46,-2,53
Airdrieon,962,5,14,6,16,56,61,-5,48
Peterhead,962,6,13,8,15,46,50,-4,47
Queen's Park,962,7,14,5,17,41,52,-11,47
East Fife,962,8,11,13,12,47,48,-1,46
Stranraer,962,9,10,6,20,44,68,-24,36
Stenhousem'r,962,10,6,7,23,39,86,-47,25
Livingston,963,1,23,4,9,73,41,32,73
Alloa,963,2,20,8,8,73,44,29,68
Airdrieon,963,3,18,6,12,64,50,14,60
East Fife,963,4,12,13,11,43,35,8,49
Peterhead,963,5,14,7,15,47,61,-14,49
Brechin,963,6,12,7,17,43,46,-3,43
Queen's Park,963,7,11,10,15,38,54,-16,43
Stranraer,963,8,12,6,18,49,59,-10,42
Albion,963,9,8,14,14,39,49,-10,38
Stenhousem'r,963,10,8,9,19,45,75,-30,33
Livingston,964,1,21,2,13,75,51,24,65
Brechin,964,2,20,5,11,62,44,18,65
Alloa,964,3,19,7,10,80,52,28,64
Airdrieon,964,4,14,9,13,52,52,0,51
Peterhead,964,5,14,8,14,53,55,-2,50
Queen's Park,964,6,14,8,14,45,49,-4,50
Stranraer,964,7,13,7,16,53,60,-7,46
East Fife,964,8,11,8,17,47,53,-6,41
Albion,964,9,10,9,17,47,56,-9,39
Stenhousem'r,964,10,8,9,19,48,90,-42,33
Livingston,965,1,20,5,11,83,55,28,65
Alloa,965,2,18,6,12,68,53,15,60
Airdrieon,965,3,17,8,11,56,48,8,59
Brechin,965,4,18,4,14,49,44,5,58
Peterhead,965,5,16,8,12,59,54,5,56
Stranraer,965,6,15,9,12,54,46,8,54
Albion,965,7,11,9,16,60,63,-3,42
Queen's Park,965,8,12,6,18,42,60,-18,42
East Fife,965,9,9,13,14,47,53,-6,40
Stenhousem'r,965,10,5,10,21,48,90,-42,25
Alloa,966,1,22,4,10,75,49,26,70
Livingston,966,2,21,5,10,74,48,26,68
Airdrieon,966,3,18,7,11,64,48,16,61
Brechin,966,4,18,3,15,42,47,-5,57
Albion,966,5,14,9,13,54,48,6,51
East Fife,966,6,14,7,15,49,48,1,49
Peterhead,966,7,11,9,16,46,51,-5,42
Stranraer,966,8,12,6,18,47,60,-13,42
Stenhousem'r,966,9,10,5,21,54,87,-33,35
Queen's Park,966,10,8,9,19,33,52,-19,33
Alloa,967,1,22,7,7,70,34,36,73
Livingston,967,2,21,6,9,82,53,29,69
Brechin,967,3,16,7,13,52,52,0,55
Peterhead,967,4,15,9,12,53,48,5,54
Airdrieon,967,5,15,5,16,57,63,-6,50
Stranraer,967,6,14,5,17,48,57,-9,47
Albion,967,7,12,10,14,49,52,-3,46
Queen's Park,967,8,13,3,20,36,50,-14,42
East Fife,967,9,12,5,19,52,49,3,41
Stenhousem'r,967,10,8,7,21,44,85,-41,31
Alloa,968,1,22,6,8,66,34,32,72
Airdrieon,968,2,20,8,8,65,49,16,68
Livingston,968,3,19,4,13,68,49,19,61
Brechin,968,4,15,9,12,48,50,-2,54
East Fife,968,5,14,9,13,56,44,12,51
Albion,968,6,11,11,14,42,48,-6,44
Peterhead,968,7,11,10,15,44,58,-14,43
Stranraer,968,8,12,6,18,52,57,-5,42
Queen's Park,968,9,11,4,21,43,64,-21,37
Stenhousem'r,968,10,7,9,20,49,80,-31,30
Livingston,969,1,19,6,11,71,46,25,63
Alloa,969,2,16,11,9,65,44,21,59
Airdrieon,969,3,17,5,14,52,54,-2,56
Peterhead,969,4,15,8,13,54,55,-1,53
East Fife,969,5,14,10,12,56,49,7,52
Queen's Park,969,6,15,7,14,43,51,-8,52
Albion,969,7,14,8,14,54,54,0,50
Stranraer,969,8,13,7,16,55,58,-3,46
Brechin,969,9,12,7,17,44,55,-11,43
Stenhousem'r,969,10,7,7,22,45,73,-28,28
Livingston,970,1,21,5,10,68,44,24,68
Alloa,970,2,19,10,7,68,38,30,67
Brechin,970,3,18,8,10,51,44,7,62
Queen's Park,970,4,17,3,16,52,50,2,54
Airdrieon,970,5,15,6,15,55,52,3,51
Peterhead,970,6,14,8,14,51,47,4,50
East Fife,970,7,10,12,14,47,48,-1,42
Albion,970,8,10,9,17,42,52,-10,39
Stenhousem'r,970,9,10,7,19,52,89,-37,37
Stranraer,970,10,10,4,22,42,64,-22,34
Alloa,971,1,22,6,8,75,38,37,72
Airdrieon,971,2,21,7,8,66,43,23,70
Brechin,971,3,18,7,11,58,44,14,61
Livingston,971,4,17,7,12,66,55,11,58
Albion,971,5,13,8,15,57,57,0,47
Peterhead,971,6,13,8,15,48,51,-3,47
East Fife,971,7,10,12,14,56,54,2,42
Stranraer,971,8,11,5,20,52,77,-25,38
Queen's Park,971,9,10,7,19,34,56,-22,37
Stenhousem'r,971,10,9,5,22,44,81,-37,32
Livingston,972,1,21,7,8,77,47,30,70
Alloa,972,2,17,12,7,71,49,22,63
Brechin,972,3,18,7,11,57,46,11,61
Airdrieon,972,4,17,7,12,58,52,6,58
Peterhead,972,5,13,12,11,52,54,-2,51
Stranraer,972,6,12,6,18,51,63,-12,42
Albion,972,7,10,11,15,56,58,-2,41
East Fife,972,8,10,8,18,48,52,-4,38
Queen's Park,972,9,9,11,16,40,54,-14,38
Stenhousem'r,972,10,8,9,19,52,87,-35,33
Livingston,973,1,23,4,9,79,43,36,73
Alloa,973,2,18,11,7,63,35,28,65
Airdrieon,973,3,15,11,10,56,54,2,56
Brechin,973,4,17,3,16,51,51,0,54
Albion,973,5,11,15,10,51,56,-5,48
East Fife,973,6,12,9,15,53,52,1,45
Peterhead,973,7,11,11,14,48,56,-8,44
Queen's Park,973,8,11,9,16,36,48,-12,42
Stranraer,973,9,9,11,16,44,57,-13,38
Stenhousem'r,973,10,8,6,22,50,79,-29,30
Alloa,974,1,25,5,6,79,36,43,80
Livingston,974,2,22,7,7,83,44,39,73
Brechin,974,3,17,7,12,58,52,6,58
Peterhead,974,4,15,7,14,43,50,-7,52
Airdrieon,974,5,15,6,15,54,60,-6,51
Albion,974,6,13,9,14,49,51,-2,48
Queen's Park,974,7,12,7,17,34,45,-11,43
East Fife,974,8,8,11,17,46,54,-8,35
Stranraer,974,9,10,3,23,43,70,-27,33
Stenhousem'r,974,10,8,8,20,55,82,-27,32
Livingston,975,1,20,5,11,75,44,31,65
Alloa,975,2,19,7,10,73,46,27,64
Airdrieon,975,3,18,8,10,67,47,20,62
Brechin,975,4,16,6,14,52,62,-10,54
Queen's Park,975,5,15,7,14,43,42,1,52
Stranraer,975,6,14,5,17,49,62,-13,47
Peterhead,975,7,14,4,18,49,58,-9,46
East Fife,975,8,13,6,17,50,53,-3,45
Albion,975,9,12,5,19,46,60,-14,41
Stenhousem'r,975,10,8,9,19,41,71,-30,33
Brechin,976,1,23,3,10,60,41,19,72
Alloa,976,2,19,6,11,66,48,18,63
Livingston,976,3,19,3,14,67,50,17,60
Stranraer,976,4,17,3,16,50,52,-2,54
Airdrieon,976,5,16,5,15,58,54,4,53
Queen's Park,976,6,14,8,14,38,49,-11,50
Peterhead,976,7,12,8,16,48,51,-3,44
Albion,976,8,12,7,17,47,54,-7,43
East Fife,976,9,12,6,18,48,52,-4,42
Stenhousem'r,976,10,7,9,20,42,73,-31,30
Albion,977,1,19,6,11,62,49,13,63
Livingston,977,2,19,5,12,75,55,20,62
Alloa,977,3,18,7,11,78,49,29,61
Airdrieon,977,4,17,9,10,60,49,11,60
Brechin,977,5,18,5,13,54,45,9,59
East Fife,977,6,15,7,14,61,45,16,52
Stranraer,977,7,14,6,16,53,60,-7,48
Peterhead,977,8,10,7,19,43,65,-22,37
Queen's Park,977,9,9,7,20,41,72,-31,34
Stenhousem'r,977,10,8,7,21,46,84,-38,31
Brechin,978,1,20,4,12,58,39,19,64
Alloa,978,2,18,8,10,69,51,18,62
Livingston,978,3,16,8,12,75,57,18,56
Airdrieon,978,4,15,9,12,63,58,5,54
Queen's Park,978,5,13,11,12,37,46,-9,50
Peterhead,978,6,12,9,15,47,51,-4,45
Stranraer,978,7,11,11,14,46,56,-10,44
Albion,978,8,9,14,13,47,53,-6,41
Stenhousem'r,978,9,10,9,17,44,72,-28,39
East Fife,978,10,9,11,16,50,53,-3,38
Airdrieon,979,1,20,4,12,62,49,13,64
Livingston,979,2,18,6,12,66,49,17,60
Brechin,979,3,17,6,13,46,43,3,57
Albion,979,4,14,11,11,52,49,3,53
Queen's Park,979,5,15,8,13,40,39,1,53
Peterhead,979,6,14,10,12,44,44,0,52
Alloa,979,7,15,6,15,60,48,12,51
Stranraer,979,8,12,9,15,43,49,-6,45
East Fife,979,9,8,15,13,45,51,-6,39
Stenhousem'r,979,10,4,11,21,36,73,-37,23
Brechin,980,1,25,2,9,66,41,25,77
Livingston,980,2,21,5,10,72,44,28,68
Alloa,980,3,17,10,9,59,38,21,61
Peterhead,980,4,15,12,9,52,42,10,57
Airdrieon,980,5,15,6,15,59,60,-1,51
Albion,980,6,11,7,18,52,65,-13,40
East Fife,980,7,9,12,15,45,46,-1,39
Stranraer,980,8,11,6,19,40,58,-18,39
Queen's Park,980,9,9,11,16,31,50,-19,38
Stenhousem'r,980,10,8,7,21,41,73,-32,31
Livingston,981,1,19,8,9,73,47,26,65
Brechin,981,2,18,9,9,56,44,12,63
Alloa,981,3,18,8,10,71,47,24,62
Airdrieon,981,4,18,7,11,55,51,4,61
Stranraer,981,5,15,5,16,55,53,2,50
Peterhead,981,6,12,10,14,46,54,-8,46
East Fife,981,7,13,6,17,49,52,-3,45
Albion,981,8,11,8,17,45,52,-7,41
Queen's Park,981,9,11,7,18,40,61,-21,40
Stenhousem'r,981,10,7,8,21,39,68,-29,29
Alloa,982,1,20,8,8,73,39,34,68
Livingston,982,2,19,5,12,77,50,27,62
Airdrieon,982,3,17,7,12,58,55,3,58
Peterhead,982,4,14,9,13,50,51,-1,51
Albion,982,5,13,9,14,56,54,2,48
Brechin,982,6,15,3,18,46,60,-14,48
Queen's Park,982,7,14,4,18,35,51,-16,46
Stranraer,982,8,12,7,17,42,52,-10,43
East Fife,982,9,11,9,16,41,45,-4,42
Stenhousem'r,982,10,10,9,17,51,72,-21,39
Livingston,983,1,20,7,9,74,51,23,67
Airdrieon,983,2,17,11,8,64,47,17,62
Alloa,983,3,17,10,9,76,54,22,61
Albion,983,4,14,10,12,54,51,3,52
Peterhead,983,5,11,13,12,46,50,-4,46
Brechin,983,6,12,10,14,41,45,-4,46
Stranraer,983,7,11,11,14,46,52,-6,44
Queen's Park,983,8,12,7,17,38,51,-13,43
East Fife,983,9,11,8,17,49,48,1,41
Stenhousem'r,983,10,6,11,19,38,77,-39,29
Livingston,984,1,20,4,12,72,44,28,64
Alloa,984,2,19,7,10,66,42,24,64
Peterhead,984,3,19,6,11,60,43,17,63
Airdrieon,984,4,16,7,13,50,59,-9,55
Albion,984,5,15,6,15,54,52,2,51
Brechin,984,6,15,5,16,48,50,-2,50
East Fife,984,7,13,8,15,46,42,4,47
Stranraer,984,8,14,5,17,60,58,2,47
Queen's Park,984,9,11,7,18,31,57,-26,40
Stenhousem'r,984,10,7,7,22,51,91,-40,28
Livingston,985,1,21,8,7,77,38,39,71
Alloa,985,2,19,7,10,66,46,20,64
Brechin,985,3,17,7,12,43,43,0,58
Albion,985,4,16,6,14,59,44,15,54
Stranraer,985,5,15,5,16,58,59,-1,50
Airdrieon,985,6,15,5,16,60,62,-2,50
East Fife,985,7,12,8,16,47,51,-4,44
Peterhead,985,8,12,6,18,46,69,-23,42
Queen's Park,985,9,11,5,20,28,52,-24,38
Stenhousem'r,985,10,10,7,19,58,78,-20,37
Livingston,986,1,23,6,7,82,47,35,75
Alloa,986,2,19,9,8,71,41,30,66
Brechin,986,3,17,5,14,59,55,4,56
Airdrieon,986,4,16,8,12,57,58,-1,56
Peterhead,986,5,14,10,12,55,53,2,52
Albion,986,6,13,8,15,55,57,-2,47
Queen's Park,986,7,14,4,18,45,60,-15,46
East Fife,986,8,11,8,17,42,49,-7,41
Stranraer,986,9,10,6,20,48,61,-13,36
Stenhousem'r,986,10,6,10,20,47,80,-33,28
Livingston,987,1,21,6,9,77,48,29,69
Alloa,987,2,19,9,8,67,34,33,66
Brechin,987,3,18,6,12,48,45,3,60
Peterhead,987,4,15,6,15,40,50,-10,51
Airdrieon,987,5,13,10,13,55,57,-2,49
Albion,987,6,12,12,12,53,50,3,48
Stranraer,987,7,14,4,18,44,53,-9,46
Queen's Park,987,8,12,10,14,43,53,-10,46
East Fife,987,9,11,10,15,47,42,5,43
Stenhousem'r,987,10,5,7,24,37,79,-42,22
Alloa,988,1,20,7,9,80,48,32,67
Livingston,988,2,19,8,9,75,41,34,65
Brechin,988,3,15,9,12,46,52,-6,54
East Fife,988,4,14,9,13,45,38,7,51
Airdrieon,988,5,14,9,13,51,50,1,51
Peterhead,988,6,14,8,14,47,54,-7,50
Stranraer,988,7,14,6,16,44,49,-5,48
Albion,988,8,13,7,16,48,50,-2,46
Queen's Park,988,9,10,11,15,35,52,-17,41
Stenhousem'r,988,10,5,10,21,40,77,-37,25
Livingston,989,1,24,4,8,77,37,40,76
Airdrieon,989,2,18,9,9,56,47,9,63
Alloa,989,3,17,10,9,71,42,29,61
East Fife,989,4,14,9,13,52,47,5,51
Stranraer,989,5,15,5,16,56,62,-6,50
Albion,989,6,13,9,14,52,51,1,48
Peterhead,989,7,12,11,13,54,53,1,47
Brechin,989,8,13,7,16,53,68,-15,46
Queen's Park,989,9,12,7,17,42,55,-13,43
Stenhousem'r,989,10,4,5,27,45,96,-51,17
Livingston,990,1,25,4,7,79,45,34,79
Alloa,990,2,18,10,8,70,45,25,64
Airdrieon,990,3,19,6,11,61,54,7,63
Brechin,990,4,17,7,12,60,48,12,58
Albion,990,5,14,10,12,61,52,9,52
East Fife,990,6,13,8,15,48,49,-1,47
Peterhead,990,7,13,7,16,54,61,-7,46
Stranraer,990,8,12,3,21,48,61,-13,39
Queen's Park,990,9,10,6,20,38,65,-27,36
Stenhousem'r,990,10,6,5,25,48,87,-39,23
Livingston,991,1,24,4,8,84,51,33,76
Airdrieon,991,2,20,5,11,71,50,21,65
Peterhead,991,3,18,4,14,54,53,1,58
Alloa,991,4,17,6,13,64,43,21,57
Albion,991,5,15,7,14,58,51,7,52
Brechin,991,6,15,6,15,48,50,-2,51
Stranraer,991,7,14,4,18,53,59,-6,46
East Fife,991,8,8,13,15,44,50,-6,37
Queen's Park,991,9,10,5,21,30,63,-33,35
Stenhousem'r,991,10,9,6,21,46,82,-36,33
Alloa,992,1,21,7,8,66,37,29,70
Livingston,992,2,22,2,12,82,56,26,68
Airdrieon,992,3,18,3,15,56,56,0,57
Stranraer,992,4,16,7,13,49,51,-2,55
Albion,992,5,15,6,15,57,46,11,51
Brechin,992,6,15,6,15,45,51,-6,51
Queen's Park,992,7,13,7,16,41,51,-10,46
Peterhead,992,8,12,9,15,44,49,-5,45
East Fife,992,9,9,12,15,50,49,1,39
Stenhousem'r,992,10,7,5,24,45,89,-44,26
Alloa,993,1,21,8,7,64,31,33,71
Livingston,993,2,22,5,9,75,48,27,71
Brechin,993,3,19,7,10,56,42,14,64
Peterhead,993,4,15,8,13,57,50,7,53
Airdrieon,993,5,15,8,13,56,52,4,53
Stranraer,993,6,11,7,18,43,55,-12,40
East Fife,993,7,9,12,15,46,47,-1,39
Queen's Park,993,8,9,12,15,30,50,-20,39
Albion,993,9,9,9,18,45,62,-17,36
Stenhousem'r,993,10,8,8,20,44,79,-35,32
Livingston,994,1,20,4,12,71,49,22,64
Airdrieon,994,2,19,6,11,58,55,3,63
Brechin,994,3,19,4,13,51,39,12,61
Alloa,994,4,17,8,11,58,42,16,59
Albion,994,5,17,8,11,58,44,14,59
Queen's Park,994,6,12,9,15,32,42,-10,45
Stranraer,994,7,13,4,19,44,55,-11,43
Peterhead,994,8,12,7,17,36,54,-18,43
East Fife,994,9,11,8,17,47,48,-1,41
Stenhousem'r,994,10,7,8,21,42,69,-27,29
Livingston,995,1,17,7,12,72,57,15,58
Airdrieon,995,2,16,10,10,60,50,10,58
Alloa,995,3,15,11,10,58,43,15,56
Peterhead,995,4,15,9,12,52,47,5,54
Albion,995,5,14,11,11,59,44,15,53
East Fife,995,6,15,8,13,50,41,9,53
Brechin,995,7,14,11,11,47,43,4,53
Queen's Park,995,8,11,9,16,33,47,-14,42
Stranraer,995,9,10,6,20,41,65,-24,36
Stenhousem'r,995,10,8,8,20,44,79,-35,32
Brechin,996,1,20,7,9,60,41,19,67
Alloa,996,2,17,9,10,66,47,19,60
Peterhead,996,3,16,8,12,48,49,-1,56
Airdrieon,996,4,15,8,13,64,62,2,53
Livingston,996,5,15,7,14,66,58,8,52
Albion,996,6,13,8,15,55,60,-5,47
Queen's Park,996,7,11,12,13,47,55,-8,45
Stranraer,996,8,11,9,16,48,58,-10,42
East Fife,996,9,9,12,15,49,47,2,39
Stenhousem'r,996,10,10,6,20,52,78,-26,36
Alloa,997,1,19,9,8,72,37,35,66
Airdrieon,997,2,18,8,10,63,50,13,62
Peterhead,997,3,17,10,9,52,43,9,61
Livingston,997,4,17,7,12,63,46,17,58
Albion,997,5,15,9,12,54,48,6,54
Stranraer,997,6,14,7,15,51,59,-8,49
East Fife,997,7,11,9,16,43,51,-8,42
Brechin,997,8,11,8,17,44,57,-13,41
Queen's Park,997,9,9,10,17,35,47,-12,37
Stenhousem'r,997,10,7,7,22,44,83,-39,28
Livingston,998,1,24,2,10,79,44,35,74
Alloa,998,2,17,10,9,75,43,32,61
Brechin,998,3,18,6,12,64,64,0,60
Airdrieon,998,4,16,7,13,58,58,0,55
Stranraer,998,5,15,5,16,48,49,-1,50
Peterhead,998,6,14,6,16,50,55,-5,48
Albion,998,7,13,8,15,54,52,2,47
East Fife,998,8,12,7,17,42,44,-2,43
Queen's Park,998,9,10,11,15,40,54,-14,41
Stenhousem'r,998,10,7,6,23,42,89,-47,27
Livingston,999,1,22,5,9,88,53,35,71
Alloa,999,2,19,7,10,75,43,32,64
Airdrieon,999,3,17,6,13,58,52,6,57
Brechin,999,4,17,6,13,50,47,3,57
Albion,999,5,16,7,13,59,51,8,55
Peterhead,999,6,15,6,15,45,52,-7,51
East Fife,999,7,13,6,17,55,55,0,45
Stranraer,999,8,12,6,18,50,63,-13,42
Queen's Park,999,9,10,6,20,36,57,-21,36
Stenhousem'r,999,10,8,7,21,37,80,-43,31
Livingston,1000,1,20,8,8,69,45,24,68
Alloa,1000,2,18,10,8,75,47,28,64
Airdrieon,1000,3,19,6,11,60,52,8,63
Peterhead,1000,4,15,9,12,48,46,2,54
East Fife,1000,5,14,9,13,62,51,11,51
Albion,1000,6,13,8,15,55,44,11,47
Stranraer,1000,7,13,7,16,47,55,-8,46
Brechin,1000,8,12,8,16,51,66,-15,44
Queen's Park,1000,9,10,11,15,28,43,-15,41
Stenhousem'r,1000,10,4,8,24,42,88,-46,20
Livingston,1001,1,23,2,11,75,39,36,71
Alloa,1001,2,21,8,7,76,41,35,71
Brechin,1001,3,21,6,9,58,42,16,69
Airdrieon,1001,4,16,8,12,59,52,7,56
Peterhead,1001,5,15,4,17,47,59,-12,49
Albion,1001,6,14,5,17,53,53,0,47
Stranraer,1001,7,14,4,18,45,53,-8,46
East Fife,1001,8,12,9,15,54,54,0,45
Queen's Park,1001,9,11,4,21,28,57,-29,37
Stenhousem'r,1001,10,4,8,24,35,80,-45,20
Livingston,1002,1,22,4,10,82,51,31,70
Airdrieon,1002,2,21,7,8,66,49,17,70
Brechin,1002,3,18,7,11,64,53,11,61
Alloa,1002,4,14,13,9,71,51,20,55
East Fife,1002,5,13,10,13,59,46,13,49
Albion,1002,6,13,8,15,47,51,-4,47
Stranraer,1002,7,12,7,17,56,65,-9,43
Peterhead,1002,8,9,11,16,45,65,-20,38
Queen's Park,1002,9,10,6,20,35,62,-27,36
Stenhousem'r,1002,10,5,13,18,44,76,-32,28
Brechin,1003,1,22,6,8,63,43,20,72
Livingston,1003,2,21,7,8,80,50,30,70
Alloa,1003,3,15,10,11,60,48,12,55
Albion,1003,4,14,8,14,52,47,5,50
East Fife,1003,5,13,9,14,47,49,-2,48
Airdrieon,1003,6,13,9,14,56,60,-4,48
Peterhead,1003,7,12,11,13,43,49,-6,47
Queen's Park,1003,8,10,11,15,39,48,-9,41
Stranraer,1003,9,9,6,21,46,66,-20,33
Stenhousem'r,1003,10,7,11,18,40,66,-26,32
Livingston,1004,1,22,3,11,86,57,29,69
Alloa,1004,2,19,6,11,67,45,22,63
Albion,1004,3,18,5,13,54,47,7,59
Brechin,1004,4,17,7,12,53,47,6,58
Airdrieon,1004,5,15,7,14,56,56,0,52
Peterhead,1004,6,13,7,16,43,53,-10,46
Queen's Park,1004,7,13,5,18,35,51,-16,44
East Fife,1004,8,10,9,17,46,46,0,39
Stranraer,1004,9,9,11,16,47,59,-12,38
Stenhousem'r,1004,10,10,8,18,47,73,-26,38
Livingston,1005,1,21,4,11,83,50,33,67
Alloa,1005,2,18,8,10,69,50,19,62
Albion,1005,3,17,8,11,59,45,14,59
Airdrieon,1005,4,16,9,11,58,52,6,57
Brechin,1005,5,13,7,16,45,45,0,46
Stranraer,1005,6,13,7,16,50,60,-10,46
East Fife,1005,7,11,11,14,49,46,3,44
Peterhead,1005,8,11,11,14,53,60,-7,44
Queen's Park,1005,9,9,11,16,30,55,-25,38
Stenhousem'r,1005,10,8,10,18,48,81,-33,34
Alloa,1006,1,21,8,7,73,38,35,71
Livingston,1006,2,16,9,11,67,49,18,57
Albion,1006,3,15,10,11,60,45,15,55
East Fife,1006,4,15,10,11,49,38,11,55
Queen's Park,1006,5,15,6,15,39,50,-11,51
Brechin,1006,6,14,8,14,49,55,-6,50
Airdrieon,1006,7,12,8,16,55,64,-9,44
Peterhead,1006,8,12,8,16,50,60,-10,44
Stranraer,1006,9,13,3,20,54,65,-11,42
Stenhousem'r,1006,10,9,6,21,39,71,-32,33
Livingston,1007,1,23,3,10,88,57,31,72
Alloa,1007,2,18,8,10,79,50,29,62
Brechin,1007,3,17,3,16,43,46,-3,54
Peterhead,1007,4,14,9,13,53,51,2,51
Airdrieon,1007,5,14,9,13,48,53,-5,51
Queen's Park,1007,6,14,7,15,46,53,-7,49
Stranraer,1007,7,13,6,17,53,60,-7,45
Albion,1007,8,12,9,15,51,59,-8,45
East Fife,1007,9,9,16,11,45,41,4,43
Stenhousem'r,1007,10,7,8,21,42,78,-36,29
Alloa,1008,1,18,8,10,69,41,28,62
Livingston,1008,2,16,10,10,62,44,18,58
Airdrieon,1008,3,15,13,8,58,47,11,58
Brechin,1008,4,16,7,13,55,54,1,55
Albion,1008,5,15,8,13,60,53,7,53
Peterhead,1008,6,13,10,13,48,48,0,49
East Fife,1008,7,12,9,15,50,56,-6,45
Stranraer,1008,8,12,8,16,47,54,-7,44
Queen's Park,1008,9,8,11,17,33,53,-20,35
Stenhousem'r,1008,10,9,8,19,45,77,-32,35
Livingston,1009,1,22,5,9,72,40,32,71
Airdrieon,1009,2,20,7,9,64,40,24,67
Alloa,1009,3,16,5,15,55,48,7,53
Peterhead,1009,4,16,5,15,48,59,-11,53
Albion,1009,5,13,10,13,54,49,5,49
Queen's Park,1009,6,13,8,15,48,53,-5,47
Brechin,1009,7,13,5,18,49,59,-10,44
East Fife,1009,8,11,10,15,47,48,-1,43
Stenhousem'r,1009,9,11,7,18,52,75,-23,40
Stranraer,1009,10,10,8,18,43,61,-18,38
Airdrieon,1010,1,21,6,9,66,53,13,69
Alloa,1010,2,18,10,8,71,51,20,64
Livingston,1010,3,17,5,14,75,66,9,56
Brechin,1010,4,16,7,13,57,55,2,55
Stranraer,1010,5,16,5,15,59,49,10,53
Queen's Park,1010,6,13,8,15,45,53,-8,47
Peterhead,1010,7,12,8,16,45,53,-8,44
East Fife,1010,8,10,12,14,57,51,6,42
Albion,1010,9,10,8,18,49,67,-18,38
Stenhousem'r,1010,10,9,7,20,57,83,-26,34
Livingston,1011,1,23,6,7,84,47,37,75
Alloa,1011,2,19,6,11,68,48,20,63
Airdrieon,1011,3,15,9,12,59,53,6,54
Brechin,1011,4,16,6,14,53,50,3,54
Peterhead,1011,5,15,6,15,43,48,-5,51
Queen's Park,1011,6,14,8,14,48,56,-8,50
Albion,1011,7,12,10,14,51,56,-5,46
East Fife,1011,8,11,12,13,47,44,3,45
Stranraer,1011,9,9,8,19,47,63,-16,35
Stenhousem'r,1011,10,7,7,22,48,83,-35,28
Airdrieon,1012,1,19,7,10,64,47,17,64
Livingston,1012,2,19,5,12,81,53,28,62
Alloa,1012,3,18,7,11,67,41,26,61
Brechin,1012,4,14,12,10,44,38,6,54
Albion,1012,5,14,10,12,47,49,-2,52
Peterhead,1012,6,13,8,15,47,60,-13,47
Queen's Park,1012,7,13,7,16,37,47,-10,46
Stranraer,1012,8,12,7,17,41,57,-16,43
East Fife,1012,9,10,9,17,52,56,-4,39
Stenhousem'r,1012,10,8,8,20,46,78,-32,32
Livingston,1013,1,21,4,11,74,49,25,67
Alloa,1013,2,19,9,8,77,39,38,66
Airdrieon,1013,3,19,9,8,53,43,10,66
Brechin,1013,4,14,11,11,62,55,7,53
Peterhead,1013,5,12,12,12,45,56,-11,48
Queen's Park,1013,6,13,7,16,42,50,-8,46
Albion,1013,7,11,11,14,49,57,-8,44
Stranraer,1013,8,10,7,19,40,59,-19,37
East Fife,1013,9,6,15,15,43,51,-8,33
Stenhousem'r,1013,10,8,9,19,46,72,-26,33
Livingston,1014,1,22,5,9,81,46,35,71
Alloa,1014,2,22,5,9,76,43,33,71
Airdrieon,1014,3,19,6,11,69,58,11,63
Brechin,1014,4,19,4,13,57,50,7,61
Albion,1014,5,17,6,13,57,49,8,57
Peterhead,1014,6,14,6,16,51,58,-7,48
Queen's Park,1014,7,13,5,18,41,55,-14,44
East Fife,1014,8,11,6,19,55,52,3,39
Stranraer,1014,9,8,12,16,46,65,-19,36
Stenhousem'r,1014,10,4,7,25,40,97,-57,19
Alloa,1015,1,19,7,10,71,39,32,64
Airdrieon,1015,2,19,7,10,59,52,7,64
Albion,1015,3,19,6,11,60,47,13,63
Livingston,1015,4,17,8,11,73,51,22,59
Brechin,1015,5,17,7,12,50,43,7,58
Queen's Park,1015,6,15,7,14,49,48,1,52
East Fife,1015,7,11,10,15,50,46,4,43
Peterhead,1015,8,11,7,18,50,63,-13,40
Stranraer,1015,9,11,6,19,41,64,-23,39
Stenhousem'r,1015,10,5,7,24,43,93,-50,22
Livingston,1016,1,24,5,7,95,47,48,77
Alloa,1016,2,18,10,8,73,44,29,64
Queen's Park,1016,3,18,7,11,59,49,10,61
Brechin,1016,4,16,7,13,52,47,5,55
Airdrieon,1016,5,15,9,12,50,55,-5,54
Peterhead,1016,6,14,7,15,49,63,-14,49
Albion,1016,7,13,7,16,60,76,-16,46
Stranraer,1016,8,8,8,20,43,61,-18,32
Stenhousem'r,1016,9,7,11,18,52,76,-24,32
East Fife,1016,10,8,7,21,47,62,-15,31
Livingston,1017,1,17,7,12,71,59,12,58
Peterhead,1017,2,16,10,10,61,52,9,58
Albion,1017,3,17,5,14,54,49,5,56
Brechin,1017,4,16,7,13,55,60,-5,55
Airdrieon,1017,5,16,6,14,57,50,7,54
Stranraer,1017,6,16,4,16,59,54,5,52
Alloa,1017,7,14,9,13,59,46,13,51
Queen's Park,1017,8,11,9,16,35,51,-16,42
East Fife,1017,9,8,13,15,48,55,-7,37
Stenhousem'r,1017,10,9,10,17,52,75,-23,37
Livingston,1018,1,21,3,12,77,46,31,66
Brechin,1018,2,19,7,10,54,44,10,64
Airdrieon,1018,3,18,7,11,60,48,12,61
Alloa,1018,4,16,7,13,60,47,13,55
East Fife,1018,5,14,11,11,53,44,9,53
Stranraer,1018,6,14,7,15,53,57,-4,49
Albion,1018,7,14,5,17,48,53,-5,47
Queen's Park,1018,8,13,6,17,36,53,-17,45
Peterhead,1018,9,9,7,20,38,55,-17,34
Stenhousem'r,1018,10,8,8,20,47,79,-32,32
Livingston,1019,1,20,7,9,76,47,29,67
Alloa,1019,2,20,7,9,74,45,29,67
Albion,1019,3,16,10,10,63,47,16,58
Brechin,1019,4,16,9,11,46,45,1,57
Peterhead,1019,5,15,11,10,52,51,1,56
Airdrieon,1019,6,15,7,14,67,56,11,52
East Fife,1019,7,10,11,15,51,50,1,41
Queen's Park,1019,8,11,4,21,35,61,-26,37
Stranraer,1019,9,9,7,20,50,67,-17,34
Stenhousem'r,1019,10,9,5,22,39,84,-45,32
Alloa,1020,1,21,8,7,69,45,24,71
Airdrieon,1020,2,18,8,10,69,58,11,62
Livingston,1020,3,17,7,12,70,52,18,58
Peterhead,1020,4,18,4,14,60,58,2,58
Queen's Park,1020,5,15,8,13,41,43,-2,53
Albion,1020,6,14,7,15,54,55,-1,49
Brechin,1020,7,14,5,17,46,45,1,47
Stranraer,1020,8,10,7,19,49,61,-12,37
East Fife,1020,9,9,9,18,56,63,-7,36
Stenhousem'r,1020,10,8,9,19,43,77,-34,33
Livingston,1021,1,24,5,7,90,47,43,77
Albion,1021,2,17,8,11,50,46,4,59
Airdrieon,1021,3,16,6,14,58,64,-6,54
Alloa,1021,4,14,9,13,62,46,16,51
Brechin,1021,5,13,12,11,46,44,2,51
East Fife,1021,6,13,11,12,52,40,12,50
Peterhead,1021,7,12,9,15,54,58,-4,45
Stranraer,1021,8,13,4,19,51,56,-5,43
Queen's Park,1021,9,12,6,18,38,60,-22,42
Stenhousem'r,1021,10,6,10,20,40,80,-40,28
Livingston,1022,1,18,6,12,77,56,21,60
Alloa,1022,2,17,9,10,66,50,16,60
Airdrieon,1022,3,16,8,12,55,55,0,56
Brechin,1022,4,15,8,13,52,45,7,53
Queen's Park,1022,5,15,8,13,47,48,-1,53
Stranraer,1022,6,15,6,15,60,54,6,51
Peterhead,1022,7,14,9,13,52,59,-7,51
Albion,1022,8,12,10,14,54,57,-3,46
East Fife,1022,9,10,8,18,51,52,-1,38
Stenhousem'r,1022,10,9,6,21,43,81,-38,33
Livingston,1023,1,19,6,11,76,53,23,63
Alloa,1023,2,17,10,9,79,51,28,61
Brechin,1023,3,15,11,10,46,43,3,56
Stranraer,1023,4,16,5,15,56,59,-3,53
Peterhead,1023,5,14,9,13,50,51,-1,51
Airdrieon,1023,6,14,8,14,60,59,1,50
Albion,1023,7,13,9,14,49,48,1,48
Queen's Park,1023,8,14,6,16,39,50,-11,48
East Fife,1023,9,9,11,16,43,49,-6,38
Stenhousem'r,1023,10,7,9,20,45,80,-35,30
Livingston,1024,1,23,3,10,79,44,35,72
Alloa,1024,2,18,8,10,71,49,22,62
Brechin,1024,3,17,6,13,51,47,4,57
Albion,1024,4,15,9,12,62,49,13,54
Stranraer,1024,5,16,4,16,55,57,-2,52
Airdrieon,1024,6,14,8,14,59,61,-2,50
East Fife,1024,7,12,10,14,51,53,-2,46
Queen's Park,1024,8,14,4,18,39,52,-13,46
Peterhead,1024,9,12,5,19,45,63,-18,41
Stenhousem'r,1024,10,6,9,21,41,78,-37,27
Alloa,1025,1,23,4,9,87,48,39,73
Airdrieon,1025,2,22,5,9,72,61,11,71
Livingston,1025,3,21,2,13,68,48,20,65
Brechin,1025,4,16,8,12,48,49,-1,56
East Fife,1025,5,13,8,15,52,44,8,47
Peterhead,1025,6,12,9,15,52,57,-5,45
Albion,1025,7,12,8,16,57,64,-7,44
Queen's Park,1025,8,12,6,18,39,60,-21,42
Stenhousem'r,1025,9,8,11,17,55,72,-17,35
Stranraer,1025,10,7,7,22,39,66,-27,28
Alloa,1026,1,20,6,10,81,49,32,66
Airdrieon,1026,2,20,5,11,56,49,7,65
Livingston,1026,3,18,7,11,69,51,18,61
Brechin,1026,4,16,6,14,47,49,-2,54
Stenhousem'r,1026,5,15,7,14,53,65,-12,52
Albion,1026,6,12,10,14,50,51,-1,46
East Fife,1026,7,13,6,17,50,45,5,45
Peterhead,1026,8,12,8,16,47,50,-3,44
Queen's Park,1026,9,9,12,15,34,57,-23,39
Stranraer,1026,10,9,5,22,46,67,-21,32
Livingston,1027,1,21,6,9,87,47,40,69
Airdrieon,1027,2,18,11,7,73,51,22,65
Alloa,1027,3,19,7,10,73,50,23,64
Albion,1027,4,16,10,10,61,47,14,58
Brechin,1027,5,14,6,16,48,58,-10,48
Stranraer,1027,6,13,7,16,50,58,-8,46
Queen's Park,1027,7,12,8,16,32,52,-20,44
Peterhead,1027,8,11,10,15,48,57,-9,43
East Fife,1027,9,8,13,15,46,50,-4,37
Stenhousem'r,1027,10,7,4,25,39,87,-48,25
Livingston,1028,1,19,7,10,88,54,34,64
Alloa,1028,2,18,9,9,65,40,25,63
Stranraer,1028,3,16,6,14,62,66,-4,54
Brechin,1028,4,14,11,11,46,44,2,53
Queen's Park,1028,5,14,9,13,48,53,-5,51
Airdrieon,1028,6,12,8,16,47,55,-8,44
Peterhead,1028,7,12,8,16,43,54,-11,44
East Fife,1028,8,9,14,13,52,47,5,41
Stenhousem'r,1028,9,11,8,17,49,74,-25,41
Albion,1028,10,10,10,16,47,60,-13,40
Livingston,1029,1,22,6,8,77,44,33,72
Alloa,1029,2,20,6,10,73,43,30,66
Airdrieon,1029,3,19,9,8,66,50,16,66
Queen's Park,1029,4,15,6,15,37,46,-9,51
Brechin,1029,5,14,7,15,46,54,-8,49
Albion,1029,6,13,7,16,51,56,-5,46
Peterhead,1029,7,12,9,15,50,61,-11,45
Stranraer,1029,8,13,2,21,54,58,-4,41
East Fife,1029,9,9,13,14,45,48,-3,40
Stenhousem'r,1029,10,8,5,23,48,87,-39,29
Brechin,1030,1,20,7,9,59,37,22,67
Airdrieon,1030,2,20,6,10,71,53,18,66
Livingston,1030,3,18,6,12,74,58,16,60
Alloa,1030,4,15,8,13,51,38,13,53
Stranraer,1030,5,14,6,16,51,60,-9,48
Albion,1030,6,14,4,18,56,63,-7,46
East Fife,1030,7,11,11,14,52,42,10,44
Peterhead,1030,8,12,7,17,47,59,-12,43
Queen's Park,1030,9,11,6,19,48,71,-23,39
Stenhousem'r,1030,10,10,9,17,53,81,-28,39
Alloa,1031,1,19,8,9,75,38,37,65
Livingston,1031,2,20,5,11,78,62,16,65
Brechin,1031,3,18,4,14,59,54,5,58
Queen's Park,1031,4,16,4,16,42,52,-10,52
East Fife,1031,5,12,14,10,55,46,9,50
Airdrieon,1031,6,12,11,13,59,63,-4,47
Peterhead,1031,7,11,12,13,46,56,-10,45
Albion,1031,8,10,13,13,48,57,-9,43
Stranraer,1031,9,10,8,18,58,69,-11,38
Stenhousem'r,1031,10,9,7,20,51,74,-23,34
Alloa,1032,1,22,6,8,73,40,33,72
Livingston,1032,2,21,5,10,74,40,34,68
Peterhead,1032,3,16,8,12,51,48,3,56
East Fife,1032,4,14,10,12,59,49,10,52
Airdrieon,1032,5,15,7,14,56,54,2,52
Albion,1032,6,14,7,15,52,51,1,49
Brechin,1032,7,12,7,17,41,58,-17,43
Stranraer,1032,8,11,8,17,43,54,-11,41
Queen's Park,1032,9,11,7,18,36,60,-24,40
Stenhousem'r,1032,10,7,9,20,44,75,-31,30
Airdrieon,1033,1,21,8,7,72,43,29,71
Livingston,1033,2,21,6,9,71,46,25,69
Alloa,1033,3,18,9,9,71,41,30,63
East Fife,1033,4,13,9,14,53,48,5,48
Brechin,1033,5,13,8,15,42,48,-6,47
Peterhead,1033,6,12,9,15,49,54,-5,45
Albion,1033,7,12,9,15,49,59,-10,45
Queen's Park,1033,8,12,7,17,38,59,-21,43
Stenhousem'r,1033,9,9,10,17,48,75,-27,37
Stranraer,1033,10,7,9,20,44,64,-20,30
Alloa,1034,1,19,9,8,73,47,26,66
Livingston,1034,2,18,8,10,77,52,25,62
East Fife,1034,3,16,11,9,68,46,22,59
Airdrieon,1034,4,16,8,12,52,54,-2,56
Stranraer,1034,5,14,10,12,51,49,2,52
Queen's Park,1034,6,13,9,14,48,56,-8,48
Albion,1034,7,13,6,17,55,60,-5,45
Brechin,1034,8,12,4,20,46,62,-16,40
Peterhead,1034,9,10,9,17,40,55,-15,39
Stenhousem'r,1034,10,8,8,20,51,80,-29,32
Brechin,1035,1,21,8,7,57,40,17,71
Livingston,1035,2,21,3,12,75,46,29,66
Peterhead,1035,3,16,9,11,45,45,0,57
Alloa,1035,4,17,4,15,71,58,13,55
Airdrieon,1035,5,15,8,13,57,50,7,53
East Fife,1035,6,14,7,15,51,47,4,49
Albion,1035,7,13,6,17,43,53,-10,45
Stranraer,1035,8,13,5,18,44,51,-7,44
Queen's Park,1035,9,11,5,20,38,55,-17,38
Stenhousem'r,1035,10,8,7,21,51,87,-36,31
Livingston,1036,1,22,2,12,71,46,25,68
Peterhead,1036,2,19,7,10,50,39,11,64
Brechin,1036,3,19,4,13,48,41,7,61
Alloa,1036,4,17,8,11,63,46,17,59
Albion,1036,5,15,6,15,53,50,3,51
Airdrieon,1036,6,15,6,15,53,51,2,51
Queen's Park,1036,7,15,6,15,41,45,-4,51
East Fife,1036,8,11,5,20,44,51,-7,38
Stenhousem'r,1036,9,10,6,20,43,75,-32,36
Stranraer,1036,10,11,2,23,45,67,-22,35
Livingston,1037,1,23,4,9,82,44,38,73
Alloa,1037,2,18,10,8,69,41,28,64
Brechin,1037,3,19,3,14,52,39,13,60
Airdrieon,1037,4,17,7,12,57,51,6,58
Peterhead,1037,5,16,5,15,52,52,0,53
Albion,1037,6,14,9,13,60,61,-1,51
Queen's Park,1037,7,13,10,13,35,46,-11,49
Stranraer,1037,8,13,2,21,51,60,-9,41
East Fife,1037,9,10,10,16,50,51,-1,40
Stenhousem'r,1037,10,5,4,27,37,100,-63,19
Alloa,1038,1,20,8,8,69,41,28,68
Livingston,1038,2,19,7,10,76,48,28,64
Brechin,1038,3,17,7,12,50,41,9,58
Peterhead,1038,4,14,10,12,55,51,4,52
Airdrieon,1038,5,15,7,14,52,49,3,52
East Fife,1038,6,14,8,14,54,46,8,50
Queen's Park,1038,7,13,9,14,47,61,-14,48
Albion,1038,8,11,8,17,52,62,-10,41
Stranraer,1038,9,12,4,20,55,75,-20,40
Stenhousem'r,1038,10,8,6,22,43,79,-36,30
Alloa,1039,1,20,6,10,68,42,26,66
Livingston,1039,2,18,6,12,63,44,19,60
Airdrieon,1039,3,18,6,12,59,50,9,60
Brechin,1039,4,18,3,15,53,51,2,57
Albion,1039,5,13,10,13,51,48,3,49
Peterhead,1039,6,12,10,14,50,54,-4,46
Stranraer,1039,7,12,8,16,47,55,-8,44
East Fife,1039,8,11,10,15,54,55,-1,43
Queen's Park,1039,9,11,9,16,42,55,-13,42
Stenhousem'r,1039,10,9,8,19,49,82,-33,35
Alloa,1040,1,18,8,10,63,47,16,62
Livingston,1040,2,16,9,11,73,61,12,57
Brechin,1040,3,16,8,12,48,43,5,56
Albion,1040,4,14,11,11,54,45,9,53
Airdrieon,1040,5,14,10,12,56,52,4,52
Stranraer,1040,6,15,6,15,52,50,2,51
Peterhead,1040,7,14,9,13,55,56,-1,51
Queen's Park,1040,8,12,10,14,36,44,-8,46
East Fife,1040,9,10,12,14,46,43,3,42
Stenhousem'r,1040,10,4,11,21,48,90,-42,23
Alloa,1041,1,19,9,8,75,49,26,66
Livingston,1041,2,20,5,11,74,49,25,65
Albion,1041,3,18,5,13,53,45,8,59
Brechin,1041,4,17,5,14,55,48,7,56
Airdrieon,1041,5,16,5,15,52,50,2,53
Stranraer,1041,6,16,3,17,56,61,-5,51
Peterhead,1041,7,12,7,17,45,57,-12,43
Queen's Park,1041,8,12,7,17,37,56,-19,43
East Fife,1041,9,10,9,17,48,55,-7,39
Stenhousem'r,1041,10,6,13,17,48,73,-25,31
Alloa,1042,1,23,5,8,69,36,33,74
Brechin,1042,2,22,3,11,58,39,19,69
Livingston,1042,3,21,4,11,66,47,19,67
Albion,1042,4,15,11,10,53,39,14,56
Peterhead,1042,5,16,5,15,50,47,3,53
Airdrieon,1042,6,13,7,16,49,61,-12,46
Stranraer,1042,7,11,8,17,43,55,-12,41
East Fife,1042,8,10,10,16,50,57,-7,40
Queen's Park,1042,9,10,5,21,39,55,-16,35
Stenhousem'r,1042,10,6,8,22,37,78,-41,26
Brechin,1043,1,20,8,8,71,43,28,68
Livingston,1043,2,20,7,9,73,44,29,67
Alloa,1043,3,20,6,10,79,44,35,66
Airdrieon,1043,4,18,6,12,57,56,1,60
Peterhead,1043,5,12,9,15,40,54,-14,45
Queen's Park,1043,6,12,8,16,41,59,-18,44
Albion,1043,7,11,9,16,56,61,-5,42
East Fife,1043,8,10,11,15,48,55,-7,41
Stranraer,1043,9,9,6,21,51,70,-19,33
Stenhousem'r,1043,10,7,12,17,43,73,-30,33
Livingston,1044,1,19,5,12,77,51,26,62
Alloa,1044,2,17,8,11,72,48,24,59
East Fife,1044,3,15,9,12,55,42,13,54
Peterhead,1044,4,14,10,12,52,50,2,52
Brechin,1044,5,15,7,14,53,62,-9,52
Airdrieon,1044,6,14,8,14,59,55,4,50
Queen's Park,1044,7,13,8,15,49,53,-4,47
Stranraer,1044,8,10,12,14,50,63,-13,42
Albion,1044,9,11,9,16,45,61,-16,42
Stenhousem'r,1044,10,10,8,18,59,86,-27,38
Livingston,1045,1,22,5,9,86,48,38,71
Alloa,1045,2,16,13,7,68,45,23,61
Brechin,1045,3,14,12,10,45,40,5,54
Airdrieon,1045,4,15,8,13,63,63,0,53
Peterhead,1045,5,15,6,15,49,49,0,51
East Fife,1045,6,13,9,14,60,50,10,48
Albion,1045,7,11,14,11,50,55,-5,47
Stranraer,1045,8,12,7,17,47,53,-6,43
Queen's Park,1045,9,11,8,17,36,54,-18,41
Stenhousem'r,1045,10,5,10,21,38,85,-47,25
Alloa,1046,1,19,7,10,77,46,31,64
Livingston,1046,2,18,7,11,67,40,27,61
Airdrieon,1046,3,16,10,10,55,51,4,58
Peterhead,1046,4,16,8,12,58,52,6,56
Brechin,1046,5,16,6,14,53,48,5,54
Queen's Park,1046,6,14,9,13,43,46,-3,51
Albion,1046,7,13,9,14,56,65,-9,48
Stenhousem'r,1046,8,9,11,16,47,71,-24,38
Stranraer,1046,9,9,8,19,45,70,-25,35
East Fife,1046,10,8,9,19,48,60,-12,33
Alloa,1047,1,22,7,7,76,39,37,73
Livingston,1047,2,21,7,8,80,44,36,70
Peterhead,1047,3,16,8,12,52,49,3,56
Brechin,1047,4,15,8,13,52,48,4,53
Albion,1047,5,15,8,13,57,62,-5,53
Airdrieon,1047,6,16,4,16,52,52,0,52
Stranraer,1047,7,14,3,19,50,57,-7,45
Queen's Park,1047,8,11,7,18,31,57,-26,40
East Fife,1047,9,9,8,19,50,53,-3,35
Stenhousem'r,1047,10,9,4,23,49,88,-39,31
Alloa,1048,1,21,6,9,73,43,30,69
Livingston,1048,2,21,3,12,88,46,42,66
Brechin,1048,3,19,6,11,57,43,14,63
Peterhead,1048,4,16,7,13,48,51,-3,55
Airdrieon,1048,5,15,8,13,54,52,2,53
Albion,1048,6,14,9,13,51,51,0,51
Queen's Park,1048,7,14,4,18,34,58,-24,46
Stranraer,1048,8,12,7,17,57,67,-10,43
East Fife,1048,9,10,10,16,53,54,-1,40
Stenhousem'r,1048,10,4,8,24,50,100,-50,20
Alloa,1049,1,21,10,5,73,39,34,73
Livingston,1049,2,21,4,11,71,48,23,67
Brechin,1049,3,15,10,11,53,52,1,55
Airdrieon,1049,4,15,8,13,56,57,-1,53
Albion,1049,5,13,8,15,49,45,4,47
Stranraer,1049,6,13,7,16,48,58,-10,46
East Fife,1049,7,13,6,17,48,45,3,45
Peterhead,1049,8,12,6,18,49,57,-8,42
Queen's Park,1049,9,9,11,16,34,54,-20,38
Stenhousem'r,1049,10,10,6,20,45,71,-26,36
Livingston,1050,1,21,6,9,77,52,25,69
Alloa,1050,2,19,10,7,79,40,39,67
Airdrieon,1050,3,17,8,11,58,48,10,59
Brechin,1050,4,15,7,14,42,48,-6,52
Stranraer,1050,5,12,10,14,56,59,-3,46
Albion,1050,6,12,8,16,60,62,-2,44
Queen's Park,1050,7,11,8,17,33,53,-20,41
Stenhousem'r,1050,8,11,8,17,42,73,-31,41
Peterhead,1050,9,10,10,16,41,52,-11,40
East Fife,1050,10,10,9,17,43,44,-1,39
Livingston,1051,1,20,7,9,81,42,39,67
Brechin,1051,2,21,4,11,55,43,12,67
Airdrieon,1051,3,18,5,13,61,63,-2,59
Alloa,1051,4,15,8,13,56,48,8,53
Peterhead,1051,5,14,10,12,52,49,3,52
Albion,1051,6,14,7,15,47,47,0,49
Stranraer,1051,7,12,8,16,46,54,-8,44
Queen's Park,1051,8,12,8,16,45,55,-10,44
East Fife,1051,9,10,10,16,45,54,-9,40
Stenhousem'r,1051,10,6,9,21,41,74,-33,27
Livingston,1052,1,24,2,10,87,51,36,74
Alloa,1052,2,19,10,7,81,47,34,67
Brechin,1052,3,18,6,12,62,46,16,60
East Fife,1052,4,13,11,12,50,38,12,50
Airdrieon,1052,5,13,10,13,54,62,-8,49
Queen's Park,1052,6,14,5,17,38,54,-16,47
Albion,1052,7,12,8,16,54,59,-5,44
Stranraer,1052,8,12,5,19,50,71,-21,41
Peterhead,1052,9,11,6,19,41,59,-18,39
Stenhousem'r,1052,10,7,11,18,53,83,-30,32
Alloa,1053,1,21,8,7,73,39,34,71
Brechin,1053,2,18,8,10,57,51,6,62
Airdrieon,1053,3,18,4,14,59,57,2,58
Livingston,1053,4,16,8,12,71,55,16,56
Peterhead,1053,5,15,8,13,53,50,3,53
Queen's Park,1053,6,13,8,15,38,45,-7,47
Stranraer,1053,7,13,7,16,49,52,-3,46
Albion,1053,8,13,5,18,48,61,-13,44
East Fife,1053,9,9,7,20,42,53,-11,34
Stenhousem'r,1053,10,9,7,20,51,78,-27,34
Airdrieon,1054,1,23,4,9,70,44,26,73
Livingston,1054,2,22,6,8,76,46,30,72
Alloa,1054,3,16,10,10,59,41,18,58
Albion,1054,4,15,10,11,50,39,11,55
Brechin,1054,5,14,9,13,43,44,-1,51
Peterhead,1054,6,13,8,15,38,53,-15,47
Stranraer,1054,7,11,8,17,53,59,-6,41
Queen's Park,1054,8,11,8,17,36,49,-13,41
East Fife,1054,9,10,9,17,49,58,-9,39
Stenhousem'r,1054,10,5,8,23,43,84,-41,23
Livingston,1055,1,20,7,9,75,41,34,67
Alloa,1055,2,18,7,11,61,41,20,61
Brechin,1055,3,18,1,17,47,52,-5,55
Albion,1055,4,15,9,12,57,48,9,54
Stranraer,1055,5,16,6,14,46,42,4,54
Airdrieon,1055,6,16,6,14,56,57,-1,54
Queen's Park,1055,7,14,8,14,43,44,-1,50
Peterhead,1055,8,14,7,15,57,60,-3,49
East Fife,1055,9,10,8,18,47,63,-16,38
Stenhousem'r,1055,10,7,5,24,42,83,-41,26
Airdrieon,1056,1,21,5,10,67,45,22,68
Livingston,1056,2,19,4,13,74,55,19,61
Alloa,1056,3,16,8,12,75,56,19,56
Brechin,1056,4,15,9,12,54,47,7,54
East Fife,1056,5,15,8,13,56,47,9,53
Albion,1056,6,14,7,15,52,50,2,49
Queen's Park,1056,7,12,10,14,38,56,-18,46
Peterhead,1056,8,12,9,15,51,61,-10,45
Stranraer,1056,9,11,8,17,41,51,-10,41
Stenhousem'r,1056,10,6,10,20,42,82,-40,28
Livingston,1057,1,24,3,9,80,46,34,75
Alloa,1057,2,20,7,9,67,42,25,67
Airdrieon,1057,3,16,5,15,63,66,-3,53
Brechin,1057,4,16,3,17,44,48,-4,51
Stranraer,1057,5,15,4,17,51,53,-2,49
Peterhead,1057,6,13,8,15,54,56,-2,47
Albion,1057,7,14,5,17,48,58,-10,47
Stenhousem'r,1057,8,12,7,17,57,71,-14,43
Queen's Park,1057,9,11,8,17,33,50,-17,41
East Fife,1057,10,9,10,17,42,49,-7,37
Alloa,1058,1,19,7,10,76,48,28,64
Livingston,1058,2,20,3,13,72,50,22,63
Airdrieon,1058,3,18,9,9,63,58,5,63
Albion,1058,4,17,7,12,56,46,10,58
Peterhead,1058,5,14,10,12,54,56,-2,52
East Fife,1058,6,13,7,16,55,53,2,46
Stranraer,1058,7,11,8,17,55,60,-5,41
Queen's Park,1058,8,11,7,18,35,52,-17,40
Brechin,1058,9,10,9,17,43,58,-15,39
Stenhousem'r,1058,10,12,3,21,50,78,-28,39
Livingston,1059,1,20,6,10,81,50,31,66
Brechin,1059,2,19,3,14,57,53,4,60
Alloa,1059,3,16,10,10,68,46,22,58
Albion,1059,4,14,11,11,48,45,3,53
Stranraer,1059,5,15,7,14,62,51,11,52
Airdrieon,1059,6,14,6,16,54,62,-8,48
Peterhead,1059,7,12,10,14,44,55,-11,46
Queen's Park,1059,8,12,9,15,40,53,-13,45
East Fife,1059,9,10,8,18,45,51,-6,38
Stenhousem'r,1059,10,9,8,19,46,79,-33,35
Livingston,1060,1,21,4,11,77,51,26,67
Brechin,1060,2,19,9,8,57,41,16,66
Airdrieon,1060,3,17,7,12,58,55,3,58
Alloa,1060,4,16,9,11,66,45,21,57
East Fife,1060,5,14,10,12,50,40,10,52
Peterhead,1060,6,13,10,13,49,50,-1,49
Queen's Park,1060,7,12,6,18,39,52,-13,42
Stranraer,1060,8,11,7,18,41,56,-15,40
Albion,1060,9,9,9,18,41,56,-15,36
Stenhousem'r,1060,10,8,9,19,41,73,-32,33
Airdrieon,1061,1,20,5,11,63,46,17,65
Brechin,1061,2,19,7,10,47,37,10,64
Alloa,1061,3,18,6,12,75,54,21,60
Livingston,1061,4,16,7,13,68,48,20,55
Stranraer,1061,5,14,7,15,53,56,-3,49
Albion,1061,6,12,11,13,46,49,-3,47
Queen's Park,1061,7,13,8,15,43,49,-6,47
East Fife,1061,8,11,10,15,44,52,-8,43
Peterhead,1061,9,11,5,20,42,56,-14,38
Stenhousem'r,1061,10,8,10,18,41,75,-34,34
Livingston,1062,1,22,5,9,77,42,35,71
Alloa,1062,2,20,7,9,75,47,28,67
Queen's Park,1062,3,16,8,12,45,50,-5,56
Albion,1062,4,15,9,12,57,50,7,54
Stranraer,1062,5,15,6,15,52,54,-2,51
Airdrieon,1062,6,14,9,13,51,60,-9,51
East Fife,1062,7,9,12,15,42,47,-5,39
Peterhead,1062,8,10,9,17,44,59,-15,39
Brechin,1062,9,11,5,20,43,54,-11,38
Stenhousem'r,1062,10,9,8,19,45,68,-23,35
Brechin,1063,1,22,5,9,63,44,19,71
Livingston,1063,2,21,5,10,83,49,34,68
Alloa,1063,3,18,6,12,65,42,23,60
Airdrieon,1063,4,19,3,14,59,54,5,60
Peterhead,1063,5,13,10,13,47,46,1,49
Albion,1063,6,12,10,14,41,51,-10,46
East Fife,1063,7,12,9,15,56,57,-1,45
Stranraer,1063,8,11,7,18,50,60,-10,40
Queen's Park,1063,9,9,9,18,36,57,-21,36
Stenhousem'r,1063,10,5,12,19,35,75,-40,27
Livingston,1064,1,23,4,9,86,54,32,73
Alloa,1064,2,17,12,7,67,41,26,63
Albion,1064,3,16,10,10,60,47,13,58
Airdrieon,1064,4,17,7,12,63,59,4,58
Brechin,1064,5,16,5,15,47,56,-9,53
Peterhead,1064,6,11,12,13,49,51,-2,45
East Fife,1064,7,11,8,17,49,55,-6,41
Stranraer,1064,8,11,8,17,47,54,-7,41
Queen's Park,1064,9,10,9,17,45,61,-16,39
Stenhousem'r,1064,10,7,7,22,42,77,-35,28
Livingston,1065,1,20,7,9,75,49,26,67
Alloa,1065,2,18,8,10,66,40,26,62
Airdrieon,1065,3,18,6,12,58,52,6,60
Brechin,1065,4,17,4,15,49,48,1,55
Albion,1065,5,15,7,14,55,47,8,52
Queen's Park,1065,6,14,8,14,43,50,-7,50
Stranraer,1065,7,12,7,17,43,53,-10,43
Peterhead,1065,8,11,9,16,45,57,-12,42
East Fife,1065,9,8,12,16,42,53,-11,36
Stenhousem'r,1065,10,9,8,19,42,69,-27,35
Livingston,1066,1,21,4,11,84,57,27,67
Airdrieon,1066,2,18,10,8,67,49,18,64
Alloa,1066,3,18,9,9,58,36,22,63
Albion,1066,4,16,8,12,62,50,12,56
Brechin,1066,5,15,7,14,57,55,2,52
Stranraer,1066,6,15,6,15,51,54,-3,51
Peterhead,1066,7,14,9,13,43,46,-3,51
Queen's Park,1066,8,11,6,19,34,58,-24,39
East Fife,1066,9,9,10,17,43,50,-7,37
Stenhousem'r,1066,10,6,5,25,37,81,-44,23
Livingston,1067,1,18,8,10,75,50,25,62
Alloa,1067,2,18,8,10,68,43,25,62
Airdrieon,1067,3,17,7,12,56,51,5,58
Albion,1067,4,14,13,9,55,46,9,55
Queen's Park,1067,5,15,9,12,51,47,4,54
Brechin,1067,6,12,10,14,45,56,-11,46
Peterhead,1067,7,12,9,15,44,48,-4,45
Stranraer,1067,8,13,4,19,44,60,-16,43
Stenhousem'r,1067,9,10,8,18,52,79,-27,38
East Fife,1067,10,9,8,19,44,54,-10,35
Alloa,1068,1,19,10,7,75,49,26,67
Airdrieon,1068,2,17,6,13,57,52,5,57
Livingston,1068,3,15,6,15,68,63,5,51
Albion,1068,4,13,12,11,53,50,3,51
Brechin,1068,5,14,9,13,46,47,-1,51
Queen's Park,1068,6,14,6,16,36,42,-6,48
East Fife,1068,7,11,14,11,50,48,2,47
Peterhead,1068,7,12,11,13,50,48,2,47
Stranraer,1068,9,11,7,18,50,57,-7,40
Stenhousem'r,1068,10,9,9,18,50,79,-29,36
Livingston,1069,1,23,5,8,73,46,27,74
Alloa,1069,2,18,8,10,69,46,23,62
Albion,1069,3,16,7,13,59,48,11,55
Brechin,1069,4,15,7,14,50,49,1,52
Airdrieon,1069,5,16,4,16,51,57,-6,52
Queen's Park,1069,6,15,5,16,38,42,-4,50
Peterhead,1069,7,13,10,13,57,50,7,49
Stranraer,1069,8,12,8,16,51,57,-6,44
East Fife,1069,9,9,12,15,41,47,-6,39
Stenhousem'r,1069,10,7,6,23,47,94,-47,27
Airdrieon,1070,1,20,5,11,68,46,22,65
Albion,1070,2,20,5,11,71,52,19,65
Livingston,1070,3,20,3,13,61,45,16,63
Alloa,1070,4,18,6,12,71,57,14,60
Brechin,1070,5,18,4,14,54,48,6,58
Queen's Park,1070,6,14,7,15,39,51,-12,49
Stranraer,1070,7,13,6,17,55,68,-13,45
East Fife,1070,8,12,6,18,45,54,-9,42
Peterhead,1070,9,9,10,17,39,58,-19,37
Stenhousem'r,1070,10,7,6,23,46,70,-24,27
Livingston,1071,1,21,7,8,83,44,39,70
Airdrieon,1071,2,20,6,10,63,45,18,66
Alloa,1071,3,18,9,9,71,44,27,63
Brechin,1071,4,18,6,12,52,51,1,60
Peterhead,1071,5,13,11,12,57,53,4,50
Albion,1071,6,12,11,13,44,49,-5,47
Queen's Park,1071,7,13,6,17,35,48,-13,45
Stranraer,1071,8,12,4,20,52,68,-16,40
East Fife,1071,9,7,9,20,40,56,-16,30
Stenhousem'r,1071,10,7,9,20,40,79,-39,30
Livingston,1072,1,19,9,8,76,47,29,66
Alloa,1072,2,20,5,11,71,50,21,65
Queen's Park,1072,3,17,8,11,51,45,6,59
Brechin,1072,4,17,7,12,53,45,8,58
Peterhead,1072,5,14,9,13,60,56,4,51
Albion,1072,6,13,12,11,53,50,3,51
Airdrieon,1072,7,14,9,13,53,60,-7,51
East Fife,1072,8,9,9,18,44,51,-7,36
Stranraer,1072,9,9,8,19,47,64,-17,35
Stenhousem'r,1072,10,5,10,21,39,79,-40,25
Alloa,1073,1,19,7,10,68,38,30,64
Livingston,1073,2,20,4,12,81,54,27,64
Brechin,1073,3,19,7,10,56,48,8,64
Airdrieon,1073,4,16,6,14,59,59,0,54
Albion,1073,5,14,8,14,60,60,0,50
East Fife,1073,6,13,9,14,59,46,13,48
Peterhead,1073,7,11,10,15,46,57,-11,43
Queen's Park,1073,8,10,12,14,37,49,-12,42
Stranraer,1073,9,10,7,19,42,62,-20,37
Stenhousem'r,1073,10,11,4,21,45,80,-35,37
Livingston,1074,1,20,4,12,70,50,20,64
Alloa,1074,2,17,9,10,72,50,22,60
Stranraer,1074,3,17,7,12,60,47,13,58
Brechin,1074,4,16,6,14,52,56,-4,54
Peterhead,1074,5,15,7,14,52,51,1,52
East Fife,1074,6,15,6,15,60,53,7,51
Albion,1074,7,14,8,14,58,55,3,50
Queen's Park,1074,8,13,9,14,40,53,-13,48
Airdrieon,1074,9,13,6,17,51,60,-9,45
Stenhousem'r,1074,10,7,4,25,48,88,-40,25
Livingston,1075,1,23,4,9,86,42,44,73
Brechin,1075,2,20,6,10,63,54,9,66
Alloa,1075,3,18,11,7,74,49,25,65
Airdrieon,1075,4,14,9,13,50,50,0,51
Peterhead,1075,5,12,10,14,55,55,0,46
Albion,1075,6,12,8,16,51,52,-1,44
East Fife,1075,7,11,10,15,51,50,1,43
Stranraer,1075,8,11,7,18,47,63,-16,40
Queen's Park,1075,9,11,7,18,37,65,-28,40
Stenhousem'r,1075,10,7,10,19,49,83,-34,31
Alloa,1076,1,20,8,8,75,37,38,68
Livingston,1076,2,20,6,10,69,49,20,66
Albion,1076,3,18,7,11,59,50,9,61
Airdrieon,1076,4,16,10,10,61,60,1,58
Brechin,1076,5,14,6,16,48,53,-5,48
Queen's Park,1076,6,13,7,16,43,48,-5,46
Peterhead,1076,7,12,9,15,44,55,-11,45
Stranraer,1076,8,11,7,18,49,63,-14,40
East Fife,1076,9,10,9,17,42,49,-7,39
Stenhousem'r,1076,10,9,5,22,46,72,-26,32
Livingston,1077,1,24,4,8,85,39,46,76
Brechin,1077,2,19,7,10,49,40,9,64
Alloa,1077,3,16,9,11,62,47,15,57
Airdrieon,1077,4,16,7,13,56,53,3,55
Stranraer,1077,5,14,7,15,56,52,4,49
Queen's Park,1077,6,14,6,16,37,48,-11,48
Peterhead,1077,7,13,8,15,53,55,-2,47
Albion,1077,8,13,7,16,50,54,-4,46
East Fife,1077,9,11,7,18,45,61,-16,40
Stenhousem'r,1077,10,6,6,24,41,85,-44,24
Alloa,1078,1,22,5,9,83,43,40,71
Livingston,1078,2,20,4,12,68,50,18,64
Airdrieon,1078,3,18,5,13,58,56,2,59
Peterhead,1078,4,17,7,12,55,53,2,58
Brechin,1078,5,15,10,11,53,51,2,55
Albion,1078,6,12,9,15,55,49,6,45
Queen's Park,1078,7,11,9,16,39,49,-10,42
Stranraer,1078,8,11,8,17,53,63,-10,41
East Fife,1078,9,11,7,18,42,57,-15,40
Stenhousem'r,1078,10,7,8,21,39,74,-35,29
Livingston,1079,1,23,5,8,70,38,32,74
Alloa,1079,2,17,10,9,66,43,23,61
Brechin,1079,3,18,5,13,58,47,11,59
Airdrieon,1079,4,17,7,12,56,51,5,58
Queen's Park,1079,5,12,10,14,37,50,-13,46
Peterhead,1079,6,12,8,16,42,50,-8,44
Albion,1079,7,11,10,15,48,50,-2,43
Stenhousem'r,1079,8,12,6,18,54,70,-16,42
East Fife,1079,9,10,10,16,42,53,-11,40
Stranraer,1079,10,10,5,21,47,68,-21,35
Livingston,1080,1,24,4,8,75,42,33,76
Alloa,1080,2,21,6,9,65,46,19,69
Peterhead,1080,3,16,7,13,51,50,1,55
Albion,1080,4,14,8,14,55,45,10,50
Queen's Park,1080,5,14,7,15,39,48,-9,49
Airdrieon,1080,6,13,9,14,52,56,-4,48
Brechin,1080,7,13,6,17,46,55,-9,45
Stranraer,1080,8,13,5,18,48,57,-9,44
East Fife,1080,9,11,7,18,47,51,-4,40
Stenhousem'r,1080,10,8,7,21,47,75,-28,31
Alloa,1081,1,21,8,7,68,39,29,71
Livingston,1081,2,22,2,12,81,61,20,68
Brechin,1081,3,18,5,13,59,46,13,59
Airdrieon,1081,4,15,11,10,59,52,7,56
Albion,1081,5,15,11,10,59,53,6,56
Peterhead,1081,6,15,7,14,53,53,0,52
East Fife,1081,7,13,8,15,52,52,0,47
Stranraer,1081,8,10,4,22,42,60,-18,34
Stenhousem'r,1081,9,8,7,21,48,76,-28,31
Queen's Park,1081,10,6,11,19,32,61,-29,29
Livingston,1082,1,22,1,13,84,55,29,67
Airdrieon,1082,2,18,9,9,70,56,14,63
Brechin,1082,3,16,6,14,49,53,-4,54
Queen's Park,1082,4,15,7,14,40,52,-12,52
Albion,1082,5,13,12,11,57,57,0,51
Alloa,1082,6,14,8,14,65,50,15,50
Peterhead,1082,7,13,9,14,56,56,0,48
Stranraer,1082,8,13,7,16,60,58,2,46
East Fife,1082,9,13,6,17,52,53,-1,45
Stenhousem'r,1082,10,7,7,22,42,85,-43,28
Livingston,1083,1,21,4,11,76,40,36,67
Brechin,1083,2,19,3,14,46,43,3,60
Alloa,1083,3,17,8,11,64,41,23,59
Albion,1083,4,17,8,11,73,55,18,59
Airdrieon,1083,5,16,7,13,53,54,-1,55
East Fife,1083,6,14,5,17,44,45,-1,47
Stranraer,1083,7,13,7,16,50,55,-5,46
Peterhead,1083,8,10,9,17,45,62,-17,39
Queen's Park,1083,9,10,9,17,35,54,-19,39
Stenhousem'r,1083,10,8,10,18,39,76,-37,34
Livingston,1084,1,18,8,10,64,48,16,62
Alloa,1084,2,17,10,9,67,44,23,61
Airdrieon,1084,3,16,8,12,54,48,6,56
Brechin,1084,4,17,5,14,51,45,6,56
Albion,1084,5,15,8,13,53,46,7,53
Peterhead,1084,6,13,10,13,44,50,-6,49
Queen's Park,1084,7,13,7,16,43,54,-11,46
Stranraer,1084,8,11,7,18,41,52,-11,40
East Fife,1084,9,10,9,17,44,46,-2,39
Stenhousem'r,1084,10,9,10,17,45,73,-28,37
Alloa,1085,1,19,7,10,68,43,25,64
Livingston,1085,2,20,3,13,76,51,25,63
Brechin,1085,3,17,7,12,52,47,5,58
Queen's Park,1085,4,16,5,15,44,47,-3,53
Airdrieon,1085,5,16,4,16,53,55,-2,52
Stranraer,1085,6,15,6,15,58,53,5,51
Albion,1085,7,14,8,14,47,49,-2,50
Peterhead,1085,8,13,7,16,51,58,-7,46
East Fife,1085,9,9,10,17,40,52,-12,37
Stenhousem'r,1085,10,9,7,20,39,73,-34,34
Alloa,1086,1,21,8,7,73,41,32,71
Livingston,1086,2,21,4,11,79,49,30,67
Brechin,1086,3,18,8,10,54,38,16,62
East Fife,1086,4,15,9,12,55,39,16,54
Airdrieon,1086,5,15,7,14,58,61,-3,52
Albion,1086,6,14,7,15,45,57,-12,49
Peterhead,1086,7,13,9,14,53,53,0,48
Queen's Park,1086,8,12,6,18,41,56,-15,42
Stranraer,1086,9,11,3,22,43,67,-24,36
Stenhousem'r,1086,10,5,9,22,37,77,-40,24
Alloa,1087,1,19,9,8,81,53,28,66
Livingston,1087,2,20,4,12,72,49,23,64
Airdrieon,1087,3,19,4,13,58,52,6,61
Stranraer,1087,4,18,6,12,52,41,11,60
Albion,1087,5,14,10,12,55,53,2,52
Peterhead,1087,6,14,7,15,45,49,-4,49
East Fife,1087,7,13,5,18,50,50,0,44
Brechin,1087,8,13,5,18,46,61,-15,44
Queen's Park,1087,9,11,10,15,39,50,-11,43
Stenhousem'r,1087,10,5,8,23,44,84,-40,23
Livingston,1088,1,23,4,9,84,48,36,73
Airdrieon,1088,2,19,4,13,58,51,7,61
Alloa,1088,3,16,12,8,68,44,24,60
Brechin,1088,4,17,9,10,50,43,7,60
Peterhead,1088,5,16,7,13,45,47,-2,55
Albion,1088,6,12,9,15,61,58,3,45
Queen's Park,1088,7,12,8,16,41,48,-7,44
East Fife,1088,8,11,9,16,49,56,-7,42
Stranraer,1088,9,11,8,17,43,55,-12,41
Stenhousem'r,1088,10,5,6,25,39,88,-49,21
Livingston,1089,1,24,2,10,80,46,34,74
Peterhead,1089,2,17,7,12,56,47,9,58
Airdrieon,1089,3,16,10,10,59,56,3,58
Alloa,1089,4,16,9,11,71,50,21,57
Queen's Park,1089,5,13,10,13,50,51,-1,49
Brechin,1089,6,13,10,13,46,48,-2,49
Stranraer,1089,7,16,1,19,46,56,-10,49
Albion,1089,8,13,5,18,47,61,-14,44
East Fife,1089,9,10,12,14,48,48,0,42
Stenhousem'r,1089,10,6,6,24,43,83,-40,24
Livingston,1090,1,21,4,11,78,57,21,67
Brechin,1090,2,19,7,10,56,42,14,64
Alloa,1090,3,18,8,10,77,46,31,62
Airdrieon,1090,4,16,6,14,63,58,5,54
Stranraer,1090,5,14,7,15,52,57,-5,49
Albion,1090,6,12,9,15,47,44,3,45
East Fife,1090,7,12,9,15,46,49,-3,45
Peterhead,1090,8,12,8,16,39,49,-10,44
Queen's Park,1090,9,13,5,18,38,50,-12,44
Stenhousem'r,1090,10,8,7,21,40,84,-44,31
Livingston,1091,1,21,4,11,71,42,29,67
Alloa,1091,2,19,7,10,69,38,31,64
Brechin,1091,3,19,6,11,52,50,2,63
Peterhead,1091,4,16,8,12,57,52,5,56
Airdrieon,1091,5,15,7,14,60,60,0,52
East Fife,1091,6,13,11,12,51,44,7,50
Stranraer,1091,7,13,7,16,57,57,0,46
Albion,1091,8,11,10,15,49,62,-13,43
Queen's Park,1091,9,11,5,20,37,58,-21,38
Stenhousem'r,1091,10,5,9,22,40,80,-40,24
Livingston,1092,1,21,5,10,86,48,38,68
Alloa,1092,2,20,7,9,69,38,31,67
Brechin,1092,3,17,7,12,47,48,-1,58
Airdrieon,1092,4,17,6,13,64,55,9,57
Albion,1092,5,17,4,15,58,49,9,55
Queen's Park,1092,6,15,4,17,33,51,-18,49
East Fife,1092,7,12,8,16,41,50,-9,44
Peterhead,1092,8,12,6,18,40,50,-10,42
Stranraer,1092,9,12,6,18,45,61,-16,42
Stenhousem'r,1092,10,7,7,22,40,73,-33,28
Alloa,1093,1,19,11,6,68,36,32,68
Livingston,1093,2,19,8,9,76,43,33,65
Brechin,1093,3,18,7,11,55,49,6,61
Albion,1093,4,16,4,16,53,60,-7,52
Airdrieon,1093,5,15,6,15,62,66,-4,51
Peterhead,1093,6,13,7,16,56,64,-8,46
Queen's Park,1093,7,12,7,17,42,48,-6,43
East Fife,1093,8,10,12,14,48,53,-5,42
Stranraer,1093,9,12,5,19,56,58,-2,41
Stenhousem'r,1093,10,8,9,19,36,75,-39,33
Livingston,1094,1,24,3,9,87,42,45,75
Brechin,1094,2,20,6,10,52,41,11,66
Alloa,1094,3,20,5,11,72,44,28,65
Airdrieon,1094,4,18,5,13,57,47,10,59
Albion,1094,5,15,7,14,59,54,5,52
Queen's Park,1094,6,14,10,12,41,51,-10,52
Peterhead,1094,7,13,6,17,40,49,-9,45
East Fife,1094,8,10,8,18,45,53,-8,38
Stenhousem'r,1094,9,7,8,21,48,83,-35,29
Stranraer,1094,10,8,4,24,40,77,-37,28
Livingston,1095,1,23,3,10,86,50,36,72
Alloa,1095,2,21,6,9,74,42,32,69
Airdrieon,1095,3,16,10,10,60,59,1,58
Albion,1095,4,16,6,14,55,51,4,54
Brechin,1095,5,15,7,14,51,50,1,52
Peterhead,1095,6,13,9,14,57,53,4,48
Queen's Park,1095,7,14,5,17,36,52,-16,47
Stranraer,1095,8,12,9,15,43,55,-12,45
Stenhousem'r,1095,9,9,6,21,47,80,-33,33
East Fife,1095,10,7,7,22,48,65,-17,28
Livingston,1096,1,25,1,10,85,40,45,76
Alloa,1096,2,18,10,8,67,43,24,64
Peterhead,1096,3,18,8,10,55,46,9,62
Albion,1096,4,18,6,12,64,46,18,60
Brechin,1096,5,17,8,11,53,48,5,59
Airdrieon,1096,6,14,8,14,53,55,-2,50
Queen's Park,1096,7,11,7,18,32,48,-16,40
Stranraer,1096,8,11,4,21,45,72,-27,37
East Fife,1096,9,9,7,20,42,55,-13,34
Stenhousem'r,1096,10,7,5,24,45,88,-43,26
Livingston,1097,1,19,6,11,75,44,31,63
Alloa,1097,2,19,6,11,68,43,25,63
Brechin,1097,3,15,10,11,44,38,6,55
Airdrieon,1097,4,16,6,14,57,55,2,54
Peterhead,1097,5,14,9,13,63,60,3,51
Stranraer,1097,6,14,7,15,50,55,-5,49
Queen's Park,1097,7,14,6,16,31,55,-24,48
Albion,1097,8,12,11,13,47,49,-2,47
East Fife,1097,9,11,11,14,49,46,3,44
Stenhousem'r,1097,10,5,10,21,44,83,-39,25
Albion,1098,1,21,6,9,58,38,20,69
Livingston,1098,2,19,7,10,79,49,30,64
Alloa,1098,3,18,10,8,76,47,29,64
Airdrieon,1098,4,17,5,14,54,60,-6,56
Brechin,1098,5,16,6,14,54,55,-1,54
Peterhead,1098,6,15,8,13,56,50,6,53
East Fife,1098,7,11,9,16,51,59,-8,42
Stranraer,1098,8,12,4,20,52,60,-8,40
Queen's Park,1098,9,11,5,20,37,56,-19,38
Stenhousem'r,1098,10,8,4,24,42,85,-43,28
Livingston,1099,1,24,4,8,73,40,33,76
Alloa,1099,2,20,7,9,71,45,26,67
Airdrieon,1099,3,17,6,13,58,59,-1,57
Brechin,1099,4,16,5,15,53,55,-2,53
Stranraer,1099,5,15,5,16,61,59,2,50
Albion,1099,6,11,12,13,50,50,0,45
Queen's Park,1099,7,13,4,19,43,59,-16,43
Stenhousem'r,1099,8,10,9,17,55,74,-19,39
Peterhead,1099,9,10,8,18,44,64,-20,38
East Fife,1099,10,9,10,17,49,52,-3,37
Alloa,1100,1,20,8,8,69,34,35,68
Brechin,1100,2,18,9,9,59,49,10,63
Livingston,1100,3,20,2,14,80,61,19,62
Airdrieon,1100,4,18,6,12,72,59,13,60
Peterhead,1100,5,16,5,15,65,59,6,53
Albion,1100,6,14,8,14,63,65,-2,50
East Fife,1100,7,11,10,15,49,52,-3,43
Stranraer,1100,8,12,6,18,56,64,-8,42
Queen's Park,1100,9,11,4,21,39,61,-22,37
Stenhousem'r,1100,10,8,6,22,47,95,-48,30
Alloa,1101,1,20,7,9,74,48,26,67
Airdrieon,1101,2,19,7,10,62,51,11,64
Livingston,1101,3,18,8,10,74,47,27,62
Brechin,1101,4,18,7,11,63,52,11,61
Stranraer,1101,5,14,9,13,53,55,-2,51
Albion,1101,6,14,9,13,58,62,-4,51
Peterhead,1101,7,13,6,17,51,60,-9,45
Queen's Park,1101,8,14,2,20,43,62,-19,44
East Fife,1101,9,9,10,17,50,53,-3,37
Stenhousem'r,1101,10,6,5,25,43,81,-38,23
Alloa,1102,1,17,11,8,69,52,17,62
Airdrieon,1102,2,18,6,12,59,58,1,60
Peterhead,1102,3,16,8,12,56,48,8,56
Albion,1102,4,15,10,11,51,44,7,55
Brechin,1102,5,15,6,15,46,47,-1,51
Livingston,1102,6,15,4,17,67,52,15,49
Stenhousem'r,1102,7,13,7,16,50,67,-17,46
Stranraer,1102,8,12,8,16,50,57,-7,44
East Fife,1102,9,11,8,17,41,47,-6,41
Queen's Park,1102,10,11,6,19,34,51,-17,39
Livingston,1103,1,20,5,11,83,53,30,65
Alloa,1103,2,17,9,10,68,40,28,60
Brechin,1103,3,17,6,13,47,43,4,57
Airdrieon,1103,4,16,7,13,60,58,2,55
Albion,1103,5,16,7,13,50,48,2,55
Queen's Park,1103,6,13,7,16,43,55,-12,46
Peterhead,1103,7,12,9,15,46,59,-13,45
East Fife,1103,8,11,11,14,48,47,1,44
Stranraer,1103,9,12,7,17,48,58,-10,43
Stenhousem'r,1103,10,8,8,20,48,80,-32,32
Airdrieon,1104,1,22,6,8,63,53,10,72
Alloa,1104,2,19,10,7,78,45,33,67
Livingston,1104,3,19,7,10,70,47,23,64
Albion,1104,4,13,11,12,54,46,8,50
East Fife,1104,5,12,11,13,53,47,6,47
Brechin,1104,6,13,8,15,41,46,-5,47
Peterhead,1104,7,12,8,16,40,46,-6,44
Queen's Park,1104,8,12,7,17,32,54,-22,43
Stranraer,1104,9,10,7,19,44,54,-10,37
Stenhousem'r,1104,10,5,11,20,37,74,-37,26
Alloa,1105,1,23,6,7,75,40,35,75
Livingston,1105,2,22,2,12,82,46,36,68
Airdrieon,1105,3,20,5,11,59,50,9,65
Brechin,1105,4,16,7,13,56,50,6,55
Peterhead,1105,5,14,7,15,57,58,-1,49
Albion,1105,6,12,10,14,53,62,-9,46
Stranraer,1105,7,13,5,18,52,56,-4,44
Queen's Park,1105,8,11,7,18,37,51,-14,40
East Fife,1105,9,10,5,21,40,63,-23,35
Stenhousem'r,1105,10,9,6,21,54,89,-35,33
Alloa,1106,1,21,6,9,70,39,31,69
Livingston,1106,2,22,2,12,80,52,28,68
Airdrieon,1106,3,16,8,12,55,49,6,56
East Fife,1106,4,16,7,13,57,46,11,55
Albion,1106,5,14,8,14,57,57,0,50
Queen's Park,1106,6,14,6,16,46,51,-5,48
Brechin,1106,7,14,3,19,46,61,-15,45
Peterhead,1106,8,12,8,16,44,58,-14,44
Stranraer,1106,9,13,4,19,51,64,-13,43
Stenhousem'r,1106,10,9,6,21,44,73,-29,33
Livingston,1107,1,21,7,8,81,49,32,70
Airdrieon,1107,2,21,5,10,71,53,18,68
Alloa,1107,3,15,10,11,66,44,22,55
Brechin,1107,4,15,5,16,53,50,3,50
East Fife,1107,5,14,8,14,52,51,1,50
Peterhead,1107,6,14,7,15,51,58,-7,49
Albion,1107,7,14,5,17,54,52,2,47
Stranraer,1107,8,13,4,19,48,63,-15,43
Stenhousem'r,1107,9,10,8,18,50,79,-29,38
Queen's Park,1107,10,9,9,18,41,68,-27,36
Livingston,1108,1,25,4,7,79,38,41,79
Airdrieon,1108,2,18,4,14,64,55,9,58
Brechin,1108,3,16,4,16,57,60,-3,52
Albion,1108,4,14,9,13,54,53,1,51
Alloa,1108,5,14,8,14,55,45,10,50
Peterhead,1108,6,13,11,12,53,52,1,50
Queen's Park,1108,7,13,9,14,49,59,-10,48
Stranraer,1108,8,9,11,16,46,67,-21,38
East Fife,1108,9,9,10,17,50,58,-8,37
Stenhousem'r,1108,10,9,10,17,60,80,-20,37
Alloa,1109,1,22,6,8,85,43,42,72
Livingston,1109,2,23,2,11,83,51,32,71
Albion,1109,3,17,6,13,62,54,8,57
Peterhead,1109,4,16,7,13,63,54,9,55
Airdrieon,1109,5,16,7,13,57,63,-6,55
Brechin,1109,6,16,4,16,59,64,-5,52
East Fife,1109,7,12,10,14,48,46,2,46
Queen's Park,1109,8,11,4,21,38,71,-33,37
Stenhousem'r,1109,9,8,9,19,52,85,-33,33
Stranraer,1109,10,9,5,22,49,65,-16,32
Alloa,1110,1,21,8,7,81,38,43,71
Livingston,1110,2,22,2,12,82,56,26,68
Brechin,1110,3,17,7,12,49,43,6,58
Airdrieon,1110,4,16,7,13,65,54,11,55
Peterhead,1110,5,14,9,13,51,53,-2,51
Stranraer,1110,6,14,8,14,51,55,-4,50
Albion,1110,7,14,5,17,55,64,-9,47
Queen's Park,1110,8,11,5,20,40,71,-31,38
East Fife,1110,9,8,11,17,47,55,-8,35
Stenhousem'r,1110,10,8,8,20,50,82,-32,32
Livingston,1111,1,25,2,9,98,52,46,77
Alloa,1111,2,23,7,6,83,39,44,76
Airdrieon,1111,3,16,8,12,53,51,2,56
Brechin,1111,4,17,4,15,53,47,6,55
Peterhead,1111,5,14,8,14,42,52,-10,50
East Fife,1111,6,11,11,14,57,56,1,44
Albion,1111,7,11,7,18,54,73,-19,40
Queen's Park,1111,8,10,9,17,37,53,-16,39
Stranraer,1111,9,11,4,21,50,74,-24,37
Stenhousem'r,1111,10,8,8,20,57,87,-30,32
Livingston,1112,1,19,6,11,81,50,31,63
Brechin,1112,2,16,12,8,47,33,14,60
Airdrieon,1112,3,17,5,14,61,65,-4,56
Alloa,1112,4,15,10,11,63,48,15,55
Albion,1112,5,16,7,13,52,46,6,55
Peterhead,1112,6,16,4,16,56,57,-1,52
Queen's Park,1112,7,15,7,14,39,45,-6,52
East Fife,1112,8,11,9,16,47,47,0,42
Stranraer,1112,9,13,3,20,45,60,-15,42
Stenhousem'r,1112,10,7,7,22,42,82,-40,28
Livingston,1113,1,22,4,10,73,44,29,70
Alloa,1113,2,19,10,7,66,42,24,67
Brechin,1113,3,19,5,12,60,39,21,62
Airdrieon,1113,4,17,7,12,53,45,8,58
Peterhead,1113,5,17,6,13,52,49,3,57
Albion,1113,6,12,8,16,48,59,-11,44
Queen's Park,1113,7,12,8,16,34,47,-13,44
East Fife,1113,8,9,11,16,46,48,-2,38
Stranraer,1113,9,9,6,21,45,67,-22,33
Stenhousem'r,1113,10,8,7,21,42,79,-37,31
Livingston,1114,1,22,3,11,82,49,33,69
Alloa,1114,2,21,5,10,75,37,38,68
Airdrieon,1114,3,18,7,11,70,56,14,61
Albion,1114,4,15,7,14,65,59,6,52
Stranraer,1114,5,16,4,16,58,61,-3,52
Brechin,1114,6,14,6,16,45,56,-11,48
Queen's Park,1114,7,12,10,14,28,48,-20,46
East Fife,1114,8,10,9,17,46,47,-1,39
Peterhead,1114,9,9,11,16,41,58,-17,38
Stenhousem'r,1114,10,9,6,21,42,81,-39,33
Livingston,1115,1,20,5,11,70,47,23,65
Brechin,1115,2,19,6,11,58,42,16,63
Alloa,1115,3,18,7,11,63,42,21,61
Airdrieon,1115,4,17,8,11,53,45,8,59
Peterhead,1115,5,11,13,12,46,54,-8,46
Stranraer,1115,6,12,8,16,52,56,-4,44
East Fife,1115,7,11,10,15,45,48,-3,43
Stenhousem'r,1115,8,11,9,16,42,68,-26,42
Queen's Park,1115,9,9,11,16,35,50,-15,38
Albion,1115,10,8,11,17,45,57,-12,35
Alloa,1116,1,20,7,9,78,49,29,67
Livingston,1116,2,20,4,12,73,51,22,64
Albion,1116,3,17,6,13,53,55,-2,57
Airdrieon,1116,4,17,6,13,58,65,-7,57
Brechin,1116,5,16,5,15,53,49,4,53
East Fife,1116,6,12,11,13,49,39,10,47
Peterhead,1116,7,13,7,16,49,48,1,46
Queen's Park,1116,8,12,10,14,38,47,-9,46
Stranraer,1116,9,8,10,18,39,58,-19,34
Stenhousem'r,1116,10,8,8,20,48,77,-29,32
Livingston,1117,1,19,8,9,69,49,20,65
Peterhead,1117,2,18,6,12,63,51,12,60
Brechin,1117,3,17,6,13,47,36,11,57
Airdrieon,1117,4,16,7,13,68,58,10,55
Alloa,1117,5,16,7,13,60,53,7,55
Queen's Park,1117,6,15,4,17,46,48,-2,49
Albion,1117,7,13,7,16,49,54,-5,46
East Fife,1117,8,10,12,14,53,60,-7,42
Stranraer,1117,9,12,6,18,46,58,-12,42
Stenhousem'r,1117,10,8,9,19,49,83,-34,33
Airdrieon,1118,1,20,8,8,70,55,15,68
Livingston,1118,2,20,3,13,78,50,28,63
Alloa,1118,3,16,8,12,66,46,20,56
Brechin,1118,4,17,5,14,52,54,-2,56
Albion,1118,5,13,11,12,59,55,4,50
Queen's Park,1118,6,13,8,15,43,51,-8,47
Peterhead,1118,7,12,9,15,62,63,-1,45
East Fife,1118,8,11,8,17,50,57,-7,41
Stranraer,1118,9,10,9,17,47,67,-20,39
Stenhousem'r,1118,10,10,7,19,52,81,-29,37
Alloa,1119,1,23,6,7,75,34,41,75
Livingston,1119,2,21,4,11,81,50,31,67
Brechin,1119,3,18,5,13,57,51,6,59
Airdrieon,1119,4,17,2,17,61,68,-7,53
Peterhead,1119,5,15,7,14,49,52,-3,52
Queen's Park,1119,6,13,10,13,43,45,-2,49
Albion,1119,7,11,12,13,51,60,-9,45
Stranraer,1119,8,12,5,19,45,60,-15,41
East Fife,1119,9,10,9,17,46,51,-5,39
Stenhousem'r,1119,10,6,8,22,39,76,-37,26
Livingston,1120,1,22,4,10,83,47,36,70
Alloa,1120,2,20,5,11,72,42,30,65
Brechin,1120,3,18,7,11,53,46,7,61
Albion,1120,4,16,7,13,58,55,3,55
Airdrieon,1120,5,15,8,13,62,60,2,53
East Fife,1120,6,15,6,15,53,46,7,51
Peterhead,1120,7,14,6,16,55,61,-6,48
Queen's Park,1120,8,13,4,19,41,60,-19,43
Stranraer,1120,9,11,5,20,48,66,-18,38
Stenhousem'r,1120,10,7,6,23,47,89,-42,27
Alloa,1121,1,23,6,7,75,41,34,75
Livingston,1121,2,16,8,12,66,54,12,56
Brechin,1121,3,17,5,14,56,56,0,56
Airdrieon,1121,4,15,9,12,52,51,1,54
Albion,1121,5,12,13,11,58,51,7,49
Stenhousem'r,1121,6,13,9,14,58,62,-4,48
Queen's Park,1121,7,13,7,16,37,47,-10,46
Peterhead,1121,8,11,10,15,46,58,-12,43
Stranraer,1121,9,12,6,18,48,57,-9,42
East Fife,1121,10,6,11,19,41,60,-19,29
Livingston,1122,1,23,4,9,78,48,30,73
Alloa,1122,2,16,10,10,60,41,19,58
Queen's Park,1122,3,17,6,13,42,49,-7,57
Brechin,1122,4,17,3,16,44,46,-2,54
Airdrieon,1122,5,15,7,14,58,56,2,52
Peterhead,1122,6,15,6,15,57,58,-1,51
Stenhousem'r,1122,7,12,9,15,59,73,-14,45
Stranraer,1122,8,11,8,17,50,52,-2,41
Albion,1122,9,10,8,18,41,55,-14,38
East Fife,1122,10,10,7,19,45,56,-11,37
Alloa,1123,1,24,4,8,82,37,45,76
Livingston,1123,2,19,4,13,73,49,24,61
Airdrieon,1123,3,16,4,16,60,60,0,52
East Fife,1123,4,14,10,12,54,56,-2,52
Peterhead,1123,5,14,8,14,54,63,-9,50
Queen's Park,1123,6,12,9,15,41,48,-7,45
Brechin,1123,7,13,6,17,48,67,-19,45
Stranraer,1123,8,12,8,16,48,53,-5,44
Albion,1123,9,11,7,18,56,65,-9,40
Stenhousem'r,1123,10,10,10,16,51,69,-18,40
Livingston,1124,1,20,6,10,82,51,31,66
Alloa,1124,2,18,10,8,67,44,23,64
Airdrieon,1124,3,18,8,10,59,52,7,62
Brechin,1124,4,18,4,14,54,54,0,58
Queen's Park,1124,5,15,5,16,32,42,-10,50
Peterhead,1124,6,13,8,15,52,51,1,47
Albion,1124,7,10,11,15,49,55,-6,41
Stranraer,1124,8,12,5,19,54,66,-12,41
East Fife,1124,9,9,11,16,50,59,-9,38
Stenhousem'r,1124,10,10,6,20,51,76,-25,36
Alloa,1125,1,22,5,9,81,41,40,71
Airdrieon,1125,2,21,7,8,63,45,18,70
Livingston,1125,3,16,5,15,74,58,16,53
Queen's Park,1125,4,15,7,14,47,48,-1,52
Brechin,1125,5,16,4,16,49,57,-8,52
Peterhead,1125,6,14,7,15,46,56,-10,49
Stranraer,1125,7,14,5,17,49,68,-19,47
Albion,1125,8,12,8,16,49,54,-5,44
East Fife,1125,9,11,6,19,47,49,-2,39
Stenhousem'r,1125,10,9,6,21,48,77,-29,33
Livingston,1126,1,21,7,8,80,45,35,70
Peterhead,1126,2,14,13,9,52,46,6,55
Alloa,1126,3,15,9,12,62,49,13,54
East Fife,1126,4,13,12,11,51,45,6,51
Airdrieon,1126,5,14,9,13,51,55,-4,51
Albion,1126,6,14,7,15,60,57,3,49
Brechin,1126,7,14,7,15,51,53,-2,49
Stranraer,1126,8,14,5,17,58,59,-1,47
Stenhousem'r,1126,9,10,7,19,52,84,-32,37
Queen's Park,1126,10,10,6,20,36,60,-24,36
Airdrieon,1127,1,21,8,7,71,49,22,71
Livingston,1127,2,19,7,10,76,47,29,64
Alloa,1127,3,16,10,10,68,46,22,58
East Fife,1127,4,14,8,14,51,46,5,50
Brechin,1127,5,14,6,16,46,60,-14,48
Queen's Park,1127,6,13,8,15,42,48,-6,47
Albion,1127,7,12,10,14,56,58,-2,46
Peterhead,1127,8,12,9,15,40,48,-8,45
Stenhousem'r,1127,9,10,8,18,50,73,-23,38
Stranraer,1127,10,10,4,22,42,67,-25,34
Alloa,1128,1,23,4,9,78,48,30,73
Livingston,1128,2,21,7,8,89,55,34,70
Airdrieon,1128,3,17,6,13,63,51,12,57
Brechin,1128,4,16,8,12,54,47,7,56
Peterhead,1128,5,14,9,13,59,57,2,51
Albion,1128,6,15,6,15,58,59,-1,51
Queen's Park,1128,7,13,8,15,45,60,-15,47
Stranraer,1128,8,12,7,17,52,61,-9,43
East Fife,1128,9,10,9,17,47,53,-6,39
Stenhousem'r,1128,10,5,4,27,35,89,-54,19
Livingston,1129,1,25,0,11,74,39,35,75
Alloa,1129,2,19,6,11,73,44,29,63
Airdrieon,1129,3,19,4,13,59,52,7,61
Albion,1129,4,17,5,14,74,58,16,56
Brechin,1129,5,17,5,14,54,47,7,56
East Fife,1129,6,14,8,14,53,45,8,50
Peterhead,1129,7,12,5,19,38,66,-28,41
Queen's Park,1129,8,11,6,19,33,57,-24,39
Stranraer,1129,9,11,5,20,49,68,-19,38
Stenhousem'r,1129,10,10,6,20,43,74,-31,36
Alloa,1130,1,20,5,11,80,47,33,65
Peterhead,1130,2,19,8,9,60,46,14,65
Livingston,1130,3,19,5,12,72,49,23,62
Airdrieon,1130,4,16,9,11,65,49,16,57
Brechin,1130,5,16,6,14,50,52,-2,54
Albion,1130,6,14,7,15,60,62,-2,49
Queen's Park,1130,7,13,9,14,38,44,-6,48
East Fife,1130,8,11,9,16,48,45,3,42
Stranraer,1130,9,9,8,19,45,70,-25,35
Stenhousem'r,1130,10,7,6,23,47,101,-54,27
Alloa,1131,1,19,9,8,82,51,31,66
Brechin,1131,2,18,7,11,51,41,10,61
Airdrieon,1131,3,17,8,11,57,46,11,59
Albion,1131,4,16,8,12,56,50,6,56
Livingston,1131,5,16,6,14,71,55,16,54
East Fife,1131,6,14,10,12,58,42,16,52
Stranraer,1131,7,12,7,17,48,59,-11,43
Queen's Park,1131,8,12,7,17,30,49,-19,43
Peterhead,1131,9,9,11,16,38,58,-20,38
Stenhousem'r,1131,10,7,7,22,41,81,-40,28
Livingston,1132,1,20,6,10,83,51,32,66
Brechin,1132,2,18,6,12,53,51,2,60
Peterhead,1132,3,16,9,11,54,47,7,57
Queen's Park,1132,4,16,9,11,45,44,1,57
Airdrieon,1132,5,15,9,12,53,57,-4,54
Alloa,1132,6,14,10,12,66,55,11,52
Stranraer,1132,7,14,6,16,57,53,4,48
Albion,1132,8,10,10,16,45,53,-8,40
East Fife,1132,9,9,8,19,42,48,-6,35
Stenhousem'r,1132,10,9,5,22,43,82,-39,32
Alloa,1133,1,22,6,8,72,42,30,72
Brechin,1133,2,19,5,12,54,46,8,62
Stranraer,1133,3,18,4,14,61,48,13,58
Airdrieon,1133,4,16,8,12,58,49,9,56
Livingston,1133,5,16,5,15,68,56,12,53
Albion,1133,6,15,8,13,57,50,7,53
Queen's Park,1133,7,12,7,17,31,46,-15,43
Peterhead,1133,8,10,9,17,41,60,-19,39
East Fife,1133,9,8,14,14,42,45,-3,38
Stenhousem'r,1133,10,7,8,21,40,82,-42,29
Livingston,1134,1,23,2,11,83,46,37,71
Alloa,1134,2,19,8,9,70,43,27,65
Airdrieon,1134,3,19,5,12,58,48,10,62
Albion,1134,4,17,9,10,55,47,8,60
Brechin,1134,5,16,7,13,57,57,0,55
Peterhead,1134,6,13,8,15,45,56,-11,47
Queen's Park,1134,7,10,10,16,37,52,-15,40
East Fife,1134,8,9,10,17,44,52,-8,37
Stenhousem'r,1134,9,10,6,20,48,74,-26,36
Stranraer,1134,10,9,5,22,50,72,-22,32
Livingston,1135,1,20,8,8,86,56,30,68
Alloa,1135,2,19,10,7,72,43,29,67
Brechin,1135,3,18,5,13,51,52,-1,59
Airdrieon,1135,4,17,6,13,59,57,2,57
Peterhead,1135,5,14,11,11,49,47,2,53
Albion,1135,6,15,7,14,54,46,8,52
Stranraer,1135,7,14,2,20,57,62,-5,44
Stenhousem'r,1135,8,10,8,18,45,72,-27,38
East Fife,1135,9,9,9,18,45,53,-8,36
Queen's Park,1135,10,9,4,23,34,64,-30,31
Alloa,1136,1,21,8,7,82,43,39,71
Livingston,1136,2,19,9,8,74,46,28,66
Airdrieon,1136,3,13,11,12,51,52,-1,50
Peterhead,1136,4,13,11,12,52,54,-2,50
Albion,1136,5,14,7,15,50,45,5,49
Brechin,1136,6,13,10,13,42,47,-5,49
East Fife,1136,7,13,9,14,48,41,7,48
Queen's Park,1136,8,11,8,17,30,51,-21,41
Stranraer,1136,9,10,7,19,50,61,-11,37
Stenhousem'r,1136,10,9,8,19,50,89,-39,35
Livingston,1137,1,20,4,12,75,53,22,64
Airdrieon,1137,2,18,10,8,63,50,13,64
Peterhead,1137,3,15,11,10,60,51,9,56
Alloa,1137,4,14,11,11,53,41,12,53
Brechin,1137,5,14,8,14,46,53,-7,50
Queen's Park,1137,6,13,8,15,37,51,-14,47
East Fife,1137,7,11,11,14,47,38,9,44
Stranraer,1137,8,13,5,18,49,60,-11,44
Albion,1137,9,11,7,18,48,59,-11,40
Stenhousem'r,1137,10,10,7,19,54,76,-22,37
Livingston,1138,1,21,6,9,76,44,32,69
Alloa,1138,2,19,10,7,67,39,28,67
Albion,1138,3,18,10,8,55,40,15,64
Brechin,1138,4,18,3,15,56,53,3,57
Peterhead,1138,5,15,5,16,53,47,6,50
Airdrieon,1138,6,12,9,15,52,60,-8,45
Stranraer,1138,7,12,6,18,42,56,-14,42
Stenhousem'r,1138,8,9,10,17,46,73,-27,37
Queen's Park,1138,9,9,9,18,31,59,-28,36
East Fife,1138,10,9,8,19,43,50,-7,35
Airdrieon,1139,1,19,5,12,61,52,9,62
Livingston,1139,2,19,4,13,84,58,26,61
Brechin,1139,3,18,6,12,57,48,9,60
Alloa,1139,4,16,8,12,73,51,22,56
Albion,1139,5,15,9,12,54,46,8,54
Queen's Park,1139,6,14,9,13,43,48,-5,51
East Fife,1139,7,13,11,12,51,46,5,50
Stranraer,1139,8,12,9,15,61,67,-6,45
Peterhead,1139,9,9,9,18,46,65,-19,36
Stenhousem'r,1139,10,6,8,22,45,94,-49,26
Livingston,1140,1,21,4,11,83,51,32,67
Brechin,1140,2,19,5,12,44,39,5,62
Alloa,1140,3,17,8,11,65,44,21,59
Queen's Park,1140,4,18,5,13,38,39,-1,59
Airdrieon,1140,5,17,5,14,57,51,6,56
Albion,1140,6,14,7,15,52,56,-4,49
Peterhead,1140,7,13,7,16,46,51,-5,46
East Fife,1140,8,10,11,15,43,50,-7,41
Stranraer,1140,9,10,6,20,51,67,-16,36
Stenhousem'r,1140,10,9,6,21,52,83,-31,33
Livingston,1141,1,22,5,9,72,40,32,71
Alloa,1141,2,20,7,9,71,47,24,67
Brechin,1141,3,20,3,13,63,43,20,63
Peterhead,1141,4,14,12,10,51,45,6,54
Airdrieon,1141,5,15,7,14,57,53,4,52
Queen's Park,1141,6,14,6,16,42,52,-10,48
Albion,1141,7,12,8,16,55,57,-2,44
East Fife,1141,8,8,13,15,37,47,-10,37
Stranraer,1141,9,11,4,21,45,71,-26,37
Stenhousem'r,1141,10,8,7,21,43,81,-38,31
Brechin,1142,1,18,9,9,56,48,8,63
Alloa,1142,2,16,12,8,78,49,29,60
Livingston,1142,3,16,9,11,69,50,19,57
Airdrieon,1142,4,15,7,14,53,54,-1,52
Albion,1142,5,14,9,13,59,52,7,51
Stranraer,1142,6,14,7,15,52,51,1,49
Queen's Park,1142,7,13,10,13,35,47,-12,49
East Fife,1142,8,9,13,14,48,48,0,40
Peterhead,1142,9,9,12,15,37,52,-15,39
Stenhousem'r,1142,10,8,8,20,39,75,-36,32
Alloa,1143,1,20,7,9,68,39,29,67
Brechin,1143,2,20,5,11,48,37,11,65
Livingston,1143,3,19,3,14,73,58,15,60
Airdrieon,1143,4,15,9,12,58,53,5,54
Peterhead,1143,5,14,9,13,48,48,0,51
Albion,1143,6,14,6,16,56,59,-3,48
Queen's Park,1143,7,13,6,17,40,48,-8,45
Stranraer,1143,8,13,6,17,53,62,-9,45
East Fife,1143,9,10,12,14,46,46,0,42
Stenhousem'r,1143,10,7,7,22,47,87,-40,28
Peterhead,1144,1,19,9,8,54,42,12,66
Alloa,1144,2,19,7,10,71,41,30,64
Livingston,1144,3,18,5,13,65,55,10,59
Albion,1144,4,16,10,10,62,45,17,58
Brechin,1144,5,15,8,13,46,42,4,53
Airdrieon,1144,6,15,6,15,56,61,-5,51
Queen's Park,1144,7,12,9,15,41,52,-11,45
Stranraer,1144,8,13,5,18,54,63,-9,44
East Fife,1144,9,7,11,18,43,54,-11,32
Stenhousem'r,1144,10,7,8,21,47,84,-37,29
Livingston,1145,1,21,6,9,76,48,28,69
Airdrieon,1145,2,16,9,11,61,57,4,57
Peterhead,1145,3,15,10,11,58,55,3,55
Alloa,1145,4,14,12,10,56,44,12,54
East Fife,1145,5,15,8,13,56,46,10,53
Brechin,1145,6,14,8,14,47,46,1,50
Queen's Park,1145,7,13,7,16,36,46,-10,46
Albion,1145,8,11,10,15,49,55,-6,43
Stranraer,1145,9,11,8,17,42,55,-13,41
Stenhousem'r,1145,10,7,8,21,43,72,-29,29
Livingston,1146,1,22,4,10,75,43,32,70
Alloa,1146,2,20,6,10,71,43,28,66
Peterhead,1146,3,19,6,11,59,45,14,63
Airdrieon,1146,4,19,5,12,60,47,13,62
Brechin,1146,5,14,8,14,47,45,2,50
East Fife,1146,6,14,7,15,44,48,-4,49
Albion,1146,7,13,8,15,60,62,-2,47
Stranraer,1146,8,9,7,20,49,71,-22,34
Queen's Park,1146,9,9,7,20,24,56,-32,34
Stenhousem'r,1146,10,8,8,20,42,71,-29,32
Livingston,1147,1,24,2,10,76,41,35,74
Alloa,1147,2,18,9,9,65,44,21,63
Brechin,1147,3,19,6,11,65,46,19,63
Airdrieon,1147,4,17,7,12,59,51,8,58
Peterhead,1147,5,15,6,15,48,46,2,51
Stranraer,1147,6,13,7,16,53,56,-3,46
Albion,1147,7,12,10,14,55,65,-10,46
East Fife,1147,8,10,11,15,42,48,-6,41
Queen's Park,1147,9,9,7,20,26,49,-23,34
Stenhousem'r,1147,10,6,9,21,37,80,-43,27
Alloa,1148,1,21,5,10,78,50,28,68
Livingston,1148,2,19,7,10,75,46,29,64
Brechin,1148,3,18,5,13,52,49,3,59
Airdrieon,1148,4,15,12,9,58,46,12,57
Stranraer,1148,5,16,6,14,48,53,-5,54
East Fife,1148,6,13,7,16,46,44,2,46
Peterhead,1148,7,12,9,15,49,53,-4,45
Albion,1148,8,11,9,16,46,54,-8,42
Queen's Park,1148,9,11,6,19,34,60,-26,39
Stenhousem'r,1148,10,7,8,21,45,76,-31,29
Alloa,1149,1,21,9,6,73,37,36,72
Airdrieon,1149,2,22,6,8,67,42,25,72
Livingston,1149,3,19,3,14,64,43,21,60
Queen's Park,1149,4,15,7,14,30,40,-10,52
Brechin,1149,5,13,8,15,45,52,-7,47
East Fife,1149,6,10,13,13,43,45,-2,43
Peterhead,1149,7,11,9,16,45,57,-12,42
Stenhousem'r,1149,8,12,4,20,48,70,-22,40
Stranraer,1149,9,11,6,19,43,58,-15,39
Albion,1149,10,9,9,18,38,52,-14,36
Alloa,1150,1,19,8,9,72,40,32,65
Livingston,1150,2,21,2,13,71,51,20,65
Airdrieon,1150,3,19,5,12,63,53,10,62
Albion,1150,4,16,12,8,57,37,20,60
Brechin,1150,5,14,9,13,43,48,-5,51
Queen's Park,1150,6,15,5,16,37,44,-7,50
East Fife,1150,7,12,7,17,46,52,-6,43
Stranraer,1150,8,12,7,17,47,61,-14,43
Peterhead,1150,9,12,6,18,48,60,-12,42
Stenhousem'r,1150,10,4,11,21,40,78,-38,23
Livingston,1151,1,21,7,8,77,46,31,70
Alloa,1151,2,20,5,11,70,50,20,65
Airdrieon,1151,3,19,5,12,61,46,15,62
Brechin,1151,4,18,6,12,61,53,8,60
Peterhead,1151,5,15,5,16,53,55,-2,50
Albion,1151,6,14,6,16,58,58,0,48
Queen's Park,1151,7,12,11,13,49,54,-5,47
East Fife,1151,8,11,8,17,45,59,-14,41
Stranraer,1151,9,10,4,22,48,75,-27,34
Stenhousem'r,1151,10,8,7,21,51,77,-26,31
Livingston,1152,1,22,7,7,78,48,30,73
Alloa,1152,2,16,6,14,67,52,15,54
Albion,1152,3,16,6,14,52,48,4,54
Airdrieon,1152,4,15,7,14,56,58,-2,52
Queen's Park,1152,5,15,7,14,40,47,-7,52
East Fife,1152,6,13,12,11,49,44,5,51
Brechin,1152,7,14,7,15,52,54,-2,49
Stranraer,1152,8,13,7,16,48,48,0,46
Peterhead,1152,9,11,7,18,42,51,-9,40
Stenhousem'r,1152,10,8,8,20,41,75,-34,32
Alloa,1153,1,20,6,10,76,44,32,66
Airdrieon,1153,2,19,7,10,61,40,21,64
Livingston,1153,3,19,5,12,73,56,17,62
Peterhead,1153,4,17,7,12,56,53,3,58
East Fife,1153,5,15,8,13,52,43,9,53
Brechin,1153,6,15,6,15,45,51,-6,51
Stranraer,1153,7,11,8,17,45,54,-9,41
Albion,1153,8,9,11,16,50,67,-17,38
Stenhousem'r,1153,9,10,5,21,54,79,-25,35
Queen's Park,1153,10,7,13,16,32,57,-25,34
Livingston,1154,1,21,6,9,81,53,28,69
Alloa,1154,2,17,10,9,79,52,27,61
Brechin,1154,3,16,6,14,55,51,4,54
Airdrieon,1154,4,16,6,14,54,53,1,54
Stranraer,1154,5,16,5,15,56,59,-3,53
Peterhead,1154,6,15,7,14,46,42,4,52
Albion,1154,7,15,7,14,53,50,3,52
East Fife,1154,8,12,7,17,53,57,-4,43
Queen's Park,1154,9,11,4,21,38,60,-22,37
Stenhousem'r,1154,10,9,6,21,41,79,-38,33
Alloa,1155,1,19,10,7,72,37,35,67
Livingston,1155,2,19,7,10,70,44,26,64
Albion,1155,3,16,8,12,57,50,7,56
Brechin,1155,4,17,5,14,54,50,4,56
East Fife,1155,5,16,7,13,54,44,10,55
Airdrieon,1155,6,15,8,13,55,56,-1,53
Peterhead,1155,7,13,6,17,46,57,-11,45
Queen's Park,1155,8,11,9,16,33,47,-14,42
Stranraer,1155,9,10,7,19,40,60,-20,37
Stenhousem'r,1155,10,6,9,21,46,82,-36,27
Livingston,1156,1,23,2,11,73,50,23,71
Alloa,1156,2,21,5,10,77,46,31,68
Brechin,1156,3,16,7,13,49,49,0,55
Peterhead,1156,4,15,9,12,50,45,5,54
Airdrieon,1156,5,16,6,14,55,53,2,54
Queen's Park,1156,6,14,7,15,42,46,-4,49
Albion,1156,7,14,7,15,50,55,-5,49
Stranraer,1156,8,13,5,18,51,58,-7,44
East Fife,1156,9,9,8,19,45,54,-9,35
Stenhousem'r,1156,10,7,8,21,45,81,-36,29
Airdrieon,1157,1,20,5,11,64,50,14,65
Livingston,1157,2,18,6,12,68,47,21,60
Alloa,1157,3,16,10,10,65,42,23,58
Brechin,1157,4,17,6,13,59,53,6,57
Stranraer,1157,5,17,4,15,51,54,-3,55
East Fife,1157,6,13,11,12,54,47,7,50
Albion,1157,7,12,12,12,51,52,-1,48
Peterhead,1157,8,12,8,16,47,58,-11,44
Queen's Park,1157,9,12,5,19,38,56,-18,41
Stenhousem'r,1157,10,6,7,23,39,77,-38,25
Alloa,1158,1,20,9,7,84,45,39,69
Airdrieon,1158,2,19,5,12,63,53,10,62
Livingston,1158,3,17,8,11,68,47,21,59
Peterhead,1158,4,16,8,12,55,44,11,56
Brechin,1158,5,15,8,13,41,49,-8,53
East Fife,1158,6,13,11,12,53,42,11,50
Stranraer,1158,7,12,7,17,46,55,-9,43
Albion,1158,8,11,9,16,46,52,-6,42
Queen's Park,1158,9,12,6,18,36,61,-25,42
Stenhousem'r,1158,10,6,7,23,43,87,-44,25
Livingston,1159,1,22,5,9,80,54,26,71
Alloa,1159,2,20,8,8,73,41,32,68
Brechin,1159,3,17,5,14,56,57,-1,56
Peterhead,1159,4,14,9,13,53,53,0,51
Queen's Park,1159,5,15,6,15,45,51,-6,51
Stranraer,1159,6,13,8,15,61,62,-1,47
Airdrieon,1159,7,12,9,15,56,62,-6,45
Albion,1159,8,13,5,18,51,66,-15,44
East Fife,1159,9,10,11,15,54,50,4,41
Stenhousem'r,1159,10,7,8,21,50,83,-33,29
Airdrieon,1160,1,22,6,8,74,48,26,72
Livingston,1160,2,19,8,9,75,50,25,65
Alloa,1160,3,17,11,8,73,49,24,62
Brechin,1160,4,17,7,12,55,48,7,58
Peterhead,1160,5,9,16,11,46,51,-5,43
Albion,1160,6,12,7,17,46,55,-9,43
Stranraer,1160,7,11,7,18,56,71,-15,40
Queen's Park,1160,8,11,7,18,35,52,-17,40
East Fife,1160,9,9,12,15,40,47,-7,39
Stenhousem'r,1160,10,8,9,19,39,68,-29,33
Livingston,1161,1,21,6,9,87,46,41,69
Brechin,1161,2,20,5,11,62,48,14,65
Airdrieon,1161,3,17,8,11,64,56,8,59
Alloa,1161,4,15,7,14,67,54,13,52
Albion,1161,5,13,12,11,49,47,2,51
East Fife,1161,6,13,9,14,66,50,16,48
Stranraer,1161,7,14,4,18,53,65,-12,46
Peterhead,1161,8,11,9,16,40,62,-22,42
Queen's Park,1161,9,11,8,17,31,50,-19,41
Stenhousem'r,1161,10,8,6,22,43,84,-41,30
Livingston,1162,1,22,4,10,83,48,35,70
Alloa,1162,2,19,5,12,78,50,28,62
Albion,1162,3,18,6,12,59,47,12,60
Brechin,1162,4,17,6,13,52,45,7,57
Airdrieon,1162,5,14,12,10,57,49,8,54
Peterhead,1162,6,15,8,13,59,55,4,53
Queen's Park,1162,7,15,3,18,31,50,-19,48
Stranraer,1162,8,11,7,18,40,59,-19,40
East Fife,1162,9,10,7,19,43,60,-17,37
Stenhousem'r,1162,10,6,8,22,43,82,-39,26
Alloa,1163,1,22,6,8,86,43,43,72
Livingston,1163,2,20,6,10,86,57,29,66
Brechin,1163,3,18,3,15,54,44,10,57
Airdrieon,1163,4,17,5,14,60,54,6,56
Peterhead,1163,5,15,8,13,54,61,-7,53
Albion,1163,6,12,10,14,51,54,-3,46
East Fife,1163,7,12,10,14,48,51,-3,46
Queen's Park,1163,8,14,4,18,45,66,-21,46
Stranraer,1163,9,11,6,19,52,68,-16,39
Stenhousem'r,1163,10,5,10,21,43,81,-38,25
Livingston,1164,1,21,6,9,86,55,31,69
Brechin,1164,2,21,6,9,57,41,16,69
Alloa,1164,3,18,9,9,60,39,21,63
Peterhead,1164,4,16,7,13,54,48,6,55
Queen's Park,1164,5,16,4,16,45,50,-5,52
Airdrieon,1164,6,14,8,14,57,62,-5,50
Albion,1164,7,13,5,18,54,68,-14,44
Stranraer,1164,8,11,6,19,50,63,-13,39
Stenhousem'r,1164,9,8,10,18,55,81,-26,34
East Fife,1164,10,6,11,19,39,50,-11,29
Alloa,1165,1,18,8,10,67,45,22,62
Livingston,1165,2,18,5,13,69,53,16,59
Peterhead,1165,3,16,9,11,51,46,5,57
Airdrieon,1165,4,17,5,14,62,54,8,56
East Fife,1165,5,14,10,12,61,48,13,52
Queen's Park,1165,6,14,8,14,42,47,-5,50
Brechin,1165,7,14,7,15,51,57,-6,49
Stranraer,1165,8,11,10,15,51,57,-6,43
Albion,1165,9,11,9,16,47,56,-9,42
Stenhousem'r,1165,10,6,11,19,45,83,-38,29
Brechin,1166,1,23,3,10,70,44,26,72
Livingston,1166,2,19,6,11,69,45,24,63
Alloa,1166,3,18,7,11,64,48,16,61
Airdrieon,1166,4,18,6,12,66,58,8,60
Albion,1166,5,13,11,12,56,60,-4,50
Peterhead,1166,6,14,8,14,50,58,-8,50
Queen's Park,1166,7,12,7,17,42,58,-16,43
East Fife,1166,8,9,9,18,51,49,2,36
Stenhousem'r,1166,9,9,8,19,52,83,-31,35
Stranraer,1166,10,9,7,20,56,73,-17,34
Livingston,1167,1,23,3,10,83,52,31,72
Airdrieon,1167,2,21,5,10,66,54,12,68
Alloa,1167,3,19,9,8,59,39,20,66
Brechin,1167,4,18,7,11,55,49,6,61
Peterhead,1167,5,14,8,14,61,61,0,50
Albion,1167,6,13,10,13,55,51,4,49
East Fife,1167,7,11,9,16,50,47,3,42
Queen's Park,1167,8,8,9,19,34,59,-25,33
Stranraer,1167,9,8,7,21,44,63,-19,31
Stenhousem'r,1167,10,8,7,21,52,84,-32,31
Livingston,1168,1,24,3,9,80,45,35,75
Airdrieon,1168,2,20,6,10,58,44,14,66
Alloa,1168,3,17,9,10,71,51,20,60
Albion,1168,4,15,9,12,63,54,9,54
East Fife,1168,5,14,10,12,52,41,11,52
Brechin,1168,6,13,6,17,44,48,-4,45
Peterhead,1168,7,13,6,17,43,50,-7,45
Stranraer,1168,8,11,7,18,46,57,-11,40
Queen's Park,1168,9,9,9,18,35,61,-26,36
Stenhousem'r,1168,10,8,7,21,46,87,-41,31
Livingston,1169,1,21,6,9,79,47,32,69
Alloa,1169,2,18,9,9,70,46,24,63
Airdrieon,1169,3,16,6,14,60,61,-1,54
Brechin,1169,4,14,11,11,43,38,5,53
Peterhead,1169,5,15,7,14,56,54,2,52
Queen's Park,1169,6,15,6,15,39,48,-9,51
Albion,1169,7,14,7,15,52,54,-2,49
Stranraer,1169,8,13,8,15,51,58,-7,47
East Fife,1169,9,9,7,20,43,55,-12,34
Stenhousem'r,1169,10,7,9,20,42,74,-32,30
Livingston,1170,1,21,4,11,92,53,39,67
Brechin,1170,2,17,6,13,56,45,11,57
East Fife,1170,3,16,8,12,58,49,9,56
Alloa,1170,4,15,10,11,64,41,23,55
Albion,1170,5,15,8,13,48,49,-1,53
Airdrieon,1170,6,13,10,13,61,59,2,49
Queen's Park,1170,7,12,10,14,38,54,-16,46
Stranraer,1170,8,12,8,16,56,71,-15,44
Peterhead,1170,9,11,7,18,43,61,-18,40
Stenhousem'r,1170,10,6,13,17,44,78,-34,31
Livingston,1171,1,22,9,5,84,40,44,75
Alloa,1171,2,18,7,11,71,52,19,61
Airdrieon,1171,3,18,7,11,56,44,12,61
Albion,1171,4,14,10,12,45,50,-5,52
Brechin,1171,5,13,10,13,46,47,-1,49
East Fife,1171,6,13,9,14,53,45,8,48
Stranraer,1171,7,12,8,16,49,60,-11,44
Queen's Park,1171,8,11,11,14,39,55,-16,44
Peterhead,1171,9,11,9,16,45,56,-11,42
Stenhousem'r,1171,10,3,10,23,45,84,-39,19
Livingston,1172,1,23,6,7,81,45,36,75
Alloa,1172,2,17,8,11,62,44,18,59
Albion,1172,3,17,7,12,60,52,8,58
Brechin,1172,4,16,7,13,52,51,1,55
Queen's Park,1172,5,15,4,17,52,51,1,49
Peterhead,1172,6,13,7,16,37,46,-9,46
Airdrieon,1172,7,13,6,17,51,61,-10,45
East Fife,1172,8,11,10,15,47,47,0,43
Stranraer,1172,9,13,4,19,54,67,-13,43
Stenhousem'r,1172,10,7,11,18,43,75,-32,32
Livingston,1173,1,20,6,10,74,43,31,66
Alloa,1173,2,18,10,8,63,35,28,64
Airdrieon,1173,3,17,13,6,57,42,15,64
Brechin,1173,4,19,5,12,52,41,11,62
Queen's Park,1173,5,14,8,14,37,44,-7,50
East Fife,1173,6,10,12,14,44,51,-7,42
Albion,1173,7,10,9,17,44,53,-9,39
Peterhead,1173,8,10,9,17,39,56,-17,39
Stranraer,1173,9,8,12,16,48,62,-14,36
Stenhousem'r,1173,10,8,8,20,42,73,-31,32
Alloa,1174,1,22,8,6,74,43,31,74
Airdrieon,1174,2,19,8,9,60,43,17,65
Albion,1174,3,17,6,13,49,49,0,57
Brechin,1174,4,17,5,14,53,49,4,56
Livingston,1174,5,14,8,14,74,66,8,50
East Fife,1174,6,12,6,18,61,58,3,42
Queen's Park,1174,7,11,9,16,38,59,-21,42
Stranraer,1174,8,12,4,20,56,63,-7,40
Peterhead,1174,9,11,7,18,48,62,-14,40
Stenhousem'r,1174,10,10,9,17,50,71,-21,39
Livingston,1175,1,19,6,11,64,48,16,63
Alloa,1175,2,16,11,9,78,44,34,59
Stranraer,1175,3,17,6,13,56,50,6,57
Airdrieon,1175,4,16,6,14,55,61,-6,54
Peterhead,1175,5,14,9,13,52,55,-3,51
Brechin,1175,6,12,12,12,51,46,5,48
Albion,1175,7,11,11,14,50,52,-2,44
Queen's Park,1175,8,12,8,16,35,49,-14,44
East Fife,1175,9,11,10,15,51,48,3,43
Stenhousem'r,1175,10,8,9,19,48,87,-39,33
Alloa,1176,1,20,7,9,68,40,28,67
Livingston,1176,2,20,5,11,78,46,32,65
Brechin,1176,3,19,5,12,55,45,10,62
Airdrieon,1176,4,18,4,14,56,51,5,58
Albion,1176,5,15,4,17,56,57,-1,49
Peterhead,1176,6,15,4,17,50,53,-3,49
Stranraer,1176,7,15,3,18,44,55,-11,48
Queen's Park,1176,8,14,4,18,38,65,-27,46
East Fife,1176,9,12,7,17,50,51,-1,43
Stenhousem'r,1176,10,8,5,23,45,77,-32,29
Alloa,1177,1,21,8,7,83,40,43,71
Livingston,1177,2,21,7,8,78,46,32,70
Airdrieon,1177,3,18,9,9,68,49,19,63
Brechin,1177,4,18,5,13,55,48,7,59
Queen's Park,1177,5,16,3,17,47,55,-8,51
Stranraer,1177,6,14,4,18,55,68,-13,46
East Fife,1177,7,12,6,18,59,65,-6,42
Peterhead,1177,8,12,6,18,47,63,-16,42
Albion,1177,9,8,9,19,48,70,-22,33
Stenhousem'r,1177,10,7,9,20,46,82,-36,30
Livingston,1178,1,23,2,11,78,42,36,71
Alloa,1178,2,20,9,7,72,39,33,69
Airdrieon,1178,3,17,5,14,60,56,4,56
Peterhead,1178,4,15,7,14,46,56,-10,52
Albion,1178,5,15,6,15,54,45,9,51
Stranraer,1178,6,15,4,17,51,66,-15,49
Brechin,1178,7,14,5,17,48,50,-2,47
Queen's Park,1178,8,11,8,17,37,51,-14,41
Stenhousem'r,1178,9,10,9,17,54,77,-23,39
East Fife,1178,10,7,11,18,41,59,-18,32
Livingston,1179,1,20,7,9,76,56,20,67
Brechin,1179,2,20,4,12,63,51,12,64
Airdrieon,1179,3,19,6,11,60,50,10,63
Alloa,1179,4,14,10,12,70,56,14,52
Albion,1179,5,14,8,14,60,56,4,50
Queen's Park,1179,6,13,8,15,42,53,-11,47
Stranraer,1179,7,12,7,17,50,58,-8,43
Peterhead,1179,8,10,12,14,47,52,-5,42
East Fife,1179,9,10,11,15,52,61,-9,41
Stenhousem'r,1179,10,7,9,20,49,76,-27,30
Alloa,1180,1,19,10,7,74,39,35,67
Livingston,1180,2,19,8,9,71,50,21,65
Airdrieon,1180,3,16,8,12,56,51,5,56
Brechin,1180,4,17,5,14,45,54,-9,56
Peterhead,1180,5,15,8,13,52,57,-5,53
East Fife,1180,6,13,11,12,56,44,12,50
Albion,1180,7,12,11,13,54,46,8,47
Queen's Park,1180,8,12,8,16,37,53,-16,44
Stranraer,1180,9,10,6,20,48,63,-15,36
Stenhousem'r,1180,10,5,9,22,44,80,-36,24
Alloa,1181,1,20,7,9,77,42,35,67
Livingston,1181,2,20,4,12,75,52,23,64
Brechin,1181,3,16,5,15,55,50,5,53
Airdrieon,1181,4,14,10,12,55,52,3,52
Albion,1181,5,15,6,15,56,61,-5,51
Queen's Park,1181,6,13,8,15,39,52,-13,47
East Fife,1181,7,13,7,16,56,54,2,46
Stranraer,1181,8,12,7,17,48,58,-10,43
Peterhead,1181,9,11,10,15,40,54,-14,43
Stenhousem'r,1181,10,11,6,19,49,75,-26,39
Livingston,1182,1,23,4,9,81,44,37,73
Alloa,1182,2,20,8,8,71,37,34,68
Brechin,1182,3,18,8,10,50,41,9,62
Airdrieon,1182,4,18,7,11,60,57,3,61
Stranraer,1182,5,15,7,14,54,51,3,52
Peterhead,1182,6,11,8,17,40,54,-14,41
Queen's Park,1182,7,10,10,16,42,52,-10,40
Albion,1182,8,9,10,17,49,64,-15,37
East Fife,1182,9,7,14,15,41,51,-10,35
Stenhousem'r,1182,10,8,6,22,46,83,-37,30
Alloa,1183,1,20,8,8,73,45,28,68
Airdrieon,1183,2,20,7,9,67,44,23,67
Livingston,1183,3,19,6,11,76,51,25,63
East Fife,1183,4,15,8,13,51,44,7,53
Brechin,1183,5,15,7,14,46,42,4,52
Peterhead,1183,6,14,7,15,44,57,-13,49
Albion,1183,7,13,9,14,53,52,1,48
Queen's Park,1183,8,11,7,18,34,54,-20,40
Stranraer,1183,9,12,3,21,50,66,-16,39
Stenhousem'r,1183,10,7,6,23,45,84,-39,27
Livingston,1184,1,21,6,9,87,49,38,69
Airdrieon,1184,2,18,10,8,69,57,12,64
East Fife,1184,3,15,9,12,51,37,14,54
Brechin,1184,4,14,11,11,54,54,0,53
Alloa,1184,5,14,9,13,62,57,5,51
Peterhead,1184,6,14,8,14,45,49,-4,50
Stranraer,1184,7,13,8,15,63,63,0,47
Queen's Park,1184,8,12,9,15,39,49,-10,45
Albion,1184,9,9,9,18,45,62,-17,36
Stenhousem'r,1184,10,6,9,21,43,81,-38,27
Livingston,1185,1,20,7,9,76,53,23,67
Airdrieon,1185,2,20,5,11,60,50,10,65
Alloa,1185,3,19,6,11,74,47,27,63
Brechin,1185,4,16,9,11,65,50,15,57
Queen's Park,1185,5,14,9,13,53,55,-2,51
Peterhead,1185,6,13,7,16,38,53,-15,46
Albion,1185,7,12,9,15,44,56,-12,45
Stranraer,1185,8,12,4,20,54,64,-10,40
East Fife,1185,9,10,8,18,50,53,-3,38
Stenhousem'r,1185,10,9,6,21,51,84,-33,33
Livingston,1186,1,22,5,9,87,45,42,71
Brechin,1186,2,19,7,10,50,43,7,64
Alloa,1186,3,18,8,10,71,46,25,62
Airdrieon,1186,4,16,7,13,59,52,7,55
Albion,1186,5,13,10,13,50,56,-6,49
Peterhead,1186,6,12,11,13,49,53,-4,47
Queen's Park,1186,7,13,8,15,40,55,-15,47
East Fife,1186,8,12,9,15,56,49,7,45
Stranraer,1186,9,8,7,21,39,67,-28,31
Stenhousem'r,1186,10,7,8,21,38,73,-35,29
Alloa,1187,1,20,6,10,70,46,24,66
Airdrieon,1187,2,19,5,12,60,57,3,62
Livingston,1187,3,18,4,14,79,58,21,58
Peterhead,1187,4,16,10,10,67,53,14,58
Brechin,1187,5,15,6,15,48,55,-7,51
Queen's Park,1187,6,14,7,15,38,42,-4,49
Stranraer,1187,7,14,4,18,52,59,-7,46
East Fife,1187,8,11,10,15,47,51,-4,43
Albion,1187,9,10,11,15,56,63,-7,41
Stenhousem'r,1187,10,7,9,20,41,74,-33,30
Alloa,1188,1,19,7,10,76,44,32,64
Livingston,1188,2,18,9,9,74,47,27,63
Airdrieon,1188,3,17,7,12,68,60,8,58
Stranraer,1188,4,15,9,12,60,56,4,54
East Fife,1188,5,14,7,15,54,53,1,49
Peterhead,1188,6,12,9,15,52,56,-4,45
Queen's Park,1188,7,12,9,15,34,50,-16,45
Albion,1188,8,10,12,14,54,58,-4,42
Brechin,1188,9,11,9,16,41,56,-15,42
Stenhousem'r,1188,10,7,12,17,43,76,-33,33
Albion,1189,1,21,5,10,63,40,23,68
Airdrieon,1189,2,19,7,10,61,42,19,64
Brechin,1189,3,18,7,11,56,48,8,61
Livingston,1189,4,16,8,12,64,50,14,56
Alloa,1189,5,16,7,13,66,58,8,55
East Fife,1189,6,14,10,12,53,43,10,52
Peterhead,1189,7,12,6,18,45,57,-12,42
Stranraer,1189,8,10,11,15,46,61,-15,41
Queen's Park,1189,9,10,8,18,38,53,-15,38
Stenhousem'r,1189,10,6,7,23,46,86,-40,25
Livingston,1190,1,26,6,4,92,35,57,84
Alloa,1190,2,19,7,10,70,40,30,64
Airdrieon,1190,3,18,4,14,52,55,-3,58
Peterhead,1190,4,14,5,17,46,49,-3,47
Brechin,1190,5,12,11,13,39,45,-6,47
Albion,1190,6,12,8,16,50,53,-3,44
Stranraer,1190,7,13,5,18,41,63,-22,44
Queen's Park,1190,8,12,6,18,45,55,-10,42
East Fife,1190,9,10,9,17,43,54,-11,39
Stenhousem'r,1190,10,10,7,19,51,80,-29,37
Livingston,1191,1,21,6,9,82,45,37,69
Alloa,1191,2,19,7,10,66,41,25,64
Airdrieon,1191,3,18,6,12,55,46,9,60
Peterhead,1191,4,17,6,13,56,49,7,57
Brechin,1191,5,17,6,13,53,47,6,57
East Fife,1191,6,11,9,16,39,49,-10,42
Queen's Park,1191,7,11,9,16,37,52,-15,42
Stranraer,1191,8,11,8,17,46,57,-11,41
Stenhousem'r,1191,9,12,5,19,54,78,-24,41
Albion,1191,10,8,8,20,43,67,-24,32
Livingston,1192,1,23,4,9,83,41,42,73
Brechin,1192,2,18,3,15,53,49,4,57
Alloa,1192,3,15,10,11,63,50,13,55
Albion,1192,4,15,9,12,54,54,0,54
Airdrieon,1192,5,16,4,16,59,62,-3,52
Peterhead,1192,6,14,6,16,50,50,0,48
East Fife,1192,7,12,10,14,48,43,5,46
Stranraer,1192,8,14,3,19,51,58,-7,45
Queen's Park,1192,9,12,6,18,37,58,-21,42
Stenhousem'r,1192,10,11,5,20,49,82,-33,38
Brechin,1193,1,20,6,10,56,40,16,66
Livingston,1193,2,17,6,13,71,52,19,57
Alloa,1193,3,17,6,13,67,49,18,57
Airdrieon,1193,4,14,11,11,56,57,-1,53
East Fife,1193,5,14,10,12,57,41,16,52
Peterhead,1193,6,12,10,14,45,46,-1,46
Albion,1193,7,12,10,14,48,50,-2,46
Queen's Park,1193,8,11,11,14,34,52,-18,44
Stranraer,1193,9,11,10,15,53,64,-11,43
Stenhousem'r,1193,10,8,8,20,48,84,-36,32
Livingston,1194,1,21,4,11,79,50,29,67
Airdrieon,1194,2,19,8,9,63,43,20,65
Brechin,1194,3,18,7,11,62,51,11,61
Alloa,1194,4,17,9,10,64,43,21,60
Peterhead,1194,5,15,7,14,45,52,-7,52
East Fife,1194,6,13,9,14,55,52,3,48
Albion,1194,7,13,8,15,53,56,-3,47
Stranraer,1194,8,12,7,17,46,61,-15,43
Queen's Park,1194,9,10,7,19,33,57,-24,37
Stenhousem'r,1194,10,6,6,24,42,77,-35,24
Brechin,1195,1,23,3,10,62,41,21,72
Alloa,1195,2,20,7,9,73,42,31,67
Airdrieon,1195,3,19,5,12,52,47,5,62
Livingston,1195,4,18,4,14,65,55,10,58
Albion,1195,5,16,7,13,60,52,8,55
Stranraer,1195,6,14,5,17,48,56,-8,47
East Fife,1195,7,13,7,16,56,52,4,46
Queen's Park,1195,8,12,7,17,41,58,-17,43
Peterhead,1195,9,11,4,21,43,61,-18,37
Stenhousem'r,1195,10,6,7,23,44,80,-36,25
Alloa,1196,1,23,8,5,78,33,45,77
Livingston,1196,2,21,6,9,72,42,30,69
Albion,1196,3,16,7,13,51,53,-2,55
Airdrieon,1196,4,16,5,15,63,57,6,53
Brechin,1196,5,15,4,17,44,48,-4,49
East Fife,1196,6,12,11,13,42,36,6,47
Queen's Park,1196,7,13,7,16,45,58,-13,46
Stranraer,1196,8,13,7,16,46,61,-15,46
Peterhead,1196,9,9,12,15,43,53,-10,39
Stenhousem'r,1196,10,5,7,24,31,74,-43,22
Alloa,1197,1,20,7,9,68,43,25,67
Livingston,1197,2,19,6,11,61,37,24,63
Airdrieon,1197,3,18,6,12,61,49,12,60
Brechin,1197,4,16,6,14,50,50,0,54
Albion,1197,5,14,8,14,51,49,2,50
Queen's Park,1197,6,15,5,16,42,55,-13,50
East Fife,1197,7,13,8,15,50,50,0,47
Stranraer,1197,8,10,9,17,43,56,-13,39
Peterhead,1197,9,10,8,18,47,64,-17,38
Stenhousem'r,1197,10,9,9,18,54,74,-20,36
Livingston,1198,1,21,4,11,76,45,31,67
Airdrieon,1198,2,19,9,8,60,44,16,66
Alloa,1198,3,18,8,10,66,43,23,62
Queen's Park,1198,4,14,8,14,42,44,-2,50
Stranraer,1198,5,15,3,18,54,58,-4,48
Brechin,1198,6,13,7,16,42,54,-12,46
Albion,1198,7,12,7,17,54,68,-14,43
East Fife,1198,8,11,9,16,50,52,-2,42
Peterhead,1198,9,9,14,13,43,53,-10,41
Stenhousem'r,1198,10,10,7,19,51,77,-26,37
Alloa,1199,1,21,8,7,80,43,37,71
Livingston,1199,2,21,6,9,84,44,40,69
Airdrieon,1199,3,16,8,12,58,64,-6,56
Peterhead,1199,4,14,9,13,54,53,1,51
Stranraer,1199,5,16,3,17,55,63,-8,51
Brechin,1199,6,14,7,15,39,47,-8,49
East Fife,1199,7,12,8,16,47,45,2,44
Albion,1199,8,12,8,16,59,64,-5,44
Queen's Park,1199,9,11,8,17,33,54,-21,41
Stenhousem'r,1199,10,7,7,22,41,73,-32,28
Livingston,1200,1,26,3,7,85,33,52,81
Brechin,1200,2,19,4,13,52,42,10,61
Alloa,1200,3,17,8,11,68,44,24,59
Airdrieon,1200,4,14,8,14,47,55,-8,50
Albion,1200,5,15,4,17,48,53,-5,49
East Fife,1200,6,13,8,15,49,47,2,47
Peterhead,1200,7,13,6,17,44,57,-13,45
Stenhousem'r,1200,8,13,4,19,52,73,-21,43
Queen's Park,1200,9,12,5,19,32,52,-20,41
Stranraer,1200,10,10,6,20,43,64,-21,36
Airdrieon,1201,1,20,10,6,72,52,20,70
Livingston,1201,2,20,9,7,68,40,28,69
Alloa,1201,3,18,7,11,73,45,28,61
Brechin,1201,4,17,7,12,51,47,4,58
Peterhead,1201,5,14,9,13,47,50,-3,51
Albion,1201,6,12,10,14,51,56,-5,46
Queen's Park,1201,7,12,9,15,33,44,-11,45
Stranraer,1201,8,10,5,21,55,75,-20,35
Stenhousem'r,1201,9,9,7,20,48,75,-27,34
East Fife,1201,10,6,11,19,48,62,-14,29
Livingston,1202,1,21,4,11,89,55,34,67
Brechin,1202,2,19,8,9,58,46,12,65
Alloa,1202,3,18,7,11,73,47,26,61
Albion,1202,4,15,12,9,55,40,15,57
Queen's Park,1202,5,14,8,14,41,52,-11,50
Airdrieon,1202,6,13,9,14,55,59,-4,48
East Fife,1202,7,13,8,15,56,47,9,47
Peterhead,1202,8,13,7,16,48,57,-9,46
Stranraer,1202,9,9,8,19,46,71,-25,35
Stenhousem'r,1202,10,5,9,22,42,89,-47,24
Livingston,1203,1,24,4,8,82,38,44,76
Alloa,1203,2,19,11,6,74,39,35,68
Airdrieon,1203,3,19,8,9,63,50,13,65
Albion,1203,4,14,11,11,54,49,5,53
Brechin,1203,5,16,4,16,47,49,-2,52
Stranraer,1203,6,13,9,14,54,64,-10,48
East Fife,1203,7,11,7,18,47,50,-3,40
Queen's Park,1203,8,11,6,19,34,61,-27,39
Peterhead,1203,9,8,8,20,42,64,-22,32
Stenhousem'r,1203,10,8,6,22,47,80,-33,30
Airdrieon,1204,1,19,9,8,65,48,17,66
Alloa,1204,2,17,7,12,66,51,15,58
Brechin,1204,3,17,7,12,55,53,2,58
Livingston,1204,4,17,6,13,79,56,23,57
Peterhead,1204,5,14,8,14,52,52,0,50
Albion,1204,6,13,9,14,59,54,5,48
East Fife,1204,7,12,10,14,46,49,-3,46
Stranraer,1204,8,13,6,17,53,59,-6,45
Queen's Park,1204,9,11,12,13,44,57,-13,45
Stenhousem'r,1204,10,6,8,22,40,80,-40,26
Airdrieon,1205,1,21,5,10,62,51,11,68
Brechin,1205,2,20,7,9,55,44,11,67
Alloa,1205,3,18,7,11,75,50,25,61
Albion,1205,4,17,4,15,66,62,4,55
Livingston,1205,5,15,7,14,66,52,14,52
East Fife,1205,6,15,7,14,57,48,9,52
Peterhead,1205,7,13,5,18,48,53,-5,44
Queen's Park,1205,8,10,8,18,41,54,-13,38
Stranraer,1205,9,10,7,19,39,67,-28,37
Stenhousem'r,1205,10,9,7,20,41,69,-28,34
Airdrieon,1206,1,19,5,12,56,49,7,62
Livingston,1206,2,18,7,11,70,47,23,61
Alloa,1206,3,17,8,11,70,49,21,59
Queen's Park,1206,4,17,6,13,48,45,3,57
Brechin,1206,5,15,8,13,43,44,-1,53
Stranraer,1206,6,14,6,16,54,63,-9,48
Albion,1206,7,13,8,15,55,56,-1,47
East Fife,1206,8,12,10,14,39,48,-9,46
Peterhead,1206,9,12,7,17,44,51,-7,43
Stenhousem'r,1206,10,8,5,23,40,67,-27,29
Alloa,1207,1,20,5,11,66,47,19,65
Livingston,1207,2,17,8,11,69,51,18,59
Albion,1207,3,16,10,10,62,48,14,58
Airdrieon,1207,4,16,9,11,63,51,12,57
Brechin,1207,5,14,7,15,51,54,-3,49
East Fife,1207,6,12,9,15,51,53,-2,45
Stenhousem'r,1207,7,11,9,16,55,77,-22,42
Stranraer,1207,8,11,8,17,56,66,-10,41
Peterhead,1207,9,9,12,15,44,51,-7,39
Queen's Park,1207,10,8,15,13,31,50,-19,39
Livingston,1208,1,24,4,8,79,42,37,76
Alloa,1208,2,16,12,8,65,49,16,60
Brechin,1208,3,16,10,10,54,48,6,58
Airdrieon,1208,4,16,7,13,56,52,4,55
East Fife,1208,5,12,13,11,50,41,9,49
Albion,1208,6,12,10,14,51,51,0,46
Peterhead,1208,7,12,8,16,47,51,-4,44
Stranraer,1208,8,10,9,17,56,57,-1,39
Queen's Park,1208,9,10,9,17,36,59,-23,39
Stenhousem'r,1208,10,6,10,20,42,86,-44,28
Livingston,1209,1,21,6,9,69,43,26,69
Alloa,1209,2,18,7,11,69,45,24,61
Airdrieon,1209,3,17,9,10,62,57,5,60
Albion,1209,4,17,7,12,57,46,11,58
Brechin,1209,5,16,4,16,50,58,-8,52
Stranraer,1209,6,13,5,18,55,65,-10,44
East Fife,1209,7,11,10,15,50,48,2,43
Peterhead,1209,8,12,7,17,53,57,-4,43
Queen's Park,1209,9,11,9,16,41,56,-15,42
Stenhousem'r,1209,10,7,10,19,43,74,-31,31
Alloa,1210,1,22,6,8,78,41,37,72
Livingston,1210,2,20,3,13,78,58,20,63
Brechin,1210,3,19,6,11,51,48,3,63
Queen's Park,1210,4,16,8,12,38,44,-6,56
Airdrieon,1210,5,14,10,12,52,53,-1,52
Peterhead,1210,6,15,6,15,58,53,5,51
Albion,1210,7,13,6,17,54,54,0,45
Stranraer,1210,8,11,8,17,47,58,-11,41
East Fife,1210,9,9,7,20,45,56,-11,34
Stenhousem'r,1210,10,8,6,22,42,78,-36,30
Livingston,1211,1,20,8,8,78,43,35,68
Alloa,1211,2,16,12,8,64,40,24,60
Brechin,1211,3,17,6,13,53,46,7,57
East Fife,1211,4,15,10,11,47,37,10,55
Albion,1211,5,16,5,15,58,52,6,53
Airdrieon,1211,6,15,8,13,55,62,-7,53
Peterhead,1211,7,13,6,17,52,63,-11,45
Stranraer,1211,8,12,7,17,51,56,-5,43
Stenhousem'r,1211,9,9,8,19,47,76,-29,35
Queen's Park,1211,10,9,6,21,35,65,-30,33
Livingston,1212,1,22,5,9,87,46,41,71
Alloa,1212,2,20,9,7,80,46,34,69
Airdrieon,1212,3,17,6,13,57,48,9,57
Albion,1212,4,16,7,13,60,58,2,55
Brechin,1212,5,17,4,15,48,49,-1,55
Peterhead,1212,6,14,7,15,52,59,-7,49
Stranraer,1212,7,13,6,17,51,52,-1,45
Queen's Park,1212,8,12,7,17,42,61,-19,43
East Fife,1212,9,10,5,21,46,60,-14,35
Stenhousem'r,1212,10,7,8,21,42,86,-44,29
Alloa,1213,1,22,8,6,76,37,39,74
Livingston,1213,2,18,6,12,71,48,23,60
Brechin,1213,3,16,8,12,51,43,8,56
Airdrieon,1213,4,15,7,14,52,55,-3,52
Peterhead,1213,5,13,12,11,52,47,5,51
Albion,1213,6,14,9,13,55,55,0,51
East Fife,1213,7,12,11,13,54,52,2,47
Stranraer,1213,8,12,5,19,46,58,-12,41
Stenhousem'r,1213,9,8,10,18,43,73,-30,34
Queen's Park,1213,10,8,8,20,28,60,-32,32
Livingston,1214,1,21,7,8,74,40,34,70
Alloa,1214,2,18,10,8,69,43,26,64
Albion,1214,3,17,7,12,57,52,5,58
Peterhead,1214,4,16,8,12,62,56,6,56
Airdrieon,1214,5,14,8,14,54,57,-3,50
Brechin,1214,6,13,7,16,47,63,-16,46
Stranraer,1214,7,13,6,17,46,54,-8,45
East Fife,1214,8,11,8,17,48,49,-1,41
Queen's Park,1214,9,12,5,19,36,48,-12,41
Stenhousem'r,1214,10,9,6,21,61,92,-31,33
Livingston,1215,1,23,6,7,86,54,32,75
Alloa,1215,2,20,6,10,74,45,29,66
Brechin,1215,3,19,4,13,57,44,13,61
Airdrieon,1215,4,17,7,12,59,60,-1,58
Albion,1215,5,13,13,10,50,46,4,52
Peterhead,1215,6,12,10,14,46,55,-9,46
East Fife,1215,7,11,8,17,45,44,1,41
Queen's Park,1215,8,11,6,19,36,51,-15,39
Stranraer,1215,9,11,4,21,50,76,-26,37
Stenhousem'r,1215,10,8,6,22,56,84,-28,30
Livingston,1216,1,23,4,9,82,45,37,73
Airdrieon,1216,2,19,6,11,66,50,16,63
Brechin,1216,3,16,7,13,52,41,11,55
Alloa,1216,4,15,7,14,64,49,15,52
Albion,1216,5,14,10,12,48,44,4,52
East Fife,1216,6,11,14,11,44,37,7,47
Peterhead,1216,7,13,8,15,49,61,-12,47
Stranraer,1216,8,14,4,18,52,69,-17,46
Queen's Park,1216,9,13,4,19,39,54,-15,43
Stenhousem'r,1216,10,8,4,24,39,85,-46,28
Livingston,1217,1,23,1,12,86,49,37,70
Brechin,1217,2,22,3,11,57,48,9,69
Alloa,1217,3,17,9,10,68,48,20,60
Albion,1217,4,15,10,11,60,49,11,55
Airdrieon,1217,5,15,6,15,52,61,-9,51
Stranraer,1217,6,15,5,16,60,60,0,50
Peterhead,1217,7,12,7,17,48,58,-10,43
East Fife,1217,8,9,13,14,51,49,2,40
Queen's Park,1217,9,8,11,17,30,55,-25,35
Stenhousem'r,1217,10,7,9,20,50,85,-35,30
Livingston,1218,1,24,4,8,87,43,44,76
Alloa,1218,2,16,12,8,67,46,21,60
Brechin,1218,3,15,11,10,47,38,9,56
Airdrieon,1218,4,16,7,13,56,58,-2,55
East Fife,1218,5,13,10,13,48,40,8,49
Peterhead,1218,6,14,7,15,50,53,-3,49
Albion,1218,7,13,8,15,54,59,-5,47
Queen's Park,1218,8,14,5,17,37,62,-25,47
Stranraer,1218,9,9,7,20,48,59,-11,34
Stenhousem'r,1218,10,8,5,23,48,84,-36,29
Alloa,1219,1,18,9,9,75,47,28,63
Livingston,1219,2,18,7,11,70,51,19,61
Brechin,1219,3,18,5,13,51,46,5,59
Albion,1219,4,15,9,12,59,47,12,54
Airdrieon,1219,5,17,2,17,56,54,2,53
Peterhead,1219,6,15,8,13,49,52,-3,53
Queen's Park,1219,7,14,6,16,46,59,-13,48
East Fife,1219,8,10,10,16,47,46,1,40
Stranraer,1219,9,10,9,17,46,62,-16,39
Stenhousem'r,1219,10,9,7,20,48,83,-35,34
Livingston,1220,1,22,5,9,86,57,29,71
Airdrieon,1220,2,20,8,8,65,44,21,68
Alloa,1220,3,16,13,7,70,46,24,61
Albion,1220,4,13,11,12,63,52,11,50
East Fife,1220,5,12,13,11,59,49,10,49
Peterhead,1220,6,12,10,14,44,50,-6,46
Queen's Park,1220,7,12,10,14,38,49,-11,46
Brechin,1220,8,12,7,17,42,60,-18,43
Stranraer,1220,9,10,5,21,47,69,-22,35
Stenhousem'r,1220,10,5,10,21,43,81,-38,25
Airdrieon,1221,1,20,6,10,63,42,21,66
Brechin,1221,2,19,7,10,58,46,12,64
Alloa,1221,3,17,7,12,73,53,20,58
Peterhead,1221,4,17,7,12,54,50,4,58
Livingston,1221,5,17,4,15,73,53,20,55
Queen's Park,1221,6,14,6,16,42,55,-13,48
Stranraer,1221,7,13,7,16,52,59,-7,46
Albion,1221,8,12,8,16,54,61,-7,44
Stenhousem'r,1221,9,9,8,19,39,76,-37,35
East Fife,1221,10,8,8,20,42,55,-13,32
Alloa,1222,1,19,9,8,75,42,33,66
Airdrieon,1222,2,18,8,10,64,50,14,62
Livingston,1222,3,17,9,10,67,48,19,60
Albion,1222,4,16,10,10,60,48,12,58
Peterhead,1222,5,13,8,15,53,56,-3,47
Brechin,1222,6,13,8,15,39,49,-10,47
Stenhousem'r,1222,7,13,6,17,52,75,-23,45
Stranraer,1222,8,9,11,16,46,60,-14,38
Queen's Park,1222,9,11,5,20,32,55,-23,38
East Fife,1222,10,8,12,16,46,51,-5,36
Airdrieon,1223,1,21,5,10,68,51,17,68
Alloa,1223,2,17,8,11,73,49,24,59
Livingston,1223,3,17,7,12,68,49,19,58
Brechin,1223,4,17,5,14,47,48,-1,56
Stranraer,1223,5,15,7,14,54,46,8,52
Peterhead,1223,6,15,6,15,56,53,3,51
East Fife,1223,7,14,8,14,49,46,3,50
Albion,1223,8,12,8,16,55,61,-6,44
Queen's Park,1223,9,11,6,19,25,55,-30,39
Stenhousem'r,1223,10,7,8,21,45,82,-37,29
Airdrieon,1224,1,18,10,8,60,48,12,64
Peterhead,1224,2,17,9,10,52,50,2,60
Livingston,1224,3,17,7,12,67,43,24,58
Alloa,1224,4,16,9,11,68,47,21,57
Stranraer,1224,5,14,9,13,58,54,4,51
Brechin,1224,6,13,9,14,49,54,-5,48
Queen's Park,1224,7,12,9,15,33,51,-18,45
East Fife,1224,8,10,14,12,50,46,4,44
Albion,1224,9,9,16,11,50,51,-1,43
Stenhousem'r,1224,10,3,10,23,34,77,-43,19
Alloa,1225,1,19,11,6,70,38,32,68
Livingston,1225,2,19,4,13,73,52,21,61
Airdrieon,1225,3,17,5,14,66,64,2,56
Brechin,1225,4,15,8,13,46,51,-5,53
Peterhead,1225,5,15,7,14,50,52,-2,52
Albion,1225,6,14,9,13,52,48,4,51
East Fife,1225,7,13,11,12,50,40,10,50
Stranraer,1225,8,15,3,18,58,61,-3,48
Queen's Park,1225,9,8,8,20,34,59,-25,32
Stenhousem'r,1225,10,8,8,20,43,77,-34,32
Brechin,1226,1,21,5,10,56,33,23,68
Livingston,1226,2,20,7,9,79,45,34,67
Alloa,1226,3,17,10,9,67,41,26,61
Peterhead,1226,4,17,6,13,57,57,0,57
Albion,1226,5,15,11,10,48,45,3,56
Stranraer,1226,6,13,8,15,50,58,-8,47
Queen's Park,1226,7,11,7,18,34,56,-22,40
Airdrieon,1226,8,11,6,19,57,73,-16,39
East Fife,1226,9,9,10,17,39,47,-8,37
Stenhousem'r,1226,10,8,6,22,43,75,-32,30
Livingston,1227,1,22,4,10,85,52,33,70
Alloa,1227,2,20,7,9,67,42,25,67
Airdrieon,1227,3,20,6,10,66,48,18,66
Brechin,1227,4,15,6,15,45,48,-3,51
Albion,1227,5,13,10,13,63,58,5,49
Peterhead,1227,6,14,7,15,45,50,-5,49
Stranraer,1227,7,13,7,16,49,54,-5,46
East Fife,1227,8,9,12,15,43,50,-7,39
Queen's Park,1227,9,11,6,19,33,56,-23,39
Stenhousem'r,1227,10,7,7,22,45,83,-38,28
Livingston,1228,1,22,5,9,80,46,34,71
Alloa,1228,2,18,9,9,71,43,28,63
Stranraer,1228,3,17,6,13,61,56,5,57
Peterhead,1228,4,17,6,13,59,54,5,57
Albion,1228,5,15,7,14,62,54,8,52
Airdrieon,1228,6,15,5,16,59,63,-4,50
Brechin,1228,7,14,4,18,52,57,-5,46
East Fife,1228,8,12,9,15,46,52,-6,45
Stenhousem'r,1228,9,8,9,19,45,81,-36,33
Queen's Park,1228,10,7,10,19,33,62,-29,31
Airdrieon,1229,1,18,9,9,61,45,16,63
Livingston,1229,2,18,7,11,64,48,16,61
Peterhead,1229,3,17,7,12,56,52,4,58
Alloa,1229,4,16,9,11,64,47,17,57
Brechin,1229,5,15,9,12,52,44,8,54
Queen's Park,1229,6,14,6,16,37,45,-8,48
East Fife,1229,7,11,8,17,44,51,-7,41
Stranraer,1229,8,10,11,15,42,52,-10,41
Stenhousem'r,1229,9,10,9,17,46,67,-21,39
Albion,1229,10,9,9,18,41,56,-15,36
Livingston,1230,1,19,5,12,79,58,21,62
Alloa,1230,2,17,9,10,74,46,28,60
Peterhead,1230,3,16,6,14,50,47,3,54
Brechin,1230,4,15,9,12,49,49,0,54
Stranraer,1230,5,15,8,13,54,51,3,53
Airdrieon,1230,6,14,9,13,55,54,1,51
Queen's Park,1230,7,15,5,16,34,48,-14,50
East Fife,1230,8,12,10,14,43,49,-6,46
Albion,1230,9,11,7,18,47,56,-9,40
Stenhousem'r,1230,10,7,10,19,43,70,-27,31
Alloa,1231,1,22,5,9,81,43,38,71
Livingston,1231,2,19,5,12,73,47,26,62
Brechin,1231,3,16,7,13,60,63,-3,55
Airdrieon,1231,4,15,9,12,60,55,5,54
Albion,1231,5,14,8,14,49,57,-8,50
Queen's Park,1231,6,14,7,15,46,49,-3,49
East Fife,1231,7,12,10,14,51,48,3,46
Peterhead,1231,8,12,10,14,45,58,-13,46
Stranraer,1231,9,10,6,20,45,63,-18,36
Stenhousem'r,1231,10,8,9,19,47,74,-27,33
Livingston,1232,1,24,4,8,87,57,30,76
Alloa,1232,2,19,6,11,74,48,26,63
Peterhead,1232,3,17,8,11,61,49,12,59
Brechin,1232,4,17,8,11,55,46,9,59
Albion,1232,5,14,9,13,62,53,9,51
Airdrieon,1232,6,14,9,13,52,57,-5,51
East Fife,1232,7,11,10,15,54,47,7,43
Queen's Park,1232,8,12,7,17,31,56,-25,43
Stranraer,1232,9,9,6,21,44,67,-23,33
Stenhousem'r,1232,10,6,7,23,45,85,-40,25
Livingston,1233,1,22,2,12,80,52,28,68
Alloa,1233,2,18,8,10,63,42,21,62
Brechin,1233,3,20,2,14,61,56,5,62
Airdrieon,1233,4,19,3,14,66,57,9,60
Queen's Park,1233,5,14,8,14,39,44,-5,50
Peterhead,1233,6,12,12,12,52,51,1,48
Albion,1233,7,13,8,15,48,54,-6,47
East Fife,1233,8,12,8,16,43,45,-2,44
Stranraer,1233,9,12,3,21,46,61,-15,39
Stenhousem'r,1233,10,8,6,22,41,77,-36,30
Peterhead,1234,1,17,9,10,59,53,6,60
Livingston,1234,2,18,4,14,72,51,21,58
Alloa,1234,3,16,8,12,64,52,12,56
Brechin,1234,4,16,6,14,46,48,-2,54
Stranraer,1234,5,15,8,13,49,48,1,53
East Fife,1234,6,15,7,14,55,45,10,52
Albion,1234,7,14,10,12,58,56,2,52
Airdrieon,1234,8,14,9,13,55,55,0,51
Queen's Park,1234,9,10,7,19,39,59,-20,37
Stenhousem'r,1234,10,8,6,22,45,75,-30,30
Airdrieon,1235,1,19,6,11,60,49,11,63
Alloa,1235,2,19,5,12,67,44,23,62
Livingston,1235,3,18,4,14,63,45,18,58
Peterhead,1235,4,15,9,12,50,50,0,54
Brechin,1235,5,15,7,14,44,50,-6,52
Albion,1235,6,14,6,16,63,58,5,48
Queen's Park,1235,7,13,8,15,39,54,-15,47
East Fife,1235,8,12,8,16,53,48,5,44
Stranraer,1235,9,11,8,17,49,62,-13,41
Stenhousem'r,1235,10,8,11,17,46,74,-28,35
Livingston,1236,1,21,3,12,67,42,25,66
Alloa,1236,2,17,9,10,64,40,24,60
Stranraer,1236,3,17,5,14,58,56,2,56
Brechin,1236,4,16,7,13,42,46,-4,55
Airdrieon,1236,5,15,9,12,61,65,-4,54
Peterhead,1236,6,14,9,13,58,54,4,51
Albion,1236,7,11,13,12,61,58,3,46
Queen's Park,1236,8,12,9,15,42,49,-7,45
East Fife,1236,9,11,8,17,50,55,-5,41
Stenhousem'r,1236,10,5,10,21,38,76,-38,25
Alloa,1237,1,22,5,9,81,42,39,71
Livingston,1237,2,21,4,11,64,43,21,67
Airdrieon,1237,3,18,5,13,59,51,8,59
Brechin,1237,4,17,5,14,50,51,-1,56
Albion,1237,5,15,8,13,67,52,15,53
Queen's Park,1237,6,12,11,13,38,48,-10,47
East Fife,1237,7,10,12,14,41,44,-3,42
Peterhead,1237,8,12,5,19,31,49,-18,41
Stenhousem'r,1237,9,8,12,16,47,72,-25,36
Stranraer,1237,10,10,3,23,44,70,-26,33
Livingston,1238,1,23,4,9,84,43,41,73
Alloa,1238,2,16,12,8,66,51,15,60
Albion,1238,3,17,8,11,57,42,15,59
Airdrieon,1238,4,17,8,11,60,54,6,59
East Fife,1238,5,15,8,13,51,45,6,53
Brechin,1238,6,15,7,14,46,48,-2,52
Stranraer,1238,7,12,7,17,46,55,-9,43
Peterhead,1238,8,11,8,17,41,55,-14,41
Queen's Park,1238,9,10,6,20,32,52,-20,36
Stenhousem'r,1238,10,6,8,22,45,83,-38,26
Livingston,1239,1,20,8,8,79,53,26,68
Brechin,1239,2,18,8,10,55,44,11,62
Alloa,1239,3,15,13,8,63,45,18,58
Airdrieon,1239,4,15,8,13,59,55,4,53
Albion,1239,5,14,8,14,60,54,6,50
Peterhead,1239,6,13,9,14,54,55,-1,48
Queen's Park,1239,7,13,6,17,35,47,-12,45
East Fife,1239,8,11,9,16,53,57,-4,42
Stenhousem'r,1239,9,10,7,19,59,87,-28,37
Stranraer,1239,10,10,6,20,41,61,-20,36
Livingston,1240,1,23,6,7,73,40,33,75
East Fife,1240,2,17,8,11,59,42,17,59
Alloa,1240,3,15,11,10,66,50,16,56
Albion,1240,4,16,8,12,52,41,11,56
Brechin,1240,5,15,8,13,50,49,1,53
Airdrieon,1240,6,13,8,15,56,61,-5,47
Queen's Park,1240,7,13,7,16,46,58,-12,46
Peterhead,1240,8,11,11,14,41,50,-9,44
Stranraer,1240,9,10,7,19,41,64,-23,37
Stenhousem'r,1240,10,7,6,23,53,82,-29,27
Alloa,1241,1,18,8,10,68,38,30,62
Livingston,1241,2,20,2,14,74,52,22,62
Albion,1241,3,17,3,16,58,51,7,54
Brechin,1241,4,15,9,12,55,54,1,54
Airdrieon,1241,5,15,8,13,52,52,0,53
East Fife,1241,6,13,10,13,47,46,1,49
Stranraer,1241,7,14,6,16,53,62,-9,48
Peterhead,1241,8,12,8,16,42,52,-10,44
Queen's Park,1241,9,13,5,18,36,52,-16,44
Stenhousem'r,1241,10,10,7,19,49,75,-26,37
Alloa,1242,1,19,9,8,71,41,30,66
Livingston,1242,2,16,9,11,59,44,15,57
Airdrieon,1242,3,15,9,12,58,53,5,54
Brechin,1242,4,15,9,12,46,41,5,54
East Fife,1242,5,13,10,13,50,46,4,49
Albion,1242,6,14,7,15,51,57,-6,49
Stranraer,1242,7,14,6,16,50,61,-11,48
Queen's Park,1242,8,13,6,17,42,47,-5,45
Peterhead,1242,9,11,8,17,42,56,-14,41
Stenhousem'r,1242,10,9,9,18,49,72,-23,36
Livingston,1243,1,22,5,9,81,46,35,71
Alloa,1243,2,22,5,9,69,38,31,71
Brechin,1243,3,20,6,10,52,37,15,66
Airdrieon,1243,4,17,7,12,57,53,4,58
Stranraer,1243,5,15,7,14,46,46,0,52
Queen's Park,1243,6,12,8,16,43,54,-11,44
Albion,1243,7,11,9,16,49,57,-8,42
Peterhead,1243,8,10,9,17,39,60,-21,39
East Fife,1243,9,7,12,17,40,49,-9,33
Stenhousem'r,1243,10,4,12,20,40,76,-36,24
Livingston,1244,1,23,4,9,79,44,35,73
Alloa,1244,2,19,11,6,71,44,27,68
Peterhead,1244,3,17,7,12,66,54,12,58
Albion,1244,4,16,8,12,58,47,11,56
Airdrieon,1244,5,16,4,16,67,68,-1,52
Brechin,1244,6,13,8,15,43,53,-10,47
Stranraer,1244,7,13,5,18,52,63,-11,44
East Fife,1244,8,11,8,17,46,54,-8,41
Queen's Park,1244,9,9,9,18,40,62,-22,36
Stenhousem'r,1244,10,7,8,21,48,81,-33,29
Alloa,1245,1,19,9,8,69,43,26,66
Livingston,1245,2,20,4,12,72,42,30,64
Brechin,1245,3,18,8,10,59,53,6,62
Airdrieon,1245,4,17,7,12,64,56,8,58
Peterhead,1245,5,13,10,13,53,60,-7,49
Albion,1245,6,11,14,11,60,53,7,47
Queen's Park,1245,7,13,7,16,46,54,-8,46
Stranraer,1245,8,10,8,18,49,58,-9,38
East Fife,1245,9,8,12,16,42,60,-18,36
Stenhousem'r,1245,10,7,9,20,46,81,-35,30
Alloa,1246,1,18,11,7,69,39,30,65
Livingston,1246,2,20,2,14,80,52,28,62
Brechin,1246,3,18,5,13,50,44,6,59
Albion,1246,4,16,7,13,56,55,1,55
Airdrieon,1246,5,15,7,14,65,62,3,52
Stranraer,1246,6,14,4,18,53,69,-16,46
East Fife,1246,7,13,6,17,42,47,-5,45
Peterhead,1246,8,13,6,17,52,59,-7,45
Stenhousem'r,1246,9,11,7,18,58,77,-19,40
Queen's Park,1246,10,10,9,17,33,54,-21,39
Brechin,1247,1,19,7,10,66,49,17,64
Livingston,1247,2,18,8,10,74,50,24,62
Alloa,1247,3,18,7,11,69,44,25,61
Airdrieon,1247,4,17,7,12,58,54,4,58
Peterhead,1247,5,18,4,14,48,47,1,58
Stranraer,1247,6,16,3,17,51,61,-10,51
Albion,1247,7,13,8,15,57,51,6,47
East Fife,1247,8,11,10,15,55,49,6,43
Queen's Park,1247,9,6,12,18,33,61,-28,30
Stenhousem'r,1247,10,7,8,21,42,87,-45,29
Alloa,1248,1,22,5,9,80,39,41,71
Airdrieon,1248,2,21,6,9,64,46,18,69
Livingston,1248,3,19,4,13,73,55,18,61
Brechin,1248,4,18,7,11,59,50,9,61
East Fife,1248,5,16,9,11,56,45,11,57
Stranraer,1248,6,12,6,18,49,59,-10,42
Peterhead,1248,7,11,7,18,42,63,-21,40
Queen's Park,1248,8,10,8,18,32,52,-20,38
Albion,1248,9,10,7,19,47,60,-13,37
Stenhousem'r,1248,10,9,5,22,46,79,-33,32
Livingston,1249,1,22,4,10,75,44,31,70
Alloa,1249,2,20,6,10,80,49,31,66
Brechin,1249,3,17,7,12,53,43,10,58
Albion,1249,4,15,11,10,62,47,15,56
Peterhead,1249,5,17,5,14,54,60,-6,56
Stranraer,1249,6,16,3,17,57,57,0,51
Airdrieon,1249,7,14,7,15,47,51,-4,49
Queen's Park,1249,8,9,9,18,34,64,-30,36
East Fife,1249,9,9,8,19,46,58,-12,35
Stenhousem'r,1249,10,8,6,22,51,86,-35,30
Alloa,1250,1,20,7,9,70,42,28,67
Livingston,1250,2,20,2,14,75,52,23,62
Airdrieon,1250,3,17,7,12,65,53,12,58
Brechin,1250,4,18,4,14,53,48,5,58
Albion,1250,5,16,6,14,53,50,3,54
Stranraer,1250,6,16,5,15,54,59,-5,53
Queen's Park,1250,7,14,4,18,44,55,-11,46
Peterhead,1250,8,13,6,17,43,54,-11,45
East Fife,1250,9,10,6,20,41,59,-18,36
Stenhousem'r,1250,10,9,7,20,47,73,-26,34
Alloa,1251,1,22,7,7,76,42,34,73
Livingston,1251,2,20,4,12,76,47,29,64
Brechin,1251,3,18,4,14,51,46,5,58
East Fife,1251,4,16,7,13,53,41,12,55
Albion,1251,5,15,7,14,54,55,-1,52
Airdrieon,1251,6,14,7,15,56,62,-6,49
Peterhead,1251,7,13,7,16,47,62,-15,46
Queen's Park,1251,8,12,5,19,41,61,-20,41
Stranraer,1251,9,10,9,17,39,54,-15,39
Stenhousem'r,1251,10,8,7,21,51,74,-23,31
Brechin,1252,1,19,9,8,62,45,17,66
Alloa,1252,2,20,5,11,68,46,22,65
Livingston,1252,3,19,7,10,78,49,29,64
Airdrieon,1252,4,18,8,10,58,50,8,62
Peterhead,1252,5,16,6,14,57,54,3,54
East Fife,1252,6,12,11,13,53,50,3,47
Albion,1252,7,12,8,16,57,57,0,44
Stranraer,1252,8,11,8,17,48,64,-16,41
Queen's Park,1252,9,9,10,17,34,56,-22,37
Stenhousem'r,1252,10,4,8,24,38,82,-44,20
Livingston,1253,1,21,2,13,71,54,17,65
Alloa,1253,2,18,8,10,79,55,24,62
Airdrieon,1253,3,17,5,14,57,57,0,56
Peterhead,1253,4,16,5,15,53,57,-4,53
Brechin,1253,5,16,3,17,53,53,0,51
Albion,1253,6,14,9,13,47,47,0,51
Stranraer,1253,7,14,8,14,55,52,3,50
Queen's Park,1253,8,14,5,17,35,49,-14,47
East Fife,1253,9,12,10,14,53,43,10,46
Stenhousem'r,1253,10,7,7,22,47,83,-36,28
Livingston,1254,1,22,5,9,76,47,29,71
Albion,1254,2,18,7,11,58,44,14,61
Alloa,1254,3,16,9,11,64,47,17,57
Airdrieon,1254,4,17,5,14,49,46,3,56
Brechin,1254,5,16,6,14,60,55,5,54
East Fife,1254,6,13,10,13,57,53,4,49
Stranraer,1254,7,14,7,15,50,51,-1,49
Peterhead,1254,8,14,7,15,43,48,-5,49
Queen's Park,1254,9,13,3,20,31,52,-21,42
Stenhousem'r,1254,10,4,7,25,43,88,-45,19
Alloa,1255,1,18,7,11,72,47,25,61
Livingston,1255,2,18,7,11,67,46,21,61
Brechin,1255,3,17,5,14,51,47,4,56
Airdrieon,1255,4,16,8,12,55,56,-1,56
Albion,1255,5,16,7,13,61,54,7,55
Stranraer,1255,6,16,5,15,59,57,2,53
Peterhead,1255,7,14,7,15,52,59,-7,49
East Fife,1255,8,13,7,16,48,43,5,46
Queen's Park,1255,9,13,7,16,37,49,-12,46
Stenhousem'r,1255,10,6,6,24,45,89,-44,24
Livingston,1256,1,20,5,11,73,47,26,65
Airdrieon,1256,2,19,6,11,63,57,6,63
Brechin,1256,3,19,3,14,56,47,9,60
Albion,1256,4,16,8,12,51,50,1,56
Peterhead,1256,5,13,11,12,56,55,1,50
Alloa,1256,6,13,10,13,68,58,10,49
Queen's Park,1256,7,14,5,17,33,42,-9,47
East Fife,1256,8,12,9,15,53,53,0,45
Stranraer,1256,9,12,5,19,46,60,-14,41
Stenhousem'r,1256,10,7,8,21,42,72,-30,29
Alloa,1257,1,21,6,9,70,43,27,69
Livingston,1257,2,21,5,10,81,50,31,68
Brechin,1257,3,20,5,11,61,47,14,65
Airdrieon,1257,4,19,4,13,63,56,7,61
Peterhead,1257,5,14,9,13,54,59,-5,51
Albion,1257,6,13,7,16,56,54,2,46
Stranraer,1257,7,14,4,18,50,56,-6,46
Queen's Park,1257,8,13,7,16,38,51,-13,46
East Fife,1257,9,9,5,22,45,62,-17,32
Stenhousem'r,1257,10,6,8,22,41,81,-40,26
Queen's Park,1258,1,17,10,9,47,45,2,61
Airdrieon,1258,2,18,6,12,62,57,5,60
Brechin,1258,3,18,5,13,60,49,11,59
Alloa,1258,4,16,9,11,67,46,21,57
Livingston,1258,5,17,5,14,72,52,20,56
Peterhead,1258,6,13,8,15,44,58,-14,47
Stranraer,1258,7,13,7,16,52,49,3,46
East Fife,1258,8,11,10,15,47,48,-1,43
Albion,1258,9,11,10,15,48,58,-10,43
Stenhousem'r,1258,10,6,10,20,38,75,-37,28
Livingston,1259,1,21,5,10,83,54,29,68
Alloa,1259,2,17,10,9,71,45,26,61
Airdrieon,1259,3,17,8,11,68,51,17,59
Brechin,1259,4,15,9,12,48,46,2,54
Peterhead,1259,5,14,9,13,55,50,5,51
Stranraer,1259,6,13,7,16,53,59,-6,46
Albion,1259,7,12,7,17,54,65,-11,43
Stenhousem'r,1259,8,12,7,17,45,83,-38,43
Queen's Park,1259,9,12,5,19,33,48,-15,41
East Fife,1259,10,8,11,17,35,44,-9,35
Livingston,1260,1,25,3,8,84,45,39,78
Alloa,1260,2,18,7,11,72,46,26,61
Airdrieon,1260,3,19,4,13,58,59,-1,61
Peterhead,1260,4,16,7,13,61,56,5,55
Albion,1260,5,14,9,13,48,53,-5,51
East Fife,1260,6,11,11,14,48,45,3,44
Stranraer,1260,7,13,5,18,54,56,-2,44
Brechin,1260,8,13,2,21,39,57,-18,41
Queen's Park,1260,9,11,6,19,36,55,-19,39
Stenhousem'r,1260,10,10,6,20,43,71,-28,36
Livingston,1261,1,18,10,8,65,38,27,64
Alloa,1261,2,17,8,11,80,59,21,59
Brechin,1261,3,16,6,14,49,48,1,54
Airdrieon,1261,4,15,7,14,47,47,0,52
Queen's Park,1261,5,15,7,14,38,48,-10,52
Stenhousem'r,1261,6,14,8,14,55,63,-8,50
Peterhead,1261,7,12,9,15,46,52,-6,45
Albion,1261,8,11,9,16,51,62,-11,42
East Fife,1261,9,9,14,13,52,52,0,41
Stranraer,1261,10,9,10,17,42,56,-14,37
Livingston,1262,1,22,6,8,90,51,39,72
Alloa,1262,2,19,8,9,69,49,20,65
Brechin,1262,3,17,6,13,48,43,5,57
Airdrieon,1262,4,16,9,11,54,52,2,57
Peterhead,1262,5,15,5,16,41,41,0,50
East Fife,1262,6,12,9,15,48,49,-1,45
Stranraer,1262,7,14,3,19,58,66,-8,45
Albion,1262,8,13,5,18,55,56,-1,44
Stenhousem'r,1262,9,9,9,18,41,74,-33,36
Queen's Park,1262,10,9,8,19,32,55,-23,35
Livingston,1263,1,20,6,10,82,53,29,66
Alloa,1263,2,19,7,10,72,43,29,64
Airdrieon,1263,3,19,7,10,61,48,13,64
Brechin,1263,4,16,7,13,52,47,5,55
Peterhead,1263,5,14,9,13,47,52,-5,51
Stranraer,1263,6,14,6,16,47,59,-12,48
Albion,1263,7,12,7,17,49,55,-6,43
Queen's Park,1263,8,10,12,14,37,50,-13,42
East Fife,1263,9,9,10,17,50,58,-8,37
Stenhousem'r,1263,10,7,9,20,51,83,-32,30
Brechin,1264,1,22,3,11,62,47,15,69
Alloa,1264,2,19,9,8,63,39,24,66
Livingston,1264,3,17,6,13,70,54,16,57
Stranraer,1264,4,16,4,16,62,61,1,52
Peterhead,1264,5,15,7,14,46,50,-4,52
Queen's Park,1264,6,14,9,13,50,50,0,51
East Fife,1264,7,13,8,15,58,55,3,47
Airdrieon,1264,8,14,4,18,63,64,-1,46
Albion,1264,9,13,6,17,47,54,-7,45
Stenhousem'r,1264,10,6,6,24,37,84,-47,24
Alloa,1265,1,21,7,8,68,41,27,70
Livingston,1265,2,22,4,10,83,57,26,70
Airdrieon,1265,3,20,6,10,67,54,13,66
Albion,1265,4,17,7,12,52,37,15,58
Brechin,1265,5,14,9,13,43,49,-6,51
Peterhead,1265,6,13,7,16,47,57,-10,46
Queen's Park,1265,7,13,6,17,36,44,-8,45
Stenhousem'r,1265,8,10,9,17,51,70,-19,39
East Fife,1265,9,9,9,18,46,55,-9,36
Stranraer,1265,10,6,6,24,39,68,-29,24
Livingston,1266,1,24,3,9,86,49,37,75
Airdrieon,1266,2,20,5,11,65,56,9,65
Alloa,1266,3,18,6,12,60,43,17,60
Albion,1266,4,15,8,13,59,48,11,53
Brechin,1266,5,16,5,15,52,44,8,53
East Fife,1266,6,15,8,13,51,48,3,53
Peterhead,1266,7,13,6,17,54,64,-10,45
Queen's Park,1266,8,12,8,16,40,56,-16,44
Stranraer,1266,9,10,5,21,43,70,-27,35
Stenhousem'r,1266,10,5,10,21,47,79,-32,25
Livingston,1267,1,22,6,8,80,46,34,72
Alloa,1267,2,18,8,10,62,47,15,62
East Fife,1267,3,17,8,11,61,41,20,59
Queen's Park,1267,4,16,6,14,47,46,1,54
Brechin,1267,5,15,8,13,55,56,-1,53
Albion,1267,6,15,6,15,63,51,12,51
Peterhead,1267,7,14,8,14,49,61,-12,50
Airdrieon,1267,8,13,5,18,57,63,-6,44
Stranraer,1267,9,12,4,20,53,68,-15,40
Stenhousem'r,1267,10,5,7,24,42,90,-48,22
Livingston,1268,1,22,4,10,83,47,36,70
Alloa,1268,2,21,4,11,77,45,32,67
Peterhead,1268,3,17,6,13,50,49,1,57
Albion,1268,4,16,8,12,72,56,16,56
Brechin,1268,5,16,5,15,54,59,-5,53
Airdrieon,1268,6,15,8,13,48,56,-8,53
Stranraer,1268,7,14,5,17,56,56,0,47
Queen's Park,1268,8,14,3,19,44,58,-14,45
East Fife,1268,9,12,8,16,53,58,-5,44
Stenhousem'r,1268,10,5,5,26,46,99,-53,20
Livingston,1269,1,22,8,6,85,45,40,74
Airdrieon,1269,2,20,5,11,71,56,15,65
Alloa,1269,3,18,10,8,74,42,32,64
Brechin,1269,4,16,7,13,55,54,1,55
Albion,1269,5,15,6,15,59,57,2,51
Queen's Park,1269,6,13,8,15,42,53,-11,47
Peterhead,1269,7,12,7,17,48,61,-13,43
Stenhousem'r,1269,8,9,8,19,49,76,-27,35
East Fife,1269,9,7,13,16,48,59,-11,34
Stranraer,1269,10,10,4,22,49,77,-28,34
Livingston,1270,1,23,3,10,77,45,32,72
Airdrieon,1270,2,20,6,10,61,48,13,66
Albion,1270,3,18,8,10,57,47,10,62
Alloa,1270,4,17,9,10,56,37,19,60
Brechin,1270,5,18,4,14,61,51,10,58
Stranraer,1270,6,14,6,16,53,57,-4,48
East Fife,1270,7,12,9,15,61,51,10,45
Queen's Park,1270,8,12,6,18,34,47,-13,42
Peterhead,1270,9,9,7,20,46,67,-21,34
Stenhousem'r,1270,10,5,6,25,39,95,-56,21
Airdrieon,1271,1,20,7,9,59,46,13,67
Livingston,1271,2,19,7,10,75,50,25,64
Peterhead,1271,3,16,8,12,57,46,11,56
Alloa,1271,4,14,9,13,64,52,12,51
Brechin,1271,5,14,9,13,47,48,-1,51
Albion,1271,6,13,10,13,58,52,6,49
Queen's Park,1271,7,14,7,15,44,55,-11,49
East Fife,1271,8,13,8,15,50,46,4,47
Stranraer,1271,9,13,6,17,50,64,-14,45
Stenhousem'r,1271,10,4,9,23,44,89,-45,21
Alloa,1272,1,20,6,10,72,46,26,66
Livingston,1272,2,19,7,10,76,42,34,64
Brechin,1272,3,19,6,11,56,40,16,63
Albion,1272,4,16,9,11,56,49,7,57
Peterhead,1272,5,15,7,14,56,57,-1,52
Airdrieon,1272,6,14,6,16,58,63,-5,48
Queen's Park,1272,7,10,10,16,40,60,-20,40
Stranraer,1272,8,12,4,20,46,67,-21,40
East Fife,1272,9,9,10,17,50,59,-9,37
Stenhousem'r,1272,10,9,9,18,49,76,-27,36
Livingston,1273,1,20,4,12,75,52,23,64
Alloa,1273,2,18,10,8,73,52,21,64
Airdrieon,1273,3,19,6,11,65,51,14,63
Brechin,1273,4,17,8,11,53,49,4,59
East Fife,1273,5,13,8,15,58,53,5,47
Queen's Park,1273,6,14,5,17,42,52,-10,47
Stenhousem'r,1273,7,14,5,17,59,86,-27,47
Peterhead,1273,8,12,8,16,56,62,-6,44
Albion,1273,9,9,11,16,58,62,-4,38
Stranraer,1273,10,8,7,21,45,65,-20,31
Alloa,1274,1,19,7,10,63,48,15,64
Peterhead,1274,2,18,7,11,62,49,13,61
Livingston,1274,3,18,6,12,71,49,22,60
Albion,1274,4,15,10,11,59,49,10,55
East Fife,1274,5,15,9,12,54,42,12,54
Airdrieon,1274,6,15,7,14,55,61,-6,52
Stranraer,1274,7,15,1,20,48,59,-11,46
Queen's Park,1274,8,12,7,17,45,50,-5,43
Brechin,1274,9,12,6,18,38,50,-12,42
Stenhousem'r,1274,10,7,8,21,42,80,-38,29
Alloa,1275,1,22,8,6,82,39,43,74
Brechin,1275,2,20,4,12,63,44,19,64
Airdrieon,1275,3,18,7,11,55,50,5,61
Livingston,1275,4,19,2,15,67,57,10,59
Peterhead,1275,5,13,9,14,51,52,-1,48
East Fife,1275,6,11,12,13,52,48,4,45
Stranraer,1275,7,12,6,18,46,62,-16,42
Queen's Park,1275,8,11,6,19,36,57,-21,39
Albion,1275,9,10,8,18,46,60,-14,38
Stenhousem'r,1275,10,9,8,19,49,78,-29,35
Livingston,1276,1,22,5,9,75,39,36,71
Airdrieon,1276,2,18,7,11,63,50,13,61
Alloa,1276,3,15,12,9,72,44,28,57
Brechin,1276,4,16,7,13,53,51,2,55
Albion,1276,5,13,9,14,50,55,-5,48
Peterhead,1276,6,12,9,15,43,55,-12,45
East Fife,1276,7,11,11,14,44,47,-3,44
Queen's Park,1276,8,12,7,17,34,48,-14,43
Stenhousem'r,1276,9,9,10,17,54,81,-27,37
Stranraer,1276,10,9,9,18,45,63,-18,36
Alloa,1277,1,24,5,7,75,35,40,77
Livingston,1277,2,21,8,7,79,43,36,71
Albion,1277,3,17,7,12,57,47,10,58
Airdrieon,1277,4,17,4,15,61,65,-4,55
East Fife,1277,5,14,8,14,54,47,7,50
Brechin,1277,6,15,5,16,41,45,-4,50
Peterhead,1277,7,14,6,16,46,55,-9,48
Queen's Park,1277,8,13,7,16,40,49,-9,46
Stranraer,1277,9,11,4,21,45,64,-19,37
Stenhousem'r,1277,10,5,4,27,38,86,-48,19
Livingston,1278,1,21,4,11,78,49,29,67
Alloa,1278,2,19,6,11,69,46,23,63
Airdrieon,1278,3,19,5,12,64,53,11,62
Peterhead,1278,4,15,8,13,49,46,3,53
Brechin,1278,5,15,6,15,47,50,-3,51
Stranraer,1278,6,14,7,15,54,60,-6,49
East Fife,1278,7,13,7,16,49,47,2,46
Albion,1278,8,12,7,17,49,58,-9,43
Queen's Park,1278,9,12,5,19,40,62,-22,41
Stenhousem'r,1278,10,8,9,19,58,86,-28,33
Livingston,1279,1,20,2,14,65,47,18,62
Airdrieon,1279,2,18,8,10,58,40,18,62
Brechin,1279,3,19,5,12,54,45,9,62
Peterhead,1279,4,18,7,11,55,41,14,61
Alloa,1279,5,17,7,12,71,50,21,58
Queen's Park,1279,6,12,9,15,32,50,-18,45
Stranraer,1279,7,12,4,20,48,58,-10,40
Albion,1279,8,10,10,16,47,59,-12,40
Stenhousem'r,1279,9,11,6,19,51,80,-29,39
East Fife,1279,10,9,10,17,35,46,-11,37
Livingston,1280,1,22,7,7,70,37,33,73
Brechin,1280,2,21,4,11,57,38,19,67
Airdrieon,1280,3,20,6,10,60,42,18,66
Alloa,1280,4,17,7,12,67,48,19,58
East Fife,1280,5,13,7,16,45,50,-5,46
Queen's Park,1280,6,12,7,17,39,51,-12,43
Albion,1280,7,11,9,16,51,61,-10,42
Peterhead,1280,8,11,9,16,42,53,-11,42
Stranraer,1280,9,11,7,18,49,62,-13,40
Stenhousem'r,1280,10,6,9,21,43,81,-38,27
Airdrieon,1281,1,21,7,8,64,51,13,70
Brechin,1281,2,21,4,11,58,42,16,67
Livingston,1281,3,20,5,11,79,48,31,65
Alloa,1281,4,16,11,9,73,54,19,59
East Fife,1281,5,13,9,14,50,48,2,48
Queen's Park,1281,6,13,7,16,42,46,-4,46
Peterhead,1281,7,11,12,13,46,46,0,45
Stranraer,1281,8,11,9,16,51,53,-2,42
Albion,1281,9,9,10,17,40,62,-22,37
Stenhousem'r,1281,10,5,6,25,30,83,-53,21
Livingston,1282,1,22,6,8,81,48,33,72
Alloa,1282,2,17,8,11,66,51,15,59
Brechin,1282,3,17,6,13,48,49,-1,57
Albion,1282,4,14,8,14,61,56,5,50
Peterhead,1282,5,13,9,14,49,50,-1,48
Queen's Park,1282,6,13,6,17,47,57,-10,45
Stranraer,1282,7,12,8,16,47,53,-6,44
Airdrieon,1282,8,12,7,17,54,59,-5,43
East Fife,1282,9,9,14,13,47,52,-5,41
Stenhousem'r,1282,10,11,8,17,51,76,-25,41
Livingston,1283,1,20,5,11,77,43,34,65
Alloa,1283,2,16,8,12,64,49,15,56
Brechin,1283,3,17,5,14,48,48,0,56
Albion,1283,4,15,10,11,57,49,8,55
Airdrieon,1283,5,15,8,13,52,58,-6,53
East Fife,1283,6,13,8,15,51,47,4,47
Stranraer,1283,7,15,2,19,54,59,-5,47
Peterhead,1283,8,12,10,14,38,45,-7,46
Queen's Park,1283,9,12,7,17,41,58,-17,43
Stenhousem'r,1283,10,9,9,18,42,68,-26,36
Livingston,1284,1,20,4,12,81,55,26,64
Brechin,1284,2,18,7,11,59,44,15,61
Alloa,1284,3,18,6,12,72,49,23,60
Stranraer,1284,4,17,7,12,68,57,11,58
Airdrieon,1284,5,17,6,13,59,57,2,57
East Fife,1284,6,12,10,14,50,47,3,46
Peterhead,1284,7,12,8,16,50,57,-7,44
Albion,1284,8,11,9,16,53,65,-12,42
Queen's Park,1284,9,11,9,16,31,49,-18,42
Stenhousem'r,1284,10,7,8,21,42,85,-43,29
Livingston,1285,1,23,4,9,86,46,40,73
Alloa,1285,2,19,8,9,67,47,20,65
Airdrieon,1285,3,20,4,12,62,54,8,64
Albion,1285,4,16,9,11,57,49,8,57
Brechin,1285,5,16,6,14,51,45,6,54
Queen's Park,1285,6,16,6,14,46,43,3,54
Stranraer,1285,7,13,4,19,53,58,-5,43
Peterhead,1285,8,11,9,16,47,62,-15,42
Stenhousem'r,1285,9,8,5,23,58,95,-37,29
East Fife,1285,10,7,7,22,40,68,-28,28
Livingston,1286,1,20,6,10,76,46,30,66
Alloa,1286,2,20,6,10,62,41,21,66
Peterhead,1286,3,18,9,9,60,47,13,63
Brechin,1286,4,17,6,13,58,48,10,57
Airdrieon,1286,5,15,11,10,55,52,3,56
Albion,1286,6,13,7,16,52,56,-4,46
Stranraer,1286,7,10,9,17,38,57,-19,39
East Fife,1286,8,9,10,17,40,48,-8,37
Queen's Park,1286,9,10,7,19,41,56,-15,37
Stenhousem'r,1286,10,9,7,20,36,67,-31,34
Alloa,1287,1,18,10,8,63,39,24,64
Livingston,1287,2,19,6,11,72,43,29,63
Albion,1287,3,17,7,12,62,52,10,58
Airdrieon,1287,4,15,12,9,57,47,10,57
Brechin,1287,5,17,5,14,52,52,0,56
Peterhead,1287,6,13,6,17,47,57,-10,45
Stranraer,1287,7,12,7,17,53,55,-2,43
East Fife,1287,8,9,12,15,42,47,-5,39
Stenhousem'r,1287,9,9,11,16,51,75,-24,38
Queen's Park,1287,10,9,8,19,35,67,-32,35
Livingston,1288,1,24,5,7,84,44,40,77
Alloa,1288,2,18,10,8,80,47,33,64
Brechin,1288,3,18,5,13,47,43,4,59
Airdrieon,1288,4,18,4,14,57,51,6,58
Peterhead,1288,5,14,8,14,52,53,-1,50
Stranraer,1288,6,13,4,19,51,61,-10,43
Queen's Park,1288,7,11,8,17,41,59,-18,41
East Fife,1288,8,8,14,14,39,43,-4,38
Albion,1288,9,10,7,19,42,63,-21,37
Stenhousem'r,1288,10,9,9,18,51,80,-29,36
Alloa,1289,1,23,6,7,80,45,35,75
Livingston,1289,2,21,5,10,74,44,30,68
Airdrieon,1289,3,17,7,12,47,48,-1,58
Albion,1289,4,17,5,14,61,57,4,56
Peterhead,1289,5,16,7,13,50,51,-1,55
East Fife,1289,6,15,9,12,51,40,11,54
Queen's Park,1289,7,14,4,18,49,51,-2,46
Brechin,1289,8,14,4,18,45,53,-8,46
Stranraer,1289,9,6,8,22,41,72,-31,26
Stenhousem'r,1289,10,7,5,24,43,80,-37,26
Alloa,1290,1,18,11,7,74,40,34,65
Airdrieon,1290,2,19,5,12,67,60,7,62
Queen's Park,1290,3,16,8,12,42,40,2,56
Livingston,1290,4,15,8,13,67,47,20,53
Peterhead,1290,5,14,9,13,49,49,0,51
East Fife,1290,6,13,10,13,46,46,0,49
Brechin,1290,7,11,13,12,45,47,-2,46
Albion,1290,8,10,13,13,43,47,-4,43
Stranraer,1290,9,11,5,20,47,67,-20,38
Stenhousem'r,1290,10,8,8,20,44,81,-37,32
Livingston,1291,1,22,2,12,78,49,29,68
Brechin,1291,2,19,6,11,60,49,11,63
Alloa,1291,3,18,8,10,80,45,35,62
Airdrieon,1291,4,18,7,11,58,52,6,61
Albion,1291,5,17,9,10,63,47,16,60
Peterhead,1291,6,13,10,13,44,50,-6,49
East Fife,1291,7,9,17,10,47,45,2,44
Stranraer,1291,8,10,10,16,48,60,-12,40
Queen's Park,1291,9,8,6,22,37,68,-31,30
Stenhousem'r,1291,10,5,7,24,45,95,-50,22
Alloa,1292,1,21,8,7,72,45,27,71
Livingston,1292,2,21,6,9,79,38,41,69
Airdrieon,1292,3,18,7,11,58,52,6,61
Brechin,1292,4,17,9,10,52,40,12,60
Peterhead,1292,5,14,9,13,48,51,-3,51
Albion,1292,6,13,7,16,50,56,-6,46
Queen's Park,1292,7,13,6,17,38,49,-11,45
East Fife,1292,8,12,5,19,47,51,-4,41
Stranraer,1292,9,8,7,21,42,67,-25,31
Stenhousem'r,1292,10,8,6,22,47,84,-37,30
Livingston,1293,1,22,4,10,78,44,34,70
Alloa,1293,2,20,7,9,73,46,27,67
Airdrieon,1293,3,19,8,9,58,47,11,65
Peterhead,1293,4,14,8,14,55,49,6,50
Albion,1293,5,14,8,14,60,64,-4,50
Brechin,1293,6,13,8,15,48,48,0,47
Stranraer,1293,7,12,8,16,48,57,-9,44
Queen's Park,1293,8,11,9,16,40,58,-18,42
East Fife,1293,9,9,11,16,50,53,-3,38
Stenhousem'r,1293,10,7,7,22,38,82,-44,28
Alloa,1294,1,20,8,8,81,42,39,68
Albion,1294,2,18,9,9,56,48,8,63
Brechin,1294,3,19,5,12,51,48,3,62
Livingston,1294,4,17,6,13,67,50,17,57
Airdrieon,1294,5,16,7,13,56,55,1,55
East Fife,1294,6,13,9,14,54,43,11,48
Peterhead,1294,7,11,11,14,42,49,-7,44
Queen's Park,1294,8,9,10,17,40,63,-23,37
Stranraer,1294,9,9,9,18,50,67,-17,36
Stenhousem'r,1294,10,8,6,22,42,74,-32,30
Livingston,1295,1,22,4,10,80,50,30,70
Alloa,1295,2,21,6,9,76,48,28,69
Airdrieon,1295,3,18,8,10,65,54,11,62
Brechin,1295,4,18,5,13,60,51,9,59
Stranraer,1295,5,13,4,19,52,54,-2,43
Albion,1295,6,11,10,15,56,70,-14,43
East Fife,1295,7,11,9,16,55,52,3,42
Stenhousem'r,1295,8,11,8,17,56,88,-32,41
Queen's Park,1295,9,11,6,19,39,55,-16,39
Peterhead,1295,10,10,8,18,35,52,-17,38
Alloa,1296,1,20,8,8,76,43,33,68
Peterhead,1296,2,16,9,11,52,53,-1,57
Brechin,1296,3,16,7,13,46,44,2,55
Airdrieon,1296,4,16,6,14,66,53,13,54
Albion,1296,5,15,7,14,48,49,-1,52
Livingston,1296,6,15,5,16,62,53,9,50
Stranraer,1296,7,12,9,15,43,53,-10,45
Queen's Park,1296,8,12,7,17,36,51,-15,43
Stenhousem'r,1296,9,10,9,17,55,81,-26,39
East Fife,1296,10,9,11,16,44,48,-4,38
Livingston,1297,1,23,5,8,74,46,28,74
Alloa,1297,2,20,7,9,68,46,22,67
Airdrieon,1297,3,18,6,12,52,48,4,60
Brechin,1297,4,16,6,14,47,49,-2,54
East Fife,1297,5,13,10,13,53,42,11,49
Albion,1297,6,13,10,13,47,48,-1,49
Stranraer,1297,7,14,6,16,56,52,4,48
Peterhead,1297,8,9,7,20,41,56,-15,34
Stenhousem'r,1297,9,8,10,18,44,69,-25,34
Queen's Park,1297,10,8,9,19,22,48,-26,33
Livingston,1298,1,25,2,9,87,46,41,77
Airdrieon,1298,2,20,4,12,75,61,14,64
Brechin,1298,3,16,5,15,53,49,4,53
Alloa,1298,4,15,7,14,71,57,14,52
Albion,1298,5,14,8,14,49,49,0,50
Peterhead,1298,6,13,9,14,47,56,-9,48
East Fife,1298,7,12,10,14,55,54,1,46
Stranraer,1298,8,12,5,19,58,75,-17,41
Queen's Park,1298,9,11,6,19,38,62,-24,39
Stenhousem'r,1298,10,10,8,18,44,68,-24,38
Alloa,1299,1,20,5,11,76,42,34,65
Livingston,1299,2,20,3,13,71,51,20,63
Airdrieon,1299,3,18,6,12,58,52,6,60
Peterhead,1299,4,15,7,14,52,60,-8,52
Queen's Park,1299,5,15,7,14,42,50,-8,52
Brechin,1299,6,14,7,15,46,49,-3,49
Stranraer,1299,7,15,4,17,49,53,-4,49
Stenhousem'r,1299,8,14,5,17,58,73,-15,47
East Fife,1299,9,11,6,19,46,59,-13,39
Albion,1299,10,10,6,20,51,60,-9,36
Livingston,1300,1,18,7,11,78,62,16,61
Albion,1300,2,18,5,13,67,48,19,59
Peterhead,1300,3,15,8,13,53,50,3,53
Queen's Park,1300,4,15,8,13,41,46,-5,53
Alloa,1300,5,14,10,12,59,44,15,52
Airdrieon,1300,6,14,8,14,58,60,-2,50
Brechin,1300,7,15,4,17,50,56,-6,49
Stranraer,1300,8,14,6,16,63,60,3,48
East Fife,1300,9,10,13,13,54,56,-2,43
Stenhousem'r,1300,10,10,5,21,48,89,-41,35
Livingston,1301,1,24,2,10,80,48,32,74
Alloa,1301,2,19,9,8,69,41,28,66
Airdrieon,1301,3,19,5,12,56,42,14,62
Peterhead,1301,4,15,8,13,48,47,1,53
Brechin,1301,5,15,5,16,46,55,-9,50
East Fife,1301,6,12,10,14,49,44,5,46
Albion,1301,7,13,7,16,57,56,1,46
Stranraer,1301,8,12,5,19,48,61,-13,41
Queen's Park,1301,9,12,4,20,39,60,-21,40
Stenhousem'r,1301,10,7,9,20,47,85,-38,30
Albion,1302,1,19,6,11,64,53,11,63
Alloa,1302,2,17,9,10,72,51,21,60
Airdrieon,1302,3,17,8,11,61,52,9,59
Livingston,1302,4,16,7,13,67,53,14,55
Brechin,1302,5,13,11,12,45,42,3,50
East Fife,1302,6,13,10,13,51,50,1,49
Peterhead,1302,7,12,10,14,57,58,-1,46
Stranraer,1302,8,11,7,18,52,65,-13,40
Queen's Park,1302,9,9,11,16,31,53,-22,38
Stenhousem'r,1302,10,10,7,19,47,70,-23,37
Livingston,1303,1,24,2,10,74,41,33,74
Alloa,1303,2,20,7,9,75,44,31,67
Albion,1303,3,16,9,11,59,48,11,57
Airdrieon,1303,4,17,5,14,62,55,7,56
Peterhead,1303,5,17,5,14,49,42,7,56
Brechin,1303,6,14,7,15,40,50,-10,49
East Fife,1303,7,13,5,18,50,56,-6,44
Stranraer,1303,8,13,5,18,48,54,-6,44
Queen's Park,1303,9,9,9,18,30,63,-33,36
Stenhousem'r,1303,10,6,8,22,43,77,-34,26
Livingston,1304,1,23,3,10,72,42,30,72
Alloa,1304,2,19,6,11,68,49,19,63
Airdrieon,1304,3,18,7,11,58,51,7,61
Albion,1304,4,16,8,12,53,39,14,56
Brechin,1304,5,14,10,12,43,42,1,52
Peterhead,1304,6,13,6,17,50,55,-5,45
Stranraer,1304,7,12,8,16,51,55,-4,44
East Fife,1304,8,12,7,17,48,59,-11,43
Queen's Park,1304,9,8,12,16,24,43,-19,36
Stenhousem'r,1304,10,8,7,21,44,76,-32,31
Alloa,1305,1,25,5,6,80,44,36,80
Livingston,1305,2,21,3,12,74,39,35,66
Airdrieon,1305,3,20,4,12,60,50,10,64
Brechin,1305,4,19,5,12,50,42,8,62
Peterhead,1305,5,18,5,13,56,53,3,59
Albion,1305,6,13,7,16,48,55,-7,46
East Fife,1305,7,11,9,16,44,48,-4,42
Stranraer,1305,8,8,8,20,37,58,-21,32
Queen's Park,1305,9,8,7,21,30,53,-23,31
Stenhousem'r,1305,10,6,9,21,38,75,-37,27
Airdrieon,1306,1,20,7,9,63,50,13,67
Alloa,1306,2,18,9,9,73,46,27,63
Livingston,1306,3,18,9,9,69,44,25,63
Brechin,1306,4,18,5,13,43,41,2,59
Albion,1306,5,11,10,15,54,57,-3,43
Peterhead,1306,6,11,10,15,45,52,-7,43
East Fife,1306,7,10,12,14,46,49,-3,42
Stranraer,1306,8,12,6,18,47,57,-10,42
Queen's Park,1306,9,10,9,17,32,51,-19,39
Stenhousem'r,1306,10,10,7,19,47,72,-25,37
Alloa,1307,1,20,7,9,74,49,25,67
Livingston,1307,2,21,4,11,76,55,21,67
Airdrieon,1307,3,18,4,14,64,57,7,58
Brechin,1307,4,17,6,13,54,54,0,57
Queen's Park,1307,5,16,5,15,43,52,-9,53
Peterhead,1307,6,15,7,14,57,62,-5,52
Albion,1307,7,14,4,18,56,60,-4,46
Stranraer,1307,8,12,4,20,57,65,-8,40
East Fife,1307,9,10,8,18,59,60,-1,38
Stenhousem'r,1307,10,10,5,21,47,73,-26,35
Livingston,1308,1,22,5,9,82,48,34,71
Alloa,1308,2,18,7,11,62,40,22,61
Brechin,1308,3,19,4,13,52,54,-2,61
Albion,1308,4,15,9,12,64,53,11,54
Airdrieon,1308,5,15,8,13,55,59,-4,53
Peterhead,1308,6,13,7,16,46,57,-11,46
East Fife,1308,7,10,14,12,47,44,3,44
Stranraer,1308,8,12,6,18,54,64,-10,42
Queen's Park,1308,9,9,9,18,27,48,-21,36
Stenhousem'r,1308,10,7,11,18,49,71,-22,32
Livingston,1309,1,25,3,8,91,47,44,78
Peterhead,1309,2,18,4,14,54,51,3,58
Albion,1309,3,16,8,12,61,48,13,56
Brechin,1309,4,16,7,13,49,48,1,55
Airdrieon,1309,5,14,11,11,62,62,0,53
Stranraer,1309,6,13,12,11,53,49,4,51
Alloa,1309,7,13,9,14,59,50,9,48
Queen's Park,1309,8,10,8,18,29,50,-21,38
East Fife,1309,9,8,12,16,44,49,-5,36
Stenhousem'r,1309,10,5,10,21,40,88,-48,25
Livingston,1310,1,19,10,7,71,52,19,67
Brechin,1310,2,20,6,10,53,37,16,66
Alloa,1310,3,18,7,11,71,49,22,61
Airdrieon,1310,4,16,7,13,58,57,1,55
Albion,1310,5,16,6,14,51,48,3,54
East Fife,1310,6,12,9,15,42,40,2,45
Stranraer,1310,7,13,6,17,43,50,-7,45
Peterhead,1310,8,9,11,16,50,63,-13,38
Stenhousem'r,1310,9,8,11,17,42,66,-24,35
Queen's Park,1310,10,8,9,19,33,52,-19,33
Alloa,1311,1,21,7,8,75,42,33,70
Livingston,1311,2,19,7,10,66,46,20,64
Airdrieon,1311,3,20,4,12,62,50,12,64
Brechin,1311,4,19,6,11,60,45,15,63
Peterhead,1311,5,15,6,15,52,58,-6,51
Albion,1311,6,14,8,14,54,50,4,50
Queen's Park,1311,7,13,4,19,39,55,-16,43
Stranraer,1311,8,13,2,21,46,65,-19,41
East Fife,1311,9,9,8,19,46,56,-10,35
Stenhousem'r,1311,10,6,10,20,42,75,-33,28
Livingston,1312,1,24,2,10,84,48,36,74
Alloa,1312,2,20,7,9,72,46,26,67
Peterhead,1312,3,18,7,11,58,43,15,61
Brechin,1312,4,19,4,13,56,46,10,61
East Fife,1312,5,15,7,14,63,46,17,52
Airdrieon,1312,6,15,4,17,59,60,-1,49
Albion,1312,7,13,9,14,53,55,-2,48
Queen's Park,1312,8,14,6,16,45,50,-5,48
Stranraer,1312,9,9,6,21,44,73,-29,33
Stenhousem'r,1312,10,4,6,26,28,95,-67,18
Livingston,1313,1,21,1,14,76,53,23,64
Brechin,1313,2,18,8,10,52,45,7,62
Alloa,1313,3,16,7,13,67,50,17,55
Albion,1313,4,15,8,13,59,49,10,53
Airdrieon,1313,5,14,9,13,58,62,-4,51
Queen's Park,1313,6,13,9,14,38,44,-6,48
East Fife,1313,7,11,14,11,48,46,2,47
Peterhead,1313,8,10,11,15,49,57,-8,41
Stranraer,1313,9,10,11,15,45,61,-16,41
Stenhousem'r,1313,10,9,8,19,51,76,-25,35
Alloa,1314,1,19,7,10,66,43,23,64
Brechin,1314,2,18,7,11,59,42,17,61
Airdrieon,1314,3,18,7,11,61,54,7,61
Livingston,1314,4,17,5,14,70,53,17,56
Queen's Park,1314,5,15,4,17,37,56,-19,49
East Fife,1314,6,12,12,12,47,42,5,48
Stranraer,1314,7,13,6,17,51,58,-7,45
Albion,1314,8,12,7,17,53,54,-1,43
Peterhead,1314,9,12,7,17,47,60,-13,43
Stenhousem'r,1314,10,10,6,20,44,73,-29,36
Livingston,1315,1,25,3,8,81,47,34,78
Alloa,1315,2,18,8,10,71,43,28,62
Peterhead,1315,3,17,10,9,56,50,6,61
Albion,1315,4,16,8,12,49,46,3,56
Airdrieon,1315,5,14,5,17,53,62,-9,47
Brechin,1315,6,13,7,16,50,54,-4,46
Stranraer,1315,7,13,6,17,52,59,-7,45
East Fife,1315,8,12,8,16,53,52,1,44
Queen's Park,1315,9,10,8,18,40,56,-16,38
Stenhousem'r,1315,10,7,7,22,48,84,-36,28
Livingston,1316,1,22,5,9,88,50,38,71
Alloa,1316,2,19,9,8,74,47,27,66
Airdrieon,1316,3,17,9,10,65,58,7,60
Brechin,1316,4,19,2,15,59,46,13,59
Stranraer,1316,5,14,7,15,56,55,1,49
Queen's Park,1316,6,13,6,17,37,51,-14,45
Albion,1316,7,11,9,16,50,58,-8,42
East Fife,1316,8,11,8,17,49,58,-9,41
Peterhead,1316,9,11,5,20,52,73,-21,38
Stenhousem'r,1316,10,10,6,20,53,87,-34,36
Airdrieon,1317,1,21,6,9,64,41,23,69
Alloa,1317,2,18,8,10,69,46,23,62
Brechin,1317,3,19,5,12,55,48,7,62
Livingston,1317,4,19,2,15,75,60,15,59
Peterhead,1317,5,16,8,12,56,56,0,56
East Fife,1317,6,15,8,13,49,49,0,53
Queen's Park,1317,7,14,9,13,44,46,-2,51
Albion,1317,8,10,6,20,44,52,-8,36
Stranraer,1317,9,9,5,22,52,69,-17,32
Stenhousem'r,1317,10,6,9,21,51,92,-41,27
Alloa,1318,1,23,5,8,85,47,38,74
Livingston,1318,2,22,3,11,75,49,26,69
Peterhead,1318,3,15,7,14,60,53,7,52
Brechin,1318,4,14,10,12,53,58,-5,52
Airdrieon,1318,5,14,7,15,60,62,-2,49
Stranraer,1318,6,15,3,18,58,55,3,48
Albion,1318,7,12,7,17,53,54,-1,43
Queen's Park,1318,8,11,10,15,43,53,-10,43
East Fife,1318,9,11,8,17,53,68,-15,41
Stenhousem'r,1318,10,9,8,19,44,85,-41,35
Alloa,1319,1,22,6,8,75,47,28,72
Livingston,1319,2,19,6,11,77,50,27,63
Brechin,1319,3,16,8,12,53,52,1,56
Airdrieon,1319,4,15,9,12,61,55,6,54
Albion,1319,5,15,6,15,55,55,0,51
Peterhead,1319,6,13,10,13,51,54,-3,49
Queen's Park,1319,7,13,8,15,42,49,-7,47
Stranraer,1319,8,12,7,17,47,58,-11,43
East Fife,1319,9,11,8,17,46,51,-5,41
Stenhousem'r,1319,10,6,8,22,46,82,-36,26
Alloa,1320,1,21,8,7,75,41,34,71
Livingston,1320,2,20,4,12,72,41,31,64
Brechin,1320,3,17,11,8,55,42,13,62
Queen's Park,1320,4,15,6,15,37,43,-6,51
Peterhead,1320,5,14,8,14,61,60,1,50
Albion,1320,6,14,7,15,45,55,-10,49
Stranraer,1320,7,14,4,18,55,58,-3,46
Airdrieon,1320,8,12,9,15,48,55,-7,45
Stenhousem'r,1320,9,8,9,19,39,74,-35,33
East Fife,1320,10,8,8,20,39,57,-18,32
Alloa,1321,1,22,8,6,84,44,40,74
Airdrieon,1321,2,19,5,12,57,53,4,62
Livingston,1321,3,18,6,12,78,55,23,60
Brechin,1321,4,17,6,13,57,51,6,57
Queen's Park,1321,5,15,5,16,40,48,-8,50
Stranraer,1321,6,14,5,17,59,68,-9,47
East Fife,1321,7,12,10,14,57,54,3,46
Peterhead,1321,8,12,9,15,51,57,-6,45
Albion,1321,9,10,11,15,45,51,-6,41
Stenhousem'r,1321,10,6,5,25,38,85,-47,23
Livingston,1322,1,22,4,10,83,43,40,70
Brechin,1322,2,17,8,11,52,44,8,59
Airdrieon,1322,3,16,8,12,59,54,5,56
Alloa,1322,4,14,13,9,70,49,21,55
East Fife,1322,5,15,8,13,57,48,9,53
Albion,1322,6,13,8,15,50,56,-6,47
Peterhead,1322,7,12,8,16,44,56,-12,44
Queen's Park,1322,8,11,10,15,39,61,-22,43
Stranraer,1322,9,10,8,18,48,64,-16,38
Stenhousem'r,1322,10,8,9,19,50,77,-27,33
Livingston,1323,1,20,3,13,70,53,17,63
Brechin,1323,2,19,5,12,56,46,10,62
Albion,1323,3,18,5,13,54,48,6,59
Peterhead,1323,4,17,7,12,60,53,7,58
Alloa,1323,5,16,7,13,64,48,16,55
Stranraer,1323,6,15,4,17,53,56,-3,49
Queen's Park,1323,7,14,6,16,43,57,-14,48
Airdrieon,1323,8,14,5,17,49,54,-5,47
East Fife,1323,9,12,10,14,44,42,2,46
Stenhousem'r,1323,10,6,6,24,45,81,-36,24
Alloa,1324,1,23,5,8,81,37,44,74
Livingston,1324,2,21,3,12,77,50,27,66
Albion,1324,3,17,9,10,58,43,15,60
Airdrieon,1324,4,16,5,15,63,64,-1,53
Peterhead,1324,5,14,7,15,53,67,-14,49
Brechin,1324,6,14,5,17,46,61,-15,47
Stranraer,1324,7,11,9,16,52,60,-8,42
Queen's Park,1324,8,12,6,18,31,50,-19,42
East Fife,1324,9,10,10,16,50,55,-5,40
Stenhousem'r,1324,10,10,5,21,51,75,-24,35
Livingston,1325,1,23,4,9,69,40,29,73
Alloa,1325,2,20,6,10,67,40,27,66
Airdrieon,1325,3,17,6,13,63,53,10,57
Brechin,1325,4,16,6,14,53,47,6,54
Peterhead,1325,5,14,6,16,39,49,-10,48
Albion,1325,6,13,8,15,44,50,-6,47
Queen's Park,1325,7,12,10,14,37,45,-8,46
East Fife,1325,8,12,9,15,50,49,1,45
Stranraer,1325,9,10,6,20,50,66,-16,36
Stenhousem'r,1325,10,9,7,20,49,82,-33,34
Alloa,1326,1,20,10,6,62,31,31,70
Livingston,1326,2,18,5,13,73,52,21,59
Airdrieon,1326,3,17,7,12,55,51,4,58
Peterhead,1326,4,14,12,10,62,53,9,54
Brechin,1326,5,17,3,16,51,62,-11,54
East Fife,1326,6,14,9,13,54,44,10,51
Queen's Park,1326,7,12,11,13,47,53,-6,47
Albion,1326,8,11,10,15,44,52,-8,43
Stranraer,1326,9,11,6,19,49,62,-13,39
Stenhousem'r,1326,10,5,9,22,45,82,-37,24
Livingston,1327,1,22,3,11,80,50,30,69
Alloa,1327,2,19,9,8,76,49,27,66
Brechin,1327,3,17,5,14,53,50,3,56
Airdrieon,1327,4,16,5,15,55,65,-10,53
Albion,1327,5,15,5,16,61,56,5,50
Peterhead,1327,6,13,11,12,49,46,3,50
Stranraer,1327,7,13,6,17,46,50,-4,45
Stenhousem'r,1327,8,11,7,18,42,63,-21,40
Queen's Park,1327,9,10,9,17,28,44,-16,39
East Fife,1327,10,9,10,17,41,58,-17,37
Livingston,1328,1,22,4,10,79,49,30,70
Alloa,1328,2,21,6,9,80,46,34,69
Brechin,1328,3,17,8,11,54,39,15,59
Airdrieon,1328,4,17,4,15,54,57,-3,55
Queen's Park,1328,5,15,6,15,43,51,-8,51
Peterhead,1328,6,14,8,14,60,54,6,50
Albion,1328,7,14,5,17,49,53,-4,47
East Fife,1328,8,11,9,16,48,48,0,42
Stranraer,1328,9,13,3,20,47,58,-11,42
Stenhousem'r,1328,10,6,7,23,42,101,-59,25
Alloa,1329,1,25,3,8,84,44,40,78
Livingston,1329,2,22,6,8,75,47,28,72
East Fife,1329,3,17,8,11,56,41,15,59
Airdrieon,1329,4,16,6,14,49,51,-2,54
Brechin,1329,5,14,6,16,53,55,-2,48
Albion,1329,6,11,8,17,53,57,-4,41
Stranraer,1329,7,12,5,19,49,63,-14,41
Peterhead,1329,8,11,7,18,45,54,-9,40
Queen's Park,1329,9,9,11,16,33,51,-18,38
Stenhousem'r,1329,10,11,4,21,44,78,-34,37
Alloa,1330,1,24,6,6,77,34,43,78
Livingston,1330,2,23,4,9,80,43,37,73
Peterhead,1330,3,15,8,13,48,48,0,53
Airdrieon,1330,4,13,7,16,51,50,1,46
Albion,1330,5,13,7,16,59,60,-1,46
Brechin,1330,6,13,7,16,44,56,-12,46
Stranraer,1330,7,14,4,18,44,64,-20,46
East Fife,1330,8,11,10,15,45,45,0,43
Queen's Park,1330,9,11,9,16,40,54,-14,42
Stenhousem'r,1330,10,8,8,20,52,86,-34,32
Airdrieon,1331,1,18,8,10,72,52,20,62
Alloa,1331,2,17,8,11,64,47,17,59
Peterhead,1331,3,17,6,13,63,48,15,57
Livingston,1331,4,18,3,15,70,58,12,57
East Fife,1331,5,15,9,12,49,41,8,54
Brechin,1331,6,15,8,13,43,44,-1,53
Queen's Park,1331,7,15,6,15,35,46,-11,51
Albion,1331,8,12,12,12,48,49,-1,48
Stranraer,1331,9,11,3,22,46,65,-19,36
Stenhousem'r,1331,10,7,7,22,46,86,-40,28
Livingston,1332,1,19,3,14,72,52,20,60
Alloa,1332,2,16,11,9,70,46,24,59
Airdrieon,1332,3,17,8,11,64,53,11,59
Peterhead,1332,4,14,10,12,48,43,5,52
East Fife,1332,5,14,9,13,50,44,6,51
Queen's Park,1332,6,15,6,15,42,49,-7,51
Albion,1332,7,14,8,14,60,56,4,50
Brechin,1332,8,14,6,16,44,57,-13,48
Stenhousem'r,1332,9,10,8,18,41,70,-29,38
Stranraer,1332,10,8,9,19,43,64,-21,33
Livingston,1333,1,23,5,8,77,38,39,74
Airdrieon,1333,2,17,9,10,50,48,2,60
Alloa,1333,3,17,8,11,61,49,12,59
Queen's Park,1333,4,16,5,15,42,42,0,53
Peterhead,1333,5,14,10,12,52,48,4,52
Albion,1333,6,12,14,10,56,50,6,50
Stranraer,1333,7,13,7,16,52,55,-3,46
Brechin,1333,8,13,5,18,38,50,-12,44
East Fife,1333,9,8,11,17,38,50,-12,35
Stenhousem'r,1333,10,7,6,23,45,81,-36,27
Albion,1334,1,19,6,11,68,57,11,63
Livingston,1334,2,19,5,12,73,48,25,62
Brechin,1334,3,18,6,12,41,40,1,60
Alloa,1334,4,15,11,10,63,41,22,56
Airdrieon,1334,5,16,7,13,51,59,-8,55
Stranraer,1334,6,12,10,14,53,54,-1,46
Peterhead,1334,7,11,13,12,45,49,-4,46
East Fife,1334,8,11,8,17,49,49,0,41
Stenhousem'r,1334,9,11,8,17,51,70,-19,41
Queen's Park,1334,10,8,6,22,32,59,-27,30
Alloa,1335,1,23,6,7,74,38,36,75
Livingston,1335,2,22,7,7,73,41,32,73
Albion,1335,3,17,9,10,58,38,20,60
Peterhead,1335,4,15,8,13,45,50,-5,53
Airdrieon,1335,5,14,6,16,60,63,-3,48
Brechin,1335,6,13,6,17,43,53,-10,45
Stranraer,1335,7,12,6,18,53,63,-10,42
Queen's Park,1335,8,12,5,19,41,62,-21,41
East Fife,1335,9,11,7,18,42,49,-7,40
Stenhousem'r,1335,10,6,10,20,43,75,-32,28
Alloa,1336,1,18,9,9,79,49,30,63
Livingston,1336,2,18,5,13,76,61,15,59
Peterhead,1336,3,16,8,12,59,54,5,56
East Fife,1336,4,15,10,11,57,38,19,55
Brechin,1336,5,15,9,12,60,55,5,54
Airdrieon,1336,6,15,6,15,61,56,5,51
Stenhousem'r,1336,7,10,14,12,47,68,-21,44
Albion,1336,8,11,9,16,45,58,-13,42
Queen's Park,1336,9,10,8,18,32,60,-28,38
Stranraer,1336,10,8,10,18,45,62,-17,34
Livingston,1337,1,22,2,12,70,45,25,68
Brechin,1337,2,20,6,10,61,42,19,66
Alloa,1337,3,19,8,9,68,40,28,65
Airdrieon,1337,4,17,10,9,59,53,6,61
Albion,1337,5,16,6,14,61,54,7,54
Peterhead,1337,6,11,10,15,49,57,-8,43
Queen's Park,1337,7,11,6,19,49,68,-19,39
East Fife,1337,8,10,8,18,48,60,-12,38
Stranraer,1337,9,9,10,17,42,63,-21,37
Stenhousem'r,1337,10,8,8,20,44,69,-25,32
Alloa,1338,1,21,7,8,69,42,27,70
Livingston,1338,2,21,6,9,78,43,35,69
Airdrieon,1338,3,21,4,11,70,49,21,67
Brechin,1338,4,16,8,12,49,42,7,56
Albion,1338,5,14,9,13,56,55,1,51
Stranraer,1338,6,15,6,15,58,64,-6,51
East Fife,1338,7,9,10,17,42,46,-4,37
Peterhead,1338,8,9,10,17,48,72,-24,37
Queen's Park,1338,9,9,9,18,36,56,-20,36
Stenhousem'r,1338,10,5,11,20,45,82,-37,26
Alloa,1339,1,21,6,9,80,46,34,69
Livingston,1339,2,20,5,11,74,61,13,65
Airdrieon,1339,3,15,13,8,70,58,12,58
Brechin,1339,4,16,7,13,53,47,6,55
East Fife,1339,5,13,10,13,55,51,4,49
Albion,1339,6,12,11,13,54,55,-1,47
Stranraer,1339,7,11,11,14,55,56,-1,44
Peterhead,1339,8,10,12,14,43,59,-16,42
Queen's Park,1339,9,10,5,21,38,56,-18,35
Stenhousem'r,1339,10,7,10,19,50,83,-33,31
Alloa,1340,1,22,3,11,82,50,32,69
Livingston,1340,2,20,6,10,80,55,25,66
Stranraer,1340,3,18,6,12,68,60,8,60
Brechin,1340,4,14,8,14,55,53,2,50
Peterhead,1340,5,15,5,16,46,46,0,50
Queen's Park,1340,6,13,10,13,46,52,-6,49
Airdrieon,1340,7,13,8,15,50,57,-7,47
East Fife,1340,8,13,7,16,53,49,4,46
Albion,1340,9,10,10,16,44,52,-8,40
Stenhousem'r,1340,10,8,5,23,45,95,-50,29
Livingston,1341,1,25,4,7,72,37,35,79
Alloa,1341,2,16,9,11,68,50,18,57
Brechin,1341,3,15,9,12,61,53,8,54
Airdrieon,1341,4,15,9,12,59,51,8,54
Queen's Park,1341,5,16,4,16,36,44,-8,52
Albion,1341,6,14,8,14,57,56,1,50
Stranraer,1341,7,14,5,17,44,49,-5,47
East Fife,1341,8,11,10,15,54,65,-11,43
Peterhead,1341,9,6,14,16,41,57,-16,32
Stenhousem'r,1341,10,8,8,20,48,78,-30,32
Livingston,1342,1,22,3,11,75,43,32,69
Alloa,1342,2,17,7,12,64,53,11,58
Peterhead,1342,3,16,6,14,61,56,5,54
Albion,1342,4,15,9,12,57,54,3,54
Queen's Park,1342,5,13,11,12,43,43,0,50
Brechin,1342,6,15,5,16,56,63,-7,50
Airdrieon,1342,7,14,7,15,54,56,-2,49
East Fife,1342,8,12,8,16,59,61,-2,44
Stranraer,1342,9,12,5,19,50,64,-14,41
Stenhousem'r,1342,10,10,7,19,51,77,-26,37
Livingston,1343,1,19,7,10,77,49,28,64
Alloa,1343,2,18,7,11,67,42,25,61
Albion,1343,3,16,9,11,54,49,5,57
Airdrieon,1343,4,16,8,12,65,58,7,56
Brechin,1343,5,16,8,12,49,46,3,56
Queen's Park,1343,6,14,9,13,45,51,-6,51
Peterhead,1343,7,14,6,16,48,53,-5,48
Stranraer,1343,8,11,8,17,48,58,-10,41
East Fife,1343,9,8,12,16,43,53,-10,36
Stenhousem'r,1343,10,8,6,22,43,80,-37,30
Livingston,1344,1,26,2,8,80,42,38,80
Alloa,1344,2,17,11,8,72,48,24,62
Airdrieon,1344,3,17,9,10,63,55,8,60
East Fife,1344,4,16,6,14,59,48,11,54
Brechin,1344,5,15,8,13,50,48,2,53
Stranraer,1344,6,14,7,15,55,56,-1,49
Peterhead,1344,7,11,9,16,43,54,-11,42
Albion,1344,8,10,9,17,46,58,-12,39
Queen's Park,1344,9,12,3,21,37,58,-21,39
Stenhousem'r,1344,10,6,8,22,49,87,-38,26
Livingston,1345,1,22,4,10,83,48,35,70
Alloa,1345,2,21,7,8,77,44,33,70
Airdrieon,1345,3,18,6,12,62,51,11,60
Stranraer,1345,4,16,6,14,56,48,8,54
Brechin,1345,5,15,4,17,55,64,-9,49
East Fife,1345,6,14,6,16,52,49,3,48
Peterhead,1345,7,11,11,14,46,62,-16,44
Albion,1345,8,11,7,18,47,59,-12,40
Queen's Park,1345,9,11,7,18,39,54,-15,40
Stenhousem'r,1345,10,8,8,20,51,89,-38,32
Livingston,1346,1,21,5,10,84,62,22,68
Brechin,1346,2,18,7,11,60,48,12,61
Airdrieon,1346,3,16,11,9,63,54,9,59
Alloa,1346,4,16,8,12,82,58,24,56
Albion,1346,5,16,6,14,51,53,-2,54
East Fife,1346,6,12,9,15,55,47,8,45
Stranraer,1346,7,13,6,17,51,60,-9,45
Queen's Park,1346,8,12,7,17,41,60,-19,43
Peterhead,1346,9,10,7,19,41,66,-25,37
Stenhousem'r,1346,10,9,8,19,59,79,-20,35
Livingston,1347,1,18,8,10,73,47,26,62
Alloa,1347,2,17,11,8,74,49,25,62
East Fife,1347,3,15,10,11,55,44,11,55
Airdrieon,1347,4,16,6,14,52,54,-2,54
Brechin,1347,5,14,8,14,47,64,-17,50
Albion,1347,6,14,7,15,63,59,4,49
Stranraer,1347,7,14,4,18,51,51,0,46
Queen's Park,1347,8,12,10,14,39,50,-11,46
Peterhead,1347,9,12,7,17,43,52,-9,43
Stenhousem'r,1347,10,9,7,20,47,74,-27,34
Livingston,1348,1,25,3,8,79,42,37,78
Alloa,1348,2,19,7,10,75,53,22,64
Brechin,1348,3,17,6,13,52,45,7,57
Queen's Park,1348,4,14,9,13,43,47,-4,51
Airdrieon,1348,5,15,5,16,60,70,-10,50
Peterhead,1348,6,14,7,15,52,60,-8,49
Albion,1348,7,14,6,16,56,49,7,48
Stranraer,1348,8,15,1,20,52,62,-10,46
East Fife,1348,9,11,8,17,46,51,-5,41
Stenhousem'r,1348,10,6,8,22,52,88,-36,26
Alloa,1349,1,22,3,11,71,45,26,69
Livingston,1349,2,19,6,11,71,47,24,63
Airdrieon,1349,3,19,6,11,72,54,18,63
Brechin,1349,4,14,10,12,48,46,2,52
Peterhead,1349,5,13,11,12,56,52,4,50
East Fife,1349,6,10,12,14,47,51,-4,42
Queen's Park,1349,7,12,6,18,34,53,-19,42
Stenhousem'r,1349,8,11,8,17,50,70,-20,41
Albion,1349,9,10,10,16,50,62,-12,40
Stranraer,1349,10,9,10,17,45,64,-19,37
Alloa,1350,1,23,6,7,75,40,35,75
Airdrieon,1350,2,20,7,9,65,45,20,67
Livingston,1350,3,20,5,11,70,46,24,65
Brechin,1350,4,15,8,13,51,48,3,53
Albion,1350,5,15,7,14,57,52,5,52
East Fife,1350,6,13,10,13,56,47,9,49
Queen's Park,1350,7,13,6,17,35,54,-19,45
Stranraer,1350,8,11,5,20,42,58,-16,38
Peterhead,1350,9,9,7,20,48,68,-20,34
Stenhousem'r,1350,10,7,7,22,48,89,-41,28
Livingston,1351,1,22,4,10,92,56,36,70
Alloa,1351,2,19,8,9,86,47,39,65
Albion,1351,3,17,8,11,57,49,8,59
Airdrieon,1351,4,16,9,11,60,51,9,57
Queen's Park,1351,5,14,6,16,41,49,-8,48
Brechin,1351,6,13,5,18,44,61,-17,44
Peterhead,1351,7,10,13,13,46,58,-12,43
Stranraer,1351,8,12,6,18,51,70,-19,42
East Fife,1351,9,11,7,18,50,55,-5,40
Stenhousem'r,1351,10,10,6,20,44,75,-31,36
Livingston,1352,1,20,5,11,78,52,26,65
Airdrieon,1352,2,19,5,12,66,50,16,62
Brechin,1352,3,19,4,13,61,55,6,61
Alloa,1352,4,17,9,10,67,44,23,60
Queen's Park,1352,5,14,7,15,39,50,-11,49
Peterhead,1352,6,13,9,14,56,58,-2,48
Albion,1352,7,13,8,15,53,60,-7,47
Stranraer,1352,8,13,4,19,62,76,-14,43
East Fife,1352,9,11,9,16,55,54,1,42
Stenhousem'r,1352,10,8,6,22,45,83,-38,30
Livingston,1353,1,20,3,13,74,55,19,63
Albion,1353,2,18,7,11,67,42,25,61
Airdrieon,1353,3,17,9,10,63,55,8,60
Alloa,1353,4,16,11,9,67,52,15,59
Queen's Park,1353,5,13,8,15,42,54,-12,47
Brechin,1353,6,13,7,16,45,48,-3,46
East Fife,1353,7,11,11,14,47,48,-1,44
Peterhead,1353,8,12,7,17,44,57,-13,43
Stenhousem'r,1353,9,11,7,18,47,72,-25,40
Stranraer,1353,10,11,6,19,50,63,-13,39
Alloa,1354,1,20,8,8,76,41,35,68
Livingston,1354,2,21,5,10,75,43,32,68
Airdrieon,1354,3,19,8,9,55,45,10,65
Albion,1354,4,13,9,14,53,51,2,48
Brechin,1354,5,12,11,13,51,52,-1,47
Peterhead,1354,6,11,10,15,48,57,-9,43
Queen's Park,1354,7,12,7,17,42,57,-15,43
Stranraer,1354,8,11,8,17,49,66,-17,41
East Fife,1354,9,10,9,17,40,52,-12,39
Stenhousem'r,1354,10,9,9,18,48,73,-25,36
Alloa,1355,1,19,8,9,68,41,27,65
Albion,1355,2,18,8,10,56,38,18,62
Peterhead,1355,3,15,10,11,61,54,7,55
Brechin,1355,4,17,4,15,48,47,1,55
Airdrieon,1355,5,15,10,11,60,60,0,55
Livingston,1355,6,16,6,14,76,59,17,54
East Fife,1355,7,15,6,15,55,54,1,51
Queen's Park,1355,8,12,7,17,41,56,-15,43
Stranraer,1355,9,10,4,22,46,63,-17,34
Stenhousem'r,1355,10,6,11,19,54,93,-39,29
Airdrieon,1356,1,19,4,13,61,51,10,61
Livingston,1356,2,17,6,13,76,56,20,57
Alloa,1356,3,16,8,12,65,46,19,56
Albion,1356,4,15,10,11,47,43,4,55
Brechin,1356,5,14,9,13,48,50,-2,51
Stranraer,1356,6,14,8,14,48,49,-1,50
Peterhead,1356,7,13,10,13,48,52,-4,49
East Fife,1356,8,11,10,15,48,54,-6,43
Stenhousem'r,1356,9,9,11,16,51,71,-20,38
Queen's Park,1356,10,10,8,18,35,55,-20,38
Livingston,1357,1,21,4,11,79,54,25,67
Brechin,1357,2,18,9,9,58,46,12,63
Airdrieon,1357,3,18,7,11,71,49,22,61
Alloa,1357,4,16,9,11,74,57,17,57
Peterhead,1357,5,15,9,12,59,59,0,54
Albion,1357,6,12,10,14,56,56,0,46
Stranraer,1357,7,12,7,17,50,60,-10,43
East Fife,1357,8,9,13,14,43,52,-9,40
Queen's Park,1357,9,10,9,17,36,58,-22,39
Stenhousem'r,1357,10,6,9,21,50,85,-35,27
Livingston,1358,1,22,5,9,86,47,39,71
Brechin,1358,2,19,9,8,62,45,17,66
Peterhead,1358,3,16,9,11,59,46,13,57
Albion,1358,4,16,7,13,65,54,11,55
Alloa,1358,5,15,7,14,67,58,9,52
Airdrieon,1358,6,15,7,14,58,62,-4,52
East Fife,1358,7,13,9,14,49,51,-2,48
Stranraer,1358,8,12,3,21,56,72,-16,39
Queen's Park,1358,9,10,9,17,29,50,-21,39
Stenhousem'r,1358,10,6,7,23,44,90,-46,25
Livingston,1359,1,22,6,8,80,44,36,72
Alloa,1359,2,21,5,10,84,51,33,68
Stranraer,1359,3,16,5,15,48,54,-6,53
Queen's Park,1359,4,14,10,12,43,45,-2,52
Peterhead,1359,5,14,8,14,55,54,1,50
Brechin,1359,6,14,6,16,44,48,-4,48
Albion,1359,7,12,10,14,47,51,-4,46
Airdrieon,1359,8,11,9,16,44,61,-17,42
Stenhousem'r,1359,9,12,6,18,50,71,-21,42
East Fife,1359,10,7,9,20,43,59,-16,30
Livingston,1360,1,23,5,8,84,41,43,74
Alloa,1360,2,17,9,10,71,48,23,60
Airdrieon,1360,3,16,10,10,60,55,5,58
Brechin,1360,4,16,8,12,56,58,-2,56
Albion,1360,5,13,9,14,57,59,-2,48
East Fife,1360,6,14,5,17,51,47,4,47
Stranraer,1360,7,12,10,14,52,55,-3,46
Peterhead,1360,8,10,7,19,42,60,-18,37
Queen's Park,1360,9,8,13,15,24,51,-27,37
Stenhousem'r,1360,10,8,10,18,48,71,-23,34
Airdrieon,1361,1,17,10,9,63,52,11,61
Brechin,1361,2,18,7,11,54,44,10,61
Albion,1361,3,17,9,10,61,45,16,60
Alloa,1361,4,17,8,11,65,46,19,59
Livingston,1361,5,17,8,11,62,49,13,59
Peterhead,1361,6,12,9,15,48,60,-12,45
Stranraer,1361,7,12,7,17,53,61,-8,43
Queen's Park,1361,8,10,8,18,39,60,-21,38
Stenhousem'r,1361,9,9,9,18,47,70,-23,36
East Fife,1361,10,8,11,17,46,51,-5,35
Livingston,1362,1,21,6,9,77,50,27,69
Alloa,1362,2,19,5,12,77,48,29,62
Airdrieon,1362,3,16,9,11,61,56,5,57
Stranraer,1362,4,16,3,17,67,64,3,51
Queen's Park,1362,5,14,5,17,37,46,-9,47
Brechin,1362,6,14,4,18,49,61,-12,46
Albion,1362,7,11,12,13,57,53,4,45
Peterhead,1362,8,11,11,14,47,61,-14,44
Stenhousem'r,1362,9,12,6,18,47,76,-29,42
East Fife,1362,10,10,11,15,49,53,-4,41
Livingston,1363,1,23,2,11,79,45,34,71
Alloa,1363,2,18,8,10,77,48,29,62
Airdrieon,1363,3,19,5,12,54,54,0,62
East Fife,1363,4,15,6,15,48,47,1,51
Brechin,1363,5,15,6,15,40,44,-4,51
Albion,1363,6,14,6,16,54,52,2,48
Queen's Park,1363,7,14,6,16,35,52,-17,48
Peterhead,1363,8,14,5,17,45,48,-3,47
Stranraer,1363,9,12,5,19,45,55,-10,41
Stenhousem'r,1363,10,8,7,21,42,74,-32,31
Alloa,1364,1,17,11,8,77,47,30,62
Brechin,1364,2,18,6,12,52,47,5,60
Airdrieon,1364,3,18,5,13,59,61,-2,59
Livingston,1364,4,18,3,15,71,50,21,57
Peterhead,1364,5,17,6,13,50,44,6,57
East Fife,1364,6,14,7,15,52,43,9,49
Stranraer,1364,7,13,9,14,48,55,-7,48
Albion,1364,8,11,9,16,43,55,-12,42
Stenhousem'r,1364,9,10,6,20,47,71,-24,36
Queen's Park,1364,10,9,8,19,32,58,-26,35
Livingston,1365,1,23,5,8,82,45,37,74
Airdrieon,1365,2,17,7,12,53,44,9,58
Alloa,1365,3,16,7,13,61,52,9,55
Albion,1365,4,16,6,14,55,52,3,54
Peterhead,1365,5,15,7,14,53,54,-1,52
Stranraer,1365,6,16,3,17,52,59,-7,51
Brechin,1365,7,14,4,18,49,56,-7,46
East Fife,1365,8,11,8,17,50,53,-3,41
Stenhousem'r,1365,9,11,7,18,48,65,-17,40
Queen's Park,1365,10,11,6,19,35,58,-23,39
Airdrieon,1366,1,19,6,11,57,48,9,63
Alloa,1366,2,17,9,10,64,45,19,60
Livingston,1366,3,17,7,12,70,57,13,58
Brechin,1366,4,16,6,14,50,48,2,54
Peterhead,1366,5,15,7,14,53,46,7,52
Albion,1366,6,14,9,13,54,52,2,51
Stranraer,1366,7,14,3,19,45,57,-12,45
East Fife,1366,8,10,13,13,54,53,1,43
Queen's Park,1366,9,12,7,17,42,55,-13,43
Stenhousem'r,1366,10,8,9,19,44,72,-28,33
Livingston,1367,1,19,6,11,66,51,15,63
Alloa,1367,2,15,11,10,68,53,15,56
Airdrieon,1367,3,16,8,12,63,50,13,56
Queen's Park,1367,4,13,11,12,47,45,2,50
Peterhead,1367,5,14,8,14,49,59,-10,50
Albion,1367,6,12,11,13,49,53,-4,47
East Fife,1367,7,12,10,14,51,52,-1,46
Brechin,1367,8,11,11,14,38,44,-6,44
Stranraer,1367,9,12,6,18,48,61,-13,42
Stenhousem'r,1367,10,10,10,16,59,70,-11,40
Alloa,1368,1,22,5,9,79,41,38,71
Livingston,1368,2,22,3,11,73,42,31,69
Airdrieon,1368,3,16,7,13,57,55,2,55
Albion,1368,4,16,6,14,50,46,4,54
Brechin,1368,5,16,6,14,46,53,-7,54
East Fife,1368,6,13,12,11,53,46,7,51
Peterhead,1368,7,13,7,16,43,52,-9,46
Stranraer,1368,8,13,5,18,51,59,-8,44
Stenhousem'r,1368,9,8,9,19,47,78,-31,33
Queen's Park,1368,10,9,4,23,36,63,-27,31
Brechin,1369,1,23,5,8,67,40,27,74
Livingston,1369,2,20,4,12,69,47,22,64
Airdrieon,1369,3,17,6,13,59,50,9,57
Albion,1369,4,15,8,13,62,50,12,53
Alloa,1369,5,15,8,13,64,55,9,53
Queen's Park,1369,6,14,9,13,43,53,-10,51
Peterhead,1369,7,13,8,15,46,50,-4,47
East Fife,1369,8,11,7,18,52,61,-9,40
Stranraer,1369,9,10,7,19,45,65,-20,37
Stenhousem'r,1369,10,7,8,21,49,85,-36,29
Livingston,1370,1,25,2,9,84,47,37,77
Alloa,1370,2,21,7,8,75,41,34,70
Brechin,1370,3,20,7,9,64,39,25,67
Airdrieon,1370,4,17,7,12,64,51,13,58
Albion,1370,5,14,9,13,53,50,3,51
Stranraer,1370,6,11,7,18,52,65,-13,40
East Fife,1370,7,10,9,17,44,47,-3,39
Peterhead,1370,8,10,8,18,38,59,-21,38
Queen's Park,1370,9,8,12,16,29,54,-25,36
Stenhousem'r,1370,10,5,10,21,40,90,-50,25
Alloa,1371,1,20,7,9,76,43,33,67
Livingston,1371,2,20,6,10,76,54,22,66
Brechin,1371,3,17,8,11,48,38,10,59
Airdrieon,1371,4,17,6,13,68,54,14,57
Albion,1371,5,14,8,14,46,49,-3,50
Stranraer,1371,6,15,2,19,51,65,-14,47
Queen's Park,1371,7,12,10,14,37,45,-8,46
East Fife,1371,8,12,7,17,53,55,-2,43
Peterhead,1371,9,11,5,20,43,63,-20,38
Stenhousem'r,1371,10,8,9,19,48,80,-32,33
Livingston,1372,1,22,4,10,79,46,33,70
Alloa,1372,2,18,11,7,67,39,28,65
Albion,1372,3,18,8,10,64,46,18,62
Airdrieon,1372,4,15,11,10,58,47,11,56
Brechin,1372,5,16,5,15,51,59,-8,53
East Fife,1372,6,12,9,15,49,51,-2,45
Stranraer,1372,7,13,5,18,56,63,-7,44
Queen's Park,1372,8,10,10,16,35,53,-18,40
Peterhead,1372,9,10,9,17,47,57,-10,39
Stenhousem'r,1372,10,7,6,23,45,90,-45,27
Livingston,1373,1,23,4,9,78,48,30,73
Alloa,1373,2,18,9,9,65,44,21,63
Airdrieon,1373,3,17,9,10,66,53,13,60
Brechin,1373,4,15,6,15,48,55,-7,51
Queen's Park,1373,5,13,9,14,37,46,-9,48
Peterhead,1373,6,11,12,13,50,54,-4,45
Stranraer,1373,7,13,6,17,50,57,-7,45
East Fife,1373,8,10,9,17,52,55,-3,39
Albion,1373,9,9,11,16,48,58,-10,38
Stenhousem'r,1373,10,8,11,17,48,72,-24,35
Livingston,1374,1,25,1,10,71,41,30,76
Alloa,1374,2,23,6,7,76,37,39,75
Brechin,1374,3,15,9,12,55,51,4,54
East Fife,1374,4,15,8,13,60,45,15,53
Queen's Park,1374,5,16,5,15,45,57,-12,53
Albion,1374,6,13,7,16,43,47,-4,46
Airdrieon,1374,7,13,6,17,47,60,-13,45
Peterhead,1374,8,10,6,20,41,55,-14,36
Stranraer,1374,9,9,7,20,44,61,-17,34
Stenhousem'r,1374,10,7,13,16,48,76,-28,34
Alloa,1375,1,22,8,6,82,38,44,74
Livingston,1375,2,21,8,7,69,37,32,71
Brechin,1375,3,16,8,12,48,45,3,56
Airdrieon,1375,4,15,10,11,56,55,1,55
Queen's Park,1375,5,12,12,12,43,52,-9,48
Albion,1375,6,13,8,15,43,54,-11,47
East Fife,1375,7,9,13,14,46,44,2,40
Stranraer,1375,8,8,13,15,40,52,-12,37
Peterhead,1375,9,8,12,16,41,56,-15,36
Stenhousem'r,1375,10,7,6,23,46,81,-35,27
Alloa,1376,1,20,11,5,66,37,29,71
Airdrieon,1376,2,20,7,9,69,54,15,67
Livingston,1376,3,20,6,10,77,47,30,66
Brechin,1376,4,16,5,15,47,56,-9,53
Albion,1376,5,13,9,14,51,53,-2,48
East Fife,1376,6,12,11,13,55,47,8,47
Peterhead,1376,7,13,6,17,48,54,-6,45
Queen's Park,1376,8,12,5,19,32,54,-22,41
Stranraer,1376,9,10,5,21,50,62,-12,35
Stenhousem'r,1376,10,8,7,21,45,76,-31,31
Livingston,1377,1,24,4,8,87,48,39,76
Alloa,1377,2,19,6,11,68,43,25,63
Airdrieon,1377,3,18,8,10,62,54,8,62
Brechin,1377,4,18,6,12,52,43,9,60
Queen's Park,1377,5,16,6,14,52,47,5,54
East Fife,1377,6,14,8,14,48,45,3,50
Stranraer,1377,7,15,2,19,47,63,-16,47
Albion,1377,8,12,6,18,50,59,-9,42
Peterhead,1377,9,11,5,20,49,67,-18,38
Stenhousem'r,1377,10,4,7,25,34,80,-46,19
Livingston,1378,1,21,5,10,74,50,24,68
Alloa,1378,2,19,9,8,67,39,28,66
Brechin,1378,3,17,5,14,59,43,16,56
Airdrieon,1378,4,15,10,11,56,47,9,55
Queen's Park,1378,5,15,8,13,40,47,-7,53
Peterhead,1378,6,13,9,14,48,59,-11,48
Stranraer,1378,7,14,5,17,49,57,-8,47
East Fife,1378,8,12,9,15,44,47,-3,45
Albion,1378,9,12,8,16,53,63,-10,44
Stenhousem'r,1378,10,5,6,25,39,77,-38,21
Airdrieon,1379,1,22,6,8,67,48,19,72
Alloa,1379,2,15,9,12,59,45,14,54
Brechin,1379,3,16,6,14,55,58,-3,54
Livingston,1379,4,15,6,15,64,52,12,51
East Fife,1379,5,14,9,13,51,46,5,51
Albion,1379,6,13,11,12,55,52,3,50
Queen's Park,1379,7,14,8,14,35,37,-2,50
Stranraer,1379,8,13,7,16,49,56,-7,46
Peterhead,1379,9,11,10,15,46,53,-7,43
Stenhousem'r,1379,10,7,8,21,50,84,-34,29
Brechin,1380,1,22,4,10,56,43,13,70
Livingston,1380,2,20,7,9,70,41,29,67
Airdrieon,1380,3,19,8,9,59,50,9,65
Alloa,1380,4,14,8,14,61,52,9,50
Albion,1380,5,13,10,13,49,46,3,49
East Fife,1380,6,12,9,15,42,43,-1,45
Stranraer,1380,7,13,5,18,47,55,-8,44
Queen's Park,1380,8,12,8,16,39,54,-15,44
Peterhead,1380,9,8,10,18,36,50,-14,34
Stenhousem'r,1380,10,7,11,18,52,77,-25,32
Alloa,1381,1,19,10,7,65,38,27,67
Livingston,1381,2,17,9,10,65,42,23,60
Airdrieon,1381,3,17,8,11,61,46,15,59
Brechin,1381,4,15,8,13,48,48,0,53
Peterhead,1381,5,14,10,12,59,60,-1,52
Albion,1381,6,14,9,13,51,48,3,51
East Fife,1381,7,14,7,15,53,51,2,49
Queen's Park,1381,8,12,9,15,42,53,-11,45
Stranraer,1381,9,10,4,22,38,61,-23,34
Stenhousem'r,1381,10,7,8,21,42,77,-35,29
Livingston,1382,1,23,5,8,84,39,45,74
Alloa,1382,2,19,7,10,66,39,27,64
Airdrieon,1382,3,17,9,10,53,46,7,60
Albion,1382,4,14,8,14,51,53,-2,50
Brechin,1382,5,14,7,15,50,48,2,49
Peterhead,1382,6,12,12,12,47,50,-3,48
East Fife,1382,7,11,11,14,46,43,3,44
Stranraer,1382,8,12,5,19,39,50,-11,41
Queen's Park,1382,9,10,8,18,31,58,-27,38
Stenhousem'r,1382,10,6,12,18,43,84,-41,30
Livingston,1383,1,25,5,6,92,42,50,80
Alloa,1383,2,18,8,10,70,43,27,62
Brechin,1383,3,18,8,10,63,53,10,62
Albion,1383,4,13,11,12,56,54,2,50
Airdrieon,1383,5,14,7,15,58,61,-3,49
Queen's Park,1383,6,14,6,16,45,63,-18,48
East Fife,1383,7,12,10,14,56,51,5,46
Stranraer,1383,8,9,9,18,43,61,-18,36
Peterhead,1383,9,8,9,19,49,72,-23,33
Stenhousem'r,1383,10,8,9,19,53,85,-32,33
Livingston,1384,1,20,4,12,77,56,21,64
Alloa,1384,2,17,12,7,78,42,36,63
Brechin,1384,3,18,4,14,50,50,0,58
Peterhead,1384,4,15,9,12,49,48,1,54
Albion,1384,5,13,13,10,64,57,7,52
Airdrieon,1384,6,15,7,14,53,54,-1,52
Stranraer,1384,7,13,9,14,50,51,-1,48
Queen's Park,1384,8,12,8,16,39,54,-15,44
East Fife,1384,9,8,11,17,48,58,-10,35
Stenhousem'r,1384,10,4,13,19,46,84,-38,25
Alloa,1385,1,21,6,9,72,44,28,69
Livingston,1385,2,19,6,11,63,46,17,63
Brechin,1385,3,17,7,12,52,44,8,58
Airdrieon,1385,4,16,8,12,60,57,3,56
Queen's Park,1385,5,15,8,13,44,45,-1,53
Albion,1385,6,15,6,15,55,51,4,51
Peterhead,1385,7,13,9,14,55,61,-6,48
Stranraer,1385,8,12,5,19,48,56,-8,41
East Fife,1385,9,10,9,17,40,50,-10,39
Stenhousem'r,1385,10,5,10,21,38,73,-35,25
Livingston,1386,1,19,7,10,66,41,25,64
Brechin,1386,2,18,9,9,61,41,20,63
Peterhead,1386,3,18,8,10,61,45,16,62
Alloa,1386,4,17,10,9,65,43,22,61
Airdrieon,1386,5,16,9,11,67,55,12,57
Stranraer,1386,6,13,9,14,55,61,-6,48
Albion,1386,7,12,9,15,51,65,-14,45
East Fife,1386,8,9,10,17,52,54,-2,37
Queen's Park,1386,9,7,9,20,27,57,-30,30
Stenhousem'r,1386,10,8,6,22,45,88,-43,30
Alloa,1387,1,20,5,11,72,46,26,65
Brechin,1387,2,19,8,9,54,36,18,65
Livingston,1387,3,17,7,12,64,44,20,58
Airdrieon,1387,4,17,5,14,53,51,2,56
Albion,1387,5,11,12,13,50,53,-3,45
Stranraer,1387,6,12,9,15,47,55,-8,45
Queen's Park,1387,7,12,8,16,40,57,-17,44
East Fife,1387,8,10,13,13,46,44,2,43
Peterhead,1387,9,10,11,15,41,53,-12,41
Stenhousem'r,1387,10,8,10,18,37,65,-28,34
Alloa,1388,1,19,10,7,65,43,22,67
Livingston,1388,2,20,4,12,75,45,30,64
Brechin,1388,3,18,4,14,48,48,0,58
Peterhead,1388,4,15,11,10,57,51,6,56
Albion,1388,5,16,7,13,53,49,4,55
East Fife,1388,6,13,10,13,50,43,7,49
Airdrieon,1388,7,13,8,15,61,63,-2,47
Stranraer,1388,8,11,9,16,48,55,-7,42
Queen's Park,1388,9,11,6,19,36,62,-26,39
Stenhousem'r,1388,10,6,7,23,43,77,-34,25
Alloa,1389,1,18,9,9,62,38,24,63
Albion,1389,2,17,6,13,64,51,13,57
Brechin,1389,3,15,11,10,43,35,8,56
Livingston,1389,4,17,4,15,74,60,14,55
Airdrieon,1389,5,16,7,13,55,56,-1,55
Peterhead,1389,6,14,10,12,51,48,3,52
Stranraer,1389,7,13,6,17,51,63,-12,45
Queen's Park,1389,8,11,11,14,36,48,-12,44
East Fife,1389,9,11,8,17,52,57,-5,41
Stenhousem'r,1389,10,8,8,20,51,83,-32,32
Alloa,1390,1,21,8,7,76,44,32,71
Livingston,1390,2,21,6,9,83,46,37,69
Peterhead,1390,3,19,6,11,58,49,9,63
Airdrieon,1390,4,18,4,14,59,54,5,58
Albion,1390,5,15,9,12,65,48,17,54
Brechin,1390,6,15,8,13,55,54,1,53
Stranraer,1390,7,10,8,18,46,65,-19,38
Queen's Park,1390,8,9,8,19,34,60,-26,35
Stenhousem'r,1390,9,8,8,20,46,86,-40,32
East Fife,1390,10,8,7,21,38,54,-16,31
Livingston,1391,1,22,4,10,86,52,34,70
Airdrieon,1391,2,19,4,13,65,52,13,61
Alloa,1391,3,17,9,10,67,46,21,60
Brechin,1391,4,17,8,11,54,43,11,59
Queen's Park,1391,5,16,7,13,40,44,-4,55
Albion,1391,6,15,7,14,57,49,8,52
East Fife,1391,7,12,6,18,47,58,-11,42
Peterhead,1391,8,11,8,17,52,57,-5,41
Stranraer,1391,9,10,9,17,49,66,-17,39
Stenhousem'r,1391,10,7,6,23,43,93,-50,27
Livingston,1392,1,23,5,8,85,43,42,74
Alloa,1392,2,16,10,10,67,44,23,58
Albion,1392,3,17,6,13,63,56,7,57
Brechin,1392,4,17,6,13,55,54,1,57
Airdrieon,1392,5,17,4,15,68,77,-9,55
Queen's Park,1392,6,15,7,14,51,55,-4,52
East Fife,1392,7,13,10,13,57,46,11,49
Peterhead,1392,8,10,10,16,51,61,-10,40
Stranraer,1392,9,11,4,21,47,65,-18,37
Stenhousem'r,1392,10,5,10,21,46,89,-43,25
Livingston,1393,1,23,2,11,78,50,28,71
Airdrieon,1393,2,18,7,11,63,57,6,61
Alloa,1393,3,17,9,10,61,46,15,60
Brechin,1393,4,15,10,11,43,39,4,55
Albion,1393,5,14,11,11,55,50,5,53
Peterhead,1393,6,13,9,14,46,42,4,48
Stranraer,1393,7,13,5,18,52,56,-4,44
East Fife,1393,8,10,10,16,44,49,-5,40
Queen's Park,1393,9,10,7,19,35,56,-21,37
Stenhousem'r,1393,10,8,8,20,51,83,-32,32
Livingston,1394,1,19,9,8,77,43,34,66
Alloa,1394,2,17,8,11,70,46,24,59
Airdrieon,1394,3,17,7,12,56,48,8,58
Brechin,1394,4,16,9,11,54,48,6,57
Albion,1394,5,16,7,13,51,50,1,55
Peterhead,1394,6,14,7,15,45,48,-3,49
East Fife,1394,7,11,11,14,51,49,2,44
Queen's Park,1394,8,12,8,16,42,52,-10,44
Stranraer,1394,9,9,10,17,43,60,-17,37
Stenhousem'r,1394,10,5,12,19,30,75,-45,27
Alloa,1395,1,20,10,6,76,45,31,70
Livingston,1395,2,21,4,11,76,51,25,67
Airdrieon,1395,3,18,8,10,58,51,7,62
Brechin,1395,4,16,10,10,55,47,8,58
Albion,1395,5,13,10,13,57,54,3,49
East Fife,1395,6,12,10,14,50,51,-1,46
Stranraer,1395,7,12,7,17,45,60,-15,43
Peterhead,1395,8,9,9,18,44,52,-8,36
Queen's Park,1395,9,8,12,16,31,50,-19,36
Stenhousem'r,1395,10,8,6,22,47,78,-31,30
Livingston,1396,1,20,3,13,72,52,20,63
Alloa,1396,2,18,8,10,73,40,33,62
Albion,1396,3,17,6,13,52,44,8,57
Brechin,1396,4,17,4,15,47,47,0,55
Queen's Park,1396,5,16,4,16,41,48,-7,52
Peterhead,1396,6,16,3,17,48,60,-12,51
Airdrieon,1396,7,15,5,16,60,61,-1,50
East Fife,1396,8,13,10,13,52,44,8,49
Stranraer,1396,9,15,2,19,53,59,-6,47
Stenhousem'r,1396,10,8,5,23,48,91,-43,29
Alloa,1397,1,20,8,8,77,41,36,68
Livingston,1397,2,20,8,8,69,43,26,68
Airdrieon,1397,3,16,7,13,57,56,1,55
East Fife,1397,4,14,10,12,51,41,10,52
Brechin,1397,5,15,6,15,48,52,-4,51
Peterhead,1397,6,13,9,14,50,49,1,48
Albion,1397,7,11,12,13,45,53,-8,45
Queen's Park,1397,8,11,7,18,38,54,-16,40
Stranraer,1397,9,11,4,21,39,59,-20,37
Stenhousem'r,1397,10,10,7,19,44,70,-26,37
Alloa,1398,1,20,9,7,64,34,30,69
Livingston,1398,2,18,6,12,73,56,17,60
Brechin,1398,3,19,3,14,51,40,11,60
Albion,1398,4,15,9,12,50,48,2,54
Airdrieon,1398,5,14,7,15,52,63,-11,49
East Fife,1398,6,14,6,16,51,48,3,48
Peterhead,1398,7,13,5,18,53,64,-11,44
Stranraer,1398,8,12,6,18,50,62,-12,42
Queen's Park,1398,9,11,8,17,35,46,-11,41
Stenhousem'r,1398,10,10,9,17,56,74,-18,39
Livingston,1399,1,21,5,10,82,48,34,68
Peterhead,1399,2,16,8,12,46,46,0,56
Albion,1399,3,16,7,13,54,49,5,55
Alloa,1399,4,15,9,12,71,48,23,54
Airdrieon,1399,5,15,7,14,53,55,-2,52
Brechin,1399,6,14,8,14,51,54,-3,50
Stranraer,1399,7,14,6,16,47,57,-10,48
East Fife,1399,8,11,12,13,49,45,4,45
Queen's Park,1399,9,13,6,17,40,60,-20,45
Stenhousem'r,1399,10,8,6,22,43,74,-31,30
Brechin,1400,1,22,3,11,53,38,15,69
Alloa,1400,2,19,6,11,72,46,26,63
Livingston,1400,3,16,11,9,67,45,22,59
Airdrieon,1400,4,15,8,13,67,64,3,53
Albion,1400,5,14,9,13,50,49,1,51
Peterhead,1400,6,14,8,14,46,53,-7,50
East Fife,1400,7,12,12,12,46,42,4,48
Stranraer,1400,8,12,7,17,48,49,-1,43
Queen's Park,1400,9,9,10,17,34,60,-26,37
Stenhousem'r,1400,10,6,8,22,39,76,-37,26
Livingston,1401,1,20,8,8,82,46,36,68
Brechin,1401,2,21,3,12,58,40,18,66
Airdrieon,1401,3,19,5,12,78,54,24,62
Alloa,1401,4,16,12,8,66,42,24,60
Peterhead,1401,5,14,9,13,51,54,-3,51
Queen's Park,1401,6,14,6,16,43,65,-22,48
Albion,1401,7,12,9,15,56,57,-1,45
East Fife,1401,8,9,12,15,46,61,-15,39
Stranraer,1401,9,10,8,18,41,57,-16,38
Stenhousem'r,1401,10,6,6,24,40,85,-45,24
Alloa,1402,1,19,9,8,69,37,32,66
Livingston,1402,2,21,2,13,74,49,25,65
Brechin,1402,3,20,5,11,62,49,13,65
Peterhead,1402,4,12,13,11,48,46,2,49
Airdrieon,1402,5,14,5,17,46,57,-11,47
Stranraer,1402,6,13,7,16,54,59,-5,46
Albion,1402,7,12,9,15,44,47,-3,45
Queen's Park,1402,8,11,10,15,43,56,-13,43
East Fife,1402,9,11,9,16,52,52,0,42
Stenhousem'r,1402,10,9,7,20,47,87,-40,34
Livingston,1403,1,23,4,9,74,43,31,73
Alloa,1403,2,19,5,12,73,44,29,62
Airdrieon,1403,3,19,4,13,60,55,5,61
Brechin,1403,4,17,6,13,48,42,6,57
Peterhead,1403,5,17,6,13,59,55,4,57
East Fife,1403,6,14,9,13,58,46,12,51
Queen's Park,1403,7,13,5,18,43,62,-19,44
Albion,1403,8,12,6,18,50,61,-11,42
Stranraer,1403,9,10,6,20,42,61,-19,36
Stenhousem'r,1403,10,8,5,23,39,77,-38,29
Livingston,1404,1,21,7,8,77,44,33,70
Brechin,1404,2,19,9,8,54,40,14,66
Airdrieon,1404,3,17,8,11,55,47,8,59
Alloa,1404,4,15,9,12,70,59,11,54
Albion,1404,5,14,6,16,51,52,-1,48
Stranraer,1404,6,13,9,14,51,54,-3,48
Peterhead,1404,7,14,4,18,56,69,-13,46
East Fife,1404,8,13,5,18,43,44,-1,44
Queen's Park,1404,9,12,5,19,35,52,-17,41
Stenhousem'r,1404,10,6,10,20,44,75,-31,28
Alloa,1405,1,22,7,7,86,44,42,73
Livingston,1405,2,17,7,12,68,55,13,58
Peterhead,1405,3,15,7,14,54,45,9,52
Airdrieon,1405,4,15,7,14,48,49,-1,52
Brechin,1405,5,15,7,14,48,50,-2,52
Stenhousem'r,1405,6,15,4,17,52,67,-15,49
Queen's Park,1405,7,13,7,16,37,56,-19,46
Albion,1405,8,12,8,16,58,59,-1,44
Stranraer,1405,9,11,7,18,47,64,-17,40
East Fife,1405,10,9,11,16,47,56,-9,38
Livingston,1406,1,23,1,12,76,53,23,70
Alloa,1406,2,17,9,10,66,45,21,60
Airdrieon,1406,3,17,7,12,67,48,19,58
Peterhead,1406,4,16,7,13,44,42,2,55
Brechin,1406,5,16,7,13,47,49,-2,55
Queen's Park,1406,6,15,7,14,39,52,-13,52
Albion,1406,7,13,9,14,55,50,5,48
East Fife,1406,8,12,8,16,48,49,-1,44
Stranraer,1406,9,12,8,16,50,55,-5,44
Stenhousem'r,1406,10,4,7,25,38,87,-49,19
Livingston,1407,1,22,6,8,81,42,39,72
Alloa,1407,2,22,3,11,77,46,31,69
Albion,1407,3,18,4,14,62,56,6,58
Brechin,1407,4,18,2,16,42,36,6,56
Stranraer,1407,5,17,4,15,46,47,-1,55
Airdrieon,1407,6,16,5,15,54,54,0,53
Peterhead,1407,7,14,8,14,43,51,-8,50
East Fife,1407,8,9,10,17,47,55,-8,37
Stenhousem'r,1407,9,9,6,21,48,81,-33,33
Queen's Park,1407,10,9,4,23,28,60,-32,31
Livingston,1408,1,19,6,11,84,52,32,63
Alloa,1408,2,16,9,11,66,50,16,57
Airdrieon,1408,3,17,5,14,63,59,4,56
Brechin,1408,4,17,5,14,50,46,4,56
Peterhead,1408,5,16,8,12,46,50,-4,56
East Fife,1408,6,15,7,14,58,46,12,52
Queen's Park,1408,7,15,5,16,40,60,-20,50
Albion,1408,8,13,8,15,53,53,0,47
Stranraer,1408,9,11,8,17,52,63,-11,41
Stenhousem'r,1408,10,7,7,22,40,73,-33,28
Alloa,1409,1,20,6,10,72,46,26,66
Airdrieon,1409,2,20,3,13,58,55,3,63
Livingston,1409,3,17,8,11,69,56,13,59
Albion,1409,4,16,7,13,56,50,6,55
Brechin,1409,5,16,6,14,50,49,1,54
Peterhead,1409,6,12,10,14,53,59,-6,46
East Fife,1409,7,11,9,16,49,50,-1,42
Queen's Park,1409,8,12,6,18,33,46,-13,42
Stenhousem'r,1409,9,11,8,17,56,76,-20,41
Stranraer,1409,10,11,5,20,58,67,-9,38
Livingston,1410,1,22,2,12,75,41,34,68
Alloa,1410,2,19,10,7,65,40,25,67
Queen's Park,1410,3,16,7,13,43,49,-6,55
Brechin,1410,4,15,8,13,56,52,4,53
Airdrieon,1410,5,14,9,13,58,58,0,51
Albion,1410,6,14,8,14,57,53,4,50
Stranraer,1410,7,14,8,14,51,58,-7,50
East Fife,1410,8,10,11,15,50,53,-3,41
Peterhead,1410,9,10,7,19,50,65,-15,37
Stenhousem'r,1410,10,7,8,21,36,72,-36,29
Alloa,1411,1,21,10,5,66,33,33,73
Airdrieon,1411,2,22,6,8,63,47,16,72
Livingston,1411,3,17,9,10,71,49,22,60
Brechin,1411,4,16,6,14,53,51,2,54
Queen's Park,1411,5,14,6,16,45,55,-10,48
East Fife,1411,6,12,10,14,49,53,-4,46
Peterhead,1411,7,12,9,15,50,55,-5,45
Albion,1411,8,12,8,16,56,54,2,44
Stranraer,1411,9,8,7,21,35,59,-24,31
Stenhousem'r,1411,10,8,5,23,40,72,-32,29
Livingston,1412,1,22,4,10,70,38,32,70
Airdrieon,1412,2,18,9,9,61,48,13,63
Brechin,1412,3,15,12,9,62,50,12,57
Queen's Park,1412,4,17,6,13,46,43,3,57
Alloa,1412,5,13,15,8,59,45,14,54
Peterhead,1412,6,12,11,13,45,50,-5,47
Stranraer,1412,7,11,10,15,48,58,-10,43
Albion,1412,8,8,14,14,48,63,-15,38
East Fife,1412,9,8,11,17,49,53,-4,35
Stenhousem'r,1412,10,6,8,22,40,80,-40,26
Livingston,1413,1,22,5,9,76,43,33,71
Alloa,1413,2,18,6,12,69,48,21,60
Brechin,1413,3,17,6,13,49,45,4,57
Albion,1413,4,14,11,11,58,52,6,53
Stranraer,1413,5,15,5,16,48,52,-4,50
Airdrieon,1413,6,11,15,10,61,61,0,48
Peterhead,1413,7,13,9,14,46,51,-5,48
East Fife,1413,8,10,9,17,43,50,-7,39
Queen's Park,1413,9,10,8,18,36,58,-22,38
Stenhousem'r,1413,10,10,6,20,53,79,-26,36
Alloa,1414,1,22,7,7,76,41,35,73
Livingston,1414,2,22,5,9,74,45,29,71
Airdrieon,1414,3,18,9,9,48,44,4,63
Albion,1414,4,15,9,12,52,43,9,54
Brechin,1414,5,15,6,15,52,50,2,51
Stranraer,1414,6,14,4,18,50,55,-5,46
East Fife,1414,7,11,8,17,48,51,-3,41
Queen's Park,1414,8,12,4,20,27,54,-27,40
Peterhead,1414,9,11,6,19,41,54,-13,39
Stenhousem'r,1414,10,6,10,20,34,65,-31,28
Livingston,1415,1,19,5,12,66,48,18,62
Alloa,1415,2,18,6,12,68,45,23,60
Queen's Park,1415,3,19,3,14,45,41,4,60
Airdrieon,1415,4,17,8,11,59,54,5,59
Peterhead,1415,5,16,7,13,46,47,-1,55
Brechin,1415,6,14,9,13,42,40,2,51
Albion,1415,7,14,6,16,49,50,-1,48
Stranraer,1415,8,12,8,16,49,54,-5,44
East Fife,1415,9,11,8,17,43,51,-8,41
Stenhousem'r,1415,10,6,8,22,47,84,-37,26
Alloa,1416,1,23,8,5,75,41,34,77
Livingston,1416,2,19,7,10,77,49,28,64
East Fife,1416,3,16,7,13,59,41,18,55
Albion,1416,4,16,7,13,55,46,9,55
Airdrieon,1416,5,16,7,13,53,48,5,55
Queen's Park,1416,6,14,6,16,39,54,-15,48
Brechin,1416,7,13,6,17,46,60,-14,45
Peterhead,1416,8,11,4,21,48,65,-17,37
Stranraer,1416,9,9,10,17,41,61,-20,37
Stenhousem'r,1416,10,9,6,21,49,77,-28,33
Alloa,1417,1,22,7,7,78,40,38,73
Airdrieon,1417,2,19,7,10,66,47,19,64
Albion,1417,3,16,7,13,54,51,3,55
Livingston,1417,4,16,5,15,70,56,14,53
Peterhead,1417,5,14,10,12,50,47,3,52
Stranraer,1417,6,15,5,16,50,55,-5,50
Brechin,1417,7,13,6,17,43,55,-12,45
Stenhousem'r,1417,8,12,5,19,55,81,-26,41
Queen's Park,1417,9,10,8,18,33,56,-23,38
East Fife,1417,10,8,10,18,45,56,-11,34
Alloa,1418,1,18,7,11,66,47,19,61
Peterhead,1418,2,18,7,11,65,47,18,61
East Fife,1418,3,16,9,11,58,47,11,57
Airdrieon,1418,4,15,7,14,54,51,3,52
Livingston,1418,5,15,6,15,64,56,8,51
Albion,1418,6,12,12,12,56,54,2,48
Queen's Park,1418,7,13,8,15,30,49,-19,47
Stranraer,1418,8,13,7,16,59,62,-3,46
Stenhousem'r,1418,9,11,7,18,56,80,-24,40
Brechin,1418,10,11,6,19,45,60,-15,39
Livingston,1419,1,22,2,12,75,43,32,68
Alloa,1419,2,18,7,11,73,43,30,61
Peterhead,1419,3,17,8,11,51,52,-1,59
Albion,1419,4,16,9,11,52,46,6,57
Brechin,1419,5,17,6,13,41,36,5,57
Queen's Park,1419,6,13,8,15,43,60,-17,47
Stranraer,1419,7,14,4,18,39,48,-9,46
Airdrieon,1419,8,13,6,17,52,56,-4,45
East Fife,1419,9,9,8,19,39,54,-15,35
Stenhousem'r,1419,10,8,8,20,43,70,-27,32
Alloa,1420,1,19,9,8,75,46,29,66
Livingston,1420,2,20,4,12,73,53,20,64
Airdrieon,1420,3,19,5,12,53,53,0,62
Brechin,1420,4,18,4,14,50,43,7,58
Stranraer,1420,5,14,8,14,61,57,4,50
Albion,1420,6,14,7,15,54,51,3,49
Queen's Park,1420,7,14,6,16,37,47,-10,48
Peterhead,1420,8,14,5,17,48,55,-7,47
East Fife,1420,9,12,6,18,47,50,-3,42
Stenhousem'r,1420,10,6,6,24,40,83,-43,24
Livingston,1421,1,22,5,9,77,40,37,71
Alloa,1421,2,20,7,9,69,50,19,67
Brechin,1421,3,15,8,13,59,50,9,53
Peterhead,1421,4,14,9,13,47,50,-3,51
Queen's Park,1421,5,14,7,15,48,48,0,49
East Fife,1421,6,14,7,15,49,50,-1,49
Stranraer,1421,7,12,8,16,52,57,-5,44
Airdrieon,1421,8,11,10,15,51,66,-15,43
Albion,1421,9,11,9,16,48,59,-11,42
Stenhousem'r,1421,10,8,8,20,45,75,-30,32
Livingston,1422,1,20,5,11,70,48,22,65
Airdrieon,1422,2,19,7,10,72,54,18,64
Brechin,1422,3,19,5,12,60,52,8,62
Alloa,1422,4,16,8,12,73,56,17,56
Albion,1422,5,14,8,14,54,50,4,50
Queen's Park,1422,6,15,5,16,42,50,-8,50
Stranraer,1422,7,14,3,19,49,64,-15,45
Peterhead,1422,8,12,9,15,43,58,-15,45
East Fife,1422,9,12,8,16,47,45,2,44
Stenhousem'r,1422,10,7,6,23,45,78,-33,27
Alloa,1423,1,19,9,8,66,45,21,66
Brechin,1423,2,19,6,11,52,45,7,63
Livingston,1423,3,17,8,11,69,50,19,59
Airdrieon,1423,4,17,5,14,62,61,1,56
Queen's Park,1423,5,15,7,14,47,53,-6,52
East Fife,1423,6,12,11,13,49,48,1,47
Albion,1423,7,12,10,14,61,57,4,46
Stranraer,1423,8,14,3,19,57,54,3,45
Stenhousem'r,1423,9,10,8,18,50,77,-27,38
Peterhead,1423,10,7,9,20,40,63,-23,30
Livingston,1424,1,17,8,11,64,44,20,59
Brechin,1424,2,18,5,13,58,48,10,59
Peterhead,1424,3,17,8,11,58,49,9,59
Albion,1424,4,17,6,13,53,43,10,57
Alloa,1424,5,17,5,14,62,52,10,56
Airdrieon,1424,6,16,7,13,63,56,7,55
Stranraer,1424,7,14,6,16,57,67,-10,48
Queen's Park,1424,8,12,8,16,36,48,-12,44
East Fife,1424,9,11,8,17,42,48,-6,41
Stenhousem'r,1424,10,7,7,22,40,78,-38,28
Livingston,1425,1,23,2,11,81,47,34,71
Airdrieon,1425,2,21,4,11,64,47,17,67
Alloa,1425,3,18,6,12,70,46,24,60
Peterhead,1425,4,15,8,13,47,52,-5,53
Queen's Park,1425,5,14,6,16,50,57,-7,48
Albion,1425,6,14,5,17,57,58,-1,47
Brechin,1425,7,14,5,17,50,60,-10,47
East Fife,1425,8,13,5,18,50,58,-8,44
Stranraer,1425,9,13,5,18,47,59,-12,44
Stenhousem'r,1425,10,9,6,21,41,73,-32,33
Livingston,1426,1,21,4,11,75,44,31,67
Alloa,1426,2,19,9,8,78,45,33,66
Peterhead,1426,3,16,9,11,49,46,3,57
Airdrieon,1426,4,15,10,11,57,48,9,55
Brechin,1426,5,15,7,14,49,49,0,52
Albion,1426,6,13,10,13,45,48,-3,49
Stranraer,1426,7,13,4,19,49,62,-13,43
East Fife,1426,8,11,9,16,50,51,-1,42
Queen's Park,1426,9,9,9,18,32,57,-25,36
Stenhousem'r,1426,10,9,7,20,44,78,-34,34
Livingston,1427,1,25,1,10,87,48,39,76
Alloa,1427,2,20,7,9,70,42,28,67
Brechin,1427,3,19,4,13,55,47,8,61
Peterhead,1427,4,18,5,13,56,47,9,59
Albion,1427,5,15,6,15,56,54,2,51
Airdrieon,1427,6,14,8,14,51,51,0,50
East Fife,1427,7,11,7,18,46,53,-7,40
Stranraer,1427,8,12,4,20,39,56,-17,40
Queen's Park,1427,9,9,7,20,30,57,-27,34
Stenhousem'r,1427,10,9,7,20,39,74,-35,34
Livingston,1428,1,21,5,10,78,45,33,68
Alloa,1428,2,19,9,8,79,50,29,66
Airdrieon,1428,3,16,6,14,53,54,-1,54
Albion,1428,4,15,8,13,51,48,3,53
Queen's Park,1428,5,16,4,16,42,55,-13,52
Stranraer,1428,6,14,9,13,52,56,-4,51
Peterhead,1428,7,12,9,15,44,51,-7,45
Brechin,1428,8,13,4,19,44,51,-7,43
East Fife,1428,9,10,9,17,53,57,-4,39
Stenhousem'r,1428,10,8,9,19,56,85,-29,33
Alloa,1429,1,21,5,10,66,38,28,68
Livingston,1429,2,20,6,10,70,42,28,66
Peterhead,1429,3,19,6,11,52,42,10,63
Airdrieon,1429,4,17,9,10,56,50,6,60
Queen's Park,1429,5,13,7,16,45,52,-7,46
Brechin,1429,6,14,3,19,55,61,-6,45
Albion,1429,7,12,8,16,50,61,-11,44
Stranraer,1429,8,11,7,18,46,60,-14,40
East Fife,1429,9,10,8,18,45,51,-6,38
Stenhousem'r,1429,10,10,7,19,49,77,-28,37
Alloa,1430,1,18,12,6,83,49,34,66
Livingston,1430,2,19,4,13,74,53,21,61
Queen's Park,1430,3,15,11,10,51,49,2,56
Airdrieon,1430,4,16,7,13,57,49,8,55
Brechin,1430,5,16,7,13,53,58,-5,55
Stranraer,1430,6,16,6,14,59,57,2,54
Peterhead,1430,7,13,9,14,44,44,0,48
Albion,1430,8,12,9,15,56,63,-7,45
Stenhousem'r,1430,9,8,9,19,46,79,-33,33
East Fife,1430,10,5,10,21,40,62,-22,25
Alloa,1431,1,22,6,8,80,37,43,72
Livingston,1431,2,19,5,12,72,48,24,62
Queen's Park,1431,3,17,8,11,46,45,1,59
Airdrieon,1431,4,16,9,11,62,57,5,57
Albion,1431,5,14,8,14,56,51,5,50
Brechin,1431,6,15,4,17,50,51,-1,49
Peterhead,1431,7,13,7,16,42,53,-11,46
East Fife,1431,8,11,9,16,45,49,-4,42
Stranraer,1431,9,11,4,21,40,60,-20,37
Stenhousem'r,1431,10,7,10,19,45,87,-42,31
Livingston,1432,1,23,6,7,77,46,31,75
Alloa,1432,2,19,9,8,72,46,26,66
Airdrieon,1432,3,17,7,12,68,53,15,58
East Fife,1432,4,15,10,11,49,41,8,55
Albion,1432,5,14,10,12,63,55,8,52
Brechin,1432,6,14,8,14,51,50,1,50
Peterhead,1432,7,11,9,16,45,52,-7,42
Queen's Park,1432,8,10,6,20,32,64,-32,36
Stranraer,1432,9,9,7,20,44,62,-18,34
Stenhousem'r,1432,10,9,6,21,49,81,-32,33
Alloa,1433,1,24,5,7,83,49,34,77
Livingston,1433,2,19,4,13,69,51,18,61
Brechin,1433,3,16,9,11,57,46,11,57
Airdrieon,1433,4,13,10,13,48,51,-3,49
Peterhead,1433,5,13,8,15,51,57,-6,47
Queen's Park,1433,6,14,5,17,43,51,-8,47
East Fife,1433,7,12,10,14,50,45,5,46
Stranraer,1433,8,11,9,16,53,58,-5,42
Albion,1433,9,11,9,16,50,60,-10,42
Stenhousem'r,1433,10,8,9,19,47,83,-36,33
Livingston,1434,1,21,5,10,81,48,33,68
Alloa,1434,2,19,11,6,76,47,29,68
Brechin,1434,3,20,5,11,55,44,11,65
Peterhead,1434,4,18,7,11,60,52,8,61
Airdrieon,1434,5,17,6,13,62,54,8,57
Queen's Park,1434,6,12,7,17,38,50,-12,43
Albion,1434,7,11,7,18,52,59,-7,40
Stranraer,1434,8,11,5,20,50,64,-14,38
East Fife,1434,9,9,9,18,41,54,-13,36
Stenhousem'r,1434,10,6,10,20,49,92,-43,28
Alloa,1435,1,22,7,7,77,39,38,73
Brechin,1435,2,20,5,11,58,46,12,65
Livingston,1435,3,19,6,11,68,48,20,63
Airdrieon,1435,4,15,6,15,51,60,-9,51
Albion,1435,5,14,7,15,47,51,-4,49
Stranraer,1435,6,14,5,17,56,63,-7,47
East Fife,1435,7,10,13,13,46,45,1,43
Queen's Park,1435,8,9,11,16,44,57,-13,38
Peterhead,1435,9,10,8,18,45,61,-16,38
Stenhousem'r,1435,10,9,8,19,50,72,-22,35
Livingston,1436,1,19,7,10,68,48,20,64
Alloa,1436,2,17,10,9,69,46,23,61
Peterhead,1436,3,15,10,11,49,43,6,55
Airdrieon,1436,4,16,7,13,54,52,2,55
East Fife,1436,5,14,11,11,54,40,14,53
Stranraer,1436,6,15,6,15,49,49,0,51
Brechin,1436,7,13,6,17,39,48,-9,45
Queen's Park,1436,8,12,8,16,31,45,-14,44
Albion,1436,9,11,7,18,42,55,-13,40
Stenhousem'r,1436,10,8,8,20,52,81,-29,32
Alloa,1437,1,20,9,7,69,32,37,69
Airdrieon,1437,2,20,9,7,61,46,15,69
Livingston,1437,3,19,5,12,72,49,23,62
Brechin,1437,4,18,7,11,56,44,12,61
Peterhead,1437,5,17,5,14,57,46,11,56
Stranraer,1437,6,13,6,17,58,62,-4,45
Albion,1437,7,13,6,17,45,57,-12,45
Queen's Park,1437,8,10,8,18,28,50,-22,38
East Fife,1437,9,7,12,17,36,47,-11,33
Stenhousem'r,1437,10,7,5,24,44,93,-49,26
Livingston,1438,1,18,8,10,72,47,25,62
Alloa,1438,2,17,7,12,63,43,20,58
Albion,1438,3,16,7,13,57,52,5,55
Peterhead,1438,4,16,6,14,61,55,6,54
Brechin,1438,5,16,5,15,54,53,1,53
Airdrieon,1438,6,15,7,14,54,59,-5,52
Stranraer,1438,7,14,8,14,55,58,-3,50
East Fife,1438,8,13,10,13,50,40,10,49
Queen's Park,1438,9,12,8,16,36,54,-18,44
Stenhousem'r,1438,10,6,8,22,50,91,-41,26
Livingston,1439,1,22,5,9,72,38,34,71
Alloa,1439,2,17,8,11,77,56,21,59
Airdrieon,1439,3,17,7,12,66,51,15,58
Albion,1439,4,17,6,13,56,51,5,57
Stranraer,1439,5,15,3,18,47,56,-9,48
Peterhead,1439,6,14,5,17,51,63,-12,47
Brechin,1439,7,13,7,16,46,50,-4,46
Queen's Park,1439,8,12,10,14,44,58,-14,46
East Fife,1439,9,9,13,14,49,45,4,40
Stenhousem'r,1439,10,8,8,20,41,81,-40,32
Alloa,1440,1,21,5,10,72,40,32,68
Livingston,1440,2,20,3,13,70,53,17,63
Airdrieon,1440,3,19,5,12,65,55,10,62
Brechin,1440,4,16,8,12,55,48,7,56
Peterhead,1440,5,16,5,15,55,58,-3,53
Queen's Park,1440,6,16,4,16,38,50,-12,52
Albion,1440,7,13,7,16,53,59,-6,46
Stranraer,1440,8,13,2,21,55,68,-13,41
East Fife,1440,9,10,7,19,51,58,-7,37
Stenhousem'r,1440,10,10,6,20,51,76,-25,36
Alloa,1441,1,20,5,11,61,36,25,65
Livingston,1441,2,18,6,12,72,50,22,60
Airdrieon,1441,3,16,10,10,58,57,1,58
Peterhead,1441,4,16,7,13,53,47,6,55
Brechin,1441,5,15,6,15,48,54,-6,51
East Fife,1441,6,13,9,14,51,49,2,48
Queen's Park,1441,7,13,7,16,37,47,-10,46
Stranraer,1441,8,13,5,18,53,58,-5,44
Albion,1441,9,10,9,17,45,54,-9,39
Stenhousem'r,1441,10,11,6,19,51,77,-26,39
Alloa,1442,1,22,6,8,74,41,33,72
Livingston,1442,2,17,9,10,65,44,21,60
Airdrieon,1442,3,19,3,14,63,53,10,60
Brechin,1442,4,15,6,15,50,49,1,51
Peterhead,1442,5,15,6,15,56,65,-9,51
Queen's Park,1442,6,14,6,16,37,53,-16,48
East Fife,1442,7,12,11,13,52,43,9,47
Albion,1442,8,12,9,15,49,51,-2,45
Stranraer,1442,9,11,5,20,41,60,-19,38
Stenhousem'r,1442,10,9,7,20,46,74,-28,34
Livingston,1443,1,24,4,8,78,38,40,76
Alloa,1443,2,23,4,9,75,43,32,73
Airdrieon,1443,3,15,9,12,59,68,-9,54
Peterhead,1443,4,15,8,13,47,44,3,53
East Fife,1443,5,12,12,12,51,40,11,48
Queen's Park,1443,6,13,9,14,40,48,-8,48
Stranraer,1443,7,13,7,16,51,58,-7,46
Albion,1443,8,11,7,18,47,58,-11,40
Brechin,1443,9,11,6,19,41,62,-21,39
Stenhousem'r,1443,10,5,10,21,42,72,-30,25
Livingston,1444,1,21,6,9,78,52,26,69
Brechin,1444,2,19,5,12,56,43,13,62
Airdrieon,1444,3,18,7,11,61,50,11,61
Alloa,1444,4,16,8,12,62,45,17,56
Queen's Park,1444,5,15,8,13,44,55,-11,53
East Fife,1444,6,13,9,14,48,46,2,48
Albion,1444,7,13,9,14,53,55,-2,48
Peterhead,1444,8,13,6,17,51,56,-5,45
Stranraer,1444,9,10,9,17,45,57,-12,39
Stenhousem'r,1444,10,4,9,23,47,86,-39,21
Livingston,1445,1,19,6,11,75,49,26,63
Alloa,1445,2,17,8,11,75,50,25,59
Airdrieon,1445,3,18,5,13,60,53,7,59
Albion,1445,4,17,7,12,47,39,8,58
Brechin,1445,5,16,6,14,47,53,-6,54
Peterhead,1445,6,13,9,14,56,58,-2,48
Queen's Park,1445,7,13,8,15,38,47,-9,47
Stranraer,1445,8,11,7,18,42,57,-15,40
Stenhousem'r,1445,9,11,7,18,46,73,-27,40
East Fife,1445,10,8,11,17,43,50,-7,35
Livingston,1446,1,24,3,9,76,40,36,75
Alloa,1446,2,21,8,7,85,47,38,71
Airdrieon,1446,3,17,9,10,62,55,7,60
Brechin,1446,4,15,8,13,48,55,-7,53
Albion,1446,5,13,12,11,45,46,-1,51
Peterhead,1446,6,12,9,15,49,57,-8,45
East Fife,1446,7,10,12,14,49,45,4,42
Queen's Park,1446,8,11,6,19,42,63,-21,39
Stranraer,1446,9,10,4,22,43,64,-21,34
Stenhousem'r,1446,10,7,9,20,50,77,-27,30
Livingston,1447,1,19,7,10,72,47,25,64
Airdrieon,1447,2,18,10,8,61,46,15,64
Peterhead,1447,3,16,9,11,50,51,-1,57
Alloa,1447,4,15,10,11,55,40,15,55
Stranraer,1447,5,16,5,15,55,51,4,53
Brechin,1447,6,16,5,15,53,49,4,53
Albion,1447,7,12,10,14,58,60,-2,46
Queen's Park,1447,8,12,5,19,34,57,-23,41
East Fife,1447,9,9,11,16,42,45,-3,38
Stenhousem'r,1447,10,7,8,21,40,74,-34,29
Alloa,1448,1,21,5,10,73,42,31,68
Livingston,1448,2,20,7,9,75,44,31,67
Airdrieon,1448,3,17,7,12,65,55,10,58
Peterhead,1448,4,15,6,15,60,57,3,51
Albion,1448,5,13,9,14,49,55,-6,48
Stranraer,1448,6,14,5,17,53,56,-3,47
East Fife,1448,7,13,7,16,52,53,-1,46
Brechin,1448,8,12,10,14,38,44,-6,46
Queen's Park,1448,9,13,5,18,41,57,-16,44
Stenhousem'r,1448,10,8,7,21,41,84,-43,31
Livingston,1449,1,23,4,9,73,43,30,73
Brechin,1449,2,22,4,10,62,38,24,70
Airdrieon,1449,3,20,6,10,55,40,15,66
Alloa,1449,4,16,6,14,59,40,19,54
Peterhead,1449,5,12,9,15,47,51,-4,45
Queen's Park,1449,6,12,9,15,37,46,-9,45
Albion,1449,7,12,8,16,51,60,-9,44
Stranraer,1449,8,13,3,20,49,70,-21,42
East Fife,1449,9,10,10,16,53,62,-9,40
Stenhousem'r,1449,10,6,9,21,46,82,-36,27
Livingston,1450,1,23,4,9,80,47,33,73
Alloa,1450,2,17,9,10,71,41,30,60
Brechin,1450,3,16,8,12,49,46,3,56
Airdrieon,1450,4,16,7,13,67,59,8,55
Peterhead,1450,5,15,8,13,50,53,-3,53
Queen's Park,1450,6,13,7,16,38,54,-16,46
Albion,1450,7,12,8,16,53,56,-3,44
East Fife,1450,8,11,10,15,55,56,-1,43
Stenhousem'r,1450,9,11,7,18,56,81,-25,40
Stranraer,1450,10,9,6,21,37,63,-26,33
Alloa,1451,1,18,9,9,76,51,25,63
Livingston,1451,2,19,5,12,74,48,26,62
Brechin,1451,3,17,6,13,49,48,1,57
Stranraer,1451,4,16,5,15,62,59,3,53
Airdrieon,1451,5,16,4,16,52,59,-7,52
East Fife,1451,6,14,9,13,58,52,6,51
Peterhead,1451,7,13,7,16,47,57,-10,46
Albion,1451,8,13,5,18,48,53,-5,44
Stenhousem'r,1451,9,11,9,16,50,76,-26,42
Queen's Park,1451,10,11,5,20,40,53,-13,38
Alloa,1452,1,20,6,10,73,47,26,66
Livingston,1452,2,19,4,13,68,51,17,61
Brechin,1452,3,17,7,12,53,50,3,58
Airdrieon,1452,4,15,9,12,56,61,-5,54
Albion,1452,5,13,13,10,60,54,6,52
Peterhead,1452,6,15,6,15,54,49,5,51
Stranraer,1452,7,15,5,16,64,62,2,50
Queen's Park,1452,8,12,6,18,35,55,-20,42
Stenhousem'r,1452,9,10,8,18,49,74,-25,38
East Fife,1452,10,8,8,20,45,54,-9,32
Livingston,1453,1,22,7,7,81,44,37,73
Alloa,1453,2,16,10,10,69,45,24,58
Brechin,1453,3,16,9,11,55,44,11,57
Airdrieon,1453,4,17,4,15,58,61,-3,55
Stranraer,1453,5,15,8,13,58,54,4,53
Albion,1453,6,15,8,13,52,55,-3,53
East Fife,1453,7,12,9,15,49,51,-2,45
Queen's Park,1453,8,12,7,17,35,47,-12,43
Peterhead,1453,9,10,6,20,38,61,-23,36
Stenhousem'r,1453,10,5,12,19,46,79,-33,27
Livingston,1454,1,20,5,11,72,43,29,65
Alloa,1454,2,20,3,13,71,44,27,63
Airdrieon,1454,3,19,4,13,64,47,17,61
Brechin,1454,4,18,5,13,59,46,13,59
Albion,1454,5,16,7,13,56,48,8,55
Stranraer,1454,6,13,8,15,49,64,-15,47
Peterhead,1454,7,11,11,14,42,58,-16,44
East Fife,1454,8,11,10,15,41,42,-1,43
Queen's Park,1454,9,12,5,19,35,58,-23,41
Stenhousem'r,1454,10,8,6,22,41,80,-39,30
Livingston,1455,1,23,4,9,76,47,29,73
Alloa,1455,2,20,8,8,73,41,32,68
Brechin,1455,3,16,8,12,56,48,8,56
Albion,1455,4,15,10,11,51,50,1,55
Airdrieon,1455,5,15,9,12,62,53,9,54
Peterhead,1455,6,14,11,11,50,50,0,53
Queen's Park,1455,7,12,6,18,37,59,-22,42
Stranraer,1455,8,10,7,19,45,62,-17,37
East Fife,1455,9,9,9,18,41,51,-10,36
Stenhousem'r,1455,10,7,6,23,54,84,-30,27
Alloa,1456,1,21,9,6,76,41,35,72
Livingston,1456,2,21,4,11,70,43,27,67
Brechin,1456,3,17,7,12,67,56,11,58
Peterhead,1456,4,14,8,14,47,45,2,50
Stranraer,1456,5,14,4,18,46,49,-3,46
Airdrieon,1456,6,13,7,16,49,64,-15,46
Albion,1456,7,12,8,16,48,57,-9,44
Queen's Park,1456,8,12,7,17,35,58,-23,43
East Fife,1456,9,12,6,18,54,57,-3,42
Stenhousem'r,1456,10,10,8,18,48,70,-22,38
Livingston,1457,1,19,5,12,73,51,22,62
Airdrieon,1457,2,16,13,7,58,44,14,61
Alloa,1457,3,17,9,10,66,41,25,60
Brechin,1457,4,15,7,14,47,44,3,52
East Fife,1457,5,12,11,13,52,46,6,47
Queen's Park,1457,6,13,7,16,43,56,-13,46
Stranraer,1457,7,12,7,17,51,60,-9,43
Albion,1457,8,11,10,15,44,57,-13,43
Peterhead,1457,9,11,9,16,42,57,-15,42
Stenhousem'r,1457,10,11,8,17,47,67,-20,41
Livingston,1458,1,22,4,10,71,44,27,70
Airdrieon,1458,2,18,6,12,71,54,17,60
Alloa,1458,3,17,7,12,61,46,15,58
East Fife,1458,4,15,7,14,53,47,6,52
Queen's Park,1458,5,15,7,14,40,41,-1,52
Brechin,1458,6,15,5,16,42,49,-7,50
Peterhead,1458,7,13,10,13,51,48,3,49
Albion,1458,8,14,6,16,51,57,-6,48
Stranraer,1458,9,13,1,22,53,73,-20,40
Stenhousem'r,1458,10,7,9,20,48,82,-34,30
Livingston,1459,1,22,4,10,76,57,19,70
Alloa,1459,2,19,10,7,68,41,27,67
Brechin,1459,3,18,6,12,55,45,10,60
Albion,1459,4,15,9,12,64,52,12,54
East Fife,1459,5,13,10,13,48,41,7,49
Airdrieon,1459,6,13,7,16,61,65,-4,46
Queen's Park,1459,7,13,7,16,33,48,-15,46
Stranraer,1459,8,12,8,16,54,64,-10,44
Peterhead,1459,9,10,7,19,47,62,-15,37
Stenhousem'r,1459,10,5,12,19,40,71,-31,27
Livingston,1460,1,22,7,7,67,39,28,73
Alloa,1460,2,18,8,10,79,52,27,62
Brechin,1460,3,18,7,11,51,53,-2,61
Airdrieon,1460,4,16,9,11,63,60,3,57
Albion,1460,5,16,8,12,53,42,11,56
East Fife,1460,6,12,11,13,62,50,12,47
Peterhead,1460,7,10,10,16,43,53,-10,40
Queen's Park,1460,8,10,8,18,36,50,-14,38
Stenhousem'r,1460,9,8,10,18,42,73,-31,34
Stranraer,1460,10,8,6,22,44,68,-24,30
Livingston,1461,1,21,5,10,79,45,34,68
Alloa,1461,2,17,12,7,70,52,18,63
Airdrieon,1461,3,16,9,11,63,60,3,57
Stranraer,1461,4,17,5,14,62,55,7,56
East Fife,1461,5,14,8,14,47,49,-2,50
Brechin,1461,6,14,6,16,49,51,-2,48
Albion,1461,7,12,6,18,54,58,-4,42
Queen's Park,1461,8,11,9,16,44,50,-6,42
Stenhousem'r,1461,9,11,7,18,44,76,-32,40
Peterhead,1461,10,10,7,19,47,63,-16,37
Livingston,1462,1,25,4,7,81,49,32,79
Airdrieon,1462,2,17,7,12,60,60,0,58
Brechin,1462,3,15,8,13,53,50,3,53
Alloa,1462,4,12,14,10,64,49,15,50
East Fife,1462,5,12,10,14,55,50,5,46
Stranraer,1462,6,12,7,17,59,63,-4,43
Peterhead,1462,7,12,7,17,44,60,-16,43
Queen's Park,1462,8,12,7,17,42,61,-19,43
Stenhousem'r,1462,9,11,9,16,56,69,-13,42
Albion,1462,10,10,11,15,51,54,-3,41
Alloa,1463,1,25,6,5,74,35,39,81
Livingston,1463,2,21,3,12,71,50,21,66
Airdrieon,1463,3,19,8,9,67,44,23,65
Albion,1463,4,17,4,15,61,58,3,55
Brechin,1463,5,14,4,18,50,54,-4,46
Queen's Park,1463,6,13,7,16,39,50,-11,46
Peterhead,1463,7,11,10,15,45,56,-11,43
Stranraer,1463,8,11,7,18,52,61,-9,40
East Fife,1463,9,10,8,18,49,55,-6,38
Stenhousem'r,1463,10,7,7,22,46,91,-45,28
Alloa,1464,1,20,10,6,69,38,31,70
Livingston,1464,2,17,8,11,72,57,15,59
Albion,1464,3,17,7,12,61,51,10,58
Brechin,1464,4,17,7,12,52,48,4,58
Airdrieon,1464,5,13,8,15,57,62,-5,47
Peterhead,1464,6,13,7,16,43,54,-11,46
Queen's Park,1464,7,12,9,15,38,47,-9,45
Stranraer,1464,8,11,9,16,49,57,-8,42
East Fife,1464,9,11,8,17,47,49,-2,41
Stenhousem'r,1464,10,7,11,18,50,75,-25,32
Livingston,1465,1,21,7,8,73,46,27,70
Brechin,1465,2,18,6,12,54,43,11,60
Airdrieon,1465,3,16,8,12,53,46,7,56
Alloa,1465,4,15,10,11,65,50,15,55
Peterhead,1465,5,15,9,12,58,62,-4,54
Albion,1465,6,12,14,10,64,55,9,50
Stranraer,1465,7,12,7,17,42,54,-12,43
Queen's Park,1465,8,10,9,17,34,50,-16,39
East Fife,1465,9,9,8,19,49,57,-8,35
Stenhousem'r,1465,10,9,8,19,58,87,-29,35
Livingston,1466,1,26,3,7,89,43,46,81
Alloa,1466,2,20,6,10,71,46,25,66
Airdrieon,1466,3,20,5,11,59,50,9,65
Brechin,1466,4,18,4,14,51,44,7,58
Peterhead,1466,5,14,4,18,42,51,-9,46
Albion,1466,6,12,8,16,48,57,-9,44
East Fife,1466,7,12,7,17,50,53,-3,43
Stranraer,1466,8,10,7,19,47,66,-19,37
Queen's Park,1466,9,10,7,19,36,58,-22,37
Stenhousem'r,1466,10,8,9,19,47,72,-25,33
Alloa,1467,1,18,8,10,63,41,22,62
Brechin,1467,2,18,7,11,46,37,9,61
Peterhead,1467,3,18,5,13,61,53,8,59
Airdrieon,1467,4,17,5,14,55,55,0,56
Stranraer,1467,5,17,4,15,63,58,5,55
Livingston,1467,6,15,9,12,59,47,12,54
Queen's Park,1467,7,13,8,15,35,43,-8,47
Albion,1467,8,11,12,13,45,45,0,45
East Fife,1467,9,9,9,18,48,53,-5,36
Stenhousem'r,1467,10,6,9,21,43,86,-43,27
Alloa,1468,1,22,6,8,68,38,30,72
Livingston,1468,2,22,5,9,80,46,34,71
Airdrieon,1468,3,18,9,9,61,55,6,63
Queen's Park,1468,4,17,4,15,47,47,0,55
Albion,1468,5,16,7,13,49,51,-2,55
Brechin,1468,6,12,8,16,44,48,-4,44
Peterhead,1468,7,13,5,18,47,59,-12,44
Stenhousem'r,1468,8,10,7,19,56,77,-21,37
East Fife,1468,9,9,9,18,39,47,-8,36
Stranraer,1468,10,8,6,22,46,69,-23,30
Alloa,1469,1,22,6,8,77,39,38,72
Livingston,1469,2,18,6,12,63,46,17,60
Airdrieon,1469,3,18,5,13,58,50,8,59
East Fife,1469,4,13,12,11,51,40,11,51
Stenhousem'r,1469,5,14,6,16,67,76,-9,48
Peterhead,1469,6,13,7,16,45,55,-10,46
Brechin,1469,7,13,7,16,40,58,-18,46
Albion,1469,8,12,9,15,46,54,-8,45
Stranraer,1469,9,11,8,17,46,50,-4,41
Queen's Park,1469,10,9,8,19,32,57,-25,35
Livingston,1470,1,23,2,11,91,55,36,71
Airdrieon,1470,2,18,10,8,55,45,10,64
Alloa,1470,3,17,8,11,72,55,17,59
Albion,1470,4,15,8,13,48,46,2,53
Queen's Park,1470,5,15,5,16,43,47,-4,50
Stranraer,1470,6,14,8,14,51,62,-11,50
Brechin,1470,7,14,4,18,42,48,-6,46
Peterhead,1470,8,11,9,16,48,55,-7,42
East Fife,1470,9,10,10,16,48,48,0,40
Stenhousem'r,1470,10,6,10,20,36,73,-37,28
Livingston,1471,1,20,7,9,75,44,31,67
Alloa,1471,2,18,8,10,65,46,19,62
Stranraer,1471,3,18,5,13,59,50,9,59
Airdrieon,1471,4,17,6,13,57,53,4,57
Brechin,1471,5,15,10,11,56,48,8,55
Albion,1471,6,14,8,14,58,59,-1,50
East Fife,1471,7,13,7,16,60,62,-2,46
Queen's Park,1471,8,12,9,15,40,52,-12,45
Peterhead,1471,9,9,7,20,51,69,-18,34
Stenhousem'r,1471,10,7,7,22,44,82,-38,28
Alloa,1472,1,23,6,7,80,46,34,75
Livingston,1472,2,23,2,11,79,46,33,71
Airdrieon,1472,3,16,6,14,67,53,14,54
Brechin,1472,4,15,9,12,53,57,-4,54
Peterhead,1472,5,13,10,13,43,46,-3,49
Albion,1472,6,12,11,13,47,46,1,47
East Fife,1472,7,11,12,13,52,47,5,45
Stranraer,1472,8,10,7,19,44,68,-24,37
Stenhousem'r,1472,9,9,9,18,47,77,-30,36
Queen's Park,1472,10,9,6,21,37,63,-26,33
Livingston,1473,1,24,2,10,79,49,30,74
Alloa,1473,2,20,7,9,69,39,30,67
Airdrieon,1473,3,18,6,12,62,57,5,60
Albion,1473,4,16,7,13,63,52,11,55
Brechin,1473,5,16,5,15,50,47,3,53
Queen's Park,1473,6,14,6,16,38,46,-8,48
East Fife,1473,7,13,8,15,52,53,-1,47
Peterhead,1473,8,11,12,13,54,64,-10,45
Stranraer,1473,9,10,4,22,44,67,-23,34
Stenhousem'r,1473,10,6,7,23,41,78,-37,25
Livingston,1474,1,24,1,11,81,44,37,73
Alloa,1474,2,19,8,9,71,41,30,65
Brechin,1474,3,17,7,12,60,57,3,58
Albion,1474,4,17,6,13,62,54,8,57
Airdrieon,1474,5,17,5,14,58,50,8,56
Stranraer,1474,6,16,5,15,59,59,0,53
East Fife,1474,7,12,7,17,42,51,-9,43
Queen's Park,1474,8,12,6,18,44,60,-16,42
Peterhead,1474,9,11,8,17,48,65,-17,41
Stenhousem'r,1474,10,6,5,25,36,80,-44,23
Livingston,1475,1,21,4,11,72,51,21,67
Airdrieon,1475,2,17,8,11,54,46,8,59
Alloa,1475,3,17,7,12,65,46,19,58
Albion,1475,4,14,13,9,55,40,15,55
Brechin,1475,5,17,4,15,49,53,-4,55
Peterhead,1475,6,14,6,16,44,49,-5,48
Stranraer,1475,7,12,7,17,45,59,-14,43
East Fife,1475,8,10,10,16,47,51,-4,40
Stenhousem'r,1475,9,10,9,17,53,71,-18,39
Queen's Park,1475,10,9,10,17,31,49,-18,37
Livingston,1476,1,22,5,9,77,44,33,71
Brechin,1476,2,17,10,9,55,37,18,61
Alloa,1476,3,15,12,9,69,51,18,57
Albion,1476,4,16,9,11,57,47,10,57
Peterhead,1476,5,14,10,12,55,50,5,52
Airdrieon,1476,6,12,9,15,52,65,-13,45
Queen's Park,1476,7,12,9,15,42,58,-16,45
Stranraer,1476,8,12,5,19,45,65,-20,41
East Fife,1476,9,9,8,19,48,49,-1,35
Stenhousem'r,1476,10,7,11,18,49,83,-34,32
Livingston,1477,1,25,3,8,88,46,42,78
Alloa,1477,2,19,9,8,68,39,29,66
Airdrieon,1477,3,18,6,12,57,55,2,60
Brechin,1477,4,16,8,12,46,42,4,56
Queen's Park,1477,5,15,7,14,42,46,-4,52
Stranraer,1477,6,15,4,17,51,54,-3,49
Stenhousem'r,1477,7,10,9,17,57,77,-20,39
East Fife,1477,8,9,10,17,40,45,-5,37
Albion,1477,9,10,6,20,45,66,-21,36
Peterhead,1477,10,9,6,21,41,65,-24,33
Livingston,1478,1,20,6,10,72,42,30,66
Airdrieon,1478,2,19,6,11,66,56,10,63
Albion,1478,3,17,8,11,57,48,9,59
Brechin,1478,4,17,7,12,55,49,6,58
Alloa,1478,5,17,6,13,69,50,19,57
Peterhead,1478,6,15,8,13,59,59,0,53
East Fife,1478,7,11,12,13,48,44,4,45
Queen's Park,1478,8,10,8,18,36,58,-22,38
Stranraer,1478,9,9,7,20,43,66,-23,34
Stenhousem'r,1478,10,6,10,20,44,77,-33,28
Alloa,1479,1,18,9,9,67,38,29,63
Brechin,1479,2,18,9,9,57,41,16,63
Livingston,1479,3,17,6,13,68,57,11,57
East Fife,1479,4,15,9,12,59,42,17,54
Airdrieon,1479,5,17,3,16,51,59,-8,54
Albion,1479,6,14,9,13,51,47,4,51
Stranraer,1479,7,12,7,17,53,62,-9,43
Peterhead,1479,8,11,9,16,45,54,-9,42
Stenhousem'r,1479,9,9,10,17,49,76,-27,37
Queen's Park,1479,10,9,9,18,35,59,-24,36
Alloa,1480,1,20,8,8,79,40,39,68
Livingston,1480,2,21,2,13,74,54,20,65
Peterhead,1480,3,16,9,11,60,56,4,57
Airdrieon,1480,4,16,7,13,57,63,-6,55
Brechin,1480,5,14,9,13,49,47,2,51
Albion,1480,6,12,10,14,59,59,0,46
East Fife,1480,7,12,9,15,50,55,-5,45
Queen's Park,1480,8,14,3,19,45,50,-5,45
Stranraer,1480,9,11,11,14,48,52,-4,44
Stenhousem'r,1480,10,7,6,23,47,92,-45,27
Alloa,1481,1,21,8,7,74,35,39,71
Airdrieon,1481,2,17,6,13,58,60,-2,57
Livingston,1481,3,18,2,16,75,54,21,56
Brechin,1481,4,16,6,14,44,47,-3,54
Albion,1481,5,15,8,13,52,44,8,53
East Fife,1481,6,14,10,12,50,44,6,52
Peterhead,1481,7,12,9,15,44,54,-10,45
Stranraer,1481,8,12,6,18,49,61,-12,42
Queen's Park,1481,9,11,9,16,38,51,-13,42
Stenhousem'r,1481,10,8,8,20,45,79,-34,32
Livingston,1482,1,21,8,7,79,44,35,71
Brechin,1482,2,18,8,10,59,48,11,62
Airdrieon,1482,3,17,7,12,61,52,9,58
Alloa,1482,4,16,7,13,62,47,15,55
Stranraer,1482,5,16,6,14,62,55,7,54
Queen's Park,1482,6,14,7,15,38,52,-14,49
Peterhead,1482,7,14,6,16,49,55,-6,48
Albion,1482,8,12,9,15,45,48,-3,45
East Fife,1482,9,6,12,18,36,53,-17,30
Stenhousem'r,1482,10,6,10,20,47,84,-37,28
Airdrieon,1483,1,21,4,11,63,49,14,67
Livingston,1483,2,21,3,12,65,48,17,66
Alloa,1483,3,17,11,8,72,48,24,62
Albion,1483,4,13,10,13,57,52,5,49
Peterhead,1483,5,14,7,15,47,52,-5,49
Brechin,1483,6,15,3,18,50,53,-3,48
Queen's Park,1483,7,13,7,16,40,53,-13,46
Stranraer,1483,8,12,7,17,59,63,-4,43
East Fife,1483,9,11,8,17,48,54,-6,41
Stenhousem'r,1483,10,9,8,19,46,75,-29,35
Livingston,1484,1,21,4,11,74,45,29,67
Airdrieon,1484,2,20,7,9,63,52,11,67
Alloa,1484,3,16,13,7,75,45,30,61
Brechin,1484,4,18,7,11,53,44,9,61
Queen's Park,1484,5,13,8,15,41,60,-19,47
Stranraer,1484,6,12,9,15,51,57,-6,45
East Fife,1484,7,10,11,15,50,50,0,41
Peterhead,1484,8,10,8,18,56,67,-11,38
Albion,1484,9,8,11,17,45,59,-14,35
Stenhousem'r,1484,10,7,12,17,51,80,-29,33
Livingston,1485,1,21,5,10,74,48,26,68
Alloa,1485,2,19,10,7,75,46,29,67
Albion,1485,3,15,10,11,55,49,6,55
Brechin,1485,4,15,9,12,50,46,4,54
Airdrieon,1485,5,13,9,14,46,51,-5,48
East Fife,1485,6,12,11,13,54,51,3,47
Stranraer,1485,7,12,6,18,52,55,-3,42
Queen's Park,1485,8,11,7,18,33,55,-22,40
Peterhead,1485,9,8,13,15,48,65,-17,37
Stenhousem'r,1485,10,9,10,17,50,71,-21,37
Airdrieon,1486,1,20,6,10,70,47,23,66
Brechin,1486,2,20,4,12,55,50,5,64
Alloa,1486,3,19,6,11,70,45,25,63
Livingston,1486,4,18,3,15,64,51,13,57
Peterhead,1486,5,16,9,11,50,46,4,57
Queen's Park,1486,6,15,5,16,44,51,-7,50
Albion,1486,7,11,12,13,43,47,-4,45
Stenhousem'r,1486,8,11,7,18,53,79,-26,40
Stranraer,1486,9,9,7,20,42,56,-14,34
East Fife,1486,10,6,11,19,37,56,-19,29
Livingston,1487,1,22,2,12,78,48,30,68
Airdrieon,1487,2,18,8,10,53,47,6,62
Brechin,1487,3,18,6,12,57,48,9,60
Alloa,1487,4,16,6,14,64,52,12,54
Albion,1487,5,14,9,13,48,50,-2,51
Peterhead,1487,6,14,8,14,53,55,-2,50
East Fife,1487,7,12,12,12,46,42,4,48
Queen's Park,1487,8,14,6,16,49,53,-4,48
Stranraer,1487,9,12,6,18,46,59,-13,42
Stenhousem'r,1487,10,5,7,24,45,85,-40,22
Livingston,1488,1,27,2,7,88,39,49,83
Alloa,1488,2,19,6,11,83,45,38,63
Airdrieon,1488,3,18,7,11,54,52,2,61
Brechin,1488,4,17,9,10,53,50,3,60
Peterhead,1488,5,17,6,13,61,55,6,57
Stranraer,1488,6,13,7,16,46,58,-12,46
Albion,1488,7,10,8,18,43,65,-22,38
East Fife,1488,8,9,8,19,47,62,-15,35
Queen's Park,1488,9,9,8,19,44,62,-18,35
Stenhousem'r,1488,10,8,5,23,49,80,-31,29
Alloa,1489,1,20,7,9,87,47,40,67
Livingston,1489,2,21,3,12,76,46,30,66
Brechin,1489,3,20,6,10,49,42,7,66
Albion,1489,4,18,6,12,59,51,8,60
Airdrieon,1489,5,16,9,11,56,57,-1,57
Peterhead,1489,6,16,7,13,54,56,-2,55
Queen's Park,1489,7,10,9,17,40,59,-19,39
Stenhousem'r,1489,8,9,8,19,50,75,-25,35
Stranraer,1489,9,8,7,21,45,65,-20,31
East Fife,1489,10,7,8,21,41,59,-18,29
Alloa,1490,1,19,8,9,71,47,24,65
Livingston,1490,2,16,10,10,72,50,22,58
Brechin,1490,3,17,6,13,54,46,8,57
Albion,1490,4,16,9,11,60,54,6,57
Airdrieon,1490,5,16,8,12,58,54,4,56
East Fife,1490,6,13,9,14,58,47,11,48
Queen's Park,1490,7,12,8,16,31,45,-14,44
Peterhead,1490,8,11,10,15,42,49,-7,43
Stranraer,1490,9,11,7,18,49,71,-22,40
Stenhousem'r,1490,10,7,9,20,52,84,-32,30
Alloa,1491,1,21,6,9,80,43,37,69
Livingston,1491,2,21,4,11,70,47,23,67
Airdrieon,1491,3,17,6,13,71,55,16,57
Albion,1491,4,15,11,10,54,45,9,56
Brechin,1491,5,16,7,13,56,53,3,55
Peterhead,1491,6,14,6,16,51,56,-5,48
Queen's Park,1491,7,14,5,17,33,54,-21,47
Stranraer,1491,8,12,4,20,47,63,-16,40
East Fife,1491,9,10,9,17,48,47,1,39
Stenhousem'r,1491,10,8,6,22,44,91,-47,30
Alloa,1492,1,20,9,7,71,38,33,69
Airdrieon,1492,2,20,7,9,63,47,16,67
Livingston,1492,3,18,5,13,68,50,18,59
Brechin,1492,4,15,8,13,46,45,1,53
Peterhead,1492,5,13,10,13,57,60,-3,49
Queen's Park,1492,6,12,10,14,35,48,-13,46
East Fife,1492,7,11,8,17,45,50,-5,41
Albion,1492,8,10,11,15,45,52,-7,41
Stranraer,1492,9,11,7,18,43,52,-9,40
Stenhousem'r,1492,10,10,5,21,55,86,-31,35
Livingston,1493,1,20,4,12,74,42,32,64
Airdrieon,1493,2,18,9,9,66,49,17,63
Alloa,1493,3,18,8,10,66,44,22,62
Peterhead,1493,4,16,10,10,59,47,12,58
Brechin,1493,5,15,7,14,55,64,-9,52
East Fife,1493,6,14,9,13,48,44,4,51
Albion,1493,7,12,8,16,51,66,-15,44
Stranraer,1493,8,11,7,18,47,58,-11,40
Queen's Park,1493,9,10,9,17,34,56,-22,39
Stenhousem'r,1493,10,6,9,21,43,73,-30,27
Livingston,1494,1,22,4,10,78,44,34,70
Alloa,1494,2,19,6,11,60,33,27,63
Peterhead,1494,3,16,8,12,58,49,9,56
Brechin,1494,4,17,4,15,48,55,-7,55
Stranraer,1494,5,14,7,15,57,52,5,49
Queen's Park,1494,6,13,9,14,39,48,-9,48
Albion,1494,7,13,8,15,51,50,1,47
Airdrieon,1494,8,13,8,15,52,65,-13,47
East Fife,1494,9,10,10,16,45,52,-7,40
Stenhousem'r,1494,10,6,10,20,39,79,-40,28
Livingston,1495,1,23,0,13,77,50,27,69
Airdrieon,1495,2,20,7,9,67,56,11,67
Brechin,1495,3,18,8,10,60,48,12,62
Albion,1495,4,15,9,12,67,54,13,54
Alloa,1495,5,15,9,12,65,53,12,54
Stranraer,1495,6,14,8,14,57,61,-4,50
Peterhead,1495,7,12,10,14,46,49,-3,46
Queen's Park,1495,8,9,11,16,36,53,-17,38
East Fife,1495,9,8,9,19,52,63,-11,33
Stenhousem'r,1495,10,7,7,22,48,88,-40,28
Livingston,1496,1,21,2,13,81,49,32,65
Airdrieon,1496,2,19,8,9,61,50,11,65
Peterhead,1496,3,16,8,12,63,51,12,56
Brechin,1496,4,14,10,12,45,48,-3,52
Alloa,1496,5,14,9,13,62,55,7,51
Albion,1496,6,14,9,13,52,48,4,51
Queen's Park,1496,7,13,9,14,41,48,-7,48
Stranraer,1496,8,12,7,17,45,61,-16,43
East Fife,1496,9,9,10,17,39,48,-9,37
Stenhousem'r,1496,10,7,10,19,53,84,-31,31
Alloa,1497,1,17,10,9,59,38,21,61
Airdrieon,1497,2,18,5,13,57,52,5,59
Albion,1497,3,17,7,12,57,45,12,58
Peterhead,1497,4,18,4,14,56,50,6,58
Brechin,1497,5,17,6,13,53,45,8,57
Livingston,1497,6,16,8,12,65,50,15,56
Stranraer,1497,7,14,5,17,49,53,-4,47
Queen's Park,1497,8,13,7,16,37,47,-10,46
East Fife,1497,9,10,8,18,42,58,-16,38
Stenhousem'r,1497,10,7,6,23,38,75,-37,27
Alloa,1498,1,20,7,9,82,42,40,67
Livingston,1498,2,21,2,13,85,53,32,65
Brechin,1498,3,19,4,13,59,52,7,61
Airdrieon,1498,4,15,9,12,62,59,3,54
Albion,1498,5,14,9,13,55,57,-2,51
Peterhead,1498,6,12,8,16,47,55,-8,44
Stranraer,1498,7,12,7,17,49,66,-17,43
Queen's Park,1498,8,12,7,17,30,55,-25,43
East Fife,1498,9,10,12,14,51,53,-2,42
Stenhousem'r,1498,10,8,9,19,55,83,-28,33
Airdrieon,1499,1,22,5,9,69,49,20,71
Livingston,1499,2,21,6,9,77,44,33,69
Alloa,1499,3,19,7,10,69,44,25,64
Albion,1499,4,18,7,11,57,47,10,61
Brechin,1499,5,19,4,13,57,48,9,61
East Fife,1499,6,10,14,12,49,43,6,44
Peterhead,1499,7,13,5,18,47,55,-8,44
Stranraer,1499,8,13,4,19,46,54,-8,43
Queen's Park,1499,9,8,5,23,24,59,-35,29
Stenhousem'r,1499,10,4,9,23,36,88,-52,21
Livingston,1500,1,20,8,8,68,45,23,68
Alloa,1500,2,18,10,8,74,45,29,64
Brechin,1500,3,19,5,12,52,46,6,62
Airdrieon,1500,4,16,6,14,55,51,4,54
Stranraer,1500,5,16,5,15,59,57,2,53
Albion,1500,6,13,11,12,61,58,3,50
Peterhead,1500,7,12,10,14,47,53,-6,46
East Fife,1500,8,9,12,15,49,49,0,39
Queen's Park,1500,9,9,6,21,36,61,-25,33
Stenhousem'r,1500,10,6,11,19,42,78,-36,29
Livingston,1501,1,21,7,8,80,41,39,70
Alloa,1501,2,18,6,12,66,44,22,60
Brechin,1501,3,14,12,10,52,47,5,54
Airdrieon,1501,4,16,6,14,52,57,-5,54
Albion,1501,5,13,9,14,58,52,6,48
Peterhead,1501,6,14,6,16,42,45,-3,48
Queen's Park,1501,7,13,9,14,39,44,-5,48
Stranraer,1501,8,12,7,17,46,59,-13,43
East Fife,1501,9,11,9,16,44,57,-13,42
Stenhousem'r,1501,10,9,7,20,45,78,-33,34
Livingston,1502,1,21,7,8,82,43,39,70
Alloa,1502,2,17,10,9,68,50,18,61
Queen's Park,1502,3,18,7,11,46,49,-3,61
Brechin,1502,4,17,7,12,48,39,9,58
Airdrieon,1502,5,15,5,16,55,54,1,50
East Fife,1502,6,13,10,13,46,37,9,49
Albion,1502,7,13,7,16,47,53,-6,46
Stranraer,1502,8,12,5,19,53,65,-12,41
Peterhead,1502,9,9,8,19,43,67,-24,35
Stenhousem'r,1502,10,8,8,20,44,75,-31,32
Alloa,1503,1,21,7,8,63,40,23,70
Livingston,1503,2,19,5,12,74,54,20,62
Airdrieon,1503,3,19,3,14,68,52,16,60
Brechin,1503,4,16,8,12,53,49,4,56
Albion,1503,5,15,6,15,59,57,2,51
East Fife,1503,6,13,10,13,61,50,11,49
Stranraer,1503,7,13,7,16,61,63,-2,46
Peterhead,1503,8,12,8,16,48,59,-11,44
Queen's Park,1503,9,11,11,14,39,53,-14,44
Stenhousem'r,1503,10,5,7,24,44,93,-49,22
Livingston,1504,1,25,3,8,83,51,32,78
Alloa,1504,2,18,8,10,73,48,25,62
Albion,1504,3,18,6,12,59,52,7,60
Brechin,1504,4,16,9,11,55,52,3,57
Peterhead,1504,5,15,9,12,54,47,7,54
Airdrieon,1504,6,14,9,13,64,65,-1,51
East Fife,1504,7,8,14,14,56,59,-3,38
Queen's Park,1504,8,9,10,17,41,59,-18,37
Stranraer,1504,9,9,7,20,47,64,-17,34
Stenhousem'r,1504,10,6,9,21,52,87,-35,27
Alloa,1505,1,24,4,8,84,36,48,76
Livingston,1505,2,21,4,11,72,45,27,67
Airdrieon,1505,3,20,5,11,63,58,5,65
Stranraer,1505,4,17,3,16,46,56,-10,54
Peterhead,1505,5,14,8,14,57,55,2,50
Brechin,1505,6,15,5,16,50,53,-3,50
Albion,1505,7,11,10,15,56,59,-3,43
Queen's Park,1505,8,11,8,17,33,61,-28,41
East Fife,1505,9,10,10,16,43,44,-1,40
Stenhousem'r,1505,10,5,7,24,41,78,-37,22
Livingston,1506,1,20,6,10,81,48,33,66
Alloa,1506,2,19,8,9,72,46,26,65
Peterhead,1506,3,17,7,12,52,38,14,58
Airdrieon,1506,4,16,7,13,56,55,1,55
Albion,1506,5,16,6,14,49,46,3,54
Brechin,1506,6,15,7,14,49,46,3,52
East Fife,1506,7,13,11,12,50,44,6,50
Stranraer,1506,8,13,6,17,43,52,-9,45
Queen's Park,1506,9,11,4,21,29,60,-31,37
Stenhousem'r,1506,10,6,6,24,45,91,-46,24
Alloa,1507,1,20,7,9,72,37,35,67
Airdrieon,1507,2,18,6,12,67,57,10,60
Livingston,1507,3,17,7,12,64,47,17,58
Albion,1507,4,15,10,11,57,47,10,55
Brechin,1507,5,17,4,15,52,54,-2,55
Stranraer,1507,6,14,5,17,47,55,-8,47
East Fife,1507,7,13,7,16,45,44,1,46
Stenhousem'r,1507,8,14,3,19,55,77,-22,45
Peterhead,1507,9,12,7,17,50,57,-7,43
Queen's Park,1507,10,11,2,23,26,60,-34,35
Alloa,1508,1,20,7,9,75,48,27,67
Airdrieon,1508,2,18,7,11,62,54,8,61
Brechin,1508,3,15,11,10,54,48,6,56
Stranraer,1508,4,17,5,14,54,56,-2,56
Livingston,1508,5,18,1,17,72,53,19,55
Peterhead,1508,6,16,7,13,55,50,5,55
East Fife,1508,7,13,6,17,45,47,-2,45
Albion,1508,8,11,9,16,51,56,-5,42
Queen's Park,1508,9,12,6,18,32,50,-18,42
Stenhousem'r,1508,10,7,7,22,43,81,-38,28
Alloa,1509,1,21,7,8,72,46,26,70
Airdrieon,1509,2,20,4,12,52,42,10,64
Livingston,1509,3,18,7,11,65,45,20,61
Albion,1509,4,15,9,12,57,54,3,54
Peterhead,1509,5,16,5,15,46,39,7,53
East Fife,1509,6,11,12,13,46,41,5,45
Queen's Park,1509,7,13,6,17,43,51,-8,45
Brechin,1509,8,11,9,16,38,50,-12,42
Stranraer,1509,9,10,8,18,40,56,-16,38
Stenhousem'r,1509,10,7,9,20,43,78,-35,30
Livingston,1510,1,27,2,7,82,39,43,83
Alloa,1510,2,16,10,10,64,45,19,58
Peterhead,1510,3,16,9,11,51,47,4,57
Airdrieon,1510,4,15,8,13,54,50,4,53
Albion,1510,5,14,8,14,48,45,3,50
Brechin,1510,6,15,4,17,50,54,-4,49
Stranraer,1510,7,14,6,16,45,55,-10,48
East Fife,1510,8,10,8,18,42,50,-8,38
Queen's Park,1510,9,10,7,19,34,50,-16,37
Stenhousem'r,1510,10,7,10,19,41,76,-35,31
Alloa,1511,1,18,10,8,67,45,22,64
Brechin,1511,2,18,9,9,65,45,20,63
Livingston,1511,3,18,6,12,75,56,19,60
Airdrieon,1511,4,16,11,9,59,49,10,59
Albion,1511,5,13,13,10,61,55,6,52
Peterhead,1511,6,13,11,12,44,45,-1,50
Stranraer,1511,7,13,7,16,52,62,-10,46
East Fife,1511,8,9,8,19,47,57,-10,35
Stenhousem'r,1511,9,9,8,19,47,74,-27,35
Queen's Park,1511,10,8,7,21,26,55,-29,31
Alloa,1512,1,23,5,8,78,41,37,74
Livingston,1512,2,21,5,10,76,47,29,68
Brechin,1512,3,20,3,13,57,44,13,63
Airdrieon,1512,4,15,7,14,47,52,-5,52
Queen's Park,1512,5,13,9,14,43,49,-6,48
Albion,1512,6,12,8,16,43,49,-6,44
Stenhousem'r,1512,7,12,8,16,46,62,-16,44
East Fife,1512,8,11,8,17,46,48,-2,41
Peterhead,1512,9,10,8,18,38,53,-15,38
Stranraer,1512,10,10,5,21,43,72,-29,35
Alloa,1513,1,22,5,9,75,41,34,71
Livingston,1513,2,21,3,12,79,55,24,66
Airdrieon,1513,3,16,8,12,54,55,-1,56
Brechin,1513,4,16,4,16,61,59,2,52
Peterhead,1513,5,13,10,13,57,55,2,49
Albion,1513,6,12,10,14,52,52,0,46
East Fife,1513,7,13,7,16,49,50,-1,46
Stranraer,1513,8,14,3,19,56,68,-12,45
Stenhousem'r,1513,9,11,7,18,55,78,-23,40
Queen's Park,1513,10,11,5,20,32,57,-25,38
Livingston,1514,1,19,7,10,80,55,25,64
Alloa,1514,2,16,9,11,67,49,18,57
Peterhead,1514,3,16,6,14,50,53,-3,54
Airdrieon,1514,4,15,8,13,54,52,2,53
Brechin,1514,5,13,11,12,49,49,0,50
Queen's Park,1514,6,15,5,16,47,56,-9,50
Stranraer,1514,7,14,7,15,56,53,3,49
East Fife,1514,8,13,9,14,50,50,0,48
Stenhousem'r,1514,9,10,8,18,54,78,-24,38
Albion,1514,10,9,10,17,51,63,-12,37
Livingston,1515,1,22,5,9,79,44,35,71
Alloa,1515,2,18,10,8,67,40,27,64
Airdrieon,1515,3,19,4,13,55,46,9,61
Brechin,1515,4,16,4,16,51,50,1,52
Queen's Park,1515,5,15,5,16,34,49,-15,50
Albion,1515,6,14,7,15,52,49,3,49
East Fife,1515,7,13,7,16,53,49,4,46
Peterhead,1515,8,11,13,12,46,49,-3,46
Stranraer,1515,9,11,4,21,46,72,-26,37
Stenhousem'r,1515,10,8,7,21,44,79,-35,31
Livingston,1516,1,22,4,10,73,44,29,70
Airdrieon,1516,2,19,7,10,67,55,12,64
Alloa,1516,3,18,6,12,71,53,18,60
Albion,1516,4,15,9,12,69,52,17,54
East Fife,1516,5,14,10,12,54,40,14,52
Queen's Park,1516,6,12,12,12,34,39,-5,48
Brechin,1516,7,13,8,15,41,52,-11,47
Peterhead,1516,8,13,7,16,47,59,-12,46
Stranraer,1516,9,8,7,21,43,65,-22,31
Stenhousem'r,1516,10,7,8,21,48,88,-40,29
Alloa,1517,1,20,8,8,69,42,27,68
Livingston,1517,2,21,3,12,75,50,25,66
Peterhead,1517,3,16,9,11,54,45,9,57
Airdrieon,1517,4,17,4,15,58,57,1,55
East Fife,1517,5,14,10,12,52,41,11,52
Stranraer,1517,6,15,5,16,51,58,-7,50
Albion,1517,7,13,8,15,50,48,2,47
Brechin,1517,8,13,7,16,46,52,-6,46
Queen's Park,1517,9,9,12,15,35,54,-19,39
Stenhousem'r,1517,10,6,6,24,38,81,-43,24
Alloa,1518,1,21,6,9,92,52,40,69
Airdrieon,1518,2,18,7,11,64,56,8,61
Livingston,1518,3,19,3,14,66,48,18,60
Peterhead,1518,4,16,8,12,50,48,2,56
Stranraer,1518,5,15,8,13,55,50,5,53
Brechin,1518,6,14,9,13,48,50,-2,51
Albion,1518,7,14,8,14,54,52,2,50
East Fife,1518,8,10,9,17,48,59,-11,39
Queen's Park,1518,9,11,6,19,37,57,-20,39
Stenhousem'r,1518,10,7,6,23,43,85,-42,27
Alloa,1519,1,21,6,9,80,43,37,69
Peterhead,1519,2,19,7,10,53,48,5,64
Livingston,1519,3,17,5,14,65,52,13,56
Airdrieon,1519,4,16,8,12,59,57,2,56
Brechin,1519,5,16,7,13,47,47,0,55
Albion,1519,6,15,8,13,56,54,2,53
Stranraer,1519,7,15,5,16,57,57,0,50
Queen's Park,1519,8,12,7,17,45,53,-8,43
East Fife,1519,9,8,9,19,44,53,-9,33
Stenhousem'r,1519,10,7,6,23,41,83,-42,27
Livingston,1520,1,22,7,7,82,45,37,73
Alloa,1520,2,18,7,11,79,48,31,61
Airdrieon,1520,3,18,7,11,60,50,10,61
Brechin,1520,4,15,8,13,49,53,-4,53
Albion,1520,5,15,7,14,56,51,5,52
East Fife,1520,6,13,8,15,50,50,0,47
Stranraer,1520,7,12,6,18,55,63,-8,42
Queen's Park,1520,8,10,9,17,40,60,-20,39
Stenhousem'r,1520,9,10,7,19,41,70,-29,37
Peterhead,1520,10,8,12,16,46,68,-22,36
Alloa,1521,1,21,9,6,69,34,35,72
Livingston,1521,2,21,7,8,79,48,31,70
Airdrieon,1521,3,15,11,10,59,50,9,56
Queen's Park,1521,4,14,7,15,36,40,-4,49
East Fife,1521,5,12,12,12,46,43,3,48
Peterhead,1521,6,14,6,16,52,52,0,48
Brechin,1521,7,13,8,15,38,48,-10,47
Albion,1521,8,12,10,14,46,47,-1,46
Stranraer,1521,9,10,8,18,49,61,-12,38
Stenhousem'r,1521,10,6,6,24,39,90,-51,24
Livingston,1522,1,22,5,9,77,42,35,71
Alloa,1522,2,21,8,7,72,40,32,71
Airdrieon,1522,3,17,6,13,57,57,0,57
Albion,1522,4,14,10,12,53,53,0,52
Brechin,1522,5,14,5,17,49,50,-1,47
East Fife,1522,6,12,10,14,49,46,3,46
Peterhead,1522,7,13,7,16,46,53,-7,46
Stranraer,1522,8,11,6,19,54,65,-11,39
Queen's Park,1522,9,10,8,18,35,56,-21,38
Stenhousem'r,1522,10,10,7,19,46,76,-30,37
Livingston,1523,1,20,7,9,70,46,24,67
Brechin,1523,2,19,6,11,60,51,9,63
Alloa,1523,3,17,9,10,70,45,25,60
Albion,1523,4,15,9,12,56,48,8,54
Stranraer,1523,5,13,8,15,47,49,-2,47
East Fife,1523,6,13,7,16,50,48,2,46
Airdrieon,1523,7,12,7,17,51,65,-14,43
Peterhead,1523,8,10,12,14,45,56,-11,42
Stenhousem'r,1523,9,10,9,17,56,76,-20,39
Queen's Park,1523,10,10,8,18,36,57,-21,38
Airdrieon,1524,1,21,7,8,65,55,10,70
Livingston,1524,2,19,7,10,80,48,32,64
Alloa,1524,3,18,7,11,67,47,20,61
Peterhead,1524,4,17,7,12,55,46,9,58
Brechin,1524,5,15,5,16,47,49,-2,50
Queen's Park,1524,6,12,10,14,48,50,-2,46
Stranraer,1524,7,11,9,16,55,62,-7,42
East Fife,1524,8,9,14,13,50,50,0,41
Albion,1524,9,10,11,15,43,54,-11,41
Stenhousem'r,1524,10,6,7,23,45,94,-49,25
Alloa,1525,1,21,7,8,76,42,34,70
Livingston,1525,2,19,6,11,74,50,24,63
Airdrieon,1525,3,18,6,12,62,64,-2,60
Brechin,1525,4,16,8,12,52,51,1,56
Stranraer,1525,5,16,6,14,60,54,6,54
Albion,1525,6,14,6,16,55,58,-3,48
East Fife,1525,7,12,11,13,58,47,11,47
Queen's Park,1525,8,11,9,16,41,52,-11,42
Peterhead,1525,9,10,6,20,38,65,-27,36
Stenhousem'r,1525,10,6,9,21,53,86,-33,27
Airdrieon,1526,1,23,7,6,63,39,24,76
Livingston,1526,2,24,3,9,79,46,33,75
Peterhead,1526,3,17,7,12,50,46,4,58
Alloa,1526,4,16,9,11,67,50,17,57
Brechin,1526,5,16,7,13,60,46,14,55
Albion,1526,6,12,8,16,47,53,-6,44
Stranraer,1526,7,12,5,19,53,64,-11,41
Queen's Park,1526,8,11,6,19,41,60,-19,39
East Fife,1526,9,8,7,21,45,59,-14,31
Stenhousem'r,1526,10,7,9,20,37,79,-42,30
Alloa,1527,1,19,12,5,67,37,30,69
Airdrieon,1527,2,20,8,8,63,38,25,68
Livingston,1527,3,21,3,12,71,52,19,66
Brechin,1527,4,16,10,10,52,42,10,58
Queen's Park,1527,5,13,6,17,37,49,-12,45
Peterhead,1527,6,11,11,14,57,59,-2,44
Albion,1527,7,10,10,16,48,63,-15,40
Stranraer,1527,8,10,7,19,52,67,-15,37
East Fife,1527,9,8,11,17,41,55,-14,35
Stenhousem'r,1527,10,8,10,18,43,69,-26,34
Airdrieon,1528,1,21,5,10,66,50,16,68
Alloa,1528,2,20,5,11,72,41,31,65
Brechin,1528,3,17,12,7,56,41,15,63
Livingston,1528,4,14,11,11,66,53,13,53
East Fife,1528,5,12,11,13,48,39,9,47
Peterhead,1528,6,12,11,13,51,62,-11,47
Albion,1528,7,11,9,16,46,57,-11,42
Stranraer,1528,8,11,7,18,50,62,-12,40
Queen's Park,1528,9,10,9,17,35,55,-20,39
Stenhousem'r,1528,10,6,12,18,46,76,-30,30
Livingston,1529,1,21,3,12,67,46,21,66
Alloa,1529,2,18,8,10,69,46,23,62
Queen's Park,1529,3,17,4,15,37,46,-9,55
Peterhead,1529,4,15,9,12,52,42,10,54
Brechin,1529,5,16,6,14,53,53,0,54
Stranraer,1529,6,15,4,17,52,56,-4,49
Albion,1529,7,13,8,15,48,48,0,47
Airdrieon,1529,8,13,5,18,44,59,-15,44
East Fife,1529,9,11,7,18,47,49,-2,40
Stenhousem'r,1529,10,11,6,19,46,70,-24,39
Livingston,1530,1,27,3,6,90,41,49,84
Alloa,1530,2,17,9,10,68,53,15,60
Albion,1530,3,17,7,12,49,48,1,58
Peterhead,1530,4,16,9,11,53,46,7,57
Brechin,1530,5,15,9,12,45,46,-1,54
Airdrieon,1530,6,13,8,15,52,62,-10,47
Queen's Park,1530,7,12,7,17,41,48,-7,43
Stranraer,1530,8,11,5,20,51,62,-11,38
Stenhousem'r,1530,9,7,10,19,44,77,-33,31
East Fife,1530,10,7,9,20,38,48,-10,30
Livingston,1531,1,20,5,11,76,44,32,65
Alloa,1531,2,16,12,8,65,42,23,60
Airdrieon,1531,3,16,8,12,66,59,7,56
Brechin,1531,4,16,7,13,55,53,2,55
Albion,1531,5,16,6,14,58,51,7,54
Peterhead,1531,6,14,11,11,54,46,8,53
Stranraer,1531,7,14,4,18,50,54,-4,46
East Fife,1531,8,13,6,17,49,61,-12,45
Queen's Park,1531,9,10,7,19,37,63,-26,37
Stenhousem'r,1531,10,8,8,20,48,85,-37,32
Livingston,1532,1,20,6,10,78,46,32,66
Alloa,1532,2,18,9,9,67,44,23,63
Airdrieon,1532,3,18,8,10,61,48,13,62
Peterhead,1532,4,16,8,12,51,47,4,56
Queen's Park,1532,5,15,7,14,45,50,-5,52
Albion,1532,6,14,9,13,55,59,-4,51
Stranraer,1532,7,14,3,19,48,60,-12,45
Brechin,1532,8,12,6,18,44,52,-8,42
East Fife,1532,9,10,8,18,49,56,-7,38
Stenhousem'r,1532,10,7,8,21,41,77,-36,29
Alloa,1533,1,21,8,7,84,44,40,71
Livingston,1533,2,23,1,12,76,50,26,70
Airdrieon,1533,3,17,7,12,67,61,6,58
Albion,1533,4,17,6,13,61,48,13,57
Brechin,1533,5,16,6,14,60,65,-5,54
Peterhead,1533,6,11,12,13,49,57,-8,45
Stranraer,1533,7,12,5,19,54,64,-10,41
Queen's Park,1533,8,11,8,17,39,55,-16,41
East Fife,1533,9,9,10,17,54,57,-3,37
Stenhousem'r,1533,10,8,7,21,41,84,-43,31
Livingston,1534,1,21,5,10,72,46,26,68
Alloa,1534,2,17,9,10,63,39,24,60
Airdrieon,1534,3,16,11,9,59,49,10,59
Peterhead,1534,4,15,5,16,47,44,3,50
Brechin,1534,5,14,8,14,55,57,-2,50
Albion,1534,6,11,12,13,53,63,-10,45
East Fife,1534,7,12,8,16,47,46,1,44
Stenhousem'r,1534,8,11,10,15,52,76,-24,43
Stranraer,1534,9,12,5,19,41,53,-12,41
Queen's Park,1534,10,10,9,17,36,52,-16,39
Livingston,1535,1,23,4,9,82,42,40,73
Peterhead,1535,2,21,7,8,61,40,21,70
Alloa,1535,3,15,10,11,68,49,19,55
Brechin,1535,4,15,8,13,54,51,3,53
Airdrieon,1535,5,15,8,13,60,58,2,53
Albion,1535,6,12,11,13,60,55,5,47
East Fife,1535,7,11,13,12,45,48,-3,46
Stranraer,1535,8,10,8,18,49,64,-15,38
Queen's Park,1535,9,8,9,19,40,68,-28,33
Stenhousem'r,1535,10,4,14,18,45,89,-44,26
Airdrieon,1536,1,21,8,7,71,50,21,71
Livingston,1536,2,19,7,10,78,55,23,64
Alloa,1536,3,18,8,10,72,45,27,62
Albion,1536,4,14,11,11,53,51,2,53
Queen's Park,1536,5,14,10,12,44,49,-5,52
Brechin,1536,6,14,4,18,47,53,-6,46
Peterhead,1536,7,13,7,16,51,59,-8,46
Stranraer,1536,8,13,6,17,62,61,1,45
East Fife,1536,9,8,10,18,41,63,-22,34
Stenhousem'r,1536,10,7,7,22,45,78,-33,28
Alloa,1537,1,19,9,8,77,41,36,66
Livingston,1537,2,19,6,11,65,43,22,63
Airdrieon,1537,3,17,9,10,55,54,1,60
Albion,1537,4,16,7,13,62,48,14,55
Brechin,1537,5,15,7,14,43,50,-7,52
Peterhead,1537,6,14,6,16,48,56,-8,48
East Fife,1537,7,12,10,14,58,52,6,46
Stranraer,1537,8,12,4,20,43,56,-13,40
Queen's Park,1537,9,11,7,18,33,52,-19,40
Stenhousem'r,1537,10,8,9,19,43,75,-32,33
Livingston,1538,1,22,2,12,79,49,30,68
Alloa,1538,2,20,5,11,63,41,22,65
Airdrieon,1538,3,17,5,14,55,56,-1,56
Albion,1538,4,15,9,12,53,53,0,54
Brechin,1538,5,17,3,16,45,45,0,54
Stranraer,1538,6,15,4,17,44,45,-1,49
East Fife,1538,7,13,8,15,46,42,4,47
Peterhead,1538,8,12,8,16,46,56,-10,44
Queen's Park,1538,9,11,8,17,28,46,-18,41
Stenhousem'r,1538,10,8,8,20,47,73,-26,32
Alloa,1539,1,21,7,8,86,43,43,70
Livingston,1539,2,19,6,11,80,57,23,63
Brechin,1539,3,18,7,11,57,48,9,61
Peterhead,1539,4,14,7,15,57,61,-4,49
Queen's Park,1539,5,14,6,16,41,59,-18,48
Airdrieon,1539,6,13,8,15,60,70,-10,47
Stranraer,1539,7,14,4,18,47,62,-15,46
East Fife,1539,8,11,11,14,48,53,-5,44
Albion,1539,9,11,9,16,50,58,-8,42
Stenhousem'r,1539,10,7,11,18,60,75,-15,32
Livingston,1540,1,25,1,10,84,46,38,76
Alloa,1540,2,19,5,12,69,42,27,62
Peterhead,1540,3,17,6,13,53,51,2,57
Brechin,1540,4,17,4,15,54,45,9,55
Airdrieon,1540,5,15,9,12,63,62,1,54
Albion,1540,6,14,6,16,49,50,-1,48
East Fife,1540,7,12,10,14,49,55,-6,46
Stranraer,1540,8,13,5,18,51,61,-10,44
Queen's Park,1540,9,11,8,17,35,58,-23,41
Stenhousem'r,1540,10,6,8,22,50,87,-37,26
Alloa,1541,1,20,6,10,70,45,25,66
Peterhead,1541,2,17,7,12,57,48,9,58
Airdrieon,1541,3,16,7,13,57,50,7,55
Brechin,1541,4,16,7,13,48,49,-1,55
Albion,1541,5,14,10,12,59,53,6,52
Stranraer,1541,6,15,7,14,59,57,2,52
Livingston,1541,7,16,3,17,62,54,8,51
Queen's Park,1541,8,15,6,15,43,46,-3,51
East Fife,1541,9,8,10,18,42,59,-17,34
Stenhousem'r,1541,10,7,9,20,51,87,-36,30
Livingston,1542,1,24,4,8,88,43,45,76
Alloa,1542,2,18,6,12,64,53,11,60
Airdrieon,1542,3,16,9,11,61,46,15,57
Peterhead,1542,4,15,10,11,65,59,6,55
Albion,1542,5,14,12,10,57,49,8,54
Brechin,1542,6,15,3,18,51,58,-7,48
Stranraer,1542,7,13,6,17,43,57,-14,45
Queen's Park,1542,8,11,9,16,42,46,-4,42
East Fife,1542,9,9,9,18,47,61,-14,36
Stenhousem'r,1542,10,8,6,22,40,86,-46,30
Alloa,1543,1,22,6,8,82,44,38,72
Airdrieon,1543,2,20,6,10,71,54,17,66
Livingston,1543,3,19,4,13,84,58,26,61
Brechin,1543,4,17,5,14,51,48,3,56
East Fife,1543,5,15,7,14,59,41,18,52
Stranraer,1543,6,15,3,18,54,63,-9,48
Albion,1543,7,12,10,14,46,50,-4,46
Queen's Park,1543,8,12,6,18,34,61,-27,42
Peterhead,1543,9,11,8,17,49,65,-16,41
Stenhousem'r,1543,10,5,9,22,38,84,-46,24
Alloa,1544,1,21,8,7,76,38,38,71
Livingston,1544,2,17,5,14,64,51,13,56
Peterhead,1544,3,16,7,13,52,48,4,55
East Fife,1544,4,15,8,13,59,50,9,53
Albion,1544,5,15,7,14,46,41,5,52
Brechin,1544,6,14,7,15,36,43,-7,49
Airdrieon,1544,7,13,9,14,50,59,-9,48
Queen's Park,1544,8,13,8,15,42,56,-14,47
Stranraer,1544,9,10,7,19,52,65,-13,37
Stenhousem'r,1544,10,9,8,19,48,74,-26,35
Livingston,1545,1,23,5,8,85,43,42,74
Alloa,1545,2,22,8,6,81,44,37,74
Brechin,1545,3,16,7,13,58,55,3,55
Airdrieon,1545,4,15,6,15,62,64,-2,51
East Fife,1545,5,13,10,13,60,53,7,49
Albion,1545,6,14,7,15,48,54,-6,49
Queen's Park,1545,7,12,8,16,41,54,-13,44
Peterhead,1545,8,10,13,13,49,61,-12,43
Stranraer,1545,9,11,7,18,44,57,-13,40
Stenhousem'r,1545,10,5,7,24,37,80,-43,22
Alloa,1546,1,23,3,10,79,47,32,72
Peterhead,1546,2,20,6,10,65,46,19,66
Livingston,1546,3,20,5,11,75,48,27,65
Airdrieon,1546,4,19,5,12,62,49,13,62
Stranraer,1546,5,15,5,16,53,59,-6,50
Brechin,1546,6,14,8,14,41,51,-10,50
Albion,1546,7,13,6,17,56,54,2,45
Queen's Park,1546,8,11,6,19,39,60,-21,39
East Fife,1546,9,8,8,20,51,66,-15,32
Stenhousem'r,1546,10,8,6,22,47,88,-41,30
Airdrieon,1547,1,20,6,10,68,51,17,66
Alloa,1547,2,19,7,10,82,44,38,64
Livingston,1547,3,20,4,12,91,56,35,64
Peterhead,1547,4,16,5,15,61,57,4,53
Queen's Park,1547,5,15,8,13,50,55,-5,53
East Fife,1547,6,11,15,10,48,46,2,48
Albion,1547,7,12,6,18,46,61,-15,42
Stranraer,1547,7,11,9,16,46,61,-15,42
Stenhousem'r,1547,9,8,10,18,46,76,-30,34
Brechin,1547,10,8,10,18,39,70,-31,34
Livingston,1548,1,20,8,8,85,52,33,68
Airdrieon,1548,2,18,4,14,53,47,6,58
Alloa,1548,3,16,8,12,64,47,17,56
Peterhead,1548,4,15,8,13,53,56,-3,53
Brechin,1548,5,14,9,13,47,56,-9,51
East Fife,1548,6,13,9,14,47,42,5,48
Queen's Park,1548,7,13,8,15,44,50,-6,47
Albion,1548,8,12,10,14,57,56,1,46
Stranraer,1548,9,13,2,21,47,64,-17,41
Stenhousem'r,1548,10,11,4,21,46,73,-27,37
Alloa,1549,1,18,11,7,67,40,27,65
Livingston,1549,2,20,4,12,71,43,28,64
Airdrieon,1549,3,16,10,10,62,55,7,58
Albion,1549,4,15,9,12,52,44,8,54
Queen's Park,1549,5,15,8,13,41,46,-5,53
Peterhead,1549,6,15,7,14,46,52,-6,52
Brechin,1549,7,12,11,13,52,56,-4,47
Stranraer,1549,8,13,6,17,50,58,-8,45
East Fife,1549,9,7,9,20,43,54,-11,30
Stenhousem'r,1549,10,7,9,20,48,84,-36,30
Brechin,1550,1,20,6,10,63,47,16,66
Livingston,1550,2,17,8,11,64,45,19,59
Stranraer,1550,3,16,7,13,56,47,9,55
Airdrieon,1550,4,16,7,13,62,55,7,55
Queen's Park,1550,5,17,4,15,40,47,-7,55
Alloa,1550,6,13,10,13,59,50,9,49
Albion,1550,7,13,9,14,43,43,0,48
Peterhead,1550,8,13,7,16,46,56,-10,46
Stenhousem'r,1550,9,9,8,19,39,70,-31,35
East Fife,1550,10,7,12,17,36,48,-12,33
Livingston,1551,1,21,3,12,74,51,23,66
Brechin,1551,2,20,4,12,47,42,5,64
Alloa,1551,3,18,9,9,69,46,23,63
Albion,1551,4,16,7,13,50,51,-1,55
Airdrieon,1551,5,17,4,15,50,53,-3,55
Peterhead,1551,6,15,9,12,53,51,2,54
Stranraer,1551,7,11,10,15,59,56,3,43
Queen's Park,1551,8,12,7,17,36,51,-15,43
East Fife,1551,9,8,11,17,40,52,-12,35
Stenhousem'r,1551,10,7,6,23,55,80,-25,27
Airdrieon,1552,1,21,5,10,59,44,15,68
Brechin,1552,2,20,5,11,72,58,14,65
Livingston,1552,3,18,9,9,73,49,24,63
Alloa,1552,4,18,8,10,73,48,25,62
East Fife,1552,5,13,10,13,51,45,6,49
Queen's Park,1552,6,14,3,19,37,51,-14,45
Stranraer,1552,7,13,3,20,53,60,-7,42
Albion,1552,8,12,6,18,51,62,-11,42
Stenhousem'r,1552,9,11,6,19,58,80,-22,39
Peterhead,1552,10,10,5,21,34,64,-30,35
Alloa,1553,1,19,8,9,67,40,27,65
Livingston,1553,2,18,8,10,74,47,27,62
Brechin,1553,3,18,8,10,60,50,10,62
Airdrieon,1553,4,16,8,12,57,49,8,56
Albion,1553,5,15,9,12,54,51,3,54
Peterhead,1553,6,15,8,13,49,50,-1,53
Queen's Park,1553,7,12,11,13,41,49,-8,47
East Fife,1553,8,11,8,17,52,58,-6,41
Stranraer,1553,9,9,5,22,50,69,-19,32
Stenhousem'r,1553,10,6,9,21,36,77,-41,27
Livingston,1554,1,24,5,7,75,37,38,77
Airdrieon,1554,2,19,6,11,75,53,22,63
Brechin,1554,3,19,4,13,59,51,8,61
Alloa,1554,4,18,6,12,72,51,21,60
East Fife,1554,5,14,8,14,55,50,5,50
Peterhead,1554,6,12,8,16,51,56,-5,44
Stranraer,1554,7,12,7,17,51,65,-14,43
Albion,1554,8,10,9,17,48,68,-20,39
Stenhousem'r,1554,9,9,8,19,54,86,-32,35
Queen's Park,1554,10,8,9,19,41,64,-23,33
Livingston,1555,1,23,6,7,91,52,39,75
Airdrieon,1555,2,20,6,10,68,49,19,66
Alloa,1555,3,19,7,10,67,47,20,64
Albion,1555,4,18,7,11,68,47,21,61
Brechin,1555,5,14,5,17,47,54,-7,47
Queen's Park,1555,6,13,7,16,41,50,-9,46
Peterhead,1555,7,12,9,15,45,60,-15,45
East Fife,1555,8,11,9,16,54,49,5,42
Stranraer,1555,9,11,2,23,45,71,-26,35
Stenhousem'r,1555,10,5,10,21,42,89,-47,25
Livingston,1556,1,22,4,10,77,38,39,70
Airdrieon,1556,2,21,7,8,65,41,24,70
Peterhead,1556,3,17,8,11,52,49,3,59
Alloa,1556,4,17,7,12,63,44,19,58
Brechin,1556,5,14,6,16,41,54,-13,48
Queen's Park,1556,6,14,5,17,39,57,-18,47
Albion,1556,7,13,5,18,50,57,-7,44
East Fife,1556,8,11,10,15,42,40,2,43
Stranraer,1556,9,10,7,19,46,64,-18,37
Stenhousem'r,1556,10,7,9,20,36,67,-31,30
Alloa,1557,1,22,7,7,72,38,34,73
Brechin,1557,2,17,8,11,63,51,12,59
Airdrieon,1557,3,17,8,11,61,53,8,59
East Fife,1557,4,16,9,11,58,44,14,57
Livingston,1557,5,16,7,13,70,49,21,55
Albion,1557,6,13,8,15,49,53,-4,47
Peterhead,1557,7,12,8,16,48,61,-13,44
Stranraer,1557,8,12,5,19,43,62,-19,41
Queen's Park,1557,9,12,4,20,34,54,-20,40
Stenhousem'r,1557,10,6,10,20,53,86,-33,28
Livingston,1558,1,20,6,10,70,46,24,66
Airdrieon,1558,2,19,5,12,58,49,9,62
Alloa,1558,3,17,8,11,74,55,19,59
Peterhead,1558,4,15,8,13,51,54,-3,53
Stranraer,1558,5,14,10,12,54,52,2,52
East Fife,1558,6,12,12,12,62,46,16,48
Brechin,1558,7,12,9,15,47,55,-8,45
Albion,1558,8,12,7,17,49,53,-4,43
Queen's Park,1558,9,11,6,19,37,64,-27,39
Stenhousem'r,1558,10,10,5,21,48,76,-28,35
Livingston,1559,1,23,3,10,78,47,31,72
Alloa,1559,2,21,6,9,72,39,33,69
Airdrieon,1559,3,16,11,9,57,46,11,59
Brechin,1559,4,15,7,14,53,53,0,52
East Fife,1559,5,13,10,13,51,50,1,49
Peterhead,1559,6,14,7,15,51,58,-7,49
Queen's Park,1559,7,11,9,16,40,53,-13,42
Albion,1559,8,10,9,17,43,53,-10,39
Stranraer,1559,9,11,5,20,49,67,-18,38
Stenhousem'r,1559,10,8,9,19,52,80,-28,33
Livingston,1560,1,23,5,8,86,48,38,74
Alloa,1560,2,19,9,8,70,46,24,66
Airdrieon,1560,3,18,8,10,59,51,8,62
Brechin,1560,4,17,7,12,54,42,12,58
Albion,1560,5,12,11,13,55,54,1,47
Queen's Park,1560,6,13,8,15,38,50,-12,47
Peterhead,1560,7,11,9,16,48,61,-13,42
Stranraer,1560,8,11,8,17,49,57,-8,41
East Fife,1560,9,10,9,17,47,55,-8,39
Stenhousem'r,1560,10,6,6,24,46,88,-42,24
Alloa,1561,1,20,11,5,70,38,32,71
Airdrieon,1561,2,19,3,14,65,50,15,60
Livingston,1561,3,17,5,14,71,55,16,56
Brechin,1561,4,14,8,14,49,54,-5,50
Peterhead,1561,5,14,7,15,47,51,-4,49
Queen's Park,1561,6,14,7,15,39,45,-6,49
East Fife,1561,7,13,8,15,53,49,4,47
Albion,1561,8,13,7,16,50,59,-9,46
Stranraer,1561,9,12,8,16,48,61,-13,44
Stenhousem'r,1561,10,6,12,18,43,73,-30,30
Livingston,1562,1,22,6,8,87,53,34,72
Alloa,1562,2,18,7,11,61,40,21,61
Brechin,1562,3,17,4,15,49,47,2,55
Airdrieon,1562,4,15,7,14,55,55,0,52
Albion,1562,5,14,9,13,52,54,-2,51
Peterhead,1562,6,13,8,15,43,58,-15,47
Queen's Park,1562,7,13,7,16,41,46,-5,46
East Fife,1562,8,11,9,16,47,52,-5,42
Stranraer,1562,9,9,11,16,39,51,-12,38
Stenhousem'r,1562,10,8,12,16,53,71,-18,36
Livingston,1563,1,21,4,11,77,50,27,67
Alloa,1563,2,16,12,8,66,46,20,60
Brechin,1563,3,18,4,14,48,45,3,58
Airdrieon,1563,4,15,8,13,57,52,5,53
Stranraer,1563,5,14,6,16,59,66,-7,48
Peterhead,1563,6,14,6,16,46,58,-12,48
East Fife,1563,7,12,10,14,49,44,5,46
Queen's Park,1563,8,13,7,16,46,52,-6,46
Albion,1563,9,9,12,15,49,52,-3,39
Stenhousem'r,1563,10,11,5,20,45,77,-32,38
Alloa,1564,1,22,5,9,70,41,29,71
Brechin,1564,2,20,5,11,57,44,13,65
Albion,1564,3,14,11,11,58,54,4,53
Livingston,1564,4,14,9,13,62,51,11,51
Airdrieon,1564,5,15,6,15,53,57,-4,51
Peterhead,1564,6,13,8,15,45,45,0,47
Queen's Park,1564,7,12,9,15,36,51,-15,45
East Fife,1564,8,11,10,15,50,50,0,43
Stranraer,1564,9,12,6,18,45,56,-11,42
Stenhousem'r,1564,10,9,7,20,49,76,-27,34
Livingston,1565,1,20,7,9,81,47,34,67
Airdrieon,1565,2,19,4,13,73,59,14,61
Brechin,1565,3,18,5,13,55,47,8,59
Alloa,1565,4,14,11,11,65,53,12,53
East Fife,1565,5,14,9,13,57,48,9,51
Albion,1565,6,13,9,14,54,53,1,48
Stranraer,1565,7,14,5,17,58,66,-8,47
Queen's Park,1565,8,11,12,13,39,50,-11,45
Peterhead,1565,9,10,10,16,40,55,-15,40
Stenhousem'r,1565,10,7,8,21,42,86,-44,29
Livingston,1566,1,23,4,9,75,41,34,73
Alloa,1566,2,19,8,9,64,38,26,65
Airdrieon,1566,3,17,7,12,59,50,9,58
Brechin,1566,4,15,5,16,38,44,-6,50
Queen's Park,1566,5,14,8,14,36,47,-11,50
Stranraer,1566,6,14,7,15,53,57,-4,49
East Fife,1566,7,13,8,15,42,43,-1,47
Peterhead,1566,8,12,11,13,52,55,-3,47
Albion,1566,9,9,9,18,44,59,-15,36
Stenhousem'r,1566,10,6,9,21,42,71,-29,27
Alloa,1567,1,20,6,10,64,39,25,66
Brechin,1567,2,20,5,11,54,41,13,65
Livingston,1567,3,18,5,13,67,47,20,59
Airdrieon,1567,4,17,5,14,52,52,0,56
Albion,1567,5,15,9,12,58,45,13,54
Peterhead,1567,6,15,9,12,48,44,4,54
Stranraer,1567,7,13,10,13,53,51,2,49
East Fife,1567,8,11,8,17,34,47,-13,41
Queen's Park,1567,9,9,10,17,27,49,-22,37
Stenhousem'r,1567,10,5,7,24,35,77,-42,22
Livingston,1568,1,21,6,9,77,55,22,69
Peterhead,1568,2,19,6,11,71,55,16,63
Airdrieon,1568,3,16,12,8,63,49,14,60
Brechin,1568,4,14,9,13,48,49,-1,51
Alloa,1568,5,13,10,13,67,56,11,49
Queen's Park,1568,6,12,10,14,33,50,-17,46
Albion,1568,7,11,11,14,52,51,1,44
East Fife,1568,8,10,11,15,52,55,-3,41
Stranraer,1568,9,9,10,17,48,55,-7,37
Stenhousem'r,1568,10,9,7,20,42,78,-36,34
Alloa,1569,1,18,7,11,82,52,30,61
Brechin,1569,2,16,9,11,60,55,5,57
Livingston,1569,3,16,7,13,72,55,17,55
Airdrieon,1569,4,16,7,13,57,51,6,55
Queen's Park,1569,5,15,10,11,46,47,-1,55
East Fife,1569,6,15,8,13,56,43,13,53
Peterhead,1569,7,14,7,15,51,62,-11,49
Albion,1569,8,13,9,14,63,58,5,48
Stranraer,1569,9,13,5,18,58,70,-12,44
Stenhousem'r,1569,10,5,9,22,46,98,-52,24
Livingston,1570,1,25,5,6,85,47,38,80
Alloa,1570,2,17,7,12,63,46,17,58
Airdrieon,1570,3,17,7,12,66,52,14,58
Peterhead,1570,4,16,7,13,55,50,5,55
Albion,1570,5,15,8,13,56,55,1,53
Brechin,1570,6,14,7,15,51,58,-7,49
Queen's Park,1570,7,12,7,17,38,53,-15,43
East Fife,1570,8,10,9,17,52,58,-6,39
Stranraer,1570,9,10,6,20,47,67,-20,36
Stenhousem'r,1570,10,8,9,19,49,76,-27,33
Alloa,1571,1,21,6,9,79,42,37,69
Livingston,1571,2,19,8,9,72,48,24,65
Airdrieon,1571,3,15,10,11,64,61,3,55
Brechin,1571,4,16,5,15,54,49,5,53
Queen's Park,1571,5,15,5,16,42,48,-6,50
East Fife,1571,6,13,9,14,52,54,-2,48
Albion,1571,7,12,9,15,50,50,0,45
Peterhead,1571,8,10,12,14,43,50,-7,42
Stranraer,1571,9,10,7,19,46,65,-19,37
Stenhousem'r,1571,10,9,9,18,46,81,-35,36
Livingston,1572,1,23,4,9,84,45,39,73
Airdrieon,1572,2,19,4,13,66,56,10,61
Alloa,1572,3,18,4,14,68,48,20,58
Brechin,1572,4,17,5,14,55,51,4,56
Albion,1572,5,15,7,14,53,56,-3,52
Peterhead,1572,6,15,7,14,59,65,-6,52
East Fife,1572,7,13,6,17,53,56,-3,45
Queen's Park,1572,8,12,9,15,35,45,-10,45
Stranraer,1572,9,13,6,17,52,65,-13,45
Stenhousem'r,1572,10,5,8,23,49,87,-38,23
Livingston,1573,1,28,1,7,94,42,52,85
Brechin,1573,2,18,4,14,46,44,2,58
Queen's Park,1573,3,16,8,12,52,49,3,56
Alloa,1573,4,16,6,14,65,54,11,54
East Fife,1573,5,14,8,14,56,50,6,50
Peterhead,1573,6,14,6,16,51,54,-3,48
Airdrieon,1573,7,13,8,15,56,61,-5,47
Stranraer,1573,8,12,4,20,49,66,-17,40
Albion,1573,9,10,8,18,46,60,-14,38
Stenhousem'r,1573,10,10,5,21,45,80,-35,35
Livingston,1574,1,20,5,11,79,55,24,65
Alloa,1574,2,19,7,10,62,44,18,64
Airdrieon,1574,3,17,8,11,73,55,18,59
Albion,1574,4,17,8,11,62,49,13,59
East Fife,1574,5,16,10,10,49,38,11,58
Brechin,1574,6,16,9,11,56,52,4,57
Peterhead,1574,7,9,10,17,40,54,-14,37
Stranraer,1574,8,10,5,21,43,61,-18,35
Queen's Park,1574,9,9,8,19,36,60,-24,35
Stenhousem'r,1574,10,8,8,20,43,75,-32,32
Alloa,1575,1,22,6,8,69,33,36,72
Livingston,1575,2,19,4,13,62,48,14,61
Brechin,1575,3,19,4,13,51,46,5,61
Peterhead,1575,4,16,8,12,56,50,6,56
Airdrieon,1575,5,15,6,15,53,61,-8,51
Albion,1575,6,13,10,13,49,48,1,49
Stranraer,1575,7,12,6,18,49,60,-11,42
East Fife,1575,8,10,10,16,50,46,4,40
Queen's Park,1575,9,11,7,18,37,52,-15,40
Stenhousem'r,1575,10,7,11,18,48,80,-32,32
Livingston,1576,1,23,5,8,80,41,39,74
Alloa,1576,2,17,12,7,65,38,27,63
Brechin,1576,3,19,4,13,53,42,11,61
Airdrieon,1576,4,15,10,11,65,58,7,55
Peterhead,1576,5,13,9,14,42,45,-3,48
Albion,1576,6,12,10,14,52,56,-4,46
East Fife,1576,7,10,10,16,52,51,1,40
Stranraer,1576,8,11,6,19,47,69,-22,39
Queen's Park,1576,9,7,15,14,33,52,-19,36
Stenhousem'r,1576,10,10,5,21,47,84,-37,35
Livingston,1577,1,24,4,8,83,42,41,76
Alloa,1577,2,20,7,9,70,42,28,67
Brechin,1577,3,16,11,9,61,54,7,59
Stranraer,1577,4,15,4,17,60,63,-3,49
Peterhead,1577,5,12,11,13,53,57,-4,47
Airdrieon,1577,6,12,8,16,58,71,-13,44
East Fife,1577,7,10,13,13,50,55,-5,43
Albion,1577,8,10,11,15,60,64,-4,41
Queen's Park,1577,9,10,11,15,34,49,-15,41
Stenhousem'r,1577,10,6,10,20,50,82,-32,28
Livingston,1578,1,21,5,10,74,43,31,68
Airdrieon,1578,2,18,9,9,64,44,20,63
Brechin,1578,3,16,8,12,48,48,0,56
East Fife,1578,4,16,7,13,52,42,10,55
Alloa,1578,5,14,12,10,67,51,16,54
Albion,1578,6,13,7,16,48,58,-10,46
Stranraer,1578,7,12,7,17,48,57,-9,43
Peterhead,1578,8,11,9,16,53,57,-4,42
Queen's Park,1578,9,11,7,18,37,55,-18,40
Stenhousem'r,1578,10,7,11,18,51,87,-36,32
Brechin,1579,1,20,5,11,58,48,10,65
Livingston,1579,2,20,2,14,81,56,25,62
Airdrieon,1579,3,19,4,13,59,52,7,61
Alloa,1579,4,16,10,10,71,49,22,58
Peterhead,1579,5,15,9,12,55,49,6,54
Albion,1579,6,15,7,14,57,52,5,52
East Fife,1579,7,12,10,14,47,43,4,46
Queen's Park,1579,8,10,7,19,32,52,-20,37
Stranraer,1579,9,10,7,19,38,67,-29,37
Stenhousem'r,1579,10,7,11,18,50,80,-30,32
Livingston,1580,1,20,8,8,75,44,31,68
Brechin,1580,2,18,7,11,54,45,9,61
Alloa,1580,3,16,9,11,66,41,25,57
Peterhead,1580,4,14,8,14,46,46,0,50
Airdrieon,1580,5,14,8,14,50,52,-2,50
Stranraer,1580,6,14,5,17,47,56,-9,47
East Fife,1580,7,12,10,14,46,46,0,46
Queen's Park,1580,8,13,7,16,40,52,-12,46
Albion,1580,9,12,8,16,50,60,-10,44
Stenhousem'r,1580,10,8,8,20,49,81,-32,32
Alloa,1581,1,21,6,9,67,38,29,69
Livingston,1581,2,20,7,9,73,45,28,67
Airdrieon,1581,3,17,6,13,58,59,-1,57
Brechin,1581,4,13,12,11,46,48,-2,51
Peterhead,1581,5,14,8,14,54,49,5,50
Albion,1581,6,14,8,14,47,44,3,50
Stranraer,1581,7,11,11,14,43,47,-4,44
East Fife,1581,8,9,12,15,47,46,1,39
Stenhousem'r,1581,9,10,7,19,46,76,-30,37
Queen's Park,1581,10,7,11,18,30,59,-29,32
Livingston,1582,1,23,4,9,82,45,37,73
Airdrieon,1582,2,18,7,11,58,53,5,61
Alloa,1582,3,17,8,11,64,49,15,59
Brechin,1582,4,17,6,13,51,45,6,57
Albion,1582,5,14,7,15,52,59,-7,49
Peterhead,1582,6,13,8,15,51,51,0,47
Queen's Park,1582,7,13,8,15,47,55,-8,47
Stranraer,1582,8,12,6,18,49,64,-15,42
East Fife,1582,9,10,8,18,45,53,-8,38
Stenhousem'r,1582,10,8,8,20,56,81,-25,32
Alloa,1583,1,21,8,7,78,41,37,71
Airdrieon,1583,2,22,5,9,69,49,20,71
Livingston,1583,3,20,5,11,83,48,35,65
Brechin,1583,4,17,5,14,47,57,-10,56
Albion,1583,5,13,10,13,51,58,-7,49
Stranraer,1583,6,15,3,18,52,57,-5,48
Queen's Park,1583,7,13,4,19,36,48,-12,43
Peterhead,1583,8,12,5,19,46,58,-12,41
East Fife,1583,9,10,9,17,42,46,-4,39
Stenhousem'r,1583,10,7,6,23,36,78,-42,27
Livingston,1584,1,22,5,9,74,44,30,71
Alloa,1584,2,19,8,9,72,45,27,65
Airdrieon,1584,3,19,7,10,57,50,7,64
Brechin,1584,4,14,9,13,47,44,3,51
Albion,1584,5,13,10,13,52,51,1,49
Queen's Park,1584,6,12,9,15,37,46,-9,45
East Fife,1584,7,10,12,14,56,54,2,42
Stenhousem'r,1584,8,11,8,17,51,72,-21,41
Peterhead,1584,9,9,12,15,41,58,-17,39
Stranraer,1584,10,8,6,22,45,68,-23,30
Alloa,1585,1,17,10,9,77,54,23,61
Livingston,1585,2,18,7,11,75,56,19,61
Airdrieon,1585,3,17,8,11,63,54,9,59
Brechin,1585,4,15,9,12,55,56,-1,54
Stranraer,1585,5,15,5,16,66,64,2,50
Albion,1585,6,10,15,11,58,50,8,45
East Fife,1585,7,11,11,14,49,50,-1,44
Peterhead,1585,8,12,7,17,53,64,-11,43
Stenhousem'r,1585,9,10,9,17,54,79,-25,39
Queen's Park,1585,10,9,11,16,39,62,-23,38
Livingston,1586,1,24,3,9,69,37,32,75
Brechin,1586,2,19,5,12,56,39,17,62
Alloa,1586,3,16,6,14,58,40,18,54
Airdrieon,1586,4,16,6,14,56,57,-1,54
Queen's Park,1586,5,15,8,13,42,47,-5,53
Albion,1586,6,14,9,13,59,53,6,51
Stranraer,1586,7,13,7,16,49,55,-6,46
Peterhead,1586,8,11,9,16,41,61,-20,42
East Fife,1586,9,11,7,18,47,58,-11,40
Stenhousem'r,1586,10,7,8,21,46,76,-30,29
Alloa,1587,1,19,9,8,69,39,30,66
Livingston,1587,2,17,7,12,80,54,26,58
Airdrieon,1587,3,16,9,11,63,53,10,57
Albion,1587,4,17,5,14,57,57,0,56
East Fife,1587,5,15,9,12,57,46,11,54
Stranraer,1587,6,15,3,18,51,56,-5,48
Brechin,1587,7,15,3,18,39,57,-18,48
Peterhead,1587,8,12,8,16,38,54,-16,44
Queen's Park,1587,9,12,6,18,43,56,-13,42
Stenhousem'r,1587,10,7,11,18,51,76,-25,32
Livingston,1588,1,22,3,11,74,50,24,69
Alloa,1588,2,21,5,10,71,41,30,68
Brechin,1588,3,17,4,15,50,46,4,55
East Fife,1588,4,14,10,12,59,44,15,52
Albion,1588,5,14,10,12,53,51,2,52
Peterhead,1588,6,13,9,14,45,50,-5,48
Airdrieon,1588,7,14,5,17,42,50,-8,47
Stranraer,1588,8,14,3,19,57,64,-7,45
Queen's Park,1588,9,10,8,18,35,57,-22,38
Stenhousem'r,1588,10,9,7,20,47,80,-33,34
Livingston,1589,1,24,7,5,98,47,51,79
Airdrieon,1589,2,21,6,9,68,51,17,69
Alloa,1589,3,18,9,9,68,44,24,63
Peterhead,1589,4,15,9,12,61,53,8,54
Brechin,1589,5,16,5,15,48,49,-1,53
Albion,1589,6,11,11,14,52,58,-6,44
Queen's Park,1589,7,11,10,15,37,53,-16,43
Stranraer,1589,8,10,8,18,43,57,-14,38
East Fife,1589,9,7,10,19,41,57,-16,31
Stenhousem'r,1589,10,6,7,23,36,83,-47,25
Alloa,1590,1,22,8,6,84,41,43,74
Livingston,1590,2,20,6,10,79,44,35,66
Brechin,1590,3,17,5,14,46,54,-8,56
East Fife,1590,4,14,7,15,56,54,2,49
Airdrieon,1590,5,13,9,14,53,64,-11,48
Queen's Park,1590,6,13,7,16,38,49,-11,46
Stranraer,1590,7,13,6,17,60,67,-7,45
Peterhead,1590,8,12,7,17,47,63,-16,43
Albion,1590,9,11,9,16,59,65,-6,42
Stenhousem'r,1590,10,10,6,20,50,71,-21,36
Livingston,1591,1,21,7,8,78,42,36,70
Alloa,1591,2,19,8,9,66,42,24,65
Brechin,1591,3,18,7,11,62,43,19,61
Albion,1591,4,15,8,13,56,53,3,53
Airdrieon,1591,5,15,8,13,55,63,-8,53
Queen's Park,1591,6,12,7,17,36,50,-14,43
Peterhead,1591,7,11,9,16,40,54,-14,42
Stranraer,1591,8,11,6,19,42,56,-14,39
Stenhousem'r,1591,9,11,6,19,48,72,-24,39
East Fife,1591,10,9,10,17,42,50,-8,37
Livingston,1592,1,18,9,9,73,49,24,63
Alloa,1592,2,17,8,11,65,45,20,59
Brechin,1592,3,15,9,12,49,45,4,54
Stranraer,1592,4,15,6,15,50,50,0,51
Queen's Park,1592,5,14,9,13,35,44,-9,51
Albion,1592,6,12,13,11,54,50,4,49
Peterhead,1592,7,12,11,13,53,56,-3,47
Airdrieon,1592,8,13,8,15,53,57,-4,47
East Fife,1592,9,12,10,14,48,44,4,46
Stenhousem'r,1592,10,8,5,23,37,77,-40,29
Livingston,1593,1,22,4,10,74,45,29,70
Brechin,1593,2,20,6,10,52,42,10,66
Alloa,1593,3,18,9,9,73,44,29,63
Airdrieon,1593,4,14,8,14,50,54,-4,50
Peterhead,1593,5,14,7,15,48,54,-6,49
Albion,1593,6,12,11,13,56,60,-4,47
Stranraer,1593,7,13,6,17,53,64,-11,45
East Fife,1593,8,12,8,16,55,53,2,44
Queen's Park,1593,9,11,7,18,35,50,-15,40
Stenhousem'r,1593,10,7,8,21,56,86,-30,29
Livingston,1594,1,24,3,9,79,44,35,75
Albion,1594,2,20,6,10,64,40,24,66
Brechin,1594,3,19,7,10,59,43,16,64
Airdrieon,1594,4,17,7,12,56,45,11,58
Alloa,1594,5,15,10,11,68,50,18,55
Peterhead,1594,6,12,9,15,48,56,-8,45
Stranraer,1594,7,14,3,19,47,62,-15,45
Stenhousem'r,1594,8,9,7,20,52,72,-20,34
Queen's Park,1594,9,9,6,21,40,83,-43,33
East Fife,1594,10,8,8,20,43,61,-18,32
Livingston,1595,1,21,5,10,69,46,23,68
Airdrieon,1595,2,18,8,10,60,47,13,62
Alloa,1595,3,16,9,11,59,44,15,57
Brechin,1595,4,15,9,12,59,50,9,54
Stranraer,1595,5,13,10,13,57,58,-1,49
East Fife,1595,6,12,12,12,55,52,3,48
Peterhead,1595,7,13,6,17,52,64,-12,45
Queen's Park,1595,8,11,9,16,43,55,-12,42
Albion,1595,9,11,5,20,56,63,-7,38
Stenhousem'r,1595,10,10,7,19,47,78,-31,37
Livingston,1596,1,22,2,12,78,49,29,68
Alloa,1596,2,20,5,11,68,46,22,65
Airdrieon,1596,3,18,7,11,64,52,12,61
Brechin,1596,4,17,6,13,59,52,7,57
Peterhead,1596,5,15,4,17,44,53,-9,49
Albion,1596,6,13,8,15,54,54,0,47
Stranraer,1596,7,13,7,16,55,62,-7,46
Queen's Park,1596,8,13,5,18,41,51,-10,44
East Fife,1596,9,12,7,17,56,59,-3,43
Stenhousem'r,1596,10,9,5,22,43,84,-41,32
Livingston,1597,1,21,3,12,82,51,31,66
Alloa,1597,2,20,6,10,72,43,29,66
Airdrieon,1597,3,19,5,12,71,56,15,62
Albion,1597,4,15,7,14,56,57,-1,52
Stranraer,1597,5,16,4,16,60,63,-3,52
East Fife,1597,6,13,10,13,53,47,6,49
Peterhead,1597,7,13,6,17,47,61,-14,45
Brechin,1597,8,13,5,18,45,59,-14,44
Queen's Park,1597,9,12,6,18,36,59,-23,42
Stenhousem'r,1597,10,9,6,21,49,75,-26,33
Livingston,1598,1,23,5,8,75,48,27,74
Alloa,1598,2,19,6,11,63,41,22,63
Airdrieon,1598,3,15,11,10,56,49,7,56
Brechin,1598,4,15,8,13,49,46,3,53
Queen's Park,1598,5,15,7,14,38,43,-5,52
Albion,1598,6,14,9,13,55,55,0,51
Stranraer,1598,7,12,8,16,53,60,-7,44
East Fife,1598,8,12,6,18,54,55,-1,42
Peterhead,1598,9,10,9,17,45,60,-15,39
Stenhousem'r,1598,10,7,7,22,50,81,-31,28
Livingston,1599,1,23,2,11,79,47,32,71
Alloa,1599,2,18,11,7,68,44,24,65
Brechin,1599,3,17,5,14,49,48,1,56
Albion,1599,4,15,9,12,75,66,9,54
Peterhead,1599,5,13,10,13,51,57,-6,49
Airdrieon,1599,6,13,9,14,69,65,4,48
Stranraer,1599,7,13,6,17,53,59,-6,45
Queen's Park,1599,8,13,6,17,46,53,-7,45
East Fife,1599,9,11,8,17,51,62,-11,41
Stenhousem'r,1599,10,7,8,21,43,83,-40,29
Livingston,1600,1,20,3,13,73,51,22,63
Alloa,1600,2,17,9,10,67,48,19,60
Airdrieon,1600,3,17,5,14,58,54,4,56
Peterhead,1600,4,15,10,11,51,45,6,55
Albion,1600,5,15,8,13,57,50,7,53
East Fife,1600,6,13,12,11,54,44,10,51
Brechin,1600,7,13,9,14,43,53,-10,48
Queen's Park,1600,8,12,4,20,36,59,-23,40
Stranraer,1600,9,11,6,19,44,57,-13,39
Stenhousem'r,1600,10,9,10,17,53,75,-22,37
Brechin,1601,1,20,8,8,55,39,16,68
Livingston,1601,2,19,8,9,75,52,23,65
Alloa,1601,3,16,11,9,63,46,17,59
Airdrieon,1601,4,15,8,13,64,56,8,53
Peterhead,1601,5,14,7,15,45,54,-9,49
Stranraer,1601,6,12,9,15,48,54,-6,45
Queen's Park,1601,7,12,8,16,36,47,-11,44
East Fife,1601,8,11,9,16,46,48,-2,42
Albion,1601,9,10,10,16,50,48,2,40
Stenhousem'r,1601,10,6,12,18,39,77,-38,30
Brechin,1602,1,20,6,10,58,41,17,66
Livingston,1602,2,18,7,11,76,52,24,61
Peterhead,1602,3,16,11,9,51,42,9,59
Albion,1602,4,14,8,14,55,51,4,50
East Fife,1602,5,12,11,13,48,51,-3,47
Airdrieon,1602,6,13,8,15,57,62,-5,47
Alloa,1602,7,12,9,15,56,49,7,45
Stranraer,1602,8,12,9,15,51,51,0,45
Queen's Park,1602,9,12,8,16,39,61,-22,44
Stenhousem'r,1602,10,9,7,20,46,77,-31,34
Livingston,1603,1,21,3,12,79,45,34,66
Airdrieon,1603,2,19,6,11,68,59,9,63
Alloa,1603,3,15,11,10,64,47,17,56
Brechin,1603,4,17,4,15,54,55,-1,55
Queen's Park,1603,5,15,7,14,42,47,-5,52
Peterhead,1603,6,13,11,12,50,47,3,50
Stranraer,1603,7,11,10,15,53,68,-15,43
East Fife,1603,8,9,13,14,42,44,-2,40
Albion,1603,9,10,10,16,52,60,-8,40
Stenhousem'r,1603,10,9,7,20,45,77,-32,34
Peterhead,1604,1,19,5,12,66,56,10,62
Brechin,1604,2,17,9,10,48,45,3,60
Livingston,1604,3,18,5,13,73,52,21,59
Alloa,1604,4,16,7,13,69,52,17,55
Airdrieon,1604,5,16,7,13,62,57,5,55
Albion,1604,6,14,9,13,50,50,0,51
Queen's Park,1604,7,13,7,16,31,47,-16,46
Stranraer,1604,8,12,5,19,52,62,-10,41
Stenhousem'r,1604,9,11,6,19,44,74,-30,39
East Fife,1604,10,10,8,18,49,49,0,38
Alloa,1605,1,20,9,7,77,42,35,69
Livingston,1605,2,19,8,9,69,47,22,65
Brechin,1605,3,19,8,9,54,43,11,65
Airdrieon,1605,4,19,5,12,59,46,13,62
Peterhead,1605,5,12,10,14,47,55,-8,46
Stranraer,1605,6,12,6,18,52,58,-6,42
Albion,1605,7,10,12,14,49,57,-8,42
Queen's Park,1605,8,12,5,19,40,57,-17,41
East Fife,1605,9,10,7,19,50,63,-13,37
Stenhousem'r,1605,10,7,10,19,45,74,-29,31
Livingston,1606,1,23,3,10,77,49,28,72
Alloa,1606,2,18,10,8,80,47,33,64
Brechin,1606,3,18,8,10,62,44,18,62
Albion,1606,4,16,6,14,54,53,1,54
Airdrieon,1606,5,14,11,11,59,60,-1,53
Peterhead,1606,6,14,9,13,53,47,6,51
East Fife,1606,7,10,12,14,45,46,-1,42
Queen's Park,1606,8,11,8,17,35,55,-20,41
Stranraer,1606,9,8,8,20,47,70,-23,32
Stenhousem'r,1606,10,7,7,22,49,90,-41,28
Livingston,1607,1,22,5,9,80,44,36,71
Alloa,1607,2,20,8,8,73,40,33,68
Airdrieon,1607,3,17,6,13,55,47,8,57
Queen's Park,1607,4,15,8,13,39,47,-8,53
Brechin,1607,5,15,6,15,43,50,-7,51
Albion,1607,6,14,8,14,57,56,1,50
Stranraer,1607,7,12,6,18,45,52,-7,42
Peterhead,1607,8,11,9,16,50,61,-11,42
East Fife,1607,9,11,7,18,39,54,-15,40
Stenhousem'r,1607,10,8,7,21,49,79,-30,31
Alloa,1608,1,21,5,10,79,48,31,68
Livingston,1608,2,20,6,10,69,42,27,66
Airdrieon,1608,3,17,8,11,56,51,5,59
Albion,1608,4,14,8,14,56,52,4,50
Brechin,1608,5,15,5,16,40,49,-9,50
Stranraer,1608,6,14,6,16,56,59,-3,48
Queen's Park,1608,7,14,5,17,33,45,-12,47
East Fife,1608,8,12,8,16,48,49,-1,44
Peterhead,1608,9,10,11,15,43,55,-12,41
Stenhousem'r,1608,10,7,10,19,44,74,-30,31
Livingston,1609,1,19,7,10,75,53,22,64
Alloa,1609,2,18,8,10,64,41,23,62
Albion,1609,3,18,8,10,69,50,19,62
Brechin,1609,4,16,10,10,52,47,5,58
Queen's Park,1609,5,14,7,15,39,45,-6,49
Airdrieon,1609,6,13,9,14,55,56,-1,48
Peterhead,1609,7,12,11,13,43,51,-8,47
Stranraer,1609,8,10,9,17,42,55,-13,39
East Fife,1609,9,8,10,18,50,60,-10,34
Stenhousem'r,1609,10,6,13,17,45,76,-31,31
Livingston,1610,1,22,5,9,84,48,36,71
Alloa,1610,2,18,8,10,71,47,24,62
Airdrieon,1610,3,18,4,14,64,60,4,58
Brechin,1610,4,14,10,12,52,45,7,52
Albion,1610,5,14,10,12,61,55,6,52
Peterhead,1610,6,13,11,12,51,50,1,50
Queen's Park,1610,7,13,8,15,46,64,-18,47
East Fife,1610,8,12,9,15,55,59,-4,45
Stranraer,1610,9,12,5,19,50,60,-10,41
Stenhousem'r,1610,10,6,6,24,45,91,-46,24
Livingston,1611,1,20,4,12,74,48,26,64
Alloa,1611,2,18,6,12,62,41,21,60
Airdrieon,1611,3,18,5,13,62,54,8,59
Brechin,1611,4,18,5,13,48,44,4,59
East Fife,1611,5,13,11,12,52,45,7,50
Albion,1611,6,12,11,13,46,50,-4,47
Queen's Park,1611,7,12,8,16,45,53,-8,44
Stenhousem'r,1611,8,11,10,15,45,62,-17,43
Peterhead,1611,9,9,11,16,42,57,-15,38
Stranraer,1611,10,10,7,19,54,76,-22,37
Livingston,1612,1,21,4,11,76,54,22,67
Alloa,1612,2,19,8,9,63,39,24,65
Brechin,1612,3,19,7,10,56,49,7,64
Queen's Park,1612,4,17,6,13,43,42,1,57
Airdrieon,1612,5,14,10,12,53,49,4,52
Albion,1612,6,14,8,14,44,49,-5,50
East Fife,1612,7,12,8,16,57,62,-5,44
Peterhead,1612,8,12,6,18,54,59,-5,42
Stranraer,1612,9,11,3,22,47,61,-14,36
Stenhousem'r,1612,10,8,6,22,50,79,-29,30
Airdrieon,1613,1,17,9,10,69,58,11,60
Alloa,1613,2,16,9,11,63,39,24,57
Livingston,1613,3,17,6,13,78,63,15,57
Brechin,1613,4,14,11,11,41,46,-5,53
Albion,1613,5,12,15,9,51,43,8,51
East Fife,1613,6,12,13,11,50,45,5,49
Stranraer,1613,7,13,10,13,58,62,-4,49
Peterhead,1613,8,14,7,15,42,49,-7,49
Queen's Park,1613,9,11,11,14,46,51,-5,44
Stenhousem'r,1613,10,5,7,24,46,88,-42,22
Livingston,1614,1,21,3,12,75,49,26,66
Alloa,1614,2,18,9,9,64,43,21,63
Airdrieon,1614,3,18,7,11,55,49,6,61
Queen's Park,1614,4,17,4,15,46,49,-3,55
Albion,1614,5,15,8,13,49,45,4,53
Peterhead,1614,6,14,9,13,54,54,0,51
Brechin,1614,7,15,5,16,46,46,0,50
Stranraer,1614,8,13,5,18,50,57,-7,44
East Fife,1614,9,8,11,17,41,51,-10,35
Stenhousem'r,1614,10,8,5,23,44,81,-37,29
Livingston,1615,1,17,8,11,61,44,17,59
Peterhead,1615,2,17,7,12,54,45,9,58
Alloa,1615,3,16,9,11,63,48,15,57
Albion,1615,4,13,14,9,60,47,13,53
Stranraer,1615,5,15,7,14,57,50,7,52
Brechin,1615,6,14,10,12,50,49,1,52
Airdrieon,1615,7,13,8,15,52,51,1,47
East Fife,1615,8,13,8,15,43,49,-6,47
Queen's Park,1615,9,12,6,18,40,54,-14,42
Stenhousem'r,1615,10,8,7,21,42,85,-43,31
Alloa,1616,1,19,7,10,70,47,23,64
Brechin,1616,2,19,5,12,58,45,13,62
Livingston,1616,3,17,8,11,81,52,29,59
Airdrieon,1616,4,15,6,15,65,68,-3,51
Queen's Park,1616,5,15,6,15,43,49,-6,51
Peterhead,1616,6,14,6,16,52,54,-2,48
Albion,1616,7,12,12,12,47,53,-6,48
East Fife,1616,8,10,13,13,43,42,1,43
Stranraer,1616,9,11,7,18,55,65,-10,40
Stenhousem'r,1616,10,9,8,19,42,81,-39,35
Alloa,1617,1,21,6,9,80,37,43,69
Livingston,1617,2,20,5,11,81,46,35,65
Airdrieon,1617,3,16,7,13,57,59,-2,55
Queen's Park,1617,4,16,6,14,39,46,-7,54
Brechin,1617,5,16,5,15,52,54,-2,53
Peterhead,1617,6,15,5,16,50,53,-3,50
Stranraer,1617,7,15,3,18,56,58,-2,48
East Fife,1617,8,11,10,15,45,49,-4,43
Albion,1617,9,12,7,17,49,65,-16,43
Stenhousem'r,1617,10,5,12,19,42,84,-42,27
Alloa,1618,1,19,8,9,77,46,31,65
Livingston,1618,2,20,5,11,75,48,27,65
Airdrieon,1618,3,17,5,14,60,53,7,56
Peterhead,1618,4,15,10,11,47,45,2,55
Brechin,1618,5,17,4,15,49,50,-1,55
Stranraer,1618,6,13,7,16,47,52,-5,46
Queen's Park,1618,7,12,8,16,35,53,-18,44
East Fife,1618,8,10,11,15,50,54,-4,41
Albion,1618,9,11,8,17,45,56,-11,41
Stenhousem'r,1618,10,10,6,20,47,75,-28,36
Livingston,1619,1,18,8,10,69,48,21,62
Alloa,1619,2,15,11,10,66,45,21,56
Brechin,1619,3,16,8,12,53,50,3,56
Queen's Park,1619,4,16,8,12,45,42,3,56
Albion,1619,5,15,7,14,52,47,5,52
Peterhead,1619,6,12,13,11,53,57,-4,49
Stranraer,1619,7,13,6,17,43,53,-10,45
Airdrieon,1619,8,11,12,13,55,66,-11,45
East Fife,1619,9,10,8,18,45,53,-8,38
Stenhousem'r,1619,10,10,7,19,53,73,-20,37
Livingston,1620,1,24,4,8,80,47,33,76
Brechin,1620,2,18,8,10,61,48,13,62
Alloa,1620,3,17,10,9,66,42,24,61
Airdrieon,1620,4,18,4,14,51,53,-2,58
Peterhead,1620,5,15,9,12,53,49,4,54
East Fife,1620,6,12,9,15,60,49,11,45
Stranraer,1620,7,12,7,17,50,64,-14,43
Queen's Park,1620,8,13,3,20,39,54,-15,42
Albion,1620,9,11,4,21,48,67,-19,37
Stenhousem'r,1620,10,8,6,22,39,74,-35,30
Alloa,1621,1,19,10,7,73,43,30,67
Airdrieon,1621,2,20,4,12,62,51,11,64
Livingston,1621,3,20,3,13,72,47,25,63
Albion,1621,4,16,5,15,63,61,2,53
Peterhead,1621,5,15,7,14,47,51,-4,52
Brechin,1621,6,16,4,16,49,57,-8,52
Stranraer,1621,7,14,5,17,50,50,0,47
East Fife,1621,8,12,10,14,53,52,1,46
Queen's Park,1621,9,11,5,20,29,51,-22,38
Stenhousem'r,1621,10,7,7,22,46,81,-35,28
Livingston,1622,1,20,7,9,77,44,33,67
Alloa,1622,2,18,12,6,68,36,32,66
Airdrieon,1622,3,19,6,11,64,59,5,63
Albion,1622,4,15,8,13,62,59,3,53
Brechin,1622,5,15,8,13,44,50,-6,53
Peterhead,1622,6,14,7,15,51,52,-1,49
East Fife,1622,7,11,10,15,51,56,-5,43
Queen's Park,1622,8,11,8,17,34,52,-18,41
Stranraer,1622,9,10,6,20,47,60,-13,36
Stenhousem'r,1622,10,7,8,21,41,71,-30,29
Alloa,1623,1,23,4,9,90,46,44,73
Livingston,1623,2,21,5,10,74,51,23,68
Brechin,1623,3,17,6,13,54,50,4,57
Airdrieon,1623,4,17,5,14,63,55,8,56
Albion,1623,5,16,7,13,60,56,4,55
Peterhead,1623,6,13,10,13,47,52,-5,49
Stranraer,1623,7,13,3,20,48,58,-10,42
East Fife,1623,8,8,12,16,42,52,-10,36
Queen's Park,1623,9,10,6,20,34,57,-23,36
Stenhousem'r,1623,10,10,6,20,50,85,-35,36
Alloa,1624,1,23,6,7,75,41,34,75
Livingston,1624,2,23,5,8,70,34,36,74
Brechin,1624,3,16,6,14,46,48,-2,54
Albion,1624,4,13,12,11,54,55,-1,51
Airdrieon,1624,5,14,6,16,51,58,-7,48
Queen's Park,1624,6,13,7,16,35,46,-11,46
Peterhead,1624,7,12,8,16,51,54,-3,44
Stranraer,1624,8,13,5,18,50,58,-8,44
East Fife,1624,9,11,7,18,45,54,-9,40
Stenhousem'r,1624,10,6,10,20,43,72,-29,28
Alloa,1625,1,18,9,9,70,47,23,63
Airdrieon,1625,2,16,10,10,65,63,2,58
Peterhead,1625,3,16,8,12,60,57,3,56
Brechin,1625,4,16,6,14,56,51,5,54
Stranraer,1625,5,15,8,13,55,53,2,53
Livingston,1625,6,15,6,15,65,54,11,51
East Fife,1625,7,14,9,13,59,52,7,51
Albion,1625,8,10,12,14,49,56,-7,42
Queen's Park,1625,9,10,10,16,39,55,-16,40
Stenhousem'r,1625,10,7,8,21,48,78,-30,29
Livingston,1626,1,23,2,11,79,51,28,71
Alloa,1626,2,20,7,9,70,37,33,67
Airdrieon,1626,3,19,5,12,66,53,13,62
Brechin,1626,4,16,5,15,54,52,2,53
Albion,1626,5,16,5,15,57,56,1,53
Queen's Park,1626,6,15,4,17,44,53,-9,49
Peterhead,1626,7,13,7,16,44,52,-8,46
East Fife,1626,8,11,9,16,49,53,-4,42
Stranraer,1626,9,13,2,21,51,66,-15,41
Stenhousem'r,1626,10,7,8,21,44,85,-41,29
Livingston,1627,1,18,6,12,72,52,20,60
Alloa,1627,2,17,8,11,66,39,27,59
Stranraer,1627,3,17,6,13,60,61,-1,57
Brechin,1627,4,17,5,14,55,51,4,56
Airdrieon,1627,5,16,7,13,62,64,-2,55
East Fife,1627,6,13,9,14,53,43,10,48
Peterhead,1627,7,12,9,15,51,62,-11,45
Stenhousem'r,1627,8,12,9,15,59,73,-14,45
Queen's Park,1627,9,13,5,18,43,56,-13,44
Albion,1627,10,10,6,20,45,65,-20,36
Livingston,1628,1,23,4,9,91,48,43,73
Alloa,1628,2,20,7,9,76,45,31,67
Airdrieon,1628,3,18,6,12,64,51,13,60
Peterhead,1628,4,13,10,13,46,52,-6,49
Albion,1628,5,13,8,15,56,51,5,47
East Fife,1628,6,12,11,13,54,55,-1,47
Brechin,1628,7,12,11,13,51,55,-4,47
Queen's Park,1628,8,12,5,19,33,55,-22,41
Stranraer,1628,9,9,10,17,42,59,-17,37
Stenhousem'r,1628,10,7,10,19,44,86,-42,31
Alloa,1629,1,22,5,9,71,39,32,71
Livingston,1629,2,22,5,9,81,51,30,71
Airdrieon,1629,3,17,9,10,61,49,12,60
Peterhead,1629,4,14,10,12,48,52,-4,52
East Fife,1629,5,13,9,14,57,53,4,48
Albion,1629,6,13,8,15,49,51,-2,47
Stranraer,1629,7,14,5,17,52,68,-16,47
Brechin,1629,8,13,7,16,48,48,0,46
Queen's Park,1629,9,10,7,19,33,53,-20,37
Stenhousem'r,1629,10,6,7,23,42,78,-36,25
Alloa,1630,1,22,6,8,74,39,35,72
Brechin,1630,2,20,3,13,56,38,18,63
Livingston,1630,3,19,4,13,71,55,16,61
Airdrieon,1630,4,16,9,11,67,62,5,57
Peterhead,1630,5,15,7,14,49,56,-7,52
Albion,1630,6,14,9,13,52,55,-3,51
East Fife,1630,7,10,12,14,52,51,1,42
Queen's Park,1630,8,12,5,19,39,62,-23,41
Stranraer,1630,9,12,4,20,46,57,-11,40
Stenhousem'r,1630,10,7,7,22,47,78,-31,28
Livingston,1631,1,22,5,9,81,48,33,71
Alloa,1631,2,18,10,8,73,45,28,64
Brechin,1631,3,18,6,12,54,42,12,60
Albion,1631,4,17,6,13,56,48,8,57
Airdrieon,1631,5,14,11,11,49,52,-3,53
East Fife,1631,6,11,12,13,51,45,6,45
Peterhead,1631,7,12,9,15,46,56,-10,45
Stranraer,1631,8,10,6,20,45,60,-15,36
Queen's Park,1631,9,10,6,20,34,61,-27,36
Stenhousem'r,1631,10,7,11,18,39,71,-32,32
Livingston,1632,1,21,7,8,83,42,41,70
Alloa,1632,2,19,9,8,77,53,24,66
Airdrieon,1632,3,16,8,12,65,57,8,56
Peterhead,1632,4,16,7,13,48,44,4,55
Brechin,1632,5,16,5,15,63,55,8,53
Albion,1632,6,14,8,14,45,51,-6,50
Queen's Park,1632,7,12,7,17,29,48,-19,43
East Fife,1632,8,11,8,17,44,45,-1,41
Stranraer,1632,9,12,3,21,47,71,-24,39
Stenhousem'r,1632,10,9,6,21,38,73,-35,33
Alloa,1633,1,19,10,7,75,42,33,67
Albion,1633,2,18,6,12,59,41,18,60
Livingston,1633,3,17,5,14,68,50,18,56
Brechin,1633,4,15,10,11,55,43,12,55
Airdrieon,1633,5,15,7,14,53,58,-5,52
Queen's Park,1633,6,15,5,16,37,41,-4,50
Stranraer,1633,7,14,5,17,54,72,-18,47
East Fife,1633,8,13,7,16,49,45,4,46
Peterhead,1633,9,10,8,18,37,62,-25,38
Stenhousem'r,1633,10,9,7,20,42,75,-33,34
Livingston,1634,1,24,4,8,84,41,43,76
Alloa,1634,2,18,7,11,68,48,20,61
Brechin,1634,3,16,8,12,54,51,3,56
Stranraer,1634,4,15,4,17,58,60,-2,49
Peterhead,1634,5,14,7,15,46,49,-3,49
Queen's Park,1634,6,13,9,14,37,43,-6,48
Albion,1634,7,11,11,14,52,57,-5,44
Airdrieon,1634,8,13,5,18,50,67,-17,44
Stenhousem'r,1634,9,11,7,18,57,82,-25,40
East Fife,1634,10,10,8,18,51,59,-8,38
Livingston,1635,1,21,5,10,65,34,31,68
Brechin,1635,2,20,5,11,59,48,11,65
Alloa,1635,3,17,9,10,60,34,26,60
Airdrieon,1635,4,16,6,14,55,54,1,54
Peterhead,1635,5,16,5,15,52,47,5,53
Queen's Park,1635,6,14,7,15,36,43,-7,49
Albion,1635,7,13,9,14,48,50,-2,48
Stranraer,1635,8,13,6,17,65,68,-3,45
East Fife,1635,9,8,10,18,41,62,-21,34
Stenhousem'r,1635,10,9,4,23,43,84,-41,31
Airdrieon,1636,1,22,4,10,57,51,6,70
Livingston,1636,2,20,4,12,81,55,26,64
Alloa,1636,3,16,13,7,73,45,28,61
Brechin,1636,4,17,9,10,53,45,8,60
East Fife,1636,5,14,9,13,52,42,10,51
Stranraer,1636,6,15,5,16,56,53,3,50
Albion,1636,7,13,7,16,55,57,-2,46
Peterhead,1636,8,11,10,15,41,49,-8,43
Queen's Park,1636,9,10,6,20,31,57,-26,36
Stenhousem'r,1636,10,6,5,25,41,86,-45,23
Livingston,1637,1,22,6,8,74,44,30,72
Alloa,1637,2,19,9,8,68,43,25,66
Airdrieon,1637,3,19,7,10,73,62,11,64
Brechin,1637,4,16,5,15,49,47,2,53
Albion,1637,5,13,11,12,54,50,4,50
East Fife,1637,6,12,11,13,58,49,9,47
Peterhead,1637,7,12,8,16,46,55,-9,44
Stranraer,1637,8,10,10,16,50,67,-17,40
Queen's Park,1637,9,9,7,20,32,53,-21,34
Stenhousem'r,1637,10,7,8,21,49,83,-34,29
Alloa,1638,1,24,4,8,80,45,35,76
Livingston,1638,2,24,3,9,81,42,39,75
Brechin,1638,3,16,7,13,45,45,0,55
Queen's Park,1638,4,15,8,13,37,38,-1,53
Peterhead,1638,5,15,7,14,47,54,-7,52
Albion,1638,6,14,9,13,49,46,3,51
East Fife,1638,7,12,9,15,46,44,2,45
Airdrieon,1638,8,11,9,16,57,66,-9,42
Stranraer,1638,9,12,4,20,52,70,-18,40
Stenhousem'r,1638,10,5,4,27,38,82,-44,19
Alloa,1639,1,20,8,8,70,40,30,68
Livingston,1639,2,20,4,12,72,47,25,64
Brechin,1639,3,16,8,12,51,52,-1,56
Airdrieon,1639,4,13,10,13,53,57,-4,49
Stranraer,1639,4,14,7,15,53,57,-4,49
Queen's Park,1639,6,14,5,17,45,54,-9,47
Albion,1639,7,12,9,15,51,51,0,45
East Fife,1639,8,11,11,14,48,47,1,44
Peterhead,1639,9,10,10,16,51,63,-12,40
Stenhousem'r,1639,10,10,8,18,52,78,-26,38
Airdrieon,1640,1,21,6,9,65,42,23,69
Alloa,1640,2,20,8,8,79,45,34,68
Livingston,1640,3,20,7,9,74,49,25,67
Albion,1640,4,17,8,11,59,54,5,59
Queen's Park,1640,5,15,6,15,47,57,-10,51
Brechin,1640,6,13,6,17,49,62,-13,45
Stranraer,1640,7,11,7,18,47,54,-7,40
East Fife,1640,8,11,7,18,45,52,-7,40
Peterhead,1640,9,9,7,20,46,66,-20,34
Stenhousem'r,1640,10,8,8,20,54,84,-30,32
Livingston,1641,1,22,8,6,77,42,35,74
Alloa,1641,2,20,10,6,77,40,37,70
Airdrieon,1641,3,19,5,12,63,51,12,62
Brechin,1641,4,15,8,13,56,54,2,53
Queen's Park,1641,5,14,7,15,40,45,-5,49
Albion,1641,6,13,8,15,52,58,-6,47
Peterhead,1641,7,11,10,15,49,57,-8,43
Stranraer,1641,8,10,9,17,50,62,-12,39
East Fife,1641,9,9,11,16,43,51,-8,38
Stenhousem'r,1641,10,4,10,22,47,94,-47,22
Alloa,1642,1,21,5,10,66,37,29,68
Livingston,1642,2,20,3,13,73,49,24,63
Albion,1642,3,18,6,12,59,54,5,60
East Fife,1642,4,15,9,12,57,43,14,54
Airdrieon,1642,5,17,3,16,54,54,0,54
Peterhead,1642,6,15,7,14,47,42,5,52
Brechin,1642,7,16,4,16,47,53,-6,52
Queen's Park,1642,8,14,10,12,38,44,-6,52
Stranraer,1642,9,12,3,21,47,63,-16,39
Stenhousem'r,1642,10,5,4,27,39,88,-49,19
Airdrieon,1643,1,19,8,9,66,43,23,65
Alloa,1643,2,18,7,11,64,45,19,61
Livingston,1643,3,16,7,13,74,61,13,55
Peterhead,1643,4,15,7,14,56,56,0,52
East Fife,1643,5,13,8,15,51,50,1,47
Stranraer,1643,6,13,8,15,53,57,-4,47
Stenhousem'r,1643,7,13,7,16,49,67,-18,46
Queen's Park,1643,8,12,9,15,34,45,-11,45
Brechin,1643,9,13,5,18,43,53,-10,44
Albion,1643,10,12,6,18,48,61,-13,42
Livingston,1644,1,18,6,12,89,61,28,60
Alloa,1644,2,14,14,8,68,49,19,56
Albion,1644,3,16,7,13,55,48,7,55
Peterhead,1644,4,14,13,9,61,56,5,55
Brechin,1644,5,15,9,12,56,47,9,54
Stranraer,1644,6,13,10,13,54,54,0,49
Airdrieon,1644,7,11,12,13,56,66,-10,45
East Fife,1644,8,10,12,14,45,47,-2,42
Queen's Park,1644,9,10,10,16,35,53,-18,40
Stenhousem'r,1644,10,8,9,19,56,94,-38,33
Albion,1645,1,20,8,8,67,43,24,68
Alloa,1645,2,17,7,12,61,43,18,58
Airdrieon,1645,3,16,10,10,62,56,6,58
East Fife,1645,4,16,7,13,64,43,21,55
Livingston,1645,5,17,4,15,59,54,5,55
Brechin,1645,6,16,5,15,44,59,-15,53
Queen's Park,1645,7,14,7,15,46,43,3,49
Peterhead,1645,8,12,10,14,44,50,-6,46
Stranraer,1645,9,11,6,19,50,64,-14,39
Stenhousem'r,1645,10,6,6,24,38,80,-42,24
Alloa,1646,1,24,6,6,83,37,46,78
Peterhead,1646,2,18,6,12,62,54,8,60
Airdrieon,1646,3,18,4,14,61,61,0,58
Queen's Park,1646,4,18,4,14,51,52,-1,58
Livingston,1646,5,17,2,17,68,56,12,53
Brechin,1646,6,15,8,13,54,49,5,53
Stenhousem'r,1646,7,13,4,19,53,78,-25,43
Albion,1646,8,12,6,18,46,64,-18,42
Stranraer,1646,9,9,8,19,51,66,-15,35
East Fife,1646,10,9,6,21,51,63,-12,33
Alloa,1647,1,21,9,6,81,42,39,72
Livingston,1647,2,18,9,9,72,48,24,63
Airdrieon,1647,3,19,6,11,72,60,12,63
Albion,1647,4,14,9,13,54,50,4,51
Brechin,1647,5,14,6,16,41,50,-9,48
Peterhead,1647,6,12,10,14,52,56,-4,46
Stranraer,1647,7,12,8,16,53,58,-5,44
Queen's Park,1647,8,11,10,15,44,53,-9,43
East Fife,1647,9,9,12,15,50,58,-8,39
Stenhousem'r,1647,10,8,5,23,45,89,-44,29
Alloa,1648,1,21,8,7,77,41,36,71
Livingston,1648,2,20,9,7,79,50,29,69
Stranraer,1648,3,16,6,14,51,46,5,54
Brechin,1648,4,16,5,15,50,45,5,53
Airdrieon,1648,5,14,7,15,50,55,-5,49
Queen's Park,1648,6,13,10,13,38,45,-7,49
East Fife,1648,7,12,9,15,47,46,1,45
Albion,1648,8,12,8,16,52,60,-8,44
Peterhead,1648,9,10,9,17,49,62,-13,39
Stenhousem'r,1648,10,7,7,22,51,94,-43,28
Livingston,1649,1,22,5,9,68,44,24,71
Alloa,1649,2,17,6,13,73,50,23,57
Airdrieon,1649,3,17,6,13,61,60,1,57
Queen's Park,1649,4,15,11,10,42,40,2,56
Brechin,1649,5,15,7,14,50,47,3,52
East Fife,1649,6,13,11,12,56,46,10,50
Peterhead,1649,7,12,8,16,53,55,-2,44
Stranraer,1649,8,12,6,18,49,68,-19,42
Stenhousem'r,1649,9,10,7,19,49,73,-24,37
Albion,1649,10,9,9,18,47,65,-18,36
Alloa,1650,1,24,5,7,85,43,42,77
Livingston,1650,2,19,6,11,68,47,21,63
Albion,1650,3,17,7,12,55,46,9,58
Brechin,1650,4,16,7,13,51,46,5,55
Airdrieon,1650,5,17,4,15,60,61,-1,55
Peterhead,1650,6,15,7,14,46,53,-7,52
Stranraer,1650,7,14,5,17,57,59,-2,47
Queen's Park,1650,8,14,4,18,46,54,-8,46
East Fife,1650,9,8,9,19,39,51,-12,33
Stenhousem'r,1650,10,5,8,23,38,85,-47,23
Livingston,1651,1,22,7,7,82,48,34,73
Brechin,1651,2,21,5,10,60,46,14,68
Alloa,1651,3,19,8,9,71,42,29,65
Albion,1651,4,14,11,11,62,54,8,53
Airdrieon,1651,5,15,8,13,54,52,2,53
Peterhead,1651,6,13,8,15,53,55,-2,47
East Fife,1651,7,10,9,17,51,57,-6,39
Stranraer,1651,8,10,6,20,39,64,-25,36
Stenhousem'r,1651,9,10,5,21,50,79,-29,35
Queen's Park,1651,10,9,7,20,31,56,-25,34
Brechin,1652,1,21,4,11,50,37,13,67
Livingston,1652,2,20,4,12,70,44,26,64
Alloa,1652,3,17,11,8,65,43,22,62
Peterhead,1652,4,15,10,11,52,43,9,55
Queen's Park,1652,5,15,7,14,34,43,-9,52
Airdrieon,1652,6,13,8,15,60,59,1,47
Albion,1652,7,13,8,15,49,56,-7,47
Stranraer,1652,8,14,2,20,48,65,-17,44
East Fife,1652,9,10,7,19,43,54,-11,37
Stenhousem'r,1652,10,5,13,18,36,63,-27,28
Livingston,1653,1,23,7,6,76,41,35,76
Alloa,1653,2,19,10,7,66,41,25,67
Brechin,1653,3,17,8,11,53,46,7,59
Airdrieon,1653,4,17,5,14,66,60,6,56
Albion,1653,5,14,8,14,61,61,0,50
Stranraer,1653,6,13,10,13,52,48,4,49
East Fife,1653,7,10,10,16,46,52,-6,40
Peterhead,1653,8,10,9,17,48,58,-10,39
Queen's Park,1653,9,9,8,19,35,56,-21,35
Stenhousem'r,1653,10,6,9,21,49,89,-40,27
Brechin,1654,1,22,4,10,67,39,28,70
Alloa,1654,2,20,7,9,80,47,33,67
Livingston,1654,3,19,5,12,72,48,24,62
Airdrieon,1654,4,17,8,11,63,54,9,59
Peterhead,1654,5,15,6,15,46,48,-2,51
Albion,1654,6,12,9,15,45,54,-9,45
Stranraer,1654,7,12,4,20,54,66,-12,40
Queen's Park,1654,8,11,7,18,38,58,-20,40
East Fife,1654,9,9,10,17,38,52,-14,37
Stenhousem'r,1654,10,10,6,20,46,83,-37,36
Alloa,1655,1,17,13,6,70,40,30,64
Livingston,1655,2,19,4,13,67,49,18,61
Airdrieon,1655,3,17,9,10,58,50,8,60
Peterhead,1655,4,14,10,12,50,46,4,52
Stenhousem'r,1655,5,14,8,14,72,68,4,50
Brechin,1655,6,14,8,14,49,58,-9,50
Stranraer,1655,7,12,7,17,52,57,-5,43
Albion,1655,8,11,10,15,45,55,-10,43
East Fife,1655,9,8,13,15,46,60,-14,37
Queen's Park,1655,10,8,10,18,34,60,-26,34
Livingston,1656,1,21,3,12,84,44,40,66
Airdrieon,1656,2,19,5,12,65,51,14,62
East Fife,1656,3,14,10,12,59,51,8,52
Stranraer,1656,4,16,4,16,53,55,-2,52
Alloa,1656,5,15,6,15,57,50,7,51
Peterhead,1656,6,14,9,13,39,43,-4,51
Brechin,1656,7,14,6,16,45,52,-7,48
Queen's Park,1656,8,12,10,14,40,56,-16,46
Albion,1656,9,13,4,19,45,58,-13,43
Stenhousem'r,1656,10,9,9,18,49,76,-27,36
Livingston,1657,1,22,4,10,80,47,33,70
Brechin,1657,2,19,7,10,63,45,18,64
Alloa,1657,3,19,6,11,72,53,19,63
Airdrieon,1657,4,17,7,12,64,54,10,58
Albion,1657,5,16,5,15,52,47,5,53
East Fife,1657,6,14,10,12,51,50,1,52
Stranraer,1657,7,14,3,19,53,56,-3,45
Peterhead,1657,8,12,9,15,53,57,-4,45
Queen's Park,1657,9,9,7,20,31,70,-39,34
Stenhousem'r,1657,10,3,12,21,39,79,-40,21
Airdrieon,1658,1,21,8,7,54,33,21,71
Livingston,1658,2,20,7,9,80,45,35,67
Alloa,1658,3,19,8,9,64,35,29,65
Albion,1658,4,14,11,11,57,50,7,53
East Fife,1658,5,15,7,14,50,46,4,52
Brechin,1658,6,15,5,16,49,49,0,50
Peterhead,1658,7,12,8,16,43,57,-14,44
Queen's Park,1658,8,11,7,18,33,52,-19,40
Stranraer,1658,9,10,6,20,42,65,-23,36
Stenhousem'r,1658,10,5,9,22,33,73,-40,24
Alloa,1659,1,23,5,8,79,39,40,74
Livingston,1659,2,24,2,10,77,40,37,74
Peterhead,1659,3,15,7,14,51,51,0,52
Brechin,1659,4,15,6,15,48,49,-1,51
Airdrieon,1659,5,15,6,15,47,58,-11,51
Albion,1659,6,14,8,14,56,57,-1,50
East Fife,1659,7,12,7,17,50,49,1,43
Queen's Park,1659,8,12,6,18,34,51,-17,42
Stenhousem'r,1659,9,11,8,17,50,76,-26,41
Stranraer,1659,10,9,5,22,42,64,-22,32
Alloa,1660,1,20,6,10,66,38,28,66
Peterhead,1660,2,19,7,10,62,48,14,64
Airdrieon,1660,3,18,9,9,55,44,11,63
Livingston,1660,4,16,9,11,71,51,20,57
Brechin,1660,5,17,5,14,49,43,6,56
Albion,1660,6,13,8,15,61,62,-1,47
Queen's Park,1660,7,12,7,17,40,58,-18,43
East Fife,1660,8,10,9,17,46,53,-7,39
Stranraer,1660,9,10,6,20,43,66,-23,36
Stenhousem'r,1660,10,9,6,21,49,79,-30,33
Livingston,1661,1,22,4,10,78,42,36,70
Airdrieon,1661,2,22,2,12,68,57,11,68
Alloa,1661,3,19,10,7,68,43,25,67
Albion,1661,4,13,10,13,56,54,2,49
Queen's Park,1661,5,12,13,11,47,50,-3,49
Peterhead,1661,6,12,12,12,56,59,-3,48
Brechin,1661,7,14,4,18,38,47,-9,46
East Fife,1661,8,9,12,15,52,55,-3,39
Stranraer,1661,9,11,5,20,42,61,-19,38
Stenhousem'r,1661,10,7,6,23,51,88,-37,27
Livingston,1662,1,24,2,10,72,47,25,74
Alloa,1662,2,21,6,9,69,35,34,69
Airdrieon,1662,3,18,6,12,62,54,8,60
Peterhead,1662,4,16,8,12,59,52,7,56
Brechin,1662,5,16,7,13,44,53,-9,55
Stranraer,1662,6,14,5,17,46,52,-6,47
East Fife,1662,7,12,9,15,54,47,7,45
Albion,1662,8,12,7,17,52,52,0,43
Queen's Park,1662,9,7,11,18,32,60,-28,32
Stenhousem'r,1662,10,5,9,22,44,82,-38,24
Alloa,1663,1,18,10,8,65,40,25,64
Airdrieon,1663,2,17,8,11,59,50,9,59
Livingston,1663,3,17,7,12,60,47,13,58
Albion,1663,4,16,10,10,59,50,9,58
Brechin,1663,5,17,5,14,59,54,5,56
Peterhead,1663,6,12,10,14,49,48,1,46
Queen's Park,1663,7,12,9,15,43,57,-14,45
Stranraer,1663,8,11,9,16,41,51,-10,42
East Fife,1663,9,10,10,16,50,53,-3,40
Stenhousem'r,1663,10,7,8,21,45,80,-35,29
Alloa,1664,1,21,6,9,78,38,40,69
Livingston,1664,2,17,10,9,75,47,28,61
Brechin,1664,3,18,6,12,47,38,9,60
Airdrieon,1664,4,17,4,15,62,60,2,55
Albion,1664,5,12,13,11,55,56,-1,49
Peterhead,1664,6,13,7,16,45,53,-8,46
East Fife,1664,7,11,12,13,44,44,0,45
Queen's Park,1664,8,13,6,17,42,58,-16,45
Stranraer,1664,9,13,4,19,37,55,-18,43
Stenhousem'r,1664,10,5,12,19,37,73,-36,27
Livingston,1665,1,20,5,11,77,46,31,65
Brechin,1665,2,18,5,13,56,51,5,59
Alloa,1665,3,15,12,9,73,55,18,57
Albion,1665,4,15,9,12,50,42,8,54
Airdrieon,1665,5,16,6,14,58,55,3,54
Stranraer,1665,6,14,7,15,55,52,3,49
Peterhead,1665,7,14,7,15,47,55,-8,49
East Fife,1665,8,9,14,13,43,50,-7,41
Queen's Park,1665,9,11,6,19,31,53,-22,39
Stenhousem'r,1665,10,8,9,19,47,78,-31,33
Alloa,1666,1,20,5,11,69,46,23,65
Airdrieon,1666,2,18,6,12,62,50,12,60
Queen's Park,1666,3,18,6,12,42,40,2,60
Livingston,1666,4,18,5,13,69,49,20,59
Brechin,1666,5,17,5,14,46,52,-6,56
Peterhead,1666,6,12,11,13,53,55,-2,47
Albion,1666,7,12,7,17,51,54,-3,43
Stenhousem'r,1666,8,12,6,18,52,68,-16,42
East Fife,1666,9,9,11,16,50,62,-12,38
Stranraer,1666,10,11,4,21,44,62,-18,37
Alloa,1667,1,20,4,12,80,52,28,64
Livingston,1667,2,19,4,13,75,52,23,61
Brechin,1667,3,16,10,10,55,49,6,58
Peterhead,1667,4,15,10,11,59,55,4,55
Airdrieon,1667,5,15,8,13,51,51,0,53
Albion,1667,6,14,8,14,47,48,-1,50
Stranraer,1667,7,14,5,17,47,55,-8,47
Queen's Park,1667,8,12,7,17,41,56,-15,43
East Fife,1667,9,10,9,17,41,50,-9,39
Stenhousem'r,1667,10,8,9,19,47,75,-28,33
Livingston,1668,1,21,6,9,79,48,31,69
Alloa,1668,2,20,8,8,71,39,32,68
Airdrieon,1668,3,18,4,14,60,57,3,58
Albion,1668,4,14,12,10,50,42,8,54
Brechin,1668,5,16,6,14,47,52,-5,54
Peterhead,1668,6,14,7,15,47,52,-5,49
Stranraer,1668,7,12,7,17,57,63,-6,43
East Fife,1668,8,10,12,14,50,49,1,42
Queen's Park,1668,9,10,7,19,34,59,-25,37
Stenhousem'r,1668,10,7,7,22,48,82,-34,28
Livingston,1669,1,24,6,6,83,42,41,78
Alloa,1669,2,19,7,10,70,46,24,64
Airdrieon,1669,3,18,5,13,62,57,5,59
Brechin,1669,4,14,8,14,45,46,-1,50
Albion,1669,5,13,9,14,50,56,-6,48
East Fife,1669,6,11,11,14,53,54,-1,44
Queen's Park,1669,7,11,11,14,37,51,-14,44
Peterhead,1669,8,11,9,16,45,56,-11,42
Stranraer,1669,9,11,8,17,54,62,-8,41
Stenhousem'r,1669,10,6,10,20,43,72,-29,28
Alloa,1670,1,20,8,8,79,44,35,68
Livingston,1670,2,21,1,14,72,51,21,64
Airdrieon,1670,3,20,3,13,62,49,13,63
Brechin,1670,4,16,7,13,48,51,-3,55
Stranraer,1670,5,15,5,16,54,59,-5,50
East Fife,1670,6,13,10,13,53,43,10,49
Queen's Park,1670,7,12,11,13,48,48,0,47
Peterhead,1670,8,13,6,17,44,57,-13,45
Albion,1670,9,10,9,17,46,64,-18,39
Stenhousem'r,1670,10,5,10,21,47,87,-40,25
Livingston,1671,1,24,5,7,85,36,49,77
Airdrieon,1671,2,16,10,10,54,46,8,58
Brechin,1671,3,16,8,12,57,47,10,56
Alloa,1671,4,13,11,12,63,58,5,50
Peterhead,1671,5,12,11,13,50,56,-6,47
Albion,1671,6,12,9,15,45,52,-7,45
Stranraer,1671,7,13,6,17,51,61,-10,45
East Fife,1671,8,10,10,16,59,59,0,40
Queen's Park,1671,9,10,10,16,33,47,-14,40
Stenhousem'r,1671,10,11,6,19,52,87,-35,39
Livingston,1672,1,22,4,10,87,49,38,70
Alloa,1672,2,19,9,8,66,38,28,66
Airdrieon,1672,3,17,5,14,54,56,-2,56
Brechin,1672,4,14,8,14,38,46,-8,50
Albion,1672,5,13,9,14,56,49,7,48
Peterhead,1672,6,13,8,15,51,59,-8,47
Stranraer,1672,7,13,7,16,49,54,-5,46
Queen's Park,1672,8,13,5,18,37,54,-17,44
East Fife,1672,9,10,10,16,47,49,-2,40
Stenhousem'r,1672,10,10,7,19,44,75,-31,37
Livingston,1673,1,22,3,11,81,49,32,69
Alloa,1673,2,20,5,11,77,48,29,65
Airdrieon,1673,3,19,6,11,63,53,10,63
Stranraer,1673,4,16,5,15,50,47,3,53
Queen's Park,1673,5,15,8,13,43,46,-3,53
Brechin,1673,6,14,7,15,44,53,-9,49
Albion,1673,7,13,8,15,50,51,-1,47
Peterhead,1673,8,12,9,15,44,55,-11,45
East Fife,1673,9,10,10,16,42,46,-4,40
Stenhousem'r,1673,10,6,5,25,45,91,-46,23
Alloa,1674,1,23,4,9,76,44,32,73
Airdrieon,1674,2,20,6,10,69,48,21,66
Livingston,1674,3,18,8,10,70,54,16,62
Brechin,1674,4,17,7,12,53,49,4,58
Stranraer,1674,5,14,9,13,62,57,5,51
Albion,1674,6,12,7,17,46,58,-12,43
East Fife,1674,7,9,12,15,45,54,-9,39
Queen's Park,1674,8,10,8,18,27,47,-20,38
Peterhead,1674,9,10,6,20,39,53,-14,36
Stenhousem'r,1674,10,9,9,18,49,72,-23,36
Livingston,1675,1,23,2,11,77,51,26,71
Airdrieon,1675,2,20,3,13,63,55,8,63
Alloa,1675,3,16,9,11,67,45,22,57
Brechin,1675,4,14,9,13,53,52,1,51
Albion,1675,5,14,7,15,66,59,7,49
Peterhead,1675,6,12,10,14,44,55,-11,46
East Fife,1675,7,11,11,14,52,59,-7,44
Stranraer,1675,8,13,4,19,54,63,-9,43
Queen's Park,1675,9,12,7,17,42,52,-10,43
Stenhousem'r,1675,10,11,6,19,49,76,-27,39
Livingston,1676,1,22,6,8,79,49,30,72
Alloa,1676,2,17,9,10,63,38,25,60
East Fife,1676,3,17,6,13,54,47,7,57
Airdrieon,1676,4,15,7,14,59,58,1,52
Albion,1676,5,13,10,13,56,57,-1,49
Queen's Park,1676,6,12,11,13,41,54,-13,47
Brechin,1676,7,12,8,16,45,58,-13,44
Peterhead,1676,8,12,7,17,45,51,-6,43
Stenhousem'r,1676,9,10,11,15,52,65,-13,41
Stranraer,1676,10,10,5,21,39,56,-17,35
Livingston,1677,1,22,5,9,80,43,37,71
Brechin,1677,2,20,4,12,65,45,20,64
Alloa,1677,3,17,7,12,59,46,13,58
Airdrieon,1677,4,16,8,12,60,53,7,56
Queen's Park,1677,5,15,7,14,43,50,-7,52
Albion,1677,6,14,7,15,53,53,0,49
Peterhead,1677,7,14,7,15,50,55,-5,49
East Fife,1677,8,12,8,16,45,46,-1,44
Stranraer,1677,9,12,5,19,41,60,-19,41
Stenhousem'r,1677,10,6,6,24,39,84,-45,24
Livingston,1678,1,25,1,10,77,48,29,76
Alloa,1678,2,19,7,10,68,42,26,64
Albion,1678,3,16,8,12,58,51,7,56
Airdrieon,1678,4,16,8,12,48,47,1,56
Brechin,1678,5,16,7,13,49,46,3,55
Peterhead,1678,6,14,5,17,49,49,0,47
East Fife,1678,7,12,9,15,53,48,5,45
Stranraer,1678,8,12,7,17,48,63,-15,43
Queen's Park,1678,9,12,6,18,37,52,-15,42
Stenhousem'r,1678,10,6,6,24,46,87,-41,24
Livingston,1679,1,19,2,15,65,45,20,59
Albion,1679,2,17,8,11,57,42,15,59
Airdrieon,1679,3,17,6,13,60,61,-1,57
Alloa,1679,4,16,7,13,64,38,26,55
Peterhead,1679,5,15,8,13,49,53,-4,53
Stranraer,1679,6,16,4,16,55,58,-3,52
Queen's Park,1679,7,14,6,16,36,47,-11,48
East Fife,1679,8,13,8,15,45,48,-3,47
Brechin,1679,9,14,5,17,51,59,-8,47
Stenhousem'r,1679,10,7,10,19,39,70,-31,31
Livingston,1680,1,23,2,11,87,50,37,71
Airdrieon,1680,2,17,9,10,62,62,0,60
Alloa,1680,3,15,10,11,61,42,19,55
Peterhead,1680,4,16,6,14,54,48,6,54
Stranraer,1680,5,15,5,16,51,55,-4,50
East Fife,1680,6,12,11,13,53,46,7,47
Brechin,1680,7,13,8,15,45,52,-7,47
Albion,1680,8,11,13,12,44,47,-3,46
Queen's Park,1680,9,11,6,19,36,60,-24,39
Stenhousem'r,1680,10,9,6,21,51,82,-31,33
Livingston,1681,1,23,4,9,87,48,39,73
Alloa,1681,2,18,12,6,75,48,27,66
Airdrieon,1681,3,18,6,12,55,49,6,60
Albion,1681,4,14,11,11,58,54,4,53
East Fife,1681,5,15,7,14,57,50,7,52
Brechin,1681,6,14,7,15,54,58,-4,49
Peterhead,1681,7,14,7,15,53,57,-4,49
Queen's Park,1681,8,11,7,18,34,54,-20,40
Stenhousem'r,1681,9,7,10,19,38,62,-24,31
Stranraer,1681,10,8,5,23,45,76,-31,29
Alloa,1682,1,20,8,8,76,41,35,68
Livingston,1682,2,20,5,11,78,48,30,65
Albion,1682,3,18,6,12,62,53,9,60
Brechin,1682,4,18,5,13,57,41,16,59
Airdrieon,1682,5,16,10,10,57,46,11,58
Stranraer,1682,6,12,6,18,46,65,-19,42
Queen's Park,1682,7,12,5,19,36,58,-22,41
Peterhead,1682,8,10,10,16,45,57,-12,40
Stenhousem'r,1682,9,10,8,18,39,71,-32,38
East Fife,1682,10,8,9,19,43,59,-16,33
Alloa,1683,1,19,7,10,76,50,26,64
Livingston,1683,2,19,6,11,75,50,25,63
Brechin,1683,3,19,4,13,68,53,15,61
East Fife,1683,4,16,8,12,61,46,15,56
Airdrieon,1683,5,15,6,15,58,61,-3,51
Queen's Park,1683,6,15,6,15,48,62,-14,51
Peterhead,1683,7,13,6,17,46,64,-18,45
Albion,1683,8,12,7,17,53,60,-7,43
Stranraer,1683,9,13,4,19,53,69,-16,43
Stenhousem'r,1683,10,6,12,18,51,74,-23,30
Livingston,1684,1,19,7,10,74,53,21,64
Peterhead,1684,2,18,6,12,56,48,8,60
Alloa,1684,3,16,11,9,65,43,22,59
Airdrieon,1684,4,17,8,11,62,54,8,59
Brechin,1684,5,17,6,13,49,43,6,57
Stranraer,1684,6,13,8,15,62,61,1,47
Albion,1684,7,14,5,17,53,54,-1,47
Queen's Park,1684,8,13,4,19,34,51,-17,43
East Fife,1684,9,10,9,17,49,53,-4,39
Stenhousem'r,1684,10,8,6,22,47,91,-44,30
Airdrieon,1685,1,20,7,9,62,48,14,67
Livingston,1685,2,17,7,12,72,49,23,58
Albion,1685,3,17,7,12,66,52,14,58
Alloa,1685,4,15,12,9,65,44,21,57
Queen's Park,1685,5,16,8,12,46,47,-1,56
Peterhead,1685,6,13,9,14,53,54,-1,48
Brechin,1685,7,14,6,16,46,54,-8,48
East Fife,1685,8,12,9,15,51,50,1,45
Stranraer,1685,9,11,7,18,52,67,-15,40
Stenhousem'r,1685,10,5,8,23,40,88,-48,23
Livingston,1686,1,23,6,7,78,41,37,75
Alloa,1686,2,21,6,9,77,43,34,69
Brechin,1686,3,17,4,15,48,44,4,55
Albion,1686,4,15,8,13,53,52,1,53
Airdrieon,1686,5,15,7,14,65,59,6,52
Peterhead,1686,6,14,7,15,41,59,-18,49
Stranraer,1686,7,13,7,16,54,58,-4,46
East Fife,1686,8,12,7,17,46,56,-10,43
Queen's Park,1686,9,9,8,19,32,51,-19,35
Stenhousem'r,1686,10,6,10,20,44,75,-31,28
Livingston,1687,1,22,2,12,72,48,24,68
Alloa,1687,2,20,6,10,76,49,27,66
Airdrieon,1687,3,19,6,11,66,52,14,63
Brechin,1687,4,16,8,12,52,46,6,56
Albion,1687,5,14,7,15,52,52,0,49
Peterhead,1687,6,13,6,17,42,51,-9,45
East Fife,1687,7,12,8,16,52,49,3,44
Stranraer,1687,8,12,6,18,50,60,-10,42
Queen's Park,1687,9,11,7,18,31,58,-27,40
Stenhousem'r,1687,10,9,8,19,52,80,-28,35
Alloa,1688,1,18,9,9,71,42,29,63
Livingston,1688,2,19,6,11,73,47,26,63
Airdrieon,1688,3,18,3,15,66,63,3,57
Peterhead,1688,4,15,10,11,53,54,-1,55
Brechin,1688,5,15,7,14,47,45,2,52
Albion,1688,6,14,8,14,58,54,4,50
East Fife,1688,7,13,6,17,52,57,-5,45
Stranraer,1688,8,12,8,16,51,59,-8,44
Queen's Park,1688,9,10,9,17,36,53,-17,39
Stenhousem'r,1688,10,6,14,16,43,76,-33,32
Livingston,1689,1,22,5,9,65,37,28,71
Alloa,1689,2,19,12,5,80,39,41,69
Brechin,1689,3,18,6,12,53,41,12,60
Peterhead,1689,4,15,10,11,46,48,-2,55
Queen's Park,1689,5,13,8,15,37,42,-5,47
Airdrieon,1689,6,13,5,18,41,55,-14,44
Stranraer,1689,7,12,7,17,43,58,-15,43
Albion,1689,8,10,11,15,44,52,-8,41
Stenhousem'r,1689,9,10,8,18,45,69,-24,38
East Fife,1689,10,8,8,20,41,54,-13,32
Livingston,1690,1,21,5,10,82,51,31,68
Alloa,1690,2,18,10,8,80,45,35,64
Brechin,1690,3,19,5,12,52,44,8,62
Airdrieon,1690,4,17,7,12,66,55,11,58
Stranraer,1690,5,15,5,16,48,61,-13,50
Peterhead,1690,6,13,7,16,49,56,-7,46
Queen's Park,1690,7,12,8,16,37,51,-14,44
East Fife,1690,8,11,9,16,51,45,6,42
Albion,1690,9,11,9,16,50,56,-6,42
Stenhousem'r,1690,10,7,7,22,47,98,-51,28
Peterhead,1691,1,18,9,9,60,43,17,63
Livingston,1691,2,18,7,11,75,51,24,61
Alloa,1691,3,15,11,10,71,50,21,56
Queen's Park,1691,4,15,8,13,46,49,-3,53
Airdrieon,1691,5,13,11,12,52,54,-2,50
Brechin,1691,6,12,14,10,49,52,-3,50
Albion,1691,7,12,11,13,53,52,1,47
East Fife,1691,8,12,9,15,45,55,-10,45
Stranraer,1691,9,8,12,16,45,56,-11,36
Stenhousem'r,1691,10,6,10,20,46,80,-34,28
Livingston,1692,1,23,6,7,83,44,39,75
Alloa,1692,2,18,10,8,63,43,20,64
Brechin,1692,3,19,6,11,48,37,11,63
Airdrieon,1692,4,16,6,14,52,54,-2,54
Albion,1692,5,15,7,14,56,49,7,52
Stranraer,1692,6,11,8,17,51,55,-4,41
Queen's Park,1692,7,11,8,17,28,48,-20,41
East Fife,1692,8,10,10,16,42,46,-4,40
Peterhead,1692,9,10,9,17,38,53,-15,39
Stenhousem'r,1692,10,8,8,20,49,81,-32,32
Alloa,1693,1,23,6,7,76,37,39,75
East Fife,1693,2,17,10,9,71,45,26,61
Airdrieon,1693,3,17,7,12,59,59,0,58
Livingston,1693,4,17,5,14,76,60,16,56
Brechin,1693,5,17,5,14,44,40,4,56
Albion,1693,6,15,5,16,53,58,-5,50
Stranraer,1693,7,13,6,17,47,55,-8,45
Peterhead,1693,8,12,7,17,44,57,-13,43
Queen's Park,1693,9,11,5,20,34,58,-24,38
Stenhousem'r,1693,10,6,8,22,43,78,-35,26
Livingston,1694,1,23,4,9,83,49,34,73
Alloa,1694,2,18,6,12,71,59,12,60
Airdrieon,1694,3,17,6,13,65,59,6,57
Brechin,1694,4,17,6,13,53,51,2,57
East Fife,1694,5,15,9,12,54,44,10,54
Albion,1694,6,14,9,13,54,45,9,51
Peterhead,1694,7,13,8,15,48,55,-7,47
Stranraer,1694,8,12,8,16,42,53,-11,44
Queen's Park,1694,9,12,6,18,45,48,-3,42
Stenhousem'r,1694,10,4,8,24,33,85,-52,20
Alloa,1695,1,23,6,7,85,34,51,75
Airdrieon,1695,2,23,4,9,69,47,22,73
Brechin,1695,3,19,4,13,51,42,9,61
Livingston,1695,4,17,6,13,69,53,16,57
Queen's Park,1695,5,15,7,14,45,50,-5,52
East Fife,1695,6,11,12,13,53,47,6,45
Peterhead,1695,7,12,6,18,38,55,-17,42
Albion,1695,8,11,7,18,43,55,-12,40
Stranraer,1695,9,11,4,21,39,65,-26,37
Stenhousem'r,1695,10,5,10,21,45,89,-44,25
Livingston,1696,1,22,5,9,83,51,32,71
Alloa,1696,2,19,8,9,80,45,35,65
Airdrieon,1696,3,19,4,13,68,56,12,61
Brechin,1696,4,17,6,13,54,50,4,57
Albion,1696,5,12,12,12,53,52,1,48
East Fife,1696,6,13,6,17,50,53,-3,45
Peterhead,1696,7,12,8,16,45,54,-9,44
Stranraer,1696,8,11,6,19,51,64,-13,39
Queen's Park,1696,9,10,9,17,38,60,-22,39
Stenhousem'r,1696,10,9,8,19,45,82,-37,35
Livingston,1697,1,21,6,9,75,47,28,69
Airdrieon,1697,2,19,10,7,64,45,19,67
Alloa,1697,3,20,5,11,76,45,31,65
East Fife,1697,4,15,9,12,58,43,15,54
Brechin,1697,5,15,5,16,48,58,-10,50
Stranraer,1697,6,12,7,17,49,64,-15,43
Albion,1697,7,11,9,16,40,50,-10,42
Peterhead,1697,8,11,9,16,52,66,-14,42
Queen's Park,1697,9,11,8,17,36,49,-13,41
Stenhousem'r,1697,10,5,12,19,36,67,-31,27
Alloa,1698,1,22,6,8,70,36,34,72
Livingston,1698,2,20,6,10,67,43,24,66
Airdrieon,1698,3,17,7,12,61,51,10,58
Brechin,1698,4,15,7,14,47,48,-1,52
Peterhead,1698,5,14,8,14,49,54,-5,50
Stranraer,1698,6,15,4,17,47,53,-6,49
East Fife,1698,7,12,10,14,52,50,2,46
Queen's Park,1698,8,12,6,18,33,48,-15,42
Albion,1698,9,10,8,18,44,60,-16,38
Stenhousem'r,1698,10,8,8,20,40,67,-27,32
Livingston,1699,1,21,3,12,84,51,33,66
Alloa,1699,2,18,9,9,72,38,34,63
Albion,1699,3,17,8,11,54,50,4,59
Brechin,1699,4,17,6,13,56,49,7,57
Airdrieon,1699,5,16,8,12,50,52,-2,56
Peterhead,1699,6,14,10,12,53,59,-6,52
Stranraer,1699,7,12,8,16,52,52,0,44
East Fife,1699,8,11,8,17,49,55,-6,41
Queen's Park,1699,9,10,10,16,39,57,-18,40
Stenhousem'r,1699,10,5,8,23,40,86,-46,23
Brechin,1700,1,20,8,8,63,44,19,68
Livingston,1700,2,19,7,10,77,45,32,64
Alloa,1700,3,17,11,8,65,44,21,62
Airdrieon,1700,4,17,8,11,71,60,11,59
Albion,1700,5,13,9,14,53,59,-6,48
Queen's Park,1700,6,11,13,12,33,45,-12,46
East Fife,1700,7,10,11,15,44,47,-3,41
Peterhead,1700,8,10,11,15,50,57,-7,41
Stranraer,1700,9,10,5,21,49,71,-22,35
Stenhousem'r,1700,10,7,9,20,47,80,-33,30
Livingston,1701,1,19,10,7,70,40,30,67
Alloa,1701,2,20,7,9,68,46,22,67
Peterhead,1701,3,16,7,13,50,46,4,55
Airdrieon,1701,4,15,6,15,52,55,-3,51
Stranraer,1701,5,15,5,16,57,57,0,50
Queen's Park,1701,6,14,8,14,36,47,-11,50
Brechin,1701,7,15,4,17,49,50,-1,49
Albion,1701,8,13,8,15,45,49,-4,47
East Fife,1701,9,11,9,16,47,51,-4,42
Stenhousem'r,1701,10,5,10,21,37,70,-33,25
Livingston,1702,1,20,4,12,66,48,18,64
Brechin,1702,2,19,7,10,52,38,14,64
Alloa,1702,3,16,11,9,61,41,20,59
Albion,1702,4,14,10,12,52,49,3,52
Stranraer,1702,5,16,4,16,58,57,1,52
East Fife,1702,6,14,9,13,52,48,4,51
Peterhead,1702,7,12,10,14,42,50,-8,46
Airdrieon,1702,8,12,5,19,47,58,-11,41
Queen's Park,1702,9,12,5,19,35,48,-13,41
Stenhousem'r,1702,10,8,9,19,43,71,-28,33
Alloa,1703,1,22,7,7,70,36,34,73
Livingston,1703,2,20,5,11,72,50,22,65
Brechin,1703,3,18,6,12,51,46,5,60
Airdrieon,1703,4,16,7,13,48,49,-1,55
East Fife,1703,5,14,9,13,61,47,14,51
Albion,1703,6,12,9,15,49,49,0,45
Stranraer,1703,7,12,7,17,45,57,-12,43
Peterhead,1703,8,11,9,16,48,57,-9,42
Queen's Park,1703,9,11,8,17,32,49,-17,41
Stenhousem'r,1703,10,7,7,22,37,73,-36,28
Livingston,1704,1,23,3,10,85,53,32,72
Alloa,1704,2,18,8,10,76,49,27,62
Airdrieon,1704,3,17,9,10,62,53,9,60
Peterhead,1704,4,13,14,9,50,46,4,53
Albion,1704,5,15,7,14,50,51,-1,52
Brechin,1704,6,14,8,14,42,43,-1,50
Queen's Park,1704,7,14,7,15,56,60,-4,49
East Fife,1704,8,11,8,17,46,52,-6,41
Stranraer,1704,9,11,7,18,52,64,-12,40
Stenhousem'r,1704,10,4,9,23,41,89,-48,21
Livingston,1705,1,21,7,8,81,46,35,70
Alloa,1705,2,17,7,12,57,42,15,58
Airdrieon,1705,3,17,6,13,59,59,0,57
Brechin,1705,4,14,11,11,52,47,5,53
East Fife,1705,5,14,9,13,60,51,9,51
Stranraer,1705,6,15,6,15,58,56,2,51
Albion,1705,7,13,9,14,53,54,-1,48
Peterhead,1705,8,13,6,17,48,53,-5,45
Queen's Park,1705,9,11,8,17,37,55,-18,41
Stenhousem'r,1705,10,7,7,22,46,88,-42,28
Livingston,1706,1,23,4,9,82,38,44,73
Albion,1706,2,18,8,10,69,45,24,62
Alloa,1706,3,16,12,8,66,43,23,60
Brechin,1706,4,16,6,14,46,49,-3,54
Peterhead,1706,5,15,7,14,53,55,-2,52
Airdrieon,1706,6,15,7,14,62,66,-4,52
Stranraer,1706,7,12,9,15,52,58,-6,45
East Fife,1706,8,9,11,16,45,53,-8,38
Queen's Park,1706,9,10,7,19,36,66,-30,37
Stenhousem'r,1706,10,7,7,22,42,80,-38,28
Alloa,1707,1,23,6,7,74,41,33,75
Livingston,1707,2,23,1,12,78,58,20,70
Airdrieon,1707,3,19,7,10,72,53,19,64
Brechin,1707,4,14,8,14,51,47,4,50
Peterhead,1707,5,13,8,15,59,57,2,47
Stranraer,1707,6,14,3,19,48,66,-18,45
Queen's Park,1707,7,12,8,16,37,52,-15,44
Albion,1707,8,11,10,15,54,56,-2,43
East Fife,1707,9,10,8,18,51,53,-2,38
Stenhousem'r,1707,10,8,7,21,49,90,-41,31
Livingston,1708,1,22,5,9,74,46,28,71
Airdrieon,1708,2,19,8,9,61,45,16,65
Alloa,1708,3,18,7,11,64,42,22,61
Brechin,1708,4,19,3,14,58,54,4,60
Albion,1708,5,16,11,9,60,41,19,59
Peterhead,1708,6,15,7,14,51,48,3,52
Stranraer,1708,7,13,4,19,54,62,-8,43
East Fife,1708,8,10,9,17,51,62,-11,39
Queen's Park,1708,9,6,12,18,28,50,-22,30
Stenhousem'r,1708,10,5,8,23,34,85,-51,23
Alloa,1709,1,22,5,9,68,41,27,71
Livingston,1709,2,19,4,13,69,52,17,61
Brechin,1709,3,19,4,13,48,42,6,61
Airdrieon,1709,4,17,6,13,58,53,5,57
Albion,1709,5,16,9,11,50,45,5,57
Peterhead,1709,6,12,12,12,50,49,1,48
East Fife,1709,7,12,11,13,52,43,9,47
Stranraer,1709,8,13,3,20,57,69,-12,42
Queen's Park,1709,9,8,10,18,28,50,-22,34
Stenhousem'r,1709,10,6,8,22,40,76,-36,26
Livingston,1710,1,25,4,7,81,46,35,79
Alloa,1710,2,20,7,9,82,39,43,67
Queen's Park,1710,3,16,7,13,40,43,-3,55
Airdrieon,1710,4,15,6,15,58,66,-8,51
Albion,1710,5,12,12,12,48,51,-3,48
Peterhead,1710,6,13,8,15,46,57,-11,47
Brechin,1710,7,13,7,16,52,58,-6,46
East Fife,1710,8,11,9,16,54,50,4,42
Stranraer,1710,9,12,5,19,53,70,-17,41
Stenhousem'r,1710,10,5,11,20,46,80,-34,26
Alloa,1711,1,22,8,6,75,39,36,74
Livingston,1711,2,21,3,12,75,51,24,66
Albion,1711,3,16,8,12,58,55,3,56
Airdrieon,1711,4,16,5,15,57,56,1,53
Brechin,1711,5,15,5,16,54,53,1,50
Queen's Park,1711,6,14,6,16,38,46,-8,48
East Fife,1711,7,12,8,16,47,48,-1,44
Stranraer,1711,8,12,7,17,49,58,-9,43
Peterhead,1711,9,11,9,16,50,62,-12,42
Stenhousem'r,1711,10,9,5,22,44,79,-35,32
Livingston,1712,1,25,3,8,81,47,34,78
Alloa,1712,2,20,8,8,86,47,39,68
Airdrieon,1712,3,19,7,10,68,52,16,64
Brechin,1712,4,17,3,16,46,52,-6,54
Peterhead,1712,5,15,6,15,56,56,0,51
Albion,1712,6,13,9,14,50,53,-3,48
Stranraer,1712,7,12,8,16,54,60,-6,44
East Fife,1712,8,11,8,17,52,52,0,41
Queen's Park,1712,9,9,7,20,31,59,-28,34
Stenhousem'r,1712,10,6,7,23,53,99,-46,25
Livingston,1713,1,21,2,13,76,47,29,65
Alloa,1713,2,19,8,9,71,43,28,65
Airdrieon,1713,3,20,5,11,59,48,11,65
Brechin,1713,4,19,2,15,49,53,-4,59
Peterhead,1713,5,15,7,14,53,54,-1,52
Albion,1713,6,15,6,15,57,48,9,51
Stranraer,1713,7,13,6,17,57,60,-3,45
Queen's Park,1713,8,12,9,15,36,48,-12,45
East Fife,1713,9,11,8,17,40,44,-4,41
Stenhousem'r,1713,10,5,7,24,41,94,-53,22
Alloa,1714,1,22,6,8,75,44,31,72
Livingston,1714,2,18,10,8,73,48,25,64
Brechin,1714,3,18,8,10,61,50,11,62
Peterhead,1714,4,13,11,12,53,51,2,50
Albion,1714,5,11,13,12,52,53,-1,46
Queen's Park,1714,6,12,9,15,40,53,-13,45
Airdrieon,1714,7,11,10,15,49,65,-16,43
Stranraer,1714,8,9,12,15,46,58,-12,39
East Fife,1714,9,8,11,17,37,42,-5,35
Stenhousem'r,1714,10,8,10,18,43,65,-22,34
Airdrieon,1715,1,21,6,9,64,47,17,69
Livingston,1715,2,19,5,12,74,52,22,62
Alloa,1715,3,19,5,12,67,45,22,62
Brechin,1715,4,17,6,13,52,57,-5,57
Peterhead,1715,5,13,8,15,44,51,-7,47
Queen's Park,1715,6,14,4,18,31,46,-15,46
Stranraer,1715,7,13,6,17,55,63,-8,45
Albion,1715,8,12,6,18,42,55,-13,42
Stenhousem'r,1715,9,10,10,16,56,70,-14,40
East Fife,1715,10,10,8,18,51,50,1,38
Livingston,1716,1,20,6,10,81,57,24,66
Alloa,1716,2,18,10,8,74,46,28,64
Airdrieon,1716,3,18,5,13,54,49,5,59
Brechin,1716,4,16,8,12,56,47,9,56
Albion,1716,5,13,9,14,60,54,6,48
Stranraer,1716,6,13,9,14,47,54,-7,48
Queen's Park,1716,7,12,9,15,39,55,-16,45
East Fife,1716,8,9,11,16,46,55,-9,38
Peterhead,1716,9,9,10,17,47,61,-14,37
Stenhousem'r,1716,10,9,9,18,56,82,-26,36
Alloa,1717,1,21,8,7,76,44,32,71
Brechin,1717,2,19,6,11,57,41,16,63
Albion,1717,3,16,8,12,50,44,6,56
Airdrieon,1717,4,16,6,14,58,55,3,54
Livingston,1717,5,15,6,15,65,54,11,51
Queen's Park,1717,6,16,3,17,40,50,-10,51
East Fife,1717,7,13,10,13,55,49,6,49
Peterhead,1717,8,12,8,16,47,59,-12,44
Stranraer,1717,9,12,5,19,54,64,-10,41
Stenhousem'r,1717,10,5,10,21,47,89,-42,25
Livingston,1718,1,20,6,10,66,47,19,66
Alloa,1718,2,17,8,11,69,50,19,59
Airdrieon,1718,3,17,6,13,57,51,6,57
Peterhead,1718,4,16,7,13,53,46,7,55
Brechin,1718,5,15,9,12,54,44,10,54
Albion,1718,6,16,6,14,52,49,3,54
East Fife,1718,7,13,7,16,53,49,4,46
Stranraer,1718,8,11,10,15,48,56,-8,43
Queen's Park,1718,9,10,8,18,36,59,-23,38
Stenhousem'r,1718,10,8,7,21,51,88,-37,31
Livingston,1719,1,22,4,10,81,53,28,70
Alloa,1719,2,18,7,11,65,45,20,61
Albion,1719,3,17,7,12,56,39,17,58
Airdrieon,1719,4,17,6,13,61,53,8,57
Peterhead,1719,5,15,8,13,54,47,7,53
Brechin,1719,6,15,5,16,46,50,-4,50
Stranraer,1719,7,13,7,16,45,51,-6,46
East Fife,1719,8,10,11,15,43,51,-8,41
Queen's Park,1719,9,11,6,19,34,57,-23,39
Stenhousem'r,1719,10,6,11,19,47,86,-39,29
Alloa,1720,1,19,7,10,76,44,32,64
Livingston,1720,2,19,4,13,75,53,22,61
Airdrieon,1720,3,18,5,13,62,52,10,59
Peterhead,1720,4,17,7,12,56,55,1,58
Brechin,1720,5,16,6,14,49,51,-2,54
East Fife,1720,6,14,10,12,52,47,5,52
Albion,1720,7,12,6,18,51,58,-7,42
Stranraer,1720,8,12,5,19,50,71,-21,41
Queen's Park,1720,9,10,10,16,37,54,-17,40
Stenhousem'r,1720,10,8,10,18,49,72,-23,34
Airdrieon,1721,1,23,4,9,69,45,24,73
Livingston,1721,2,23,2,11,74,44,30,71
Queen's Park,1721,3,17,4,15,38,42,-4,55
Alloa,1721,4,14,11,11,60,47,13,53
Brechin,1721,5,14,8,14,43,44,-1,50
Peterhead,1721,6,12,10,14,43,48,-5,46
Albion,1721,7,12,9,15,52,60,-8,45
Stranraer,1721,8,11,9,16,51,57,-6,42
East Fife,1721,9,9,9,18,50,60,-10,36
Stenhousem'r,1721,10,8,8,20,42,75,-33,32
Livingston,1722,1,19,5,12,69,48,21,62
Brechin,1722,2,17,9,10,54,48,6,60
Airdrieon,1722,3,18,6,12,55,51,4,60
Alloa,1722,4,15,8,13,68,46,22,53
Peterhead,1722,5,15,6,15,55,53,2,51
East Fife,1722,6,13,9,14,47,43,4,48
Albion,1722,7,12,11,13,44,54,-10,47
Stranraer,1722,8,11,8,17,50,52,-2,41
Stenhousem'r,1722,9,11,8,17,48,68,-20,41
Queen's Park,1722,10,11,6,19,39,66,-27,39
Livingston,1723,1,22,4,10,87,55,32,70
Alloa,1723,2,20,6,10,83,48,35,66
Airdrieon,1723,3,18,9,9,65,46,19,63
Albion,1723,4,17,6,13,64,56,8,57
Brechin,1723,5,14,8,14,57,55,2,50
Peterhead,1723,6,13,9,14,41,53,-12,48
Queen's Park,1723,7,13,9,14,35,51,-16,48
East Fife,1723,8,8,11,17,46,57,-11,35
Stranraer,1723,9,9,7,20,45,69,-24,34
Stenhousem'r,1723,10,7,9,20,47,80,-33,30
Livingston,1724,1,19,3,14,70,55,15,60
Alloa,1724,2,17,7,12,71,47,24,58
Peterhead,1724,3,16,9,11,52,42,10,57
Albion,1724,4,15,10,11,57,48,9,55
Stranraer,1724,5,16,6,14,62,62,0,54
Queen's Park,1724,6,14,5,17,35,43,-8,47
Brechin,1724,7,14,5,17,40,52,-12,47
East Fife,1724,8,11,12,13,43,42,1,45
Airdrieon,1724,9,12,7,17,44,58,-14,43
Stenhousem'r,1724,10,11,6,19,52,77,-25,39
Livingston,1725,1,24,4,8,89,44,45,76
Alloa,1725,2,19,9,8,62,42,20,66
Airdrieon,1725,3,17,8,11,59,55,4,59
Peterhead,1725,4,16,7,13,49,44,5,55
Stranraer,1725,5,14,7,15,41,44,-3,49
Brechin,1725,6,15,2,19,42,53,-11,47
Albion,1725,7,13,7,16,56,59,-3,46
Queen's Park,1725,8,12,7,17,45,59,-14,43
East Fife,1725,9,10,10,16,46,52,-6,40
Stenhousem'r,1725,10,5,9,22,41,78,-37,24
Livingston,1726,1,21,3,12,79,57,22,66
Alloa,1726,2,15,13,8,69,47,22,58
Brechin,1726,3,13,13,10,53,47,6,52
Albion,1726,4,13,11,12,52,50,2,50
Queen's Park,1726,5,13,10,13,40,45,-5,49
Airdrieon,1726,6,14,6,16,52,59,-7,48
Stenhousem'r,1726,7,14,5,17,54,75,-21,47
East Fife,1726,8,12,8,16,54,48,6,44
Peterhead,1726,9,11,10,15,50,56,-6,43
Stranraer,1726,10,11,7,18,47,66,-19,40
Alloa,1727,1,20,7,9,69,44,25,67
Peterhead,1727,2,19,4,13,60,45,15,61
Livingston,1727,3,18,4,14,61,50,11,58
Brechin,1727,4,16,7,13,49,51,-2,55
Albion,1727,5,16,6,14,61,56,5,54
Airdrieon,1727,6,14,7,15,59,63,-4,49
Queen's Park,1727,7,13,6,17,41,52,-11,45
Stenhousem'r,1727,8,12,8,16,49,67,-18,44
East Fife,1727,9,10,11,15,51,52,-1,41
Stranraer,1727,10,8,8,20,44,64,-20,32
Livingston,1728,1,21,6,9,78,48,30,69
Brechin,1728,2,15,10,11,50,45,5,55
Alloa,1728,3,16,6,14,76,60,16,54
Airdrieon,1728,4,14,11,11,58,50,8,53
Queen's Park,1728,5,15,8,13,46,50,-4,53
Albion,1728,6,14,10,12,52,47,5,52
Peterhead,1728,7,14,7,15,51,57,-6,49
Stranraer,1728,8,12,9,15,54,61,-7,45
East Fife,1728,9,10,7,19,46,59,-13,37
Stenhousem'r,1728,10,9,6,21,53,87,-34,33
Livingston,1729,1,25,3,8,83,41,42,78
Airdrieon,1729,2,18,10,8,61,47,14,64
Brechin,1729,3,16,8,12,52,48,4,56
Queen's Park,1729,4,17,5,14,44,46,-2,56
East Fife,1729,5,13,7,16,52,44,8,46
Alloa,1729,6,12,10,14,57,55,2,46
Albion,1729,7,13,5,18,57,66,-9,44
Peterhead,1729,8,12,6,18,47,61,-14,42
Stranraer,1729,9,10,10,16,55,64,-9,40
Stenhousem'r,1729,10,7,10,19,39,75,-36,31
Livingston,1730,1,22,6,8,81,42,39,72
Alloa,1730,2,19,8,9,67,44,23,65
Brechin,1730,3,17,9,10,54,39,15,60
Peterhead,1730,4,17,6,13,58,62,-4,57
Airdrieon,1730,5,16,7,13,60,53,7,55
Queen's Park,1730,6,16,5,15,46,46,0,53
Albion,1730,7,13,8,15,49,54,-5,47
Stranraer,1730,8,11,7,18,47,64,-17,40
East Fife,1730,9,8,10,18,43,53,-10,34
Stenhousem'r,1730,10,4,8,24,40,88,-48,20
Livingston,1731,1,24,4,8,82,37,45,76
Alloa,1731,2,22,6,8,63,38,25,72
Brechin,1731,3,20,3,13,56,41,15,63
Airdrieon,1731,4,16,7,13,61,57,4,55
Peterhead,1731,5,14,8,14,49,57,-8,50
Stranraer,1731,6,14,4,18,57,61,-4,46
Albion,1731,7,11,8,17,54,61,-7,41
East Fife,1731,8,10,10,16,44,52,-8,40
Queen's Park,1731,9,12,2,22,31,62,-31,38
Stenhousem'r,1731,10,6,10,20,45,76,-31,28
Peterhead,1732,1,18,11,7,59,46,13,65
Alloa,1732,2,18,8,10,66,49,17,62
Livingston,1732,3,17,8,11,68,53,15,59
Airdrieon,1732,4,16,8,12,60,51,9,56
Brechin,1732,5,16,8,12,53,45,8,56
Albion,1732,6,13,9,14,47,49,-2,48
Queen's Park,1732,7,14,6,16,39,48,-9,48
East Fife,1732,8,11,11,14,56,56,0,44
Stranraer,1732,9,9,5,22,45,67,-22,32
Stenhousem'r,1732,10,8,6,22,44,73,-29,30
Livingston,1733,1,19,5,12,69,53,16,62
Airdrieon,1733,2,18,8,10,66,55,11,62
Alloa,1733,3,18,5,13,68,46,22,59
Albion,1733,4,16,11,9,64,49,15,59
Stranraer,1733,5,16,8,12,55,44,11,56
East Fife,1733,6,13,14,9,60,47,13,53
Brechin,1733,7,12,11,13,49,58,-9,47
Peterhead,1733,8,11,8,17,45,56,-11,41
Queen's Park,1733,9,9,12,15,34,49,-15,39
Stenhousem'r,1733,10,3,8,25,36,89,-53,17
Livingston,1734,1,23,5,8,81,43,38,74
Alloa,1734,2,17,8,11,66,53,13,59
Airdrieon,1734,3,15,8,13,60,60,0,53
Brechin,1734,4,15,6,15,46,46,0,51
Queen's Park,1734,5,14,7,15,42,45,-3,49
Albion,1734,6,13,9,14,51,48,3,48
Peterhead,1734,7,12,11,13,41,46,-5,47
East Fife,1734,8,12,10,14,44,49,-5,46
Stranraer,1734,9,12,6,18,50,62,-12,42
Stenhousem'r,1734,10,8,8,20,40,69,-29,32
Alloa,1735,1,19,7,10,66,38,28,64
Airdrieon,1735,2,17,10,9,75,60,15,61
Albion,1735,3,18,6,12,54,49,5,60
Livingston,1735,4,17,5,14,81,58,23,56
Queen's Park,1735,5,14,9,13,44,51,-7,51
Stranraer,1735,6,14,6,16,59,62,-3,48
Brechin,1735,7,14,5,17,49,58,-9,47
Peterhead,1735,8,12,10,14,46,54,-8,46
East Fife,1735,9,11,9,16,53,55,-2,42
Stenhousem'r,1735,10,8,5,23,59,101,-42,29
Livingston,1736,1,23,4,9,82,39,43,73
Alloa,1736,2,20,10,6,74,40,34,70
Airdrieon,1736,3,16,5,15,54,55,-1,53
Brechin,1736,4,15,6,15,53,57,-4,51
Queen's Park,1736,5,14,7,15,46,57,-11,49
Albion,1736,6,12,12,12,50,51,-1,48
East Fife,1736,7,11,11,14,48,47,1,44
Peterhead,1736,8,11,8,17,49,62,-13,41
Stranraer,1736,9,10,9,17,52,66,-14,39
Stenhousem'r,1736,10,9,6,21,45,79,-34,33
Airdrieon,1737,1,23,4,9,68,46,22,73
Livingston,1737,2,20,4,12,76,53,23,64
Brechin,1737,3,17,6,13,55,50,5,57
Peterhead,1737,4,16,6,14,51,53,-2,54
Alloa,1737,5,15,8,13,66,57,9,53
Albion,1737,6,14,7,15,53,49,4,49
East Fife,1737,7,13,8,15,56,45,11,47
Stranraer,1737,8,13,5,18,61,69,-8,44
Queen's Park,1737,9,11,6,19,31,53,-22,39
Stenhousem'r,1737,10,8,6,22,51,93,-42,30
Alloa,1738,1,23,5,8,75,41,34,74
Livingston,1738,2,17,7,12,81,60,21,58
Airdrieon,1738,3,17,7,12,64,57,7,58
Brechin,1738,4,16,8,12,62,53,9,56
Peterhead,1738,5,16,7,13,52,50,2,55
East Fife,1738,6,12,9,15,48,47,1,45
Albion,1738,7,12,9,15,51,57,-6,45
Queen's Park,1738,8,10,10,16,38,59,-21,40
Stranraer,1738,9,11,4,21,46,61,-15,37
Stenhousem'r,1738,10,10,6,20,42,74,-32,36
Livingston,1739,1,21,4,11,79,47,32,67
Brechin,1739,2,19,5,12,55,54,1,62
Airdrieon,1739,3,19,3,14,61,56,5,60
Alloa,1739,4,16,8,12,72,52,20,56
Stranraer,1739,5,15,4,17,51,54,-3,49
Peterhead,1739,6,13,9,14,56,60,-4,48
Albion,1739,7,14,6,16,52,61,-9,48
Stenhousem'r,1739,8,10,10,16,48,66,-18,40
Queen's Park,1739,9,10,9,17,39,58,-19,39
East Fife,1739,10,10,8,18,54,59,-5,38
Alloa,1740,1,19,7,10,69,44,25,64
Livingston,1740,2,18,8,10,71,49,22,62
Airdrieon,1740,3,18,8,10,57,46,11,62
Brechin,1740,4,15,10,11,49,40,9,55
Peterhead,1740,5,14,7,15,44,51,-7,49
East Fife,1740,6,12,12,12,52,46,6,48
Albion,1740,7,12,12,12,49,49,0,48
Queen's Park,1740,8,10,9,17,36,49,-13,39
Stranraer,1740,9,10,8,18,38,60,-22,38
Stenhousem'r,1740,10,7,9,20,46,77,-31,30
Brechin,1741,1,21,6,9,59,45,14,69
Livingston,1741,2,20,7,9,76,46,30,67
Alloa,1741,3,14,13,9,58,40,18,55
Airdrieon,1741,4,16,7,13,59,58,1,55
Queen's Park,1741,5,14,6,16,43,49,-6,48
Albion,1741,6,12,11,13,52,50,2,47
East Fife,1741,7,11,11,14,51,49,2,44
Peterhead,1741,8,12,6,18,47,64,-17,42
Stranraer,1741,9,12,6,18,45,62,-17,42
Stenhousem'r,1741,10,7,9,20,52,79,-27,30
Livingston,1742,1,24,2,10,84,41,43,74
Alloa,1742,2,18,6,12,68,45,23,60
Peterhead,1742,3,16,8,12,50,45,5,56
Brechin,1742,4,16,6,14,51,48,3,54
Stranraer,1742,5,14,9,13,52,50,2,51
Airdrieon,1742,6,15,6,15,56,57,-1,51
East Fife,1742,7,13,7,16,37,47,-10,46
Queen's Park,1742,8,13,5,18,34,55,-21,44
Albion,1742,9,12,7,17,54,54,0,43
Stenhousem'r,1742,10,8,6,22,42,86,-44,30
Livingston,1743,1,25,2,9,82,49,33,77
Alloa,1743,2,21,5,10,77,51,26,68
Peterhead,1743,3,18,5,13,57,57,0,59
Airdrieon,1743,4,15,9,12,69,65,4,54
Brechin,1743,5,15,5,16,51,60,-9,50
Albion,1743,6,13,6,17,56,63,-7,45
Stranraer,1743,7,12,9,15,48,55,-7,45
East Fife,1743,8,11,8,17,52,55,-3,41
Queen's Park,1743,9,11,5,20,45,59,-14,38
Stenhousem'r,1743,10,8,8,20,53,76,-23,32
Livingston,1744,1,22,2,12,71,47,24,68
Alloa,1744,2,19,9,8,68,43,25,66
Airdrieon,1744,3,17,6,13,59,53,6,57
Queen's Park,1744,4,15,9,12,40,43,-3,54
East Fife,1744,5,14,9,13,51,46,5,51
Albion,1744,6,15,5,16,48,52,-4,50
Peterhead,1744,7,14,7,15,54,57,-3,49
Brechin,1744,8,13,6,17,52,51,1,45
Stranraer,1744,9,12,4,20,43,61,-18,40
Stenhousem'r,1744,10,7,7,22,41,74,-33,28
Livingston,1745,1,25,2,9,88,46,42,77
Alloa,1745,2,22,5,9,76,50,26,71
Airdrieon,1745,3,17,6,13,56,51,5,57
Brechin,1745,4,15,8,13,50,46,4,53
Albion,1745,5,14,7,15,56,56,0,49
Queen's Park,1745,6,13,8,15,44,60,-16,47
Peterhead,1745,7,12,8,16,52,57,-5,44
East Fife,1745,8,11,5,20,48,64,-16,38
Stranraer,1745,9,10,6,20,57,67,-10,36
Stenhousem'r,1745,10,9,9,18,54,84,-30,36
Livingston,1746,1,24,4,8,86,44,42,76
Airdrieon,1746,2,18,8,10,63,53,10,62
Alloa,1746,3,15,9,12,68,58,10,54
Peterhead,1746,4,14,9,13,59,53,6,51
East Fife,1746,5,13,10,13,56,45,11,49
Brechin,1746,6,14,7,15,50,56,-6,49
Albion,1746,7,13,9,14,51,54,-3,48
Queen's Park,1746,8,10,10,16,40,59,-19,40
Stranraer,1746,9,10,6,20,47,64,-17,36
Stenhousem'r,1746,10,9,8,19,51,85,-34,35
Livingston,1747,1,19,7,10,85,58,27,64
Alloa,1747,2,19,7,10,67,43,24,64
Airdrieon,1747,3,16,9,11,60,53,7,57
East Fife,1747,4,14,10,12,59,47,12,52
Albion,1747,5,14,9,13,59,58,1,51
Queen's Park,1747,6,14,8,14,46,52,-6,50
Brechin,1747,7,14,5,17,48,63,-15,47
Peterhead,1747,8,10,11,15,48,55,-7,41
Stenhousem'r,1747,9,11,7,18,56,78,-22,40
Stranraer,1747,10,9,7,20,48,69,-21,34
Livingston,1748,1,21,5,10,79,46,33,68
Airdrieon,1748,2,19,8,9,53,41,12,65
Alloa,1748,3,18,10,8,73,44,29,64
Queen's Park,1748,4,17,5,14,44,49,-5,56
Brechin,1748,5,15,8,13,56,55,1,53
Albion,1748,6,13,7,16,47,43,4,46
Stranraer,1748,7,12,9,15,46,52,-6,45
East Fife,1748,8,10,12,14,43,48,-5,42
Peterhead,1748,9,11,8,17,47,51,-4,41
Stenhousem'r,1748,10,6,4,26,36,95,-59,22
Livingston,1749,1,25,4,7,79,47,32,79
Alloa,1749,2,19,9,8,69,43,26,66
Queen's Park,1749,3,14,9,13,45,44,1,51
Brechin,1749,4,15,6,15,53,53,0,51
Airdrieon,1749,5,16,3,17,58,63,-5,51
Albion,1749,6,13,8,15,55,54,1,47
East Fife,1749,7,12,8,16,47,48,-1,44
Stranraer,1749,8,13,5,18,52,59,-7,44
Peterhead,1749,9,12,7,17,53,66,-13,43
Stenhousem'r,1749,10,8,7,21,47,81,-34,31
Livingston,1750,1,20,4,12,76,54,22,64
Airdrieon,1750,2,18,7,11,63,49,14,61
Alloa,1750,3,17,7,12,63,53,10,58
Brechin,1750,4,16,7,13,43,39,4,55
Peterhead,1750,5,16,6,14,58,53,5,54
Albion,1750,6,16,6,14,59,57,2,54
East Fife,1750,7,14,6,16,58,53,5,48
Stranraer,1750,8,10,9,17,47,60,-13,39
Queen's Park,1750,9,10,9,17,35,48,-13,39
Stenhousem'r,1750,10,9,7,20,45,81,-36,34
Alloa,1751,1,21,5,10,71,43,28,68
Airdrieon,1751,2,19,6,11,57,45,12,63
Livingston,1751,3,18,6,12,74,56,18,60
Brechin,1751,4,18,4,14,57,53,4,58
Peterhead,1751,5,14,9,13,54,50,4,51
Stranraer,1751,6,14,6,16,51,57,-6,48
East Fife,1751,7,14,5,17,52,49,3,47
Albion,1751,8,13,6,17,52,59,-7,45
Queen's Park,1751,9,11,9,16,41,56,-15,42
Stenhousem'r,1751,10,7,6,23,46,87,-41,27
Alloa,1752,1,21,6,9,75,40,35,69
Livingston,1752,2,21,4,11,78,55,23,67
Stranraer,1752,3,18,4,14,56,48,8,58
Brechin,1752,4,18,3,15,56,48,8,57
Albion,1752,5,15,9,12,61,53,8,54
Queen's Park,1752,6,15,7,14,48,57,-9,52
Airdrieon,1752,7,14,6,16,57,66,-9,48
Stenhousem'r,1752,8,11,7,18,60,83,-23,40
Peterhead,1752,9,10,6,20,36,62,-26,36
East Fife,1752,10,7,8,21,49,64,-15,29
Livingston,1753,1,22,5,9,85,43,42,71
Alloa,1753,2,15,13,8,62,39,23,58
Brechin,1753,3,15,10,11,47,40,7,55
Peterhead,1753,4,15,8,13,56,54,2,53
Albion,1753,5,14,8,14,59,56,3,50
Airdrieon,1753,6,13,8,15,56,62,-6,47
Queen's Park,1753,7,12,11,13,36,54,-18,47
East Fife,1753,8,10,11,15,43,49,-6,41
Stranraer,1753,9,9,11,16,45,66,-21,38
Stenhousem'r,1753,10,8,9,19,46,72,-26,33
Livingston,1754,1,23,4,9,86,57,29,73
Alloa,1754,2,19,8,9,68,44,24,65
Queen's Park,1754,3,16,7,13,46,49,-3,55
East Fife,1754,4,14,11,11,65,40,25,53
Brechin,1754,5,16,4,16,51,45,6,52
Airdrieon,1754,6,15,7,14,54,56,-2,52
Albion,1754,7,12,8,16,55,61,-6,44
Peterhead,1754,8,12,7,17,53,68,-15,43
Stranraer,1754,9,10,5,21,48,73,-25,35
Stenhousem'r,1754,10,8,9,19,46,79,-33,33
Livingston,1755,1,21,5,10,79,45,34,68
Alloa,1755,2,20,6,10,69,42,27,66
Airdrieon,1755,3,19,6,11,59,50,9,63
Brechin,1755,4,15,7,14,41,50,-9,52
Stranraer,1755,5,15,6,15,53,55,-2,51
Albion,1755,6,11,11,14,46,46,0,44
Queen's Park,1755,7,13,4,19,34,56,-22,43
Peterhead,1755,8,11,9,16,42,54,-12,42
Stenhousem'r,1755,9,10,9,17,49,68,-19,39
East Fife,1755,10,10,7,19,42,48,-6,37
Livingston,1756,1,19,6,11,77,54,23,63
Airdrieon,1756,2,18,6,12,52,51,1,60
Alloa,1756,3,16,9,11,61,46,15,57
Brechin,1756,4,17,6,13,57,45,12,57
Peterhead,1756,5,14,9,13,48,48,0,51
Albion,1756,6,12,13,11,53,45,8,49
Stranraer,1756,7,14,7,15,51,55,-4,49
East Fife,1756,8,12,9,15,46,47,-1,45
Queen's Park,1756,9,9,9,18,30,52,-22,36
Stenhousem'r,1756,10,9,6,21,47,79,-32,33
Alloa,1757,1,21,7,8,82,45,37,70
Livingston,1757,2,21,6,9,78,53,25,69
Airdrieon,1757,3,20,7,9,55,44,11,67
Albion,1757,4,14,9,13,59,57,2,51
Peterhead,1757,5,15,6,15,52,57,-5,51
East Fife,1757,6,13,10,13,59,48,11,49
Brechin,1757,7,14,6,16,45,54,-9,48
Queen's Park,1757,8,11,9,16,37,49,-12,42
Stranraer,1757,9,12,5,19,55,63,-8,41
Stenhousem'r,1757,10,3,7,26,40,92,-52,16
Alloa,1758,1,22,9,5,71,37,34,75
Livingston,1758,2,20,7,9,70,44,26,67
Brechin,1758,3,17,4,15,50,54,-4,55
Albion,1758,4,14,11,11,49,39,10,53
Airdrieon,1758,5,14,9,13,47,54,-7,51
East Fife,1758,6,12,10,14,54,46,8,46
Stranraer,1758,7,13,6,17,59,59,0,45
Peterhead,1758,8,12,5,19,40,58,-18,41
Queen's Park,1758,9,8,12,16,33,51,-18,36
Stenhousem'r,1758,10,8,7,21,39,70,-31,31
Airdrieon,1759,1,18,9,9,58,49,9,63
Livingston,1759,2,17,7,12,74,55,19,58
Alloa,1759,3,16,8,12,64,50,14,56
East Fife,1759,4,14,10,12,54,49,5,52
Queen's Park,1759,5,14,8,14,47,61,-14,50
Brechin,1759,6,14,7,15,50,51,-1,49
Peterhead,1759,7,14,7,15,53,58,-5,49
Albion,1759,8,11,12,13,58,59,-1,45
Stranraer,1759,9,12,5,19,53,60,-7,41
Stenhousem'r,1759,10,9,9,18,53,72,-19,36
Livingston,1760,1,22,4,10,86,48,38,70
Airdrieon,1760,2,19,9,8,58,42,16,66
Brechin,1760,3,19,3,14,58,46,12,60
Alloa,1760,4,15,8,13,62,45,17,53
Albion,1760,5,12,10,14,54,57,-3,46
Peterhead,1760,6,12,9,15,43,59,-16,45
Stranraer,1760,7,13,4,19,41,61,-20,43
Stenhousem'r,1760,8,11,8,17,49,71,-22,41
East Fife,1760,9,10,10,16,41,42,-1,40
Queen's Park,1760,10,10,9,17,35,56,-21,39
Livingston,1761,1,23,5,8,77,43,34,74
Alloa,1761,2,19,6,11,65,49,16,63
Brechin,1761,3,18,7,11,59,48,11,61
Albion,1761,4,17,9,10,60,51,9,60
Airdrieon,1761,5,16,5,15,52,54,-2,53
East Fife,1761,6,11,10,15,49,52,-3,43
Stranraer,1761,7,12,7,17,43,53,-10,43
Peterhead,1761,8,10,10,16,48,56,-8,40
Queen's Park,1761,9,9,10,17,39,49,-10,37
Stenhousem'r,1761,10,6,9,21,42,79,-37,27
Livingston,1762,1,23,6,7,81,41,40,75
Alloa,1762,2,17,11,8,65,41,24,62
East Fife,1762,3,16,8,12,52,42,10,56
Queen's Park,1762,4,16,6,14,46,46,0,54
Airdrieon,1762,5,16,5,15,61,64,-3,53
Brechin,1762,6,16,4,16,54,59,-5,52
Albion,1762,7,14,9,13,50,48,2,51
Peterhead,1762,8,13,7,16,52,56,-4,46
Stranraer,1762,9,9,10,17,46,58,-12,37
Stenhousem'r,1762,10,2,10,24,42,94,-52,16
Alloa,1763,1,20,10,6,65,34,31,70
Livingston,1763,2,19,4,13,74,55,19,61
East Fife,1763,3,15,9,12,47,42,5,54
Stranraer,1763,4,15,9,12,59,55,4,54
Queen's Park,1763,5,13,8,15,39,55,-16,47
Airdrieon,1763,6,12,10,14,54,55,-1,46
Albion,1763,7,13,7,16,49,56,-7,46
Brechin,1763,8,12,9,15,46,51,-5,45
Peterhead,1763,9,11,9,16,47,53,-6,42
Stenhousem'r,1763,10,7,11,18,45,69,-24,32
Livingston,1764,1,21,4,11,76,51,25,67
Alloa,1764,2,18,8,10,75,51,24,62
Airdrieon,1764,3,18,5,13,61,58,3,59
Albion,1764,4,14,8,14,52,51,1,50
Brechin,1764,5,15,5,16,45,54,-9,50
Stranraer,1764,6,14,7,15,58,57,1,49
Peterhead,1764,7,12,10,14,52,56,-4,46
Queen's Park,1764,8,12,9,15,40,52,-12,45
East Fife,1764,9,11,9,16,46,50,-4,42
Stenhousem'r,1764,10,7,11,18,46,71,-25,32
Livingston,1765,1,21,3,12,83,52,31,66
Alloa,1765,2,18,7,11,60,44,16,61
Brechin,1765,3,18,7,11,63,53,10,61
Airdrieon,1765,4,17,8,11,62,49,13,59
Stranraer,1765,5,16,4,16,50,52,-2,52
East Fife,1765,6,12,12,12,47,41,6,48
Albion,1765,7,12,9,15,59,64,-5,45
Peterhead,1765,8,11,10,15,44,53,-9,43
Queen's Park,1765,9,12,5,19,45,62,-17,41
Stenhousem'r,1765,10,6,9,21,33,76,-43,27
Alloa,1766,1,22,8,6,70,35,35,74
Livingston,1766,2,21,6,9,83,54,29,69
Airdrieon,1766,3,19,7,10,58,44,14,64
Albion,1766,4,16,8,12,61,51,10,56
Stranraer,1766,5,14,4,18,48,51,-3,46
Peterhead,1766,6,13,7,16,49,55,-6,46
East Fife,1766,7,12,7,17,51,57,-6,43
Brechin,1766,8,11,8,17,42,54,-12,41
Queen's Park,1766,9,11,7,18,38,59,-21,40
Stenhousem'r,1766,10,7,6,23,42,82,-40,27
Livingston,1767,1,20,6,10,66,42,24,66
Brechin,1767,2,19,7,10,52,37,15,64
Alloa,1767,3,17,10,9,61,37,24,61
Albion,1767,4,16,8,12,59,53,6,56
Airdrieon,1767,5,14,12,10,60,50,10,54
East Fife,1767,6,12,9,15,45,43,2,45
Peterhead,1767,7,11,11,14,46,47,-1,44
Queen's Park,1767,8,12,7,17,32,50,-18,43
Stranraer,1767,9,9,7,20,50,75,-25,34
Stenhousem'r,1767,10,8,7,21,47,84,-37,31
Livingston,1768,1,24,5,7,83,40,43,77
Alloa,1768,2,22,7,7,72,33,39,73
Stranraer,1768,3,16,6,14,61,56,5,54
Peterhead,1768,4,15,6,15,57,59,-2,51
Brechin,1768,5,15,6,15,48,55,-7,51
Airdrieon,1768,6,14,8,14,60,64,-4,50
Albion,1768,7,14,7,15,52,60,-8,49
Queen's Park,1768,8,10,8,18,32,49,-17,38
East Fife,1768,9,9,10,17,46,54,-8,37
Stenhousem'r,1768,10,6,7,23,42,83,-41,25
Livingston,1769,1,24,4,8,87,52,35,76
Alloa,1769,2,17,12,7,65,46,19,63
Brechin,1769,3,16,7,13,55,49,6,55
Peterhead,1769,4,15,8,13,50,48,2,53
Airdrieon,1769,5,13,8,15,52,60,-8,47
Queen's Park,1769,6,14,4,18,41,56,-15,46
East Fife,1769,7,13,6,17,52,50,2,45
Albion,1769,8,9,16,11,51,56,-5,43
Stranraer,1769,9,13,4,19,47,56,-9,43
Stenhousem'r,1769,10,5,13,18,45,72,-27,28
Livingston,1770,1,21,4,11,67,51,16,67
Brechin,1770,2,18,8,10,56,51,5,62
Alloa,1770,3,18,7,11,71,44,27,61
Peterhead,1770,4,17,8,11,50,44,6,59
Airdrieon,1770,5,18,4,14,62,59,3,58
Albion,1770,6,13,6,17,56,57,-1,45
Stranraer,1770,7,12,8,16,46,49,-3,44
Queen's Park,1770,8,12,7,17,36,50,-14,43
East Fife,1770,9,9,12,15,53,53,0,39
Stenhousem'r,1770,10,7,6,23,49,88,-39,27
Livingston,1771,1,20,7,9,78,44,34,67
Airdrieon,1771,2,19,6,11,60,46,14,63
Alloa,1771,3,16,11,9,65,54,11,59
Peterhead,1771,4,16,8,12,44,42,2,56
Brechin,1771,5,12,12,12,43,55,-12,48
East Fife,1771,6,11,10,15,43,46,-3,43
Queen's Park,1771,7,12,7,17,48,53,-5,43
Albion,1771,8,11,8,17,42,59,-17,41
Stenhousem'r,1771,9,10,10,16,56,68,-12,40
Stranraer,1771,10,9,9,18,46,58,-12,36
Alloa,1772,1,24,5,7,83,40,43,77
Livingston,1772,2,17,8,11,71,55,16,59
Peterhead,1772,3,17,7,12,59,51,8,58
Brechin,1772,4,15,8,13,49,48,1,53
Airdrieon,1772,5,15,5,16,61,67,-6,50
Albion,1772,6,13,8,15,51,51,0,47
East Fife,1772,7,12,8,16,45,44,1,44
Queen's Park,1772,8,12,6,18,45,57,-12,42
Stenhousem'r,1772,9,11,6,19,52,77,-25,39
Stranraer,1772,10,12,3,21,54,80,-26,39
Airdrieon,1773,1,22,5,9,77,46,31,71
Livingston,1773,2,21,3,12,73,54,19,66
Alloa,1773,3,16,10,10,65,46,19,58
Albion,1773,4,13,11,12,46,46,0,50
Peterhead,1773,5,12,10,14,47,57,-10,46
Queen's Park,1773,6,14,4,18,37,51,-14,46
Stranraer,1773,7,13,5,18,49,62,-13,44
Brechin,1773,8,12,7,17,45,55,-10,43
East Fife,1773,9,9,13,14,47,46,1,40
Stenhousem'r,1773,10,11,6,19,51,74,-23,39
Airdrieon,1774,1,20,7,9,63,52,11,67
Livingston,1774,2,19,4,13,77,55,22,61
Albion,1774,3,17,10,9,59,42,17,61
Brechin,1774,4,18,7,11,58,42,16,61
Alloa,1774,5,15,11,10,67,51,16,56
Peterhead,1774,6,14,7,15,61,64,-3,49
Stranraer,1774,7,12,6,18,50,62,-12,42
Queen's Park,1774,8,10,8,18,38,62,-24,38
Stenhousem'r,1774,9,8,10,18,52,78,-26,34
East Fife,1774,10,8,8,20,44,61,-17,32
Livingston,1775,1,19,7,10,72,49,23,64
Airdrieon,1775,2,17,8,11,59,45,14,59
Alloa,1775,3,16,7,13,67,53,14,55
Brechin,1775,4,16,7,13,52,50,2,55
Albion,1775,5,15,6,15,53,54,-1,51
East Fife,1775,6,13,11,12,51,48,3,50
Stranraer,1775,7,14,8,14,53,60,-7,50
Queen's Park,1775,8,13,6,17,45,49,-4,45
Peterhead,1775,9,12,8,16,50,54,-4,44
Stenhousem'r,1775,10,7,8,21,42,82,-40,29
Brechin,1776,1,21,5,10,55,40,15,68
Alloa,1776,2,20,6,10,76,44,32,66
Airdrieon,1776,3,19,7,10,67,46,21,64
Livingston,1776,4,18,6,12,70,54,16,60
Albion,1776,5,16,7,13,55,54,1,55
East Fife,1776,6,11,12,13,47,42,5,45
Peterhead,1776,7,12,9,15,43,52,-9,45
Queen's Park,1776,8,10,8,18,38,57,-19,38
Stranraer,1776,9,9,7,20,43,62,-19,34
Stenhousem'r,1776,10,7,7,22,42,85,-43,28
Livingston,1777,1,20,10,6,79,45,34,70
Brechin,1777,2,19,7,10,60,46,14,64
East Fife,1777,3,16,10,10,58,36,22,58
Peterhead,1777,4,16,8,12,54,52,2,56
Alloa,1777,5,15,7,14,66,48,18,52
Airdrieon,1777,6,14,6,16,53,59,-6,48
Albion,1777,7,12,11,13,50,54,-4,47
Stranraer,1777,8,13,6,17,51,63,-12,45
Queen's Park,1777,9,9,7,20,29,57,-28,34
Stenhousem'r,1777,10,5,10,21,42,82,-40,25
Alloa,1778,1,22,7,7,76,41,35,73
Livingston,1778,2,20,4,12,77,51,26,64
Airdrieon,1778,3,18,5,13,59,55,4,59
Brechin,1778,4,17,5,14,47,43,4,56
Albion,1778,5,12,11,13,58,55,3,47
Stranraer,1778,6,14,5,17,50,55,-5,47
Stenhousem'r,1778,7,12,8,16,53,72,-19,44
Peterhead,1778,8,11,9,16,53,69,-16,42
Queen's Park,1778,9,11,6,19,38,57,-19,39
East Fife,1778,10,8,10,18,41,54,-13,34
Livingston,1779,1,20,8,8,72,44,28,68
Airdrieon,1779,2,18,9,9,66,50,16,63
Alloa,1779,3,18,8,10,73,41,32,62
Brechin,1779,4,16,7,13,52,50,2,55
Peterhead,1779,5,16,7,13,54,55,-1,55
Albion,1779,6,15,8,13,62,62,0,53
Queen's Park,1779,7,11,8,17,32,52,-20,41
East Fife,1779,8,10,10,16,43,46,-3,40
Stranraer,1779,9,9,8,19,47,67,-20,35
Stenhousem'r,1779,10,6,9,21,42,76,-34,27
Alloa,1780,1,22,6,8,75,42,33,72
Livingston,1780,2,19,6,11,65,43,22,63
East Fife,1780,3,17,7,12,63,43,20,58
Albion,1780,4,17,7,12,60,49,11,58
Brechin,1780,5,17,7,12,60,52,8,58
Airdrieon,1780,6,16,7,13,59,56,3,55
Peterhead,1780,7,13,7,16,45,54,-9,46
Queen's Park,1780,8,12,4,20,29,57,-28,40
Stranraer,1780,9,10,4,22,42,59,-17,34
Stenhousem'r,1780,10,5,9,22,40,83,-43,24
Livingston,1781,1,22,5,9,74,44,30,71
Brechin,1781,2,19,6,11,49,39,10,63
Stranraer,1781,3,17,4,15,56,46,10,55
East Fife,1781,4,14,11,11,52,39,13,53
Alloa,1781,5,15,8,13,56,46,10,53
Airdrieon,1781,6,15,6,15,54,59,-5,51
Queen's Park,1781,7,14,6,16,36,51,-15,48
Peterhead,1781,8,13,5,18,51,53,-2,44
Albion,1781,9,11,10,15,50,58,-8,43
Stenhousem'r,1781,10,6,7,23,39,82,-43,25
Alloa,1782,1,24,6,6,84,40,44,78
Brechin,1782,2,22,4,10,52,33,19,70
Livingston,1782,3,17,6,13,65,53,12,57
Albion,1782,4,16,7,13,59,61,-2,55
Stranraer,1782,5,15,7,14,52,48,4,52
Airdrieon,1782,6,15,7,14,51,47,4,52
Peterhead,1782,7,11,8,17,44,59,-15,41
Queen's Park,1782,8,10,8,18,31,55,-24,38
East Fife,1782,9,9,9,18,47,57,-10,36
Stenhousem'r,1782,10,6,8,22,39,71,-32,26
Alloa,1783,1,22,5,9,75,42,33,71
Livingston,1783,2,20,3,13,77,56,21,63
Airdrieon,1783,3,18,6,12,61,57,4,60
Peterhead,1783,4,17,7,12,52,47,5,58
Albion,1783,5,15,8,13,66,60,6,53
Brechin,1783,6,13,8,15,46,46,0,47
East Fife,1783,7,13,7,16,52,59,-7,46
Stranraer,1783,8,12,8,16,54,55,-1,44
Queen's Park,1783,9,12,6,18,32,51,-19,42
Stenhousem'r,1783,10,6,6,24,42,84,-42,24
Airdrieon,1784,1,18,10,8,68,48,20,64
Alloa,1784,2,18,9,9,66,38,28,63
Livingston,1784,3,20,3,13,71,50,21,63
Albion,1784,4,17,7,12,56,46,10,58
Queen's Park,1784,5,15,6,15,39,47,-8,51
Brechin,1784,6,14,8,14,48,48,0,50
East Fife,1784,7,13,10,13,50,47,3,49
Peterhead,1784,8,13,7,16,51,59,-8,46
Stranraer,1784,9,11,5,20,48,63,-15,38
Stenhousem'r,1784,10,5,7,24,38,89,-51,22
Livingston,1785,1,23,4,9,76,44,32,73
Brechin,1785,2,19,6,11,52,41,11,63
Alloa,1785,3,17,7,12,69,50,19,58
Peterhead,1785,4,16,7,13,51,53,-2,55
Stranraer,1785,5,16,3,17,54,60,-6,51
Airdrieon,1785,6,13,7,16,51,47,4,46
Queen's Park,1785,7,12,8,16,38,54,-16,44
Albion,1785,8,12,7,17,54,52,2,43
East Fife,1785,9,11,10,15,43,46,-3,43
Stenhousem'r,1785,10,6,11,19,45,86,-41,29
Alloa,1786,1,18,8,10,74,50,24,62
Livingston,1786,2,18,4,14,65,47,18,58
Brechin,1786,3,17,6,13,54,46,8,57
Airdrieon,1786,4,16,7,13,55,57,-2,55
Albion,1786,5,14,9,13,51,49,2,51
Peterhead,1786,6,15,6,15,47,49,-2,51
Queen's Park,1786,7,15,5,16,46,52,-6,50
East Fife,1786,8,10,13,13,53,51,2,43
Stranraer,1786,9,12,5,19,47,62,-15,41
Stenhousem'r,1786,10,9,9,18,50,79,-29,36
Livingston,1787,1,19,7,10,78,51,27,64
Brechin,1787,2,19,6,11,57,43,14,63
Alloa,1787,3,15,11,10,60,46,14,56
Peterhead,1787,4,14,11,11,56,51,5,53
Airdrieon,1787,5,14,11,11,54,49,5,53
Albion,1787,6,13,10,13,51,51,0,49
Queen's Park,1787,7,14,7,15,38,46,-8,49
Stranraer,1787,8,9,10,17,40,56,-16,37
East Fife,1787,9,9,9,18,48,56,-8,36
Stenhousem'r,1787,10,8,10,18,42,75,-33,34
Livingston,1788,1,23,5,8,78,43,35,74
Alloa,1788,2,18,7,11,64,42,22,61
Albion,1788,3,18,7,11,55,46,9,61
Airdrieon,1788,4,17,8,11,60,53,7,59
Stranraer,1788,5,16,5,15,57,55,2,53
Brechin,1788,6,15,5,16,54,53,1,50
East Fife,1788,7,11,10,15,38,39,-1,43
Peterhead,1788,8,11,9,16,50,64,-14,42
Queen's Park,1788,9,11,6,19,31,54,-23,39
Stenhousem'r,1788,10,6,6,24,44,82,-38,24
Livingston,1789,1,19,6,11,74,47,27,63
Alloa,1789,2,17,11,8,61,40,21,62
Airdrieon,1789,3,17,8,11,58,55,3,59
Brechin,1789,4,16,7,13,47,48,-1,55
Albion,1789,5,15,7,14,61,58,3,52
Stranraer,1789,6,15,5,16,46,52,-6,50
Peterhead,1789,7,14,7,15,56,56,0,49
East Fife,1789,8,12,11,13,48,44,4,47
Queen's Park,1789,9,10,11,15,40,53,-13,41
Stenhousem'r,1789,10,4,9,23,47,85,-38,21
Livingston,1790,1,23,4,9,83,50,33,73
Airdrieon,1790,2,19,5,12,71,57,14,62
Alloa,1790,3,17,10,9,58,41,17,61
Brechin,1790,4,18,6,12,55,42,13,60
Peterhead,1790,5,14,9,13,47,54,-7,51
Queen's Park,1790,6,14,6,16,38,48,-10,48
Stranraer,1790,7,14,5,17,61,61,0,47
East Fife,1790,8,11,10,15,45,45,0,43
Albion,1790,9,11,9,16,49,64,-15,42
Stenhousem'r,1790,10,3,8,25,39,84,-45,17
Alloa,1791,1,22,6,8,68,38,30,72
Livingston,1791,2,22,4,10,74,49,25,70
Brechin,1791,3,18,4,14,60,46,14,58
Airdrieon,1791,4,17,5,14,66,57,9,56
Albion,1791,5,16,8,12,62,53,9,56
Peterhead,1791,6,16,6,14,56,54,2,54
Stranraer,1791,7,14,5,17,50,59,-9,47
East Fife,1791,8,11,8,17,48,55,-7,41
Queen's Park,1791,9,9,6,21,34,60,-26,33
Stenhousem'r,1791,10,6,6,24,45,92,-47,24
Albion,1792,1,17,10,9,55,38,17,61
Livingston,1792,2,18,6,12,74,51,23,60
Alloa,1792,3,17,9,10,64,44,20,60
Airdrieon,1792,4,17,8,11,56,50,6,59
Stranraer,1792,5,17,3,16,61,59,2,54
Peterhead,1792,6,13,9,14,51,57,-6,48
Brechin,1792,7,14,5,17,45,54,-9,47
Queen's Park,1792,8,12,7,17,38,54,-16,43
East Fife,1792,9,8,12,16,41,50,-9,36
Stenhousem'r,1792,10,7,11,18,43,71,-28,32
Airdrieon,1793,1,22,2,12,66,51,15,68
Alloa,1793,2,19,8,9,67,39,28,65
Livingston,1793,3,19,6,11,70,46,24,63
Brechin,1793,4,19,6,11,58,51,7,63
Peterhead,1793,5,15,8,13,46,55,-9,53
East Fife,1793,6,13,8,15,51,45,6,47
Queen's Park,1793,7,13,6,17,41,58,-17,45
Stranraer,1793,8,11,7,18,54,67,-13,40
Albion,1793,9,9,9,18,44,54,-10,36
Stenhousem'r,1793,10,6,8,22,46,77,-31,26
Livingston,1794,1,23,3,10,84,56,28,72
Alloa,1794,2,20,7,9,78,53,25,67
Brechin,1794,3,20,3,13,58,50,8,63
Peterhead,1794,4,18,6,12,63,44,19,60
Airdrieon,1794,5,17,5,14,71,66,5,56
East Fife,1794,6,15,7,14,58,52,6,52
Stranraer,1794,7,12,6,18,42,63,-21,42
Queen's Park,1794,8,12,5,19,39,52,-13,41
Albion,1794,9,10,5,21,60,75,-15,35
Stenhousem'r,1794,10,6,7,23,51,93,-42,25
Livingston,1795,1,21,5,10,70,43,27,68
Alloa,1795,2,20,7,9,81,46,35,67
Airdrieon,1795,3,19,6,11,64,49,15,63
Brechin,1795,4,15,7,14,55,54,1,52
East Fife,1795,5,14,7,15,67,64,3,49
Stranraer,1795,6,14,5,17,53,57,-4,47
Albion,1795,7,12,9,15,54,69,-15,45
Queen's Park,1795,8,12,7,17,38,49,-11,43
Peterhead,1795,9,11,10,15,44,56,-12,43
Stenhousem'r,1795,10,7,7,22,46,85,-39,28
Livingston,1796,1,21,2,13,81,51,30,65
Alloa,1796,2,20,5,11,73,51,22,65
Airdrieon,1796,3,19,6,11,65,46,19,63
Brechin,1796,4,18,4,14,58,52,6,58
Queen's Park,1796,5,15,5,16,43,48,-5,50
Albion,1796,6,13,8,15,49,54,-5,47
Peterhead,1796,7,13,7,16,46,56,-10,46
East Fife,1796,8,11,10,15,45,48,-3,43
Stranraer,1796,9,11,8,17,45,63,-18,41
Stenhousem'r,1796,10,8,7,21,51,87,-36,31
Alloa,1797,1,19,12,5,68,33,35,69
Livingston,1797,2,20,4,12,68,47,21,64
Airdrieon,1797,3,17,9,10,63,56,7,60
Brechin,1797,4,15,9,12,50,43,7,54
Albion,1797,5,13,9,14,54,53,1,48
Stranraer,1797,6,11,10,15,46,53,-7,43
Stenhousem'r,1797,7,10,11,15,51,61,-10,41
Queen's Park,1797,8,11,8,17,31,55,-24,41
East Fife,1797,9,10,9,17,48,51,-3,39
Peterhead,1797,10,8,11,17,39,66,-27,35
Alloa,1798,1,19,8,9,72,44,28,65
Livingston,1798,2,19,6,11,73,54,19,63
Brechin,1798,3,16,8,12,54,50,4,56
Airdrieon,1798,4,15,10,11,66,55,11,55
Stranraer,1798,5,15,5,16,48,50,-2,50
Peterhead,1798,6,13,10,13,51,50,1,49
Queen's Park,1798,7,12,13,11,43,48,-5,49
Albion,1798,8,9,13,14,52,60,-8,40
East Fife,1798,9,10,9,17,45,50,-5,39
Stenhousem'r,1798,10,6,10,20,40,83,-43,28
Livingston,1799,1,21,5,10,88,66,22,68
Airdrieon,1799,2,20,6,10,61,48,13,66
Alloa,1799,3,19,7,10,70,37,33,64
Brechin,1799,4,17,7,12,58,49,9,58
Peterhead,1799,5,13,11,12,44,43,1,50
Queen's Park,1799,6,14,7,15,43,43,0,49
Stranraer,1799,7,13,8,15,51,57,-6,47
Albion,1799,8,9,12,15,50,56,-6,39
East Fife,1799,9,9,11,16,39,52,-13,38
Stenhousem'r,1799,10,6,4,26,41,94,-53,22
Alloa,1800,1,20,7,9,74,39,35,67
Livingston,1800,2,20,6,10,77,47,30,66
Airdrieon,1800,3,18,6,12,62,49,13,60
Brechin,1800,4,16,9,11,54,50,4,57
Albion,1800,5,14,9,13,54,55,-1,51
Stranraer,1800,6,15,5,16,47,52,-5,50
Peterhead,1800,7,14,7,15,49,56,-7,49
East Fife,1800,8,10,13,13,48,48,0,43
Queen's Park,1800,9,10,8,18,29,49,-20,38
Stenhousem'r,1800,10,3,10,23,38,87,-49,19
Livingston,1801,1,24,4,8,88,47,41,76
Alloa,1801,2,21,6,9,78,47,31,69
Airdrieon,1801,3,21,4,11,64,55,9,67
Peterhead,1801,4,15,6,15,53,50,3,51
Brechin,1801,5,15,6,15,46,50,-4,51
East Fife,1801,6,12,9,15,53,53,0,45
Albion,1801,7,11,9,16,52,60,-8,42
Stranraer,1801,8,12,4,20,44,64,-20,40
Queen's Park,1801,9,8,10,18,32,51,-19,34
Stenhousem'r,1801,10,7,10,19,50,83,-33,31
Livingston,1802,1,21,6,9,74,43,31,69
Airdrieon,1802,2,19,6,11,64,52,12,63
Alloa,1802,3,17,7,12,67,53,14,58
Albion,1802,4,16,7,13,56,49,7,55
Brechin,1802,5,16,4,16,49,58,-9,52
Peterhead,1802,6,14,9,13,56,52,4,51
Queen's Park,1802,7,13,7,16,33,46,-13,46
Stranraer,1802,8,12,7,17,51,55,-4,43
East Fife,1802,9,10,9,17,47,55,-8,39
Stenhousem'r,1802,10,8,6,22,38,72,-34,30
Alloa,1803,1,23,6,7,72,38,34,75
Livingston,1803,2,20,3,13,79,55,24,63
Brechin,1803,3,18,6,12,51,44,7,60
Airdrieon,1803,4,18,5,13,59,53,6,59
Peterhead,1803,5,16,7,13,58,53,5,55
Stranraer,1803,6,15,5,16,49,53,-4,50
Albion,1803,7,11,9,16,43,55,-12,42
Queen's Park,1803,8,11,7,18,38,52,-14,40
East Fife,1803,9,8,10,18,44,52,-8,34
Stenhousem'r,1803,10,6,10,20,44,82,-38,28
Brechin,1804,1,18,9,9,55,36,19,63
Alloa,1804,2,18,8,10,69,47,22,62
Livingston,1804,3,18,6,12,75,49,26,60
Airdrieon,1804,4,16,10,10,50,45,5,58
Albion,1804,5,11,15,10,54,51,3,48
Stranraer,1804,6,12,10,14,49,52,-3,46
Peterhead,1804,7,11,10,15,41,56,-15,43
East Fife,1804,8,10,9,17,46,55,-9,39
Stenhousem'r,1804,9,10,8,18,49,69,-20,38
Queen's Park,1804,10,9,9,18,29,57,-28,36
Livingston,1805,1,19,5,12,65,45,20,62
Alloa,1805,2,18,7,11,69,47,22,61
Brechin,1805,3,19,4,13,51,51,0,61
Airdrieon,1805,4,17,7,12,58,50,8,58
Albion,1805,5,17,7,12,57,49,8,58
Queen's Park,1805,6,15,6,15,43,46,-3,51
East Fife,1805,7,12,6,18,55,57,-2,42
Stenhousem'r,1805,8,11,8,17,49,67,-18,41
Peterhead,1805,9,10,8,18,48,59,-11,38
Stranraer,1805,10,9,8,19,47,71,-24,35
Alloa,1806,1,23,6,7,79,41,38,75
Livingston,1806,2,19,8,9,72,40,32,65
Airdrieon,1806,3,19,7,10,68,56,12,64
East Fife,1806,4,12,12,12,48,39,9,48
Brechin,1806,5,15,3,18,42,48,-6,48
Peterhead,1806,6,13,8,15,52,55,-3,47
Albion,1806,7,13,8,15,48,55,-7,47
Queen's Park,1806,8,10,11,15,36,57,-21,41
Stranraer,1806,9,9,6,21,42,65,-23,33
Stenhousem'r,1806,10,8,9,19,44,75,-31,33
Livingston,1807,1,21,5,10,75,51,24,68
Alloa,1807,2,18,9,9,67,40,27,63
Airdrieon,1807,3,18,5,13,60,48,12,59
Brechin,1807,4,17,7,12,53,49,4,58
Albion,1807,5,16,6,14,52,51,1,54
East Fife,1807,6,13,9,14,54,52,2,48
Peterhead,1807,7,13,7,16,53,56,-3,46
Stranraer,1807,8,13,5,18,57,64,-7,44
Queen's Park,1807,9,10,8,18,33,51,-18,38
Stenhousem'r,1807,10,7,7,22,42,84,-42,28
Livingston,1808,1,20,8,8,67,39,28,68
Alloa,1808,2,17,9,10,71,47,24,60
Brechin,1808,3,17,5,14,53,49,4,56
Airdrieon,1808,4,16,5,15,54,54,0,53
East Fife,1808,5,13,11,12,56,46,10,50
Albion,1808,6,14,6,16,44,49,-5,48
Queen's Park,1808,7,12,8,16,37,52,-15,44
Stranraer,1808,8,12,5,19,50,65,-15,41
Stenhousem'r,1808,9,10,11,15,62,78,-16,41
Peterhead,1808,10,10,10,16,47,62,-15,40
Alloa,1809,1,18,10,8,69,39,30,64
Livingston,1809,2,19,7,10,70,48,22,64
Airdrieon,1809,3,17,11,8,64,52,12,62
Brechin,1809,4,18,7,11,56,40,16,61
Peterhead,1809,5,18,7,11,61,51,10,61
Stranraer,1809,6,15,6,15,57,53,4,51
Queen's Park,1809,7,13,5,18,43,59,-16,44
East Fife,1809,8,10,11,15,47,49,-2,41
Albion,1809,9,9,8,19,48,71,-23,35
Stenhousem'r,1809,10,3,8,25,38,91,-53,17
Livingston,1810,1,21,4,11,80,52,28,67
Airdrieon,1810,2,18,11,7,60,46,14,65
Alloa,1810,3,18,9,9,69,44,25,63
Queen's Park,1810,4,15,7,14,36,43,-7,52
Brechin,1810,5,15,6,15,51,46,5,51
Albion,1810,6,14,8,14,59,61,-2,50
Peterhead,1810,7,12,9,15,44,55,-11,45
East Fife,1810,8,10,9,17,41,49,-8,39
Stranraer,1810,9,10,9,17,42,59,-17,39
Stenhousem'r,1810,10,5,12,19,47,74,-27,27
Livingston,1811,1,25,5,6,77,37,40,80
Peterhead,1811,2,21,5,10,64,41,23,68
Alloa,1811,3,16,8,12,63,43,20,56
Brechin,1811,4,15,6,15,47,53,-6,51
Airdrieon,1811,5,14,6,16,47,59,-12,48
Albion,1811,6,13,6,17,48,51,-3,45
Stranraer,1811,7,10,12,14,48,59,-11,42
Queen's Park,1811,8,9,12,15,42,57,-15,39
East Fife,1811,9,9,11,16,45,51,-6,38
Stenhousem'r,1811,10,8,9,19,42,72,-30,33
Livingston,1812,1,21,3,12,75,50,25,66
Alloa,1812,2,18,9,9,71,48,23,63
East Fife,1812,3,17,5,14,55,51,4,56
Brechin,1812,4,16,7,13,55,53,2,55
Airdrieon,1812,5,15,8,13,55,56,-1,53
Peterhead,1812,6,14,9,13,54,55,-1,51
Stranraer,1812,7,11,10,15,55,60,-5,43
Albion,1812,8,11,9,16,48,54,-6,42
Stenhousem'r,1812,9,11,7,18,54,73,-19,40
Queen's Park,1812,10,8,9,19,36,58,-22,33
Livingston,1813,1,25,4,7,104,52,52,79
Alloa,1813,2,19,5,12,71,46,25,62
Brechin,1813,3,16,7,13,55,46,9,55
Peterhead,1813,4,16,6,14,52,53,-1,54
Airdrieon,1813,5,15,6,15,62,69,-7,51
Albion,1813,6,14,6,16,52,64,-12,48
East Fife,1813,7,13,8,15,55,51,4,47
Queen's Park,1813,8,12,8,16,47,58,-11,44
Stranraer,1813,9,12,5,19,50,72,-22,41
Stenhousem'r,1813,10,7,7,22,49,86,-37,28
Airdrieon,1814,1,21,4,11,65,51,14,67
Livingston,1814,2,21,2,13,77,54,23,65
Peterhead,1814,3,15,10,11,49,41,8,55
Alloa,1814,4,16,6,14,66,56,10,54
Brechin,1814,5,16,6,14,46,50,-4,54
Queen's Park,1814,6,14,9,13,42,44,-2,51
Albion,1814,7,13,9,14,52,51,1,48
East Fife,1814,8,12,8,16,50,49,1,44
Stranraer,1814,9,10,9,17,46,61,-15,39
Stenhousem'r,1814,10,8,5,23,43,79,-36,29
Livingston,1815,1,23,5,8,76,44,32,74
Alloa,1815,2,17,11,8,65,39,26,62
Brechin,1815,3,16,8,12,56,43,13,56
Airdrieon,1815,4,15,8,13,56,54,2,53
Peterhead,1815,5,14,10,12,48,49,-1,52
Albion,1815,6,12,11,13,48,55,-7,47
East Fife,1815,7,12,9,15,45,44,1,45
Queen's Park,1815,8,10,10,16,37,57,-20,40
Stranraer,1815,9,11,6,19,45,56,-11,39
Stenhousem'r,1815,10,6,10,20,46,81,-35,28
Alloa,1816,1,20,9,7,79,44,35,69
Livingston,1816,2,18,8,10,74,52,22,62
Airdrieon,1816,3,17,6,13,59,54,5,57
Brechin,1816,4,17,5,14,52,46,6,56
Albion,1816,5,15,9,12,55,57,-2,54
Peterhead,1816,6,13,7,16,47,56,-9,46
Queen's Park,1816,7,13,5,18,44,57,-13,44
Stranraer,1816,8,12,5,19,53,64,-11,41
Stenhousem'r,1816,9,10,8,18,44,72,-28,38
East Fife,1816,10,9,10,17,42,47,-5,37
Airdrieon,1817,1,21,5,10,61,44,17,68
Alloa,1817,2,18,9,9,65,34,31,63
Livingston,1817,3,19,5,12,73,47,26,62
Brechin,1817,4,17,6,13,55,52,3,57
East Fife,1817,5,14,8,14,50,50,0,50
Peterhead,1817,6,12,12,12,46,48,-2,48
Albion,1817,7,12,9,15,49,61,-12,45
Queen's Park,1817,8,12,6,18,43,53,-10,42
Stranraer,1817,9,13,2,21,44,61,-17,41
Stenhousem'r,1817,10,8,6,22,44,80,-36,30
Livingston,1818,1,24,4,8,75,33,42,76
Alloa,1818,2,16,10,10,56,39,17,58
Brechin,1818,3,15,11,10,48,39,9,56
Airdrieon,1818,4,15,10,11,47,46,1,55
Albion,1818,5,14,9,13,48,52,-4,51
East Fife,1818,6,13,8,15,47,46,1,47
Queen's Park,1818,7,12,7,17,40,56,-16,43
Peterhead,1818,8,9,15,12,44,47,-3,42
Stranraer,1818,9,9,11,16,45,56,-11,38
Stenhousem'r,1818,10,5,11,20,41,77,-36,26
Livingston,1819,1,19,8,9,63,41,22,65
Alloa,1819,2,18,8,10,64,39,25,62
Airdrieon,1819,3,16,7,13,54,55,-1,55
East Fife,1819,4,16,6,14,51,45,6,54
Albion,1819,5,14,11,11,47,44,3,53
Peterhead,1819,6,15,7,14,56,51,5,52
Brechin,1819,7,13,7,16,48,54,-6,46
Stranraer,1819,8,13,7,16,48,58,-10,46
Queen's Park,1819,9,12,9,15,37,44,-7,45
Stenhousem'r,1819,10,7,4,25,50,87,-37,25
Livingston,1820,1,24,5,7,85,39,46,77
Airdrieon,1820,2,17,9,10,63,53,10,60
Alloa,1820,3,14,12,10,62,49,13,54
Brechin,1820,4,14,9,13,41,40,1,51
Albion,1820,5,13,9,14,56,51,5,48
Stranraer,1820,6,12,9,15,51,58,-7,45
Peterhead,1820,7,11,9,16,45,56,-11,42
East Fife,1820,8,9,12,15,40,44,-4,39
Queen's Park,1820,9,9,12,15,30,51,-21,39
Stenhousem'r,1820,10,9,10,17,48,80,-32,37
Airdrieon,1821,1,22,6,8,71,46,25,72
Alloa,1821,2,18,10,8,72,45,27,64
Livingston,1821,3,20,2,14,66,45,21,62
Brechin,1821,4,17,3,16,48,45,3,54
East Fife,1821,5,15,8,13,58,49,9,53
Peterhead,1821,6,15,6,15,43,45,-2,51
Albion,1821,7,10,12,14,42,51,-9,42
Queen's Park,1821,8,11,8,17,44,57,-13,41
Stranraer,1821,9,11,5,20,47,71,-24,38
Stenhousem'r,1821,10,6,10,20,39,76,-37,28
Livingston,1822,1,22,3,11,78,49,29,69
Airdrieon,1822,2,21,3,12,73,56,17,66
Brechin,1822,3,21,2,13,66,54,12,65
Alloa,1822,4,17,8,11,73,51,22,59
Peterhead,1822,5,17,5,14,52,48,4,56
Albion,1822,6,14,8,14,60,54,6,50
Stranraer,1822,7,15,2,19,56,61,-5,47
Queen's Park,1822,8,13,4,19,48,72,-24,43
Stenhousem'r,1822,9,10,5,21,50,87,-37,35
East Fife,1822,10,7,6,23,41,65,-24,27
Livingston,1823,1,22,5,9,89,49,40,71
Alloa,1823,2,20,9,7,78,38,40,69
Airdrieon,1823,3,20,4,12,64,58,6,64
Brechin,1823,4,15,8,13,41,45,-4,53
East Fife,1823,5,15,7,14,58,46,12,52
Peterhead,1823,6,15,6,15,53,57,-4,51
Stranraer,1823,7,13,7,16,47,55,-8,46
Queen's Park,1823,8,11,6,19,33,55,-22,39
Albion,1823,9,8,13,15,43,62,-19,37
Stenhousem'r,1823,10,6,5,25,44,85,-41,23
Livingston,1824,1,23,3,10,77,40,37,72
Alloa,1824,2,20,10,6,64,29,35,70
Airdrieon,1824,3,19,6,11,64,54,10,63
Brechin,1824,4,17,5,14,53,52,1,56
Peterhead,1824,5,14,7,15,49,50,-1,49
Queen's Park,1824,6,14,6,16,44,58,-14,48
East Fife,1824,7,11,11,14,50,53,-3,44
Albion,1824,8,10,10,16,50,63,-13,40
Stranraer,1824,9,10,4,22,52,65,-13,34
Stenhousem'r,1824,10,7,8,21,50,89,-39,29
Livingston,1825,1,20,7,9,75,49,26,67
Alloa,1825,2,17,7,12,61,47,14,58
Peterhead,1825,3,15,10,11,54,41,13,55
Airdrieon,1825,4,16,5,15,51,52,-1,53
Albion,1825,5,14,9,13,57,55,2,51
Stranraer,1825,6,15,5,16,50,53,-3,50
Brechin,1825,7,14,8,14,48,54,-6,50
Queen's Park,1825,8,12,7,17,44,54,-10,43
East Fife,1825,9,9,12,15,46,53,-7,39
Stenhousem'r,1825,10,9,8,19,52,80,-28,35
Livingston,1826,1,19,6,11,70,51,19,63
Alloa,1826,2,18,8,10,76,51,25,62
Airdrieon,1826,3,17,7,12,64,46,18,58
Queen's Park,1826,4,18,3,15,42,49,-7,57
Brechin,1826,5,16,6,14,48,42,6,54
East Fife,1826,6,14,10,12,53,46,7,52
Peterhead,1826,7,12,12,12,48,50,-2,48
Albion,1826,8,12,9,15,57,57,0,45
Stenhousem'r,1826,9,8,9,19,56,87,-31,33
Stranraer,1826,10,8,6,22,40,75,-35,30
Livingston,1827,1,23,5,8,83,44,39,74
Alloa,1827,2,19,6,11,72,49,23,63
East Fife,1827,3,15,11,10,59,43,16,56
Airdrieon,1827,4,15,8,13,57,54,3,53
Peterhead,1827,5,14,7,15,61,60,1,49
Brechin,1827,6,14,5,17,41,59,-18,47
Albion,1827,7,13,7,16,63,62,1,46
Queen's Park,1827,8,12,9,15,42,59,-17,45
Stranraer,1827,9,10,6,20,50,65,-15,36
Stenhousem'r,1827,10,8,10,18,44,77,-33,34
Livingston,1828,1,21,4,11,84,55,29,67
Brechin,1828,2,19,3,14,56,51,5,60
Alloa,1828,3,17,7,12,70,49,21,58
Airdrieon,1828,4,16,6,14,49,46,3,54
Albion,1828,5,15,7,14,62,55,7,52
Queen's Park,1828,6,15,7,14,40,44,-4,52
Peterhead,1828,7,14,6,16,44,59,-15,48
East Fife,1828,8,12,7,17,47,48,-1,43
Stranraer,1828,9,12,7,17,52,63,-11,43
Stenhousem'r,1828,10,8,8,20,51,85,-34,32
Livingston,1829,1,23,7,6,82,42,40,76
Alloa,1829,2,19,8,9,65,40,25,65
Albion,1829,3,16,8,12,51,45,6,56
Airdrieon,1829,4,16,7,13,58,54,4,55
Stranraer,1829,5,15,8,13,51,51,0,53
Brechin,1829,6,14,10,12,55,56,-1,52
Peterhead,1829,7,11,8,17,45,55,-10,41
East Fife,1829,8,10,8,18,43,51,-8,38
Queen's Park,1829,9,9,9,18,39,60,-21,36
Stenhousem'r,1829,10,6,9,21,55,90,-35,27
Livingston,1830,1,21,4,11,70,43,27,67
Alloa,1830,2,19,8,9,77,40,37,65
Brechin,1830,3,18,9,9,55,42,13,63
Airdrieon,1830,4,18,5,13,56,50,6,59
Peterhead,1830,5,16,7,13,55,57,-2,55
Stranraer,1830,6,13,8,15,54,59,-5,47
Queen's Park,1830,7,13,6,17,39,52,-13,45
Albion,1830,8,9,12,15,43,58,-15,39
East Fife,1830,9,9,6,21,45,54,-9,33
Stenhousem'r,1830,10,6,11,19,43,82,-39,29
Livingston,1831,1,20,7,9,70,42,28,67
Airdrieon,1831,2,17,9,10,63,47,16,60
Brechin,1831,3,18,6,12,55,52,3,60
Alloa,1831,4,16,11,9,62,48,14,59
East Fife,1831,5,13,12,11,53,44,9,51
Albion,1831,6,14,6,16,55,58,-3,48
Peterhead,1831,7,13,8,15,46,52,-6,47
Queen's Park,1831,8,13,6,17,38,51,-13,45
Stranraer,1831,9,11,4,21,47,62,-15,37
Stenhousem'r,1831,10,8,5,23,43,76,-33,29
Alloa,1832,1,21,9,6,76,29,47,72
Livingston,1832,2,23,1,12,76,47,29,70
Airdrieon,1832,3,19,4,13,65,58,7,61
Peterhead,1832,4,16,9,11,54,50,4,57
Brechin,1832,5,15,11,10,52,52,0,56
Queen's Park,1832,6,15,6,15,45,57,-12,51
Albion,1832,7,10,8,18,45,55,-10,38
Stranraer,1832,8,10,7,19,40,54,-14,37
East Fife,1832,9,10,6,20,48,54,-6,36
Stenhousem'r,1832,10,8,5,23,37,82,-45,29
Airdrieon,1833,1,20,7,9,74,59,15,67
Livingston,1833,2,21,2,13,67,48,19,65
Brechin,1833,3,17,9,10,55,46,9,60
Queen's Park,1833,4,15,6,15,40,46,-6,51
East Fife,1833,5,13,11,12,53,51,2,50
Peterhead,1833,6,14,8,14,54,55,-1,50
Alloa,1833,7,13,10,13,67,57,10,49
Stranraer,1833,8,13,8,15,45,48,-3,47
Albion,1833,9,8,11,17,46,53,-7,35
Stenhousem'r,1833,10,7,6,23,45,83,-38,27
Alloa,1834,1,19,5,12,73,52,21,62
Brechin,1834,2,18,6,12,50,44,6,60
Livingston,1834,3,17,5,14,67,52,15,56
Stranraer,1834,4,17,4,15,51,58,-7,55
Queen's Park,1834,5,16,5,15,43,49,-6,53
Airdrieon,1834,6,15,4,17,50,58,-8,49
Albion,1834,7,13,7,16,52,55,-3,46
Peterhead,1834,8,13,7,16,48,52,-4,46
East Fife,1834,9,12,9,15,52,43,9,45
Stenhousem'r,1834,10,11,6,19,48,71,-23,39
Alloa,1835,1,26,6,4,91,37,54,84
Livingston,1835,2,20,4,12,72,51,21,64
Airdrieon,1835,3,17,7,12,60,55,5,58
Brechin,1835,4,16,4,16,47,49,-2,52
East Fife,1835,5,12,9,15,51,56,-5,45
Queen's Park,1835,6,13,6,17,35,46,-11,45
Albion,1835,7,12,9,15,51,63,-12,45
Stranraer,1835,8,12,5,19,46,59,-13,41
Peterhead,1835,9,9,11,16,44,59,-15,38
Stenhousem'r,1835,10,9,7,20,51,73,-22,34
Livingston,1836,1,20,3,13,84,58,26,63
Airdrieon,1836,2,19,4,13,66,60,6,61
Alloa,1836,3,17,8,11,59,46,13,59
Albion,1836,4,17,6,13,56,49,7,57
Peterhead,1836,5,15,9,12,51,50,1,54
Brechin,1836,6,14,8,14,53,51,2,50
Queen's Park,1836,7,13,9,14,48,51,-3,48
Stranraer,1836,8,12,6,18,52,63,-11,42
East Fife,1836,9,11,7,18,52,68,-16,40
Stenhousem'r,1836,10,9,6,21,49,74,-25,33
Livingston,1837,1,20,4,12,72,53,19,64
Brechin,1837,2,19,6,11,57,53,4,63
Alloa,1837,3,17,10,9,67,46,21,61
Airdrieon,1837,4,17,10,9,57,50,7,61
Albion,1837,5,15,11,10,62,49,13,56
Queen's Park,1837,6,11,12,13,41,50,-9,45
Stranraer,1837,7,12,8,16,53,58,-5,44
East Fife,1837,8,8,15,13,45,43,2,39
Peterhead,1837,9,8,11,17,45,57,-12,35
Stenhousem'r,1837,10,4,11,21,45,85,-40,23
Livingston,1838,1,18,7,11,67,44,23,61
Brechin,1838,2,17,10,9,53,41,12,61
Alloa,1838,3,17,8,11,64,41,23,59
Airdrieon,1838,4,16,10,10,55,47,8,58
Queen's Park,1838,5,15,9,12,41,43,-2,54
East Fife,1838,6,13,6,17,58,50,8,45
Peterhead,1838,7,12,9,15,40,49,-9,45
Albion,1838,8,11,8,17,45,56,-11,41
Stranraer,1838,9,11,7,18,45,65,-20,40
Stenhousem'r,1838,10,10,6,20,50,82,-32,36
Livingston,1839,1,25,4,7,85,37,48,79
Alloa,1839,2,16,10,10,68,47,21,58
Albion,1839,3,16,7,13,57,54,3,55
Stranraer,1839,4,17,3,16,65,62,3,54
Airdrieon,1839,5,15,7,14,56,58,-2,52
Brechin,1839,6,15,6,15,56,57,-1,51
East Fife,1839,7,11,9,16,41,44,-3,42
Queen's Park,1839,8,11,9,16,36,52,-16,42
Stenhousem'r,1839,9,9,9,18,49,83,-34,36
Peterhead,1839,10,9,8,19,36,55,-19,35
Alloa,1840,1,19,12,5,70,36,34,69
Livingston,1840,2,22,2,12,74,46,28,68
Airdrieon,1840,3,19,5,12,63,47,16,62
Brechin,1840,4,17,10,9,61,49,12,61
East Fife,1840,5,14,7,15,49,56,-7,49
Albion,1840,6,13,9,14,53,45,8,48
Stranraer,1840,7,12,7,17,46,60,-14,43
Peterhead,1840,8,11,9,16,39,49,-10,42
Queen's Park,1840,9,11,5,20,39,61,-22,38
Stenhousem'r,1840,10,5,8,23,39,84,-45,23
Alloa,1841,1,19,9,8,72,40,32,66
Livingston,1841,2,20,4,12,74,51,23,64
Airdrieon,1841,3,17,10,9,63,47,16,61
Stranraer,1841,4,15,7,14,51,58,-7,52
Peterhead,1841,5,14,9,13,50,52,-2,51
Queen's Park,1841,6,15,5,16,41,49,-8,50
East Fife,1841,7,12,9,15,51,56,-5,45
Brechin,1841,8,11,8,17,37,50,-13,41
Albion,1841,9,11,7,18,51,57,-6,40
Stenhousem'r,1841,10,8,8,20,43,73,-30,32
Alloa,1842,1,25,4,7,79,50,29,79
Brechin,1842,2,20,5,11,50,39,11,65
Airdrieon,1842,3,18,8,10,56,46,10,62
Peterhead,1842,4,16,7,13,55,47,8,55
Livingston,1842,5,16,6,14,64,49,15,54
East Fife,1842,6,14,7,15,48,45,3,49
Albion,1842,7,11,9,16,45,53,-8,42
Queen's Park,1842,8,12,4,20,36,54,-18,40
Stranraer,1842,9,12,3,21,47,61,-14,39
Stenhousem'r,1842,10,6,7,23,37,73,-36,25
Airdrieon,1843,1,19,6,11,62,53,9,63
Brechin,1843,2,18,9,9,49,41,8,63
Livingston,1843,3,17,6,13,74,60,14,57
Alloa,1843,4,15,11,10,71,48,23,56
Albion,1843,5,16,7,13,61,52,9,55
Queen's Park,1843,6,15,8,13,40,47,-7,53
Peterhead,1843,7,12,9,15,43,55,-12,45
Stranraer,1843,8,13,5,18,52,56,-4,44
East Fife,1843,9,11,6,19,48,54,-6,39
Stenhousem'r,1843,10,6,9,21,45,79,-34,27
Livingston,1844,1,23,7,6,82,41,41,76
Alloa,1844,2,17,11,8,69,46,23,62
Brechin,1844,3,15,8,13,49,47,2,53
Airdrieon,1844,4,15,8,13,49,51,-2,53
Peterhead,1844,5,13,10,13,49,49,0,49
Queen's Park,1844,6,12,9,15,38,47,-9,45
East Fife,1844,7,11,9,16,53,53,0,42
Albion,1844,8,11,9,16,51,63,-12,42
Stranraer,1844,9,11,6,19,43,59,-16,39
Stenhousem'r,1844,10,7,13,16,52,79,-27,34
Livingston,1845,1,25,5,6,81,40,41,80
Alloa,1845,2,20,9,7,75,44,31,69
Airdrieon,1845,3,18,5,13,54,55,-1,59
Peterhead,1845,4,13,8,15,50,45,5,47
Albion,1845,5,12,11,13,44,44,0,47
Brechin,1845,6,12,10,14,43,48,-5,46
East Fife,1845,7,10,10,16,44,50,-6,40
Queen's Park,1845,8,11,7,18,35,55,-20,40
Stranraer,1845,9,10,8,18,42,56,-14,38
Stenhousem'r,1845,10,7,11,18,46,77,-31,32
Livingston,1846,1,22,3,11,76,45,31,69
Alloa,1846,2,18,10,8,82,50,32,64
Brechin,1846,3,17,5,14,43,48,-5,56
Albion,1846,4,14,10,12,58,56,2,52
Queen's Park,1846,5,15,6,15,48,49,-1,51
Stranraer,1846,6,15,5,16,52,51,1,50
Airdrieon,1846,7,14,6,16,54,60,-6,48
Peterhead,1846,8,13,7,16,45,48,-3,46
East Fife,1846,9,7,13,16,41,51,-10,34
Stenhousem'r,1846,10,9,7,20,46,87,-41,34
Alloa,1847,1,20,6,10,71,52,19,66
Airdrieon,1847,2,18,11,7,68,42,26,65
Livingston,1847,3,17,8,11,72,55,17,59
East Fife,1847,4,15,10,11,61,47,14,55
Brechin,1847,5,14,9,13,48,49,-1,51
Stranraer,1847,6,13,9,14,49,52,-3,48
Albion,1847,7,12,10,14,49,51,-2,46
Queen's Park,1847,8,10,11,15,31,43,-12,41
Peterhead,1847,9,8,12,16,44,59,-15,36
Stenhousem'r,1847,10,6,8,22,50,93,-43,26
Alloa,1848,1,20,9,7,76,38,38,69
Livingston,1848,2,21,5,10,77,46,31,68
Brechin,1848,3,18,3,15,55,52,3,57
Airdrieon,1848,4,17,5,14,54,56,-2,56
Albion,1848,5,15,7,14,57,50,7,52
East Fife,1848,6,12,10,14,49,50,-1,46
Peterhead,1848,7,12,10,14,50,58,-8,46
Queen's Park,1848,8,10,11,15,36,53,-17,41
Stranraer,1848,9,10,6,20,49,69,-20,36
Stenhousem'r,1848,10,8,8,20,46,77,-31,32
Alloa,1849,1,21,8,7,76,38,38,71
Airdrieon,1849,2,19,6,11,61,57,4,63
Brechin,1849,3,17,5,14,49,46,3,56
Livingston,1849,4,16,7,13,71,55,16,55
Albion,1849,5,15,8,13,63,58,5,53
Peterhead,1849,6,15,8,13,52,53,-1,53
Stranraer,1849,7,15,4,17,57,63,-6,49
Queen's Park,1849,8,12,7,17,38,55,-17,43
East Fife,1849,9,7,10,19,51,61,-10,31
Stenhousem'r,1849,10,7,9,20,41,73,-32,30
Livingston,1850,1,24,1,11,85,52,33,73
Alloa,1850,2,18,8,10,71,51,20,62
Brechin,1850,3,20,2,14,58,46,12,62
Albion,1850,4,16,11,9,57,44,13,59
Airdrieon,1850,5,14,10,12,56,55,1,52
Queen's Park,1850,6,15,6,15,52,51,1,51
Stranraer,1850,7,12,5,19,51,60,-9,41
East Fife,1850,8,9,10,17,39,51,-12,37
Peterhead,1850,9,9,8,19,44,67,-23,35
Stenhousem'r,1850,10,10,5,21,46,82,-36,35
Livingston,1851,1,23,6,7,75,38,37,75
Airdrieon,1851,2,21,6,9,61,48,13,69
Brechin,1851,3,16,9,11,50,39,11,57
Alloa,1851,4,14,10,12,60,51,9,52
Albion,1851,5,14,10,12,56,55,1,52
Queen's Park,1851,6,12,10,14,38,52,-14,46
East Fife,1851,7,10,8,18,51,56,-5,38
Stranraer,1851,8,9,11,16,40,49,-9,38
Peterhead,1851,9,10,7,19,49,58,-9,37
Stenhousem'r,1851,10,7,11,18,37,71,-34,32
Livingston,1852,1,19,6,11,81,48,33,63
Alloa,1852,2,17,9,10,58,42,16,60
Brechin,1852,3,16,11,9,51,41,10,59
Airdrieon,1852,4,16,10,10,68,56,12,58
Albion,1852,5,13,11,12,52,52,0,50
Peterhead,1852,6,15,5,16,45,52,-7,50
East Fife,1852,7,11,11,14,45,47,-2,44
Stranraer,1852,8,12,7,17,52,57,-5,43
Queen's Park,1852,9,11,9,16,38,58,-20,42
Stenhousem'r,1852,10,5,11,20,48,85,-37,26
Livingston,1853,1,22,5,9,79,37,42,71
Brechin,1853,2,19,7,10,55,40,15,64
Alloa,1853,3,16,10,10,65,48,17,58
Airdrieon,1853,4,16,10,10,64,55,9,58
Queen's Park,1853,5,13,8,15,44,54,-10,47
Peterhead,1853,6,13,7,16,46,58,-12,46
Albion,1853,7,11,11,14,45,55,-10,44
Stranraer,1853,8,11,8,17,54,62,-8,41
East Fife,1853,9,9,10,17,45,54,-9,37
Stenhousem'r,1853,10,6,12,18,41,75,-34,30
Livingston,1854,1,22,4,10,77,41,36,70
Alloa,1854,2,19,8,9,71,38,33,65
Albion,1854,3,15,10,11,49,42,7,55
Airdrieon,1854,4,15,9,12,49,52,-3,54
East Fife,1854,5,13,10,13,47,47,0,49
Brechin,1854,6,14,6,16,43,48,-5,48
Peterhead,1854,7,12,10,14,41,53,-12,46
Stenhousem'r,1854,8,11,6,19,51,74,-23,39
Stranraer,1854,9,10,8,18,43,57,-14,38
Queen's Park,1854,10,8,11,17,30,49,-19,35
Alloa,1855,1,19,7,10,72,48,24,64
Livingston,1855,2,18,6,12,65,51,14,60
Brechin,1855,3,14,9,13,54,52,2,51
Stenhousem'r,1855,4,14,8,14,58,66,-8,50
Albion,1855,5,13,10,13,51,52,-1,49
Peterhead,1855,6,13,8,15,50,54,-4,47
Queen's Park,1855,7,12,11,13,39,43,-4,47
East Fife,1855,8,13,6,17,54,57,-3,45
Stranraer,1855,9,12,8,16,47,58,-11,44
Airdrieon,1855,10,12,7,17,54,63,-9,43
Airdrieon,1856,1,20,9,7,62,46,16,69
Alloa,1856,2,19,11,6,74,39,35,68
Livingston,1856,3,18,6,12,70,59,11,60
Albion,1856,4,14,12,10,49,41,8,54
East Fife,1856,5,13,10,13,56,51,5,49
Queen's Park,1856,6,13,7,16,34,51,-17,46
Brechin,1856,7,11,9,16,49,54,-5,42
Stranraer,1856,8,11,8,17,49,53,-4,41
Peterhead,1856,9,10,7,19,43,52,-9,37
Stenhousem'r,1856,10,6,11,19,43,83,-40,29
Livingston,1857,1,20,6,10,76,51,25,66
Peterhead,1857,2,19,5,12,57,53,4,62
Brechin,1857,3,18,5,13,51,48,3,59
Alloa,1857,4,17,6,13,67,49,18,57
Stranraer,1857,5,16,5,15,47,51,-4,53
Airdrieon,1857,6,15,7,14,56,51,5,52
Queen's Park,1857,7,13,10,13,37,48,-11,49
Albion,1857,8,11,10,15,52,54,-2,43
East Fife,1857,9,7,14,15,40,42,-2,35
Stenhousem'r,1857,10,6,8,22,47,83,-36,26
Livingston,1858,1,20,8,8,68,43,25,68
Alloa,1858,2,18,8,10,65,44,21,62
Airdrieon,1858,3,16,11,9,49,44,5,59
Brechin,1858,4,16,9,11,50,42,8,57
Queen's Park,1858,5,15,8,13,38,45,-7,53
Peterhead,1858,6,13,10,13,48,50,-2,49
East Fife,1858,7,10,11,15,50,52,-2,41
Albion,1858,8,11,8,17,51,57,-6,41
Stenhousem'r,1858,9,9,7,20,48,70,-22,34
Stranraer,1858,10,7,10,19,38,58,-20,31
Livingston,1859,1,21,4,11,82,50,32,67
Alloa,1859,2,18,7,11,72,48,24,61
Peterhead,1859,3,18,7,11,51,45,6,61
Airdrieon,1859,4,17,3,16,59,58,1,54
Brechin,1859,5,15,6,15,52,55,-3,51
Albion,1859,6,13,10,13,59,56,3,49
East Fife,1859,7,13,8,15,57,57,0,47
Queen's Park,1859,8,13,8,15,35,57,-22,47
Stranraer,1859,9,10,10,16,47,54,-7,40
Stenhousem'r,1859,10,7,7,22,51,85,-34,28
Livingston,1860,1,21,4,11,85,50,35,67
Alloa,1860,2,20,7,9,79,54,25,67
Airdrieon,1860,3,21,4,11,68,51,17,67
Brechin,1860,4,18,6,12,53,39,14,60
Stranraer,1860,5,16,7,13,68,62,6,55
Queen's Park,1860,6,15,6,15,43,51,-8,51
Peterhead,1860,7,10,6,20,35,63,-28,36
East Fife,1860,8,9,8,19,44,55,-11,35
Albion,1860,9,9,8,19,43,67,-24,35
Stenhousem'r,1860,10,8,10,18,53,79,-26,34
Livingston,1861,1,20,7,9,75,44,31,67
Brechin,1861,2,20,4,12,66,42,24,64
Albion,1861,3,18,7,11,61,51,10,61
Airdrieon,1861,4,17,7,12,54,56,-2,58
Alloa,1861,5,16,7,13,62,46,16,55
East Fife,1861,6,12,10,14,46,50,-4,46
Queen's Park,1861,7,13,7,16,46,52,-6,46
Peterhead,1861,8,12,8,16,43,52,-9,44
Stranraer,1861,9,9,8,19,40,60,-20,35
Stenhousem'r,1861,10,8,5,23,38,78,-40,29
Alloa,1862,1,19,11,6,78,45,33,68
Livingston,1862,2,20,5,11,67,43,24,65
Airdrieon,1862,3,18,8,10,68,47,21,62
Brechin,1862,4,17,7,12,59,52,7,58
Albion,1862,5,13,8,15,48,52,-4,47
East Fife,1862,6,12,8,16,52,55,-3,44
Queen's Park,1862,7,12,5,19,39,54,-15,41
Peterhead,1862,8,10,10,16,40,55,-15,40
Stranraer,1862,9,11,7,18,52,68,-16,40
Stenhousem'r,1862,10,9,9,18,42,74,-32,36
Alloa,1863,1,18,11,7,64,41,23,65
Livingston,1863,2,19,7,10,75,45,30,64
Brechin,1863,3,16,9,11,55,49,6,57
East Fife,1863,4,15,8,13,56,43,13,53
Queen's Park,1863,5,14,10,12,39,43,-4,52
Peterhead,1863,6,15,6,15,61,58,3,51
Albion,1863,7,15,6,15,57,56,1,51
Airdrieon,1863,8,13,5,18,52,65,-13,44
Stranraer,1863,9,10,8,18,52,70,-18,38
Stenhousem'r,1863,10,6,8,22,45,86,-41,26
Livingston,1864,1,21,4,11,70,45,25,67
Brechin,1864,2,17,9,10,48,39,9,60
East Fife,1864,3,16,10,10,56,44,12,58
Alloa,1864,4,16,9,11,62,45,17,57
Airdrieon,1864,5,15,10,11,51,46,5,55
Peterhead,1864,6,15,8,13,53,48,5,53
Stranraer,1864,7,14,7,15,49,51,-2,49
Albion,1864,8,12,9,15,52,55,-3,45
Queen's Park,1864,9,11,7,18,33,52,-19,40
Stenhousem'r,1864,10,4,5,27,42,91,-49,17
Livingston,1865,1,22,3,11,80,51,29,69
Alloa,1865,2,18,9,9,70,43,27,63
Airdrieon,1865,3,19,4,13,58,54,4,61
Brechin,1865,4,15,7,14,51,49,2,52
Queen's Park,1865,5,14,7,15,40,53,-13,49
Peterhead,1865,6,14,6,16,42,54,-12,48
Stranraer,1865,7,14,5,17,52,56,-4,47
Albion,1865,8,12,9,15,48,52,-4,45
East Fife,1865,9,11,6,19,48,55,-7,39
Stenhousem'r,1865,10,10,6,20,50,72,-22,36
Livingston,1866,1,21,4,11,67,45,22,67
Brechin,1866,2,21,3,12,60,43,17,66
Alloa,1866,3,19,7,10,65,49,16,64
Airdrieon,1866,4,18,6,12,65,56,9,60
Albion,1866,5,17,4,15,61,51,10,55
Stranraer,1866,6,13,7,16,52,62,-10,46
Queen's Park,1866,7,13,6,17,32,48,-16,45
Peterhead,1866,8,11,7,18,42,50,-8,40
East Fife,1866,9,9,7,20,49,56,-7,34
Stenhousem'r,1866,10,9,7,20,46,79,-33,34
Livingston,1867,1,18,8,10,66,48,18,62
Brechin,1867,2,18,8,10,52,39,13,62
Alloa,1867,3,18,7,11,60,41,19,61
Airdrieon,1867,4,17,9,10,53,44,9,60
Albion,1867,5,17,7,12,59,47,12,58
East Fife,1867,6,14,10,12,46,36,10,52
Peterhead,1867,7,13,5,18,50,59,-9,44
Queen's Park,1867,8,12,6,18,37,52,-15,42
Stranraer,1867,9,10,3,23,45,64,-19,33
Stenhousem'r,1867,10,8,7,21,38,76,-38,31
Alloa,1868,1,22,5,9,81,46,35,71
Livingston,1868,2,22,4,10,74,45,29,70
Airdrieon,1868,3,17,8,11,59,52,7,59
Brechin,1868,4,17,5,14,57,54,3,56
Albion,1868,5,15,8,13,56,58,-2,53
Peterhead,1868,6,14,7,15,49,51,-2,49
Stranraer,1868,7,13,6,17,46,54,-8,45
East Fife,1868,8,12,6,18,47,52,-5,42
Queen's Park,1868,9,10,6,20,35,54,-19,36
Stenhousem'r,1868,10,7,7,22,45,83,-38,28
Livingston,1869,1,21,3,12,76,51,25,66
Alloa,1869,2,19,8,9,77,46,31,65
Airdrieon,1869,3,18,7,11,59,51,8,61
Brechin,1869,4,16,9,11,55,50,5,57
Queen's Park,1869,5,12,10,14,34,44,-10,46
Albion,1869,6,11,12,13,50,54,-4,45
Stranraer,1869,7,12,8,16,52,61,-9,44
Peterhead,1869,8,12,7,17,45,54,-9,43
East Fife,1869,9,9,11,16,51,59,-8,38
Stenhousem'r,1869,10,7,11,18,47,76,-29,32
Alloa,1870,1,20,8,8,83,44,39,68
Livingston,1870,2,19,7,10,74,51,23,64
Peterhead,1870,3,17,11,8,57,44,13,62
Stranraer,1870,4,15,5,16,53,54,-1,50
Brechin,1870,5,14,7,15,43,45,-2,49
Albion,1870,6,13,10,13,51,54,-3,49
Airdrieon,1870,7,13,7,16,48,57,-9,46
Queen's Park,1870,8,12,8,16,34,53,-19,44
East Fife,1870,9,11,10,15,42,45,-3,43
Stenhousem'r,1870,10,6,7,23,45,83,-38,25
Alloa,1871,1,18,10,8,78,47,31,64
Airdrieon,1871,2,17,11,8,64,51,13,62
Livingston,1871,3,15,10,11,69,52,17,55
Brechin,1871,4,15,10,11,43,38,5,55
East Fife,1871,5,12,12,12,46,41,5,48
Queen's Park,1871,6,13,9,14,43,56,-13,48
Stranraer,1871,7,12,8,16,51,56,-5,44
Albion,1871,8,10,12,14,45,56,-11,42
Peterhead,1871,9,10,7,19,47,62,-15,37
Stenhousem'r,1871,10,9,9,18,49,76,-27,36
Livingston,1872,1,22,7,7,81,41,40,73
Brechin,1872,2,18,5,13,55,53,2,59
Alloa,1872,3,16,8,12,71,53,18,56
Peterhead,1872,4,16,7,13,58,53,5,55
Airdrieon,1872,5,14,10,12,55,58,-3,52
Albion,1872,6,14,8,14,54,52,2,50
Queen's Park,1872,7,13,9,14,39,46,-7,48
East Fife,1872,8,10,8,18,41,47,-6,38
Stranraer,1872,9,11,5,20,50,62,-12,38
Stenhousem'r,1872,10,8,9,19,42,81,-39,33
Airdrieon,1873,1,22,4,10,66,45,21,70
Livingston,1873,2,20,8,8,69,42,27,68
Alloa,1873,3,17,8,11,68,50,18,59
Brechin,1873,4,15,8,13,49,50,-1,53
East Fife,1873,5,13,9,14,46,47,-1,48
Albion,1873,6,11,11,14,52,54,-2,44
Peterhead,1873,7,11,9,16,45,58,-13,42
Queen's Park,1873,8,11,8,17,38,47,-9,41
Stenhousem'r,1873,9,11,8,17,55,74,-19,41
Stranraer,1873,10,10,5,21,45,66,-21,35
Peterhead,1874,1,20,4,12,49,48,1,64
Livingston,1874,2,18,9,9,64,40,24,63
Airdrieon,1874,3,16,9,11,64,55,9,57
Queen's Park,1874,4,16,9,11,40,40,0,57
Brechin,1874,5,15,7,14,42,46,-4,52
Alloa,1874,6,14,7,15,61,48,13,49
Albion,1874,7,13,10,13,50,47,3,49
Stranraer,1874,8,11,5,20,41,55,-14,38
Stenhousem'r,1874,9,10,8,18,48,71,-23,38
East Fife,1874,10,9,8,19,40,49,-9,35
Livingston,1875,1,20,5,11,81,52,29,65
Alloa,1875,2,18,11,7,74,50,24,65
Airdrieon,1875,3,18,4,14,63,56,7,58
Brechin,1875,4,17,5,14,53,55,-2,56
Albion,1875,5,16,7,13,54,42,12,55
Queen's Park,1875,6,13,9,14,43,52,-9,48
Stranraer,1875,7,12,5,19,53,70,-17,41
Peterhead,1875,8,10,10,16,46,58,-12,40
East Fife,1875,9,9,10,17,50,58,-8,37
Stenhousem'r,1875,10,9,10,17,51,75,-24,37
Airdrieon,1876,1,19,8,9,69,55,14,65
Livingston,1876,2,18,10,8,73,47,26,64
Alloa,1876,3,16,10,10,55,40,15,58
Peterhead,1876,4,15,5,16,46,57,-11,50
Queen's Park,1876,5,12,12,12,42,47,-5,48
East Fife,1876,6,12,10,14,45,45,0,46
Albion,1876,7,11,10,15,54,61,-7,43
Stranraer,1876,8,10,12,14,51,51,0,42
Brechin,1876,9,10,9,17,42,57,-15,39
Stenhousem'r,1876,10,8,12,16,52,69,-17,36
Livingston,1877,1,22,5,9,76,43,33,71
Peterhead,1877,2,18,6,12,55,47,8,60
Airdrieon,1877,3,16,6,14,63,60,3,54
Brechin,1877,4,14,9,13,53,50,3,51
Queen's Park,1877,5,15,6,15,39,54,-15,51
Alloa,1877,6,14,8,14,71,59,12,50
Albion,1877,7,14,7,15,50,60,-10,49
East Fife,1877,8,12,10,14,52,44,8,46
Stenhousem'r,1877,9,10,9,17,42,64,-22,39
Stranraer,1877,10,9,6,21,53,73,-20,33
Livingston,1878,1,22,4,10,86,49,37,70
Alloa,1878,2,20,8,8,67,41,26,68
Brechin,1878,3,18,3,15,54,53,1,57
Airdrieon,1878,4,14,9,13,55,58,-3,51
Stranraer,1878,5,14,7,15,50,51,-1,49
Peterhead,1878,6,14,7,15,56,61,-5,49
Queen's Park,1878,7,12,10,14,41,45,-4,46
Albion,1878,8,11,13,12,54,60,-6,46
East Fife,1878,9,10,8,18,55,63,-8,38
Stenhousem'r,1878,10,5,11,20,50,87,-37,26
Alloa,1879,1,20,9,7,66,38,28,69
Livingston,1879,2,20,4,12,77,59,18,64
Queen's Park,1879,3,16,6,14,39,43,-4,54
Airdrieon,1879,4,13,12,11,54,55,-1,51
Brechin,1879,5,15,6,15,55,59,-4,51
Stranraer,1879,6,13,7,16,55,54,1,46
Peterhead,1879,7,12,10,14,52,59,-7,46
Albion,1879,8,11,8,17,41,55,-14,41
East Fife,1879,9,9,11,16,46,47,-1,38
Stenhousem'r,1879,10,9,11,16,52,68,-16,38
Livingston,1880,1,21,7,8,77,44,33,70
Alloa,1880,2,19,10,7,71,42,29,67
East Fife,1880,3,16,7,13,54,44,10,55
Airdrieon,1880,4,16,7,13,57,57,0,55
Brechin,1880,5,17,4,15,45,45,0,55
Queen's Park,1880,6,13,10,13,36,43,-7,49
Peterhead,1880,7,13,8,15,42,47,-5,47
Stranraer,1880,8,11,7,18,50,69,-19,40
Albion,1880,9,8,11,17,42,54,-12,35
Stenhousem'r,1880,10,5,11,20,43,72,-29,26
Livingston,1881,1,20,6,10,80,49,31,66
Brechin,1881,2,20,4,12,47,32,15,64
Airdrieon,1881,3,17,5,14,50,50,0,56
Alloa,1881,4,15,9,12,60,47,13,54
Peterhead,1881,5,14,9,13,51,45,6,51
Albion,1881,6,13,10,13,57,54,3,49
Stenhousem'r,1881,7,14,6,16,49,69,-20,48
Stranraer,1881,8,12,8,16,53,60,-7,44
East Fife,1881,9,9,10,17,37,49,-12,37
Queen's Park,1881,10,9,7,20,29,58,-29,34
Livingston,1882,1,21,7,8,83,50,33,70
Brechin,1882,2,19,9,8,63,45,18,66
Albion,1882,3,17,10,9,55,44,11,61
Airdrieon,1882,4,15,8,13,63,52,11,53
Queen's Park,1882,5,14,8,14,46,52,-6,50
Alloa,1882,6,13,7,16,54,50,4,46
East Fife,1882,7,12,8,16,44,47,-3,44
Peterhead,1882,8,12,8,16,48,52,-4,44
Stenhousem'r,1882,9,9,7,20,38,72,-34,34
Stranraer,1882,10,8,8,20,37,67,-30,32
Livingston,1883,1,20,6,10,70,48,22,66
Alloa,1883,2,18,10,8,71,39,32,64
Airdrieon,1883,3,17,9,10,61,47,14,60
Brechin,1883,4,16,5,15,52,47,5,53
Albion,1883,5,15,6,15,54,54,0,51
Queen's Park,1883,6,14,9,13,46,52,-6,51
East Fife,1883,7,11,9,16,44,49,-5,42
Stranraer,1883,8,11,9,16,50,64,-14,42
Peterhead,1883,9,11,8,17,41,54,-13,41
Stenhousem'r,1883,10,6,11,19,46,81,-35,29
Alloa,1884,1,18,11,7,63,37,26,65
Livingston,1884,2,19,5,12,73,49,24,62
Airdrieon,1884,3,15,10,11,53,48,5,55
Brechin,1884,4,15,7,14,53,49,4,52
Queen's Park,1884,5,15,6,15,42,43,-1,51
Albion,1884,6,13,11,12,51,54,-3,50
East Fife,1884,7,13,10,13,50,44,6,49
Peterhead,1884,8,12,11,13,41,48,-7,47
Stranraer,1884,9,12,4,20,43,59,-16,40
Stenhousem'r,1884,10,6,9,21,42,80,-38,27
Livingston,1885,1,22,6,8,81,42,39,72
Alloa,1885,2,17,8,11,59,46,13,59
Brechin,1885,3,16,7,13,62,57,5,55
Airdrieon,1885,4,16,7,13,54,51,3,55
East Fife,1885,5,15,7,14,54,51,3,52
Stranraer,1885,6,14,6,16,56,57,-1,48
Albion,1885,7,13,8,15,53,58,-5,47
Peterhead,1885,8,13,6,17,46,54,-8,45
Queen's Park,1885,9,13,6,17,38,52,-14,45
Stenhousem'r,1885,10,8,5,23,49,84,-35,29
Airdrieon,1886,1,19,6,11,61,51,10,63
Alloa,1886,2,17,11,8,65,45,20,62
Livingston,1886,3,16,8,12,71,56,15,56
Brechin,1886,4,15,9,12,46,44,2,54
Stranraer,1886,5,15,6,15,60,58,2,51
East Fife,1886,6,14,8,14,51,44,7,50
Peterhead,1886,7,12,11,13,44,42,2,47
Queen's Park,1886,8,12,8,16,40,57,-17,44
Albion,1886,9,10,9,17,43,57,-14,39
Stenhousem'r,1886,10,9,6,21,43,70,-27,33
Livingston,1887,1,24,3,9,82,52,30,75
Alloa,1887,2,22,5,9,89,42,47,71
Albion,1887,3,16,7,13,54,53,1,55
Airdrieon,1887,4,15,8,13,57,59,-2,53
Brechin,1887,5,16,4,16,55,57,-2,52
Peterhead,1887,6,12,10,14,59,63,-4,46
Stranraer,1887,7,13,6,17,51,58,-7,45
East Fife,1887,8,12,7,17,50,58,-8,43
Queen's Park,1887,9,10,6,20,33,57,-24,36
Stenhousem'r,1887,10,6,12,18,44,75,-31,30
Livingston,1888,1,23,5,8,81,42,39,74
Alloa,1888,2,20,7,9,75,42,33,67
Brechin,1888,3,18,6,12,46,44,2,60
Airdrieon,1888,4,17,7,12,57,53,4,58
Peterhead,1888,5,15,7,14,48,50,-2,52
Stranraer,1888,6,13,4,19,44,59,-15,43
East Fife,1888,7,10,11,15,43,42,1,41
Albion,1888,8,10,10,16,47,56,-9,40
Queen's Park,1888,9,11,7,18,36,53,-17,40
Stenhousem'r,1888,10,6,10,20,45,81,-36,28
Livingston,1889,1,20,7,9,71,47,24,67
Alloa,1889,2,19,8,9,84,45,39,65
Peterhead,1889,3,16,11,9,57,46,11,59
Airdrieon,1889,4,16,8,12,62,57,5,56
Brechin,1889,5,17,5,14,51,52,-1,56
Albion,1889,6,13,8,15,56,54,2,47
Stranraer,1889,7,14,4,18,49,63,-14,46
Queen's Park,1889,8,10,8,18,38,56,-18,38
East Fife,1889,9,10,7,19,40,53,-13,37
Stenhousem'r,1889,10,9,6,21,44,79,-35,33
Livingston,1890,1,20,3,13,77,47,30,63
Airdrieon,1890,2,18,9,9,57,49,8,63
Alloa,1890,3,18,8,10,66,40,26,62
Albion,1890,4,15,9,12,65,56,9,54
Brechin,1890,5,16,2,18,44,54,-10,50
Peterhead,1890,6,13,9,14,51,50,1,48
Stranraer,1890,7,13,9,14,52,53,-1,48
Stenhousem'r,1890,8,12,8,16,51,68,-17,44
Queen's Park,1890,9,12,7,17,36,65,-29,43
East Fife,1890,10,7,8,21,40,57,-17,29
Livingston,1891,1,24,5,7,75,45,30,77
Alloa,1891,2,19,8,9,79,44,35,65
Brechin,1891,3,19,4,13,50,47,3,61
Airdrieon,1891,4,18,5,13,63,55,8,59
Stranraer,1891,5,15,7,14,69,62,7,52
Albion,1891,6,12,9,15,49,52,-3,45
Peterhead,1891,7,9,13,14,52,68,-16,40
East Fife,1891,8,8,12,16,42,51,-9,36
Queen's Park,1891,9,8,11,17,40,63,-23,35
Stenhousem'r,1891,10,9,4,23,45,77,-32,31
Livingston,1892,1,21,7,8,77,46,31,70
Alloa,1892,2,19,9,8,67,43,24,66
Airdrieon,1892,3,15,10,11,62,59,3,55
Peterhead,1892,4,15,7,14,68,56,12,52
Brechin,1892,5,14,8,14,42,53,-11,50
Stranraer,1892,6,14,7,15,51,50,1,49
Albion,1892,7,12,8,16,51,61,-10,44
Queen's Park,1892,8,13,4,19,35,51,-16,43
Stenhousem'r,1892,9,12,6,18,53,81,-28,42
East Fife,1892,10,7,10,19,48,54,-6,31
Alloa,1893,1,21,9,6,68,41,27,72
Livingston,1893,2,22,5,9,88,50,38,71
Brechin,1893,3,14,11,11,49,48,1,53
Airdrieon,1893,4,13,12,11,57,56,1,51
Peterhead,1893,5,14,9,13,48,49,-1,51
East Fife,1893,6,13,11,12,54,48,6,50
Stranraer,1893,7,10,8,18,54,65,-11,38
Queen's Park,1893,8,10,8,18,32,52,-20,38
Albion,1893,9,9,10,17,50,63,-13,37
Stenhousem'r,1893,10,8,9,19,48,76,-28,33
Livingston,1894,1,24,4,8,77,37,40,76
Alloa,1894,2,20,7,9,65,33,32,67
Airdrieon,1894,3,18,5,13,54,51,3,59
Peterhead,1894,4,14,8,14,50,47,3,50
Albion,1894,5,14,8,14,49,47,2,50
Brechin,1894,6,14,6,16,45,48,-3,48
Queen's Park,1894,7,14,6,16,37,46,-9,48
East Fife,1894,8,13,7,16,49,52,-3,46
Stranraer,1894,9,14,3,19,47,60,-13,45
Stenhousem'r,1894,10,4,8,24,36,88,-52,20
Livingston,1895,1,21,4,11,83,53,30,67
Peterhead,1895,2,19,5,12,60,45,15,62
Airdrieon,1895,3,17,5,14,57,54,3,56
Alloa,1895,4,15,10,11,69,45,24,55
Stranraer,1895,5,15,8,13,59,62,-3,53
Brechin,1895,6,14,8,14,41,48,-7,50
Albion,1895,7,12,11,13,49,48,1,47
East Fife,1895,8,13,8,15,45,49,-4,47
Queen's Park,1895,9,9,8,19,29,51,-22,35
Stenhousem'r,1895,10,7,9,20,49,86,-37,30
Livingston,1896,1,20,7,9,71,48,23,67
Alloa,1896,2,19,7,10,56,41,15,64
Airdrieon,1896,3,18,5,13,57,49,8,59
Brechin,1896,4,16,8,12,58,44,14,56
Stranraer,1896,5,14,9,13,49,48,1,51
Albion,1896,6,13,11,12,55,49,6,50
East Fife,1896,7,13,10,13,50,48,2,49
Peterhead,1896,8,11,7,18,39,54,-15,40
Queen's Park,1896,9,8,12,16,34,54,-20,36
Stenhousem'r,1896,10,5,10,21,54,88,-34,25
Alloa,1897,1,19,9,8,69,44,25,66
Livingston,1897,2,20,4,12,76,51,25,64
Brechin,1897,3,17,6,13,46,45,1,57
Queen's Park,1897,4,16,5,15,49,50,-1,53
Peterhead,1897,5,14,10,12,58,54,4,52
Airdrieon,1897,6,13,8,15,56,63,-7,47
East Fife,1897,7,13,7,16,47,50,-3,46
Albion,1897,8,12,9,15,49,50,-1,45
Stranraer,1897,9,11,6,19,49,72,-23,39
Stenhousem'r,1897,10,10,6,20,51,71,-20,36
Livingston,1898,1,22,5,9,102,54,48,71
Alloa,1898,2,21,6,9,72,43,29,69
Brechin,1898,3,19,4,13,48,44,4,61
Airdrieon,1898,4,16,9,11,53,49,4,57
East Fife,1898,5,14,7,15,55,47,8,49
Peterhead,1898,6,12,10,14,45,51,-6,46
Albion,1898,7,12,9,15,61,55,6,45
Stranraer,1898,8,10,8,18,40,57,-17,38
Queen's Park,1898,9,10,7,19,37,72,-35,37
Stenhousem'r,1898,10,7,9,20,48,89,-41,30
Livingston,1899,1,23,5,8,86,46,40,74
Alloa,1899,2,17,13,6,60,35,25,64
Brechin,1899,3,17,8,11,50,44,6,59
Airdrieon,1899,4,16,8,12,58,55,3,56
East Fife,1899,5,13,8,15,57,56,1,47
Stranraer,1899,6,14,4,18,47,55,-8,46
Queen's Park,1899,7,12,10,14,43,52,-9,46
Albion,1899,8,12,8,16,47,52,-5,44
Peterhead,1899,9,10,9,17,41,57,-16,39
Stenhousem'r,1899,10,6,7,23,43,80,-37,25
Airdrieon,1900,1,20,9,7,70,49,21,69
Alloa,1900,2,19,7,10,72,48,24,64
Livingston,1900,3,18,9,9,75,50,25,63
Brechin,1900,4,16,6,14,52,50,2,54
Peterhead,1900,5,14,6,16,52,53,-1,48
Queen's Park,1900,6,13,8,15,39,52,-13,47
Albion,1900,7,13,6,17,53,61,-8,45
Stranraer,1900,8,11,7,18,45,59,-14,40
East Fife,1900,9,9,10,17,48,60,-12,37
Stenhousem'r,1900,10,9,8,19,46,70,-24,35
Alloa,1901,1,22,7,7,69,43,26,73
Airdrieon,1901,2,20,6,10,63,51,12,66
Livingston,1901,3,19,6,11,70,51,19,63
Albion,1901,4,14,8,14,59,58,1,50
Peterhead,1901,5,14,6,16,50,57,-7,48
East Fife,1901,6,13,7,16,59,55,4,46
Brechin,1901,7,13,6,17,49,52,-3,45
Queen's Park,1901,8,12,8,16,37,44,-7,44
Stranraer,1901,9,12,5,19,54,65,-11,41
Stenhousem'r,1901,10,8,7,21,48,82,-34,31
Livingston,1902,1,22,3,11,79,52,27,69
Alloa,1902,2,17,11,8,75,47,28,62
Albion,1902,3,18,6,12,64,53,11,60
Airdrieon,1902,4,17,7,12,60,57,3,58
Brechin,1902,5,16,6,14,49,50,-1,54
Peterhead,1902,6,15,7,14,55,55,0,52
Queen's Park,1902,7,15,5,16,44,52,-8,50
East Fife,1902,8,11,7,18,58,59,-1,40
Stranraer,1902,9,11,5,20,48,70,-22,38
Stenhousem'r,1902,10,7,5,24,50,87,-37,26
Livingston,1903,1,24,3,9,80,44,36,75
Alloa,1903,2,19,7,10,79,52,27,64
Airdrieon,1903,3,18,8,10,75,54,21,62
Brechin,1903,4,17,3,16,55,63,-8,54
Queen's Park,1903,5,16,5,15,51,57,-6,53
Stranraer,1903,6,15,5,16,51,46,5,50
Albion,1903,7,13,7,16,52,61,-9,46
Peterhead,1903,8,12,8,16,40,50,-10,44
East Fife,1903,9,11,8,17,48,51,-3,41
Stenhousem'r,1903,10,3,10,23,39,92,-53,19
Livingston,1904,1,22,6,8,75,39,36,72
Alloa,1904,2,21,6,9,73,44,29,69
Brechin,1904,3,20,8,8,61,38,23,68
Airdrieon,1904,4,18,4,14,66,57,9,58
Albion,1904,5,14,8,14,56,58,-2,50
Peterhead,1904,6,14,7,15,49,50,-1,49
Stenhousem'r,1904,7,11,8,17,52,74,-22,41
Queen's Park,1904,8,12,4,20,32,62,-30,40
Stranraer,1904,9,9,5,22,46,70,-24,32
East Fife,1904,10,7,8,21,39,57,-18,29
Brechin,1905,1,21,6,9,58,41,17,69
Livingston,1905,2,21,5,10,75,47,28,68
Alloa,1905,3,17,9,10,83,47,36,60
Airdrieon,1905,4,16,8,12,59,55,4,56
Albion,1905,5,13,11,12,51,51,0,50
Peterhead,1905,6,13,8,15,50,53,-3,47
Stranraer,1905,7,13,6,17,52,67,-15,45
Queen's Park,1905,8,9,9,18,34,58,-24,36
East Fife,1905,9,7,13,16,42,52,-10,34
Stenhousem'r,1905,10,9,7,20,41,74,-33,34
Alloa,1906,1,21,5,10,70,41,29,68
Livingston,1906,2,18,8,10,80,51,29,62
Brechin,1906,3,18,8,10,52,37,15,62
Peterhead,1906,4,17,8,11,52,47,5,59
Albion,1906,5,17,5,14,67,54,13,56
Airdrieon,1906,6,13,9,14,50,53,-3,48
Queen's Park,1906,7,10,10,16,37,60,-23,40
East Fife,1906,8,10,9,17,39,57,-18,39
Stranraer,1906,9,9,11,16,52,63,-11,38
Stenhousem'r,1906,10,7,7,22,40,76,-36,28
Livingston,1907,1,25,4,7,89,41,48,79
Alloa,1907,2,20,8,8,76,46,30,68
Albion,1907,3,19,6,11,64,40,24,63
Airdrieon,1907,4,16,7,13,60,56,4,55
Stranraer,1907,5,15,5,16,52,61,-9,50
Brechin,1907,6,14,6,16,50,60,-10,48
Peterhead,1907,7,14,5,17,52,57,-5,47
Queen's Park,1907,8,11,9,16,43,60,-17,42
East Fife,1907,9,8,9,19,42,58,-16,33
Stenhousem'r,1907,10,5,7,24,37,86,-49,22
Livingston,1908,1,23,6,7,83,42,41,75
Alloa,1908,2,19,5,12,70,53,17,62
Brechin,1908,3,17,6,13,52,47,5,57
Airdrieon,1908,4,16,7,13,58,59,-1,55
Albion,1908,5,15,7,14,53,49,4,52
East Fife,1908,6,13,9,14,57,55,2,48
Queen's Park,1908,7,13,9,14,39,50,-11,48
Peterhead,1908,8,11,9,16,47,52,-5,42
Stranraer,1908,9,10,8,18,45,58,-13,38
Stenhousem'r,1908,10,7,6,23,41,80,-39,27
Alloa,1909,1,23,5,8,71,36,35,74
Livingston,1909,2,18,7,11,65,49,16,61
Airdrieon,1909,3,18,4,14,59,53,6,58
Peterhead,1909,4,15,10,11,47,49,-2,55
Albion,1909,5,14,6,16,53,56,-3,48
Stranraer,1909,6,14,5,17,50,53,-3,47
East Fife,1909,7,12,9,15,48,39,9,45
Queen's Park,1909,8,13,6,17,43,53,-10,45
Brechin,1909,9,13,5,18,41,50,-9,44
Stenhousem'r,1909,10,7,9,20,41,80,-39,30
Alloa,1910,1,19,9,8,71,39,32,66
Livingston,1910,2,19,4,13,74,47,27,61
Airdrieon,1910,3,17,7,12,57,52,5,58
Brechin,1910,4,17,7,12,44,43,1,58
Albion,1910,5,14,10,12,60,56,4,52
East Fife,1910,6,12,11,13,55,54,1,47
Peterhead,1910,7,13,6,17,45,57,-12,45
Queen's Park,1910,8,13,6,17,39,51,-12,45
Stranraer,1910,9,10,8,18,39,55,-16,38
Stenhousem'r,1910,10,9,6,21,47,77,-30,33
Brechin,1911,1,18,10,8,58,41,17,64
Livingston,1911,2,19,5,12,74,52,22,62
Alloa,1911,3,18,6,12,62,49,13,60
Peterhead,1911,4,16,7,13,55,52,3,55
Queen's Park,1911,5,16,6,14,41,45,-4,54
Airdrieon,1911,6,15,8,13,55,54,1,53
Stranraer,1911,7,13,7,16,51,58,-7,46
Albion,1911,8,10,10,16,52,64,-12,40
East Fife,1911,9,9,10,17,46,51,-5,37
Stenhousem'r,1911,10,7,9,20,45,73,-28,30
Alloa,1912,1,18,9,9,63,43,20,63
Livingston,1912,2,19,3,14,63,49,14,60
Airdrieon,1912,3,18,6,12,56,53,3,60
Albion,1912,4,16,8,12,49,41,8,56
Brechin,1912,5,17,4,15,48,51,-3,55
Stranraer,1912,6,15,6,15,55,49,6,51
Peterhead,1912,7,15,5,16,57,47,10,50
Queen's Park,1912,8,12,8,16,34,49,-15,44
East Fife,1912,9,9,10,17,40,51,-11,37
Stenhousem'r,1912,10,8,7,21,45,77,-32,31
Brechin,1913,1,21,4,11,53,47,6,67
Alloa,1913,2,18,10,8,71,46,25,64
Livingston,1913,3,20,3,13,80,62,18,63
Airdrieon,1913,4,17,7,12,55,49,6,58
Albion,1913,5,17,4,15,58,48,10,55
Peterhead,1913,6,13,7,16,45,51,-6,46
Stranraer,1913,7,12,6,18,48,53,-5,42
Queen's Park,1913,8,11,8,17,36,53,-17,41
East Fife,1913,9,8,11,17,40,48,-8,35
Stenhousem'r,1913,10,9,8,19,42,71,-29,35
Livingston,1914,1,20,5,11,79,42,37,65
Alloa,1914,2,19,6,11,66,47,19,63
Albion,1914,3,17,7,12,58,50,8,58
Queen's Park,1914,4,15,9,12,48,42,6,54
Airdrieon,1914,5,15,8,13,53,53,0,53
Brechin,1914,6,16,5,15,48,51,-3,53
East Fife,1914,7,13,8,15,47,48,-1,47
Peterhead,1914,8,13,8,15,46,49,-3,47
Stranraer,1914,9,10,6,20,44,66,-22,36
Stenhousem'r,1914,10,8,6,22,42,83,-41,30
Livingston,1915,1,20,6,10,77,50,27,66
Airdrieon,1915,2,19,6,11,67,53,14,63
Alloa,1915,3,17,8,11,68,52,16,59
Brechin,1915,4,16,7,13,46,44,2,55
East Fife,1915,5,15,9,12,54,35,19,54
Stranraer,1915,6,15,7,14,53,56,-3,52
Peterhead,1915,7,13,6,17,45,55,-10,45
Albion,1915,8,10,11,15,46,59,-13,41
Queen's Park,1915,9,11,4,21,32,51,-19,37
Stenhousem'r,1915,10,7,10,19,39,72,-33,31
Livingston,1916,1,20,7,9,79,43,36,67
Alloa,1916,2,21,4,11,66,45,21,67
Brechin,1916,3,18,5,13,50,43,7,59
Airdrieon,1916,4,16,9,11,54,50,4,57
Albion,1916,5,15,11,10,51,37,14,56
Stranraer,1916,6,17,4,15,54,51,3,55
Peterhead,1916,7,14,6,16,53,58,-5,48
Queen's Park,1916,8,11,6,19,30,52,-22,39
East Fife,1916,9,9,11,16,50,59,-9,38
Stenhousem'r,1916,10,3,9,24,39,88,-49,18
Livingston,1917,1,23,4,9,77,43,34,73
Alloa,1917,2,21,3,12,62,44,18,66
Airdrieon,1917,3,18,9,9,62,54,8,63
Brechin,1917,4,15,6,15,51,54,-3,51
Albion,1917,5,13,10,13,52,50,2,49
Peterhead,1917,6,13,10,13,46,45,1,49
East Fife,1917,7,12,10,14,49,48,1,46
Stranraer,1917,8,12,7,17,50,55,-5,43
Queen's Park,1917,9,12,6,18,33,52,-19,42
Stenhousem'r,1917,10,5,7,24,46,83,-37,22
Livingston,1918,1,22,4,10,72,42,30,70
Brechin,1918,2,17,8,11,51,41,10,59
Alloa,1918,3,17,7,12,66,47,19,58
Queen's Park,1918,4,17,4,15,49,48,1,55
Airdrieon,1918,5,15,8,13,58,56,2,53
Peterhead,1918,6,15,7,14,49,52,-3,52
Albion,1918,7,13,8,15,53,60,-7,47
East Fife,1918,8,12,7,17,55,58,-3,43
Stranraer,1918,9,11,4,21,40,59,-19,37
Stenhousem'r,1918,10,8,9,19,43,73,-30,33
Livingston,1919,1,24,1,11,80,48,32,73
Alloa,1919,2,21,7,8,72,47,25,70
Airdrieon,1919,3,15,6,15,53,52,1,51
Albion,1919,4,14,8,14,52,48,4,50
Peterhead,1919,5,14,8,14,52,56,-4,50
East Fife,1919,6,14,7,15,59,55,4,49
Stranraer,1919,7,12,9,15,47,54,-7,45
Brechin,1919,8,12,7,17,44,53,-9,43
Queen's Park,1919,9,12,6,18,37,54,-17,42
Stenhousem'r,1919,10,10,5,21,52,81,-29,35
Alloa,1920,1,22,7,7,71,37,34,73
Brechin,1920,2,21,4,11,68,47,21,67
Livingston,1920,3,18,6,12,75,60,15,60
Airdrieon,1920,4,17,9,10,51,47,4,60
Peterhead,1920,5,14,8,14,49,53,-4,50
Albion,1920,6,12,8,16,44,47,-3,44
Queen's Park,1920,7,12,4,20,35,54,-19,40
Stranraer,1920,8,10,9,17,49,59,-10,39
Stenhousem'r,1920,9,8,11,17,51,77,-26,35
East Fife,1920,10,8,10,18,36,48,-12,34
Livingston,1921,1,22,6,8,81,46,35,72
Brechin,1921,2,19,7,10,60,50,10,64
Albion,1921,3,15,10,11,50,43,7,55
Alloa,1921,4,14,11,11,62,43,19,53
Stranraer,1921,5,15,3,18,54,63,-9,48
Peterhead,1921,6,11,13,12,40,43,-3,46
East Fife,1921,7,11,12,13,48,47,1,45
Airdrieon,1921,8,11,12,13,48,52,-4,45
Queen's Park,1921,9,9,9,18,28,46,-18,36
Stenhousem'r,1921,10,7,9,20,35,73,-38,30
Alloa,1922,1,20,6,10,68,40,28,66
Livingston,1922,2,17,6,13,67,52,15,57
Airdrieon,1922,3,16,8,12,62,50,12,56
Peterhead,1922,4,16,6,14,56,50,6,54
Brechin,1922,5,15,8,13,48,50,-2,53
Albion,1922,6,14,9,13,54,49,5,51
Queen's Park,1922,7,12,11,13,35,48,-13,47
East Fife,1922,8,11,10,15,45,48,-3,43
Stranraer,1922,9,13,3,20,46,65,-19,42
Stenhousem'r,1922,10,9,7,20,43,72,-29,34
Livingston,1923,1,21,5,10,82,58,24,68
Airdrieon,1923,2,19,8,9,69,54,15,65
Brechin,1923,3,17,7,12,56,51,5,58
Alloa,1923,4,17,5,14,65,49,16,56
East Fife,1923,5,13,8,15,53,50,3,47
Peterhead,1923,6,11,11,14,54,57,-3,44
Stranraer,1923,7,13,5,18,50,66,-16,44
Queen's Park,1923,8,12,7,17,40,47,-7,43
Albion,1923,9,11,8,17,50,53,-3,41
Stenhousem'r,1923,10,10,8,18,44,78,-34,38
Brechin,1924,1,18,9,9,51,37,14,63
Livingston,1924,2,19,5,12,70,47,23,62
Alloa,1924,3,18,8,10,64,42,22,62
Airdrieon,1924,4,15,8,13,57,58,-1,53
Albion,1924,5,13,9,14,53,55,-2,48
Stenhousem'r,1924,6,14,6,16,61,72,-11,48
Peterhead,1924,7,12,9,15,47,53,-6,45
East Fife,1924,8,11,10,15,55,54,1,43
Stranraer,1924,9,11,7,18,46,61,-15,40
Queen's Park,1924,10,9,9,18,37,62,-25,36
Livingston,1925,1,21,4,11,71,45,26,67
Alloa,1925,2,17,9,10,65,42,23,60
Brechin,1925,3,17,7,12,61,49,12,58
Queen's Park,1925,4,17,6,13,46,46,0,57
Peterhead,1925,5,16,7,13,51,45,6,55
East Fife,1925,6,14,9,13,52,49,3,51
Stranraer,1925,7,13,8,15,53,56,-3,47
Airdrieon,1925,8,13,7,16,49,57,-8,46
Albion,1925,9,8,9,19,45,61,-16,33
Stenhousem'r,1925,10,7,8,21,48,91,-43,29
Livingston,1926,1,23,5,8,80,42,38,74
Brechin,1926,2,21,4,11,58,46,12,67
Alloa,1926,3,17,8,11,74,47,27,59
Airdrieon,1926,4,15,9,12,57,52,5,54
Queen's Park,1926,5,15,7,14,37,47,-10,52
Albion,1926,6,10,12,14,45,57,-12,42
Peterhead,1926,7,11,9,16,43,55,-12,42
Stranraer,1926,8,12,5,19,52,66,-14,41
Stenhousem'r,1926,9,10,7,19,53,78,-25,37
East Fife,1926,10,10,6,20,51,60,-9,36
Livingston,1927,1,24,4,8,82,40,42,76
Alloa,1927,2,20,4,12,60,44,16,64
Airdrieon,1927,3,19,4,13,68,55,13,61
Peterhead,1927,4,16,6,14,63,63,0,54
Albion,1927,5,14,8,14,53,50,3,50
East Fife,1927,6,13,10,13,57,45,12,49
Brechin,1927,7,12,6,18,39,55,-16,42
Queen's Park,1927,8,11,8,17,36,55,-19,41
Stranraer,1927,9,11,5,20,46,61,-15,38
Stenhousem'r,1927,10,8,9,19,50,86,-36,33
Livingston,1928,1,22,4,10,78,49,29,70
Airdrieon,1928,2,20,7,9,66,46,20,67
Albion,1928,3,18,7,11,60,44,16,61
Alloa,1928,4,17,8,11,68,49,19,59
Brechin,1928,5,14,8,14,47,54,-7,50
Queen's Park,1928,6,14,4,18,38,50,-12,46
Stranraer,1928,7,12,9,15,52,60,-8,45
East Fife,1928,8,12,7,17,51,52,-1,43
Peterhead,1928,9,9,7,20,45,65,-20,34
Stenhousem'r,1928,10,7,9,20,45,81,-36,30
Livingston,1929,1,20,8,8,77,45,32,68
Alloa,1929,2,19,9,8,69,40,29,66
Brechin,1929,3,16,6,14,58,48,10,54
Airdrieon,1929,4,15,7,14,52,54,-2,52
Albion,1929,5,13,9,14,51,50,1,48
East Fife,1929,6,12,8,16,54,55,-1,44
Peterhead,1929,7,11,10,15,49,59,-10,43
Stenhousem'r,1929,8,12,7,17,45,73,-28,43
Stranraer,1929,9,11,9,16,51,60,-9,42
Queen's Park,1929,10,10,9,17,38,60,-22,39
Livingston,1930,1,24,2,10,75,41,34,74
Alloa,1930,2,20,8,8,70,33,37,68
Airdrieon,1930,3,18,5,13,60,50,10,59
Brechin,1930,4,15,8,13,45,48,-3,53
East Fife,1930,5,14,7,15,47,49,-2,49
Stranraer,1930,6,14,4,18,49,62,-13,46
Albion,1930,7,12,9,15,47,47,0,45
Peterhead,1930,8,12,8,16,40,52,-12,44
Queen's Park,1930,9,10,9,17,34,53,-19,39
Stenhousem'r,1930,10,4,14,18,43,75,-32,26
Alloa,1931,1,19,9,8,82,49,33,66
Livingston,1931,2,19,7,10,68,51,17,64
Brechin,1931,3,20,4,12,48,41,7,64
Airdrieon,1931,4,15,6,15,54,56,-2,51
Albion,1931,5,13,11,12,60,56,4,50
Stranraer,1931,6,15,5,16,57,55,2,50
Peterhead,1931,7,12,10,14,48,53,-5,46
East Fife,1931,8,12,8,16,51,48,3,44
Queen's Park,1931,9,8,13,15,34,54,-20,37
Stenhousem'r,1931,10,7,7,22,52,91,-39,28
Livingston,1932,1,19,4,13,72,50,22,61
Alloa,1932,2,17,8,11,67,51,16,59
Peterhead,1932,3,16,9,11,57,54,3,57
Airdrieon,1932,4,16,6,14,52,49,3,54
Albion,1932,5,13,11,12,52,48,4,50
Brechin,1932,6,15,5,16,48,56,-8,50
East Fife,1932,7,14,6,16,59,49,10,48
Queen's Park,1932,8,12,10,14,40,51,-11,46
Stenhousem'r,1932,9,11,8,17,47,69,-22,41
Stranraer,1932,10,10,7,19,41,58,-17,37
Alloa,1933,1,20,10,6,75,38,37,70
Livingston,1933,2,22,3,11,70,46,24,69
Albion,1933,3,15,8,13,59,53,6,53
Brechin,1933,4,16,5,15,56,54,2,53
Stranraer,1933,5,14,6,16,49,54,-5,48
Airdrieon,1933,6,14,6,16,50,61,-11,48
Peterhead,1933,7,12,9,15,41,52,-11,45
Queen's Park,1933,8,12,6,18,41,56,-15,42
East Fife,1933,9,8,15,13,50,50,0,39
Stenhousem'r,1933,10,8,10,18,51,78,-27,34
Alloa,1934,1,24,6,6,80,40,40,78
Livingston,1934,2,19,6,11,65,50,15,63
Peterhead,1934,3,15,7,14,49,47,2,52
Albion,1934,4,14,8,14,52,53,-1,50
Brechin,1934,5,13,11,12,45,52,-7,50
East Fife,1934,6,13,10,13,46,41,5,49
Airdrieon,1934,7,12,9,15,48,49,-1,45
Stranraer,1934,8,12,7,17,44,51,-7,43
Queen's Park,1934,9,10,10,16,39,54,-15,40
Stenhousem'r,1934,10,5,12,19,39,70,-31,27
Livingston,1935,1,22,6,8,82,45,37,72
Alloa,1935,2,17,10,9,72,48,24,61
Stranraer,1935,3,17,8,11,55,48,7,59
Brechin,1935,4,17,5,14,48,44,4,56
Airdrieon,1935,5,15,7,14,50,52,-2,52
East Fife,1935,6,14,9,13,49,44,5,51
Queen's Park,1935,7,14,5,17,45,51,-6,47
Albion,1935,8,12,8,16,53,59,-6,44
Peterhead,1935,9,11,7,18,50,64,-14,40
Stenhousem'r,1935,10,4,9,23,39,88,-49,21
Livingston,1936,1,21,8,7,72,36,36,71
Alloa,1936,2,17,10,9,62,43,19,61
Airdrieon,1936,3,17,7,12,63,54,9,58
Peterhead,1936,4,16,9,11,55,52,3,57
Brechin,1936,5,16,8,12,57,55,2,56
Albion,1936,6,14,11,11,58,56,2,53
Queen's Park,1936,7,12,7,17,30,50,-20,43
East Fife,1936,8,11,9,16,58,55,3,42
Stranraer,1936,9,11,3,22,46,57,-11,36
Stenhousem'r,1936,10,4,10,22,46,89,-43,22
Livingston,1937,1,19,8,9,76,48,28,65
Brechin,1937,2,20,4,12,58,48,10,64
Alloa,1937,3,18,5,13,59,52,7,59
Airdrieon,1937,4,16,8,12,56,51,5,56
Albion,1937,5,15,6,15,53,53,0,51
Queen's Park,1937,6,14,7,15,46,51,-5,49
East Fife,1937,7,13,9,14,58,48,10,48
Stranraer,1937,8,14,5,17,57,66,-9,47
Peterhead,1937,9,12,8,16,42,50,-8,44
Stenhousem'r,1937,10,4,10,22,44,82,-38,22
Alloa,1938,1,20,11,5,77,44,33,71
Livingston,1938,2,20,3,13,70,56,14,63
Brechin,1938,3,19,3,14,58,52,6,60
Peterhead,1938,4,17,5,14,53,48,5,56
Airdrieon,1938,5,16,7,13,54,59,-5,55
Albion,1938,6,14,11,11,63,51,12,53
Stranraer,1938,7,15,3,18,63,63,0,48
East Fife,1938,8,10,11,15,45,53,-8,41
Queen's Park,1938,9,9,10,17,29,48,-19,37
Stenhousem'r,1938,10,6,4,26,50,88,-38,22
Livingston,1939,1,21,5,10,80,48,32,68
Alloa,1939,2,17,9,10,67,49,18,60
Airdrieon,1939,3,15,9,12,62,48,14,54
East Fife,1939,4,14,11,11,47,45,2,53
Stranraer,1939,5,15,5,16,49,50,-1,50
Peterhead,1939,6,12,12,12,51,47,4,48
Brechin,1939,7,14,6,16,44,52,-8,48
Albion,1939,8,12,9,15,48,51,-3,45
Queen's Park,1939,9,12,9,15,36,54,-18,45
Stenhousem'r,1939,10,6,9,21,40,80,-40,27
Livingston,1940,1,19,6,11,84,51,33,63
Brechin,1940,2,18,9,9,46,46,0,63
Airdrieon,1940,3,16,9,11,56,53,3,57
Alloa,1940,4,12,13,11,61,52,9,49
Albion,1940,5,13,10,13,48,48,0,49
Peterhead,1940,6,11,13,12,50,53,-3,46
Queen's Park,1940,7,12,7,17,39,54,-15,43
Stenhousem'r,1940,8,12,7,17,58,74,-16,43
Stranraer,1940,9,12,5,19,46,56,-10,41
East Fife,1940,10,9,13,14,52,53,-1,40
Livingston,1941,1,23,2,11,85,61,24,71
Airdrieon,1941,2,22,3,11,63,53,10,69
Alloa,1941,3,19,9,8,72,41,31,66
Brechin,1941,4,17,6,13,62,57,5,57
East Fife,1941,5,14,9,13,51,40,11,51
Peterhead,1941,6,14,9,13,49,47,2,51
Stranraer,1941,7,13,3,20,59,71,-12,42
Albion,1941,8,11,4,21,49,55,-6,37
Queen's Park,1941,9,10,5,21,33,65,-32,35
Stenhousem'r,1941,10,9,6,21,43,76,-33,33
Livingston,1942,1,21,6,9,69,39,30,69
Airdrieon,1942,2,19,7,10,61,46,15,64
Albion,1942,3,18,6,12,63,46,17,60
Brechin,1942,4,17,7,12,50,47,3,58
Peterhead,1942,5,15,9,12,49,45,4,54
Alloa,1942,6,13,8,15,57,44,13,47
Stranraer,1942,7,14,5,17,55,61,-6,47
Queen's Park,1942,8,13,5,18,38,61,-23,44
East Fife,1942,9,8,9,19,44,58,-14,33
Stenhousem'r,1942,10,8,6,22,45,84,-39,30
Livingston,1943,1,23,7,6,79,41,38,76
Alloa,1943,2,18,7,11,69,45,24,61
Airdrieon,1943,3,18,7,11,58,52,6,61
Brechin,1943,4,18,6,12,53,43,10,60
Stranraer,1943,5,14,7,15,53,60,-7,49
Albion,1943,6,13,9,14,52,52,0,48
Queen's Park,1943,7,13,7,16,41,50,-9,46
Peterhead,1943,8,12,7,17,42,55,-13,43
East Fife,1943,9,9,9,18,47,54,-7,36
Stenhousem'r,1943,10,6,6,24,48,90,-42,24
Livingston,1944,1,24,3,9,79,50,29,75
Alloa,1944,2,20,7,9,75,46,29,67
Brechin,1944,3,16,5,15,45,43,2,53
Airdrieon,1944,4,16,5,15,55,62,-7,53
Stranraer,1944,5,15,4,17,55,59,-4,49
Albion,1944,6,13,9,14,56,57,-1,48
Queen's Park,1944,7,14,6,16,40,51,-11,48
East Fife,1944,8,12,11,13,53,40,13,47
Peterhead,1944,9,11,5,20,48,56,-8,38
Stenhousem'r,1944,10,9,5,22,43,85,-42,32
Alloa,1945,1,20,8,8,72,45,27,68
Airdrieon,1945,2,18,8,10,62,54,8,62
Brechin,1945,3,18,7,11,52,45,7,61
Livingston,1945,4,18,4,14,69,50,19,58
Albion,1945,5,15,10,11,54,45,9,55
Peterhead,1945,6,12,10,14,50,52,-2,46
East Fife,1945,7,11,8,17,41,48,-7,41
Queen's Park,1945,8,9,13,14,34,45,-11,40
Stranraer,1945,9,11,5,20,45,63,-18,38
Stenhousem'r,1945,10,8,7,21,47,79,-32,31
Livingston,1946,1,21,8,7,80,46,34,71
Brechin,1946,2,19,7,10,62,50,12,64
Alloa,1946,3,18,8,10,74,47,27,62
Airdrieon,1946,4,16,7,13,65,56,9,55
Peterhead,1946,5,16,5,15,50,53,-3,53
Albion,1946,6,13,8,15,58,64,-6,47
East Fife,1946,7,11,8,17,49,52,-3,41
Stranraer,1946,8,11,8,17,61,68,-7,41
Queen's Park,1946,9,10,11,15,33,48,-15,41
Stenhousem'r,1946,10,7,6,23,40,88,-48,27
Livingston,1947,1,22,4,10,73,47,26,70
Airdrieon,1947,2,15,15,6,63,44,19,60
Alloa,1947,3,16,11,9,61,44,17,59
Peterhead,1947,4,15,10,11,52,48,4,55
Brechin,1947,5,15,4,17,61,57,4,49
Stranraer,1947,6,13,7,16,50,63,-13,46
Albion,1947,7,12,9,15,55,60,-5,45
East Fife,1947,8,12,7,17,48,49,-1,43
Queen's Park,1947,9,10,8,18,37,53,-16,38
Stenhousem'r,1947,10,7,11,18,45,80,-35,32
Livingston,1948,1,21,4,11,71,48,23,67
Alloa,1948,2,19,8,9,73,47,26,65
Brechin,1948,3,16,9,11,50,49,1,57
Airdrieon,1948,4,16,7,13,56,52,4,55
Albion,1948,5,15,6,15,51,49,2,51
Queen's Park,1948,6,15,5,16,46,48,-2,50
Peterhead,1948,7,12,9,15,54,60,-6,45
Stranraer,1948,8,11,10,15,46,55,-9,43
East Fife,1948,9,9,12,15,46,51,-5,39
Stenhousem'r,1948,10,6,10,20,51,85,-34,28
Livingston,1949,1,20,5,11,85,52,33,65
Alloa,1949,2,18,7,11,73,47,26,61
Brechin,1949,3,18,7,11,50,53,-3,61
Peterhead,1949,4,19,3,14,55,51,4,60
Airdrieon,1949,5,16,8,12,69,55,14,56
Albion,1949,6,12,10,14,57,63,-6,46
Stranraer,1949,7,13,4,19,54,67,-13,43
Queen's Park,1949,8,12,6,18,36,51,-15,42
East Fife,1949,9,10,8,18,49,61,-12,38
Stenhousem'r,1949,10,9,8,19,54,82,-28,35
Alloa,1950,1,20,9,7,76,45,31,69
Livingston,1950,2,19,6,11,67,43,24,63
Airdrieon,1950,3,17,8,11,63,59,4,59
Brechin,1950,4,15,10,11,58,53,5,55
Peterhead,1950,5,13,10,13,46,48,-2,49
Albion,1950,6,12,12,12,45,46,-1,48
Queen's Park,1950,7,12,7,17,36,51,-15,43
Stranraer,1950,8,10,8,18,53,65,-12,38
East Fife,1950,9,7,16,13,48,51,-3,37
Stenhousem'r,1950,10,7,10,19,48,79,-31,31
Alloa,1951,1,21,7,8,79,41,38,70
Livingston,1951,2,16,11,9,74,48,26,59
Airdrieon,1951,3,16,6,14,63,63,0,54
Brechin,1951,4,15,6,15,47,50,-3,51
Peterhead,1951,5,14,9,13,47,54,-7,51
Queen's Park,1951,6,13,10,13,42,53,-11,49
East Fife,1951,7,11,13,12,50,50,0,46
Albion,1951,8,12,10,14,46,52,-6,46
Stranraer,1951,9,11,10,15,43,52,-9,43
Stenhousem'r,1951,10,6,8,22,43,71,-28,26
Alloa,1952,1,21,5,10,74,44,30,68
Livingston,1952,2,21,2,13,67,42,25,65
Brechin,1952,3,16,10,10,45,38,7,58
Airdrieon,1952,4,16,7,13,49,51,-2,55
Albion,1952,5,15,9,12,57,50,7,54
Peterhead,1952,6,12,11,13,42,43,-1,47
Stranraer,1952,7,13,6,17,43,48,-5,45
Queen's Park,1952,8,11,10,15,27,39,-12,43
East Fife,1952,9,7,12,17,41,58,-17,33
Stenhousem'r,1952,10,8,8,20,46,78,-32,32
Alloa,1953,1,21,6,9,69,41,28,69
Airdrieon,1953,2,19,5,12,57,50,7,62
Brechin,1953,3,18,7,11,53,43,10,61
Stranraer,1953,4,17,7,12,53,45,8,58
Livingston,1953,5,16,7,13,74,57,17,55
Peterhead,1953,6,15,7,14,48,51,-3,52
Albion,1953,7,13,7,16,51,56,-5,46
Queen's Park,1953,8,13,5,18,34,53,-19,44
East Fife,1953,9,8,10,18,43,52,-9,34
Stenhousem'r,1953,10,6,7,23,39,73,-34,25
Livingston,1954,1,22,4,10,81,45,36,70
Alloa,1954,2,20,6,10,74,46,28,66
Brechin,1954,3,17,8,11,49,44,5,59
Airdrieon,1954,4,16,10,10,55,44,11,58
Peterhead,1954,5,16,9,11,47,46,1,57
Queen's Park,1954,6,12,11,13,36,43,-7,47
Albion,1954,7,10,12,14,52,56,-4,42
Stranraer,1954,8,11,5,20,53,67,-14,38
East Fife,1954,9,9,10,17,44,60,-16,37
Stenhousem'r,1954,10,7,5,24,49,89,-40,26
Airdrieon,1955,1,19,7,10,66,56,10,64
Alloa,1955,2,19,6,11,72,54,18,63
Brechin,1955,3,16,7,13,51,49,2,55
Livingston,1955,4,15,6,15,65,51,14,51
Peterhead,1955,5,14,9,13,50,51,-1,51
Stranraer,1955,6,15,6,15,53,58,-5,51
Albion,1955,7,11,13,12,58,54,4,46
Queen's Park,1955,8,12,10,14,40,46,-6,46
East Fife,1955,9,11,9,16,42,45,-3,42
Stenhousem'r,1955,10,7,9,20,47,80,-33,30
Alloa,1956,1,18,9,9,70,51,19,63
Airdrieon,1956,2,17,12,7,67,49,18,63
Brechin,1956,3,19,3,14,56,48,8,60
Albion,1956,4,16,8,12,60,48,12,56
Livingston,1956,5,16,7,13,65,50,15,55
Peterhead,1956,6,14,9,13,47,49,-2,51
Queen's Park,1956,7,13,7,16,40,51,-11,46
East Fife,1956,8,10,13,13,52,50,2,43
Stranraer,1956,9,11,5,20,48,64,-16,38
Stenhousem'r,1956,10,5,9,22,42,87,-45,24
Livingston,1957,1,23,4,9,73,43,30,73
Alloa,1957,2,18,6,12,66,51,15,60
Airdrieon,1957,3,17,8,11,53,53,0,59
Peterhead,1957,4,17,5,14,50,51,-1,56
Brechin,1957,5,16,3,17,49,51,-2,51
Stranraer,1957,6,13,9,14,49,53,-4,48
Albion,1957,7,13,6,17,56,60,-4,45
East Fife,1957,8,11,9,16,59,49,10,42
Queen's Park,1957,9,12,6,18,39,55,-16,42
Stenhousem'r,1957,10,8,8,20,46,74,-28,32
Alloa,1958,1,21,7,8,81,40,41,70
Livingston,1958,2,19,5,12,74,58,16,62
Peterhead,1958,3,14,13,9,50,43,7,55
Airdrieon,1958,4,15,9,12,58,50,8,54
Albion,1958,5,15,9,12,51,48,3,54
Brechin,1958,6,14,9,13,45,44,1,51
Queen's Park,1958,7,12,9,15,33,44,-11,45
Stranraer,1958,8,11,8,17,45,59,-14,41
East Fife,1958,9,6,14,16,38,53,-15,32
Stenhousem'r,1958,10,8,7,21,47,83,-36,31
Livingston,1959,1,22,5,9,78,43,35,71
Alloa,1959,2,17,12,7,73,48,25,63
Albion,1959,3,16,9,11,53,46,7,57
Brechin,1959,4,16,7,13,50,44,6,55
Peterhead,1959,5,15,7,14,44,48,-4,52
Airdrieon,1959,6,14,7,15,55,55,0,49
Stranraer,1959,7,12,8,16,50,59,-9,44
Queen's Park,1959,8,12,7,17,36,60,-24,43
East Fife,1959,9,11,9,16,48,46,2,42
Stenhousem'r,1959,10,5,9,22,40,78,-38,24
Alloa,1960,1,21,6,9,72,37,35,69
Livingston,1960,2,20,5,11,77,52,25,65
Brechin,1960,3,20,5,11,50,37,13,65
Peterhead,1960,4,15,7,14,45,51,-6,52
Queen's Park,1960,5,14,7,15,39,49,-10,49
Airdrieon,1960,6,14,6,16,49,57,-8,48
Stranraer,1960,7,13,6,17,49,53,-4,45
Albion,1960,8,11,11,14,40,43,-3,44
East Fife,1960,9,8,11,17,40,47,-7,35
Stenhousem'r,1960,10,8,8,20,45,80,-35,32
Alloa,1961,1,22,8,6,83,44,39,74
Livingston,1961,2,21,7,8,77,42,35,70
Airdrieon,1961,3,16,9,11,62,59,3,57
Brechin,1961,4,15,8,13,47,47,0,53
East Fife,1961,5,15,5,16,56,47,9,50
Peterhead,1961,6,15,5,16,49,53,-4,50
Albion,1961,7,13,10,13,56,60,-4,49
Queen's Park,1961,8,12,4,20,38,60,-22,40
Stranraer,1961,9,9,7,20,49,62,-13,34
Stenhousem'r,1961,10,7,7,22,41,84,-43,28
Livingston,1962,1,22,4,10,76,44,32,70
Brechin,1962,2,19,5,12,55,50,5,62
Alloa,1962,3,17,5,14,62,43,19,56
East Fife,1962,4,15,7,14,51,47,4,52
Airdrieon,1962,5,16,4,16,55,56,-1,52
Peterhead,1962,6,14,8,14,49,51,-2,50
Albion,1962,7,13,10,13,49,50,-1,49
Queen's Park,1962,8,12,9,15,42,51,-9,45
Stranraer,1962,9,11,5,20,52,66,-14,38
Stenhousem'r,1962,10,10,5,21,46,79,-33,35
Livingston,1963,1,19,9,8,65,40,25,66
Alloa,1963,2,19,8,9,71,44,27,65
Brechin,1963,3,20,5,11,55,43,12,65
Airdrieon,1963,4,17,7,12,59,50,9,58
Peterhead,1963,5,15,10,11,46,46,0,55
Albion,1963,6,13,10,13,46,51,-5,49
Stranraer,1963,7,12,8,16,51,61,-10,44
East Fife,1963,8,7,15,14,41,43,-2,36
Queen's Park,1963,9,7,9,20,29,48,-19,30
Stenhousem'r,1963,10,7,7,22,38,75,-37,28
Airdrieon,1964,1,20,7,9,68,49,19,67
Livingston,1964,2,16,10,10,69,52,17,58
Alloa,1964,3,15,12,9,62,41,21,57
East Fife,1964,4,16,8,12,57,45,12,56
Peterhead,1964,5,15,8,13,54,48,6,53
Brechin,1964,6,13,11,12,41,51,-10,50
Stranraer,1964,7,14,7,15,50,52,-2,49
Albion,1964,8,10,9,17,42,51,-9,39
Queen's Park,1964,9,10,9,17,33,53,-20,39
Stenhousem'r,1964,10,5,11,20,46,80,-34,26
Livingston,1965,1,23,3,10,80,51,29,72
Alloa,1965,2,18,9,9,73,47,26,63
Airdrieon,1965,3,17,10,9,60,52,8,61
Albion,1965,4,16,4,16,59,55,4,52
Brechin,1965,5,14,7,15,49,56,-7,49
Queen's Park,1965,6,13,8,15,38,46,-8,47
Stranraer,1965,7,14,4,18,58,63,-5,46
Peterhead,1965,8,13,6,17,51,60,-9,45
East Fife,1965,9,10,9,17,54,57,-3,39
Stenhousem'r,1965,10,8,8,20,47,82,-35,32
Alloa,1966,1,25,5,6,75,33,42,80
Livingston,1966,2,24,3,9,81,40,41,75
Brechin,1966,3,15,7,14,45,46,-1,52
Airdrieon,1966,4,16,3,17,58,55,3,51
Queen's Park,1966,5,14,7,15,43,49,-6,49
Albion,1966,6,13,9,14,49,55,-6,48
Peterhead,1966,7,13,8,15,44,50,-6,47
East Fife,1966,8,11,8,17,42,51,-9,41
Stranraer,1966,9,13,2,21,39,63,-24,41
Stenhousem'r,1966,10,8,4,24,49,83,-34,28
Livingston,1967,1,21,7,8,72,39,33,70
Airdrieon,1967,2,19,7,10,63,47,16,64
Alloa,1967,3,18,4,14,68,44,24,58
Albion,1967,4,15,8,13,49,59,-10,53
East Fife,1967,5,13,12,11,54,43,11,51
Peterhead,1967,6,14,8,14,53,50,3,50
Brechin,1967,7,14,6,16,46,52,-6,48
Stranraer,1967,8,13,4,19,44,57,-13,43
Queen's Park,1967,9,11,7,18,35,52,-17,40
Stenhousem'r,1967,10,7,7,22,49,90,-41,28
Livingston,1968,1,23,2,11,73,43,30,71
Alloa,1968,2,18,11,7,74,43,31,65
Brechin,1968,3,15,8,13,47,43,4,53
Airdrieon,1968,4,16,5,15,52,52,0,53
East Fife,1968,5,14,9,13,50,47,3,51
Albion,1968,6,15,5,16,57,57,0,50
Queen's Park,1968,7,14,6,16,46,50,-4,48
Peterhead,1968,8,12,10,14,43,55,-12,46
Stranraer,1968,9,10,7,19,49,63,-14,37
Stenhousem'r,1968,10,9,5,22,41,79,-38,32
Livingston,1969,1,20,4,12,82,55,27,64
Alloa,1969,2,18,7,11,72,47,25,61
Airdrieon,1969,3,19,4,13,71,63,8,61
Albion,1969,4,14,12,10,55,46,9,54
Brechin,1969,5,16,5,15,48,52,-4,53
Peterhead,1969,6,15,7,14,48,54,-6,52
Stranraer,1969,7,14,4,18,48,55,-7,46
Queen's Park,1969,8,13,6,17,38,60,-22,45
Stenhousem'r,1969,9,10,7,19,52,75,-23,37
East Fife,1969,10,8,10,18,42,49,-7,34
Alloa,1970,1,21,7,8,65,39,26,70
Airdrieon,1970,2,21,6,9,61,44,17,69
Livingston,1970,3,20,4,12,75,44,31,64
Brechin,1970,4,13,10,13,50,55,-5,49
Peterhead,1970,5,12,11,13,49,50,-1,47
Queen's Park,1970,6,12,9,15,40,54,-14,45
Stranraer,1970,7,13,4,19,48,62,-14,43
Albion,1970,8,11,9,16,59,64,-5,42
East Fife,1970,9,8,13,15,40,47,-7,37
Stenhousem'r,1970,10,9,7,20,51,79,-28,34
Airdrieon,1971,1,20,6,10,74,55,19,66
Livingston,1971,2,19,5,12,72,54,18,62
Peterhead,1971,3,19,5,12,56,47,9,62
Alloa,1971,4,17,5,14,61,48,13,56
Albion,1971,5,15,9,12,58,54,4,54
East Fife,1971,6,14,9,13,57,50,7,51
Queen's Park,1971,7,14,6,16,46,54,-8,48
Stranraer,1971,8,12,3,21,50,69,-19,39
Brechin,1971,9,11,5,20,43,55,-12,38
Stenhousem'r,1971,10,9,7,20,50,81,-31,34
Livingston,1972,1,20,4,12,72,51,21,64
Alloa,1972,2,18,8,10,80,53,27,62
Airdrieon,1972,3,17,7,12,53,50,3,58
Brechin,1972,4,16,9,11,52,49,3,57
East Fife,1972,5,12,10,14,49,48,1,46
Peterhead,1972,6,11,12,13,46,50,-4,45
Albion,1972,7,13,6,17,53,62,-9,45
Queen's Park,1972,8,12,7,17,47,55,-8,43
Stranraer,1972,9,12,5,19,54,70,-16,41
Stenhousem'r,1972,10,10,10,16,50,68,-18,40
Alloa,1973,1,17,11,8,70,46,24,62
Airdrieon,1973,2,19,5,12,59,54,5,62
Livingston,1973,3,17,8,11,75,49,26,59
Brechin,1973,4,17,8,11,55,46,9,59
Peterhead,1973,5,16,5,15,52,42,10,53
Albion,1973,6,14,9,13,61,60,1,51
Queen's Park,1973,7,13,7,16,42,60,-18,46
East Fife,1973,8,10,12,14,52,52,0,42
Stranraer,1973,9,9,10,17,45,56,-11,37
Stenhousem'r,1973,10,6,9,21,43,89,-46,27
Livingston,1974,1,24,3,9,81,47,34,75
Alloa,1974,2,20,6,10,67,42,25,66
Airdrieon,1974,3,17,8,11,57,51,6,59
Brechin,1974,4,16,9,11,44,43,1,57
Peterhead,1974,5,14,8,14,56,52,4,50
Albion,1974,6,14,7,15,53,51,2,49
Stranraer,1974,7,14,5,17,60,65,-5,47
East Fife,1974,8,10,7,19,47,49,-2,37
Stenhousem'r,1974,9,7,13,16,44,77,-33,34
Queen's Park,1974,10,8,6,22,28,60,-32,30
Livingston,1975,1,20,5,11,77,53,24,65
Alloa,1975,2,19,7,10,72,43,29,64
Brechin,1975,3,17,7,12,50,41,9,58
East Fife,1975,4,14,13,9,62,53,9,55
Airdrieon,1975,5,13,11,12,56,55,1,50
Albion,1975,6,12,10,14,56,56,0,46
Queen's Park,1975,7,13,6,17,39,56,-17,45
Peterhead,1975,8,12,7,17,46,52,-6,43
Stranraer,1975,9,12,5,19,44,60,-16,41
Stenhousem'r,1975,10,8,9,19,51,84,-33,33
Livingston,1976,1,19,8,9,79,51,28,65
Brechin,1976,2,18,8,10,56,48,8,62
Alloa,1976,3,16,8,12,60,46,14,56
Airdrieon,1976,4,15,8,13,66,58,8,53
Albion,1976,5,14,10,12,57,50,7,52
Stranraer,1976,6,13,6,17,46,55,-9,45
Queen's Park,1976,7,12,9,15,38,47,-9,45
Peterhead,1976,8,13,6,17,42,57,-15,45
East Fife,1976,9,11,8,17,53,56,-3,41
Stenhousem'r,1976,10,9,9,18,48,77,-29,36
Brechin,1977,1,18,10,8,60,41,19,64
Alloa,1977,2,15,12,9,63,46,17,57
Livingston,1977,3,17,5,14,67,49,18,56
Airdrieon,1977,4,15,5,16,53,58,-5,50
Queen's Park,1977,5,14,8,14,39,52,-13,50
Stenhousem'r,1977,6,14,8,14,48,63,-15,50
Albion,1977,7,12,10,14,54,49,5,46
Stranraer,1977,8,13,7,16,55,59,-4,46
Peterhead,1977,9,12,7,17,52,62,-10,43
East Fife,1977,10,10,8,18,45,57,-12,38
Alloa,1978,1,21,8,7,68,36,32,71
Livingston,1978,2,21,4,11,79,49,30,67
Airdrieon,1978,3,20,6,10,68,44,24,66
Albion,1978,4,14,10,12,54,48,6,52
Brechin,1978,5,15,6,15,56,59,-3,51
Peterhead,1978,6,15,5,16,51,47,4,50
East Fife,1978,7,12,10,14,41,44,-3,46
Stranraer,1978,8,11,10,15,50,61,-11,43
Stenhousem'r,1978,9,7,8,21,38,80,-42,29
Queen's Park,1978,10,7,7,22,31,68,-37,28
Livingston,1979,1,22,4,10,75,41,34,70
Alloa,1979,2,20,10,6,74,41,33,70
Airdrieon,1979,3,17,7,12,54,52,2,58
Brechin,1979,4,17,3,16,57,60,-3,54
East Fife,1979,5,14,8,14,51,47,4,50
Peterhead,1979,6,13,11,12,52,51,1,50
Albion,1979,7,12,10,14,51,51,0,46
Queen's Park,1979,8,12,6,18,44,58,-14,42
Stenhousem'r,1979,9,9,7,20,46,78,-32,34
Stranraer,1979,10,8,6,22,42,67,-25,30
Livingston,1980,1,24,5,7,80,38,42,77
Alloa,1980,2,17,10,9,72,52,20,61
Airdrieon,1980,3,16,6,14,57,57,0,54
Brechin,1980,4,15,9,12,56,59,-3,54
Peterhead,1980,5,13,11,12,49,48,1,50
Albion,1980,6,13,11,12,60,63,-3,50
Stranraer,1980,7,14,3,19,52,57,-5,45
East Fife,1980,8,10,11,15,40,43,-3,41
Queen's Park,1980,9,10,9,17,37,51,-14,39
Stenhousem'r,1980,10,5,11,20,49,84,-35,26
Livingston,1981,1,20,8,8,73,48,25,68
Alloa,1981,2,16,11,9,66,44,22,59
Peterhead,1981,3,17,8,11,59,53,6,59
Airdrieon,1981,4,17,7,12,66,57,9,58
Brechin,1981,5,16,6,14,46,52,-6,54
Stranraer,1981,6,17,2,17,53,56,-3,53
East Fife,1981,7,12,11,13,49,48,1,47
Albion,1981,8,11,11,14,56,54,2,44
Queen's Park,1981,9,8,9,19,27,45,-18,33
Stenhousem'r,1981,10,5,9,22,42,80,-38,24
Peterhead,1982,1,16,9,11,52,46,6,57
Livingston,1982,2,17,4,15,70,55,15,55
Stranraer,1982,3,16,7,13,55,51,4,55
Airdrieon,1982,4,16,7,13,64,62,2,55
Albion,1982,5,15,9,12,57,55,2,54
Alloa,1982,6,14,11,11,64,52,12,53
Brechin,1982,7,14,9,13,56,52,4,51
East Fife,1982,8,11,11,14,56,50,6,44
Queen's Park,1982,9,10,10,16,28,50,-22,40
Stenhousem'r,1982,10,8,9,19,42,71,-29,33
Alloa,1983,1,17,12,7,67,47,20,63
Livingston,1983,2,16,9,11,73,54,19,57
Brechin,1983,3,17,5,14,59,48,11,56
Airdrieon,1983,4,17,3,16,59,67,-8,54
Stranraer,1983,5,15,7,14,57,58,-1,52
East Fife,1983,6,13,10,13,56,47,9,49
Queen's Park,1983,7,13,8,15,39,50,-11,47
Peterhead,1983,8,11,12,13,46,48,-2,45
Albion,1983,9,11,7,18,50,58,-8,40
Stenhousem'r,1983,10,10,7,19,49,78,-29,37
Livingston,1984,1,19,8,9,83,59,24,65
Alloa,1984,2,19,7,10,70,43,27,64
Brechin,1984,3,18,7,11,54,49,5,61
Airdrieon,1984,4,17,7,12,54,52,2,58
Peterhead,1984,5,14,10,12,67,58,9,52
Albion,1984,6,12,10,14,54,57,-3,46
Stranraer,1984,7,13,4,19,48,55,-7,43
Queen's Park,1984,8,11,8,17,42,58,-16,41
Stenhousem'r,1984,9,10,7,19,59,82,-23,37
East Fife,1984,10,8,10,18,44,62,-18,34
Alloa,1985,1,20,8,8,71,40,31,68
Livingston,1985,2,20,7,9,71,47,24,67
Brechin,1985,3,17,11,8,58,40,18,62
Airdrieon,1985,4,18,5,13,59,57,2,59
Albion,1985,5,16,6,14,53,51,2,54
Peterhead,1985,6,12,8,16,43,52,-9,44
East Fife,1985,7,11,8,17,51,60,-9,41
Stenhousem'r,1985,8,11,6,19,52,74,-22,39
Stranraer,1985,9,11,5,20,46,56,-10,38
Queen's Park,1985,10,7,10,19,29,56,-27,31
Livingston,1986,1,25,1,10,85,41,44,76
Alloa,1986,2,15,12,9,63,48,15,57
Brechin,1986,3,17,3,16,49,51,-2,54
Airdrieon,1986,4,15,7,14,52,54,-2,52
East Fife,1986,5,15,6,15,59,48,11,51
Stranraer,1986,6,15,5,16,54,60,-6,50
Albion,1986,7,13,7,16,51,54,-3,46
Peterhead,1986,8,13,7,16,46,54,-8,46
Queen's Park,1986,9,13,6,17,35,53,-18,45
Stenhousem'r,1986,10,8,8,20,45,76,-31,32
Alloa,1987,1,20,10,6,78,43,35,70
Livingston,1987,2,21,6,9,68,48,20,69
Airdrieon,1987,3,18,9,9,69,50,19,63
East Fife,1987,4,17,6,13,65,48,17,57
Brechin,1987,5,14,4,18,53,64,-11,46
Peterhead,1987,6,12,8,16,54,64,-10,44
Queen's Park,1987,7,13,5,18,39,55,-16,44
Albion,1987,8,11,9,16,50,53,-3,42
Stranraer,1987,9,11,6,19,54,67,-13,39
Stenhousem'r,1987,10,7,9,20,43,81,-38,30
Peterhead,1988,1,19,7,10,60,42,18,64
Livingston,1988,2,19,5,12,77,51,26,62
Brechin,1988,3,19,5,12,57,45,12,62
Albion,1988,4,17,7,12,62,51,11,58
Airdrieon,1988,5,17,5,14,62,58,4,56
Alloa,1988,6,14,8,14,65,51,14,50
Stranraer,1988,7,13,9,14,48,55,-7,48
East Fife,1988,8,11,9,16,50,51,-1,42
Queen's Park,1988,9,11,8,17,35,60,-25,41
Stenhousem'r,1988,10,4,9,23,37,89,-52,21
Alloa,1989,1,20,6,10,74,47,27,66
Livingston,1989,2,19,7,10,68,48,20,64
Airdrieon,1989,3,18,8,10,62,55,7,62
Brechin,1989,4,18,4,14,58,47,11,58
Stranraer,1989,5,14,5,17,56,60,-4,47
Albion,1989,6,11,10,15,53,61,-8,43
Peterhead,1989,7,12,7,17,45,57,-12,43
Stenhousem'r,1989,8,11,8,17,59,72,-13,41
East Fife,1989,9,10,10,16,51,55,-4,40
Queen's Park,1989,10,11,7,18,33,57,-24,40
Livingston,1990,1,25,7,4,87,35,52,82
Alloa,1990,2,17,8,11,62,43,19,59
Brechin,1990,3,17,8,11,53,47,6,59
Airdrieon,1990,4,17,5,14,53,57,-4,56
Albion,1990,5,15,8,13,57,53,4,53
Stranraer,1990,6,16,4,16,58,63,-5,52
East Fife,1990,7,10,11,15,46,45,1,41
Peterhead,1990,8,11,6,19,40,54,-14,39
Stenhousem'r,1990,9,9,9,18,44,71,-27,36
Queen's Park,1990,10,7,6,23,33,65,-32,27
Alloa,1991,1,18,10,8,73,46,27,64
Livingston,1991,2,19,4,13,73,53,20,61
Airdrieon,1991,3,18,7,11,56,52,4,61
Brechin,1991,4,17,9,10,55,40,15,60
Queen's Park,1991,5,15,9,12,43,42,1,54
Peterhead,1991,6,15,7,14,53,52,1,52
East Fife,1991,7,12,9,15,46,49,-3,45
Albion,1991,8,11,7,18,45,62,-17,40
Stenhousem'r,1991,9,9,8,19,44,72,-28,35
Stranraer,1991,10,9,4,23,44,64,-20,31
Alloa,1992,1,20,5,11,65,48,17,65
Livingston,1992,2,20,2,14,76,56,20,62
Brechin,1992,3,19,4,13,54,45,9,61
Peterhead,1992,4,17,7,12,54,51,3,58
Airdrieon,1992,5,16,4,16,55,51,4,52
Albion,1992,6,14,9,13,51,55,-4,51
Stranraer,1992,7,16,1,19,54,56,-2,49
Queen's Park,1992,8,12,9,15,43,52,-9,45
East Fife,1992,9,10,12,14,54,52,2,42
Stenhousem'r,1992,10,7,5,24,41,81,-40,26
Alloa,1993,1,20,8,8,70,44,26,68
Airdrieon,1993,2,20,6,10,73,52,21,66
Livingston,1993,3,20,6,10,74,56,18,66
Albion,1993,4,15,9,12,72,55,17,54
Brechin,1993,5,16,6,14,50,49,1,54
East Fife,1993,6,12,9,15,45,44,1,45
Stranraer,1993,7,14,2,20,53,57,-4,44
Peterhead,1993,8,10,11,15,42,58,-16,41
Queen's Park,1993,9,10,6,20,33,60,-27,36
Stenhousem'r,1993,10,7,9,20,50,87,-37,30
Livingston,1994,1,21,6,9,73,46,27,69
Alloa,1994,2,17,12,7,65,36,29,63
Airdrieon,1994,3,17,10,9,65,52,13,61
Brechin,1994,4,18,6,12,53,44,9,60
East Fife,1994,5,14,8,14,48,49,-1,50
Albion,1994,6,11,10,15,54,53,1,43
Peterhead,1994,7,11,9,16,46,59,-13,42
Stranraer,1994,8,11,6,19,40,57,-17,39
Queen's Park,1994,9,10,7,19,35,54,-19,37
Stenhousem'r,1994,10,8,10,18,45,74,-29,34
Alloa,1995,1,19,7,10,74,54,20,64
Brechin,1995,2,18,7,11,57,51,6,61
Livingston,1995,3,18,6,12,72,59,13,60
Albion,1995,4,17,5,14,57,44,13,56
Airdrieon,1995,5,16,8,12,57,53,4,56
Stranraer,1995,6,15,8,13,59,58,1,53
Peterhead,1995,7,12,11,13,50,56,-6,47
East Fife,1995,8,12,10,14,56,48,8,46
Queen's Park,1995,9,9,9,18,39,60,-21,36
Stenhousem'r,1995,10,5,7,24,38,76,-38,22
Alloa,1996,1,22,4,10,66,36,30,70
Livingston,1996,2,21,1,14,71,45,26,64
Airdrieon,1996,3,20,3,13,65,59,6,63
Brechin,1996,4,19,2,15,51,51,0,59
Albion,1996,5,15,6,15,54,50,4,51
Peterhead,1996,6,15,5,16,46,44,2,50
Queen's Park,1996,7,15,4,17,41,51,-10,49
East Fife,1996,8,13,6,17,48,49,-1,45
Stranraer,1996,9,11,6,19,50,65,-15,39
Stenhousem'r,1996,10,8,5,23,46,88,-42,29
Livingston,1997,1,22,4,10,83,55,28,70
Alloa,1997,2,16,9,11,69,52,17,57
Airdrieon,1997,3,17,5,14,56,50,6,56
Albion,1997,4,15,8,13,57,53,4,53
Peterhead,1997,5,13,9,14,48,56,-8,48
Queen's Park,1997,6,14,5,17,44,49,-5,47
Brechin,1997,7,13,8,15,50,60,-10,47
Stranraer,1997,8,13,7,16,53,62,-9,46
Stenhousem'r,1997,9,11,10,15,54,69,-15,43
East Fife,1997,10,9,9,18,43,51,-8,36
Livingston,1998,1,24,5,7,85,41,44,77
Alloa,1998,2,19,9,8,78,45,33,66
Brechin,1998,3,15,8,13,48,49,-1,53
Stranraer,1998,4,13,11,12,57,54,3,50
Peterhead,1998,5,13,11,12,44,50,-6,50
Airdrieon,1998,6,14,7,15,55,60,-5,49
Albion,1998,7,12,12,12,53,55,-2,48
East Fife,1998,8,12,8,16,42,49,-7,44
Queen's Park,1998,9,8,8,20,35,60,-25,32
Stenhousem'r,1998,10,7,7,22,48,82,-34,28
Livingston,1999,1,23,5,8,79,46,33,74
Peterhead,1999,2,18,5,13,57,55,2,59
Alloa,1999,3,15,11,10,69,47,22,56
Brechin,1999,4,14,12,10,51,46,5,54
Albion,1999,5,13,12,11,56,52,4,51
Airdrieon,1999,6,15,6,15,56,58,-2,51
Queen's Park,1999,7,11,15,10,47,52,-5,48
East Fife,1999,8,9,12,15,49,47,2,39
Stranraer,1999,9,11,5,20,48,67,-19,38
Stenhousem'r,1999,10,5,9,22,35,77,-42,24
Livingston,2000,1,20,6,10,75,46,29,66
Airdrieon,2000,2,16,9,11,65,61,4,57
Alloa,2000,3,15,10,11,63,48,15,55
Brechin,2000,4,17,4,15,44,49,-5,55
East Fife,2000,5,15,9,12,60,44,16,54
Peterhead,2000,6,12,12,12,62,61,1,48
Albion,2000,7,13,7,16,55,59,-4,46
Queen's Park,2000,8,13,7,16,35,48,-13,46
Stranraer,2000,9,12,6,18,52,61,-9,42
Stenhousem'r,2000,10,7,10,19,43,77,-34,31
Livingston,2001,1,22,4,10,65,41,24,70
Alloa,2001,2,19,8,9,58,39,19,65
Airdrieon,2001,3,16,8,12,54,51,3,56
Brechin,2001,4,16,4,16,49,54,-5,52
East Fife,2001,5,14,7,15,54,52,2,49
Peterhead,2001,6,13,9,14,54,54,0,48
Albion,2001,7,11,12,13,49,44,5,45
Stranraer,2001,8,13,5,18,47,54,-7,44
Queen's Park,2001,9,10,7,19,33,52,-19,37
Stenhousem'r,2001,10,9,10,17,47,69,-22,37
Peterhead,2002,1,21,5,10,50,39,11,68
Airdrieon,2002,2,20,4,12,60,42,18,64
Livingston,2002,3,18,8,10,78,53,25,62
Brechin,2002,4,16,8,12,47,41,6,56
Alloa,2002,5,16,7,13,69,54,15,55
Albion,2002,6,13,9,14,51,52,-1,48
Stranraer,2002,7,14,5,17,62,62,0,47
East Fife,2002,8,11,11,14,56,52,4,44
Queen's Park,2002,9,9,7,20,30,61,-31,34
Stenhousem'r,2002,10,6,8,22,42,89,-47,26
Brechin,2003,1,20,5,11,58,41,17,65
Airdrieon,2003,2,18,7,11,67,54,13,61
Alloa,2003,3,17,9,10,66,42,24,60
Livingston,2003,4,18,4,14,64,54,10,58
Peterhead,2003,5,15,9,12,56,48,8,54
East Fife,2003,6,15,6,15,50,45,5,51
Albion,2003,7,14,9,13,53,54,-1,51
Stranraer,2003,8,15,4,17,55,66,-11,49
Queen's Park,2003,9,11,4,21,44,65,-21,37
Stenhousem'r,2003,10,5,7,24,44,88,-44,22
Alloa,2004,1,20,8,8,82,49,33,68
Livingston,2004,2,20,4,12,66,47,19,64
Brechin,2004,3,18,6,12,48,44,4,60
Queen's Park,2004,4,16,7,13,55,49,6,55
Peterhead,2004,5,15,10,11,50,48,2,55
Airdrieon,2004,6,13,6,17,54,59,-5,45
Stenhousem'r,2004,7,12,6,18,51,71,-20,42
East Fife,2004,8,9,11,16,51,57,-6,38
Albion,2004,9,10,8,18,43,60,-17,38
Stranraer,2004,10,9,10,17,52,68,-16,37
Livingston,2005,1,24,4,8,87,44,43,76
Alloa,2005,2,17,10,9,72,44,28,61
Peterhead,2005,3,16,8,12,49,49,0,56
Airdrieon,2005,4,17,4,15,60,60,0,55
Stranraer,2005,5,16,5,15,53,55,-2,53
Albion,2005,6,14,8,14,53,51,2,50
Brechin,2005,7,15,4,17,50,53,-3,49
East Fife,2005,8,11,10,15,44,45,-1,43
Queen's Park,2005,9,12,6,18,33,55,-22,42
Stenhousem'r,2005,10,5,7,24,43,88,-45,22
Livingston,2006,1,25,3,8,80,39,41,78
Albion,2006,2,19,6,11,56,43,13,63
Alloa,2006,3,16,10,10,67,43,24,58
Airdrieon,2006,4,15,6,15,47,46,1,51
East Fife,2006,5,14,8,14,49,42,7,50
Brechin,2006,6,14,7,15,45,44,1,49
Peterhead,2006,7,13,9,14,44,56,-12,48
Queen's Park,2006,8,13,4,19,43,58,-15,43
Stranraer,2006,9,11,6,19,45,63,-18,39
Stenhousem'r,2006,10,7,7,22,39,81,-42,28
Alloa,2007,1,20,7,9,69,40,29,67
Livingston,2007,2,20,4,12,67,56,11,64
Peterhead,2007,3,15,7,14,51,48,3,52
Brechin,2007,4,15,7,14,44,48,-4,52
Airdrieon,2007,5,14,9,13,56,58,-2,51
Stranraer,2007,6,14,7,15,48,47,1,49
Albion,2007,7,13,9,14,60,57,3,48
East Fife,2007,8,13,8,15,49,51,-2,47
Queen's Park,2007,9,10,11,15,35,50,-15,41
Stenhousem'r,2007,10,9,5,22,53,77,-24,32
Alloa,2008,1,20,8,8,75,42,33,68
Airdrieon,2008,2,20,8,8,66,45,21,68
Livingston,2008,3,20,7,9,73,47,26,67
Brechin,2008,4,16,7,13,51,54,-3,55
Peterhead,2008,5,12,12,12,55,52,3,48
Albion,2008,6,12,9,15,53,50,3,45
East Fife,2008,7,11,10,15,47,47,0,43
Queen's Park,2008,8,11,8,17,31,56,-25,41
Stranraer,2008,9,10,6,20,45,63,-18,36
Stenhousem'r,2008,10,6,9,21,43,83,-40,27
Alloa,2009,1,21,10,5,86,38,48,73
Livingston,2009,2,22,1,13,77,49,28,67
Airdrieon,2009,3,19,5,12,62,57,5,62
Brechin,2009,4,17,6,13,53,57,-4,57
Queen's Park,2009,5,13,8,15,40,52,-12,47
Albion,2009,6,12,8,16,43,49,-6,44
Peterhead,2009,7,12,8,16,43,50,-7,44
East Fife,2009,8,8,14,14,41,49,-8,38
Stranraer,2009,9,10,6,20,46,63,-17,36
Stenhousem'r,2009,10,9,8,19,50,77,-27,35
Livingston,2010,1,24,1,11,82,46,36,73
Alloa,2010,2,21,5,10,71,41,30,68
Brechin,2010,3,17,4,15,56,52,4,55
Peterhead,2010,4,16,6,14,55,53,2,54
Albion,2010,5,14,9,13,59,55,4,51
Airdrieon,2010,6,14,8,14,58,60,-2,50
East Fife,2010,7,12,9,15,47,47,0,45
Stranraer,2010,8,13,6,17,50,65,-15,45
Stenhousem'r,2010,9,9,9,18,54,80,-26,36
Queen's Park,2010,10,9,5,22,28,61,-33,32
Livingston,2011,1,22,4,10,81,43,38,70
Alloa,2011,2,21,5,10,74,44,30,68
Peterhead,2011,3,19,7,10,60,53,7,64
Albion,2011,4,15,10,11,66,59,7,55
Airdrieon,2011,5,16,5,15,57,53,4,53
Queen's Park,2011,6,12,9,15,45,55,-10,45
Brechin,2011,7,13,6,17,48,59,-11,45
Stranraer,2011,8,12,5,19,50,61,-11,41
East Fife,2011,9,8,10,18,40,47,-7,34
Stenhousem'r,2011,10,8,7,21,47,94,-47,31
Livingston,2012,1,25,4,7,85,45,40,79
Alloa,2012,2,21,9,6,81,43,38,72
Airdrieon,2012,3,17,4,15,64,61,3,55
Peterhead,2012,4,13,9,14,51,58,-7,48
Brechin,2012,5,13,8,15,47,53,-6,47
Queen's Park,2012,6,13,6,17,35,50,-15,45
Albion,2012,7,11,11,14,58,65,-7,44
East Fife,2012,8,9,13,14,47,47,0,40
Stranraer,2012,9,9,9,18,43,63,-20,36
Stenhousem'r,2012,10,8,9,19,62,88,-26,33
Livingston,2013,1,23,4,9,84,50,34,73
Alloa,2013,2,17,9,10,70,43,27,60
Brechin,2013,3,18,4,14,48,47,1,58
Airdrieon,2013,4,14,11,11,53,56,-3,53
Peterhead,2013,5,15,7,14,55,60,-5,52
Albion,2013,6,13,11,12,50,48,2,50
East Fife,2013,7,14,7,15,54,49,5,49
Queen's Park,2013,8,14,6,16,44,46,-2,48
Stranraer,2013,9,11,5,20,46,59,-13,38
Stenhousem'r,2013,10,6,6,24,43,89,-46,24
Alloa,2014,1,20,8,8,81,51,30,68
Albion,2014,2,19,7,10,62,47,15,64
Livingston,2014,3,19,6,11,79,48,31,63
Peterhead,2014,4,17,6,13,51,46,5,57
Stranraer,2014,5,17,4,15,65,67,-2,55
Brechin,2014,6,12,10,14,56,59,-3,46
Queen's Park,2014,7,11,9,16,36,51,-15,42
Airdrieon,2014,8,13,3,20,47,68,-21,42
East Fife,2014,9,9,10,17,51,59,-8,37
Stenhousem'r,2014,10,8,7,21,47,79,-32,31
Livingston,2015,1,24,3,9,87,47,40,75
Alloa,2015,2,18,9,9,67,42,25,63
Albion,2015,3,16,8,12,58,51,7,56
Airdrieon,2015,4,17,5,14,53,49,4,56
East Fife,2015,5,14,8,14,53,47,6,50
Brechin,2015,6,15,4,17,59,71,-12,49
Peterhead,2015,7,12,10,14,47,49,-2,46
Queen's Park,2015,8,13,3,20,31,55,-24,42
Stranraer,2015,9,12,5,19,49,60,-11,41
Stenhousem'r,2015,10,8,7,21,48,81,-33,31
Alloa,2016,1,19,9,8,72,47,25,66
Brechin,2016,2,20,4,12,63,50,13,64
Livingston,2016,3,19,4,13,61,47,14,61
Airdrieon,2016,4,17,8,11,54,49,5,59
Peterhead,2016,5,16,7,13,46,46,0,55
Stranraer,2016,6,12,7,17,47,51,-4,43
Albion,2016,7,10,11,15,50,54,-4,41
Queen's Park,2016,8,11,7,18,38,56,-18,40
East Fife,2016,9,9,12,15,48,48,0,39
Stenhousem'r,2016,10,8,9,19,50,81,-31,33
Livingston,2017,1,24,5,7,86,45,41,77
Alloa,2017,2,19,11,6,76,42,34,68
Brechin,2017,3,21,4,11,53,43,10,67
Airdrieon,2017,4,14,11,11,58,54,4,53
Albion,2017,5,13,9,14,48,49,-1,48
East Fife,2017,6,10,11,15,45,50,-5,41
Stranraer,2017,7,10,10,16,58,67,-9,40
Queen's Park,2017,8,9,11,16,34,57,-23,38
Peterhead,2017,9,9,9,18,48,65,-17,36
Stenhousem'r,2017,10,6,9,21,44,78,-34,27
Livingston,2018,1,24,5,7,88,44,44,77
Alloa,2018,2,18,7,11,67,46,21,61
Brechin,2018,3,16,7,13,47,48,-1,55
Queen's Park,2018,4,16,6,14,48,49,-1,54
Stranraer,2018,5,15,7,14,56,65,-9,52
Airdrieon,2018,6,13,9,14,56,58,-2,48
Albion,2018,7,12,10,14,46,48,-2,46
Peterhead,2018,8,9,12,15,42,57,-15,39
East Fife,2018,9,7,12,17,38,49,-11,33
Stenhousem'r,2018,10,7,11,18,47,71,-24,32
Livingston,2019,1,25,5,6,89,42,47,80
Albion,2019,2,19,6,11,72,56,16,63
Alloa,2019,3,18,7,11,78,50,28,61
Airdrieon,2019,4,17,7,12,65,67,-2,58
Brechin,2019,5,17,4,15,58,49,9,55
Peterhead,2019,6,14,7,15,54,59,-5,49
East Fife,2019,7,11,9,16,49,55,-6,42
Queen's Park,2019,8,11,6,19,32,58,-26,39
Stranraer,2019,9,10,4,22,47,72,-25,34
Stenhousem'r,2019,10,8,5,23,44,80,-36,29
Livingston,2020,1,18,5,13,74,50,24,59
Airdrieon,2020,2,18,4,14,67,68,-1,58
Alloa,2020,3,17,6,13,73,48,25,57
Albion,2020,4,16,7,13,52,51,1,55
Brechin,2020,5,17,4,15,53,67,-14,55
East Fife,2020,6,15,8,13,58,43,15,53
Peterhead,2020,7,13,9,14,48,53,-5,48
Stranraer,2020,8,13,7,16,64,66,-2,46
Queen's Park,2020,9,12,7,17,32,44,-12,43
Stenhousem'r,2020,10,9,7,20,53,84,-31,34
Alloa,2021,1,21,7,8,76,41,35,70
Brechin,2021,2,17,6,13,54,50,4,57
Livingston,2021,3,18,1,17,71,51,20,55
Albion,2021,4,16,6,14,56,49,7,54
Airdrieon,2021,5,16,5,15,56,60,-4,53
East Fife,2021,6,14,8,14,53,57,-4,50
Stranraer,2021,7,15,4,17,53,56,-3,49
Peterhead,2021,8,13,9,14,46,50,-4,48
Queen's Park,2021,9,10,9,17,34,54,-20,39
Stenhousem'r,2021,10,8,9,19,41,72,-31,33
Livingston,2022,1,20,4,12,78,53,25,64
Airdrieon,2022,2,19,6,11,59,53,6,63
Alloa,2022,3,18,8,10,72,47,25,62
Brechin,2022,4,18,7,11,62,50,12,61
Albion,2022,5,15,7,14,56,57,-1,52
Queen's Park,2022,6,14,7,15,40,53,-13,49
Peterhead,2022,7,13,9,14,51,53,-2,48
East Fife,2022,8,12,7,17,50,49,1,43
Stranraer,2022,9,10,8,18,51,61,-10,38
Stenhousem'r,2022,10,5,9,22,42,85,-43,24
Livingston,2023,1,22,3,11,89,54,35,69
Airdrieon,2023,2,18,9,9,64,57,7,63
Alloa,2023,3,18,8,10,73,45,28,62
Brechin,2023,4,18,6,12,54,43,11,60
Stranraer,2023,5,14,8,14,46,53,-7,50
East Fife,2023,6,13,8,15,47,44,3,47
Queen's Park,2023,7,12,8,16,43,54,-11,44
Albion,2023,8,11,10,15,49,53,-4,43
Peterhead,2023,9,8,12,16,48,65,-17,36
Stenhousem'r,2023,10,6,8,22,40,85,-45,26
Alloa,2024,1,20,8,8,73,43,30,68
Airdrieon,2024,2,18,7,11,69,55,14,61
Livingston,2024,3,18,4,14,69,50,19,58
Albion,2024,4,16,9,11,59,44,15,57
Brechin,2024,5,17,6,13,49,43,6,57
Stranraer,2024,6,14,6,16,53,65,-12,48
Peterhead,2024,7,11,10,15,45,61,-16,43
East Fife,2024,8,10,10,16,45,54,-9,40
Queen's Park,2024,9,11,6,19,42,59,-17,39
Stenhousem'r,2024,10,8,8,20,43,73,-30,32
Livingston,2025,1,25,4,7,80,38,42,79
Alloa,2025,2,20,5,11,72,48,24,65
Airdrieon,2025,3,18,5,13,61,54,7,59
Brechin,2025,4,16,7,13,56,45,11,55
East Fife,2025,5,15,7,14,55,46,9,52
Albion,2025,6,14,10,12,45,49,-4,52
Queen's Park,2025,7,10,10,16,41,58,-17,40
Peterhead,2025,8,11,5,20,42,65,-23,38
Stranraer,2025,9,11,3,22,55,69,-14,36
Stenhousem'r,2025,10,8,8,20,45,80,-35,32
Alloa,2026,1,23,4,9,77,39,38,73
Livingston,2026,2,23,1,12,89,48,41,70
Brechin,2026,3,16,6,14,46,51,-5,54
Airdrieon,2026,4,15,7,14,52,59,-7,52
Albion,2026,5,14,7,15,54,56,-2,49
Stranraer,2026,6,15,4,17,52,59,-7,49
Queen's Park,2026,7,14,6,16,34,46,-12,48
Peterhead,2026,8,12,8,16,39,61,-22,44
Stenhousem'r,2026,9,11,6,19,50,65,-15,39
East Fife,2026,10,9,7,20,39,48,-9,34
Alloa,2027,1,21,7,8,68,39,29,70
Livingston,2027,2,21,5,10,80,47,33,68
Queen's Park,2027,3,15,9,12,46,48,-2,54
Airdrieon,2027,4,15,5,16,56,63,-7,50
Brechin,2027,5,13,10,13,48,50,-2,49
Albion,2027,6,14,6,16,48,56,-8,48
Stenhousem'r,2027,7,12,9,15,54,68,-14,45
Peterhead,2027,8,11,11,14,51,60,-9,44
Stranraer,2027,9,12,4,20,61,66,-5,40
East Fife,2027,10,8,10,18,46,61,-15,34
Livingston,2028,1,21,6,9,78,44,34,69
Airdrieon,2028,2,19,6,11,66,49,17,63
Alloa,2028,3,17,10,9,73,49,24,61
Albion,2028,4,17,6,13,52,53,-1,57
Brechin,2028,5,16,4,16,49,55,-6,52
Peterhead,2028,6,15,6,15,49,52,-3,51
Stranraer,2028,7,14,6,16,51,56,-5,48
Queen's Park,2028,8,13,9,14,37,49,-12,48
East Fife,2028,9,11,6,19,49,56,-7,39
Stenhousem'r,2028,10,5,5,26,36,77,-41,20
Livingston,2029,1,24,2,10,86,45,41,74
Albion,2029,2,17,12,7,58,41,17,63
Brechin,2029,3,17,9,10,53,54,-1,60
Airdrieon,2029,4,17,8,11,61,53,8,59
Alloa,2029,5,13,12,11,55,39,16,51
Queen's Park,2029,6,13,8,15,42,52,-10,47
Stranraer,2029,7,13,5,18,49,57,-8,44
Peterhead,2029,8,10,7,19,43,62,-19,37
East Fife,2029,9,8,12,16,46,57,-11,36
Stenhousem'r,2029,10,6,9,21,45,78,-33,27
Airdrieon,2030,1,23,2,11,71,47,24,71
Alloa,2030,2,17,9,10,72,47,25,60
Livingston,2030,3,18,6,12,76,60,16,60
Stranraer,2030,4,17,4,15,55,48,7,55
Brechin,2030,5,15,9,12,48,48,0,54
East Fife,2030,6,11,12,13,46,50,-4,45
Queen's Park,2030,7,12,9,15,39,48,-9,45
Peterhead,2030,8,12,7,17,40,51,-11,43
Albion,2030,9,10,6,20,52,63,-11,36
Stenhousem'r,2030,10,10,6,20,43,80,-37,36
Livingston,2031,1,21,6,9,74,46,28,69
Peterhead,2031,2,20,6,10,59,46,13,66
Airdrieon,2031,3,17,6,13,55,51,4,57
Brechin,2031,4,16,8,12,47,41,6,56
Alloa,2031,5,14,10,12,67,52,15,52
Stranraer,2031,6,14,4,18,52,64,-12,46
East Fife,2031,7,9,14,13,46,47,-1,41
Queen's Park,2031,8,11,8,17,37,58,-21,41
Albion,2031,9,11,7,18,47,56,-9,40
Stenhousem'r,2031,10,8,9,19,53,76,-23,33
Livingston,2032,1,25,4,7,88,42,46,79
Alloa,2032,2,18,7,11,73,60,13,61
Albion,2032,3,16,8,12,59,48,11,56
Brechin,2032,4,17,5,14,50,50,0,56
Airdrieon,2032,5,17,3,16,65,67,-2,54
East Fife,2032,6,15,6,15,55,46,9,51
Queen's Park,2032,7,13,7,16,44,51,-7,46
Stenhousem'r,2032,8,11,7,18,53,73,-20,40
Peterhead,2032,9,9,8,19,44,66,-22,35
Stranraer,2032,10,8,7,21,45,73,-28,31
Livingston,2033,1,23,5,8,70,37,33,74
Alloa,2033,2,18,7,11,76,48,28,61
Brechin,2033,3,17,5,14,59,50,9,56
Stranraer,2033,4,15,7,14,54,51,3,52
Airdrieon,2033,5,13,12,11,52,57,-5,51
Albion,2033,6,14,8,14,52,49,3,50
East Fife,2033,7,12,9,15,54,52,2,45
Peterhead,2033,8,10,13,13,43,51,-8,43
Queen's Park,2033,9,11,9,16,35,55,-20,42
Stenhousem'r,2033,10,5,9,22,39,84,-45,24
Livingston,2034,1,20,5,11,73,47,26,65
Brechin,2034,2,18,9,9,49,43,6,63
Airdrieon,2034,3,19,4,13,67,57,10,61
Alloa,2034,4,17,6,13,72,50,22,57
Queen's Park,2034,5,14,8,14,36,41,-5,50
Stranraer,2034,6,12,10,14,48,50,-2,46
Albion,2034,7,11,12,13,45,46,-1,45
Peterhead,2034,8,11,11,14,46,58,-12,44
East Fife,2034,9,9,9,18,46,53,-7,36
Stenhousem'r,2034,10,9,6,21,44,81,-37,33
Livingston,2035,1,24,2,10,89,52,37,74
Brechin,2035,2,23,5,8,63,41,22,74
Airdrieon,2035,3,17,8,11,66,62,4,59
Alloa,2035,4,17,7,12,75,52,23,58
Albion,2035,5,15,6,15,50,50,0,51
East Fife,2035,6,12,9,15,51,53,-2,45
Peterhead,2035,7,10,10,16,42,56,-14,40
Queen's Park,2035,8,10,9,17,34,54,-20,39
Stranraer,2035,9,9,7,20,45,59,-14,34
Stenhousem'r,2035,10,7,9,20,47,83,-36,30
Alloa,2036,1,21,7,8,80,38,42,70
Livingston,2036,2,19,6,11,66,48,18,63
Brechin,2036,3,18,8,10,53,41,12,62
Albion,2036,4,16,8,12,56,55,1,56
Airdrieon,2036,5,15,5,16,47,54,-7,50
Queen's Park,2036,6,14,7,15,43,50,-7,49
East Fife,2036,7,12,8,16,51,50,1,44
Stranraer,2036,8,13,2,21,56,65,-9,41
Peterhead,2036,9,12,4,20,44,63,-19,40
Stenhousem'r,2036,10,9,7,20,46,78,-32,34
Livingston,2037,1,18,7,11,78,51,27,61
Airdrieon,2037,2,18,7,11,63,52,11,61
Alloa,2037,3,15,9,12,64,45,19,54
Albion,2037,4,17,3,16,56,50,6,54
Brechin,2037,5,16,6,14,43,43,0,54
Peterhead,2037,6,15,7,14,49,48,1,52
Stranraer,2037,7,15,6,15,49,60,-11,51
East Fife,2037,8,14,8,14,55,50,5,50
Queen's Park,2037,9,11,8,17,37,58,-21,41
Stenhousem'r,2037,10,7,7,22,43,80,-37,28
Livingston,2038,1,21,4,11,76,52,24,67
Airdrieon,2038,2,19,9,8,65,52,13,66
Alloa,2038,3,17,10,9,70,47,23,61
Albion,2038,4,17,9,10,67,45,22,60
Brechin,2038,5,18,6,12,42,35,7,60
Peterhead,2038,6,13,8,15,44,50,-6,47
Stranraer,2038,7,13,5,18,48,55,-7,44
Queen's Park,2038,8,11,5,20,42,66,-24,38
East Fife,2038,9,9,10,17,46,54,-8,37
Stenhousem'r,2038,10,6,6,24,39,83,-44,24
Alloa,2039,1,19,8,9,74,50,24,65
Livingston,2039,2,20,5,11,64,40,24,65
Airdrieon,2039,3,16,8,12,47,47,0,56
Peterhead,2039,4,15,9,12,60,50,10,54
Brechin,2039,5,15,9,12,57,50,7,54
Queen's Park,2039,6,15,7,14,45,49,-4,52
Albion,2039,7,13,10,13,56,55,1,49
East Fife,2039,8,12,10,14,44,43,1,46
Stranraer,2039,9,8,6,22,39,69,-30,30
Stenhousem'r,2039,10,6,10,20,39,72,-33,28
Airdrieon,2040,1,20,7,9,62,49,13,67
Livingston,2040,2,21,3,12,79,55,24,66
Alloa,2040,3,18,9,9,63,36,27,63
Brechin,2040,4,18,4,14,51,47,4,58
Albion,2040,5,15,6,15,54,51,3,51
Stranraer,2040,6,15,6,15,56,57,-1,51
Peterhead,2040,7,13,5,18,41,52,-11,44
East Fife,2040,8,12,6,18,50,51,-1,42
Queen's Park,2040,9,11,8,17,32,49,-17,41
Stenhousem'r,2040,10,6,8,22,46,87,-41,26
Livingston,2041,1,22,3,11,80,55,25,69
Airdrieon,2041,2,19,6,11,64,52,12,63
Alloa,2041,3,18,8,10,68,44,24,62
Stranraer,2041,4,17,5,14,58,55,3,56
Queen's Park,2041,5,15,9,12,48,41,7,54
Albion,2041,6,13,9,14,54,63,-9,48
Peterhead,2041,7,11,9,16,41,49,-8,42
East Fife,2041,8,10,11,15,48,50,-2,41
Brechin,2041,9,11,7,18,37,53,-16,40
Stenhousem'r,2041,10,6,9,21,50,86,-36,27
Alloa,2042,1,17,8,11,61,41,20,59
Livingston,2042,2,17,8,11,66,47,19,59
Airdrieon,2042,3,16,8,12,63,58,5,56
Peterhead,2042,4,16,7,13,55,44,11,55
Queen's Park,2042,5,17,4,15,43,40,3,55
Albion,2042,6,14,12,10,54,51,3,54
Brechin,2042,7,14,10,12,46,45,1,52
East Fife,2042,8,12,8,16,48,53,-5,44
Stranraer,2042,9,10,9,17,48,61,-13,39
Stenhousem'r,2042,10,7,6,23,41,85,-44,27
Livingston,2043,1,21,6,9,75,41,34,69
Alloa,2043,2,19,7,10,62,41,21,64
Brechin,2043,3,17,6,13,52,47,5,57
Airdrieon,2043,4,15,7,14,59,58,1,52
Albion,2043,5,14,9,13,48,44,4,51
East Fife,2043,6,14,8,14,48,44,4,50
Queen's Park,2043,7,14,7,15,37,50,-13,49
Stranraer,2043,8,13,6,17,50,52,-2,45
Peterhead,2043,9,10,11,15,49,58,-9,41
Stenhousem'r,2043,10,5,9,22,47,92,-45,24
Livingston,2044,1,23,3,10,81,44,37,72
Alloa,2044,2,19,6,11,66,47,19,63
Brechin,2044,3,17,3,16,49,47,2,54
Airdrieon,2044,4,16,6,14,52,52,0,54
Peterhead,2044,5,15,6,15,58,61,-3,51
Albion,2044,6,14,8,14,54,53,1,50
Stranraer,2044,7,15,5,16,50,50,0,50
Queen's Park,2044,8,14,3,19,37,52,-15,45
East Fife,2044,9,12,8,16,53,57,-4,44
Stenhousem'r,2044,10,8,6,22,49,86,-37,30
Alloa,2045,1,21,10,5,72,35,37,73
Livingston,2045,2,20,8,8,78,45,33,68
Stranraer,2045,3,15,9,12,58,52,6,54
Airdrieon,2045,4,15,8,13,52,56,-4,53
Brechin,2045,5,13,8,15,53,54,-1,47
East Fife,2045,6,13,7,16,50,47,3,46
Peterhead,2045,7,13,7,16,49,52,-3,46
Albion,2045,8,11,8,17,53,67,-14,41
Queen's Park,2045,9,10,9,17,34,61,-27,39
Stenhousem'r,2045,10,8,8,20,42,72,-30,32
Livingston,2046,1,22,7,7,82,38,44,73
Airdrieon,2046,2,20,4,12,67,53,14,64
Alloa,2046,3,19,6,11,80,53,27,63
Peterhead,2046,4,13,9,14,42,49,-7,48
Brechin,2046,5,14,5,17,40,53,-13,47
Albion,2046,6,11,12,13,57,52,5,45
East Fife,2046,7,12,8,16,43,51,-8,44
Queen's Park,2046,8,12,8,16,37,60,-23,44
Stranraer,2046,9,10,9,17,44,53,-9,39
Stenhousem'r,2046,10,10,6,20,54,84,-30,36
Peterhead,2047,1,17,9,10,57,45,12,60
Brechin,2047,2,17,7,12,47,42,5,58
Alloa,2047,3,15,12,9,60,44,16,57
East Fife,2047,4,16,9,11,57,41,16,57
Livingston,2047,5,15,8,13,66,58,8,53
Airdrieon,2047,6,15,7,14,49,54,-5,52
Albion,2047,7,14,9,13,52,54,-2,51
Stranraer,2047,8,14,4,18,47,52,-5,46
Queen's Park,2047,9,9,9,18,40,52,-12,36
Stenhousem'r,2047,10,7,8,21,48,81,-33,29
Livingston,2048,1,22,3,11,78,49,29,69
Airdrieon,2048,2,20,6,10,66,50,16,66
Peterhead,2048,3,16,9,11,55,55,0,57
Brechin,2048,4,16,6,14,58,53,5,54
Alloa,2048,5,15,8,13,64,51,13,53
Albion,2048,6,15,6,15,45,47,-2,51
Queen's Park,2048,7,12,10,14,43,52,-9,46
East Fife,2048,8,12,6,18,46,53,-7,42
Stranraer,2048,9,10,7,19,49,63,-14,37
Stenhousem'r,2048,10,7,9,20,41,72,-31,30
Livingston,2049,1,22,5,9,84,51,33,71
Airdrieon,2049,2,20,6,10,63,51,12,66
Alloa,2049,3,20,5,11,82,53,29,65
Brechin,2049,4,16,9,11,56,54,2,57
Peterhead,2049,5,13,7,16,54,59,-5,46
Albion,2049,6,12,8,16,49,53,-4,44
East Fife,2049,7,12,7,17,54,49,5,43
Queen's Park,2049,8,11,10,15,34,51,-17,43
Stranraer,2049,9,11,5,20,52,71,-19,38
Stenhousem'r,2049,10,8,8,20,51,87,-36,32
Livingston,2050,1,22,7,7,79,41,38,73
Alloa,2050,2,17,9,10,69,50,19,60
Airdrieon,2050,3,16,9,11,60,54,6,57
Brechin,2050,4,16,8,12,52,50,2,56
Albion,2050,5,14,7,15,52,57,-5,49
Stranraer,2050,6,14,5,17,56,62,-6,47
Peterhead,2050,7,12,8,16,51,59,-8,44
East Fife,2050,8,10,12,14,54,54,0,42
Queen's Park,2050,9,10,7,19,45,65,-20,37
Stenhousem'r,2050,10,9,8,19,47,73,-26,35
Brechin,2051,1,19,7,10,65,45,20,64
Alloa,2051,2,17,11,8,76,44,32,62
Peterhead,2051,3,16,8,12,47,47,0,56
Livingston,2051,4,17,4,15,63,49,14,55
Queen's Park,2051,5,17,4,15,42,49,-7,55
Airdrieon,2051,6,15,8,13,52,61,-9,53
Albion,2051,7,14,9,13,44,45,-1,51
Stranraer,2051,8,12,5,19,53,65,-12,41
Stenhousem'r,2051,9,9,9,18,47,73,-26,36
East Fife,2051,10,7,9,20,42,53,-11,30
Alloa,2052,1,20,9,7,76,47,29,69
Brechin,2052,2,21,6,9,59,39,20,69
Airdrieon,2052,3,20,5,11,70,53,17,65
Livingston,2052,4,17,5,14,65,52,13,56
Peterhead,2052,5,15,8,13,51,56,-5,53
Albion,2052,6,12,12,12,57,55,2,48
Stranraer,2052,7,14,4,18,57,63,-6,46
East Fife,2052,8,8,12,16,48,51,-3,36
Queen's Park,2052,9,6,14,16,32,55,-23,32
Stenhousem'r,2052,10,4,11,21,42,86,-44,23
Alloa,2053,1,24,4,8,84,38,46,76
Livingston,2053,2,20,6,10,76,52,24,66
Brechin,2053,3,20,3,13,50,49,1,63
Peterhead,2053,4,15,8,13,44,43,1,53
East Fife,2053,5,14,7,15,53,43,10,49
Albion,2053,6,12,12,12,52,55,-3,48
Airdrieon,2053,7,14,5,17,51,50,1,47
Queen's Park,2053,8,11,8,17,36,57,-21,41
Stranraer,2053,9,10,6,20,48,63,-15,36
Stenhousem'r,2053,10,6,9,21,45,89,-44,27
Livingston,2054,1,24,2,10,81,55,26,74
Alloa,2054,2,23,3,10,79,46,33,72
Peterhead,2054,3,18,6,12,61,50,11,60
Albion,2054,4,16,6,14,59,56,3,54
Queen's Park,2054,5,16,6,14,43,45,-2,54
Brechin,2054,6,15,8,13,63,52,11,53
Airdrieon,2054,7,14,4,18,58,64,-6,46
East Fife,2054,8,9,9,18,44,55,-11,36
Stenhousem'r,2054,9,9,6,21,58,91,-33,33
Stranraer,2054,10,9,4,23,42,74,-32,31
Albion,2055,1,20,6,10,60,41,19,66
Alloa,2055,2,17,9,10,65,44,21,60
Livingston,2055,3,18,4,14,70,47,23,58
Airdrieon,2055,4,15,7,14,51,54,-3,52
Brechin,2055,5,15,7,14,44,49,-5,52
Stranraer,2055,6,14,6,16,51,54,-3,48
Peterhead,2055,7,13,7,16,55,62,-7,46
East Fife,2055,8,11,10,15,56,58,-2,43
Stenhousem'r,2055,9,12,6,18,53,72,-19,42
Queen's Park,2055,10,10,8,18,32,56,-24,38
Airdrieon,2056,1,20,5,11,63,50,13,65
Alloa,2056,2,19,6,11,78,50,28,63
Livingston,2056,3,19,3,14,77,60,17,60
Brechin,2056,4,16,6,14,52,55,-3,54
Peterhead,2056,5,15,6,15,47,51,-4,51
Stranraer,2056,6,15,5,16,43,53,-10,50
Albion,2056,7,15,3,18,55,54,1,48
East Fife,2056,8,12,11,13,50,46,4,47
Queen's Park,2056,9,13,6,17,37,47,-10,45
Stenhousem'r,2056,10,7,7,22,49,85,-36,28
Airdrieon,2057,1,17,12,7,68,56,12,63
Livingston,2057,2,18,7,11,79,60,19,61
Albion,2057,3,18,7,11,66,47,19,61
Alloa,2057,4,14,11,11,67,55,12,53
Brechin,2057,5,14,8,14,50,50,0,50
Peterhead,2057,6,13,10,13,53,56,-3,49
East Fife,2057,7,12,10,14,49,51,-2,46
Stranraer,2057,8,13,7,16,54,58,-4,46
Queen's Park,2057,9,10,8,18,31,48,-17,38
Stenhousem'r,2057,10,4,14,18,41,77,-36,26
Livingston,2058,1,22,4,10,81,51,30,70
Alloa,2058,2,18,8,10,81,49,32,62
Airdrieon,2058,3,18,7,11,61,50,11,61
Brechin,2058,4,15,10,11,47,45,2,55
Albion,2058,5,12,11,13,48,55,-7,47
Peterhead,2058,6,12,9,15,52,67,-15,45
Queen's Park,2058,7,11,10,15,35,45,-10,43
Stranraer,2058,8,11,7,18,53,67,-14,40
East Fife,2058,9,7,16,13,46,51,-5,37
Stenhousem'r,2058,10,7,12,17,53,77,-24,33
Alloa,2059,1,21,8,7,78,49,29,71
Livingston,2059,2,21,2,13,72,46,26,65
Brechin,2059,3,17,3,16,49,53,-4,54
Albion,2059,4,15,8,13,54,49,5,53
Stranraer,2059,5,16,4,16,58,58,0,52
Airdrieon,2059,6,15,6,15,58,58,0,51
Peterhead,2059,7,14,7,15,50,50,0,49
East Fife,2059,8,12,8,16,54,51,3,44
Queen's Park,2059,9,12,6,18,40,59,-19,42
Stenhousem'r,2059,10,8,6,22,50,90,-40,30
Alloa,2060,1,18,11,7,72,49,23,65
Livingston,2060,2,18,6,12,68,48,20,60
Brechin,2060,3,15,9,12,47,47,0,54
Airdrieon,2060,4,15,8,13,51,51,0,53
Albion,2060,5,13,13,10,56,51,5,52
Peterhead,2060,6,14,8,14,52,49,3,50
Queen's Park,2060,7,12,12,12,38,48,-10,48
East Fife,2060,8,11,10,15,46,45,1,43
Stranraer,2060,9,10,10,16,49,60,-11,40
Stenhousem'r,2060,10,6,9,21,40,71,-31,27
Livingston,2061,1,21,5,10,81,46,35,68
Airdrieon,2061,2,20,4,12,63,50,13,64
Alloa,2061,3,19,6,11,64,46,18,63
Brechin,2061,4,19,2,15,54,49,5,59
Albion,2061,5,17,8,11,48,46,2,59
Peterhead,2061,6,16,8,12,54,48,6,56
Queen's Park,2061,7,14,3,19,46,58,-12,45
East Fife,2061,8,11,7,18,46,55,-9,40
Stranraer,2061,9,11,4,21,49,64,-15,37
Stenhousem'r,2061,10,5,7,24,44,87,-43,22
Alloa,2062,1,21,5,10,73,48,25,68
Livingston,2062,2,19,9,8,80,46,34,66
Brechin,2062,3,18,10,8,54,35,19,64
Airdrieon,2062,4,16,9,11,65,55,10,57
Albion,2062,5,14,7,15,59,52,7,49
Queen's Park,2062,6,11,11,14,30,47,-17,44
Peterhead,2062,7,11,8,17,34,46,-12,41
East Fife,2062,8,10,10,16,47,57,-10,40
Stranraer,2062,9,11,3,22,38,69,-31,36
Stenhousem'r,2062,10,9,8,19,47,72,-25,35
Livingston,2063,1,22,6,8,91,45,46,72
Brechin,2063,2,18,6,12,53,39,14,60
Alloa,2063,3,17,5,14,62,46,16,56
Albion,2063,4,16,7,13,60,57,3,55
Airdrieon,2063,5,13,12,11,58,58,0,51
Peterhead,2063,6,14,8,14,49,57,-8,50
Queen's Park,2063,7,12,10,14,39,56,-17,46
Stranraer,2063,8,13,5,18,54,60,-6,44
East Fife,2063,9,10,10,16,48,57,-9,40
Stenhousem'r,2063,10,7,7,22,48,87,-39,28
Livingston,2064,1,23,5,8,84,52,32,74
Alloa,2064,2,21,6,9,72,37,35,69
Brechin,2064,3,17,11,8,59,47,12,62
Airdrieon,2064,4,19,3,14,67,49,18,60
Albion,2064,5,12,7,17,52,68,-16,43
Stranraer,2064,6,12,6,18,46,65,-19,42
East Fife,2064,7,10,11,15,52,58,-6,41
Queen's Park,2064,8,10,9,17,37,57,-20,39
Peterhead,2064,9,9,10,17,36,44,-8,37
Stenhousem'r,2064,10,10,6,20,47,75,-28,36
Livingston,2065,1,22,4,10,75,50,25,70
Alloa,2065,2,20,6,10,72,43,29,66
Brechin,2065,3,16,8,12,58,47,11,56
Airdrieon,2065,4,15,7,14,61,59,2,52
Albion,2065,5,15,7,14,51,50,1,52
Peterhead,2065,6,14,9,13,56,52,4,51
East Fife,2065,7,12,10,14,47,49,-2,46
Queen's Park,2065,8,13,6,17,41,57,-16,45
Stenhousem'r,2065,9,9,8,19,54,81,-27,35
Stranraer,2065,10,8,7,21,35,62,-27,31
Airdrieon,2066,1,20,8,8,71,49,22,68
Alloa,2066,2,19,6,11,81,52,29,63
Livingston,2066,3,19,6,11,75,48,27,63
Albion,2066,4,15,9,12,54,48,6,54
Brechin,2066,5,13,9,14,46,52,-6,48
Queen's Park,2066,6,13,7,16,41,55,-14,46
East Fife,2066,7,11,11,14,49,56,-7,44
Peterhead,2066,8,10,11,15,43,52,-9,41
Stranraer,2066,9,9,11,16,44,54,-10,38
Stenhousem'r,2066,10,9,6,21,50,88,-38,33
Airdrieon,2067,1,19,6,11,65,46,19,63
Brechin,2067,2,20,3,13,63,47,16,63
Livingston,2067,3,18,8,10,68,53,15,62
Alloa,2067,4,17,7,12,74,54,20,58
Albion,2067,5,14,9,13,62,52,10,51
Stranraer,2067,6,14,8,14,61,60,1,50
Peterhead,2067,7,11,12,13,40,49,-9,45
Queen's Park,2067,8,13,5,18,30,45,-15,44
Stenhousem'r,2067,9,10,8,18,47,79,-32,38
East Fife,2067,10,7,8,21,32,57,-25,29
Livingston,2068,1,26,2,8,81,48,33,80
Airdrieon,2068,2,19,6,11,58,53,5,63
Brechin,2068,3,19,5,12,62,51,11,62
Peterhead,2068,4,17,7,12,51,48,3,58
Alloa,2068,5,15,10,11,65,52,13,55
Albion,2068,6,15,5,16,62,57,5,50
Stranraer,2068,7,13,5,18,52,57,-5,44
Queen's Park,2068,8,11,9,16,39,51,-12,42
East Fife,2068,9,11,6,19,46,49,-3,39
Stenhousem'r,2068,10,3,7,26,33,83,-50,16
Livingston,2069,1,23,5,8,81,44,37,74
Airdrieon,2069,2,22,4,10,61,46,15,70
Alloa,2069,3,19,9,8,75,45,30,66
Albion,2069,4,17,6,13,65,53,12,57
Brechin,2069,5,12,9,15,43,50,-7,45
Peterhead,2069,6,13,5,18,48,58,-10,44
Queen's Park,2069,7,13,4,19,32,51,-19,43
East Fife,2069,8,10,11,15,45,48,-3,41
Stranraer,2069,9,12,5,19,53,64,-11,41
Stenhousem'r,2069,10,6,8,22,38,82,-44,26
Alloa,2070,1,21,7,8,80,41,39,70
Airdrieon,2070,2,20,7,9,65,50,15,67
Livingston,2070,3,20,4,12,75,44,31,64
Stranraer,2070,4,17,4,15,58,61,-3,55
Queen's Park,2070,5,15,7,14,38,46,-8,52
Peterhead,2070,6,13,9,14,51,57,-6,48
East Fife,2070,7,13,6,17,51,55,-4,45
Brechin,2070,8,13,6,17,54,60,-6,45
Albion,2070,9,10,7,19,41,60,-19,37
Stenhousem'r,2070,10,6,7,23,43,82,-39,25
Livingston,2071,1,20,10,6,79,42,37,70
Alloa,2071,2,20,8,8,74,38,36,68
Peterhead,2071,3,16,10,10,54,47,7,58
Airdrieon,2071,4,14,8,14,52,55,-3,50
Brechin,2071,5,14,8,14,36,47,-11,50
Queen's Park,2071,6,15,4,17,40,52,-12,49
Albion,2071,7,11,10,15,50,52,-2,43
East Fife,2071,8,10,9,17,48,51,-3,39
Stranraer,2071,9,11,5,20,48,64,-16,38
Stenhousem'r,2071,10,9,8,19,50,83,-33,35
Brechin,2072,1,20,6,10,59,42,17,66
Alloa,2072,2,18,11,7,72,46,26,65
Livingston,2072,3,19,8,9,72,47,25,65
Peterhead,2072,4,17,6,13,65,49,16,57
Airdrieon,2072,5,15,9,12,60,54,6,54
Albion,2072,6,14,8,14,58,58,0,50
Stranraer,2072,7,10,10,16,51,60,-9,40
East Fife,2072,8,10,7,19,47,60,-13,37
Queen's Park,2072,9,7,13,16,32,54,-22,34
Stenhousem'r,2072,10,6,10,20,41,87,-46,28
Livingston,2073,1,21,4,11,76,48,28,67
Alloa,2073,2,16,10,10,70,48,22,58
Brechin,2073,3,18,4,14,59,55,4,58
Albion,2073,4,16,8,12,54,46,8,56
Airdrieon,2073,5,14,8,14,66,64,2,50
Peterhead,2073,6,13,8,15,49,50,-1,47
East Fife,2073,7,13,8,15,49,52,-3,47
Queen's Park,2073,8,13,8,15,36,50,-14,47
Stenhousem'r,2073,9,11,5,20,49,82,-33,38
Stranraer,2073,10,10,7,19,48,61,-13,37
Livingston,2074,1,26,2,8,90,43,47,80
Alloa,2074,2,20,7,9,74,45,29,67
Brechin,2074,3,18,4,14,45,41,4,58
Airdrieon,2074,4,17,6,13,55,56,-1,57
Albion,2074,5,13,10,13,55,53,2,49
Queen's Park,2074,6,13,8,15,46,51,-5,47
East Fife,2074,7,10,10,16,44,52,-8,40
Stranraer,2074,8,10,9,17,49,63,-14,39
Stenhousem'r,2074,9,10,4,22,54,81,-27,34
Peterhead,2074,10,8,10,18,43,70,-27,34
Livingston,2075,1,22,4,10,76,46,30,70
Alloa,2075,2,18,8,10,69,43,26,62
Brechin,2075,3,18,7,11,52,41,11,61
Airdrieon,2075,4,17,9,10,63,50,13,60
Stranraer,2075,5,15,7,14,53,51,2,52
Peterhead,2075,6,13,10,13,48,52,-4,49
East Fife,2075,7,12,7,17,49,52,-3,43
Albion,2075,8,11,6,19,48,62,-14,39
Queen's Park,2075,9,10,8,18,32,51,-19,38
Stenhousem'r,2075,10,7,8,21,51,93,-42,29
Alloa,2076,1,22,7,7,75,44,31,73
Airdrieon,2076,2,22,4,10,73,50,23,70
Livingston,2076,3,20,5,11,71,42,29,65
Peterhead,2076,4,20,5,11,57,51,6,65
Brechin,2076,5,15,3,18,43,48,-5,48
Albion,2076,6,13,8,15,53,53,0,47
Stranraer,2076,7,14,5,17,50,59,-9,47
Queen's Park,2076,8,10,6,20,29,52,-23,36
East Fife,2076,9,8,7,21,52,66,-14,31
Stenhousem'r,2076,10,7,8,21,53,91,-38,29
Livingston,2077,1,21,3,12,81,51,30,66
Brechin,2077,2,20,5,11,60,46,14,65
Alloa,2077,3,17,8,11,59,38,21,59
Airdrieon,2077,4,17,8,11,62,51,11,59
Peterhead,2077,5,14,8,14,51,60,-9,50
Albion,2077,6,12,10,14,46,51,-5,46
Queen's Park,2077,7,13,6,17,48,55,-7,45
East Fife,2077,8,10,12,14,48,51,-3,42
Stranraer,2077,9,11,8,17,51,66,-15,41
Stenhousem'r,2077,10,6,10,20,46,83,-37,28
Livingston,2078,1,22,7,7,82,44,38,73
Alloa,2078,2,20,8,8,72,41,31,68
Brechin,2078,3,19,4,13,65,57,8,61
Airdrieon,2078,4,15,10,11,55,53,2,55
Albion,2078,5,15,7,14,61,53,8,52
Peterhead,2078,6,11,9,16,44,55,-11,42
Stranraer,2078,7,11,7,18,48,59,-11,40
East Fife,2078,8,9,12,15,46,57,-11,39
Queen's Park,2078,9,11,6,19,38,66,-28,39
Stenhousem'r,2078,10,8,8,20,47,73,-26,32
Livingston,2079,1,20,7,9,70,48,22,67
Alloa,2079,2,16,10,10,60,39,21,58
Queen's Park,2079,3,17,7,12,47,46,1,58
Albion,2079,4,15,9,12,56,45,11,54
Stranraer,2079,5,14,6,16,51,52,-1,48
Airdrieon,2079,6,13,8,15,52,57,-5,47
Brechin,2079,7,12,10,14,47,57,-10,46
Peterhead,2079,8,12,8,16,46,56,-10,44
Stenhousem'r,2079,9,12,7,17,49,67,-18,43
East Fife,2079,10,8,10,18,47,58,-11,34
Livingston,2080,1,20,7,9,88,58,30,67
Alloa,2080,2,20,7,9,71,44,27,67
Brechin,2080,3,18,8,10,55,44,11,62
Albion,2080,4,16,9,11,61,47,14,57
Airdrieon,2080,5,13,9,14,54,59,-5,48
Peterhead,2080,6,12,7,17,42,52,-10,43
Queen's Park,2080,7,10,11,15,32,53,-21,41
Stranraer,2080,8,10,7,19,52,71,-19,37
Stenhousem'r,2080,9,8,13,15,57,79,-22,37
East Fife,2080,10,8,12,16,49,54,-5,36
Alloa,2081,1,21,8,7,68,36,32,71
Airdrieon,2081,2,17,8,11,62,52,10,59
Brechin,2081,3,18,5,13,49,40,9,59
Livingston,2081,4,16,10,10,64,45,19,58
Albion,2081,5,15,10,11,55,50,5,55
Queen's Park,2081,6,12,10,14,40,46,-6,46
Peterhead,2081,7,9,13,14,40,48,-8,40
Stranraer,2081,8,11,7,18,44,61,-17,40
East Fife,2081,9,10,8,18,45,56,-11,38
Stenhousem'r,2081,10,7,9,20,42,75,-33,30
Alloa,2082,1,24,5,7,75,37,38,77
Livingston,2082,2,17,8,11,70,55,15,59
Airdrieon,2082,3,16,9,11,68,55,13,57
East Fife,2082,4,14,9,13,55,46,9,51
Albion,2082,5,14,7,15,56,56,0,49
Brechin,2082,6,13,10,13,48,48,0,49
Peterhead,2082,7,11,15,10,52,50,2,48
Queen's Park,2082,8,13,7,16,38,54,-16,46
Stranraer,2082,9,8,9,19,48,66,-18,33
Stenhousem'r,2082,10,5,11,20,41,84,-43,26
Alloa,2083,1,17,10,9,70,50,20,61
Airdrieon,2083,2,17,9,10,58,52,6,60
East Fife,2083,3,15,9,12,60,45,15,54
Livingston,2083,4,17,3,16,65,57,8,54
Peterhead,2083,5,15,8,13,53,50,3,53
Brechin,2083,6,16,5,15,56,56,0,53
Albion,2083,7,14,9,13,58,53,5,51
Stranraer,2083,8,15,6,15,63,62,1,51
Queen's Park,2083,9,10,7,19,35,57,-22,37
Stenhousem'r,2083,10,6,10,20,35,71,-36,28
Airdrieon,2084,1,21,8,7,66,39,27,71
Livingston,2084,2,20,4,12,78,50,28,64
Brechin,2084,3,20,4,12,60,55,5,64
Alloa,2084,4,18,7,11,71,43,28,61
Peterhead,2084,5,12,11,13,50,57,-7,47
Queen's Park,2084,6,12,9,15,40,52,-12,45
Albion,2084,7,11,9,16,46,55,-9,42
East Fife,2084,8,9,10,17,41,47,-6,37
Stenhousem'r,2084,9,8,11,17,50,77,-27,35
Stranraer,2084,10,10,5,21,46,73,-27,35
Livingston,2085,1,19,5,12,75,52,23,62
Alloa,2085,2,17,7,12,65,45,20,58
Albion,2085,3,17,7,12,60,51,9,58
Airdrieon,2085,4,17,7,12,54,48,6,58
Brechin,2085,5,17,5,14,53,51,2,56
Queen's Park,2085,6,14,6,16,44,59,-15,48
Peterhead,2085,7,12,10,14,42,44,-2,46
East Fife,2085,8,11,9,16,42,47,-5,42
Stranraer,2085,9,12,5,19,49,56,-7,41
Stenhousem'r,2085,10,11,5,20,51,82,-31,38
Livingston,2086,1,23,5,8,82,38,44,74
Alloa,2086,2,19,11,6,72,35,37,68
Brechin,2086,3,16,9,11,49,47,2,57
Airdrieon,2086,4,16,8,12,56,48,8,56
Queen's Park,2086,5,15,7,14,44,55,-11,52
East Fife,2086,6,13,10,13,49,48,1,49
Albion,2086,7,12,8,16,45,47,-2,44
Peterhead,2086,8,11,9,16,45,52,-7,42
Stranraer,2086,9,10,4,22,44,73,-29,34
Stenhousem'r,2086,10,6,7,23,43,86,-43,25
Brechin,2087,1,19,6,11,58,44,14,63
Livingston,2087,2,19,3,14,76,55,21,60
Airdrieon,2087,3,17,7,12,53,49,4,58
Alloa,2087,4,15,11,10,62,44,18,56
Peterhead,2087,5,13,10,13,47,47,0,49
Albion,2087,6,13,9,14,48,55,-7,48
Queen's Park,2087,7,13,8,15,47,45,2,47
Stranraer,2087,8,13,6,17,48,66,-18,45
East Fife,2087,9,8,12,16,42,53,-11,36
Stenhousem'r,2087,10,8,12,16,59,82,-23,36
Alloa,2088,1,22,6,8,77,41,36,72
Livingston,2088,2,21,5,10,85,58,27,68
Brechin,2088,3,18,4,14,58,50,8,58
Albion,2088,4,16,9,11,55,47,8,57
East Fife,2088,5,15,8,13,61,49,12,53
Airdrieon,2088,6,14,6,16,52,58,-6,48
Peterhead,2088,7,13,6,17,43,54,-11,45
Stranraer,2088,8,11,7,18,48,65,-17,40
Queen's Park,2088,9,10,9,17,35,52,-17,39
Stenhousem'r,2088,10,7,6,23,49,89,-40,27
Livingston,2089,1,21,5,10,84,45,39,68
Alloa,2089,2,19,6,11,82,51,31,63
Brechin,2089,3,18,6,12,54,47,7,60
Airdrieon,2089,4,14,11,11,60,59,1,53
Queen's Park,2089,5,14,10,12,42,48,-6,52
Peterhead,2089,6,15,5,16,52,59,-7,50
Stranraer,2089,7,14,4,18,53,65,-12,46
Albion,2089,8,10,9,17,49,58,-9,39
East Fife,2089,9,8,13,15,39,52,-13,37
Stenhousem'r,2089,10,9,7,20,55,86,-31,34
Livingston,2090,1,23,4,9,90,45,45,73
Alloa,2090,2,20,9,7,82,45,37,69
Brechin,2090,3,17,6,13,52,48,4,57
Albion,2090,4,16,8,12,54,47,7,56
Airdrieon,2090,5,16,8,12,61,68,-7,56
Peterhead,2090,6,14,6,16,55,60,-5,48
Stranraer,2090,7,11,7,18,46,56,-10,40
East Fife,2090,8,8,13,15,45,52,-7,37
Queen's Park,2090,9,9,9,18,28,51,-23,36
Stenhousem'r,2090,10,6,10,20,40,81,-41,28
Alloa,2091,1,22,7,7,70,30,40,73
Airdrieon,2091,2,19,7,10,58,48,10,64
Livingston,2091,3,18,6,12,74,49,25,60
Brechin,2091,4,16,8,12,47,49,-2,56
Peterhead,2091,5,15,6,15,61,57,4,51
Albion,2091,6,14,7,15,51,55,-4,49
Stranraer,2091,7,13,5,18,53,55,-2,44
Queen's Park,2091,8,10,9,17,36,55,-19,39
East Fife,2091,9,9,11,16,47,54,-7,38
Stenhousem'r,2091,10,7,8,21,36,81,-45,29
Livingston,2092,1,22,5,9,80,48,32,71
Alloa,2092,2,18,12,6,69,39,30,66
Airdrieon,2092,3,18,8,10,61,49,12,62
Brechin,2092,4,17,5,14,51,46,5,56
Albion,2092,5,16,5,15,52,50,2,53
Peterhead,2092,6,15,8,13,48,47,1,53
Queen's Park,2092,7,15,6,15,36,49,-13,51
Stranraer,2092,8,13,5,18,47,52,-5,44
East Fife,2092,9,8,9,19,42,57,-15,33
Stenhousem'r,2092,10,4,5,27,32,81,-49,17
Alloa,2093,1,22,9,5,87,39,48,75
Airdrieon,2093,2,15,10,11,49,50,-1,55
Livingston,2093,3,16,5,15,72,62,10,53
Brechin,2093,4,15,8,13,48,46,2,53
Albion,2093,5,13,12,11,62,57,5,51
East Fife,2093,6,13,10,13,58,44,14,49
Peterhead,2093,7,12,8,16,50,62,-12,44
Queen's Park,2093,8,11,10,15,45,57,-12,43
Stranraer,2093,9,11,7,18,45,59,-14,40
Stenhousem'r,2093,10,9,7,20,46,86,-40,34
Livingston,2094,1,21,6,9,83,48,35,69
Airdrieon,2094,2,19,5,12,68,53,15,62
Alloa,2094,3,18,7,11,62,41,21,61
Brechin,2094,4,16,9,11,42,41,1,57
Albion,2094,5,15,8,13,54,45,9,53
Queen's Park,2094,6,14,5,17,39,52,-13,47
Stranraer,2094,7,13,7,16,46,54,-8,46
Peterhead,2094,8,13,6,17,51,57,-6,45
East Fife,2094,9,11,7,18,45,50,-5,40
Stenhousem'r,2094,10,7,6,23,41,90,-49,27
Livingston,2095,1,20,7,9,76,43,33,67
Alloa,2095,2,17,11,8,74,48,26,62
Brechin,2095,3,17,5,14,56,49,7,56
Peterhead,2095,4,15,9,12,47,48,-1,54
Albion,2095,5,15,8,13,53,52,1,53
Airdrieon,2095,6,14,6,16,48,56,-8,48
Stenhousem'r,2095,7,13,7,16,44,62,-18,46
East Fife,2095,8,11,11,14,45,43,2,44
Stranraer,2095,9,11,6,19,51,69,-18,39
Queen's Park,2095,10,9,6,21,34,58,-24,33
Alloa,2096,1,20,6,10,70,44,26,66
Livingston,2096,2,19,5,12,78,56,22,62
Airdrieon,2096,3,19,4,13,65,50,15,61
Brechin,2096,4,17,6,13,51,50,1,57
Peterhead,2096,5,15,7,14,49,50,-1,52
Albion,2096,6,15,5,16,52,49,3,50
Stranraer,2096,7,14,6,16,49,52,-3,48
East Fife,2096,8,11,8,17,49,59,-10,41
Queen's Park,2096,9,10,7,19,39,59,-20,37
Stenhousem'r,2096,10,8,10,18,41,74,-33,34
Livingston,2097,1,19,4,13,70,52,18,61
Alloa,2097,2,16,12,8,60,40,20,60
Peterhead,2097,3,16,8,12,51,49,2,56
Queen's Park,2097,4,16,6,14,54,49,5,54
Airdrieon,2097,5,15,9,12,54,52,2,54
Albion,2097,6,15,7,14,55,53,2,52
Brechin,2097,7,15,5,16,43,54,-11,50
Stranraer,2097,8,13,6,17,48,49,-1,45
East Fife,2097,9,11,8,17,46,54,-8,41
Stenhousem'r,2097,10,9,5,22,49,78,-29,32
Alloa,2098,1,21,5,10,71,44,27,68
Livingston,2098,2,20,2,14,70,53,17,62
Brechin,2098,3,19,3,14,54,43,11,60
Albion,2098,4,17,8,11,60,48,12,59
Peterhead,2098,5,16,5,15,57,53,4,53
Stranraer,2098,6,14,7,15,57,55,2,49
Airdrieon,2098,7,14,7,15,51,53,-2,49
East Fife,2098,8,11,7,18,45,52,-7,40
Queen's Park,2098,9,10,7,19,27,60,-33,37
Stenhousem'r,2098,10,9,7,20,44,75,-31,34
Livingston,2099,1,23,6,7,77,43,34,75
Airdrieon,2099,2,17,7,12,58,48,10,58
Brechin,2099,3,17,7,12,56,46,10,58
Alloa,2099,4,16,8,12,77,57,20,56
Peterhead,2099,5,14,10,12,47,47,0,52
Queen's Park,2099,6,14,4,18,37,57,-20,46
Stenhousem'r,2099,7,13,5,18,51,72,-21,44
East Fife,2099,8,10,9,17,44,53,-9,39
Stranraer,2099,9,11,6,19,53,67,-14,39
Albion,2099,10,10,8,18,49,59,-10,38
Alloa,2100,1,18,7,11,60,41,19,61
Livingston,2100,2,17,9,10,69,51,18,60
Airdrieon,2100,3,17,6,13,53,51,2,57
Brechin,2100,4,17,5,14,52,49,3,56
Peterhead,2100,5,15,9,12,54,45,9,54
Albion,2100,6,15,7,14,52,48,4,52
Queen's Park,2100,7,13,7,16,46,59,-13,46
East Fife,2100,8,11,10,15,42,41,1,43
Stranraer,2100,9,13,3,20,39,55,-16,42
Stenhousem'r,2100,10,8,9,19,47,74,-27,33
Alloa,2101,1,20,8,8,84,45,39,68
Airdrieon,2101,2,21,4,11,69,54,15,67
Brechin,2101,3,19,5,12,58,49,9,62
Livingston,2101,4,18,4,14,67,46,21,58
East Fife,2101,5,14,7,15,47,48,-1,49
Albion,2101,6,12,11,13,45,50,-5,47
Stranraer,2101,7,13,6,17,48,62,-14,45
Queen's Park,2101,8,12,7,17,34,50,-16,43
Peterhead,2101,9,12,6,18,52,63,-11,42
Stenhousem'r,2101,10,6,8,22,44,81,-37,26
Alloa,2102,1,20,9,7,81,45,36,69
Livingston,2102,2,19,7,10,73,51,22,64
Peterhead,2102,3,16,9,11,54,52,2,57
Brechin,2102,4,15,11,10,56,49,7,56
Airdrieon,2102,5,14,9,13,56,53,3,51
East Fife,2102,6,14,6,16,52,59,-7,48
Queen's Park,2102,7,12,6,18,41,56,-15,42
Stranraer,2102,8,12,5,19,55,63,-8,41
Albion,2102,9,11,7,18,48,58,-10,40
Stenhousem'r,2102,10,6,13,17,46,76,-30,31
Alloa,2103,1,20,6,10,70,44,26,66
Livingston,2103,2,20,5,11,78,54,24,65
Airdrieon,2103,3,18,5,13,62,53,9,59
Brechin,2103,4,16,8,12,56,45,11,56
Stranraer,2103,5,16,2,18,43,49,-6,50
Albion,2103,6,13,9,14,50,57,-7,48
Peterhead,2103,7,12,11,13,51,58,-7,47
East Fife,2103,8,12,9,15,48,50,-2,45
Queen's Park,2103,9,12,7,17,33,46,-13,43
Stenhousem'r,2103,10,7,6,23,38,73,-35,27
Alloa,2104,1,19,5,12,78,43,35,62
Airdrieon,2104,2,18,7,11,54,48,6,61
Livingston,2104,3,18,6,12,66,48,18,60
Brechin,2104,4,16,8,12,45,50,-5,56
Stranraer,2104,5,17,3,16,50,51,-1,54
Albion,2104,6,14,6,16,51,54,-3,48
Stenhousem'r,2104,7,14,5,17,57,71,-14,47
Peterhead,2104,8,13,4,19,46,59,-13,43
East Fife,2104,9,11,9,16,47,45,2,42
Queen's Park,2104,10,10,7,19,37,62,-25,37
Airdrieon,2105,1,23,3,10,71,56,15,72
Livingston,2105,2,21,5,10,79,52,27,68
Alloa,2105,3,19,8,9,78,50,28,65
Brechin,2105,4,17,11,8,55,42,13,62
Albion,2105,5,15,5,16,59,64,-5,50
Peterhead,2105,6,12,9,15,47,56,-9,45
Stranraer,2105,7,12,6,18,50,55,-5,42
Queen's Park,2105,8,11,8,17,45,58,-13,41
East Fife,2105,9,10,9,17,50,53,-3,39
Stenhousem'r,2105,10,6,4,26,38,86,-48,22
Alloa,2106,1,23,8,5,76,38,38,77
Livingston,2106,2,21,3,12,69,50,19,66
Brechin,2106,3,16,10,10,44,38,6,58
Albion,2106,4,14,11,11,52,45,7,53
East Fife,2106,5,14,8,14,63,52,11,50
Airdrieon,2106,6,13,9,14,52,53,-1,48
Peterhead,2106,7,11,8,17,46,53,-7,41
Stranraer,2106,8,11,8,17,40,57,-17,41
Queen's Park,2106,9,9,11,16,32,48,-16,38
Stenhousem'r,2106,10,7,6,23,35,75,-40,27
Livingston,2107,1,25,4,7,98,41,57,79
East Fife,2107,2,17,7,12,54,40,14,58
Airdrieon,2107,3,17,7,12,63,54,9,58
Alloa,2107,4,16,8,12,63,47,16,56
Brechin,2107,5,14,9,13,48,53,-5,51
Stranraer,2107,6,13,7,16,54,59,-5,46
Albion,2107,7,11,10,15,53,63,-10,43
Peterhead,2107,8,11,7,18,46,66,-20,40
Queen's Park,2107,9,11,7,18,34,57,-23,40
Stenhousem'r,2107,10,9,6,21,47,80,-33,33
Livingston,2108,1,23,5,8,79,47,32,74
Alloa,2108,2,18,8,10,79,46,33,62
Airdrieon,2108,3,17,7,12,61,58,3,58
Brechin,2108,4,17,4,15,47,55,-8,55
East Fife,2108,5,14,7,15,48,45,3,49
Peterhead,2108,6,12,12,12,59,54,5,48
Stranraer,2108,7,13,6,17,50,65,-15,45
Albion,2108,8,10,9,17,55,60,-5,39
Queen's Park,2108,9,10,9,17,37,57,-20,39
Stenhousem'r,2108,10,8,9,19,45,73,-28,33
Livingston,2109,1,24,1,11,87,47,40,73
Alloa,2109,2,21,5,10,80,47,33,68
Airdrieon,2109,3,20,5,11,61,54,7,65
Brechin,2109,4,15,7,14,46,49,-3,52
Albion,2109,5,14,9,13,56,59,-3,51
Stranraer,2109,6,13,5,18,50,63,-13,44
Peterhead,2109,7,12,7,17,47,54,-7,43
Queen's Park,2109,8,13,4,19,44,56,-12,43
Stenhousem'r,2109,9,11,8,17,57,80,-23,41
East Fife,2109,10,7,9,20,40,59,-19,30
Alloa,2110,1,19,9,8,61,38,23,66
Airdrieon,2110,2,18,8,10,56,43,13,62
Livingston,2110,3,18,7,11,74,48,26,61
Brechin,2110,4,17,9,10,47,41,6,60
East Fife,2110,5,12,10,14,48,45,3,46
Stranraer,2110,6,13,5,18,57,64,-7,44
Peterhead,2110,7,12,8,16,43,51,-8,44
Albion,2110,8,11,9,16,51,63,-12,42
Queen's Park,2110,9,11,8,17,34,50,-16,41
Stenhousem'r,2110,10,7,11,18,40,68,-28,32
Alloa,2111,1,23,6,7,82,41,41,75
Livingston,2111,2,19,5,12,71,47,24,62
Airdrieon,2111,3,19,5,12,57,51,6,62
Brechin,2111,4,16,6,14,50,51,-1,54
Albion,2111,5,13,9,14,54,56,-2,48
Queen's Park,2111,6,13,7,16,37,44,-7,46
Stranraer,2111,7,13,6,17,49,60,-11,45
East Fife,2111,8,12,6,18,47,57,-10,42
Peterhead,2111,9,11,7,18,43,58,-15,40
Stenhousem'r,2111,10,10,5,21,55,80,-25,35
Livingston,2112,1,21,4,11,73,47,26,67
Alloa,2112,2,16,11,9,71,51,20,59
Airdrieon,2112,3,15,10,11,54,52,2,55
East Fife,2112,4,14,9,13,57,43,14,51
Albion,2112,5,14,7,15,49,51,-2,49
Brechin,2112,6,14,6,16,45,51,-6,48
Queen's Park,2112,7,13,9,14,40,53,-13,48
Peterhead,2112,8,13,7,16,47,60,-13,46
Stranraer,2112,9,14,3,19,54,59,-5,45
Stenhousem'r,2112,10,9,8,19,48,71,-23,35
Alloa,2113,1,20,8,8,67,36,31,68
Livingston,2113,2,20,7,9,71,43,28,67
Airdrieon,2113,3,19,5,12,67,53,14,62
Brechin,2113,4,17,5,14,50,46,4,56
Albion,2113,5,14,10,12,58,47,11,52
Peterhead,2113,6,13,10,13,52,49,3,49
Queen's Park,2113,7,13,8,15,34,49,-15,47
East Fife,2113,8,12,8,16,40,44,-4,44
Stranraer,2113,9,9,6,21,40,68,-28,33
Stenhousem'r,2113,10,6,7,23,36,80,-44,25
Alloa,2114,1,22,6,8,81,43,38,72
Livingston,2114,2,20,6,10,78,51,27,66
Airdrieon,2114,3,17,11,8,62,50,12,62
Stranraer,2114,4,16,4,16,54,56,-2,52
Albion,2114,5,13,10,13,49,48,1,49
Brechin,2114,6,12,8,16,44,53,-9,44
East Fife,2114,7,11,10,15,55,55,0,43
Peterhead,2114,8,12,7,17,49,52,-3,43
Queen's Park,2114,9,11,8,17,32,59,-27,41
Stenhousem'r,2114,10,6,10,20,36,73,-37,28
Livingston,2115,1,18,8,10,68,53,15,62
Alloa,2115,2,16,10,10,68,47,21,58
Brechin,2115,3,17,5,14,59,49,10,56
Peterhead,2115,4,15,9,12,56,50,6,54
Airdrieon,2115,5,14,9,13,54,59,-5,51
Queen's Park,2115,6,13,9,14,43,50,-7,48
East Fife,2115,7,12,10,14,55,59,-4,46
Albion,2115,8,11,12,13,45,46,-1,45
Stranraer,2115,9,11,8,17,48,60,-12,41
Stenhousem'r,2115,10,8,10,18,51,74,-23,34
Alloa,2116,1,18,11,7,72,46,26,65
Livingston,2116,2,19,4,13,75,51,24,61
Peterhead,2116,3,18,6,12,57,48,9,60
Airdrieon,2116,4,15,9,12,58,52,6,54
Brechin,2116,5,15,7,14,49,50,-1,52
East Fife,2116,6,15,6,15,49,48,1,51
Albion,2116,7,13,9,14,46,47,-1,48
Queen's Park,2116,8,13,5,18,40,55,-15,44
Stranraer,2116,9,11,6,19,50,69,-19,39
Stenhousem'r,2116,10,7,9,20,48,78,-30,30
Livingston,2117,1,20,7,9,74,46,28,67
Airdrieon,2117,2,19,7,10,60,48,12,64
Alloa,2117,3,17,9,10,67,48,19,60
East Fife,2117,4,15,8,13,56,50,6,53
Brechin,2117,5,14,8,14,59,50,9,50
Peterhead,2117,6,14,8,14,50,51,-1,50
Albion,2117,7,13,10,13,53,47,6,49
Stranraer,2117,8,11,11,14,47,55,-8,44
Queen's Park,2117,9,8,9,19,29,53,-24,33
Stenhousem'r,2117,10,7,7,22,43,90,-47,28
Alloa,2118,1,22,6,8,80,46,34,72
Livingston,2118,2,21,5,10,79,53,26,68
Brechin,2118,3,18,3,15,53,53,0,57
Airdrieon,2118,4,16,7,13,60,60,0,55
Peterhead,2118,5,15,6,15,52,56,-4,51
Queen's Park,2118,6,14,4,18,39,49,-10,46
East Fife,2118,7,12,9,15,55,52,3,45
Stranraer,2118,8,12,5,19,57,60,-3,41
Albion,2118,9,12,5,19,55,64,-9,41
Stenhousem'r,2118,10,10,6,20,45,82,-37,36
Alloa,2119,1,19,9,8,70,43,27,66
Brechin,2119,2,21,3,12,58,45,13,66
Livingston,2119,3,20,4,12,77,49,28,64
Airdrieon,2119,4,15,8,13,54,53,1,53
Albion,2119,5,13,10,13,53,58,-5,49
Stranraer,2119,6,13,7,16,50,55,-5,46
East Fife,2119,7,11,9,16,42,46,-4,42
Queen's Park,2119,8,12,5,19,38,55,-17,41
Stenhousem'r,2119,9,10,9,17,53,75,-22,39
Peterhead,2119,10,8,12,16,38,54,-16,36
Alloa,2120,1,23,4,9,85,42,43,73
Livingston,2120,2,20,5,11,73,52,21,65
Airdrieon,2120,3,16,12,8,57,49,8,60
Brechin,2120,4,16,10,10,50,41,9,58
Queen's Park,2120,5,15,8,13,42,49,-7,53
Peterhead,2120,6,13,9,14,56,53,3,48
Albion,2120,7,12,8,16,56,62,-6,44
Stranraer,2120,8,12,2,22,51,68,-17,38
East Fife,2120,9,7,12,17,41,57,-16,33
Stenhousem'r,2120,10,7,8,21,42,80,-38,29
Alloa,2121,1,21,6,9,73,40,33,69
Livingston,2121,2,18,7,11,68,47,21,61
Brechin,2121,3,17,5,14,46,47,-1,56
Albion,2121,4,16,6,14,47,44,3,54
Peterhead,2121,5,15,7,14,56,52,4,52
Queen's Park,2121,6,14,7,15,46,55,-9,49
Airdrieon,2121,7,13,7,16,52,58,-6,46
Stranraer,2121,8,13,7,16,45,53,-8,46
East Fife,2121,9,9,9,18,47,48,-1,36
Stenhousem'r,2121,10,9,9,18,35,71,-36,36
Alloa,2122,1,21,8,7,74,40,34,71
Livingston,2122,2,21,2,13,82,56,26,65
Airdrieon,2122,3,15,11,10,52,50,2,56
East Fife,2122,4,14,11,11,47,39,8,53
Albion,2122,5,13,10,13,56,56,0,49
Brechin,2122,6,13,9,14,46,49,-3,48
Queen's Park,2122,7,14,5,17,33,48,-15,47
Stranraer,2122,8,13,4,19,54,62,-8,43
Peterhead,2122,9,11,7,18,57,66,-9,40
Stenhousem'r,2122,10,7,9,20,51,86,-35,30
Livingston,2123,1,22,6,8,84,47,37,72
Brechin,2123,2,20,6,10,57,45,12,66
Airdrieon,2123,3,20,5,11,66,58,8,65
Queen's Park,2123,4,16,6,14,45,49,-4,54
Alloa,2123,5,15,6,15,70,54,16,51
Peterhead,2123,6,14,8,14,52,56,-4,50
Stranraer,2123,7,11,9,16,50,62,-12,42
Albion,2123,8,11,7,18,49,62,-13,40
East Fife,2123,9,9,8,19,46,53,-7,35
Stenhousem'r,2123,10,8,7,21,40,73,-33,31
Livingston,2124,1,21,5,10,79,48,31,68
Airdrieon,2124,2,17,8,11,61,53,8,59
Alloa,2124,3,14,12,10,58,47,11,54
Peterhead,2124,4,15,9,12,51,50,1,54
Albion,2124,5,15,6,15,51,51,0,51
Brechin,2124,6,14,9,13,42,50,-8,51
Queen's Park,2124,7,12,7,17,43,53,-10,43
Stranraer,2124,8,12,6,18,43,52,-9,42
Stenhousem'r,2124,9,11,8,17,49,63,-14,41
East Fife,2124,10,8,12,16,41,51,-10,36
Livingston,2125,1,22,5,9,80,42,38,71
Alloa,2125,2,17,11,8,66,51,15,62
Albion,2125,3,16,7,13,45,42,3,55
Airdrieon,2125,4,15,7,14,51,50,1,52
Peterhead,2125,5,15,7,14,45,46,-1,52
Brechin,2125,6,13,8,15,49,52,-3,47
Stranraer,2125,7,12,6,18,53,65,-12,42
Queen's Park,2125,8,10,12,14,25,39,-14,42
Stenhousem'r,2125,9,11,7,18,45,68,-23,40
East Fife,2125,10,7,14,15,41,45,-4,35
Livingston,2126,1,22,7,7,81,46,35,73
Airdrieon,2126,2,19,8,9,57,45,12,65
Alloa,2126,3,14,13,9,69,51,18,55
Brechin,2126,4,14,9,13,53,52,1,51
Stranraer,2126,5,14,8,14,54,52,2,50
Queen's Park,2126,6,13,8,15,36,47,-11,47
Peterhead,2126,7,13,7,16,41,56,-15,46
East Fife,2126,8,10,9,17,50,54,-4,39
Albion,2126,9,9,10,17,44,55,-11,37
Stenhousem'r,2126,10,7,11,18,43,70,-27,32
Livingston,2127,1,20,4,12,79,53,26,64
Airdrieon,2127,2,19,7,10,64,58,6,64
Alloa,2127,3,19,6,11,63,47,16,63
Brechin,2127,4,16,4,16,48,58,-10,52
Peterhead,2127,5,14,8,14,52,46,6,50
Albion,2127,6,14,8,14,50,48,2,50
East Fife,2127,7,11,11,14,49,49,0,44
Stranraer,2127,8,12,7,17,53,60,-7,43
Queen's Park,2127,9,12,6,18,43,54,-11,42
Stenhousem'r,2127,10,9,7,20,44,72,-28,34
Airdrieon,2128,1,19,10,7,57,40,17,67
Livingston,2128,2,19,4,13,66,49,17,61
Alloa,2128,3,16,8,12,64,49,15,56
Albion,2128,4,16,6,14,49,46,3,54
Peterhead,2128,5,15,4,17,42,49,-7,49
Brechin,2128,6,12,11,13,48,54,-6,47
Stenhousem'r,2128,7,12,8,16,56,63,-7,44
Queen's Park,2128,8,12,8,16,34,51,-17,44
Stranraer,2128,9,12,7,17,49,56,-7,43
East Fife,2128,10,9,10,17,44,52,-8,37
Alloa,2129,1,20,5,11,74,40,34,65
Brechin,2129,2,18,6,12,58,44,14,60
Airdrieon,2129,3,17,9,10,58,46,12,60
Livingston,2129,4,15,6,15,70,66,4,51
Queen's Park,2129,5,14,9,13,35,45,-10,51
Albion,2129,6,12,12,12,55,56,-1,48
Peterhead,2129,7,13,8,15,44,52,-8,47
Stenhousem'r,2129,8,10,10,16,50,65,-15,40
Stranraer,2129,9,11,7,18,40,60,-20,40
East Fife,2129,10,9,10,17,49,59,-10,37
Livingston,2130,1,19,4,13,69,55,14,61
Brechin,2130,2,18,6,12,53,43,10,60
Peterhead,2130,3,18,6,12,52,44,8,60
Airdrieon,2130,4,17,8,11,57,48,9,59
Alloa,2130,5,15,9,12,65,45,20,54
Albion,2130,6,14,9,13,60,49,11,51
Queen's Park,2130,7,12,9,15,36,54,-18,45
East Fife,2130,8,12,8,16,40,45,-5,44
Stranraer,2130,9,9,11,16,44,58,-14,38
Stenhousem'r,2130,10,8,6,22,42,77,-35,30
Alloa,2131,1,18,9,9,64,40,24,63
Livingston,2131,2,19,4,13,73,50,23,61
Airdrieon,2131,3,17,6,13,59,56,3,57
Brechin,2131,4,16,7,13,51,47,4,55
Stranraer,2131,5,16,4,16,55,60,-5,52
East Fife,2131,6,13,10,13,50,49,1,49
Queen's Park,2131,7,13,9,14,44,50,-6,48
Peterhead,2131,8,13,8,15,45,53,-8,47
Albion,2131,9,12,9,15,53,55,-2,45
Stenhousem'r,2131,10,5,10,21,43,77,-34,25
Livingston,2132,1,20,8,8,69,39,30,68
Alloa,2132,2,18,9,9,68,40,28,63
Brechin,2132,3,19,6,11,58,45,13,63
East Fife,2132,4,14,8,14,51,47,4,50
Albion,2132,5,14,6,16,58,57,1,48
Peterhead,2132,6,13,9,14,52,57,-5,48
Airdrieon,2132,7,13,5,18,52,65,-13,44
Queen's Park,2132,8,10,10,16,44,52,-8,40
Stenhousem'r,2132,9,10,10,16,41,72,-31,40
Stranraer,2132,10,10,7,19,49,68,-19,37
Livingston,2133,1,21,6,9,78,42,36,69
Albion,2133,2,19,8,9,64,51,13,65
Alloa,2133,3,18,9,9,77,45,32,63
Airdrieon,2133,4,18,7,11,59,59,0,61
Stranraer,2133,5,15,8,13,47,46,1,53
Brechin,2133,6,14,9,13,45,52,-7,51
East Fife,2133,7,11,8,17,50,54,-4,41
Peterhead,2133,8,11,8,17,45,59,-14,41
Queen's Park,2133,9,12,4,20,33,49,-16,40
Stenhousem'r,2133,10,5,5,26,47,88,-41,20
Alloa,2134,1,21,5,10,72,46,26,68
Brechin,2134,2,18,7,11,57,47,10,61
Livingston,2134,3,17,7,12,69,50,19,58
Peterhead,2134,4,16,6,14,47,49,-2,54
Albion,2134,5,15,7,14,56,55,1,52
Stranraer,2134,6,14,6,16,52,54,-2,48
Airdrieon,2134,7,12,8,16,48,61,-13,44
East Fife,2134,8,11,7,18,48,52,-4,40
Stenhousem'r,2134,9,10,10,16,54,70,-16,40
Queen's Park,2134,10,11,7,18,33,52,-19,40
Alloa,2135,1,19,7,10,70,44,26,64
Brechin,2135,2,19,3,14,59,40,19,60
Airdrieon,2135,3,18,6,12,59,59,0,60
Livingston,2135,4,18,3,15,75,61,14,57
Queen's Park,2135,5,16,6,14,47,59,-12,54
Peterhead,2135,6,14,10,12,52,47,5,52
Albion,2135,7,14,6,16,54,57,-3,48
East Fife,2135,8,11,9,16,42,44,-2,42
Stranraer,2135,9,12,3,21,47,63,-16,39
Stenhousem'r,2135,10,8,9,19,48,79,-31,33
Livingston,2136,1,21,7,8,83,50,33,70
Albion,2136,2,18,9,9,59,37,22,63
Alloa,2136,3,16,13,7,62,36,26,61
Airdrieon,2136,4,16,6,14,45,52,-7,54
Brechin,2136,5,15,7,14,51,54,-3,52
Peterhead,2136,6,12,13,11,47,39,8,49
Queen's Park,2136,7,14,7,15,39,46,-7,49
Stranraer,2136,8,11,8,17,41,52,-11,41
East Fife,2136,9,8,10,18,40,56,-16,34
Stenhousem'r,2136,10,5,8,23,32,77,-45,23
Livingston,2137,1,19,9,8,70,51,19,66
Alloa,2137,2,19,7,10,69,43,26,64
Airdrieon,2137,3,15,8,13,57,49,8,53
Peterhead,2137,4,14,10,12,54,55,-1,52
Albion,2137,5,15,7,14,54,56,-2,52
Brechin,2137,6,13,9,14,47,53,-6,48
Stranraer,2137,7,12,7,17,54,58,-4,43
East Fife,2137,8,10,11,15,49,48,1,41
Queen's Park,2137,9,10,10,16,33,50,-17,40
Stenhousem'r,2137,10,9,10,17,55,79,-24,37
Livingston,2138,1,23,6,7,82,45,37,75
Alloa,2138,2,21,6,9,76,43,33,69
Brechin,2138,3,17,4,15,57,47,10,55
Queen's Park,2138,4,15,7,14,40,55,-15,52
Albion,2138,5,14,9,13,47,44,3,51
Peterhead,2138,6,14,9,13,49,49,0,51
Airdrieon,2138,7,14,6,16,47,54,-7,48
Stranraer,2138,8,14,4,18,49,55,-6,46
East Fife,2138,9,11,8,17,47,48,-1,41
Stenhousem'r,2138,10,3,9,24,34,88,-54,18
Alloa,2139,1,23,6,7,67,34,33,75
Livingston,2139,2,23,3,10,83,52,31,72
Airdrieon,2139,3,15,9,12,58,51,7,54
East Fife,2139,4,13,8,15,51,47,4,47
Peterhead,2139,5,14,5,17,45,49,-4,47
Stenhousem'r,2139,6,13,7,16,50,58,-8,46
Queen's Park,2139,7,14,4,18,37,48,-11,46
Stranraer,2139,8,13,4,19,43,56,-13,43
Albion,2139,9,12,6,18,44,64,-20,42
Brechin,2139,10,12,4,20,47,66,-19,40
Livingston,2140,1,25,3,8,95,47,48,78
Alloa,2140,2,22,5,9,77,44,33,71
Airdrieon,2140,3,17,6,13,67,56,11,57
Brechin,2140,4,18,3,15,58,53,5,57
Albion,2140,5,15,5,16,61,55,6,50
Queen's Park,2140,6,13,7,16,34,56,-22,46
Peterhead,2140,7,13,6,17,52,60,-8,45
Stranraer,2140,8,12,4,20,52,78,-26,40
East Fife,2140,9,9,9,18,46,55,-9,36
Stenhousem'r,2140,10,10,4,22,56,94,-38,34
Livingston,2141,1,20,6,10,87,58,29,66
Airdrieon,2141,2,18,5,13,59,53,6,59
Alloa,2141,3,16,10,10,68,49,19,58
Brechin,2141,4,16,8,12,47,41,6,56
Albion,2141,5,14,8,14,57,54,3,50
Peterhead,2141,6,14,8,14,55,58,-3,50
Queen's Park,2141,7,14,4,18,44,48,-4,46
Stranraer,2141,8,12,8,16,48,58,-10,44
East Fife,2141,9,10,8,18,44,56,-12,38
Stenhousem'r,2141,10,9,9,18,51,85,-34,36
Livingston,2142,1,24,3,9,72,37,35,75
Alloa,2142,2,21,7,8,72,42,30,70
Brechin,2142,3,16,10,10,58,48,10,58
Peterhead,2142,4,16,8,12,59,52,7,56
Airdrieon,2142,5,15,10,11,57,48,9,55
East Fife,2142,6,11,10,15,44,52,-8,43
Queen's Park,2142,7,10,11,15,34,49,-15,41
Stranraer,2142,8,12,5,19,49,65,-16,41
Albion,2142,9,9,8,19,42,62,-20,35
Stenhousem'r,2142,10,4,12,20,45,77,-32,24
Livingston,2143,1,23,6,7,71,42,29,75
Alloa,2143,2,19,9,8,62,38,24,66
Brechin,2143,3,16,11,9,50,37,13,59
Airdrieon,2143,4,16,10,10,47,40,7,58
East Fife,2143,5,13,11,12,53,44,9,50
Albion,2143,6,12,12,12,47,49,-2,48
Stranraer,2143,7,13,5,18,51,56,-5,44
Peterhead,2143,8,8,10,18,37,56,-19,34
Queen's Park,2143,9,8,8,20,33,57,-24,32
Stenhousem'r,2143,10,7,8,21,47,79,-32,29
Brechin,2144,1,20,7,9,45,32,13,67
Alloa,2144,2,18,7,11,64,45,19,61
Airdrieon,2144,3,16,9,11,62,51,11,57
Livingston,2144,4,15,11,10,71,56,15,56
Queen's Park,2144,5,14,11,11,44,44,0,53
Peterhead,2144,6,14,7,15,44,47,-3,49
Albion,2144,7,12,10,14,45,49,-4,46
Stranraer,2144,8,10,8,18,48,62,-14,38
East Fife,2144,9,9,10,17,46,54,-8,37
Stenhousem'r,2144,10,8,8,20,46,75,-29,32
Livingston,2145,1,20,5,11,69,47,22,65
Alloa,2145,2,18,7,11,72,44,28,61
Airdrieon,2145,3,18,3,15,48,58,-10,57
Albion,2145,4,14,9,13,61,52,9,51
Queen's Park,2145,5,15,6,15,34,48,-14,51
Brechin,2145,6,15,5,16,45,48,-3,50
Peterhead,2145,7,15,4,17,47,52,-5,49
Stranraer,2145,8,12,11,13,53,52,1,47
East Fife,2145,9,12,10,14,47,41,6,46
Stenhousem'r,2145,10,7,8,21,51,85,-34,29
Livingston,2146,1,23,2,11,72,51,21,71
Alloa,2146,2,20,8,8,80,47,33,68
Brechin,2146,3,19,4,13,59,44,15,61
Airdrieon,2146,4,16,8,12,61,56,5,56
Peterhead,2146,5,13,10,13,51,46,5,49
Albion,2146,6,13,9,14,49,49,0,48
Stranraer,2146,7,14,5,17,54,60,-6,47
Queen's Park,2146,8,12,7,17,39,60,-21,43
East Fife,2146,9,9,9,18,47,59,-12,36
Stenhousem'r,2146,10,6,8,22,38,78,-40,26
Alloa,2147,1,21,6,9,70,43,27,69
Airdrieon,2147,2,21,3,12,64,49,15,66
Livingston,2147,3,19,7,10,78,53,25,64
Albion,2147,4,14,12,10,57,53,4,54
Brechin,2147,5,14,10,12,50,45,5,52
Stranraer,2147,6,13,6,17,48,55,-7,45
Peterhead,2147,7,12,8,16,51,59,-8,44
East Fife,2147,8,10,12,14,45,53,-8,42
Queen's Park,2147,9,10,6,20,36,59,-23,36
Stenhousem'r,2147,10,7,8,21,41,71,-30,29
Livingston,2148,1,19,6,11,71,44,27,63
Alloa,2148,2,18,8,10,66,43,23,62
Stranraer,2148,3,17,5,14,49,45,4,56
Airdrieon,2148,4,17,4,15,59,62,-3,55
Brechin,2148,5,14,8,14,46,48,-2,50
Albion,2148,6,13,10,13,45,48,-3,49
Peterhead,2148,7,14,7,15,51,57,-6,49
East Fife,2148,8,12,9,15,50,48,2,45
Stenhousem'r,2148,9,11,6,19,48,66,-18,39
Queen's Park,2148,10,11,5,20,35,59,-24,38
Alloa,2149,1,22,8,6,80,39,41,74
Livingston,2149,2,18,6,12,82,62,20,60
Albion,2149,3,15,9,12,56,47,9,54
Brechin,2149,4,15,8,13,50,50,0,53
Airdrieon,2149,5,14,9,13,67,61,6,51
Stranraer,2149,6,12,7,17,53,62,-9,43
Stenhousem'r,2149,7,12,7,17,55,85,-30,43
Peterhead,2149,8,11,8,17,48,63,-15,41
East Fife,2149,9,8,15,13,46,49,-3,39
Queen's Park,2149,10,8,13,15,33,52,-19,37
Livingston,2150,1,22,5,9,82,40,42,71
Brechin,2150,2,23,2,11,58,43,15,71
Alloa,2150,3,19,5,12,59,43,16,62
Airdrieon,2150,4,17,8,11,63,54,9,59
Peterhead,2150,5,15,7,14,47,50,-3,52
Queen's Park,2150,6,14,6,16,33,49,-16,48
Albion,2150,7,11,11,14,57,56,1,44
Stranraer,2150,8,11,8,17,45,56,-11,41
East Fife,2150,9,9,6,21,47,53,-6,33
Stenhousem'r,2150,10,7,6,23,43,90,-47,27
Livingston,2151,1,22,5,9,78,48,30,71
Alloa,2151,2,20,9,7,72,36,36,69
Brechin,2151,3,17,6,13,51,52,-1,57
Albion,2151,4,16,8,12,62,49,13,56
Airdrieon,2151,5,17,4,15,56,56,0,55
Peterhead,2151,6,16,5,15,50,51,-1,53
Stranraer,2151,7,13,6,17,50,58,-8,45
East Fife,2151,8,10,7,19,45,56,-11,37
Queen's Park,2151,9,8,12,16,34,52,-18,36
Stenhousem'r,2151,10,6,8,22,37,77,-40,26
Livingston,2152,1,21,5,10,84,53,31,68
Airdrieon,2152,2,17,10,9,57,47,10,61
Brechin,2152,3,18,3,15,61,55,6,57
Peterhead,2152,4,16,9,11,54,54,0,57
Alloa,2152,5,14,11,11,66,51,15,53
Queen's Park,2152,6,15,8,13,46,52,-6,53
Albion,2152,7,12,10,14,56,58,-2,46
Stranraer,2152,8,12,6,18,44,53,-9,42
East Fife,2152,9,10,11,15,49,50,-1,41
Stenhousem'r,2152,10,4,9,23,46,90,-44,21
Livingston,2153,1,20,7,9,82,55,27,67
Alloa,2153,2,19,9,8,73,45,28,66
Airdrieon,2153,3,16,10,10,60,53,7,58
Brechin,2153,4,18,3,15,60,53,7,57
Queen's Park,2153,5,16,7,13,54,50,4,55
East Fife,2153,6,15,7,14,53,41,12,52
Albion,2153,7,10,12,14,45,52,-7,42
Peterhead,2153,8,12,6,18,47,60,-13,42
Stranraer,2153,9,10,7,19,44,67,-23,37
Stenhousem'r,2153,10,6,8,22,50,92,-42,26
Livingston,2154,1,21,6,9,70,37,33,69
Alloa,2154,2,19,9,8,68,41,27,66
Airdrieon,2154,3,19,5,12,55,43,12,62
Brechin,2154,4,17,5,14,47,50,-3,56
Albion,2154,5,14,13,9,53,42,11,55
Peterhead,2154,6,15,9,12,54,56,-2,54
Stranraer,2154,7,10,9,17,44,54,-10,39
East Fife,2154,8,9,9,18,44,55,-11,36
Queen's Park,2154,9,8,10,18,30,57,-27,34
Stenhousem'r,2154,10,6,9,21,43,73,-30,27
Livingston,2155,1,21,7,8,80,49,31,70
Airdrieon,2155,2,19,10,7,55,40,15,67
Alloa,2155,3,17,11,8,72,48,24,62
Brechin,2155,4,16,9,11,56,45,11,57
Stranraer,2155,5,15,5,16,60,59,1,50
Albion,2155,6,14,7,15,51,48,3,49
Peterhead,2155,7,12,7,17,45,57,-12,43
Queen's Park,2155,8,10,11,15,35,53,-18,41
East Fife,2155,9,9,9,18,51,57,-6,36
Stenhousem'r,2155,10,6,6,24,39,88,-49,24
Livingston,2156,1,24,3,9,73,38,35,75
Brechin,2156,2,19,2,15,59,52,7,59
Alloa,2156,3,15,11,10,60,48,12,56
Airdrieon,2156,4,14,8,14,58,58,0,50
Peterhead,2156,5,14,7,15,52,55,-3,49
Stranraer,2156,6,13,7,16,60,67,-7,46
Albion,2156,7,11,11,14,52,62,-10,44
Stenhousem'r,2156,8,11,10,15,57,75,-18,43
East Fife,2156,9,11,9,16,52,52,0,42
Queen's Park,2156,10,11,6,19,45,61,-16,39
Livingston,2157,1,20,4,12,69,42,27,64
Airdrieon,2157,2,19,6,11,67,60,7,63
Alloa,2157,3,17,8,11,61,43,18,59
Peterhead,2157,4,16,5,15,45,50,-5,53
Albion,2157,5,14,8,14,53,49,4,50
Queen's Park,2157,6,13,11,12,39,48,-9,50
Brechin,2157,7,13,9,14,48,53,-5,48
Stranraer,2157,8,12,8,16,48,54,-6,44
East Fife,2157,9,9,11,16,44,50,-6,38
Stenhousem'r,2157,10,8,8,20,47,72,-25,32
Alloa,2158,1,22,7,7,86,47,39,73
Livingston,2158,2,20,6,10,86,55,31,66
Airdrieon,2158,3,19,7,10,59,51,8,64
Stranraer,2158,4,16,3,17,58,60,-2,51
Albion,2158,5,15,5,16,53,53,0,50
Brechin,2158,6,14,6,16,51,52,-1,48
Peterhead,2158,7,14,6,16,55,62,-7,48
East Fife,2158,8,10,10,16,49,52,-3,40
Queen's Park,2158,9,10,8,18,36,68,-32,38
Stenhousem'r,2158,10,8,6,22,52,85,-33,30
Livingston,2159,1,19,6,11,72,53,19,63
Alloa,2159,2,18,6,12,70,48,22,60
Albion,2159,3,15,10,11,55,49,6,55
Brechin,2159,4,16,7,13,54,48,6,55
Airdrieon,2159,5,15,9,12,58,50,8,54
Stranraer,2159,6,15,5,16,51,59,-8,50
Peterhead,2159,7,13,8,15,48,50,-2,47
East Fife,2159,8,12,8,16,48,49,-1,44
Queen's Park,2159,9,11,10,15,32,48,-16,43
Stenhousem'r,2159,10,8,7,21,50,84,-34,31
Alloa,2160,1,19,10,7,71,40,31,67
Brechin,2160,2,17,13,6,65,46,19,64
Livingston,2160,3,20,2,14,76,54,22,62
Albion,2160,4,17,11,8,67,51,16,62
Airdrieon,2160,5,19,5,12,57,46,11,62
Peterhead,2160,6,14,8,14,49,49,0,50
Stranraer,2160,7,12,9,15,50,55,-5,45
Queen's Park,2160,8,11,5,20,34,64,-30,38
East Fife,2160,9,7,6,23,46,72,-26,27
Stenhousem'r,2160,10,6,7,23,50,88,-38,25
Livingston,2161,1,28,2,6,88,37,51,86
Brechin,2161,2,17,5,14,49,42,7,56
Airdrieon,2161,3,16,8,12,53,51,2,56
Alloa,2161,4,15,8,13,66,50,16,53
Queen's Park,2161,5,13,9,14,32,44,-12,48
Stranraer,2161,6,14,5,17,52,56,-4,47
Albion,2161,7,12,10,14,47,50,-3,46
Peterhead,2161,8,10,12,14,48,57,-9,42
East Fife,2161,9,11,6,19,46,57,-11,39
Stenhousem'r,2161,10,8,7,21,45,82,-37,31
Livingston,2162,1,22,3,11,78,45,33,69
Alloa,2162,2,15,12,9,70,52,18,57
Airdrieon,2162,3,16,8,12,55,62,-7,56
Brechin,2162,4,14,10,12,47,43,4,52
Queen's Park,2162,5,13,10,13,43,48,-5,49
Peterhead,2162,6,12,12,12,52,54,-2,48
Albion,2162,7,11,12,13,58,57,1,45
Stranraer,2162,8,14,3,19,52,63,-11,45
East Fife,2162,9,9,11,16,46,49,-3,38
Stenhousem'r,2162,10,9,9,18,49,77,-28,36
Livingston,2163,1,21,6,9,80,46,34,69
Brechin,2163,2,16,7,13,61,55,6,55
Peterhead,2163,3,14,13,9,47,41,6,55
Alloa,2163,4,14,11,11,61,47,14,53
Airdrieon,2163,5,16,5,15,58,56,2,53
Stranraer,2163,6,13,7,16,56,63,-7,46
Queen's Park,2163,7,12,8,16,41,55,-14,44
Albion,2163,8,11,11,14,45,60,-15,44
East Fife,2163,9,10,11,15,55,53,2,41
Stenhousem'r,2163,10,7,13,16,44,72,-28,34
Brechin,2164,1,21,3,12,72,45,27,66
Airdrieon,2164,2,19,6,11,57,46,11,63
Alloa,2164,3,18,8,10,72,51,21,62
Livingston,2164,4,19,5,12,74,59,15,62
Albion,2164,5,16,6,14,58,52,6,54
Peterhead,2164,6,15,7,14,57,48,9,52
East Fife,2164,7,11,9,16,48,50,-2,42
Stranraer,2164,8,12,3,21,49,71,-22,39
Queen's Park,2164,9,11,5,20,26,50,-24,38
Stenhousem'r,2164,10,8,8,20,46,87,-41,32
Livingston,2165,1,24,6,6,85,40,45,78
Alloa,2165,2,18,6,12,65,44,21,60
Brechin,2165,3,17,9,10,58,48,10,60
Airdrieon,2165,4,16,10,10,65,59,6,58
Peterhead,2165,5,13,10,13,47,51,-4,49
Queen's Park,2165,6,15,4,17,38,47,-9,49
Albion,2165,7,13,9,14,57,51,6,48
Stranraer,2165,8,11,7,18,41,62,-21,40
East Fife,2165,9,7,9,20,42,61,-19,30
Stenhousem'r,2165,10,7,8,21,49,84,-35,29
Livingston,2166,1,18,7,11,72,47,25,61
Alloa,2166,2,17,9,10,72,46,26,60
Airdrieon,2166,3,16,7,13,62,52,10,55
Albion,2166,4,17,4,15,52,52,0,55
Brechin,2166,5,14,9,13,45,46,-1,51
East Fife,2166,6,13,11,12,41,38,3,50
Peterhead,2166,7,14,7,15,44,49,-5,49
Queen's Park,2166,8,13,10,13,44,51,-7,49
Stranraer,2166,9,9,9,18,52,66,-14,36
Stenhousem'r,2166,10,9,7,20,43,80,-37,34
Livingston,2167,1,22,5,9,74,42,32,71
Alloa,2167,2,15,14,7,75,46,29,59
Brechin,2167,3,18,5,13,51,55,-4,59
Albion,2167,4,17,7,12,54,45,9,58
Airdrieon,2167,5,16,7,13,64,51,13,55
Queen's Park,2167,6,13,6,17,37,54,-17,45
Stranraer,2167,7,12,7,17,48,55,-7,43
Peterhead,2167,8,11,9,16,38,45,-7,42
Stenhousem'r,2167,9,9,8,19,41,75,-34,35
East Fife,2167,10,8,10,18,48,62,-14,34
Livingston,2168,1,23,3,10,82,52,30,72
Alloa,2168,2,21,6,9,72,42,30,69
Brechin,2168,3,19,9,8,58,39,19,66
Albion,2168,4,14,9,13,55,49,6,51
Peterhead,2168,5,12,11,13,48,54,-6,47
East Fife,2168,6,12,10,14,55,56,-1,46
Airdrieon,2168,7,13,7,16,46,57,-11,46
Queen's Park,2168,8,13,7,16,36,48,-12,46
Stranraer,2168,9,9,7,20,43,58,-15,34
Stenhousem'r,2168,10,5,9,22,47,87,-40,24
Livingston,2169,1,22,5,9,82,46,36,71
Alloa,2169,2,21,8,7,71,46,25,71
Albion,2169,3,20,7,9,68,42,26,67
Brechin,2169,4,19,4,13,56,52,4,61
Airdrieon,2169,5,16,8,12,59,56,3,56
Stranraer,2169,6,14,4,18,48,59,-11,46
Peterhead,2169,7,10,7,19,40,55,-15,37
Queen's Park,2169,8,9,10,17,38,55,-17,37
East Fife,2169,9,10,6,20,47,55,-8,36
Stenhousem'r,2169,10,6,7,23,37,80,-43,25
Livingston,2170,1,27,1,8,90,48,42,82
Alloa,2170,2,20,5,11,69,43,26,65
Airdrieon,2170,3,16,7,13,58,53,5,55
Brechin,2170,4,16,6,14,49,51,-2,54
Peterhead,2170,5,15,7,14,56,54,2,52
East Fife,2170,6,15,5,16,61,52,9,50
Stranraer,2170,7,15,5,16,48,51,-3,50
Albion,2170,8,14,6,16,58,63,-5,48
Queen's Park,2170,9,10,4,22,35,71,-36,34
Stenhousem'r,2170,10,6,6,24,38,76,-38,24
Livingston,2171,1,24,4,8,81,39,42,76
Alloa,2171,2,20,5,11,76,45,31,65
Airdrieon,2171,3,18,6,12,62,55,7,60
Peterhead,2171,4,17,7,12,57,53,4,58
Brechin,2171,5,18,4,14,51,49,2,58
East Fife,2171,6,13,8,15,53,49,4,47
Albion,2171,7,13,8,15,55,65,-10,47
Stranraer,2171,8,12,4,20,48,62,-14,40
Queen's Park,2171,9,10,7,19,47,65,-18,37
Stenhousem'r,2171,10,4,9,23,39,87,-48,21
Alloa,2172,1,20,9,7,71,42,29,69
Livingston,2172,2,20,3,13,76,51,25,63
Airdrieon,2172,3,17,7,12,62,63,-1,58
Brechin,2172,4,16,8,12,60,47,13,56
Albion,2172,5,16,4,16,55,62,-7,52
East Fife,2172,6,13,11,12,49,41,8,50
Queen's Park,2172,7,13,7,16,38,52,-14,46
Stenhousem'r,2172,8,11,5,20,50,80,-30,38
Peterhead,2172,9,10,7,19,56,65,-9,37
Stranraer,2172,10,10,7,19,54,68,-14,37
Alloa,2173,1,20,5,11,80,45,35,65
Livingston,2173,2,19,7,10,72,44,28,64
Brechin,2173,3,18,7,11,60,53,7,61
Airdrieon,2173,4,16,5,15,54,56,-2,53
Queen's Park,2173,5,15,8,13,38,45,-7,53
East Fife,2173,6,14,8,14,59,53,6,50
Albion,2173,7,12,6,18,47,56,-9,42
Stranraer,2173,8,11,8,17,51,62,-11,41
Stenhousem'r,2173,9,10,9,17,53,75,-22,39
Peterhead,2173,10,10,7,19,42,67,-25,37
Livingston,2174,1,25,3,8,79,35,44,78
Airdrieon,2174,2,21,3,12,56,52,4,66
Alloa,2174,3,15,8,13,48,44,4,53
Albion,2174,4,14,9,13,58,52,6,51
Brechin,2174,5,13,11,12,44,41,3,50
Peterhead,2174,6,14,8,14,50,50,0,50
Stranraer,2174,7,13,8,15,41,49,-8,47
Queen's Park,2174,8,10,8,18,36,50,-14,38
Stenhousem'r,2174,9,9,8,19,41,71,-30,35
East Fife,2174,10,8,10,18,44,53,-9,34
Livingston,2175,1,23,3,10,77,41,36,72
Alloa,2175,2,22,5,9,86,44,42,71
Peterhead,2175,3,17,8,11,50,51,-1,59
Brechin,2175,4,17,5,14,51,53,-2,56
Airdrieon,2175,5,16,4,16,52,56,-4,52
East Fife,2175,6,12,10,14,51,48,3,46
Stranraer,2175,7,13,7,16,54,62,-8,46
Albion,2175,8,14,4,18,45,54,-9,46
Queen's Park,2175,9,9,7,20,38,64,-26,34
Stenhousem'r,2175,10,8,5,23,48,79,-31,29
Alloa,2176,1,23,6,7,81,33,48,75
Livingston,2176,2,21,2,13,83,51,32,65
Airdrieon,2176,3,16,8,12,58,55,3,56
Brechin,2176,4,16,6,14,51,47,4,54
Stranraer,2176,5,14,6,16,53,53,0,48
Peterhead,2176,6,12,10,14,45,55,-10,46
Albion,2176,7,12,9,15,49,59,-10,45
East Fife,2176,8,11,10,15,46,46,0,43
Queen's Park,2176,9,11,5,20,35,60,-25,38
Stenhousem'r,2176,10,10,6,20,42,84,-42,36
Livingston,2177,1,21,2,13,81,52,29,65
Alloa,2177,2,18,5,13,63,45,18,59
Brechin,2177,3,17,8,11,53,47,6,59
Airdrieon,2177,4,18,4,14,53,56,-3,58
East Fife,2177,5,14,9,13,46,39,7,51
Peterhead,2177,6,14,6,16,46,51,-5,48
Queen's Park,2177,7,13,9,14,40,47,-7,48
Stranraer,2177,8,11,7,18,50,58,-8,40
Stenhousem'r,2177,9,11,7,18,52,74,-22,40
Albion,2177,10,10,9,17,47,62,-15,39
Livingston,2178,1,21,4,11,79,56,23,67
Alloa,2178,2,19,8,9,69,41,28,65
Albion,2178,3,15,9,12,63,59,4,54
Brechin,2178,4,16,5,15,52,54,-2,53
Airdrieon,2178,5,15,5,16,60,64,-4,50
Peterhead,2178,6,13,8,15,49,53,-4,47
Stenhousem'r,2178,7,13,7,16,63,68,-5,46
East Fife,2178,8,11,12,13,52,52,0,45
Stranraer,2178,9,11,8,17,45,63,-18,41
Queen's Park,2178,10,8,10,18,32,54,-22,34
Livingston,2179,1,23,5,8,87,43,44,74
Alloa,2179,2,19,6,11,69,43,26,63
Brechin,2179,3,19,5,12,48,46,2,62
Airdrieon,2179,4,18,6,12,62,60,2,60
Peterhead,2179,5,16,8,12,62,60,2,56
East Fife,2179,6,12,9,15,50,50,0,45
Queen's Park,2179,7,13,4,19,37,57,-20,43
Stranraer,2179,8,10,8,18,42,54,-12,38
Albion,2179,9,8,12,16,47,57,-10,36
Stenhousem'r,2179,10,6,9,21,46,80,-34,27
Alloa,2180,1,19,9,8,73,48,25,66
Airdrieon,2180,2,20,5,11,63,52,11,65
Livingston,2180,3,18,6,12,73,62,11,60
Brechin,2180,4,18,5,13,59,43,16,59
Albion,2180,5,15,11,10,64,51,13,56
Stranraer,2180,6,16,7,13,54,53,1,55
Peterhead,2180,7,12,6,18,46,60,-14,42
East Fife,2180,8,9,10,17,41,47,-6,37
Queen's Park,2180,9,10,5,21,33,58,-25,35
Stenhousem'r,2180,10,5,12,19,47,79,-32,27
Alloa,2181,1,21,7,8,73,46,27,70
Brechin,2181,2,17,10,9,55,42,13,61
Livingston,2181,3,18,6,12,69,48,21,60
Peterhead,2181,4,15,8,13,50,48,2,53
Albion,2181,5,12,12,12,55,54,1,48
Stranraer,2181,6,12,12,12,51,51,0,48
Airdrieon,2181,7,13,7,16,47,54,-7,46
East Fife,2181,8,11,9,16,52,59,-7,42
Queen's Park,2181,9,10,10,16,29,46,-17,40
Stenhousem'r,2181,10,7,7,22,52,85,-33,28
Alloa,2182,1,21,8,7,89,51,38,71
Livingston,2182,2,20,9,7,85,56,29,69
Airdrieon,2182,3,17,8,11,67,52,15,59
Brechin,2182,4,16,8,12,57,52,5,56
Peterhead,2182,5,13,8,15,55,63,-8,47
Albion,2182,6,10,13,13,57,63,-6,43
Stranraer,2182,7,11,9,16,45,59,-14,42
Queen's Park,2182,8,12,5,19,42,59,-17,41
Stenhousem'r,2182,9,10,9,17,44,80,-36,39
East Fife,2182,10,7,9,20,52,58,-6,30
Livingston,2183,1,22,4,10,64,34,30,70
Airdrieon,2183,2,20,4,12,69,52,17,64
Brechin,2183,3,17,7,12,50,41,9,58
Alloa,2183,4,16,6,14,63,53,10,54
Stranraer,2183,5,16,5,15,46,58,-12,53
East Fife,2183,6,11,12,13,50,40,10,45
Albion,2183,7,12,8,16,47,55,-8,44
Queen's Park,2183,8,11,9,16,36,55,-19,42
Peterhead,2183,9,11,8,17,46,56,-10,41
Stenhousem'r,2183,10,8,9,19,44,71,-27,33
Alloa,2184,1,20,8,8,71,44,27,68
Livingston,2184,2,19,5,12,72,48,24,62
Brechin,2184,3,18,3,15,54,50,4,57
Airdrieon,2184,4,17,5,14,64,56,8,56
Albion,2184,5,15,8,13,59,57,2,53
Peterhead,2184,6,15,7,14,53,53,0,52
East Fife,2184,7,13,6,17,50,45,5,45
Stranraer,2184,8,12,9,15,49,59,-10,45
Queen's Park,2184,9,12,8,16,35,53,-18,44
Stenhousem'r,2184,10,5,9,22,44,86,-42,24
Brechin,2185,1,17,8,11,50,42,8,59
Airdrieon,2185,2,18,5,13,55,53,2,59
Albion,2185,3,16,7,13,52,49,3,55
Alloa,2185,4,14,12,10,55,40,15,54
Peterhead,2185,5,16,6,14,52,47,5,54
Queen's Park,2185,6,15,7,14,36,42,-6,52
Livingston,2185,7,14,8,14,75,59,16,50
Stranraer,2185,8,14,7,15,62,57,5,49
East Fife,2185,9,10,7,19,42,61,-19,37
Stenhousem'r,2185,10,9,7,20,46,75,-29,34
Livingston,2186,1,22,5,9,79,46,33,71
Alloa,2186,2,19,7,10,71,44,27,64
East Fife,2186,3,17,6,13,66,48,18,57
Airdrieon,2186,4,17,6,13,57,52,5,57
Brechin,2186,5,16,9,11,46,47,-1,57
Peterhead,2186,6,13,10,13,50,53,-3,49
Albion,2186,7,13,8,15,52,58,-6,47
Stranraer,2186,8,12,6,18,56,66,-10,42
Queen's Park,2186,9,9,4,23,29,61,-32,31
Stenhousem'r,2186,10,7,9,20,49,80,-31,30
Alloa,2187,1,21,7,8,75,46,29,70
Livingston,2187,2,21,3,12,77,50,27,66
Brechin,2187,3,19,6,11,63,52,11,63
Albion,2187,4,14,8,14,55,50,5,50
Peterhead,2187,5,13,10,13,53,53,0,49
Airdrieon,2187,6,14,7,15,60,63,-3,49
East Fife,2187,7,11,12,13,55,57,-2,45
Stranraer,2187,8,13,4,19,49,63,-14,43
Queen's Park,2187,9,11,9,16,36,47,-11,42
Stenhousem'r,2187,10,6,8,22,42,84,-42,26
Livingston,2188,1,24,2,10,84,47,37,74
Alloa,2188,2,19,6,11,78,48,30,63
Airdrieon,2188,3,17,8,11,55,45,10,59
Brechin,2188,4,16,7,13,50,51,-1,55
Albion,2188,5,13,13,10,56,51,5,52
Queen's Park,2188,6,15,6,15,49,55,-6,51
Peterhead,2188,7,13,11,12,57,51,6,50
East Fife,2188,8,9,10,17,49,60,-11,37
Stranraer,2188,9,11,3,22,54,77,-23,36
Stenhousem'r,2188,10,5,10,21,43,90,-47,25
Livingston,2189,1,23,5,8,80,43,37,74
Alloa,2189,2,17,9,10,66,43,23,60
Airdrieon,2189,3,17,9,10,64,54,10,60
Brechin,2189,4,16,9,11,54,44,10,57
Peterhead,2189,5,15,8,13,53,62,-9,53
Albion,2189,6,11,14,11,51,49,2,47
Stranraer,2189,7,14,4,18,55,56,-1,46
East Fife,2189,8,11,9,16,48,52,-4,42
Queen's Park,2189,9,10,8,18,34,54,-20,38
Stenhousem'r,2189,10,4,9,23,43,91,-48,21
Alloa,2190,1,18,10,8,70,46,24,64
Livingston,2190,2,19,7,10,70,47,23,64
Brechin,2190,3,18,5,13,54,54,0,59
Airdrieon,2190,4,16,8,12,62,55,7,56
East Fife,2190,5,15,7,14,63,48,15,52
Peterhead,2190,6,15,5,16,50,61,-11,50
Albion,2190,7,13,8,15,56,61,-5,47
Stranraer,2190,8,11,5,20,54,65,-11,38
Queen's Park,2190,9,10,8,18,29,49,-20,38
Stenhousem'r,2190,10,11,5,20,51,73,-22,38
Alloa,2191,1,17,9,10,64,42,22,60
Livingston,2191,2,19,2,15,71,52,19,59
Brechin,2191,3,17,8,11,58,45,13,59
Albion,2191,4,16,8,12,53,45,8,56
Airdrieon,2191,5,16,7,13,59,56,3,55
Queen's Park,2191,6,14,7,15,34,47,-13,49
Stranraer,2191,7,14,6,16,50,59,-9,48
East Fife,2191,8,11,11,14,49,46,3,44
Peterhead,2191,9,11,10,15,46,58,-12,43
Stenhousem'r,2191,10,8,6,22,39,73,-34,30
Alloa,2192,1,18,7,11,60,41,19,61
Livingston,2192,2,16,9,11,70,53,17,57
Airdrieon,2192,3,16,9,11,71,62,9,57
Peterhead,2192,4,16,6,14,53,53,0,54
Albion,2192,5,14,9,13,54,59,-5,51
Stranraer,2192,6,14,8,14,67,60,7,50
East Fife,2192,7,15,5,16,60,53,7,50
Brechin,2192,8,13,9,14,52,48,4,48
Queen's Park,2192,9,10,10,16,35,57,-22,40
Stenhousem'r,2192,10,7,10,19,44,80,-36,31
Livingston,2193,1,24,3,9,88,44,44,75
Airdrieon,2193,2,18,7,11,55,48,7,61
Brechin,2193,3,18,7,11,47,43,4,61
Alloa,2193,4,17,9,10,76,49,27,60
East Fife,2193,5,14,8,14,52,49,3,50
Peterhead,2193,6,13,6,17,51,57,-6,45
Albion,2193,7,11,10,15,57,58,-1,43
Queen's Park,2193,8,12,5,19,33,51,-18,41
Stenhousem'r,2193,9,10,7,19,48,80,-32,37
Stranraer,2193,10,7,10,19,42,70,-28,31
Alloa,2194,1,19,9,8,66,41,25,66
Airdrieon,2194,2,20,6,10,63,49,14,66
Livingston,2194,3,19,7,10,72,48,24,64
Albion,2194,4,14,10,12,50,44,6,52
Stranraer,2194,5,14,7,15,49,51,-2,49
Brechin,2194,6,14,6,16,42,49,-7,48
Peterhead,2194,7,11,10,15,41,53,-12,43
Queen's Park,2194,8,11,7,18,34,47,-13,40
Stenhousem'r,2194,9,9,8,19,53,78,-25,35
East Fife,2194,10,6,16,14,47,57,-10,34
Livingston,2195,1,23,6,7,84,43,41,75
Alloa,2195,2,19,6,11,81,47,34,63
Brechin,2195,3,17,6,13,51,57,-6,57
Airdrieon,2195,4,16,4,16,64,66,-2,52
Peterhead,2195,5,14,8,14,49,53,-4,50
Albion,2195,6,13,9,14,58,49,9,48
Queen's Park,2195,7,14,3,19,37,48,-11,45
Stranraer,2195,8,14,3,19,49,63,-14,45
East Fife,2195,9,10,11,15,47,54,-7,41
Stenhousem'r,2195,10,7,10,19,44,84,-40,31
Livingston,2196,1,19,4,13,73,50,23,61
Brechin,2196,2,16,9,11,52,45,7,57
Alloa,2196,3,15,11,10,69,47,22,56
Airdrieon,2196,4,16,8,12,57,53,4,56
Albion,2196,5,15,8,13,51,47,4,53
Peterhead,2196,6,14,9,13,58,51,7,51
Stranraer,2196,7,13,5,18,54,64,-10,44
East Fife,2196,8,11,10,15,46,54,-8,43
Stenhousem'r,2196,9,11,7,18,50,73,-23,40
Queen's Park,2196,10,11,7,18,34,60,-26,40
Airdrieon,2197,1,24,5,7,72,44,28,77
Alloa,2197,2,21,7,8,71,41,30,70
Livingston,2197,3,15,9,12,66,53,13,54
Brechin,2197,4,15,8,13,55,45,10,53
Albion,2197,5,15,8,13,55,58,-3,53
Queen's Park,2197,6,14,7,15,46,51,-5,49
Peterhead,2197,7,11,13,12,52,55,-3,46
East Fife,2197,8,10,12,14,49,49,0,42
Stranraer,2197,9,6,10,20,42,70,-28,28
Stenhousem'r,2197,10,6,7,23,39,81,-42,25
Alloa,2198,1,16,12,8,66,42,24,60
Airdrieon,2198,2,17,8,11,61,53,8,59
Brechin,2198,3,17,8,11,47,40,7,59
Livingston,2198,4,16,7,13,58,49,9,55
Peterhead,2198,5,15,7,14,50,46,4,52
Stranraer,2198,6,12,10,14,52,55,-3,46
East Fife,2198,7,11,11,14,44,48,-4,44
Queen's Park,2198,8,12,8,16,42,51,-9,44
Albion,2198,9,11,10,15,51,55,-4,43
Stenhousem'r,2198,10,9,7,20,42,74,-32,34
Alloa,2199,1,19,7,10,74,49,25,64
Livingston,2199,2,17,6,13,79,63,16,57
Queen's Park,2199,3,16,7,13,41,43,-2,55
Albion,2199,4,14,11,11,48,37,11,53
Stranraer,2199,5,16,5,15,47,47,0,53
Brechin,2199,6,15,8,13,46,48,-2,53
Airdrieon,2199,7,14,9,13,60,57,3,51
Peterhead,2199,8,13,7,16,51,55,-4,46
East Fife,2199,9,11,10,15,44,48,-4,43
Stenhousem'r,2199,10,6,8,22,40,83,-43,26
Livingston,2200,1,23,3,10,73,43,30,72
Alloa,2200,2,18,11,7,69,37,32,65
Peterhead,2200,3,17,8,11,52,45,7,59
Airdrieon,2200,4,18,5,13,56,53,3,59
Queen's Park,2200,5,14,9,13,37,38,-1,51
Albion,2200,6,13,10,13,47,48,-1,49
Stranraer,2200,7,14,6,16,45,52,-7,48
Brechin,2200,8,13,6,17,44,52,-8,45
East Fife,2200,9,7,10,19,41,57,-16,31
Stenhousem'r,2200,10,5,8,23,44,83,-39,23
Alloa,2201,1,21,8,7,67,37,30,71
Livingston,2201,2,22,2,12,69,48,21,68
Airdrieon,2201,3,18,7,11,56,50,6,61
Brechin,2201,4,18,5,13,56,41,15,59
Albion,2201,5,14,11,11,60,52,8,53
East Fife,2201,6,11,9,16,56,59,-3,42
Stranraer,2201,7,12,6,18,45,52,-7,42
Queen's Park,2201,8,11,8,17,34,53,-19,41
Peterhead,2201,9,11,7,18,44,59,-15,40
Stenhousem'r,2201,10,7,7,22,49,85,-36,28
Alloa,2202,1,21,6,9,74,51,23,69
Livingston,2202,2,21,5,10,75,44,31,68
Brechin,2202,3,19,5,12,58,44,14,62
Albion,2202,4,16,8,12,49,47,2,56
Airdrieon,2202,5,14,7,15,52,55,-3,49
Stranraer,2202,6,13,8,15,52,58,-6,47
Peterhead,2202,7,12,8,16,47,56,-9,44
East Fife,2202,8,11,9,16,46,51,-5,42
Queen's Park,2202,9,11,8,17,43,52,-9,41
Stenhousem'r,2202,10,7,6,23,43,81,-38,27
Alloa,2203,1,18,9,9,77,47,30,63
Livingston,2203,2,17,8,11,77,51,26,59
Airdrieon,2203,3,18,5,13,63,54,9,59
Brechin,2203,4,17,8,11,55,48,7,59
Peterhead,2203,5,14,10,12,44,46,-2,52
Albion,2203,6,14,9,13,55,58,-3,51
Stranraer,2203,7,12,8,16,48,56,-8,44
Queen's Park,2203,8,12,7,17,34,52,-18,43
East Fife,2203,9,10,8,18,49,53,-4,38
Stenhousem'r,2203,10,6,12,18,46,83,-37,30
Alloa,2204,1,20,7,9,75,39,36,67
Brechin,2204,2,18,8,10,49,47,2,62
Livingston,2204,3,19,4,13,71,47,24,61
Peterhead,2204,4,14,9,13,45,50,-5,51
Stenhousem'r,2204,5,15,6,15,51,65,-14,51
East Fife,2204,6,13,10,13,54,51,3,49
Airdrieon,2204,7,13,8,15,50,49,1,47
Stranraer,2204,8,13,5,18,40,53,-13,44
Albion,2204,9,11,8,17,47,61,-14,41
Queen's Park,2204,10,7,9,20,33,53,-20,30
Livingston,2205,1,22,5,9,72,43,29,71
Airdrieon,2205,2,18,7,11,66,54,12,61
Alloa,2205,3,16,9,11,76,57,19,57
Albion,2205,4,14,8,14,56,57,-1,50
Peterhead,2205,5,14,8,14,46,55,-9,50
Queen's Park,2205,6,13,10,13,41,44,-3,49
East Fife,2205,7,12,9,15,50,43,7,45
Stranraer,2205,8,14,3,19,48,61,-13,45
Brechin,2205,9,12,6,18,43,50,-7,42
Stenhousem'r,2205,10,8,9,19,47,81,-34,33
Airdrieon,2206,1,20,9,7,64,43,21,69
Livingston,2206,2,18,6,12,68,50,18,60
Alloa,2206,3,14,12,10,66,46,20,54
Albion,2206,4,14,9,13,52,45,7,51
East Fife,2206,5,14,9,13,51,44,7,51
Peterhead,2206,6,14,8,14,45,45,0,50
Stranraer,2206,7,14,8,14,48,53,-5,50
Brechin,2206,8,12,6,18,34,47,-13,42
Queen's Park,2206,9,11,4,21,37,65,-28,37
Stenhousem'r,2206,10,9,9,18,52,79,-27,36
Airdrieon,2207,1,19,9,8,63,55,8,66
Alloa,2207,2,17,9,10,77,53,24,60
Brechin,2207,3,19,3,14,55,46,9,60
Livingston,2207,4,17,7,12,70,57,13,58
Queen's Park,2207,5,13,9,14,42,52,-10,48
East Fife,2207,6,12,11,13,54,52,2,47
Peterhead,2207,7,13,8,15,49,55,-6,47
Stranraer,2207,8,13,6,17,63,57,6,45
Albion,2207,9,12,7,17,60,70,-10,43
Stenhousem'r,2207,10,7,7,22,52,88,-36,28
Livingston,2208,1,21,5,10,86,49,37,68
Brechin,2208,2,18,5,13,61,53,8,59
Alloa,2208,3,17,7,12,57,45,12,58
Airdrieon,2208,4,18,4,14,73,65,8,58
Albion,2208,5,17,6,13,60,57,3,57
Peterhead,2208,6,16,6,14,54,52,2,54
East Fife,2208,7,13,8,15,53,47,6,47
Queen's Park,2208,8,13,4,19,43,61,-18,43
Stranraer,2208,9,10,5,21,41,63,-22,35
Stenhousem'r,2208,10,8,8,20,44,80,-36,32
Brechin,2209,1,20,6,10,62,52,10,66
Alloa,2209,2,19,6,11,70,46,24,63
Airdrieon,2209,3,19,5,12,68,52,16,62
Livingston,2209,4,17,6,13,70,51,19,57
Peterhead,2209,5,16,7,13,65,60,5,55
Albion,2209,6,13,8,15,48,52,-4,47
Stranraer,2209,7,14,5,17,51,65,-14,47
Queen's Park,2209,8,10,8,18,35,55,-20,38
East Fife,2209,9,9,9,18,43,53,-10,36
Stenhousem'r,2209,10,9,8,19,60,86,-26,35
Livingston,2210,1,19,8,9,72,51,21,65
Airdrieon,2210,2,18,6,12,58,53,5,60
Alloa,2210,3,16,8,12,65,47,18,56
Peterhead,2210,4,14,9,13,53,53,0,51
Brechin,2210,5,14,9,13,48,53,-5,51
Queen's Park,2210,6,15,5,16,47,62,-15,50
Stranraer,2210,7,15,3,18,55,55,0,48
Albion,2210,8,12,9,15,52,53,-1,45
East Fife,2210,9,9,13,14,40,44,-4,40
Stenhousem'r,2210,10,9,8,19,52,71,-19,35
Alloa,2211,1,20,5,11,69,47,22,65
Livingston,2211,2,19,6,11,73,49,24,63
Peterhead,2211,3,19,5,12,60,46,14,62
Airdrieon,2211,4,15,10,11,51,51,0,55
Albion,2211,5,15,9,12,53,47,6,54
Brechin,2211,6,16,6,14,52,47,5,54
Stranraer,2211,7,12,8,16,49,64,-15,44
East Fife,2211,8,11,9,16,48,47,1,42
Queen's Park,2211,9,12,6,18,34,54,-20,42
Stenhousem'r,2211,10,5,8,23,41,78,-37,23
Livingston,2212,1,21,9,6,72,39,33,72
Alloa,2212,2,21,6,9,68,44,24,69
Airdrieon,2212,3,19,6,11,66,56,10,63
Brechin,2212,4,15,9,12,46,44,2,54
East Fife,2212,5,14,9,13,55,41,14,51
Peterhead,2212,6,14,7,15,51,53,-2,49
Albion,2212,7,13,7,16,63,61,2,46
Stranraer,2212,8,11,6,19,50,64,-14,39
Queen's Park,2212,9,9,8,19,32,53,-21,35
Stenhousem'r,2212,10,5,9,22,38,86,-48,24
Alloa,2213,1,20,9,7,79,41,38,69
Livingston,2213,2,19,10,7,71,48,23,67
East Fife,2213,3,15,10,11,55,45,10,55
Brechin,2213,4,15,8,13,45,50,-5,53
Albion,2213,5,14,10,12,51,44,7,52
Airdrieon,2213,6,15,7,14,64,62,2,52
Peterhead,2213,7,14,5,17,50,53,-3,47
Stranraer,2213,8,11,8,17,47,58,-11,41
Queen's Park,2213,9,8,12,16,35,56,-21,36
Stenhousem'r,2213,10,5,9,22,45,85,-40,24
Livingston,2214,1,25,4,7,88,43,45,79
Alloa,2214,2,22,5,9,80,43,37,71
Airdrieon,2214,3,18,8,10,56,50,6,62
East Fife,2214,4,14,10,12,48,42,6,52
Brechin,2214,5,15,6,15,48,46,2,51
Albion,2214,6,12,11,13,48,47,1,47
Peterhead,2214,7,12,8,16,43,47,-4,44
Stranraer,2214,8,10,9,17,52,64,-12,39
Queen's Park,2214,9,9,8,19,27,63,-36,35
Stenhousem'r,2214,10,4,9,23,41,86,-45,21
Alloa,2215,1,20,6,10,79,48,31,66
Airdrieon,2215,2,20,4,12,65,48,17,64
Livingston,2215,3,19,4,13,75,57,18,61
Albion,2215,4,17,6,13,56,48,8,57
Brechin,2215,5,15,7,14,50,51,-1,52
Queen's Park,2215,6,15,6,15,43,50,-7,51
Peterhead,2215,7,13,10,13,54,61,-7,49
Stranraer,2215,8,15,4,17,53,60,-7,49
East Fife,2215,9,9,8,19,48,58,-10,35
Stenhousem'r,2215,10,6,7,23,44,86,-42,25
Livingston,2216,1,22,6,8,84,49,35,72
Brechin,2216,2,20,5,11,52,45,7,65
Airdrieon,2216,3,18,6,12,64,64,0,60
Alloa,2216,4,15,9,12,67,50,17,54
Queen's Park,2216,5,15,5,16,43,47,-4,50
East Fife,2216,6,13,9,14,51,44,7,48
Peterhead,2216,7,12,8,16,53,58,-5,44
Albion,2216,8,11,9,16,56,65,-9,42
Stranraer,2216,9,11,5,20,51,67,-16,38
Stenhousem'r,2216,10,7,10,19,50,82,-32,31
Alloa,2217,1,19,8,9,72,53,19,65
Livingston,2217,2,18,8,10,73,43,30,62
Brechin,2217,3,16,10,10,52,40,12,58
East Fife,2217,4,14,11,11,54,47,7,53
Airdrieon,2217,5,15,6,15,54,65,-11,51
Peterhead,2217,6,14,7,15,55,59,-4,49
Queen's Park,2217,7,14,6,16,36,51,-15,48
Stranraer,2217,8,13,6,17,60,64,-4,45
Albion,2217,9,11,7,18,52,62,-10,40
Stenhousem'r,2217,10,8,7,21,53,77,-24,31
Alloa,2218,1,20,9,7,68,39,29,69
Livingston,2218,2,21,4,11,76,50,26,67
Airdrieon,2218,3,20,6,10,70,54,16,66
Brechin,2218,4,15,7,14,55,49,6,52
Albion,2218,5,13,10,13,53,47,6,49
East Fife,2218,6,13,7,16,48,51,-3,46
Queen's Park,2218,7,12,7,17,35,49,-14,43
Peterhead,2218,8,11,7,18,46,53,-7,40
Stenhousem'r,2218,9,11,5,20,54,86,-32,38
Stranraer,2218,10,11,4,21,42,69,-27,37
Brechin,2219,1,21,5,10,55,39,16,68
Livingston,2219,2,20,3,13,74,50,24,63
Alloa,2219,3,17,11,8,59,35,24,62
Airdrieon,2219,4,17,8,11,56,50,6,59
Peterhead,2219,5,17,5,14,55,52,3,56
Albion,2219,6,14,10,12,54,47,7,52
Queen's Park,2219,7,10,9,17,33,48,-15,39
Stranraer,2219,8,10,7,19,48,65,-17,37
East Fife,2219,9,8,11,17,39,46,-7,35
Stenhousem'r,2219,10,8,7,21,43,84,-41,31
Livingston,2220,1,23,5,8,81,41,40,74
Alloa,2220,2,17,7,12,65,47,18,58
Airdrieon,2220,3,17,7,12,65,60,5,58
Brechin,2220,4,15,10,11,45,43,2,55
Peterhead,2220,5,16,6,14,54,60,-6,54
Albion,2220,6,13,8,15,56,55,1,47
Queen's Park,2220,7,13,8,15,45,56,-11,47
East Fife,2220,8,10,11,15,48,48,0,41
Stranraer,2220,9,11,7,18,49,59,-10,40
Stenhousem'r,2220,10,7,7,22,45,84,-39,28
Livingston,2221,1,22,4,10,76,47,29,70
Alloa,2221,2,20,7,9,66,43,23,67
Airdrieon,2221,3,21,3,12,65,50,15,66
Peterhead,2221,4,17,5,14,49,48,1,56
Brechin,2221,5,16,6,14,54,50,4,54
East Fife,2221,6,12,12,12,46,37,9,48
Queen's Park,2221,7,14,6,16,37,49,-12,48
Albion,2221,8,11,7,18,42,54,-12,40
Stranraer,2221,9,10,8,18,46,59,-13,38
Stenhousem'r,2221,10,5,6,25,37,81,-44,21
Alloa,2222,1,19,8,9,72,38,34,65
Livingston,2222,2,20,4,12,77,49,28,64
Brechin,2222,3,18,5,13,55,49,6,59
Airdrieon,2222,4,16,9,11,61,52,9,57
Stranraer,2222,5,16,8,12,57,58,-1,56
East Fife,2222,6,12,10,14,45,46,-1,46
Peterhead,2222,7,11,11,14,43,49,-6,44
Albion,2222,8,11,10,15,50,59,-9,43
Queen's Park,2222,9,10,6,20,29,55,-26,36
Stenhousem'r,2222,10,7,9,20,47,81,-34,30
Livingston,2223,1,23,6,7,84,41,43,75
Alloa,2223,2,16,10,10,63,51,12,58
Airdrieon,2223,3,16,9,11,51,43,8,57
Peterhead,2223,4,16,7,13,46,50,-4,55
Brechin,2223,5,14,10,12,51,53,-2,52
Albion,2223,6,12,11,13,56,49,7,47
East Fife,2223,7,12,11,13,48,42,6,47
Queen's Park,2223,8,12,11,13,36,48,-12,47
Stranraer,2223,9,7,11,18,41,61,-20,32
Stenhousem'r,2223,10,5,8,23,41,79,-38,23
Livingston,2224,1,21,4,11,79,52,27,67
Alloa,2224,2,20,6,10,74,46,28,66
Brechin,2224,3,17,4,15,46,45,1,55
Albion,2224,4,12,11,13,54,57,-3,47
Peterhead,2224,5,13,8,15,42,52,-10,47
East Fife,2224,6,12,10,14,55,49,6,46
Stranraer,2224,7,14,4,18,48,57,-9,46
Airdrieon,2224,8,14,4,18,47,58,-11,46
Queen's Park,2224,9,12,9,15,43,56,-13,45
Stenhousem'r,2224,10,10,10,16,56,72,-16,40
Livingston,2225,1,21,6,9,74,43,31,69
Brechin,2225,2,19,7,10,60,40,20,64
Alloa,2225,3,18,6,12,70,51,19,60
Airdrieon,2225,4,16,7,13,64,55,9,55
Peterhead,2225,5,14,7,15,56,61,-5,49
Stranraer,2225,6,14,4,18,49,56,-7,46
East Fife,2225,7,11,11,14,45,50,-5,44
Albion,2225,8,9,16,11,49,57,-8,43
Queen's Park,2225,9,11,8,17,36,48,-12,41
Stenhousem'r,2225,10,6,10,20,40,82,-42,28
Alloa,2226,1,21,8,7,77,40,37,71
Livingston,2226,2,21,3,12,76,48,28,66
Albion,2226,3,17,6,13,63,49,14,57
Airdrieon,2226,4,17,6,13,59,62,-3,57
Brechin,2226,5,16,8,12,53,46,7,56
Peterhead,2226,6,16,6,14,47,48,-1,54
East Fife,2226,7,13,8,15,58,56,2,47
Queen's Park,2226,8,11,5,20,38,60,-22,38
Stranraer,2226,9,11,4,21,51,75,-24,37
Stenhousem'r,2226,10,6,8,22,45,83,-38,26
Livingston,2227,1,18,9,9,75,52,23,63
Alloa,2227,2,16,12,8,67,47,20,60
Stranraer,2227,3,16,7,13,60,55,5,55
Albion,2227,4,15,9,12,57,47,10,54
Airdrieon,2227,5,16,6,14,59,57,2,54
Brechin,2227,6,15,7,14,43,49,-6,52
Queen's Park,2227,7,13,12,11,50,47,3,51
East Fife,2227,8,12,9,15,48,49,-1,45
Peterhead,2227,9,10,6,20,50,72,-22,36
Stenhousem'r,2227,10,7,7,22,45,79,-34,28
Alloa,2228,1,20,11,5,77,43,34,71
Livingston,2228,2,21,1,14,73,55,18,64
Airdrieon,2228,3,16,13,7,64,49,15,61
Queen's Park,2228,4,14,10,12,33,38,-5,52
Brechin,2228,5,14,8,14,50,50,0,50
Albion,2228,6,12,11,13,53,55,-2,47
Peterhead,2228,7,13,7,16,50,50,0,46
East Fife,2228,8,9,13,14,42,46,-4,40
Stranraer,2228,9,10,6,20,40,62,-22,36
Stenhousem'r,2228,10,8,6,22,43,77,-34,30
Alloa,2229,1,20,9,7,77,40,37,69
Livingston,2229,2,17,6,13,62,50,12,57
Airdrieon,2229,3,16,8,12,58,58,0,56
Albion,2229,4,16,7,13,65,58,7,55
Brechin,2229,5,16,4,16,53,55,-2,52
Stranraer,2229,6,14,6,16,52,57,-5,48
Peterhead,2229,7,13,8,15,49,55,-6,47
East Fife,2229,8,12,10,14,46,44,2,46
Queen's Park,2229,9,13,7,16,37,49,-12,46
Stenhousem'r,2229,10,7,7,22,44,77,-33,28
Livingston,2230,1,21,9,6,79,46,33,72
Alloa,2230,2,21,6,9,81,42,39,69
Brechin,2230,3,15,7,14,50,50,0,52
Stranraer,2230,4,15,5,16,50,50,0,50
Airdrieon,2230,5,13,9,14,47,55,-8,48
Queen's Park,2230,6,12,11,13,47,55,-8,47
East Fife,2230,7,11,13,12,50,43,7,46
Peterhead,2230,8,11,9,16,41,55,-14,42
Albion,2230,9,10,10,16,54,66,-12,40
Stenhousem'r,2230,10,6,11,19,37,74,-37,29
Alloa,2231,1,19,8,9,75,43,32,65
Livingston,2231,2,19,4,13,75,55,20,61
Airdrieon,2231,3,18,6,12,60,52,8,60
Brechin,2231,4,15,7,14,50,53,-3,52
Peterhead,2231,5,14,7,15,56,58,-2,49
Stenhousem'r,2231,6,13,10,13,53,64,-11,49
Albion,2231,7,12,11,13,50,60,-10,47
Stranraer,2231,8,13,6,17,48,60,-12,45
Queen's Park,2231,9,9,11,16,33,48,-15,38
East Fife,2231,10,9,8,19,50,57,-7,35
Livingston,2232,1,21,8,7,83,43,40,71
Brechin,2232,2,21,6,9,51,32,19,69
Alloa,2232,3,15,11,10,58,38,20,56
Airdrieon,2232,4,14,9,13,56,58,-2,51
Peterhead,2232,5,14,8,14,45,51,-6,50
Albion,2232,6,12,11,13,56,57,-1,47
Queen's Park,2232,7,10,11,15,29,51,-22,41
East Fife,2232,8,9,13,14,43,48,-5,40
Stranraer,2232,9,10,9,17,46,58,-12,39
Stenhousem'r,2232,10,6,10,20,43,74,-31,28
Livingston,2233,1,26,3,7,88,49,39,81
Alloa,2233,2,18,9,9,65,42,23,63
Brechin,2233,3,17,6,13,53,46,7,57
Albion,2233,4,16,7,13,67,60,7,55
Airdrieon,2233,5,13,11,12,60,52,8,50
Peterhead,2233,6,14,7,15,53,60,-7,49
Stranraer,2233,7,12,8,16,49,61,-12,44
Queen's Park,2233,8,10,8,18,47,60,-13,38
East Fife,2233,9,9,10,17,50,57,-7,37
Stenhousem'r,2233,10,6,9,21,44,89,-45,27
Alloa,2234,1,22,5,9,82,43,39,71
Livingston,2234,2,21,2,13,78,52,26,65
Brechin,2234,3,18,4,14,45,38,7,58
Airdrieon,2234,4,17,5,14,56,51,5,56
Albion,2234,5,15,5,16,53,54,-1,50
East Fife,2234,6,13,10,13,51,48,3,49
Peterhead,2234,7,13,9,14,54,62,-8,48
Queen's Park,2234,8,13,4,19,38,57,-19,43
Stranraer,2234,9,11,5,20,42,58,-16,38
Stenhousem'r,2234,10,10,5,21,47,83,-36,35
Livingston,2235,1,22,4,10,75,45,30,70
Alloa,2235,2,18,7,11,80,51,29,61
Brechin,2235,3,18,6,12,67,53,14,60
Airdrieon,2235,4,15,9,12,61,53,8,54
Queen's Park,2235,5,13,10,13,38,47,-9,49
Stranraer,2235,6,13,7,16,50,59,-9,46
Albion,2235,7,12,8,16,48,54,-6,44
East Fife,2235,8,11,10,15,49,54,-5,43
Peterhead,2235,9,10,7,19,44,69,-25,37
Stenhousem'r,2235,10,9,10,17,51,78,-27,37
Livingston,2236,1,19,4,13,75,50,25,61
Airdrieon,2236,2,17,8,11,58,52,6,59
Albion,2236,3,16,8,12,58,51,7,56
Alloa,2236,4,16,7,13,69,50,19,55
East Fife,2236,5,15,9,12,52,43,9,54
Peterhead,2236,6,15,9,12,40,44,-4,54
Brechin,2236,7,15,8,13,47,48,-1,53
Queen's Park,2236,8,13,6,17,36,50,-14,45
Stranraer,2236,9,11,7,18,50,65,-15,40
Stenhousem'r,2236,10,6,8,22,46,78,-32,26
Livingston,2237,1,22,4,10,75,44,31,70
Brechin,2237,2,22,2,12,58,41,17,68
Airdrieon,2237,3,17,6,13,62,48,14,57
Alloa,2237,4,16,7,13,69,44,25,55
Stranraer,2237,5,16,5,15,54,55,-1,53
Peterhead,2237,6,15,6,15,55,54,1,51
East Fife,2237,7,13,4,19,50,58,-8,43
Albion,2237,8,11,9,16,48,65,-17,42
Stenhousem'r,2237,9,10,7,19,48,85,-37,37
Queen's Park,2237,10,10,6,20,31,56,-25,36
Livingston,2238,1,19,4,13,69,54,15,61
Albion,2238,2,16,9,11,55,49,6,57
Alloa,2238,3,16,8,12,68,54,14,56
Brechin,2238,4,16,7,13,51,45,6,55
Airdrieon,2238,5,15,7,14,66,58,8,52
Queen's Park,2238,6,14,10,12,42,47,-5,52
Peterhead,2238,7,13,8,15,47,55,-8,47
East Fife,2238,8,12,9,15,44,42,2,45
Stranraer,2238,9,12,6,18,44,55,-11,42
Stenhousem'r,2238,10,10,6,20,55,82,-27,36
Livingston,2239,1,24,3,9,81,47,34,75
Alloa,2239,2,20,8,8,68,42,26,68
Airdrieon,2239,3,19,6,11,67,56,11,63
Brechin,2239,4,16,7,13,54,54,0,55
Albion,2239,5,13,10,13,53,50,3,49
Peterhead,2239,6,13,8,15,47,56,-9,47
Stranraer,2239,7,12,8,16,58,60,-2,44
Queen's Park,2239,8,12,6,18,39,49,-10,42
East Fife,2239,9,10,7,19,46,58,-12,37
Stenhousem'r,2239,10,6,7,23,44,85,-41,25
Alloa,2240,1,20,9,7,72,39,33,69
Airdrieon,2240,2,19,5,12,59,62,-3,62
Livingston,2240,3,16,9,11,69,53,16,57
East Fife,2240,4,16,7,13,57,39,18,55
Brechin,2240,5,16,5,15,44,46,-2,53
Peterhead,2240,6,13,11,12,54,49,5,50
Albion,2240,7,12,9,15,49,51,-2,45
Stranraer,2240,8,12,7,17,52,62,-10,43
Queen's Park,2240,9,8,10,18,35,55,-20,34
Stenhousem'r,2240,10,7,10,19,45,80,-35,31
Livingston,2241,1,20,4,12,76,45,31,64
Alloa,2241,2,19,7,10,69,42,27,64
Albion,2241,3,15,9,12,65,53,12,54
Airdrieon,2241,4,16,5,15,54,66,-12,53
Peterhead,2241,5,14,10,12,51,49,2,52
Brechin,2241,6,15,7,14,47,53,-6,52
Stranraer,2241,7,15,6,15,55,55,0,51
Queen's Park,2241,8,13,7,16,37,48,-11,46
East Fife,2241,9,9,11,16,51,52,-1,38
Stenhousem'r,2241,10,8,6,22,41,83,-42,30
Alloa,2242,1,20,9,7,80,43,37,69
Livingston,2242,2,19,2,15,64,54,10,59
Airdrieon,2242,3,17,6,13,57,58,-1,57
Albion,2242,4,16,8,12,62,56,6,56
East Fife,2242,5,14,9,13,53,42,11,51
Brechin,2242,6,14,6,16,46,46,0,48
Queen's Park,2242,7,13,9,14,36,45,-9,48
Peterhead,2242,8,13,8,15,48,52,-4,47
Stranraer,2242,9,11,6,19,52,61,-9,39
Stenhousem'r,2242,10,8,7,21,47,88,-41,31
Livingston,2243,1,23,3,10,81,46,35,72
Alloa,2243,2,16,13,7,66,42,24,61
Airdrieon,2243,3,18,7,11,57,49,8,61
Peterhead,2243,4,14,12,10,49,44,5,54
Brechin,2243,5,14,8,14,47,52,-5,50
Albion,2243,6,14,7,15,57,54,3,49
East Fife,2243,7,13,8,15,52,55,-3,47
Queen's Park,2243,8,12,6,18,50,69,-19,42
Stranraer,2243,9,9,8,19,43,61,-18,35
Stenhousem'r,2243,10,6,10,20,44,74,-30,28
Livingston,2244,1,23,4,9,85,44,41,73
Airdrieon,2244,2,16,10,10,59,53,6,58
Brechin,2244,3,16,7,13,50,46,4,55
Alloa,2244,4,15,9,12,56,43,13,54
Albion,2244,5,15,7,14,56,50,6,52
Peterhead,2244,6,12,10,14,48,56,-8,46
East Fife,2244,7,13,6,17,49,51,-2,45
Stranraer,2244,8,12,7,17,50,63,-13,43
Stenhousem'r,2244,9,10,8,18,49,76,-27,38
Queen's Park,2244,10,9,10,17,41,61,-20,37
Livingston,2245,1,21,6,9,80,45,35,69
Airdrieon,2245,2,18,6,12,62,57,5,60
Stranraer,2245,3,18,4,14,57,58,-1,58
Alloa,2245,4,15,11,10,62,47,15,56
Albion,2245,5,16,7,13,65,54,11,55
Brechin,2245,6,14,10,12,49,46,3,52
Peterhead,2245,7,14,9,13,56,51,5,51
Queen's Park,2245,8,13,7,16,46,54,-8,46
East Fife,2245,9,6,10,20,40,61,-21,28
Stenhousem'r,2245,10,5,10,21,46,90,-44,25
Livingston,2246,1,23,4,9,76,43,33,73
Alloa,2246,2,17,9,10,79,51,28,60
Brechin,2246,3,17,8,11,49,44,5,59
Airdrieon,2246,4,15,7,14,54,54,0,52
Peterhead,2246,5,13,12,11,50,50,0,51
Albion,2246,6,12,11,13,56,52,4,47
East Fife,2246,7,11,10,15,53,56,-3,43
Queen's Park,2246,8,12,7,17,35,58,-23,43
Stranraer,2246,9,12,5,19,49,59,-10,41
Stenhousem'r,2246,10,7,9,20,52,86,-34,30
Livingston,2247,1,20,6,10,74,48,26,66
Alloa,2247,2,18,9,9,66,44,22,63
Airdrieon,2247,3,15,10,11,65,53,12,55
Brechin,2247,4,16,4,16,47,48,-1,52
Albion,2247,5,15,6,15,56,53,3,51
Peterhead,2247,6,13,11,12,43,47,-4,50
East Fife,2247,7,13,9,14,59,55,4,48
Stranraer,2247,8,13,7,16,48,60,-12,46
Queen's Park,2247,9,10,9,17,46,63,-17,39
Stenhousem'r,2247,10,6,11,19,49,82,-33,29
Airdrieon,2248,1,20,7,9,60,44,16,67
Brechin,2248,2,21,4,11,50,41,9,67
Alloa,2248,3,17,10,9,69,45,24,61
Livingston,2248,4,15,7,14,67,54,13,52
Albion,2248,5,15,6,15,51,50,1,51
Peterhead,2248,6,13,11,12,48,49,-1,50
East Fife,2248,7,10,12,14,50,52,-2,42
Stranraer,2248,8,13,3,20,56,62,-6,42
Queen's Park,2248,9,11,8,17,37,61,-24,41
Stenhousem'r,2248,10,8,6,22,53,83,-30,30
Livingston,2249,1,22,5,9,70,43,27,71
Alloa,2249,2,18,9,9,67,39,28,63
Albion,2249,3,17,9,10,64,54,10,60
Airdrieon,2249,4,17,4,15,58,61,-3,55
Brechin,2249,5,14,10,12,52,50,2,52
Queen's Park,2249,6,15,3,18,46,56,-10,48
East Fife,2249,7,12,9,15,46,48,-2,45
Peterhead,2249,8,12,7,17,53,64,-11,43
Stranraer,2249,9,11,5,20,46,63,-17,38
Stenhousem'r,2249,10,7,9,20,52,76,-24,30
Livingston,2250,1,21,5,10,84,54,30,68
Brechin,2250,2,18,4,14,54,46,8,58
Albion,2250,3,17,7,12,52,46,6,58
Alloa,2250,4,16,8,12,71,47,24,56
Stranraer,2250,5,16,5,15,58,58,0,53
Airdrieon,2250,6,14,8,14,54,55,-1,50
East Fife,2250,7,12,11,13,52,45,7,47
Peterhead,2250,8,11,10,15,50,53,-3,43
Queen's Park,2250,9,12,4,20,36,66,-30,40
Stenhousem'r,2250,10,9,6,21,44,85,-41,33
Airdrieon,2251,1,20,8,8,74,55,19,68
Livingston,2251,2,20,6,10,74,50,24,66
Alloa,2251,3,18,8,10,64,47,17,62
Albion,2251,4,16,8,12,58,55,3,56
Brechin,2251,5,15,8,13,50,46,4,53
Peterhead,2251,6,13,10,13,54,53,1,49
Queen's Park,2251,7,13,8,15,36,45,-9,47
East Fife,2251,8,10,12,14,41,41,0,42
Stranraer,2251,9,9,6,21,43,55,-12,33
Stenhousem'r,2251,10,6,6,24,42,89,-47,24
Alloa,2252,1,20,10,6,75,35,40,70
Livingston,2252,2,20,5,11,72,50,22,65
Airdrieon,2252,3,17,8,11,67,60,7,59
Brechin,2252,4,17,4,15,50,45,5,55
Peterhead,2252,5,12,13,11,49,46,3,49
Albion,2252,6,14,5,17,55,58,-3,47
East Fife,2252,7,11,10,15,47,49,-2,43
Stranraer,2252,8,13,4,19,53,69,-16,43
Queen's Park,2252,9,11,6,19,35,53,-18,39
Stenhousem'r,2252,10,8,9,19,49,87,-38,33
Alloa,2253,1,21,6,9,69,40,29,69
Livingston,2253,2,19,6,11,65,40,25,63
Airdrieon,2253,3,18,8,10,61,48,13,62
East Fife,2253,4,15,8,13,43,41,2,53
Albion,2253,5,13,13,10,49,43,6,52
Brechin,2253,6,15,6,15,48,53,-5,51
Stranraer,2253,7,15,5,16,47,53,-6,50
Queen's Park,2253,8,13,5,18,38,50,-12,44
Peterhead,2253,9,10,7,19,38,56,-18,37
Stenhousem'r,2253,10,5,8,23,34,68,-34,23
Livingston,2254,1,23,6,7,78,36,42,75
Alloa,2254,2,19,8,9,76,44,32,65
Brechin,2254,3,17,7,12,55,51,4,58
Stranraer,2254,4,17,6,13,56,49,7,57
Airdrieon,2254,5,14,7,15,60,63,-3,49
Peterhead,2254,6,14,6,16,55,50,5,48
Albion,2254,7,13,7,16,46,63,-17,46
East Fife,2254,8,10,12,14,52,58,-6,42
Queen's Park,2254,9,9,8,19,32,55,-23,35
Stenhousem'r,2254,10,6,9,21,43,84,-41,27
Alloa,2255,1,21,7,8,79,39,40,70
Livingston,2255,2,22,3,11,72,50,22,69
Brechin,2255,3,17,5,14,44,48,-4,56
Albion,2255,4,15,6,15,56,53,3,51
East Fife,2255,5,13,8,15,48,43,5,47
Airdrieon,2255,6,14,5,17,49,63,-14,47
Stranraer,2255,7,14,4,18,53,58,-5,46
Peterhead,2255,8,13,7,16,42,53,-11,46
Queen's Park,2255,9,12,7,17,39,46,-7,43
Stenhousem'r,2255,10,10,6,20,42,71,-29,36
Livingston,2256,1,23,3,10,82,52,30,72
Alloa,2256,2,21,7,8,74,42,32,70
Brechin,2256,3,20,3,13,50,44,6,63
Airdrieon,2256,4,17,6,13,61,60,1,57
Albion,2256,5,13,10,13,54,54,0,49
Peterhead,2256,6,13,7,16,44,52,-8,46
East Fife,2256,7,11,9,16,51,48,3,42
Stranraer,2256,8,11,8,17,46,57,-11,41
Queen's Park,2256,9,11,7,18,36,53,-17,40
Stenhousem'r,2256,10,5,10,21,40,76,-36,25
Alloa,2257,1,20,5,11,74,44,30,65
Livingston,2257,2,20,5,11,79,50,29,65
Brechin,2257,3,20,4,12,54,40,14,64
Peterhead,2257,4,18,6,12,55,50,5,60
Airdrieon,2257,5,14,8,14,55,55,0,50
Stranraer,2257,6,13,9,14,46,51,-5,48
Albion,2257,7,13,8,15,57,55,2,47
East Fife,2257,8,9,13,14,45,49,-4,40
Queen's Park,2257,9,9,8,19,31,59,-28,35
Stenhousem'r,2257,10,7,8,21,44,87,-43,29
Livingston,2258,1,22,5,9,74,51,23,71
Alloa,2258,2,18,9,9,72,42,30,63
Airdrieon,2258,3,19,4,13,58,53,5,61
Brechin,2258,4,15,5,16,47,48,-1,50
East Fife,2258,5,12,11,13,54,48,6,47
Peterhead,2258,6,12,9,15,45,57,-12,45
Stranraer,2258,7,12,8,16,54,64,-10,44
Albion,2258,8,11,8,17,43,51,-8,41
Queen's Park,2258,9,10,11,15,41,52,-11,41
Stenhousem'r,2258,10,9,10,17,50,72,-22,37
Alloa,2259,1,18,8,10,67,46,21,62
Livingston,2259,2,18,5,13,66,43,23,59
Brechin,2259,3,16,10,10,52,41,11,58
Stranraer,2259,4,15,5,16,55,57,-2,50
Queen's Park,2259,5,14,8,14,40,52,-12,50
Peterhead,2259,6,12,12,12,51,56,-5,48
Airdrieon,2259,7,14,6,16,53,60,-7,48
Albion,2259,8,11,10,15,47,53,-6,43
East Fife,2259,9,9,13,14,44,47,-3,40
Stenhousem'r,2259,10,11,7,18,52,72,-20,40
Alloa,2260,1,21,7,8,73,38,35,70
Livingston,2260,2,20,5,11,85,57,28,65
Brechin,2260,3,17,9,10,54,39,15,60
Airdrieon,2260,4,18,6,12,57,55,2,60
East Fife,2260,5,13,9,14,53,47,6,48
Peterhead,2260,6,13,7,16,58,60,-2,46
Queen's Park,2260,7,13,7,16,39,51,-12,46
Stranraer,2260,8,12,8,16,53,65,-12,44
Albion,2260,9,11,4,21,48,65,-17,37
Stenhousem'r,2260,10,8,6,22,49,92,-43,30
Alloa,2261,1,22,8,6,75,41,34,74
Livingston,2261,2,21,3,12,77,49,28,66
Airdrieon,2261,3,19,7,10,68,50,18,64
Stranraer,2261,4,18,5,13,57,50,7,59
Brechin,2261,5,15,7,14,49,54,-5,52
Peterhead,2261,6,15,5,16,53,54,-1,50
Albion,2261,7,10,11,15,50,58,-8,41
East Fife,2261,8,9,9,18,49,57,-8,36
Queen's Park,2261,9,10,6,20,31,60,-29,36
Stenhousem'r,2261,10,7,7,22,47,83,-36,28
Livingston,2262,1,23,4,9,72,43,29,73
Airdrieon,2262,2,19,7,10,63,44,19,64
Alloa,2262,3,17,11,8,64,40,24,62
Albion,2262,4,16,7,13,55,49,6,55
Brechin,2262,5,15,8,13,55,50,5,53
Stranraer,2262,6,12,7,17,46,55,-9,43
Queen's Park,2262,7,12,6,18,38,57,-19,42
Peterhead,2262,8,11,7,18,45,60,-15,40
East Fife,2262,9,10,8,18,45,57,-12,38
Stenhousem'r,2262,10,8,9,19,41,69,-28,33
Livingston,2263,1,23,2,11,77,50,27,71
Brechin,2263,2,18,6,12,55,47,8,60
Alloa,2263,3,17,7,12,65,51,14,58
Albion,2263,4,16,8,12,57,52,5,56
Airdrieon,2263,5,16,8,12,55,52,3,56
Stranraer,2263,6,15,7,14,62,56,6,52
East Fife,2263,7,9,14,13,59,59,0,41
Peterhead,2263,8,11,7,18,46,57,-11,40
Queen's Park,2263,9,12,4,20,38,59,-21,40
Stenhousem'r,2263,10,9,5,22,46,77,-31,32
Alloa,2264,1,17,12,7,73,39,34,63
Livingston,2264,2,18,6,12,67,52,15,60
Airdrieon,2264,3,16,7,13,50,50,0,55
Brechin,2264,4,17,4,15,49,53,-4,55
Queen's Park,2264,5,15,7,14,33,38,-5,52
Stranraer,2264,6,14,6,16,42,51,-9,48
East Fife,2264,7,12,11,13,53,50,3,47
Peterhead,2264,8,13,7,16,47,50,-3,46
Albion,2264,9,11,8,17,43,46,-3,41
Stenhousem'r,2264,10,10,6,20,46,74,-28,36
Alloa,2265,1,23,7,6,78,37,41,76
Livingston,2265,2,22,2,12,82,49,33,68
Brechin,2265,3,18,8,10,51,45,6,62
Airdrieon,2265,4,17,7,12,66,53,13,58
Albion,2265,5,14,7,15,44,49,-5,49
East Fife,2265,6,12,9,15,53,45,8,45
Peterhead,2265,7,12,8,16,43,52,-9,44
Queen's Park,2265,8,9,11,16,35,56,-21,38
Stenhousem'r,2265,9,9,7,20,54,92,-38,34
Stranraer,2265,10,9,4,23,45,73,-28,31
Livingston,2266,1,22,3,11,70,43,27,69
Alloa,2266,2,18,7,11,63,43,20,61
Airdrieon,2266,3,18,6,12,66,53,13,60
Albion,2266,4,16,8,12,62,54,8,56
Brechin,2266,5,15,11,10,51,45,6,56
Peterhead,2266,6,14,5,17,47,60,-13,47
Stranraer,2266,7,14,4,18,49,60,-11,46
Queen's Park,2266,8,12,6,18,40,54,-14,42
East Fife,2266,9,9,9,18,44,51,-7,36
Stenhousem'r,2266,10,10,5,21,48,77,-29,35
Livingston,2267,1,21,5,10,82,51,31,68
Alloa,2267,2,17,10,9,72,41,31,61
Airdrieon,2267,3,17,8,11,58,56,2,59
Brechin,2267,4,15,9,12,51,55,-4,54
Stranraer,2267,5,15,8,13,57,50,7,53
East Fife,2267,6,14,5,17,48,43,5,47
Albion,2267,7,13,8,15,46,47,-1,47
Queen's Park,2267,8,11,9,16,38,57,-19,42
Stenhousem'r,2267,9,11,4,21,50,82,-32,37
Peterhead,2267,10,9,8,19,39,59,-20,35
Alloa,2268,1,20,7,9,78,42,36,67
Livingston,2268,2,20,6,10,68,48,20,66
Peterhead,2268,3,18,6,12,54,51,3,60
Airdrieon,2268,4,18,5,13,61,54,7,59
Queen's Park,2268,5,18,4,14,38,44,-6,58
Brechin,2268,6,15,5,16,48,49,-1,50
East Fife,2268,7,12,6,18,44,47,-3,42
Albion,2268,8,10,10,16,48,62,-14,40
Stranraer,2268,9,11,6,19,47,63,-16,39
Stenhousem'r,2268,10,7,7,22,45,71,-26,28
Alloa,2269,1,19,7,10,70,47,23,64
Livingston,2269,2,18,6,12,78,60,18,60
Peterhead,2269,3,16,9,11,53,52,1,57
Brechin,2269,4,18,3,15,60,62,-2,57
Albion,2269,5,16,6,14,51,43,8,54
Stranraer,2269,6,15,7,14,64,61,3,52
Airdrieon,2269,7,14,8,14,60,63,-3,50
Queen's Park,2269,8,11,11,14,50,53,-3,44
East Fife,2269,9,11,8,17,56,59,-3,41
Stenhousem'r,2269,10,6,7,23,40,82,-42,25
Livingston,2270,1,24,4,8,87,44,43,76
Brechin,2270,2,18,8,10,50,46,4,62
Alloa,2270,3,16,10,10,71,51,20,58
Airdrieon,2270,4,17,5,14,53,52,1,56
Peterhead,2270,5,14,6,16,52,56,-4,48
Albion,2270,6,13,8,15,52,48,4,47
Queen's Park,2270,7,12,9,15,40,52,-12,45
Stranraer,2270,8,10,8,18,43,56,-13,38
East Fife,2270,9,8,12,16,38,51,-13,36
Stenhousem'r,2270,10,8,10,18,49,79,-30,34
Livingston,2271,1,23,5,8,82,45,37,74
Alloa,2271,2,20,5,11,68,46,22,65
Brechin,2271,3,16,8,12,48,48,0,56
Airdrieon,2271,4,15,9,12,63,59,4,54
Queen's Park,2271,5,15,8,13,45,44,1,53
Stranraer,2271,6,15,5,16,59,54,5,50
East Fife,2271,7,12,8,16,48,57,-9,44
Peterhead,2271,8,13,5,18,46,57,-11,44
Albion,2271,9,10,9,17,43,62,-19,39
Stenhousem'r,2271,10,6,8,22,44,74,-30,26
Livingston,2272,1,27,1,8,86,51,35,82
Alloa,2272,2,20,8,8,73,45,28,68
Stranraer,2272,3,17,4,15,59,53,6,55
East Fife,2272,4,14,9,13,53,44,9,51
Brechin,2272,5,13,10,13,53,50,3,49
Airdrieon,2272,6,13,10,13,57,62,-5,49
Peterhead,2272,7,13,9,14,47,48,-1,48
Albion,2272,8,11,8,17,48,58,-10,41
Stenhousem'r,2272,9,7,9,20,41,74,-33,30
Queen's Park,2272,10,7,8,21,31,63,-32,29
Livingston,2273,1,22,4,10,75,47,28,70
Alloa,2273,2,17,11,8,66,44,22,62
Airdrieon,2273,3,16,8,12,61,57,4,56
Albion,2273,4,15,8,13,51,48,3,53
Brechin,2273,5,13,11,12,56,52,4,50
Peterhead,2273,6,12,14,10,48,46,2,50
Queen's Park,2273,7,13,9,14,46,55,-9,48
Stranraer,2273,8,13,3,20,48,58,-10,42
Stenhousem'r,2273,9,10,7,19,51,75,-24,37
East Fife,2273,10,8,7,21,46,66,-20,31
Livingston,2274,1,22,3,11,67,47,20,69
Alloa,2274,2,18,10,8,68,36,32,64
Airdrieon,2274,3,17,11,8,61,49,12,62
Brechin,2274,4,14,8,14,40,39,1,50
Queen's Park,2274,5,14,6,16,43,54,-11,48
Albion,2274,6,13,7,16,49,54,-5,46
East Fife,2274,7,12,9,15,51,50,1,45
Peterhead,2274,8,11,11,14,40,49,-9,44
Stranraer,2274,9,12,5,19,53,64,-11,41
Stenhousem'r,2274,10,9,6,21,49,79,-30,33
Livingston,2275,1,20,7,9,67,38,29,67
Airdrieon,2275,2,19,8,9,59,44,15,65
Alloa,2275,3,17,11,8,59,42,17,62
Brechin,2275,4,14,14,8,49,40,9,56
East Fife,2275,5,12,13,11,54,42,12,49
Peterhead,2275,6,12,11,13,52,56,-4,47
Albion,2275,7,11,12,13,53,48,5,45
Queen's Park,2275,8,11,7,18,34,55,-21,40
Stranraer,2275,9,11,4,21,50,65,-15,37
Stenhousem'r,2275,10,6,7,23,39,86,-47,25
Livingston,2276,1,21,3,12,79,53,26,66
Alloa,2276,2,18,8,10,70,44,26,62
Airdrieon,2276,3,17,7,12,59,53,6,58
Queen's Park,2276,4,15,11,10,55,46,9,56
Brechin,2276,5,15,5,16,47,54,-7,50
Albion,2276,6,14,7,15,52,57,-5,49
Stranraer,2276,7,14,4,18,46,56,-10,46
Peterhead,2276,8,12,8,16,50,54,-4,44
East Fife,2276,9,10,10,16,38,44,-6,40
Stenhousem'r,2276,10,7,11,18,43,78,-35,32
Alloa,2277,1,21,6,9,73,37,36,69
Livingston,2277,2,20,8,8,77,44,33,68
Airdrieon,2277,3,19,8,9,59,45,14,65
Stranraer,2277,4,15,7,14,58,57,1,52
Peterhead,2277,5,14,9,13,49,43,6,51
East Fife,2277,6,12,13,11,49,35,14,49
Albion,2277,7,13,8,15,47,54,-7,47
Brechin,2277,8,13,7,16,41,60,-19,46
Queen's Park,2277,9,8,10,18,33,54,-21,34
Stenhousem'r,2277,10,3,8,25,35,92,-57,17
Alloa,2278,1,19,8,9,68,40,28,65
Livingston,2278,2,19,7,10,68,45,23,64
Airdrieon,2278,3,18,6,12,64,57,7,60
Brechin,2278,4,18,5,13,53,53,0,59
Albion,2278,5,14,7,15,51,45,6,49
Peterhead,2278,6,13,9,14,51,52,-1,48
Queen's Park,2278,7,13,8,15,38,47,-9,47
East Fife,2278,8,11,8,17,54,58,-4,41
Stranraer,2278,9,11,8,17,45,58,-13,41
Stenhousem'r,2278,10,7,8,21,45,82,-37,29
Alloa,2279,1,21,9,6,80,41,39,72
Peterhead,2279,2,22,5,9,59,46,13,71
Livingston,2279,3,20,4,12,75,46,29,64
Brechin,2279,4,18,6,12,59,53,6,60
Airdrieon,2279,5,15,8,13,61,57,4,53
Albion,2279,6,11,10,15,52,57,-5,43
Queen's Park,2279,7,10,10,16,38,57,-19,40
Stranraer,2279,8,10,8,18,41,61,-20,38
East Fife,2279,9,8,9,19,43,56,-13,33
Stenhousem'r,2279,10,4,13,19,41,75,-34,25
Alloa,2280,1,23,4,9,75,40,35,73
Livingston,2280,2,21,6,9,81,47,34,69
Albion,2280,3,18,7,11,57,48,9,61
Brechin,2280,4,17,4,15,54,55,-1,55
Airdrieon,2280,5,16,6,14,60,60,0,54
Stranraer,2280,6,13,6,17,57,62,-5,45
East Fife,2280,7,12,6,18,54,53,1,42
Queen's Park,2280,8,11,9,16,38,55,-17,42
Peterhead,2280,9,10,8,18,41,57,-16,38
Stenhousem'r,2280,10,7,8,21,41,81,-40,29
Brechin,2281,1,18,7,11,63,49,14,61
Airdrieon,2281,2,17,8,11,58,52,6,59
Livingston,2281,3,18,4,14,71,58,13,58
Alloa,2281,4,16,7,13,66,57,9,55
Peterhead,2281,5,14,11,11,54,53,1,53
East Fife,2281,6,14,8,14,52,51,1,50
Albion,2281,7,14,7,15,54,52,2,49
Queen's Park,2281,8,13,8,15,42,49,-7,47
Stranraer,2281,9,13,5,18,53,57,-4,44
Stenhousem'r,2281,10,6,9,21,46,81,-35,27
Livingston,2282,1,21,4,11,83,49,34,67
Alloa,2282,2,19,7,10,73,46,27,64
Airdrieon,2282,3,18,5,13,63,60,3,59
Brechin,2282,4,16,7,13,51,46,5,55
Peterhead,2282,5,16,5,15,55,50,5,53
Stranraer,2282,6,16,4,16,54,60,-6,52
Queen's Park,2282,7,11,11,14,29,48,-19,44
Albion,2282,8,10,11,15,44,54,-10,41
East Fife,2282,9,8,10,18,46,53,-7,34
Stenhousem'r,2282,10,8,10,18,41,73,-32,34
Brechin,2283,1,20,9,7,61,38,23,69
Livingston,2283,2,19,7,10,77,49,28,64
Peterhead,2283,3,17,5,14,64,57,7,56
Alloa,2283,4,15,9,12,68,53,15,54
Airdrieon,2283,5,16,6,14,59,57,2,54
Albion,2283,6,13,9,14,47,52,-5,48
Queen's Park,2283,7,12,11,13,40,46,-6,47
East Fife,2283,8,9,11,16,50,57,-7,38
Stranraer,2283,9,9,10,17,46,66,-20,37
Stenhousem'r,2283,10,7,9,20,50,87,-37,30
Livingston,2284,1,22,1,13,70,50,20,67
Alloa,2284,2,19,7,10,67,43,24,64
Airdrieon,2284,3,19,6,11,62,47,15,63
Peterhead,2284,4,16,7,13,55,53,2,55
East Fife,2284,5,15,8,13,56,47,9,53
Stranraer,2284,6,16,5,15,47,51,-4,53
Brechin,2284,7,15,2,19,42,53,-11,47
Queen's Park,2284,8,13,8,15,37,48,-11,47
Albion,2284,9,8,7,21,43,61,-18,31
Stenhousem'r,2284,10,8,7,21,49,75,-26,31
Airdrieon,2285,1,21,7,8,68,51,17,70
Livingston,2285,2,21,4,11,74,55,19,67
Alloa,2285,3,17,6,13,76,62,14,57
Brechin,2285,4,15,6,15,49,53,-4,51
Queen's Park,2285,5,14,8,14,52,52,0,50
Albion,2285,6,13,9,14,57,61,-4,48
Peterhead,2285,7,11,9,16,47,55,-8,42
East Fife,2285,8,10,11,15,40,42,-2,41
Stenhousem'r,2285,9,11,8,17,46,69,-23,41
Stranraer,2285,10,11,4,21,54,63,-9,37
Livingston,2286,1,26,3,7,83,40,43,81
Alloa,2286,2,16,10,10,77,51,26,58
Stranraer,2286,3,18,4,14,62,56,6,58
Airdrieon,2286,4,16,5,15,58,58,0,53
Brechin,2286,5,15,8,13,45,47,-2,53
Albion,2286,6,14,7,15,58,53,5,49
East Fife,2286,7,12,11,13,49,46,3,47
Peterhead,2286,8,11,7,18,42,62,-20,40
Queen's Park,2286,9,10,8,18,33,54,-21,38
Stenhousem'r,2286,10,7,7,22,42,82,-40,28
Livingston,2287,1,22,3,11,77,45,32,69
Albion,2287,2,20,6,10,68,50,18,66
Airdrieon,2287,3,18,8,10,65,55,10,62
Brechin,2287,4,17,6,13,55,44,11,57
Alloa,2287,5,15,7,14,53,44,9,52
Peterhead,2287,6,15,7,14,51,52,-1,52
East Fife,2287,7,11,9,16,48,49,-1,42
Stranraer,2287,8,12,3,21,36,59,-23,39
Queen's Park,2287,9,11,5,20,33,57,-24,38
Stenhousem'r,2287,10,9,6,21,43,74,-31,33
Alloa,2288,1,20,9,7,80,46,34,69
Livingston,2288,2,20,7,9,75,51,24,67
Brechin,2288,3,19,4,13,59,50,9,61
Airdrieon,2288,4,15,7,14,61,59,2,52
Peterhead,2288,5,14,8,14,53,50,3,50
Albion,2288,6,12,8,16,58,58,0,44
Stranraer,2288,7,12,8,16,49,60,-11,44
East Fife,2288,8,12,7,17,57,64,-7,43
Queen's Park,2288,9,12,6,18,43,59,-16,42
Stenhousem'r,2288,10,7,10,19,54,92,-38,31
Alloa,2289,1,22,7,7,68,37,31,73
Livingston,2289,2,21,7,8,83,48,35,70
Brechin,2289,3,16,8,12,49,43,6,56
Airdrieon,2289,4,15,6,15,55,50,5,51
Albion,2289,5,13,8,15,49,51,-2,47
Stranraer,2289,6,12,8,16,56,55,1,44
Queen's Park,2289,7,10,13,13,34,43,-9,43
Peterhead,2289,8,11,10,15,43,56,-13,43
East Fife,2289,9,8,11,17,43,57,-14,35
Stenhousem'r,2289,10,9,8,19,49,89,-40,35
Alloa,2290,1,20,11,5,77,44,33,71
Livingston,2290,2,18,9,9,71,45,26,63
Airdrieon,2290,3,16,9,11,63,56,7,57
Brechin,2290,4,16,9,11,52,45,7,57
Albion,2290,5,12,9,15,54,58,-4,45
Peterhead,2290,6,11,10,15,41,52,-11,43
Queen's Park,2290,7,11,10,15,42,56,-14,43
East Fife,2290,8,9,15,12,42,41,1,42
Stranraer,2290,9,11,6,19,49,57,-8,39
Stenhousem'r,2290,10,8,8,20,45,82,-37,32
Livingston,2291,1,24,6,6,81,45,36,78
Alloa,2291,2,17,12,7,68,44,24,63
Airdrieon,2291,3,18,5,13,56,45,11,59
Peterhead,2291,4,15,7,14,59,56,3,52
East Fife,2291,5,12,11,13,50,46,4,47
Albion,2291,6,12,10,14,52,53,-1,46
Stranraer,2291,7,13,6,17,48,58,-10,45
Brechin,2291,8,13,6,17,40,51,-11,45
Queen's Park,2291,9,11,4,21,41,62,-21,37
Stenhousem'r,2291,10,7,9,20,46,81,-35,30
Livingston,2292,1,25,2,9,86,48,38,77
Brechin,2292,2,19,5,12,64,47,17,62
Airdrieon,2292,3,19,5,12,67,56,11,62
Albion,2292,4,17,7,12,54,51,3,58
Alloa,2292,5,16,5,15,63,54,9,53
Peterhead,2292,6,14,6,16,51,55,-4,48
Stranraer,2292,7,14,4,18,61,68,-7,46
East Fife,2292,8,12,7,17,54,48,6,43
Stenhousem'r,2292,9,9,7,20,43,73,-30,34
Queen's Park,2292,10,8,6,22,28,71,-43,30
Livingston,2293,1,24,4,8,77,45,32,76
Alloa,2293,2,19,7,10,69,45,24,64
Airdrieon,2293,3,14,9,13,51,55,-4,51
Peterhead,2293,4,14,8,14,54,53,1,50
Brechin,2293,5,14,8,14,39,42,-3,50
Queen's Park,2293,6,15,5,16,48,52,-4,50
Stenhousem'r,2293,7,12,8,16,55,71,-16,44
East Fife,2293,8,11,9,16,46,46,0,42
Albion,2293,9,10,9,17,49,58,-9,39
Stranraer,2293,10,10,7,19,45,66,-21,37
Livingston,2294,1,19,7,10,78,50,28,64
Alloa,2294,2,17,10,9,68,41,27,61
Albion,2294,3,16,7,13,50,45,5,55
Peterhead,2294,4,15,10,11,48,44,4,55
Airdrieon,2294,5,16,6,14,64,57,7,54
Stranraer,2294,6,16,5,15,60,57,3,53
Queen's Park,2294,7,12,11,13,34,45,-11,47
Brechin,2294,8,13,6,17,46,59,-13,45
East Fife,2294,9,11,7,18,44,54,-10,40
Stenhousem'r,2294,10,7,7,22,41,81,-40,28
Livingston,2295,1,20,4,12,71,46,25,64
Albion,2295,2,17,9,10,52,42,10,60
Alloa,2295,3,17,7,12,67,46,21,58
Peterhead,2295,4,16,7,13,46,47,-1,55
Brechin,2295,5,16,6,14,51,50,1,54
Airdrieon,2295,6,15,5,16,53,58,-5,50
East Fife,2295,7,14,7,15,51,45,6,49
Stranraer,2295,8,13,6,17,53,59,-6,45
Queen's Park,2295,9,9,11,16,34,55,-21,38
Stenhousem'r,2295,10,8,8,20,51,81,-30,32
Brechin,2296,1,20,6,10,62,39,23,66
Airdrieon,2296,2,18,10,8,61,45,16,64
Livingston,2296,3,19,4,13,69,47,22,61
Alloa,2296,4,17,7,12,56,43,13,58
Peterhead,2296,5,14,10,12,49,44,5,52
Albion,2296,6,13,7,16,40,52,-12,46
Queen's Park,2296,7,12,7,17,36,50,-14,43
East Fife,2296,8,11,9,16,40,42,-2,42
Stranraer,2296,9,11,6,19,48,62,-14,39
Stenhousem'r,2296,10,9,6,21,43,80,-37,33
Livingston,2297,1,22,7,7,83,42,41,73
Alloa,2297,2,20,7,9,74,41,33,67
Brechin,2297,3,17,5,14,50,44,6,56
Queen's Park,2297,4,16,6,14,37,49,-12,54
Airdrieon,2297,5,14,11,11,57,54,3,53
Albion,2297,6,13,10,13,49,55,-6,49
Peterhead,2297,7,12,10,14,54,57,-3,46
Stranraer,2297,8,13,5,18,47,58,-11,44
East Fife,2297,9,7,11,18,42,54,-12,32
Stenhousem'r,2297,10,5,10,21,49,88,-39,25
Livingston,2298,1,23,5,8,79,41,38,74
Alloa,2298,2,19,7,10,67,41,26,64
Brechin,2298,3,18,3,15,54,53,1,57
Peterhead,2298,4,14,13,9,55,45,10,55
Airdrieon,2298,5,17,4,15,62,62,0,55
Queen's Park,2298,6,15,4,17,40,55,-15,49
Albion,2298,7,13,8,15,52,55,-3,47
Stranraer,2298,8,14,4,18,50,58,-8,46
East Fife,2298,9,11,8,17,50,52,-2,41
Stenhousem'r,2298,10,5,6,25,39,86,-47,21
Livingston,2299,1,22,7,7,92,47,45,73
Alloa,2299,2,18,7,11,70,49,21,61
Airdrieon,2299,3,15,11,10,51,45,6,56
Peterhead,2299,4,15,10,11,50,46,4,55
Brechin,2299,5,15,8,13,55,49,6,53
Albion,2299,6,11,13,12,49,47,2,46
Queen's Park,2299,7,13,7,16,41,48,-7,46
East Fife,2299,8,12,9,15,46,54,-8,45
Stranraer,2299,9,10,6,20,44,66,-22,36
Stenhousem'r,2299,10,5,10,21,34,81,-47,25
Livingston,2300,1,20,5,11,76,50,26,65
Alloa,2300,2,18,8,10,62,39,23,62
Airdrieon,2300,3,18,5,13,62,55,7,59
Brechin,2300,4,17,6,13,58,47,11,57
East Fife,2300,5,15,8,13,51,46,5,53
Queen's Park,2300,6,14,5,17,34,48,-14,47
Stranraer,2300,7,13,7,16,50,56,-6,46
Peterhead,2300,8,13,7,16,40,51,-11,46
Albion,2300,9,12,7,17,50,62,-12,43
Stenhousem'r,2300,10,5,12,19,47,76,-29,27
Livingston,2301,1,22,5,9,83,52,31,71
Alloa,2301,2,19,7,10,79,49,30,64
Airdrieon,2301,3,18,10,8,61,48,13,64
Brechin,2301,4,16,10,10,51,44,7,58
Peterhead,2301,5,17,6,13,51,51,0,57
Albion,2301,6,12,7,17,49,51,-2,43
Queen's Park,2301,7,12,7,17,49,62,-13,43
Stranraer,2301,8,12,7,17,56,72,-16,43
East Fife,2301,9,10,8,18,46,53,-7,38
Stenhousem'r,2301,10,5,7,24,40,83,-43,22
Livingston,2302,1,26,4,6,96,50,46,82
Alloa,2302,2,17,7,12,66,44,22,58
Brechin,2302,3,18,3,15,51,56,-5,57
Airdrieon,2302,4,12,12,12,49,50,-1,48
Peterhead,2302,5,12,11,13,52,52,0,47
Stranraer,2302,6,14,5,17,60,62,-2,47
Albion,2302,7,12,9,15,45,49,-4,45
Queen's Park,2302,8,12,9,15,38,54,-16,45
East Fife,2302,9,11,10,15,44,49,-5,43
Stenhousem'r,2302,10,6,10,20,39,74,-35,28
Livingston,2303,1,22,5,9,86,43,43,71
Brechin,2303,2,19,6,11,50,41,9,63
Peterhead,2303,3,17,7,12,55,46,9,58
Airdrieon,2303,4,17,5,14,52,49,3,56
Albion,2303,5,16,8,12,56,58,-2,56
Alloa,2303,6,15,6,15,62,50,12,51
East Fife,2303,7,13,6,17,56,51,5,45
Stranraer,2303,8,12,5,19,46,63,-17,41
Queen's Park,2303,9,10,9,17,33,54,-21,39
Stenhousem'r,2303,10,7,7,22,50,91,-41,28
Livingston,2304,1,21,7,8,72,46,26,70
Alloa,2304,2,19,9,8,73,41,32,66
Airdrieon,2304,3,17,9,10,70,55,15,60
Brechin,2304,4,16,5,15,54,57,-3,53
Stranraer,2304,5,15,7,14,65,58,7,52
Peterhead,2304,6,15,6,15,48,54,-6,51
East Fife,2304,7,13,6,17,48,50,-2,45
Albion,2304,8,13,6,17,53,60,-7,45
Queen's Park,2304,9,10,11,15,37,52,-15,41
Stenhousem'r,2304,10,4,8,24,33,80,-47,20
Livingston,2305,1,21,5,10,87,53,34,68
Alloa,2305,2,20,7,9,76,42,34,67
Albion,2305,3,15,8,13,54,51,3,53
Peterhead,2305,4,14,11,11,49,50,-1,53
Brechin,2305,5,16,5,15,49,55,-6,53
Airdrieon,2305,6,14,10,12,53,49,4,52
Stranraer,2305,7,13,5,18,50,68,-18,44
Queen's Park,2305,8,11,9,16,42,51,-9,42
East Fife,2305,9,8,13,15,49,55,-6,37
Stenhousem'r,2305,10,8,7,21,46,81,-35,31
Airdrieon,2306,1,20,3,13,62,53,9,63
Alloa,2306,2,18,7,11,67,45,22,61
Brechin,2306,3,19,3,14,54,51,3,60
Livingston,2306,4,17,4,15,70,53,17,55
Albion,2306,5,15,7,14,61,57,4,52
East Fife,2306,6,15,6,15,58,61,-3,51
Stranraer,2306,7,14,7,15,60,60,0,49
Peterhead,2306,8,13,9,14,61,59,2,48
Queen's Park,2306,9,10,7,19,33,54,-21,37
Stenhousem'r,2306,10,9,7,20,53,86,-33,34
Alloa,2307,1,21,8,7,84,38,46,71
Livingston,2307,2,21,2,13,76,57,19,65
Albion,2307,3,18,6,12,56,55,1,60
Queen's Park,2307,4,16,6,14,43,38,5,54
Peterhead,2307,5,15,8,13,52,52,0,53
Airdrieon,2307,6,15,6,15,53,54,-1,51
Brechin,2307,7,12,8,16,41,54,-13,44
East Fife,2307,8,11,6,19,49,63,-14,39
Stranraer,2307,9,11,5,20,53,68,-15,38
Stenhousem'r,2307,10,9,7,20,46,74,-28,34
Alloa,2308,1,22,8,6,66,36,30,74
Livingston,2308,2,23,3,10,78,44,34,72
Albion,2308,3,15,11,10,53,44,9,56
Airdrieon,2308,4,15,6,15,59,58,1,51
East Fife,2308,5,14,7,15,51,51,0,49
Peterhead,2308,6,13,8,15,49,56,-7,47
Brechin,2308,7,13,5,18,49,53,-4,44
Queen's Park,2308,8,11,10,15,37,52,-15,43
Stranraer,2308,9,12,5,19,58,68,-10,41
Stenhousem'r,2308,10,5,11,20,44,82,-38,26
Peterhead,2309,1,19,9,8,60,49,11,66
Airdrieon,2309,2,20,4,12,65,55,10,64
Livingston,2309,3,18,5,13,75,50,25,59
Alloa,2309,4,17,7,12,66,47,19,58
Brechin,2309,5,15,8,13,48,52,-4,53
Albion,2309,6,13,8,15,61,56,5,47
Stenhousem'r,2309,7,12,9,15,52,68,-16,45
Queen's Park,2309,8,12,8,16,45,60,-15,44
Stranraer,2309,9,11,4,21,49,69,-20,37
East Fife,2309,10,7,10,19,39,54,-15,31
Livingston,2310,1,23,3,10,85,43,42,72
Peterhead,2310,2,18,8,10,63,49,14,62
Alloa,2310,3,17,9,10,64,41,23,60
Airdrieon,2310,4,17,6,13,58,55,3,57
Brechin,2310,5,17,5,14,51,50,1,56
Queen's Park,2310,6,16,5,15,44,52,-8,53
Albion,2310,7,14,9,13,60,64,-4,51
East Fife,2310,8,12,8,16,49,49,0,44
Stranraer,2310,9,12,3,21,48,69,-21,39
Stenhousem'r,2310,10,3,6,27,42,92,-50,15
Alloa,2311,1,24,6,6,87,37,50,78
Livingston,2311,2,23,5,8,69,43,26,74
Airdrieon,2311,3,17,9,10,58,48,10,60
Brechin,2311,4,16,7,13,46,44,2,55
Stranraer,2311,5,14,7,15,57,57,0,49
Albion,2311,6,13,6,17,54,60,-6,45
Peterhead,2311,7,12,8,16,46,59,-13,44
East Fife,2311,8,11,9,16,41,42,-1,42
Queen's Park,2311,9,9,4,23,29,59,-30,31
Stenhousem'r,2311,10,6,9,21,41,79,-38,27
Livingston,2312,1,19,6,11,77,48,29,63
Airdrieon,2312,2,16,10,10,54,47,7,58
Alloa,2312,3,15,11,10,64,49,15,56
Brechin,2312,4,15,9,12,53,49,4,54
Peterhead,2312,5,14,11,11,48,47,1,53
Queen's Park,2312,6,13,9,14,38,52,-14,48
East Fife,2312,7,11,11,14,47,45,2,44
Albion,2312,8,11,11,14,48,49,-1,44
Stranraer,2312,9,11,6,19,48,62,-14,39
Stenhousem'r,2312,10,8,10,18,48,77,-29,34
Livingston,2313,1,22,9,5,92,46,46,75
Airdrieon,2313,2,19,6,11,66,58,8,63
Brechin,2313,3,16,9,11,49,43,6,57
Alloa,2313,4,15,8,13,56,51,5,53
Albion,2313,5,14,9,13,58,54,4,51
Peterhead,2313,6,12,10,14,49,49,0,46
East Fife,2313,7,12,9,15,54,53,1,45
Queen's Park,2313,8,9,11,16,36,57,-21,38
Stenhousem'r,2313,9,8,11,17,47,77,-30,35
Stranraer,2313,10,10,4,22,40,59,-19,34
Livingston,2314,1,24,2,10,88,45,43,74
Alloa,2314,2,19,6,11,74,48,26,63
Peterhead,2314,3,18,4,14,58,50,8,58
Airdrieon,2314,4,17,7,12,56,55,1,58
Albion,2314,5,16,6,14,57,57,0,54
Brechin,2314,6,16,5,15,47,44,3,53
Queen's Park,2314,7,11,10,15,42,59,-17,43
Stranraer,2314,8,13,2,21,49,66,-17,41
East Fife,2314,9,10,9,17,46,52,-6,39
Stenhousem'r,2314,10,8,5,23,42,83,-41,29
Alloa,2315,1,22,5,9,79,40,39,71
Livingston,2315,2,20,4,12,74,49,25,64
Brechin,2315,3,16,9,11,55,47,8,57
Peterhead,2315,4,14,8,14,48,50,-2,50
Albion,2315,5,12,12,12,50,50,0,48
Stranraer,2315,6,14,6,16,60,63,-3,48
Queen's Park,2315,7,13,8,15,43,54,-11,47
East Fife,2315,8,11,11,14,50,55,-5,44
Airdrieon,2315,9,11,7,18,51,68,-17,40
Stenhousem'r,2315,10,6,12,18,41,75,-34,30
Alloa,2316,1,19,4,13,68,50,18,61
Airdrieon,2316,2,17,9,10,57,54,3,60
Brechin,2316,3,17,8,11,56,47,9,59
Livingston,2316,4,17,4,15,70,53,17,55
Albion,2316,5,16,7,13,60,51,9,55
Peterhead,2316,6,14,8,14,54,56,-2,50
East Fife,2316,7,12,10,14,55,48,7,46
Queen's Park,2316,8,13,4,19,39,59,-20,43
Stranraer,2316,9,12,6,18,49,59,-10,42
Stenhousem'r,2316,10,9,8,19,52,83,-31,35
Alloa,2317,1,21,5,10,72,41,31,68
Livingston,2317,2,18,7,11,67,51,16,61
Airdrieon,2317,3,19,4,13,61,47,14,61
Brechin,2317,4,16,9,11,51,44,7,57
Queen's Park,2317,5,15,7,14,40,42,-2,52
Stranraer,2317,6,15,3,18,47,56,-9,48
East Fife,2317,7,10,13,13,47,46,1,43
Albion,2317,8,10,9,17,46,51,-5,39
Stenhousem'r,2317,9,11,6,19,50,83,-33,39
Peterhead,2317,10,10,7,19,43,63,-20,37
Livingston,2318,1,21,6,9,77,45,32,69
Alloa,2318,2,18,8,10,68,42,26,62
Brechin,2318,3,17,5,14,47,49,-2,56
Airdrieon,2318,4,16,7,13,57,60,-3,55
Albion,2318,5,13,9,14,51,53,-2,48
Stranraer,2318,6,12,11,13,52,53,-1,47
Peterhead,2318,7,11,13,12,41,44,-3,46
Queen's Park,2318,8,13,6,17,37,51,-14,45
East Fife,2318,9,12,7,17,50,53,-3,43
Stenhousem'r,2318,10,7,8,21,46,76,-30,29
Alloa,2319,1,21,9,6,78,45,33,72
Livingston,2319,2,20,4,12,78,48,30,64
Brechin,2319,3,16,6,14,49,48,1,54
Stranraer,2319,4,14,9,13,58,54,4,51
Peterhead,2319,5,13,10,13,57,58,-1,49
Airdrieon,2319,6,14,7,15,57,62,-5,49
Queen's Park,2319,7,12,10,14,39,56,-17,46
East Fife,2319,8,11,10,15,47,42,5,43
Albion,2319,9,10,8,18,47,61,-14,38
Stenhousem'r,2319,10,9,7,20,49,85,-36,34
Alloa,2320,1,20,7,9,83,46,37,67
Airdrieon,2320,2,16,7,13,59,52,7,55
Livingston,2320,3,16,5,15,73,56,17,53
Albion,2320,4,14,10,12,60,52,8,52
Brechin,2320,5,15,7,14,52,54,-2,52
East Fife,2320,6,14,9,13,56,58,-2,51
Queen's Park,2320,7,12,10,14,33,43,-10,46
Peterhead,2320,8,12,9,15,47,57,-10,45
Stranraer,2320,9,11,7,18,50,70,-20,40
Stenhousem'r,2320,10,10,9,17,44,69,-25,39
Livingston,2321,1,20,6,10,80,47,33,66
Alloa,2321,2,17,8,11,65,40,25,59
Airdrieon,2321,3,16,8,12,53,50,3,56
East Fife,2321,4,13,11,12,57,46,11,50
Queen's Park,2321,5,13,11,12,42,45,-3,50
Brechin,2321,6,12,12,12,46,50,-4,48
Peterhead,2321,7,12,11,13,41,46,-5,47
Albion,2321,8,12,10,14,55,59,-4,46
Stranraer,2321,9,10,9,17,45,65,-20,39
Stenhousem'r,2321,10,7,10,19,41,77,-36,31
Livingston,2322,1,21,5,10,84,49,35,68
Alloa,2322,2,18,11,7,68,42,26,65
Peterhead,2322,3,17,7,12,50,44,6,58
Albion,2322,4,14,7,15,53,51,2,49
Queen's Park,2322,5,12,13,11,45,57,-12,49
Stranraer,2322,6,12,8,16,56,60,-4,44
Brechin,2322,7,12,8,16,44,51,-7,44
Airdrieon,2322,8,12,6,18,53,76,-23,42
East Fife,2322,9,10,10,16,53,55,-2,40
Stenhousem'r,2322,10,11,7,18,52,73,-21,40
Alloa,2323,1,20,7,9,70,38,32,67
Livingston,2323,2,18,8,10,75,43,32,62
Albion,2323,3,17,10,9,65,51,14,61
Brechin,2323,4,17,6,13,47,51,-4,57
Airdrieon,2323,5,15,7,14,51,54,-3,52
Queen's Park,2323,6,12,9,15,44,53,-9,45
Peterhead,2323,7,12,6,18,43,55,-12,42
East Fife,2323,8,9,12,15,47,55,-8,39
Stranraer,2323,9,10,8,18,49,58,-9,38
Stenhousem'r,2323,10,10,7,19,45,78,-33,37
Brechin,2324,1,20,6,10,59,39,20,66
Alloa,2324,2,19,7,10,67,46,21,64
Livingston,2324,3,19,5,12,66,49,17,62
Albion,2324,4,17,6,13,59,51,8,57
Airdrieon,2324,5,17,3,16,56,52,4,54
Peterhead,2324,6,16,6,14,54,51,3,54
East Fife,2324,7,15,7,14,53,48,5,52
Stranraer,2324,8,14,2,20,54,61,-7,44
Queen's Park,2324,9,8,10,18,33,65,-32,34
Stenhousem'r,2324,10,6,6,24,36,75,-39,24
Airdrieon,2325,1,22,4,10,67,52,15,70
Alloa,2325,2,19,7,10,77,43,34,64
Albion,2325,3,17,8,11,63,55,8,59
Livingston,2325,4,17,7,12,79,52,27,58
Brechin,2325,5,16,4,16,50,57,-7,52
Queen's Park,2325,6,14,8,14,41,48,-7,50
Peterhead,2325,7,12,8,16,45,56,-11,44
East Fife,2325,8,11,8,17,50,52,-2,41
Stranraer,2325,9,12,4,20,49,61,-12,40
Stenhousem'r,2325,10,8,6,22,49,94,-45,30
Livingston,2326,1,24,5,7,86,42,44,77
Alloa,2326,2,18,7,11,67,45,22,61
Airdrieon,2326,3,18,7,11,59,45,14,61
Brechin,2326,4,17,6,13,50,48,2,57
East Fife,2326,5,13,10,13,52,46,6,49
Queen's Park,2326,6,13,7,16,35,50,-15,46
Albion,2326,7,11,10,15,50,47,3,43
Stranraer,2326,8,11,9,16,45,64,-19,42
Peterhead,2326,9,11,7,18,43,62,-19,40
Stenhousem'r,2326,10,4,12,20,41,79,-38,24
Alloa,2327,1,19,7,10,74,37,37,64
Livingston,2327,2,19,5,12,77,54,23,62
Brechin,2327,3,17,6,13,51,53,-2,57
Albion,2327,4,16,8,12,59,51,8,56
Airdrieon,2327,5,15,5,16,55,57,-2,50
East Fife,2327,6,13,10,13,58,54,4,49
Peterhead,2327,7,13,10,13,58,60,-2,49
Stranraer,2327,8,13,8,15,47,54,-7,47
Queen's Park,2327,9,11,8,17,39,58,-19,41
Stenhousem'r,2327,10,7,7,22,39,79,-40,28
Alloa,2328,1,21,6,9,73,43,30,69
Livingston,2328,2,21,3,12,71,46,25,66
Airdrieon,2328,3,18,6,12,66,58,8,60
Peterhead,2328,4,16,8,12,50,49,1,56
Albion,2328,5,16,5,15,61,52,9,53
Queen's Park,2328,6,13,8,15,42,49,-7,47
Brechin,2328,7,14,3,19,49,64,-15,45
East Fife,2328,8,11,9,16,46,50,-4,42
Stranraer,2328,9,11,5,20,48,65,-17,38
Stenhousem'r,2328,10,10,5,21,45,75,-30,35
Alloa,2329,1,21,7,8,75,47,28,70
Livingston,2329,2,19,4,13,75,50,25,61
Airdrieon,2329,3,18,6,12,59,51,8,60
Albion,2329,4,14,10,12,48,48,0,52
Peterhead,2329,5,14,10,12,46,48,-2,52
East Fife,2329,6,14,8,14,52,50,2,50
Brechin,2329,7,12,9,15,50,50,0,45
Queen's Park,2329,8,11,12,13,42,53,-11,45
Stenhousem'r,2329,9,10,6,20,56,80,-24,36
Stranraer,2329,10,8,6,22,38,64,-26,30
Livingston,2330,1,23,5,8,85,42,43,74
Alloa,2330,2,17,12,7,71,43,28,63
Airdrieon,2330,3,19,6,11,68,53,15,63
Brechin,2330,4,18,4,14,55,52,3,58
Stranraer,2330,5,17,7,12,57,60,-3,58
Albion,2330,6,11,9,16,53,58,-5,42
Peterhead,2330,7,9,11,16,53,61,-8,38
Queen's Park,2330,8,9,9,18,33,62,-29,36
East Fife,2330,9,6,14,16,40,53,-13,32
Stenhousem'r,2330,10,7,11,18,44,75,-31,32
Livingston,2331,1,23,6,7,87,47,40,75
Alloa,2331,2,18,5,13,67,49,18,59
Airdrieon,2331,3,18,4,14,56,54,2,58
Stranraer,2331,4,17,4,15,64,56,8,55
Albion,2331,5,16,7,13,55,53,2,55
Brechin,2331,6,14,5,17,52,51,1,47
East Fife,2331,7,12,9,15,50,52,-2,45
Peterhead,2331,8,12,8,16,50,62,-12,44
Queen's Park,2331,9,10,7,19,28,53,-25,37
Stenhousem'r,2331,10,7,11,18,49,81,-32,32
Airdrieon,2332,1,20,9,7,64,44,20,69
Brechin,2332,2,19,7,10,51,45,6,64
Alloa,2332,3,18,6,12,64,44,20,60
Livingston,2332,4,18,4,14,62,52,10,58
Peterhead,2332,5,15,8,13,57,54,3,53
Queen's Park,2332,6,16,3,17,47,52,-5,51
Stranraer,2332,7,12,8,16,54,59,-5,44
East Fife,2332,8,10,10,16,46,55,-9,40
Albion,2332,9,11,5,20,51,55,-4,38
Stenhousem'r,2332,10,9,4,23,44,80,-36,31
Alloa,2333,1,20,10,6,72,36,36,70
Livingston,2333,2,20,5,11,69,46,23,65
Airdrieon,2333,3,17,9,10,59,46,13,60
Brechin,2333,4,18,5,13,54,48,6,59
Albion,2333,5,16,5,15,56,49,7,53
East Fife,2333,6,12,8,16,50,48,2,44
Peterhead,2333,7,12,7,17,42,53,-11,43
Stranraer,2333,8,11,7,18,53,67,-14,40
Queen's Park,2333,9,10,7,19,32,61,-29,37
Stenhousem'r,2333,10,8,9,19,48,81,-33,33
Alloa,2334,1,18,9,9,62,45,17,63
Brechin,2334,2,19,4,13,61,44,17,61
Stranraer,2334,3,17,8,11,60,51,9,59
Livingston,2334,4,15,6,15,65,56,9,51
Airdrieon,2334,5,14,8,14,50,51,-1,50
East Fife,2334,6,14,7,15,50,48,2,49
Peterhead,2334,7,13,8,15,46,50,-4,47
Albion,2334,8,12,11,13,47,52,-5,47
Queen's Park,2334,9,11,8,17,35,53,-18,41
Stenhousem'r,2334,10,8,9,19,48,74,-26,33
Livingston,2335,1,26,3,7,87,44,43,81
Airdrieon,2335,2,22,6,8,71,49,22,72
Alloa,2335,3,22,5,9,85,47,38,71
Brechin,2335,4,16,6,14,46,50,-4,54
Albion,2335,5,14,7,15,56,59,-3,49
Stranraer,2335,6,13,2,21,52,63,-11,41
East Fife,2335,7,10,9,17,47,49,-2,39
Queen's Park,2335,8,11,6,19,32,56,-24,39
Stenhousem'r,2335,9,9,6,21,51,85,-34,33
Peterhead,2335,10,8,8,20,43,68,-25,32
Livingston,2336,1,18,10,8,67,36,31,64
Airdrieon,2336,2,18,9,9,55,42,13,63
Alloa,2336,3,17,8,11,62,37,25,59
Brechin,2336,4,17,8,11,57,44,13,59
East Fife,2336,5,11,12,13,50,49,1,45
Albion,2336,6,12,9,15,56,56,0,45
Peterhead,2336,7,11,12,13,43,55,-12,45
Stranraer,2336,8,12,8,16,47,60,-13,44
Queen's Park,2336,9,10,9,17,35,50,-15,39
Stenhousem'r,2336,10,7,9,20,38,81,-43,30
Alloa,2337,1,22,8,6,79,41,38,74
Livingston,2337,2,21,5,10,78,50,28,68
Airdrieon,2337,3,17,7,12,57,52,5,58
Peterhead,2337,4,13,11,12,47,47,0,50
Albion,2337,5,14,7,15,57,54,3,49
Brechin,2337,6,12,13,11,53,59,-6,49
Stranraer,2337,7,13,6,17,57,51,6,45
East Fife,2337,8,11,10,15,51,60,-9,43
Queen's Park,2337,9,9,8,19,32,55,-23,35
Stenhousem'r,2337,10,6,9,21,50,92,-42,27
Alloa,2338,1,20,9,7,76,39,37,69
Livingston,2338,2,18,8,10,68,53,15,62
Airdrieon,2338,3,16,7,13,53,49,4,55
Brechin,2338,4,14,9,13,49,50,-1,51
Peterhead,2338,5,14,9,13,48,58,-10,51
Queen's Park,2338,6,14,8,14,40,41,-1,50
Albion,2338,7,14,6,16,55,54,1,48
East Fife,2338,8,9,12,15,48,51,-3,39
Stranraer,2338,9,9,10,17,44,60,-16,37
Stenhousem'r,2338,10,6,14,16,47,73,-26,32
Livingston,2339,1,24,3,9,79,47,32,75
Alloa,2339,2,19,6,11,68,48,20,63
Brechin,2339,3,19,4,13,56,45,11,61
Peterhead,2339,4,15,7,14,52,54,-2,52
East Fife,2339,5,14,8,14,49,46,3,50
Queen's Park,2339,6,15,5,16,47,55,-8,50
Airdrieon,2339,7,14,7,15,54,60,-6,49
Albion,2339,8,12,7,17,49,57,-8,43
Stranraer,2339,9,12,7,17,54,64,-10,43
Stenhousem'r,2339,10,7,4,25,47,79,-32,25
Livingston,2340,1,23,4,9,91,50,41,73
Airdrieon,2340,2,20,5,11,59,52,7,65
Albion,2340,3,15,10,11,54,48,6,55
Alloa,2340,4,12,14,10,63,59,4,50
Peterhead,2340,5,15,3,18,46,51,-5,48
Brechin,2340,6,12,11,13,51,52,-1,47
Queen's Park,2340,7,12,9,15,36,51,-15,45
East Fife,2340,8,11,10,15,55,51,4,43
Stranraer,2340,9,11,7,18,52,63,-11,40
Stenhousem'r,2340,10,9,7,20,55,85,-30,34
Airdrieon,2341,1,22,7,7,78,37,41,73
Alloa,2341,2,17,10,9,67,42,25,61
Livingston,2341,3,17,10,9,68,44,24,61
Albion,2341,4,16,6,14,55,59,-4,54
Brechin,2341,5,14,6,16,47,63,-16,48
Stranraer,2341,6,13,8,15,48,58,-10,47
Queen's Park,2341,7,12,7,17,33,47,-14,43
Peterhead,2341,8,12,6,18,46,67,-21,42
East Fife,2341,9,10,10,16,44,44,0,40
Stenhousem'r,2341,10,8,8,20,48,73,-25,32
Alloa,2342,1,19,7,10,72,45,27,64
Livingston,2342,2,19,7,10,69,46,23,64
Peterhead,2342,3,15,9,12,50,49,1,54
Airdrieon,2342,4,14,9,13,54,48,6,51
Albion,2342,5,14,9,13,44,49,-5,51
Brechin,2342,6,12,12,12,49,50,-1,48
Stenhousem'r,2342,7,12,9,15,54,72,-18,45
East Fife,2342,8,11,11,14,52,53,-1,44
Stranraer,2342,9,10,9,17,51,63,-12,39
Queen's Park,2342,10,10,6,20,28,48,-20,36
Alloa,2343,1,19,10,7,67,40,27,67
Livingston,2343,2,20,2,14,79,56,23,62
Airdrieon,2343,3,17,8,11,66,61,5,59
Brechin,2343,4,17,6,13,52,52,0,57
Albion,2343,5,16,5,15,57,48,9,53
Peterhead,2343,6,14,11,11,56,53,3,53
Queen's Park,2343,7,14,6,16,41,51,-10,48
Stranraer,2343,8,13,6,17,48,56,-8,45
East Fife,2343,9,11,8,17,54,58,-4,41
Stenhousem'r,2343,10,6,4,26,38,83,-45,22
Livingston,2344,1,25,2,9,90,48,42,77
Alloa,2344,2,18,8,10,75,50,25,62
Brechin,2344,3,18,5,13,56,54,2,59
Peterhead,2344,4,14,9,13,56,55,1,51
Stranraer,2344,5,15,5,16,60,61,-1,50
Airdrieon,2344,6,15,2,19,58,73,-15,47
Queen's Park,2344,7,13,8,15,42,57,-15,47
East Fife,2344,8,12,8,16,59,53,6,44
Albion,2344,9,11,7,18,45,55,-10,40
Stenhousem'r,2344,10,6,12,18,50,85,-35,30
Airdrieon,2345,1,22,3,11,68,47,21,69
Livingston,2345,2,20,8,8,74,44,30,68
Alloa,2345,3,18,9,9,70,46,24,63
Brechin,2345,4,16,8,12,50,44,6,56
Albion,2345,5,15,8,13,52,49,3,53
East Fife,2345,6,14,9,13,55,49,6,51
Peterhead,2345,7,14,5,17,42,51,-9,47
Queen's Park,2345,8,13,7,16,43,45,-2,46
Stranraer,2345,9,9,4,23,37,66,-29,31
Stenhousem'r,2345,10,4,9,23,32,82,-50,21
Livingston,2346,1,18,6,12,72,51,21,60
Airdrieon,2346,2,17,9,10,61,53,8,60
Alloa,2346,3,17,8,11,65,51,14,59
Peterhead,2346,4,15,7,14,53,50,3,52
Stranraer,2346,5,16,4,16,61,60,1,52
Brechin,2346,6,14,10,12,40,40,0,52
Albion,2346,7,14,9,13,53,51,2,51
East Fife,2346,8,11,7,18,47,50,-3,40
Queen's Park,2346,9,9,10,17,31,51,-20,37
Stenhousem'r,2346,10,9,10,17,49,75,-26,37
Livingston,2347,1,21,3,12,74,47,27,66
Brechin,2347,2,20,4,12,59,47,12,64
Airdrieon,2347,3,17,9,10,58,47,11,60
Alloa,2347,4,16,8,12,67,56,11,56
Stranraer,2347,5,16,5,15,70,64,6,53
Peterhead,2347,6,13,9,14,46,50,-4,48
Queen's Park,2347,7,13,4,19,37,53,-16,43
East Fife,2347,8,11,8,17,48,57,-9,41
Stenhousem'r,2347,9,11,7,18,49,74,-25,40
Albion,2347,10,10,7,19,47,60,-13,37
Livingston,2348,1,21,6,9,69,40,29,69
Alloa,2348,2,17,8,11,73,49,24,59
Brechin,2348,3,17,6,13,46,46,0,57
Peterhead,2348,4,16,7,13,59,49,10,55
Airdrieon,2348,5,16,7,13,59,58,1,55
Albion,2348,6,14,10,12,56,51,5,52
East Fife,2348,7,12,10,14,49,45,4,46
Stranraer,2348,8,13,3,20,54,69,-15,42
Queen's Park,2348,9,11,6,19,29,52,-23,39
Stenhousem'r,2348,10,7,9,20,41,76,-35,30
Livingston,2349,1,22,6,8,87,42,45,72
Alloa,2349,2,20,9,7,77,44,33,69
Airdrieon,2349,3,20,7,9,59,47,12,67
Brechin,2349,4,20,4,12,52,38,14,64
Peterhead,2349,5,16,6,14,55,58,-3,54
Queen's Park,2349,6,11,9,16,34,56,-22,42
East Fife,2349,7,10,7,19,43,49,-6,37
Albion,2349,8,10,7,19,46,64,-18,37
Stranraer,2349,9,10,5,21,43,61,-18,35
Stenhousem'r,2349,10,8,6,22,44,81,-37,30
Alloa,2350,1,21,6,9,77,45,32,69
Livingston,2350,2,20,5,11,74,54,20,65
Brechin,2350,3,19,4,13,51,55,-4,61
Peterhead,2350,4,17,6,13,61,52,9,57
Albion,2350,5,15,8,13,54,49,5,53
Airdrieon,2350,6,15,7,14,60,57,3,52
Queen's Park,2350,7,13,6,17,49,59,-10,45
East Fife,2350,8,10,7,19,55,62,-7,37
Stranraer,2350,9,11,3,22,48,68,-20,36
Stenhousem'r,2350,10,9,8,19,44,72,-28,35
Livingston,2351,1,22,3,11,70,48,22,69
Alloa,2351,2,20,7,9,66,40,26,67
Peterhead,2351,3,15,7,14,59,56,3,52
Brechin,2351,4,15,6,15,44,47,-3,51
Airdrieon,2351,5,14,8,14,52,50,2,50
Stranraer,2351,6,14,7,15,52,53,-1,49
Queen's Park,2351,7,13,10,13,33,41,-8,49
Albion,2351,8,12,9,15,48,49,-1,45
East Fife,2351,9,9,11,16,41,43,-2,38
Stenhousem'r,2351,10,9,6,21,52,90,-38,33
Alloa,2352,1,20,9,7,73,47,26,69
Livingston,2352,2,21,4,11,79,50,29,67
Albion,2352,3,16,8,12,67,53,14,56
Peterhead,2352,4,16,6,14,51,52,-1,54
Stranraer,2352,5,16,5,15,59,54,5,53
Brechin,2352,6,15,7,14,48,46,2,52
Airdrieon,2352,7,14,8,14,52,60,-8,50
East Fife,2352,8,12,7,17,51,59,-8,43
Queen's Park,2352,9,10,8,18,32,49,-17,38
Stenhousem'r,2352,10,5,8,23,49,91,-42,23
Alloa,2353,1,21,8,7,79,41,38,71
Airdrieon,2353,2,19,7,10,68,50,18,64
Brechin,2353,3,20,4,12,65,52,13,64
Livingston,2353,4,18,7,11,68,47,21,61
Stranraer,2353,5,16,4,16,54,60,-6,52
Peterhead,2353,6,13,8,15,45,58,-13,47
Albion,2353,7,12,8,16,43,47,-4,44
East Fife,2353,8,9,12,15,52,55,-3,39
Queen's Park,2353,9,9,8,19,34,64,-30,35
Stenhousem'r,2353,10,6,8,22,48,82,-34,26
Alloa,2354,1,20,9,7,75,40,35,69
Livingston,2354,2,21,5,10,70,42,28,68
Brechin,2354,3,20,5,11,54,48,6,65
Queen's Park,2354,4,14,10,12,40,42,-2,52
Stranraer,2354,5,14,8,14,52,53,-1,50
Airdrieon,2354,6,14,6,16,55,65,-10,48
Albion,2354,7,12,10,14,48,53,-5,46
East Fife,2354,8,8,13,15,43,47,-4,37
Peterhead,2354,9,9,10,17,45,58,-13,37
Stenhousem'r,2354,10,7,6,23,39,73,-34,27
Livingston,2355,1,21,4,11,78,38,40,67
Airdrieon,2355,2,19,5,12,66,54,12,62
Peterhead,2355,3,19,5,12,55,50,5,62
Alloa,2355,4,17,9,10,79,52,27,60
Brechin,2355,5,14,9,13,47,55,-8,51
East Fife,2355,6,10,14,12,45,47,-2,44
Queen's Park,2355,7,10,13,13,32,42,-10,43
Albion,2355,8,10,11,15,52,57,-5,41
Stranraer,2355,9,11,5,20,42,65,-23,38
Stenhousem'r,2355,10,8,7,21,44,80,-36,31
Livingston,2356,1,21,6,9,73,46,27,69
Alloa,2356,2,19,7,10,68,40,28,64
Brechin,2356,3,16,6,14,49,48,1,54
Airdrieon,2356,4,14,11,11,48,42,6,53
Queen's Park,2356,5,16,4,16,41,48,-7,52
Albion,2356,6,15,4,17,51,48,3,49
Peterhead,2356,7,12,10,14,45,53,-8,46
Stranraer,2356,8,12,6,18,51,65,-14,42
East Fife,2356,9,11,7,18,44,54,-10,40
Stenhousem'r,2356,10,10,7,19,46,72,-26,37
Airdrieon,2357,1,19,7,10,55,44,11,64
Alloa,2357,2,17,9,10,73,54,19,60
Brechin,2357,3,17,6,13,50,47,3,57
Livingston,2357,4,17,4,15,66,55,11,55
East Fife,2357,5,16,6,14,59,49,10,54
Peterhead,2357,6,15,6,15,53,53,0,51
Queen's Park,2357,7,14,9,13,37,42,-5,51
Stranraer,2357,8,11,11,14,53,58,-5,44
Albion,2357,9,10,6,20,47,60,-13,36
Stenhousem'r,2357,10,7,10,19,49,80,-31,31
Livingston,2358,1,25,4,7,85,39,46,79
Alloa,2358,2,17,6,13,63,47,16,57
Brechin,2358,3,16,5,15,38,42,-4,53
Albion,2358,4,14,10,12,54,50,4,52
Airdrieon,2358,5,16,4,16,60,63,-3,52
Stranraer,2358,6,15,5,16,56,62,-6,50
Peterhead,2358,7,13,6,17,47,56,-9,45
East Fife,2358,8,11,10,15,51,52,-1,43
Queen's Park,2358,9,12,6,18,37,50,-13,42
Stenhousem'r,2358,10,9,8,19,45,75,-30,35
Livingston,2359,1,24,3,9,84,47,37,75
Brechin,2359,2,22,5,9,64,43,21,71
Alloa,2359,3,18,6,12,68,46,22,60
Albion,2359,4,18,5,13,58,51,7,59
Airdrieon,2359,5,15,7,14,61,59,2,52
Queen's Park,2359,6,13,7,16,41,50,-9,46
East Fife,2359,7,11,9,16,50,50,0,42
Stranraer,2359,8,13,3,20,49,58,-9,42
Peterhead,2359,9,11,5,20,41,64,-23,38
Stenhousem'r,2359,10,8,4,24,40,88,-48,28
Livingston,2360,1,24,1,11,87,49,38,73
Alloa,2360,2,21,6,9,70,37,33,69
Airdrieon,2360,3,15,8,13,52,53,-1,53
Queen's Park,2360,4,15,6,15,40,43,-3,51
Brechin,2360,5,15,6,15,47,55,-8,51
Albion,2360,6,14,8,14,53,59,-6,50
East Fife,2360,7,13,6,17,59,51,8,45
Peterhead,2360,8,12,8,16,44,60,-16,44
Stranraer,2360,9,11,8,17,47,60,-13,41
Stenhousem'r,2360,10,8,7,21,39,71,-32,31
Livingston,2361,1,21,5,10,84,52,32,68
Alloa,2361,2,17,10,9,69,50,19,61
Peterhead,2361,3,16,10,10,56,46,10,58
Airdrieon,2361,4,16,5,15,61,61,0,53
Brechin,2361,5,16,5,15,53,55,-2,53
Albion,2361,6,15,7,14,59,49,10,52
Stranraer,2361,7,15,5,16,57,58,-1,50
Queen's Park,2361,8,14,7,15,40,50,-10,49
East Fife,2361,9,9,11,16,45,53,-8,38
Stenhousem'r,2361,10,5,7,24,38,88,-50,22
Livingston,2362,1,22,4,10,83,50,33,70
Alloa,2362,2,20,7,9,73,45,28,67
Albion,2362,3,19,6,11,56,42,14,63
Airdrieon,2362,4,16,10,10,62,54,8,58
Peterhead,2362,5,16,8,12,50,47,3,56
Brechin,2362,6,17,3,16,54,51,3,54
East Fife,2362,7,11,8,17,44,53,-9,41
Queen's Park,2362,8,8,11,17,33,54,-21,35
Stenhousem'r,2362,9,9,5,22,46,81,-35,32
Stranraer,2362,10,7,8,21,38,62,-24,29
Alloa,2363,1,19,9,8,64,38,26,66
Livingston,2363,2,21,2,13,68,44,24,65
Brechin,2363,3,20,5,11,57,38,19,65
Airdrieon,2363,4,18,5,13,56,56,0,59
Albion,2363,5,14,7,15,64,61,3,49
Stranraer,2363,6,15,4,17,57,57,0,49
Peterhead,2363,7,12,9,15,44,51,-7,45
Queen's Park,2363,8,13,4,19,38,52,-14,43
Stenhousem'r,2363,9,10,5,21,46,80,-34,35
East Fife,2363,10,8,10,18,42,59,-17,34
Livingston,2364,1,24,2,10,83,52,31,74
Alloa,2364,2,21,4,11,78,48,30,67
Airdrieon,2364,3,19,7,10,68,54,14,64
Brechin,2364,4,18,4,14,59,55,4,58
Peterhead,2364,5,17,5,14,53,51,2,56
Albion,2364,6,13,9,14,53,53,0,48
Queen's Park,2364,7,13,7,16,44,58,-14,46
Stranraer,2364,8,11,5,20,45,67,-22,38
East Fife,2364,9,9,7,20,47,52,-5,34
Stenhousem'r,2364,10,7,6,23,43,83,-40,27
Livingston,2365,1,24,4,8,84,47,37,76
Brechin,2365,2,20,7,9,69,43,26,67
Alloa,2365,3,17,10,9,66,45,21,61
Airdrieon,2365,4,18,7,11,68,60,8,61
Stranraer,2365,5,15,5,16,54,58,-4,50
Queen's Park,2365,6,14,3,19,45,65,-20,45
East Fife,2365,7,12,7,17,54,58,-4,43
Albion,2365,8,10,11,15,52,56,-4,41
Peterhead,2365,9,11,7,18,40,52,-12,40
Stenhousem'r,2365,10,5,7,24,49,97,-48,22
Alloa,2366,1,20,9,7,71,36,35,69
Airdrieon,2366,2,18,7,11,64,47,17,61
Livingston,2366,3,17,8,11,68,48,20,59
Brechin,2366,4,16,10,10,46,36,10,58
Queen's Park,2366,5,16,4,16,44,48,-4,52
Peterhead,2366,6,13,12,11,54,51,3,51
Stranraer,2366,7,11,10,15,44,48,-4,43
Albion,2366,8,11,9,16,51,65,-14,42
East Fife,2366,9,7,13,16,41,49,-8,34
Stenhousem'r,2366,10,5,10,21,41,96,-55,25
Livingston,2367,1,22,5,9,82,47,35,71
Alloa,2367,2,18,8,10,71,49,22,62
Airdrieon,2367,3,19,5,12,64,52,12,62
Peterhead,2367,4,17,8,11,60,50,10,59
East Fife,2367,5,13,9,14,55,48,7,48
Albion,2367,6,13,6,17,51,57,-6,45
Queen's Park,2367,7,12,9,15,42,51,-9,45
Stranraer,2367,8,13,4,19,50,59,-9,43
Brechin,2367,9,12,4,20,41,63,-22,40
Stenhousem'r,2367,10,10,4,22,41,81,-40,34
Livingston,2368,1,25,2,9,82,43,39,77
Alloa,2368,2,17,12,7,69,42,27,63
Airdrieon,2368,3,17,7,12,59,55,4,58
Albion,2368,4,14,7,15,50,52,-2,49
Brechin,2368,5,14,7,15,51,56,-5,49
Peterhead,2368,6,14,7,15,43,59,-16,49
East Fife,2368,7,12,10,14,52,50,2,46
Stranraer,2368,8,12,7,17,56,59,-3,43
Queen's Park,2368,9,9,10,17,35,52,-17,37
Stenhousem'r,2368,10,8,7,21,48,77,-29,31
Livingston,2369,1,22,6,8,73,39,34,72
Alloa,2369,2,18,9,9,67,41,26,63
Brechin,2369,3,18,3,15,55,45,10,57
Airdrieon,2369,4,16,7,13,52,53,-1,55
Peterhead,2369,5,15,6,15,48,56,-8,51
Albion,2369,6,15,5,16,45,49,-4,50
East Fife,2369,7,13,8,15,50,47,3,47
Stranraer,2369,8,14,4,18,51,61,-10,46
Queen's Park,2369,9,10,6,20,34,49,-15,36
Stenhousem'r,2369,10,9,6,21,43,78,-35,33
Airdrieon,2370,1,23,5,8,68,42,26,74
Livingston,2370,2,22,4,10,76,45,31,70
Alloa,2370,3,19,8,9,75,49,26,65
Brechin,2370,4,16,7,13,57,52,5,55
Queen's Park,2370,5,13,8,15,44,53,-9,47
Stranraer,2370,6,13,5,18,59,63,-4,44
East Fife,2370,7,11,10,15,46,50,-4,43
Peterhead,2370,8,12,5,19,51,71,-20,41
Albion,2370,9,11,6,19,49,66,-17,39
Stenhousem'r,2370,10,9,4,23,48,82,-34,31
Alloa,2371,1,24,6,6,70,34,36,78
Brechin,2371,2,22,2,12,56,40,16,68
Livingston,2371,3,17,7,12,60,40,20,58
Airdrieon,2371,4,16,9,11,57,50,7,57
Albion,2371,5,15,8,13,49,47,2,53
Peterhead,2371,6,11,10,15,47,53,-6,43
Queen's Park,2371,7,12,7,17,28,43,-15,43
Stranraer,2371,8,10,9,17,47,58,-11,39
East Fife,2371,9,11,5,20,47,57,-10,38
Stenhousem'r,2371,10,6,9,21,36,75,-39,27
Livingston,2372,1,21,4,11,73,46,27,67
Airdrieon,2372,2,19,7,10,64,51,13,64
Alloa,2372,3,19,6,11,74,46,28,63
Queen's Park,2372,4,16,5,15,32,44,-12,53
Peterhead,2372,5,14,9,13,45,52,-7,51
Brechin,2372,6,15,5,16,51,49,2,50
Stranraer,2372,7,14,6,16,52,60,-8,48
Albion,2372,8,10,11,15,48,54,-6,41
East Fife,2372,9,11,7,18,44,50,-6,40
Stenhousem'r,2372,10,7,8,21,45,76,-31,29
Alloa,2373,1,22,7,7,75,39,36,73
Livingston,2373,2,20,5,11,70,46,24,65
Albion,2373,3,18,7,11,60,51,9,61
Peterhead,2373,4,16,8,12,56,47,9,56
Brechin,2373,5,17,3,16,55,51,4,54
Airdrieon,2373,6,15,7,14,56,56,0,52
Stranraer,2373,7,12,7,17,45,59,-14,43
Queen's Park,2373,8,11,7,18,33,54,-21,40
East Fife,2373,9,9,11,16,41,49,-8,38
Stenhousem'r,2373,10,6,6,24,43,82,-39,24
Alloa,2374,1,21,8,7,74,42,32,71
Livingston,2374,2,22,5,9,69,38,31,71
Brechin,2374,3,16,6,14,50,51,-1,54
Peterhead,2374,4,15,8,13,44,46,-2,53
Albion,2374,5,15,6,15,56,52,4,51
Airdrieon,2374,6,12,9,15,53,56,-3,45
East Fife,2374,7,11,10,15,42,46,-4,43
Stranraer,2374,8,12,7,17,50,60,-10,43
Queen's Park,2374,9,12,6,18,33,48,-15,42
Stenhousem'r,2374,10,6,11,19,49,81,-32,29
Livingston,2375,1,22,3,11,74,45,29,69
Stranraer,2375,2,21,3,12,62,46,16,66
Airdrieon,2375,3,17,7,12,57,44,13,58
Alloa,2375,4,17,5,14,64,49,15,56
Brechin,2375,5,16,8,12,55,49,6,56
Peterhead,2375,6,15,8,13,58,54,4,53
Albion,2375,7,14,8,14,48,49,-1,50
East Fife,2375,8,10,11,15,49,49,0,41
Queen's Park,2375,9,9,7,20,27,63,-36,34
Stenhousem'r,2375,10,5,8,23,42,88,-46,23
Brechin,2376,1,22,6,8,50,32,18,72
Livingston,2376,2,21,6,9,69,42,27,69
Airdrieon,2376,3,21,5,10,66,50,16,68
Stranraer,2376,4,14,9,13,48,49,-1,51
Alloa,2376,5,14,8,14,58,45,13,50
Peterhead,2376,6,14,5,17,54,53,1,47
Albion,2376,7,13,7,16,45,53,-8,46
East Fife,2376,8,10,8,18,47,55,-8,38
Queen's Park,2376,9,10,4,22,30,56,-26,34
Stenhousem'r,2376,10,9,6,21,47,79,-32,33
Alloa,2377,1,21,7,8,74,45,29,70
Livingston,2377,2,19,8,9,73,48,25,65
Brechin,2377,3,18,6,12,58,53,5,60
Airdrieon,2377,4,16,7,13,58,49,9,55
Peterhead,2377,5,14,9,13,52,48,4,51
Queen's Park,2377,6,15,4,17,39,49,-10,49
Albion,2377,7,13,7,16,53,52,1,46
Stenhousem'r,2377,8,9,11,16,53,79,-26,38
East Fife,2377,9,9,10,17,47,56,-9,37
Stranraer,2377,10,7,9,20,47,75,-28,30
Livingston,2378,1,24,3,9,87,52,35,75
Brechin,2378,2,21,5,10,51,40,11,68
Airdrieon,2378,3,19,5,12,66,60,6,62
Peterhead,2378,4,19,5,12,53,52,1,62
Alloa,2378,5,16,9,11,68,46,22,57
Albion,2378,6,14,5,17,51,47,4,47
Stranraer,2378,7,11,7,18,42,56,-14,40
East Fife,2378,8,10,8,18,34,39,-5,38
Queen's Park,2378,9,9,7,20,34,56,-22,34
Stenhousem'r,2378,10,6,8,22,42,80,-38,26
Livingston,2379,1,20,6,10,73,48,25,66
Airdrieon,2379,2,19,6,11,59,49,10,63
Alloa,2379,3,17,10,9,69,47,22,61
Brechin,2379,4,17,4,15,52,47,5,55
Albion,2379,5,15,9,12,51,43,8,54
Peterhead,2379,6,14,11,11,50,43,7,53
East Fife,2379,7,13,7,16,53,59,-6,46
Stranraer,2379,8,9,10,17,43,60,-17,37
Queen's Park,2379,9,10,6,20,23,53,-30,36
Stenhousem'r,2379,10,8,7,21,47,71,-24,31
Alloa,2380,1,22,8,6,85,47,38,74
Brechin,2380,2,18,8,10,61,46,15,62
Livingston,2380,3,18,6,12,67,49,18,60
Queen's Park,2380,4,15,7,14,42,54,-12,52
Stranraer,2380,5,14,6,16,59,63,-4,48
Albion,2380,6,13,8,15,58,59,-1,47
Airdrieon,2380,7,11,13,12,52,50,2,46
Peterhead,2380,8,10,10,16,49,63,-14,40
East Fife,2380,9,9,10,17,46,56,-10,37
Stenhousem'r,2380,10,6,12,18,41,73,-32,30
Brechin,2381,1,21,6,9,55,38,17,69
Alloa,2381,2,21,5,10,76,39,37,68
Livingston,2381,3,19,6,11,79,55,24,63
Airdrieon,2381,4,15,4,17,57,64,-7,49
Peterhead,2381,5,13,7,16,51,61,-10,46
Stranraer,2381,6,13,7,16,42,55,-13,46
East Fife,2381,7,11,12,13,54,52,2,45
Albion,2381,8,12,7,17,62,66,-4,43
Queen's Park,2381,9,12,7,17,40,50,-10,43
Stenhousem'r,2381,10,8,9,19,58,94,-36,33
Brechin,2382,1,20,5,11,50,43,7,65
Livingston,2382,2,20,4,12,75,48,27,64
Airdrieon,2382,3,19,5,12,57,50,7,62
East Fife,2382,4,15,10,11,58,38,20,55
Alloa,2382,5,16,7,13,59,42,17,55
Stranraer,2382,6,15,7,14,51,56,-5,52
Queen's Park,2382,7,14,6,16,43,46,-3,48
Albion,2382,8,10,11,15,43,52,-9,41
Peterhead,2382,9,9,9,18,34,55,-21,36
Stenhousem'r,2382,10,7,6,23,40,80,-40,27
Alloa,2383,1,21,5,10,77,43,34,68
Airdrieon,2383,2,20,7,9,62,50,12,67
Livingston,2383,3,21,3,12,72,52,20,66
Brechin,2383,4,16,6,14,46,47,-1,54
Stranraer,2383,5,15,6,15,50,57,-7,51
Peterhead,2383,6,13,6,17,43,58,-15,45
Stenhousem'r,2383,7,11,7,18,54,76,-22,40
Albion,2383,8,10,9,17,45,49,-4,39
East Fife,2383,9,10,9,17,43,48,-5,39
Queen's Park,2383,10,9,10,17,35,47,-12,37
Alloa,2384,1,19,6,11,56,38,18,63
Livingston,2384,2,18,7,11,68,50,18,61
Airdrieon,2384,3,16,10,10,64,48,16,58
Brechin,2384,4,15,7,14,44,50,-6,52
Albion,2384,5,14,8,14,51,54,-3,50
Peterhead,2384,6,14,7,15,50,56,-6,49
Queen's Park,2384,7,11,13,12,49,48,1,46
Stranraer,2384,8,14,4,18,44,53,-9,46
East Fife,2384,9,11,11,14,46,44,2,44
Stenhousem'r,2384,10,8,7,21,51,82,-31,31
Livingston,2385,1,22,5,9,74,48,26,71
Alloa,2385,2,19,6,11,63,41,22,63
Airdrieon,2385,3,19,5,12,62,42,20,62
Brechin,2385,4,18,3,15,47,47,0,57
Albion,2385,5,15,7,14,54,51,3,52
Stranraer,2385,6,15,5,16,51,54,-3,50
Peterhead,2385,7,15,5,16,45,52,-7,50
Queen's Park,2385,8,12,8,16,41,48,-7,44
East Fife,2385,9,10,7,19,43,54,-11,37
Stenhousem'r,2385,10,5,9,22,40,83,-43,24
Livingston,2386,1,23,3,10,77,45,32,72
Alloa,2386,2,18,9,9,63,35,28,63
Airdrieon,2386,3,17,5,14,56,51,5,56
East Fife,2386,4,15,9,12,52,42,10,54
Albion,2386,5,14,9,13,53,53,0,51
Brechin,2386,6,13,7,16,49,53,-4,46
Stranraer,2386,7,11,11,14,42,49,-7,44
Peterhead,2386,8,13,5,18,42,56,-14,44
Queen's Park,2386,9,10,10,16,34,55,-21,40
Stenhousem'r,2386,10,9,6,21,42,71,-29,33
Livingston,2387,1,21,5,10,68,47,21,68
Airdrieon,2387,2,19,6,11,62,49,13,63
Brechin,2387,3,17,7,12,46,41,5,58
East Fife,2387,4,14,11,11,58,48,10,53
Alloa,2387,5,14,9,13,54,51,3,51
Stranraer,2387,6,15,5,16,64,58,6,50
Peterhead,2387,7,13,8,15,49,51,-2,47
Albion,2387,8,13,7,16,54,54,0,46
Queen's Park,2387,9,12,6,18,35,52,-17,42
Stenhousem'r,2387,10,7,6,23,46,85,-39,27
Livingston,2388,1,25,5,6,83,42,41,80
Alloa,2388,2,18,7,11,75,54,21,61
Airdrieon,2388,3,17,8,11,61,51,10,59
Brechin,2388,4,17,6,13,53,52,1,57
Albion,2388,5,16,5,15,57,59,-2,53
East Fife,2388,6,11,10,15,49,45,4,43
Queen's Park,2388,7,12,7,17,36,54,-18,43
Peterhead,2388,8,11,8,17,53,59,-6,41
Stranraer,2388,9,11,3,22,52,66,-14,36
Stenhousem'r,2388,10,9,7,20,48,85,-37,34
Alloa,2389,1,21,9,6,72,41,31,72
Livingston,2389,2,21,4,11,81,47,34,67
Airdrieon,2389,3,20,7,9,69,49,20,67
Brechin,2389,4,17,2,17,55,61,-6,53
Stranraer,2389,5,15,6,15,50,48,2,51
Peterhead,2389,6,12,6,18,44,54,-10,42
Queen's Park,2389,7,11,9,16,44,59,-15,42
Albion,2389,8,12,4,20,56,65,-9,40
Stenhousem'r,2389,9,11,7,18,49,82,-33,40
East Fife,2389,10,9,8,19,46,60,-14,35
Livingston,2390,1,23,4,9,77,49,28,73
Alloa,2390,2,17,12,7,69,45,24,63
Airdrieon,2390,3,18,5,13,70,55,15,59
Brechin,2390,4,14,9,13,52,49,3,51
Queen's Park,2390,5,14,9,13,47,46,1,51
Peterhead,2390,6,14,8,14,52,59,-7,50
East Fife,2390,7,11,10,15,50,46,4,43
Albion,2390,8,12,6,18,51,65,-14,42
Stranraer,2390,9,9,8,19,44,60,-16,35
Stenhousem'r,2390,10,7,11,18,48,86,-38,32
Livingston,2391,1,20,3,13,84,58,26,63
Airdrieon,2391,2,19,5,12,64,54,10,62
Alloa,2391,3,17,10,9,67,46,21,61
Brechin,2391,4,17,9,10,50,42,8,60
Albion,2391,5,14,9,13,55,56,-1,51
Queen's Park,2391,6,15,4,17,43,54,-11,49
Stranraer,2391,7,13,7,16,46,58,-12,46
Peterhead,2391,8,13,5,18,43,55,-12,44
East Fife,2391,9,12,6,18,51,50,1,42
Stenhousem'r,2391,10,7,8,21,46,76,-30,29
Livingston,2392,1,20,4,12,86,60,26,64
Airdrieon,2392,2,18,7,11,59,49,10,61
Brechin,2392,3,18,6,12,59,52,7,60
Alloa,2392,4,17,7,12,66,48,18,58
Albion,2392,5,14,7,15,54,49,5,49
Peterhead,2392,6,13,9,14,49,57,-8,48
Queen's Park,2392,7,13,6,17,29,46,-17,45
Stranraer,2392,8,13,5,18,52,67,-15,44
Stenhousem'r,2392,9,12,6,18,46,65,-19,42
East Fife,2392,10,10,7,19,47,54,-7,37
Livingston,2393,1,21,4,11,88,54,34,67
Alloa,2393,2,17,8,11,70,44,26,59
Brechin,2393,3,16,10,10,52,47,5,58
Albion,2393,4,15,11,10,56,46,10,56
Airdrieon,2393,5,16,6,14,51,60,-9,54
Queen's Park,2393,6,13,9,14,39,45,-6,48
Stranraer,2393,7,13,8,15,50,61,-11,47
Peterhead,2393,8,13,7,16,55,66,-11,46
East Fife,2393,9,8,9,19,48,57,-9,33
Stenhousem'r,2393,10,8,8,20,44,73,-29,32
Livingston,2394,1,22,3,11,81,43,38,69
Alloa,2394,2,19,10,7,64,37,27,67
Airdrieon,2394,3,21,4,11,70,59,11,67
Peterhead,2394,4,14,9,13,54,44,10,51
Albion,2394,5,14,8,14,47,50,-3,50
Brechin,2394,6,14,8,14,45,54,-9,50
Stranraer,2394,7,13,5,18,54,64,-10,44
Queen's Park,2394,8,11,11,14,36,49,-13,44
East Fife,2394,9,10,7,19,41,48,-7,37
Stenhousem'r,2394,10,7,5,24,41,85,-44,26
Livingston,2395,1,24,4,8,80,40,40,76
Alloa,2395,2,18,8,10,67,40,27,62
Queen's Park,2395,3,15,7,14,52,51,1,52
East Fife,2395,4,14,9,13,60,53,7,51
Peterhead,2395,5,14,8,14,52,61,-9,50
Airdrieon,2395,6,13,9,14,55,55,0,48
Albion,2395,7,12,9,15,52,51,1,45
Brechin,2395,8,12,9,15,44,59,-15,45
Stenhousem'r,2395,9,9,9,18,46,75,-29,36
Stranraer,2395,10,9,8,19,42,65,-23,35
Alloa,2396,1,22,7,7,74,37,37,73
Airdrieon,2396,2,18,11,7,56,39,17,65
Brechin,2396,3,18,6,12,46,39,7,60
Livingston,2396,4,17,6,13,72,54,18,57
Albion,2396,5,14,11,11,58,50,8,53
Peterhead,2396,6,14,8,14,47,54,-7,50
East Fife,2396,7,11,8,17,55,59,-4,41
Stranraer,2396,8,11,7,18,50,59,-9,40
Queen's Park,2396,9,8,7,21,29,58,-29,31
Stenhousem'r,2396,10,7,9,20,40,78,-38,30
Livingston,2397,1,21,6,9,65,40,25,69
Alloa,2397,2,16,10,10,64,46,18,58
Airdrieon,2397,3,16,8,12,64,53,11,56
Peterhead,2397,4,16,8,12,47,45,2,56
East Fife,2397,5,15,7,14,56,44,12,52
Brechin,2397,6,15,3,18,46,48,-2,48
Stranraer,2397,7,12,8,16,55,62,-7,44
Albion,2397,8,12,8,16,42,50,-8,44
Queen's Park,2397,9,12,7,17,35,48,-13,43
Stenhousem'r,2397,10,9,7,20,52,90,-38,34
Alloa,2398,1,22,6,8,68,44,24,72
Livingston,2398,2,21,6,9,71,44,27,69
Airdrieon,2398,3,18,4,14,61,52,9,58
Brechin,2398,4,16,4,16,45,45,0,52
Albion,2398,5,15,6,15,54,54,0,51
Peterhead,2398,6,14,8,14,56,51,5,50
Queen's Park,2398,7,13,7,16,37,51,-14,46
East Fife,2398,8,10,11,15,48,53,-5,41
Stranraer,2398,9,9,7,20,45,59,-14,34
Stenhousem'r,2398,10,7,11,18,43,75,-32,32
Livingston,2399,1,23,6,7,78,36,42,75
Alloa,2399,2,21,6,9,75,36,39,69
Brechin,2399,3,16,5,15,50,52,-2,53
Airdrieon,2399,4,14,10,12,60,62,-2,52
Peterhead,2399,5,14,9,13,49,51,-2,51
Queen's Park,2399,6,14,5,17,43,56,-13,47
Stranraer,2399,7,13,5,18,48,55,-7,44
Albion,2399,8,12,7,17,51,67,-16,43
East Fife,2399,9,11,9,16,47,52,-5,42
Stenhousem'r,2399,10,8,6,22,40,74,-34,30
Livingston,2400,1,28,1,7,88,38,50,85
Airdrieon,2400,2,20,5,11,64,47,17,65
Alloa,2400,3,17,10,9,68,43,25,61
Brechin,2400,4,17,4,15,48,48,0,55
Peterhead,2400,5,16,6,14,59,61,-2,54
East Fife,2400,6,12,7,17,53,67,-14,43
Albion,2400,7,11,7,18,48,64,-16,40
Stranraer,2400,8,12,3,21,51,66,-15,39
Stenhousem'r,2400,9,10,7,19,56,71,-15,37
Queen's Park,2400,10,9,6,21,30,60,-30,33
Livingston,2401,1,21,7,8,71,45,26,70
Alloa,2401,2,19,8,9,71,49,22,65
Brechin,2401,3,17,7,12,57,48,9,58
Albion,2401,4,16,8,12,60,53,7,56
Airdrieon,2401,5,16,7,13,53,53,0,55
Peterhead,2401,6,14,7,15,47,47,0,49
Queen's Park,2401,7,12,7,17,40,53,-13,43
East Fife,2401,8,10,8,18,52,48,4,38
Stenhousem'r,2401,9,10,8,18,45,72,-27,38
Stranraer,2401,10,9,5,22,39,67,-28,32
Livingston,2402,1,21,4,11,82,50,32,67
Brechin,2402,2,19,5,12,52,48,4,62
Alloa,2402,3,16,12,8,64,38,26,60
Albion,2402,4,15,8,13,66,45,21,53
Airdrieon,2402,5,14,10,12,54,56,-2,52
Stranraer,2402,6,14,6,16,49,56,-7,48
East Fife,2402,7,11,13,12,50,47,3,46
Peterhead,2402,8,12,7,17,41,54,-13,43
Queen's Park,2402,9,12,6,18,39,61,-22,42
Stenhousem'r,2402,10,6,9,21,39,81,-42,27
Alloa,2403,1,22,7,7,73,40,33,73
Livingston,2403,2,18,6,12,64,48,16,60
Brechin,2403,3,15,11,10,48,38,10,56
Airdrieon,2403,4,16,3,17,63,56,7,51
Peterhead,2403,5,13,10,13,43,44,-1,49
Stranraer,2403,6,14,4,18,58,65,-7,46
Queen's Park,2403,7,13,7,16,33,50,-17,46
East Fife,2403,8,12,9,15,52,57,-5,45
Albion,2403,9,12,5,19,50,57,-7,41
Stenhousem'r,2403,10,10,8,18,50,79,-29,38
Brechin,2404,1,20,6,10,55,42,13,66
Livingston,2404,2,18,7,11,74,51,23,61
Alloa,2404,3,17,6,13,67,53,14,57
Peterhead,2404,4,15,10,11,53,45,8,55
Airdrieon,2404,5,17,4,15,65,69,-4,55
Albion,2404,6,15,6,15,60,55,5,51
Queen's Park,2404,7,14,9,13,44,47,-3,51
Stranraer,2404,8,12,6,18,55,70,-15,42
East Fife,2404,9,8,10,18,41,52,-11,34
Stenhousem'r,2404,10,7,10,19,49,79,-30,31
Alloa,2405,1,22,7,7,73,35,38,73
Livingston,2405,2,23,3,10,81,41,40,72
Albion,2405,3,20,7,9,69,43,26,67
Brechin,2405,4,15,7,14,54,55,-1,52
Airdrieon,2405,5,15,6,15,57,60,-3,51
East Fife,2405,6,14,8,14,50,52,-2,50
Peterhead,2405,7,10,9,17,48,66,-18,39
Stranraer,2405,8,9,9,18,48,67,-19,36
Queen's Park,2405,9,9,6,21,29,56,-27,33
Stenhousem'r,2405,10,6,12,18,42,76,-34,30
Livingston,2406,1,26,4,6,89,46,43,82
Airdrieon,2406,2,19,7,10,61,46,15,64
Alloa,2406,3,17,6,13,69,49,20,57
Peterhead,2406,4,16,9,11,60,46,14,57
Brechin,2406,5,15,7,14,51,58,-7,52
Albion,2406,6,13,9,14,53,49,4,48
East Fife,2406,7,11,10,15,54,56,-2,43
Stranraer,2406,8,12,4,20,54,66,-12,40
Queen's Park,2406,9,11,5,20,27,51,-24,38
Stenhousem'r,2406,10,6,7,23,48,99,-51,25
Alloa,2407,1,21,8,7,64,39,25,71
Airdrieon,2407,2,19,7,10,57,52,5,64
Livingston,2407,3,18,4,14,71,56,15,58
Brechin,2407,4,17,3,16,54,49,5,54
East Fife,2407,5,13,9,14,48,42,6,48
Peterhead,2407,6,13,7,16,40,56,-16,46
Queen's Park,2407,7,11,12,13,39,46,-7,45
Stranraer,2407,8,12,6,18,47,53,-6,42
Albion,2407,9,11,8,17,46,61,-15,41
Stenhousem'r,2407,10,10,6,20,62,74,-12,36
Alloa,2408,1,19,9,8,84,57,27,66
Brechin,2408,2,18,7,11,60,53,7,61
Livingston,2408,3,17,5,14,69,55,14,56
Airdrieon,2408,4,16,8,12,60,55,5,56
Albion,2408,5,15,8,13,56,48,8,53
Peterhead,2408,6,14,5,17,47,57,-10,47
East Fife,2408,7,11,10,15,50,47,3,43
Stranraer,2408,8,12,7,17,58,59,-1,43
Queen's Park,2408,9,11,7,18,34,61,-27,40
Stenhousem'r,2408,10,8,12,16,44,70,-26,36
Airdrieon,2409,1,21,6,9,61,45,16,69
Livingston,2409,2,21,5,10,68,43,25,68
Alloa,2409,3,19,7,10,71,48,23,64
Peterhead,2409,4,17,9,10,43,36,7,60
Stranraer,2409,5,13,9,14,54,55,-1,48
Queen's Park,2409,6,13,8,15,38,48,-10,47
Albion,2409,7,12,7,17,53,55,-2,43
East Fife,2409,8,10,10,16,40,42,-2,40
Brechin,2409,9,12,4,20,37,54,-17,40
Stenhousem'r,2409,10,5,9,22,37,76,-39,24
Livingston,2410,1,22,4,10,82,43,39,70
Airdrieon,2410,2,17,7,12,60,56,4,58
Alloa,2410,3,16,8,12,72,57,15,56
East Fife,2410,4,14,10,12,55,48,7,52
Stranraer,2410,5,14,9,13,52,51,1,51
Peterhead,2410,6,15,6,15,55,59,-4,51
Albion,2410,7,13,8,15,52,56,-4,47
Brechin,2410,8,14,5,17,49,53,-4,47
Queen's Park,2410,9,14,4,18,39,53,-14,46
Stenhousem'r,2410,10,8,5,23,42,82,-40,29
Alloa,2411,1,23,6,7,73,37,36,75
Livingston,2411,2,21,6,9,77,45,32,69
East Fife,2411,3,16,6,14,58,44,14,54
Peterhead,2411,4,14,9,13,47,49,-2,51
Albion,2411,5,14,8,14,56,52,4,50
Stranraer,2411,6,14,8,14,52,55,-3,50
Brechin,2411,7,12,8,16,50,59,-9,44
Queen's Park,2411,8,11,9,16,41,57,-16,42
Airdrieon,2411,9,10,7,19,42,65,-23,37
Stenhousem'r,2411,10,9,5,22,52,85,-33,32
Livingston,2412,1,20,6,10,78,47,31,66
Peterhead,2412,2,15,12,9,59,43,16,57
Albion,2412,3,17,6,13,53,49,4,57
Brechin,2412,4,16,8,12,51,50,1,56
Airdrieon,2412,5,16,6,14,65,60,5,54
Alloa,2412,6,15,8,13,61,51,10,53
East Fife,2412,7,12,12,12,47,49,-2,48
Stranraer,2412,8,12,6,18,47,62,-15,42
Queen's Park,2412,9,11,6,19,42,61,-19,39
Stenhousem'r,2412,10,5,12,19,39,70,-31,27
Alloa,2413,1,22,6,8,82,41,41,72
Livingston,2413,2,21,5,10,71,43,28,68
Airdrieon,2413,3,18,5,13,54,51,3,59
Brechin,2413,4,16,7,13,47,51,-4,55
Peterhead,2413,5,14,11,11,57,53,4,53
Albion,2413,6,11,11,14,47,54,-7,44
East Fife,2413,7,11,8,17,50,58,-8,41
Queen's Park,2413,8,12,5,19,38,57,-19,41
Stranraer,2413,9,10,7,19,49,64,-15,37
Stenhousem'r,2413,10,9,7,20,48,71,-23,34
Livingston,2414,1,21,4,11,74,49,25,67
Alloa,2414,2,17,9,10,63,42,21,60
Peterhead,2414,3,17,7,12,64,48,16,58
Brechin,2414,4,16,7,13,56,51,5,55
Queen's Park,2414,5,13,12,11,38,45,-7,51
Airdrieon,2414,6,13,11,12,53,55,-2,50
Stranraer,2414,7,14,7,15,52,55,-3,49
Albion,2414,8,11,10,15,52,59,-7,43
East Fife,2414,9,8,13,15,45,52,-7,37
Stenhousem'r,2414,10,6,8,22,46,87,-41,26
Livingston,2415,1,23,3,10,81,43,38,72
Alloa,2415,2,20,6,10,82,46,36,66
Airdrieon,2415,3,18,6,12,69,60,9,60
Brechin,2415,4,15,8,13,54,56,-2,53
Peterhead,2415,5,14,6,16,51,60,-9,48
Albion,2415,6,13,7,16,52,61,-9,46
Queen's Park,2415,7,13,6,17,35,54,-19,45
East Fife,2415,8,12,8,16,57,46,11,44
Stranraer,2415,9,10,11,15,46,56,-10,41
Stenhousem'r,2415,10,9,5,22,50,95,-45,32
Livingston,2416,1,22,4,10,72,44,28,70
Alloa,2416,2,19,9,8,70,38,32,66
Brechin,2416,3,17,8,11,49,45,4,59
Airdrieon,2416,4,17,6,13,62,57,5,57
Peterhead,2416,5,15,7,14,56,53,3,52
Queen's Park,2416,6,12,12,12,36,42,-6,48
East Fife,2416,7,11,13,12,49,48,1,46
Albion,2416,8,12,7,17,53,56,-3,43
Stranraer,2416,9,10,8,18,48,61,-13,38
Stenhousem'r,2416,10,6,4,26,45,96,-51,22
Alloa,2417,1,21,7,8,72,44,28,70
Livingston,2417,2,21,3,12,84,55,29,66
Airdrieon,2417,3,19,5,12,62,57,5,62
Queen's Park,2417,4,17,6,13,45,44,1,57
Peterhead,2417,5,14,7,15,50,56,-6,49
Albion,2417,6,13,7,16,51,59,-8,46
Brechin,2417,7,12,9,15,45,49,-4,45
East Fife,2417,8,11,7,18,57,60,-3,40
Stranraer,2417,9,12,4,20,47,66,-19,40
Stenhousem'r,2417,10,8,9,19,57,80,-23,33
Livingston,2418,1,21,1,14,70,53,17,64
Airdrieon,2418,2,19,4,13,60,57,3,61
Alloa,2418,3,15,14,7,66,48,18,59
Peterhead,2418,4,17,4,15,57,51,6,55
Brechin,2418,5,17,4,15,53,60,-7,55
Albion,2418,6,14,10,12,56,48,8,52
Queen's Park,2418,7,14,8,14,49,48,1,50
Stranraer,2418,8,14,6,16,57,62,-5,48
East Fife,2418,9,10,9,17,51,48,3,39
Stenhousem'r,2418,10,5,8,23,48,92,-44,23
Alloa,2419,1,21,7,8,71,40,31,70
Livingston,2419,2,20,7,9,75,45,30,67
Brechin,2419,3,16,8,12,49,46,3,56
Albion,2419,4,14,9,13,52,47,5,51
Airdrieon,2419,5,15,5,16,51,57,-6,50
East Fife,2419,6,12,13,11,45,43,2,49
Peterhead,2419,7,13,8,15,52,57,-5,47
Stranraer,2419,8,13,7,16,51,57,-6,46
Queen's Park,2419,9,11,4,21,33,56,-23,37
Stenhousem'r,2419,10,7,8,21,49,80,-31,29
Alloa,2420,1,22,7,7,76,44,32,73
Livingston,2420,2,20,3,13,76,48,28,63
Brechin,2420,3,17,10,9,49,37,12,61
Airdrieon,2420,4,18,6,12,57,54,3,60
Albion,2420,5,14,10,12,55,52,3,52
Peterhead,2420,6,13,7,16,42,54,-12,46
Queen's Park,2420,7,11,12,13,33,42,-9,45
Stranraer,2420,8,10,8,18,43,57,-14,38
East Fife,2420,9,8,11,17,43,54,-11,35
Stenhousem'r,2420,10,5,10,21,45,77,-32,25
Livingston,2421,1,23,3,10,79,49,30,72
Alloa,2421,2,20,6,10,78,47,31,66
Airdrieon,2421,3,16,10,10,62,49,13,58
Peterhead,2421,4,16,8,12,49,41,8,56
Albion,2421,5,14,8,14,50,59,-9,50
Stranraer,2421,6,13,9,14,49,54,-5,48
Brechin,2421,7,14,6,16,45,50,-5,48
East Fife,2421,8,10,8,18,40,48,-8,38
Queen's Park,2421,9,10,7,19,34,55,-21,37
Stenhousem'r,2421,10,9,5,22,46,80,-34,32
Livingston,2422,1,24,6,6,87,40,47,78
Alloa,2422,2,19,8,9,75,44,31,65
Airdrieon,2422,3,18,3,15,61,63,-2,57
Brechin,2422,4,15,8,13,48,48,0,53
Peterhead,2422,5,14,7,15,54,55,-1,49
East Fife,2422,6,11,10,15,52,55,-3,43
Stenhousem'r,2422,7,13,4,19,45,74,-29,43
Albion,2422,8,11,9,16,48,53,-5,42
Stranraer,2422,9,11,5,20,42,61,-19,38
Queen's Park,2422,10,8,12,16,36,55,-19,36
Livingston,2423,1,22,3,11,80,47,33,69
Alloa,2423,2,21,6,9,77,44,33,69
Brechin,2423,3,17,6,13,56,49,7,57
Airdrieon,2423,4,16,5,15,55,55,0,53
Queen's Park,2423,5,14,8,14,41,52,-11,50
East Fife,2423,6,12,9,15,45,49,-4,45
Albion,2423,7,12,8,16,54,55,-1,44
Stranraer,2423,8,12,7,17,47,63,-16,43
Peterhead,2423,9,10,9,17,40,55,-15,39
Stenhousem'r,2423,10,9,9,18,53,79,-26,36
Livingston,2424,1,20,5,11,70,43,27,65
Alloa,2424,2,17,11,8,70,48,22,62
Airdrieon,2424,3,17,7,12,58,57,1,58
Albion,2424,4,14,8,14,54,48,6,50
East Fife,2424,5,13,10,13,49,44,5,49
Queen's Park,2424,6,13,10,13,34,48,-14,49
Brechin,2424,7,12,11,13,44,46,-2,47
Stranraer,2424,8,14,5,17,50,55,-5,47
Peterhead,2424,9,12,7,17,52,57,-5,43
Stenhousem'r,2424,10,7,8,21,46,81,-35,29
Alloa,2425,1,18,10,8,69,39,30,64
Livingston,2425,2,19,5,12,67,52,15,62
Peterhead,2425,3,15,11,10,55,51,4,56
Brechin,2425,4,15,7,14,42,41,1,52
Queen's Park,2425,5,15,7,14,39,43,-4,52
Airdrieon,2425,6,13,8,15,55,57,-2,47
Stranraer,2425,7,13,8,15,51,56,-5,47
Albion,2425,8,12,10,14,50,48,2,46
East Fife,2425,9,12,8,16,49,48,1,44
Stenhousem'r,2425,10,6,10,20,36,78,-42,28
Airdrieon,2426,1,22,3,11,64,46,18,69
Livingston,2426,2,20,4,12,74,49,25,64
Brechin,2426,3,17,6,13,47,44,3,57
Alloa,2426,4,15,11,10,68,50,18,56
East Fife,2426,5,14,11,11,59,43,16,53
Albion,2426,6,15,8,13,68,54,14,53
Peterhead,2426,7,13,10,13,50,59,-9,49
Queen's Park,2426,8,11,9,16,43,65,-22,42
Stranraer,2426,9,9,4,23,43,70,-27,31
Stenhousem'r,2426,10,8,6,22,46,82,-36,30
Livingston,2427,1,24,2,10,83,43,40,74
Alloa,2427,2,17,9,10,72,51,21,60
East Fife,2427,3,17,8,11,58,41,17,59
Stranraer,2427,4,16,6,14,56,55,1,54
Airdrieon,2427,5,15,5,16,53,54,-1,50
Brechin,2427,6,13,10,13,48,45,3,49
Queen's Park,2427,7,13,7,16,41,52,-11,46
Albion,2427,8,12,8,16,51,61,-10,44
Peterhead,2427,9,10,7,19,40,62,-22,37
Stenhousem'r,2427,10,9,6,21,42,80,-38,33
Livingston,2428,1,22,4,10,76,43,33,70
Alloa,2428,2,18,8,10,66,46,20,62
Airdrieon,2428,3,15,5,16,57,53,4,50
Peterhead,2428,4,14,8,14,51,57,-6,50
Queen's Park,2428,5,14,8,14,41,49,-8,50
Brechin,2428,6,13,10,13,42,46,-4,49
Albion,2428,7,11,11,14,49,55,-6,44
East Fife,2428,8,12,8,16,47,53,-6,44
Stranraer,2428,9,12,6,18,51,62,-11,42
Stenhousem'r,2428,10,10,10,16,56,72,-16,40
Alloa,2429,1,19,8,9,69,43,26,65
Airdrieon,2429,2,19,6,11,64,51,13,63
Livingston,2429,3,19,3,14,63,56,7,60
Brechin,2429,4,15,8,13,56,51,5,53
Albion,2429,5,15,7,14,54,51,3,52
Peterhead,2429,6,14,10,12,50,52,-2,52
East Fife,2429,7,13,9,14,49,46,3,48
Queen's Park,2429,8,12,8,16,35,50,-15,44
Stranraer,2429,9,8,11,17,50,66,-16,35
Stenhousem'r,2429,10,8,6,22,57,81,-24,30
Livingston,2430,1,23,4,9,76,37,39,73
Alloa,2430,2,18,11,7,68,42,26,65
Brechin,2430,3,19,4,13,52,45,7,61
Airdrieon,2430,4,16,4,16,65,61,4,52
Peterhead,2430,5,14,9,13,61,58,3,51
Stranraer,2430,6,15,6,15,54,57,-3,51
Albion,2430,7,14,7,15,51,53,-2,49
East Fife,2430,8,12,7,17,48,50,-2,43
Queen's Park,2430,9,13,4,19,34,49,-15,43
Stenhousem'r,2430,10,6,4,26,38,95,-57,22
Airdrieon,2431,1,19,8,9,69,53,16,65
Alloa,2431,2,18,10,8,66,45,21,64
Livingston,2431,3,18,9,9,72,45,27,63
Albion,2431,4,16,10,10,58,48,10,58
Peterhead,2431,5,12,12,12,54,53,1,48
Brechin,2431,6,12,8,16,44,48,-4,44
Stranraer,2431,7,11,7,18,59,68,-9,40
Queen's Park,2431,8,10,8,18,38,57,-19,38
East Fife,2431,9,8,13,15,48,58,-10,37
Stenhousem'r,2431,10,10,7,19,51,84,-33,37
Livingston,2432,1,22,3,11,74,46,28,69
Peterhead,2432,2,16,10,10,57,50,7,58
Alloa,2432,3,17,5,14,61,53,8,56
Brechin,2432,4,16,8,12,57,49,8,56
Airdrieon,2432,5,15,6,15,52,55,-3,51
Stranraer,2432,6,14,4,18,53,58,-5,46
Albion,2432,7,11,11,14,47,48,-1,44
Queen's Park,2432,8,11,9,16,39,51,-12,42
Stenhousem'r,2432,9,11,9,16,51,73,-22,42
East Fife,2432,10,8,13,15,43,51,-8,37
Livingston,2433,1,22,5,9,75,43,32,71
Alloa,2433,2,21,7,8,85,45,40,70
Brechin,2433,3,17,7,12,59,53,6,58
Airdrieon,2433,4,16,5,15,59,61,-2,53
Peterhead,2433,5,13,9,14,56,56,0,48
Albion,2433,6,11,14,11,50,50,0,47
Stranraer,2433,7,12,10,14,56,60,-4,46
Queen's Park,2433,8,13,7,16,36,51,-15,46
East Fife,2433,9,8,9,19,42,58,-16,33
Stenhousem'r,2433,10,7,7,22,49,90,-41,28
Alloa,2434,1,21,9,6,76,36,40,72
Peterhead,2434,2,17,8,11,65,43,22,59
Livingston,2434,3,17,6,13,71,54,17,57
Airdrieon,2434,4,15,9,12,56,51,5,54
East Fife,2434,5,15,7,14,60,49,11,52
Albion,2434,6,15,3,18,52,57,-5,48
Brechin,2434,7,13,7,16,45,53,-8,46
Stranraer,2434,8,13,5,18,50,62,-12,44
Queen's Park,2434,9,12,5,19,40,62,-22,41
Stenhousem'r,2434,10,10,5,21,49,97,-48,35
Livingston,2435,1,23,4,9,88,42,46,73
Alloa,2435,2,19,8,9,68,44,24,65
Brechin,2435,3,18,7,11,48,38,10,61
Airdrieon,2435,4,14,9,13,56,63,-7,51
Queen's Park,2435,5,13,7,16,44,57,-13,46
Peterhead,2435,6,11,12,13,47,55,-8,45
Stranraer,2435,7,11,9,16,45,52,-7,42
Albion,2435,8,10,10,16,56,65,-9,40
Stenhousem'r,2435,9,10,8,18,52,81,-29,38
East Fife,2435,10,9,10,17,53,60,-7,37
Livingston,2436,1,21,7,8,79,42,37,70
Alloa,2436,2,20,6,10,66,46,20,66
Airdrieon,2436,3,17,8,11,59,48,11,59
East Fife,2436,4,11,16,9,47,41,6,49
Peterhead,2436,5,12,11,13,52,55,-3,47
Queen's Park,2436,6,13,7,16,36,48,-12,46
Brechin,2436,7,12,9,15,48,52,-4,45
Albion,2436,8,10,12,14,55,60,-5,42
Stranraer,2436,9,11,6,19,42,60,-18,39
Stenhousem'r,2436,10,6,12,18,52,84,-32,30
Alloa,2437,1,19,6,11,78,45,33,63
Brechin,2437,2,18,4,14,47,47,0,58
Albion,2437,3,17,6,13,58,56,2,57
Airdrieon,2437,4,17,5,14,55,55,0,56
Queen's Park,2437,5,17,5,14,44,45,-1,56
Livingston,2437,6,17,4,15,63,50,13,55
Peterhead,2437,7,14,8,14,45,53,-8,50
East Fife,2437,8,11,10,15,46,47,-1,43
Stranraer,2437,9,11,6,19,51,59,-8,39
Stenhousem'r,2437,10,9,6,21,44,74,-30,33
Alloa,2438,1,22,7,7,77,37,40,73
Livingston,2438,2,20,7,9,80,47,33,67
Airdrieon,2438,3,16,7,13,59,60,-1,55
Peterhead,2438,4,15,7,14,55,50,5,52
Albion,2438,5,14,9,13,51,49,2,51
Queen's Park,2438,6,14,6,16,34,54,-20,48
Brechin,2438,7,13,6,17,43,55,-12,45
Stranraer,2438,8,12,8,16,54,61,-7,44
East Fife,2438,9,11,10,15,50,48,2,43
Stenhousem'r,2438,10,6,7,23,43,85,-42,25
Livingston,2439,1,22,6,8,70,38,32,72
Airdrieon,2439,2,17,8,11,52,47,5,59
Brechin,2439,3,15,8,13,54,50,4,53
Alloa,2439,4,14,10,12,57,47,10,52
Peterhead,2439,5,15,6,15,50,52,-2,51
Albion,2439,6,12,9,15,46,52,-6,45
East Fife,2439,7,12,8,16,44,45,-1,44
Stranraer,2439,8,12,7,17,53,61,-8,43
Stenhousem'r,2439,9,12,7,17,52,65,-13,43
Queen's Park,2439,10,9,11,16,36,57,-21,38
Alloa,2440,1,21,10,5,70,34,36,73
Livingston,2440,2,19,7,10,76,44,32,64
Airdrieon,2440,3,19,6,11,60,48,12,63
Brechin,2440,4,16,6,14,49,52,-3,54
East Fife,2440,5,14,8,14,49,46,3,50
Peterhead,2440,6,14,7,15,54,52,2,49
Albion,2440,7,14,6,16,48,52,-4,48
Stranraer,2440,8,12,8,16,50,59,-9,44
Queen's Park,2440,9,9,10,17,29,47,-18,37
Stenhousem'r,2440,10,4,8,24,31,82,-51,20
Brechin,2441,1,17,13,6,59,38,21,64
Alloa,2441,2,20,3,13,77,48,29,63
Livingston,2441,3,17,9,10,72,53,19,60
Airdrieon,2441,4,17,6,13,56,55,1,57
Albion,2441,5,14,11,11,58,54,4,53
Peterhead,2441,6,12,11,13,51,55,-4,47
Stranraer,2441,7,12,9,15,57,54,3,45
Queen's Park,2441,8,10,11,15,39,56,-17,41
East Fife,2441,9,9,13,14,45,46,-1,40
Stenhousem'r,2441,10,4,10,22,40,95,-55,22
Alloa,2442,1,19,8,9,79,44,35,65
Livingston,2442,2,18,7,11,65,53,12,61
Airdrieon,2442,3,17,6,13,57,61,-4,57
Peterhead,2442,4,16,6,14,53,46,7,54
Albion,2442,5,14,9,13,53,47,6,51
Stranraer,2442,6,14,5,17,54,59,-5,47
Brechin,2442,7,13,7,16,45,55,-10,46
East Fife,2442,8,12,8,16,49,48,1,44
Queen's Park,2442,9,11,11,14,38,54,-16,44
Stenhousem'r,2442,10,8,9,19,54,80,-26,33
Livingston,2443,1,19,8,9,73,40,33,65
Alloa,2443,2,18,10,8,64,39,25,64
Brechin,2443,3,16,9,11,55,53,2,57
Airdrieon,2443,4,16,8,12,64,63,1,56
East Fife,2443,5,14,8,14,54,48,6,50
Peterhead,2443,6,14,7,15,50,57,-7,49
Queen's Park,2443,7,13,8,15,40,49,-9,47
Stranraer,2443,8,12,7,17,56,60,-4,43
Albion,2443,9,12,7,17,47,58,-11,43
Stenhousem'r,2443,10,7,6,23,46,82,-36,27
Livingston,2444,1,21,4,11,68,46,22,67
Airdrieon,2444,2,19,7,10,76,58,18,64
Alloa,2444,3,18,6,12,63,45,18,60
East Fife,2444,4,16,6,14,49,43,6,54
Peterhead,2444,5,15,7,14,51,60,-9,52
Brechin,2444,6,16,3,17,47,51,-4,51
Queen's Park,2444,7,15,5,16,52,47,5,50
Albion,2444,8,14,7,15,53,49,4,49
Stranraer,2444,9,12,5,19,49,64,-15,41
Stenhousem'r,2444,10,6,6,24,41,86,-45,24
Airdrieon,2445,1,19,8,9,69,49,20,65
Brechin,2445,2,17,6,13,51,49,2,57
Livingston,2445,3,16,4,16,68,57,11,52
Queen's Park,2445,4,15,7,14,44,50,-6,52
Alloa,2445,5,13,12,11,62,46,16,51
Peterhead,2445,6,15,5,16,45,50,-5,50
Albion,2445,7,13,10,13,56,54,2,49
Stranraer,2445,8,13,7,16,50,58,-8,46
East Fife,2445,9,13,6,17,57,57,0,45
Stenhousem'r,2445,10,10,7,19,43,75,-32,37
Livingston,2446,1,22,2,12,78,46,32,68
Alloa,2446,2,20,6,10,64,42,22,66
Airdrieon,2446,3,18,6,12,62,48,14,60
Brechin,2446,4,16,7,13,48,42,6,55
Peterhead,2446,5,14,10,12,54,55,-1,52
Stranraer,2446,6,13,7,16,52,59,-7,46
Queen's Park,2446,7,13,7,16,31,46,-15,46
East Fife,2446,8,10,8,18,42,58,-16,38
Stenhousem'r,2446,9,10,8,18,51,75,-24,38
Albion,2446,10,9,9,18,52,63,-11,36
Livingston,2447,1,19,7,10,78,50,28,64
Alloa,2447,2,17,11,8,72,45,27,62
Albion,2447,3,16,7,13,62,52,10,55
Airdrieon,2447,4,16,7,13,58,54,4,55
Brechin,2447,5,14,8,14,51,58,-7,50
East Fife,2447,6,13,8,15,48,50,-2,47
Queen's Park,2447,7,13,6,17,35,51,-16,45
Stranraer,2447,8,10,13,13,53,50,3,43
Peterhead,2447,9,11,7,18,41,63,-22,40
Stenhousem'r,2447,10,11,6,19,51,76,-25,39
Brechin,2448,1,22,3,11,66,50,16,69
Livingston,2448,2,21,5,10,77,50,27,68
Queen's Park,2448,3,18,7,11,53,47,6,61
Alloa,2448,4,16,9,11,68,54,14,57
Albion,2448,5,13,10,13,63,56,7,49
Airdrieon,2448,6,13,9,14,52,61,-9,48
Peterhead,2448,7,13,7,16,49,53,-4,46
Stranraer,2448,8,12,6,18,57,63,-6,42
East Fife,2448,9,8,11,17,43,57,-14,35
Stenhousem'r,2448,10,6,9,21,46,83,-37,27
Livingston,2449,1,22,5,9,73,40,33,71
Alloa,2449,2,18,11,7,81,43,38,65
Airdrieon,2449,3,16,10,10,65,56,9,58
Brechin,2449,4,15,8,13,46,47,-1,53
Peterhead,2449,5,13,13,10,56,53,3,52
Albion,2449,6,12,9,15,47,63,-16,45
Stranraer,2449,7,12,8,16,51,59,-8,44
Queen's Park,2449,8,10,7,19,40,61,-21,37
East Fife,2449,9,7,14,15,48,54,-6,35
Stenhousem'r,2449,10,7,11,18,51,82,-31,32
Alloa,2450,1,21,9,6,71,36,35,72
Livingston,2450,2,19,6,11,76,53,23,63
Airdrieon,2450,3,18,8,10,54,49,5,62
Brechin,2450,4,16,8,12,43,35,8,56
Albion,2450,5,14,10,12,45,46,-1,52
Peterhead,2450,6,14,6,16,55,53,2,48
East Fife,2450,7,11,9,16,45,49,-4,42
Stranraer,2450,8,10,8,18,42,56,-14,38
Queen's Park,2450,9,8,11,17,31,54,-23,35
Stenhousem'r,2450,10,7,9,20,54,85,-31,30
Alloa,2451,1,20,10,6,73,40,33,70
Livingston,2451,2,22,3,11,74,37,37,69
Brechin,2451,3,20,4,12,50,42,8,64
Airdrieon,2451,4,14,7,15,51,56,-5,49
Queen's Park,2451,5,15,4,17,39,54,-15,49
Peterhead,2451,6,14,6,16,41,43,-2,48
East Fife,2451,7,12,10,14,47,42,5,46
Albion,2451,8,13,6,17,49,57,-8,45
Stranraer,2451,9,12,4,20,42,60,-18,40
Stenhousem'r,2451,10,7,8,21,35,70,-35,29
Livingston,2452,1,24,3,9,94,45,49,75
Alloa,2452,2,22,5,9,80,46,34,71
Albion,2452,3,13,11,12,51,45,6,50
Airdrieon,2452,4,15,5,16,57,56,1,50
Brechin,2452,5,14,8,14,55,63,-8,50
East Fife,2452,6,13,8,15,48,52,-4,47
Peterhead,2452,7,12,10,14,41,52,-11,46
Stranraer,2452,8,11,7,18,49,65,-16,40
Queen's Park,2452,9,11,6,19,34,59,-25,39
Stenhousem'r,2452,10,11,5,20,59,85,-26,38
Alloa,2453,1,21,7,8,81,42,39,70
Livingston,2453,2,21,6,9,82,48,34,69
Brechin,2453,3,21,6,9,58,47,11,69
Airdrieon,2453,4,18,7,11,66,50,16,61
Albion,2453,5,13,8,15,53,58,-5,47
East Fife,2453,6,11,9,16,51,58,-7,42
Peterhead,2453,7,11,8,17,50,66,-16,41
Stranraer,2453,8,11,7,18,54,65,-11,40
Queen's Park,2453,9,10,8,18,39,63,-24,38
Stenhousem'r,2453,10,6,8,22,45,82,-37,26
Livingston,2454,1,23,4,9,84,45,39,73
Alloa,2454,2,20,8,8,74,42,32,68
Brechin,2454,3,17,4,15,51,48,3,55
Airdrieon,2454,4,16,7,13,55,55,0,55
Peterhead,2454,5,14,10,12,53,51,2,52
Albion,2454,6,13,9,14,50,53,-3,48
Stranraer,2454,7,13,7,16,46,55,-9,46
Queen's Park,2454,8,12,5,19,32,59,-27,41
East Fife,2454,9,10,10,16,47,53,-6,40
Stenhousem'r,2454,10,7,6,23,50,81,-31,27
Livingston,2455,1,22,5,9,78,46,32,71
Peterhead,2455,2,19,7,10,54,43,11,64
Airdrieon,2455,3,19,5,12,62,57,5,62
Brechin,2455,4,18,5,13,51,48,3,59
Alloa,2455,5,13,12,11,54,42,12,51
Albion,2455,6,12,11,13,60,61,-1,47
Queen's Park,2455,7,13,6,17,45,51,-6,45
Stranraer,2455,8,11,4,21,50,64,-14,37
Stenhousem'r,2455,9,9,7,20,54,85,-31,34
East Fife,2455,10,7,12,17,44,55,-11,33
Livingston,2456,1,21,3,12,84,54,30,66
Airdrieon,2456,2,19,6,11,55,47,8,63
Alloa,2456,3,16,8,12,67,45,22,56
East Fife,2456,4,15,8,13,51,46,5,53
Albion,2456,5,16,5,15,52,48,4,53
Stranraer,2456,6,16,5,15,52,58,-6,53
Brechin,2456,7,15,5,16,45,47,-2,50
Queen's Park,2456,8,12,9,15,37,49,-12,45
Stenhousem'r,2456,9,9,8,19,50,80,-30,35
Peterhead,2456,10,8,9,19,38,57,-19,33
Livingston,2457,1,23,6,7,73,35,38,75
Alloa,2457,2,19,8,9,81,50,31,65
Stranraer,2457,3,19,3,14,60,51,9,60
Peterhead,2457,4,15,8,13,66,57,9,53
Airdrieon,2457,5,15,6,15,52,55,-3,51
Brechin,2457,6,15,3,18,51,61,-10,48
Queen's Park,2457,7,14,6,16,33,50,-17,48
Albion,2457,8,13,7,16,51,52,-1,46
East Fife,2457,9,11,6,19,50,60,-10,39
Stenhousem'r,2457,10,7,5,24,40,86,-46,26
Livingston,2458,1,21,4,11,80,48,32,67
Alloa,2458,2,17,9,10,67,43,24,60
Airdrieon,2458,3,18,4,14,55,57,-2,58
Brechin,2458,4,17,6,13,54,51,3,57
Stranraer,2458,5,15,5,16,62,63,-1,50
Albion,2458,6,15,5,16,54,57,-3,50
Queen's Park,2458,7,15,5,16,37,50,-13,50
Peterhead,2458,8,12,11,13,49,44,5,47
East Fife,2458,9,13,6,17,49,49,0,45
Stenhousem'r,2458,10,6,7,23,46,91,-45,25
Livingston,2459,1,23,4,9,79,47,32,73
Alloa,2459,2,22,5,9,73,40,33,71
Brechin,2459,3,18,6,12,56,54,2,60
Airdrieon,2459,4,17,8,11,57,48,9,59
East Fife,2459,5,13,10,13,59,43,16,49
Queen's Park,2459,6,12,8,16,46,53,-7,44
Stranraer,2459,7,11,8,17,51,62,-11,41
Peterhead,2459,8,10,11,15,45,62,-17,41
Albion,2459,9,10,7,19,41,57,-16,37
Stenhousem'r,2459,10,8,5,23,39,80,-41,29
Alloa,2460,1,22,7,7,84,40,44,73
Albion,2460,2,19,9,8,56,39,17,66
Livingston,2460,3,18,7,11,73,47,26,61
Airdrieon,2460,4,15,10,11,65,60,5,55
Brechin,2460,5,13,10,13,42,45,-3,49
Stranraer,2460,6,13,4,19,48,65,-17,43
Peterhead,2460,7,11,9,16,49,53,-4,42
Queen's Park,2460,8,11,6,19,33,59,-26,39
Stenhousem'r,2460,9,9,10,17,45,69,-24,37
East Fife,2460,10,9,8,19,38,56,-18,35
Alloa,2461,1,20,8,8,69,40,29,68
Livingston,2461,2,17,7,12,61,45,16,58
Peterhead,2461,3,15,9,12,51,47,4,54
Airdrieon,2461,4,15,8,13,54,51,3,53
Queen's Park,2461,5,15,7,14,44,42,2,52
Stranraer,2461,6,15,7,14,55,54,1,52
Brechin,2461,7,14,8,14,48,57,-9,50
Albion,2461,8,12,8,16,48,51,-3,44
East Fife,2461,9,11,9,16,45,49,-4,42
Stenhousem'r,2461,10,6,9,21,41,80,-39,27
Alloa,2462,1,25,4,7,84,38,46,79
Livingston,2462,2,19,7,10,74,52,22,64
Albion,2462,3,17,11,8,58,44,14,62
Airdrieon,2462,4,15,7,14,53,61,-8,52
East Fife,2462,5,13,10,13,58,54,4,49
Brechin,2462,6,14,6,16,48,53,-5,48
Queen's Park,2462,7,13,5,18,43,51,-8,44
Peterhead,2462,8,11,7,18,43,54,-11,40
Stranraer,2462,9,11,7,18,55,70,-15,40
Stenhousem'r,2462,10,7,6,23,39,78,-39,27
Alloa,2463,1,23,6,7,89,49,40,75
Livingston,2463,2,19,5,12,78,51,27,62
Albion,2463,3,17,5,14,66,52,14,56
Airdrieon,2463,4,16,7,13,60,58,2,55
Brechin,2463,5,16,4,16,54,61,-7,52
Peterhead,2463,6,14,9,13,57,56,1,51
Stranraer,2463,7,14,5,17,56,63,-7,47
Queen's Park,2463,8,14,4,18,42,59,-17,46
East Fife,2463,9,11,7,18,55,62,-7,40
Stenhousem'r,2463,10,7,6,23,46,92,-46,27
Alloa,2464,1,20,9,7,71,42,29,69
Livingston,2464,2,19,5,12,72,51,21,62
Airdrieon,2464,3,18,4,14,54,59,-5,58
Peterhead,2464,4,15,5,16,56,51,5,50
Queen's Park,2464,5,12,12,12,38,43,-5,48
East Fife,2464,6,13,6,17,52,53,-1,45
Stranraer,2464,7,13,6,17,53,55,-2,45
Albion,2464,8,12,8,16,41,49,-8,44
Brechin,2464,9,11,11,14,46,57,-11,44
Stenhousem'r,2464,10,10,8,18,56,79,-23,38
Alloa,2465,1,21,5,10,71,47,24,68
Livingston,2465,2,20,5,11,75,54,21,65
Airdrieon,2465,3,16,8,12,58,53,5,56
Brechin,2465,4,16,6,14,52,50,2,54
East Fife,2465,5,15,8,13,58,42,16,53
Albion,2465,6,15,5,16,56,58,-2,50
Peterhead,2465,7,12,9,15,50,54,-4,45
Queen's Park,2465,8,11,10,15,37,48,-11,43
Stenhousem'r,2465,9,11,7,18,51,71,-20,40
Stranraer,2465,10,9,5,22,43,74,-31,32
Alloa,2466,1,21,6,9,70,47,23,69
Albion,2466,2,20,5,11,58,44,14,65
Brechin,2466,3,20,4,12,55,41,14,64
Livingston,2466,4,18,4,14,74,58,16,58
Airdrieon,2466,5,17,6,13,67,50,17,57
Peterhead,2466,6,14,7,15,49,56,-7,49
East Fife,2466,7,11,10,15,55,59,-4,43
Stranraer,2466,8,11,6,19,51,64,-13,39
Queen's Park,2466,9,9,8,19,32,51,-19,35
Stenhousem'r,2466,10,8,6,22,49,90,-41,30
Livingston,2467,1,20,5,11,74,46,28,65
Alloa,2467,2,19,7,10,72,42,30,64
Peterhead,2467,3,15,9,12,49,45,4,54
Airdrieon,2467,4,15,8,13,51,59,-8,53
Brechin,2467,5,15,7,14,50,46,4,52
Albion,2467,6,13,11,12,52,53,-1,50
East Fife,2467,7,11,12,13,52,48,4,45
Stranraer,2467,8,13,6,17,49,61,-12,45
Stenhousem'r,2467,9,10,9,17,50,71,-21,39
Queen's Park,2467,10,8,8,20,27,55,-28,32
Alloa,2468,1,19,6,11,75,46,29,63
Airdrieon,2468,2,18,9,9,72,55,17,63
Queen's Park,2468,3,15,8,13,42,44,-2,53
Livingston,2468,4,15,7,14,74,62,12,52
Albion,2468,5,13,11,12,49,51,-2,50
Peterhead,2468,6,14,8,14,42,48,-6,50
East Fife,2468,7,14,5,17,47,45,2,47
Stranraer,2468,8,11,11,14,49,55,-6,44
Brechin,2468,9,12,8,16,41,52,-11,44
Stenhousem'r,2468,10,8,9,19,50,83,-33,33
Livingston,2469,1,23,4,9,82,45,37,73
Alloa,2469,2,19,8,9,81,50,31,65
Airdrieon,2469,3,19,6,11,67,48,19,63
Brechin,2469,4,14,8,14,48,51,-3,50
Queen's Park,2469,5,15,3,18,35,51,-16,48
Albion,2469,6,12,10,14,55,58,-3,46
Peterhead,2469,7,13,7,16,43,56,-13,46
Stranraer,2469,8,11,8,17,51,67,-16,41
East Fife,2469,9,11,7,18,51,53,-2,40
Stenhousem'r,2469,10,7,11,18,50,84,-34,32
Alloa,2470,1,19,11,6,78,43,35,68
Airdrieon,2470,2,18,5,13,55,45,10,59
Livingston,2470,3,17,7,12,78,51,27,58
Brechin,2470,4,17,7,12,46,41,5,58
Albion,2470,5,14,7,15,55,60,-5,49
East Fife,2470,6,13,9,14,55,49,6,48
Queen's Park,2470,7,13,7,16,42,54,-12,46
Stranraer,2470,8,12,7,17,52,68,-16,43
Peterhead,2470,9,12,6,18,49,59,-10,42
Stenhousem'r,2470,10,7,10,19,38,78,-40,31
Airdrieon,2471,1,21,5,10,63,49,14,68
Livingston,2471,2,20,5,11,80,51,29,65
Alloa,2471,3,16,9,11,67,42,25,57
Albion,2471,4,16,8,12,48,48,0,56
Brechin,2471,5,16,6,14,50,47,3,54
Peterhead,2471,6,15,9,12,44,45,-1,54
East Fife,2471,7,11,10,15,50,53,-3,43
Queen's Park,2471,8,11,9,16,30,44,-14,42
Stranraer,2471,9,12,5,19,45,62,-17,41
Stenhousem'r,2471,10,6,6,24,46,82,-36,24
Airdrieon,2472,1,20,5,11,60,51,9,65
Brechin,2472,2,17,7,12,46,44,2,58
East Fife,2472,3,16,9,11,58,42,16,57
Livingston,2472,4,14,11,11,68,54,14,53
Peterhead,2472,5,14,10,12,50,52,-2,52
Alloa,2472,6,14,9,13,61,42,19,51
Albion,2472,7,13,11,12,47,45,2,50
Stranraer,2472,8,12,4,20,50,58,-8,40
Queen's Park,2472,9,8,12,16,36,60,-24,36
Stenhousem'r,2472,10,7,12,17,41,69,-28,33
Alloa,2473,1,21,6,9,73,44,29,69
Livingston,2473,2,20,7,9,66,44,22,67
Brechin,2473,3,19,4,13,57,45,12,61
Airdrieon,2473,4,15,8,13,67,59,8,53
Peterhead,2473,5,12,8,16,48,56,-8,44
East Fife,2473,6,10,13,13,48,45,3,43
Stenhousem'r,2473,7,11,10,15,51,70,-19,43
Albion,2473,8,9,13,14,46,53,-7,40
Queen's Park,2473,9,10,9,17,30,56,-26,39
Stranraer,2473,10,10,8,18,48,62,-14,38
Livingston,2474,1,22,5,9,85,46,39,71
Alloa,2474,2,19,5,12,70,37,33,62
Airdrieon,2474,3,18,5,13,63,53,10,59
Albion,2474,4,14,10,12,57,52,5,52
Queen's Park,2474,5,15,5,16,42,53,-11,50
East Fife,2474,6,13,10,13,45,48,-3,49
Peterhead,2474,7,13,9,14,53,58,-5,48
Brechin,2474,8,13,7,16,45,53,-8,46
Stranraer,2474,9,13,5,18,53,68,-15,44
Stenhousem'r,2474,10,6,7,23,45,90,-45,25
Livingston,2475,1,21,2,13,70,50,20,65
Alloa,2475,2,19,7,10,73,49,24,64
Brechin,2475,3,18,7,11,50,45,5,61
Airdrieon,2475,4,16,8,12,55,48,7,56
Queen's Park,2475,5,16,7,13,46,46,0,55
Albion,2475,6,12,9,15,54,56,-2,45
East Fife,2475,7,12,7,17,61,59,2,43
Peterhead,2475,8,10,10,16,45,61,-16,40
Stranraer,2475,9,11,6,19,55,67,-12,39
Stenhousem'r,2475,10,10,7,19,46,74,-28,37
Livingston,2476,1,23,1,12,69,47,22,70
Albion,2476,2,18,5,13,65,55,10,59
Alloa,2476,3,16,7,13,62,47,15,55
Peterhead,2476,4,15,8,13,55,50,5,53
Airdrieon,2476,5,16,4,16,53,52,1,52
East Fife,2476,6,14,9,13,55,51,4,51
Stranraer,2476,7,15,6,15,52,54,-2,51
Brechin,2476,8,13,9,14,46,50,-4,48
Queen's Park,2476,9,12,9,15,30,46,-16,45
Stenhousem'r,2476,10,7,4,25,39,74,-35,25
Livingston,2477,1,20,4,12,75,49,26,64
Alloa,2477,2,19,7,10,59,36,23,64
Airdrieon,2477,3,18,6,12,57,51,6,60
Albion,2477,4,18,5,13,56,47,9,59
Stranraer,2477,5,18,3,15,59,52,7,57
East Fife,2477,6,13,8,15,55,47,8,47
Peterhead,2477,7,12,9,15,48,65,-17,45
Brechin,2477,8,13,3,20,45,57,-12,42
Queen's Park,2477,9,12,5,19,29,51,-22,41
Stenhousem'r,2477,10,7,10,19,41,69,-28,31
Alloa,2478,1,21,9,6,75,39,36,72
Airdrieon,2478,2,19,5,12,60,53,7,62
Livingston,2478,3,16,8,12,64,46,18,56
Brechin,2478,4,17,5,14,57,49,8,56
Albion,2478,5,16,7,13,52,50,2,55
Stranraer,2478,6,15,4,17,46,50,-4,49
Queen's Park,2478,7,15,3,18,35,51,-16,48
Peterhead,2478,8,11,9,16,48,53,-5,42
East Fife,2478,9,8,10,18,47,58,-11,34
Stenhousem'r,2478,10,9,6,21,49,84,-35,33
Livingston,2479,1,21,8,7,78,43,35,71
Alloa,2479,2,20,7,9,79,40,39,67
Peterhead,2479,3,19,5,12,57,45,12,62
Airdrieon,2479,4,16,6,14,52,54,-2,54
Brechin,2479,5,16,4,16,45,53,-8,52
Albion,2479,6,14,7,15,55,56,-1,49
Stranraer,2479,7,12,7,17,46,54,-8,43
East Fife,2479,8,11,9,16,53,53,0,42
Queen's Park,2479,9,11,7,18,36,60,-24,40
Stenhousem'r,2479,10,7,6,23,40,83,-43,27
Livingston,2480,1,21,6,9,75,49,26,69
Airdrieon,2480,2,16,9,11,63,55,8,57
Alloa,2480,3,14,12,10,67,47,20,54
Stenhousem'r,2480,4,14,8,14,53,59,-6,50
Brechin,2480,5,14,7,15,42,55,-13,49
Stranraer,2480,6,13,8,15,49,52,-3,47
East Fife,2480,7,12,9,15,50,52,-2,45
Peterhead,2480,8,10,13,13,46,52,-6,43
Albion,2480,9,10,12,14,49,56,-7,42
Queen's Park,2480,10,8,12,16,26,43,-17,36
Brechin,2481,1,21,9,6,62,46,16,72
Livingston,2481,2,20,6,10,77,46,31,66
Alloa,2481,3,17,9,10,65,43,22,60
Airdrieon,2481,4,15,11,10,56,55,1,56
Peterhead,2481,5,13,7,16,48,61,-13,46
East Fife,2481,6,11,12,13,53,53,0,45
Stranraer,2481,7,13,6,17,57,61,-4,45
Queen's Park,2481,8,12,8,16,32,50,-18,44
Albion,2481,9,9,8,19,55,62,-7,35
Stenhousem'r,2481,10,8,6,22,45,73,-28,30
Alloa,2482,1,21,6,9,75,42,33,69
Livingston,2482,2,21,3,12,80,53,27,66
Albion,2482,3,18,8,10,55,43,12,62
Stranraer,2482,4,16,6,14,49,45,4,54
Brechin,2482,5,16,5,15,56,53,3,53
Airdrieon,2482,6,14,8,14,56,62,-6,50
Queen's Park,2482,7,14,6,16,44,53,-9,48
East Fife,2482,8,10,9,17,46,54,-8,39
Peterhead,2482,9,10,9,17,45,56,-11,39
Stenhousem'r,2482,10,6,8,22,40,85,-45,26
Livingston,2483,1,20,5,11,77,55,22,65
Alloa,2483,2,17,9,10,68,46,22,60
Airdrieon,2483,3,18,6,12,62,52,10,60
East Fife,2483,4,16,8,12,54,43,11,56
Brechin,2483,5,13,11,12,45,45,0,50
Peterhead,2483,6,13,10,13,46,49,-3,49
Albion,2483,7,12,11,13,49,51,-2,47
Stranraer,2483,8,13,7,16,47,57,-10,46
Queen's Park,2483,9,13,7,16,40,51,-11,46
Stenhousem'r,2483,10,3,10,23,35,74,-39,19
Livingston,2484,1,25,2,9,79,50,29,77
Brechin,2484,2,19,6,11,55,46,9,63
Alloa,2484,3,18,6,12,73,43,30,60
Airdrieon,2484,4,18,5,13,59,49,10,59
Queen's Park,2484,5,14,6,16,42,49,-7,48
Peterhead,2484,6,13,7,16,47,56,-9,46
East Fife,2484,7,12,9,15,43,43,0,45
Stranraer,2484,8,13,6,17,50,61,-11,45
Albion,2484,9,13,6,17,53,65,-12,45
Stenhousem'r,2484,10,5,7,24,33,72,-39,22
Livingston,2485,1,23,4,9,81,43,38,73
Airdrieon,2485,2,18,11,7,67,43,24,65
Peterhead,2485,3,16,8,12,48,45,3,56
Alloa,2485,4,15,10,11,67,49,18,55
Brechin,2485,5,15,6,15,52,55,-3,51
Stranraer,2485,6,15,5,16,55,65,-10,50
Albion,2485,7,11,9,16,46,56,-10,42
East Fife,2485,8,11,8,17,45,44,1,41
Queen's Park,2485,9,10,9,17,31,55,-24,39
Stenhousem'r,2485,10,8,6,22,47,84,-37,30
Brechin,2486,1,20,6,10,58,43,15,66
Alloa,2486,2,18,11,7,65,36,29,65
Livingston,2486,3,20,5,11,72,45,27,65
Airdrieon,2486,4,18,7,11,55,49,6,61
Peterhead,2486,5,15,8,13,56,50,6,53
East Fife,2486,6,12,11,13,51,48,3,47
Stranraer,2486,7,12,6,18,47,53,-6,42
Queen's Park,2486,8,9,9,18,34,59,-25,36
Albion,2486,9,9,7,20,34,59,-25,34
Stenhousem'r,2486,10,8,8,20,42,72,-30,32
Livingston,2487,1,19,8,9,74,43,31,65
Alloa,2487,2,18,9,9,61,41,20,63
Brechin,2487,3,18,9,9,52,38,14,63
Airdrieon,2487,4,15,12,9,59,50,9,57
Albion,2487,5,15,9,12,54,47,7,54
Peterhead,2487,6,9,13,14,42,49,-7,40
East Fife,2487,7,10,10,16,49,57,-8,40
Stranraer,2487,8,11,7,18,44,63,-19,40
Stenhousem'r,2487,9,9,10,17,48,71,-23,37
Queen's Park,2487,10,8,9,19,33,57,-24,33
Alloa,2488,1,19,6,11,72,41,31,63
Livingston,2488,2,19,5,12,89,58,31,62
Peterhead,2488,3,16,11,9,53,45,8,59
Airdrieon,2488,4,14,10,12,61,65,-4,52
East Fife,2488,5,13,12,11,53,52,1,51
Brechin,2488,6,15,5,16,54,62,-8,50
Albion,2488,7,12,9,15,59,57,2,45
Queen's Park,2488,8,11,11,14,43,57,-14,44
Stranraer,2488,9,9,9,18,47,65,-18,36
Stenhousem'r,2488,10,8,10,18,45,74,-29,34
Alloa,2489,1,21,8,7,75,45,30,71
Airdrieon,2489,2,19,7,10,57,46,11,64
Livingston,2489,3,20,3,13,72,49,23,63
Brechin,2489,4,17,3,16,45,49,-4,54
Stranraer,2489,5,13,6,17,59,60,-1,45
Albion,2489,6,11,11,14,46,48,-2,44
Queen's Park,2489,7,12,8,16,39,51,-12,44
Peterhead,2489,8,11,8,17,47,64,-17,41
East Fife,2489,9,9,13,14,43,50,-7,40
Stenhousem'r,2489,10,9,9,18,48,69,-21,36
Alloa,2490,1,21,8,7,72,39,33,71
Livingston,2490,2,20,4,12,64,41,23,64
Peterhead,2490,3,17,9,10,54,47,7,60
Airdrieon,2490,4,17,6,13,67,56,11,57
Stranraer,2490,5,14,5,17,53,62,-9,47
Brechin,2490,6,13,7,16,47,55,-8,46
Queen's Park,2490,7,13,7,16,46,54,-8,46
Albion,2490,8,13,5,18,54,63,-9,44
East Fife,2490,9,10,10,16,56,62,-6,40
Stenhousem'r,2490,10,8,7,21,43,77,-34,31
Alloa,2491,1,20,8,8,68,40,28,68
Livingston,2491,2,19,6,11,74,47,27,63
Albion,2491,3,17,7,12,56,45,11,58
Airdrieon,2491,4,14,6,16,45,52,-7,48
Queen's Park,2491,5,13,9,14,40,47,-7,48
Stranraer,2491,6,14,5,17,49,55,-6,47
Brechin,2491,7,12,9,15,45,52,-7,45
Peterhead,2491,8,12,9,15,36,49,-13,45
East Fife,2491,9,12,8,16,42,46,-4,44
Stenhousem'r,2491,10,9,9,18,42,64,-22,36
Livingston,2492,1,20,9,7,88,53,35,69
Alloa,2492,2,17,10,9,68,44,24,61
Peterhead,2492,3,17,6,13,51,47,4,57
Airdrieon,2492,4,16,8,12,60,57,3,56
Albion,2492,5,14,7,15,53,51,2,49
Stranraer,2492,6,13,10,13,53,53,0,49
Brechin,2492,7,12,10,14,53,61,-8,46
Queen's Park,2492,8,10,9,17,40,57,-17,39
Stenhousem'r,2492,9,8,11,17,47,77,-30,35
East Fife,2492,10,8,10,18,46,59,-13,34
Livingston,2493,1,22,5,9,77,45,32,71
Alloa,2493,2,18,9,9,74,47,27,63
Airdrieon,2493,3,19,6,11,60,51,9,63
Brechin,2493,4,15,6,15,49,50,-1,51
Stranraer,2493,5,13,10,13,50,49,1,49
Peterhead,2493,6,13,9,14,51,54,-3,48
Queen's Park,2493,7,11,11,14,36,48,-12,44
East Fife,2493,8,10,11,15,49,55,-6,41
Albion,2493,9,10,10,16,52,54,-2,40
Stenhousem'r,2493,10,6,9,21,41,86,-45,27
Livingston,2494,1,22,6,8,82,53,29,72
Alloa,2494,2,20,10,6,76,50,26,70
Brechin,2494,3,18,7,11,63,47,16,61
Peterhead,2494,4,16,8,12,61,54,7,56
Albion,2494,5,13,9,14,48,56,-8,48
Airdrieon,2494,6,12,9,15,59,64,-5,45
Queen's Park,2494,7,11,9,16,42,55,-13,42
Stranraer,2494,8,11,8,17,51,60,-9,41
East Fife,2494,9,10,7,19,49,60,-11,37
Stenhousem'r,2494,10,7,7,22,49,81,-32,28
Brechin,2495,1,16,10,10,46,39,7,58
East Fife,2495,2,16,9,11,56,38,18,57
Alloa,2495,3,15,10,11,70,48,22,55
Livingston,2495,4,16,7,13,64,50,14,55
Peterhead,2495,5,14,9,13,46,47,-1,51
Albion,2495,6,14,7,15,46,51,-5,49
Queen's Park,2495,7,14,7,15,37,43,-6,49
Airdrieon,2495,8,14,7,15,60,72,-12,49
Stranraer,2495,9,11,8,17,52,68,-16,41
Stenhousem'r,2495,10,8,10,18,51,72,-21,34
Alloa,2496,1,16,11,9,66,41,25,59
Airdrieon,2496,2,16,8,12,60,55,5,56
Albion,2496,3,15,10,11,57,51,6,55
Brechin,2496,4,17,4,15,49,51,-2,55
Livingston,2496,5,15,6,15,65,60,5,51
Queen's Park,2496,6,13,10,13,45,48,-3,49
Peterhead,2496,7,13,8,15,46,51,-5,47
East Fife,2496,8,12,9,15,47,48,-1,45
Stranraer,2496,9,10,10,16,53,63,-10,40
Stenhousem'r,2496,10,10,10,16,47,67,-20,40
Alloa,2497,1,19,12,5,69,34,35,69
Brechin,2497,2,21,2,13,47,40,7,65
Livingston,2497,3,19,5,12,81,50,31,62
Airdrieon,2497,4,17,11,8,63,50,13,62
Peterhead,2497,5,14,11,11,47,46,1,53
Albion,2497,6,13,8,15,42,52,-10,47
Queen's Park,2497,7,12,8,16,30,47,-17,44
Stranraer,2497,8,9,8,19,48,64,-16,35
East Fife,2497,9,8,9,19,48,56,-8,33
Stenhousem'r,2497,10,7,8,21,45,81,-36,29
Livingston,2498,1,21,6,9,84,46,38,69
Airdrieon,2498,2,19,10,7,68,48,20,67
Alloa,2498,3,19,9,8,71,40,31,66
Peterhead,2498,4,16,6,14,49,44,5,54
Albion,2498,5,12,9,15,51,59,-8,45
Brechin,2498,6,13,6,17,51,62,-11,45
Queen's Park,2498,7,12,5,19,41,69,-28,41
Stenhousem'r,2498,8,11,7,18,48,73,-25,40
East Fife,2498,9,10,9,17,48,56,-8,39
Stranraer,2498,10,11,5,20,51,65,-14,38
Livingston,2499,1,21,5,10,80,48,32,68
Brechin,2499,2,17,9,10,54,39,15,60
Alloa,2499,3,16,9,11,64,45,19,57
East Fife,2499,4,16,9,11,51,39,12,57
Queen's Park,2499,5,13,11,12,37,41,-4,50
Peterhead,2499,6,14,7,15,43,44,-1,49
Airdrieon,2499,7,14,6,16,49,62,-13,48
Stranraer,2499,8,13,5,18,55,64,-9,44
Albion,2499,9,13,4,19,52,64,-12,43
Stenhousem'r,2499,10,8,5,23,48,87,-39,29
Livingston,2500,1,19,8,9,69,44,25,65
Albion,2500,2,17,9,10,64,48,16,60
Airdrieon,2500,3,17,7,12,56,54,2,58
Alloa,2500,4,14,11,11,64,52,12,53
Stranraer,2500,5,12,12,12,59,54,5,48
Peterhead,2500,6,13,9,14,53,49,4,48
Brechin,2500,7,13,9,14,47,57,-10,48
East Fife,2500,8,11,11,14,43,43,0,44
Queen's Park,2500,9,9,11,16,29,47,-18,38
Stenhousem'r,2500,10,7,9,20,48,84,-36,30
Livingston,2501,1,22,4,10,88,48,40,70
Airdrieon,2501,2,22,4,10,68,50,18,70
Alloa,2501,3,15,9,12,56,41,15,54
Peterhead,2501,4,15,7,14,51,59,-8,52
Albion,2501,5,14,8,14,51,54,-3,50
East Fife,2501,6,13,10,13,48,40,8,49
Brechin,2501,7,11,14,11,45,50,-5,47
Queen's Park,2501,8,13,6,17,39,51,-12,45
Stranraer,2501,9,11,7,18,52,56,-4,40
Stenhousem'r,2501,10,5,9,22,39,88,-49,24
Livingston,2502,1,22,8,6,84,40,44,74
Brechin,2502,2,20,9,7,59,40,19,69
Alloa,2502,3,19,7,10,68,46,22,64
Albion,2502,4,15,9,12,60,53,7,54
East Fife,2502,5,12,9,15,53,50,3,45
Peterhead,2502,6,12,9,15,45,56,-11,45
Airdrieon,2502,7,12,8,16,58,59,-1,44
Queen's Park,2502,8,13,5,18,44,62,-18,44
Stranraer,2502,9,9,6,21,43,69,-26,33
Stenhousem'r,2502,10,6,10,20,44,83,-39,28
Livingston,2503,1,22,4,10,72,36,36,70
Alloa,2503,2,19,11,6,70,42,28,68
Brechin,2503,3,19,7,10,56,43,13,64
Airdrieon,2503,4,16,7,13,48,50,-2,55
Peterhead,2503,5,15,5,16,43,53,-10,50
Stranraer,2503,6,14,6,16,45,53,-8,48
East Fife,2503,7,13,7,16,49,43,6,46
Albion,2503,8,11,6,19,49,60,-11,39
Queen's Park,2503,9,11,6,19,29,49,-20,39
Stenhousem'r,2503,10,8,5,23,54,86,-32,29
Livingston,2504,1,23,6,7,80,47,33,75
Alloa,2504,2,17,11,8,61,38,23,62
Airdrieon,2504,3,16,7,13,61,59,2,55
Peterhead,2504,4,15,9,12,58,57,1,54
Brechin,2504,5,15,9,12,55,57,-2,54
East Fife,2504,6,12,7,17,51,48,3,43
Albion,2504,7,12,7,17,57,59,-2,43
Queen's Park,2504,8,12,6,18,37,57,-20,42
Stenhousem'r,2504,9,11,8,17,55,78,-23,41
Stranraer,2504,10,9,6,21,49,64,-15,33
Livingston,2505,1,25,3,8,82,43,39,78
Alloa,2505,2,19,7,10,74,49,25,64
Albion,2505,3,14,12,10,56,50,6,54
Stranraer,2505,4,15,6,15,58,56,2,51
Airdrieon,2505,5,15,6,15,49,51,-2,51
Brechin,2505,6,13,10,13,56,54,2,49
Peterhead,2505,7,13,10,13,49,52,-3,49
Queen's Park,2505,8,9,10,17,39,62,-23,37
Stenhousem'r,2505,9,8,9,19,44,79,-35,33
East Fife,2505,10,7,11,18,43,54,-11,32
Livingston,2506,1,22,5,9,84,44,40,71
Alloa,2506,2,18,7,11,71,49,22,61
Albion,2506,3,15,11,10,57,48,9,56
Airdrieon,2506,4,16,8,12,62,58,4,56
Brechin,2506,5,16,7,13,54,49,5,55
Stranraer,2506,6,16,5,15,47,54,-7,53
Queen's Park,2506,7,13,8,15,36,47,-11,47
Peterhead,2506,8,12,8,16,46,59,-13,44
East Fife,2506,9,8,11,17,41,50,-9,35
Stenhousem'r,2506,10,2,14,20,40,80,-40,20
Alloa,2507,1,21,6,9,65,36,29,69
Livingston,2507,2,20,6,10,64,38,26,66
Airdrieon,2507,3,18,8,10,65,54,11,62
Albion,2507,4,15,9,12,48,41,7,54
Brechin,2507,5,16,6,14,51,45,6,54
Peterhead,2507,6,13,8,15,48,50,-2,47
Queen's Park,2507,7,12,5,19,29,53,-24,41
East Fife,2507,8,10,8,18,44,56,-12,38
Stranraer,2507,9,10,8,18,43,59,-16,38
Stenhousem'r,2507,10,8,10,18,44,69,-25,34
Livingston,2508,1,19,7,10,69,44,25,64
Alloa,2508,2,18,8,10,69,48,21,62
Brechin,2508,3,18,7,11,49,38,11,61
Airdrieon,2508,4,17,8,11,56,54,2,59
Queen's Park,2508,5,15,7,14,44,45,-1,52
East Fife,2508,6,13,6,17,51,51,0,45
Albion,2508,7,13,6,17,55,59,-4,45
Stranraer,2508,8,12,5,19,47,65,-18,41
Stenhousem'r,2508,9,10,8,18,51,69,-18,38
Peterhead,2508,10,8,12,16,42,60,-18,36
Alloa,2509,1,24,6,6,72,42,30,78
Airdrieon,2509,2,19,4,13,72,56,16,61
Livingston,2509,3,19,3,14,69,47,22,60
Brechin,2509,4,17,3,16,59,58,1,54
Peterhead,2509,5,14,7,15,52,51,1,49
Albion,2509,6,14,6,16,48,58,-10,48
Queen's Park,2509,7,13,8,15,37,49,-12,47
Stranraer,2509,8,12,5,19,50,59,-9,41
East Fife,2509,9,9,10,17,46,54,-8,37
Stenhousem'r,2509,10,10,6,20,39,70,-31,36
Livingston,2510,1,24,1,11,77,43,34,73
Alloa,2510,2,18,6,12,66,48,18,60
Airdrieon,2510,3,18,5,13,66,59,7,59
Brechin,2510,4,18,5,13,52,46,6,59
Stranraer,2510,5,13,8,15,50,53,-3,47
Peterhead,2510,6,13,7,16,51,61,-10,46
East Fife,2510,7,12,9,15,46,45,1,45
Albion,2510,8,12,9,15,48,54,-6,45
Queen's Park,2510,9,10,10,16,40,53,-13,40
Stenhousem'r,2510,10,9,6,21,41,75,-34,33
Alloa,2511,1,20,10,6,70,38,32,70
Livingston,2511,2,21,6,9,79,49,30,69
Brechin,2511,3,17,6,13,53,49,4,57
Airdrieon,2511,4,16,6,14,57,61,-4,54
East Fife,2511,5,14,10,12,48,42,6,52
Stranraer,2511,6,15,4,17,56,63,-7,49
Albion,2511,7,12,10,14,58,54,4,46
Peterhead,2511,8,11,10,15,49,54,-5,43
Queen's Park,2511,9,8,9,19,31,52,-21,33
Stenhousem'r,2511,10,7,7,22,49,88,-39,28
Livingston,2512,1,22,5,9,74,46,28,71
Airdrieon,2512,2,20,9,7,63,47,16,69
Alloa,2512,3,19,8,9,70,40,30,65
Brechin,2512,4,16,8,12,55,53,2,56
Albion,2512,5,13,5,18,55,55,0,44
East Fife,2512,6,11,10,15,55,60,-5,43
Peterhead,2512,7,12,7,17,47,57,-10,43
Queen's Park,2512,8,12,5,19,35,52,-17,41
Stranraer,2512,9,11,7,18,51,67,-16,40
Stenhousem'r,2512,10,8,8,20,44,72,-28,32
Livingston,2513,1,28,4,4,91,34,57,88
Brechin,2513,2,17,7,12,57,47,10,58
Airdrieon,2513,3,16,6,14,60,53,7,54
East Fife,2513,4,14,8,14,60,50,10,50
Alloa,2513,5,14,8,14,59,51,8,50
Peterhead,2513,6,12,8,16,43,55,-12,44
Queen's Park,2513,7,12,8,16,44,57,-13,44
Stranraer,2513,8,12,7,17,42,60,-18,43
Albion,2513,9,11,9,16,48,64,-16,42
Stenhousem'r,2513,10,8,7,21,46,79,-33,31
Brechin,2514,1,20,5,11,55,43,12,65
Livingston,2514,2,19,6,11,74,55,19,63
Airdrieon,2514,3,19,4,13,58,52,6,61
Alloa,2514,4,15,12,9,65,43,22,57
Albion,2514,5,14,9,13,54,54,0,51
Stranraer,2514,6,14,6,16,59,60,-1,48
Queen's Park,2514,7,13,8,15,38,44,-6,47
East Fife,2514,8,11,11,14,59,56,3,44
Peterhead,2514,9,10,9,17,37,47,-10,39
Stenhousem'r,2514,10,7,6,23,46,91,-45,27
Livingston,2515,1,22,4,10,70,37,33,70
Alloa,2515,2,18,9,9,76,46,30,63
Airdrieon,2515,3,18,5,13,53,50,3,59
Brechin,2515,4,17,5,14,53,48,5,56
Albion,2515,5,14,7,15,50,54,-4,49
Queen's Park,2515,6,14,6,16,34,47,-13,48
Stranraer,2515,7,12,7,17,47,55,-8,43
Peterhead,2515,8,10,11,15,43,59,-16,41
East Fife,2515,9,10,9,17,42,52,-10,39
Stenhousem'r,2515,10,9,9,18,52,72,-20,36
Alloa,2516,1,20,10,6,83,42,41,70
Livingston,2516,2,21,6,9,80,49,31,69
Airdrieon,2516,3,19,7,10,74,51,23,64
Albion,2516,4,14,11,11,58,57,1,53
Peterhead,2516,5,14,11,11,50,49,1,53
Brechin,2516,6,15,4,17,49,57,-8,49
Stranraer,2516,7,12,6,18,50,65,-15,42
East Fife,2516,8,8,15,13,45,47,-2,39
Queen's Park,2516,9,8,8,20,32,59,-27,32
Stenhousem'r,2516,10,6,8,22,39,84,-45,26
Livingston,2517,1,23,5,8,80,46,34,74
Alloa,2517,2,17,8,11,64,43,21,59
Airdrieon,2517,3,17,8,11,55,50,5,59
Brechin,2517,4,18,3,15,58,53,5,57
Albion,2517,5,17,5,14,58,55,3,56
Peterhead,2517,6,16,6,14,54,61,-7,54
East Fife,2517,7,13,9,14,56,48,8,48
Stranraer,2517,8,13,7,16,52,56,-4,46
Queen's Park,2517,9,9,5,22,40,67,-27,32
Stenhousem'r,2517,10,6,6,24,45,83,-38,24
Alloa,2518,1,19,8,9,72,47,25,65
Brechin,2518,2,18,5,13,55,45,10,59
East Fife,2518,3,16,9,11,62,44,18,57
Airdrieon,2518,4,16,9,11,64,59,5,57
Livingston,2518,5,16,7,13,70,55,15,55
Albion,2518,6,15,7,14,58,58,0,52
Stranraer,2518,7,14,6,16,61,64,-3,48
Peterhead,2518,8,12,7,17,55,64,-9,43
Queen's Park,2518,9,9,10,17,34,54,-20,37
Stenhousem'r,2518,10,6,10,20,45,86,-41,28
Livingston,2519,1,20,7,9,82,44,38,67
Brechin,2519,2,19,6,11,58,51,7,63
Alloa,2519,3,17,9,10,75,46,29,60
Airdrieon,2519,4,16,8,12,57,56,1,56
Albion,2519,5,14,9,13,60,63,-3,51
Stranraer,2519,6,14,6,16,58,67,-9,48
Peterhead,2519,7,13,8,15,46,52,-6,47
Queen's Park,2519,8,11,7,18,41,63,-22,40
East Fife,2519,9,9,11,16,47,47,0,38
Stenhousem'r,2519,10,8,7,21,52,87,-35,31
Livingston,2520,1,23,2,11,68,41,27,71
Alloa,2520,2,18,7,11,65,47,18,61
Airdrieon,2520,3,17,8,11,60,49,11,59
Peterhead,2520,4,15,8,13,50,49,1,53
Stranraer,2520,5,15,5,16,55,56,-1,50
Albion,2520,6,14,7,15,47,53,-6,49
Queen's Park,2520,7,14,7,15,41,50,-9,49
Brechin,2520,8,14,6,16,51,58,-7,48
East Fife,2520,9,11,8,17,57,53,4,41
Stenhousem'r,2520,10,6,8,22,42,80,-38,26
Alloa,2521,1,22,8,6,73,34,39,74
Livingston,2521,2,21,7,8,82,40,42,70
Brechin,2521,3,17,8,11,49,49,0,59
Airdrieon,2521,4,15,7,14,65,56,9,52
Stranraer,2521,5,14,4,18,48,55,-7,46
East Fife,2521,6,11,12,13,54,50,4,45
Albion,2521,7,11,11,14,48,56,-8,44
Peterhead,2521,8,12,6,18,39,53,-14,42
Queen's Park,2521,9,11,7,18,43,64,-21,40
Stenhousem'r,2521,10,6,10,20,45,89,-44,28
Livingston,2522,1,21,1,14,75,46,29,64
Airdrieon,2522,2,19,6,11,62,57,5,63
Alloa,2522,3,16,9,11,62,52,10,57
Albion,2522,4,16,7,13,62,59,3,55
Brechin,2522,5,14,12,10,47,44,3,54
Peterhead,2522,6,13,7,16,54,60,-6,46
Queen's Park,2522,7,13,7,16,42,56,-14,46
Stranraer,2522,8,11,11,14,50,52,-2,44
East Fife,2522,9,12,7,17,51,51,0,43
Stenhousem'r,2522,10,9,5,22,53,81,-28,32
Livingston,2523,1,21,4,11,72,47,25,67
Alloa,2523,2,19,8,9,65,46,19,65
East Fife,2523,3,16,7,13,60,43,17,55
Stranraer,2523,4,16,6,14,52,48,4,54
Airdrieon,2523,5,14,8,14,55,64,-9,50
Peterhead,2523,6,12,13,11,43,44,-1,49
Brechin,2523,7,15,3,18,45,58,-13,48
Albion,2523,8,12,6,18,49,53,-4,42
Stenhousem'r,2523,9,11,6,19,46,66,-20,39
Queen's Park,2523,10,11,5,20,31,49,-18,38
Livingston,2524,1,20,4,12,69,42,27,64
Airdrieon,2524,2,18,9,9,61,47,14,63
Brechin,2524,3,18,5,13,51,43,8,59
Alloa,2524,4,16,8,12,59,46,13,56
Peterhead,2524,5,16,8,12,54,50,4,56
East Fife,2524,6,14,6,16,55,50,5,48
Albion,2524,7,13,6,17,52,61,-9,45
Queen's Park,2524,8,11,10,15,36,52,-16,43
Stranraer,2524,9,10,9,17,49,58,-9,39
Stenhousem'r,2524,10,9,5,22,41,78,-37,32
Livingston,2525,1,19,6,11,79,50,29,63
Brechin,2525,2,18,9,9,47,32,15,63
Alloa,2525,3,18,8,10,74,50,24,62
Albion,2525,4,17,8,11,59,43,16,59
Peterhead,2525,5,16,8,12,44,47,-3,56
Stranraer,2525,6,16,5,15,49,45,4,53
Airdrieon,2525,7,12,12,12,50,56,-6,48
East Fife,2525,8,9,12,15,48,52,-4,39
Queen's Park,2525,9,8,5,23,27,66,-39,29
Stenhousem'r,2525,10,7,7,22,45,81,-36,28
Alloa,2526,1,22,8,6,82,38,44,74
Livingston,2526,2,21,5,10,76,48,28,68
Brechin,2526,3,17,8,11,57,57,0,59
Albion,2526,4,14,8,14,56,61,-5,50
Queen's Park,2526,5,13,8,15,39,46,-7,47
Airdrieon,2526,6,12,10,14,50,65,-15,46
Peterhead,2526,7,11,12,13,48,52,-4,45
East Fife,2526,8,11,11,14,56,51,5,44
Stranraer,2526,9,11,9,16,49,55,-6,42
Stenhousem'r,2526,10,4,9,23,42,82,-40,21
Airdrieon,2527,1,20,7,9,66,47,19,67
Brechin,2527,2,21,4,11,63,53,10,67
Alloa,2527,3,20,6,10,72,44,28,66
Livingston,2527,4,21,3,12,62,42,20,66
Albion,2527,5,14,7,15,54,58,-4,49
Peterhead,2527,6,13,8,15,44,51,-7,47
East Fife,2527,7,11,11,14,50,52,-2,44
Queen's Park,2527,8,11,5,20,32,50,-18,38
Stranraer,2527,9,9,8,19,38,55,-17,35
Stenhousem'r,2527,10,7,7,22,45,74,-29,28
Livingston,2528,1,21,6,9,76,45,31,69
Alloa,2528,2,20,7,9,70,41,29,67
Airdrieon,2528,3,20,5,11,67,58,9,65
Queen's Park,2528,4,16,4,16,46,53,-7,52
Brechin,2528,5,14,7,15,51,57,-6,49
Albion,2528,6,13,9,14,52,53,-1,48
Stranraer,2528,7,14,4,18,60,61,-1,46
East Fife,2528,8,10,9,17,47,50,-3,39
Peterhead,2528,9,10,7,19,47,64,-17,37
Stenhousem'r,2528,10,9,8,19,43,77,-34,35
Livingston,2529,1,23,4,9,76,42,34,73
Alloa,2529,2,20,7,9,82,48,34,67
Airdrieon,2529,3,18,7,11,57,51,6,61
Brechin,2529,4,16,6,14,51,44,7,54
Stranraer,2529,5,12,10,14,50,51,-1,46
East Fife,2529,6,12,9,15,52,55,-3,45
Albion,2529,7,13,6,17,52,66,-14,45
Queen's Park,2529,8,13,4,19,35,56,-21,43
Peterhead,2529,9,11,9,16,43,45,-2,42
Stenhousem'r,2529,10,7,8,21,49,89,-40,29
Alloa,2530,1,21,5,10,71,40,31,68
Livingston,2530,2,18,5,13,78,58,20,59
Albion,2530,3,16,8,12,53,49,4,56
East Fife,2530,4,15,7,14,62,49,13,52
Stranraer,2530,5,15,7,14,60,55,5,52
Brechin,2530,6,15,7,14,50,47,3,52
Airdrieon,2530,7,15,7,14,50,58,-8,52
Peterhead,2530,8,12,8,16,46,57,-11,44
Queen's Park,2530,9,12,7,17,40,57,-17,43
Stenhousem'r,2530,10,6,9,21,42,82,-40,27
Livingston,2531,1,24,3,9,84,45,39,75
Brechin,2531,2,21,6,9,58,38,20,69
Airdrieon,2531,3,21,5,10,60,52,8,68
Alloa,2531,4,17,8,11,72,49,23,59
Stenhousem'r,2531,5,16,3,17,55,74,-19,51
Albion,2531,6,13,6,17,47,55,-8,45
Queen's Park,2531,7,13,5,18,39,49,-10,44
Peterhead,2531,8,12,6,18,47,60,-13,42
East Fife,2531,9,9,6,21,41,54,-13,33
Stranraer,2531,10,8,4,24,43,70,-27,28
Livingston,2532,1,21,6,9,74,45,29,69
Alloa,2532,2,16,9,11,63,45,18,57
Albion,2532,3,16,8,12,56,49,7,56
East Fife,2532,4,15,10,11,65,50,15,55
Airdrieon,2532,5,15,10,11,51,50,1,55
Brechin,2532,6,14,9,13,50,54,-4,51
Queen's Park,2532,7,13,11,12,35,39,-4,50
Peterhead,2532,8,11,7,18,46,62,-16,40
Stranraer,2532,9,10,6,20,49,62,-13,36
Stenhousem'r,2532,10,5,12,19,47,80,-33,27
Livingston,2533,1,20,7,9,75,44,31,67
Alloa,2533,2,18,9,9,71,46,25,63
Airdrieon,2533,3,18,7,11,52,49,3,61
Albion,2533,4,14,8,14,60,59,1,50
Brechin,2533,5,14,8,14,44,47,-3,50
East Fife,2533,6,12,12,12,50,41,9,48
Peterhead,2533,7,11,12,13,48,55,-7,45
Queen's Park,2533,8,13,5,18,48,59,-11,44
Stranraer,2533,9,10,7,19,39,57,-18,37
Stenhousem'r,2533,10,8,9,19,53,83,-30,33
Livingston,2534,1,22,3,11,69,45,24,69
Brechin,2534,2,19,7,10,57,43,14,64
Airdrieon,2534,3,19,4,13,64,57,7,61
Alloa,2534,4,16,10,10,64,42,22,58
Albion,2534,5,16,8,12,58,44,14,56
East Fife,2534,6,12,12,12,49,48,1,48
Peterhead,2534,7,12,9,15,43,55,-12,45
Stranraer,2534,8,12,4,20,47,60,-13,40
Queen's Park,2534,9,10,8,18,29,48,-19,38
Stenhousem'r,2534,10,6,7,23,43,81,-38,25
Livingston,2535,1,21,5,10,76,42,34,68
Alloa,2535,2,18,7,11,72,46,26,61
Airdrieon,2535,3,17,8,11,57,47,10,59
Albion,2535,4,14,8,14,55,57,-2,50
Peterhead,2535,5,14,8,14,50,55,-5,50
Queen's Park,2535,6,14,7,15,42,46,-4,49
East Fife,2535,7,11,11,14,47,46,1,44
Brechin,2535,8,11,10,15,43,59,-16,43
Stenhousem'r,2535,9,10,9,17,47,74,-27,39
Stranraer,2535,10,11,5,20,46,63,-17,38
Alloa,2536,1,21,7,8,78,46,32,70
Airdrieon,2536,2,21,6,9,65,48,17,69
Livingston,2536,3,19,5,12,75,54,21,62
East Fife,2536,4,16,7,13,66,58,8,55
Albion,2536,5,15,5,16,56,54,2,50
Brechin,2536,6,14,8,14,48,51,-3,50
Queen's Park,2536,7,12,9,15,39,52,-13,45
Peterhead,2536,8,11,8,17,50,52,-2,41
Stranraer,2536,9,10,3,23,42,69,-27,33
Stenhousem'r,2536,10,8,8,20,41,76,-35,32
Livingston,2537,1,23,3,10,78,47,31,72
Brechin,2537,2,18,9,9,56,46,10,63
Alloa,2537,3,18,8,10,85,55,30,62
Airdrieon,2537,4,18,5,13,62,64,-2,59
Queen's Park,2537,5,15,7,14,47,51,-4,52
Albion,2537,6,14,9,13,57,61,-4,51
Peterhead,2537,7,10,12,14,47,50,-3,42
East Fife,2537,8,10,9,17,45,47,-2,39
Stranraer,2537,9,10,6,20,50,66,-16,36
Stenhousem'r,2537,10,7,6,23,45,85,-40,27
Airdrieon,2538,1,21,4,11,65,49,16,67
Albion,2538,2,17,10,9,61,50,11,61
Alloa,2538,3,17,8,11,72,44,28,59
Livingston,2538,4,17,8,11,70,53,17,59
Peterhead,2538,5,15,8,13,47,44,3,53
Brechin,2538,6,14,6,16,49,56,-7,48
Stranraer,2538,7,14,5,17,49,51,-2,47
East Fife,2538,8,12,9,15,44,45,-1,45
Queen's Park,2538,9,12,8,16,31,48,-17,44
Stenhousem'r,2538,10,5,6,25,44,92,-48,21
Livingston,2539,1,20,6,10,71,45,26,66
Alloa,2539,2,18,8,10,68,44,24,62
Brechin,2539,3,16,10,10,54,43,11,58
Airdrieon,2539,4,14,10,12,56,55,1,52
Stranraer,2539,5,14,9,13,54,48,6,51
Peterhead,2539,6,14,7,15,53,59,-6,49
Albion,2539,7,10,12,14,40,48,-8,42
Queen's Park,2539,8,11,9,16,37,56,-19,42
East Fife,2539,9,10,10,16,47,54,-7,40
Stenhousem'r,2539,10,8,9,19,55,83,-28,33
Airdrieon,2540,1,18,10,8,55,42,13,64
Livingston,2540,2,19,4,13,67,45,22,61
Alloa,2540,3,16,10,10,69,49,20,58
Albion,2540,4,16,8,12,47,50,-3,56
Queen's Park,2540,5,16,5,15,41,44,-3,53
Peterhead,2540,6,14,10,12,56,45,11,52
Brechin,2540,7,14,6,16,40,50,-10,48
Stranraer,2540,8,12,7,17,40,53,-13,43
Stenhousem'r,2540,9,8,11,17,47,67,-20,35
East Fife,2540,10,8,7,21,42,59,-17,31
Alloa,2541,1,22,5,9,73,40,33,71
Livingston,2541,2,20,5,11,75,47,28,65
Brechin,2541,3,18,5,13,62,57,5,59
Airdrieon,2541,4,16,5,15,47,50,-3,53
Peterhead,2541,5,14,10,12,55,58,-3,52
East Fife,2541,6,12,11,13,54,55,-1,47
Stranraer,2541,7,14,3,19,48,50,-2,45
Queen's Park,2541,8,11,7,18,44,57,-13,40
Stenhousem'r,2541,9,9,10,17,49,73,-24,37
Albion,2541,10,9,9,18,47,67,-20,36
Livingston,2542,1,24,6,6,81,32,49,78
Alloa,2542,2,22,6,8,71,45,26,72
Airdrieon,2542,3,18,6,12,61,51,10,60
Peterhead,2542,4,16,8,12,48,47,1,56
Brechin,2542,5,15,7,14,49,46,3,52
Albion,2542,6,12,9,15,43,51,-8,45
Queen's Park,2542,7,11,9,16,34,49,-15,42
East Fife,2542,8,8,10,18,37,48,-11,34
Stranraer,2542,9,9,6,21,42,65,-23,33
Stenhousem'r,2542,10,9,5,22,45,77,-32,32
Alloa,2543,1,18,10,8,77,47,30,64
Livingston,2543,2,20,4,12,77,56,21,64
Airdrieon,2543,3,18,7,11,63,55,8,61
Brechin,2543,4,15,9,12,49,48,1,54
Albion,2543,5,13,10,13,57,58,-1,49
Peterhead,2543,6,13,9,14,49,49,0,48
Queen's Park,2543,7,11,12,13,36,49,-13,45
Stranraer,2543,8,12,7,17,48,63,-15,43
East Fife,2543,9,8,11,17,43,50,-7,35
Stenhousem'r,2543,10,6,13,17,59,83,-24,31
Livingston,2544,1,22,3,11,76,47,29,69
Albion,2544,2,20,5,11,62,45,17,65
Brechin,2544,3,16,8,12,53,50,3,56
Alloa,2544,4,15,9,12,72,55,17,54
Airdrieon,2544,5,15,9,12,59,54,5,54
Stranraer,2544,6,15,4,17,41,48,-7,49
East Fife,2544,7,11,10,15,49,47,2,43
Queen's Park,2544,8,12,5,19,38,58,-20,41
Peterhead,2544,9,10,8,18,43,61,-18,38
Stenhousem'r,2544,10,9,9,18,47,75,-28,36
Livingston,2545,1,22,6,8,80,43,37,72
Airdrieon,2545,2,22,5,9,65,45,20,71
Alloa,2545,3,18,6,12,69,47,22,60
Brechin,2545,4,18,6,12,53,50,3,60
Peterhead,2545,5,16,8,12,55,51,4,56
Albion,2545,6,12,9,15,53,59,-6,45
Stranraer,2545,7,10,9,17,41,58,-17,39
East Fife,2545,8,10,8,18,51,52,-1,38
Queen's Park,2545,9,8,11,17,33,51,-18,35
Stenhousem'r,2545,10,6,8,22,42,86,-44,26
Livingston,2546,1,24,1,11,85,47,38,73
Alloa,2546,2,18,7,11,66,45,21,61
Airdrieon,2546,3,17,6,13,50,50,0,57
Brechin,2546,4,17,5,14,50,48,2,56
Stranraer,2546,5,15,4,17,51,55,-4,49
Peterhead,2546,6,13,9,14,53,48,5,48
East Fife,2546,7,12,10,14,52,51,1,46
Albion,2546,8,13,7,16,51,56,-5,46
Queen's Park,2546,9,11,5,20,33,60,-27,38
Stenhousem'r,2546,10,9,8,19,47,78,-31,35
Livingston,2547,1,20,7,9,73,42,31,67
Alloa,2547,2,19,8,9,74,44,30,65
Airdrieon,2547,3,17,8,11,56,46,10,59
East Fife,2547,4,15,9,12,49,40,9,54
Brechin,2547,5,15,8,13,49,50,-1,53
Queen's Park,2547,6,15,8,13,43,49,-6,53
Albion,2547,7,11,10,15,58,55,3,43
Peterhead,2547,8,9,9,18,41,67,-26,36
Stranraer,2547,9,9,8,19,45,63,-18,35
Stenhousem'r,2547,10,6,13,17,41,73,-32,31
Livingston,2548,1,22,1,13,76,52,24,67
Alloa,2548,2,19,9,8,68,35,33,66
Airdrieon,2548,3,19,5,12,60,55,5,62
Queen's Park,2548,4,15,7,14,41,41,0,52
Brechin,2548,5,14,8,14,45,52,-7,50
Stranraer,2548,6,13,8,15,51,61,-10,47
East Fife,2548,7,12,9,15,58,49,9,45
Albion,2548,8,12,7,17,51,57,-6,43
Peterhead,2548,9,10,11,15,44,53,-9,41
Stenhousem'r,2548,10,8,7,21,50,89,-39,31
Alloa,2549,1,21,6,9,72,43,29,69
Livingston,2549,2,21,5,10,72,38,34,68
Brechin,2549,3,19,6,11,52,42,10,63
Stranraer,2549,4,16,4,16,57,52,5,52
Airdrieon,2549,5,14,8,14,47,51,-4,50
East Fife,2549,6,12,12,12,53,44,9,48
Albion,2549,7,11,9,16,42,48,-6,42
Stenhousem'r,2549,8,10,8,18,48,72,-24,38
Peterhead,2549,9,9,10,17,40,68,-28,37
Queen's Park,2549,10,8,10,18,32,57,-25,34
Livingston,2550,1,26,2,8,86,36,50,80
Alloa,2550,2,16,8,12,67,56,11,56
Peterhead,2550,3,16,7,13,55,48,7,55
Airdrieon,2550,4,15,10,11,53,49,4,55
Brechin,2550,5,15,9,12,48,50,-2,54
Albion,2550,6,13,7,16,51,49,2,46
Stranraer,2550,7,12,6,18,46,58,-12,42
Stenhousem'r,2550,8,11,6,19,53,76,-23,39
Queen's Park,2550,9,11,6,19,29,52,-23,39
East Fife,2550,10,9,11,16,43,57,-14,38
Alloa,2551,1,21,7,8,67,42,25,70
Livingston,2551,2,21,4,11,79,50,29,67
Peterhead,2551,3,16,6,14,57,46,11,54
Airdrieon,2551,4,15,9,12,54,58,-4,54
Brechin,2551,5,16,5,15,54,49,5,53
Albion,2551,6,13,10,13,60,59,1,49
East Fife,2551,7,13,7,16,51,52,-1,46
Stranraer,2551,8,13,6,17,56,59,-3,45
Queen's Park,2551,9,12,7,17,37,59,-22,43
Stenhousem'r,2551,10,7,5,24,45,86,-41,26
Alloa,2552,1,23,8,5,77,41,36,77
Livingston,2552,2,22,4,10,78,47,31,70
Albion,2552,3,16,9,11,51,47,4,57
Airdrieon,2552,4,17,6,13,63,60,3,57
Brechin,2552,5,16,4,16,55,52,3,52
East Fife,2552,6,12,10,14,56,52,4,46
Peterhead,2552,7,12,8,16,48,53,-5,44
Queen's Park,2552,8,12,5,19,40,57,-17,41
Stranraer,2552,9,10,7,19,43,62,-19,37
Stenhousem'r,2552,10,5,9,22,38,78,-40,24
Livingston,2553,1,22,3,11,75,55,20,69
Airdrieon,2553,2,17,9,10,60,52,8,60
Alloa,2553,3,15,11,10,71,50,21,56
Brechin,2553,4,16,6,14,54,50,4,54
Albion,2553,5,15,6,15,60,50,10,51
Peterhead,2553,6,13,9,14,47,48,-1,48
Stranraer,2553,7,14,4,18,53,63,-10,46
East Fife,2553,8,11,8,17,50,50,0,41
Queen's Park,2553,9,10,10,16,40,64,-24,40
Stenhousem'r,2553,10,11,6,19,54,82,-28,39
Livingston,2554,1,23,6,7,76,42,34,75
Alloa,2554,2,21,5,10,73,44,29,68
Brechin,2554,3,14,10,12,47,43,4,52
Airdrieon,2554,4,14,9,13,59,62,-3,51
Queen's Park,2554,5,14,7,15,42,49,-7,49
Stranraer,2554,6,14,6,16,60,65,-5,48
Peterhead,2554,7,12,10,14,52,54,-2,46
East Fife,2554,8,10,8,18,43,50,-7,38
Albion,2554,9,9,11,16,42,51,-9,38
Stenhousem'r,2554,10,9,8,19,47,81,-34,35
Livingston,2555,1,22,4,10,79,56,23,70
Airdrieon,2555,2,19,7,10,71,50,21,64
Alloa,2555,3,17,10,9,66,42,24,61
Stranraer,2555,4,16,8,12,56,49,7,56
Brechin,2555,5,17,4,15,53,49,4,55
Peterhead,2555,6,14,8,14,49,58,-9,50
East Fife,2555,7,12,12,12,55,45,10,48
Albion,2555,8,12,7,17,56,62,-6,43
Queen's Park,2555,9,10,3,23,40,66,-26,33
Stenhousem'r,2555,10,6,7,23,48,96,-48,25
Airdrieon,2556,1,17,11,8,68,54,14,62
Livingston,2556,2,18,7,11,74,52,22,61
Alloa,2556,3,16,11,9,60,40,20,59
Albion,2556,4,16,8,12,61,50,11,56
Queen's Park,2556,5,16,4,16,48,51,-3,52
Brechin,2556,6,14,9,13,54,54,0,51
Peterhead,2556,7,13,8,15,45,54,-9,47
Stranraer,2556,8,12,7,17,54,57,-3,43
East Fife,2556,9,9,8,19,46,65,-19,35
Stenhousem'r,2556,10,7,11,18,46,79,-33,32
Livingston,2557,1,23,4,9,77,44,33,73
Alloa,2557,2,21,7,8,70,40,30,70
Peterhead,2557,3,16,9,11,61,50,11,57
Brechin,2557,4,16,7,13,58,48,10,55
Airdrieon,2557,5,14,12,10,55,50,5,54
Queen's Park,2557,6,15,6,15,40,56,-16,51
Stranraer,2557,7,13,2,21,46,63,-17,41
Albion,2557,8,10,10,16,52,61,-9,40
East Fife,2557,9,8,10,18,40,51,-11,34
Stenhousem'r,2557,10,7,7,22,41,77,-36,28
Livingston,2558,1,21,5,10,69,47,22,68
Stranraer,2558,2,17,8,11,55,48,7,59
Brechin,2558,3,16,9,11,55,48,7,57
Alloa,2558,4,15,7,14,60,52,8,52
Airdrieon,2558,5,15,6,15,51,55,-4,51
Peterhead,2558,6,14,7,15,48,49,-1,49
Queen's Park,2558,7,14,7,15,35,47,-12,49
East Fife,2558,8,12,12,12,51,47,4,48
Albion,2558,9,11,9,16,54,58,-4,42
Stenhousem'r,2558,10,5,10,21,44,71,-27,25
Livingston,2559,1,20,7,9,75,43,32,67
Alloa,2559,2,17,8,11,63,45,18,59
Airdrieon,2559,3,16,8,12,63,54,9,56
Brechin,2559,4,16,8,12,49,49,0,56
Peterhead,2559,5,15,8,13,54,53,1,53
Stranraer,2559,6,14,8,14,51,54,-3,50
Albion,2559,7,13,10,13,47,50,-3,49
East Fife,2559,8,10,9,17,45,53,-8,39
Queen's Park,2559,9,10,7,19,28,51,-23,37
Stenhousem'r,2559,10,9,7,20,50,73,-23,34
Livingston,2560,1,19,7,10,71,45,26,64
Albion,2560,2,19,6,11,56,48,8,63
Brechin,2560,3,18,5,13,49,43,6,59
Peterhead,2560,4,16,9,11,54,49,5,57
Airdrieon,2560,5,16,9,11,63,59,4,57
Alloa,2560,6,15,9,12,70,50,20,54
Stranraer,2560,7,13,4,19,53,62,-9,43
Queen's Park,2560,8,10,8,18,30,51,-21,38
East Fife,2560,9,10,7,19,53,61,-8,37
Stenhousem'r,2560,10,6,12,18,41,72,-31,30
Livingston,2561,1,22,5,9,79,39,40,71
Alloa,2561,2,18,8,10,67,41,26,62
Albion,2561,3,16,9,11,62,46,16,57
Brechin,2561,4,16,7,13,49,45,4,55
Airdrieon,2561,5,15,7,14,54,55,-1,52
East Fife,2561,6,13,9,14,49,43,6,48
Stranraer,2561,7,13,8,15,57,65,-8,47
Peterhead,2561,8,13,6,17,51,65,-14,45
Queen's Park,2561,9,12,5,19,33,57,-24,41
Stenhousem'r,2561,10,6,8,22,42,87,-45,26
Livingston,2562,1,23,4,9,89,51,38,73
Alloa,2562,2,19,10,7,70,44,26,67
Brechin,2562,3,17,7,12,47,40,7,58
Albion,2562,4,16,9,11,50,40,10,57
Peterhead,2562,5,16,6,14,53,52,1,54
Airdrieon,2562,6,12,12,12,50,50,0,48
Stranraer,2562,7,13,7,16,48,59,-11,46
East Fife,2562,8,9,11,16,42,49,-7,38
Queen's Park,2562,9,9,8,19,25,59,-34,35
Stenhousem'r,2562,10,6,6,24,41,71,-30,24
Brechin,2563,1,21,6,9,65,51,14,69
Airdrieon,2563,2,17,9,10,61,50,11,60
Livingston,2563,3,18,5,13,74,53,21,59
Albion,2563,4,17,6,13,70,52,18,57
Alloa,2563,5,15,12,9,57,41,16,57
Peterhead,2563,6,12,9,15,50,51,-1,45
East Fife,2563,7,12,7,17,62,61,1,43
Queen's Park,2563,8,10,11,15,41,59,-18,41
Stranraer,2563,9,11,5,20,48,68,-20,38
Stenhousem'r,2563,10,8,8,20,43,85,-42,32
Livingston,2564,1,19,9,8,81,51,30,66
Alloa,2564,2,18,6,12,72,47,25,60
Airdrieon,2564,3,16,10,10,65,51,14,58
Brechin,2564,4,17,7,12,50,41,9,58
Albion,2564,5,16,9,11,57,45,12,57
Peterhead,2564,6,13,10,13,47,50,-3,49
East Fife,2564,7,12,8,16,51,47,4,44
Stenhousem'r,2564,8,11,6,19,48,80,-32,39
Stranraer,2564,9,8,11,17,42,64,-22,35
Queen's Park,2564,10,8,8,20,31,68,-37,32
Livingston,2565,1,20,6,10,70,40,30,66
Alloa,2565,2,17,9,10,61,38,23,60
Airdrieon,2565,3,17,9,10,62,51,11,60
Peterhead,2565,4,16,11,9,59,50,9,59
Stranraer,2565,5,15,8,13,50,50,0,53
Queen's Park,2565,6,13,6,17,42,48,-6,45
East Fife,2565,7,10,14,12,51,52,-1,44
Brechin,2565,8,12,6,18,42,63,-21,42
Albion,2565,9,10,9,17,43,56,-13,39
Stenhousem'r,2565,10,7,8,21,41,73,-32,29
Alloa,2566,1,24,6,6,83,43,40,78
Livingston,2566,2,21,4,11,89,54,35,67
Brechin,2566,3,17,5,14,53,48,5,56
Albion,2566,4,15,7,14,60,58,2,52
Stranraer,2566,5,14,7,15,58,61,-3,49
Airdrieon,2566,6,14,6,16,55,70,-15,48
Peterhead,2566,7,13,7,16,49,56,-7,46
East Fife,2566,8,10,11,15,49,52,-3,41
Queen's Park,2566,9,11,7,18,31,49,-18,40
Stenhousem'r,2566,10,7,8,21,47,83,-36,29
Alloa,2567,1,19,11,6,70,34,36,68
Livingston,2567,2,19,6,11,69,45,24,63
Airdrieon,2567,3,19,6,11,70,52,18,63
Peterhead,2567,4,14,9,13,48,54,-6,51
Queen's Park,2567,5,15,6,15,41,51,-10,51
Brechin,2567,6,14,8,14,51,44,7,50
Albion,2567,7,12,9,15,46,53,-7,45
Stranraer,2567,8,11,11,14,65,74,-9,44
East Fife,2567,9,8,12,16,44,55,-11,36
Stenhousem'r,2567,10,6,8,22,30,72,-42,26
Alloa,2568,1,21,7,8,78,41,37,70
Airdrieon,2568,2,20,6,10,58,47,11,66
Livingston,2568,3,19,6,11,80,49,31,63
Albion,2568,4,16,8,12,67,67,0,56
Peterhead,2568,5,14,9,13,53,56,-3,51
Brechin,2568,6,13,9,14,48,51,-3,48
Stranraer,2568,7,14,5,17,53,61,-8,47
Queen's Park,2568,8,9,10,17,49,69,-20,37
East Fife,2568,9,8,12,16,45,52,-7,36
Stenhousem'r,2568,10,5,10,21,37,75,-38,25
Livingston,2569,1,21,5,10,74,52,22,68
Alloa,2569,2,19,7,10,72,45,27,64
Airdrieon,2569,3,18,7,11,54,47,7,61
Brechin,2569,4,17,7,12,54,50,4,58
Albion,2569,5,15,8,13,61,52,9,53
Queen's Park,2569,6,15,6,15,44,50,-6,51
Stranraer,2569,7,12,9,15,55,60,-5,45
Peterhead,2569,8,11,8,17,47,60,-13,41
East Fife,2569,9,9,7,20,43,59,-16,34
Stenhousem'r,2569,10,5,12,19,43,72,-29,27
Alloa,2570,1,21,8,7,71,38,33,71
Livingston,2570,2,21,3,12,77,50,27,66
Airdrieon,2570,3,19,9,8,70,55,15,66
Peterhead,2570,4,15,9,12,53,49,4,54
Brechin,2570,5,12,12,12,42,43,-1,48
Albion,2570,6,11,14,11,55,47,8,47
Stranraer,2570,7,14,5,17,51,56,-5,47
Queen's Park,2570,8,9,11,16,31,57,-26,38
Stenhousem'r,2570,9,6,11,19,46,82,-36,29
East Fife,2570,10,6,10,20,36,55,-19,28
Livingston,2571,1,22,5,9,88,45,43,71
Alloa,2571,2,18,8,10,70,43,27,62
Brechin,2571,3,16,6,14,54,57,-3,54
Airdrieon,2571,4,15,7,14,53,63,-10,52
Peterhead,2571,5,14,7,15,55,54,1,49
Stranraer,2571,5,13,10,13,55,54,1,49
Albion,2571,7,13,7,16,51,65,-14,46
East Fife,2571,8,11,9,16,49,52,-3,42
Stenhousem'r,2571,9,10,9,17,55,81,-26,39
Queen's Park,2571,10,9,10,17,42,58,-16,37
Livingston,2572,1,20,3,13,71,50,21,63
Brechin,2572,2,18,9,9,54,36,18,63
Alloa,2572,3,17,10,9,63,39,24,61
Airdrieon,2572,4,17,8,11,67,53,14,59
Albion,2572,5,17,7,12,63,48,15,58
Peterhead,2572,6,12,8,16,47,57,-10,44
Queen's Park,2572,7,12,8,16,36,50,-14,44
Stranraer,2572,8,12,6,18,57,68,-11,42
East Fife,2572,9,10,11,15,41,50,-9,41
Stenhousem'r,2572,10,7,6,23,40,88,-48,27
Livingston,2573,1,22,3,11,82,49,33,69
Alloa,2573,2,18,8,10,67,42,25,62
Brechin,2573,3,18,6,12,51,46,5,60
Peterhead,2573,4,16,6,14,52,52,0,54
Airdrieon,2573,5,15,6,15,55,62,-7,51
Stranraer,2573,6,13,7,16,54,58,-4,46
East Fife,2573,7,11,12,13,45,44,1,45
Queen's Park,2573,8,13,5,18,39,51,-12,44
Albion,2573,9,11,10,15,52,59,-7,43
Stenhousem'r,2573,10,8,7,21,47,81,-34,31
Alloa,2574,1,20,9,7,67,31,36,69
Livingston,2574,2,19,8,9,71,49,22,65
Peterhead,2574,3,16,10,10,47,41,6,58
Airdrieon,2574,4,15,9,12,52,54,-2,54
Brechin,2574,5,15,7,14,51,48,3,52
Queen's Park,2574,6,14,9,13,39,44,-5,51
Albion,2574,7,12,9,15,61,56,5,45
East Fife,2574,8,9,10,17,44,60,-16,37
Stranraer,2574,9,10,5,21,48,75,-27,35
Stenhousem'r,2574,10,9,6,21,50,72,-22,33
Livingston,2575,1,24,2,10,86,46,40,74
Alloa,2575,2,20,5,11,73,55,18,65
Brechin,2575,3,20,5,11,62,49,13,65
Peterhead,2575,4,16,8,12,61,50,11,56
Airdrieon,2575,5,16,6,14,59,57,2,54
Queen's Park,2575,6,15,4,17,41,50,-9,49
Albion,2575,7,13,9,14,54,56,-2,48
Stranraer,2575,8,12,5,19,48,66,-18,41
East Fife,2575,9,8,8,20,44,56,-12,32
Stenhousem'r,2575,10,6,8,22,42,85,-43,26
Livingston,2576,1,20,2,14,73,49,24,62
Alloa,2576,2,18,7,11,65,47,18,61
Brechin,2576,3,18,5,13,49,48,1,59
Albion,2576,4,17,7,12,58,45,13,58
Airdrieon,2576,5,15,6,15,52,58,-6,51
Stranraer,2576,6,14,8,14,51,54,-3,50
Peterhead,2576,7,13,9,14,50,48,2,48
Queen's Park,2576,8,14,6,16,38,48,-10,48
East Fife,2576,9,12,6,18,54,48,6,42
Stenhousem'r,2576,10,8,6,22,49,94,-45,30
Airdrieon,2577,1,20,5,11,61,48,13,65
Livingston,2577,2,20,3,13,71,52,19,63
Alloa,2577,3,15,10,11,68,46,22,55
Peterhead,2577,4,16,6,14,56,51,5,54
Albion,2577,5,14,9,13,53,50,3,51
Brechin,2577,6,15,6,15,47,49,-2,51
East Fife,2577,7,13,9,14,49,46,3,48
Stranraer,2577,8,13,5,18,44,59,-15,44
Stenhousem'r,2577,9,10,8,18,47,77,-30,38
Queen's Park,2577,10,9,9,18,39,57,-18,36
Livingston,2578,1,24,4,8,77,38,39,76
Alloa,2578,2,19,8,9,67,38,29,65
Airdrieon,2578,3,18,8,10,58,50,8,62
Albion,2578,4,15,7,14,53,54,-1,52
Brechin,2578,5,14,8,14,47,46,1,50
East Fife,2578,6,10,14,12,54,50,4,44
Stranraer,2578,7,12,6,18,46,60,-14,42
Peterhead,2578,8,10,9,17,41,55,-14,39
Queen's Park,2578,9,9,9,18,37,59,-22,36
Stenhousem'r,2578,10,9,7,20,46,76,-30,34
Livingston,2579,1,21,6,9,65,39,26,69
Alloa,2579,2,19,7,10,68,43,25,64
Airdrieon,2579,3,19,7,10,69,49,20,64
Albion,2579,4,16,8,12,55,43,12,56
Brechin,2579,5,17,5,14,47,53,-6,56
East Fife,2579,6,14,11,11,46,34,12,53
Stranraer,2579,7,13,7,16,51,60,-9,46
Queen's Park,2579,8,10,8,18,32,55,-23,38
Peterhead,2579,9,10,7,19,48,53,-5,37
Stenhousem'r,2579,10,4,8,24,37,89,-52,20
Alloa,2580,1,19,9,8,75,42,33,66
Livingston,2580,2,20,6,10,72,49,23,66
Brechin,2580,3,18,7,11,50,38,12,61
Airdrieon,2580,4,18,7,11,54,45,9,61
Albion,2580,5,15,6,15,57,53,4,51
Peterhead,2580,6,15,6,15,52,51,1,51
East Fife,2580,7,11,8,17,44,54,-10,41
Stranraer,2580,8,12,5,19,47,62,-15,41
Queen's Park,2580,9,12,4,20,36,55,-19,40
Stenhousem'r,2580,10,5,12,19,37,75,-38,27
Livingston,2581,1,20,5,11,73,54,19,65
Brechin,2581,2,20,4,12,64,57,7,64
Alloa,2581,3,18,8,10,65,45,20,62
Albion,2581,4,16,5,15,49,47,2,53
Peterhead,2581,5,15,7,14,59,55,4,52
Airdrieon,2581,6,16,4,16,59,61,-2,52
Queen's Park,2581,7,13,7,16,44,49,-5,46
Stranraer,2581,8,14,4,18,55,66,-11,46
East Fife,2581,9,10,8,18,40,48,-8,38
Stenhousem'r,2581,10,8,8,20,51,77,-26,32
Alloa,2582,1,23,8,5,81,36,45,77
Livingston,2582,2,21,5,10,72,41,31,68
Airdrieon,2582,3,18,5,13,59,52,7,59
Brechin,2582,4,16,6,14,49,47,2,54
Peterhead,2582,5,13,11,12,43,45,-2,50
Queen's Park,2582,6,14,4,18,40,58,-18,46
East Fife,2582,7,12,7,17,40,52,-12,43
Stranraer,2582,8,12,5,19,46,57,-11,41
Albion,2582,9,8,13,15,40,49,-9,37
Stenhousem'r,2582,10,7,8,21,41,74,-33,29
Livingston,2583,1,21,6,9,82,41,41,69
Alloa,2583,2,18,9,9,73,48,25,63
Brechin,2583,3,16,9,11,51,50,1,57
Albion,2583,4,16,6,14,59,53,6,54
Queen's Park,2583,5,15,9,12,47,47,0,54
Peterhead,2583,6,13,9,14,53,56,-3,48
Airdrieon,2583,7,14,4,18,55,67,-12,46
Stranraer,2583,8,13,3,20,50,64,-14,42
East Fife,2583,9,11,8,17,55,61,-6,41
Stenhousem'r,2583,10,9,5,22,46,84,-38,32
Livingston,2584,1,22,5,9,82,48,34,71
Alloa,2584,2,19,9,8,64,35,29,66
Brechin,2584,3,19,5,12,49,39,10,62
Peterhead,2584,4,16,8,12,57,49,8,56
Albion,2584,5,14,12,10,54,47,7,54
Airdrieon,2584,6,13,11,12,47,49,-2,50
East Fife,2584,7,11,7,18,43,52,-9,40
Stranraer,2584,8,11,6,19,46,58,-12,39
Queen's Park,2584,9,8,9,19,26,48,-22,33
Stenhousem'r,2584,10,5,12,19,35,78,-43,27
Livingston,2585,1,23,4,9,86,47,39,73
Alloa,2585,2,19,7,10,81,56,25,64
Albion,2585,3,15,10,11,60,45,15,55
Brechin,2585,4,16,7,13,47,44,3,55
Airdrieon,2585,5,15,9,12,55,61,-6,54
East Fife,2585,6,12,12,12,54,51,3,48
Stranraer,2585,7,11,8,17,56,66,-10,41
Queen's Park,2585,8,11,8,17,35,58,-23,41
Peterhead,2585,9,9,10,17,44,56,-12,37
Stenhousem'r,2585,10,8,7,21,50,84,-34,31
Alloa,2586,1,21,8,7,68,36,32,71
Livingston,2586,2,20,7,9,68,38,30,67
Airdrieon,2586,3,18,8,10,56,47,9,62
Albion,2586,4,16,10,10,59,47,12,58
Peterhead,2586,5,11,13,12,46,49,-3,46
Brechin,2586,6,12,9,15,43,50,-7,45
Stranraer,2586,7,13,6,17,49,66,-17,45
East Fife,2586,8,9,11,16,54,53,1,38
Queen's Park,2586,9,9,7,20,33,55,-22,34
Stenhousem'r,2586,10,6,11,19,44,79,-35,29
Alloa,2587,1,19,9,8,66,39,27,66
Brechin,2587,2,19,7,10,49,37,12,64
Airdrieon,2587,3,17,8,11,57,47,10,59
Livingston,2587,4,17,5,14,65,48,17,56
Peterhead,2587,5,15,9,12,46,43,3,54
East Fife,2587,6,11,11,14,40,43,-3,44
Albion,2587,7,11,10,15,49,52,-3,43
Queen's Park,2587,8,11,9,16,31,43,-12,42
Stenhousem'r,2587,9,8,12,16,48,77,-29,36
Stranraer,2587,10,7,10,19,42,64,-22,31
Alloa,2588,1,21,4,11,73,51,22,67
Livingston,2588,2,20,6,10,81,51,30,66
Brechin,2588,3,20,6,10,59,49,10,66
Peterhead,2588,4,15,9,12,59,51,8,54
Stranraer,2588,5,14,7,15,56,59,-3,49
Airdrieon,2588,6,14,7,15,53,65,-12,49
Albion,2588,7,14,5,17,51,47,4,47
East Fife,2588,8,10,10,16,49,53,-4,40
Queen's Park,2588,9,11,7,18,45,64,-19,40
Stenhousem'r,2588,10,6,9,21,41,77,-36,27
Alloa,2589,1,21,8,7,79,41,38,71
Airdrieon,2589,2,20,7,9,69,48,21,67
Livingston,2589,3,20,1,15,70,54,16,61
Albion,2589,4,14,10,12,54,51,3,52
Brechin,2589,5,15,7,14,44,55,-11,52
Stranraer,2589,6,12,7,17,55,58,-3,43
East Fife,2589,7,10,12,14,49,50,-1,42
Peterhead,2589,8,11,9,16,47,58,-11,42
Queen's Park,2589,9,10,9,17,30,50,-20,39
Stenhousem'r,2589,10,8,8,20,49,81,-32,32
Livingston,2590,1,24,4,8,79,43,36,76
Alloa,2590,2,21,8,7,72,37,35,71
Brechin,2590,3,16,8,12,45,42,3,56
East Fife,2590,4,14,10,12,58,44,14,52
Stranraer,2590,5,15,6,15,52,52,0,51
Albion,2590,6,11,12,13,53,51,2,45
Airdrieon,2590,7,13,6,17,52,60,-8,45
Peterhead,2590,8,12,6,18,44,60,-16,42
Queen's Park,2590,9,11,6,19,34,55,-21,39
Stenhousem'r,2590,10,5,10,21,37,82,-45,25
Alloa,2591,1,21,9,6,83,50,33,72
Livingston,2591,2,18,9,9,76,48,28,63
Brechin,2591,3,18,4,14,60,51,9,58
Airdrieon,2591,4,15,9,12,55,52,3,54
Albion,2591,5,14,7,15,51,55,-4,49
Queen's Park,2591,6,12,9,15,40,55,-15,45
East Fife,2591,7,10,14,12,40,37,3,44
Peterhead,2591,8,10,10,16,43,54,-11,40
Stranraer,2591,9,10,9,17,43,57,-14,39
Stenhousem'r,2591,10,9,6,21,42,74,-32,33
Livingston,2592,1,21,5,10,84,51,33,68
Alloa,2592,2,17,9,10,62,44,18,60
Airdrieon,2592,3,17,5,14,58,58,0,56
Peterhead,2592,4,15,8,13,56,55,1,53
Brechin,2592,5,13,10,13,48,47,1,49
Queen's Park,2592,6,14,6,16,36,42,-6,48
East Fife,2592,7,13,8,15,51,43,8,47
Stranraer,2592,8,13,7,16,52,56,-4,46
Stenhousem'r,2592,9,12,6,18,51,75,-24,42
Albion,2592,10,9,8,19,44,71,-27,35
Brechin,2593,1,19,8,9,50,38,12,65
Livingston,2593,2,19,5,12,68,46,22,62
Alloa,2593,3,16,9,11,63,47,16,57
East Fife,2593,4,13,10,13,50,47,3,49
Queen's Park,2593,5,13,8,15,41,42,-1,47
Airdrieon,2593,6,12,10,14,54,56,-2,46
Peterhead,2593,7,12,10,14,50,54,-4,46
Stranraer,2593,8,12,10,14,45,52,-7,46
Albion,2593,9,11,7,18,50,62,-12,40
Stenhousem'r,2593,10,11,7,18,53,80,-27,40
Airdrieon,2594,1,21,7,8,58,42,16,70
Alloa,2594,2,21,6,9,76,44,32,69
Albion,2594,3,15,12,9,54,51,3,57
Livingston,2594,4,18,2,16,61,53,8,56
Brechin,2594,5,16,7,13,55,48,7,55
Peterhead,2594,6,14,8,14,54,54,0,50
Queen's Park,2594,7,12,6,18,31,48,-17,42
East Fife,2594,8,10,8,18,43,49,-6,38
Stranraer,2594,9,10,7,19,53,65,-12,37
Stenhousem'r,2594,10,8,7,21,40,71,-31,31
Livingston,2595,1,21,4,11,77,44,33,67
Alloa,2595,2,20,5,11,78,44,34,65
Brechin,2595,3,18,8,10,53,44,9,62
Stranraer,2595,4,19,3,14,54,51,3,60
Airdrieon,2595,5,19,3,14,61,61,0,60
Peterhead,2595,6,17,6,13,56,51,5,57
Albion,2595,7,15,7,14,55,57,-2,52
Queen's Park,2595,8,9,7,20,28,53,-25,34
East Fife,2595,9,8,9,19,46,56,-10,33
Stenhousem'r,2595,10,5,6,25,32,79,-47,21
Alloa,2596,1,22,7,7,85,39,46,73
Airdrieon,2596,2,20,5,11,65,47,18,65
Livingston,2596,3,19,3,14,68,55,13,60
Peterhead,2596,4,17,7,12,55,54,1,58
Queen's Park,2596,5,17,6,13,41,47,-6,57
Brechin,2596,6,16,5,15,48,55,-7,53
Albion,2596,7,15,6,15,59,54,5,51
Stranraer,2596,8,14,2,20,51,62,-11,44
East Fife,2596,9,6,9,21,35,56,-21,27
Stenhousem'r,2596,10,7,4,25,47,85,-38,25
Livingston,2597,1,22,7,7,76,42,34,73
Alloa,2597,2,19,8,9,72,45,27,65
Albion,2597,3,16,8,12,57,51,6,56
Airdrieon,2597,4,15,4,17,58,69,-11,49
Brechin,2597,5,14,6,16,49,58,-9,48
Peterhead,2597,6,12,10,14,47,50,-3,46
East Fife,2597,7,12,9,15,51,50,1,45
Stranraer,2597,8,12,8,16,54,62,-8,44
Queen's Park,2597,9,11,7,18,36,53,-17,40
Stenhousem'r,2597,10,10,7,19,48,68,-20,37
Alloa,2598,1,21,6,9,73,48,25,69
Albion,2598,2,18,9,9,60,47,13,63
Airdrieon,2598,3,16,8,12,58,53,5,56
Livingston,2598,4,15,7,14,67,52,15,52
Brechin,2598,5,15,7,14,53,49,4,52
Stranraer,2598,6,15,6,15,55,59,-4,51
Peterhead,2598,7,14,7,15,61,50,11,49
East Fife,2598,8,11,11,14,48,48,0,44
Queen's Park,2598,9,11,6,19,35,58,-23,39
Stenhousem'r,2598,10,7,7,22,36,82,-46,28
Alloa,2599,1,21,9,6,77,46,31,72
Livingston,2599,2,20,4,12,76,51,25,64
Brechin,2599,3,17,8,11,54,48,6,59
Airdrieon,2599,4,15,9,12,68,59,9,54
Albion,2599,5,13,12,11,61,46,15,51
Stranraer,2599,6,14,6,16,57,62,-5,48
Peterhead,2599,7,12,9,15,49,57,-8,45
Queen's Park,2599,8,12,6,18,33,55,-22,42
East Fife,2599,9,9,14,13,41,45,-4,41
Stenhousem'r,2599,10,5,7,24,47,94,-47,22
Livingston,2600,1,22,5,9,68,42,26,71
Alloa,2600,2,20,7,9,66,41,25,67
Brechin,2600,3,18,9,9,57,41,16,63
Airdrieon,2600,4,17,10,9,60,46,14,61
Peterhead,2600,5,12,13,11,50,47,3,49
East Fife,2600,6,11,10,15,44,42,2,43
Queen's Park,2600,7,10,13,13,36,47,-11,43
Stranraer,2600,8,10,9,17,47,61,-14,39
Albion,2600,9,8,8,20,38,61,-23,32
Stenhousem'r,2600,10,6,8,22,47,85,-38,26
Livingston,2601,1,21,4,11,76,50,26,67
Alloa,2601,2,18,8,10,73,47,26,62
Airdrieon,2601,3,15,9,12,62,55,7,54
Peterhead,2601,4,14,12,10,51,51,0,54
Queen's Park,2601,5,15,9,12,41,44,-3,54
Brechin,2601,6,15,5,16,55,52,3,50
Albion,2601,7,13,10,13,51,51,0,49
Stranraer,2601,8,12,10,14,49,57,-8,46
East Fife,2601,9,10,8,18,43,56,-13,38
Stenhousem'r,2601,10,6,7,23,50,88,-38,25
Alloa,2602,1,20,7,9,82,54,28,67
Livingston,2602,2,21,3,12,88,44,44,66
Brechin,2602,3,19,2,15,47,45,2,59
East Fife,2602,4,16,8,12,65,48,17,56
Airdrieon,2602,5,15,9,12,51,51,0,54
Peterhead,2602,6,14,7,15,54,59,-5,49
Albion,2602,7,13,10,13,54,60,-6,49
Stenhousem'r,2602,8,10,10,16,53,78,-25,40
Queen's Park,2602,9,9,8,19,39,60,-21,35
Stranraer,2602,10,8,6,22,37,71,-34,30
Livingston,2603,1,20,4,12,83,54,29,64
Alloa,2603,2,17,10,9,66,38,28,61
Albion,2603,3,17,9,10,56,47,9,60
East Fife,2603,4,16,7,13,52,42,10,55
Airdrieon,2603,5,16,7,13,56,53,3,55
Peterhead,2603,6,16,5,15,50,51,-1,53
Brechin,2603,7,13,7,16,44,56,-12,46
Queen's Park,2603,8,10,10,16,34,53,-19,40
Stranraer,2603,9,10,7,19,41,59,-18,37
Stenhousem'r,2603,10,7,10,19,52,81,-29,31
Livingston,2604,1,27,1,8,93,45,48,82
Alloa,2604,2,18,9,9,63,42,21,63
Stranraer,2604,3,18,3,15,61,56,5,57
Brechin,2604,4,15,6,15,46,53,-7,51
Airdrieon,2604,5,16,2,18,56,60,-4,50
East Fife,2604,6,13,8,15,53,54,-1,47
Albion,2604,7,12,9,15,55,60,-5,45
Peterhead,2604,8,13,5,18,52,55,-3,44
Queen's Park,2604,9,12,7,17,36,51,-15,43
Stenhousem'r,2604,10,6,10,20,43,82,-39,28
Livingston,2605,1,19,6,11,80,50,30,63
Airdrieon,2605,2,19,6,11,58,49,9,63
Alloa,2605,3,16,12,8,66,38,28,60
Albion,2605,4,16,8,12,64,56,8,56
Brechin,2605,5,16,7,13,63,56,7,55
East Fife,2605,6,15,7,14,57,50,7,52
Peterhead,2605,7,11,10,15,41,50,-9,43
Stranraer,2605,8,12,4,20,44,65,-21,40
Queen's Park,2605,9,9,9,18,41,59,-18,36
Stenhousem'r,2605,10,8,9,19,43,84,-41,33
Livingston,2606,1,24,4,8,85,42,43,76
Alloa,2606,2,18,7,11,66,45,21,61
Airdrieon,2606,3,15,10,11,60,58,2,55
Stranraer,2606,4,14,8,14,54,52,2,50
Peterhead,2606,5,15,5,16,49,48,1,50
Albion,2606,6,13,10,13,56,52,4,49
Brechin,2606,7,13,7,16,49,56,-7,46
East Fife,2606,8,12,7,17,49,55,-6,43
Queen's Park,2606,9,12,7,17,38,54,-16,43
Stenhousem'r,2606,10,7,9,20,42,86,-44,30
Livingston,2607,1,25,1,10,85,45,40,76
Alloa,2607,2,17,6,13,62,49,13,57
Brechin,2607,3,17,5,14,52,50,2,56
Albion,2607,4,15,10,11,58,54,4,55
Airdrieon,2607,5,15,9,12,57,58,-1,54
Peterhead,2607,6,12,10,14,51,52,-1,46
East Fife,2607,7,11,8,17,52,50,2,41
Queen's Park,2607,8,11,8,17,40,58,-18,41
Stranraer,2607,9,12,4,20,48,62,-14,40
Stenhousem'r,2607,10,10,9,17,46,73,-27,39
Alloa,2608,1,21,6,9,82,50,32,69
Livingston,2608,2,17,7,12,74,57,17,58
Albion,2608,3,17,7,12,60,50,10,58
Brechin,2608,4,17,7,12,42,45,-3,58
Airdrieon,2608,5,15,8,13,61,64,-3,53
Queen's Park,2608,6,15,5,16,43,49,-6,50
East Fife,2608,7,13,9,14,58,51,7,48
Peterhead,2608,8,12,9,15,50,54,-4,45
Stranraer,2608,9,11,7,18,53,61,-8,40
Stenhousem'r,2608,10,5,9,22,36,78,-42,24
Brechin,2609,1,19,10,7,61,38,23,67
Alloa,2609,2,19,7,10,71,52,19,64
Livingston,2609,3,18,9,9,75,46,29,63
Airdrieon,2609,4,14,11,11,54,51,3,53
Albion,2609,5,14,6,16,52,58,-6,48
East Fife,2609,6,12,11,13,54,50,4,47
Queen's Park,2609,7,12,9,15,48,56,-8,45
Peterhead,2609,8,12,9,15,47,59,-12,45
Stenhousem'r,2609,9,7,11,18,50,72,-22,32
Stranraer,2609,10,9,5,22,48,78,-30,32
Livingston,2610,1,22,4,10,83,50,33,70
Alloa,2610,2,19,5,12,80,50,30,62
Brechin,2610,3,17,7,12,51,46,5,58
East Fife,2610,4,15,9,12,56,48,8,54
Airdrieon,2610,5,14,9,13,57,61,-4,51
Albion,2610,6,12,8,16,45,54,-9,44
Peterhead,2610,7,12,8,16,40,49,-9,44
Queen's Park,2610,8,12,8,16,41,53,-12,44
Stenhousem'r,2610,9,12,5,19,46,70,-24,41
Stranraer,2610,10,13,1,22,48,66,-18,40
Livingston,2611,1,22,6,8,83,44,39,72
Brechin,2611,2,18,8,10,54,41,13,62
Airdrieon,2611,3,17,8,11,68,57,11,59
Alloa,2611,4,16,10,10,75,54,21,58
Albion,2611,5,16,8,12,63,50,13,56
Peterhead,2611,6,15,8,13,49,58,-9,53
East Fife,2611,7,10,9,17,50,58,-8,39
Queen's Park,2611,8,8,11,17,35,55,-20,35
Stranraer,2611,9,8,10,18,44,65,-21,34
Stenhousem'r,2611,10,6,10,20,43,82,-39,28
Livingston,2612,1,19,8,9,63,44,19,65
Brechin,2612,2,18,5,13,56,53,3,59
Airdrieon,2612,3,16,9,11,61,56,5,57
Peterhead,2612,4,16,8,12,64,47,17,56
Alloa,2612,5,15,11,10,51,36,15,56
Albion,2612,6,14,10,12,52,50,2,52
Queen's Park,2612,7,13,7,16,34,41,-7,46
Stranraer,2612,8,11,7,18,50,59,-9,40
Stenhousem'r,2612,9,10,7,19,47,73,-26,37
East Fife,2612,10,9,6,21,45,64,-19,33
Brechin,2613,1,22,5,9,53,36,17,71
Livingston,2613,2,20,3,13,78,56,22,63
Airdrieon,2613,3,19,6,11,61,48,13,63
Stranraer,2613,4,17,7,12,56,50,6,58
Peterhead,2613,5,16,5,15,52,56,-4,53
Alloa,2613,6,15,5,16,57,51,6,50
Albion,2613,7,13,9,14,52,49,3,48
East Fife,2613,8,11,8,17,49,56,-7,41
Queen's Park,2613,9,9,9,18,30,49,-19,36
Stenhousem'r,2613,10,5,9,22,43,80,-37,24
Livingston,2614,1,20,7,9,71,45,26,67
Alloa,2614,2,20,6,10,65,43,22,66
Airdrieon,2614,3,19,5,12,64,62,2,62
Albion,2614,4,14,10,12,52,46,6,52
Brechin,2614,5,16,4,16,53,55,-2,52
Queen's Park,2614,6,14,6,16,39,43,-4,48
Peterhead,2614,7,13,7,16,48,54,-6,46
Stranraer,2614,8,13,5,18,47,54,-7,44
East Fife,2614,9,9,11,16,40,48,-8,38
Stenhousem'r,2614,10,8,7,21,42,71,-29,31
Alloa,2615,1,22,6,8,76,40,36,72
Livingston,2615,2,23,3,10,73,50,23,72
Airdrieon,2615,3,16,7,13,62,49,13,55
Brechin,2615,4,16,4,16,54,64,-10,52
Queen's Park,2615,5,15,5,16,41,43,-2,50
Albion,2615,6,13,8,15,48,48,0,47
Peterhead,2615,7,13,7,16,45,53,-8,46
East Fife,2615,8,12,8,16,53,55,-2,44
Stranraer,2615,9,10,7,19,38,59,-21,37
Stenhousem'r,2615,10,10,5,21,49,78,-29,35
Livingston,2616,1,22,5,9,87,46,41,71
Alloa,2616,2,18,12,6,62,35,27,66
Brechin,2616,3,16,8,12,50,42,8,56
Stranraer,2616,4,15,6,15,53,54,-1,51
Peterhead,2616,5,13,11,12,48,51,-3,50
East Fife,2616,6,13,7,16,48,44,4,46
Airdrieon,2616,7,12,9,15,48,54,-6,45
Albion,2616,8,13,6,17,48,59,-11,45
Queen's Park,2616,9,10,9,17,33,50,-17,39
Stenhousem'r,2616,10,8,7,21,44,86,-42,31
Brechin,2617,1,20,9,7,62,45,17,69
Alloa,2617,2,18,11,7,72,40,32,65
Livingston,2617,3,19,4,13,70,47,23,61
Airdrieon,2617,4,18,6,12,70,62,8,60
Queen's Park,2617,5,14,6,16,43,53,-10,48
Albion,2617,6,11,14,11,52,50,2,47
Stranraer,2617,7,13,7,16,51,58,-7,46
Peterhead,2617,8,12,9,15,50,59,-9,45
Stenhousem'r,2617,9,9,9,18,45,78,-33,36
East Fife,2617,10,5,7,24,40,63,-23,22
Livingston,2618,1,22,4,10,76,54,22,70
Alloa,2618,2,19,8,9,78,45,33,65
Airdrieon,2618,3,17,4,15,62,63,-1,55
East Fife,2618,4,15,9,12,57,40,17,54
Brechin,2618,5,16,5,15,53,56,-3,53
Peterhead,2618,6,15,8,13,56,63,-7,53
Queen's Park,2618,7,12,9,15,36,48,-12,45
Albion,2618,8,11,11,14,54,50,4,44
Stranraer,2618,9,13,5,18,51,60,-9,44
Stenhousem'r,2618,10,4,9,23,48,92,-44,21
Airdrieon,2619,1,21,3,12,58,46,12,66
Livingston,2619,2,20,5,11,75,46,29,65
Alloa,2619,3,14,12,10,65,51,14,54
Peterhead,2619,4,14,9,13,56,55,1,51
Brechin,2619,5,15,6,15,50,54,-4,51
Albion,2619,6,13,8,15,45,45,0,47
Stranraer,2619,7,13,8,15,52,58,-6,47
Queen's Park,2619,8,12,9,15,43,55,-12,45
East Fife,2619,9,9,15,12,52,52,0,42
Stenhousem'r,2619,10,9,5,22,45,79,-34,32
Airdrieon,2620,1,22,7,7,66,38,28,73
Alloa,2620,2,18,10,8,64,37,27,64
Brechin,2620,3,19,6,11,57,47,10,63
Livingston,2620,4,17,5,14,61,57,4,56
East Fife,2620,5,11,14,11,46,38,8,47
Stranraer,2620,6,12,11,13,53,52,1,47
Queen's Park,2620,7,11,9,16,32,49,-17,42
Albion,2620,8,12,5,19,48,54,-6,41
Peterhead,2620,9,9,11,16,49,62,-13,38
Stenhousem'r,2620,10,7,6,23,44,86,-42,27
Alloa,2621,1,19,7,10,65,46,19,64
Livingston,2621,2,19,5,12,68,46,22,62
East Fife,2621,3,18,8,10,60,38,22,62
Queen's Park,2621,4,16,8,12,53,50,3,56
Peterhead,2621,5,15,5,16,51,53,-2,50
Airdrieon,2621,6,12,9,15,54,60,-6,45
Stranraer,2621,7,12,9,15,51,58,-7,45
Brechin,2621,8,13,6,17,50,59,-9,45
Albion,2621,9,10,9,17,47,65,-18,39
Stenhousem'r,2621,10,10,6,20,47,71,-24,36
Livingston,2622,1,21,5,10,74,47,27,68
Airdrieon,2622,2,19,9,8,64,49,15,66
Alloa,2622,3,19,7,10,70,43,27,64
Brechin,2622,4,15,8,13,43,40,3,53
Peterhead,2622,5,15,6,15,53,58,-5,51
East Fife,2622,6,14,7,15,55,49,6,49
Albion,2622,7,13,6,17,55,61,-6,45
Queen's Park,2622,8,12,6,18,35,59,-24,42
Stranraer,2622,9,10,5,21,39,57,-18,35
Stenhousem'r,2622,10,9,7,20,45,70,-25,34
Livingston,2623,1,22,3,11,79,44,35,69
Alloa,2623,2,19,7,10,62,38,24,64
Brechin,2623,3,17,8,11,48,47,1,59
Airdrieon,2623,4,16,9,11,60,60,0,57
Peterhead,2623,5,15,11,10,51,48,3,56
Albion,2623,6,13,10,13,57,46,11,49
East Fife,2623,7,12,5,19,55,57,-2,41
Queen's Park,2623,8,10,10,16,31,45,-14,40
Stranraer,2623,9,8,11,17,51,69,-18,35
Stenhousem'r,2623,10,8,6,22,43,83,-40,30
Livingston,2624,1,25,1,10,78,41,37,76
Alloa,2624,2,21,6,9,63,37,26,69
Airdrieon,2624,3,17,6,13,66,56,10,57
Albion,2624,4,13,9,14,63,55,8,48
Peterhead,2624,5,13,9,14,44,51,-7,48
Brechin,2624,6,14,5,17,50,60,-10,47
Stranraer,2624,7,14,4,18,54,66,-12,46
Queen's Park,2624,8,12,8,16,42,49,-7,44
East Fife,2624,9,11,10,15,52,53,-1,43
Stenhousem'r,2624,10,7,8,21,43,87,-44,29
Livingston,2625,1,20,5,11,69,46,23,65
Brechin,2625,2,19,7,10,57,42,15,64
Alloa,2625,3,19,6,11,74,44,30,63
Albion,2625,4,15,9,12,54,50,4,54
Peterhead,2625,5,15,7,14,48,47,1,52
Airdrieon,2625,6,15,4,17,54,63,-9,49
East Fife,2625,7,12,9,15,48,46,2,45
Queen's Park,2625,8,11,9,16,45,61,-16,42
Stranraer,2625,9,11,5,20,41,65,-24,38
Stenhousem'r,2625,10,7,11,18,43,69,-26,32
Brechin,2626,1,19,10,7,54,39,15,67
Alloa,2626,2,19,8,9,72,43,29,65
Livingston,2626,3,18,6,12,79,47,32,60
Albion,2626,4,17,7,12,58,46,12,58
Peterhead,2626,5,15,6,15,52,49,3,51
Airdrieon,2626,6,14,7,15,50,54,-4,49
Stranraer,2626,7,14,6,16,47,51,-4,48
Queen's Park,2626,8,10,9,17,31,68,-37,39
East Fife,2626,9,9,10,17,55,56,-1,37
Stenhousem'r,2626,10,6,9,21,42,87,-45,27
Alloa,2627,1,18,8,10,79,54,25,62
Livingston,2627,2,19,4,13,67,52,15,61
Brechin,2627,3,19,2,15,55,48,7,59
Peterhead,2627,4,15,10,11,58,58,0,55
Albion,2627,5,14,8,14,56,52,4,50
Airdrieon,2627,6,13,10,13,51,58,-7,49
East Fife,2627,7,13,7,16,47,49,-2,46
Queen's Park,2627,8,12,10,14,39,51,-12,46
Stranraer,2627,9,11,7,18,50,58,-8,40
Stenhousem'r,2627,10,10,6,20,52,74,-22,36
Alloa,2628,1,19,9,8,71,40,31,66
Airdrieon,2628,2,18,5,13,55,54,1,59
Peterhead,2628,3,17,6,13,51,48,3,57
Livingston,2628,4,17,5,14,73,45,28,56
Albion,2628,5,15,10,11,52,50,2,55
Brechin,2628,6,16,7,13,48,51,-3,55
Queen's Park,2628,7,13,7,16,40,55,-15,46
Stranraer,2628,8,12,9,15,55,60,-5,45
East Fife,2628,9,11,11,14,50,49,1,44
Stenhousem'r,2628,10,2,11,23,40,83,-43,17
Livingston,2629,1,22,4,10,71,49,22,70
Airdrieon,2629,2,20,6,10,68,49,19,66
Peterhead,2629,3,17,8,11,59,46,13,59
Albion,2629,4,15,11,10,65,52,13,56
Alloa,2629,5,16,6,14,67,50,17,54
Stranraer,2629,6,14,8,14,43,47,-4,50
Brechin,2629,7,13,9,14,47,54,-7,48
East Fife,2629,8,9,12,15,46,45,1,39
Stenhousem'r,2629,9,7,9,20,45,86,-41,30
Queen's Park,2629,10,7,7,22,36,69,-33,28
Alloa,2630,1,23,6,7,77,37,40,75
Airdrieon,2630,2,20,6,10,73,48,25,66
Brechin,2630,3,19,5,12,53,52,1,62
Livingston,2630,4,19,4,13,73,50,23,61
East Fife,2630,5,14,9,13,48,43,5,51
Peterhead,2630,6,12,9,15,37,43,-6,45
Stranraer,2630,7,12,5,19,49,65,-16,41
Albion,2630,8,8,12,16,43,56,-13,36
Queen's Park,2630,9,9,8,19,39,64,-25,35
Stenhousem'r,2630,10,9,6,21,47,81,-34,33
Livingston,2631,1,22,3,11,84,57,27,69
Brechin,2631,2,18,10,8,49,36,13,64
Airdrieon,2631,3,19,5,12,67,51,16,62
East Fife,2631,4,15,6,15,59,55,4,51
Queen's Park,2631,5,13,10,13,41,47,-6,49
Peterhead,2631,6,14,5,17,44,47,-3,47
Alloa,2631,7,13,7,16,66,57,9,46
Albion,2631,8,12,9,15,51,52,-1,45
Stranraer,2631,9,11,5,20,46,65,-19,38
Stenhousem'r,2631,10,9,8,19,52,92,-40,35
Livingston,2632,1,19,8,9,83,53,30,65
Alloa,2632,2,17,7,12,68,44,24,58
Albion,2632,3,15,11,10,56,50,6,56
Airdrieon,2632,4,15,10,11,50,46,4,55
Stranraer,2632,5,14,6,16,49,53,-4,48
Brechin,2632,6,13,9,14,45,52,-7,48
Peterhead,2632,7,14,5,17,44,61,-17,47
East Fife,2632,8,12,10,14,54,47,7,46
Queen's Park,2632,9,12,4,20,33,54,-21,40
Stenhousem'r,2632,10,9,10,17,46,68,-22,37
Livingston,2633,1,24,5,7,88,47,41,77
Alloa,2633,2,20,5,11,72,51,21,65
Airdrieon,2633,3,18,10,8,62,43,19,64
Brechin,2633,4,18,5,13,51,43,8,59
Albion,2633,5,15,11,10,54,49,5,56
Stranraer,2633,6,15,3,18,53,58,-5,48
East Fife,2633,7,11,9,16,50,50,0,42
Peterhead,2633,8,10,7,19,47,66,-19,37
Queen's Park,2633,9,8,7,21,32,56,-24,31
Stenhousem'r,2633,10,5,10,21,39,85,-46,25
Livingston,2634,1,22,6,8,80,42,38,72
Alloa,2634,2,18,9,9,66,45,21,63
Queen's Park,2634,3,17,5,14,43,43,0,56
East Fife,2634,4,13,11,12,50,46,4,50
Peterhead,2634,5,13,11,12,52,55,-3,50
Airdrieon,2634,6,15,5,16,49,58,-9,50
Brechin,2634,7,14,7,15,51,50,1,49
Albion,2634,8,12,8,16,46,54,-8,44
Stranraer,2634,9,13,4,19,56,59,-3,43
Stenhousem'r,2634,10,6,8,22,39,80,-41,26
Livingston,2635,1,19,6,11,76,50,26,63
Alloa,2635,2,17,12,7,71,45,26,63
Airdrieon,2635,3,18,6,12,73,61,12,60
Brechin,2635,4,16,7,13,51,55,-4,55
Queen's Park,2635,5,14,8,14,44,51,-7,50
Albion,2635,6,13,10,13,58,58,0,49
East Fife,2635,7,13,8,15,49,50,-1,47
Peterhead,2635,8,11,7,18,47,55,-8,40
Stranraer,2635,9,11,7,18,54,65,-11,40
Stenhousem'r,2635,10,9,7,20,48,81,-33,34
Alloa,2636,1,23,5,8,84,40,44,74
Livingston,2636,2,20,5,11,67,41,26,65
Brechin,2636,3,17,8,11,56,43,13,59
Airdrieon,2636,4,16,10,10,61,59,2,58
Albion,2636,5,14,8,14,53,60,-7,50
Peterhead,2636,6,11,12,13,59,63,-4,45
East Fife,2636,7,9,14,13,46,54,-8,41
Queen's Park,2636,8,10,10,16,33,48,-15,40
Stranraer,2636,9,9,9,18,50,65,-15,36
Stenhousem'r,2636,10,6,9,21,49,85,-36,27
Peterhead,2637,1,20,7,9,60,45,15,67
Livingston,2637,2,17,8,11,69,55,14,59
Alloa,2637,3,17,7,12,64,50,14,58
Queen's Park,2637,4,14,11,11,48,49,-1,53
Albion,2637,5,15,7,14,58,55,3,52
Brechin,2637,6,15,5,16,48,49,-1,50
Airdrieon,2637,7,14,8,14,48,56,-8,50
Stranraer,2637,8,13,6,17,56,56,0,45
East Fife,2637,9,8,10,18,41,52,-11,34
Stenhousem'r,2637,10,7,11,18,47,72,-25,32
Livingston,2638,1,22,5,9,75,45,30,71
Alloa,2638,2,19,8,9,76,51,25,65
Albion,2638,3,16,6,14,56,55,1,54
Airdrieon,2638,4,15,8,13,55,53,2,53
Peterhead,2638,5,13,9,14,49,49,0,48
Brechin,2638,6,13,9,14,48,48,0,48
Stranraer,2638,7,13,5,18,51,56,-5,44
East Fife,2638,8,12,8,16,46,57,-11,44
Queen's Park,2638,9,10,11,15,29,48,-19,41
Stenhousem'r,2638,10,7,11,18,49,72,-23,32
Livingston,2639,1,23,4,9,78,44,34,73
Alloa,2639,2,17,11,8,75,42,33,62
Peterhead,2639,3,13,11,12,44,49,-5,50
Stranraer,2639,4,14,4,18,55,55,0,46
Queen's Park,2639,5,12,10,14,47,54,-7,46
Brechin,2639,6,12,10,14,46,55,-9,46
Airdrieon,2639,7,12,10,14,43,56,-13,46
Albion,2639,8,10,13,13,46,49,-3,43
East Fife,2639,9,10,13,13,42,48,-6,43
Stenhousem'r,2639,10,9,10,17,50,74,-24,37
Livingston,2640,1,21,2,13,90,64,26,65
Airdrieon,2640,2,19,6,11,57,53,4,63
Brechin,2640,3,17,7,12,57,47,10,58
Alloa,2640,4,16,8,12,74,59,15,56
Stranraer,2640,5,16,7,13,62,57,5,55
Peterhead,2640,6,13,8,15,57,55,2,47
Queen's Park,2640,7,13,8,15,40,58,-18,47
Albion,2640,8,13,7,16,57,56,1,46
East Fife,2640,9,10,13,13,49,48,1,43
Stenhousem'r,2640,10,6,6,24,39,85,-46,24
Livingston,2641,1,24,2,10,77,43,34,74
Alloa,2641,2,19,5,12,71,44,27,62
Brechin,2641,3,16,7,13,47,45,2,55
Airdrieon,2641,4,15,9,12,56,55,1,54
Peterhead,2641,5,16,6,14,56,56,0,54
Stranraer,2641,6,15,5,16,57,60,-3,50
Queen's Park,2641,7,13,8,15,39,56,-17,47
Albion,2641,8,13,7,16,50,52,-2,46
East Fife,2641,9,11,11,14,49,47,2,44
Stenhousem'r,2641,10,4,8,24,35,79,-44,20
Livingston,2642,1,20,5,11,71,46,25,65
Alloa,2642,2,18,8,10,62,39,23,62
Airdrieon,2642,3,19,3,14,60,50,10,60
Brechin,2642,4,14,11,11,56,55,1,53
Albion,2642,5,15,7,14,55,50,5,52
Peterhead,2642,6,14,7,15,46,48,-2,49
Queen's Park,2642,7,12,10,14,41,52,-11,46
Stranraer,2642,8,12,8,16,54,59,-5,44
East Fife,2642,9,9,11,16,43,50,-7,38
Stenhousem'r,2642,10,9,6,21,51,90,-39,33
Livingston,2643,1,19,7,10,76,49,27,64
Brechin,2643,2,19,7,10,54,38,16,64
Alloa,2643,3,17,10,9,54,36,18,61
Albion,2643,4,15,10,11,56,49,7,55
Peterhead,2643,5,17,4,15,51,50,1,55
Airdrieon,2643,6,16,5,15,59,61,-2,53
East Fife,2643,7,13,6,17,48,49,-1,45
Stranraer,2643,8,10,7,19,45,60,-15,37
Queen's Park,2643,9,9,8,19,31,55,-24,35
Stenhousem'r,2643,10,9,8,19,49,76,-27,35
Livingston,2644,1,19,8,9,85,49,36,65
Brechin,2644,2,16,10,10,60,51,9,58
Peterhead,2644,3,16,7,13,59,58,1,55
Albion,2644,4,15,9,12,62,54,8,54
Airdrieon,2644,5,16,6,14,60,58,2,54
Alloa,2644,6,15,8,13,63,53,10,53
East Fife,2644,7,12,11,13,51,46,5,47
Queen's Park,2644,8,12,9,15,38,53,-15,45
Stranraer,2644,9,11,5,20,45,66,-21,38
Stenhousem'r,2644,10,7,9,20,51,86,-35,30
Livingston,2645,1,18,5,13,76,57,19,59
Alloa,2645,2,17,8,11,66,51,15,59
Airdrieon,2645,3,17,8,11,60,51,9,59
Brechin,2645,4,18,4,14,55,49,6,58
Queen's Park,2645,5,14,11,11,44,46,-2,53
Albion,2645,6,13,10,13,51,52,-1,49
East Fife,2645,7,12,9,15,46,45,1,45
Peterhead,2645,8,12,8,16,48,51,-3,44
Stranraer,2645,9,12,7,17,47,62,-15,43
Stenhousem'r,2645,10,7,10,19,44,73,-29,31
Livingston,2646,1,22,3,11,83,54,29,69
Alloa,2646,2,19,4,13,82,50,32,61
Brechin,2646,3,18,5,13,57,53,4,59
Albion,2646,4,15,10,11,57,57,0,55
Stranraer,2646,5,14,8,14,55,57,-2,50
Airdrieon,2646,6,15,4,17,52,55,-3,49
East Fife,2646,7,13,8,15,49,49,0,47
Stenhousem'r,2646,8,13,5,18,54,69,-15,44
Peterhead,2646,9,12,5,19,47,64,-17,41
Queen's Park,2646,10,11,4,21,35,63,-28,37
Livingston,2647,1,23,5,8,82,43,39,74
Brechin,2647,2,21,6,9,54,38,16,69
Alloa,2647,3,19,6,11,68,43,25,63
Peterhead,2647,4,16,6,14,55,45,10,54
Albion,2647,5,15,9,12,54,56,-2,54
Airdrieon,2647,6,16,6,14,53,55,-2,54
East Fife,2647,7,13,8,15,51,55,-4,47
Queen's Park,2647,8,10,7,19,35,56,-21,37
Stranraer,2647,9,10,3,23,44,66,-22,33
Stenhousem'r,2647,10,4,10,22,39,78,-39,22
Brechin,2648,1,22,5,9,65,45,20,71
Livingston,2648,2,22,3,11,84,45,39,69
Alloa,2648,3,18,8,10,80,52,28,62
Airdrieon,2648,4,16,6,14,52,50,2,54
Peterhead,2648,5,14,9,13,42,47,-5,51
Albion,2648,6,14,7,15,52,64,-12,49
Stranraer,2648,7,14,3,19,54,59,-5,45
Queen's Park,2648,8,11,8,17,30,50,-20,41
East Fife,2648,9,11,7,18,49,57,-8,40
Stenhousem'r,2648,10,8,4,24,47,86,-39,28
Livingston,2649,1,23,2,11,74,41,33,71
Airdrieon,2649,2,19,7,10,65,49,16,64
Albion,2649,3,18,4,14,54,53,1,58
Queen's Park,2649,4,16,7,13,40,45,-5,55
Alloa,2649,5,15,8,13,58,50,8,53
Brechin,2649,6,16,5,15,49,45,4,53
Peterhead,2649,7,15,7,14,43,41,2,52
East Fife,2649,8,10,9,17,42,52,-10,39
Stranraer,2649,9,11,3,22,45,66,-21,36
Stenhousem'r,2649,10,8,6,22,43,71,-28,30
Livingston,2650,1,20,7,9,72,38,34,67
Alloa,2650,2,19,8,9,63,42,21,65
Brechin,2650,3,18,6,12,53,47,6,60
Airdrieon,2650,4,14,10,12,48,52,-4,52
Queen's Park,2650,5,14,9,13,41,41,0,51
Albion,2650,6,11,12,13,46,49,-3,45
Peterhead,2650,7,10,13,13,40,45,-5,43
Stranraer,2650,8,11,8,17,46,54,-8,41
East Fife,2650,9,10,9,17,59,63,-4,39
Stenhousem'r,2650,10,8,8,20,54,91,-37,32
Alloa,2651,1,22,5,9,83,48,35,71
Livingston,2651,2,23,1,12,76,47,29,70
Brechin,2651,3,17,9,10,61,52,9,60
Stranraer,2651,4,17,4,15,63,60,3,55
East Fife,2651,5,13,13,10,59,48,11,52
Albion,2651,6,13,10,13,64,56,8,49
Peterhead,2651,7,12,7,17,54,70,-16,43
Airdrieon,2651,8,12,6,18,53,58,-5,42
Queen's Park,2651,9,9,10,17,33,62,-29,37
Stenhousem'r,2651,10,7,5,24,48,93,-45,26
Livingston,2652,1,22,5,9,75,40,35,71
Airdrieon,2652,2,21,4,11,69,56,13,67
Brechin,2652,3,18,6,12,55,46,9,60
Alloa,2652,4,13,12,11,56,42,14,51
Albion,2652,5,14,9,13,54,57,-3,51
Stranraer,2652,6,14,7,15,55,56,-1,49
Peterhead,2652,7,13,9,14,49,51,-2,48
East Fife,2652,8,12,10,14,53,49,4,46
Queen's Park,2652,9,10,7,19,38,56,-18,37
Stenhousem'r,2652,10,6,5,25,43,94,-51,23
Livingston,2653,1,21,5,10,76,50,26,68
Brechin,2653,2,19,7,10,56,45,11,64
Peterhead,2653,3,18,8,10,53,42,11,62
Alloa,2653,4,19,3,14,71,48,23,60
Albion,2653,5,12,10,14,40,47,-7,46
East Fife,2653,6,11,11,14,51,57,-6,44
Stranraer,2653,7,12,7,17,57,58,-1,43
Queen's Park,2653,8,12,7,17,36,51,-15,43
Airdrieon,2653,9,11,7,18,46,60,-14,40
Stenhousem'r,2653,10,8,9,19,58,86,-28,33
Alloa,2654,1,20,10,6,70,36,34,70
Livingston,2654,2,18,9,9,79,50,29,63
Airdrieon,2654,3,17,8,11,60,54,6,59
Albion,2654,4,13,12,11,56,47,9,51
Stranraer,2654,5,12,9,15,51,59,-8,45
Peterhead,2654,6,12,8,16,50,58,-8,44
Brechin,2654,7,12,8,16,44,62,-18,44
East Fife,2654,8,10,10,16,44,49,-5,40
Stenhousem'r,2654,9,10,10,16,56,77,-21,40
Queen's Park,2654,10,9,10,17,39,57,-18,37
Alloa,2655,1,19,8,9,72,47,25,65
Airdrieon,2655,2,16,12,8,57,47,10,60
Livingston,2655,3,18,4,14,74,56,18,58
East Fife,2655,4,15,7,14,53,48,5,52
Brechin,2655,5,14,8,14,38,45,-7,50
Albion,2655,6,13,8,15,53,51,2,47
Queen's Park,2655,7,13,6,17,35,50,-15,45
Stranraer,2655,8,12,7,17,55,64,-9,43
Peterhead,2655,9,11,9,16,47,56,-9,42
Stenhousem'r,2655,10,7,15,14,46,66,-20,36
Livingston,2656,1,22,6,8,76,45,31,72
Alloa,2656,2,21,5,10,80,48,32,68
Airdrieon,2656,3,19,8,9,70,48,22,65
Albion,2656,4,16,7,13,51,43,8,55
Brechin,2656,5,16,5,15,47,58,-11,53
East Fife,2656,6,12,9,15,52,46,6,45
Peterhead,2656,7,11,8,17,38,51,-13,41
Stranraer,2656,8,10,7,19,46,60,-14,37
Stenhousem'r,2656,9,10,5,21,49,84,-35,35
Queen's Park,2656,10,8,10,18,38,64,-26,34
Airdrieon,2657,1,22,4,10,64,53,11,70
Livingston,2657,2,22,3,11,77,43,34,69
Alloa,2657,3,20,8,8,73,35,38,68
Albion,2657,4,17,6,13,56,45,11,57
Brechin,2657,5,14,7,15,46,50,-4,49
Queen's Park,2657,6,12,8,16,39,48,-9,44
East Fife,2657,7,11,10,15,51,56,-5,43
Peterhead,2657,8,11,5,20,47,70,-23,38
Stenhousem'r,2657,9,10,6,20,49,84,-35,36
Stranraer,2657,10,10,5,21,44,62,-18,35
Livingston,2658,1,22,3,11,79,47,32,69
Alloa,2658,2,18,8,10,77,45,32,62
Airdrieon,2658,3,17,7,12,55,45,10,58
Brechin,2658,4,17,7,12,55,53,2,58
East Fife,2658,5,13,11,12,53,43,10,50
Queen's Park,2658,6,13,9,14,34,48,-14,48
Peterhead,2658,7,12,8,16,49,56,-7,44
Albion,2658,8,11,8,17,43,51,-8,41
Stranraer,2658,9,11,7,18,52,66,-14,40
Stenhousem'r,2658,10,7,10,19,42,85,-43,31
Livingston,2659,1,22,4,10,68,43,25,70
Alloa,2659,2,20,6,10,63,37,26,66
Albion,2659,3,17,5,14,48,41,7,56
Airdrieon,2659,4,16,5,15,61,60,1,53
Brechin,2659,5,14,7,15,47,50,-3,49
East Fife,2659,6,13,8,15,56,50,6,47
Peterhead,2659,7,13,7,16,58,62,-4,46
Queen's Park,2659,8,13,7,16,41,45,-4,46
Stranraer,2659,9,13,5,18,50,62,-12,44
Stenhousem'r,2659,10,8,8,20,47,89,-42,32
Livingston,2660,1,18,7,11,74,55,19,61
Alloa,2660,2,17,8,11,63,47,16,59
Stranraer,2660,3,16,5,15,55,46,9,53
Queen's Park,2660,4,15,8,13,43,44,-1,53
Airdrieon,2660,5,15,7,14,57,55,2,52
Peterhead,2660,6,13,12,11,46,50,-4,51
Brechin,2660,7,13,10,13,47,55,-8,49
Albion,2660,8,12,10,14,57,58,-1,46
Stenhousem'r,2660,9,12,4,20,45,72,-27,40
East Fife,2660,10,8,11,17,39,44,-5,35
Livingston,2661,1,22,3,11,71,45,26,69
Airdrieon,2661,2,20,6,10,68,63,5,66
Alloa,2661,3,16,11,9,67,47,20,59
Albion,2661,4,15,11,10,60,47,13,56
Peterhead,2661,5,15,6,15,50,42,8,51
East Fife,2661,6,13,7,16,52,50,2,46
Stranraer,2661,7,14,4,18,52,54,-2,46
Brechin,2661,8,12,6,18,44,60,-16,42
Queen's Park,2661,9,12,6,18,39,59,-20,42
Stenhousem'r,2661,10,7,8,21,47,83,-36,29
Alloa,2662,1,18,8,10,71,48,23,62
Livingston,2662,2,18,8,10,75,56,19,62
Airdrieon,2662,3,17,9,10,60,52,8,60
Albion,2662,4,16,8,12,63,45,18,56
Brechin,2662,5,16,7,13,45,50,-5,55
Peterhead,2662,6,14,9,13,47,50,-3,51
Stranraer,2662,7,15,4,17,62,60,2,49
Queen's Park,2662,8,12,5,19,36,57,-21,41
East Fife,2662,9,10,8,18,50,56,-6,38
Stenhousem'r,2662,10,5,12,19,48,83,-35,27
Brechin,2663,1,20,4,12,56,53,3,64
Livingston,2663,2,17,8,11,70,51,19,59
Stranraer,2663,3,18,4,14,62,52,10,58
Airdrieon,2663,4,16,8,12,57,51,6,56
Albion,2663,5,17,4,15,61,61,0,55
Alloa,2663,6,16,6,14,66,49,17,54
Peterhead,2663,7,13,11,12,46,48,-2,50
Queen's Park,2663,8,11,7,18,43,58,-15,40
East Fife,2663,9,9,12,15,45,50,-5,39
Stenhousem'r,2663,10,7,8,21,48,81,-33,29
Livingston,2664,1,21,5,10,76,49,27,68
Brechin,2664,2,19,6,11,53,45,8,63
Alloa,2664,3,18,7,11,64,40,24,61
Stranraer,2664,4,15,7,14,51,52,-1,52
Albion,2664,5,15,6,15,60,51,9,51
Airdrieon,2664,6,15,5,16,50,54,-4,50
Peterhead,2664,7,12,8,16,49,55,-6,44
Queen's Park,2664,8,12,7,17,48,65,-17,43
East Fife,2664,9,8,12,16,49,57,-8,36
Stenhousem'r,2664,10,7,13,16,45,77,-32,34
Livingston,2665,1,23,5,8,82,47,35,74
Alloa,2665,2,20,8,8,72,41,31,68
Airdrieon,2665,3,16,10,10,59,52,7,58
Albion,2665,4,16,7,13,56,50,6,55
Brechin,2665,5,16,6,14,52,48,4,54
East Fife,2665,6,13,11,12,58,52,6,50
Peterhead,2665,7,10,12,14,47,57,-10,42
Queen's Park,2665,8,9,9,18,40,63,-23,36
Stranraer,2665,9,10,5,21,54,65,-11,35
Stenhousem'r,2665,10,6,9,21,44,89,-45,27
Alloa,2666,1,19,9,8,67,42,25,66
Airdrieon,2666,2,20,6,10,66,52,14,66
Livingston,2666,3,17,6,13,66,53,13,57
Peterhead,2666,4,15,7,14,55,51,4,52
Brechin,2666,5,14,9,13,44,48,-4,51
Stranraer,2666,6,14,8,14,54,55,-1,50
East Fife,2666,7,11,11,14,45,44,1,44
Albion,2666,8,11,10,15,52,59,-7,43
Stenhousem'r,2666,9,11,5,20,54,78,-24,38
Queen's Park,2666,10,9,7,20,36,57,-21,34
Livingston,2667,1,23,5,8,78,41,37,74
Brechin,2667,2,21,2,13,56,43,13,65
Airdrieon,2667,3,18,8,10,56,46,10,62
Alloa,2667,4,17,5,14,62,52,10,56
Peterhead,2667,5,14,9,13,55,49,6,51
East Fife,2667,6,13,12,11,45,39,6,51
Queen's Park,2667,7,13,6,17,39,50,-11,45
Albion,2667,8,13,4,19,54,64,-10,43
Stranraer,2667,9,12,6,18,49,62,-13,42
Stenhousem'r,2667,10,3,9,24,37,85,-48,18
Stranraer,2668,1,18,6,12,67,61,6,60
Brechin,2668,2,17,6,13,57,48,9,57
Peterhead,2668,3,16,8,12,48,50,-2,56
Alloa,2668,4,16,6,14,66,54,12,54
Livingston,2668,5,15,8,13,66,52,14,53
East Fife,2668,6,12,11,13,54,51,3,47
Airdrieon,2668,7,11,14,11,50,53,-3,47
Albion,2668,8,12,9,15,45,50,-5,45
Queen's Park,2668,9,12,6,18,39,53,-14,42
Stenhousem'r,2668,10,11,6,19,52,72,-20,39
Livingston,2669,1,20,5,11,72,39,33,65
Alloa,2669,2,18,10,8,65,43,22,64
Airdrieon,2669,3,17,7,12,51,44,7,58
Albion,2669,4,15,7,14,51,51,0,52
Brechin,2669,5,13,9,14,41,46,-5,48
Queen's Park,2669,6,13,7,16,27,40,-13,46
Peterhead,2669,7,12,9,15,55,61,-6,45
East Fife,2669,8,11,11,14,49,49,0,44
Stranraer,2669,9,11,9,16,40,51,-11,42
Stenhousem'r,2669,10,10,6,20,45,72,-27,36
Airdrieon,2670,1,22,5,9,82,50,32,71
Alloa,2670,2,18,9,9,79,49,30,63
Livingston,2670,3,18,5,13,77,53,24,59
Brechin,2670,4,16,9,11,50,52,-2,57
Queen's Park,2670,5,15,8,13,46,46,0,53
Peterhead,2670,6,15,7,14,49,50,-1,52
Stranraer,2670,7,12,10,14,64,58,6,46
Albion,2670,8,12,8,16,55,65,-10,44
East Fife,2670,9,7,10,19,45,71,-26,31
Stenhousem'r,2670,10,7,5,24,44,97,-53,26
Alloa,2671,1,19,8,9,68,42,26,65
Airdrieon,2671,2,18,8,10,68,53,15,62
Brechin,2671,3,18,5,13,55,49,6,59
Livingston,2671,4,16,6,14,62,48,14,54
Albion,2671,5,14,10,12,50,49,1,52
Peterhead,2671,6,14,9,13,54,56,-2,51
Stranraer,2671,7,14,4,18,54,58,-4,46
Queen's Park,2671,8,12,7,17,37,56,-19,43
East Fife,2671,9,9,9,18,43,52,-9,36
Stenhousem'r,2671,10,8,10,18,52,80,-28,34
Livingston,2672,1,21,6,9,82,51,31,69
Airdrieon,2672,2,20,6,10,68,50,18,66
Brechin,2672,3,19,8,9,55,35,20,65
Alloa,2672,4,18,4,14,62,47,15,58
Peterhead,2672,5,13,9,14,48,52,-4,48
Stranraer,2672,6,14,5,17,47,57,-10,47
Queen's Park,2672,7,13,8,15,39,51,-12,47
Albion,2672,8,12,9,15,53,57,-4,45
East Fife,2672,9,8,10,18,46,53,-7,34
Stenhousem'r,2672,10,5,9,22,38,85,-47,24
Livingston,2673,1,20,7,9,82,51,31,67
East Fife,2673,2,18,8,10,59,42,17,62
Brechin,2673,3,17,6,13,50,49,1,57
Airdrieon,2673,4,17,4,15,62,56,6,55
Alloa,2673,5,15,8,13,69,61,8,53
Peterhead,2673,6,15,6,15,49,50,-1,51
Albion,2673,7,13,10,13,54,56,-2,49
Queen's Park,2673,8,12,8,16,43,52,-9,44
Stranraer,2673,9,12,4,20,43,57,-14,40
Stenhousem'r,2673,10,7,7,22,42,79,-37,28
Alloa,2674,1,19,9,8,70,47,23,66
Airdrieon,2674,2,20,4,12,61,51,10,64
Livingston,2674,3,17,9,10,75,53,22,60
Peterhead,2674,4,13,12,11,46,48,-2,51
Brechin,2674,5,14,8,14,47,53,-6,50
Albion,2674,6,13,10,13,51,47,4,49
East Fife,2674,7,11,11,14,43,39,4,44
Queen's Park,2674,8,11,10,15,37,47,-10,43
Stranraer,2674,9,10,7,19,45,60,-15,37
Stenhousem'r,2674,10,7,10,19,49,79,-30,31
Alloa,2675,1,18,11,7,72,46,26,65
Livingston,2675,2,17,7,12,65,46,19,58
Airdrieon,2675,3,15,9,12,57,54,3,54
Brechin,2675,4,15,8,13,45,43,2,53
Queen's Park,2675,5,14,8,14,43,47,-4,50
East Fife,2675,6,12,10,14,55,51,4,46
Albion,2675,7,10,13,13,49,52,-3,43
Stenhousem'r,2675,8,10,13,13,51,65,-14,43
Stranraer,2675,9,12,7,17,48,62,-14,43
Peterhead,2675,10,9,10,17,41,60,-19,37
Alloa,2676,1,21,8,7,69,40,29,71
Livingston,2676,2,21,5,10,68,43,25,68
Airdrieon,2676,3,18,7,11,53,47,6,61
Albion,2676,4,15,9,12,59,47,12,54
East Fife,2676,5,15,9,12,54,47,7,54
Stranraer,2676,6,13,7,16,46,58,-12,46
Peterhead,2676,7,10,12,14,46,51,-5,42
Brechin,2676,8,12,5,19,49,58,-9,41
Queen's Park,2676,9,12,3,21,38,58,-20,39
Stenhousem'r,2676,10,6,9,21,39,72,-33,27
Airdrieon,2677,1,22,4,10,64,42,22,70
Livingston,2677,2,21,4,11,75,55,20,67
Alloa,2677,3,18,11,7,60,31,29,65
Queen's Park,2677,4,17,4,15,42,43,-1,55
Brechin,2677,5,15,3,18,52,56,-4,48
Stranraer,2677,6,14,6,16,47,54,-7,48
East Fife,2677,7,12,9,15,52,51,1,45
Albion,2677,8,11,8,17,45,52,-7,41
Peterhead,2677,9,11,5,20,48,64,-16,38
Stenhousem'r,2677,10,9,6,21,37,74,-37,33
Livingston,2678,1,22,6,8,89,53,36,72
Alloa,2678,2,19,6,11,73,51,22,63
Airdrieon,2678,3,17,8,11,61,53,8,59
Brechin,2678,4,18,3,15,55,51,4,57
Peterhead,2678,5,13,11,12,54,57,-3,50
East Fife,2678,6,12,12,12,51,44,7,48
Queen's Park,2678,7,13,7,16,43,52,-9,46
Albion,2678,8,11,8,17,44,55,-11,41
Stranraer,2678,9,10,8,18,52,63,-11,38
Stenhousem'r,2678,10,6,9,21,50,93,-43,27
Livingston,2679,1,17,9,10,69,45,24,60
Alloa,2679,2,16,11,9,67,49,18,59
Albion,2679,3,15,14,7,57,40,17,59
Airdrieon,2679,4,17,6,13,58,54,4,57
Queen's Park,2679,5,15,6,15,39,50,-11,51
Peterhead,2679,6,14,7,15,49,50,-1,49
Brechin,2679,7,14,7,15,44,49,-5,49
Stranraer,2679,8,11,8,17,49,61,-12,41
East Fife,2679,9,8,14,14,49,55,-6,38
Stenhousem'r,2679,10,8,8,20,42,70,-28,32
Airdrieon,2680,1,22,5,9,61,45,16,71
Livingston,2680,2,20,7,9,75,42,33,67
Alloa,2680,3,18,7,11,67,45,22,61
Brechin,2680,4,19,3,14,57,51,6,60
Albion,2680,5,16,7,13,52,45,7,55
Queen's Park,2680,6,11,10,15,43,58,-15,43
Peterhead,2680,7,12,5,19,38,52,-14,41
East Fife,2680,8,9,13,14,50,53,-3,40
Stranraer,2680,9,10,6,20,39,59,-20,36
Stenhousem'r,2680,10,7,9,20,40,72,-32,30
Livingston,2681,1,26,2,8,74,42,32,80
Alloa,2681,2,20,9,7,75,43,32,69
Airdrieon,2681,3,16,7,13,63,56,7,55
Brechin,2681,4,16,7,13,49,51,-2,55
Albion,2681,5,13,11,12,61,53,8,50
Queen's Park,2681,6,14,7,15,45,52,-7,49
Peterhead,2681,7,13,5,18,49,58,-9,44
Stranraer,2681,8,11,8,17,48,59,-11,41
East Fife,2681,9,7,11,18,41,53,-12,32
Stenhousem'r,2681,10,7,7,22,42,80,-38,28
Alloa,2682,1,22,5,9,90,49,41,71
Livingston,2682,2,19,4,13,68,52,16,61
Brechin,2682,3,17,4,15,65,56,9,55
Airdrieon,2682,4,16,7,13,62,57,5,55
Peterhead,2682,5,15,7,14,59,64,-5,52
Queen's Park,2682,6,15,7,14,41,51,-10,52
East Fife,2682,7,14,9,13,57,44,13,51
Albion,2682,8,13,9,14,47,51,-4,48
Stranraer,2682,9,11,6,19,56,72,-16,39
Stenhousem'r,2682,10,6,6,24,42,91,-49,24
Livingston,2683,1,23,2,11,81,45,36,71
Alloa,2683,2,21,6,9,70,40,30,69
Peterhead,2683,3,19,7,10,54,44,10,64
Brechin,2683,4,17,8,11,57,47,10,59
Albion,2683,5,15,6,15,57,56,1,51
Airdrieon,2683,6,14,7,15,56,59,-3,49
Queen's Park,2683,7,11,6,19,38,64,-26,39
Stranraer,2683,8,10,6,20,47,61,-14,36
East Fife,2683,9,8,11,17,41,55,-14,35
Stenhousem'r,2683,10,8,9,19,41,71,-30,33
Alloa,2684,1,23,6,7,83,44,39,75
Airdrieon,2684,2,19,8,9,59,43,16,65
Brechin,2684,3,18,5,13,58,52,6,59
Livingston,2684,4,18,3,15,75,57,18,57
Albion,2684,5,15,9,12,48,48,0,54
Stranraer,2684,6,15,2,19,49,55,-6,47
Queen's Park,2684,7,12,7,17,32,54,-22,43
Peterhead,2684,8,11,8,17,44,56,-12,41
East Fife,2684,9,10,8,18,51,59,-8,38
Stenhousem'r,2684,10,9,4,23,53,84,-31,31
Livingston,2685,1,22,3,11,78,42,36,69
Airdrieon,2685,2,17,8,11,56,48,8,59
Albion,2685,3,16,7,13,59,46,13,55
Stranraer,2685,4,16,7,13,57,58,-1,55
Brechin,2685,5,16,5,15,46,57,-11,53
Peterhead,2685,6,14,9,13,55,53,2,51
Alloa,2685,7,14,8,14,55,53,2,50
East Fife,2685,8,12,6,18,48,48,0,42
Queen's Park,2685,9,12,6,18,31,43,-12,42
Stenhousem'r,2685,10,9,5,22,41,78,-37,32
Alloa,2686,1,23,6,7,77,42,35,75
Livingston,2686,2,22,3,11,78,54,24,69
Airdrieon,2686,3,19,7,10,73,53,20,64
Brechin,2686,4,15,6,15,49,53,-4,51
Stranraer,2686,5,16,3,17,51,58,-7,51
Peterhead,2686,6,13,8,15,46,49,-3,47
Queen's Park,2686,7,12,10,14,44,52,-8,46
Albion,2686,8,12,9,15,64,67,-3,45
East Fife,2686,9,9,5,22,44,55,-11,32
Stenhousem'r,2686,10,7,7,22,47,90,-43,28
Livingston,2687,1,22,7,7,82,45,37,73
Alloa,2687,2,17,11,8,61,39,22,62
Airdrieon,2687,3,16,6,14,54,53,1,54
Brechin,2687,4,15,5,16,40,44,-4,50
East Fife,2687,5,13,10,13,43,43,0,49
Stranraer,2687,6,13,9,14,49,49,0,48
Albion,2687,7,11,13,12,46,44,2,46
Queen's Park,2687,8,12,6,18,40,58,-18,42
Peterhead,2687,9,9,10,17,44,53,-9,37
Stenhousem'r,2687,10,9,9,18,43,74,-31,36
Livingston,2688,1,21,5,10,83,58,25,68
Brechin,2688,2,17,9,10,57,48,9,60
Peterhead,2688,3,17,7,12,58,58,0,58
Airdrieon,2688,4,16,8,12,48,41,7,56
Alloa,2688,5,16,7,13,71,52,19,55
Albion,2688,6,15,8,13,61,50,11,53
Queen's Park,2688,7,13,6,17,42,47,-5,45
East Fife,2688,8,9,10,17,43,55,-12,37
Stranraer,2688,9,9,8,19,43,65,-22,35
Stenhousem'r,2688,10,8,10,18,46,78,-32,34
Livingston,2689,1,25,3,8,87,45,42,78
Alloa,2689,2,18,9,9,67,42,25,63
Airdrieon,2689,3,18,8,10,58,43,15,62
Brechin,2689,4,17,6,13,57,50,7,57
Peterhead,2689,5,12,7,17,48,64,-16,43
Albion,2689,6,11,9,16,53,58,-5,42
Queen's Park,2689,7,11,8,17,44,63,-19,41
Stenhousem'r,2689,8,11,8,17,56,80,-24,41
East Fife,2689,9,11,7,18,36,47,-11,40
Stranraer,2689,10,9,9,18,45,59,-14,36
Livingston,2690,1,21,7,8,74,46,28,70
Alloa,2690,2,18,8,10,74,44,30,62
Airdrieon,2690,3,19,5,12,61,52,9,62
Peterhead,2690,4,15,7,14,54,52,2,52
Stranraer,2690,5,16,2,18,54,59,-5,50
Brechin,2690,6,14,7,15,45,50,-5,49
Albion,2690,7,13,8,15,50,61,-11,47
Queen's Park,2690,8,12,7,17,39,55,-16,43
East Fife,2690,9,9,10,17,45,50,-5,37
Stenhousem'r,2690,10,8,9,19,50,77,-27,33
Alloa,2691,1,20,8,8,69,40,29,68
Livingston,2691,2,21,5,10,77,50,27,68
East Fife,2691,3,16,7,13,56,42,14,55
Brechin,2691,4,15,5,16,49,51,-2,50
Albion,2691,5,14,8,14,55,58,-3,50
Airdrieon,2691,6,14,5,17,62,65,-3,47
Stenhousem'r,2691,7,13,5,18,50,71,-21,44
Peterhead,2691,8,12,7,17,45,54,-9,43
Queen's Park,2691,9,10,11,15,29,50,-21,41
Stranraer,2691,10,11,7,18,45,56,-11,40
Livingston,2692,1,22,4,10,78,48,30,70
Alloa,2692,2,20,7,9,65,35,30,67
Airdrieon,2692,3,17,8,11,65,52,13,59
Peterhead,2692,4,17,8,11,60,56,4,59
Brechin,2692,5,15,4,17,47,43,4,49
Albion,2692,6,12,10,14,52,50,2,46
Queen's Park,2692,7,13,6,17,39,58,-19,45
Stranraer,2692,8,11,9,16,55,61,-6,42
East Fife,2692,9,9,11,16,39,50,-11,38
Stenhousem'r,2692,10,7,7,22,50,97,-47,28
Alloa,2693,1,20,6,10,69,49,20,66
Airdrieon,2693,2,19,5,12,68,52,16,62
Livingston,2693,3,18,6,12,75,58,17,60
Brechin,2693,4,16,8,12,50,45,5,56
Albion,2693,5,17,5,14,54,54,0,56
Peterhead,2693,6,15,6,15,46,53,-7,51
East Fife,2693,7,13,11,12,54,47,7,50
Stranraer,2693,8,11,8,17,51,55,-4,41
Queen's Park,2693,9,8,10,18,31,50,-19,34
Stenhousem'r,2693,10,7,7,22,37,72,-35,28
Livingston,2694,1,22,3,11,82,51,31,69
Alloa,2694,2,18,6,12,64,52,12,60
Airdrieon,2694,3,18,6,12,64,61,3,60
Brechin,2694,4,17,4,15,54,55,-1,55
Albion,2694,5,15,7,14,60,52,8,52
Peterhead,2694,6,15,7,14,52,55,-3,52
Stranraer,2694,7,13,8,15,60,59,1,47
East Fife,2694,8,12,9,15,50,55,-5,45
Queen's Park,2694,9,11,6,19,34,50,-16,39
Stenhousem'r,2694,10,8,6,22,47,77,-30,30
Alloa,2695,1,22,8,6,79,39,40,74
Livingston,2695,2,21,4,11,76,44,32,67
Brechin,2695,3,16,7,13,52,44,8,55
Peterhead,2695,4,16,6,14,54,52,2,54
Albion,2695,5,14,9,13,50,48,2,51
Queen's Park,2695,6,15,6,15,43,48,-5,51
Airdrieon,2695,7,15,6,15,54,63,-9,51
Stranraer,2695,8,12,7,17,44,55,-11,43
East Fife,2695,9,10,7,19,41,55,-14,37
Stenhousem'r,2695,10,6,6,24,36,81,-45,24
Livingston,2696,1,25,3,8,87,43,44,78
Airdrieon,2696,2,20,9,7,66,43,23,69
Alloa,2696,3,17,6,13,68,56,12,57
Brechin,2696,4,16,3,17,49,48,1,51
Albion,2696,5,14,7,15,56,57,-1,49
Queen's Park,2696,6,14,6,16,44,59,-15,48
East Fife,2696,7,11,10,15,47,51,-4,43
Peterhead,2696,8,12,7,17,44,59,-15,43
Stranraer,2696,9,12,3,21,43,61,-18,39
Stenhousem'r,2696,10,8,8,20,53,80,-27,32
Alloa,2697,1,21,5,10,72,38,34,68
Livingston,2697,2,20,2,14,65,55,10,62
Airdrieon,2697,3,17,7,12,55,48,7,58
East Fife,2697,4,15,9,12,53,44,9,54
Stranraer,2697,5,16,4,16,53,56,-3,52
Brechin,2697,6,15,3,18,48,51,-3,48
Peterhead,2697,7,13,7,16,45,49,-4,46
Albion,2697,8,12,10,14,43,54,-11,46
Queen's Park,2697,9,11,8,17,36,53,-17,41
Stenhousem'r,2697,10,9,7,20,51,73,-22,34
Alloa,2698,1,20,9,7,73,41,32,69
Livingston,2698,2,18,6,12,62,39,23,60
Brechin,2698,3,18,6,12,50,43,7,60
Airdrieon,2698,4,18,5,13,65,55,10,59
Albion,2698,5,15,8,13,50,51,-1,53
East Fife,2698,6,12,9,15,52,56,-4,45
Queen's Park,2698,7,12,7,17,35,52,-17,43
Peterhead,2698,8,11,8,17,56,62,-6,41
Stenhousem'r,2698,9,11,6,19,49,75,-26,39
Stranraer,2698,10,10,6,20,52,70,-18,36
Livingston,2699,1,21,5,10,78,58,20,68
Airdrieon,2699,2,19,9,8,64,40,24,66
Alloa,2699,3,17,9,10,67,48,19,60
Brechin,2699,4,17,6,13,50,44,6,57
Peterhead,2699,5,16,7,13,48,44,4,55
Albion,2699,6,13,10,13,53,46,7,49
Queen's Park,2699,7,14,6,16,38,52,-14,48
East Fife,2699,8,11,7,18,52,53,-1,40
Stranraer,2699,9,9,7,20,38,65,-27,34
Stenhousem'r,2699,10,7,6,23,47,85,-38,27
Livingston,2700,1,26,2,8,82,37,45,80
Alloa,2700,2,23,6,7,74,38,36,75
Brechin,2700,3,19,5,12,58,48,10,62
Peterhead,2700,4,17,4,15,47,49,-2,55
Airdrieon,2700,5,15,5,16,52,56,-4,50
Albion,2700,6,13,9,14,50,49,1,48
Stranraer,2700,7,13,5,18,49,66,-17,44
East Fife,2700,8,12,7,17,54,52,2,43
Queen's Park,2700,9,10,7,19,28,57,-29,37
Stenhousem'r,2700,10,5,4,27,41,83,-42,19
Livingston,2701,1,21,2,13,81,54,27,65
Alloa,2701,2,17,9,10,70,45,25,60
Airdrieon,2701,3,18,5,13,60,53,7,59
Peterhead,2701,4,17,7,12,59,48,11,58
Albion,2701,5,15,8,13,59,53,6,53
Stranraer,2701,6,15,5,16,62,61,1,50
Brechin,2701,7,13,6,17,51,67,-16,45
Queen's Park,2701,8,12,7,17,37,57,-20,43
East Fife,2701,9,9,11,16,51,57,-6,38
Stenhousem'r,2701,10,9,8,19,46,81,-35,35
Livingston,2702,1,21,5,10,74,44,30,68
Airdrieon,2702,2,19,7,10,64,49,15,64
Alloa,2702,3,18,7,11,65,44,21,61
Peterhead,2702,4,16,11,9,60,48,12,59
Brechin,2702,5,17,4,15,52,52,0,55
Albion,2702,6,15,7,14,62,57,5,52
Queen's Park,2702,7,14,9,13,41,46,-5,51
Stranraer,2702,8,11,8,17,51,64,-13,41
East Fife,2702,9,10,8,18,51,59,-8,38
Stenhousem'r,2702,10,3,6,27,37,94,-57,15
Alloa,2703,1,21,8,7,76,48,28,71
Livingston,2703,2,20,4,12,75,59,16,64
Brechin,2703,3,17,5,14,51,47,4,56
Airdrieon,2703,4,15,7,14,52,58,-6,52
Peterhead,2703,5,15,6,15,51,48,3,51
Stranraer,2703,6,14,6,16,56,57,-1,48
Albion,2703,7,11,11,14,49,50,-1,44
Stenhousem'r,2703,8,11,8,17,48,71,-23,41
East Fife,2703,9,9,12,15,48,52,-4,39
Queen's Park,2703,10,9,9,18,42,58,-16,36
Alloa,2704,1,22,6,8,72,43,29,72
Brechin,2704,2,20,5,11,64,46,18,65
Livingston,2704,3,20,4,12,81,55,26,64
Peterhead,2704,4,16,5,15,53,57,-4,53
Albion,2704,5,13,11,12,55,49,6,50
Airdrieon,2704,6,14,7,15,53,62,-9,49
Queen's Park,2704,7,14,4,18,33,50,-17,46
East Fife,2704,8,11,11,14,47,48,-1,44
Stenhousem'r,2704,9,8,9,19,54,82,-28,33
Stranraer,2704,10,8,6,22,44,64,-20,30
Alloa,2705,1,19,7,10,71,46,25,64
Albion,2705,2,19,6,11,61,45,16,63
Airdrieon,2705,3,18,6,12,57,51,6,60
Livingston,2705,4,19,2,15,67,51,16,59
Brechin,2705,5,17,8,11,60,48,12,59
Peterhead,2705,6,16,8,12,47,41,6,56
Queen's Park,2705,7,11,8,17,40,58,-18,41
Stenhousem'r,2705,8,11,4,21,44,82,-38,37
East Fife,2705,9,9,8,19,49,56,-7,35
Stranraer,2705,10,9,7,20,47,65,-18,34
Alloa,2706,1,20,6,10,77,50,27,66
Livingston,2706,2,21,3,12,81,58,23,66
Brechin,2706,3,16,7,13,50,49,1,55
Airdrieon,2706,4,16,6,14,59,57,2,54
Queen's Park,2706,5,16,3,17,48,50,-2,51
Stranraer,2706,6,15,6,15,58,64,-6,51
Albion,2706,7,12,10,14,52,54,-2,46
East Fife,2706,8,12,8,16,45,51,-6,44
Peterhead,2706,9,11,6,19,47,61,-14,39
Stenhousem'r,2706,10,10,7,19,59,82,-23,37
Livingston,2707,1,23,4,9,77,41,36,73
Alloa,2707,2,18,10,8,63,40,23,64
Airdrieon,2707,3,19,5,12,60,52,8,62
Brechin,2707,4,17,5,14,52,45,7,56
Peterhead,2707,5,15,6,15,53,60,-7,51
Albion,2707,6,12,10,14,47,60,-13,46
East Fife,2707,7,12,7,17,54,51,3,43
Queen's Park,2707,8,12,7,17,42,51,-9,43
Stranraer,2707,9,12,3,21,47,62,-15,39
Stenhousem'r,2707,10,8,7,21,44,77,-33,31
Livingston,2708,1,21,3,12,77,54,23,66
Alloa,2708,2,20,5,11,69,44,25,65
Brechin,2708,3,17,7,12,51,40,11,58
Peterhead,2708,4,16,6,14,50,50,0,54
Queen's Park,2708,5,15,9,12,37,42,-5,54
Airdrieon,2708,6,14,11,11,53,56,-3,53
Stranraer,2708,7,13,6,17,53,57,-4,45
Albion,2708,8,11,11,14,51,54,-3,44
East Fife,2708,9,10,6,20,41,50,-9,36
Stenhousem'r,2708,10,6,10,20,41,76,-35,28
Livingston,2709,1,19,7,10,70,44,26,64
Brechin,2709,2,20,4,12,49,42,7,64
Alloa,2709,3,19,5,12,63,47,16,62
Stranraer,2709,4,16,8,12,54,48,6,56
Airdrieon,2709,5,14,7,15,51,50,1,49
Peterhead,2709,6,13,9,14,47,52,-5,48
Queen's Park,2709,7,14,5,17,38,51,-13,47
Albion,2709,8,11,13,12,49,54,-5,46
Stenhousem'r,2709,9,9,8,19,43,67,-24,35
East Fife,2709,10,7,10,19,42,51,-9,31
Alloa,2710,1,23,5,8,82,43,39,74
Livingston,2710,2,17,5,14,79,60,19,56
Albion,2710,3,14,11,11,56,52,4,53
Brechin,2710,4,15,8,13,43,51,-8,53
Queen's Park,2710,5,15,7,14,48,51,-3,52
Airdrieon,2710,6,16,4,16,59,66,-7,52
East Fife,2710,7,13,10,13,52,47,5,49
Stranraer,2710,8,16,1,19,51,58,-7,49
Peterhead,2710,9,13,9,14,53,55,-2,48
Stenhousem'r,2710,10,4,8,24,43,83,-40,20
Brechin,2711,1,17,11,8,50,43,7,62
Livingston,2711,2,18,6,12,75,49,26,60
Alloa,2711,3,17,9,10,72,49,23,60
Albion,2711,4,15,10,11,56,50,6,55
Peterhead,2711,5,14,10,12,50,50,0,52
Stranraer,2711,6,15,7,14,53,54,-1,52
Airdrieon,2711,7,13,8,15,51,57,-6,47
Queen's Park,2711,8,11,10,15,36,49,-13,43
East Fife,2711,9,10,7,19,51,57,-6,37
Stenhousem'r,2711,10,8,6,22,46,82,-36,30
Alloa,2712,1,20,8,8,65,39,26,68
Livingston,2712,2,18,9,9,71,47,24,63
Airdrieon,2712,3,17,8,11,61,55,6,59
Stranraer,2712,4,15,8,13,57,51,6,53
Brechin,2712,5,14,10,12,47,47,0,52
East Fife,2712,6,14,8,14,55,43,12,50
Albion,2712,7,13,10,13,51,50,1,49
Peterhead,2712,8,10,10,16,43,53,-10,40
Queen's Park,2712,9,9,8,19,36,61,-25,35
Stenhousem'r,2712,10,6,9,21,40,80,-40,27
Livingston,2713,1,21,5,10,73,48,25,68
Brechin,2713,2,19,7,10,57,47,10,64
Alloa,2713,3,18,5,13,64,46,18,59
Airdrieon,2713,4,15,8,13,53,57,-4,53
Stranraer,2713,5,15,7,14,59,53,6,52
East Fife,2713,6,14,8,14,51,43,8,50
Queen's Park,2713,7,14,8,14,44,49,-5,50
Albion,2713,8,11,10,15,50,54,-4,43
Peterhead,2713,9,11,8,17,44,55,-11,41
Stenhousem'r,2713,10,5,8,23,43,86,-43,23
Livingston,2714,1,21,3,12,69,47,22,66
Albion,2714,2,17,9,10,63,40,23,60
Airdrieon,2714,3,18,5,13,62,59,3,59
Alloa,2714,4,16,10,10,64,51,13,58
Brechin,2714,5,17,6,13,58,47,11,57
East Fife,2714,6,16,8,12,57,49,8,56
Queen's Park,2714,7,11,9,16,40,52,-12,42
Peterhead,2714,8,8,12,16,47,60,-13,36
Stranraer,2714,9,9,7,20,39,61,-22,34
Stenhousem'r,2714,10,8,9,19,35,68,-33,33
Alloa,2715,1,21,5,10,72,41,31,68
Livingston,2715,2,21,3,12,74,48,26,66
Brechin,2715,3,17,5,14,52,50,2,56
Airdrieon,2715,4,15,9,12,52,49,3,54
Stranraer,2715,5,13,8,15,49,56,-7,47
Albion,2715,6,12,10,14,53,53,0,46
Peterhead,2715,7,12,9,15,51,55,-4,45
East Fife,2715,8,11,10,15,47,45,2,43
Queen's Park,2715,9,12,6,18,32,54,-22,42
Stenhousem'r,2715,10,10,7,19,48,79,-31,37
Alloa,2716,1,24,6,6,73,30,43,78
Brechin,2716,2,17,8,11,54,51,3,59
Livingston,2716,3,18,4,14,68,55,13,58
Airdrieon,2716,4,16,7,13,60,51,9,55
Peterhead,2716,5,14,9,13,46,47,-1,51
East Fife,2716,6,13,9,14,53,48,5,48
Stranraer,2716,7,11,9,16,57,64,-7,42
Queen's Park,2716,8,10,11,15,33,53,-20,41
Albion,2716,9,8,11,17,47,63,-16,35
Stenhousem'r,2716,10,8,8,20,50,79,-29,32
Livingston,2717,1,23,4,9,87,56,31,73
Alloa,2717,2,19,7,10,75,45,30,64
Airdrieon,2717,3,16,9,11,60,57,3,57
Brechin,2717,4,17,4,15,53,54,-1,55
East Fife,2717,5,14,10,12,60,42,18,52
Peterhead,2717,6,12,10,14,52,55,-3,46
Albion,2717,7,13,7,16,51,61,-10,46
Stranraer,2717,8,12,9,15,57,61,-4,45
Stenhousem'r,2717,9,9,8,19,45,81,-36,35
Queen's Park,2717,10,6,10,20,36,64,-28,28
Alloa,2718,1,21,9,6,79,41,38,72
Livingston,2718,2,19,7,10,75,45,30,64
Airdrieon,2718,3,16,8,12,56,57,-1,56
Peterhead,2718,4,14,13,9,54,51,3,55
Brechin,2718,5,17,3,16,50,62,-12,54
East Fife,2718,6,13,8,15,53,50,3,47
Albion,2718,7,12,10,14,51,56,-5,46
Queen's Park,2718,8,11,10,15,42,48,-6,43
Stranraer,2718,9,7,10,19,48,66,-18,31
Stenhousem'r,2718,10,7,8,21,47,79,-32,29
Alloa,2719,1,20,7,9,73,44,29,67
Livingston,2719,2,20,5,11,68,41,27,65
Airdrieon,2719,3,18,9,9,64,50,14,63
Peterhead,2719,4,15,6,15,52,52,0,51
Brechin,2719,5,14,7,15,46,51,-5,49
Albion,2719,6,12,12,12,51,48,3,48
Queen's Park,2719,7,12,9,15,39,52,-13,45
Stranraer,2719,8,10,11,15,40,50,-10,41
East Fife,2719,9,9,10,17,38,48,-10,37
Stenhousem'r,2719,10,7,10,19,42,77,-35,31
Livingston,2720,1,23,4,9,77,41,36,73
Alloa,2720,2,19,9,8,73,41,32,66
Airdrieon,2720,3,17,7,12,57,53,4,58
Brechin,2720,4,16,9,11,46,43,3,57
Albion,2720,5,14,9,13,55,51,4,51
Peterhead,2720,6,12,10,14,50,51,-1,46
Queen's Park,2720,7,12,9,15,30,45,-15,45
Stranraer,2720,8,11,7,18,40,55,-15,40
East Fife,2720,9,9,11,16,42,50,-8,38
Stenhousem'r,2720,10,6,7,23,38,78,-40,25
Livingston,2721,1,22,7,7,77,43,34,73
Alloa,2721,2,21,7,8,64,40,24,70
Airdrieon,2721,3,18,7,11,63,52,11,61
Peterhead,2721,4,15,9,12,50,51,-1,54
Albion,2721,5,14,11,11,51,49,2,53
Queen's Park,2721,6,13,6,17,39,46,-7,45
Brechin,2721,7,11,9,16,39,55,-16,42
East Fife,2721,8,9,12,15,48,48,0,39
Stenhousem'r,2721,9,8,10,18,57,78,-21,34
Stranraer,2721,10,6,8,22,42,68,-26,26
Livingston,2722,1,21,5,10,77,44,33,68
Albion,2722,2,18,10,8,71,54,17,64
Airdrieon,2722,3,20,4,12,55,47,8,64
Alloa,2722,4,16,11,9,68,46,22,59
East Fife,2722,5,14,11,11,53,48,5,53
Brechin,2722,6,13,11,12,51,51,0,50
Peterhead,2722,7,12,4,20,49,70,-21,40
Stranraer,2722,8,9,8,19,49,64,-15,35
Stenhousem'r,2722,9,10,5,21,55,73,-18,35
Queen's Park,2722,10,9,7,20,37,68,-31,34
Livingston,2723,1,20,5,11,70,49,21,65
Brechin,2723,2,18,9,9,57,41,16,63
Alloa,2723,3,18,8,10,69,48,21,62
Airdrieon,2723,4,16,7,13,56,55,1,55
Queen's Park,2723,5,13,9,14,45,56,-11,48
Stranraer,2723,6,13,7,16,54,55,-1,46
East Fife,2723,7,10,13,13,52,54,-2,43
Peterhead,2723,8,11,10,15,48,53,-5,43
Albion,2723,9,9,11,16,39,49,-10,38
Stenhousem'r,2723,10,8,9,19,45,75,-30,33
Livingston,2724,1,18,6,12,68,47,21,60
Brechin,2724,2,18,6,12,56,49,7,60
Airdrieon,2724,3,17,8,11,65,57,8,59
Alloa,2724,4,13,12,11,64,48,16,51
Albion,2724,5,14,6,16,59,60,-1,48
Stranraer,2724,6,13,7,16,55,65,-10,46
East Fife,2724,7,12,9,15,54,54,0,45
Peterhead,2724,8,11,11,14,47,48,-1,44
Queen's Park,2724,9,11,11,14,34,48,-14,44
Stenhousem'r,2724,10,11,8,17,43,69,-26,41
Alloa,2725,1,21,7,8,73,37,36,70
Livingston,2725,2,19,5,12,72,48,24,62
Peterhead,2725,3,16,8,12,60,54,6,56
Brechin,2725,4,15,8,13,52,53,-1,53
Stranraer,2725,5,16,2,18,51,64,-13,50
Albion,2725,6,14,7,15,51,53,-2,49
East Fife,2725,7,12,12,12,56,47,9,48
Queen's Park,2725,8,14,6,16,52,60,-8,48
Airdrieon,2725,9,13,6,17,50,62,-12,45
Stenhousem'r,2725,10,5,9,22,45,84,-39,24
Livingston,2726,1,22,6,8,82,49,33,72
Alloa,2726,2,17,11,8,66,43,23,62
Airdrieon,2726,3,18,8,10,60,49,11,62
East Fife,2726,4,17,5,14,52,43,9,56
Albion,2726,5,15,6,15,61,58,3,51
Brechin,2726,6,14,9,13,50,53,-3,51
Queen's Park,2726,7,14,5,17,44,55,-11,47
Stranraer,2726,8,10,8,18,47,58,-11,38
Peterhead,2726,9,9,10,17,36,52,-16,37
Stenhousem'r,2726,10,7,6,23,40,78,-38,27
Alloa,2727,1,22,6,8,81,45,36,72
Airdrieon,2727,2,20,4,12,60,47,13,64
Livingston,2727,3,19,5,12,79,53,26,62
Albion,2727,4,16,9,11,53,52,1,57
Brechin,2727,5,16,8,12,63,58,5,56
Stranraer,2727,6,17,5,14,54,52,2,56
Peterhead,2727,7,15,6,15,51,57,-6,51
Stenhousem'r,2727,8,7,9,20,47,75,-28,30
East Fife,2727,9,6,11,19,39,51,-12,29
Queen's Park,2727,10,7,7,22,37,74,-37,28
Alloa,2728,1,23,4,9,85,44,41,73
Livingston,2728,2,20,6,10,73,52,21,66
Airdrieon,2728,3,15,9,12,59,60,-1,54
Stranraer,2728,4,14,9,13,53,57,-4,51
Queen's Park,2728,5,14,7,15,43,53,-10,49
Brechin,2728,6,14,6,16,57,60,-3,48
Albion,2728,7,12,8,16,41,47,-6,44
East Fife,2728,8,11,9,16,54,50,4,42
Peterhead,2728,9,12,6,18,49,61,-12,42
Stenhousem'r,2728,10,9,8,19,49,79,-30,35
Airdrieon,2729,1,21,4,11,66,56,10,67
Alloa,2729,2,20,5,11,69,40,29,65
Brechin,2729,3,19,3,14,50,45,5,60
Livingston,2729,4,18,4,14,77,52,25,58
Queen's Park,2729,5,15,6,15,42,56,-14,51
Peterhead,2729,6,13,8,15,47,50,-3,47
East Fife,2729,7,13,7,16,49,47,2,46
Stranraer,2729,8,13,5,18,52,63,-11,44
Albion,2729,9,12,7,17,51,52,-1,43
Stenhousem'r,2729,10,7,9,20,41,83,-42,30
Livingston,2730,1,19,6,11,71,52,19,63
Albion,2730,2,16,8,12,57,44,13,56
Peterhead,2730,3,16,8,12,57,53,4,56
Alloa,2730,4,16,7,13,64,48,16,55
Brechin,2730,5,16,7,13,51,44,7,55
Airdrieon,2730,6,14,12,10,53,49,4,54
Stenhousem'r,2730,7,12,7,17,44,65,-21,43
Queen's Park,2730,8,11,9,16,28,52,-24,42
East Fife,2730,9,10,10,16,53,58,-5,40
Stranraer,2730,10,9,8,19,56,69,-13,35
Livingston,2731,1,24,4,8,76,49,27,76
Alloa,2731,2,19,8,9,66,43,23,65
Airdrieon,2731,3,17,9,10,59,59,0,60
Peterhead,2731,4,14,12,10,54,43,11,54
Brechin,2731,5,14,8,14,50,50,0,50
Queen's Park,2731,6,14,7,15,48,51,-3,49
Albion,2731,7,11,12,13,51,57,-6,45
East Fife,2731,8,10,7,19,47,58,-11,37
Stranraer,2731,9,10,4,22,56,68,-12,34
Stenhousem'r,2731,10,8,7,21,45,74,-29,31
Livingston,2732,1,19,5,12,76,55,21,62
Brechin,2732,2,18,7,11,66,50,16,61
Albion,2732,3,17,9,10,68,58,10,60
Peterhead,2732,4,17,7,12,53,43,10,58
Alloa,2732,5,15,11,10,67,49,18,56
Airdrieon,2732,6,13,8,15,57,61,-4,47
Queen's Park,2732,7,13,6,17,46,62,-16,45
Stranraer,2732,8,12,5,19,61,76,-15,41
East Fife,2732,9,9,10,17,48,56,-8,37
Stenhousem'r,2732,10,9,8,19,47,79,-32,35
Livingston,2733,1,21,4,11,74,50,24,67
Peterhead,2733,2,18,5,13,56,48,8,59
Airdrieon,2733,3,17,7,12,55,54,1,58
Brechin,2733,4,18,1,17,48,54,-6,55
Alloa,2733,5,15,6,15,68,57,11,51
East Fife,2733,6,15,6,15,52,51,1,51
Albion,2733,7,14,7,15,52,47,5,49
Queen's Park,2733,8,14,6,16,42,48,-6,48
Stranraer,2733,9,11,6,19,51,65,-14,39
Stenhousem'r,2733,10,10,6,20,57,81,-24,36
Livingston,2734,1,21,2,13,82,50,32,65
Stranraer,2734,2,17,6,13,62,53,9,57
Albion,2734,3,17,5,14,60,49,11,56
East Fife,2734,4,15,10,11,55,45,10,55
Alloa,2734,5,16,6,14,66,52,14,54
Airdrieon,2734,6,16,5,15,57,65,-8,53
Brechin,2734,7,13,9,14,46,50,-4,48
Peterhead,2734,8,14,6,16,52,63,-11,48
Queen's Park,2734,9,11,10,15,43,57,-14,43
Stenhousem'r,2734,10,8,5,23,45,84,-39,29
Livingston,2735,1,22,2,12,85,53,32,68
Alloa,2735,2,19,10,7,69,46,23,67
Brechin,2735,3,20,5,11,48,42,6,65
Airdrieon,2735,4,17,5,14,63,57,6,56
Queen's Park,2735,5,14,8,14,44,48,-4,50
Albion,2735,6,13,9,14,58,54,4,48
Peterhead,2735,7,11,10,15,50,59,-9,43
Stranraer,2735,8,11,6,19,53,75,-22,39
East Fife,2735,9,7,12,17,40,52,-12,33
Stenhousem'r,2735,10,8,9,19,48,72,-24,33
Livingston,2736,1,21,3,12,79,50,29,66
Brechin,2736,2,18,9,9,55,42,13,63
Alloa,2736,3,15,12,9,69,51,18,57
Airdrieon,2736,4,16,8,12,51,50,1,56
Peterhead,2736,5,14,12,10,47,46,1,54
Albion,2736,6,13,11,12,53,50,3,50
Stranraer,2736,7,15,4,17,57,65,-8,49
Queen's Park,2736,8,9,11,16,33,53,-20,38
East Fife,2736,9,9,9,18,45,48,-3,36
Stenhousem'r,2736,10,6,9,21,44,78,-34,27
Alloa,2737,1,18,11,7,66,41,25,65
Livingston,2737,2,20,4,12,73,49,24,64
Airdrieon,2737,3,18,4,14,59,56,3,58
East Fife,2737,4,16,9,11,57,38,19,57
Albion,2737,5,15,10,11,56,52,4,55
Brechin,2737,6,15,6,15,52,59,-7,51
Peterhead,2737,7,12,10,14,49,55,-6,46
Queen's Park,2737,8,12,7,17,41,51,-10,43
Stranraer,2737,9,11,5,20,48,60,-12,38
Stenhousem'r,2737,10,7,6,23,46,86,-40,27
Alloa,2738,1,21,7,8,76,43,33,70
Livingston,2738,2,20,4,12,65,41,24,64
Albion,2738,3,17,5,14,50,44,6,56
Brechin,2738,4,16,8,12,53,50,3,56
Airdrieon,2738,5,16,5,15,57,61,-4,53
Queen's Park,2738,6,13,6,17,36,47,-11,45
Peterhead,2738,7,12,8,16,45,50,-5,44
Stranraer,2738,8,12,7,17,43,54,-11,43
East Fife,2738,9,11,8,17,45,49,-4,41
Stenhousem'r,2738,10,9,8,19,45,76,-31,35
Alloa,2739,1,21,6,9,69,41,28,69
Livingston,2739,2,20,3,13,69,49,20,63
Airdrieon,2739,3,17,6,13,63,52,11,57
Brechin,2739,4,17,6,13,52,48,4,57
Queen's Park,2739,5,15,5,16,44,49,-5,50
Stranraer,2739,6,14,6,16,48,58,-10,48
Albion,2739,7,13,8,15,46,49,-3,47
Peterhead,2739,8,11,10,15,47,59,-12,43
East Fife,2739,9,9,11,16,45,54,-9,38
Stenhousem'r,2739,10,10,5,21,49,73,-24,35
Alloa,2740,1,22,5,9,77,46,31,71
Brechin,2740,2,18,6,12,61,43,18,60
Livingston,2740,3,18,3,15,63,50,13,57
Peterhead,2740,4,16,7,13,56,58,-2,55
Airdrieon,2740,5,16,5,15,58,62,-4,53
Albion,2740,6,14,10,12,58,51,7,52
Queen's Park,2740,7,14,7,15,56,55,1,49
Stranraer,2740,8,14,3,19,49,62,-13,45
East Fife,2740,9,11,7,18,51,60,-9,40
Stenhousem'r,2740,10,8,5,23,41,83,-42,29
Livingston,2741,1,25,5,6,82,41,41,80
Airdrieon,2741,2,19,7,10,59,51,8,64
Alloa,2741,3,17,8,11,62,42,20,59
Peterhead,2741,4,17,5,14,54,52,2,56
Albion,2741,5,12,11,13,54,55,-1,47
Brechin,2741,6,12,8,16,41,47,-6,44
Queen's Park,2741,7,12,7,17,35,57,-22,43
Stranraer,2741,8,11,9,16,57,58,-1,42
East Fife,2741,9,9,11,16,42,48,-6,38
Stenhousem'r,2741,10,6,9,21,43,78,-35,27
Livingston,2742,1,22,4,10,84,50,34,70
Alloa,2742,2,16,11,9,71,49,22,59
Albion,2742,3,15,8,13,56,54,2,53
Brechin,2742,4,15,6,15,45,49,-4,51
Airdrieon,2742,5,14,8,14,54,50,4,50
Peterhead,2742,6,13,11,12,55,60,-5,50
Queen's Park,2742,7,14,6,16,39,53,-14,48
Stranraer,2742,8,12,7,17,51,60,-9,43
East Fife,2742,9,10,8,18,49,55,-6,38
Stenhousem'r,2742,10,9,11,16,47,71,-24,38
Livingston,2743,1,20,4,12,75,47,28,64
Airdrieon,2743,2,17,11,8,58,47,11,62
Brechin,2743,3,18,7,11,53,38,15,61
Alloa,2743,4,18,6,12,72,54,18,60
East Fife,2743,5,15,7,14,55,46,9,52
Peterhead,2743,6,16,4,16,58,60,-2,52
Albion,2743,7,14,8,14,56,53,3,50
Queen's Park,2743,8,11,10,15,32,47,-15,43
Stranraer,2743,9,12,6,18,47,65,-18,42
Stenhousem'r,2743,10,4,7,25,44,93,-49,19
Livingston,2744,1,21,2,13,81,57,24,65
Alloa,2744,2,18,10,8,67,42,25,64
Albion,2744,3,17,8,11,59,51,8,59
Airdrieon,2744,4,18,3,15,67,63,4,57
Brechin,2744,5,17,6,13,46,52,-6,57
Peterhead,2744,6,14,7,15,50,54,-4,49
Queen's Park,2744,7,14,4,18,44,48,-4,46
Stranraer,2744,8,13,5,18,60,71,-11,44
East Fife,2744,9,9,8,19,50,55,-5,35
Stenhousem'r,2744,10,10,5,21,50,81,-31,35
Alloa,2745,1,21,7,8,66,37,29,70
Airdrieon,2745,2,20,6,10,66,55,11,66
Livingston,2745,3,19,6,11,72,50,22,63
Brechin,2745,4,19,6,11,53,41,12,63
Peterhead,2745,5,16,7,13,55,48,7,55
Albion,2745,6,10,13,13,46,48,-2,43
Queen's Park,2745,7,11,9,16,39,50,-11,42
East Fife,2745,8,11,7,18,50,53,-3,40
Stranraer,2745,9,9,8,19,44,63,-19,35
Stenhousem'r,2745,10,7,5,24,45,91,-46,26
Livingston,2746,1,21,3,12,66,41,25,66
Airdrieon,2746,2,20,4,12,67,51,16,64
Alloa,2746,3,19,6,11,75,54,21,63
Brechin,2746,4,17,6,13,55,56,-1,57
Peterhead,2746,5,15,7,14,54,58,-4,52
Queen's Park,2746,6,14,7,15,51,50,1,49
Albion,2746,7,13,9,14,47,50,-3,48
Stranraer,2746,8,11,7,18,51,63,-12,40
East Fife,2746,9,9,12,15,43,47,-4,39
Stenhousem'r,2746,10,7,7,22,44,83,-39,28
Alloa,2747,1,21,8,7,76,39,37,71
Brechin,2747,2,20,6,10,52,35,17,66
Albion,2747,3,19,8,9,69,50,19,65
Livingston,2747,4,17,11,8,65,42,23,62
Airdrieon,2747,5,15,7,14,48,50,-2,52
Stranraer,2747,6,14,7,15,52,56,-4,49
Queen's Park,2747,7,9,10,17,39,55,-16,37
Peterhead,2747,8,9,10,17,38,55,-17,37
East Fife,2747,9,8,7,21,37,53,-16,31
Stenhousem'r,2747,10,9,4,23,45,86,-41,31
Livingston,2748,1,19,7,10,72,44,28,64
Alloa,2748,2,19,7,10,66,38,28,64
Airdrieon,2748,3,17,9,10,62,53,9,60
Brechin,2748,4,18,5,13,58,45,13,59
Albion,2748,5,15,6,15,54,57,-3,51
Stranraer,2748,6,14,5,17,54,63,-9,47
East Fife,2748,7,11,11,14,54,57,-3,44
Peterhead,2748,8,11,11,14,51,58,-7,44
Queen's Park,2748,9,12,7,17,30,52,-22,43
Stenhousem'r,2748,10,7,6,23,46,80,-34,27
Livingston,2749,1,19,6,11,73,52,21,63
Airdrieon,2749,2,19,6,11,58,47,11,63
Albion,2749,3,19,5,12,68,49,19,62
Alloa,2749,4,16,11,9,64,46,18,59
East Fife,2749,5,13,10,13,52,43,9,49
Peterhead,2749,6,14,7,15,42,52,-10,49
Stranraer,2749,7,14,4,18,47,54,-7,46
Brechin,2749,8,12,6,18,47,58,-11,42
Queen's Park,2749,9,11,8,17,39,54,-15,41
Stenhousem'r,2749,10,7,9,20,44,79,-35,30
Livingston,2750,1,23,6,7,78,43,35,75
Brechin,2750,2,20,6,10,56,42,14,66
Airdrieon,2750,3,16,8,12,60,56,4,56
Alloa,2750,4,15,8,13,69,54,15,53
Queen's Park,2750,5,15,7,14,40,45,-5,52
Peterhead,2750,6,14,9,13,54,46,8,51
Albion,2750,7,12,9,15,52,53,-1,45
Stranraer,2750,8,11,5,20,45,64,-19,38
East Fife,2750,9,8,9,19,40,58,-18,33
Stenhousem'r,2750,10,8,9,19,48,81,-33,33
Alloa,2751,1,21,9,6,75,41,34,72
Livingston,2751,2,22,2,12,77,49,28,68
Airdrieon,2751,3,18,6,12,67,58,9,60
Brechin,2751,4,16,8,12,44,43,1,56
Albion,2751,5,14,8,14,52,49,3,50
Peterhead,2751,6,13,6,17,47,57,-10,45
East Fife,2751,7,10,12,14,44,48,-4,42
Stranraer,2751,8,12,6,18,51,65,-14,42
Queen's Park,2751,9,10,10,16,32,47,-15,40
Stenhousem'r,2751,10,5,11,20,46,78,-32,26
Alloa,2752,1,18,11,7,72,42,30,65
Brechin,2752,2,18,7,11,54,45,9,61
Peterhead,2752,3,18,7,11,49,44,5,61
Livingston,2752,4,18,6,12,78,56,22,60
Airdrieon,2752,5,16,7,13,56,54,2,55
East Fife,2752,6,13,9,14,51,48,3,48
Queen's Park,2752,7,13,6,17,40,52,-12,45
Stranraer,2752,8,11,7,18,48,64,-16,40
Albion,2752,9,10,8,18,55,62,-7,38
Stenhousem'r,2752,10,7,8,21,45,81,-36,29
Livingston,2753,1,24,4,8,91,48,43,76
Alloa,2753,2,21,8,7,73,41,32,71
Brechin,2753,3,19,4,13,51,51,0,61
Airdrieon,2753,4,15,8,13,53,53,0,53
Peterhead,2753,5,14,8,14,50,51,-1,50
Albion,2753,6,12,7,17,47,53,-6,43
East Fife,2753,7,11,9,16,46,48,-2,42
Stranraer,2753,8,10,7,19,41,58,-17,37
Queen's Park,2753,9,9,9,18,41,61,-20,36
Stenhousem'r,2753,10,10,6,20,50,79,-29,36
Livingston,2754,1,21,4,11,76,49,27,67
Alloa,2754,2,17,10,9,69,40,29,61
Airdrieon,2754,3,18,5,13,59,61,-2,59
Stranraer,2754,4,17,4,15,55,51,4,55
Brechin,2754,5,15,8,13,49,49,0,53
Peterhead,2754,6,14,8,14,42,42,0,50
Albion,2754,7,13,10,13,55,50,5,49
Queen's Park,2754,8,14,7,15,40,50,-10,49
East Fife,2754,9,8,8,20,36,50,-14,32
Stenhousem'r,2754,10,6,10,20,37,76,-39,28
Livingston,2755,1,20,10,6,72,42,30,70
Alloa,2755,2,19,10,7,68,38,30,67
Brechin,2755,3,18,6,12,54,41,13,60
Queen's Park,2755,4,17,7,12,48,46,2,58
Albion,2755,5,13,8,15,53,68,-15,47
Peterhead,2755,6,12,8,16,43,55,-12,44
Airdrieon,2755,7,12,6,18,51,64,-13,42
Stranraer,2755,8,12,5,19,47,53,-6,41
East Fife,2755,9,10,10,16,50,53,-3,40
Stenhousem'r,2755,10,8,8,20,48,74,-26,32
Livingston,2756,1,21,5,10,77,50,27,68
Brechin,2756,2,19,9,8,56,45,11,66
Alloa,2756,3,18,7,11,78,55,23,61
Airdrieon,2756,4,15,8,13,57,57,0,53
Albion,2756,5,12,10,14,55,51,4,46
Peterhead,2756,6,12,7,17,51,59,-8,43
East Fife,2756,7,9,14,13,52,52,0,41
Queen's Park,2756,8,10,10,16,37,58,-21,40
Stenhousem'r,2756,9,10,10,16,45,69,-24,40
Stranraer,2756,10,11,6,19,40,52,-12,39
Alloa,2757,1,19,7,10,72,51,21,64
Livingston,2757,2,18,5,13,82,55,27,59
Peterhead,2757,3,16,7,13,56,53,3,55
Brechin,2757,4,17,3,16,51,46,5,54
Airdrieon,2757,5,16,4,16,55,63,-8,52
Queen's Park,2757,6,14,7,15,40,53,-13,49
Albion,2757,7,13,9,14,49,49,0,48
Stranraer,2757,8,14,6,16,50,55,-5,48
Stenhousem'r,2757,9,10,9,17,50,71,-21,39
East Fife,2757,10,9,11,16,43,52,-9,38
Alloa,2758,1,21,6,9,79,50,29,69
Livingston,2758,2,20,8,8,76,44,32,68
Airdrieon,2758,3,19,10,7,62,49,13,67
Albion,2758,4,12,12,12,61,58,3,48
East Fife,2758,5,11,14,11,46,41,5,47
Queen's Park,2758,6,14,5,17,36,48,-12,47
Brechin,2758,7,13,5,18,46,57,-11,44
Stranraer,2758,8,13,4,19,56,68,-12,43
Peterhead,2758,9,9,13,14,42,51,-9,40
Stenhousem'r,2758,10,5,9,22,40,78,-38,24
Livingston,2759,1,19,5,12,77,52,25,62
Alloa,2759,2,17,9,10,69,43,26,60
Albion,2759,3,16,10,10,59,48,11,58
Airdrieon,2759,4,16,9,11,62,53,9,57
Brechin,2759,5,13,10,13,41,50,-9,49
East Fife,2759,6,13,9,14,41,40,1,48
Queen's Park,2759,7,13,9,14,40,50,-10,48
Peterhead,2759,8,11,10,15,49,56,-7,43
Stranraer,2759,9,11,6,19,47,64,-17,39
Stenhousem'r,2759,10,9,7,20,53,82,-29,34
Alloa,2760,1,20,8,8,81,48,33,68
Brechin,2760,2,19,8,9,55,42,13,65
Livingston,2760,3,19,6,11,73,47,26,63
Airdrieon,2760,4,15,10,11,56,50,6,55
Albion,2760,5,16,7,13,52,52,0,55
Peterhead,2760,6,12,13,11,46,45,1,49
Queen's Park,2760,7,12,9,15,32,47,-15,45
Stranraer,2760,8,11,7,18,49,56,-7,40
East Fife,2760,9,10,9,17,42,52,-10,39
Stenhousem'r,2760,10,3,9,24,39,86,-47,18
Livingston,2761,1,19,7,10,75,52,23,64
Airdrieon,2761,2,18,6,12,61,46,15,60
Alloa,2761,3,17,8,11,63,42,21,59
Albion,2761,4,15,8,13,56,49,7,53
East Fife,2761,5,14,9,13,52,44,8,51
Peterhead,2761,6,12,10,14,44,59,-15,46
Stranraer,2761,7,13,6,17,49,60,-11,45
Brechin,2761,8,11,11,14,49,59,-10,44
Stenhousem'r,2761,9,11,6,19,60,79,-19,39
Queen's Park,2761,10,9,11,16,33,52,-19,38
Livingston,2762,1,23,3,10,79,47,32,72
Alloa,2762,2,21,6,9,80,43,37,69
Airdrieon,2762,3,17,7,12,65,58,7,58
Brechin,2762,4,17,5,14,42,48,-6,56
Queen's Park,2762,5,15,7,14,45,51,-6,52
Albion,2762,6,13,8,15,51,60,-9,47
Peterhead,2762,7,13,7,16,54,60,-6,46
Stenhousem'r,2762,8,9,9,18,46,68,-22,36
East Fife,2762,9,9,8,19,49,58,-9,35
Stranraer,2762,10,9,8,19,40,58,-18,35
Alloa,2763,1,22,7,7,73,44,29,73
Livingston,2763,2,21,6,9,79,47,32,69
Airdrieon,2763,3,20,5,11,65,54,11,65
Albion,2763,4,15,4,17,62,55,7,49
Brechin,2763,5,15,4,17,45,52,-7,49
Peterhead,2763,6,12,11,13,47,51,-4,47
Queen's Park,2763,7,12,8,16,43,52,-9,44
Stranraer,2763,8,12,6,18,57,64,-7,42
Stenhousem'r,2763,9,10,7,19,47,72,-25,37
East Fife,2763,10,9,6,21,37,64,-27,33
Livingston,2764,1,23,2,11,86,50,36,71
Alloa,2764,2,20,8,8,88,53,35,68
Airdrieon,2764,3,19,9,8,68,45,23,66
Peterhead,2764,4,15,7,14,47,50,-3,52
Brechin,2764,5,13,7,16,44,47,-3,46
Albion,2764,6,13,7,16,51,58,-7,46
Queen's Park,2764,7,10,11,15,32,48,-16,41
East Fife,2764,8,11,7,18,45,51,-6,40
Stranraer,2764,9,9,9,18,42,62,-20,36
Stenhousem'r,2764,10,9,9,18,43,82,-39,36
Livingston,2765,1,22,6,8,77,46,31,72
Brechin,2765,2,22,4,10,62,45,17,70
Alloa,2765,3,17,7,12,76,55,21,58
Albion,2765,4,15,5,16,60,63,-3,50
Stranraer,2765,5,16,2,18,60,64,-4,50
Peterhead,2765,6,14,7,15,49,54,-5,49
Queen's Park,2765,7,12,9,15,37,42,-5,45
Airdrieon,2765,8,12,9,15,56,64,-8,45
Stenhousem'r,2765,9,8,10,18,47,76,-29,34
East Fife,2765,10,7,11,18,41,56,-15,32
Alloa,2766,1,21,8,7,87,47,40,71
Airdrieon,2766,2,17,7,12,63,60,3,58
Livingston,2766,3,17,5,14,69,52,17,56
East Fife,2766,4,15,9,12,55,42,13,54
Albion,2766,5,15,9,12,63,51,12,54
Brechin,2766,6,16,4,16,49,50,-1,52
Peterhead,2766,7,12,10,14,52,58,-6,46
Stranraer,2766,8,13,6,17,51,65,-14,45
Queen's Park,2766,9,12,9,15,42,60,-18,45
Stenhousem'r,2766,10,5,7,24,47,93,-46,22
Livingston,2767,1,20,6,10,74,44,30,66
Brechin,2767,2,18,4,14,54,53,1,58
Peterhead,2767,3,17,7,12,51,52,-1,58
Airdrieon,2767,4,15,8,13,58,59,-1,53
Stranraer,2767,5,15,3,18,55,62,-7,48
Alloa,2767,6,13,7,16,63,57,6,46
Albion,2767,7,12,10,14,58,64,-6,46
East Fife,2767,8,12,9,15,51,46,5,45
Stenhousem'r,2767,9,11,12,13,58,64,-6,45
Queen's Park,2767,10,10,8,18,35,56,-21,38
Alloa,2768,1,20,7,9,74,48,26,67
Airdrieon,2768,2,20,7,9,67,50,17,67
Brechin,2768,3,15,12,9,56,48,8,57
Livingston,2768,4,16,8,12,72,56,16,56
Albion,2768,5,16,5,15,64,59,5,53
Peterhead,2768,6,13,7,16,45,58,-13,46
Stranraer,2768,7,12,6,18,56,67,-11,42
Queen's Park,2768,8,10,10,16,37,51,-14,40
Stenhousem'r,2768,9,8,12,16,52,71,-19,36
East Fife,2768,10,7,12,17,42,57,-15,33
Livingston,2769,1,24,4,8,70,34,36,76
Alloa,2769,2,22,6,8,77,38,39,72
Airdrieon,2769,3,18,8,10,60,48,12,62
Albion,2769,4,16,6,14,57,54,3,54
Peterhead,2769,5,13,10,13,51,55,-4,49
Brechin,2769,6,13,7,16,45,53,-8,46
Stranraer,2769,7,12,5,19,44,55,-11,41
East Fife,2769,8,10,10,16,47,48,-1,40
Queen's Park,2769,9,11,7,18,38,49,-11,40
Stenhousem'r,2769,10,5,9,22,40,95,-55,24
Livingston,2770,1,22,4,10,78,49,29,70
Alloa,2770,2,20,9,7,75,46,29,69
Brechin,2770,3,16,8,12,56,50,6,56
Airdrieon,2770,4,13,12,11,57,57,0,51
East Fife,2770,5,13,11,12,55,50,5,50
Peterhead,2770,6,14,8,14,55,53,2,50
Albion,2770,7,11,12,13,46,52,-6,45
Queen's Park,2770,8,9,11,16,33,49,-16,38
Stranraer,2770,9,10,7,19,54,69,-15,37
Stenhousem'r,2770,10,8,6,22,53,87,-34,30
Livingston,2771,1,20,9,7,83,50,33,69
Brechin,2771,2,19,7,10,58,44,14,64
Alloa,2771,3,17,11,8,75,49,26,62
Peterhead,2771,4,18,5,13,63,58,5,59
Airdrieon,2771,5,17,7,12,63,56,7,58
Albion,2771,6,13,7,16,51,56,-5,46
Queen's Park,2771,7,12,5,19,44,65,-21,41
East Fife,2771,8,9,12,15,50,58,-8,39
Stranraer,2771,9,10,6,20,46,56,-10,36
Stenhousem'r,2771,10,4,13,19,44,85,-41,25
Livingston,2772,1,21,3,12,79,57,22,66
Alloa,2772,2,19,7,10,69,47,22,64
Albion,2772,3,16,11,9,57,49,8,59
Airdrieon,2772,4,15,10,11,63,53,10,55
Brechin,2772,5,16,4,16,47,49,-2,52
Peterhead,2772,6,13,8,15,56,57,-1,47
East Fife,2772,7,11,12,13,47,43,4,45
Stranraer,2772,8,12,9,15,51,54,-3,45
Queen's Park,2772,9,10,8,18,32,57,-25,38
Stenhousem'r,2772,10,7,8,21,52,87,-35,29
Alloa,2773,1,21,7,8,74,45,29,70
Brechin,2773,2,21,5,10,60,49,11,68
Livingston,2773,3,19,5,12,70,52,18,62
Airdrieon,2773,4,17,7,12,62,50,12,58
Albion,2773,5,14,7,15,52,54,-2,49
Queen's Park,2773,6,13,8,15,36,45,-9,47
Stranraer,2773,7,12,7,17,45,56,-11,43
Peterhead,2773,8,11,8,17,47,54,-7,41
East Fife,2773,9,8,14,14,41,44,-3,38
Stenhousem'r,2773,10,5,10,21,42,80,-38,25
Alloa,2774,1,20,8,8,64,40,24,68
Livingston,2774,2,20,6,10,73,44,29,66
Airdrieon,2774,3,15,12,9,68,49,19,57
Peterhead,2774,4,16,6,14,60,57,3,54
Albion,2774,5,15,6,15,48,54,-6,51
Brechin,2774,6,14,3,19,46,56,-10,45
East Fife,2774,7,11,11,14,41,49,-8,44
Queen's Park,2774,8,12,7,17,35,48,-13,43
Stranraer,2774,9,12,6,18,45,56,-11,42
Stenhousem'r,2774,10,9,7,20,43,70,-27,34
Albion,2775,1,22,4,10,68,42,26,70
Livingston,2775,2,22,3,11,77,42,35,69
Alloa,2775,3,17,8,11,61,52,9,59
Airdrieon,2775,4,18,4,14,67,54,13,58
Brechin,2775,5,17,3,16,55,61,-6,54
Queen's Park,2775,6,14,5,17,42,51,-9,47
East Fife,2775,7,12,7,17,48,47,1,43
Peterhead,2775,8,12,7,17,46,57,-11,43
Stranraer,2775,9,13,3,20,54,74,-20,42
Stenhousem'r,2775,10,8,6,22,40,78,-38,30
Airdrieon,2776,1,19,7,10,65,52,13,64
Livingston,2776,2,20,3,13,69,52,17,63
Albion,2776,3,19,6,11,64,51,13,63
Queen's Park,2776,4,18,7,11,45,41,4,61
Alloa,2776,5,16,6,14,69,58,11,54
Brechin,2776,6,15,6,15,54,51,3,51
Peterhead,2776,7,14,5,17,47,56,-9,47
Stranraer,2776,8,10,8,18,51,60,-9,38
Stenhousem'r,2776,9,10,8,18,49,74,-25,38
East Fife,2776,10,7,8,21,49,67,-18,29
Livingston,2777,1,20,5,11,76,46,30,65
Alloa,2777,2,19,8,9,68,45,23,65
Brechin,2777,3,18,7,11,57,45,12,61
Airdrieon,2777,4,17,6,13,58,55,3,57
Queen's Park,2777,5,14,6,16,40,50,-10,48
Stranraer,2777,6,15,2,19,60,56,4,47
Peterhead,2777,7,12,9,15,48,55,-7,45
Albion,2777,8,12,7,17,42,61,-19,43
East Fife,2777,9,9,14,13,47,45,2,41
Stenhousem'r,2777,10,10,4,22,56,94,-38,34
Alloa,2778,1,21,9,6,79,43,36,72
Livingston,2778,2,19,7,10,66,45,21,64
Brechin,2778,3,16,10,10,55,40,15,58
East Fife,2778,4,14,11,11,55,41,14,53
Airdrieon,2778,5,14,10,12,50,48,2,52
Albion,2778,6,12,8,16,50,61,-11,44
Stranraer,2778,7,12,7,17,51,61,-10,43
Queen's Park,2778,8,11,9,16,43,57,-14,42
Peterhead,2778,9,10,8,18,42,63,-21,38
Stenhousem'r,2778,10,6,11,19,43,75,-32,29
Alloa,2779,1,21,7,8,80,44,36,70
Livingston,2779,2,19,4,13,71,57,14,61
Brechin,2779,3,17,7,12,53,52,1,58
East Fife,2779,4,15,9,12,57,41,16,54
Airdrieon,2779,5,15,5,16,52,59,-7,50
Peterhead,2779,6,13,9,14,48,55,-7,48
Stranraer,2779,7,12,9,15,57,60,-3,45
Queen's Park,2779,8,13,6,17,43,56,-13,45
Albion,2779,9,11,8,17,51,55,-4,41
Stenhousem'r,2779,10,7,10,19,47,80,-33,31
Alloa,2780,1,21,10,5,91,50,41,73
Livingston,2780,2,20,6,10,73,54,19,66
Airdrieon,2780,3,18,9,9,68,50,18,63
Queen's Park,2780,4,13,10,13,50,54,-4,49
Brechin,2780,5,13,8,15,51,58,-7,47
Albion,2780,6,11,11,14,51,49,2,44
Peterhead,2780,7,11,11,14,47,51,-4,44
East Fife,2780,8,9,11,16,48,58,-10,38
Stranraer,2780,9,9,9,18,47,70,-23,36
Stenhousem'r,2780,10,8,9,19,45,77,-32,33
Alloa,2781,1,20,8,8,72,44,28,68
Livingston,2781,2,22,2,12,76,52,24,68
Brechin,2781,3,19,3,14,56,46,10,60
Airdrieon,2781,4,16,6,14,68,60,8,54
Peterhead,2781,5,15,7,14,46,42,4,52
Albion,2781,6,13,10,13,51,49,2,49
Stranraer,2781,7,12,6,18,45,61,-16,42
Queen's Park,2781,8,11,9,16,36,57,-21,42
East Fife,2781,9,11,8,17,50,57,-7,41
Stenhousem'r,2781,10,8,7,21,46,78,-32,31
Livingston,2782,1,21,4,11,75,52,23,67
Alloa,2782,2,16,11,9,61,40,21,59
Brechin,2782,3,18,4,14,51,47,4,58
Airdrieon,2782,4,15,7,14,65,57,8,52
Stranraer,2782,5,16,3,17,50,51,-1,51
Albion,2782,6,15,6,15,51,54,-3,51
Peterhead,2782,7,14,7,15,48,53,-5,49
Queen's Park,2782,8,13,7,16,37,48,-11,46
East Fife,2782,9,12,9,15,56,52,4,45
Stenhousem'r,2782,10,7,8,21,46,86,-40,29
Alloa,2783,1,18,9,9,69,42,27,63
Albion,2783,2,17,9,10,64,48,16,60
Livingston,2783,3,18,2,16,69,57,12,56
Stranraer,2783,4,15,9,12,54,50,4,54
Airdrieon,2783,5,14,11,11,56,57,-1,53
East Fife,2783,6,14,8,14,50,51,-1,50
Brechin,2783,7,14,8,14,48,55,-7,50
Peterhead,2783,8,12,10,14,50,51,-1,46
Queen's Park,2783,9,13,5,18,37,47,-10,44
Stenhousem'r,2783,10,5,9,22,37,76,-39,24
Brechin,2784,1,24,4,8,63,48,15,76
Livingston,2784,2,22,3,11,97,48,49,69
Alloa,2784,3,20,8,8,75,43,32,68
Airdrieon,2784,4,15,6,15,55,64,-9,51
Albion,2784,5,12,13,11,52,51,1,49
Peterhead,2784,6,13,8,15,53,54,-1,47
Queen's Park,2784,7,13,4,19,38,59,-21,43
Stranraer,2784,8,10,7,19,48,61,-13,37
Stenhousem'r,2784,9,8,11,17,49,77,-28,35
East Fife,2784,10,7,8,21,38,63,-25,29
Livingston,2785,1,20,6,10,76,49,27,66
Alloa,2785,2,18,10,8,78,47,31,64
Brechin,2785,3,17,7,12,49,47,2,58
Airdrieon,2785,4,15,7,14,51,52,-1,52
Albion,2785,5,14,8,14,61,55,6,50
East Fife,2785,6,12,10,14,51,52,-1,46
Peterhead,2785,7,12,9,15,49,62,-13,45
Stranraer,2785,8,11,7,18,50,67,-17,40
Queen's Park,2785,9,10,9,17,43,54,-11,39
Stenhousem'r,2785,10,10,9,17,49,72,-23,39
Livingston,2786,1,20,7,9,72,44,28,67
Alloa,2786,2,19,8,9,69,43,26,65
Albion,2786,3,15,11,10,51,46,5,56
Airdrieon,2786,4,16,6,14,51,57,-6,54
Brechin,2786,5,16,5,15,52,46,6,53
Stranraer,2786,6,14,4,18,56,58,-2,46
East Fife,2786,7,12,10,14,52,54,-2,46
Peterhead,2786,8,12,7,17,44,52,-8,43
Queen's Park,2786,9,12,5,19,41,57,-16,41
Stenhousem'r,2786,10,7,11,18,46,77,-31,32
Livingston,2787,1,23,4,9,77,40,37,73
Airdrieon,2787,2,21,7,8,61,39,22,70
Alloa,2787,3,21,5,10,72,51,21,68
Brechin,2787,4,15,9,12,54,53,1,54
Peterhead,2787,5,11,9,16,50,56,-6,42
East Fife,2787,6,8,17,11,51,53,-2,41
Stranraer,2787,7,12,5,19,47,59,-12,41
Stenhousem'r,2787,8,10,9,17,55,77,-22,39
Albion,2787,9,8,11,17,44,57,-13,35
Queen's Park,2787,10,9,8,19,30,56,-26,35
Livingston,2788,1,21,5,10,77,49,28,68
Alloa,2788,2,18,7,11,69,45,24,61
Peterhead,2788,3,17,6,13,64,49,15,57
Airdrieon,2788,4,16,5,15,56,61,-5,53
Albion,2788,5,11,15,10,56,50,6,48
East Fife,2788,6,12,10,14,52,55,-3,46
Stranraer,2788,7,14,4,18,53,58,-5,46
Brechin,2788,8,12,10,14,51,56,-5,46
Queen's Park,2788,9,10,10,16,36,52,-16,40
Stenhousem'r,2788,10,9,8,19,50,89,-39,35
Livingston,2789,1,20,4,12,76,57,19,64
Airdrieon,2789,2,18,8,10,67,53,14,62
Alloa,2789,3,17,7,12,74,52,22,58
Brechin,2789,4,18,1,17,57,57,0,55
Queen's Park,2789,5,16,6,14,44,47,-3,54
Peterhead,2789,6,14,10,12,53,52,1,52
Albion,2789,7,14,8,14,60,61,-1,50
East Fife,2789,8,13,9,14,50,45,5,48
Stranraer,2789,9,11,9,16,45,53,-8,42
Stenhousem'r,2789,10,5,6,25,41,90,-49,21
Livingston,2790,1,24,3,9,77,40,37,75
Airdrieon,2790,2,22,5,9,64,44,20,71
Brechin,2790,3,18,6,12,50,48,2,60
Albion,2790,4,14,11,11,53,49,4,53
Alloa,2790,5,14,8,14,58,49,9,50
Peterhead,2790,6,12,7,17,57,53,4,43
Stranraer,2790,7,11,8,17,50,60,-10,41
Queen's Park,2790,8,11,8,17,28,54,-26,41
East Fife,2790,9,8,13,15,49,55,-6,37
Stenhousem'r,2790,10,8,7,21,48,82,-34,31
Livingston,2791,1,21,6,9,81,47,34,69
Brechin,2791,2,20,7,9,63,50,13,67
Alloa,2791,3,18,8,10,73,47,26,62
East Fife,2791,4,14,8,14,59,54,5,50
Peterhead,2791,5,14,8,14,53,54,-1,50
Airdrieon,2791,6,13,9,14,55,56,-1,48
Albion,2791,7,14,5,17,50,56,-6,47
Queen's Park,2791,8,12,9,15,38,54,-16,45
Stranraer,2791,9,12,5,19,56,72,-16,41
Stenhousem'r,2791,10,4,11,21,45,83,-38,23
Livingston,2792,1,19,9,8,75,56,19,66
Alloa,2792,2,17,7,12,66,49,17,58
East Fife,2792,3,16,10,10,53,42,11,58
Airdrieon,2792,4,17,6,13,59,54,5,57
Peterhead,2792,5,15,7,14,50,51,-1,52
Queen's Park,2792,6,13,7,16,40,52,-12,46
Brechin,2792,7,13,6,17,60,57,3,45
Albion,2792,8,11,10,15,51,60,-9,43
Stranraer,2792,9,12,7,17,49,58,-9,43
Stenhousem'r,2792,10,7,11,18,48,72,-24,32
Livingston,2793,1,23,4,9,81,48,33,73
Alloa,2793,2,20,7,9,72,41,31,67
Airdrieon,2793,3,19,6,11,63,53,10,63
Albion,2793,4,15,9,12,53,45,8,54
Stranraer,2793,5,16,5,15,52,57,-5,53
Brechin,2793,6,14,6,16,49,57,-8,48
Peterhead,2793,7,13,6,17,48,57,-9,45
Queen's Park,2793,8,10,9,17,37,57,-20,39
East Fife,2793,9,10,6,20,50,61,-11,36
Stenhousem'r,2793,10,7,8,21,43,72,-29,29
Alloa,2794,1,19,11,6,77,40,37,68
Livingston,2794,2,19,6,11,81,54,27,63
Albion,2794,3,17,8,11,51,42,9,59
Airdrieon,2794,4,17,8,11,57,49,8,59
Brechin,2794,5,13,8,15,44,54,-10,47
Queen's Park,2794,6,13,7,16,35,51,-16,46
Stranraer,2794,7,11,11,14,47,57,-10,44
East Fife,2794,8,11,10,15,45,49,-4,43
Peterhead,2794,9,12,7,17,51,56,-5,43
Stenhousem'r,2794,10,6,8,22,47,83,-36,26
Alloa,2795,1,18,12,6,72,42,30,66
Livingston,2795,2,18,5,13,63,52,11,59
Brechin,2795,3,17,5,14,51,45,6,56
Albion,2795,4,16,6,14,55,51,4,54
Queen's Park,2795,5,15,8,13,42,44,-2,53
Peterhead,2795,6,13,7,16,50,66,-16,46
East Fife,2795,7,11,12,13,51,46,5,45
Airdrieon,2795,8,13,6,17,60,62,-2,45
Stranraer,2795,9,12,8,16,39,46,-7,44
Stenhousem'r,2795,10,9,7,20,56,85,-29,34
Livingston,2796,1,22,5,9,75,42,33,71
Alloa,2796,2,17,10,9,66,40,26,61
Brechin,2796,3,18,3,15,53,43,10,57
Peterhead,2796,4,17,6,13,54,54,0,57
Queen's Park,2796,5,14,8,14,49,51,-2,50
Airdrieon,2796,6,13,9,14,57,61,-4,48
Albion,2796,7,12,10,14,52,56,-4,46
East Fife,2796,8,9,14,13,47,47,0,41
Stranraer,2796,9,10,7,19,50,69,-19,37
Stenhousem'r,2796,10,8,8,20,47,87,-40,32
Alloa,2797,1,21,8,7,73,42,31,71
Livingston,2797,2,22,4,10,79,49,30,70
Brechin,2797,3,17,7,12,54,43,11,58
Albion,2797,4,16,8,12,54,47,7,56
Queen's Park,2797,5,14,8,14,46,51,-5,50
Airdrieon,2797,6,15,5,16,48,57,-9,50
Peterhead,2797,7,12,10,14,50,63,-13,46
Stranraer,2797,8,12,5,19,53,60,-7,41
East Fife,2797,9,9,10,17,45,52,-7,37
Stenhousem'r,2797,10,6,7,23,44,82,-38,25
Airdrieon,2798,1,20,7,9,68,46,22,67
Brechin,2798,2,19,8,9,56,45,11,65
Livingston,2798,3,17,11,8,76,54,22,62
Alloa,2798,4,15,13,8,68,48,20,58
Queen's Park,2798,5,14,6,16,42,54,-12,48
Albion,2798,6,12,11,13,56,51,5,47
Stranraer,2798,7,11,8,17,50,59,-9,41
East Fife,2798,8,11,7,18,46,51,-5,40
Peterhead,2798,9,9,13,14,48,54,-6,40
Stenhousem'r,2798,10,7,6,23,43,91,-48,27
Livingston,2799,1,18,10,8,71,43,28,64
Alloa,2799,2,16,11,9,74,50,24,59
Airdrieon,2799,3,16,10,10,56,51,5,58
Queen's Park,2799,4,17,6,13,46,48,-2,57
Albion,2799,5,13,13,10,52,49,3,52
Stranraer,2799,6,15,6,15,57,53,4,51
Brechin,2799,7,13,8,15,44,47,-3,47
East Fife,2799,8,11,11,14,52,52,0,44
Peterhead,2799,9,11,10,15,52,65,-13,43
Stenhousem'r,2799,10,4,7,25,40,86,-46,19
Airdrieon,2800,1,20,4,12,58,58,0,64
Livingston,2800,2,18,7,11,74,51,23,61
Alloa,2800,3,17,7,12,68,50,18,58
Queen's Park,2800,4,17,6,13,46,47,-1,57
Brechin,2800,5,17,4,15,57,50,7,55
Peterhead,2800,6,15,5,16,59,61,-2,50
Albion,2800,7,13,8,15,55,58,-3,47
Stenhousem'r,2800,8,12,6,18,47,66,-19,42
East Fife,2800,9,10,8,18,48,55,-7,38
Stranraer,2800,10,11,5,20,43,59,-16,38
Alloa,2801,1,22,4,10,83,49,34,70
Livingston,2801,2,19,7,10,84,59,25,64
Airdrieon,2801,3,18,8,10,59,53,6,62
Brechin,2801,4,17,7,12,58,52,6,58
Stranraer,2801,5,15,4,17,51,53,-2,49
Peterhead,2801,6,14,6,16,58,66,-8,48
East Fife,2801,7,11,9,16,51,56,-5,42
Queen's Park,2801,8,12,5,19,43,55,-12,41
Albion,2801,9,10,8,18,50,66,-16,38
Stenhousem'r,2801,10,10,6,20,52,80,-28,36
Livingston,2802,1,23,4,9,80,41,39,73
Alloa,2802,2,21,6,9,72,46,26,69
Airdrieon,2802,3,19,6,11,61,53,8,63
Peterhead,2802,4,14,6,16,44,52,-8,48
Albion,2802,5,13,8,15,55,53,2,47
Stranraer,2802,6,13,7,16,52,56,-4,46
Brechin,2802,7,11,10,15,45,57,-12,43
Queen's Park,2802,8,11,9,16,34,46,-12,42
East Fife,2802,9,9,11,16,52,58,-6,38
Stenhousem'r,2802,10,8,9,19,46,79,-33,33
Alloa,2803,1,21,6,9,76,47,29,69
Brechin,2803,2,20,4,12,51,43,8,64
Livingston,2803,3,16,8,12,70,48,22,56
Airdrieon,2803,4,15,5,16,55,55,0,50
East Fife,2803,5,12,13,11,52,48,4,49
Stranraer,2803,6,13,7,16,59,61,-2,46
Queen's Park,2803,7,13,7,16,34,46,-12,46
Peterhead,2803,8,11,11,14,48,55,-7,44
Stenhousem'r,2803,9,11,7,18,45,75,-30,40
Albion,2803,10,9,10,17,48,60,-12,37
Livingston,2804,1,21,4,11,72,47,25,67
Alloa,2804,2,18,11,7,78,44,34,65
Brechin,2804,3,17,5,14,54,51,3,56
East Fife,2804,4,14,8,14,54,50,4,50
Airdrieon,2804,5,14,8,14,58,62,-4,50
Stranraer,2804,6,14,6,16,57,55,2,48
Albion,2804,7,13,9,14,50,56,-6,48
Queen's Park,2804,8,11,9,16,35,51,-16,42
Stenhousem'r,2804,9,10,9,17,47,68,-21,39
Peterhead,2804,10,11,5,20,47,68,-21,38
Alloa,2805,1,23,6,7,77,39,38,75
Livingston,2805,2,22,3,11,64,37,27,69
Brechin,2805,3,19,6,11,50,42,8,63
Stranraer,2805,4,14,6,16,58,58,0,48
Peterhead,2805,5,12,10,14,51,59,-8,46
Queen's Park,2805,6,13,7,16,33,49,-16,46
Albion,2805,7,13,6,17,51,52,-1,45
Airdrieon,2805,8,12,5,19,42,57,-15,41
East Fife,2805,9,10,8,18,50,55,-5,38
Stenhousem'r,2805,10,10,7,19,44,72,-28,37
Livingston,2806,1,24,0,12,79,58,21,72
Alloa,2806,2,17,11,8,71,49,22,62
Airdrieon,2806,3,16,6,14,58,49,9,54
Brechin,2806,4,15,9,12,47,40,7,54
Queen's Park,2806,5,15,7,14,40,49,-9,52
Peterhead,2806,6,14,9,13,46,49,-3,51
Albion,2806,7,14,8,14,54,56,-2,50
Stranraer,2806,8,12,9,15,50,54,-4,45
East Fife,2806,9,9,9,18,47,55,-8,36
Stenhousem'r,2806,10,6,8,22,41,74,-33,26
Livingston,2807,1,22,4,10,79,45,34,70
Alloa,2807,2,20,8,8,72,40,32,68
Albion,2807,3,16,6,14,57,56,1,54
Peterhead,2807,4,16,6,14,47,49,-2,54
Airdrieon,2807,5,14,8,14,55,54,1,50
East Fife,2807,6,13,10,13,55,51,4,49
Queen's Park,2807,7,14,6,16,44,53,-9,48
Brechin,2807,8,12,10,14,48,55,-7,46
Stranraer,2807,9,13,4,19,49,62,-13,43
Stenhousem'r,2807,10,6,6,24,45,86,-41,24
Alloa,2808,1,20,8,8,78,43,35,68
Livingston,2808,2,19,5,12,72,57,15,62
Albion,2808,3,18,5,13,61,48,13,59
Airdrieon,2808,4,17,6,13,62,53,9,57
Brechin,2808,5,16,7,13,55,49,6,55
Stranraer,2808,6,15,6,15,50,53,-3,51
Peterhead,2808,7,15,6,15,52,58,-6,51
East Fife,2808,8,11,11,14,53,51,2,44
Queen's Park,2808,9,9,8,19,26,53,-27,35
Stenhousem'r,2808,10,6,6,24,37,81,-44,24
Alloa,2809,1,20,7,9,71,37,34,67
Livingston,2809,2,21,4,11,76,44,32,67
Airdrieon,2809,3,19,8,9,62,51,11,65
Brechin,2809,4,15,9,12,50,43,7,54
Stranraer,2809,5,16,5,15,50,60,-10,53
Peterhead,2809,6,13,8,15,54,57,-3,47
Albion,2809,7,13,7,16,50,64,-14,46
East Fife,2809,8,9,10,17,41,47,-6,37
Queen's Park,2809,9,10,6,20,39,58,-19,36
Stenhousem'r,2809,10,8,8,20,45,77,-32,32
Livingston,2810,1,19,3,14,71,48,23,60
Alloa,2810,2,17,9,10,62,44,18,60
Airdrieon,2810,3,18,4,14,64,60,4,58
Brechin,2810,4,18,4,14,49,48,1,58
Albion,2810,5,17,6,13,53,45,8,57
Peterhead,2810,6,15,8,13,55,55,0,53
Stranraer,2810,7,13,8,15,49,52,-3,47
East Fife,2810,8,13,6,17,50,53,-3,45
Queen's Park,2810,9,11,7,18,36,54,-18,40
Stenhousem'r,2810,10,8,7,21,44,74,-30,31
Livingston,2811,1,19,7,10,72,49,23,64
Alloa,2811,2,17,11,8,65,44,21,62
Airdrieon,2811,3,17,4,15,58,55,3,55
Queen's Park,2811,4,13,12,11,47,49,-2,51
Brechin,2811,5,14,9,13,45,47,-2,51
Albion,2811,6,12,10,14,51,56,-5,46
Peterhead,2811,7,12,9,15,43,50,-7,45
Stranraer,2811,8,11,9,16,52,60,-8,42
East Fife,2811,9,9,14,13,55,52,3,41
Stenhousem'r,2811,10,7,13,16,50,76,-26,34
Livingston,2812,1,26,1,9,84,41,43,79
Alloa,2812,2,21,7,8,77,45,32,70
Airdrieon,2812,3,17,6,13,58,59,-1,57
Brechin,2812,4,15,5,16,53,56,-3,50
Peterhead,2812,5,14,7,15,49,53,-4,49
Stranraer,2812,6,13,8,15,61,64,-3,47
Albion,2812,7,13,7,16,54,62,-8,46
Queen's Park,2812,8,12,6,18,49,66,-17,42
Stenhousem'r,2812,9,9,8,19,46,77,-31,35
East Fife,2812,10,8,9,19,45,53,-8,33
Livingston,2813,1,23,3,10,80,48,32,72
Airdrieon,2813,2,20,9,7,61,41,20,69
Brechin,2813,3,19,4,13,55,44,11,61
Alloa,2813,4,17,7,12,68,47,21,58
East Fife,2813,5,15,8,13,61,49,12,53
Albion,2813,6,12,10,14,47,49,-2,46
Peterhead,2813,7,12,9,15,48,59,-11,45
Queen's Park,2813,8,13,6,17,33,46,-13,45
Stranraer,2813,9,10,4,22,45,68,-23,34
Stenhousem'r,2813,10,7,4,25,40,87,-47,25
Alloa,2814,1,19,9,8,85,53,32,66
Brechin,2814,2,19,6,11,53,43,10,63
Livingston,2814,3,18,3,15,63,56,7,57
Airdrieon,2814,4,16,7,13,57,57,0,55
Albion,2814,5,13,14,9,51,49,2,53
Peterhead,2814,6,14,7,15,49,49,0,49
East Fife,2814,7,11,13,12,52,48,4,46
Queen's Park,2814,8,12,9,15,40,51,-11,45
Stranraer,2814,9,12,7,17,56,58,-2,43
Stenhousem'r,2814,10,3,11,22,44,86,-42,20
Livingston,2815,1,21,7,8,77,46,31,70
Alloa,2815,2,18,6,12,69,49,20,60
Brechin,2815,3,17,9,10,56,47,9,60
Airdrieon,2815,4,17,8,11,59,48,11,59
Peterhead,2815,5,15,8,13,49,52,-3,53
East Fife,2815,6,14,7,15,53,51,2,49
Albion,2815,7,13,8,15,52,55,-3,47
Queen's Park,2815,8,11,10,15,43,55,-12,43
Stenhousem'r,2815,9,9,6,21,42,80,-38,33
Stranraer,2815,10,9,3,24,51,68,-17,30
Albion,2816,1,19,10,7,59,41,18,67
Livingston,2816,2,19,4,13,66,47,19,61
Airdrieon,2816,3,16,10,10,64,54,10,58
Alloa,2816,4,16,9,11,71,50,21,57
Brechin,2816,5,18,1,17,58,60,-2,55
Peterhead,2816,6,15,7,14,51,51,0,52
Queen's Park,2816,7,12,10,14,41,53,-12,46
Stranraer,2816,8,11,10,15,50,61,-11,43
East Fife,2816,9,7,10,19,46,58,-12,31
Stenhousem'r,2816,10,6,11,19,44,75,-31,29
Livingston,2817,1,20,5,11,69,52,17,65
Airdrieon,2817,2,18,5,13,56,52,4,59
Alloa,2817,3,15,11,10,65,44,21,56
Brechin,2817,4,16,8,12,57,51,6,56
Albion,2817,5,14,10,12,61,53,8,52
Stranraer,2817,6,15,6,15,54,55,-1,51
Peterhead,2817,7,14,9,13,53,54,-1,51
Queen's Park,2817,8,14,8,14,46,53,-7,50
East Fife,2817,9,6,12,18,43,56,-13,30
Stenhousem'r,2817,10,7,8,21,45,79,-34,29
Alloa,2818,1,19,10,7,73,42,31,67
Livingston,2818,2,20,7,9,74,44,30,67
Brechin,2818,3,17,6,13,47,44,3,57
Airdrieon,2818,4,16,4,16,56,66,-10,52
East Fife,2818,5,14,8,14,63,53,10,50
Albion,2818,6,14,7,15,55,54,1,49
Queen's Park,2818,7,12,9,15,36,52,-16,45
Peterhead,2818,8,11,9,16,50,61,-11,42
Stranraer,2818,9,11,8,17,55,62,-7,41
Stenhousem'r,2818,10,7,10,19,50,81,-31,31
Alloa,2819,1,19,11,6,72,44,28,68
Brechin,2819,2,19,6,11,57,45,12,63
Airdrieon,2819,3,19,5,12,62,53,9,62
Livingston,2819,4,17,4,15,65,58,7,55
Albion,2819,5,14,7,15,50,56,-6,49
Stranraer,2819,6,14,6,16,47,50,-3,48
Queen's Park,2819,7,13,7,16,34,48,-14,46
East Fife,2819,8,12,8,16,54,45,9,44
Peterhead,2819,9,8,12,16,43,63,-20,36
Stenhousem'r,2819,10,8,8,20,53,75,-22,32
Livingston,2820,1,21,6,9,86,53,33,69
Alloa,2820,2,19,7,10,67,45,22,64
Airdrieon,2820,3,16,7,13,57,52,5,55
Brechin,2820,4,16,6,14,52,52,0,54
Albion,2820,5,14,9,13,52,51,1,51
Peterhead,2820,6,13,9,14,45,49,-4,48
Stranraer,2820,7,12,6,18,44,57,-13,42
Stenhousem'r,2820,8,11,9,16,51,74,-23,42
East Fife,2820,9,10,10,16,45,47,-2,40
Queen's Park,2820,10,9,9,18,32,51,-19,36
Livingston,2821,1,20,3,13,75,55,20,63
Alloa,2821,2,17,10,9,70,45,25,61
Airdrieon,2821,3,18,7,11,63,46,17,61
Brechin,2821,4,16,4,16,48,50,-2,52
Queen's Park,2821,5,14,9,13,40,43,-3,51
Peterhead,2821,6,12,13,11,43,47,-4,49
Stranraer,2821,7,15,4,17,49,57,-8,49
East Fife,2821,8,12,7,17,53,54,-1,43
Albion,2821,9,11,9,16,51,61,-10,42
Stenhousem'r,2821,10,7,10,19,40,74,-34,31
Livingston,2822,1,17,11,8,72,43,29,62
Airdrieon,2822,2,18,5,13,58,50,8,59
Brechin,2822,3,16,10,10,59,47,12,58
Peterhead,2822,4,18,4,14,52,54,-2,58
Alloa,2822,5,16,8,12,63,56,7,56
Albion,2822,6,15,7,14,62,46,16,52
East Fife,2822,7,14,6,16,62,56,6,48
Stranraer,2822,8,12,5,19,46,65,-19,41
Queen's Park,2822,9,11,7,18,36,58,-22,40
Stenhousem'r,2822,10,8,7,21,50,85,-35,31
Livingston,2823,1,21,6,9,79,47,32,69
Alloa,2823,2,16,12,8,66,45,21,60
Brechin,2823,3,16,9,11,49,44,5,57
Airdrieon,2823,4,15,10,11,55,47,8,55
Peterhead,2823,5,12,12,12,45,49,-4,48
Queen's Park,2823,6,13,9,14,38,47,-9,48
East Fife,2823,7,12,9,15,53,45,8,45
Albion,2823,8,12,6,18,43,60,-17,42
Stranraer,2823,9,12,5,19,52,60,-8,41
Stenhousem'r,2823,10,8,8,20,44,80,-36,32
Livingston,2824,1,22,3,11,79,51,28,69
Alloa,2824,2,20,7,9,83,48,35,67
Brechin,2824,3,17,8,11,59,49,10,59
East Fife,2824,4,17,5,14,54,45,9,56
Airdrieon,2824,5,17,5,14,55,56,-1,56
Peterhead,2824,6,13,13,10,56,50,6,52
Stranraer,2824,7,13,4,19,44,64,-20,43
Albion,2824,8,12,5,19,49,57,-8,41
Queen's Park,2824,9,8,11,17,31,53,-22,35
Stenhousem'r,2824,10,6,9,21,45,82,-37,27
Alloa,2825,1,18,8,10,82,58,24,62
Airdrieon,2825,2,18,8,10,58,51,7,62
Livingston,2825,3,19,3,14,62,47,15,60
Brechin,2825,4,18,6,12,52,46,6,60
East Fife,2825,5,14,9,13,61,50,11,51
Peterhead,2825,6,14,9,13,49,57,-8,51
Albion,2825,7,12,11,13,53,58,-5,47
Stranraer,2825,8,11,7,18,49,58,-9,40
Queen's Park,2825,9,9,10,17,35,55,-20,37
Stenhousem'r,2825,10,9,5,22,50,71,-21,32
Alloa,2826,1,22,5,9,79,45,34,71
Livingston,2826,2,21,5,10,77,49,28,68
Airdrieon,2826,3,16,9,11,59,48,11,57
Stranraer,2826,4,15,6,15,56,56,0,51
Brechin,2826,5,15,4,17,50,61,-11,49
Peterhead,2826,6,13,9,14,48,53,-5,48
Albion,2826,7,14,5,17,49,53,-4,47
East Fife,2826,8,10,11,15,49,54,-5,41
Queen's Park,2826,9,12,4,20,30,52,-22,40
Stenhousem'r,2826,10,9,8,19,53,79,-26,35
Alloa,2827,1,21,6,9,71,41,30,69
Livingston,2827,2,17,8,11,65,51,14,59
Peterhead,2827,3,16,9,11,52,46,6,57
Brechin,2827,4,14,9,13,43,47,-4,51
Albion,2827,5,13,11,12,53,51,2,50
Airdrieon,2827,6,13,10,13,59,64,-5,49
Queen's Park,2827,7,13,7,16,40,49,-9,46
Stranraer,2827,8,13,6,17,51,54,-3,45
East Fife,2827,9,9,10,17,46,49,-3,37
Stenhousem'r,2827,10,9,8,19,51,79,-28,35
Livingston,2828,1,20,5,11,73,47,26,65
Alloa,2828,2,18,10,8,66,42,24,64
Airdrieon,2828,3,18,7,11,60,52,8,61
Albion,2828,4,16,7,13,65,56,9,55
Brechin,2828,5,15,5,16,42,49,-7,50
East Fife,2828,6,13,10,13,49,45,4,49
Stranraer,2828,7,11,8,17,43,56,-13,41
Queen's Park,2828,8,11,8,17,39,58,-19,41
Peterhead,2828,9,11,6,19,41,52,-11,39
Stenhousem'r,2828,10,11,6,19,52,73,-21,39
Livingston,2829,1,25,3,8,78,42,36,78
Brechin,2829,2,17,8,11,57,49,8,59
Alloa,2829,3,17,6,13,71,56,15,57
Queen's Park,2829,4,14,10,12,43,50,-7,52
Stranraer,2829,5,14,9,13,54,50,4,51
Airdrieon,2829,6,14,8,14,50,57,-7,50
Albion,2829,7,12,8,16,56,63,-7,44
East Fife,2829,8,10,12,14,49,45,4,42
Peterhead,2829,9,10,10,16,47,59,-12,40
Stenhousem'r,2829,10,6,8,22,42,76,-34,26
Alloa,2830,1,25,3,8,80,34,46,78
Airdrieon,2830,2,22,6,8,58,39,19,72
Livingston,2830,3,21,6,9,70,45,25,69
Brechin,2830,4,14,8,14,39,47,-8,50
Peterhead,2830,5,11,12,13,46,56,-10,45
Albion,2830,6,12,8,16,53,56,-3,44
Queen's Park,2830,7,11,9,16,35,49,-14,42
Stenhousem'r,2830,8,9,11,16,46,70,-24,38
Stranraer,2830,9,10,6,20,47,63,-16,36
East Fife,2830,10,5,11,20,42,57,-15,26
Alloa,2831,1,21,6,9,76,45,31,69
Airdrieon,2831,2,17,7,12,65,52,13,58
Livingston,2831,3,17,6,13,62,52,10,57
Brechin,2831,4,17,4,15,47,44,3,55
Peterhead,2831,5,14,10,12,54,59,-5,52
Queen's Park,2831,6,15,5,16,35,46,-11,50
Stenhousem'r,2831,7,14,5,17,54,69,-15,47
Albion,2831,8,12,10,14,51,52,-1,46
East Fife,2831,9,11,8,17,42,48,-6,41
Stranraer,2831,10,9,5,22,42,61,-19,32
Livingston,2832,1,21,5,10,81,47,34,68
Alloa,2832,2,19,7,10,75,43,32,64
Peterhead,2832,3,17,6,13,52,45,7,57
Airdrieon,2832,4,15,9,12,52,52,0,54
East Fife,2832,5,13,7,16,52,49,3,46
Stranraer,2832,6,13,7,16,51,54,-3,46
Brechin,2832,7,13,7,16,45,55,-10,46
Albion,2832,8,11,11,14,52,63,-11,44
Queen's Park,2832,9,12,6,18,39,65,-26,42
Stenhousem'r,2832,10,9,9,18,53,79,-26,36
Livingston,2833,1,22,5,9,78,43,35,71
Alloa,2833,2,19,9,8,66,42,24,66
Airdrieon,2833,3,17,10,9,60,46,14,61
Brechin,2833,4,16,9,11,59,46,13,57
Queen's Park,2833,5,12,11,13,41,59,-18,47
Albion,2833,6,13,7,16,59,56,3,46
Stranraer,2833,7,12,7,17,53,67,-14,43
Peterhead,2833,8,10,10,16,47,60,-13,40
East Fife,2833,9,9,10,17,42,51,-9,37
Stenhousem'r,2833,10,7,8,21,38,73,-35,29
Livingston,2834,1,22,3,11,80,44,36,69
Alloa,2834,2,19,6,11,72,49,23,63
Brechin,2834,3,20,2,14,58,49,9,62
Albion,2834,4,14,12,10,53,52,1,54
Stranraer,2834,5,15,4,17,56,56,0,49
Airdrieon,2834,6,14,7,15,56,69,-13,49
Peterhead,2834,7,14,5,17,50,59,-9,47
Queen's Park,2834,8,13,7,16,39,52,-13,46
East Fife,2834,9,10,10,16,47,52,-5,40
Stenhousem'r,2834,10,8,6,22,49,78,-29,30
Livingston,2835,1,20,8,8,68,48,20,68
Alloa,2835,2,20,6,10,73,37,36,66
Brechin,2835,3,18,8,10,52,45,7,62
Airdrieon,2835,4,15,10,11,57,52,5,55
Peterhead,2835,5,16,6,14,52,51,1,54
Albion,2835,6,13,9,14,58,54,4,48
Stranraer,2835,7,12,8,16,53,60,-7,44
East Fife,2835,8,11,8,17,43,49,-6,41
Queen's Park,2835,9,10,8,18,34,50,-16,38
Stenhousem'r,2835,10,6,7,23,46,90,-44,25
Alloa,2836,1,20,9,7,81,44,37,69
Livingston,2836,2,19,6,11,73,51,22,63
Queen's Park,2836,3,16,8,12,43,44,-1,56
Albion,2836,4,16,7,13,57,52,5,55
Brechin,2836,5,16,7,13,46,45,1,55
Airdrieon,2836,6,14,10,12,63,55,8,52
Peterhead,2836,7,13,9,14,55,56,-1,48
East Fife,2836,8,10,13,13,44,41,3,43
Stranraer,2836,9,12,3,21,44,69,-25,39
Stenhousem'r,2836,10,4,8,24,34,83,-49,20
Livingston,2837,1,22,2,12,77,53,24,68
Alloa,2837,2,19,9,8,76,47,29,66
Brechin,2837,3,19,4,13,50,53,-3,61
Airdrieon,2837,4,14,11,11,58,52,6,53
East Fife,2837,5,13,12,11,55,40,15,51
Albion,2837,6,12,10,14,50,55,-5,46
Peterhead,2837,7,11,11,14,46,49,-3,44
Stranraer,2837,8,13,4,19,53,66,-13,43
Queen's Park,2837,9,9,10,17,38,49,-11,37
Stenhousem'r,2837,10,9,5,22,47,86,-39,32
Livingston,2838,1,23,4,9,76,39,37,73
Alloa,2838,2,19,8,9,59,39,20,65
Airdrieon,2838,3,17,10,9,66,54,12,61
Brechin,2838,4,16,5,15,52,43,9,53
Albion,2838,5,15,5,16,50,61,-11,50
Peterhead,2838,6,13,9,14,43,45,-2,48
Stranraer,2838,7,12,8,16,51,54,-3,44
East Fife,2838,8,11,8,17,49,58,-9,41
Queen's Park,2838,9,11,8,17,26,48,-22,41
Stenhousem'r,2838,10,6,9,21,46,77,-31,27
Alloa,2839,1,18,12,6,74,43,31,66
Brechin,2839,2,18,9,9,55,44,11,63
Livingston,2839,3,17,9,10,72,49,23,60
Airdrieon,2839,4,17,9,10,64,48,16,60
Albion,2839,5,11,11,14,54,59,-5,44
Peterhead,2839,6,12,8,16,52,62,-10,44
Stranraer,2839,7,13,5,18,56,72,-16,44
Queen's Park,2839,8,10,11,15,37,50,-13,41
East Fife,2839,9,7,15,14,48,52,-4,36
Stenhousem'r,2839,10,7,11,18,50,83,-33,32
Alloa,2840,1,20,7,9,72,40,32,67
Livingston,2840,2,18,7,11,72,52,20,61
Airdrieon,2840,3,17,6,13,62,56,6,57
Brechin,2840,4,16,7,13,55,53,2,55
Peterhead,2840,5,15,9,12,49,49,0,54
Albion,2840,6,14,8,14,51,49,2,50
Stenhousem'r,2840,7,12,9,15,57,80,-23,45
Queen's Park,2840,8,11,10,15,46,58,-12,43
Stranraer,2840,9,8,11,17,44,59,-15,35
East Fife,2840,10,7,10,19,48,60,-12,31
Brechin,2841,1,20,5,11,49,40,9,65
Livingston,2841,2,20,2,14,80,56,24,62
Alloa,2841,3,15,12,9,58,41,17,57
Airdrieon,2841,4,17,5,14,64,51,13,56
Queen's Park,2841,5,15,10,11,38,42,-4,55
Peterhead,2841,6,14,8,14,52,52,0,50
Albion,2841,7,14,5,17,46,59,-13,47
East Fife,2841,8,13,7,16,50,53,-3,46
Stranraer,2841,9,11,8,17,46,56,-10,41
Stenhousem'r,2841,10,5,10,21,52,85,-33,25
Livingston,2842,1,21,4,11,76,44,32,67
Airdrieon,2842,2,18,11,7,74,49,25,65
Alloa,2842,3,15,11,10,70,44,26,56
Albion,2842,4,15,9,12,53,52,1,54
Peterhead,2842,5,14,7,15,44,52,-8,49
Brechin,2842,6,13,8,15,44,55,-11,47
Queen's Park,2842,7,13,5,18,39,55,-16,44
Stranraer,2842,8,12,7,17,47,62,-15,43
East Fife,2842,9,9,11,16,45,48,-3,38
Stenhousem'r,2842,10,10,7,19,44,75,-31,37
Livingston,2843,1,23,3,10,77,40,37,72
Peterhead,2843,2,16,9,11,50,49,1,57
Queen's Park,2843,3,14,9,13,45,49,-4,51
Brechin,2843,4,15,6,15,49,57,-8,51
Albion,2843,5,14,8,14,60,58,2,50
Alloa,2843,6,13,10,13,59,49,10,49
Stranraer,2843,7,14,7,15,59,57,2,49
East Fife,2843,8,12,12,12,52,51,1,48
Airdrieon,2843,9,13,7,16,55,58,-3,46
Stenhousem'r,2843,10,7,7,22,43,81,-38,28
Livingston,2844,1,24,3,9,75,41,34,75
Brechin,2844,2,18,7,11,54,43,11,61
Alloa,2844,3,16,10,10,65,45,20,58
Peterhead,2844,4,18,4,14,62,62,0,58
Stranraer,2844,5,15,5,16,59,62,-3,50
Queen's Park,2844,6,15,4,17,37,51,-14,49
Airdrieon,2844,7,14,6,16,49,53,-4,48
East Fife,2844,8,11,10,15,50,48,2,43
Albion,2844,9,10,9,17,54,58,-4,39
Stenhousem'r,2844,10,5,10,21,51,93,-42,25
Alloa,2845,1,22,7,7,73,41,32,73
Airdrieon,2845,2,18,9,9,68,56,12,63
Brechin,2845,3,17,6,13,46,41,5,57
Albion,2845,4,17,6,13,54,50,4,57
Livingston,2845,5,16,5,15,63,51,12,53
East Fife,2845,6,13,9,14,49,44,5,48
Stranraer,2845,7,12,5,19,46,62,-16,41
Queen's Park,2845,8,10,8,18,34,54,-20,38
Peterhead,2845,9,8,12,16,47,60,-13,36
Stenhousem'r,2845,10,8,11,17,43,64,-21,35
Livingston,2846,1,22,4,10,82,46,36,70
Alloa,2846,2,17,9,10,62,40,22,60
Brechin,2846,3,18,6,12,56,46,10,60
East Fife,2846,4,17,5,14,61,50,11,56
Airdrieon,2846,5,16,4,16,56,57,-1,52
Peterhead,2846,6,15,7,14,51,59,-8,52
Albion,2846,7,12,13,11,50,54,-4,49
Queen's Park,2846,8,11,7,18,32,55,-23,40
Stranraer,2846,9,11,4,21,52,66,-14,37
Stenhousem'r,2846,10,8,7,21,48,77,-29,31
Livingston,2847,1,20,5,11,80,57,23,65
Brechin,2847,2,18,6,12,64,51,13,60
Alloa,2847,3,16,7,13,63,54,9,55
Albion,2847,4,15,7,14,58,55,3,52
Airdrieon,2847,5,14,9,13,52,50,2,51
Queen's Park,2847,6,14,6,16,48,56,-8,48
Stranraer,2847,7,11,11,14,56,58,-2,44
Peterhead,2847,8,11,11,14,44,62,-18,44
Stenhousem'r,2847,9,10,10,16,54,70,-16,40
East Fife,2847,10,9,12,15,47,53,-6,39
Livingston,2848,1,20,4,12,86,55,31,64
Alloa,2848,2,19,5,12,72,50,22,62
Airdrieon,2848,3,17,7,12,53,50,3,58
Brechin,2848,4,16,7,13,58,52,6,55
Albion,2848,5,15,8,13,54,49,5,53
Peterhead,2848,6,13,12,11,54,50,4,51
Queen's Park,2848,7,15,6,15,46,54,-8,51
East Fife,2848,8,11,8,17,52,63,-11,41
Stranraer,2848,9,10,8,18,51,66,-15,38
Stenhousem'r,2848,10,8,7,21,49,86,-37,31
Alloa,2849,1,22,6,8,70,44,26,72
Livingston,2849,2,20,6,10,82,50,32,66
Airdrieon,2849,3,19,6,11,56,47,9,63
East Fife,2849,4,13,10,13,56,48,8,49
Peterhead,2849,5,14,6,16,52,57,-5,48
Brechin,2849,6,13,8,15,43,46,-3,47
Albion,2849,7,12,10,14,50,54,-4,46
Queen's Park,2849,8,13,7,16,34,46,-12,46
Stranraer,2849,9,11,4,21,50,68,-18,37
Stenhousem'r,2849,10,8,7,21,39,72,-33,31
Airdrieon,2850,1,21,8,7,59,40,19,71
Alloa,2850,2,18,7,11,75,55,20,61
Livingston,2850,3,17,6,13,71,51,20,57
Stranraer,2850,4,15,6,15,55,51,4,51
Brechin,2850,5,15,4,17,46,56,-10,49
Queen's Park,2850,6,13,9,14,41,50,-9,48
Albion,2850,7,11,13,12,50,45,5,46
East Fife,2850,8,13,6,17,46,49,-3,45
Peterhead,2850,9,9,12,15,43,55,-12,39
Stenhousem'r,2850,10,8,9,19,45,79,-34,33
Livingston,2851,1,19,9,8,70,50,20,66
Alloa,2851,2,18,10,8,77,47,30,64
Airdrieon,2851,3,19,6,11,60,48,12,63
Queen's Park,2851,4,16,8,12,50,51,-1,56
Brechin,2851,5,14,6,16,47,53,-6,48
Stranraer,2851,6,13,7,16,49,53,-4,46
East Fife,2851,7,11,10,15,51,51,0,43
Peterhead,2851,8,9,14,13,42,47,-5,41
Albion,2851,9,10,10,16,48,53,-5,40
Stenhousem'r,2851,10,6,10,20,38,79,-41,28
Livingston,2852,1,21,5,10,69,43,26,68
Alloa,2852,2,19,10,7,76,42,34,67
Airdrieon,2852,3,17,7,12,55,49,6,58
Albion,2852,4,16,8,12,61,52,9,56
Brechin,2852,5,13,9,14,46,46,0,48
Queen's Park,2852,6,12,8,16,43,56,-13,44
Peterhead,2852,7,10,12,14,47,64,-17,42
Stranraer,2852,8,11,8,17,46,53,-7,41
East Fife,2852,9,9,12,15,45,59,-14,39
Stenhousem'r,2852,10,8,9,19,54,78,-24,33
Livingston,2853,1,20,6,10,67,45,22,66
Brechin,2853,2,20,4,12,55,42,13,64
Alloa,2853,3,19,6,11,71,50,21,63
Airdrieon,2853,4,18,8,10,65,51,14,62
Albion,2853,5,15,5,16,46,52,-6,50
Peterhead,2853,6,14,7,15,44,50,-6,49
East Fife,2853,7,12,7,17,44,46,-2,43
Stranraer,2853,8,12,6,18,48,55,-7,42
Queen's Park,2853,9,12,6,18,35,49,-14,42
Stenhousem'r,2853,10,7,7,22,41,76,-35,28
Brechin,2854,1,19,6,11,51,38,13,63
Livingston,2854,2,19,5,12,76,49,27,62
Alloa,2854,3,18,7,11,72,49,23,61
Airdrieon,2854,4,18,5,13,61,55,6,59
Queen's Park,2854,5,14,7,15,43,55,-12,49
Albion,2854,6,12,11,13,48,55,-7,47
East Fife,2854,7,13,7,16,48,50,-2,46
Peterhead,2854,8,13,7,16,51,55,-4,46
Stranraer,2854,9,12,8,16,55,62,-7,44
Stenhousem'r,2854,10,7,7,22,51,88,-37,28
Alloa,2855,1,18,11,7,72,34,38,65
Livingston,2855,2,20,5,11,70,46,24,65
Brechin,2855,3,17,5,14,53,45,8,56
Peterhead,2855,4,16,7,13,52,49,3,55
Airdrieon,2855,5,15,7,14,51,57,-6,52
Albion,2855,6,13,8,15,65,64,1,47
East Fife,2855,7,12,10,14,47,46,1,46
Queen's Park,2855,8,12,9,15,35,46,-11,45
Stranraer,2855,9,8,13,15,42,55,-13,37
Stenhousem'r,2855,10,8,7,21,43,88,-45,31
Livingston,2856,1,24,7,5,84,40,44,79
Alloa,2856,2,17,9,10,65,48,17,60
Peterhead,2856,3,15,9,12,51,45,6,54
Brechin,2856,4,15,7,14,53,52,1,52
Airdrieon,2856,5,15,7,14,52,52,0,52
Albion,2856,6,13,7,16,52,58,-6,46
Queen's Park,2856,7,12,9,15,35,50,-15,45
Stranraer,2856,8,12,5,19,46,56,-10,41
East Fife,2856,9,10,10,16,47,49,-2,40
Stenhousem'r,2856,10,8,8,20,45,80,-35,32
Airdrieon,2857,1,19,7,10,58,43,15,64
Livingston,2857,2,20,3,13,65,51,14,63
Albion,2857,3,17,7,12,56,50,6,58
Alloa,2857,4,14,11,11,74,55,19,53
Peterhead,2857,5,14,8,14,54,51,3,50
East Fife,2857,6,13,9,14,53,43,10,48
Queen's Park,2857,7,14,6,16,41,50,-9,48
Stranraer,2857,8,14,5,17,49,54,-5,47
Brechin,2857,9,13,6,17,42,56,-14,45
Stenhousem'r,2857,10,7,8,21,40,79,-39,29
Livingston,2858,1,22,4,10,73,46,27,70
Alloa,2858,2,18,11,7,66,34,32,65
Albion,2858,3,19,6,11,66,48,18,63
Airdrieon,2858,4,17,9,10,58,53,5,60
Brechin,2858,5,16,6,14,44,39,5,54
East Fife,2858,6,12,13,11,50,47,3,49
Queen's Park,2858,7,10,10,16,33,44,-11,40
Stranraer,2858,8,9,10,17,49,61,-12,37
Peterhead,2858,9,8,9,19,42,68,-26,33
Stenhousem'r,2858,10,7,6,23,44,85,-41,27
Alloa,2859,1,22,8,6,76,35,41,74
Airdrieon,2859,2,18,8,10,72,54,18,62
Brechin,2859,3,19,5,12,49,42,7,62
Livingston,2859,4,16,10,10,67,46,21,58
Peterhead,2859,5,13,10,13,42,48,-6,49
Stranraer,2859,6,14,6,16,56,60,-4,48
Albion,2859,7,13,8,15,46,56,-10,47
Queen's Park,2859,8,12,8,16,43,55,-12,44
East Fife,2859,9,5,12,19,37,52,-15,27
Stenhousem'r,2859,10,5,11,20,45,85,-40,26
Livingston,2860,1,20,7,9,79,59,20,67
Brechin,2860,2,19,6,11,53,41,12,63
Alloa,2860,3,19,5,12,75,48,27,62
Peterhead,2860,4,18,6,12,66,52,14,60
Albion,2860,5,14,6,16,49,55,-6,48
Airdrieon,2860,6,13,9,14,57,64,-7,48
Queen's Park,2860,7,13,9,14,39,49,-10,48
Stenhousem'r,2860,8,10,7,19,51,75,-24,37
Stranraer,2860,9,10,6,20,60,71,-11,36
East Fife,2860,10,8,11,17,40,55,-15,35
Airdrieon,2861,1,20,6,10,63,53,10,66
Livingston,2861,2,19,6,11,72,48,24,63
Alloa,2861,3,17,10,9,66,41,25,61
Albion,2861,4,18,6,12,63,57,6,60
Peterhead,2861,5,14,8,14,61,50,11,50
Brechin,2861,6,14,7,15,50,53,-3,49
Stranraer,2861,7,14,6,16,50,54,-4,48
Queen's Park,2861,8,12,8,16,48,59,-11,44
East Fife,2861,9,10,9,17,42,51,-9,39
Stenhousem'r,2861,10,6,6,24,38,87,-49,24
Livingston,2862,1,22,6,8,81,48,33,72
Airdrieon,2862,2,22,6,8,62,48,14,72
Brechin,2862,3,20,5,11,58,43,15,65
Alloa,2862,4,19,7,10,63,40,23,64
East Fife,2862,5,12,9,15,50,45,5,45
Albion,2862,6,11,10,15,49,53,-4,43
Stranraer,2862,7,12,7,17,52,58,-6,43
Queen's Park,2862,8,12,6,18,36,53,-17,42
Peterhead,2862,9,11,4,21,50,64,-14,37
Stenhousem'r,2862,10,6,6,24,39,88,-49,24
Livingston,2863,1,23,3,10,86,51,35,72
Alloa,2863,2,22,5,9,81,48,33,71
Airdrieon,2863,3,18,8,10,68,56,12,62
Brechin,2863,4,17,5,14,60,55,5,56
Queen's Park,2863,5,15,5,16,42,54,-12,50
Stranraer,2863,6,13,5,18,49,58,-9,44
Albion,2863,7,12,7,17,56,63,-7,43
Peterhead,2863,8,11,7,18,44,69,-25,40
East Fife,2863,9,9,10,17,51,56,-5,37
Stenhousem'r,2863,10,9,7,20,50,77,-27,34
Livingston,2864,1,23,2,11,86,46,40,71
Brechin,2864,2,20,5,11,58,49,9,65
Alloa,2864,3,17,7,12,69,52,17,58
Queen's Park,2864,4,17,6,13,42,51,-9,57
Airdrieon,2864,5,16,5,15,64,60,4,53
Stranraer,2864,6,14,8,14,58,54,4,50
Peterhead,2864,7,14,6,16,46,53,-7,48
Albion,2864,8,11,9,16,47,52,-5,42
Stenhousem'r,2864,9,10,4,22,47,81,-34,34
East Fife,2864,10,9,6,21,44,63,-19,33
Livingston,2865,1,22,7,7,79,41,38,73
Alloa,2865,2,17,9,10,64,38,26,60
Airdrieon,2865,3,16,11,9,60,47,13,59
Albion,2865,4,13,10,13,50,46,4,49
Queen's Park,2865,5,12,13,11,34,36,-2,49
Brechin,2865,6,13,8,15,51,53,-2,47
Peterhead,2865,7,11,11,14,38,47,-9,44
East Fife,2865,8,11,9,16,47,58,-11,42
Stranraer,2865,9,10,11,15,41,56,-15,41
Stenhousem'r,2865,10,6,9,21,37,79,-42,27
Alloa,2866,1,20,7,9,68,45,23,67
Brechin,2866,2,19,7,10,57,39,18,64
Livingston,2866,3,17,6,13,66,46,20,57
Albion,2866,4,15,10,11,59,49,10,55
Peterhead,2866,5,15,7,14,49,48,1,52
Airdrieon,2866,6,15,7,14,51,53,-2,52
East Fife,2866,7,13,6,17,54,58,-4,45
Queen's Park,2866,8,11,9,16,32,50,-18,42
Stranraer,2866,9,11,6,19,47,63,-16,39
Stenhousem'r,2866,10,7,9,20,47,79,-32,30
Livingston,2867,1,29,2,5,84,41,43,89
Brechin,2867,2,17,9,10,53,45,8,60
Alloa,2867,3,14,10,12,69,56,13,52
Peterhead,2867,4,15,6,15,54,50,4,51
Airdrieon,2867,5,15,6,15,63,61,2,51
East Fife,2867,6,12,11,13,53,47,6,47
Albion,2867,7,10,11,15,48,56,-8,41
Stranraer,2867,8,12,5,19,47,61,-14,41
Queen's Park,2867,9,11,6,19,41,60,-19,39
Stenhousem'r,2867,10,7,10,19,49,84,-35,31
Alloa,2868,1,24,5,7,86,35,51,77
Livingston,2868,2,20,4,12,79,42,37,64
Brechin,2868,3,19,5,12,53,50,3,62
Albion,2868,4,17,8,11,60,47,13,59
Airdrieon,2868,5,16,7,13,54,51,3,55
East Fife,2868,6,9,12,15,49,53,-4,39
Peterhead,2868,7,10,9,17,43,61,-18,39
Queen's Park,2868,8,10,9,17,29,57,-28,39
Stranraer,2868,9,10,6,20,46,78,-32,36
Stenhousem'r,2868,10,6,13,17,45,70,-25,31
Alloa,2869,1,24,6,6,79,40,39,78
Airdrieon,2869,2,18,6,12,65,53,12,60
Brechin,2869,3,18,6,12,52,42,10,60
Livingston,2869,4,16,6,14,68,61,7,54
Peterhead,2869,5,14,7,15,52,54,-2,49
Albion,2869,6,13,9,14,57,58,-1,48
Queen's Park,2869,7,12,9,15,45,50,-5,45
East Fife,2869,8,9,13,14,40,52,-12,40
Stenhousem'r,2869,9,10,8,18,52,75,-23,38
Stranraer,2869,10,9,4,23,47,72,-25,31
Livingston,2870,1,21,7,8,75,42,33,70
Alloa,2870,2,17,9,10,69,40,29,60
Airdrieon,2870,3,16,8,12,62,58,4,56
Brechin,2870,4,15,9,12,47,48,-1,54
Stranraer,2870,5,14,8,14,55,58,-3,50
Albion,2870,6,13,10,13,52,44,8,49
Peterhead,2870,7,12,10,14,43,51,-8,46
East Fife,2870,8,10,12,14,46,52,-6,42
Stenhousem'r,2870,9,8,10,18,44,70,-26,34
Queen's Park,2870,10,8,9,19,28,58,-30,33
Livingston,2871,1,18,8,10,66,45,21,62
Alloa,2871,2,15,13,8,63,45,18,58
Brechin,2871,3,16,8,12,54,48,6,56
Albion,2871,4,12,12,12,46,45,1,48
Peterhead,2871,5,13,9,14,43,43,0,48
Stranraer,2871,6,13,8,15,52,56,-4,47
Airdrieon,2871,7,14,5,17,45,51,-6,47
Queen's Park,2871,8,13,7,16,31,49,-18,46
Stenhousem'r,2871,9,12,7,17,49,68,-19,43
East Fife,2871,10,8,15,13,47,46,1,39
Livingston,2872,1,24,4,8,76,40,36,76
Alloa,2872,2,21,7,8,74,41,33,70
East Fife,2872,3,16,7,13,53,43,10,55
Brechin,2872,4,16,6,14,56,56,0,54
Airdrieon,2872,5,16,6,14,54,56,-2,54
Albion,2872,6,14,5,17,51,57,-6,47
Peterhead,2872,7,11,8,17,49,56,-7,41
Queen's Park,2872,8,11,8,17,34,50,-16,41
Stenhousem'r,2872,9,8,11,17,47,75,-28,35
Stranraer,2872,10,8,8,20,42,62,-20,32
Alloa,2873,1,19,7,10,79,43,36,64
Livingston,2873,2,19,6,11,71,49,22,63
Airdrieon,2873,3,17,7,12,54,45,9,58
Brechin,2873,4,17,7,12,48,42,6,58
Peterhead,2873,5,16,8,12,47,46,1,56
Queen's Park,2873,6,14,8,14,54,57,-3,50
Albion,2873,7,13,9,14,54,59,-5,48
East Fife,2873,8,9,10,17,45,57,-12,37
Stranraer,2873,9,10,6,20,46,65,-19,36
Stenhousem'r,2873,10,9,6,21,45,80,-35,33
Livingston,2874,1,23,2,11,80,44,36,71
Alloa,2874,2,19,10,7,72,42,30,67
Albion,2874,3,17,7,12,60,52,8,58
Queen's Park,2874,4,17,5,14,46,47,-1,56
Brechin,2874,5,15,8,13,57,54,3,53
Airdrieon,2874,6,15,7,14,59,55,4,52
Stranraer,2874,7,14,5,17,48,59,-11,47
Peterhead,2874,8,12,7,17,51,60,-9,43
East Fife,2874,9,6,12,18,44,58,-14,30
Stenhousem'r,2874,10,7,7,22,45,91,-46,28
Alloa,2875,1,21,6,9,79,50,29,69
Brechin,2875,2,19,7,10,50,45,5,64
Livingston,2875,3,20,2,14,77,58,19,62
Airdrieon,2875,4,17,9,10,58,47,11,60
Albion,2875,5,14,8,14,60,51,9,50
Peterhead,2875,6,12,11,13,53,55,-2,47
East Fife,2875,7,11,11,14,47,47,0,44
Stenhousem'r,2875,8,10,8,18,51,80,-29,38
Stranraer,2875,9,10,7,19,51,66,-15,37
Queen's Park,2875,10,7,9,20,28,55,-27,30
Alloa,2876,1,22,7,7,71,37,34,73
Livingston,2876,2,20,3,13,71,50,21,63
Peterhead,2876,3,17,5,14,52,49,3,56
Stranraer,2876,4,16,5,15,55,51,4,53
Brechin,2876,5,16,5,15,50,47,3,53
Airdrieon,2876,6,15,6,15,55,54,1,51
East Fife,2876,7,12,10,14,52,53,-1,46
Queen's Park,2876,8,12,7,17,40,56,-16,43
Albion,2876,9,9,10,17,48,66,-18,37
Stenhousem'r,2876,10,9,6,21,39,70,-31,33
Livingston,2877,1,21,6,9,72,50,22,69
Brechin,2877,2,18,6,12,54,49,5,60
Alloa,2877,3,16,9,11,73,43,30,57
East Fife,2877,4,15,10,11,59,45,14,55
Peterhead,2877,5,13,12,11,63,64,-1,51
Airdrieon,2877,6,13,10,13,56,56,0,49
Albion,2877,7,13,7,16,59,63,-4,46
Stranraer,2877,8,11,8,17,49,59,-10,41
Queen's Park,2877,9,10,10,16,37,54,-17,40
Stenhousem'r,2877,10,7,8,21,48,87,-39,29
Alloa,2878,1,21,9,6,80,46,34,72
Livingston,2878,2,21,7,8,82,44,38,70
Airdrieon,2878,3,19,7,10,66,49,17,64
Peterhead,2878,4,15,7,14,50,50,0,52
Albion,2878,5,14,7,15,51,52,-1,49
Stranraer,2878,6,14,6,16,51,60,-9,48
East Fife,2878,7,12,10,14,54,50,4,46
Queen's Park,2878,8,11,7,18,37,53,-16,40
Brechin,2878,9,10,9,17,40,55,-15,39
Stenhousem'r,2878,10,4,9,23,38,90,-52,21
Livingston,2879,1,19,7,10,82,51,31,64
Alloa,2879,2,19,7,10,74,48,26,64
Albion,2879,3,16,11,9,58,41,17,59
Peterhead,2879,4,16,6,14,50,50,0,54
East Fife,2879,5,14,11,11,55,45,10,53
Airdrieon,2879,6,15,4,17,55,62,-7,49
Brechin,2879,7,14,7,15,49,59,-10,49
Queen's Park,2879,8,12,7,17,34,57,-23,43
Stranraer,2879,9,12,5,19,59,68,-9,41
Stenhousem'r,2879,10,7,7,22,42,77,-35,28
Livingston,2880,1,20,7,9,79,46,33,67
Albion,2880,2,18,8,10,60,40,20,62
Alloa,2880,3,18,8,10,66,50,16,62
Airdrieon,2880,4,17,4,15,54,48,6,55
Brechin,2880,5,16,5,15,52,55,-3,53
Queen's Park,2880,6,14,6,16,34,44,-10,48
Stranraer,2880,7,13,5,18,48,60,-12,44
Peterhead,2880,8,9,15,12,44,50,-6,42
East Fife,2880,9,10,10,16,50,60,-10,40
Stenhousem'r,2880,10,7,8,21,39,73,-34,29
Livingston,2881,1,24,2,10,73,42,31,74
Airdrieon,2881,2,17,7,12,68,62,6,58
Alloa,2881,3,15,10,11,60,50,10,55
Brechin,2881,4,16,4,16,53,49,4,52
East Fife,2881,5,14,9,13,55,44,11,51
Queen's Park,2881,6,14,9,13,44,51,-7,51
Albion,2881,7,13,11,12,57,51,6,50
Peterhead,2881,8,12,8,16,47,57,-10,44
Stranraer,2881,9,10,6,20,49,71,-22,36
Stenhousem'r,2881,10,8,8,20,55,84,-29,32
Livingston,2882,1,22,6,8,81,48,33,72
Brechin,2882,2,22,5,9,55,38,17,71
Alloa,2882,3,20,6,10,69,40,29,66
Airdrieon,2882,4,18,7,11,55,48,7,61
Albion,2882,5,15,6,15,56,51,5,51
Queen's Park,2882,6,14,7,15,50,54,-4,49
Peterhead,2882,7,13,7,16,48,56,-8,46
Stranraer,2882,8,12,4,20,52,70,-18,40
East Fife,2882,9,9,7,20,54,63,-9,34
Stenhousem'r,2882,10,3,9,24,41,93,-52,18
Alloa,2883,1,20,7,9,79,44,35,67
Airdrieon,2883,2,17,12,7,61,52,9,63
Livingston,2883,3,18,5,13,71,58,13,59
Albion,2883,4,16,9,11,56,50,6,57
Brechin,2883,5,14,8,14,44,56,-12,50
Peterhead,2883,6,12,10,14,49,54,-5,46
Stranraer,2883,7,11,11,14,55,58,-3,44
East Fife,2883,8,11,8,17,55,48,7,41
Queen's Park,2883,9,9,9,18,40,63,-23,36
Stenhousem'r,2883,10,7,11,18,45,72,-27,32
Alloa,2884,1,19,6,11,73,43,30,63
Airdrieon,2884,2,15,10,11,63,52,11,55
Albion,2884,3,16,7,13,54,55,-1,55
Livingston,2884,4,16,4,16,73,62,11,52
Brechin,2884,5,15,6,15,52,54,-2,51
Peterhead,2884,6,13,10,13,46,54,-8,49
Queen's Park,2884,7,14,6,16,38,49,-11,48
East Fife,2884,8,13,8,15,55,54,1,47
Stranraer,2884,9,12,10,14,46,54,-8,46
Stenhousem'r,2884,10,9,9,18,51,74,-23,36
Livingston,2885,1,26,4,6,93,49,44,82
Alloa,2885,2,20,7,9,73,44,29,67
Brechin,2885,3,20,1,15,61,60,1,61
Airdrieon,2885,4,14,6,16,54,56,-2,48
Queen's Park,2885,5,13,8,15,50,54,-4,47
Peterhead,2885,6,12,8,16,41,61,-20,44
Stranraer,2885,7,12,7,17,54,66,-12,43
Albion,2885,8,12,6,18,59,64,-5,42
East Fife,2885,9,10,11,15,52,58,-6,41
Stenhousem'r,2885,10,9,6,21,53,78,-25,33
Livingston,2886,1,24,6,6,95,45,50,78
Brechin,2886,2,20,6,10,63,45,18,66
Airdrieon,2886,3,17,9,10,71,60,11,60
Alloa,2886,4,17,8,11,66,44,22,59
Albion,2886,5,13,10,13,57,59,-2,49
Peterhead,2886,6,12,8,16,45,61,-16,44
Queen's Park,2886,7,11,9,16,33,45,-12,42
Stranraer,2886,8,11,3,22,42,68,-26,36
Stenhousem'r,2886,9,9,9,18,44,72,-28,36
East Fife,2886,10,7,10,19,41,58,-17,31
Airdrieon,2887,1,18,8,10,58,43,15,62
Brechin,2887,2,19,4,13,60,49,11,61
Queen's Park,2887,3,18,7,11,53,46,7,61
Alloa,2887,4,17,9,10,62,42,20,60
Livingston,2887,5,17,4,15,67,52,15,55
Peterhead,2887,6,15,7,14,49,49,0,52
Albion,2887,7,14,9,13,53,50,3,51
Stranraer,2887,8,13,4,19,53,68,-15,43
East Fife,2887,9,11,7,18,49,59,-10,40
Stenhousem'r,2887,10,4,9,23,41,87,-46,21
Alloa,2888,1,18,10,8,72,43,29,64
Livingston,2888,2,20,4,12,64,55,9,64
Brechin,2888,3,16,10,10,51,47,4,58
Peterhead,2888,4,16,8,12,55,51,4,56
Airdrieon,2888,5,15,9,12,59,60,-1,54
Albion,2888,6,15,5,16,67,55,12,50
Queen's Park,2888,7,14,6,16,45,49,-4,48
Stranraer,2888,8,13,4,19,50,66,-16,43
East Fife,2888,9,9,11,16,47,50,-3,38
Stenhousem'r,2888,10,8,5,23,35,69,-34,29
Alloa,2889,1,23,7,6,76,37,39,76
Airdrieon,2889,2,19,8,9,63,50,13,65
Livingston,2889,3,18,9,9,79,51,28,63
Brechin,2889,4,17,7,12,56,47,9,58
Peterhead,2889,5,14,8,14,50,50,0,50
Stranraer,2889,6,15,3,18,55,66,-11,48
Albion,2889,7,13,8,15,56,52,4,47
East Fife,2889,8,10,9,17,39,46,-7,39
Queen's Park,2889,9,10,9,17,31,57,-26,39
Stenhousem'r,2889,10,3,8,25,37,86,-49,17
Brechin,2890,1,19,5,12,49,48,1,62
Livingston,2890,2,19,4,13,65,43,22,61
Stranraer,2890,3,18,5,13,58,47,11,59
Alloa,2890,4,14,11,11,63,42,21,53
Albion,2890,5,15,8,13,52,54,-2,53
East Fife,2890,6,13,11,12,44,36,8,50
Airdrieon,2890,7,15,5,16,54,57,-3,50
Queen's Park,2890,8,12,9,15,35,46,-11,45
Peterhead,2890,9,12,7,17,47,54,-7,43
Stenhousem'r,2890,10,7,7,22,38,78,-40,28
Alloa,2891,1,19,8,9,74,42,32,65
Livingston,2891,2,17,7,12,71,53,18,58
East Fife,2891,3,15,9,12,46,40,6,54
Airdrieon,2891,4,15,8,13,56,56,0,53
Brechin,2891,5,16,5,15,46,48,-2,53
Peterhead,2891,6,14,8,14,51,60,-9,50
Albion,2891,7,14,7,15,58,57,1,49
Queen's Park,2891,8,13,8,15,32,44,-12,47
Stranraer,2891,9,13,6,17,49,52,-3,45
Stenhousem'r,2891,10,8,6,22,50,81,-31,30
Livingston,2892,1,22,4,10,81,53,28,70
Alloa,2892,2,21,6,9,71,42,29,69
Brechin,2892,3,16,9,11,49,38,11,57
Peterhead,2892,4,17,5,14,55,51,4,56
Airdrieon,2892,5,16,7,13,55,52,3,55
Stranraer,2892,6,11,8,17,43,51,-8,41
Queen's Park,2892,7,10,11,15,32,52,-20,41
East Fife,2892,8,8,14,14,43,54,-11,38
Albion,2892,9,10,7,19,51,62,-11,37
Stenhousem'r,2892,10,8,11,17,50,75,-25,35
Alloa,2893,1,23,8,5,78,35,43,77
Airdrieon,2893,2,19,4,13,65,47,18,61
Livingston,2893,3,18,5,13,60,52,8,59
Brechin,2893,4,17,6,13,50,47,3,57
Albion,2893,5,14,10,12,58,44,14,52
East Fife,2893,6,15,7,14,47,40,7,52
Stranraer,2893,7,13,6,17,54,61,-7,45
Queen's Park,2893,8,12,7,17,40,55,-15,43
Peterhead,2893,9,12,7,17,41,60,-19,43
Stenhousem'r,2893,10,4,6,26,41,93,-52,18
Brechin,2894,1,19,3,14,53,52,1,60
Livingston,2894,2,18,4,14,79,61,18,58
Peterhead,2894,3,17,6,13,52,51,1,57
Alloa,2894,4,16,8,12,68,51,17,56
Airdrieon,2894,5,14,9,13,58,58,0,51
East Fife,2894,6,12,12,12,47,44,3,48
Stranraer,2894,7,14,6,16,52,62,-10,48
Albion,2894,8,12,10,14,55,50,5,46
Queen's Park,2894,9,13,6,17,38,52,-14,45
Stenhousem'r,2894,10,8,10,18,49,70,-21,34
Alloa,2895,1,21,6,9,71,43,28,69
Airdrieon,2895,2,20,5,11,59,46,13,65
Livingston,2895,3,20,4,12,70,43,27,64
Peterhead,2895,4,18,5,13,51,47,4,59
Albion,2895,5,16,4,16,56,55,1,52
Brechin,2895,6,15,4,17,51,51,0,49
Queen's Park,2895,7,14,4,18,35,53,-18,46
East Fife,2895,8,12,8,16,50,57,-7,44
Stranraer,2895,9,11,7,18,50,59,-9,40
Stenhousem'r,2895,10,6,7,23,37,76,-39,25
Alloa,2896,1,23,7,6,76,35,41,76
Livingston,2896,2,21,5,10,78,45,33,68
Airdrieon,2896,3,17,7,12,55,62,-7,58
Albion,2896,4,15,6,15,54,57,-3,51
Queen's Park,2896,5,14,9,13,38,44,-6,51
Peterhead,2896,6,13,7,16,45,54,-9,46
East Fife,2896,7,11,9,16,44,46,-2,42
Brechin,2896,8,12,6,18,46,55,-9,42
Stranraer,2896,9,11,8,17,47,56,-9,41
Stenhousem'r,2896,10,7,8,21,50,79,-29,29
Livingston,2897,1,21,6,9,75,44,31,69
Brechin,2897,2,18,10,8,59,40,19,64
Airdrieon,2897,3,19,7,10,66,55,11,64
Alloa,2897,4,16,9,11,65,42,23,57
Peterhead,2897,5,14,9,13,50,52,-2,51
Albion,2897,6,14,8,14,55,53,2,50
East Fife,2897,7,13,6,17,46,51,-5,45
Queen's Park,2897,8,12,7,17,44,58,-14,43
Stranraer,2897,9,10,6,20,49,59,-10,36
Stenhousem'r,2897,10,5,8,23,38,93,-55,23
Livingston,2898,1,22,5,9,76,44,32,71
Alloa,2898,2,19,8,9,73,43,30,65
Brechin,2898,3,18,5,13,58,46,12,59
Albion,2898,4,15,11,10,66,59,7,56
Airdrieon,2898,5,15,6,15,47,59,-12,51
Peterhead,2898,6,13,9,14,44,45,-1,48
Queen's Park,2898,7,13,7,16,41,58,-17,46
Stranraer,2898,8,12,7,17,45,52,-7,43
East Fife,2898,9,10,10,16,43,49,-6,40
Stenhousem'r,2898,10,4,10,22,39,77,-38,22
Livingston,2899,1,23,3,10,87,45,42,72
Alloa,2899,2,18,9,9,65,46,19,63
Airdrieon,2899,3,16,7,13,63,58,5,55
Albion,2899,4,15,8,13,66,58,8,53
Brechin,2899,5,15,7,14,47,53,-6,52
Peterhead,2899,6,13,9,14,53,56,-3,48
East Fife,2899,7,13,8,15,55,48,7,47
Queen's Park,2899,8,12,8,16,45,52,-7,44
Stranraer,2899,9,12,5,19,52,64,-12,41
Stenhousem'r,2899,10,7,8,21,40,93,-53,29
Livingston,2900,1,21,4,11,79,48,31,67
Alloa,2900,2,17,9,10,65,42,23,60
Brechin,2900,3,16,8,12,51,45,6,56
Airdrieon,2900,4,14,10,12,51,49,2,52
East Fife,2900,5,15,6,15,57,49,8,51
Stranraer,2900,6,12,12,12,53,55,-2,48
Peterhead,2900,7,12,9,15,48,59,-11,45
Albion,2900,8,12,8,16,48,55,-7,44
Queen's Park,2900,9,12,8,16,34,46,-12,44
Stenhousem'r,2900,10,8,8,20,36,74,-38,32
Alloa,2901,1,23,7,6,79,39,40,76
Livingston,2901,2,23,5,8,83,43,40,74
Brechin,2901,3,20,5,11,65,50,15,65
East Fife,2901,4,15,7,14,61,56,5,52
Airdrieon,2901,5,13,10,13,49,52,-3,49
Peterhead,2901,6,13,6,17,52,54,-2,45
Albion,2901,7,11,10,15,45,63,-18,43
Queen's Park,2901,8,10,6,20,33,56,-23,36
Stranraer,2901,9,10,5,21,47,67,-20,35
Stenhousem'r,2901,10,8,7,21,39,73,-34,31
Livingston,2902,1,21,7,8,71,39,32,70
Brechin,2902,2,21,3,12,47,38,9,66
Alloa,2902,3,18,6,12,64,46,18,60
East Fife,2902,4,14,11,11,59,47,12,53
Peterhead,2902,5,15,7,14,56,52,4,52
Airdrieon,2902,6,13,6,17,51,60,-9,45
Stranraer,2902,7,12,6,18,53,60,-7,42
Albion,2902,8,9,13,14,48,57,-9,40
Queen's Park,2902,9,10,9,17,38,57,-19,39
Stenhousem'r,2902,10,8,10,18,48,79,-31,34
Brechin,2903,1,22,6,8,65,34,31,72
Livingston,2903,2,22,4,10,77,41,36,70
Alloa,2903,3,20,5,11,70,49,21,65
Airdrieon,2903,4,18,4,14,61,55,6,58
Peterhead,2903,5,15,5,16,50,59,-9,50
East Fife,2903,6,12,9,15,47,49,-2,45
Stranraer,2903,7,13,3,20,52,72,-20,42
Albion,2903,8,11,7,18,54,64,-10,40
Queen's Park,2903,9,10,8,18,37,52,-15,38
Stenhousem'r,2903,10,8,7,21,47,85,-38,31
Livingston,2904,1,22,6,8,74,38,36,72
Alloa,2904,2,21,8,7,72,35,37,71
Airdrieon,2904,3,16,11,9,59,51,8,59
Brechin,2904,4,15,6,15,54,48,6,51
Peterhead,2904,5,12,15,9,44,40,4,51
Albion,2904,6,13,7,16,44,51,-7,46
East Fife,2904,7,10,11,15,51,53,-2,41
Queen's Park,2904,8,10,9,17,32,47,-15,39
Stranraer,2904,9,10,6,20,44,71,-27,36
Stenhousem'r,2904,10,8,7,21,44,84,-40,31
Livingston,2905,1,21,3,12,80,50,30,66
Alloa,2905,2,20,5,11,75,45,30,65
Brechin,2905,3,17,7,12,52,50,2,58
Airdrieon,2905,4,15,6,15,57,72,-15,51
Stranraer,2905,5,15,3,18,56,58,-2,48
Peterhead,2905,6,13,9,14,39,46,-7,48
Albion,2905,7,13,8,15,51,48,3,47
Stenhousem'r,2905,8,12,8,16,49,63,-14,44
East Fife,2905,9,12,7,17,45,50,-5,43
Queen's Park,2905,10,11,6,19,37,59,-22,39
Alloa,2906,1,21,6,9,70,45,25,69
Livingston,2906,2,21,4,11,81,53,28,67
Airdrieon,2906,3,18,6,12,63,47,16,60
Brechin,2906,4,14,9,13,41,47,-6,51
Albion,2906,5,13,11,12,49,48,1,50
Peterhead,2906,6,13,11,12,50,50,0,50
Stranraer,2906,7,13,9,14,49,53,-4,48
East Fife,2906,8,10,9,17,49,58,-9,39
Queen's Park,2906,9,10,9,17,41,56,-15,39
Stenhousem'r,2906,10,6,8,22,42,78,-36,26
Alloa,2907,1,21,7,8,70,39,31,70
Livingston,2907,2,21,1,14,79,52,27,64
Albion,2907,3,17,7,12,55,55,0,58
Queen's Park,2907,4,17,4,15,42,54,-12,55
Airdrieon,2907,5,16,5,15,56,66,-10,53
Peterhead,2907,6,15,7,14,52,49,3,52
Brechin,2907,7,14,5,17,44,47,-3,47
East Fife,2907,8,12,9,15,50,48,2,45
Stranraer,2907,9,9,6,21,47,62,-15,33
Stenhousem'r,2907,10,8,9,19,52,75,-23,33
Alloa,2908,1,19,10,7,76,42,34,67
Livingston,2908,2,20,5,11,67,44,23,65
Airdrieon,2908,3,15,10,11,56,44,12,55
Albion,2908,4,15,9,12,58,50,8,54
Peterhead,2908,5,13,10,13,50,49,1,49
East Fife,2908,6,13,10,13,46,46,0,49
Stranraer,2908,7,14,6,16,50,55,-5,48
Brechin,2908,8,15,1,20,36,57,-21,46
Queen's Park,2908,9,13,6,17,35,49,-14,45
Stenhousem'r,2908,10,6,7,23,41,79,-38,25
Alloa,2909,1,18,11,7,74,44,30,65
Livingston,2909,2,20,3,13,71,50,21,63
Airdrieon,2909,3,19,4,13,63,49,14,61
Albion,2909,4,15,10,11,56,55,1,55
Brechin,2909,5,16,4,16,48,54,-6,52
Peterhead,2909,6,13,10,13,55,52,3,49
East Fife,2909,7,11,9,16,50,55,-5,42
Stranraer,2909,8,11,8,17,57,65,-8,41
Stenhousem'r,2909,9,10,9,17,55,84,-29,39
Queen's Park,2909,10,10,6,20,33,54,-21,36
Livingston,2910,1,22,6,8,79,50,29,72
Alloa,2910,2,19,5,12,77,49,28,62
Peterhead,2910,3,18,5,13,58,48,10,59
Brechin,2910,4,17,8,11,53,46,7,59
Airdrieon,2910,5,16,6,14,64,58,6,54
Stranraer,2910,6,14,4,18,60,62,-2,46
East Fife,2910,7,12,10,14,50,53,-3,46
Queen's Park,2910,8,12,8,16,39,61,-22,44
Albion,2910,9,9,8,19,49,66,-17,35
Stenhousem'r,2910,10,8,6,22,47,83,-36,30
Alloa,2911,1,20,8,8,79,39,40,68
Livingston,2911,2,21,3,12,73,46,27,66
Airdrieon,2911,3,17,11,8,58,42,16,62
Brechin,2911,4,15,10,11,50,52,-2,55
East Fife,2911,5,15,7,14,51,49,2,52
Peterhead,2911,6,14,9,13,50,53,-3,51
Albion,2911,7,12,7,17,48,56,-8,43
Queen's Park,2911,8,10,9,17,27,48,-21,39
Stranraer,2911,9,9,9,18,37,53,-16,36
Stenhousem'r,2911,10,6,9,21,39,74,-35,27
Brechin,2912,1,21,7,8,63,40,23,70
Livingston,2912,2,20,7,9,82,43,39,67
Airdrieon,2912,3,19,8,9,65,48,17,65
Alloa,2912,4,16,10,10,66,52,14,58
Peterhead,2912,5,14,10,12,51,59,-8,52
Albion,2912,6,11,12,13,54,57,-3,45
Stranraer,2912,7,12,6,18,50,58,-8,42
East Fife,2912,8,9,9,18,44,50,-6,36
Stenhousem'r,2912,9,9,6,21,52,88,-36,33
Queen's Park,2912,10,8,7,21,29,61,-32,31
Airdrieon,2913,1,22,5,9,67,46,21,71
Livingston,2913,2,22,3,11,73,51,22,69
Alloa,2913,3,17,10,9,73,49,24,61
Albion,2913,4,16,8,12,51,47,4,56
Queen's Park,2913,5,15,6,15,46,49,-3,51
Brechin,2913,6,15,5,16,47,53,-6,50
Peterhead,2913,7,13,10,13,51,54,-3,49
East Fife,2913,8,9,10,17,45,54,-9,37
Stranraer,2913,9,10,5,21,46,56,-10,35
Stenhousem'r,2913,10,5,10,21,43,83,-40,25
Alloa,2914,1,19,7,10,70,45,25,64
Livingston,2914,2,20,2,14,83,60,23,62
Airdrieon,2914,3,16,9,11,58,54,4,57
Queen's Park,2914,4,15,9,12,43,43,0,54
Albion,2914,5,13,11,12,63,60,3,50
Peterhead,2914,6,15,5,16,49,55,-6,50
Brechin,2914,7,13,10,13,38,41,-3,49
East Fife,2914,8,13,9,14,56,46,10,48
Stranraer,2914,9,10,8,18,49,66,-17,38
Stenhousem'r,2914,10,9,4,23,44,83,-39,31
Livingston,2915,1,21,6,9,91,45,46,69
Alloa,2915,2,20,8,8,67,43,24,68
Brechin,2915,3,17,8,11,55,47,8,59
Airdrieon,2915,4,18,5,13,57,56,1,59
Stenhousem'r,2915,5,14,5,17,54,68,-14,47
Albion,2915,6,11,12,13,50,52,-2,45
East Fife,2915,7,12,7,17,44,46,-2,43
Stranraer,2915,8,12,4,20,46,65,-19,40
Peterhead,2915,9,9,10,17,37,57,-20,37
Queen's Park,2915,10,10,7,19,28,50,-22,37
Alloa,2916,1,18,9,9,68,45,23,63
Livingston,2916,2,17,8,11,74,51,23,59
Stranraer,2916,3,16,6,14,52,49,3,54
Brechin,2916,4,16,4,16,54,53,1,52
East Fife,2916,5,14,9,13,59,48,11,51
Peterhead,2916,6,14,8,14,54,46,8,50
Queen's Park,2916,7,15,5,16,41,56,-15,50
Albion,2916,8,13,10,13,53,51,2,49
Airdrieon,2916,9,13,7,16,46,58,-12,46
Stenhousem'r,2916,10,7,8,21,50,94,-44,29
Livingston,2917,1,24,8,4,91,40,51,80
Alloa,2917,2,19,8,9,74,46,28,65
Airdrieon,2917,3,18,3,15,54,53,1,57
Brechin,2917,4,15,7,14,50,46,4,52
Peterhead,2917,5,13,9,14,54,59,-5,48
Stranraer,2917,6,14,5,17,58,70,-12,47
Queen's Park,2917,7,13,7,16,42,49,-7,46
Albion,2917,8,9,13,14,46,54,-8,40
East Fife,2917,9,9,10,17,42,58,-16,37
Stenhousem'r,2917,10,7,8,21,43,79,-36,29
Alloa,2918,1,19,7,10,68,38,30,64
Brechin,2918,2,18,6,12,52,41,11,60
Livingston,2918,3,18,5,13,67,50,17,59
Airdrieon,2918,4,17,7,12,60,52,8,58
East Fife,2918,5,15,8,13,51,43,8,53
Albion,2918,6,13,11,12,56,50,6,50
Stranraer,2918,7,14,5,17,53,64,-11,47
Queen's Park,2918,8,13,7,16,40,49,-9,46
Peterhead,2918,9,13,6,17,42,46,-4,45
Stenhousem'r,2918,10,5,8,23,35,91,-56,23
Alloa,2919,1,22,6,8,70,37,33,72
Airdrieon,2919,2,20,6,10,60,43,17,66
Livingston,2919,3,18,7,11,69,52,17,61
Brechin,2919,4,17,5,14,50,49,1,56
Stranraer,2919,5,16,7,13,56,50,6,55
Albion,2919,6,13,9,14,51,54,-3,48
Peterhead,2919,7,11,10,15,45,53,-8,43
East Fife,2919,8,9,12,15,46,52,-6,39
Queen's Park,2919,9,10,7,19,33,51,-18,37
Stenhousem'r,2919,10,6,7,23,51,90,-39,25
Livingston,2920,1,22,6,8,83,44,39,72
Alloa,2920,2,17,8,11,62,43,19,59
Airdrieon,2920,3,17,7,12,58,54,4,58
Stranraer,2920,4,15,4,17,53,56,-3,49
Peterhead,2920,5,14,7,15,52,55,-3,49
Albion,2920,6,11,14,11,46,51,-5,47
Brechin,2920,7,13,8,15,49,57,-8,47
East Fife,2920,8,11,9,16,55,54,1,42
Stenhousem'r,2920,9,11,7,18,49,71,-22,40
Queen's Park,2920,10,9,10,17,29,51,-22,37
Brechin,2921,1,19,7,10,56,41,15,64
Livingston,2921,2,18,7,11,72,51,21,61
Alloa,2921,3,17,8,11,72,55,17,59
Peterhead,2921,4,17,8,11,60,49,11,59
Airdrieon,2921,5,16,7,13,55,53,2,55
East Fife,2921,6,12,10,14,46,41,5,46
Stranraer,2921,7,13,4,19,51,63,-12,43
Queen's Park,2921,8,12,6,18,41,58,-17,42
Stenhousem'r,2921,9,11,7,18,52,73,-21,40
Albion,2921,10,10,6,20,45,66,-21,36
Livingston,2922,1,22,2,12,81,49,32,68
Alloa,2922,2,18,10,8,72,44,28,64
Albion,2922,3,15,8,13,52,59,-7,53
Airdrieon,2922,4,14,8,14,57,61,-4,50
Queen's Park,2922,5,14,8,14,46,52,-6,50
Stranraer,2922,6,14,7,15,59,59,0,49
East Fife,2922,7,13,9,14,51,41,10,48
Peterhead,2922,8,13,8,15,43,48,-5,47
Brechin,2922,9,12,9,15,40,48,-8,45
Stenhousem'r,2922,10,6,9,21,48,88,-40,27
Livingston,2923,1,22,4,10,85,52,33,70
Alloa,2923,2,16,11,9,65,47,18,59
Albion,2923,3,14,13,9,56,46,10,55
Peterhead,2923,4,15,8,13,46,48,-2,53
Brechin,2923,5,15,8,13,44,48,-4,53
Airdrieon,2923,6,13,11,12,57,56,1,50
Queen's Park,2923,7,13,6,17,39,59,-20,45
Stranraer,2923,8,13,5,18,49,54,-5,44
Stenhousem'r,2923,9,10,8,18,48,73,-25,38
East Fife,2923,10,7,10,19,50,56,-6,31
Livingston,2924,1,19,12,5,73,41,32,69
Alloa,2924,2,17,9,10,72,53,19,60
Albion,2924,3,16,8,12,59,54,5,56
Peterhead,2924,4,16,7,13,57,53,4,55
Airdrieon,2924,5,16,6,14,68,63,5,54
Brechin,2924,6,16,6,14,57,52,5,54
Queen's Park,2924,7,12,8,16,43,56,-13,44
East Fife,2924,8,9,11,16,46,50,-4,38
Stenhousem'r,2924,9,10,7,19,56,87,-31,37
Stranraer,2924,10,9,6,21,43,65,-22,33
Livingston,2925,1,19,7,10,83,55,28,64
Alloa,2925,2,19,7,10,72,44,28,64
East Fife,2925,3,16,9,11,60,42,18,57
Airdrieon,2925,4,16,8,12,67,56,11,56
Albion,2925,5,16,7,13,59,55,4,55
Queen's Park,2925,6,16,4,16,44,50,-6,52
Peterhead,2925,7,11,10,15,46,54,-8,43
Brechin,2925,8,11,8,17,43,67,-24,41
Stranraer,2925,9,11,7,18,47,58,-11,40
Stenhousem'r,2925,10,8,7,21,51,91,-40,31
Airdrieon,2926,1,20,6,10,56,45,11,66
Alloa,2926,2,19,6,11,66,42,24,63
Livingston,2926,3,19,4,13,71,52,19,61
Brechin,2926,4,17,4,15,45,43,2,55
Peterhead,2926,5,14,8,14,48,52,-4,50
Albion,2926,6,14,8,14,49,54,-5,50
East Fife,2926,7,13,8,15,56,43,13,47
Queen's Park,2926,8,12,8,16,33,51,-18,44
Stranraer,2926,9,10,7,19,41,62,-21,37
Stenhousem'r,2926,10,10,5,21,48,69,-21,35
Airdrieon,2927,1,17,9,10,64,49,15,60
Livingston,2927,2,18,5,13,67,47,20,59
Alloa,2927,3,15,10,11,70,49,21,55
Queen's Park,2927,4,16,7,13,45,40,5,55
Brechin,2927,5,15,9,12,42,44,-2,54
Peterhead,2927,6,15,6,15,43,51,-8,51
Albion,2927,7,13,8,15,46,54,-8,47
Stranraer,2927,8,12,9,15,54,54,0,45
East Fife,2927,9,11,9,16,43,53,-10,42
Stenhousem'r,2927,10,7,10,19,45,78,-33,31
Alloa,2928,1,23,6,7,77,39,38,75
Livingston,2928,2,22,6,8,86,50,36,72
Brechin,2928,3,20,4,12,57,45,12,64
Airdrieon,2928,4,20,4,12,62,51,11,64
Albion,2928,5,14,9,13,57,59,-2,51
Stranraer,2928,6,12,5,19,48,61,-13,41
Queen's Park,2928,7,11,7,18,30,52,-22,40
East Fife,2928,8,9,10,17,49,59,-10,37
Peterhead,2928,9,9,9,18,44,55,-11,36
Stenhousem'r,2928,10,7,6,23,47,86,-39,27
Airdrieon,2929,1,18,8,10,60,51,9,62
Livingston,2929,2,17,7,12,81,57,24,58
Albion,2929,3,18,4,14,57,58,-1,58
Alloa,2929,4,16,9,11,68,50,18,57
Brechin,2929,5,17,5,14,64,59,5,56
Peterhead,2929,6,15,7,14,52,48,4,52
East Fife,2929,7,13,10,13,53,53,0,49
Stranraer,2929,8,10,10,16,53,66,-13,40
Queen's Park,2929,9,11,5,20,37,59,-22,38
Stenhousem'r,2929,10,9,7,20,53,77,-24,34
Airdrieon,2930,1,23,5,8,67,45,22,74
Queen's Park,2930,2,19,5,12,44,41,3,62
Livingston,2930,3,17,5,14,68,54,14,56
Alloa,2930,4,16,7,13,65,51,14,55
East Fife,2930,5,15,7,14,55,55,0,52
Albion,2930,6,15,6,15,53,47,6,51
Brechin,2930,7,12,8,16,40,47,-7,44
Stranraer,2930,8,11,7,18,50,61,-11,40
Peterhead,2930,9,11,5,20,50,62,-12,38
Stenhousem'r,2930,10,9,9,18,50,79,-29,36
Alloa,2931,1,23,9,4,78,38,40,78
Livingston,2931,2,23,2,11,74,48,26,71
Peterhead,2931,3,16,13,7,56,43,13,61
Brechin,2931,4,16,5,15,45,46,-1,53
East Fife,2931,5,11,11,14,54,50,4,44
Airdrieon,2931,6,13,5,18,53,60,-7,44
Queen's Park,2931,7,12,8,16,39,49,-10,44
Stranraer,2931,8,11,6,19,52,68,-16,39
Albion,2931,9,10,7,19,49,59,-10,37
Stenhousem'r,2931,10,9,6,21,43,82,-39,33
Brechin,2932,1,21,6,9,58,38,20,69
Livingston,2932,2,21,5,10,74,52,22,68
Alloa,2932,3,15,12,9,73,45,28,57
Airdrieon,2932,4,16,6,14,55,57,-2,54
Albion,2932,5,13,10,13,56,56,0,49
East Fife,2932,6,12,10,14,51,48,3,46
Peterhead,2932,7,11,10,15,51,56,-5,43
Stranraer,2932,8,12,6,18,45,56,-11,42
Queen's Park,2932,9,12,6,18,36,57,-21,42
Stenhousem'r,2932,10,8,7,21,46,80,-34,31
Livingston,2933,1,18,7,11,78,57,21,61
Peterhead,2933,2,18,6,12,62,48,14,60
Brechin,2933,3,18,4,14,48,47,1,58
Airdrieon,2933,4,16,9,11,52,46,6,57
Albion,2933,5,15,7,14,60,55,5,52
East Fife,2933,6,14,7,15,56,51,5,49
Alloa,2933,7,14,7,15,53,48,5,49
Queen's Park,2933,8,13,8,15,45,49,-4,47
Stranraer,2933,9,13,5,18,45,57,-12,44
Stenhousem'r,2933,10,7,8,21,41,82,-41,29
Alloa,2934,1,18,8,10,70,42,28,62
Albion,2934,2,17,9,10,59,48,11,60
Brechin,2934,3,19,3,14,52,49,3,60
Livingston,2934,4,17,7,12,79,64,15,58
Queen's Park,2934,5,17,6,13,44,40,4,57
Airdrieon,2934,6,14,8,14,56,60,-4,50
Peterhead,2934,7,14,5,17,44,53,-9,47
Stranraer,2934,8,11,7,18,48,55,-7,40
East Fife,2934,9,10,9,17,39,44,-5,39
Stenhousem'r,2934,10,8,8,20,49,85,-36,32
Livingston,2935,1,18,8,10,66,45,21,62
Brechin,2935,2,18,7,11,50,50,0,61
Alloa,2935,3,15,11,10,62,44,18,56
Albion,2935,4,16,7,13,60,48,12,55
Airdrieon,2935,5,12,15,9,48,45,3,51
Peterhead,2935,6,14,9,13,59,58,1,51
Queen's Park,2935,7,13,9,14,39,51,-12,48
Stranraer,2935,8,10,12,14,52,53,-1,42
East Fife,2935,9,10,10,16,45,50,-5,40
Stenhousem'r,2935,10,6,8,22,45,82,-37,26
Airdrieon,2936,1,21,6,9,69,49,20,69
Livingston,2936,2,21,4,11,75,48,27,67
Peterhead,2936,3,17,8,11,55,49,6,59
Alloa,2936,4,15,12,9,66,46,20,57
East Fife,2936,5,15,9,12,48,42,6,54
Brechin,2936,6,15,7,14,51,47,4,52
Albion,2936,7,10,12,14,48,57,-9,42
Queen's Park,2936,8,10,7,19,34,50,-16,37
Stranraer,2936,9,6,13,17,40,62,-22,31
Stenhousem'r,2936,10,6,10,20,44,80,-36,28
Livingston,2937,1,26,5,5,90,40,50,83
Alloa,2937,2,18,10,8,70,47,23,64
Brechin,2937,3,18,6,12,63,56,7,60
Airdrieon,2937,4,17,7,12,59,55,4,58
East Fife,2937,5,12,8,16,49,46,3,44
Albion,2937,6,11,9,16,50,56,-6,42
Peterhead,2937,7,11,9,16,42,52,-10,42
Stranraer,2937,8,10,10,16,50,60,-10,40
Queen's Park,2937,9,11,6,19,32,57,-25,39
Stenhousem'r,2937,10,7,8,21,44,80,-36,29
Alloa,2938,1,20,9,7,74,34,40,69
Brechin,2938,2,18,6,12,55,51,4,60
Airdrieon,2938,3,17,7,12,56,57,-1,58
Livingston,2938,4,16,7,13,76,53,23,55
Albion,2938,5,15,7,14,54,55,-1,52
East Fife,2938,6,12,8,16,55,51,4,44
Peterhead,2938,7,11,11,14,56,60,-4,44
Queen's Park,2938,8,12,6,18,36,58,-22,42
Stranraer,2938,9,10,10,16,45,62,-17,40
Stenhousem'r,2938,10,10,7,19,52,78,-26,37
Livingston,2939,1,22,4,10,83,48,35,70
Alloa,2939,2,19,7,10,68,46,22,64
Airdrieon,2939,3,19,5,12,57,49,8,62
Peterhead,2939,4,16,8,12,57,42,15,56
Stranraer,2939,5,16,6,14,56,49,7,54
Queen's Park,2939,6,15,5,16,42,65,-23,50
Brechin,2939,7,14,4,18,44,51,-7,46
East Fife,2939,8,11,10,15,43,50,-7,43
Albion,2939,9,10,10,16,49,56,-7,40
Stenhousem'r,2939,10,5,7,24,43,86,-43,22
Alloa,2940,1,21,6,9,74,43,31,69
Livingston,2940,2,19,5,12,73,51,22,62
Airdrieon,2940,3,16,8,12,57,52,5,56
Brechin,2940,4,16,6,14,49,45,4,54
Albion,2940,5,14,7,15,55,52,3,49
Stranraer,2940,6,14,6,16,51,59,-8,48
Queen's Park,2940,7,14,6,16,43,52,-9,48
Peterhead,2940,8,12,8,16,46,57,-11,44
Stenhousem'r,2940,9,11,7,18,49,76,-27,40
East Fife,2940,10,8,11,17,42,52,-10,35
Alloa,2941,1,20,8,8,77,43,34,68
Airdrieon,2941,2,21,5,10,59,48,11,68
Livingston,2941,3,19,6,11,84,51,33,63
Albion,2941,4,15,8,13,56,55,1,53
Queen's Park,2941,5,16,4,16,55,52,3,52
Peterhead,2941,6,14,8,14,53,52,1,50
Brechin,2941,7,14,8,14,49,50,-1,50
East Fife,2941,8,10,10,16,43,52,-9,40
Stranraer,2941,9,11,5,20,45,69,-24,38
Stenhousem'r,2941,10,5,8,23,36,85,-49,23
Livingston,2942,1,22,4,10,80,52,28,70
Alloa,2942,2,21,4,11,84,47,37,67
Airdrieon,2942,3,20,3,13,66,59,7,63
Brechin,2942,4,17,8,11,50,45,5,59
Stranraer,2942,5,16,3,17,59,56,3,51
East Fife,2942,6,13,9,14,45,45,0,48
Queen's Park,2942,7,13,5,18,36,51,-15,44
Peterhead,2942,8,12,6,18,47,55,-8,42
Albion,2942,9,10,10,16,52,69,-17,40
Stenhousem'r,2942,10,7,6,23,44,84,-40,27
Livingston,2943,1,23,3,10,76,48,28,72
Airdrieon,2943,2,20,8,8,62,44,18,68
Albion,2943,3,17,4,15,55,51,4,55
Peterhead,2943,4,15,7,14,48,50,-2,52
Queen's Park,2943,5,15,6,15,36,45,-9,51
Brechin,2943,6,14,7,15,49,47,2,49
Alloa,2943,7,12,11,13,54,50,4,47
East Fife,2943,8,11,8,17,50,55,-5,41
Stranraer,2943,9,12,4,20,56,66,-10,40
Stenhousem'r,2943,10,8,8,20,40,70,-30,32
Alloa,2944,1,17,8,11,66,49,17,59
Airdrieon,2944,2,17,8,11,56,49,7,59
Livingston,2944,3,17,7,12,72,52,20,58
Brechin,2944,4,15,10,11,54,45,9,55
Albion,2944,5,14,7,15,51,56,-5,49
Queen's Park,2944,6,13,9,14,43,44,-1,48
Stranraer,2944,7,12,9,15,53,61,-8,45
East Fife,2944,8,12,9,15,51,60,-9,45
Peterhead,2944,9,11,8,17,52,63,-11,41
Stenhousem'r,2944,10,8,13,15,48,67,-19,37
Livingston,2945,1,22,6,8,77,46,31,72
Albion,2945,2,15,9,12,52,47,5,54
Peterhead,2945,3,16,6,14,49,44,5,54
Airdrieon,2945,4,16,6,14,55,51,4,54
Stranraer,2945,5,15,7,14,58,58,0,52
Brechin,2945,6,15,6,15,54,62,-8,51
Alloa,2945,7,15,5,16,71,53,18,50
East Fife,2945,8,13,9,14,50,52,-2,48
Queen's Park,2945,9,13,8,15,29,41,-12,47
Stenhousem'r,2945,10,6,6,24,41,82,-41,24
Livingston,2946,1,22,4,10,71,42,29,70
Alloa,2946,2,17,8,11,67,53,14,59
Airdrieon,2946,3,16,9,11,58,47,11,57
Brechin,2946,4,17,6,13,51,50,1,57
East Fife,2946,5,14,9,13,54,50,4,51
Albion,2946,6,12,13,11,47,42,5,49
Peterhead,2946,7,11,14,11,50,49,1,47
Queen's Park,2946,8,12,8,16,33,49,-16,44
Stranraer,2946,9,9,9,18,46,56,-10,36
Stenhousem'r,2946,10,6,8,22,39,78,-39,26
Alloa,2947,1,20,7,9,72,37,35,67
Livingston,2947,2,21,3,12,79,60,19,66
Brechin,2947,3,19,8,9,63,46,17,65
Albion,2947,4,13,11,12,52,51,1,50
Airdrieon,2947,5,13,11,12,54,57,-3,50
Peterhead,2947,6,14,8,14,54,59,-5,50
Stranraer,2947,7,14,5,17,59,59,0,47
East Fife,2947,8,10,10,16,46,55,-9,40
Queen's Park,2947,9,9,7,20,36,62,-26,34
Stenhousem'r,2947,10,7,10,19,50,79,-29,31
Alloa,2948,1,19,6,11,63,45,18,63
Livingston,2948,2,18,8,10,76,51,25,62
Albion,2948,3,17,9,10,59,52,7,60
Queen's Park,2948,4,16,7,13,51,48,3,55
Brechin,2948,5,16,7,13,47,45,2,55
Peterhead,2948,6,14,6,16,52,55,-3,48
Airdrieon,2948,7,13,8,15,56,64,-8,47
Stranraer,2948,8,12,6,18,53,60,-7,42
East Fife,2948,9,9,12,15,50,51,-1,39
Stenhousem'r,2948,10,7,9,20,42,78,-36,30
Livingston,2949,1,21,2,13,84,52,32,65
Alloa,2949,2,18,10,8,67,41,26,64
Airdrieon,2949,3,19,5,12,55,45,10,62
Brechin,2949,4,17,6,13,54,49,5,57
Albion,2949,5,15,11,10,55,49,6,56
Stranraer,2949,6,14,7,15,56,59,-3,49
Queen's Park,2949,7,13,7,16,32,50,-18,46
East Fife,2949,8,10,10,16,41,48,-7,40
Peterhead,2949,9,8,9,19,41,59,-18,33
Stenhousem'r,2949,10,7,9,20,36,69,-33,30
Alloa,2950,1,19,11,6,69,39,30,68
Livingston,2950,2,20,6,10,68,45,23,66
Albion,2950,3,16,7,13,56,51,5,55
Brechin,2950,4,15,6,15,50,52,-2,51
Stranraer,2950,5,14,7,15,52,55,-3,49
Queen's Park,2950,6,13,9,14,43,54,-11,48
Airdrieon,2950,7,14,4,18,49,58,-9,46
Peterhead,2950,8,13,6,17,57,63,-6,45
East Fife,2950,9,11,8,17,52,51,1,41
Stenhousem'r,2950,10,10,6,20,54,82,-28,36
Livingston,2951,1,23,5,8,82,46,36,74
Alloa,2951,2,19,8,9,72,43,29,65
Airdrieon,2951,3,17,7,12,58,50,8,58
Brechin,2951,4,18,4,14,45,46,-1,58
Albion,2951,5,15,9,12,47,37,10,54
Peterhead,2951,6,15,7,14,47,49,-2,52
Stranraer,2951,7,14,4,18,53,66,-13,46
Queen's Park,2951,8,11,4,21,34,56,-22,37
East Fife,2951,9,7,10,19,38,50,-12,31
Stenhousem'r,2951,10,7,10,19,45,78,-33,31
Alloa,2952,1,22,7,7,81,39,42,73
Livingston,2952,2,22,3,11,71,42,29,69
Queen's Park,2952,3,17,7,12,54,53,1,58
Airdrieon,2952,4,15,7,14,51,59,-8,52
Peterhead,2952,5,14,7,15,47,52,-5,49
Albion,2952,6,13,9,14,47,49,-2,48
East Fife,2952,7,12,8,16,42,44,-2,44
Stranraer,2952,8,13,4,19,44,57,-13,43
Brechin,2952,9,12,3,21,49,62,-13,39
Stenhousem'r,2952,10,9,7,20,46,75,-29,34
Alloa,2953,1,20,7,9,70,48,22,67
Livingston,2953,2,18,5,13,78,55,23,59
Brechin,2953,3,18,5,13,63,49,14,59
Airdrieon,2953,4,18,5,13,63,62,1,59
Albion,2953,5,14,10,12,51,54,-3,52
Queen's Park,2953,6,14,9,13,43,52,-9,51
Peterhead,2953,7,12,11,13,50,46,4,47
Stranraer,2953,8,11,10,15,53,61,-8,43
East Fife,2953,9,8,14,14,46,46,0,38
Stenhousem'r,2953,10,4,10,22,47,91,-44,22
Brechin,2954,1,22,2,12,55,43,12,68
Airdrieon,2954,2,21,4,11,57,44,13,67
Livingston,2954,3,21,3,12,79,54,25,66
Alloa,2954,4,17,7,12,65,49,16,58
Peterhead,2954,5,16,7,13,54,53,1,55
Queen's Park,2954,6,13,6,17,38,55,-17,45
Stranraer,2954,7,13,5,18,38,50,-12,44
East Fife,2954,8,12,6,18,49,56,-7,42
Stenhousem'r,2954,9,11,5,20,48,63,-15,38
Albion,2954,10,8,7,21,42,58,-16,31
Livingston,2955,1,20,5,11,66,47,19,65
Alloa,2955,2,17,7,12,68,49,19,58
Queen's Park,2955,3,16,10,10,37,37,0,58
Airdrieon,2955,4,17,4,15,62,59,3,55
Peterhead,2955,5,15,9,12,49,42,7,54
Albion,2955,6,14,11,11,53,49,4,53
Brechin,2955,7,13,7,16,51,54,-3,46
Stranraer,2955,8,14,4,18,50,63,-13,46
East Fife,2955,9,10,7,19,48,51,-3,37
Stenhousem'r,2955,10,9,6,21,42,75,-33,33
Livingston,2956,1,25,2,9,84,41,43,77
Airdrieon,2956,2,18,5,13,55,47,8,59
Peterhead,2956,3,13,14,9,57,50,7,53
Albion,2956,4,15,8,13,56,52,4,53
Stranraer,2956,5,15,5,16,58,59,-1,50
Brechin,2956,6,14,8,14,46,48,-2,50
Alloa,2956,7,12,11,13,55,51,4,47
Queen's Park,2956,8,12,7,17,39,55,-16,43
East Fife,2956,9,7,14,15,36,50,-14,35
Stenhousem'r,2956,10,8,8,20,49,82,-33,32
Livingston,2957,1,22,3,11,88,51,37,69
Alloa,2957,2,18,10,8,79,49,30,64
Airdrieon,2957,3,20,4,12,66,51,15,64
Peterhead,2957,4,15,7,14,51,57,-6,52
Albion,2957,5,14,8,14,50,53,-3,50
Queen's Park,2957,6,14,7,15,44,48,-4,49
Brechin,2957,7,13,7,16,49,56,-7,46
East Fife,2957,8,12,7,17,59,62,-3,43
Stranraer,2957,9,12,3,21,53,76,-23,39
Stenhousem'r,2957,10,9,6,21,36,72,-36,33
Livingston,2958,1,22,2,12,81,55,26,68
Airdrieon,2958,2,19,6,11,67,54,13,63
Brechin,2958,3,17,8,11,57,54,3,59
Albion,2958,4,16,10,10,55,40,15,58
Alloa,2958,5,15,11,10,67,50,17,56
Peterhead,2958,6,13,8,15,43,51,-8,47
East Fife,2958,7,11,10,15,48,47,1,43
Queen's Park,2958,8,11,6,19,44,64,-20,39
Stranraer,2958,9,11,5,20,46,62,-16,38
Stenhousem'r,2958,10,8,8,20,44,75,-31,32
Brechin,2959,1,20,5,11,49,41,8,65
Airdrieon,2959,2,18,7,11,67,57,10,61
Alloa,2959,3,17,9,10,60,36,24,60
Albion,2959,4,18,6,12,59,47,12,60
Livingston,2959,5,16,5,15,64,53,11,53
East Fife,2959,6,13,9,14,51,46,5,48
Queen's Park,2959,7,13,6,17,40,48,-8,45
Stranraer,2959,8,11,6,19,47,60,-13,39
Stenhousem'r,2959,9,9,10,17,47,77,-30,37
Peterhead,2959,10,9,9,18,38,57,-19,36
Alloa,2960,1,24,4,8,86,45,41,76
Livingston,2960,2,18,7,11,71,52,19,61
Albion,2960,3,15,10,11,63,51,12,55
Airdrieon,2960,4,16,6,14,54,52,2,54
Peterhead,2960,5,14,9,13,56,51,5,51
Brechin,2960,6,14,9,13,53,50,3,51
Queen's Park,2960,7,11,10,15,40,55,-15,43
East Fife,2960,8,10,10,16,42,47,-5,40
Stranraer,2960,9,11,5,20,51,76,-25,38
Stenhousem'r,2960,10,8,8,20,43,80,-37,32
Livingston,2961,1,20,4,12,71,51,20,64
Alloa,2961,2,19,6,11,65,46,19,63
Airdrieon,2961,3,18,5,13,60,53,7,59
Albion,2961,4,17,5,14,68,54,14,56
Queen's Park,2961,5,15,10,11,54,56,-2,55
Brechin,2961,6,16,6,14,54,48,6,54
Peterhead,2961,7,15,7,14,48,49,-1,52
East Fife,2961,8,11,7,18,47,52,-5,40
Stranraer,2961,9,10,6,20,47,66,-19,36
Stenhousem'r,2961,10,6,10,20,46,85,-39,28
Alloa,2962,1,19,9,8,78,41,37,66
Livingston,2962,2,16,11,9,72,55,17,59
Brechin,2962,3,16,9,11,48,45,3,57
Queen's Park,2962,4,17,5,14,43,50,-7,56
Airdrieon,2962,5,17,4,15,55,56,-1,55
Peterhead,2962,6,14,7,15,44,46,-2,49
Albion,2962,7,12,9,15,59,56,3,45
Stranraer,2962,8,12,6,18,50,64,-14,42
East Fife,2962,9,10,10,16,41,48,-7,40
Stenhousem'r,2962,10,9,6,21,47,76,-29,33
Livingston,2963,1,26,6,4,94,45,49,84
Alloa,2963,2,20,7,9,70,41,29,67
Albion,2963,3,16,6,14,53,51,2,54
Airdrieon,2963,4,15,6,15,50,47,3,51
Peterhead,2963,5,13,11,12,43,46,-3,50
Queen's Park,2963,6,14,3,19,42,55,-13,45
Stranraer,2963,7,12,8,16,50,61,-11,44
Brechin,2963,8,12,6,18,47,57,-10,42
East Fife,2963,9,9,12,15,43,47,-4,39
Stenhousem'r,2963,10,7,7,22,42,84,-42,28
Livingston,2964,1,22,1,13,76,53,23,67
Airdrieon,2964,2,18,6,12,67,59,8,60
Alloa,2964,3,17,6,13,72,52,20,57
Albion,2964,4,17,5,14,55,52,3,56
Brechin,2964,5,16,6,14,53,48,5,54
Peterhead,2964,6,14,9,13,42,49,-7,51
East Fife,2964,7,12,10,14,54,50,4,46
Queen's Park,2964,8,12,8,16,38,50,-12,44
Stenhousem'r,2964,9,12,5,19,56,82,-26,41
Stranraer,2964,10,10,4,22,55,73,-18,34
Livingston,2965,1,21,5,10,75,44,31,68
Alloa,2965,2,17,8,11,69,47,22,59
Albion,2965,3,15,11,10,56,44,12,56
Brechin,2965,4,15,8,13,48,46,2,53
Airdrieon,2965,5,14,9,13,55,58,-3,51
Queen's Park,2965,6,13,12,11,40,46,-6,51
Stranraer,2965,7,13,6,17,44,55,-11,45
Peterhead,2965,8,12,9,15,50,63,-13,45
East Fife,2965,9,10,8,18,50,55,-5,38
Stenhousem'r,2965,10,8,8,20,45,74,-29,32
Livingston,2966,1,21,5,10,76,45,31,68
Airdrieon,2966,2,18,5,13,63,55,8,59
Brechin,2966,3,17,6,13,50,41,9,57
Alloa,2966,4,15,10,11,67,55,12,55
Peterhead,2966,5,14,8,14,48,47,1,50
Queen's Park,2966,6,13,9,14,39,48,-9,48
East Fife,2966,7,12,9,15,45,40,5,45
Stenhousem'r,2966,8,9,12,15,50,73,-23,39
Stranraer,2966,9,10,9,17,39,63,-24,39
Albion,2966,10,9,11,16,44,54,-10,38
Livingston,2967,1,23,6,7,84,45,39,75
Airdrieon,2967,2,20,5,11,64,52,12,65
Alloa,2967,3,18,7,11,68,48,20,61
Brechin,2967,4,17,8,11,49,47,2,59
Peterhead,2967,5,15,8,13,51,49,2,53
Albion,2967,6,14,7,15,60,64,-4,49
Queen's Park,2967,7,12,5,19,40,54,-14,41
East Fife,2967,8,10,9,17,57,60,-3,39
Stranraer,2967,9,11,6,19,51,63,-12,39
Stenhousem'r,2967,10,6,7,23,48,90,-42,25
Airdrieon,2968,1,20,6,10,65,45,20,66
Livingston,2968,2,19,5,12,68,47,21,62
Alloa,2968,3,17,9,10,66,48,18,60
East Fife,2968,4,17,9,10,55,44,11,60
Albion,2968,5,15,7,14,56,50,6,52
Brechin,2968,6,13,6,17,44,54,-10,45
Peterhead,2968,7,11,10,15,45,60,-15,43
Stranraer,2968,8,10,10,16,54,61,-7,40
Queen's Park,2968,9,11,7,18,35,53,-18,40
Stenhousem'r,2968,10,8,9,19,49,75,-26,33
Alloa,2969,1,20,7,9,73,40,33,67
Airdrieon,2969,2,18,6,12,68,52,16,60
Livingston,2969,3,18,5,13,74,56,18,59
Brechin,2969,4,16,10,10,55,44,11,58
Peterhead,2969,5,15,5,16,55,63,-8,50
Stenhousem'r,2969,6,13,7,16,54,74,-20,46
Albion,2969,7,12,8,16,52,58,-6,44
Queen's Park,2969,8,11,9,16,40,50,-10,42
East Fife,2969,9,10,10,16,43,56,-13,40
Stranraer,2969,10,10,7,19,44,65,-21,37
Airdrieon,2970,1,20,3,13,64,57,7,63
Livingston,2970,2,19,5,12,72,47,25,62
Alloa,2970,3,18,7,11,69,42,27,61
Albion,2970,4,16,8,12,55,52,3,56
Brechin,2970,5,15,5,16,45,52,-7,50
Queen's Park,2970,6,14,8,14,38,46,-8,50
Peterhead,2970,7,13,9,14,53,56,-3,48
Stranraer,2970,8,11,11,14,50,58,-8,44
East Fife,2970,9,11,10,15,53,48,5,43
Stenhousem'r,2970,10,5,10,21,42,83,-41,25
Livingston,2971,1,23,4,9,78,45,33,73
Peterhead,2971,2,18,6,12,60,52,8,60
Airdrieon,2971,3,16,6,14,60,59,1,54
Alloa,2971,4,16,5,15,60,53,7,53
Stranraer,2971,5,16,5,15,54,52,2,53
Brechin,2971,6,15,4,17,50,52,-2,49
Queen's Park,2971,7,15,4,17,46,62,-16,49
East Fife,2971,8,14,6,16,52,49,3,48
Albion,2971,9,14,4,18,61,70,-9,46
Stenhousem'r,2971,10,7,8,21,47,74,-27,29
Airdrieon,2972,1,19,8,9,55,45,10,65
Livingston,2972,2,19,6,11,70,53,17,63
Peterhead,2972,3,18,8,10,58,47,11,62
Alloa,2972,4,16,8,12,68,49,19,56
Brechin,2972,5,14,10,12,50,48,2,52
Albion,2972,6,13,10,13,50,48,2,49
Stranraer,2972,7,13,8,15,48,56,-8,47
Queen's Park,2972,8,11,9,16,33,47,-14,42
East Fife,2972,9,7,12,17,46,50,-4,33
Stenhousem'r,2972,10,7,7,22,40,75,-35,28
Livingston,2973,1,22,5,9,85,44,41,71
Airdrieon,2973,2,19,7,10,58,48,10,64
Alloa,2973,3,16,11,9,57,43,14,59
Brechin,2973,4,15,10,11,51,56,-5,55
East Fife,2973,5,14,9,13,47,44,3,51
Peterhead,2973,6,13,7,16,52,56,-4,46
Albion,2973,7,14,4,18,49,55,-6,46
Stranraer,2973,8,12,7,17,53,61,-8,43
Queen's Park,2973,9,9,10,17,30,47,-17,37
Stenhousem'r,2973,10,7,8,21,44,72,-28,29
Alloa,2974,1,25,7,4,90,39,51,82
Livingston,2974,2,20,7,9,82,49,33,67
Brechin,2974,3,15,7,14,56,57,-1,52
Stranraer,2974,4,14,8,14,52,54,-2,50
Airdrieon,2974,5,14,8,14,49,53,-4,50
Peterhead,2974,6,13,7,16,48,59,-11,46
Albion,2974,7,12,10,14,46,58,-12,46
East Fife,2974,8,10,9,17,42,47,-5,39
Queen's Park,2974,9,10,7,19,35,58,-23,37
Stenhousem'r,2974,10,7,10,19,44,70,-26,31
Airdrieon,2975,1,19,8,9,56,58,-2,65
Livingston,2975,2,19,5,12,76,55,21,62
Alloa,2975,3,17,8,11,71,47,24,59
Brechin,2975,4,17,4,15,53,50,3,55
Albion,2975,5,14,7,15,57,54,3,49
Peterhead,2975,6,14,7,15,54,58,-4,49
East Fife,2975,7,12,10,14,52,50,2,46
Stranraer,2975,8,12,8,16,58,63,-5,44
Queen's Park,2975,9,13,5,18,43,54,-11,44
Stenhousem'r,2975,10,9,6,21,56,87,-31,33
Livingston,2976,1,20,5,11,76,49,27,65
Alloa,2976,2,18,8,10,74,47,27,62
East Fife,2976,3,16,11,9,58,44,14,59
Brechin,2976,4,15,8,13,55,58,-3,53
Albion,2976,5,14,10,12,57,48,9,52
Airdrieon,2976,6,14,9,13,51,55,-4,51
Peterhead,2976,7,13,9,14,59,62,-3,48
Queen's Park,2976,8,12,7,17,40,49,-9,43
Stranraer,2976,9,12,7,17,54,64,-10,43
Stenhousem'r,2976,10,5,8,23,46,94,-48,23
Alloa,2977,1,23,4,9,78,37,41,73
Livingston,2977,2,22,4,10,80,48,32,70
Brechin,2977,3,16,7,13,52,54,-2,55
Airdrieon,2977,4,16,6,14,59,63,-4,54
Albion,2977,5,13,12,11,53,48,5,51
Peterhead,2977,6,15,5,16,52,54,-2,50
East Fife,2977,7,14,6,16,65,57,8,48
Stranraer,2977,8,12,4,20,53,73,-20,40
Queen's Park,2977,9,11,3,22,34,61,-27,36
Stenhousem'r,2977,10,10,5,21,50,81,-31,35
Livingston,2978,1,25,3,8,92,41,51,78
Alloa,2978,2,22,5,9,70,40,30,71
Airdrieon,2978,3,18,6,12,58,54,4,60
Brechin,2978,4,18,4,14,47,48,-1,58
Peterhead,2978,5,17,4,15,56,49,7,55
Albion,2978,6,14,8,14,48,47,1,50
East Fife,2978,7,12,8,16,47,55,-8,44
Queen's Park,2978,8,11,5,20,35,57,-22,38
Stranraer,2978,9,10,4,22,48,66,-18,34
Stenhousem'r,2978,10,7,5,24,39,83,-44,26
Livingston,2979,1,23,4,9,81,50,31,73
Airdrieon,2979,2,17,8,11,68,55,13,59
Alloa,2979,3,16,10,10,58,41,17,58
Brechin,2979,4,14,10,12,42,41,1,52
Peterhead,2979,5,13,10,13,55,56,-1,49
Queen's Park,2979,6,13,8,15,39,48,-9,47
Albion,2979,7,13,7,16,52,63,-11,46
Stranraer,2979,8,11,9,16,40,52,-12,42
East Fife,2979,9,11,8,17,45,42,3,41
Stenhousem'r,2979,10,7,10,19,47,79,-32,31
Alloa,2980,1,21,6,9,68,40,28,69
Livingston,2980,2,21,4,11,84,52,32,67
Airdrieon,2980,3,17,8,11,60,63,-3,59
Brechin,2980,4,17,6,13,49,44,5,57
Queen's Park,2980,5,15,9,12,42,42,0,54
Albion,2980,6,15,7,14,62,53,9,52
Stranraer,2980,7,16,4,16,61,67,-6,52
Peterhead,2980,8,12,11,13,51,59,-8,47
East Fife,2980,9,8,8,20,52,68,-16,32
Stenhousem'r,2980,10,4,5,27,49,90,-41,17
Livingston,2981,1,22,5,9,83,48,35,71
Alloa,2981,2,19,8,9,69,42,27,65
Airdrieon,2981,3,16,7,13,57,57,0,55
Stranraer,2981,4,13,8,15,53,58,-5,47
Albion,2981,5,12,9,15,54,57,-3,45
Stenhousem'r,2981,6,12,9,15,53,73,-20,45
Peterhead,2981,7,12,8,16,45,55,-10,44
East Fife,2981,8,11,10,15,46,47,-1,43
Brechin,2981,9,11,9,16,40,48,-8,42
Queen's Park,2981,10,11,9,16,36,51,-15,42
Alloa,2982,1,21,6,9,76,41,35,69
Livingston,2982,2,21,4,11,83,53,30,67
Airdrieon,2982,3,17,8,11,64,54,10,59
Brechin,2982,4,15,10,11,52,48,4,55
Stranraer,2982,5,16,5,15,51,53,-2,53
Albion,2982,6,14,9,13,55,56,-1,51
East Fife,2982,7,13,9,14,51,47,4,48
Queen's Park,2982,8,13,6,17,40,52,-12,45
Peterhead,2982,9,10,9,17,53,64,-11,39
Stenhousem'r,2982,10,4,6,26,40,97,-57,18
Livingston,2983,1,21,5,10,68,45,23,68
Airdrieon,2983,2,18,8,10,64,54,10,62
Alloa,2983,3,16,8,12,64,47,17,56
Peterhead,2983,4,16,6,14,49,47,2,54
Brechin,2983,5,15,8,13,49,50,-1,53
East Fife,2983,6,12,11,13,54,47,7,47
Albion,2983,7,13,8,15,52,55,-3,47
Queen's Park,2983,8,13,6,17,30,42,-12,45
Stenhousem'r,2983,9,11,8,17,48,68,-20,41
Stranraer,2983,10,9,4,23,41,64,-23,31
Alloa,2984,1,19,9,8,78,46,32,66
Brechin,2984,2,18,5,13,54,49,5,59
Livingston,2984,3,17,6,13,69,51,18,57
Albion,2984,4,16,9,11,51,43,8,57
Airdrieon,2984,5,16,8,12,62,57,5,56
Peterhead,2984,6,13,9,14,50,52,-2,48
Stranraer,2984,7,13,4,19,54,66,-12,43
Stenhousem'r,2984,8,11,8,17,44,69,-25,41
Queen's Park,2984,9,9,11,16,33,52,-19,38
East Fife,2984,10,9,9,18,42,52,-10,36
Livingston,2985,1,22,4,10,75,45,30,70
Airdrieon,2985,2,18,7,11,63,57,6,61
Brechin,2985,3,17,7,12,62,52,10,58
Peterhead,2985,4,14,11,11,55,47,8,53
Alloa,2985,5,15,8,13,64,58,6,53
Queen's Park,2985,6,13,8,15,49,58,-9,47
Stranraer,2985,7,14,4,18,54,57,-3,46
Albion,2985,8,11,11,14,56,68,-12,44
Stenhousem'r,2985,9,10,7,19,54,77,-23,37
East Fife,2985,10,9,7,20,53,66,-13,34
Alloa,2986,1,24,6,6,83,41,42,78
Livingston,2986,2,24,1,11,75,46,29,73
Brechin,2986,3,17,6,13,57,53,4,57
Albion,2986,4,15,7,14,56,50,6,52
Peterhead,2986,5,14,7,15,44,44,0,49
Stranraer,2986,6,15,4,17,55,58,-3,49
Airdrieon,2986,7,14,6,16,56,53,3,48
Stenhousem'r,2986,8,10,7,19,38,67,-29,37
East Fife,2986,9,10,6,20,45,65,-20,36
Queen's Park,2986,10,10,4,22,29,61,-32,34
Livingston,2987,1,21,5,10,86,53,33,68
Alloa,2987,2,20,4,12,78,44,34,64
Brechin,2987,3,18,5,13,53,43,10,59
Albion,2987,4,16,9,11,58,48,10,57
Queen's Park,2987,5,15,5,16,38,48,-10,50
Airdrieon,2987,6,15,4,17,62,68,-6,49
Peterhead,2987,7,12,11,13,47,59,-12,47
Stranraer,2987,8,13,7,16,43,56,-13,46
East Fife,2987,9,10,10,16,50,53,-3,40
Stenhousem'r,2987,10,6,8,22,40,83,-43,26
Alloa,2988,1,16,12,8,65,45,20,60
Livingston,2988,2,18,6,12,74,56,18,60
Airdrieon,2988,3,17,8,11,75,59,16,59
Stranraer,2988,4,16,8,12,65,54,11,56
Brechin,2988,5,15,9,12,47,51,-4,54
Albion,2988,6,13,10,13,55,53,2,49
Queen's Park,2988,7,13,9,14,39,46,-7,48
East Fife,2988,8,11,10,15,52,55,-3,43
Stenhousem'r,2988,9,8,11,17,49,74,-25,35
Peterhead,2988,10,6,11,19,33,61,-28,29
Livingston,2989,1,28,2,6,95,42,53,86
Alloa,2989,2,16,11,9,67,51,16,59
Peterhead,2989,3,17,4,15,59,50,9,55
Albion,2989,4,16,6,14,60,55,5,54
Airdrieon,2989,5,15,6,15,56,57,-1,51
East Fife,2989,6,14,6,16,53,45,8,48
Brechin,2989,7,14,6,16,39,42,-3,48
Queen's Park,2989,8,13,5,18,46,66,-20,44
Stranraer,2989,9,12,5,19,43,67,-24,41
Stenhousem'r,2989,10,8,3,25,43,86,-43,27
Livingston,2990,1,25,3,8,87,38,49,78
Airdrieon,2990,2,21,4,11,68,50,18,67
Alloa,2990,3,18,8,10,65,49,16,62
Brechin,2990,4,16,6,14,52,52,0,54
Albion,2990,5,13,10,13,62,60,2,49
East Fife,2990,6,12,9,15,55,57,-2,45
Queen's Park,2990,7,13,6,17,38,51,-13,45
Peterhead,2990,8,10,8,18,45,64,-19,38
Stranraer,2990,9,10,6,20,45,65,-20,36
Stenhousem'r,2990,10,9,6,21,43,74,-31,33
Alloa,2991,1,20,7,9,68,38,30,67
Livingston,2991,2,18,10,8,72,46,26,64
Albion,2991,3,17,9,10,60,47,13,60
Airdrieon,2991,4,17,6,13,62,57,5,57
Brechin,2991,5,17,6,13,49,45,4,57
Stranraer,2991,6,14,9,13,50,46,4,51
East Fife,2991,7,11,8,17,43,52,-9,41
Peterhead,2991,8,10,8,18,40,58,-18,38
Stenhousem'r,2991,9,9,10,17,43,65,-22,37
Queen's Park,2991,10,7,7,22,33,66,-33,28
Alloa,2992,1,21,8,7,75,34,41,71
Livingston,2992,2,21,7,8,86,46,40,70
Brechin,2992,3,18,8,10,58,46,12,62
Airdrieon,2992,4,18,8,10,60,50,10,62
Albion,2992,5,12,8,16,52,58,-6,44
Peterhead,2992,6,11,9,16,42,59,-17,42
Stranraer,2992,7,10,10,16,43,55,-12,40
East Fife,2992,8,9,12,15,48,49,-1,39
Queen's Park,2992,9,9,11,16,36,56,-20,38
Stenhousem'r,2992,10,7,7,22,43,90,-47,28
Airdrieon,2993,1,21,8,7,71,53,18,71
Livingston,2993,2,21,4,11,85,55,30,67
Alloa,2993,3,18,6,12,62,51,11,60
Brechin,2993,4,18,5,13,58,52,6,59
Peterhead,2993,5,14,10,12,57,54,3,52
Albion,2993,6,15,7,14,51,49,2,52
Stranraer,2993,7,16,2,18,62,60,2,50
Queen's Park,2993,8,11,6,19,41,69,-28,39
East Fife,2993,9,9,10,17,51,55,-4,37
Stenhousem'r,2993,10,4,8,24,42,82,-40,20
Livingston,2994,1,22,4,10,78,47,31,70
Airdrieon,2994,2,19,8,9,68,61,7,65
Alloa,2994,3,19,7,10,77,53,24,64
Peterhead,2994,4,16,8,12,55,46,9,56
Brechin,2994,5,17,3,16,59,57,2,54
Queen's Park,2994,6,14,6,16,39,46,-7,48
Albion,2994,7,12,8,16,48,63,-15,44
East Fife,2994,8,11,9,16,43,48,-5,42
Stranraer,2994,9,10,7,19,45,57,-12,37
Stenhousem'r,2994,10,6,8,22,45,79,-34,26
Livingston,2995,1,22,5,9,81,49,32,71
Alloa,2995,2,20,7,9,66,42,24,67
Airdrieon,2995,3,16,9,11,65,59,6,57
Peterhead,2995,4,16,7,13,50,46,4,55
Brechin,2995,5,14,8,14,52,57,-5,50
Albion,2995,6,14,7,15,52,52,0,49
Stenhousem'r,2995,7,13,7,16,52,66,-14,46
Stranraer,2995,8,11,7,18,46,57,-11,40
East Fife,2995,9,8,14,14,50,53,-3,38
Queen's Park,2995,10,7,7,22,30,63,-33,28
Alloa,2996,1,21,7,8,83,44,39,70
Livingston,2996,2,20,5,11,72,46,26,65
Brechin,2996,3,17,8,11,50,44,6,59
Peterhead,2996,4,16,7,13,60,54,6,55
East Fife,2996,5,13,13,10,54,47,7,52
Albion,2996,6,14,9,13,60,46,14,51
Airdrieon,2996,7,16,3,17,66,76,-10,51
Stranraer,2996,8,11,7,18,52,66,-14,40
Queen's Park,2996,9,11,3,22,32,61,-29,36
Stenhousem'r,2996,10,7,6,23,44,89,-45,27
Brechin,2997,1,15,11,10,56,48,8,56
Alloa,2997,2,15,10,11,52,45,7,55
Airdrieon,2997,3,15,10,11,53,49,4,55
East Fife,2997,4,14,9,13,58,54,4,51
Peterhead,2997,5,15,6,15,59,58,1,51
Livingston,2997,6,14,8,14,72,59,13,50
Stranraer,2997,7,14,8,14,53,49,4,50
Albion,2997,8,13,9,14,47,51,-4,48
Queen's Park,2997,9,11,8,17,30,45,-15,41
Stenhousem'r,2997,10,11,7,18,48,70,-22,40
Livingston,2998,1,21,3,12,80,54,26,66
Alloa,2998,2,19,8,9,64,43,21,65
Airdrieon,2998,3,20,4,12,57,47,10,64
Brechin,2998,4,17,6,13,50,45,5,57
Stranraer,2998,5,15,8,13,60,54,6,53
East Fife,2998,6,12,8,16,47,43,4,44
Queen's Park,2998,7,12,6,18,35,54,-19,42
Peterhead,2998,8,10,9,17,47,59,-12,39
Stenhousem'r,2998,9,11,6,19,49,75,-26,39
Albion,2998,10,10,8,18,43,58,-15,38
Livingston,2999,1,24,3,9,80,44,36,75
Alloa,2999,2,19,7,10,66,43,23,64
Brechin,2999,3,17,10,9,46,36,10,61
Airdrieon,2999,4,16,7,13,54,56,-2,55
Albion,2999,5,13,12,11,57,42,15,51
Queen's Park,2999,6,12,7,17,37,51,-14,43
Peterhead,2999,7,12,6,18,41,57,-16,42
Stranraer,2999,8,12,3,21,56,75,-19,39
East Fife,2999,9,10,8,18,49,52,-3,38
Stenhousem'r,2999,10,10,7,19,52,82,-30,37
Livingston,3000,1,23,5,8,81,38,43,74
Brechin,3000,2,21,6,9,60,37,23,69
Alloa,3000,3,15,11,10,73,53,20,56
Airdrieon,3000,4,16,6,14,62,59,3,54
Stranraer,3000,5,15,8,13,51,54,-3,53
Peterhead,3000,6,14,7,15,52,55,-3,49
Albion,3000,7,13,7,16,48,59,-11,46
East Fife,3000,8,11,11,14,51,53,-2,44
Queen's Park,3000,9,9,6,21,34,60,-26,33
Stenhousem'r,3000,10,6,7,23,38,82,-44,25
Livingston,3001,1,17,8,11,68,48,20,59
Alloa,3001,2,15,10,11,65,46,19,55
Airdrieon,3001,3,16,6,14,52,55,-3,54
Peterhead,3001,4,15,8,13,54,42,12,53
Albion,3001,5,14,11,11,44,42,2,53
Stranraer,3001,6,15,7,14,54,49,5,52
Brechin,3001,7,14,8,14,55,56,-1,50
Queen's Park,3001,8,14,7,15,33,47,-14,49
Stenhousem'r,3001,9,10,8,18,42,72,-30,38
East Fife,3001,10,9,9,18,42,52,-10,36
Livingston,3002,1,23,4,9,76,45,31,73
Alloa,3002,2,20,6,10,76,41,35,66
Albion,3002,3,17,8,11,57,50,7,59
Airdrieon,3002,4,17,8,11,57,52,5,59
Peterhead,3002,5,14,7,15,49,46,3,49
Brechin,3002,6,13,9,14,42,54,-12,48
Queen's Park,3002,7,11,10,15,37,54,-17,43
Stranraer,3002,8,11,9,16,47,54,-7,42
Stenhousem'r,3002,9,9,7,20,48,78,-30,34
East Fife,3002,10,6,10,20,34,49,-15,28
Livingston,3003,1,23,5,8,76,40,36,74
Alloa,3003,2,19,8,9,70,42,28,65
Airdrieon,3003,3,19,5,12,65,61,4,62
Brechin,3003,4,18,5,13,58,49,9,59
Stranraer,3003,5,15,3,18,55,55,0,48
Albion,3003,6,12,10,14,55,58,-3,46
Peterhead,3003,7,12,8,16,39,45,-6,44
Queen's Park,3003,8,12,8,16,37,58,-21,44
East Fife,3003,9,9,13,14,47,53,-6,40
Stenhousem'r,3003,10,6,5,25,47,88,-41,23
Livingston,3004,1,25,2,9,76,40,36,77
Airdrieon,3004,2,22,6,8,77,51,26,72
Alloa,3004,3,20,7,9,83,49,34,67
Albion,3004,4,16,5,15,53,53,0,53
Peterhead,3004,5,15,7,14,59,59,0,52
Brechin,3004,6,13,7,16,53,61,-8,46
East Fife,3004,7,12,8,16,46,53,-7,44
Stranraer,3004,8,12,3,21,50,62,-12,39
Queen's Park,3004,9,11,5,20,41,63,-22,38
Stenhousem'r,3004,10,7,4,25,47,94,-47,25
Airdrieon,3005,1,20,6,10,75,57,18,66
Livingston,3005,2,19,3,14,79,63,16,60
Queen's Park,3005,3,18,5,13,59,46,13,59
Alloa,3005,4,17,7,12,69,46,23,58
Albion,3005,5,16,6,14,52,53,-1,54
Brechin,3005,6,14,9,13,53,56,-3,51
East Fife,3005,7,13,9,14,49,48,1,48
Stranraer,3005,8,13,6,17,54,60,-6,45
Peterhead,3005,9,11,7,18,44,56,-12,40
Stenhousem'r,3005,10,8,4,24,46,95,-49,28
Brechin,3006,1,18,8,10,55,45,10,62
Alloa,3006,2,16,12,8,74,51,23,60
Livingston,3006,3,18,5,13,79,53,26,59
Airdrieon,3006,4,15,12,9,56,46,10,57
Peterhead,3006,5,13,12,11,53,51,2,51
East Fife,3006,6,12,11,13,46,52,-6,47
Albion,3006,7,11,13,12,47,54,-7,46
Stenhousem'r,3006,8,13,6,17,61,81,-20,45
Stranraer,3006,9,10,5,21,46,55,-9,35
Queen's Park,3006,10,7,10,19,25,54,-29,31
Alloa,3007,1,21,7,8,64,36,28,70
Livingston,3007,2,18,6,12,83,59,24,60
Airdrieon,3007,3,17,7,12,59,49,10,58
Brechin,3007,4,17,4,15,54,52,2,55
Peterhead,3007,5,14,9,13,46,47,-1,51
Albion,3007,6,13,11,12,57,54,3,50
Stranraer,3007,7,14,5,17,57,60,-3,47
East Fife,3007,8,10,10,16,45,49,-4,40
Queen's Park,3007,9,10,9,17,36,63,-27,39
Stenhousem'r,3007,10,7,10,19,52,84,-32,31
Alloa,3008,1,19,8,9,70,51,19,65
Livingston,3008,2,18,7,11,64,44,20,61
Brechin,3008,3,18,4,14,52,44,8,58
Airdrieon,3008,4,16,9,11,59,51,8,57
East Fife,3008,5,15,6,15,53,50,3,51
Stranraer,3008,6,15,5,16,52,58,-6,50
Albion,3008,7,12,12,12,47,44,3,48
Queen's Park,3008,8,11,10,15,41,48,-7,43
Peterhead,3008,9,11,8,17,43,47,-4,41
Stenhousem'r,3008,10,6,9,21,44,88,-44,27
Alloa,3009,1,21,7,8,75,42,33,70
Livingston,3009,2,21,5,10,88,58,30,68
Airdrieon,3009,3,19,5,12,62,49,13,62
Brechin,3009,4,15,7,14,49,50,-1,52
Albion,3009,5,13,10,13,57,57,0,49
Peterhead,3009,6,12,11,13,47,51,-4,47
Queen's Park,3009,7,12,5,19,37,52,-15,41
East Fife,3009,8,10,10,16,44,57,-13,40
Stranraer,3009,9,10,10,16,41,55,-14,40
Stenhousem'r,3009,10,8,8,20,54,83,-29,32
Livingston,3010,1,19,6,11,80,59,21,63
Peterhead,3010,2,19,6,11,64,49,15,63
Alloa,3010,3,17,10,9,69,43,26,61
Airdrieon,3010,4,15,8,13,60,59,1,53
Brechin,3010,5,15,6,15,48,56,-8,51
Stranraer,3010,6,14,5,17,49,53,-4,47
Queen's Park,3010,7,13,8,15,34,48,-14,47
Albion,3010,8,11,9,16,51,64,-13,42
Stenhousem'r,3010,9,7,15,14,46,64,-18,36
East Fife,3010,10,8,11,17,43,49,-6,35
Alloa,3011,1,21,7,8,74,45,29,70
Albion,3011,2,19,7,10,65,50,15,64
Stranraer,3011,3,18,2,16,58,61,-3,56
Airdrieon,3011,4,16,7,13,61,53,8,55
Brechin,3011,5,16,7,13,53,49,4,55
Livingston,3011,6,17,3,16,65,52,13,54
Peterhead,3011,7,15,7,14,57,57,0,52
East Fife,3011,8,10,10,16,51,55,-4,40
Queen's Park,3011,9,9,9,18,39,65,-26,36
Stenhousem'r,3011,10,7,5,24,47,83,-36,26
Livingston,3012,1,21,4,11,79,54,25,67
Alloa,3012,2,20,5,11,69,46,23,65
Brechin,3012,3,19,8,9,57,37,20,65
Airdrieon,3012,4,16,7,13,62,53,9,55
Albion,3012,5,15,8,13,59,56,3,53
Peterhead,3012,6,14,6,16,50,49,1,48
Stranraer,3012,7,13,7,16,49,54,-5,46
East Fife,3012,8,12,7,17,42,50,-8,43
Queen's Park,3012,9,10,6,20,34,60,-26,36
Stenhousem'r,3012,10,8,6,22,47,89,-42,30
Livingston,3013,1,25,3,8,82,40,42,78
Peterhead,3013,2,21,5,10,66,52,14,68
Alloa,3013,3,19,8,9,78,48,30,65
Brechin,3013,4,17,7,12,49,56,-7,58
Airdrieon,3013,5,14,7,15,59,54,5,49
Stranraer,3013,6,13,7,16,52,57,-5,46
Queen's Park,3013,7,13,7,16,44,54,-10,46
Albion,3013,8,11,7,18,47,58,-11,40
Stenhousem'r,3013,9,7,8,21,44,76,-32,29
East Fife,3013,10,6,9,21,36,62,-26,27
Livingston,3014,1,21,4,11,79,39,40,67
Brechin,3014,2,18,7,11,49,44,5,61
Airdrieon,3014,3,18,6,12,61,53,8,60
East Fife,3014,4,15,10,11,55,52,3,55
Albion,3014,5,15,9,12,55,52,3,54
Alloa,3014,6,14,10,12,63,44,19,52
Peterhead,3014,7,14,8,14,49,47,2,50
Stranraer,3014,8,10,7,19,42,60,-18,37
Queen's Park,3014,9,10,7,19,35,56,-21,37
Stenhousem'r,3014,10,8,6,22,51,92,-41,30
Brechin,3015,1,20,5,11,51,45,6,65
Livingston,3015,2,20,4,12,77,54,23,64
Peterhead,3015,3,16,11,9,54,43,11,59
Stranraer,3015,4,17,5,14,57,51,6,56
Airdrieon,3015,5,14,9,13,53,50,3,51
Alloa,3015,6,13,8,15,62,56,6,47
Albion,3015,7,11,13,12,49,48,1,46
East Fife,3015,8,11,10,15,50,46,4,43
Queen's Park,3015,9,13,4,19,39,61,-22,43
Stenhousem'r,3015,10,8,5,23,44,82,-38,29
Livingston,3016,1,20,4,12,73,51,22,64
Alloa,3016,2,18,9,9,71,41,30,63
Airdrieon,3016,3,18,7,11,66,53,13,61
Brechin,3016,4,17,8,11,52,50,2,59
Albion,3016,5,14,10,12,58,56,2,52
Peterhead,3016,6,11,10,15,44,58,-14,43
East Fife,3016,7,10,12,14,45,50,-5,42
Stranraer,3016,8,10,11,15,53,58,-5,41
Queen's Park,3016,9,10,8,18,41,59,-18,38
Stenhousem'r,3016,10,8,9,19,52,79,-27,33
Airdrieon,3017,1,19,7,10,55,46,9,64
Livingston,3017,2,18,9,9,79,52,27,63
Alloa,3017,3,17,7,12,62,45,17,58
Albion,3017,4,14,10,12,44,38,6,52
Peterhead,3017,5,13,13,10,47,50,-3,52
Queen's Park,3017,6,15,6,15,35,38,-3,51
Brechin,3017,7,14,7,15,50,53,-3,49
East Fife,3017,8,10,13,13,41,44,-3,43
Stranraer,3017,9,10,11,15,56,69,-13,41
Stenhousem'r,3017,10,4,9,23,43,77,-34,21
Alloa,3018,1,19,8,9,79,54,25,65
Livingston,3018,2,19,5,12,67,46,21,62
Brechin,3018,3,16,10,10,57,48,9,58
Airdrieon,3018,4,15,9,12,53,54,-1,54
Peterhead,3018,5,14,10,12,48,45,3,52
East Fife,3018,6,12,13,11,52,43,9,49
Albion,3018,7,13,9,14,54,50,4,48
Stranraer,3018,8,12,6,18,56,67,-11,42
Stenhousem'r,3018,9,7,12,17,44,67,-23,33
Queen's Park,3018,10,7,10,19,24,60,-36,31
Livingston,3019,1,23,3,10,85,51,34,72
Queen's Park,3019,2,20,3,13,49,46,3,63
Alloa,3019,3,17,8,11,68,50,18,59
East Fife,3019,4,14,12,10,55,38,17,54
Albion,3019,5,14,10,12,52,42,10,52
Airdrieon,3019,6,14,9,13,53,56,-3,51
Brechin,3019,7,13,6,17,56,58,-2,45
Peterhead,3019,8,13,6,17,46,64,-18,45
Stranraer,3019,9,11,6,19,55,69,-14,39
Stenhousem'r,3019,10,6,7,23,34,79,-45,25
Airdrieon,3020,1,20,5,11,59,49,10,65
Brechin,3020,2,18,7,11,50,49,1,61
Livingston,3020,3,19,3,14,81,57,24,60
Alloa,3020,4,16,10,10,71,50,21,58
Peterhead,3020,5,15,6,15,58,54,4,51
East Fife,3020,6,13,8,15,49,47,2,47
Albion,3020,7,13,8,15,57,59,-2,47
Stranraer,3020,8,13,6,17,59,63,-4,45
Queen's Park,3020,9,11,11,14,36,49,-13,44
Stenhousem'r,3020,10,6,8,22,41,84,-43,26
Brechin,3021,1,21,5,10,58,41,17,68
Livingston,3021,2,19,6,11,71,53,18,63
Alloa,3021,3,19,6,11,65,48,17,63
Airdrieon,3021,4,17,6,13,61,50,11,57
Peterhead,3021,5,15,9,12,49,43,6,54
Stranraer,3021,6,15,5,16,50,52,-2,50
Queen's Park,3021,7,13,6,17,40,56,-16,45
East Fife,3021,8,11,10,15,55,52,3,43
Albion,3021,9,9,9,18,43,60,-17,36
Stenhousem'r,3021,10,8,4,24,43,80,-37,28
Brechin,3022,1,22,2,12,50,35,15,68
Livingston,3022,2,21,2,13,69,54,15,65
Alloa,3022,3,16,10,10,63,40,23,58
Airdrieon,3022,4,18,3,15,51,50,1,57
Stranraer,3022,5,17,3,16,48,45,3,54
Queen's Park,3022,6,14,7,15,41,43,-2,49
Albion,3022,7,13,6,17,53,57,-4,45
Peterhead,3022,8,13,5,18,41,57,-16,44
East Fife,3022,9,9,11,16,49,48,1,38
Stenhousem'r,3022,10,10,5,21,45,81,-36,35
Livingston,3023,1,21,8,7,71,36,35,71
Airdrieon,3023,2,18,8,10,61,52,9,62
Peterhead,3023,3,16,7,13,52,47,5,55
Albion,3023,4,16,6,14,54,51,3,54
Brechin,3023,5,15,8,13,46,50,-4,53
Alloa,3023,6,13,11,12,62,47,15,50
Stranraer,3023,7,12,7,17,48,55,-7,43
Queen's Park,3023,8,11,7,18,39,54,-15,40
East Fife,3023,9,10,7,19,48,61,-13,37
Stenhousem'r,3023,10,9,9,18,51,79,-28,36
Livingston,3024,1,23,4,9,70,41,29,73
Alloa,3024,2,20,3,13,71,49,22,63
Brechin,3024,3,20,3,13,54,45,9,63
Airdrieon,3024,4,17,8,11,64,55,9,59
Peterhead,3024,5,16,4,16,48,51,-3,52
East Fife,3024,6,13,8,15,60,58,2,47
Albion,3024,7,11,12,13,56,61,-5,45
Queen's Park,3024,8,13,5,18,47,56,-9,44
Stranraer,3024,9,12,5,19,53,69,-16,41
Stenhousem'r,3024,10,5,8,23,46,84,-38,23
Alloa,3025,1,21,7,8,67,41,26,70
Livingston,3025,2,20,4,12,73,47,26,64
Albion,3025,3,17,7,12,56,51,5,58
Airdrieon,3025,4,16,7,13,55,52,3,55
Peterhead,3025,5,14,10,12,44,47,-3,52
Brechin,3025,6,14,9,13,50,47,3,51
East Fife,3025,7,14,8,14,52,36,16,50
Queen's Park,3025,8,11,9,16,47,60,-13,42
Stranraer,3025,9,12,6,18,49,64,-15,42
Stenhousem'r,3025,10,4,7,25,40,88,-48,19
Airdrieon,3026,1,22,6,8,66,40,26,72
Alloa,3026,2,18,9,9,62,40,22,63
East Fife,3026,3,16,9,11,53,50,3,57
Albion,3026,4,16,6,14,56,46,10,54
Brechin,3026,5,15,6,15,54,51,3,51
Livingston,3026,6,15,5,16,68,64,4,50
Peterhead,3026,7,14,6,16,52,55,-3,48
Stranraer,3026,8,14,4,18,49,55,-6,46
Queen's Park,3026,9,10,8,18,40,60,-20,38
Stenhousem'r,3026,10,7,7,22,48,87,-39,28
Alloa,3027,1,21,8,7,78,43,35,71
Livingston,3027,2,19,5,12,66,49,17,62
Airdrieon,3027,3,15,12,9,53,44,9,57
Stranraer,3027,4,16,6,14,52,57,-5,54
Albion,3027,5,15,8,13,57,49,8,53
East Fife,3027,6,13,11,12,47,46,1,50
Brechin,3027,7,14,7,15,54,52,2,49
Queen's Park,3027,8,10,9,17,38,56,-18,39
Peterhead,3027,9,11,5,20,40,59,-19,38
Stenhousem'r,3027,10,7,7,22,47,77,-30,28
Livingston,3028,1,23,6,7,79,39,40,75
Alloa,3028,2,19,6,11,71,46,25,63
Airdrieon,3028,3,19,5,12,69,50,19,62
Brechin,3028,4,14,11,11,44,40,4,53
Peterhead,3028,5,14,10,12,52,48,4,52
Albion,3028,6,13,10,13,53,56,-3,49
East Fife,3028,7,12,10,14,54,53,1,46
Queen's Park,3028,8,11,9,16,39,52,-13,42
Stranraer,3028,9,8,9,19,41,67,-26,33
Stenhousem'r,3028,10,5,8,23,47,98,-51,23
Livingston,3029,1,20,8,8,69,41,28,68
Stranraer,3029,2,18,5,13,53,46,7,59
Alloa,3029,3,16,8,12,67,44,23,56
Brechin,3029,4,15,9,12,47,46,1,54
Airdrieon,3029,5,15,9,12,53,56,-3,54
East Fife,3029,6,13,11,12,48,42,6,50
Albion,3029,7,11,12,13,47,49,-2,45
Peterhead,3029,8,12,7,17,48,61,-13,43
Queen's Park,3029,9,10,9,17,28,43,-15,39
Stenhousem'r,3029,10,7,8,21,48,80,-32,29
Livingston,3030,1,21,4,11,75,43,32,67
Brechin,3030,2,20,5,11,51,44,7,65
Alloa,3030,3,18,8,10,77,48,29,62
Airdrieon,3030,4,18,7,11,60,57,3,61
Albion,3030,5,14,9,13,57,53,4,51
East Fife,3030,6,11,11,14,47,49,-2,44
Queen's Park,3030,7,13,5,18,39,56,-17,44
Stranraer,3030,8,13,4,19,57,62,-5,43
Peterhead,3030,9,12,7,17,46,60,-14,43
Stenhousem'r,3030,10,6,8,22,50,87,-37,26
Alloa,3031,1,20,8,8,71,42,29,68
Livingston,3031,2,20,4,12,66,53,13,64
Airdrieon,3031,3,19,7,10,65,53,12,64
Brechin,3031,4,18,7,11,50,43,7,61
Peterhead,3031,5,15,6,15,57,52,5,51
Stranraer,3031,6,14,5,17,48,56,-8,47
Queen's Park,3031,7,12,4,20,33,55,-22,40
Albion,3031,8,10,9,17,38,52,-14,39
Stenhousem'r,3031,9,9,10,17,49,66,-17,37
East Fife,3031,10,9,8,19,43,48,-5,35
Alloa,3032,1,18,9,9,73,44,29,63
Airdrieon,3032,2,18,9,9,62,56,6,63
Brechin,3032,3,18,8,10,59,47,12,62
Livingston,3032,4,17,10,9,64,42,22,61
Peterhead,3032,5,14,7,15,57,58,-1,49
Albion,3032,6,14,6,16,54,51,3,48
Queen's Park,3032,7,13,5,18,45,66,-21,44
Stranraer,3032,8,11,9,16,52,58,-6,42
East Fife,3032,9,8,12,16,50,61,-11,36
Stenhousem'r,3032,10,8,7,21,46,79,-33,31
Livingston,3033,1,23,6,7,81,40,41,75
Alloa,3033,2,19,7,10,65,42,23,64
East Fife,3033,3,16,10,10,61,37,24,58
Airdrieon,3033,4,14,8,14,60,61,-1,50
Brechin,3033,5,15,5,16,47,53,-6,50
Queen's Park,3033,6,15,5,16,44,54,-10,50
Peterhead,3033,7,13,8,15,42,50,-8,47
Albion,3033,8,12,8,16,48,54,-6,44
Stenhousem'r,3033,9,8,10,18,42,76,-34,34
Stranraer,3033,10,9,5,22,37,60,-23,32
Livingston,3034,1,23,3,10,78,46,32,72
Alloa,3034,2,21,7,8,83,40,43,70
Airdrieon,3034,3,19,6,11,69,63,6,63
Peterhead,3034,4,16,7,13,53,45,8,55
East Fife,3034,5,13,9,14,51,47,4,48
Queen's Park,3034,6,13,8,15,36,48,-12,47
Brechin,3034,7,13,5,18,47,60,-13,44
Albion,3034,8,11,6,19,43,61,-18,39
Stranraer,3034,9,10,6,20,48,67,-19,36
Stenhousem'r,3034,10,9,7,20,47,78,-31,34
Alloa,3035,1,22,6,8,65,40,25,72
Airdrieon,3035,2,18,5,13,62,56,6,59
Livingston,3035,3,18,4,14,70,51,19,58
Brechin,3035,4,15,8,13,47,48,-1,53
Albion,3035,5,14,10,12,47,44,3,52
Peterhead,3035,6,13,8,15,53,55,-2,47
Queen's Park,3035,7,12,9,15,44,52,-8,45
East Fife,3035,8,10,12,14,50,50,0,42
Stranraer,3035,9,11,6,19,56,65,-9,39
Stenhousem'r,3035,10,8,10,18,42,75,-33,34
Livingston,3036,1,19,2,15,74,54,20,59
Airdrieon,3036,2,16,8,12,58,53,5,56
Peterhead,3036,3,14,11,11,51,45,6,53
Alloa,3036,4,14,8,14,56,49,7,50
Stenhousem'r,3036,5,15,5,16,52,69,-17,50
Stranraer,3036,6,14,6,16,60,63,-3,48
East Fife,3036,7,13,8,15,47,45,2,47
Brechin,3036,8,13,8,15,49,51,-2,47
Albion,3036,9,12,11,13,56,60,-4,47
Queen's Park,3036,10,12,9,15,34,48,-14,45
Alloa,3037,1,24,4,8,85,42,43,76
Airdrieon,3037,2,18,9,9,63,47,16,63
Livingston,3037,3,18,4,14,81,66,15,58
Brechin,3037,4,16,5,15,52,47,5,53
Peterhead,3037,5,15,8,13,52,50,2,53
Albion,3037,6,13,10,13,50,57,-7,49
Stranraer,3037,7,13,6,17,48,59,-11,45
Queen's Park,3037,8,12,5,19,35,55,-20,41
Stenhousem'r,3037,9,10,8,18,51,76,-25,38
East Fife,3037,10,8,7,21,40,58,-18,31
Livingston,3038,1,23,5,8,80,42,38,74
Brechin,3038,2,18,7,11,50,41,9,61
Alloa,3038,3,16,11,9,65,44,21,59
Airdrieon,3038,4,17,6,13,56,55,1,57
East Fife,3038,5,13,9,14,54,47,7,48
Peterhead,3038,6,13,9,14,54,62,-8,48
Albion,3038,7,12,7,17,49,62,-13,43
Queen's Park,3038,8,11,8,17,34,47,-13,41
Stranraer,3038,9,11,6,19,39,53,-14,39
Stenhousem'r,3038,10,8,8,20,42,70,-28,32
Livingston,3039,1,24,1,11,77,49,28,73
Alloa,3039,2,20,8,8,71,37,34,68
Airdrieon,3039,3,16,8,12,53,52,1,56
Peterhead,3039,4,15,8,13,51,45,6,53
Stranraer,3039,5,15,7,14,44,46,-2,52
East Fife,3039,6,13,9,14,48,47,1,48
Brechin,3039,7,14,6,16,47,54,-7,48
Queen's Park,3039,8,13,4,19,41,56,-15,43
Albion,3039,9,12,4,20,47,60,-13,40
Stenhousem'r,3039,10,6,9,21,38,71,-33,27
Livingston,3040,1,22,3,11,84,47,37,69
Airdrieon,3040,2,19,6,11,63,51,12,63
Brechin,3040,3,18,8,10,50,45,5,62
Alloa,3040,4,17,10,9,63,42,21,61
Peterhead,3040,5,15,6,15,49,56,-7,51
Albion,3040,6,13,8,15,49,52,-3,47
Stenhousem'r,3040,7,13,4,19,57,81,-24,43
East Fife,3040,8,10,8,18,50,58,-8,38
Queen's Park,3040,9,9,10,17,40,52,-12,37
Stranraer,3040,10,10,5,21,49,70,-21,35
Livingston,3041,1,21,5,10,83,49,34,68
Alloa,3041,2,19,8,9,73,51,22,65
Brechin,3041,3,18,6,12,51,38,13,60
Airdrieon,3041,4,16,7,13,63,64,-1,55
Peterhead,3041,5,14,8,14,50,49,1,50
East Fife,3041,6,13,7,16,57,49,8,46
Albion,3041,7,13,7,16,46,54,-8,46
Stranraer,3041,8,14,4,18,47,60,-13,46
Queen's Park,3041,9,11,5,20,33,61,-28,38
Stenhousem'r,3041,10,9,7,20,49,77,-28,34
Alloa,3042,1,20,10,6,83,41,42,70
Livingston,3042,2,22,4,10,78,43,35,70
Airdrieon,3042,3,18,6,12,64,56,8,60
Brechin,3042,4,16,8,12,57,47,10,56
Albion,3042,5,13,9,14,54,60,-6,48
East Fife,3042,6,13,8,15,51,46,5,47
Queen's Park,3042,7,13,7,16,44,62,-18,46
Stenhousem'r,3042,8,10,6,20,42,77,-35,36
Stranraer,3042,9,9,7,20,46,63,-17,34
Peterhead,3042,10,7,13,16,39,63,-24,34
Livingston,3043,1,21,6,9,69,45,24,69
Alloa,3043,2,19,10,7,68,45,23,67
Brechin,3043,3,17,6,13,47,46,1,57
Airdrieon,3043,4,15,6,15,67,62,5,51
Peterhead,3043,5,14,9,13,55,52,3,51
Albion,3043,6,13,7,16,49,49,0,46
Stenhousem'r,3043,7,12,8,16,54,70,-16,44
Stranraer,3043,8,12,5,19,41,56,-15,41
Queen's Park,3043,9,10,9,17,28,43,-15,39
East Fife,3043,10,10,8,18,46,56,-10,38
Livingston,3044,1,23,4,9,79,48,31,73
Brechin,3044,2,20,3,13,61,43,18,63
Airdrieon,3044,3,18,6,12,60,51,9,60
Albion,3044,4,17,7,12,52,45,7,58
Alloa,3044,5,16,9,11,64,47,17,57
Stranraer,3044,6,15,4,17,53,52,1,49
Peterhead,3044,7,12,8,16,48,61,-13,44
Queen's Park,3044,8,11,5,20,35,62,-27,38
East Fife,3044,9,9,9,18,44,52,-8,36
Stenhousem'r,3044,10,7,9,20,43,78,-35,30
Airdrieon,3045,1,19,7,10,61,48,13,64
Livingston,3045,2,17,5,14,69,55,14,56
Alloa,3045,3,16,6,14,68,54,14,54
Queen's Park,3045,4,16,5,15,43,52,-9,53
Brechin,3045,5,15,7,14,49,46,3,52
Albion,3045,6,15,6,15,55,54,1,51
Stranraer,3045,7,15,5,16,58,60,-2,50
Peterhead,3045,8,13,9,14,49,51,-2,48
East Fife,3045,9,12,9,15,48,49,-1,45
Stenhousem'r,3045,10,9,7,20,47,78,-31,34
Livingston,3046,1,20,5,11,85,54,31,65
Alloa,3046,2,19,8,9,66,44,22,65
Albion,3046,3,14,11,11,56,49,7,53
Brechin,3046,4,16,5,15,46,48,-2,53
Airdrieon,3046,5,15,5,16,51,52,-1,50
Queen's Park,3046,6,13,10,13,48,53,-5,49
Peterhead,3046,7,13,9,14,55,57,-2,48
East Fife,3046,8,12,7,17,44,46,-2,43
Stranraer,3046,9,12,7,17,52,65,-13,43
Stenhousem'r,3046,10,9,7,20,53,88,-35,34
Livingston,3047,1,25,3,8,83,41,42,78
Alloa,3047,2,18,7,11,64,47,17,61
Airdrieon,3047,3,17,8,11,60,53,7,59
Peterhead,3047,4,16,8,12,59,47,12,56
Albion,3047,5,14,8,14,57,53,4,50
Brechin,3047,6,13,7,16,50,54,-4,46
East Fife,3047,7,11,9,16,51,58,-7,42
Stranraer,3047,8,10,8,18,47,59,-12,38
Stenhousem'r,3047,9,11,5,20,44,77,-33,38
Queen's Park,3047,10,9,9,18,27,53,-26,36
Livingston,3048,1,21,2,13,81,49,32,65
Brechin,3048,2,18,5,13,52,50,2,59
Alloa,3048,3,17,7,12,68,51,17,58
Airdrieon,3048,4,14,11,11,55,55,0,53
Queen's Park,3048,5,15,7,14,50,49,1,52
Albion,3048,6,14,9,13,51,47,4,51
East Fife,3048,7,14,6,16,54,48,6,48
Peterhead,3048,8,13,7,16,50,64,-14,46
Stranraer,3048,9,12,6,18,47,60,-13,42
Stenhousem'r,3048,10,10,4,22,46,81,-35,34
Alloa,3049,1,19,8,9,68,44,24,65
Airdrieon,3049,2,18,6,12,62,49,13,60
Livingston,3049,3,16,11,9,72,50,22,59
Brechin,3049,4,16,8,12,56,50,6,56
Peterhead,3049,5,15,9,12,51,49,2,54
Stranraer,3049,6,14,4,18,48,52,-4,46
Albion,3049,7,11,12,13,50,56,-6,45
East Fife,3049,8,10,12,14,51,49,2,42
Queen's Park,3049,9,9,8,19,29,58,-29,35
Stenhousem'r,3049,10,9,8,19,42,72,-30,35
Alloa,3050,1,21,7,8,69,37,32,70
Livingston,3050,2,21,5,10,79,49,30,68
Brechin,3050,3,17,6,13,61,53,8,57
Peterhead,3050,4,15,10,11,49,41,8,55
Albion,3050,5,14,10,12,63,57,6,52
Stranraer,3050,6,16,4,16,55,57,-2,52
Airdrieon,3050,7,15,6,15,52,51,1,51
Queen's Park,3050,8,12,4,20,38,67,-29,40
Stenhousem'r,3050,9,7,10,19,43,79,-36,31
East Fife,3050,10,6,10,20,39,57,-18,28
Alloa,3051,1,23,6,7,88,41,47,75
Brechin,3051,2,20,6,10,58,41,17,66
Livingston,3051,3,20,4,12,77,52,25,64
Airdrieon,3051,4,15,8,13,49,57,-8,53
Queen's Park,3051,5,14,7,15,38,52,-14,49
Peterhead,3051,6,14,6,16,45,51,-6,48
Albion,3051,7,13,7,16,52,50,2,46
East Fife,3051,8,12,8,16,53,46,7,44
Stranraer,3051,9,13,3,20,48,66,-18,42
Stenhousem'r,3051,10,6,5,25,45,97,-52,23
Livingston,3052,1,23,6,7,95,42,53,75
Alloa,3052,2,16,10,10,63,41,22,58
East Fife,3052,3,15,10,11,60,47,13,55
Albion,3052,4,16,6,14,49,49,0,54
Brechin,3052,5,15,5,16,52,53,-1,50
Airdrieon,3052,6,14,7,15,51,67,-16,49
Queen's Park,3052,7,12,12,12,39,51,-12,48
Peterhead,3052,8,13,7,16,48,53,-5,46
Stranraer,3052,9,13,3,20,49,67,-18,42
Stenhousem'r,3052,10,5,10,21,43,79,-36,25
Livingston,3053,1,24,3,9,82,47,35,75
Alloa,3053,2,20,9,7,77,46,31,69
Airdrieon,3053,3,15,13,8,54,45,9,58
Brechin,3053,4,17,4,15,49,49,0,55
Albion,3053,5,15,5,16,51,58,-7,50
Stranraer,3053,6,15,4,17,60,60,0,49
Queen's Park,3053,7,12,10,14,35,41,-6,46
East Fife,3053,8,11,9,16,52,59,-7,42
Peterhead,3053,9,9,11,16,47,64,-17,38
Stenhousem'r,3053,10,4,8,24,43,81,-38,20
Alloa,3054,1,23,5,8,69,39,30,74
Livingston,3054,2,20,7,9,81,53,28,67
Airdrieon,3054,3,17,5,14,56,47,9,56
Brechin,3054,4,16,6,14,50,48,2,54
Albion,3054,5,14,9,13,61,60,1,51
East Fife,3054,6,12,11,13,50,44,6,47
Stenhousem'r,3054,7,11,10,15,57,75,-18,43
Queen's Park,3054,8,11,7,18,29,47,-18,40
Peterhead,3054,9,9,11,16,38,53,-15,38
Stranraer,3054,10,9,5,22,41,66,-25,32
Livingston,3055,1,21,6,9,77,51,26,69
Airdrieon,3055,2,17,10,9,68,54,14,61
Alloa,3055,3,16,12,8,70,42,28,60
Peterhead,3055,4,16,8,12,66,55,11,56
Brechin,3055,5,16,5,15,55,54,1,53
Stranraer,3055,6,16,5,15,54,57,-3,53
Queen's Park,3055,7,12,9,15,41,55,-14,45
Albion,3055,8,12,8,16,45,55,-10,44
East Fife,3055,9,8,9,19,41,53,-12,33
Stenhousem'r,3055,10,7,6,23,39,80,-41,27
Livingston,3056,1,21,3,12,78,48,30,66
Alloa,3056,2,19,7,10,70,48,22,64
Brechin,3056,3,19,5,12,51,41,10,62
Airdrieon,3056,4,17,10,9,61,48,13,61
East Fife,3056,5,14,9,13,52,46,6,51
Stranraer,3056,6,15,5,16,50,54,-4,50
Albion,3056,7,13,9,14,51,53,-2,48
Queen's Park,3056,8,13,6,17,39,55,-16,45
Peterhead,3056,9,11,7,18,47,57,-10,40
Stenhousem'r,3056,10,5,5,26,40,89,-49,20
Brechin,3057,1,19,3,14,51,44,7,60
Alloa,3057,2,17,7,12,67,49,18,58
Airdrieon,3057,3,17,5,14,56,57,-1,56
Albion,3057,4,15,10,11,65,54,11,55
Livingston,3057,5,16,6,14,72,57,15,54
East Fife,3057,6,15,9,12,57,48,9,54
Stranraer,3057,7,16,4,16,55,52,3,52
Peterhead,3057,8,11,10,15,44,56,-12,43
Queen's Park,3057,9,11,9,16,35,53,-18,42
Stenhousem'r,3057,10,7,9,20,43,75,-32,30
Livingston,3058,1,24,3,9,84,46,38,75
Airdrieon,3058,2,20,5,11,70,53,17,65
Alloa,3058,3,17,8,11,67,50,17,59
Brechin,3058,4,16,8,12,49,46,3,56
Albion,3058,5,13,11,12,51,48,3,50
Stranraer,3058,6,12,9,15,48,55,-7,45
East Fife,3058,7,10,11,15,42,44,-2,41
Peterhead,3058,8,10,10,16,32,46,-14,40
Queen's Park,3058,9,10,6,20,29,52,-23,36
Stenhousem'r,3058,10,10,5,21,47,79,-32,35
Airdrieon,3059,1,19,8,9,64,52,12,65
Livingston,3059,2,19,4,13,66,47,19,61
Alloa,3059,3,16,10,10,66,46,20,58
Stranraer,3059,4,16,5,15,60,58,2,53
Brechin,3059,5,14,9,13,44,46,-2,51
Albion,3059,6,14,7,15,62,56,6,49
Peterhead,3059,7,12,12,12,44,51,-7,48
Queen's Park,3059,8,12,8,16,39,51,-12,44
East Fife,3059,9,9,9,18,50,62,-12,36
Stenhousem'r,3059,10,10,6,20,44,70,-26,36
Alloa,3060,1,21,7,8,67,33,34,70
Airdrieon,3060,2,18,9,9,55,44,11,63
Livingston,3060,3,20,0,16,72,52,20,60
Brechin,3060,4,18,3,15,46,48,-2,57
Albion,3060,5,16,7,13,60,49,11,55
Stranraer,3060,6,13,6,17,51,53,-2,45
Queen's Park,3060,7,13,5,18,39,54,-15,44
East Fife,3060,8,11,9,16,50,54,-4,42
Peterhead,3060,9,10,12,14,40,51,-11,42
Stenhousem'r,3060,10,8,6,22,48,90,-42,30
Livingston,3061,1,20,8,8,69,36,33,68
Alloa,3061,2,19,8,9,68,41,27,65
Brechin,3061,3,20,5,11,51,46,5,65
Albion,3061,4,15,10,11,52,46,6,55
Airdrieon,3061,5,14,8,14,61,58,3,50
East Fife,3061,6,13,8,15,49,45,4,47
Peterhead,3061,7,12,10,14,50,57,-7,46
Stranraer,3061,8,12,4,20,54,67,-13,40
Queen's Park,3061,9,10,6,20,36,53,-17,36
Stenhousem'r,3061,10,8,7,21,47,88,-41,31
Livingston,3062,1,22,4,10,77,46,31,70
Alloa,3062,2,17,9,10,67,49,18,60
Brechin,3062,3,18,4,14,56,48,8,58
Airdrieon,3062,4,16,6,14,56,50,6,54
Albion,3062,5,15,9,12,60,61,-1,54
Stranraer,3062,6,14,5,17,47,58,-11,47
Peterhead,3062,7,12,10,14,53,54,-1,46
Queen's Park,3062,8,12,9,15,46,51,-5,45
East Fife,3062,9,10,10,16,52,55,-3,40
Stenhousem'r,3062,10,7,8,21,41,83,-42,29
Albion,3063,1,19,8,9,60,43,17,65
Alloa,3063,2,18,10,8,72,42,30,64
Livingston,3063,3,20,3,13,80,50,30,63
Airdrieon,3063,4,19,3,14,58,52,6,60
Peterhead,3063,5,15,10,11,52,49,3,55
East Fife,3063,6,14,8,14,60,51,9,50
Brechin,3063,7,13,6,17,42,53,-11,45
Queen's Park,3063,8,12,6,18,38,59,-21,42
Stranraer,3063,9,11,6,19,44,64,-20,39
Stenhousem'r,3063,10,6,6,24,42,85,-43,24
Livingston,3064,1,20,7,9,81,49,32,67
Airdrieon,3064,2,18,9,9,62,53,9,63
Peterhead,3064,3,17,5,14,56,50,6,56
Alloa,3064,4,16,6,14,68,49,19,54
Albion,3064,5,14,11,11,53,52,1,53
Brechin,3064,6,16,5,15,47,48,-1,53
East Fife,3064,7,14,8,14,55,48,7,50
Queen's Park,3064,8,12,6,18,34,48,-14,42
Stranraer,3064,9,12,5,19,49,60,-11,41
Stenhousem'r,3064,10,7,6,23,52,100,-48,27
Livingston,3065,1,21,4,11,70,55,15,67
Alloa,3065,2,19,9,8,61,41,20,66
Airdrieon,3065,3,18,6,12,61,45,16,60
Brechin,3065,4,16,6,14,49,50,-1,54
Peterhead,3065,5,14,10,12,49,52,-3,52
Queen's Park,3065,6,14,8,14,44,51,-7,50
East Fife,3065,7,11,10,15,48,52,-4,43
Albion,3065,8,10,12,14,46,51,-5,42
Stranraer,3065,9,13,3,20,49,59,-10,42
Stenhousem'r,3065,10,5,10,21,49,70,-21,25
Livingston,3066,1,22,6,8,71,48,23,72
Alloa,3066,2,19,8,9,64,40,24,65
Peterhead,3066,3,16,10,10,56,49,7,58
Queen's Park,3066,4,16,4,16,51,53,-2,52
Brechin,3066,5,14,7,15,50,52,-2,49
Airdrieon,3066,6,12,10,14,61,60,1,46
Albion,3066,7,10,12,14,57,58,-1,42
Stenhousem'r,3066,8,11,8,17,48,71,-23,41
East Fife,3066,9,9,12,15,48,52,-4,39
Stranraer,3066,10,9,7,20,46,69,-23,34
Livingston,3067,1,27,1,8,91,43,48,82
Alloa,3067,2,18,8,10,66,45,21,62
Albion,3067,3,16,9,11,54,44,10,57
Brechin,3067,4,16,8,12,52,52,0,56
Airdrieon,3067,5,15,8,13,53,54,-1,53
Queen's Park,3067,6,12,8,16,37,53,-16,44
Peterhead,3067,7,12,6,18,40,50,-10,42
Stranraer,3067,8,12,4,20,49,64,-15,40
East Fife,3067,9,9,10,17,43,49,-6,37
Stenhousem'r,3067,10,9,6,21,47,78,-31,33
Alloa,3068,1,23,6,7,82,41,41,75
Livingston,3068,2,18,5,13,70,52,18,59
Airdrieon,3068,3,18,5,13,63,55,8,59
Albion,3068,4,13,12,11,59,53,6,51
Peterhead,3068,5,14,8,14,50,48,2,50
Brechin,3068,6,15,5,16,55,55,0,50
Stranraer,3068,7,15,5,16,57,70,-13,50
East Fife,3068,8,12,10,14,50,49,1,46
Queen's Park,3068,9,11,7,18,41,54,-13,40
Stenhousem'r,3068,10,6,7,23,39,89,-50,25
Alloa,3069,1,20,7,9,79,43,36,67
Livingston,3069,2,20,7,9,75,49,26,67
Peterhead,3069,3,16,9,11,54,43,11,57
Airdrieon,3069,4,16,8,12,66,57,9,56
Brechin,3069,5,16,3,17,51,56,-5,51
Albion,3069,6,13,9,14,52,58,-6,48
Stranraer,3069,7,14,5,17,54,59,-5,47
Queen's Park,3069,8,11,7,18,37,57,-20,40
East Fife,3069,9,10,8,18,48,58,-10,38
Stenhousem'r,3069,10,9,7,20,42,78,-36,34
Livingston,3070,1,25,4,7,82,48,34,79
Alloa,3070,2,18,6,12,70,50,20,60
Brechin,3070,3,18,6,12,59,54,5,60
Albion,3070,4,13,10,13,65,58,7,49
Airdrieon,3070,5,13,10,13,60,63,-3,49
East Fife,3070,6,10,15,11,52,46,6,45
Stranraer,3070,7,13,6,17,51,55,-4,45
Queen's Park,3070,8,11,8,17,37,53,-16,41
Stenhousem'r,3070,9,9,9,18,57,83,-26,36
Peterhead,3070,10,9,8,19,42,65,-23,35
Livingston,3071,1,21,6,9,78,46,32,69
Alloa,3071,2,18,12,6,75,41,34,66
Brechin,3071,3,18,5,13,49,41,8,59
Peterhead,3071,4,14,8,14,46,51,-5,50
East Fife,3071,5,13,9,14,49,49,0,48
Airdrieon,3071,6,12,10,14,50,60,-10,46
Stranraer,3071,7,12,10,14,45,55,-10,46
Albion,3071,8,10,10,16,44,53,-9,40
Queen's Park,3071,9,9,9,18,31,51,-20,36
Stenhousem'r,3071,10,8,11,17,47,67,-20,35
Alloa,3072,1,18,11,7,69,45,24,65
Brechin,3072,2,19,7,10,60,43,17,64
Airdrieon,3072,3,15,12,9,56,47,9,57
Livingston,3072,4,16,8,12,71,56,15,56
Peterhead,3072,5,15,10,11,57,49,8,55
Albion,3072,6,10,14,12,54,59,-5,44
East Fife,3072,7,10,13,13,47,48,-1,43
Queen's Park,3072,8,10,9,17,38,55,-17,39
Stranraer,3072,9,11,4,21,48,62,-14,37
Stenhousem'r,3072,10,8,8,20,53,89,-36,32
Livingston,3073,1,22,4,10,77,43,34,70
Alloa,3073,2,20,5,11,69,47,22,65
Brechin,3073,3,17,4,15,47,43,4,55
Albion,3073,4,16,6,14,62,56,6,54
Airdrieon,3073,5,15,8,13,49,47,2,53
Stranraer,3073,6,15,2,19,57,66,-9,47
Peterhead,3073,7,13,8,15,44,53,-9,47
East Fife,3073,8,12,9,15,51,50,1,45
Queen's Park,3073,9,13,4,19,40,55,-15,43
Stenhousem'r,3073,10,9,6,21,44,80,-36,33
Alloa,3074,1,20,10,6,76,42,34,70
Livingston,3074,2,21,5,10,74,41,33,68
Airdrieon,3074,3,15,10,11,57,55,2,55
Brechin,3074,4,16,5,15,56,54,2,53
Albion,3074,5,14,9,13,60,56,4,51
Queen's Park,3074,6,12,12,12,42,48,-6,48
Peterhead,3074,7,13,6,17,48,60,-12,45
Stranraer,3074,8,10,11,15,52,61,-9,41
East Fife,3074,9,11,8,17,39,51,-12,41
Stenhousem'r,3074,10,5,10,21,46,82,-36,25
Livingston,3075,1,21,4,11,71,41,30,67
Airdrieon,3075,2,20,6,10,66,47,19,66
Alloa,3075,3,19,8,9,72,46,26,65
Peterhead,3075,4,17,6,13,60,50,10,57
Brechin,3075,5,15,7,14,57,50,7,52
Albion,3075,6,14,10,12,48,48,0,52
Queen's Park,3075,7,14,5,17,36,49,-13,47
Stranraer,3075,8,12,3,21,45,65,-20,39
East Fife,3075,9,8,9,19,47,57,-10,33
Stenhousem'r,3075,10,7,8,21,42,91,-49,29
Brechin,3076,1,20,6,10,53,40,13,66
Alloa,3076,2,17,10,9,66,40,26,61
Albion,3076,3,17,7,12,61,48,13,58
Livingston,3076,4,16,7,13,62,52,10,55
Peterhead,3076,5,16,7,13,45,42,3,55
Airdrieon,3076,6,15,7,14,49,51,-2,52
East Fife,3076,7,10,11,15,49,48,1,41
Stranraer,3076,8,11,6,19,41,57,-16,39
Queen's Park,3076,9,11,6,19,32,56,-24,39
Stenhousem'r,3076,10,9,9,18,44,68,-24,36
Livingston,3077,1,22,4,10,76,47,29,70
Brechin,3077,2,19,6,11,55,41,14,63
Alloa,3077,3,18,7,11,66,45,21,61
East Fife,3077,4,14,10,12,48,37,11,52
Peterhead,3077,5,13,9,14,51,57,-6,48
Albion,3077,6,12,9,15,49,55,-6,45
Stranraer,3077,7,14,3,19,53,66,-13,45
Airdrieon,3077,8,10,12,14,49,59,-10,42
Queen's Park,3077,9,10,9,17,31,52,-21,39
Stenhousem'r,3077,10,10,7,19,44,63,-19,37
Airdrieon,3078,1,22,5,9,62,44,18,71
Livingston,3078,2,20,3,13,79,51,28,63
Alloa,3078,3,18,9,9,70,48,22,63
Brechin,3078,4,18,5,13,57,51,6,59
Peterhead,3078,5,14,7,15,53,51,2,49
East Fife,3078,6,11,10,15,51,49,2,43
Stranraer,3078,7,12,5,19,48,63,-15,41
Albion,3078,8,10,9,17,49,61,-12,39
Stenhousem'r,3078,9,10,9,17,47,72,-25,39
Queen's Park,3078,10,10,8,18,38,64,-26,38
Alloa,3079,1,20,8,8,75,42,33,68
Airdrieon,3079,2,17,9,10,64,55,9,60
Livingston,3079,3,18,4,14,65,55,10,58
Stranraer,3079,4,16,5,15,55,55,0,53
Brechin,3079,5,16,4,16,47,45,2,52
East Fife,3079,6,13,8,15,47,44,3,47
Albion,3079,7,12,10,14,48,50,-2,46
Queen's Park,3079,8,13,7,16,37,48,-11,46
Peterhead,3079,9,13,6,17,48,51,-3,45
Stenhousem'r,3079,10,7,9,20,41,82,-41,30
Alloa,3080,1,21,8,7,71,43,28,71
Livingston,3080,2,22,5,9,72,47,25,71
Brechin,3080,3,18,7,11,56,43,13,61
Albion,3080,4,16,6,14,51,46,5,54
Peterhead,3080,5,15,7,14,48,54,-6,52
Airdrieon,3080,6,14,7,15,55,63,-8,49
Queen's Park,3080,7,13,7,16,40,51,-11,46
Stranraer,3080,8,11,3,22,46,66,-20,36
East Fife,3080,9,8,11,17,51,49,2,35
Stenhousem'r,3080,10,9,5,22,52,80,-28,32
Alloa,3081,1,18,9,9,68,51,17,63
Livingston,3081,2,18,4,14,80,57,23,58
Peterhead,3081,3,15,9,12,56,48,8,54
East Fife,3081,4,14,9,13,57,41,16,51
Airdrieon,3081,5,15,6,15,55,54,1,51
Albion,3081,6,15,6,15,53,56,-3,51
Stranraer,3081,7,14,6,16,60,63,-3,48
Queen's Park,3081,8,12,10,14,35,50,-15,46
Brechin,3081,9,13,6,17,44,60,-16,45
Stenhousem'r,3081,10,11,5,20,59,87,-28,38
Livingston,3082,1,25,2,9,87,44,43,77
Brechin,3082,2,17,6,13,52,44,8,57
Alloa,3082,3,16,8,12,60,48,12,56
Albion,3082,4,15,9,12,60,55,5,54
Airdrieon,3082,5,15,7,14,58,52,6,52
Stranraer,3082,6,14,6,16,55,59,-4,48
East Fife,3082,7,12,10,14,45,47,-2,46
Queen's Park,3082,8,14,4,18,35,52,-17,46
Stenhousem'r,3082,9,9,9,18,48,76,-28,36
Peterhead,3082,10,8,9,19,43,66,-23,33
Livingston,3083,1,20,4,12,78,52,26,64
Airdrieon,3083,2,19,6,11,61,49,12,63
Alloa,3083,3,18,8,10,69,46,23,62
Brechin,3083,4,17,9,10,55,48,7,60
Peterhead,3083,5,15,12,9,64,48,16,57
Albion,3083,6,15,7,14,53,55,-2,52
Stranraer,3083,7,14,4,18,54,56,-2,46
Queen's Park,3083,8,13,6,17,34,51,-17,45
East Fife,3083,9,6,11,19,38,54,-16,29
Stenhousem'r,3083,10,7,5,24,34,81,-47,26
Livingston,3084,1,23,2,11,76,45,31,71
Alloa,3084,2,18,8,10,76,45,31,62
Brechin,3084,3,19,5,12,60,54,6,62
Airdrieon,3084,4,15,8,13,56,60,-4,53
East Fife,3084,5,14,8,14,53,47,6,50
Albion,3084,6,14,8,14,55,55,0,50
Stranraer,3084,7,14,5,17,52,62,-10,47
Peterhead,3084,8,13,6,17,51,59,-8,45
Stenhousem'r,3084,9,10,5,21,50,85,-35,35
Queen's Park,3084,10,9,7,20,38,55,-17,34
Livingston,3085,1,23,5,8,89,45,44,74
Alloa,3085,2,19,9,8,71,41,30,66
Stranraer,3085,3,15,7,14,55,57,-2,52
Peterhead,3085,4,15,7,14,53,58,-5,52
Brechin,3085,5,14,9,13,50,49,1,51
Airdrieon,3085,6,15,6,15,59,59,0,51
East Fife,3085,7,9,14,13,49,50,-1,41
Albion,3085,8,11,8,17,49,64,-15,41
Queen's Park,3085,9,10,10,16,38,55,-17,40
Stenhousem'r,3085,10,8,7,21,53,88,-35,31
Livingston,3086,1,21,3,12,79,42,37,66
Alloa,3086,2,20,5,11,73,48,25,65
Airdrieon,3086,3,19,6,11,65,54,11,63
Albion,3086,4,17,9,10,66,47,19,60
Peterhead,3086,5,15,7,14,52,49,3,52
Brechin,3086,6,15,6,15,47,52,-5,51
Stranraer,3086,7,11,10,15,50,61,-11,43
Queen's Park,3086,8,10,8,18,39,64,-25,38
East Fife,3086,9,10,6,20,42,55,-13,36
Stenhousem'r,3086,10,9,6,21,47,88,-41,33
Livingston,3087,1,20,5,11,80,57,23,65
Alloa,3087,2,19,6,11,71,47,24,63
Albion,3087,3,16,9,11,59,51,8,57
Brechin,3087,4,15,7,14,45,44,1,52
East Fife,3087,5,13,12,11,55,43,12,51
Airdrieon,3087,6,13,9,14,57,56,1,48
Peterhead,3087,7,12,11,13,51,61,-10,47
Stranraer,3087,8,11,8,17,53,67,-14,41
Stenhousem'r,3087,9,9,10,17,52,72,-20,37
Queen's Park,3087,10,10,7,19,39,64,-25,37
Livingston,3088,1,23,3,10,71,47,24,72
Alloa,3088,2,19,8,9,76,47,29,65
Airdrieon,3088,3,17,6,13,54,48,6,57
Brechin,3088,4,16,8,12,42,41,1,56
Albion,3088,5,13,10,13,60,53,7,49
Queen's Park,3088,6,14,6,16,36,45,-9,48
Stranraer,3088,7,13,7,16,46,51,-5,46
Peterhead,3088,8,11,12,13,40,47,-7,45
East Fife,3088,9,11,7,18,38,48,-10,40
Stenhousem'r,3088,10,5,9,22,39,75,-36,24
Alloa,3089,1,22,5,9,80,43,37,71
Livingston,3089,2,20,6,10,70,47,23,66
Airdrieon,3089,3,19,7,10,76,57,19,64
Brechin,3089,4,18,4,14,56,54,2,58
Albion,3089,5,15,7,14,57,54,3,52
Peterhead,3089,6,14,6,16,45,53,-8,48
Queen's Park,3089,7,12,7,17,51,58,-7,43
East Fife,3089,8,12,7,17,49,59,-10,43
Stenhousem'r,3089,9,9,7,20,55,88,-33,34
Stranraer,3089,10,8,6,22,39,65,-26,30
Alloa,3090,1,23,5,8,77,39,38,74
Livingston,3090,2,20,6,10,73,51,22,66
Airdrieon,3090,3,16,6,14,49,48,1,54
Brechin,3090,4,15,7,14,47,51,-4,52
Stranraer,3090,5,14,5,17,48,63,-15,47
Peterhead,3090,6,12,9,15,50,47,3,45
Albion,3090,7,11,12,13,42,44,-2,45
East Fife,3090,8,11,10,15,47,49,-2,43
Queen's Park,3090,9,12,6,18,41,54,-13,42
Stenhousem'r,3090,10,10,6,20,43,71,-28,36
Livingston,3091,1,26,3,7,89,46,43,81
Alloa,3091,2,20,8,8,85,45,40,68
Airdrieon,3091,3,19,6,11,57,44,13,63
Brechin,3091,4,19,4,13,61,52,9,61
Stranraer,3091,5,16,3,17,54,55,-1,51
Albion,3091,6,11,10,15,62,61,1,43
Queen's Park,3091,7,11,9,16,38,57,-19,42
East Fife,3091,8,10,10,16,43,54,-11,40
Peterhead,3091,9,7,11,18,47,69,-22,32
Stenhousem'r,3091,10,6,6,24,38,91,-53,24
Livingston,3092,1,22,3,11,77,47,30,69
Alloa,3092,2,19,10,7,64,37,27,67
Airdrieon,3092,3,20,5,11,55,42,13,65
Albion,3092,4,17,8,11,59,46,13,59
Brechin,3092,5,16,4,16,49,43,6,52
Peterhead,3092,6,12,8,16,46,55,-9,44
Queen's Park,3092,7,10,11,15,32,48,-16,41
East Fife,3092,8,10,7,19,44,56,-12,37
Stranraer,3092,9,10,7,19,45,69,-24,37
Stenhousem'r,3092,10,8,9,19,41,69,-28,33
Livingston,3093,1,20,7,9,74,45,29,67
Alloa,3093,2,16,9,11,70,47,23,57
Brechin,3093,3,16,8,12,46,48,-2,56
Airdrieon,3093,4,15,9,12,57,57,0,54
Albion,3093,5,12,12,12,54,55,-1,48
Queen's Park,3093,6,13,9,14,42,46,-4,48
Peterhead,3093,7,13,6,17,49,55,-6,45
East Fife,3093,8,11,11,14,51,47,4,44
Stranraer,3093,9,12,6,18,48,58,-10,42
Stenhousem'r,3093,10,8,11,17,43,76,-33,35
Alloa,3094,1,20,7,9,74,45,29,67
Livingston,3094,2,18,6,12,69,55,14,60
Peterhead,3094,3,16,10,10,59,47,12,58
Brechin,3094,4,17,5,14,64,57,7,56
Queen's Park,3094,5,15,6,15,47,48,-1,51
Airdrieon,3094,6,11,14,11,48,51,-3,47
Albion,3094,7,12,11,13,53,59,-6,47
East Fife,3094,8,12,9,15,58,50,8,45
Stranraer,3094,9,11,6,19,47,67,-20,39
Stenhousem'r,3094,10,8,6,22,46,86,-40,30
Alloa,3095,1,19,9,8,76,37,39,66
Brechin,3095,2,19,6,11,56,42,14,63
Airdrieon,3095,3,18,7,11,58,50,8,61
Albion,3095,4,17,6,13,57,47,10,57
Livingston,3095,5,18,2,16,73,56,17,56
Peterhead,3095,6,15,5,16,51,57,-6,50
Stranraer,3095,7,14,7,15,41,53,-12,49
East Fife,3095,8,12,7,17,56,51,5,43
Queen's Park,3095,9,12,6,18,31,60,-29,42
Stenhousem'r,3095,10,5,7,24,39,85,-46,22
Livingston,3096,1,25,5,6,78,42,36,80
Peterhead,3096,2,20,5,11,54,43,11,65
Alloa,3096,3,19,6,11,60,41,19,63
Airdrieon,3096,4,18,8,10,58,48,10,62
Brechin,3096,5,16,3,17,53,50,3,51
Albion,3096,6,14,6,16,48,52,-4,48
Stranraer,3096,7,12,7,17,44,61,-17,43
Queen's Park,3096,8,11,8,17,34,48,-14,41
East Fife,3096,9,8,8,20,44,53,-9,32
Stenhousem'r,3096,10,7,4,25,47,82,-35,25
Livingston,3097,1,23,3,10,83,50,33,72
Alloa,3097,2,17,11,8,60,40,20,62
Airdrieon,3097,3,18,5,13,65,57,8,59
Brechin,3097,4,17,7,12,46,41,5,58
Albion,3097,5,13,14,9,58,45,13,53
Peterhead,3097,6,14,10,12,63,47,16,52
East Fife,3097,7,12,12,12,55,49,6,48
Queen's Park,3097,8,11,8,17,37,60,-23,41
Stranraer,3097,9,7,10,19,41,68,-27,31
Stenhousem'r,3097,10,5,6,25,37,88,-51,21
Livingston,3098,1,21,7,8,83,53,30,70
Airdrieon,3098,2,19,5,12,69,61,8,62
Brechin,3098,3,18,7,11,60,47,13,61
Alloa,3098,4,17,7,12,75,52,23,58
Peterhead,3098,5,16,7,13,58,49,9,55
East Fife,3098,6,15,9,12,58,49,9,54
Albion,3098,7,15,6,15,46,53,-7,51
Stranraer,3098,8,12,4,20,55,71,-16,40
Queen's Park,3098,9,7,8,21,29,58,-29,29
Stenhousem'r,3098,10,5,10,21,50,90,-40,25
Livingston,3099,1,21,7,8,78,46,32,70
Airdrieon,3099,2,18,7,11,61,51,10,61
Alloa,3099,3,15,14,7,67,45,22,59
Brechin,3099,4,16,7,13,50,47,3,55
Peterhead,3099,5,13,11,12,55,60,-5,50
Stranraer,3099,6,13,6,17,54,61,-7,45
Albion,3099,7,11,11,14,51,54,-3,44
East Fife,3099,8,11,9,16,48,48,0,42
Stenhousem'r,3099,9,10,6,20,49,79,-30,36
Queen's Park,3099,10,8,10,18,36,58,-22,34
Livingston,3100,1,22,5,9,79,44,35,71
Alloa,3100,2,19,8,9,64,44,20,65
Peterhead,3100,3,16,6,14,54,47,7,54
Albion,3100,4,15,9,12,52,46,6,54
Airdrieon,3100,5,16,5,15,55,56,-1,53
East Fife,3100,6,14,8,14,56,49,7,50
Stranraer,3100,7,14,5,17,47,51,-4,47
Brechin,3100,8,11,7,18,38,52,-14,40
Queen's Park,3100,9,9,10,17,37,62,-25,37
Stenhousem'r,3100,10,9,7,20,47,78,-31,34
Livingston,3101,1,20,6,10,72,50,22,66
Brechin,3101,2,17,7,12,50,45,5,58
Airdrieon,3101,3,17,6,13,50,50,0,57
Alloa,3101,4,15,11,10,63,41,22,56
Peterhead,3101,5,15,10,11,47,42,5,55
Albion,3101,6,13,10,13,40,42,-2,49
East Fife,3101,7,13,9,14,51,46,5,48
Queen's Park,3101,8,10,10,16,29,44,-15,40
Stranraer,3101,9,9,9,18,42,59,-17,36
Stenhousem'r,3101,10,7,10,19,42,67,-25,31
Livingston,3102,1,21,3,12,77,45,32,66
Alloa,3102,2,19,9,8,76,45,31,66
Brechin,3102,3,17,6,13,59,52,7,57
Albion,3102,4,15,7,14,49,54,-5,52
East Fife,3102,5,15,5,16,53,49,4,50
Airdrieon,3102,6,14,8,14,55,57,-2,50
Peterhead,3102,7,14,7,15,50,56,-6,49
Stranraer,3102,8,13,3,20,48,61,-13,42
Stenhousem'r,3102,9,10,9,17,47,71,-24,39
Queen's Park,3102,10,11,5,20,35,59,-24,38
Livingston,3103,1,21,4,11,75,48,27,67
Alloa,3103,2,18,11,7,60,38,22,65
Airdrieon,3103,3,19,8,9,69,51,18,65
Brechin,3103,4,14,8,14,40,46,-6,50
Albion,3103,5,14,6,16,52,53,-1,48
East Fife,3103,6,13,7,16,55,49,6,46
Queen's Park,3103,7,13,7,16,32,53,-21,46
Peterhead,3103,8,12,9,15,45,52,-7,45
Stranraer,3103,9,13,5,18,54,61,-7,44
Stenhousem'r,3103,10,7,7,22,41,72,-31,28
Alloa,3104,1,23,7,6,79,38,41,76
Livingston,3104,2,21,6,9,77,41,36,69
Airdrieon,3104,3,19,6,11,64,54,10,63
Albion,3104,4,16,8,12,59,49,10,56
Brechin,3104,5,15,9,12,46,44,2,54
Peterhead,3104,6,15,5,16,55,59,-4,50
East Fife,3104,7,12,8,16,54,50,4,44
Stranraer,3104,8,12,4,20,45,65,-20,40
Queen's Park,3104,9,9,6,21,33,61,-28,33
Stenhousem'r,3104,10,6,5,25,40,91,-51,23
Alloa,3105,1,19,10,7,76,40,36,67
Livingston,3105,2,20,5,11,85,59,26,65
Airdrieon,3105,3,17,6,13,53,52,1,57
Brechin,3105,4,17,5,14,53,53,0,56
East Fife,3105,5,13,11,12,52,47,5,50
Peterhead,3105,6,13,10,13,47,50,-3,49
Queen's Park,3105,7,14,5,17,39,53,-14,47
Albion,3105,8,11,10,15,49,56,-7,43
Stranraer,3105,9,10,7,19,55,69,-14,37
Stenhousem'r,3105,10,9,5,22,43,73,-30,32
Alloa,3106,1,18,11,7,73,43,30,65
Brechin,3106,2,20,4,12,51,45,6,64
Livingston,3106,3,20,3,13,67,45,22,63
Airdrieon,3106,4,16,9,11,55,47,8,57
Albion,3106,5,14,10,12,52,42,10,52
Peterhead,3106,6,13,10,13,41,47,-6,49
East Fife,3106,7,12,11,13,59,57,2,47
Queen's Park,3106,8,12,6,18,34,53,-19,42
Stranraer,3106,9,11,4,21,52,68,-16,37
Stenhousem'r,3106,10,7,6,23,44,81,-37,27
Livingston,3107,1,26,1,9,78,47,31,79
Alloa,3107,2,16,7,13,66,49,17,55
Brechin,3107,3,14,10,12,49,49,0,52
Peterhead,3107,4,15,7,14,47,49,-2,52
Airdrieon,3107,5,15,5,16,58,61,-3,50
Stranraer,3107,6,14,7,15,59,61,-2,49
Albion,3107,7,13,8,15,52,50,2,47
East Fife,3107,8,11,10,15,50,52,-2,43
Stenhousem'r,3107,9,10,8,18,47,67,-20,38
Queen's Park,3107,10,9,11,16,32,53,-21,38
Alloa,3108,1,22,7,7,76,46,30,73
Albion,3108,2,18,9,9,65,47,18,63
Livingston,3108,3,17,8,11,69,50,19,59
Peterhead,3108,4,15,9,12,57,50,7,54
Airdrieon,3108,5,14,10,12,59,59,0,52
Brechin,3108,6,13,8,15,48,52,-4,47
Queen's Park,3108,7,12,10,14,37,50,-13,46
Stranraer,3108,8,12,5,19,49,59,-10,41
East Fife,3108,9,10,8,18,46,55,-9,38
Stenhousem'r,3108,10,6,8,22,46,84,-38,26
Livingston,3109,1,22,3,11,68,44,24,69
Alloa,3109,2,19,7,10,64,38,26,64
Peterhead,3109,3,17,7,12,56,45,11,58
Airdrieon,3109,4,16,7,13,57,51,6,55
East Fife,3109,5,13,9,14,48,47,1,48
Brechin,3109,6,13,9,14,48,55,-7,48
Albion,3109,7,13,7,16,54,58,-4,46
Queen's Park,3109,8,13,6,17,28,47,-19,45
Stranraer,3109,9,10,6,20,47,63,-16,36
Stenhousem'r,3109,10,9,9,18,52,74,-22,36
Livingston,3110,1,18,9,9,68,47,21,63
Alloa,3110,2,18,7,11,65,44,21,61
Brechin,3110,3,18,5,13,53,40,13,59
Airdrieon,3110,4,18,4,14,61,57,4,58
Peterhead,3110,5,15,8,13,50,50,0,53
Queen's Park,3110,6,15,5,16,37,49,-12,50
Stranraer,3110,7,13,8,15,46,52,-6,47
Albion,3110,8,12,10,14,47,47,0,46
East Fife,3110,9,12,8,16,45,47,-2,44
Stenhousem'r,3110,10,5,8,23,46,85,-39,23
Livingston,3111,1,25,3,8,85,45,40,78
Alloa,3111,2,18,8,10,66,41,25,62
Albion,3111,3,16,7,13,51,44,7,55
Queen's Park,3111,4,15,7,14,37,43,-6,52
Peterhead,3111,5,13,8,15,48,50,-2,47
Airdrieon,3111,6,13,7,16,58,61,-3,46
Stranraer,3111,7,13,7,16,43,55,-12,46
Brechin,3111,8,13,6,17,41,51,-10,45
Stenhousem'r,3111,9,12,7,17,46,67,-21,43
East Fife,3111,10,7,10,19,38,56,-18,31
Alloa,3112,1,21,6,9,66,36,30,69
Livingston,3112,2,21,5,10,72,45,27,68
Brechin,3112,3,19,4,13,53,40,13,61
Airdrieon,3112,4,17,4,15,58,61,-3,55
Peterhead,3112,5,14,9,13,48,55,-7,51
Stranraer,3112,6,14,5,17,58,58,0,47
East Fife,3112,7,12,11,13,40,40,0,47
Queen's Park,3112,8,12,6,18,42,53,-11,42
Albion,3112,9,9,9,18,55,69,-14,36
Stenhousem'r,3112,10,5,13,18,43,78,-35,28
Livingston,3113,1,24,3,9,86,45,41,75
Airdrieon,3113,2,21,5,10,63,45,18,68
Alloa,3113,3,17,9,10,66,42,24,60
Albion,3113,4,17,8,11,64,51,13,59
Queen's Park,3113,5,14,4,18,32,52,-20,46
Brechin,3113,6,12,8,16,49,58,-9,44
Stranraer,3113,7,13,5,18,48,58,-10,44
Peterhead,3113,8,12,8,16,50,61,-11,44
East Fife,3113,9,9,9,18,44,50,-6,36
Stenhousem'r,3113,10,8,7,21,39,79,-40,31
Alloa,3114,1,20,6,10,69,40,29,66
Airdrieon,3114,2,17,10,9,61,50,11,61
Albion,3114,3,18,4,14,56,54,2,58
Livingston,3114,4,16,9,11,72,50,22,57
Peterhead,3114,5,15,10,11,50,47,3,55
Brechin,3114,6,14,6,16,45,54,-9,48
East Fife,3114,7,12,8,16,50,48,2,44
Stranraer,3114,8,12,6,18,51,69,-18,42
Queen's Park,3114,9,12,4,20,39,55,-16,40
Stenhousem'r,3114,10,7,11,18,49,75,-26,32
Livingston,3115,1,20,6,10,72,45,27,66
Alloa,3115,2,19,7,10,67,43,24,64
Brechin,3115,3,19,4,13,55,46,9,61
Albion,3115,4,17,8,11,60,51,9,59
Airdrieon,3115,5,17,5,14,54,52,2,56
Queen's Park,3115,6,14,6,16,47,46,1,48
Peterhead,3115,7,13,8,15,47,55,-8,47
Stenhousem'r,3115,8,11,9,16,46,71,-25,42
Stranraer,3115,9,10,6,20,38,59,-21,36
East Fife,3115,10,5,11,20,41,59,-18,26
Livingston,3116,1,21,2,13,70,42,28,65
Alloa,3116,2,18,8,10,69,49,20,62
Airdrieon,3116,3,17,7,12,57,53,4,58
Brechin,3116,4,17,6,13,50,40,10,57
Queen's Park,3116,5,17,5,14,44,46,-2,56
Peterhead,3116,6,14,8,14,39,47,-8,50
Albion,3116,7,14,4,18,55,60,-5,46
Stranraer,3116,8,12,9,15,49,54,-5,45
East Fife,3116,9,11,8,17,43,53,-10,41
Stenhousem'r,3116,10,7,7,22,47,79,-32,28
Alloa,3117,1,23,9,4,71,35,36,78
Livingston,3117,2,20,4,12,80,51,29,64
Airdrieon,3117,3,18,7,11,60,49,11,61
Queen's Park,3117,4,16,5,15,43,42,1,53
Brechin,3117,5,15,6,15,46,50,-4,51
Peterhead,3117,6,12,10,14,54,59,-5,46
Albion,3117,7,12,9,15,52,56,-4,45
Stranraer,3117,8,12,3,21,53,68,-15,39
East Fife,3117,9,9,9,18,45,54,-9,36
Stenhousem'r,3117,10,8,8,20,51,91,-40,32
Alloa,3118,1,19,5,12,66,43,23,62
Brechin,3118,2,18,7,11,57,42,15,61
Livingston,3118,3,18,6,12,64,52,12,60
Albion,3118,4,17,4,15,59,46,13,55
Airdrieon,3118,5,15,9,12,53,49,4,54
Stranraer,3118,6,12,9,15,46,55,-9,45
Peterhead,3118,7,12,9,15,45,55,-10,45
Stenhousem'r,3118,8,12,6,18,54,78,-24,42
East Fife,3118,9,10,11,15,51,50,1,41
Queen's Park,3118,10,11,6,19,24,49,-25,39
Livingston,3119,1,24,6,6,81,35,46,78
Alloa,3119,2,20,7,9,65,37,28,67
Airdrieon,3119,3,17,6,13,63,59,4,57
Brechin,3119,4,14,8,14,47,53,-6,50
Peterhead,3119,5,13,8,15,49,50,-1,47
Stranraer,3119,6,13,7,16,49,52,-3,46
East Fife,3119,7,11,9,16,50,52,-2,42
Queen's Park,3119,8,10,10,16,37,57,-20,40
Albion,3119,9,9,10,17,41,64,-23,37
Stenhousem'r,3119,10,8,11,17,48,71,-23,35
Alloa,3120,1,21,6,9,65,38,27,69
Livingston,3120,2,19,4,13,67,46,21,61
Brechin,3120,3,18,7,11,45,40,5,61
Airdrieon,3120,4,18,6,12,58,47,11,60
Peterhead,3120,5,13,7,16,48,53,-5,46
Albion,3120,6,12,8,16,50,51,-1,44
Stranraer,3120,7,11,11,14,42,50,-8,44
Queen's Park,3120,8,12,7,17,35,52,-17,43
East Fife,3120,9,9,11,16,44,53,-9,38
Stenhousem'r,3120,10,9,9,18,38,62,-24,36
Livingston,3121,1,21,3,12,77,46,31,66
Alloa,3121,2,19,7,10,66,44,22,64
Brechin,3121,3,18,7,11,52,44,8,61
Airdrieon,3121,4,17,5,14,58,54,4,56
East Fife,3121,5,13,10,13,58,47,11,49
Peterhead,3121,6,12,12,12,54,57,-3,48
Stranraer,3121,7,13,4,19,49,56,-7,43
Queen's Park,3121,8,11,8,17,37,55,-18,41
Albion,3121,9,9,13,14,49,58,-9,40
Stenhousem'r,3121,10,6,13,17,51,90,-39,31
Alloa,3122,1,22,6,8,68,34,34,72
Airdrieon,3122,2,20,6,10,63,49,14,66
Livingston,3122,3,20,3,13,69,48,21,63
Brechin,3122,4,14,7,15,47,52,-5,49
East Fife,3122,5,12,10,14,54,55,-1,46
Albion,3122,6,13,7,16,50,57,-7,46
Peterhead,3122,7,11,11,14,49,55,-6,44
Stenhousem'r,3122,8,11,8,17,53,73,-20,41
Stranraer,3122,9,11,6,19,51,62,-11,39
Queen's Park,3122,10,9,10,17,31,50,-19,37
Livingston,3123,1,21,8,7,78,44,34,71
Airdrieon,3123,2,19,7,10,67,49,18,64
Brechin,3123,3,18,8,10,54,45,9,62
Alloa,3123,4,17,9,10,74,49,25,60
Albion,3123,5,13,10,13,53,51,2,49
Queen's Park,3123,6,13,5,18,36,56,-20,44
Peterhead,3123,7,12,6,18,44,59,-15,42
Stranraer,3123,8,11,7,18,47,58,-11,40
East Fife,3123,9,8,10,18,46,54,-8,34
Stenhousem'r,3123,10,8,10,18,43,77,-34,34
Livingston,3124,1,21,4,11,84,51,33,67
Alloa,3124,2,19,8,9,78,47,31,65
Airdrieon,3124,3,18,7,11,65,54,11,61
Brechin,3124,4,16,5,15,54,51,3,53
East Fife,3124,5,14,9,13,48,45,3,51
Albion,3124,6,12,12,12,52,48,4,48
Queen's Park,3124,7,13,8,15,43,58,-15,47
Peterhead,3124,8,13,7,16,38,52,-14,46
Stranraer,3124,9,10,8,18,49,62,-13,38
Stenhousem'r,3124,10,7,6,23,34,77,-43,27
Livingston,3125,1,19,8,9,73,45,28,65
Alloa,3125,2,18,9,9,67,39,28,63
Brechin,3125,3,18,8,10,55,47,8,62
Airdrieon,3125,4,16,5,15,58,60,-2,53
Queen's Park,3125,5,15,7,14,49,51,-2,52
East Fife,3125,6,13,9,14,45,42,3,48
Albion,3125,7,14,6,16,56,61,-5,48
Peterhead,3125,8,12,7,17,52,63,-11,43
Stenhousem'r,3125,9,11,6,19,50,73,-23,39
Stranraer,3125,10,9,5,22,42,66,-24,32
Livingston,3126,1,20,5,11,72,52,20,65
Alloa,3126,2,17,10,9,70,54,16,61
Airdrieon,3126,3,18,7,11,63,54,9,61
Peterhead,3126,4,18,4,14,61,46,15,58
Stranraer,3126,5,17,5,14,59,57,2,56
Albion,3126,6,15,8,13,61,52,9,53
Brechin,3126,7,14,3,19,41,53,-12,45
East Fife,3126,8,11,10,15,48,52,-4,43
Queen's Park,3126,9,10,6,20,33,55,-22,36
Stenhousem'r,3126,10,7,8,21,46,79,-33,29
Alloa,3127,1,19,7,10,70,42,28,64
Brechin,3127,2,18,8,10,52,43,9,62
Livingston,3127,3,18,6,12,66,47,19,60
Airdrieon,3127,4,18,6,12,64,50,14,60
Queen's Park,3127,5,15,7,14,47,51,-4,52
Albion,3127,6,13,11,12,56,50,6,50
Stranraer,3127,7,12,8,16,56,59,-3,44
East Fife,3127,8,11,7,18,40,53,-13,40
Peterhead,3127,9,10,7,19,53,72,-19,37
Stenhousem'r,3127,10,6,13,17,46,83,-37,31
Alloa,3128,1,19,10,7,67,43,24,67
Livingston,3128,2,17,8,11,72,44,28,59
Airdrieon,3128,3,17,7,12,49,47,2,58
Albion,3128,4,14,11,11,55,51,4,53
Brechin,3128,5,15,8,13,52,49,3,53
Peterhead,3128,6,12,13,11,52,50,2,49
East Fife,3128,7,11,13,12,57,48,9,46
Queen's Park,3128,8,10,7,19,36,63,-27,37
Stranraer,3128,9,10,6,20,51,69,-18,36
Stenhousem'r,3128,10,8,11,17,44,71,-27,35
Livingston,3129,1,25,5,6,89,40,49,80
Alloa,3129,2,18,9,9,69,41,28,63
Albion,3129,3,17,9,10,60,47,13,60
Brechin,3129,4,17,7,12,49,40,9,58
Airdrieon,3129,5,14,9,13,47,57,-10,51
East Fife,3129,6,12,6,18,48,53,-5,42
Stenhousem'r,3129,7,11,9,16,52,73,-21,42
Stranraer,3129,8,12,4,20,49,67,-18,40
Queen's Park,3129,9,10,6,20,30,53,-23,36
Peterhead,3129,10,8,8,20,37,59,-22,32
Alloa,3130,1,19,9,8,72,47,25,66
Livingston,3130,2,18,9,9,76,47,29,63
Brechin,3130,3,19,6,11,55,43,12,63
Queen's Park,3130,4,16,7,13,41,41,0,55
Airdrieon,3130,5,15,9,12,54,55,-1,54
Peterhead,3130,6,14,9,13,52,52,0,51
Albion,3130,7,13,7,16,56,59,-3,46
East Fife,3130,8,8,11,17,41,52,-11,35
Stranraer,3130,9,9,6,21,44,63,-19,33
Stenhousem'r,3130,10,8,9,19,43,75,-32,33
Livingston,3131,1,23,5,8,73,43,30,74
Alloa,3131,2,21,7,8,82,41,41,70
Queen's Park,3131,3,15,8,13,47,47,0,53
Albion,3131,4,14,10,12,53,51,2,52
Airdrieon,3131,5,14,6,16,54,70,-16,48
Stranraer,3131,6,15,2,19,57,64,-7,47
East Fife,3131,7,12,9,15,47,45,2,45
Brechin,3131,8,13,6,17,49,54,-5,45
Peterhead,3131,9,9,9,18,38,59,-21,36
Stenhousem'r,3131,10,8,10,18,53,79,-26,34
Alloa,3132,1,24,6,6,76,35,41,78
Brechin,3132,2,20,5,11,58,42,16,65
Livingston,3132,3,19,2,15,74,54,20,59
Airdrieon,3132,4,17,4,15,61,62,-1,55
Albion,3132,5,14,7,15,42,50,-8,49
East Fife,3132,6,13,8,15,48,50,-2,47
Queen's Park,3132,7,13,6,17,35,50,-15,45
Peterhead,3132,8,12,6,18,49,56,-7,42
Stranraer,3132,9,12,6,18,47,56,-9,42
Stenhousem'r,3132,10,7,8,21,49,84,-35,29
Alloa,3133,1,21,8,7,78,37,41,71
Livingston,3133,2,20,4,12,74,54,20,64
Brechin,3133,3,17,8,11,48,38,10,59
Airdrieon,3133,4,15,5,16,55,56,-1,50
Stranraer,3133,5,14,7,15,55,52,3,49
East Fife,3133,6,13,10,13,54,52,2,49
Peterhead,3133,7,12,9,15,43,50,-7,45
Queen's Park,3133,8,11,8,17,35,57,-22,41
Albion,3133,9,11,7,18,41,54,-13,40
Stenhousem'r,3133,10,10,6,20,51,84,-33,36
Alloa,3134,1,21,6,9,66,37,29,69
Airdrieon,3134,2,20,4,12,65,51,14,64
Livingston,3134,3,18,9,9,66,39,27,63
Brechin,3134,4,19,6,11,59,48,11,63
East Fife,3134,5,12,10,14,49,43,6,46
Albion,3134,6,11,13,12,50,55,-5,46
Peterhead,3134,7,11,11,14,50,51,-1,44
Stranraer,3134,8,11,4,21,44,62,-18,37
Stenhousem'r,3134,9,9,8,19,41,73,-32,35
Queen's Park,3134,10,8,9,19,29,60,-31,33
Livingston,3135,1,23,2,11,75,51,24,71
Brechin,3135,2,20,7,9,54,34,20,67
Airdrieon,3135,3,20,6,10,67,44,23,66
Alloa,3135,4,16,11,9,58,37,21,59
Peterhead,3135,5,16,4,16,46,55,-9,52
Albion,3135,6,15,5,16,54,51,3,50
Stranraer,3135,7,12,3,21,53,75,-22,39
East Fife,3135,8,10,8,18,44,57,-13,38
Queen's Park,3135,9,10,8,18,34,48,-14,38
Stenhousem'r,3135,10,8,6,22,39,72,-33,30
Alloa,3136,1,21,6,9,78,39,39,69
Livingston,3136,2,22,2,12,76,47,29,68
Brechin,3136,3,15,9,12,48,49,-1,54
Peterhead,3136,4,14,9,13,55,50,5,51
Airdrieon,3136,5,14,8,14,52,55,-3,50
Stranraer,3136,6,12,8,16,50,58,-8,44
Albion,3136,7,11,11,14,54,63,-9,44
Queen's Park,3136,8,12,7,17,34,58,-24,43
East Fife,3136,9,11,9,16,52,50,2,42
Stenhousem'r,3136,10,10,7,19,50,80,-30,37
Livingston,3137,1,22,1,13,77,48,29,67
Alloa,3137,2,19,5,12,71,53,18,62
Brechin,3137,3,18,7,11,51,40,11,61
Airdrieon,3137,4,17,8,11,54,45,9,59
Queen's Park,3137,5,15,6,15,39,50,-11,51
Peterhead,3137,6,13,8,15,48,57,-9,47
Albion,3137,7,11,10,15,54,54,0,43
East Fife,3137,8,10,11,15,49,49,0,41
Stranraer,3137,9,11,7,18,48,65,-17,40
Stenhousem'r,3137,10,9,7,20,42,72,-30,34
Livingston,3138,1,21,4,11,80,46,34,67
Alloa,3138,2,20,6,10,70,40,30,66
East Fife,3138,3,15,9,12,50,40,10,54
Albion,3138,4,16,6,14,51,48,3,54
Airdrieon,3138,5,15,8,13,61,61,0,53
Brechin,3138,6,15,5,16,49,58,-9,50
Peterhead,3138,7,14,6,16,46,47,-1,48
Stranraer,3138,8,13,5,18,49,63,-14,44
Queen's Park,3138,9,12,7,17,38,61,-23,43
Stenhousem'r,3138,10,7,8,21,43,73,-30,29
Livingston,3139,1,24,6,6,84,46,38,78
Airdrieon,3139,2,18,7,11,67,58,9,61
Alloa,3139,3,16,9,11,64,47,17,57
Peterhead,3139,4,13,9,14,47,54,-7,48
Brechin,3139,5,13,8,15,53,57,-4,47
East Fife,3139,6,13,7,16,48,43,5,46
Stranraer,3139,7,12,10,14,55,64,-9,46
Albion,3139,8,11,11,14,52,55,-3,44
Queen's Park,3139,9,12,7,17,45,57,-12,43
Stenhousem'r,3139,10,7,8,21,41,75,-34,29
Alloa,3140,1,21,7,8,75,50,25,70
Airdrieon,3140,2,17,8,11,55,50,5,59
Brechin,3140,3,17,6,13,58,45,13,57
Livingston,3140,4,17,4,15,72,56,16,55
East Fife,3140,5,15,6,15,58,44,14,51
Peterhead,3140,6,14,8,14,49,48,1,50
Albion,3140,7,15,5,16,64,65,-1,50
Queen's Park,3140,8,13,5,18,41,62,-21,44
Stranraer,3140,9,11,7,18,49,64,-15,40
Stenhousem'r,3140,10,7,10,19,40,77,-37,31
Alloa,3141,1,19,10,7,79,42,37,67
Livingston,3141,2,19,8,9,75,46,29,65
Brechin,3141,3,17,7,12,51,54,-3,58
Albion,3141,4,15,11,10,59,53,6,56
Peterhead,3141,5,15,8,13,51,55,-4,53
Stranraer,3141,6,14,7,15,58,57,1,49
Airdrieon,3141,7,14,6,16,60,59,1,48
Queen's Park,3141,8,10,10,16,36,50,-14,40
East Fife,3141,9,7,13,16,47,55,-8,34
Stenhousem'r,3141,10,6,8,22,38,83,-45,26
Alloa,3142,1,20,8,8,73,37,36,68
Albion,3142,2,19,7,10,61,53,8,64
Brechin,3142,3,18,8,10,56,46,10,62
Airdrieon,3142,4,18,7,11,63,53,10,61
Livingston,3142,5,19,3,14,71,47,24,60
Peterhead,3142,6,12,9,15,46,48,-2,45
East Fife,3142,7,11,11,14,48,45,3,44
Queen's Park,3142,8,10,9,17,43,60,-17,39
Stranraer,3142,9,11,6,19,49,70,-21,39
Stenhousem'r,3142,10,4,8,24,43,94,-51,20
Livingston,3143,1,27,2,7,86,34,52,83
Brechin,3143,2,18,6,12,50,44,6,60
Alloa,3143,3,15,8,13,63,44,19,53
Peterhead,3143,4,15,7,14,52,49,3,52
Albion,3143,5,13,12,11,49,50,-1,51
Airdrieon,3143,6,13,11,12,50,57,-7,50
Stranraer,3143,7,12,6,18,43,52,-9,42
East Fife,3143,8,10,8,18,45,56,-11,38
Queen's Park,3143,9,10,7,19,36,54,-18,37
Stenhousem'r,3143,10,10,7,19,41,75,-34,37
Livingston,3144,1,25,3,8,88,39,49,78
Brechin,3144,2,19,9,8,61,40,21,66
Alloa,3144,3,18,8,10,70,51,19,62
Albion,3144,4,17,8,11,56,48,8,59
Airdrieon,3144,5,18,4,14,61,59,2,58
East Fife,3144,6,12,8,16,47,46,1,44
Queen's Park,3144,7,11,6,19,37,57,-20,39
Stranraer,3144,8,10,6,20,40,65,-25,36
Peterhead,3144,9,9,7,20,49,62,-13,34
Stenhousem'r,3144,10,8,7,21,47,89,-42,31
Alloa,3145,1,19,9,8,75,41,34,66
Livingston,3145,2,17,5,14,71,50,21,56
Albion,3145,3,17,5,14,52,46,6,56
Peterhead,3145,4,16,8,12,51,48,3,56
Stranraer,3145,5,16,5,15,57,54,3,53
Brechin,3145,6,15,7,14,52,58,-6,52
Queen's Park,3145,7,11,11,14,35,49,-14,44
East Fife,3145,8,10,13,13,42,48,-6,43
Airdrieon,3145,9,12,7,17,47,58,-11,43
Stenhousem'r,3145,10,7,10,19,48,78,-30,31
Livingston,3146,1,20,5,11,75,53,22,65
Airdrieon,3146,2,18,7,11,61,56,5,61
Brechin,3146,3,17,8,11,61,50,11,59
Alloa,3146,4,16,9,11,67,52,15,57
Albion,3146,5,12,11,13,53,50,3,47
Peterhead,3146,6,11,12,13,48,56,-8,45
East Fife,3146,7,12,8,16,50,52,-2,44
Queen's Park,3146,8,12,7,17,34,46,-12,43
Stranraer,3146,9,12,6,18,52,63,-11,42
Stenhousem'r,3146,10,8,11,17,51,74,-23,35
Livingston,3147,1,23,5,8,77,43,34,74
Alloa,3147,2,16,11,9,64,48,16,59
East Fife,3147,3,17,8,11,53,41,12,59
Queen's Park,3147,4,16,6,14,52,47,5,54
Albion,3147,5,15,8,13,55,49,6,53
Airdrieon,3147,6,15,7,14,63,56,7,52
Brechin,3147,7,14,6,16,51,55,-4,48
Peterhead,3147,8,11,9,16,48,53,-5,42
Stranraer,3147,9,12,5,19,50,61,-11,41
Stenhousem'r,3147,10,4,9,23,34,94,-60,21
Livingston,3148,1,22,1,13,77,48,29,67
Alloa,3148,2,18,9,9,66,42,24,63
Airdrieon,3148,3,19,5,12,61,53,8,62
Peterhead,3148,4,15,7,14,56,49,7,52
Brechin,3148,5,14,10,12,52,49,3,52
Albion,3148,6,14,9,13,63,56,7,51
Queen's Park,3148,7,13,7,16,41,51,-10,46
Stranraer,3148,8,14,4,18,49,65,-16,46
East Fife,3148,9,7,13,16,50,55,-5,34
Stenhousem'r,3148,10,8,7,21,41,88,-47,31
Alloa,3149,1,22,7,7,76,39,37,73
Livingston,3149,2,21,5,10,81,50,31,68
Brechin,3149,3,19,4,13,55,50,5,61
Peterhead,3149,4,16,6,14,46,47,-1,54
East Fife,3149,5,12,12,12,44,43,1,48
Airdrieon,3149,6,13,9,14,53,60,-7,48
Stranraer,3149,7,11,8,17,48,60,-12,41
Queen's Park,3149,8,10,9,17,33,50,-17,39
Albion,3149,9,9,11,16,38,49,-11,38
Stenhousem'r,3149,10,8,7,21,55,81,-26,31
Livingston,3150,1,23,3,10,76,45,31,72
Airdrieon,3150,2,18,8,10,63,50,13,62
Alloa,3150,3,15,10,11,58,44,14,55
Brechin,3150,4,16,7,13,42,37,5,55
East Fife,3150,5,14,10,12,58,46,12,52
Queen's Park,3150,6,15,6,15,42,57,-15,51
Peterhead,3150,7,11,10,15,46,57,-11,43
Stranraer,3150,8,11,9,16,60,61,-1,42
Albion,3150,9,9,9,18,38,53,-15,36
Stenhousem'r,3150,10,8,8,20,42,75,-33,32
Livingston,3151,1,22,3,11,87,52,35,69
Alloa,3151,2,19,6,11,67,49,18,63
Airdrieon,3151,3,19,2,15,71,51,20,59
Brechin,3151,4,16,8,12,63,60,3,56
East Fife,3151,5,14,9,13,68,57,11,51
Albion,3151,6,14,7,15,62,62,0,49
Stranraer,3151,7,15,3,18,54,64,-10,48
Peterhead,3151,8,11,11,14,43,57,-14,44
Queen's Park,3151,9,10,7,19,39,61,-22,37
Stenhousem'r,3151,10,6,12,18,51,92,-41,30
Alloa,3152,1,21,9,6,71,36,35,72
Livingston,3152,2,18,5,13,67,57,10,59
Airdrieon,3152,3,17,8,11,53,50,3,59
Brechin,3152,4,16,9,11,43,42,1,57
Peterhead,3152,5,14,10,12,52,47,5,52
Albion,3152,6,12,9,15,53,49,4,45
Queen's Park,3152,7,11,9,16,41,52,-11,42
Stranraer,3152,8,11,8,17,41,54,-13,41
East Fife,3152,9,9,10,17,45,52,-7,37
Stenhousem'r,3152,10,8,9,19,50,77,-27,33
Livingston,3153,1,21,7,8,76,38,38,70
Peterhead,3153,2,19,6,11,52,46,6,63
Alloa,3153,3,16,11,9,70,52,18,59
Airdrieon,3153,4,18,4,14,56,50,6,58
Albion,3153,5,15,9,12,52,43,9,54
Brechin,3153,6,15,8,13,49,43,6,53
East Fife,3153,7,10,11,15,45,50,-5,41
Stranraer,3153,8,9,12,15,45,55,-10,39
Queen's Park,3153,9,9,8,19,29,61,-32,35
Stenhousem'r,3153,10,5,10,21,43,79,-36,25
Livingston,3154,1,23,4,9,72,37,35,73
Alloa,3154,2,19,8,9,66,40,26,65
Airdrieon,3154,3,16,7,13,51,48,3,55
Brechin,3154,4,14,11,11,53,51,2,53
Peterhead,3154,5,14,8,14,52,54,-2,50
East Fife,3154,6,11,13,12,53,49,4,46
Queen's Park,3154,7,13,6,17,29,47,-18,45
Stranraer,3154,8,13,5,18,50,62,-12,44
Albion,3154,9,10,12,14,51,53,-2,42
Stenhousem'r,3154,10,6,8,22,40,76,-36,26
Alloa,3155,1,19,7,10,69,41,28,64
Livingston,3155,2,17,9,10,63,52,11,60
Brechin,3155,3,17,5,14,51,42,9,56
Airdrieon,3155,4,15,9,12,52,51,1,54
East Fife,3155,5,15,8,13,59,50,9,53
Albion,3155,6,15,6,15,53,51,2,51
Stranraer,3155,7,15,2,19,52,55,-3,47
Peterhead,3155,8,12,8,16,45,59,-14,44
Queen's Park,3155,9,12,8,16,34,48,-14,44
Stenhousem'r,3155,10,9,6,21,49,78,-29,33
Alloa,3156,1,21,7,8,70,37,33,70
East Fife,3156,2,16,9,11,48,40,8,57
Albion,3156,3,15,9,12,56,48,8,54
Airdrieon,3156,4,14,10,12,51,53,-2,52
Livingston,3156,5,15,6,15,74,58,16,51
Queen's Park,3156,6,14,6,16,52,60,-8,48
Brechin,3156,7,13,7,16,46,57,-11,46
Stranraer,3156,8,13,6,17,54,61,-7,45
Peterhead,3156,9,11,9,16,49,59,-10,42
Stenhousem'r,3156,10,9,9,18,50,77,-27,36
Livingston,3157,1,24,3,9,88,42,46,75
Brechin,3157,2,21,3,12,59,41,18,66
Alloa,3157,3,18,11,7,68,45,23,65
Peterhead,3157,4,15,9,12,47,46,1,54
Airdrieon,3157,5,14,9,13,51,54,-3,51
Stranraer,3157,6,12,5,19,50,62,-12,41
East Fife,3157,7,11,8,17,45,57,-12,41
Albion,3157,8,11,7,18,54,63,-9,40
Queen's Park,3157,9,9,11,16,35,56,-21,38
Stenhousem'r,3157,10,8,8,20,47,78,-31,32
Livingston,3158,1,21,5,10,78,43,35,68
Alloa,3158,2,19,7,10,72,51,21,64
Brechin,3158,3,18,6,12,59,51,8,60
Airdrieon,3158,4,18,5,13,53,50,3,59
Peterhead,3158,5,16,6,14,52,52,0,54
Albion,3158,6,16,5,15,55,54,1,53
Queen's Park,3158,7,15,7,14,43,48,-5,52
Stranraer,3158,8,10,6,20,45,63,-18,36
Stenhousem'r,3158,9,9,9,18,52,77,-25,36
East Fife,3158,10,6,8,22,35,55,-20,26
Livingston,3159,1,25,3,8,85,41,44,78
Alloa,3159,2,18,4,14,72,52,20,58
Airdrieon,3159,3,17,6,13,66,57,9,57
Peterhead,3159,4,17,4,15,51,54,-3,55
East Fife,3159,5,15,8,13,54,46,8,53
Stranraer,3159,6,15,6,15,54,61,-7,51
Brechin,3159,7,14,8,14,50,48,2,50
Albion,3159,8,12,8,16,52,56,-4,44
Queen's Park,3159,9,12,6,18,39,63,-24,42
Stenhousem'r,3159,10,5,7,24,40,85,-45,22
Livingston,3160,1,25,1,10,86,48,38,76
Albion,3160,2,19,6,11,62,48,14,63
Alloa,3160,3,16,9,11,67,45,22,57
Airdrieon,3160,4,17,6,13,61,53,8,57
Brechin,3160,5,17,6,13,49,47,2,57
Peterhead,3160,6,12,9,15,39,49,-10,45
Stranraer,3160,7,11,7,18,53,69,-16,40
East Fife,3160,8,9,11,16,48,55,-7,38
Queen's Park,3160,9,10,8,18,33,60,-27,38
Stenhousem'r,3160,10,8,9,19,50,74,-24,33
Alloa,3161,1,22,8,6,77,40,37,74
Brechin,3161,2,20,6,10,57,40,17,66
Airdrieon,3161,3,20,6,10,62,53,9,66
Livingston,3161,4,21,1,14,71,43,28,64
Queen's Park,3161,5,17,5,14,43,48,-5,56
East Fife,3161,6,13,6,17,53,53,0,45
Albion,3161,7,12,5,19,40,59,-19,41
Peterhead,3161,8,11,5,20,42,57,-15,38
Stranraer,3161,9,10,4,22,43,61,-18,34
Stenhousem'r,3161,10,8,6,22,53,87,-34,30
Alloa,3162,1,20,10,6,69,39,30,70
Livingston,3162,2,21,5,10,85,45,40,68
Airdrieon,3162,3,17,10,9,56,46,10,61
Brechin,3162,4,16,5,15,50,55,-5,53
Queen's Park,3162,5,15,6,15,40,46,-6,51
Albion,3162,6,14,5,17,58,63,-5,47
East Fife,3162,7,10,12,14,51,59,-8,42
Peterhead,3162,8,11,9,16,46,59,-13,42
Stranraer,3162,9,9,8,19,39,55,-16,35
Stenhousem'r,3162,10,7,10,19,44,71,-27,31
Livingston,3163,1,23,4,9,84,50,34,73
Airdrieon,3163,2,18,7,11,53,47,6,61
Alloa,3163,3,15,10,11,63,44,19,55
Brechin,3163,4,16,5,15,51,51,0,53
Stranraer,3163,5,15,7,14,55,50,5,52
Albion,3163,6,14,6,16,47,56,-9,48
Peterhead,3163,7,12,11,13,48,51,-3,47
East Fife,3163,8,11,8,17,51,50,1,41
Queen's Park,3163,9,12,4,20,34,53,-19,40
Stenhousem'r,3163,10,8,10,18,45,79,-34,34
Alloa,3164,1,23,5,8,69,37,32,74
Livingston,3164,2,22,6,8,74,44,30,72
Airdrieon,3164,3,16,7,13,64,54,10,55
Brechin,3164,4,16,4,16,55,54,1,52
Albion,3164,5,14,7,15,51,58,-7,49
Peterhead,3164,6,14,7,15,52,60,-8,49
East Fife,3164,7,13,6,17,50,44,6,45
Queen's Park,3164,8,13,6,17,43,54,-11,45
Stenhousem'r,3164,9,8,10,18,48,76,-28,34
Stranraer,3164,10,9,6,21,51,76,-25,33
Livingston,3165,1,19,8,9,71,45,26,65
Alloa,3165,2,18,10,8,71,47,24,64
Airdrieon,3165,3,17,6,13,67,61,6,57
Brechin,3165,4,16,5,15,48,46,2,53
East Fife,3165,5,13,9,14,50,52,-2,48
Albion,3165,6,12,11,13,57,51,6,47
Stranraer,3165,7,13,6,17,48,58,-10,45
Queen's Park,3165,8,13,6,17,41,62,-21,45
Peterhead,3165,9,12,8,16,53,54,-1,44
Stenhousem'r,3165,10,9,7,20,46,76,-30,34
Livingston,3166,1,21,3,12,72,46,26,66
Alloa,3166,2,18,10,8,65,45,20,64
Peterhead,3166,3,17,6,13,53,52,1,57
Brechin,3166,4,17,5,14,54,47,7,56
East Fife,3166,5,14,10,12,58,44,14,52
Stranraer,3166,6,15,4,17,55,58,-3,49
Airdrieon,3166,7,14,5,17,59,66,-7,47
Queen's Park,3166,8,13,5,18,40,60,-20,44
Albion,3166,9,12,7,17,52,53,-1,43
Stenhousem'r,3166,10,7,9,20,51,88,-37,30
Livingston,3167,1,24,2,10,72,46,26,74
Alloa,3167,2,21,7,8,73,43,30,70
Albion,3167,3,17,7,12,59,51,8,58
Brechin,3167,4,15,6,15,50,45,5,51
Airdrieon,3167,5,14,9,13,52,55,-3,51
Queen's Park,3167,6,15,5,16,38,51,-13,50
East Fife,3167,7,11,10,15,43,40,3,43
Peterhead,3167,8,11,9,16,50,59,-9,42
Stranraer,3167,9,10,7,19,48,60,-12,37
Stenhousem'r,3167,10,9,4,23,40,75,-35,31
Alloa,3168,1,19,10,7,77,44,33,67
Brechin,3168,2,17,7,12,57,48,9,58
Livingston,3168,3,17,6,13,79,63,16,57
Airdrieon,3168,4,16,8,12,60,62,-2,56
Queen's Park,3168,5,17,5,14,41,48,-7,56
Albion,3168,6,13,10,13,51,55,-4,49
Stranraer,3168,7,13,8,15,56,56,0,47
East Fife,3168,8,11,9,16,47,46,1,42
Peterhead,3168,9,10,10,16,48,62,-14,40
Stenhousem'r,3168,10,8,5,23,48,80,-32,29
Livingston,3169,1,24,3,9,81,47,34,75
Stranraer,3169,2,15,6,15,46,48,-2,51
Airdrieon,3169,3,14,9,13,50,55,-5,51
Alloa,3169,4,14,8,14,74,58,16,50
Peterhead,3169,5,13,11,12,58,55,3,50
Albion,3169,6,12,13,11,52,52,0,49
Brechin,3169,7,14,7,15,49,58,-9,49
East Fife,3169,8,10,14,12,53,51,2,44
Queen's Park,3169,9,11,8,17,30,51,-21,41
Stenhousem'r,3169,10,8,11,17,54,72,-18,35
Alloa,3170,1,22,7,7,82,45,37,73
Livingston,3170,2,22,5,9,77,47,30,71
Brechin,3170,3,18,5,13,53,59,-6,59
Airdrieon,3170,4,15,10,11,57,54,3,55
Queen's Park,3170,5,13,10,13,48,49,-1,49
Peterhead,3170,6,12,8,16,51,55,-4,44
Albion,3170,7,12,8,16,58,64,-6,44
East Fife,3170,8,12,7,17,53,52,1,43
Stranraer,3170,9,12,6,18,54,70,-16,42
Stenhousem'r,3170,10,6,6,24,46,84,-38,24
Alloa,3171,1,22,6,8,76,43,33,72
Livingston,3171,2,21,4,11,74,47,27,67
Albion,3171,3,18,4,14,55,46,9,58
Airdrieon,3171,4,17,6,13,63,58,5,57
Brechin,3171,5,16,6,14,50,50,0,54
Peterhead,3171,6,15,6,15,53,61,-8,51
Stranraer,3171,7,14,3,19,49,58,-9,45
East Fife,3171,8,12,6,18,50,51,-1,42
Queen's Park,3171,9,10,5,21,36,59,-23,35
Stenhousem'r,3171,10,9,6,21,49,82,-33,33
Livingston,3172,1,21,2,13,77,53,24,65
Brechin,3172,2,18,9,9,49,33,16,63
Airdrieon,3172,3,18,6,12,59,49,10,60
Alloa,3172,4,16,6,14,68,52,16,54
East Fife,3172,5,14,8,14,42,39,3,50
Peterhead,3172,6,14,8,14,45,51,-6,50
Albion,3172,7,14,6,16,51,51,0,48
Stenhousem'r,3172,8,12,5,19,48,70,-22,41
Stranraer,3172,9,11,7,18,47,60,-13,40
Queen's Park,3172,10,11,5,20,31,59,-28,38
Livingston,3173,1,20,5,11,74,46,28,65
Brechin,3173,2,17,6,13,51,47,4,57
Alloa,3173,3,14,13,9,60,41,19,55
Queen's Park,3173,4,14,10,12,36,44,-8,52
Stranraer,3173,5,13,9,14,52,59,-7,48
East Fife,3173,6,12,11,13,53,43,10,47
Peterhead,3173,7,12,11,13,55,54,1,47
Airdrieon,3173,8,12,8,16,46,55,-9,44
Albion,3173,9,11,9,16,41,52,-11,42
Stenhousem'r,3173,10,10,8,18,47,74,-27,38
Alloa,3174,1,18,7,11,73,39,34,61
Livingston,3174,2,18,6,12,74,57,17,60
Albion,3174,3,18,6,12,63,54,9,60
Brechin,3174,4,16,5,15,57,50,7,53
Airdrieon,3174,5,16,5,15,63,65,-2,53
East Fife,3174,6,13,12,11,52,50,2,51
Peterhead,3174,7,14,8,14,48,51,-3,50
Stranraer,3174,8,11,7,18,50,64,-14,40
Queen's Park,3174,9,11,7,18,32,53,-21,40
Stenhousem'r,3174,10,8,11,17,45,74,-29,35
Livingston,3175,1,21,5,10,74,42,32,68
Alloa,3175,2,18,8,10,66,42,24,62
Airdrieon,3175,3,18,4,14,65,53,12,58
Brechin,3175,4,17,5,14,53,50,3,56
Peterhead,3175,5,14,8,14,46,52,-6,50
Albion,3175,6,15,5,16,53,62,-9,50
Stranraer,3175,7,14,6,16,51,52,-1,48
Queen's Park,3175,8,13,6,17,42,61,-19,45
East Fife,3175,9,11,11,14,52,45,7,44
Stenhousem'r,3175,10,6,8,22,43,86,-43,26
Livingston,3176,1,21,10,5,81,43,38,73
Alloa,3176,2,18,10,8,70,47,23,64
Brechin,3176,3,17,9,10,56,42,14,60
Queen's Park,3176,4,14,8,14,45,54,-9,50
Peterhead,3176,5,13,8,15,50,51,-1,47
Airdrieon,3176,6,13,7,16,49,65,-16,46
Stranraer,3176,7,11,9,16,46,55,-9,42
Albion,3176,8,12,6,18,52,64,-12,42
East Fife,3176,9,11,6,19,51,53,-2,39
Stenhousem'r,3176,10,10,7,19,48,74,-26,37
Livingston,3177,1,22,4,10,80,47,33,70
Alloa,3177,2,18,7,11,66,42,24,61
Albion,3177,3,15,10,11,54,50,4,55
Brechin,3177,4,16,6,14,51,54,-3,54
Airdrieon,3177,5,16,5,15,55,53,2,53
Peterhead,3177,6,14,10,12,50,47,3,52
Stranraer,3177,7,14,4,18,56,63,-7,46
Queen's Park,3177,8,12,7,17,41,52,-11,43
East Fife,3177,9,10,8,18,45,58,-13,38
Stenhousem'r,3177,10,8,9,19,45,77,-32,33
Livingston,3178,1,20,9,7,74,39,35,69
Alloa,3178,2,17,11,8,67,41,26,62
Albion,3178,3,16,8,12,60,57,3,56
Airdrieon,3178,4,16,6,14,56,52,4,54
Queen's Park,3178,5,14,9,13,46,50,-4,51
Brechin,3178,6,15,5,16,58,63,-5,50
Stranraer,3178,7,13,7,16,56,65,-9,46
East Fife,3178,8,11,9,16,55,54,1,42
Peterhead,3178,9,10,9,17,44,56,-12,39
Stenhousem'r,3178,10,6,11,19,46,85,-39,29
Alloa,3179,1,21,8,7,75,42,33,71
Livingston,3179,2,19,7,10,76,51,25,64
Brechin,3179,3,18,4,14,59,53,6,58
Airdrieon,3179,4,15,7,14,48,57,-9,52
East Fife,3179,5,14,9,13,53,49,4,51
Albion,3179,6,13,10,13,59,55,4,49
Peterhead,3179,7,10,13,13,46,52,-6,43
Stranraer,3179,8,12,7,17,53,65,-12,43
Queen's Park,3179,9,11,6,19,33,52,-19,39
Stenhousem'r,3179,10,7,9,20,51,77,-26,30
Livingston,3180,1,21,7,8,80,43,37,70
Alloa,3180,2,20,7,9,76,46,30,67
Brechin,3180,3,18,7,11,56,47,9,61
East Fife,3180,4,15,8,13,60,53,7,53
Peterhead,3180,5,13,10,13,50,49,1,49
Stranraer,3180,6,12,8,16,50,54,-4,44
Airdrieon,3180,7,13,5,18,47,66,-19,44
Albion,3180,8,12,7,17,60,68,-8,43
Queen's Park,3180,9,12,6,18,38,54,-16,42
Stenhousem'r,3180,10,8,7,21,50,87,-37,31
Livingston,3181,1,21,8,7,81,45,36,71
East Fife,3181,2,16,9,11,51,46,5,57
Alloa,3181,3,15,10,11,63,58,5,55
Brechin,3181,4,15,7,14,49,46,3,52
Albion,3181,5,14,8,14,61,53,8,50
Airdrieon,3181,6,13,11,12,62,65,-3,50
Stranraer,3181,7,13,7,16,53,62,-9,46
Queen's Park,3181,8,14,4,18,36,50,-14,46
Peterhead,3181,9,11,12,13,48,53,-5,45
Stenhousem'r,3181,10,5,10,21,47,73,-26,25
Livingston,3182,1,18,9,9,77,47,30,63
Alloa,3182,2,17,8,11,68,44,24,59
Brechin,3182,3,16,8,12,48,46,2,56
Albion,3182,4,16,5,15,49,50,-1,53
Stranraer,3182,5,14,7,15,53,59,-6,49
Peterhead,3182,6,11,14,11,47,44,3,47
Queen's Park,3182,7,13,8,15,33,47,-14,47
East Fife,3182,8,13,7,16,58,48,10,46
Airdrieon,3182,9,13,6,17,48,74,-26,45
Stenhousem'r,3182,10,9,8,19,48,70,-22,35
Livingston,3183,1,21,10,5,83,43,40,73
Alloa,3183,2,18,13,5,77,41,36,67
Airdrieon,3183,3,17,10,9,65,55,10,61
Brechin,3183,4,17,7,12,57,49,8,58
Queen's Park,3183,5,13,9,14,41,52,-11,48
East Fife,3183,6,12,8,16,47,49,-2,44
Peterhead,3183,7,10,11,15,43,48,-5,41
Albion,3183,8,10,9,17,56,69,-13,39
Stenhousem'r,3183,9,9,7,20,46,84,-38,34
Stranraer,3183,10,8,6,22,39,64,-25,30
Alloa,3184,1,23,5,8,72,40,32,74
Livingston,3184,2,20,8,8,81,47,34,68
Brechin,3184,3,17,5,14,54,54,0,56
Peterhead,3184,4,16,7,13,52,51,1,55
Albion,3184,5,12,11,13,53,51,2,47
East Fife,3184,6,14,5,17,44,42,2,47
Airdrieon,3184,7,12,8,16,45,52,-7,44
Stranraer,3184,8,12,8,16,48,57,-9,44
Queen's Park,3184,9,11,6,19,42,61,-19,39
Stenhousem'r,3184,10,8,7,21,41,77,-36,31
Livingston,3185,1,21,3,12,84,51,33,66
Albion,3185,2,17,10,9,51,47,4,61
Airdrieon,3185,3,16,7,13,57,49,8,55
Alloa,3185,4,16,6,14,65,49,16,54
Brechin,3185,5,16,5,15,53,63,-10,53
Peterhead,3185,6,13,9,14,57,56,1,48
Stranraer,3185,7,13,7,16,50,51,-1,46
Queen's Park,3185,8,12,8,16,37,52,-15,44
East Fife,3185,9,9,13,14,48,52,-4,40
Stenhousem'r,3185,10,10,6,20,51,83,-32,36
Alloa,3186,1,23,5,8,78,39,39,74
Airdrieon,3186,2,20,7,9,63,41,22,67
Livingston,3186,3,19,5,12,71,58,13,62
Brechin,3186,4,16,6,14,38,44,-6,54
Stranraer,3186,5,15,5,16,51,49,2,50
East Fife,3186,6,13,9,14,56,44,12,48
Albion,3186,7,13,7,16,53,54,-1,46
Peterhead,3186,8,11,7,18,37,59,-22,40
Queen's Park,3186,9,11,7,18,35,57,-22,40
Stenhousem'r,3186,10,7,6,23,44,81,-37,27
Livingston,3187,1,19,5,12,67,47,20,62
Alloa,3187,2,18,7,11,73,45,28,61
Peterhead,3187,3,16,8,12,45,42,3,56
Albion,3187,4,15,6,15,55,54,1,51
Airdrieon,3187,5,15,6,15,50,56,-6,51
Queen's Park,3187,6,15,5,16,44,55,-11,50
Brechin,3187,7,13,8,15,46,49,-3,47
Stranraer,3187,8,12,10,14,44,51,-7,46
East Fife,3187,9,10,10,16,50,54,-4,40
Stenhousem'r,3187,10,11,7,18,41,62,-21,40
Alloa,3188,1,23,7,6,77,41,36,76
Livingston,3188,2,22,5,9,74,43,31,71
Airdrieon,3188,3,16,5,15,58,59,-1,53
Peterhead,3188,4,15,7,14,54,49,5,52
Brechin,3188,5,13,8,15,52,55,-3,47
East Fife,3188,6,11,11,14,50,53,-3,44
Albion,3188,7,11,10,15,55,61,-6,43
Queen's Park,3188,8,12,7,17,37,52,-15,43
Stranraer,3188,9,12,6,18,46,56,-10,42
Stenhousem'r,3188,10,9,6,21,50,84,-34,33
Alloa,3189,1,19,9,8,73,44,29,66
Livingston,3189,2,19,7,10,79,51,28,64
Airdrieon,3189,3,14,14,8,63,52,11,56
East Fife,3189,4,12,12,12,49,41,8,48
Peterhead,3189,5,12,11,13,61,62,-1,47
Brechin,3189,6,12,10,14,45,46,-1,46
Stranraer,3189,7,11,12,13,46,58,-12,45
Queen's Park,3189,8,12,8,16,35,53,-18,44
Albion,3189,9,11,10,15,44,55,-11,43
Stenhousem'r,3189,10,6,11,19,38,71,-33,29
Livingston,3190,1,20,5,11,77,48,29,65
Brechin,3190,2,19,3,14,50,49,1,60
Alloa,3190,3,16,6,14,62,47,15,54
Albion,3190,4,16,5,15,56,51,5,53
Airdrieon,3190,5,14,11,11,52,49,3,53
Queen's Park,3190,6,15,7,14,37,40,-3,52
Peterhead,3190,7,14,9,13,56,54,2,51
Stranraer,3190,8,14,5,17,53,64,-11,47
East Fife,3190,9,13,6,17,55,55,0,45
Stenhousem'r,3190,10,6,9,21,40,81,-41,27
Alloa,3191,1,20,7,9,73,45,28,67
Albion,3191,2,18,8,10,68,46,22,62
Livingston,3191,3,17,7,12,73,53,20,58
Airdrieon,3191,4,14,10,12,61,54,7,52
Stranraer,3191,5,15,7,14,60,63,-3,52
Peterhead,3191,6,14,9,13,51,56,-5,51
Brechin,3191,7,13,8,15,49,52,-3,47
Queen's Park,3191,8,11,9,16,37,47,-10,42
East Fife,3191,9,9,10,17,48,59,-11,37
Stenhousem'r,3191,10,8,7,21,46,91,-45,31
Livingston,3192,1,25,2,9,83,46,37,77
Alloa,3192,2,19,8,9,66,40,26,65
Airdrieon,3192,3,16,8,12,59,54,5,56
Brechin,3192,4,16,5,15,46,47,-1,53
Peterhead,3192,5,14,9,13,55,46,9,51
Albion,3192,6,13,9,14,55,58,-3,48
Queen's Park,3192,7,12,9,15,36,42,-6,45
Stranraer,3192,8,11,6,19,42,61,-19,39
East Fife,3192,9,9,11,16,42,52,-10,38
Stenhousem'r,3192,10,8,7,21,45,83,-38,31
Livingston,3193,1,22,3,11,86,57,29,69
Alloa,3193,2,20,8,8,76,40,36,68
Albion,3193,3,16,6,14,58,47,11,54
Airdrieon,3193,4,15,6,15,55,76,-21,51
East Fife,3193,5,13,10,13,54,48,6,49
Stranraer,3193,6,12,10,14,60,57,3,46
Peterhead,3193,7,13,7,16,52,63,-11,46
Brechin,3193,8,13,6,17,48,61,-13,45
Stenhousem'r,3193,9,12,5,19,57,75,-18,41
Queen's Park,3193,10,10,7,19,41,63,-22,37
Airdrieon,3194,1,20,6,10,52,40,12,66
Alloa,3194,2,19,5,12,65,44,21,62
Livingston,3194,3,18,8,10,69,51,18,62
Albion,3194,4,14,9,13,60,57,3,51
Peterhead,3194,5,14,9,13,50,52,-2,51
East Fife,3194,6,13,8,15,56,48,8,47
Brechin,3194,7,13,8,15,47,54,-7,47
Stranraer,3194,8,12,6,18,47,60,-13,42
Queen's Park,3194,9,10,8,18,40,59,-19,38
Stenhousem'r,3194,10,11,5,20,52,73,-21,38
Livingston,3195,1,25,3,8,85,39,46,78
Brechin,3195,2,19,9,8,50,37,13,66
Alloa,3195,3,16,9,11,61,43,18,57
Peterhead,3195,4,17,6,13,52,47,5,57
East Fife,3195,5,14,11,11,56,42,14,53
Airdrieon,3195,6,13,9,14,55,64,-9,48
Albion,3195,7,13,6,17,55,57,-2,45
Stranraer,3195,8,10,10,16,44,61,-17,40
Queen's Park,3195,9,8,9,19,29,50,-21,33
Stenhousem'r,3195,10,6,6,24,44,91,-47,24
Livingston,3196,1,26,4,6,86,44,42,82
Peterhead,3196,2,17,6,13,51,50,1,57
Albion,3196,3,17,5,14,59,51,8,56
Alloa,3196,4,15,10,11,59,44,15,55
Airdrieon,3196,5,17,4,15,64,56,8,55
Brechin,3196,6,13,8,15,49,57,-8,47
Queen's Park,3196,7,12,7,17,43,58,-15,43
East Fife,3196,8,10,11,15,49,50,-1,41
Stranraer,3196,9,11,5,20,56,68,-12,38
Stenhousem'r,3196,10,8,8,20,47,85,-38,32
Brechin,3197,1,22,4,10,58,46,12,70
Livingston,3197,2,21,4,11,72,43,29,67
Alloa,3197,3,17,7,12,77,50,27,58
Peterhead,3197,4,16,9,11,58,45,13,57
Airdrieon,3197,5,16,7,13,64,57,7,55
Queen's Park,3197,6,14,7,15,40,51,-11,49
Stranraer,3197,7,12,6,18,49,73,-24,42
Albion,3197,8,11,6,19,42,56,-14,39
Stenhousem'r,3197,9,9,8,19,49,78,-29,35
East Fife,3197,10,8,10,18,44,54,-10,34
Alloa,3198,1,19,6,11,65,46,19,63
Brechin,3198,2,19,5,12,59,46,13,62
Livingston,3198,3,17,10,9,75,56,19,61
Airdrieon,3198,4,16,9,11,54,52,2,57
Albion,3198,5,14,12,10,51,45,6,54
Peterhead,3198,6,14,8,14,53,50,3,50
Stranraer,3198,7,12,7,17,50,59,-9,43
Queen's Park,3198,8,10,10,16,35,48,-13,40
East Fife,3198,9,9,11,16,54,56,-2,38
Stenhousem'r,3198,10,6,10,20,44,82,-38,28
Livingston,3199,1,27,1,8,82,36,46,82
Alloa,3199,2,20,8,8,68,42,26,68
Brechin,3199,3,19,4,13,53,52,1,61
Albion,3199,4,15,10,11,61,50,11,55
Airdrieon,3199,5,16,5,15,50,46,4,53
Queen's Park,3199,6,14,4,18,41,56,-15,46
East Fife,3199,7,11,9,16,53,61,-8,42
Peterhead,3199,8,12,6,18,48,63,-15,42
Stenhousem'r,3199,9,7,10,19,55,78,-23,31
Stranraer,3199,10,8,5,23,36,63,-27,29
Livingston,3200,1,21,6,9,79,47,32,69
Alloa,3200,2,18,9,9,75,50,25,63
Albion,3200,3,18,8,10,54,45,9,62
Airdrieon,3200,4,17,6,13,55,48,7,57
Queen's Park,3200,5,15,9,12,45,47,-2,54
Brechin,3200,6,15,7,14,54,53,1,52
Peterhead,3200,7,13,8,15,42,44,-2,47
Stranraer,3200,8,12,6,18,46,60,-14,42
East Fife,3200,9,7,9,20,36,56,-20,30
Stenhousem'r,3200,10,6,8,22,42,78,-36,26
Brechin,3201,1,21,6,9,60,44,16,69
Airdrieon,3201,2,21,5,10,73,48,25,68
Alloa,3201,3,19,8,9,71,46,25,65
Livingston,3201,4,19,3,14,67,44,23,60
Albion,3201,5,17,9,10,56,47,9,60
Peterhead,3201,6,14,6,16,52,54,-2,48
East Fife,3201,7,12,7,17,46,52,-6,43
Queen's Park,3201,8,9,9,18,31,53,-22,36
Stranraer,3201,9,10,5,21,43,61,-18,35
Stenhousem'r,3201,10,6,6,24,44,94,-50,24
Alloa,3202,1,21,6,9,86,43,43,69
Livingston,3202,2,20,5,11,78,51,27,65
Peterhead,3202,3,15,9,12,53,52,1,54
Albion,3202,4,14,8,14,51,52,-1,50
Airdrieon,3202,5,15,5,16,56,59,-3,50
Brechin,3202,6,13,9,14,45,50,-5,48
Queen's Park,3202,7,12,10,14,39,56,-17,46
Stranraer,3202,8,13,3,20,52,70,-18,42
Stenhousem'r,3202,9,11,7,18,48,73,-25,40
East Fife,3202,10,9,12,15,51,53,-2,39
Livingston,3203,1,21,6,9,67,38,29,69
Alloa,3203,2,19,8,9,69,42,27,65
Airdrieon,3203,3,20,3,13,57,52,5,63
Brechin,3203,4,16,7,13,52,48,4,55
Queen's Park,3203,5,16,7,13,41,45,-4,55
Peterhead,3203,6,14,6,16,49,54,-5,48
Albion,3203,7,13,7,16,56,59,-3,46
Stranraer,3203,8,10,6,20,44,58,-14,36
East Fife,3203,9,8,11,17,47,57,-10,35
Stenhousem'r,3203,10,9,7,20,42,71,-29,34
Alloa,3204,1,21,5,10,86,46,40,68
Brechin,3204,2,21,5,10,60,44,16,68
Livingston,3204,3,20,3,13,70,51,19,63
Stranraer,3204,4,17,5,14,59,52,7,56
Airdrieon,3204,5,16,5,15,58,62,-4,53
Peterhead,3204,6,14,7,15,43,49,-6,49
Albion,3204,7,12,11,13,54,51,3,47
Queen's Park,3204,8,11,10,15,38,58,-20,43
East Fife,3204,9,9,9,18,46,59,-13,36
Stenhousem'r,3204,10,6,6,24,45,87,-42,24
Livingston,3205,1,24,5,7,75,44,31,77
Airdrieon,3205,2,23,4,9,73,49,24,73
Alloa,3205,3,20,8,8,71,38,33,68
Albion,3205,4,14,6,16,56,60,-4,48
East Fife,3205,5,12,8,16,56,53,3,44
Brechin,3205,6,13,5,18,46,52,-6,44
Peterhead,3205,7,11,10,15,55,60,-5,43
Stranraer,3205,8,12,6,18,42,58,-16,42
Queen's Park,3205,9,10,9,17,35,54,-19,39
Stenhousem'r,3205,10,7,7,22,43,84,-41,28
Livingston,3206,1,20,4,12,80,56,24,64
Airdrieon,3206,2,19,4,13,65,57,8,61
Brechin,3206,3,17,5,14,48,53,-5,56
Alloa,3206,4,15,10,11,66,49,17,55
Albion,3206,5,15,8,13,57,57,0,53
Stranraer,3206,6,15,4,17,56,55,1,49
Peterhead,3206,7,14,7,15,54,54,0,49
Queen's Park,3206,8,12,9,15,45,56,-11,45
East Fife,3206,9,9,13,14,41,46,-5,40
Stenhousem'r,3206,10,7,10,19,42,71,-29,31
Livingston,3207,1,20,6,10,78,47,31,66
Peterhead,3207,2,17,10,9,56,46,10,61
Alloa,3207,3,17,9,10,58,41,17,60
Airdrieon,3207,4,18,5,13,56,54,2,59
Brechin,3207,5,14,10,12,45,45,0,52
Stranraer,3207,6,13,6,17,41,48,-7,45
Queen's Park,3207,7,13,6,17,38,51,-13,45
East Fife,3207,8,11,11,14,51,50,1,44
Albion,3207,9,9,9,18,40,60,-20,36
Stenhousem'r,3207,10,9,6,21,47,68,-21,33
Livingston,3208,1,26,3,7,87,39,48,81
Brechin,3208,2,18,8,10,53,39,14,62
Alloa,3208,3,17,7,12,73,53,20,58
Albion,3208,4,15,11,10,57,46,11,56
Airdrieon,3208,5,16,6,14,55,55,0,54
Peterhead,3208,6,11,11,14,50,50,0,44
Queen's Park,3208,7,10,14,12,38,51,-13,44
East Fife,3208,8,8,13,15,44,58,-14,37
Stranraer,3208,9,8,8,20,47,74,-27,32
Stenhousem'r,3208,10,8,5,23,48,87,-39,29
Livingston,3209,1,21,4,11,73,45,28,67
Alloa,3209,2,18,10,8,60,44,16,64
Airdrieon,3209,3,19,7,10,62,51,11,64
Queen's Park,3209,4,18,6,12,41,36,5,60
Brechin,3209,5,17,4,15,46,44,2,55
Albion,3209,6,13,8,15,53,54,-1,47
East Fife,3209,7,13,7,16,47,51,-4,46
Peterhead,3209,8,12,8,16,44,49,-5,44
Stranraer,3209,9,8,6,22,48,68,-20,30
Stenhousem'r,3209,10,7,8,21,51,83,-32,29
Livingston,3210,1,19,8,9,76,50,26,65
Brechin,3210,2,19,6,11,56,37,19,63
Alloa,3210,3,18,7,11,68,46,22,61
Peterhead,3210,4,16,7,13,66,61,5,55
Queen's Park,3210,5,15,9,12,44,43,1,54
Albion,3210,6,15,6,15,52,52,0,51
East Fife,3210,7,11,8,17,50,52,-2,41
Airdrieon,3210,8,10,11,15,55,66,-11,41
Stranraer,3210,9,10,7,19,45,66,-21,37
Stenhousem'r,3210,10,10,5,21,48,87,-39,35
Airdrieon,3211,1,19,9,8,70,49,21,66
Livingston,3211,2,20,5,11,79,58,21,65
Albion,3211,3,17,5,14,57,49,8,56
Alloa,3211,4,16,6,14,63,52,11,54
East Fife,3211,5,15,7,14,53,45,8,52
Brechin,3211,6,14,5,17,48,59,-11,47
Queen's Park,3211,7,13,7,16,42,54,-12,46
Stranraer,3211,8,12,5,19,53,65,-12,41
Peterhead,3211,9,10,10,16,42,47,-5,40
Stenhousem'r,3211,10,10,9,17,51,80,-29,39
Livingston,3212,1,22,3,11,70,41,29,69
Airdrieon,3212,2,19,9,8,64,46,18,66
Queen's Park,3212,3,16,9,11,53,51,2,57
Alloa,3212,4,15,11,10,62,43,19,56
Brechin,3212,5,16,8,12,56,48,8,56
Peterhead,3212,6,13,8,15,39,43,-4,47
East Fife,3212,7,11,11,14,47,47,0,44
Albion,3212,8,11,5,20,42,62,-20,38
Stranraer,3212,9,10,7,19,43,62,-19,37
Stenhousem'r,3212,10,9,5,22,41,74,-33,32
Brechin,3213,1,20,4,12,53,47,6,64
Alloa,3213,2,18,6,12,62,45,17,60
Peterhead,3213,3,17,8,11,51,45,6,59
Livingston,3213,4,18,4,14,64,57,7,58
Airdrieon,3213,5,15,10,11,60,49,11,55
Albion,3213,6,13,11,12,50,47,3,50
East Fife,3213,7,12,12,12,46,40,6,48
Queen's Park,3213,8,13,3,20,42,56,-14,42
Stenhousem'r,3213,9,8,10,18,48,74,-26,34
Stranraer,3213,10,9,6,21,49,65,-16,33
Airdrieon,3214,1,19,6,11,58,46,12,63
Alloa,3214,2,18,7,11,67,48,19,61
Livingston,3214,3,19,3,14,66,56,10,60
Peterhead,3214,4,16,7,13,50,53,-3,55
East Fife,3214,5,15,9,12,58,44,14,54
Stranraer,3214,6,15,6,15,60,55,5,51
Brechin,3214,7,14,7,15,48,47,1,49
Queen's Park,3214,8,13,5,18,39,52,-13,44
Albion,3214,9,10,9,17,50,59,-9,39
Stenhousem'r,3214,10,7,9,20,43,79,-36,30
Livingston,3215,1,21,4,11,77,53,24,67
Alloa,3215,2,19,9,8,69,43,26,66
Airdrieon,3215,3,19,8,9,66,50,16,65
Albion,3215,4,14,7,15,51,51,0,49
Brechin,3215,5,14,5,17,45,49,-4,47
Stranraer,3215,6,14,5,17,59,66,-7,47
Peterhead,3215,7,13,6,17,47,56,-9,45
Queen's Park,3215,8,11,11,14,40,50,-10,44
East Fife,3215,9,9,13,14,48,48,0,40
Stenhousem'r,3215,10,9,6,21,48,84,-36,33
Alloa,3216,1,20,7,9,76,45,31,67
Livingston,3216,2,19,6,11,72,51,21,63
Brechin,3216,3,17,10,9,51,47,4,61
Albion,3216,4,17,8,11,65,46,19,59
Queen's Park,3216,5,13,5,18,37,53,-16,44
Stranraer,3216,6,10,13,13,46,54,-8,43
Peterhead,3216,7,11,10,15,45,54,-9,43
Airdrieon,3216,8,11,9,16,47,55,-8,42
East Fife,3216,9,10,11,15,48,51,-3,41
Stenhousem'r,3216,10,8,9,19,47,78,-31,33
Livingston,3217,1,24,3,9,75,47,28,75
Alloa,3217,2,17,10,9,77,50,27,61
Airdrieon,3217,3,16,11,9,62,53,9,59
Brechin,3217,4,17,4,15,48,50,-2,55
Albion,3217,5,16,6,14,65,52,13,54
Stranraer,3217,6,17,3,16,55,51,4,54
Peterhead,3217,7,10,10,16,37,50,-13,40
East Fife,3217,8,10,8,18,52,60,-8,38
Queen's Park,3217,9,10,6,20,30,56,-26,36
Stenhousem'r,3217,10,8,9,19,49,81,-32,33
Alloa,3218,1,21,8,7,75,44,31,71
Livingston,3218,2,20,3,13,74,53,21,63
Airdrieon,3218,3,19,4,13,62,56,6,61
Brechin,3218,4,17,7,12,52,44,8,58
Stranraer,3218,5,14,4,18,55,63,-8,46
Albion,3218,6,12,9,15,52,60,-8,45
Peterhead,3218,7,12,8,16,46,51,-5,44
Queen's Park,3218,8,12,8,16,37,49,-12,44
East Fife,3218,9,9,10,17,49,60,-11,37
Stenhousem'r,3218,10,10,7,19,54,76,-22,37
Alloa,3219,1,22,7,7,67,34,33,73
Livingston,3219,2,21,5,10,82,44,38,68
Airdrieon,3219,3,19,6,11,73,55,18,63
Brechin,3219,4,17,9,10,57,47,10,60
Stranraer,3219,5,15,5,16,52,56,-4,50
East Fife,3219,6,11,7,18,41,51,-10,40
Queen's Park,3219,7,11,7,18,41,64,-23,40
Peterhead,3219,8,10,8,18,52,65,-13,38
Stenhousem'r,3219,9,11,5,20,47,79,-32,38
Albion,3219,10,10,7,19,41,58,-17,37
Airdrieon,3220,1,21,5,10,74,53,21,68
Livingston,3220,2,21,3,12,78,51,27,66
Alloa,3220,3,19,8,9,65,41,24,65
Brechin,3220,4,17,6,13,57,49,8,57
Albion,3220,5,15,7,14,60,60,0,52
East Fife,3220,6,13,7,16,50,51,-1,46
Peterhead,3220,7,9,14,13,42,52,-10,41
Queen's Park,3220,8,11,8,17,36,47,-11,41
Stranraer,3220,9,12,4,20,51,73,-22,40
Stenhousem'r,3220,10,5,12,19,38,74,-36,27
Alloa,3221,1,21,6,9,78,45,33,69
Airdrieon,3221,2,20,7,9,62,45,17,67
Brechin,3221,3,19,9,8,56,43,13,66
Livingston,3221,4,19,5,12,69,46,23,62
Peterhead,3221,5,15,7,14,47,48,-1,52
Albion,3221,6,13,10,13,53,52,1,49
Stranraer,3221,7,11,8,17,45,52,-7,41
Queen's Park,3221,8,9,11,16,32,54,-22,38
East Fife,3221,9,6,12,18,41,55,-14,30
Stenhousem'r,3221,10,4,11,21,39,82,-43,23
Livingston,3222,1,24,3,9,86,50,36,75
Alloa,3222,2,19,7,10,66,41,25,64
Airdrieon,3222,3,19,5,12,67,60,7,62
Albion,3222,4,15,10,11,53,51,2,55
Brechin,3222,5,17,3,16,50,47,3,54
Peterhead,3222,6,14,8,14,65,58,7,50
Queen's Park,3222,7,11,9,16,45,59,-14,42
Stranraer,3222,8,12,5,19,47,63,-16,41
East Fife,3222,9,9,8,19,46,53,-7,35
Stenhousem'r,3222,10,7,8,21,45,88,-43,29
Alloa,3223,1,19,12,5,76,39,37,69
Livingston,3223,2,19,4,13,68,47,21,61
Queen's Park,3223,3,16,10,10,50,43,7,58
Airdrieon,3223,4,14,9,13,54,57,-3,51
Peterhead,3223,5,13,8,15,52,52,0,47
Brechin,3223,6,13,8,15,44,52,-8,47
Albion,3223,7,12,9,15,43,55,-12,45
East Fife,3223,8,12,7,17,54,58,-4,43
Stenhousem'r,3223,9,10,9,17,53,75,-22,39
Stranraer,3223,10,8,12,16,45,61,-16,36
Livingston,3224,1,18,10,8,80,54,26,64
Alloa,3224,2,17,7,12,70,48,22,58
Albion,3224,3,14,14,8,62,52,10,56
Brechin,3224,4,15,4,17,45,57,-12,49
Airdrieon,3224,5,13,9,14,54,54,0,48
Peterhead,3224,6,13,9,14,55,59,-4,48
Queen's Park,3224,7,11,13,12,38,50,-12,46
East Fife,3224,8,11,12,13,47,47,0,45
Stranraer,3224,9,11,8,17,55,63,-8,41
Stenhousem'r,3224,10,8,12,16,57,79,-22,36
Livingston,3225,1,21,2,13,76,51,25,65
Alloa,3225,2,17,11,8,70,47,23,62
Airdrieon,3225,3,17,8,11,56,46,10,59
Peterhead,3225,4,17,6,13,54,45,9,57
Brechin,3225,5,15,9,12,44,48,-4,54
Albion,3225,6,13,10,13,50,51,-1,49
Stranraer,3225,7,12,10,14,51,55,-4,46
Queen's Park,3225,8,11,6,19,35,51,-16,39
East Fife,3225,9,7,14,15,40,49,-9,35
Stenhousem'r,3225,10,7,10,19,38,71,-33,31
Brechin,3226,1,21,3,12,63,44,19,66
Livingston,3226,2,20,5,11,74,57,17,65
Airdrieon,3226,3,17,9,10,57,48,9,60
Alloa,3226,4,15,14,7,76,52,24,59
East Fife,3226,5,14,10,12,48,45,3,52
Peterhead,3226,6,14,8,14,53,56,-3,50
Queen's Park,3226,7,14,8,14,51,57,-6,50
Albion,3226,8,11,10,15,54,64,-10,43
Stranraer,3226,9,11,4,21,47,64,-17,37
Stenhousem'r,3226,10,4,7,25,43,79,-36,19
Alloa,3227,1,23,4,9,87,45,42,73
Livingston,3227,2,21,5,10,71,37,34,68
Airdrieon,3227,3,22,2,12,63,54,9,68
Brechin,3227,4,18,5,13,56,49,7,59
Peterhead,3227,5,13,8,15,46,51,-5,47
East Fife,3227,6,11,11,14,48,45,3,44
Queen's Park,3227,7,12,6,18,29,53,-24,42
Stranraer,3227,8,11,7,18,45,53,-8,40
Albion,3227,9,8,11,17,42,60,-18,35
Stenhousem'r,3227,10,8,7,21,44,84,-40,31
Brechin,3228,1,21,6,9,58,46,12,69
Livingston,3228,2,19,4,13,80,51,29,61
Peterhead,3228,3,16,8,12,66,48,18,56
Alloa,3228,4,15,9,12,57,54,3,54
Airdrieon,3228,5,15,6,15,51,55,-4,51
Albion,3228,6,12,11,13,54,52,2,47
Stenhousem'r,3228,7,13,6,17,60,75,-15,45
Queen's Park,3228,8,12,8,16,37,52,-15,44
Stranraer,3228,9,13,4,19,38,55,-17,43
East Fife,3228,10,7,12,17,42,55,-13,33
Alloa,3229,1,20,7,9,81,41,40,67
Livingston,3229,2,19,6,11,66,48,18,63
Brechin,3229,3,19,6,11,61,49,12,63
Airdrieon,3229,4,18,7,11,53,46,7,61
Queen's Park,3229,5,15,8,13,42,45,-3,53
Stranraer,3229,6,14,5,17,50,54,-4,47
East Fife,3229,7,12,8,16,56,50,6,44
Albion,3229,8,10,10,16,46,58,-12,40
Peterhead,3229,9,9,8,19,39,57,-18,35
Stenhousem'r,3229,10,8,7,21,50,96,-46,31
Livingston,3230,1,22,6,8,84,44,40,72
Airdrieon,3230,2,20,4,12,61,51,10,64
Alloa,3230,3,16,10,10,68,47,21,58
Brechin,3230,4,17,5,14,47,46,1,56
Albion,3230,5,14,9,13,55,57,-2,51
Queen's Park,3230,6,15,6,15,44,50,-6,51
East Fife,3230,7,11,13,12,50,47,3,46
Peterhead,3230,8,10,8,18,42,52,-10,38
Stranraer,3230,9,9,7,20,42,63,-21,34
Stenhousem'r,3230,10,9,6,21,46,82,-36,33
Livingston,3231,1,23,4,9,80,46,34,73
Alloa,3231,2,18,8,10,84,45,39,62
Airdrieon,3231,3,17,8,11,60,52,8,59
Albion,3231,4,14,9,13,55,59,-4,51
East Fife,3231,5,13,10,13,57,49,8,49
Brechin,3231,6,15,4,17,48,61,-13,49
Stranraer,3231,7,14,6,16,46,51,-5,48
Peterhead,3231,8,13,8,15,56,64,-8,47
Queen's Park,3231,9,10,10,16,38,55,-17,40
Stenhousem'r,3231,10,7,5,24,46,88,-42,26
Livingston,3232,1,23,4,9,77,42,35,73
Brechin,3232,2,19,6,11,55,42,13,63
Alloa,3232,3,17,8,11,66,49,17,59
East Fife,3232,4,16,7,13,65,51,14,55
Airdrieon,3232,5,16,6,14,70,69,1,54
Albion,3232,6,14,9,13,60,56,4,51
Peterhead,3232,7,13,8,15,49,60,-11,47
Queen's Park,3232,8,10,8,18,34,49,-15,38
Stranraer,3232,9,10,4,22,46,70,-24,34
Stenhousem'r,3232,10,8,8,20,47,81,-34,32
Alloa,3233,1,23,7,6,86,42,44,76
Livingston,3233,2,24,1,11,89,52,37,73
Airdrieon,3233,3,16,10,10,58,48,10,58
East Fife,3233,4,14,9,13,47,50,-3,51
Peterhead,3233,5,14,7,15,42,48,-6,49
Albion,3233,6,12,11,13,58,58,0,47
Brechin,3233,7,13,8,15,47,57,-10,47
Queen's Park,3233,8,11,9,16,41,53,-12,42
Stranraer,3233,9,9,6,21,44,62,-18,33
Stenhousem'r,3233,10,7,6,23,38,80,-42,27
Livingston,3234,1,21,5,10,76,52,24,68
Alloa,3234,2,19,10,7,69,39,30,67
Albion,3234,3,19,9,8,69,50,19,66
East Fife,3234,4,14,9,13,56,47,9,51
Airdrieon,3234,5,14,8,14,63,61,2,50
Peterhead,3234,6,13,8,15,52,59,-7,47
Brechin,3234,7,13,6,17,46,61,-15,45
Queen's Park,3234,8,12,8,16,40,49,-9,44
Stranraer,3234,9,10,5,21,44,63,-19,35
Stenhousem'r,3234,10,6,10,20,56,90,-34,28
Livingston,3235,1,22,2,12,76,51,25,68
Airdrieon,3235,2,21,3,12,63,51,12,66
Alloa,3235,3,17,7,12,67,47,20,58
Albion,3235,4,13,11,12,53,51,2,50
East Fife,3235,5,13,9,14,49,46,3,48
Queen's Park,3235,6,14,6,16,45,56,-11,48
Brechin,3235,7,12,9,15,45,46,-1,45
Stranraer,3235,8,12,6,18,48,63,-15,42
Peterhead,3235,9,11,8,17,39,46,-7,41
Stenhousem'r,3235,10,11,7,18,49,77,-28,40
Livingston,3236,1,20,8,8,73,45,28,68
Alloa,3236,2,19,8,9,83,55,28,65
Airdrieon,3236,3,18,7,11,73,64,9,61
Brechin,3236,4,16,9,11,64,54,10,57
Queen's Park,3236,5,14,7,15,40,48,-8,49
Peterhead,3236,6,13,9,14,49,56,-7,48
Albion,3236,7,12,10,14,54,56,-2,46
Stranraer,3236,8,11,6,19,54,70,-16,39
East Fife,3236,9,9,11,16,48,51,-3,38
Stenhousem'r,3236,10,7,7,22,45,84,-39,28
Livingston,3237,1,22,4,10,90,50,40,70
Brechin,3237,2,16,9,11,60,53,7,57
Peterhead,3237,3,15,11,10,47,41,6,56
Queen's Park,3237,4,14,10,12,46,52,-6,52
Alloa,3237,5,13,11,12,54,46,8,50
Albion,3237,6,13,11,12,52,48,4,50
Airdrieon,3237,7,14,6,16,55,55,0,48
Stranraer,3237,8,12,6,18,53,75,-22,42
Stenhousem'r,3237,9,8,12,16,44,69,-25,36
East Fife,3237,10,8,10,18,38,50,-12,34
Alloa,3238,1,21,8,7,75,43,32,71
Livingston,3238,2,21,6,9,72,48,24,69
Albion,3238,3,17,8,11,62,47,15,59
Brechin,3238,4,16,7,13,47,49,-2,55
Queen's Park,3238,5,15,5,16,44,48,-4,50
Airdrieon,3238,6,14,7,15,52,54,-2,49
Peterhead,3238,7,11,9,16,45,58,-13,42
Stranraer,3238,8,9,10,17,48,56,-8,37
East Fife,3238,9,7,13,16,46,53,-7,34
Stenhousem'r,3238,10,8,9,19,45,80,-35,33
Alloa,3239,1,21,4,11,75,51,24,67
Livingston,3239,2,20,4,12,69,50,19,64
Airdrieon,3239,3,19,5,12,69,52,17,62
Brechin,3239,4,16,7,13,60,57,3,55
Queen's Park,3239,5,17,3,16,49,52,-3,54
Albion,3239,6,15,7,14,55,58,-3,52
Stranraer,3239,7,14,8,14,60,57,3,50
Peterhead,3239,8,14,4,18,51,63,-12,46
East Fife,3239,9,10,7,19,55,62,-7,37
Stenhousem'r,3239,10,6,7,23,52,93,-41,25
Livingston,3240,1,22,4,10,74,47,27,70
Alloa,3240,2,21,5,10,70,44,26,68
Albion,3240,3,16,5,15,68,53,15,53
Airdrieon,3240,4,14,11,11,54,47,7,53
Peterhead,3240,5,15,8,13,49,50,-1,53
East Fife,3240,6,13,10,13,48,47,1,49
Brechin,3240,7,15,4,17,50,54,-4,49
Queen's Park,3240,8,13,8,15,41,50,-9,47
Stranraer,3240,9,12,5,19,57,68,-11,41
Stenhousem'r,3240,10,5,8,23,42,93,-51,23
Alloa,3241,1,22,7,7,68,36,32,73
Livingston,3241,2,19,7,10,80,38,42,64
Airdrieon,3241,3,15,8,13,54,53,1,53
Brechin,3241,4,16,5,15,44,51,-7,53
Queen's Park,3241,5,14,8,14,36,41,-5,50
Stranraer,3241,6,13,9,14,55,58,-3,48
Albion,3241,7,12,11,13,55,55,0,47
Peterhead,3241,8,13,8,15,43,52,-9,47
East Fife,3241,9,8,12,16,45,57,-12,36
Stenhousem'r,3241,10,8,5,23,49,88,-39,29
Livingston,3242,1,23,5,8,93,53,40,74
Alloa,3242,2,18,9,9,66,45,21,63
Airdrieon,3242,3,19,4,13,73,58,15,61
Albion,3242,4,16,9,11,58,45,13,57
Brechin,3242,5,18,2,16,50,44,6,56
Stranraer,3242,6,14,2,20,49,63,-14,44
East Fife,3242,7,11,9,16,50,46,4,42
Peterhead,3242,8,11,9,16,39,64,-25,42
Queen's Park,3242,9,9,10,17,38,59,-21,37
Stenhousem'r,3242,10,7,9,20,46,85,-39,30
Alloa,3243,1,19,10,7,74,45,29,67
Livingston,3243,2,19,7,10,75,49,26,64
Airdrieon,3243,3,18,8,10,72,56,16,62
Peterhead,3243,4,15,7,14,54,48,6,52
Stranraer,3243,5,16,3,17,53,57,-4,51
Queen's Park,3243,6,15,6,15,40,48,-8,51
Brechin,3243,7,14,8,14,46,51,-5,50
Albion,3243,8,12,5,19,51,60,-9,41
East Fife,3243,9,9,8,19,44,56,-12,35
Stenhousem'r,3243,10,9,6,21,44,83,-39,33
Alloa,3244,1,19,6,11,65,41,24,63
Livingston,3244,2,20,3,13,77,66,11,63
Brechin,3244,3,17,7,12,55,43,12,58
Albion,3244,4,15,10,11,60,55,5,55
Peterhead,3244,5,15,7,14,50,54,-4,52
Stranraer,3244,6,15,6,15,59,56,3,51
Airdrieon,3244,7,15,4,17,60,56,4,49
East Fife,3244,8,12,7,17,50,52,-2,43
Queen's Park,3244,9,12,6,18,37,59,-22,42
Stenhousem'r,3244,10,8,8,20,46,77,-31,32
Livingston,3245,1,21,7,8,74,43,31,70
Alloa,3245,2,17,8,11,66,50,16,59
Brechin,3245,3,17,5,14,60,50,10,56
Airdrieon,3245,4,15,11,10,63,58,5,56
Peterhead,3245,5,14,9,13,48,51,-3,51
Stranraer,3245,6,15,4,17,56,54,2,49
Queen's Park,3245,7,12,9,15,34,48,-14,45
East Fife,3245,8,12,8,16,49,49,0,44
Albion,3245,9,11,10,15,47,57,-10,43
Stenhousem'r,3245,10,5,11,20,46,83,-37,26
Livingston,3246,1,22,6,8,79,50,29,72
Alloa,3246,2,21,7,8,81,37,44,70
Airdrieon,3246,3,16,5,15,59,60,-1,53
Albion,3246,4,14,10,12,55,53,2,52
Queen's Park,3246,5,15,6,15,39,50,-11,51
Brechin,3246,6,12,10,14,47,51,-4,46
Peterhead,3246,7,13,7,16,45,50,-5,46
East Fife,3246,8,11,9,16,44,54,-10,42
Stranraer,3246,9,9,8,19,43,57,-14,35
Stenhousem'r,3246,10,8,10,18,46,76,-30,34
Livingston,3247,1,19,6,11,72,48,24,63
Alloa,3247,2,17,9,10,69,46,23,60
Brechin,3247,3,18,3,15,48,49,-1,57
Airdrieon,3247,4,15,9,12,52,56,-4,54
Peterhead,3247,5,16,4,16,56,53,3,52
Stranraer,3247,6,15,5,16,58,58,0,50
Queen's Park,3247,7,13,9,14,48,51,-3,48
Albion,3247,8,12,10,14,51,56,-5,46
East Fife,3247,9,8,12,16,47,50,-3,36
Stenhousem'r,3247,10,9,9,18,43,77,-34,36
Livingston,3248,1,23,7,6,82,40,42,76
Airdrieon,3248,2,20,5,11,64,43,21,65
Brechin,3248,3,18,3,15,52,46,6,57
Alloa,3248,4,15,7,14,65,51,14,52
Queen's Park,3248,5,16,4,16,44,51,-7,52
Albion,3248,6,14,9,13,63,59,4,51
Peterhead,3248,7,14,6,16,49,54,-5,48
East Fife,3248,8,10,10,16,45,56,-11,40
Stranraer,3248,9,10,5,21,45,70,-25,35
Stenhousem'r,3248,10,8,8,20,44,83,-39,32
Livingston,3249,1,21,6,9,82,52,30,69
Airdrieon,3249,2,18,9,9,63,54,9,63
Brechin,3249,3,17,7,12,55,47,8,58
Alloa,3249,4,15,12,9,62,40,22,57
Peterhead,3249,5,13,9,14,54,52,2,48
Albion,3249,6,13,8,15,52,57,-5,47
Queen's Park,3249,7,12,7,17,34,50,-16,43
Stranraer,3249,8,10,9,17,58,79,-21,39
East Fife,3249,9,10,8,18,53,53,0,38
Stenhousem'r,3249,10,10,7,19,55,84,-29,37
Livingston,3250,1,24,3,9,81,48,33,75
Airdrieon,3250,2,21,5,10,63,49,14,68
Brechin,3250,3,17,6,13,47,44,3,57
Alloa,3250,4,14,9,13,63,48,15,51
Albion,3250,5,13,9,14,51,50,1,48
Queen's Park,3250,6,14,6,16,38,45,-7,48
East Fife,3250,7,12,10,14,43,40,3,46
Stranraer,3250,8,13,5,18,50,60,-10,44
Peterhead,3250,9,11,7,18,47,61,-14,40
Stenhousem'r,3250,10,8,6,22,41,79,-38,30
Livingston,3251,1,21,5,10,68,41,27,68
Alloa,3251,2,18,8,10,67,42,25,62
Albion,3251,3,16,8,12,56,51,5,56
East Fife,3251,4,16,6,14,59,43,16,54
Brechin,3251,5,15,8,13,47,47,0,53
Stranraer,3251,6,15,4,17,52,65,-13,49
Queen's Park,3251,7,11,12,13,34,44,-10,45
Airdrieon,3251,8,12,8,16,53,60,-7,44
Peterhead,3251,9,12,8,16,46,56,-10,44
Stenhousem'r,3251,10,7,7,22,43,76,-33,28
Alloa,3252,1,20,6,10,71,40,31,66
Livingston,3252,2,19,5,12,79,60,19,62
Airdrieon,3252,3,18,4,14,63,54,9,58
Brechin,3252,4,17,4,15,56,47,9,55
Queen's Park,3252,5,15,9,12,40,45,-5,54
Albion,3252,6,14,9,13,58,55,3,51
East Fife,3252,7,13,6,17,44,51,-7,45
Stranraer,3252,8,13,4,19,49,62,-13,43
Peterhead,3252,9,12,6,18,42,57,-15,42
Stenhousem'r,3252,10,9,7,20,51,82,-31,34
Alloa,3253,1,20,7,9,73,41,32,67
Livingston,3253,2,19,7,10,69,48,21,64
Brechin,3253,3,18,7,11,51,43,8,61
Albion,3253,4,17,9,10,53,44,9,60
Airdrieon,3253,5,15,8,13,53,57,-4,53
Peterhead,3253,6,11,12,13,54,60,-6,45
Queen's Park,3253,7,12,8,16,30,43,-13,44
Stranraer,3253,8,10,9,17,50,61,-11,39
Stenhousem'r,3253,9,6,15,15,40,62,-22,33
East Fife,3253,10,5,12,19,46,60,-14,27
Alloa,3254,1,20,7,9,74,46,28,67
Airdrieon,3254,2,19,4,13,62,51,11,61
Livingston,3254,3,17,8,11,71,52,19,59
Peterhead,3254,4,14,11,11,47,47,0,53
Queen's Park,3254,5,14,9,13,37,43,-6,51
Brechin,3254,6,14,6,16,37,48,-11,48
Albion,3254,7,11,13,12,50,46,4,46
East Fife,3254,8,11,9,16,48,49,-1,42
Stranraer,3254,9,12,6,18,50,60,-10,42
Stenhousem'r,3254,10,7,9,20,47,81,-34,30
Livingston,3255,1,21,4,11,84,58,26,67
Alloa,3255,2,17,7,12,69,47,22,58
Brechin,3255,3,15,9,12,52,47,5,54
Peterhead,3255,4,14,11,11,49,45,4,53
Albion,3255,5,14,11,11,48,46,2,53
Stranraer,3255,6,15,5,16,59,54,5,50
East Fife,3255,7,14,8,14,54,58,-4,50
Airdrieon,3255,8,14,7,15,53,52,1,49
Queen's Park,3255,9,11,8,17,40,55,-15,41
Stenhousem'r,3255,10,5,10,21,50,96,-46,25
Alloa,3256,1,17,12,7,74,46,28,63
Brechin,3256,2,19,6,11,56,52,4,63
Livingston,3256,3,16,10,10,71,52,19,58
Airdrieon,3256,4,16,8,12,59,51,8,56
Queen's Park,3256,5,15,5,16,37,46,-9,50
Albion,3256,6,14,7,15,54,59,-5,49
Peterhead,3256,7,11,11,14,43,52,-9,44
Stranraer,3256,8,12,7,17,53,57,-4,43
East Fife,3256,9,9,9,18,44,54,-10,36
Stenhousem'r,3256,10,8,11,17,47,69,-22,35
Brechin,3257,1,20,6,10,47,35,12,66
Livingston,3257,2,20,3,13,75,56,19,63
Alloa,3257,3,17,7,12,58,42,16,58
Stranraer,3257,4,15,6,15,64,58,6,51
Albion,3257,5,14,9,13,49,52,-3,51
Queen's Park,3257,6,13,10,13,34,40,-6,49
Airdrieon,3257,7,14,7,15,52,59,-7,49
Peterhead,3257,8,12,9,15,45,53,-8,45
East Fife,3257,9,9,12,15,50,49,1,39
Stenhousem'r,3257,10,7,9,20,54,84,-30,30
Alloa,3258,1,20,6,10,74,39,35,66
Livingston,3258,2,19,5,12,77,51,26,62
Brechin,3258,3,18,8,10,45,38,7,62
Airdrieon,3258,4,16,7,13,55,57,-2,55
Queen's Park,3258,5,16,7,13,47,50,-3,55
Albion,3258,6,16,6,14,48,56,-8,54
Stranraer,3258,7,13,7,16,47,53,-6,46
East Fife,3258,8,11,8,17,53,46,7,41
Peterhead,3258,9,10,8,18,44,59,-15,38
Stenhousem'r,3258,10,7,6,23,35,76,-41,27
Alloa,3259,1,19,7,10,81,56,25,64
Livingston,3259,2,19,5,12,73,55,18,62
Brechin,3259,3,19,5,12,54,51,3,62
Peterhead,3259,4,18,6,12,59,52,7,60
Airdrieon,3259,5,16,7,13,63,59,4,55
Stranraer,3259,6,15,5,16,66,55,11,50
Albion,3259,7,14,6,16,50,49,1,48
Queen's Park,3259,8,14,6,16,37,48,-11,48
East Fife,3259,9,10,9,17,49,61,-12,39
Stenhousem'r,3259,10,5,6,25,46,92,-46,21
Livingston,3260,1,20,6,10,76,49,27,66
Alloa,3260,2,15,12,9,67,50,17,57
Brechin,3260,3,16,7,13,53,46,7,55
Queen's Park,3260,4,15,10,11,48,46,2,55
East Fife,3260,5,13,11,12,52,48,4,50
Peterhead,3260,6,13,9,14,53,56,-3,48
Albion,3260,7,10,15,11,51,53,-2,45
Airdrieon,3260,8,11,12,13,51,60,-9,45
Stranraer,3260,9,12,5,19,54,68,-14,41
Stenhousem'r,3260,10,6,11,19,43,72,-29,29
Livingston,3261,1,22,5,9,80,37,43,71
Alloa,3261,2,19,9,8,75,48,27,66
Peterhead,3261,3,14,11,11,52,48,4,53
Albion,3261,4,14,9,13,51,50,1,51
Brechin,3261,5,14,9,13,47,46,1,51
Airdrieon,3261,6,12,12,12,50,55,-5,48
East Fife,3261,7,11,12,13,42,43,-1,45
Queen's Park,3261,8,11,7,18,33,52,-19,40
Stranraer,3261,9,11,4,21,40,63,-23,37
Stenhousem'r,3261,10,9,8,19,50,78,-28,35
Brechin,3262,1,20,8,8,56,37,19,68
Alloa,3262,2,19,5,12,68,43,25,62
Livingston,3262,3,19,3,14,71,46,25,60
Albion,3262,4,16,11,9,53,46,7,59
Airdrieon,3262,5,15,8,13,57,59,-2,53
Stranraer,3262,6,15,6,15,45,48,-3,51
Queen's Park,3262,7,12,9,15,38,49,-11,45
Peterhead,3262,8,12,8,16,46,52,-6,44
East Fife,3262,9,7,12,17,37,50,-13,33
Stenhousem'r,3262,10,6,8,22,47,88,-41,26
Alloa,3263,1,20,7,9,67,39,28,67
Livingston,3263,2,19,7,10,77,45,32,64
Airdrieon,3263,3,17,7,12,58,54,4,58
Brechin,3263,4,17,5,14,51,45,6,56
Albion,3263,5,14,11,11,55,48,7,53
Peterhead,3263,6,15,8,13,52,47,5,53
East Fife,3263,7,11,11,14,47,49,-2,44
Stranraer,3263,8,13,4,19,48,58,-10,43
Queen's Park,3263,9,12,7,17,36,54,-18,43
Stenhousem'r,3263,10,6,5,25,41,93,-52,23
Livingston,3264,1,20,8,8,67,39,28,68
Airdrieon,3264,2,17,10,9,67,55,12,61
Alloa,3264,3,15,11,10,63,47,16,56
Brechin,3264,4,15,8,13,43,49,-6,53
Stranraer,3264,5,15,4,17,61,62,-1,49
Albion,3264,6,12,10,14,51,52,-1,46
Queen's Park,3264,7,11,11,14,40,53,-13,44
Peterhead,3264,8,10,13,13,50,57,-7,43
East Fife,3264,9,10,10,16,47,45,2,40
Stenhousem'r,3264,10,8,9,19,41,71,-30,33
Livingston,3265,1,22,5,9,77,42,35,71
Alloa,3265,2,17,12,7,70,41,29,63
Brechin,3265,3,19,6,11,58,45,13,63
East Fife,3265,4,16,7,13,55,40,15,55
Airdrieon,3265,5,15,9,12,54,52,2,54
Albion,3265,6,14,8,14,56,55,1,50
Peterhead,3265,7,10,11,15,44,55,-11,41
Queen's Park,3265,8,10,10,16,35,51,-16,40
Stranraer,3265,9,12,3,21,46,66,-20,39
Stenhousem'r,3265,10,4,11,21,43,91,-48,23
Livingston,3266,1,22,3,11,82,46,36,69
Albion,3266,2,19,8,9,64,43,21,65
Alloa,3266,3,15,11,10,72,47,25,56
Brechin,3266,4,16,8,12,48,48,0,56
Airdrieon,3266,5,17,4,15,54,51,3,55
East Fife,3266,6,14,6,16,42,49,-7,48
Peterhead,3266,7,13,7,16,49,54,-5,46
Queen's Park,3266,8,12,9,15,42,53,-11,45
Stranraer,3266,9,12,6,18,51,59,-8,42
Stenhousem'r,3266,10,6,6,24,34,88,-54,24
Alloa,3267,1,20,8,8,76,44,32,68
Brechin,3267,2,19,8,9,57,39,18,65
Livingston,3267,3,17,8,11,73,52,21,59
Airdrieon,3267,4,14,9,13,57,49,8,51
Peterhead,3267,5,12,10,14,44,55,-11,46
Stranraer,3267,6,13,6,17,49,60,-11,45
East Fife,3267,7,11,11,14,48,53,-5,44
Albion,3267,8,12,7,17,45,47,-2,43
Stenhousem'r,3267,9,12,6,18,49,76,-27,42
Queen's Park,3267,10,11,5,20,31,54,-23,38
Livingston,3268,1,22,3,11,79,54,25,69
Alloa,3268,2,20,6,10,77,44,33,66
Brechin,3268,3,18,4,14,52,49,3,58
Airdrieon,3268,4,17,6,13,57,46,11,57
Albion,3268,5,16,6,14,60,56,4,54
Queen's Park,3268,6,15,4,17,44,58,-14,49
Peterhead,3268,7,10,11,15,40,58,-18,41
Stenhousem'r,3268,8,11,7,18,51,74,-23,40
Stranraer,3268,9,11,6,19,44,55,-11,39
East Fife,3268,10,10,7,19,42,52,-10,37
Livingston,3269,1,20,6,10,76,52,24,66
Airdrieon,3269,2,18,8,10,67,43,24,62
Albion,3269,3,16,8,12,59,56,3,56
East Fife,3269,4,15,7,14,61,49,12,52
Brechin,3269,5,14,9,13,52,53,-1,51
Peterhead,3269,6,14,7,15,52,54,-2,49
Stranraer,3269,7,11,12,13,52,57,-5,45
Alloa,3269,8,11,11,14,56,52,4,44
Queen's Park,3269,9,10,8,18,36,61,-25,38
Stenhousem'r,3269,10,8,10,18,49,83,-34,34
Livingston,3270,1,21,7,8,78,43,35,70
Alloa,3270,2,18,7,11,67,51,16,61
Brechin,3270,3,17,4,15,57,54,3,55
Peterhead,3270,4,15,6,15,56,58,-2,51
Queen's Park,3270,5,13,10,13,46,49,-3,49
East Fife,3270,6,13,8,15,52,50,2,47
Airdrieon,3270,7,13,8,15,56,65,-9,47
Albion,3270,8,11,11,14,45,53,-8,44
Stranraer,3270,9,10,10,16,51,58,-7,40
Stenhousem'r,3270,10,10,7,19,49,76,-27,37
Brechin,3271,1,21,8,7,64,39,25,71
Alloa,3271,2,19,8,9,79,48,31,65
Livingston,3271,3,17,8,11,71,55,16,59
Airdrieon,3271,4,17,6,13,63,60,3,57
Queen's Park,3271,5,13,7,16,45,51,-6,46
Peterhead,3271,6,12,10,14,44,52,-8,46
Albion,3271,7,12,9,15,55,59,-4,45
Stranraer,3271,8,11,6,19,50,68,-18,39
Stenhousem'r,3271,9,10,8,18,42,66,-24,38
East Fife,3271,10,8,10,18,50,65,-15,34
Alloa,3272,1,18,10,8,69,45,24,64
Livingston,3272,2,17,6,13,73,54,19,57
Peterhead,3272,3,15,10,11,57,55,2,55
Brechin,3272,4,15,8,13,42,44,-2,53
Airdrieon,3272,5,13,10,13,62,64,-2,49
Albion,3272,6,11,14,11,49,41,8,47
Queen's Park,3272,7,12,9,15,42,58,-16,45
Stranraer,3272,8,11,11,14,59,55,4,44
East Fife,3272,9,11,11,14,54,52,2,44
Stenhousem'r,3272,10,9,7,20,54,93,-39,34
Livingston,3273,1,21,4,11,73,46,27,67
Alloa,3273,2,18,9,9,78,46,32,63
Airdrieon,3273,3,16,9,11,61,52,9,57
Brechin,3273,4,16,3,17,40,49,-9,51
Albion,3273,5,12,13,11,52,53,-1,49
Stranraer,3273,6,14,7,15,46,49,-3,49
East Fife,3273,7,12,10,14,52,47,5,46
Peterhead,3273,8,12,8,16,47,60,-13,44
Queen's Park,3273,9,10,11,15,34,49,-15,41
Stenhousem'r,3273,10,7,10,19,42,74,-32,31
Livingston,3274,1,23,5,8,79,40,39,74
Albion,3274,2,16,9,11,66,49,17,57
Airdrieon,3274,3,17,5,14,61,52,9,56
Alloa,3274,4,16,6,14,68,55,13,54
Brechin,3274,5,16,6,14,44,43,1,54
Peterhead,3274,6,15,8,13,53,58,-5,53
Queen's Park,3274,7,14,10,12,44,54,-10,52
East Fife,3274,8,10,11,15,51,50,1,41
Stranraer,3274,9,12,4,20,45,60,-15,40
Stenhousem'r,3274,10,6,6,24,38,88,-50,24
Livingston,3275,1,23,2,11,81,47,34,71
Brechin,3275,2,21,4,11,56,42,14,67
Alloa,3275,3,19,8,9,74,49,25,65
Albion,3275,4,18,9,9,63,48,15,63
Queen's Park,3275,5,16,3,17,46,58,-12,51
Airdrieon,3275,6,14,7,15,52,50,2,49
East Fife,3275,7,12,9,15,60,51,9,45
Peterhead,3275,8,11,9,16,50,65,-15,42
Stranraer,3275,9,9,5,22,44,69,-25,32
Stenhousem'r,3275,10,6,6,24,45,92,-47,24
Livingston,3276,1,22,4,10,81,56,25,70
Alloa,3276,2,18,7,11,66,52,14,61
Airdrieon,3276,3,16,6,14,56,52,4,54
Brechin,3276,4,15,7,14,46,45,1,52
Queen's Park,3276,5,12,14,10,43,42,1,50
Stranraer,3276,6,15,4,17,54,60,-6,49
East Fife,3276,7,12,12,12,60,55,5,48
Albion,3276,8,13,7,16,61,58,3,46
Peterhead,3276,9,10,8,18,38,57,-19,38
Stenhousem'r,3276,10,9,7,20,55,83,-28,34
Alloa,3277,1,22,6,8,76,40,36,72
Livingston,3277,2,19,8,9,81,48,33,65
East Fife,3277,3,14,11,11,53,43,10,53
Airdrieon,3277,4,15,7,14,62,55,7,52
Brechin,3277,5,15,7,14,55,55,0,52
Queen's Park,3277,6,14,6,16,38,51,-13,48
Stranraer,3277,7,14,4,18,47,62,-15,46
Albion,3277,8,12,8,16,51,55,-4,44
Peterhead,3277,9,11,7,18,54,74,-20,40
Stenhousem'r,3277,10,9,6,21,44,78,-34,33
Airdrieon,3278,1,22,4,10,60,39,21,70
Brechin,3278,2,20,8,8,55,41,14,68
Livingston,3278,3,20,5,11,81,53,28,65
Alloa,3278,4,20,4,12,74,51,23,64
Peterhead,3278,5,15,5,16,55,55,0,50
Stranraer,3278,6,14,5,17,48,55,-7,47
East Fife,3278,7,12,9,15,44,50,-6,45
Albion,3278,8,12,6,18,52,62,-10,42
Queen's Park,3278,9,10,6,20,31,49,-18,36
Stenhousem'r,3278,10,5,8,23,42,87,-45,23
Livingston,3279,1,22,7,7,79,41,38,73
Brechin,3279,2,19,7,10,62,42,20,64
Alloa,3279,3,15,14,7,61,43,18,59
Airdrieon,3279,4,17,7,12,53,49,4,58
Peterhead,3279,5,14,9,13,50,46,4,51
Albion,3279,6,14,8,14,54,51,3,50
East Fife,3279,7,12,10,14,50,50,0,46
Queen's Park,3279,8,10,9,17,34,53,-19,39
Stranraer,3279,9,10,4,22,43,64,-21,34
Stenhousem'r,3279,10,5,9,22,39,86,-47,24
Livingston,3280,1,22,5,9,72,43,29,71
Airdrieon,3280,2,18,9,9,63,45,18,63
Alloa,3280,3,15,13,8,69,46,23,58
Brechin,3280,4,16,8,12,51,44,7,56
Peterhead,3280,5,14,9,13,44,52,-8,51
Albion,3280,6,13,10,13,58,55,3,49
Queen's Park,3280,7,12,11,13,41,56,-15,47
Stranraer,3280,8,12,6,18,54,62,-8,42
East Fife,3280,9,9,8,19,48,54,-6,35
Stenhousem'r,3280,10,6,7,23,42,85,-43,25
Livingston,3281,1,23,4,9,83,51,32,73
Alloa,3281,2,19,9,8,73,42,31,66
Airdrieon,3281,3,15,9,12,54,56,-2,54
Brechin,3281,4,16,6,14,44,48,-4,54
Peterhead,3281,5,13,10,13,60,58,2,49
Stranraer,3281,6,12,9,15,57,63,-6,45
Albion,3281,7,12,8,16,49,57,-8,44
East Fife,3281,8,12,7,17,48,50,-2,43
Queen's Park,3281,9,11,5,20,43,59,-16,38
Stenhousem'r,3281,10,10,7,19,43,70,-27,37
Livingston,3282,1,23,4,9,82,46,36,73
Alloa,3282,2,17,10,9,74,52,22,61
Airdrieon,3282,3,18,7,11,63,58,5,61
Albion,3282,4,13,10,13,56,56,0,49
Brechin,3282,5,14,7,15,49,49,0,49
Peterhead,3282,6,12,8,16,49,60,-11,44
Stranraer,3282,7,12,6,18,50,53,-3,42
Queen's Park,3282,8,11,8,17,40,60,-20,41
East Fife,3282,9,10,10,16,51,59,-8,40
Stenhousem'r,3282,10,10,10,16,56,77,-21,40
Alloa,3283,1,19,9,8,60,39,21,66
Albion,3283,2,19,7,10,68,47,21,64
Livingston,3283,3,19,3,14,71,53,18,60
Peterhead,3283,4,16,8,12,56,55,1,56
Airdrieon,3283,5,15,8,13,67,57,10,53
Brechin,3283,6,16,3,17,54,44,10,51
Stranraer,3283,7,15,4,17,45,56,-11,49
East Fife,3283,8,12,8,16,49,47,2,44
Queen's Park,3283,9,9,11,16,35,53,-18,38
Stenhousem'r,3283,10,5,9,22,40,94,-54,24
Alloa,3284,1,23,5,8,81,39,42,74
Livingston,3284,2,17,9,10,72,51,21,60
Albion,3284,3,17,7,12,57,52,5,58
Queen's Park,3284,4,17,7,12,48,43,5,58
Peterhead,3284,5,13,8,15,50,61,-11,47
Stranraer,3284,6,13,6,17,52,55,-3,45
Airdrieon,3284,7,14,2,20,48,61,-13,44
Brechin,3284,8,13,4,19,41,57,-16,43
East Fife,3284,9,11,9,16,48,53,-5,42
Stenhousem'r,3284,10,10,7,19,47,72,-25,37
Livingston,3285,1,23,1,12,82,53,29,70
Alloa,3285,2,20,6,10,74,47,27,66
Airdrieon,3285,3,17,8,11,65,58,7,59
Brechin,3285,4,15,9,12,46,43,3,54
Albion,3285,5,14,9,13,54,47,7,51
Stranraer,3285,6,15,5,16,57,59,-2,50
East Fife,3285,7,13,7,16,47,45,2,46
Peterhead,3285,8,12,6,18,37,57,-20,42
Queen's Park,3285,9,11,6,19,35,55,-20,39
Stenhousem'r,3285,10,8,7,21,51,84,-33,31
Alloa,3286,1,18,10,8,62,37,25,64
Brechin,3286,2,19,6,11,57,46,11,63
Livingston,3286,3,19,4,13,73,56,17,61
Airdrieon,3286,4,14,10,12,56,53,3,52
Queen's Park,3286,5,14,9,13,45,48,-3,51
East Fife,3286,6,14,7,15,56,47,9,49
Peterhead,3286,7,11,11,14,44,53,-9,44
Albion,3286,8,10,11,15,41,52,-11,41
Stranraer,3286,9,10,8,18,44,54,-10,38
Stenhousem'r,3286,10,8,10,18,42,74,-32,34
Alloa,3287,1,21,5,10,80,45,35,68
Livingston,3287,2,19,4,13,65,49,16,61
Brechin,3287,3,18,7,11,55,40,15,61
Peterhead,3287,4,15,11,10,50,50,0,56
Airdrieon,3287,5,13,8,15,60,62,-2,47
Albion,3287,6,12,10,14,47,48,-1,46
Stranraer,3287,7,13,7,16,52,59,-7,46
East Fife,3287,8,10,10,16,44,52,-8,40
Queen's Park,3287,9,11,7,18,39,56,-17,40
Stenhousem'r,3287,10,9,9,18,47,78,-31,36
Livingston,3288,1,21,6,9,76,45,31,69
Alloa,3288,2,16,8,12,65,46,19,56
Airdrieon,3288,3,16,7,13,51,55,-4,55
Albion,3288,4,14,12,10,61,50,11,54
Peterhead,3288,5,14,8,14,56,58,-2,50
Queen's Park,3288,6,14,6,16,37,46,-9,48
Brechin,3288,7,12,10,14,43,48,-5,46
East Fife,3288,8,9,15,12,43,40,3,42
Stranraer,3288,9,10,9,17,45,57,-12,39
Stenhousem'r,3288,10,8,11,17,44,76,-32,35
Airdrieon,3289,1,19,5,12,66,56,10,62
Brechin,3289,2,18,5,13,57,53,4,59
Stranraer,3289,3,17,5,14,58,54,4,56
Alloa,3289,4,15,10,11,65,47,18,55
Albion,3289,5,17,4,15,54,48,6,55
Livingston,3289,6,17,3,16,68,56,12,54
Peterhead,3289,7,15,7,14,59,61,-2,52
East Fife,3289,8,13,7,16,58,51,7,46
Queen's Park,3289,9,13,3,20,41,63,-22,42
Stenhousem'r,3289,10,8,7,21,48,85,-37,31
Livingston,3290,1,22,6,8,69,32,37,72
Alloa,3290,2,17,10,9,70,49,21,61
Brechin,3290,3,17,6,13,47,43,4,57
Airdrieon,3290,4,16,8,12,65,57,8,56
East Fife,3290,5,14,8,14,50,43,7,50
Stranraer,3290,6,13,8,15,52,54,-2,47
Albion,3290,7,12,9,15,55,59,-4,45
Peterhead,3290,8,11,8,17,47,60,-13,41
Queen's Park,3290,9,12,5,19,31,51,-20,41
Stenhousem'r,3290,10,7,10,19,41,79,-38,31
Livingston,3291,1,21,6,9,86,45,41,69
Alloa,3291,2,19,7,10,76,48,28,64
Brechin,3291,3,17,8,11,52,41,11,59
Airdrieon,3291,4,17,5,14,59,51,8,56
Peterhead,3291,5,16,5,15,54,56,-2,53
Queen's Park,3291,6,16,5,15,39,44,-5,53
Albion,3291,7,12,14,10,55,48,7,50
East Fife,3291,8,12,8,16,53,57,-4,44
Stranraer,3291,9,9,6,21,33,66,-33,33
Stenhousem'r,3291,10,5,8,23,34,85,-51,23
Alloa,3292,1,24,5,7,85,45,40,77
Livingston,3292,2,20,5,11,77,51,26,65
Airdrieon,3292,3,17,8,11,57,51,6,59
Brechin,3292,4,17,4,15,57,49,8,55
Queen's Park,3292,5,14,6,16,35,45,-10,48
East Fife,3292,6,13,8,15,44,50,-6,47
Peterhead,3292,7,12,10,14,50,52,-2,46
Albion,3292,8,11,13,12,47,50,-3,46
Stranraer,3292,9,9,6,21,35,53,-18,33
Stenhousem'r,3292,10,7,7,22,53,94,-41,28
Alloa,3293,1,18,13,5,77,44,33,67
Livingston,3293,2,18,7,11,68,46,22,61
Albion,3293,3,17,7,12,54,44,10,58
Brechin,3293,4,17,5,14,52,49,3,56
Airdrieon,3293,5,14,7,15,58,62,-4,49
Queen's Park,3293,6,13,9,14,43,48,-5,48
Peterhead,3293,7,11,11,14,50,53,-3,44
Stranraer,3293,8,11,8,17,46,63,-17,41
East Fife,3293,9,9,12,15,46,50,-4,39
Stenhousem'r,3293,10,6,13,17,45,80,-35,31
Alloa,3294,1,21,5,10,74,51,23,68
Airdrieon,3294,2,20,5,11,59,52,7,65
Livingston,3294,3,17,6,13,66,60,6,57
Peterhead,3294,4,15,7,14,50,49,1,52
Albion,3294,5,14,8,14,47,47,0,50
Brechin,3294,6,13,10,13,44,47,-3,49
Stranraer,3294,7,13,5,18,63,68,-5,44
Queen's Park,3294,8,13,5,18,42,49,-7,44
East Fife,3294,9,11,8,17,46,42,4,41
Stenhousem'r,3294,10,11,5,20,45,71,-26,38
Livingston,3295,1,23,5,8,75,47,28,74
Alloa,3295,2,20,8,8,71,40,31,68
Airdrieon,3295,3,17,5,14,56,51,5,56
Brechin,3295,4,15,9,12,54,52,2,54
Albion,3295,5,14,8,14,55,57,-2,50
Queen's Park,3295,6,12,7,17,46,52,-6,43
East Fife,3295,7,12,7,17,50,58,-8,43
Stenhousem'r,3295,8,11,8,17,47,68,-21,41
Peterhead,3295,9,9,10,17,46,56,-10,37
Stranraer,3295,10,8,11,17,47,66,-19,35
Livingston,3296,1,20,7,9,80,45,35,67
Brechin,3296,2,19,6,11,56,46,10,63
Airdrieon,3296,3,18,8,10,60,54,6,62
Alloa,3296,4,17,8,11,63,49,14,59
Albion,3296,5,14,7,15,50,51,-1,49
East Fife,3296,6,12,7,17,50,52,-2,43
Queen's Park,3296,7,13,4,19,34,48,-14,43
Stranraer,3296,8,12,6,18,47,58,-11,42
Peterhead,3296,9,12,6,18,49,63,-14,42
Stenhousem'r,3296,10,10,7,19,48,71,-23,37
Livingston,3297,1,23,3,10,77,47,30,72
Alloa,3297,2,18,5,13,87,57,30,59
Brechin,3297,3,18,5,13,51,50,1,59
Albion,3297,4,16,7,13,67,51,16,55
Airdrieon,3297,5,16,7,13,67,61,6,55
Peterhead,3297,6,12,12,12,51,54,-3,48
Stranraer,3297,7,14,5,17,52,66,-14,47
East Fife,3297,8,12,10,14,54,50,4,46
Queen's Park,3297,9,11,6,19,32,63,-31,39
Stenhousem'r,3297,10,5,10,21,41,80,-39,25
Alloa,3298,1,18,9,9,70,46,24,63
Livingston,3298,2,18,8,10,77,53,24,62
East Fife,3298,3,15,10,11,55,39,16,55
Airdrieon,3298,4,16,6,14,56,54,2,54
Queen's Park,3298,5,15,8,13,37,41,-4,53
Brechin,3298,6,16,3,17,52,52,0,51
Peterhead,3298,7,13,8,15,45,49,-4,47
Stranraer,3298,8,13,6,17,46,61,-15,45
Albion,3298,9,11,8,17,43,52,-9,41
Stenhousem'r,3298,10,5,14,17,45,79,-34,29
Brechin,3299,1,21,3,12,57,41,16,66
Livingston,3299,2,19,3,14,72,53,19,60
Alloa,3299,3,17,8,11,71,44,27,59
East Fife,3299,4,16,5,15,54,40,14,53
Albion,3299,5,16,5,15,53,59,-6,53
Airdrieon,3299,6,14,9,13,50,52,-2,51
Stenhousem'r,3299,7,13,8,15,53,73,-20,47
Peterhead,3299,8,12,8,16,45,55,-10,44
Queen's Park,3299,9,12,6,18,33,48,-15,42
Stranraer,3299,10,9,7,20,41,64,-23,34
Airdrieon,3300,1,21,7,8,75,53,22,70
Livingston,3300,2,22,2,12,84,52,32,68
Alloa,3300,3,20,4,12,76,46,30,64
Brechin,3300,4,19,5,12,62,57,5,62
Albion,3300,5,15,9,12,58,58,0,54
Stranraer,3300,6,14,5,17,52,59,-7,47
Queen's Park,3300,7,12,7,17,43,59,-16,43
Peterhead,3300,8,10,6,20,44,64,-20,36
East Fife,3300,9,9,8,19,47,56,-9,35
Stenhousem'r,3300,10,9,5,22,43,80,-37,32
Livingston,3301,1,23,5,8,86,42,44,74
Alloa,3301,2,21,8,7,65,33,32,71
Brechin,3301,3,15,5,16,42,49,-7,50
Airdrieon,3301,4,14,8,14,50,59,-9,50
Albion,3301,5,13,9,14,52,51,1,48
Peterhead,3301,6,12,11,13,43,48,-5,47
Queen's Park,3301,7,14,5,17,41,56,-15,47
East Fife,3301,8,11,8,17,54,52,2,41
Stranraer,3301,9,11,8,17,45,59,-14,41
Stenhousem'r,3301,10,8,9,19,41,70,-29,33
Brechin,3302,1,20,5,11,61,42,19,65
Alloa,3302,2,19,6,11,72,47,25,63
Livingston,3302,3,17,9,10,79,58,21,60
Airdrieon,3302,4,14,10,12,57,54,3,52
Albion,3302,5,13,11,12,51,52,-1,50
Peterhead,3302,6,12,12,12,41,42,-1,48
Queen's Park,3302,7,13,9,14,42,50,-8,48
Stranraer,3302,8,10,7,19,42,63,-21,37
Stenhousem'r,3302,9,10,7,19,43,68,-25,37
East Fife,3302,10,7,14,15,43,55,-12,35
Alloa,3303,1,20,10,6,70,37,33,70
Livingston,3303,2,20,7,9,82,44,38,67
Airdrieon,3303,3,17,9,10,60,51,9,60
Brechin,3303,4,17,4,15,51,54,-3,55
Albion,3303,5,13,9,14,53,52,1,48
Queen's Park,3303,6,14,6,16,45,55,-10,48
Stranraer,3303,7,13,6,17,47,58,-11,45
East Fife,3303,8,12,8,16,51,49,2,44
Peterhead,3303,9,12,7,17,47,61,-14,43
Stenhousem'r,3303,10,6,6,24,34,79,-45,24
Alloa,3304,1,24,3,9,76,41,35,75
Airdrieon,3304,2,21,4,11,67,49,18,67
Livingston,3304,3,20,6,10,73,49,24,66
Brechin,3304,4,16,4,16,54,54,0,52
Stranraer,3304,5,16,3,17,57,62,-5,51
Peterhead,3304,6,14,7,15,53,64,-11,49
Albion,3304,7,13,9,14,58,56,2,48
East Fife,3304,8,11,8,17,52,56,-4,41
Queen's Park,3304,9,12,5,19,36,61,-25,41
Stenhousem'r,3304,10,5,7,24,52,86,-34,22
Alloa,3305,1,21,6,9,69,37,32,69
Livingston,3305,2,21,4,11,68,45,23,67
Airdrieon,3305,3,18,8,10,61,46,15,62
Brechin,3305,4,18,5,13,50,42,8,59
Albion,3305,5,11,11,14,48,52,-4,44
Peterhead,3305,6,12,8,16,45,52,-7,44
Queen's Park,3305,7,12,5,19,41,50,-9,41
Stranraer,3305,8,11,7,18,46,62,-16,40
Stenhousem'r,3305,9,11,7,18,47,79,-32,40
East Fife,3305,10,9,11,16,44,54,-10,38
Alloa,3306,1,20,7,9,70,37,33,67
Livingston,3306,2,18,7,11,73,54,19,61
Brechin,3306,3,17,7,12,55,50,5,58
Queen's Park,3306,4,16,7,13,37,44,-7,55
Peterhead,3306,5,14,11,11,55,51,4,53
Airdrieon,3306,6,14,8,14,55,59,-4,50
Albion,3306,7,13,9,14,48,49,-1,48
Stranraer,3306,8,13,8,15,60,62,-2,47
East Fife,3306,9,8,10,18,40,51,-11,34
Stenhousem'r,3306,10,6,8,22,44,80,-36,26
Livingston,3307,1,22,5,9,75,43,32,71
Peterhead,3307,2,18,7,11,58,51,7,61
Brechin,3307,3,16,9,11,44,42,2,57
Alloa,3307,4,15,9,12,66,51,15,54
Queen's Park,3307,5,15,9,12,54,54,0,54
Airdrieon,3307,6,16,5,15,56,58,-2,53
Albion,3307,7,12,11,13,53,53,0,47
Stranraer,3307,8,11,6,19,48,62,-14,39
East Fife,3307,9,9,10,17,47,54,-7,37
Stenhousem'r,3307,10,7,7,22,43,76,-33,28
Alloa,3308,1,20,7,9,72,40,32,67
Albion,3308,2,17,10,9,55,41,14,61
Peterhead,3308,3,15,10,11,58,54,4,55
Brechin,3308,4,15,7,14,53,54,-1,52
Livingston,3308,5,14,8,14,60,46,14,50
East Fife,3308,6,14,7,15,56,61,-5,49
Stranraer,3308,7,13,6,17,45,56,-11,45
Airdrieon,3308,8,12,8,16,55,68,-13,44
Stenhousem'r,3308,9,9,11,16,51,70,-19,38
Queen's Park,3308,10,8,12,16,33,48,-15,36
Livingston,3309,1,22,3,11,77,49,28,69
Brechin,3309,2,19,4,13,64,61,3,61
Airdrieon,3309,3,17,9,10,63,56,7,60
Peterhead,3309,4,16,10,10,52,42,10,58
Alloa,3309,5,15,9,12,74,55,19,54
Albion,3309,6,16,6,14,57,65,-8,54
East Fife,3309,7,11,9,16,51,47,4,42
Queen's Park,3309,8,12,6,18,40,51,-11,42
Stenhousem'r,3309,9,10,5,21,48,77,-29,35
Stranraer,3309,10,6,11,19,45,68,-23,29
Livingston,3310,1,23,3,10,85,47,38,72
Airdrieon,3310,2,20,5,11,72,55,17,65
Brechin,3310,3,18,7,11,58,49,9,61
Albion,3310,4,15,9,12,59,56,3,54
Alloa,3310,5,15,6,15,59,51,8,51
Peterhead,3310,6,13,8,15,42,56,-14,47
Stranraer,3310,7,13,4,19,55,73,-18,43
Queen's Park,3310,8,11,8,17,32,47,-15,41
Stenhousem'r,3310,9,10,7,19,55,74,-19,37
East Fife,3310,10,9,9,18,45,54,-9,36
Airdrieon,3311,1,19,8,9,63,48,15,65
Livingston,3311,2,20,4,12,79,50,29,64
Peterhead,3311,3,17,8,11,50,45,5,59
Brechin,3311,4,15,8,13,47,50,-3,53
Alloa,3311,5,14,8,14,62,45,17,50
Stranraer,3311,6,13,10,13,55,55,0,49
Albion,3311,7,10,14,12,44,45,-1,44
East Fife,3311,8,10,12,14,42,52,-10,42
Queen's Park,3311,9,11,5,20,33,54,-21,38
Stenhousem'r,3311,10,9,7,20,48,79,-31,34
Livingston,3312,1,23,3,10,80,48,32,72
Airdrieon,3312,2,19,8,9,59,44,15,65
Brechin,3312,3,19,6,11,62,46,16,63
Alloa,3312,4,16,8,12,73,47,26,56
Albion,3312,5,15,9,12,57,50,7,54
Queen's Park,3312,6,13,7,16,39,59,-20,46
Peterhead,3312,7,13,6,17,40,59,-19,45
Stranraer,3312,8,12,6,18,47,60,-13,42
East Fife,3312,9,11,7,18,52,49,3,40
Stenhousem'r,3312,10,5,8,23,36,83,-47,23
Albion,3313,1,21,6,9,67,42,25,69
Alloa,3313,2,19,11,6,69,42,27,68
Livingston,3313,3,17,6,13,72,54,18,57
Brechin,3313,4,17,6,13,46,45,1,57
Airdrieon,3313,5,15,7,14,61,60,1,52
Peterhead,3313,6,14,9,13,44,45,-1,51
Queen's Park,3313,7,14,4,18,43,59,-16,46
East Fife,3313,8,11,6,19,45,55,-10,39
Stranraer,3313,9,10,5,21,50,64,-14,35
Stenhousem'r,3313,10,8,8,20,50,81,-31,32
Alloa,3314,1,21,8,7,72,35,37,71
Livingston,3314,2,21,4,11,78,48,30,67
Airdrieon,3314,3,18,6,12,65,51,14,60
Brechin,3314,4,16,8,12,48,45,3,56
Albion,3314,5,13,10,13,47,53,-6,49
Queen's Park,3314,6,13,6,17,44,59,-15,45
East Fife,3314,7,12,8,16,48,48,0,44
Peterhead,3314,8,10,9,17,41,47,-6,39
Stranraer,3314,9,11,5,20,49,67,-18,38
Stenhousem'r,3314,10,9,8,19,42,81,-39,35
Alloa,3315,1,20,5,11,72,41,31,65
Livingston,3315,2,19,6,11,69,46,23,63
Brechin,3315,3,15,9,12,45,50,-5,54
Airdrieon,3315,4,15,7,14,43,50,-7,52
Albion,3315,5,13,11,12,63,58,5,50
Peterhead,3315,6,13,8,15,50,54,-4,47
Queen's Park,3315,7,13,7,16,42,48,-6,46
Stranraer,3315,8,12,9,15,48,54,-6,45
East Fife,3315,9,11,9,16,52,58,-6,42
Stenhousem'r,3315,10,10,7,19,47,72,-25,37
Alloa,3316,1,21,8,7,76,43,33,71
East Fife,3316,2,21,6,9,69,41,28,69
Brechin,3316,3,16,8,12,51,46,5,56
Livingston,3316,4,17,4,15,64,44,20,55
Airdrieon,3316,5,16,7,13,59,60,-1,55
Queen's Park,3316,6,14,6,16,38,49,-11,48
Stranraer,3316,7,12,6,18,49,61,-12,42
Peterhead,3316,8,10,9,17,42,58,-16,39
Stenhousem'r,3316,9,10,8,18,46,71,-25,38
Albion,3316,10,7,10,19,41,62,-21,31
Livingston,3317,1,25,2,9,78,49,29,77
Alloa,3317,2,21,5,10,73,41,32,68
Airdrieon,3317,3,18,4,14,62,59,3,58
Brechin,3317,4,16,8,12,49,38,11,56
Albion,3317,5,14,9,13,49,43,6,51
Peterhead,3317,6,13,6,17,52,55,-3,45
Stenhousem'r,3317,7,12,6,18,51,77,-26,42
East Fife,3317,8,11,6,19,45,51,-6,39
Queen's Park,3317,9,10,7,19,32,55,-23,37
Stranraer,3317,10,9,9,18,41,64,-23,36
Alloa,3318,1,19,8,9,67,37,30,65
Livingston,3318,2,20,5,11,67,46,21,65
Airdrieon,3318,3,16,6,14,61,55,6,54
Albion,3318,4,14,11,11,47,45,2,53
Peterhead,3318,5,15,8,13,54,56,-2,53
Brechin,3318,6,13,10,13,52,54,-2,49
Stranraer,3318,7,13,7,16,55,60,-5,46
East Fife,3318,8,10,10,16,49,52,-3,40
Queen's Park,3318,9,9,10,17,32,52,-20,37
Stenhousem'r,3318,10,9,9,18,52,79,-27,36
Livingston,3319,1,22,3,11,77,47,30,69
Alloa,3319,2,18,8,10,84,46,38,62
Airdrieon,3319,3,18,7,11,67,58,9,61
Brechin,3319,4,17,5,14,54,46,8,56
Peterhead,3319,5,14,9,13,50,49,1,51
Queen's Park,3319,6,15,6,15,42,48,-6,51
Albion,3319,7,13,9,14,55,62,-7,48
East Fife,3319,8,12,7,17,49,59,-10,43
Stranraer,3319,9,11,3,22,45,73,-28,36
Stenhousem'r,3319,10,7,9,20,43,78,-35,30
Livingston,3320,1,25,5,6,82,37,45,80
Alloa,3320,2,22,5,9,75,41,34,71
Airdrieon,3320,3,19,4,13,57,51,6,61
Brechin,3320,4,16,4,16,52,52,0,52
East Fife,3320,5,13,8,15,45,45,0,47
Albion,3320,6,13,6,17,49,53,-4,45
Peterhead,3320,7,12,8,16,49,58,-9,44
Queen's Park,3320,8,14,2,20,32,49,-17,44
Stenhousem'r,3320,9,10,7,19,49,83,-34,37
Stranraer,3320,10,10,3,23,38,59,-21,33
Alloa,3321,1,21,5,10,71,43,28,68
Livingston,3321,2,19,7,10,79,54,25,64
Brechin,3321,3,17,7,12,56,43,13,58
Peterhead,3321,4,18,4,14,59,52,7,58
Queen's Park,3321,5,14,9,13,40,43,-3,51
Stranraer,3321,6,15,4,17,58,55,3,49
Airdrieon,3321,7,13,8,15,53,66,-13,47
East Fife,3321,8,11,9,16,48,51,-3,42
Albion,3321,9,11,9,16,49,65,-16,42
Stenhousem'r,3321,10,6,8,22,37,78,-41,26
Alloa,3322,1,20,8,8,77,50,27,68
Livingston,3322,2,20,3,13,73,51,22,63
Peterhead,3322,3,17,8,11,52,48,4,59
Brechin,3322,4,18,4,14,56,51,5,58
Airdrieon,3322,5,16,9,11,63,56,7,57
Albion,3322,6,15,3,18,51,53,-2,48
Queen's Park,3322,7,13,8,15,37,45,-8,47
East Fife,3322,8,12,9,15,49,43,6,45
Stranraer,3322,9,10,4,22,49,73,-24,34
Stenhousem'r,3322,10,5,12,19,40,77,-37,27
Livingston,3323,1,22,2,12,73,45,28,68
Brechin,3323,2,19,3,14,48,40,8,60
Alloa,3323,3,17,8,11,68,36,32,59
East Fife,3323,4,14,10,12,48,43,5,52
Albion,3323,5,13,11,12,53,48,5,50
Airdrieon,3323,6,15,5,16,57,64,-7,50
Peterhead,3323,7,13,8,15,43,50,-7,47
Queen's Park,3323,8,13,8,15,33,46,-13,47
Stranraer,3323,9,12,6,18,47,68,-21,42
Stenhousem'r,3323,10,7,9,20,48,78,-30,30
Livingston,3324,1,21,4,11,73,46,27,67
Airdrieon,3324,2,19,4,13,55,48,7,61
Alloa,3324,3,18,5,13,74,52,22,59
Peterhead,3324,4,16,8,12,58,47,11,56
Albion,3324,5,15,8,13,50,50,0,53
Brechin,3324,6,16,5,15,46,52,-6,53
Queen's Park,3324,7,14,6,16,38,50,-12,48
Stranraer,3324,8,13,6,17,49,58,-9,45
East Fife,3324,9,9,11,16,50,54,-4,38
Stenhousem'r,3324,10,6,9,21,46,82,-36,27
Alloa,3325,1,21,4,11,67,43,24,67
Livingston,3325,2,19,6,11,85,55,30,63
Airdrieon,3325,3,19,6,11,65,48,17,63
Brechin,3325,4,18,6,12,51,46,5,60
Albion,3325,5,17,5,14,59,58,1,56
Queen's Park,3325,6,15,5,16,41,51,-10,50
Stranraer,3325,7,14,4,18,51,57,-6,46
Peterhead,3325,8,12,9,15,47,55,-8,45
East Fife,3325,9,8,9,19,45,60,-15,33
Stenhousem'r,3325,10,6,8,22,46,84,-38,26
Livingston,3326,1,20,7,9,75,43,32,67
Alloa,3326,2,19,7,10,73,53,20,64
Airdrieon,3326,3,17,6,13,68,64,4,57
Peterhead,3326,4,16,7,13,43,41,2,55
Brechin,3326,5,14,6,16,60,61,-1,48
Queen's Park,3326,6,15,3,18,39,52,-13,48
Stranraer,3326,7,14,5,17,58,61,-3,47
Albion,3326,8,12,7,17,55,66,-11,43
Stenhousem'r,3326,9,12,6,18,52,74,-22,42
East Fife,3326,10,11,6,19,46,54,-8,39
Livingston,3327,1,26,4,6,89,37,52,82
Brechin,3327,2,20,4,12,57,46,11,64
Alloa,3327,3,19,6,11,76,47,29,63
Airdrieon,3327,4,18,6,12,65,59,6,60
Albion,3327,5,16,6,14,54,43,11,54
Peterhead,3327,6,14,6,16,50,53,-3,48
East Fife,3327,7,11,7,18,41,51,-10,40
Queen's Park,3327,8,10,10,16,34,52,-18,40
Stranraer,3327,9,10,5,21,45,73,-28,35
Stenhousem'r,3327,10,5,8,23,37,87,-50,23
Livingston,3328,1,20,5,11,70,48,22,65
Airdrieon,3328,2,18,8,10,59,50,9,62
Brechin,3328,3,17,8,11,52,44,8,59
Alloa,3328,4,15,9,12,67,55,12,54
Albion,3328,5,15,7,14,60,65,-5,52
Stranraer,3328,6,15,3,18,59,64,-5,48
East Fife,3328,7,13,7,16,52,48,4,46
Peterhead,3328,8,12,7,17,45,54,-9,43
Queen's Park,3328,9,10,10,16,42,53,-11,40
Stenhousem'r,3328,10,8,10,18,49,74,-25,34
Alloa,3329,1,21,7,8,79,44,35,70
Livingston,3329,2,21,6,9,86,53,33,69
Airdrieon,3329,3,17,8,11,61,52,9,59
Brechin,3329,4,17,8,11,52,45,7,59
Queen's Park,3329,5,13,11,12,38,39,-1,50
Albion,3329,6,14,7,15,49,51,-2,49
Stranraer,3329,7,13,5,18,55,68,-13,44
East Fife,3329,8,9,13,14,47,49,-2,40
Peterhead,3329,9,10,9,17,41,55,-14,39
Stenhousem'r,3329,10,6,4,26,37,89,-52,22
Livingston,3330,1,20,4,12,73,57,16,64
Alloa,3330,2,18,6,12,72,52,20,60
Airdrieon,3330,3,16,7,13,56,55,1,55
Brechin,3330,4,15,8,13,46,42,4,53
East Fife,3330,5,15,6,15,57,49,8,51
Stranraer,3330,6,15,5,16,53,55,-2,50
Queen's Park,3330,7,14,6,16,41,51,-10,48
Peterhead,3330,8,13,8,15,41,50,-9,47
Albion,3330,9,13,7,16,56,51,5,46
Stenhousem'r,3330,10,9,7,20,43,76,-33,34
Livingston,3331,1,21,5,10,78,47,31,68
Alloa,3331,2,17,8,11,68,51,17,59
Airdrieon,3331,3,17,8,11,64,49,15,59
Brechin,3331,4,16,8,12,51,45,6,56
Peterhead,3331,5,16,6,14,59,52,7,54
Albion,3331,6,13,10,13,55,56,-1,49
Stranraer,3331,7,13,6,17,52,62,-10,45
East Fife,3331,8,10,10,16,47,50,-3,40
Queen's Park,3331,9,9,10,17,35,56,-21,37
Stenhousem'r,3331,10,8,9,19,45,86,-41,33
Alloa,3332,1,24,5,7,83,41,42,77
Livingston,3332,2,22,3,11,66,40,26,69
Peterhead,3332,3,16,6,14,56,58,-2,54
Brechin,3332,4,15,9,12,50,52,-2,54
East Fife,3332,5,11,11,14,46,49,-3,44
Airdrieon,3332,6,12,8,16,60,70,-10,44
Stranraer,3332,7,12,7,17,41,51,-10,43
Albion,3332,8,10,10,16,51,59,-8,40
Queen's Park,3332,9,11,7,18,34,50,-16,40
Stenhousem'r,3332,10,10,8,18,50,67,-17,38
Alloa,3333,1,20,9,7,68,46,22,69
Brechin,3333,2,20,5,11,60,47,13,65
Airdrieon,3333,3,19,6,11,69,52,17,63
Livingston,3333,4,18,6,12,73,45,28,60
East Fife,3333,5,11,12,13,51,50,1,45
Albion,3333,6,12,9,15,48,55,-7,45
Queen's Park,3333,7,11,10,15,37,52,-15,43
Peterhead,3333,8,10,11,15,43,50,-7,41
Stranraer,3333,9,11,5,20,54,63,-9,38
Stenhousem'r,3333,10,6,11,19,41,84,-43,29
Livingston,3334,1,24,6,6,87,40,47,78
Alloa,3334,2,19,7,10,70,48,22,64
Albion,3334,3,17,8,11,59,49,10,59
Brechin,3334,4,15,8,13,51,46,5,53
Queen's Park,3334,5,15,7,14,47,50,-3,52
Airdrieon,3334,6,13,8,15,55,51,4,47
Peterhead,3334,7,11,11,14,49,59,-10,44
East Fife,3334,8,10,10,16,45,50,-5,40
Stranraer,3334,9,9,11,16,49,64,-15,38
Stenhousem'r,3334,10,6,6,24,34,89,-55,24
Livingston,3335,1,23,4,9,75,44,31,73
Airdrieon,3335,2,19,7,10,61,51,10,64
Albion,3335,3,16,7,13,48,43,5,55
Alloa,3335,4,14,8,14,68,53,15,50
Brechin,3335,5,14,7,15,53,50,3,49
Peterhead,3335,6,14,6,16,47,51,-4,48
Queen's Park,3335,7,13,7,16,43,58,-15,46
East Fife,3335,8,10,11,15,49,59,-10,41
Stranraer,3335,9,12,5,19,48,65,-17,41
Stenhousem'r,3335,10,12,4,20,53,71,-18,40
Alloa,3336,1,17,9,10,68,49,19,60
Albion,3336,2,17,9,10,59,48,11,60
Brechin,3336,3,17,8,11,51,41,10,59
Livingston,3336,4,17,7,12,69,45,24,58
Airdrieon,3336,5,13,9,14,56,66,-10,48
Queen's Park,3336,6,13,8,15,45,50,-5,47
Stranraer,3336,7,13,8,15,49,58,-9,47
Peterhead,3336,8,13,8,15,49,59,-10,47
East Fife,3336,9,10,9,17,52,53,-1,39
Stenhousem'r,3336,10,8,9,19,48,77,-29,33
Livingston,3337,1,23,3,10,88,49,39,72
Alloa,3337,2,21,8,7,72,38,34,71
Brechin,3337,3,18,6,12,54,55,-1,60
Airdrieon,3337,4,16,4,16,54,52,2,52
Albion,3337,5,14,9,13,47,49,-2,51
Peterhead,3337,6,13,7,16,44,57,-13,46
East Fife,3337,7,12,9,15,51,41,10,45
Queen's Park,3337,8,12,9,15,39,52,-13,45
Stranraer,3337,9,12,4,20,43,60,-17,40
Stenhousem'r,3337,10,6,7,23,37,76,-39,25
Alloa,3338,1,19,6,11,66,40,26,63
Livingston,3338,2,19,3,14,64,52,12,60
Airdrieon,3338,3,16,11,9,58,47,11,59
Albion,3338,4,16,9,11,55,48,7,57
Brechin,3338,5,14,9,13,48,50,-2,51
East Fife,3338,6,14,8,14,53,46,7,50
Stenhousem'r,3338,7,11,10,15,52,72,-20,43
Queen's Park,3338,8,12,6,18,33,50,-17,42
Peterhead,3338,9,10,8,18,51,58,-7,38
Stranraer,3338,10,10,8,18,46,63,-17,38
Alloa,3339,1,24,6,6,78,38,40,78
Brechin,3339,2,19,8,9,64,49,15,65
Livingston,3339,3,19,4,13,62,47,15,61
Airdrieon,3339,4,14,14,8,64,50,14,56
Peterhead,3339,5,15,7,14,51,53,-2,52
Albion,3339,6,12,9,15,54,52,2,45
Stranraer,3339,7,13,6,17,52,61,-9,45
East Fife,3339,8,11,8,17,46,52,-6,41
Queen's Park,3339,9,10,7,19,27,52,-25,37
Stenhousem'r,3339,10,6,5,25,43,87,-44,23
Livingston,3340,1,21,6,9,71,45,26,69
Peterhead,3340,2,18,6,12,57,51,6,60
Alloa,3340,3,15,10,11,69,54,15,55
Airdrieon,3340,4,15,8,13,53,54,-1,53
East Fife,3340,5,14,10,12,57,45,12,52
Brechin,3340,6,13,7,16,48,49,-1,46
Stranraer,3340,7,13,7,16,50,56,-6,46
Queen's Park,3340,8,13,6,17,36,53,-17,45
Stenhousem'r,3340,9,10,9,17,54,78,-24,39
Albion,3340,10,10,7,19,50,60,-10,37
Livingston,3341,1,20,2,14,83,54,29,62
Alloa,3341,2,17,8,11,68,44,24,59
Brechin,3341,3,16,7,13,46,48,-2,55
Queen's Park,3341,4,16,5,15,50,53,-3,53
Airdrieon,3341,5,15,6,15,47,53,-6,51
Stenhousem'r,3341,6,14,8,14,59,73,-14,50
Stranraer,3341,7,15,4,17,55,55,0,49
Peterhead,3341,8,14,6,16,45,52,-7,48
Albion,3341,9,12,11,13,47,52,-5,47
East Fife,3341,10,9,7,20,47,63,-16,34
Livingston,3342,1,24,3,9,81,34,47,75
Alloa,3342,2,20,7,9,68,44,24,67
Brechin,3342,3,20,5,11,63,46,17,65
Airdrieon,3342,4,15,11,10,57,55,2,56
East Fife,3342,5,14,8,14,53,41,12,50
Albion,3342,6,12,10,14,49,54,-5,46
Peterhead,3342,7,14,4,18,45,54,-9,46
Stranraer,3342,8,10,7,19,43,67,-24,37
Queen's Park,3342,9,11,4,21,36,60,-24,37
Stenhousem'r,3342,10,6,9,21,49,89,-40,27
Livingston,3343,1,21,6,9,73,46,27,69
Alloa,3343,2,17,8,11,72,49,23,59
Airdrieon,3343,3,17,7,12,64,55,9,58
Albion,3343,4,16,8,12,53,47,6,56
Peterhead,3343,5,14,12,10,46,51,-5,54
Brechin,3343,6,14,9,13,50,49,1,51
Stranraer,3343,7,16,3,17,55,55,0,51
Queen's Park,3343,8,9,10,17,37,56,-19,37
East Fife,3343,9,7,13,16,45,55,-10,34
Stenhousem'r,3343,10,7,8,21,50,82,-32,29
Livingston,3344,1,20,6,10,72,47,25,66
Airdrieon,3344,2,17,9,10,55,41,14,60
Brechin,3344,3,18,5,13,52,45,7,59
Alloa,3344,4,15,9,12,55,43,12,54
Albion,3344,5,14,10,12,50,52,-2,52
East Fife,3344,6,12,12,12,50,38,12,48
Peterhead,3344,7,12,9,15,48,56,-8,45
Queen's Park,3344,8,13,6,17,32,51,-19,45
Stranraer,3344,9,13,4,19,48,63,-15,43
Stenhousem'r,3344,10,6,10,20,46,72,-26,28
Alloa,3345,1,18,8,10,67,38,29,62
Livingston,3345,2,18,7,11,76,50,26,61
Stranraer,3345,3,16,8,12,56,53,3,56
Brechin,3345,4,15,7,14,53,46,7,52
Peterhead,3345,5,14,9,13,48,55,-7,51
Airdrieon,3345,6,15,4,17,54,59,-5,49
Albion,3345,7,13,8,15,52,56,-4,47
East Fife,3345,8,12,10,14,50,59,-9,46
Queen's Park,3345,9,12,6,18,31,52,-21,42
Stenhousem'r,3345,10,9,9,18,52,71,-19,36
Brechin,3346,1,20,6,10,50,36,14,66
Livingston,3346,2,20,4,12,70,48,22,64
Alloa,3346,3,16,9,11,65,43,22,57
Airdrieon,3346,4,16,8,12,51,56,-5,56
East Fife,3346,5,13,11,12,49,43,6,50
Albion,3346,6,14,6,16,43,46,-3,48
Peterhead,3346,7,12,11,13,50,50,0,47
Queen's Park,3346,8,12,8,16,35,46,-11,44
Stranraer,3346,9,11,4,21,45,61,-16,37
Stenhousem'r,3346,10,8,9,19,41,70,-29,33
Alloa,3347,1,19,10,7,71,42,29,67
Brechin,3347,2,21,4,11,51,39,12,67
Livingston,3347,3,19,6,11,73,45,28,63
Peterhead,3347,4,17,6,13,54,49,5,57
Airdrieon,3347,5,15,6,15,50,57,-7,51
Queen's Park,3347,6,12,9,15,37,52,-15,45
East Fife,3347,7,11,9,16,51,53,-2,42
Stranraer,3347,8,11,7,18,44,55,-11,40
Albion,3347,9,8,13,15,46,53,-7,37
Stenhousem'r,3347,10,8,8,20,47,79,-32,32
Albion,3348,1,18,10,8,60,38,22,64
Alloa,3348,2,18,9,9,69,45,24,63
Airdrieon,3348,3,19,5,12,59,49,10,62
Livingston,3348,4,18,7,11,68,44,24,61
Brechin,3348,5,16,6,14,52,47,5,54
Peterhead,3348,6,14,8,14,53,60,-7,50
East Fife,3348,7,13,8,15,53,53,0,47
Stranraer,3348,8,15,2,19,51,65,-14,47
Stenhousem'r,3348,9,8,6,22,50,82,-32,30
Queen's Park,3348,10,9,3,24,31,63,-32,30
Livingston,3349,1,20,5,11,82,49,33,65
Brechin,3349,2,19,4,13,46,45,1,61
Airdrieon,3349,3,17,6,13,64,63,1,57
Albion,3349,4,15,9,12,54,49,5,54
Alloa,3349,5,14,9,13,60,51,9,51
Queen's Park,3349,6,14,8,14,45,45,0,50
Stranraer,3349,7,14,7,15,57,62,-5,49
East Fife,3349,8,12,11,13,44,40,4,47
Peterhead,3349,9,11,10,15,46,55,-9,43
Stenhousem'r,3349,10,5,9,22,43,82,-39,24
Livingston,3350,1,24,4,8,82,50,32,76
Brechin,3350,2,17,5,14,57,47,10,56
Albion,3350,3,16,7,13,60,56,4,55
Alloa,3350,4,15,9,12,60,48,12,54
Airdrieon,3350,5,16,5,15,62,61,1,53
East Fife,3350,6,14,9,13,54,43,11,51
Stranraer,3350,7,14,4,18,66,68,-2,46
Peterhead,3350,8,12,8,16,47,65,-18,44
Queen's Park,3350,9,12,5,19,34,58,-24,41
Stenhousem'r,3350,10,8,8,20,50,76,-26,32
Livingston,3351,1,25,3,8,79,41,38,78
Alloa,3351,2,18,5,13,68,46,22,59
Peterhead,3351,3,17,7,12,49,49,0,58
Brechin,3351,4,17,6,13,62,53,9,57
Airdrieon,3351,5,15,9,12,58,56,2,54
Albion,3351,6,14,8,14,60,58,2,50
Queen's Park,3351,7,13,6,17,40,54,-14,45
Stranraer,3351,8,9,10,17,49,67,-18,37
Stenhousem'r,3351,9,9,9,18,46,68,-22,36
East Fife,3351,10,6,11,19,44,63,-19,29
Alloa,3352,1,22,9,5,71,34,37,75
Livingston,3352,2,19,6,11,69,50,19,63
Airdrieon,3352,3,18,7,11,61,55,6,61
Albion,3352,4,17,7,12,64,49,15,58
East Fife,3352,5,13,11,12,52,47,5,50
Brechin,3352,6,15,4,17,47,54,-7,49
Peterhead,3352,7,11,8,17,50,65,-15,41
Stranraer,3352,8,10,9,17,48,56,-8,39
Queen's Park,3352,9,10,9,17,33,46,-13,39
Stenhousem'r,3352,10,7,6,23,41,80,-39,27
Livingston,3353,1,22,2,12,82,48,34,68
Alloa,3353,2,20,7,9,79,49,30,67
Airdrieon,3353,3,17,6,13,57,49,8,57
Peterhead,3353,4,15,9,12,57,51,6,54
Brechin,3353,5,15,8,13,51,56,-5,53
Albion,3353,6,14,9,13,62,65,-3,51
Queen's Park,3353,7,12,9,15,44,57,-13,45
Stranraer,3353,8,10,8,18,44,63,-19,38
East Fife,3353,9,9,10,17,44,58,-14,37
Stenhousem'r,3353,10,8,8,20,50,74,-24,32
Airdrieon,3354,1,19,7,10,64,55,9,64
Livingston,3354,2,18,6,12,67,47,20,60
Albion,3354,3,16,9,11,56,44,12,57
Alloa,3354,4,15,10,11,60,52,8,55
Peterhead,3354,5,14,11,11,62,47,15,53
Brechin,3354,6,15,8,13,45,45,0,53
Queen's Park,3354,7,15,7,14,37,44,-7,52
Stranraer,3354,8,13,5,18,57,59,-2,44
East Fife,3354,9,9,12,15,47,51,-4,39
Stenhousem'r,3354,10,3,11,22,39,90,-51,20
Alloa,3355,1,21,8,7,83,48,35,71
Livingston,3355,2,21,5,10,75,43,32,68
Airdrieon,3355,3,16,7,13,62,57,5,55
Peterhead,3355,4,16,7,13,51,48,3,55
Brechin,3355,5,16,6,14,57,60,-3,54
East Fife,3355,6,14,8,14,55,50,5,50
Albion,3355,7,10,12,14,59,64,-5,42
Queen's Park,3355,8,11,6,19,40,61,-21,39
Stranraer,3355,9,11,5,20,49,68,-19,38
Stenhousem'r,3355,10,9,6,21,48,80,-32,33
Livingston,3356,1,22,5,9,81,47,34,71
Alloa,3356,2,19,9,8,77,45,32,66
Albion,3356,3,16,9,11,68,52,16,57
Peterhead,3356,4,13,11,12,50,56,-6,50
Queen's Park,3356,5,13,9,14,40,47,-7,48
Brechin,3356,6,14,5,17,53,77,-24,47
East Fife,3356,7,12,10,14,56,48,8,46
Airdrieon,3356,8,12,9,15,52,57,-5,45
Stranraer,3356,9,12,7,17,52,60,-8,43
Stenhousem'r,3356,10,5,10,21,43,83,-40,25
Brechin,3357,1,20,10,6,62,35,27,70
Livingston,3357,2,20,9,7,71,38,33,69
Alloa,3357,3,19,9,8,74,48,26,66
Airdrieon,3357,4,17,8,11,57,46,11,59
East Fife,3357,5,12,13,11,57,50,7,49
Peterhead,3357,6,10,11,15,39,52,-13,41
Queen's Park,3357,7,10,11,15,39,57,-18,41
Albion,3357,8,12,4,20,50,60,-10,40
Stranraer,3357,9,8,7,21,38,61,-23,31
Stenhousem'r,3357,10,8,6,22,42,82,-40,30
Livingston,3358,1,23,1,12,77,40,37,70
Alloa,3358,2,21,5,10,75,39,36,68
Brechin,3358,3,19,4,13,54,45,9,61
Airdrieon,3358,4,17,7,12,63,61,2,58
Peterhead,3358,5,16,8,12,49,51,-2,56
Albion,3358,6,13,8,15,50,52,-2,47
East Fife,3358,7,12,10,14,52,51,1,46
Queen's Park,3358,8,12,6,18,43,60,-17,42
Stranraer,3358,9,11,4,21,38,61,-23,37
Stenhousem'r,3358,10,6,7,23,44,85,-41,25
Airdrieon,3359,1,17,12,7,60,47,13,63
Alloa,3359,2,18,7,11,65,47,18,61
Livingston,3359,3,19,2,15,77,56,21,59
Albion,3359,4,16,7,13,53,54,-1,55
Peterhead,3359,5,14,12,10,60,53,7,54
Brechin,3359,6,15,7,14,54,59,-5,52
East Fife,3359,7,13,9,14,44,40,4,48
Queen's Park,3359,8,12,8,16,45,52,-7,44
Stenhousem'r,3359,9,10,8,18,50,74,-24,38
Stranraer,3359,10,9,2,25,51,77,-26,29
Livingston,3360,1,22,2,12,83,52,31,68
Alloa,3360,2,20,7,9,73,48,25,67
Airdrieon,3360,3,16,7,13,62,63,-1,55
Peterhead,3360,4,15,9,12,57,50,7,54
Albion,3360,5,14,7,15,57,57,0,49
Stranraer,3360,6,14,6,16,57,58,-1,48
Brechin,3360,7,13,7,16,48,64,-16,46
East Fife,3360,8,11,10,15,51,50,1,43
Queen's Park,3360,9,12,7,17,36,51,-15,43
Stenhousem'r,3360,10,8,8,20,51,82,-31,32
Alloa,3361,1,21,7,8,80,35,45,70
Airdrieon,3361,2,19,9,8,63,42,21,66
Livingston,3361,3,17,7,12,59,49,10,58
Brechin,3361,4,16,9,11,46,47,-1,57
Albion,3361,5,14,10,12,54,55,-1,52
Peterhead,3361,6,11,9,16,49,54,-5,42
Stranraer,3361,7,11,9,16,45,54,-9,42
Queen's Park,3361,8,11,8,17,36,55,-19,41
East Fife,3361,9,8,13,15,41,54,-13,37
Stenhousem'r,3361,10,8,7,21,50,78,-28,31
Alloa,3362,1,21,10,5,76,36,40,73
Livingston,3362,2,18,7,11,77,54,23,61
Brechin,3362,3,19,4,13,55,42,13,61
Airdrieon,3362,4,15,10,11,58,51,7,55
Albion,3362,5,14,7,15,63,64,-1,49
Peterhead,3362,6,14,6,16,47,55,-8,48
Queen's Park,3362,7,12,7,17,38,60,-22,43
East Fife,3362,8,9,13,14,48,54,-6,40
Stranraer,3362,9,10,9,17,42,55,-13,39
Stenhousem'r,3362,10,6,11,19,43,76,-33,29
Alloa,3363,1,22,6,8,71,44,27,72
Livingston,3363,2,20,4,12,77,51,26,64
Airdrieon,3363,3,18,8,10,65,56,9,62
Brechin,3363,4,17,6,13,49,43,6,57
East Fife,3363,5,14,10,12,57,53,4,52
Albion,3363,6,15,7,14,51,48,3,52
Stranraer,3363,7,14,7,15,58,63,-5,49
Peterhead,3363,8,8,10,18,39,47,-8,34
Queen's Park,3363,9,9,7,20,35,60,-25,34
Stenhousem'r,3363,10,7,7,22,45,82,-37,28
Livingston,3364,1,21,4,11,79,50,29,67
Alloa,3364,2,20,5,11,67,45,22,65
Brechin,3364,3,19,3,14,51,44,7,60
Airdrieon,3364,4,17,5,14,60,64,-4,56
Albion,3364,5,15,8,13,60,54,6,53
Peterhead,3364,6,15,7,14,54,49,5,52
East Fife,3364,7,11,9,16,52,50,2,42
Queen's Park,3364,8,12,4,20,30,58,-28,40
Stranraer,3364,9,11,6,19,48,62,-14,39
Stenhousem'r,3364,10,9,9,18,51,76,-25,36
Livingston,3365,1,22,3,11,73,46,27,69
Peterhead,3365,2,20,7,9,59,40,19,67
Airdrieon,3365,3,18,4,14,70,60,10,58
Alloa,3365,4,15,8,13,66,60,6,53
Brechin,3365,5,16,5,15,55,52,3,53
Albion,3365,6,14,8,14,61,55,6,50
East Fife,3365,7,12,9,15,41,43,-2,45
Queen's Park,3365,8,11,7,18,34,55,-21,40
Stranraer,3365,9,10,8,18,49,65,-16,38
Stenhousem'r,3365,10,8,9,19,43,75,-32,33
Livingston,3366,1,20,6,10,75,49,26,66
Airdrieon,3366,2,17,9,10,60,49,11,60
Brechin,3366,3,17,6,13,46,46,0,57
Peterhead,3366,4,15,11,10,54,49,5,56
Alloa,3366,5,13,14,9,61,47,14,53
Albion,3366,6,13,12,11,61,55,6,51
Queen's Park,3366,7,12,9,15,31,47,-16,45
Stranraer,3366,8,10,10,16,46,52,-6,40
East Fife,3366,9,8,13,15,46,49,-3,37
Stenhousem'r,3366,10,6,8,22,42,79,-37,26
Airdrieon,3367,1,21,5,10,73,50,23,68
Alloa,3367,2,18,8,10,79,53,26,62
Stranraer,3367,3,18,6,12,61,53,8,60
Livingston,3367,4,18,5,13,63,48,15,59
Albion,3367,5,15,12,9,57,48,9,57
Peterhead,3367,6,13,8,15,49,59,-10,47
Brechin,3367,7,14,4,18,41,52,-11,46
Queen's Park,3367,8,10,8,18,44,61,-17,38
Stenhousem'r,3367,9,10,7,19,58,82,-24,37
East Fife,3367,10,8,7,21,48,67,-19,31
Alloa,3368,1,17,9,10,70,46,24,60
Livingston,3368,2,18,6,12,70,52,18,60
Airdrieon,3368,3,18,6,12,57,50,7,60
Brechin,3368,4,18,4,14,60,56,4,58
Peterhead,3368,5,14,9,13,54,55,-1,51
East Fife,3368,6,14,6,16,41,43,-2,48
Queen's Park,3368,7,13,8,15,44,52,-8,47
Albion,3368,8,11,12,13,51,56,-5,45
Stranraer,3368,9,12,6,18,56,67,-11,42
Stenhousem'r,3368,10,5,14,17,42,68,-26,29
Livingston,3369,1,22,4,10,74,43,31,70
Airdrieon,3369,2,20,7,9,57,42,15,67
East Fife,3369,3,17,10,9,65,39,26,61
Alloa,3369,4,14,8,14,62,52,10,50
Stranraer,3369,5,14,7,15,57,60,-3,49
Brechin,3369,6,14,7,15,39,47,-8,49
Queen's Park,3369,7,13,6,17,37,54,-17,45
Peterhead,3369,8,12,8,16,39,49,-10,44
Albion,3369,9,12,6,18,51,57,-6,42
Stenhousem'r,3369,10,6,9,21,43,81,-38,27
Alloa,3370,1,23,5,8,68,38,30,74
Livingston,3370,2,19,4,13,68,48,20,61
Brechin,3370,3,17,6,13,52,49,3,57
Queen's Park,3370,4,16,6,14,45,50,-5,54
Airdrieon,3370,5,14,11,11,51,52,-1,53
Peterhead,3370,6,15,7,14,60,58,2,52
Albion,3370,7,13,10,13,57,53,4,49
Stranraer,3370,8,12,4,20,50,62,-12,40
Stenhousem'r,3370,9,9,7,20,49,75,-26,34
East Fife,3370,10,8,8,20,42,57,-15,32
Livingston,3371,1,20,3,13,76,55,21,63
Brechin,3371,2,18,7,11,58,54,4,61
Alloa,3371,3,16,9,11,65,48,17,57
Airdrieon,3371,4,16,8,12,58,57,1,56
East Fife,3371,5,15,9,12,54,41,13,54
Albion,3371,6,14,9,13,61,56,5,51
Peterhead,3371,7,14,8,14,57,53,4,50
Stranraer,3371,8,12,5,19,51,66,-15,41
Queen's Park,3371,9,11,6,19,38,58,-20,39
Stenhousem'r,3371,10,8,8,20,51,81,-30,32
Livingston,3372,1,22,6,8,75,37,38,72
Alloa,3372,2,19,8,9,71,47,24,65
Airdrieon,3372,3,18,5,13,58,54,4,59
Brechin,3372,4,14,10,12,49,48,1,52
East Fife,3372,5,13,11,12,52,43,9,50
Peterhead,3372,6,13,10,13,45,47,-2,49
Queen's Park,3372,7,13,6,17,43,49,-6,45
Albion,3372,8,11,10,15,58,58,0,43
Stranraer,3372,9,10,9,17,47,71,-24,39
Stenhousem'r,3372,10,5,9,22,35,79,-44,24
Alloa,3373,1,20,8,8,68,39,29,68
Livingston,3373,2,21,4,11,68,46,22,67
Airdrieon,3373,3,17,5,14,65,53,12,56
Brechin,3373,4,16,8,12,53,48,5,56
Albion,3373,5,15,7,14,47,44,3,52
Stranraer,3373,6,13,6,17,54,56,-2,45
Peterhead,3373,7,12,7,17,39,55,-16,43
East Fife,3373,8,9,13,14,44,47,-3,40
Stenhousem'r,3373,9,10,10,16,47,68,-21,40
Queen's Park,3373,10,10,6,20,29,58,-29,36
Brechin,3374,1,20,8,8,60,42,18,68
Livingston,3374,2,21,4,11,77,44,33,67
Airdrieon,3374,3,19,7,10,60,46,14,64
Alloa,3374,4,16,6,14,71,55,16,54
East Fife,3374,5,15,8,13,57,46,11,53
Albion,3374,6,13,9,14,49,50,-1,48
Peterhead,3374,7,13,9,14,50,56,-6,48
Stranraer,3374,8,11,6,19,50,67,-17,39
Queen's Park,3374,9,8,8,20,36,59,-23,32
Stenhousem'r,3374,10,7,9,20,47,92,-45,30
Livingston,3375,1,22,6,8,84,45,39,72
Alloa,3375,2,19,10,7,70,41,29,67
Brechin,3375,3,15,10,11,46,45,1,55
Albion,3375,4,13,12,11,50,52,-2,51
Airdrieon,3375,5,13,10,13,51,59,-8,49
Queen's Park,3375,6,12,7,17,36,52,-16,43
East Fife,3375,7,10,11,15,48,51,-3,41
Stranraer,3375,8,11,8,17,51,57,-6,41
Peterhead,3375,9,11,6,19,51,64,-13,39
Stenhousem'r,3375,10,10,8,18,52,73,-21,38
Airdrieon,3376,1,22,5,9,61,41,20,71
Livingston,3376,2,19,8,9,69,40,29,65
Albion,3376,3,15,11,10,55,45,10,56
Alloa,3376,4,14,12,10,61,45,16,54
Brechin,3376,5,14,8,14,50,52,-2,50
Peterhead,3376,6,13,9,14,52,56,-4,48
East Fife,3376,7,12,9,15,46,52,-6,45
Stranraer,3376,8,13,4,19,40,48,-8,43
Queen's Park,3376,9,9,7,20,35,56,-21,34
Stenhousem'r,3376,10,6,13,17,35,69,-34,31
Livingston,3377,1,23,3,10,72,43,29,72
Alloa,3377,2,18,11,7,73,45,28,65
Airdrieon,3377,3,18,10,8,66,46,20,64
East Fife,3377,4,14,8,14,52,49,3,50
Brechin,3377,5,14,6,16,48,51,-3,48
Queen's Park,3377,6,12,9,15,41,49,-8,45
Albion,3377,7,11,11,14,51,53,-2,44
Stenhousem'r,3377,8,11,8,17,47,71,-24,41
Stranraer,3377,9,10,6,20,45,66,-21,36
Peterhead,3377,10,8,10,18,45,67,-22,34
Alloa,3378,1,21,7,8,68,40,28,70
Livingston,3378,2,20,6,10,69,43,26,66
Albion,3378,3,18,5,13,52,47,5,59
Brechin,3378,4,16,6,14,41,40,1,54
Airdrieon,3378,5,15,7,14,58,53,5,52
Queen's Park,3378,6,14,7,15,41,49,-8,49
Peterhead,3378,7,13,6,17,47,55,-8,45
East Fife,3378,8,10,12,14,51,49,2,42
Stranraer,3378,9,10,8,18,51,59,-8,38
Stenhousem'r,3378,10,8,6,22,44,87,-43,30
Alloa,3379,1,17,10,9,73,41,32,61
Livingston,3379,2,18,7,11,68,53,15,61
Airdrieon,3379,3,18,7,11,53,52,1,61
Brechin,3379,4,17,7,12,48,44,4,58
East Fife,3379,5,13,9,14,48,44,4,48
Albion,3379,6,12,11,13,52,51,1,47
Peterhead,3379,7,12,8,16,51,57,-6,44
Queen's Park,3379,8,12,8,16,36,46,-10,44
Stranraer,3379,9,11,9,16,49,58,-9,42
Stenhousem'r,3379,10,6,12,18,47,79,-32,30
Alloa,3380,1,22,7,7,81,45,36,73
Brechin,3380,2,18,8,10,56,46,10,62
Airdrieon,3380,3,19,5,12,62,55,7,62
Livingston,3380,4,18,5,13,76,53,23,59
Peterhead,3380,5,13,10,13,46,46,0,49
Stranraer,3380,6,13,5,18,51,58,-7,44
Queen's Park,3380,7,12,8,16,36,56,-20,44
Albion,3380,8,10,12,14,46,52,-6,42
East Fife,3380,9,10,8,18,42,55,-13,38
Stenhousem'r,3380,10,6,10,20,48,78,-30,28
Alloa,3381,1,21,10,5,76,47,29,73
Livingston,3381,2,21,5,10,73,47,26,68
Albion,3381,3,13,14,9,54,46,8,53
Airdrieon,3381,4,14,10,12,52,51,1,52
Brechin,3381,5,14,8,14,45,49,-4,50
East Fife,3381,6,11,12,13,52,49,3,45
Peterhead,3381,7,11,10,15,41,50,-9,43
Stranraer,3381,8,11,7,18,55,67,-12,40
Stenhousem'r,3381,9,11,7,18,45,67,-22,40
Queen's Park,3381,10,8,7,21,31,51,-20,31
Livingston,3382,1,18,7,11,75,49,26,61
Alloa,3382,2,16,12,8,71,47,24,60
Brechin,3382,3,15,9,12,50,48,2,54
Albion,3382,4,15,8,13,52,46,6,53
Peterhead,3382,5,15,8,13,49,56,-7,53
Airdrieon,3382,6,14,10,12,49,53,-4,52
Queen's Park,3382,7,12,12,12,40,50,-10,48
East Fife,3382,8,13,8,15,56,48,8,47
Stranraer,3382,9,12,6,18,46,55,-9,42
Stenhousem'r,3382,10,7,6,23,39,75,-36,27
Livingston,3383,1,22,1,13,79,59,20,67
Airdrieon,3383,2,20,3,13,66,57,9,63
Alloa,3383,3,17,6,13,66,50,16,57
Brechin,3383,4,16,6,14,43,38,5,54
Peterhead,3383,5,16,5,15,54,49,5,53
Stranraer,3383,6,16,4,16,57,53,4,52
East Fife,3383,7,14,7,15,54,52,2,49
Queen's Park,3383,8,14,6,16,38,48,-10,48
Albion,3383,9,10,8,18,45,61,-16,38
Stenhousem'r,3383,10,9,6,21,43,78,-35,33
Alloa,3384,1,19,8,9,61,35,26,65
Livingston,3384,2,19,5,12,68,40,28,62
East Fife,3384,3,16,6,14,63,51,12,54
Albion,3384,4,14,9,13,55,50,5,51
Brechin,3384,5,14,8,14,43,46,-3,50
Airdrieon,3384,6,14,8,14,52,58,-6,50
Peterhead,3384,7,13,9,14,39,51,-12,48
Stranraer,3384,8,12,9,15,45,53,-8,45
Stenhousem'r,3384,9,10,9,17,47,69,-22,39
Queen's Park,3384,10,9,9,18,27,47,-20,36
Livingston,3385,1,20,6,10,83,50,33,66
Airdrieon,3385,2,18,8,10,64,53,11,62
Albion,3385,3,18,7,11,53,42,11,61
Alloa,3385,4,16,10,10,65,41,24,58
Brechin,3385,5,17,6,13,51,42,9,57
Peterhead,3385,6,13,9,14,49,56,-7,48
East Fife,3385,7,10,12,14,47,50,-3,42
Queen's Park,3385,8,11,7,18,34,49,-15,40
Stranraer,3385,9,11,6,19,46,72,-26,39
Stenhousem'r,3385,10,7,7,22,49,86,-37,28
Alloa,3386,1,22,5,9,80,44,36,71
Albion,3386,2,21,4,11,61,46,15,67
Livingston,3386,3,17,6,13,64,51,13,57
Queen's Park,3386,4,16,5,15,34,42,-8,53
Airdrieon,3386,5,15,7,14,56,56,0,52
Brechin,3386,6,15,6,15,47,53,-6,51
Stranraer,3386,7,14,4,18,53,58,-5,46
Peterhead,3386,8,12,9,15,50,57,-7,45
East Fife,3386,9,8,11,17,44,50,-6,35
Stenhousem'r,3386,10,7,9,20,46,78,-32,30
Livingston,3387,1,22,5,9,71,45,26,71
Alloa,3387,2,18,11,7,71,41,30,65
Airdrieon,3387,3,19,6,11,65,52,13,63
Albion,3387,4,16,7,13,55,51,4,55
Stranraer,3387,5,13,7,16,52,57,-5,46
Brechin,3387,6,13,6,17,47,51,-4,45
Peterhead,3387,7,11,11,14,45,57,-12,44
Queen's Park,3387,8,11,9,16,32,48,-16,42
East Fife,3387,9,10,8,18,43,50,-7,38
Stenhousem'r,3387,10,9,6,21,42,71,-29,33
Livingston,3388,1,22,3,11,82,57,25,69
Alloa,3388,2,19,8,9,66,42,24,65
Airdrieon,3388,3,19,7,10,75,49,26,64
Albion,3388,4,17,6,13,55,48,7,57
Brechin,3388,5,17,4,15,48,52,-4,55
Stranraer,3388,6,16,2,18,53,59,-6,50
Peterhead,3388,7,14,6,16,49,52,-3,48
East Fife,3388,8,11,11,14,45,50,-5,44
Queen's Park,3388,9,11,6,19,37,53,-16,39
Stenhousem'r,3388,10,5,5,26,42,90,-48,20
Livingston,3389,1,22,4,10,75,46,29,70
Alloa,3389,2,18,10,8,77,48,29,64
Airdrieon,3389,3,15,12,9,58,56,2,57
Queen's Park,3389,4,18,3,15,38,39,-1,57
Brechin,3389,5,16,5,15,52,49,3,53
Albion,3389,6,15,6,15,56,57,-1,51
East Fife,3389,7,11,9,16,51,53,-2,42
Peterhead,3389,8,11,7,18,52,57,-5,40
Stranraer,3389,9,11,4,21,48,73,-25,37
Stenhousem'r,3389,10,9,8,19,53,82,-29,35
Livingston,3390,1,22,1,13,80,52,28,67
Alloa,3390,2,19,7,10,66,45,21,64
Albion,3390,3,15,10,11,64,46,18,55
Brechin,3390,4,16,6,14,50,49,1,54
Queen's Park,3390,5,14,9,13,49,57,-8,51
Airdrieon,3390,6,15,5,16,52,59,-7,50
Peterhead,3390,7,13,8,15,54,57,-3,47
East Fife,3390,8,12,10,14,57,50,7,46
Stranraer,3390,9,12,5,19,50,71,-21,41
Stenhousem'r,3390,10,6,11,19,51,87,-36,29
Alloa,3391,1,19,9,8,68,39,29,66
Airdrieon,3391,2,20,5,11,67,49,18,65
Brechin,3391,3,16,9,11,60,51,9,57
Albion,3391,4,14,11,11,61,48,13,53
Livingston,3391,5,16,5,15,69,58,11,53
Peterhead,3391,6,12,13,11,45,47,-2,49
Queen's Park,3391,7,13,8,15,35,42,-7,47
Stranraer,3391,8,12,7,17,48,63,-15,43
East Fife,3391,9,8,16,12,52,53,-1,40
Stenhousem'r,3391,10,4,9,23,35,90,-55,21
Alloa,3392,1,20,5,11,77,42,35,65
Livingston,3392,2,18,8,10,79,47,32,62
Airdrieon,3392,3,17,7,12,52,50,2,58
Brechin,3392,4,16,8,12,47,46,1,56
Queen's Park,3392,5,14,8,14,33,39,-6,50
Albion,3392,6,12,11,13,47,51,-4,47
Peterhead,3392,7,10,14,12,42,51,-9,44
East Fife,3392,8,10,10,16,45,54,-9,40
Stranraer,3392,9,10,9,17,45,58,-13,39
Stenhousem'r,3392,10,8,10,18,46,75,-29,34
Livingston,3393,1,20,6,10,68,43,25,66
Airdrieon,3393,2,18,4,14,67,66,1,58
Alloa,3393,3,16,7,13,65,51,14,55
East Fife,3393,4,14,10,12,54,44,10,52
Peterhead,3393,5,14,9,13,52,41,11,51
Albion,3393,6,14,9,13,48,48,0,51
Brechin,3393,7,15,6,15,50,55,-5,51
Stranraer,3393,8,13,6,17,44,61,-17,45
Stenhousem'r,3393,9,10,8,18,49,63,-14,38
Queen's Park,3393,10,10,7,19,31,56,-25,37
Brechin,3394,1,20,4,12,55,46,9,64
Livingston,3394,2,20,2,14,72,48,24,62
Alloa,3394,3,18,6,12,58,38,20,60
Airdrieon,3394,4,16,8,12,57,52,5,56
Albion,3394,5,15,10,11,61,45,16,55
Peterhead,3394,6,16,7,13,53,52,1,55
Queen's Park,3394,7,13,8,15,44,49,-5,47
Stranraer,3394,8,13,5,18,45,54,-9,44
Stenhousem'r,3394,9,9,6,21,47,95,-48,33
East Fife,3394,10,7,10,19,41,54,-13,31
Livingston,3395,1,21,8,7,76,41,35,71
Brechin,3395,2,19,9,8,53,37,16,66
Alloa,3395,3,15,11,10,67,50,17,56
Airdrieon,3395,4,15,6,15,50,55,-5,51
Albion,3395,5,14,8,14,61,60,1,50
Peterhead,3395,6,13,10,13,48,49,-1,49
Queen's Park,3395,7,13,6,17,35,44,-9,45
East Fife,3395,8,12,8,16,47,52,-5,44
Stranraer,3395,9,12,5,19,52,62,-10,41
Stenhousem'r,3395,10,8,5,23,46,85,-39,29
Alloa,3396,1,19,9,8,72,40,32,66
Livingston,3396,2,20,5,11,73,47,26,65
Brechin,3396,3,18,6,12,50,41,9,60
Albion,3396,4,16,8,12,61,54,7,56
Peterhead,3396,5,15,6,15,48,52,-4,51
Airdrieon,3396,6,15,5,16,50,55,-5,50
Stranraer,3396,7,14,3,19,48,61,-13,45
East Fife,3396,8,12,7,17,50,49,1,43
Queen's Park,3396,9,11,7,18,39,59,-20,40
Stenhousem'r,3396,10,10,4,22,48,81,-33,34
Alloa,3397,1,22,8,6,77,43,34,74
Livingston,3397,2,21,6,9,81,55,26,69
Airdrieon,3397,3,17,7,12,62,59,3,58
Brechin,3397,4,16,7,13,55,48,7,55
Stranraer,3397,5,13,9,14,51,45,6,48
Queen's Park,3397,6,12,8,16,45,56,-11,44
East Fife,3397,7,9,14,13,53,51,2,41
Albion,3397,8,10,11,15,51,54,-3,41
Peterhead,3397,9,10,9,17,43,56,-13,39
Stenhousem'r,3397,10,6,9,21,45,96,-51,27
Livingston,3398,1,21,8,7,90,49,41,71
Brechin,3398,2,20,5,11,50,46,4,65
Alloa,3398,3,16,12,8,66,44,22,60
Airdrieon,3398,4,16,8,12,56,53,3,56
Peterhead,3398,5,13,9,14,43,46,-3,48
Albion,3398,6,12,11,13,48,53,-5,47
Stranraer,3398,7,13,7,16,48,50,-2,46
East Fife,3398,8,10,9,17,41,47,-6,39
Queen's Park,3398,9,8,10,18,39,60,-21,34
Stenhousem'r,3398,10,7,9,20,40,73,-33,30
Alloa,3399,1,23,8,5,82,42,40,77
Livingston,3399,2,22,5,9,78,45,33,71
Airdrieon,3399,3,20,6,10,70,53,17,66
Albion,3399,4,14,9,13,50,52,-2,51
Brechin,3399,5,14,8,14,51,48,3,50
Peterhead,3399,6,12,7,17,48,54,-6,43
Stranraer,3399,7,11,5,20,46,58,-12,38
Stenhousem'r,3399,8,10,8,18,53,85,-32,38
East Fife,3399,9,9,10,17,49,58,-9,37
Queen's Park,3399,10,9,6,21,29,61,-32,33
Alloa,3400,1,20,8,8,71,40,31,68
Peterhead,3400,2,20,7,9,55,38,17,67
Livingston,3400,3,19,5,12,74,49,25,62
Brechin,3400,4,19,5,12,53,47,6,62
Airdrieon,3400,5,16,8,12,50,48,2,56
Albion,3400,6,12,12,12,50,56,-6,48
Stranraer,3400,7,12,6,18,48,61,-13,42
East Fife,3400,8,7,12,17,40,44,-4,33
Stenhousem'r,3400,9,8,7,21,46,80,-34,31
Queen's Park,3400,10,6,12,18,24,48,-24,30
Alloa,3401,1,19,6,11,76,56,20,63
Peterhead,3401,2,18,7,11,58,49,9,61
Livingston,3401,3,18,5,13,73,49,24,59
Airdrieon,3401,4,14,11,11,60,53,7,53
Brechin,3401,5,16,4,16,60,64,-4,52
Queen's Park,3401,6,14,10,12,50,56,-6,52
Albion,3401,7,14,8,14,58,49,9,50
East Fife,3401,8,11,10,15,47,47,0,43
Stenhousem'r,3401,9,9,10,17,42,72,-30,37
Stranraer,3401,10,8,7,21,44,73,-29,31
Livingston,3402,1,23,2,11,84,51,33,71
Alloa,3402,2,19,8,9,73,47,26,65
Brechin,3402,3,19,6,11,55,49,6,63
Stranraer,3402,4,15,7,14,56,48,8,52
Peterhead,3402,5,15,7,14,50,49,1,52
Airdrieon,3402,6,14,6,16,53,59,-6,48
Queen's Park,3402,7,13,8,15,39,50,-11,47
Albion,3402,8,10,11,15,53,63,-10,41
East Fife,3402,9,8,11,17,44,55,-11,35
Stenhousem'r,3402,10,8,6,22,45,81,-36,30
Livingston,3403,1,21,4,11,86,53,33,67
Alloa,3403,2,18,9,9,75,51,24,63
Airdrieon,3403,3,18,9,9,64,58,6,63
Brechin,3403,4,17,5,14,52,52,0,56
Peterhead,3403,5,15,9,12,57,52,5,54
Albion,3403,6,12,9,15,46,49,-3,45
East Fife,3403,7,11,9,16,47,49,-2,42
Stenhousem'r,3403,8,12,6,18,55,76,-21,42
Stranraer,3403,9,11,5,20,48,64,-16,38
Queen's Park,3403,10,9,7,20,31,57,-26,34
Alloa,3404,1,22,5,9,70,46,24,71
Livingston,3404,2,21,7,8,72,43,29,70
Airdrieon,3404,3,18,8,10,53,48,5,62
Peterhead,3404,4,14,11,11,57,47,10,53
Brechin,3404,5,14,8,14,44,49,-5,50
Albion,3404,6,12,9,15,59,58,1,45
Stranraer,3404,7,12,7,17,56,60,-4,43
East Fife,3404,8,10,12,14,47,49,-2,42
Queen's Park,3404,9,9,12,15,35,53,-18,39
Stenhousem'r,3404,10,5,7,24,35,75,-40,22
Livingston,3405,1,25,4,7,89,45,44,79
Airdrieon,3405,2,19,6,11,63,58,5,63
Alloa,3405,3,17,8,11,71,43,28,59
Albion,3405,4,15,8,13,55,52,3,53
Brechin,3405,5,15,6,15,50,58,-8,51
Peterhead,3405,6,14,8,14,47,53,-6,50
Queen's Park,3405,7,14,5,17,39,53,-14,47
East Fife,3405,8,13,5,18,46,50,-4,44
Stranraer,3405,9,9,6,21,44,60,-16,33
Stenhousem'r,3405,10,7,8,21,46,78,-32,29
Livingston,3406,1,21,4,11,76,51,25,67
Alloa,3406,2,19,9,8,64,43,21,66
Airdrieon,3406,3,20,3,13,70,57,13,63
Brechin,3406,4,18,5,13,51,49,2,59
Albion,3406,5,12,14,10,54,45,9,50
Queen's Park,3406,6,11,10,15,40,51,-11,43
Peterhead,3406,7,11,10,15,49,61,-12,43
East Fife,3406,8,10,12,14,44,47,-3,42
Stranraer,3406,9,10,8,18,53,61,-8,38
Stenhousem'r,3406,10,5,11,20,39,75,-36,26
Alloa,3407,1,21,7,8,79,44,35,70
Brechin,3407,2,22,4,10,61,41,20,70
Albion,3407,3,17,9,10,63,45,18,60
Livingston,3407,4,19,3,14,61,57,4,60
Airdrieon,3407,5,17,5,14,56,52,4,56
Queen's Park,3407,6,14,5,17,37,48,-11,47
Stranraer,3407,7,11,9,16,49,62,-13,42
Peterhead,3407,8,10,10,16,48,59,-11,40
Stenhousem'r,3407,9,10,5,21,48,72,-24,35
East Fife,3407,10,7,7,22,36,58,-22,28
Livingston,3408,1,21,6,9,77,45,32,69
Airdrieon,3408,2,20,9,7,52,35,17,69
Alloa,3408,3,19,5,12,65,47,18,62
Brechin,3408,4,15,7,14,46,46,0,52
Peterhead,3408,5,13,10,13,51,47,4,49
Albion,3408,6,12,10,14,52,61,-9,46
Queen's Park,3408,7,11,7,18,35,50,-15,40
East Fife,3408,8,10,9,17,42,50,-8,39
Stenhousem'r,3408,9,9,11,16,47,69,-22,38
Stranraer,3408,10,10,6,20,46,63,-17,36
Livingston,3409,1,18,7,11,76,47,29,61
Alloa,3409,2,17,9,10,66,44,22,60
Airdrieon,3409,3,17,6,13,64,54,10,57
Peterhead,3409,4,17,6,13,55,48,7,57
East Fife,3409,5,14,8,14,53,50,3,50
Queen's Park,3409,6,14,6,16,39,52,-13,48
Stranraer,3409,7,14,5,17,57,58,-1,47
Brechin,3409,8,14,5,17,48,61,-13,47
Albion,3409,9,13,8,15,41,57,-16,47
Stenhousem'r,3409,10,8,8,20,43,71,-28,32
Airdrieon,3410,1,20,6,10,64,54,10,66
Brechin,3410,2,19,6,11,59,40,19,63
Livingston,3410,3,18,8,10,76,53,23,62
Alloa,3410,4,15,12,9,68,45,23,57
Albion,3410,5,15,9,12,51,49,2,54
Peterhead,3410,6,14,6,16,45,51,-6,48
East Fife,3410,7,11,11,14,56,52,4,44
Stranraer,3410,8,13,5,18,48,57,-9,44
Queen's Park,3410,9,10,11,15,32,45,-13,41
Stenhousem'r,3410,10,3,10,23,38,91,-53,19
Airdrieon,3411,1,22,6,8,75,47,28,72
Brechin,3411,2,20,7,9,57,43,14,67
Livingston,3411,3,19,7,10,72,48,24,64
Alloa,3411,4,17,7,12,68,47,21,58
Albion,3411,5,17,5,14,63,50,13,56
Peterhead,3411,6,12,12,12,40,44,-4,48
Queen's Park,3411,7,12,6,18,42,58,-16,42
Stranraer,3411,8,11,5,20,42,61,-19,38
East Fife,3411,9,10,5,21,50,68,-18,35
Stenhousem'r,3411,10,8,4,24,50,93,-43,28
Livingston,3412,1,20,5,11,80,52,28,65
Alloa,3412,2,18,9,9,76,51,25,63
Brechin,3412,3,16,8,12,58,54,4,56
Airdrieon,3412,4,16,7,13,59,56,3,55
Peterhead,3412,5,15,8,13,58,55,3,53
Albion,3412,6,13,11,12,51,47,4,50
Queen's Park,3412,7,12,11,13,42,48,-6,47
Stranraer,3412,8,11,7,18,49,64,-15,40
East Fife,3412,9,8,13,15,51,58,-7,37
Stenhousem'r,3412,10,8,7,21,44,83,-39,31
Brechin,3413,1,19,6,11,52,48,4,63
Alloa,3413,2,17,8,11,71,51,20,59
Livingston,3413,3,18,3,15,75,58,17,57
Airdrieon,3413,4,15,11,10,60,53,7,56
Peterhead,3413,5,15,7,14,54,53,1,52
Queen's Park,3413,6,15,7,14,42,48,-6,52
Stranraer,3413,7,16,3,17,61,66,-5,51
East Fife,3413,8,11,10,15,48,53,-5,43
Albion,3413,9,11,7,18,53,58,-5,40
Stenhousem'r,3413,10,9,6,21,48,76,-28,33
Brechin,3414,1,19,9,8,52,39,13,66
Alloa,3414,2,19,7,10,69,42,27,64
Livingston,3414,3,20,3,13,77,47,30,63
Airdrieon,3414,4,18,4,14,58,62,-4,58
Peterhead,3414,5,16,6,14,59,55,4,54
Queen's Park,3414,6,13,11,12,47,50,-3,50
Albion,3414,7,14,7,15,65,63,2,49
Stranraer,3414,8,12,5,19,46,59,-13,41
Stenhousem'r,3414,9,8,7,21,44,82,-38,31
East Fife,3414,10,7,9,20,47,65,-18,30
Alloa,3415,1,21,5,10,78,43,35,68
Livingston,3415,2,19,5,12,72,55,17,62
Airdrieon,3415,3,18,7,11,63,60,3,61
Brechin,3415,4,17,4,15,53,43,10,55
Albion,3415,5,15,6,15,55,63,-8,51
Stranraer,3415,6,15,5,16,56,60,-4,50
Queen's Park,3415,7,13,6,17,37,52,-15,45
East Fife,3415,8,11,10,15,48,49,-1,43
Peterhead,3415,9,10,9,17,51,65,-14,39
Stenhousem'r,3415,10,10,5,21,55,78,-23,35
Livingston,3416,1,21,4,11,74,43,31,67
Alloa,3416,2,19,7,10,73,45,28,64
Airdrieon,3416,3,20,4,12,65,48,17,64
Brechin,3416,4,17,8,11,62,53,9,59
Stranraer,3416,5,16,5,15,54,55,-1,53
Albion,3416,6,14,9,13,49,51,-2,51
East Fife,3416,7,11,7,18,49,60,-11,40
Queen's Park,3416,8,9,9,18,34,51,-17,36
Peterhead,3416,9,9,9,18,36,58,-22,36
Stenhousem'r,3416,10,10,6,20,46,78,-32,36
Livingston,3417,1,21,5,10,74,43,31,68
Alloa,3417,2,16,9,11,56,46,10,57
Airdrieon,3417,3,16,8,12,65,56,9,56
Stranraer,3417,4,16,6,14,56,57,-1,54
Peterhead,3417,5,16,5,15,57,51,6,53
Brechin,3417,6,15,7,14,60,60,0,52
Albion,3417,7,13,7,16,42,50,-8,46
East Fife,3417,8,12,9,15,45,49,-4,45
Queen's Park,3417,9,11,6,19,42,61,-19,39
Stenhousem'r,3417,10,10,6,20,55,79,-24,36
Livingston,3418,1,22,6,8,88,48,40,72
Alloa,3418,2,19,6,11,75,45,30,63
Airdrieon,3418,3,20,3,13,66,57,9,63
Brechin,3418,4,16,7,13,52,48,4,55
Albion,3418,5,15,9,12,49,44,5,54
Peterhead,3418,6,14,6,16,51,55,-4,48
Queen's Park,3418,7,13,6,17,40,62,-22,45
East Fife,3418,8,11,8,17,38,51,-13,41
Stranraer,3418,9,9,8,19,39,59,-20,35
Stenhousem'r,3418,10,8,7,21,48,77,-29,31
Livingston,3419,1,25,5,6,84,37,47,80
Alloa,3419,2,18,9,9,72,51,21,63
Airdrieon,3419,3,19,3,14,73,64,9,60
East Fife,3419,4,14,8,14,51,44,7,50
Brechin,3419,5,16,2,18,47,62,-15,50
Albion,3419,6,14,6,16,53,60,-7,48
Queen's Park,3419,7,14,5,17,54,61,-7,47
Peterhead,3419,8,13,6,17,50,53,-3,45
Stenhousem'r,3419,9,10,7,19,47,77,-30,37
Stranraer,3419,10,9,5,22,45,67,-22,32
Alloa,3420,1,24,6,6,74,36,38,78
Airdrieon,3420,2,17,9,10,61,52,9,60
Brechin,3420,3,17,6,13,50,43,7,57
Livingston,3420,4,16,5,15,63,55,8,53
Albion,3420,5,15,7,14,48,54,-6,52
Peterhead,3420,6,12,12,12,48,46,2,48
East Fife,3420,7,11,9,16,48,50,-2,42
Stranraer,3420,8,12,6,18,54,67,-13,42
Queen's Park,3420,9,11,5,20,38,53,-15,38
Stenhousem'r,3420,10,9,7,20,48,76,-28,34
Livingston,3421,1,21,7,8,76,45,31,70
Alloa,3421,2,20,7,9,72,41,31,67
Brechin,3421,3,21,3,12,63,48,15,66
Airdrieon,3421,4,20,5,11,56,47,9,65
Albion,3421,5,16,6,14,60,55,5,54
East Fife,3421,6,11,7,18,50,49,1,40
Peterhead,3421,7,11,7,18,41,67,-26,40
Queen's Park,3421,8,11,6,19,38,53,-15,39
Stranraer,3421,9,11,4,21,45,64,-19,37
Stenhousem'r,3421,10,9,6,21,40,72,-32,33
Livingston,3422,1,25,2,9,86,45,41,77
Alloa,3422,2,18,5,13,67,48,19,59
Albion,3422,3,17,8,11,66,52,14,59
Brechin,3422,4,17,6,13,50,47,3,57
Airdrieon,3422,5,14,6,16,54,58,-4,48
Stranraer,3422,6,14,3,19,60,71,-11,45
Peterhead,3422,7,13,5,18,41,52,-11,44
East Fife,3422,8,11,9,16,42,46,-4,42
Queen's Park,3422,9,11,8,17,40,52,-12,41
Stenhousem'r,3422,10,12,4,20,50,85,-35,40
Airdrieon,3423,1,19,9,8,68,50,18,66
Livingston,3423,2,19,4,13,69,49,20,61
Alloa,3423,3,18,4,14,68,44,24,58
East Fife,3423,4,15,9,12,53,41,12,54
Peterhead,3423,5,14,10,12,50,51,-1,52
Albion,3423,6,13,9,14,55,58,-3,48
Stranraer,3423,7,15,3,18,53,58,-5,48
Brechin,3423,8,13,8,15,47,48,-1,47
Queen's Park,3423,9,13,6,17,36,50,-14,45
Stenhousem'r,3423,10,5,10,21,40,90,-50,25
Livingston,3424,1,19,8,9,79,54,25,65
Alloa,3424,2,15,10,11,67,49,18,55
Brechin,3424,3,16,6,14,47,49,-2,54
Peterhead,3424,4,16,4,16,64,59,5,52
Albion,3424,5,13,11,12,51,53,-2,50
Stranraer,3424,6,14,7,15,48,52,-4,49
East Fife,3424,7,12,10,14,49,47,2,46
Airdrieon,3424,8,14,4,18,59,66,-7,46
Queen's Park,3424,9,12,8,16,39,59,-20,44
Stenhousem'r,3424,10,11,8,17,62,77,-15,41
Livingston,3425,1,23,2,11,89,49,40,71
Airdrieon,3425,2,19,7,10,66,48,18,64
Alloa,3425,3,15,10,11,64,51,13,55
Brechin,3425,4,15,8,13,56,55,1,53
Queen's Park,3425,5,13,9,14,38,47,-9,48
Stranraer,3425,6,14,5,17,54,59,-5,47
Albion,3425,7,13,7,16,58,57,1,46
Peterhead,3425,8,12,10,14,53,59,-6,46
East Fife,3425,9,10,10,16,51,63,-12,40
Stenhousem'r,3425,10,8,8,20,45,86,-41,32
Livingston,3426,1,21,5,10,80,57,23,68
Alloa,3426,2,19,8,9,77,48,29,65
Brechin,3426,3,18,4,14,51,50,1,58
Airdrieon,3426,4,16,6,14,62,60,2,54
Albion,3426,5,15,8,13,49,47,2,53
East Fife,3426,6,15,7,14,63,48,15,52
Peterhead,3426,7,15,7,14,53,60,-7,52
Queen's Park,3426,8,10,7,19,38,59,-21,37
Stenhousem'r,3426,9,9,9,18,46,72,-26,36
Stranraer,3426,10,9,5,22,48,66,-18,32
Alloa,3427,1,18,8,10,65,36,29,62
Livingston,3427,2,17,10,9,72,44,28,61
Airdrieon,3427,3,17,8,11,59,56,3,59
Albion,3427,4,15,12,9,57,46,11,57
Peterhead,3427,5,14,8,14,50,56,-6,50
Stranraer,3427,6,13,9,14,56,63,-7,48
East Fife,3427,7,12,11,13,47,44,3,47
Queen's Park,3427,8,10,8,18,30,51,-21,38
Stenhousem'r,3427,9,10,7,19,45,68,-23,37
Brechin,3427,10,9,9,18,38,55,-17,36
Livingston,3428,1,23,3,10,74,46,28,72
Alloa,3428,2,18,6,12,73,46,27,60
Albion,3428,3,17,6,13,66,56,10,57
Airdrieon,3428,4,16,8,12,60,50,10,56
Brechin,3428,5,14,7,15,47,48,-1,49
Stranraer,3428,6,14,7,15,46,56,-10,49
Peterhead,3428,7,14,5,17,46,55,-9,47
East Fife,3428,8,13,7,16,52,52,0,46
Queen's Park,3428,9,11,10,15,39,57,-18,43
Stenhousem'r,3428,10,7,7,22,44,81,-37,28
Livingston,3429,1,23,3,10,77,40,37,72
Airdrieon,3429,2,20,3,13,67,54,13,63
Alloa,3429,3,18,7,11,59,40,19,61
Brechin,3429,4,18,6,12,59,46,13,60
East Fife,3429,5,13,5,18,47,53,-6,44
Peterhead,3429,6,11,11,14,40,48,-8,44
Queen's Park,3429,7,12,8,16,33,53,-20,44
Stranraer,3429,8,12,7,17,46,53,-7,43
Stenhousem'r,3429,9,11,8,17,43,65,-22,41
Albion,3429,10,10,6,20,44,63,-19,36
Livingston,3430,1,22,4,10,80,47,33,70
Alloa,3430,2,21,5,10,59,40,19,68
Airdrieon,3430,3,18,5,13,53,47,6,59
Brechin,3430,4,17,6,13,52,51,1,57
Queen's Park,3430,5,14,6,16,38,46,-8,48
East Fife,3430,6,13,8,15,58,60,-2,47
Peterhead,3430,7,13,7,16,48,58,-10,46
Albion,3430,8,12,8,16,69,61,8,44
Stranraer,3430,9,13,2,21,56,73,-17,41
Stenhousem'r,3430,10,6,11,19,44,74,-30,29
Livingston,3431,1,21,5,10,74,47,27,68
Alloa,3431,2,20,7,9,60,39,21,67
Brechin,3431,3,18,5,13,50,43,7,59
Airdrieon,3431,4,17,7,12,62,53,9,58
Queen's Park,3431,5,15,8,13,41,44,-3,53
Peterhead,3431,6,15,7,14,55,55,0,52
Albion,3431,7,10,11,15,39,51,-12,41
East Fife,3431,8,10,9,17,42,46,-4,39
Stranraer,3431,9,10,5,21,41,54,-13,35
Stenhousem'r,3431,10,7,10,19,44,76,-32,31
Brechin,3432,1,21,5,10,61,42,19,68
Alloa,3432,2,20,4,12,75,53,22,64
Livingston,3432,3,19,6,11,80,52,28,63
Airdrieon,3432,4,16,9,11,62,56,6,57
East Fife,3432,5,14,8,14,54,47,7,50
Stranraer,3432,6,13,8,15,58,60,-2,47
Peterhead,3432,7,11,9,16,49,59,-10,42
Albion,3432,8,11,8,17,51,61,-10,41
Queen's Park,3432,9,12,5,19,39,56,-17,41
Stenhousem'r,3432,10,8,8,20,46,89,-43,32
Livingston,3433,1,23,6,7,65,33,32,75
Airdrieon,3433,2,19,6,11,62,49,13,63
Alloa,3433,3,16,10,10,75,39,36,58
Brechin,3433,4,17,5,14,54,51,3,56
East Fife,3433,5,14,10,12,56,52,4,52
Queen's Park,3433,6,13,8,15,33,46,-13,47
Peterhead,3433,7,12,7,17,37,49,-12,43
Albion,3433,8,11,8,17,54,65,-11,41
Stranraer,3433,9,11,6,19,50,67,-17,39
Stenhousem'r,3433,10,8,6,22,42,77,-35,30
Livingston,3434,1,21,6,9,80,46,34,69
Alloa,3434,2,17,9,10,76,48,28,60
Airdrieon,3434,3,17,5,14,61,65,-4,56
Brechin,3434,4,15,11,10,39,43,-4,56
Albion,3434,5,16,7,13,63,52,11,55
Peterhead,3434,6,13,12,11,46,44,2,51
Queen's Park,3434,7,12,9,15,38,51,-13,45
East Fife,3434,8,10,11,15,45,48,-3,41
Stranraer,3434,9,8,9,19,46,64,-18,33
Stenhousem'r,3434,10,6,11,19,39,72,-33,29
Livingston,3435,1,21,6,9,74,47,27,69
Peterhead,3435,2,17,7,12,57,49,8,58
Airdrieon,3435,3,17,5,14,73,61,12,56
Alloa,3435,4,15,10,11,75,63,12,55
Brechin,3435,5,16,5,15,60,58,2,53
East Fife,3435,6,13,8,15,52,50,2,47
Stranraer,3435,7,13,7,16,46,54,-8,46
Albion,3435,8,12,9,15,55,61,-6,45
Queen's Park,3435,9,12,9,15,40,49,-9,45
Stenhousem'r,3435,10,7,8,21,50,90,-40,29
Livingston,3436,1,23,5,8,86,50,36,74
Airdrieon,3436,2,18,6,12,59,55,4,60
Brechin,3436,3,17,8,11,55,49,6,59
Peterhead,3436,4,16,6,14,49,53,-4,54
Alloa,3436,5,16,5,15,65,53,12,53
Albion,3436,6,14,10,12,50,48,2,52
Stranraer,3436,7,12,7,17,57,61,-4,43
Queen's Park,3436,8,10,7,19,39,65,-26,37
East Fife,3436,9,8,12,16,45,52,-7,36
Stenhousem'r,3436,10,9,8,19,44,63,-19,35
Livingston,3437,1,26,4,6,74,33,41,82
Peterhead,3437,2,18,6,12,51,42,9,60
Alloa,3437,3,16,10,10,56,40,16,58
Brechin,3437,4,16,6,14,51,50,1,54
East Fife,3437,5,14,9,13,48,39,9,51
Queen's Park,3437,6,13,8,15,37,51,-14,47
Stranraer,3437,7,13,4,19,50,58,-8,43
Albion,3437,8,11,7,18,46,54,-8,40
Airdrieon,3437,9,10,7,19,52,68,-16,37
Stenhousem'r,3437,10,8,9,19,44,74,-30,33
Brechin,3438,1,21,5,10,48,40,8,68
Alloa,3438,2,19,6,11,72,45,27,63
Peterhead,3438,3,18,7,11,61,47,14,61
Livingston,3438,4,18,6,12,69,49,20,60
Albion,3438,5,14,11,11,51,49,2,53
Airdrieon,3438,6,14,6,16,51,59,-8,48
Stenhousem'r,3438,7,13,5,18,57,72,-15,44
Stranraer,3438,8,12,6,18,50,62,-12,42
East Fife,3438,9,9,8,19,41,49,-8,35
Queen's Park,3438,10,10,4,22,30,58,-28,34
Livingston,3439,1,21,4,11,71,44,27,67
Alloa,3439,2,18,9,9,58,43,15,63
Peterhead,3439,3,18,8,10,60,49,11,62
Albion,3439,4,16,6,14,65,54,11,54
Brechin,3439,5,16,6,14,56,51,5,54
Queen's Park,3439,6,13,8,15,38,54,-16,47
Airdrieon,3439,7,13,7,16,53,59,-6,46
Stranraer,3439,8,11,6,19,50,64,-14,39
Stenhousem'r,3439,9,9,10,17,50,71,-21,37
East Fife,3439,10,8,10,18,46,58,-12,34
Alloa,3440,1,19,9,8,70,45,25,66
Airdrieon,3440,2,20,6,10,71,53,18,66
Brechin,3440,3,16,7,13,54,48,6,55
Livingston,3440,4,15,9,12,65,49,16,54
Albion,3440,5,14,9,13,59,56,3,51
East Fife,3440,6,12,13,11,56,44,12,49
Peterhead,3440,7,13,8,15,52,55,-3,47
Stranraer,3440,8,12,11,13,50,56,-6,47
Queen's Park,3440,9,10,5,21,34,62,-28,35
Stenhousem'r,3440,10,8,5,23,50,93,-43,29
Albion,3441,1,18,7,11,64,44,20,61
Alloa,3441,2,17,8,11,64,46,18,59
Livingston,3441,3,16,9,11,68,50,18,57
Stranraer,3441,4,16,7,13,54,49,5,55
Queen's Park,3441,5,15,6,15,41,45,-4,51
Airdrieon,3441,6,15,5,16,51,55,-4,50
Peterhead,3441,7,14,8,14,42,50,-8,50
East Fife,3441,8,13,7,16,53,57,-4,46
Brechin,3441,9,11,5,20,45,63,-18,38
Stenhousem'r,3441,10,10,8,18,49,72,-23,38
Livingston,3442,1,20,6,10,69,43,26,66
Alloa,3442,2,18,10,8,64,35,29,64
Brechin,3442,3,19,7,10,54,47,7,64
Queen's Park,3442,4,13,11,12,47,45,2,50
Peterhead,3442,5,13,9,14,42,55,-13,48
Stranraer,3442,6,14,4,18,48,59,-11,46
Airdrieon,3442,7,12,8,16,48,57,-9,44
Albion,3442,8,9,12,15,43,51,-8,39
East Fife,3442,9,8,14,14,48,47,1,38
Stenhousem'r,3442,10,10,7,19,48,72,-24,37
Alloa,3443,1,18,7,11,68,41,27,61
Airdrieon,3443,2,18,7,11,71,61,10,61
Brechin,3443,3,19,4,13,53,47,6,61
Livingston,3443,4,17,7,12,63,48,15,58
Peterhead,3443,5,16,8,12,53,47,6,56
Queen's Park,3443,6,13,8,15,42,56,-14,47
Stranraer,3443,7,13,7,16,50,58,-8,46
East Fife,3443,8,10,11,15,54,55,-1,41
Albion,3443,9,9,12,15,48,56,-8,39
Stenhousem'r,3443,10,7,9,20,41,74,-33,30
Livingston,3444,1,25,2,9,83,45,38,77
Alloa,3444,2,17,11,8,69,45,24,62
Albion,3444,3,16,6,14,59,53,6,54
Peterhead,3444,4,15,8,13,56,59,-3,53
Airdrieon,3444,5,16,4,16,64,57,7,52
Stranraer,3444,6,13,7,16,46,57,-11,46
Brechin,3444,7,12,8,16,45,53,-8,44
East Fife,3444,8,11,10,15,49,54,-5,43
Queen's Park,3444,9,12,7,17,40,55,-15,43
Stenhousem'r,3444,10,8,7,21,43,76,-33,31
Livingston,3445,1,22,5,9,85,50,35,71
Alloa,3445,2,20,9,7,78,47,31,69
Brechin,3445,3,18,5,13,51,46,5,59
Airdrieon,3445,4,16,5,15,53,55,-2,53
Albion,3445,5,14,8,14,53,53,0,50
Queen's Park,3445,6,12,11,13,44,57,-13,47
Stranraer,3445,7,13,5,18,58,63,-5,44
East Fife,3445,8,11,8,17,40,47,-7,41
Peterhead,3445,9,10,7,19,50,61,-11,37
Stenhousem'r,3445,10,8,9,19,51,84,-33,33
Alloa,3446,1,22,6,8,82,43,39,72
Brechin,3446,2,18,9,9,51,37,14,63
Livingston,3446,3,18,8,10,72,49,23,62
Peterhead,3446,4,14,10,12,54,58,-4,52
Albion,3446,5,13,11,12,53,48,5,50
Stranraer,3446,6,13,8,15,49,65,-16,47
East Fife,3446,7,12,10,14,54,49,5,46
Airdrieon,3446,8,13,6,17,51,54,-3,45
Queen's Park,3446,9,12,7,17,36,49,-13,43
Stenhousem'r,3446,10,3,9,24,37,87,-50,18
Livingston,3447,1,24,2,10,76,49,27,74
Alloa,3447,2,20,5,11,74,51,23,65
Airdrieon,3447,3,20,4,12,66,58,8,64
East Fife,3447,4,15,8,13,49,43,6,53
Brechin,3447,5,14,6,16,48,54,-6,48
Albion,3447,6,12,11,13,56,51,5,47
Peterhead,3447,7,11,10,15,53,61,-8,43
Stranraer,3447,8,13,3,20,53,58,-5,42
Queen's Park,3447,9,10,8,18,33,52,-19,38
Stenhousem'r,3447,10,8,9,19,47,78,-31,33
Livingston,3448,1,23,3,10,87,55,32,72
Alloa,3448,2,20,8,8,64,38,26,68
Airdrieon,3448,3,18,7,11,61,49,12,61
East Fife,3448,4,13,13,10,57,44,13,52
Albion,3448,5,14,8,14,54,52,2,50
Stranraer,3448,6,14,4,18,52,55,-3,46
Brechin,3448,7,12,6,18,48,54,-6,42
Peterhead,3448,8,11,7,18,36,52,-16,40
Queen's Park,3448,9,11,6,19,38,57,-19,39
Stenhousem'r,3448,10,10,6,20,46,87,-41,36
Livingston,3449,1,25,2,9,78,41,37,77
Airdrieon,3449,2,20,5,11,77,60,17,65
Alloa,3449,3,18,7,11,71,48,23,61
Albion,3449,4,15,8,13,56,51,5,53
Peterhead,3449,5,13,9,14,58,53,5,48
Stranraer,3449,6,13,7,16,48,59,-11,46
Brechin,3449,7,12,9,15,39,49,-10,45
East Fife,3449,8,11,10,15,48,56,-8,43
Queen's Park,3449,9,10,4,22,33,58,-25,34
Stenhousem'r,3449,10,8,9,19,49,82,-33,33
Alloa,3450,1,22,7,7,80,39,41,73
Livingston,3450,2,21,5,10,80,50,30,68
Albion,3450,3,16,7,13,56,46,10,55
Airdrieon,3450,4,16,5,15,60,65,-5,53
Brechin,3450,5,16,4,16,51,55,-4,52
Peterhead,3450,6,14,8,14,56,52,4,50
Queen's Park,3450,7,13,7,16,41,61,-20,46
East Fife,3450,8,11,10,15,49,49,0,43
Stranraer,3450,9,12,5,19,45,60,-15,41
Stenhousem'r,3450,10,5,10,21,40,81,-41,25
Airdrieon,3451,1,21,4,11,55,51,4,67
Livingston,3451,2,19,7,10,70,48,22,64
Alloa,3451,3,17,7,12,62,43,19,58
Albion,3451,4,17,6,13,56,46,10,57
Peterhead,3451,5,14,10,12,54,50,4,52
Brechin,3451,6,15,5,16,37,48,-11,50
East Fife,3451,7,13,7,16,56,54,2,46
Stranraer,3451,8,13,5,18,49,55,-6,44
Queen's Park,3451,9,11,6,19,35,49,-14,39
Stenhousem'r,3451,10,8,7,21,50,80,-30,31
Alloa,3452,1,21,8,7,80,41,39,71
Livingston,3452,2,20,6,10,83,56,27,66
Brechin,3452,3,20,6,10,60,40,20,66
Airdrieon,3452,4,17,5,14,56,61,-5,56
Albion,3452,5,14,9,13,49,46,3,51
Peterhead,3452,6,13,6,17,44,51,-7,45
Queen's Park,3452,7,13,5,18,37,55,-18,44
Stranraer,3452,8,10,8,18,40,58,-18,38
East Fife,3452,9,10,6,20,38,49,-11,36
Stenhousem'r,3452,10,7,11,18,41,71,-30,32
Alloa,3453,1,20,8,8,70,38,32,68
Livingston,3453,2,20,5,11,87,52,35,65
Airdrieon,3453,3,18,4,14,63,63,0,58
Brechin,3453,4,16,7,13,53,49,4,55
Albion,3453,5,15,6,15,58,54,4,51
Peterhead,3453,6,14,9,13,48,49,-1,51
Stranraer,3453,7,14,4,18,51,63,-12,46
Queen's Park,3453,8,11,9,16,30,49,-19,42
East Fife,3453,9,9,10,17,44,52,-8,37
Stenhousem'r,3453,10,9,6,21,49,84,-35,33
Alloa,3454,1,22,8,6,81,43,38,74
Brechin,3454,2,22,5,9,61,45,16,71
Livingston,3454,3,18,6,12,76,52,24,60
Airdrieon,3454,4,17,9,10,63,57,6,60
Peterhead,3454,5,15,8,13,52,49,3,53
Queen's Park,3454,6,13,5,18,38,46,-8,44
East Fife,3454,7,12,6,18,48,52,-4,42
Stranraer,3454,8,12,5,19,52,63,-11,41
Albion,3454,9,9,7,20,45,68,-23,34
Stenhousem'r,3454,10,6,9,21,46,87,-41,27
Alloa,3455,1,21,6,9,69,41,28,69
Stranraer,3455,2,17,4,15,52,51,1,55
Airdrieon,3455,3,16,7,13,55,55,0,55
Peterhead,3455,4,17,3,16,48,59,-11,54
Livingston,3455,5,16,5,15,57,52,5,53
Albion,3455,6,14,9,13,53,46,7,51
Brechin,3455,7,14,6,16,44,51,-7,48
East Fife,3455,8,12,8,16,49,43,6,44
Queen's Park,3455,9,12,7,17,43,54,-11,43
Stenhousem'r,3455,10,10,7,19,52,70,-18,37
Livingston,3456,1,22,3,11,68,41,27,69
Alloa,3456,2,19,7,10,62,40,22,64
Brechin,3456,3,16,11,9,47,39,8,59
Airdrieon,3456,4,16,8,12,60,52,8,56
Peterhead,3456,5,15,6,15,50,53,-3,51
East Fife,3456,6,13,9,14,47,41,6,48
Albion,3456,7,12,8,16,48,53,-5,44
Stranraer,3456,8,12,7,17,43,56,-13,43
Queen's Park,3456,9,12,5,19,39,53,-14,41
Stenhousem'r,3456,10,9,4,23,51,87,-36,31
Livingston,3457,1,21,2,13,71,45,26,65
Airdrieon,3457,2,17,10,9,57,48,9,61
Brechin,3457,3,17,6,13,58,49,9,57
Peterhead,3457,4,16,8,12,47,43,4,56
Alloa,3457,5,15,10,11,61,50,11,55
Albion,3457,6,15,10,11,58,47,11,55
Stranraer,3457,7,14,7,15,56,52,4,49
East Fife,3457,8,10,9,17,47,51,-4,39
Stenhousem'r,3457,9,9,7,20,49,87,-38,34
Queen's Park,3457,10,7,9,20,26,58,-32,30
Livingston,3458,1,22,6,8,87,50,37,72
Alloa,3458,2,21,7,8,74,42,32,70
Brechin,3458,3,17,7,12,53,47,6,58
Airdrieon,3458,4,18,3,15,57,56,1,57
Albion,3458,5,16,8,12,57,50,7,56
Peterhead,3458,6,14,9,13,50,46,4,51
Stranraer,3458,7,12,4,20,45,63,-18,40
East Fife,3458,8,11,6,19,47,55,-8,39
Queen's Park,3458,9,8,9,19,32,59,-27,33
Stenhousem'r,3458,10,7,9,20,40,74,-34,30
Livingston,3459,1,23,3,10,76,47,29,72
Alloa,3459,2,19,10,7,65,39,26,67
Brechin,3459,3,18,8,10,49,39,10,62
Peterhead,3459,4,15,9,12,57,49,8,54
Airdrieon,3459,5,16,4,16,52,54,-2,52
Albion,3459,6,14,5,17,58,60,-2,47
Stranraer,3459,7,14,4,18,43,54,-11,46
East Fife,3459,8,9,10,17,51,58,-7,37
Queen's Park,3459,9,9,8,19,31,55,-24,35
Stenhousem'r,3459,10,9,7,20,42,69,-27,34
Livingston,3460,1,24,3,9,93,48,45,75
Alloa,3460,2,19,9,8,70,44,26,66
Brechin,3460,3,19,6,11,73,54,19,63
Airdrieon,3460,4,16,7,13,64,66,-2,55
Stranraer,3460,5,15,4,17,62,65,-3,49
Peterhead,3460,6,13,7,16,47,49,-2,46
Albion,3460,7,12,8,16,47,61,-14,44
Queen's Park,3460,8,12,7,17,35,54,-19,43
East Fife,3460,9,10,8,18,43,59,-16,38
Stenhousem'r,3460,10,7,7,22,41,75,-34,28
Alloa,3461,1,20,7,9,74,44,30,67
Livingston,3461,2,19,3,14,71,43,28,60
Airdrieon,3461,3,18,4,14,54,57,-3,58
Brechin,3461,4,17,6,13,52,47,5,57
Peterhead,3461,5,16,9,11,53,49,4,57
Albion,3461,6,13,7,16,52,55,-3,46
Stranraer,3461,7,14,4,18,53,65,-12,46
East Fife,3461,8,10,11,15,44,49,-5,41
Stenhousem'r,3461,9,12,5,19,48,69,-21,41
Queen's Park,3461,10,10,6,20,35,58,-23,36
Livingston,3462,1,20,6,10,78,51,27,66
Alloa,3462,2,16,9,11,69,50,19,57
Queen's Park,3462,3,17,5,14,46,53,-7,56
Peterhead,3462,4,15,8,13,53,46,7,53
Brechin,3462,5,15,7,14,54,55,-1,52
Albion,3462,6,15,5,16,55,58,-3,50
East Fife,3462,7,13,10,13,45,45,0,49
Airdrieon,3462,8,12,8,16,49,51,-2,44
Stranraer,3462,9,12,5,19,57,69,-12,41
Stenhousem'r,3462,10,10,7,19,54,82,-28,37
Alloa,3463,1,20,6,10,68,44,24,66
Livingston,3463,2,19,6,11,71,40,31,63
Albion,3463,3,15,6,15,56,47,9,51
Brechin,3463,4,16,2,18,46,51,-5,50
Stranraer,3463,5,15,5,16,48,57,-9,50
Airdrieon,3463,6,14,8,14,44,53,-9,50
East Fife,3463,7,14,6,16,61,55,6,48
Peterhead,3463,8,14,6,16,45,56,-11,48
Queen's Park,3463,9,12,9,15,37,53,-16,45
Stenhousem'r,3463,10,11,6,19,47,67,-20,39
Brechin,3464,1,18,10,8,62,45,17,64
Alloa,3464,2,18,7,11,76,54,22,61
Airdrieon,3464,3,18,7,11,60,50,10,61
Livingston,3464,4,16,12,8,79,50,29,60
Albion,3464,5,14,7,15,55,54,1,49
Stranraer,3464,6,12,7,17,54,65,-11,43
Peterhead,3464,7,12,7,17,52,64,-12,43
East Fife,3464,8,12,7,17,44,57,-13,43
Queen's Park,3464,9,9,10,17,32,49,-17,37
Stenhousem'r,3464,10,8,12,16,50,76,-26,36
Livingston,3465,1,24,3,9,90,50,40,75
Alloa,3465,2,18,6,12,72,58,14,60
Albion,3465,3,16,10,10,56,46,10,58
Brechin,3465,4,17,7,12,54,52,2,58
Stranraer,3465,5,15,9,12,64,62,2,54
Peterhead,3465,6,12,11,13,58,56,2,47
Airdrieon,3465,7,13,7,16,62,74,-12,46
East Fife,3465,8,12,8,16,52,47,5,44
Queen's Park,3465,9,11,6,19,42,61,-19,39
Stenhousem'r,3465,10,4,9,23,41,85,-44,21
Alloa,3466,1,20,6,10,72,42,30,66
Livingston,3466,2,20,5,11,72,42,30,65
Airdrieon,3466,3,18,7,11,61,54,7,61
Brechin,3466,4,17,7,12,50,48,2,58
Peterhead,3466,5,15,7,14,54,51,3,52
Queen's Park,3466,6,15,7,14,41,46,-5,52
East Fife,3466,7,12,11,13,52,49,3,47
Albion,3466,8,13,7,16,60,59,1,46
Stranraer,3466,9,11,7,18,44,59,-15,40
Stenhousem'r,3466,10,5,4,27,41,97,-56,19
Alloa,3467,1,19,11,6,64,35,29,68
Brechin,3467,2,20,4,12,53,47,6,64
Livingston,3467,3,18,5,13,72,53,19,59
Airdrieon,3467,4,16,10,10,68,61,7,58
Peterhead,3467,5,14,10,12,57,49,8,52
Queen's Park,3467,6,15,6,15,44,51,-7,51
Albion,3467,7,12,10,14,53,52,1,46
Stranraer,3467,8,12,5,19,50,63,-13,41
East Fife,3467,9,8,10,18,47,52,-5,34
Stenhousem'r,3467,10,7,7,22,43,88,-45,28
Alloa,3468,1,21,7,8,70,40,30,70
Livingston,3468,2,20,9,7,77,44,33,69
Brechin,3468,3,17,6,13,49,44,5,57
Airdrieon,3468,4,16,7,13,58,63,-5,55
Albion,3468,5,15,8,13,56,51,5,53
Peterhead,3468,6,12,8,16,44,49,-5,44
Stranraer,3468,7,12,6,18,51,62,-11,42
Queen's Park,3468,8,11,8,17,25,48,-23,41
East Fife,3468,9,9,10,17,42,49,-7,37
Stenhousem'r,3468,10,8,9,19,49,71,-22,33
Airdrieon,3469,1,22,5,9,79,48,31,71
Livingston,3469,2,19,5,12,75,47,28,62
Alloa,3469,3,16,8,12,65,46,19,56
Peterhead,3469,4,17,5,14,56,48,8,56
Brechin,3469,5,13,8,15,43,54,-11,47
Stranraer,3469,6,15,2,19,49,63,-14,47
East Fife,3469,7,12,10,14,49,49,0,46
Queen's Park,3469,8,11,9,16,35,51,-16,42
Albion,3469,9,10,11,15,50,65,-15,41
Stenhousem'r,3469,10,10,7,19,42,72,-30,37
Alloa,3470,1,21,8,7,73,42,31,71
Livingston,3470,2,20,7,9,75,49,26,67
Airdrieon,3470,3,18,6,12,64,58,6,60
Albion,3470,4,15,11,10,55,47,8,56
Stranraer,3470,5,15,5,16,58,58,0,50
Brechin,3470,6,11,11,14,38,42,-4,44
Peterhead,3470,7,13,5,18,45,59,-14,44
East Fife,3470,8,11,10,15,58,48,10,43
Queen's Park,3470,9,12,6,18,35,52,-17,42
Stenhousem'r,3470,10,7,5,24,44,90,-46,26
Livingston,3471,1,23,3,10,75,47,28,72
Brechin,3471,2,19,8,9,48,29,19,65
Alloa,3471,3,19,5,12,71,50,21,62
Queen's Park,3471,4,16,4,16,36,41,-5,52
Peterhead,3471,5,15,6,15,42,43,-1,51
Airdrieon,3471,6,14,7,15,54,51,3,49
East Fife,3471,7,11,11,14,46,49,-3,44
Stranraer,3471,8,11,7,18,38,54,-16,40
Albion,3471,9,9,12,15,44,51,-7,39
Stenhousem'r,3471,10,8,7,21,35,74,-39,31
Alloa,3472,1,20,8,8,83,36,47,68
Livingston,3472,2,21,5,10,65,48,17,68
East Fife,3472,3,15,10,11,55,41,14,55
Brechin,3472,4,16,7,13,41,39,2,55
Stranraer,3472,5,13,10,13,53,55,-2,49
Airdrieon,3472,6,13,7,16,46,60,-14,46
Queen's Park,3472,7,12,8,16,42,55,-13,44
Peterhead,3472,8,11,7,18,48,62,-14,40
Albion,3472,9,10,9,17,46,55,-9,39
Stenhousem'r,3472,10,10,7,19,53,81,-28,37
Alloa,3473,1,18,7,11,68,44,24,61
Livingston,3473,2,18,4,14,60,43,17,58
Airdrieon,3473,3,16,7,13,51,51,0,55
Peterhead,3473,4,16,6,14,52,45,7,54
East Fife,3473,5,16,5,15,50,40,10,53
Brechin,3473,6,15,8,13,52,55,-3,53
Stranraer,3473,7,15,7,14,51,49,2,52
Stenhousem'r,3473,8,11,8,17,52,69,-17,41
Albion,3473,9,10,10,16,40,60,-20,40
Queen's Park,3473,10,12,4,20,35,55,-20,40
Alloa,3474,1,20,10,6,81,41,40,70
Livingston,3474,2,19,5,12,67,48,19,62
Airdrieon,3474,3,16,7,13,60,59,1,55
Stranraer,3474,4,15,8,13,55,48,7,53
Albion,3474,5,13,9,14,61,64,-3,48
Peterhead,3474,6,12,9,15,52,69,-17,45
Brechin,3474,7,12,8,16,49,54,-5,44
Stenhousem'r,3474,8,12,8,16,55,75,-20,44
Queen's Park,3474,9,11,9,16,42,55,-13,42
East Fife,3474,10,9,9,18,45,54,-9,36
Livingston,3475,1,23,3,10,84,51,33,72
Alloa,3475,2,16,12,8,62,43,19,60
Albion,3475,3,17,7,12,58,56,2,58
Brechin,3475,4,16,7,13,47,48,-1,55
Airdrieon,3475,5,15,8,13,54,53,1,53
Peterhead,3475,6,14,7,15,55,52,3,49
East Fife,3475,7,13,7,16,51,48,3,46
Queen's Park,3475,8,13,5,18,42,50,-8,44
Stenhousem'r,3475,9,9,9,18,41,72,-31,36
Stranraer,3475,10,9,5,22,42,63,-21,32
Livingston,3476,1,21,6,9,78,47,31,69
Airdrieon,3476,2,21,4,11,62,49,13,67
Albion,3476,3,18,7,11,59,46,13,61
Brechin,3476,4,17,8,11,48,47,1,59
Alloa,3476,5,17,7,12,74,49,25,58
Peterhead,3476,6,15,6,15,59,59,0,51
Stranraer,3476,7,14,3,19,48,55,-7,45
East Fife,3476,8,12,8,16,48,51,-3,44
Queen's Park,3476,9,11,6,19,33,57,-24,39
Stenhousem'r,3476,10,4,5,27,43,92,-49,17
Alloa,3477,1,22,6,8,75,46,29,72
Livingston,3477,2,20,5,11,64,46,18,65
Airdrieon,3477,3,17,7,12,59,53,6,58
Queen's Park,3477,4,17,7,12,45,43,2,58
Brechin,3477,5,17,6,13,49,44,5,57
Albion,3477,6,13,7,16,57,57,0,46
Peterhead,3477,7,12,7,17,53,60,-7,43
East Fife,3477,8,11,8,17,55,53,2,41
Stranraer,3477,9,9,8,19,46,64,-18,35
Stenhousem'r,3477,10,7,9,20,47,84,-37,30
Brechin,3478,1,19,5,12,62,46,16,62
Airdrieon,3478,2,18,6,12,59,57,2,60
Alloa,3478,3,17,8,11,67,43,24,59
Livingston,3478,4,18,4,14,73,58,15,58
Peterhead,3478,5,16,7,13,60,47,13,55
Albion,3478,6,16,6,14,48,43,5,54
Stranraer,3478,7,15,5,16,52,60,-8,50
Queen's Park,3478,8,14,4,18,41,61,-20,46
East Fife,3478,9,10,11,15,46,52,-6,41
Stenhousem'r,3478,10,6,6,24,45,86,-41,24
Alloa,3479,1,19,8,9,66,41,25,65
Livingston,3479,2,19,7,10,71,50,21,64
Brechin,3479,3,18,8,10,47,40,7,62
Peterhead,3479,4,13,11,12,46,47,-1,50
Albion,3479,5,13,10,13,53,52,1,49
Airdrieon,3479,6,14,7,15,48,51,-3,49
East Fife,3479,7,12,12,12,56,48,8,48
Stranraer,3479,8,11,8,17,48,55,-7,41
Stenhousem'r,3479,9,9,9,18,46,72,-26,36
Queen's Park,3479,10,8,8,20,28,53,-25,32
Alloa,3480,1,18,9,9,80,49,31,63
Albion,3480,2,17,8,11,60,51,9,59
Livingston,3480,3,17,7,12,68,49,19,58
Brechin,3480,4,14,8,14,49,45,4,50
Stranraer,3480,5,15,4,17,52,58,-6,49
Airdrieon,3480,6,14,7,15,49,64,-15,49
Queen's Park,3480,7,11,13,12,32,44,-12,46
Peterhead,3480,8,13,6,17,50,51,-1,45
Stenhousem'r,3480,9,11,9,16,54,78,-24,42
East Fife,3480,10,10,9,17,42,47,-5,39
Livingston,3481,1,23,7,6,88,42,46,76
Airdrieon,3481,2,19,7,10,65,48,17,64
Albion,3481,3,15,6,15,55,53,2,51
Brechin,3481,4,14,9,13,47,46,1,51
East Fife,3481,5,14,6,16,53,46,7,48
Alloa,3481,6,13,9,14,62,61,1,48
Stranraer,3481,7,15,3,18,57,71,-14,48
Peterhead,3481,8,13,6,17,48,60,-12,45
Queen's Park,3481,9,12,8,16,39,47,-8,44
Stenhousem'r,3481,10,9,5,22,42,82,-40,32
Airdrieon,3482,1,21,8,7,65,45,20,71
Livingston,3482,2,20,7,9,87,44,43,67
Alloa,3482,3,17,12,7,66,42,24,63
Brechin,3482,4,15,7,14,49,46,3,52
Stranraer,3482,5,14,7,15,56,59,-3,49
Albion,3482,6,13,8,15,47,52,-5,47
Peterhead,3482,7,13,7,16,48,58,-10,46
Queen's Park,3482,8,13,6,17,39,61,-22,45
East Fife,3482,9,9,11,16,42,51,-9,38
Stenhousem'r,3482,10,6,5,25,43,84,-41,23
Livingston,3483,1,23,4,9,88,51,37,73
Airdrieon,3483,2,21,6,9,58,45,13,69
Brechin,3483,3,19,8,9,64,45,19,65
Alloa,3483,4,17,9,10,74,55,19,60
Albion,3483,5,13,7,16,56,61,-5,46
Peterhead,3483,6,13,5,18,50,58,-8,44
Stranraer,3483,7,12,6,18,44,58,-14,42
East Fife,3483,8,10,7,19,45,54,-9,37
Queen's Park,3483,9,10,7,19,38,59,-21,37
Stenhousem'r,3483,10,8,9,19,56,87,-31,33
Airdrieon,3484,1,21,6,9,64,46,18,69
Livingston,3484,2,21,3,12,67,44,23,66
Alloa,3484,3,19,7,10,67,46,21,64
Albion,3484,4,17,8,11,57,47,10,59
Brechin,3484,5,15,9,12,37,42,-5,54
Peterhead,3484,6,12,7,17,53,57,-4,43
East Fife,3484,7,10,11,15,53,49,4,41
Queen's Park,3484,8,11,8,17,33,53,-20,41
Stranraer,3484,9,8,9,19,40,56,-16,33
Stenhousem'r,3484,10,9,6,21,42,73,-31,33
Livingston,3485,1,22,4,10,74,56,18,70
Brechin,3485,2,17,5,14,47,45,2,56
Airdrieon,3485,3,16,7,13,61,58,3,55
Peterhead,3485,4,15,7,14,45,40,5,52
Alloa,3485,5,14,9,13,64,50,14,51
Queen's Park,3485,6,14,7,15,50,51,-1,49
Stranraer,3485,7,15,4,17,53,59,-6,49
Stenhousem'r,3485,8,12,9,15,51,65,-14,45
Albion,3485,9,12,7,17,54,61,-7,43
East Fife,3485,10,9,9,18,46,60,-14,36
Alloa,3486,1,20,10,6,73,37,36,70
Livingston,3486,2,22,3,11,73,45,28,69
Peterhead,3486,3,18,8,10,61,50,11,62
Airdrieon,3486,4,16,8,12,58,53,5,56
Brechin,3486,5,15,7,14,53,54,-1,52
Queen's Park,3486,6,14,8,14,48,52,-4,50
East Fife,3486,7,10,9,17,48,46,2,39
Albion,3486,8,10,7,19,48,66,-18,37
Stenhousem'r,3486,9,9,9,18,52,78,-26,36
Stranraer,3486,10,8,7,21,42,75,-33,31
Alloa,3487,1,21,7,8,81,49,32,70
Livingston,3487,2,20,6,10,80,57,23,66
Brechin,3487,3,16,8,12,53,54,-1,56
Queen's Park,3487,4,14,10,12,46,44,2,52
Airdrieon,3487,5,14,8,14,52,48,4,50
Peterhead,3487,6,12,8,16,50,59,-9,44
East Fife,3487,7,11,10,15,52,48,4,43
Stranraer,3487,8,12,7,17,55,62,-7,43
Stenhousem'r,3487,9,10,10,16,46,69,-23,40
Albion,3487,10,8,10,18,45,70,-25,34
Livingston,3488,1,24,3,9,81,46,35,75
Alloa,3488,2,21,7,8,71,37,34,70
Brechin,3488,3,15,8,13,46,50,-4,53
Airdrieon,3488,4,15,6,15,64,61,3,51
Albion,3488,5,13,10,13,54,45,9,49
Peterhead,3488,6,14,7,15,47,58,-11,49
East Fife,3488,7,12,9,15,51,51,0,45
Stranraer,3488,8,12,6,18,54,60,-6,42
Queen's Park,3488,9,11,8,17,39,53,-14,41
Stenhousem'r,3488,10,7,8,21,40,86,-46,29
Alloa,3489,1,21,6,9,64,31,33,69
Livingston,3489,2,20,7,9,73,43,30,67
Airdrieon,3489,3,16,8,12,57,58,-1,56
Brechin,3489,4,16,5,15,59,53,6,53
Albion,3489,5,15,7,14,56,58,-2,52
Queen's Park,3489,6,14,9,13,39,45,-6,51
East Fife,3489,7,13,6,17,49,50,-1,45
Peterhead,3489,8,11,9,16,45,53,-8,42
Stranraer,3489,9,10,8,18,47,62,-15,38
Stenhousem'r,3489,10,7,9,20,37,73,-36,30
Alloa,3490,1,20,7,9,79,55,24,67
Airdrieon,3490,2,20,7,9,66,52,14,67
Livingston,3490,3,20,5,11,77,57,20,65
Brechin,3490,4,18,3,15,56,46,10,57
Peterhead,3490,5,14,9,13,48,47,1,51
Albion,3490,6,13,8,15,53,59,-6,47
East Fife,3490,7,11,8,17,57,57,0,41
Stranraer,3490,8,11,8,17,50,58,-8,41
Queen's Park,3490,9,9,8,19,35,62,-27,35
Stenhousem'r,3490,10,10,5,21,54,82,-28,35
Livingston,3491,1,21,6,9,73,40,33,69
Brechin,3491,2,18,10,8,50,37,13,64
Alloa,3491,3,18,7,11,61,50,11,61
Peterhead,3491,4,15,10,11,50,42,8,55
Airdrieon,3491,5,15,6,15,54,56,-2,51
Stranraer,3491,6,14,5,17,52,54,-2,47
Albion,3491,7,12,10,14,52,49,3,46
East Fife,3491,8,11,7,18,45,53,-8,40
Queen's Park,3491,9,9,8,19,36,61,-25,35
Stenhousem'r,3491,10,8,9,19,46,77,-31,33
Alloa,3492,1,21,7,8,69,36,33,70
Livingston,3492,2,22,4,10,77,49,28,70
Airdrieon,3492,3,16,11,9,62,49,13,59
Albion,3492,4,17,6,13,60,48,12,57
Stranraer,3492,5,12,11,13,57,63,-6,47
Brechin,3492,6,14,5,17,45,57,-12,47
East Fife,3492,7,12,9,15,52,50,2,45
Queen's Park,3492,8,12,5,19,39,56,-17,41
Peterhead,3492,9,10,10,16,47,64,-17,40
Stenhousem'r,3492,10,7,6,23,45,81,-36,27
Livingston,3493,1,23,4,9,80,43,37,73
Airdrieon,3493,2,17,9,10,64,52,12,60
Alloa,3493,3,16,11,9,65,48,17,59
Albion,3493,4,17,7,12,63,51,12,58
Brechin,3493,5,17,5,14,58,47,11,56
Stranraer,3493,6,13,5,18,43,62,-19,44
East Fife,3493,7,11,10,15,48,50,-2,43
Peterhead,3493,8,11,9,16,45,59,-14,42
Queen's Park,3493,9,10,8,18,41,60,-19,38
Stenhousem'r,3493,10,7,8,21,51,86,-35,29
Livingston,3494,1,23,7,6,81,44,37,76
Airdrieon,3494,2,20,8,8,64,49,15,68
Alloa,3494,3,17,8,11,66,45,21,59
Brechin,3494,4,17,7,12,55,46,9,58
Albion,3494,5,14,9,13,54,51,3,51
Stranraer,3494,6,12,8,16,56,62,-6,44
Peterhead,3494,7,12,6,18,46,57,-11,42
Queen's Park,3494,8,11,8,17,38,51,-13,41
East Fife,3494,9,11,7,18,52,59,-7,40
Stenhousem'r,3494,10,6,6,24,38,86,-48,24
Livingston,3495,1,22,6,8,82,49,33,72
Alloa,3495,2,19,7,10,70,43,27,64
Airdrieon,3495,3,18,6,12,63,48,15,60
Albion,3495,4,14,10,12,56,45,11,52
Stranraer,3495,5,16,3,17,49,53,-4,51
Brechin,3495,6,15,6,15,51,62,-11,51
East Fife,3495,7,11,12,13,59,50,9,45
Peterhead,3495,8,12,7,17,48,63,-15,43
Queen's Park,3495,9,11,7,18,39,61,-22,40
Stenhousem'r,3495,10,5,10,21,39,82,-43,25
Livingston,3496,1,20,8,8,84,52,32,68
Alloa,3496,2,17,9,10,66,40,26,60
Airdrieon,3496,3,16,10,10,55,50,5,58
Peterhead,3496,4,17,6,13,57,54,3,57
Brechin,3496,5,17,4,15,49,52,-3,55
East Fife,3496,6,15,8,13,57,51,6,53
Albion,3496,7,14,6,16,65,56,9,48
Queen's Park,3496,8,12,9,15,36,49,-13,45
Stranraer,3496,9,10,5,21,51,72,-21,35
Stenhousem'r,3496,10,7,5,24,36,80,-44,26
Alloa,3497,1,20,7,9,73,50,23,67
Livingston,3497,2,18,5,13,71,49,22,59
Brechin,3497,3,18,4,14,52,53,-1,58
East Fife,3497,4,16,8,12,61,42,19,56
Airdrieon,3497,5,17,4,15,50,56,-6,55
Stranraer,3497,6,16,5,15,58,54,4,53
Albion,3497,7,16,4,16,56,53,3,52
Peterhead,3497,8,13,8,15,52,53,-1,47
Queen's Park,3497,9,10,6,20,38,64,-26,36
Stenhousem'r,3497,10,6,9,21,50,87,-37,27
Alloa,3498,1,20,4,12,70,45,25,64
Brechin,3498,2,17,8,11,60,48,12,59
Airdrieon,3498,3,18,5,13,61,53,8,59
Livingston,3498,4,16,5,15,72,57,15,53
Peterhead,3498,5,14,9,13,52,46,6,51
Albion,3498,6,14,9,13,54,50,4,51
Queen's Park,3498,7,13,4,19,34,62,-28,43
East Fife,3498,8,10,12,14,49,58,-9,42
Stranraer,3498,9,12,6,18,51,63,-12,42
Stenhousem'r,3498,10,10,10,16,49,70,-21,40
Livingston,3499,1,24,2,10,76,41,35,74
Alloa,3499,2,18,7,11,68,54,14,61
Albion,3499,3,15,8,13,60,56,4,53
Peterhead,3499,4,14,9,13,52,49,3,51
Stranraer,3499,5,16,3,17,57,60,-3,51
Airdrieon,3499,6,14,9,13,50,56,-6,51
Brechin,3499,7,14,7,15,47,51,-4,49
Queen's Park,3499,8,14,7,15,42,49,-7,49
East Fife,3499,9,9,11,16,55,51,4,38
Stenhousem'r,3499,10,7,7,22,38,78,-40,28
Brechin,3500,1,20,6,10,47,38,9,66
Airdrieon,3500,2,17,13,6,69,50,19,64
Livingston,3500,3,18,8,10,77,52,25,62
Alloa,3500,4,18,8,10,66,41,25,62
Peterhead,3500,5,14,7,15,45,59,-14,49
Albion,3500,6,13,9,14,50,52,-2,48
East Fife,3500,7,11,8,17,45,54,-9,41
Stenhousem'r,3500,8,10,8,18,54,70,-16,38
Queen's Park,3500,9,9,9,18,35,58,-23,36
Stranraer,3500,10,9,6,21,44,58,-14,33
Alloa,3501,1,21,8,7,73,38,35,71
Brechin,3501,2,22,3,11,66,46,20,69
Livingston,3501,3,19,5,12,73,42,31,62
Peterhead,3501,4,15,7,14,52,53,-1,52
Stranraer,3501,5,14,7,15,55,58,-3,49
Queen's Park,3501,6,14,6,16,41,50,-9,48
Airdrieon,3501,7,12,9,15,49,58,-9,45
Albion,3501,8,9,10,17,41,62,-21,37
East Fife,3501,9,8,12,16,47,56,-9,36
Stenhousem'r,3501,10,8,9,19,49,83,-34,33
Alloa,3502,1,21,8,7,85,42,43,71
Airdrieon,3502,2,22,5,9,69,52,17,71
Livingston,3502,3,20,4,12,72,50,22,64
Albion,3502,4,13,11,12,54,44,10,50
Brechin,3502,5,14,8,14,50,55,-5,50
East Fife,3502,6,13,10,13,52,44,8,49
Queen's Park,3502,7,12,8,16,36,54,-18,44
Stranraer,3502,8,12,7,17,50,58,-8,43
Peterhead,3502,9,8,7,21,44,71,-27,31
Stenhousem'r,3502,10,7,8,21,44,86,-42,29
Alloa,3503,1,17,10,9,72,36,36,61
Airdrieon,3503,2,16,11,9,63,52,11,59
Peterhead,3503,3,16,9,11,47,47,0,57
Livingston,3503,4,17,3,16,73,50,23,54
Brechin,3503,5,16,6,14,46,47,-1,54
Queen's Park,3503,6,14,9,13,40,49,-9,51
Albion,3503,7,12,13,11,51,54,-3,49
Stranraer,3503,8,13,5,18,49,58,-9,44
East Fife,3503,9,8,13,15,44,50,-6,37
Stenhousem'r,3503,10,8,7,21,45,87,-42,31
Alloa,3504,1,21,8,7,83,47,36,71
Livingston,3504,2,18,6,12,71,55,16,60
Airdrieon,3504,3,17,7,12,63,56,7,58
Peterhead,3504,4,15,10,11,44,39,5,55
Brechin,3504,5,14,8,14,52,54,-2,50
Queen's Park,3504,6,13,10,13,41,48,-7,49
Stranraer,3504,7,14,3,19,50,64,-14,45
Albion,3504,8,10,11,15,53,59,-6,41
Stenhousem'r,3504,9,9,9,18,46,76,-30,36
East Fife,3504,10,8,10,18,45,50,-5,34
Livingston,3505,1,18,6,12,74,52,22,60
Airdrieon,3505,2,17,7,12,63,54,9,58
Brechin,3505,3,17,7,12,48,44,4,58
Alloa,3505,4,13,15,8,71,51,20,54
East Fife,3505,5,15,8,13,52,40,12,53
Albion,3505,6,13,10,13,50,50,0,49
Stranraer,3505,7,12,7,17,54,64,-10,43
Peterhead,3505,8,10,13,13,44,55,-11,43
Queen's Park,3505,9,12,7,17,42,56,-14,43
Stenhousem'r,3505,10,8,10,18,46,78,-32,34
Livingston,3506,1,23,4,9,80,44,36,73
Brechin,3506,2,21,9,6,59,33,26,72
Alloa,3506,3,17,8,11,66,46,20,59
Albion,3506,4,15,11,10,63,53,10,56
Airdrieon,3506,5,16,7,13,60,60,0,55
Peterhead,3506,6,14,7,15,48,54,-6,49
Stranraer,3506,7,12,7,17,47,63,-16,43
Queen's Park,3506,8,11,7,18,39,53,-14,40
East Fife,3506,9,5,14,17,37,50,-13,29
Stenhousem'r,3506,10,5,8,23,47,90,-43,23
Livingston,3507,1,22,4,10,77,49,28,70
Airdrieon,3507,2,20,5,11,58,38,20,65
Queen's Park,3507,3,16,6,14,43,50,-7,54
Brechin,3507,4,16,5,15,49,52,-3,53
Alloa,3507,5,14,10,12,63,48,15,52
Peterhead,3507,6,11,13,12,38,41,-3,46
Stranraer,3507,7,14,3,19,52,73,-21,45
Albion,3507,8,12,8,16,51,53,-2,44
East Fife,3507,9,11,10,15,50,47,3,43
Stenhousem'r,3507,10,10,4,22,38,68,-30,34
Livingston,3508,1,22,5,9,85,48,37,71
Albion,3508,2,19,8,9,68,50,18,65
Alloa,3508,3,18,9,9,79,57,22,63
Brechin,3508,4,17,7,12,53,50,3,58
Stranraer,3508,5,14,6,16,57,61,-4,48
Airdrieon,3508,6,12,11,13,53,58,-5,47
East Fife,3508,7,12,10,14,49,44,5,46
Peterhead,3508,8,13,7,16,45,49,-4,46
Queen's Park,3508,9,11,7,18,40,65,-25,40
Stenhousem'r,3508,10,3,8,25,43,90,-47,17
Alloa,3509,1,21,7,8,70,44,26,70
Livingston,3509,2,18,7,11,68,49,19,61
Brechin,3509,3,18,6,12,64,50,14,60
Airdrieon,3509,4,14,12,10,62,56,6,54
Peterhead,3509,5,16,5,15,56,54,2,53
Queen's Park,3509,6,13,7,16,37,46,-9,46
Stranraer,3509,7,13,6,17,50,55,-5,45
East Fife,3509,8,11,11,14,47,50,-3,44
Albion,3509,9,10,9,17,45,59,-14,39
Stenhousem'r,3509,10,8,6,22,46,82,-36,30
Livingston,3510,1,23,3,10,76,46,30,72
Airdrieon,3510,2,20,6,10,67,55,12,66
Brechin,3510,3,18,6,12,51,45,6,60
Alloa,3510,4,15,12,9,64,51,13,57
Albion,3510,5,15,8,13,53,51,2,53
Stranraer,3510,6,13,8,15,54,57,-3,47
Queen's Park,3510,7,13,7,16,46,53,-7,46
Peterhead,3510,8,10,11,15,49,58,-9,41
East Fife,3510,9,6,15,15,41,47,-6,33
Stenhousem'r,3510,10,4,10,22,38,76,-38,22
Airdrieon,3511,1,20,10,6,63,50,13,70
Alloa,3511,2,20,8,8,69,39,30,68
Livingston,3511,3,20,3,13,69,50,19,63
Brechin,3511,4,18,6,12,58,46,12,60
Albion,3511,5,17,7,12,61,48,13,58
Queen's Park,3511,6,14,6,16,43,53,-10,48
Peterhead,3511,7,12,5,19,52,60,-8,41
Stranraer,3511,8,9,8,19,39,59,-20,35
Stenhousem'r,3511,9,8,10,18,48,79,-31,34
East Fife,3511,10,6,9,21,45,63,-18,27
East Fife,3512,1,19,6,11,63,46,17,63
Livingston,3512,2,18,8,10,66,44,22,62
Alloa,3512,3,18,6,12,71,51,20,60
Airdrieon,3512,4,18,6,12,60,46,14,60
Albion,3512,5,14,9,13,52,51,1,51
Queen's Park,3512,6,14,7,15,40,53,-13,49
Brechin,3512,7,14,3,19,47,59,-12,45
Peterhead,3512,8,12,6,18,41,53,-12,42
Stenhousem'r,3512,9,9,10,17,51,66,-15,37
Stranraer,3512,10,10,7,19,45,67,-22,37
Livingston,3513,1,20,6,10,75,43,32,66
Alloa,3513,2,18,9,9,72,43,29,63
Albion,3513,3,18,8,10,60,41,19,62
Airdrieon,3513,4,16,10,10,65,54,11,58
Brechin,3513,5,17,5,14,50,53,-3,56
Peterhead,3513,6,12,12,12,54,59,-5,48
East Fife,3513,7,13,7,16,52,55,-3,46
Stranraer,3513,8,11,7,18,54,70,-16,40
Queen's Park,3513,9,9,7,20,34,59,-25,34
Stenhousem'r,3513,10,8,5,23,50,89,-39,29
Alloa,3514,1,21,8,7,78,42,36,71
Brechin,3514,2,17,10,9,48,43,5,61
Livingston,3514,3,17,6,13,57,46,11,57
Peterhead,3514,4,15,7,14,57,48,9,52
Albion,3514,5,13,8,15,47,49,-2,47
East Fife,3514,6,11,13,12,47,43,4,46
Airdrieon,3514,7,11,11,14,45,55,-10,44
Stranraer,3514,8,12,6,18,46,58,-12,42
Queen's Park,3514,9,12,4,20,28,47,-19,40
Stenhousem'r,3514,10,10,9,17,52,74,-22,39
Alloa,3515,1,22,7,7,70,35,35,73
Brechin,3515,2,20,4,12,57,46,11,64
Airdrieon,3515,3,17,11,8,62,49,13,62
Livingston,3515,4,18,6,12,74,52,22,60
Albion,3515,5,13,10,13,51,55,-4,49
Peterhead,3515,6,13,7,16,49,57,-8,46
Stranraer,3515,7,12,7,17,56,59,-3,43
Queen's Park,3515,8,12,5,19,46,58,-12,41
East Fife,3515,9,8,9,19,37,54,-17,33
Stenhousem'r,3515,10,8,8,20,48,85,-37,32
Alloa,3516,1,21,8,7,72,46,26,71
Livingston,3516,2,20,7,9,77,48,29,67
Airdrieon,3516,3,17,7,12,54,51,3,58
Peterhead,3516,4,16,7,13,49,42,7,55
Albion,3516,5,15,5,16,59,58,1,50
East Fife,3516,6,12,8,16,45,50,-5,44
Stranraer,3516,7,12,8,16,43,49,-6,44
Queen's Park,3516,8,11,10,15,41,55,-14,43
Brechin,3516,9,12,5,19,39,52,-13,41
Stenhousem'r,3516,10,8,7,21,51,79,-28,31
Livingston,3517,1,23,3,10,77,42,35,72
Alloa,3517,2,20,6,10,73,44,29,66
Peterhead,3517,3,16,8,12,49,48,1,56
Albion,3517,4,14,10,12,54,47,7,52
Airdrieon,3517,5,14,10,12,60,58,2,52
East Fife,3517,6,13,9,14,55,48,7,48
Brechin,3517,7,13,7,16,45,55,-10,46
Stranraer,3517,8,11,8,17,43,59,-16,41
Queen's Park,3517,9,10,9,17,37,60,-23,39
Stenhousem'r,3517,10,7,8,21,46,78,-32,29
Alloa,3518,1,18,10,8,69,44,25,64
Brechin,3518,2,20,4,12,53,39,14,64
Livingston,3518,3,19,6,11,66,51,15,63
Airdrieon,3518,4,16,7,13,57,56,1,55
Albion,3518,5,14,10,12,48,46,2,52
Queen's Park,3518,6,13,10,13,44,44,0,49
Stranraer,3518,7,14,3,19,49,57,-8,45
East Fife,3518,8,11,8,17,51,59,-8,41
Peterhead,3518,9,9,9,18,46,62,-16,36
Stenhousem'r,3518,10,8,9,19,46,71,-25,33
Livingston,3519,1,19,9,8,71,38,33,66
Brechin,3519,2,17,6,13,50,46,4,57
Albion,3519,3,16,7,13,57,57,0,55
Queen's Park,3519,4,15,9,12,44,47,-3,54
Alloa,3519,5,14,8,14,53,51,2,50
Peterhead,3519,6,12,9,15,50,56,-6,45
Airdrieon,3519,7,12,8,16,51,60,-9,44
East Fife,3519,8,10,13,13,48,44,4,43
Stranraer,3519,9,12,7,17,53,60,-7,43
Stenhousem'r,3519,10,10,10,16,55,73,-18,40
Alloa,3520,1,21,8,7,76,43,33,71
Livingston,3520,2,17,9,10,63,48,15,60
Brechin,3520,3,18,5,13,51,47,4,59
Airdrieon,3520,4,17,6,13,61,57,4,57
Queen's Park,3520,5,16,7,13,37,37,0,55
East Fife,3520,6,13,11,12,47,40,7,50
Albion,3520,7,14,5,17,51,53,-2,47
Peterhead,3520,8,13,8,15,52,59,-7,47
Stranraer,3520,9,9,4,23,41,64,-23,31
Stenhousem'r,3520,10,5,11,20,45,76,-31,26
Brechin,3521,1,18,10,8,52,44,8,64
Alloa,3521,2,16,10,10,69,42,27,58
Airdrieon,3521,3,16,8,12,56,51,5,56
Queen's Park,3521,4,16,7,13,55,47,8,55
Livingston,3521,5,16,6,14,62,49,13,54
Peterhead,3521,6,15,9,12,53,51,2,54
East Fife,3521,7,12,8,16,56,51,5,44
Stenhousem'r,3521,8,11,8,17,44,67,-23,41
Albion,3521,9,11,7,18,40,56,-16,40
Stranraer,3521,10,10,5,21,45,74,-29,35
Brechin,3522,1,20,5,11,59,41,18,65
Livingston,3522,2,17,5,14,69,56,13,56
Alloa,3522,3,16,8,12,62,50,12,56
Stranraer,3522,4,17,4,15,61,61,0,55
Airdrieon,3522,5,16,7,13,58,61,-3,55
Peterhead,3522,6,15,8,13,47,50,-3,53
Albion,3522,7,13,10,13,58,54,4,49
Queen's Park,3522,8,13,8,15,40,46,-6,47
East Fife,3522,9,9,8,19,48,51,-3,35
Stenhousem'r,3522,10,10,5,21,45,77,-32,35
Livingston,3523,1,23,3,10,72,41,31,72
Airdrieon,3523,2,18,9,9,57,44,13,63
Brechin,3523,3,17,10,9,58,43,15,61
Alloa,3523,4,16,8,12,63,49,14,56
Stranraer,3523,5,16,6,14,65,59,6,54
Queen's Park,3523,6,15,6,15,42,50,-8,51
Peterhead,3523,7,12,8,16,53,61,-8,44
Albion,3523,8,10,10,16,53,66,-13,40
East Fife,3523,9,8,12,16,46,58,-12,36
Stenhousem'r,3523,10,5,8,23,37,75,-38,23
Livingston,3524,1,22,5,9,80,40,40,71
Alloa,3524,2,21,8,7,86,52,34,71
Brechin,3524,3,21,2,13,58,52,6,65
Airdrieon,3524,4,18,9,9,68,51,17,63
Queen's Park,3524,5,13,8,15,38,54,-16,47
Peterhead,3524,6,11,12,13,49,50,-1,45
Albion,3524,7,12,9,15,50,52,-2,45
East Fife,3524,8,10,7,19,54,55,-1,37
Stranraer,3524,9,10,7,19,46,65,-19,37
Stenhousem'r,3524,10,5,7,24,45,103,-58,22
Albion,3525,1,21,6,9,76,46,30,69
Livingston,3525,2,21,5,10,78,49,29,68
Alloa,3525,3,16,12,8,72,47,25,60
Brechin,3525,4,16,7,13,43,45,-2,55
Peterhead,3525,5,14,7,15,43,51,-8,49
Airdrieon,3525,6,13,9,14,61,61,0,48
East Fife,3525,7,11,11,14,48,48,0,44
Stranraer,3525,8,12,6,18,48,62,-14,42
Queen's Park,3525,9,12,6,18,33,51,-18,42
Stenhousem'r,3525,10,6,7,23,49,91,-42,25
Livingston,3526,1,23,8,5,89,48,41,77
Alloa,3526,2,18,9,9,63,37,26,63
Stranraer,3526,3,17,3,16,51,52,-1,54
Queen's Park,3526,4,15,7,14,47,52,-5,52
Brechin,3526,5,16,4,16,54,60,-6,52
Airdrieon,3526,6,13,10,13,54,57,-3,49
Albion,3526,7,13,9,14,53,53,0,48
Peterhead,3526,8,12,7,17,44,52,-8,43
East Fife,3526,9,10,5,21,45,57,-12,35
Stenhousem'r,3526,10,9,6,21,51,83,-32,33
Airdrieon,3527,1,20,4,12,58,42,16,64
Livingston,3527,2,19,3,14,71,57,14,60
Albion,3527,3,17,8,11,63,49,14,59
Brechin,3527,4,16,7,13,42,44,-2,55
Alloa,3527,5,15,9,12,63,46,17,54
East Fife,3527,6,15,8,13,58,54,4,53
Peterhead,3527,7,14,9,13,49,45,4,51
Queen's Park,3527,8,13,8,15,50,56,-6,47
Stranraer,3527,9,10,3,23,38,63,-25,33
Stenhousem'r,3527,10,9,5,22,43,79,-36,32
Livingston,3528,1,21,6,9,75,45,30,69
Alloa,3528,2,19,8,9,78,52,26,65
Airdrieon,3528,3,18,5,13,51,50,1,59
Brechin,3528,4,16,7,13,51,50,1,55
Queen's Park,3528,5,14,5,17,43,50,-7,47
Peterhead,3528,6,13,7,16,54,57,-3,46
East Fife,3528,7,11,11,14,46,47,-1,44
Albion,3528,8,11,10,15,43,47,-4,43
Stranraer,3528,9,11,6,19,49,66,-17,39
Stenhousem'r,3528,10,11,5,20,55,81,-26,38
Livingston,3529,1,20,6,10,70,51,19,66
Alloa,3529,2,16,11,9,69,43,26,59
Airdrieon,3529,3,16,9,11,53,44,9,57
Brechin,3529,4,17,2,17,45,48,-3,53
Albion,3529,5,14,10,12,58,49,9,52
Queen's Park,3529,6,14,10,12,42,40,2,52
East Fife,3529,7,12,11,13,41,40,1,47
Peterhead,3529,8,12,8,16,48,57,-9,44
Stenhousem'r,3529,9,10,6,20,44,80,-36,36
Stranraer,3529,10,9,7,20,46,64,-18,34
Livingston,3530,1,17,7,12,72,54,18,58
Alloa,3530,2,15,12,9,65,45,20,57
Brechin,3530,3,18,3,15,51,57,-6,57
Albion,3530,4,16,8,12,65,53,12,56
Airdrieon,3530,5,16,8,12,57,62,-5,56
Peterhead,3530,6,14,12,10,56,45,11,54
Queen's Park,3530,7,12,8,16,40,52,-12,44
Stranraer,3530,8,12,7,17,53,62,-9,43
East Fife,3530,9,12,5,19,46,51,-5,41
Stenhousem'r,3530,10,9,8,19,51,75,-24,35
Livingston,3531,1,24,2,10,78,43,35,74
Alloa,3531,2,19,6,11,75,47,28,63
Peterhead,3531,3,15,8,13,48,45,3,53
Airdrieon,3531,4,13,11,12,52,53,-1,50
Queen's Park,3531,5,13,9,14,44,47,-3,48
Albion,3531,6,11,12,13,52,57,-5,45
Stenhousem'r,3531,7,12,8,16,51,75,-24,44
East Fife,3531,8,11,10,15,53,55,-2,43
Brechin,3531,9,12,6,18,43,59,-16,42
Stranraer,3531,10,10,8,18,38,53,-15,38
Alloa,3532,1,18,9,9,68,44,24,63
Airdrieon,3532,2,18,8,10,67,48,19,62
Brechin,3532,3,19,5,12,55,40,15,62
Livingston,3532,4,18,6,12,72,56,16,60
Albion,3532,5,15,7,14,50,48,2,52
East Fife,3532,6,13,11,12,47,45,2,50
Peterhead,3532,7,12,8,16,43,51,-8,44
Stranraer,3532,8,13,3,20,52,64,-12,42
Stenhousem'r,3532,9,8,11,17,42,77,-35,35
Queen's Park,3532,10,9,6,21,30,53,-23,33
Alloa,3533,1,19,10,7,68,42,26,67
Airdrieon,3533,2,17,9,10,64,52,12,60
Livingston,3533,3,16,9,11,68,58,10,57
Brechin,3533,4,15,6,15,47,43,4,51
Stranraer,3533,5,12,10,14,55,60,-5,46
Queen's Park,3533,6,12,9,15,47,55,-8,45
Peterhead,3533,7,12,9,15,43,52,-9,45
East Fife,3533,8,10,13,13,46,44,2,43
Stenhousem'r,3533,9,12,6,18,63,80,-17,42
Albion,3533,10,10,9,17,47,62,-15,39
Alloa,3534,1,22,5,9,72,48,24,71
Airdrieon,3534,2,21,7,8,63,50,13,70
Livingston,3534,3,17,8,11,77,51,26,59
Brechin,3534,4,14,12,10,47,39,8,54
Peterhead,3534,5,13,10,13,55,53,2,49
Queen's Park,3534,6,14,7,15,36,44,-8,49
Albion,3534,7,11,11,14,53,50,3,44
East Fife,3534,8,10,9,17,47,54,-7,39
Stranraer,3534,9,8,9,19,55,78,-23,33
Stenhousem'r,3534,10,7,8,21,45,83,-38,29
Livingston,3535,1,22,6,8,84,44,40,72
Alloa,3535,2,17,10,9,79,56,23,61
Peterhead,3535,3,17,6,13,59,53,6,57
Brechin,3535,4,17,4,15,59,47,12,55
Airdrieon,3535,5,15,8,13,61,59,2,53
Albion,3535,6,14,8,14,64,61,3,50
East Fife,3535,7,14,6,16,52,54,-2,48
Stranraer,3535,8,12,6,18,48,62,-14,42
Queen's Park,3535,9,10,8,18,38,64,-26,38
Stenhousem'r,3535,10,8,6,22,42,86,-44,30
Brechin,3536,1,19,7,10,51,37,14,64
Alloa,3536,2,18,6,12,71,45,26,60
Queen's Park,3536,3,19,3,14,40,46,-6,60
Livingston,3536,4,19,1,16,67,57,10,58
Peterhead,3536,5,17,7,12,60,52,8,58
Albion,3536,6,16,7,13,54,50,4,55
Airdrieon,3536,7,17,4,15,57,54,3,55
East Fife,3536,8,10,10,16,43,51,-8,40
Stenhousem'r,3536,9,8,8,20,49,74,-25,32
Stranraer,3536,10,8,5,23,42,68,-26,29
Livingston,3537,1,22,4,10,85,49,36,70
Airdrieon,3537,2,16,11,9,57,52,5,59
Alloa,3537,3,15,11,10,58,41,17,56
Brechin,3537,4,17,4,15,48,46,2,55
Queen's Park,3537,5,14,7,15,43,52,-9,49
East Fife,3537,6,13,8,15,52,49,3,47
Stranraer,3537,7,13,6,17,48,56,-8,45
Albion,3537,8,11,11,14,54,48,6,44
Peterhead,3537,9,11,9,16,41,53,-12,42
Stenhousem'r,3537,10,8,9,19,44,84,-40,33
Livingston,3538,1,23,3,10,79,43,36,72
Alloa,3538,2,18,7,11,65,44,21,61
Albion,3538,3,16,9,11,53,42,11,57
Airdrieon,3538,4,17,5,14,65,58,7,56
Peterhead,3538,5,14,11,11,52,52,0,53
Brechin,3538,6,16,5,15,52,53,-1,53
Queen's Park,3538,7,14,8,14,35,45,-10,50
East Fife,3538,8,11,11,14,49,48,1,44
Stranraer,3538,9,13,3,20,54,67,-13,42
Stenhousem'r,3538,10,4,6,26,36,88,-52,18
Alloa,3539,1,20,6,10,73,47,26,66
Livingston,3539,2,20,5,11,78,57,21,65
Airdrieon,3539,3,18,6,12,57,46,11,60
Queen's Park,3539,4,16,6,14,43,48,-5,54
Brechin,3539,5,15,8,13,55,58,-3,53
Peterhead,3539,6,14,7,15,65,58,7,49
Albion,3539,7,13,7,16,49,58,-9,46
Stenhousem'r,3539,8,13,6,17,58,76,-18,45
Stranraer,3539,9,10,7,19,42,57,-15,37
East Fife,3539,10,9,6,21,42,57,-15,33
Alloa,3540,1,23,7,6,79,41,38,76
Livingston,3540,2,23,4,9,86,51,35,73
Airdrieon,3540,3,16,7,13,52,47,5,55
Albion,3540,4,14,9,13,56,55,1,51
Brechin,3540,5,14,8,14,57,55,2,50
East Fife,3540,6,11,11,14,47,47,0,44
Stranraer,3540,7,12,6,18,49,57,-8,42
Peterhead,3540,8,11,7,18,43,62,-19,40
Queen's Park,3540,9,10,8,18,43,64,-21,38
Stenhousem'r,3540,10,9,7,20,47,80,-33,34
Alloa,3541,1,19,8,9,76,48,28,65
Peterhead,3541,2,19,8,9,49,38,11,65
Brechin,3541,3,17,7,12,55,48,7,58
Airdrieon,3541,4,16,9,11,55,46,9,57
Livingston,3541,5,15,10,11,67,55,12,55
Queen's Park,3541,6,14,8,14,47,47,0,50
Albion,3541,7,14,6,16,53,59,-6,48
East Fife,3541,8,12,5,19,54,59,-5,41
Stranraer,3541,9,10,5,21,39,66,-27,35
Stenhousem'r,3541,10,8,6,22,49,78,-29,30
Airdrieon,3542,1,22,5,9,72,58,14,71
Livingston,3542,2,22,3,11,76,44,32,69
Alloa,3542,3,16,8,12,66,44,22,56
Albion,3542,4,16,5,15,50,48,2,53
Brechin,3542,5,16,4,16,57,55,2,52
Peterhead,3542,6,13,9,14,46,57,-11,48
East Fife,3542,7,14,5,17,44,46,-2,47
Stranraer,3542,8,13,5,18,54,60,-6,44
Queen's Park,3542,9,12,7,17,32,45,-13,43
Stenhousem'r,3542,10,7,7,22,35,75,-40,28
Alloa,3543,1,24,5,7,76,46,30,77
Livingston,3543,2,21,4,11,79,48,31,67
Airdrieon,3543,3,18,5,13,60,56,4,59
Brechin,3543,4,18,5,13,46,42,4,59
Peterhead,3543,5,14,10,12,58,54,4,52
Albion,3543,6,12,8,16,55,59,-4,44
Stranraer,3543,7,13,3,20,45,55,-10,42
East Fife,3543,8,11,8,17,52,52,0,41
Queen's Park,3543,9,12,2,22,27,59,-32,38
Stenhousem'r,3543,10,8,8,20,57,84,-27,32
Alloa,3544,1,21,7,8,73,30,43,70
Livingston,3544,2,19,6,11,61,42,19,63
Albion,3544,3,15,11,10,48,40,8,56
Brechin,3544,4,15,9,12,42,37,5,54
Airdrieon,3544,5,15,5,16,55,55,0,50
Peterhead,3544,6,14,7,15,48,57,-9,49
Stranraer,3544,7,12,10,14,55,51,4,46
Queen's Park,3544,8,12,8,16,36,55,-19,44
East Fife,3544,9,10,10,16,47,50,-3,40
Stenhousem'r,3544,10,6,9,21,44,92,-48,27
Livingston,3545,1,21,7,8,76,41,35,70
Alloa,3545,2,16,9,11,66,42,24,57
Airdrieon,3545,3,17,5,14,46,47,-1,56
Stranraer,3545,4,15,6,15,46,47,-1,51
Albion,3545,5,14,8,14,57,49,8,50
East Fife,3545,6,14,8,14,55,48,7,50
Brechin,3545,7,13,8,15,41,50,-9,47
Queen's Park,3545,8,14,5,17,44,62,-18,47
Peterhead,3545,9,11,10,15,39,49,-10,43
Stenhousem'r,3545,10,9,6,21,43,78,-35,33
Livingston,3546,1,21,7,8,70,39,31,70
Alloa,3546,2,17,9,10,76,49,27,60
Airdrieon,3546,3,16,10,10,58,51,7,58
Brechin,3546,4,17,5,14,57,59,-2,56
Queen's Park,3546,5,14,9,13,38,45,-7,51
Stranraer,3546,6,12,9,15,53,57,-4,45
Peterhead,3546,7,11,9,16,39,53,-14,42
Stenhousem'r,3546,8,11,7,18,58,72,-14,40
East Fife,3546,9,10,9,17,52,58,-6,39
Albion,3546,10,10,8,18,40,58,-18,38
Alloa,3547,1,20,7,9,78,46,32,67
Brechin,3547,2,20,5,11,58,41,17,65
Livingston,3547,3,18,5,13,70,56,14,59
Albion,3547,4,14,13,9,56,53,3,55
Airdrieon,3547,5,13,12,11,53,52,1,51
Stranraer,3547,6,13,11,12,50,50,0,50
Peterhead,3547,7,10,10,16,51,64,-13,40
Queen's Park,3547,8,10,10,16,34,52,-18,40
East Fife,3547,9,9,11,16,40,47,-7,38
Stenhousem'r,3547,10,8,6,22,45,74,-29,30
Alloa,3548,1,19,9,8,80,47,33,66
Livingston,3548,2,21,3,12,78,50,28,66
Brechin,3548,3,19,4,13,52,49,3,61
Airdrieon,3548,4,18,6,12,57,52,5,60
Peterhead,3548,5,17,6,13,52,50,2,57
Albion,3548,6,14,9,13,55,60,-5,51
Stranraer,3548,7,13,5,18,51,59,-8,44
Queen's Park,3548,8,12,3,21,39,54,-15,39
Stenhousem'r,3548,9,7,11,18,43,72,-29,32
East Fife,3548,10,6,12,18,42,56,-14,30
Livingston,3549,1,21,4,11,73,45,28,67
Alloa,3549,2,17,9,10,68,52,16,60
Stranraer,3549,3,18,3,15,59,55,4,57
Airdrieon,3549,4,16,9,11,59,56,3,57
Brechin,3549,5,17,6,13,55,53,2,57
East Fife,3549,6,13,10,13,55,46,9,49
Albion,3549,7,11,10,15,57,59,-2,43
Queen's Park,3549,8,12,6,18,38,52,-14,42
Peterhead,3549,9,10,8,18,46,69,-23,38
Stenhousem'r,3549,10,8,9,19,56,79,-23,33
Livingston,3550,1,23,4,9,83,49,34,73
Alloa,3550,2,21,9,6,81,43,38,72
Brechin,3550,3,18,7,11,48,37,11,61
Airdrieon,3550,4,16,8,12,59,56,3,56
Peterhead,3550,5,13,9,14,50,54,-4,48
East Fife,3550,6,13,8,15,61,57,4,47
Albion,3550,7,13,7,16,62,66,-4,46
Stranraer,3550,8,10,6,20,45,69,-24,36
Queen's Park,3550,9,9,8,19,35,60,-25,35
Stenhousem'r,3550,10,8,6,22,53,86,-33,30
Livingston,3551,1,24,4,8,83,48,35,76
Brechin,3551,2,16,11,9,53,42,11,59
Stranraer,3551,3,17,5,14,61,55,6,56
Airdrieon,3551,4,17,5,14,52,63,-11,56
Albion,3551,5,14,10,12,55,48,7,52
Alloa,3551,6,12,10,14,62,47,15,46
Peterhead,3551,7,13,7,16,40,53,-13,46
East Fife,3551,8,12,6,18,51,49,2,42
Queen's Park,3551,9,10,8,18,39,52,-13,38
Stenhousem'r,3551,10,9,6,21,42,81,-39,33
Livingston,3552,1,24,5,7,83,40,43,77
Airdrieon,3552,2,21,7,8,62,44,18,70
Stranraer,3552,3,18,6,12,51,42,9,60
Alloa,3552,4,17,7,12,66,46,20,58
Albion,3552,5,13,8,15,51,60,-9,47
Peterhead,3552,6,12,10,14,42,48,-6,46
Brechin,3552,7,13,7,16,45,55,-10,46
Queen's Park,3552,8,11,9,16,38,52,-14,42
East Fife,3552,9,9,9,18,42,48,-6,36
Stenhousem'r,3552,10,4,8,24,41,86,-45,20
Alloa,3553,1,20,8,8,76,44,32,68
Airdrieon,3553,2,20,7,9,70,58,12,67
Livingston,3553,3,17,7,12,75,62,13,58
Brechin,3553,4,17,7,12,58,48,10,58
Peterhead,3553,5,14,9,13,58,52,6,51
Stranraer,3553,6,14,5,17,54,64,-10,47
Albion,3553,7,11,10,15,52,60,-8,43
East Fife,3553,8,10,9,17,46,54,-8,39
Queen's Park,3553,9,10,7,19,41,62,-21,37
Stenhousem'r,3553,10,7,11,18,56,82,-26,32
Alloa,3554,1,22,7,7,75,38,37,73
Airdrieon,3554,2,21,4,11,66,49,17,67
Brechin,3554,3,17,7,12,55,49,6,58
Livingston,3554,4,16,5,15,70,59,11,53
Queen's Park,3554,5,14,6,16,40,48,-8,48
Peterhead,3554,6,13,7,16,49,58,-9,46
East Fife,3554,7,11,11,14,54,52,2,44
Stranraer,3554,8,12,7,17,51,55,-4,43
Albion,3554,9,10,11,15,47,58,-11,41
Stenhousem'r,3554,10,7,9,20,50,91,-41,30
Livingston,3555,1,24,4,8,69,38,31,76
Albion,3555,2,16,9,11,57,49,8,57
Alloa,3555,3,15,8,13,69,53,16,53
Peterhead,3555,4,14,9,13,53,46,7,51
Airdrieon,3555,5,13,12,11,56,53,3,51
Brechin,3555,6,15,6,15,50,55,-5,51
Stranraer,3555,7,13,11,12,53,51,2,50
Queen's Park,3555,8,11,9,16,40,55,-15,42
East Fife,3555,9,8,10,18,43,53,-10,34
Stenhousem'r,3555,10,6,12,18,47,84,-37,30
Livingston,3556,1,21,5,10,78,46,32,68
Alloa,3556,2,20,5,11,62,38,24,65
Airdrieon,3556,3,16,10,10,62,58,4,58
Albion,3556,4,15,7,14,53,50,3,52
East Fife,3556,5,13,11,12,54,51,3,50
Brechin,3556,6,13,9,14,42,43,-1,48
Stranraer,3556,7,13,8,15,55,58,-3,47
Peterhead,3556,8,12,8,16,50,61,-11,44
Queen's Park,3556,9,12,5,19,32,53,-21,41
Stenhousem'r,3556,10,6,10,20,51,81,-30,28
Livingston,3557,1,23,2,11,80,44,36,71
Alloa,3557,2,20,9,7,74,41,33,69
Peterhead,3557,3,15,6,15,51,53,-2,51
Airdrieon,3557,4,15,5,16,53,60,-7,50
Albion,3557,5,14,7,15,46,51,-5,49
Queen's Park,3557,6,14,6,16,40,43,-3,48
East Fife,3557,7,12,10,14,50,46,4,46
Brechin,3557,8,14,3,19,48,59,-11,45
Stranraer,3557,9,13,5,18,54,66,-12,44
Stenhousem'r,3557,10,11,5,20,57,90,-33,38
Livingston,3558,1,24,3,9,89,46,43,75
Alloa,3558,2,19,8,9,63,41,22,65
Airdrieon,3558,3,20,5,11,64,57,7,65
Brechin,3558,4,18,7,11,54,44,10,61
Albion,3558,5,14,8,14,59,56,3,50
Queen's Park,3558,6,15,4,17,38,49,-11,49
Peterhead,3558,7,12,7,17,44,56,-12,43
East Fife,3558,8,11,9,16,51,51,0,42
Stranraer,3558,9,9,5,22,46,64,-18,32
Stenhousem'r,3558,10,6,8,22,39,83,-44,26
Livingston,3559,1,22,4,10,78,53,25,70
Alloa,3559,2,21,6,9,75,50,25,69
Brechin,3559,3,19,6,11,55,47,8,63
Airdrieon,3559,4,14,9,13,57,55,2,51
Stranraer,3559,5,15,5,16,56,57,-1,50
Peterhead,3559,6,13,9,14,46,52,-6,48
Albion,3559,7,12,10,14,49,48,1,46
East Fife,3559,8,9,11,16,46,50,-4,38
Queen's Park,3559,9,10,7,19,38,55,-17,37
Stenhousem'r,3559,10,6,11,19,49,82,-33,29
Livingston,3560,1,22,5,9,76,42,34,71
Alloa,3560,2,17,8,11,74,52,22,59
Brechin,3560,3,18,5,13,54,52,2,59
Airdrieon,3560,4,16,10,10,54,41,13,58
Peterhead,3560,5,15,7,14,45,52,-7,52
Albion,3560,6,13,10,13,55,53,2,49
East Fife,3560,7,13,6,17,54,58,-4,45
Stranraer,3560,8,13,4,19,52,62,-10,43
Queen's Park,3560,9,10,7,19,34,53,-19,37
Stenhousem'r,3560,10,8,8,20,53,86,-33,32
Airdrieon,3561,1,21,4,11,64,51,13,67
Peterhead,3561,2,20,5,11,56,43,13,65
Alloa,3561,3,18,9,9,67,43,24,63
Livingston,3561,4,18,6,12,69,59,10,60
Brechin,3561,5,13,7,16,46,49,-3,46
Queen's Park,3561,6,13,6,17,39,50,-11,45
Albion,3561,7,12,8,16,49,48,1,44
East Fife,3561,8,10,11,15,53,56,-3,41
Stranraer,3561,9,9,10,17,44,59,-15,37
Stenhousem'r,3561,10,9,8,19,50,79,-29,35
Livingston,3562,1,18,11,7,75,44,31,65
Alloa,3562,2,17,12,7,61,41,20,63
Airdrieon,3562,3,18,5,13,67,50,17,59
Brechin,3562,4,17,7,12,48,41,7,58
Albion,3562,5,12,13,11,51,55,-4,49
Peterhead,3562,6,11,13,12,45,50,-5,46
Queen's Park,3562,7,13,6,17,41,46,-5,45
Stranraer,3562,8,11,7,18,44,60,-16,40
East Fife,3562,9,10,9,17,36,48,-12,39
Stenhousem'r,3562,10,7,9,20,50,83,-33,30
Peterhead,3563,1,20,5,11,60,46,14,65
Queen's Park,3563,2,19,8,9,46,38,8,65
Alloa,3563,3,18,7,11,67,39,28,61
Livingston,3563,4,18,4,14,66,51,15,58
Airdrieon,3563,5,16,9,11,55,46,9,57
Stranraer,3563,6,16,4,16,57,60,-3,52
East Fife,3563,7,9,12,15,49,56,-7,39
Albion,3563,8,10,9,17,51,59,-8,39
Brechin,3563,9,9,8,19,43,65,-22,35
Stenhousem'r,3563,10,8,8,20,47,81,-34,32
Livingston,3564,1,23,3,10,83,46,37,72
Alloa,3564,2,19,6,11,69,43,26,63
Brechin,3564,3,18,7,11,52,39,13,61
Airdrieon,3564,4,16,8,12,61,55,6,56
Albion,3564,5,15,9,12,58,50,8,54
East Fife,3564,6,13,9,14,47,47,0,48
Peterhead,3564,7,13,5,18,46,53,-7,44
Queen's Park,3564,8,11,7,18,34,51,-17,40
Stranraer,3564,9,10,8,18,40,58,-18,38
Stenhousem'r,3564,10,7,8,21,37,85,-48,29
Alloa,3565,1,21,6,9,78,44,34,69
Livingston,3565,2,21,5,10,81,47,34,68
Brechin,3565,3,16,8,12,53,48,5,56
Albion,3565,4,14,11,11,54,48,6,53
Peterhead,3565,5,15,5,16,55,59,-4,50
Airdrieon,3565,6,15,5,16,55,61,-6,50
Queen's Park,3565,7,12,8,16,31,47,-16,44
Stranraer,3565,8,12,5,19,45,56,-11,41
East Fife,3565,9,10,8,18,41,55,-14,38
Stenhousem'r,3565,10,10,7,19,53,81,-28,37
Livingston,3566,1,22,4,10,70,38,32,70
Alloa,3566,2,19,9,8,72,39,33,66
Albion,3566,3,17,8,11,52,44,8,59
Brechin,3566,4,16,6,14,50,48,2,54
Airdrieon,3566,5,16,6,14,52,58,-6,54
Stranraer,3566,6,15,2,19,52,58,-6,47
Peterhead,3566,7,12,9,15,41,54,-13,45
East Fife,3566,8,11,11,14,56,50,6,44
Queen's Park,3566,9,10,12,14,37,54,-17,42
Stenhousem'r,3566,10,5,7,24,38,77,-39,22
Livingston,3567,1,21,6,9,77,51,26,69
Alloa,3567,2,17,12,7,61,35,26,63
Albion,3567,3,16,8,12,58,50,8,56
Airdrieon,3567,4,14,9,13,55,51,4,51
Brechin,3567,5,15,6,15,52,56,-4,51
Peterhead,3567,6,14,9,13,46,54,-8,51
East Fife,3567,7,11,11,14,48,49,-1,44
Queen's Park,3567,8,12,8,16,41,50,-9,44
Stranraer,3567,9,12,7,17,57,64,-7,43
Stenhousem'r,3567,10,6,8,22,41,76,-35,26
Alloa,3568,1,21,6,9,79,42,37,69
Livingston,3568,2,19,4,13,75,53,22,61
Airdrieon,3568,3,17,7,12,56,50,6,58
Brechin,3568,4,17,6,13,54,56,-2,57
Albion,3568,5,15,10,11,55,51,4,55
Queen's Park,3568,6,13,8,15,43,55,-12,47
Stranraer,3568,7,14,4,18,52,61,-9,46
East Fife,3568,8,12,9,15,50,46,4,45
Peterhead,3568,9,11,8,17,50,60,-10,41
Stenhousem'r,3568,10,7,6,23,48,88,-40,27
Alloa,3569,1,18,10,8,63,33,30,64
Airdrieon,3569,2,20,4,12,64,52,12,64
Livingston,3569,3,19,6,11,72,51,21,63
Albion,3569,4,17,9,10,59,44,15,60
Peterhead,3569,5,15,9,12,55,47,8,54
Brechin,3569,6,13,11,12,42,42,0,50
East Fife,3569,7,13,8,15,46,44,2,47
Queen's Park,3569,8,8,10,18,28,60,-32,34
Stranraer,3569,9,8,9,19,42,69,-27,33
Stenhousem'r,3569,10,8,6,22,51,80,-29,30
Alloa,3570,1,22,5,9,70,43,27,71
Airdrieon,3570,2,18,6,12,67,56,11,60
Albion,3570,3,18,4,14,57,47,10,58
Brechin,3570,4,18,4,14,44,36,8,58
Stranraer,3570,5,16,6,14,56,53,3,54
Livingston,3570,6,14,8,14,70,57,13,50
Peterhead,3570,7,11,9,16,52,57,-5,42
Stenhousem'r,3570,8,10,10,16,54,80,-26,40
Queen's Park,3570,9,11,6,19,36,60,-24,39
East Fife,3570,10,8,10,18,44,61,-17,34
Alloa,3571,1,20,8,8,78,40,38,68
Livingston,3571,2,19,7,10,69,39,30,64
Brechin,3571,3,16,10,10,55,45,10,58
Airdrieon,3571,4,16,10,10,56,47,9,58
Albion,3571,5,14,8,14,52,54,-2,50
Stranraer,3571,6,14,6,16,53,58,-5,48
Peterhead,3571,7,12,8,16,52,57,-5,44
East Fife,3571,8,11,10,15,52,51,1,43
Stenhousem'r,3571,9,8,10,18,48,88,-40,34
Queen's Park,3571,10,8,7,21,28,64,-36,31
Alloa,3572,1,23,5,8,93,46,47,74
Livingston,3572,2,23,4,9,87,48,39,73
Airdrieon,3572,3,19,6,11,61,49,12,63
Brechin,3572,4,15,5,16,54,55,-1,50
Peterhead,3572,5,14,7,15,58,57,1,49
Stranraer,3572,6,15,4,17,49,57,-8,49
Albion,3572,7,11,11,14,48,64,-16,44
Queen's Park,3572,8,10,7,19,31,58,-27,37
East Fife,3572,9,9,9,18,46,57,-11,36
Stenhousem'r,3572,10,9,6,21,41,77,-36,33
Alloa,3573,1,20,9,7,73,48,25,69
Livingston,3573,2,17,9,10,68,49,19,60
Albion,3573,3,16,12,8,63,44,19,60
Peterhead,3573,4,15,10,11,62,52,10,55
Airdrieon,3573,5,15,9,12,52,55,-3,54
Brechin,3573,6,13,5,18,46,58,-12,44
East Fife,3573,7,11,9,16,50,50,0,42
Stranraer,3573,8,11,7,18,49,57,-8,40
Queen's Park,3573,9,10,8,18,33,49,-16,38
Stenhousem'r,3573,10,8,10,18,46,80,-34,34
Alloa,3574,1,24,4,8,77,36,41,76
Livingston,3574,2,23,3,10,78,44,34,72
Brechin,3574,3,17,8,11,57,52,5,59
Stranraer,3574,4,18,1,17,50,52,-2,55
Peterhead,3574,5,14,7,15,49,52,-3,49
Airdrieon,3574,6,14,7,15,57,63,-6,49
Albion,3574,7,14,5,17,49,55,-6,47
Queen's Park,3574,8,14,5,17,41,52,-11,47
East Fife,3574,9,11,7,18,45,52,-7,40
Stenhousem'r,3574,10,4,7,25,34,79,-45,19
Alloa,3575,1,19,10,7,66,38,28,67
Livingston,3575,2,20,4,12,72,50,22,64
Airdrieon,3575,3,19,5,12,59,53,6,62
Brechin,3575,4,18,5,13,52,50,2,59
Peterhead,3575,5,14,8,14,54,49,5,50
Albion,3575,6,13,9,14,54,58,-4,48
East Fife,3575,7,13,8,15,61,56,5,47
Stranraer,3575,8,11,9,16,49,55,-6,42
Queen's Park,3575,9,11,6,19,32,46,-14,39
Stenhousem'r,3575,10,7,6,23,52,96,-44,27
Livingston,3576,1,22,5,9,76,41,35,71
Brechin,3576,2,19,7,10,62,45,17,64
Alloa,3576,3,17,9,10,70,49,21,60
Airdrieon,3576,4,15,10,11,54,58,-4,55
Stranraer,3576,5,14,7,15,52,58,-6,49
Albion,3576,6,14,7,15,53,60,-7,49
Peterhead,3576,7,13,6,17,50,56,-6,45
East Fife,3576,8,11,10,15,50,45,5,43
Queen's Park,3576,9,10,7,19,41,57,-16,37
Stenhousem'r,3576,10,6,10,20,51,90,-39,28
Brechin,3577,1,20,4,12,59,42,17,64
Livingston,3577,2,18,7,11,71,55,16,61
Alloa,3577,3,17,6,13,59,43,16,57
Airdrieon,3577,4,16,9,11,65,55,10,57
Peterhead,3577,5,16,8,12,58,50,8,56
Albion,3577,6,16,4,16,54,55,-1,52
Stranraer,3577,7,14,6,16,52,54,-2,48
East Fife,3577,8,11,10,15,53,52,1,43
Queen's Park,3577,9,10,5,21,29,58,-29,35
Stenhousem'r,3577,10,10,5,21,52,88,-36,35
Livingston,3578,1,19,7,10,83,58,25,64
Airdrieon,3578,2,17,6,13,64,66,-2,57
Alloa,3578,3,14,12,10,59,44,15,54
Queen's Park,3578,4,13,13,10,46,49,-3,52
Brechin,3578,5,14,9,13,55,54,1,51
East Fife,3578,6,13,11,12,57,45,12,50
Peterhead,3578,7,12,11,13,51,54,-3,47
Albion,3578,8,13,6,17,53,58,-5,45
Stenhousem'r,3578,9,12,9,15,57,75,-18,45
Stranraer,3578,10,9,4,23,43,65,-22,31
Livingston,3579,1,20,6,10,75,41,34,66
Alloa,3579,2,19,5,12,67,50,17,62
Airdrieon,3579,3,18,7,11,65,55,10,61
Brechin,3579,4,17,4,15,54,56,-2,55
Peterhead,3579,5,12,10,14,55,62,-7,46
Queen's Park,3579,6,13,7,16,37,49,-12,46
Albion,3579,7,12,9,15,55,51,4,45
East Fife,3579,8,11,11,14,49,43,6,44
Stranraer,3579,9,10,9,17,43,65,-22,39
Stenhousem'r,3579,10,9,10,17,51,79,-28,37
Livingston,3580,1,22,3,11,81,56,25,69
Alloa,3580,2,21,4,11,62,41,21,67
Airdrieon,3580,3,18,6,12,63,49,14,60
Peterhead,3580,4,15,9,12,56,45,11,54
Brechin,3580,5,15,7,14,49,55,-6,52
Albion,3580,6,14,5,17,47,54,-7,47
Queen's Park,3580,7,13,7,16,38,50,-12,46
Stranraer,3580,8,14,4,18,46,60,-14,46
East Fife,3580,9,9,10,17,46,50,-4,37
Stenhousem'r,3580,10,7,9,20,42,70,-28,30
Alloa,3581,1,18,6,12,73,48,25,60
Brechin,3581,2,17,8,11,62,48,14,59
Livingston,3581,3,17,5,14,54,52,2,56
Albion,3581,4,14,12,10,62,54,8,54
Stranraer,3581,5,16,6,14,56,56,0,54
Peterhead,3581,6,15,6,15,60,60,0,51
Airdrieon,3581,7,13,9,14,53,57,-4,48
East Fife,3581,8,12,11,13,54,45,9,47
Queen's Park,3581,9,11,8,17,38,55,-17,41
Stenhousem'r,3581,10,7,9,20,37,74,-37,30
Livingston,3582,1,21,7,8,79,51,28,70
Brechin,3582,2,18,5,13,49,43,6,59
Airdrieon,3582,3,16,8,12,66,58,8,56
Alloa,3582,4,15,9,12,59,50,9,54
East Fife,3582,5,14,11,11,54,35,19,53
Stranraer,3582,6,14,9,13,52,60,-8,51
Albion,3582,7,13,11,12,53,53,0,50
Queen's Park,3582,8,11,9,16,33,47,-14,42
Peterhead,3582,9,10,9,17,36,50,-14,39
Stenhousem'r,3582,10,5,8,23,44,78,-34,23
Livingston,3583,1,21,4,11,64,43,21,67
Alloa,3583,2,19,9,8,61,39,22,66
Brechin,3583,3,20,4,12,47,45,2,64
Peterhead,3583,4,17,8,11,57,45,12,59
Airdrieon,3583,5,16,7,13,66,58,8,55
East Fife,3583,6,13,7,16,52,48,4,46
Stranraer,3583,7,13,6,17,46,57,-11,45
Albion,3583,8,9,11,16,47,53,-6,38
Queen's Park,3583,9,10,8,18,38,51,-13,38
Stenhousem'r,3583,10,7,6,23,45,84,-39,27
Alloa,3584,1,22,7,7,85,47,38,73
Airdrieon,3584,2,18,8,10,60,47,13,62
Livingston,3584,3,16,6,14,70,54,16,54
Albion,3584,4,14,12,10,47,42,5,54
Brechin,3584,5,12,11,13,44,46,-2,47
Queen's Park,3584,6,11,12,13,38,41,-3,45
Peterhead,3584,7,11,11,14,45,51,-6,44
Stranraer,3584,8,12,6,18,49,67,-18,42
East Fife,3584,9,9,10,17,41,55,-14,37
Stenhousem'r,3584,10,9,9,18,49,78,-29,36
Livingston,3585,1,27,3,6,92,42,50,84
Alloa,3585,2,18,7,11,69,45,24,61
Brechin,3585,3,18,3,15,51,52,-1,57
Airdrieon,3585,4,14,12,10,65,57,8,54
East Fife,3585,5,13,10,13,47,45,2,49
Peterhead,3585,6,13,8,15,43,47,-4,47
Stranraer,3585,7,12,6,18,47,62,-15,42
Albion,3585,8,9,10,17,46,58,-12,37
Queen's Park,3585,9,10,7,19,35,57,-22,37
Stenhousem'r,3585,10,9,8,19,43,73,-30,35
Alloa,3586,1,23,7,6,82,40,42,76
Livingston,3586,2,20,6,10,70,38,32,66
Airdrieon,3586,3,18,6,12,59,47,12,60
Queen's Park,3586,4,16,6,14,43,43,0,54
Albion,3586,5,16,6,14,55,59,-4,54
Brechin,3586,6,13,9,14,50,53,-3,48
Peterhead,3586,7,12,8,16,51,55,-4,44
Stranraer,3586,8,12,7,17,44,60,-16,43
East Fife,3586,9,7,10,19,35,49,-14,31
Stenhousem'r,3586,10,6,9,21,35,80,-45,27
Alloa,3587,1,20,10,6,85,42,43,70
Livingston,3587,2,18,7,11,70,57,13,61
Airdrieon,3587,3,17,7,12,61,61,0,58
Brechin,3587,4,17,6,13,49,46,3,57
Queen's Park,3587,5,12,10,14,37,52,-15,46
Stranraer,3587,6,13,6,17,57,58,-1,45
Albion,3587,7,12,8,16,43,56,-13,44
East Fife,3587,8,10,12,14,47,46,1,42
Peterhead,3587,9,9,14,13,47,51,-4,41
Stenhousem'r,3587,10,9,6,21,53,80,-27,33
Livingston,3588,1,25,5,6,80,46,34,80
Alloa,3588,2,20,8,8,81,51,30,68
Brechin,3588,3,19,7,10,58,42,16,64
Queen's Park,3588,4,16,9,11,53,46,7,57
Airdrieon,3588,5,14,5,17,50,52,-2,47
Albion,3588,6,14,4,18,53,62,-9,46
Stranraer,3588,7,10,11,15,52,57,-5,41
Peterhead,3588,8,10,8,18,38,58,-20,38
East Fife,3588,9,8,9,19,46,58,-12,33
Stenhousem'r,3588,10,7,8,21,46,85,-39,29
Livingston,3589,1,21,7,8,82,51,31,70
Alloa,3589,2,19,11,6,73,37,36,68
Brechin,3589,3,18,7,11,50,41,9,61
Peterhead,3589,4,17,8,11,58,46,12,59
Airdrieon,3589,5,16,9,11,59,48,11,57
Albion,3589,6,14,9,13,63,54,9,51
Queen's Park,3589,7,11,11,14,35,48,-13,44
Stranraer,3589,8,9,6,21,44,66,-22,33
East Fife,3589,9,7,11,18,43,54,-11,32
Stenhousem'r,3589,10,4,9,23,39,101,-62,21
Airdrieon,3590,1,20,7,9,71,45,26,67
Livingston,3590,2,19,6,11,75,45,30,63
Alloa,3590,3,16,10,10,70,46,24,58
Brechin,3590,4,16,8,12,51,53,-2,56
Albion,3590,5,16,7,13,57,62,-5,55
Queen's Park,3590,6,12,10,14,37,40,-3,46
Peterhead,3590,7,11,10,15,48,58,-10,43
East Fife,3590,8,11,7,18,46,48,-2,40
Stranraer,3590,9,10,8,18,58,70,-12,38
Stenhousem'r,3590,10,10,5,21,43,89,-46,35
Alloa,3591,1,23,5,8,84,46,38,74
Livingston,3591,2,20,4,12,76,50,26,64
Brechin,3591,3,17,5,14,51,53,-2,56
Peterhead,3591,4,15,10,11,54,47,7,55
Airdrieon,3591,5,15,8,13,62,58,4,53
Albion,3591,6,15,6,15,51,52,-1,51
Queen's Park,3591,7,13,4,19,36,51,-15,43
Stranraer,3591,8,11,7,18,43,59,-16,40
Stenhousem'r,3591,9,10,7,19,49,82,-33,37
East Fife,3591,10,9,8,19,41,49,-8,35
Livingston,3592,1,24,4,8,89,45,44,76
Alloa,3592,2,20,8,8,69,38,31,68
Brechin,3592,3,16,6,14,49,53,-4,54
Albion,3592,4,15,8,13,57,51,6,53
Peterhead,3592,5,14,10,12,49,53,-4,52
Queen's Park,3592,6,14,5,17,41,54,-13,47
Airdrieon,3592,7,12,8,16,52,60,-8,44
East Fife,3592,8,9,15,12,49,42,7,42
Stranraer,3592,9,11,8,17,49,60,-11,41
Stenhousem'r,3592,10,7,4,25,40,88,-48,25
Livingston,3593,1,17,10,9,67,46,21,61
Airdrieon,3593,2,18,5,13,57,54,3,59
Alloa,3593,3,17,7,12,66,48,18,58
Queen's Park,3593,4,15,8,13,42,46,-4,53
Albion,3593,5,14,10,12,53,45,8,52
Peterhead,3593,6,14,10,12,48,46,2,52
East Fife,3593,7,13,11,12,47,40,7,50
Brechin,3593,8,13,9,14,38,43,-5,48
Stranraer,3593,9,10,6,20,46,65,-19,36
Stenhousem'r,3593,10,8,6,22,48,79,-31,30
Livingston,3594,1,22,7,7,79,44,35,73
Albion,3594,2,17,10,9,59,38,21,61
Alloa,3594,3,18,6,12,58,49,9,60
Peterhead,3594,4,17,6,13,54,48,6,57
Airdrieon,3594,5,16,7,13,61,61,0,55
Queen's Park,3594,6,13,8,15,36,44,-8,47
East Fife,3594,7,12,9,15,47,49,-2,45
Brechin,3594,8,12,7,17,41,56,-15,43
Stranraer,3594,9,7,11,18,40,53,-13,32
Stenhousem'r,3594,10,7,7,22,41,74,-33,28
Livingston,3595,1,26,2,8,81,41,40,80
Alloa,3595,2,22,7,7,79,44,35,73
Brechin,3595,3,16,5,15,49,54,-5,53
Peterhead,3595,4,15,7,14,45,49,-4,52
Albion,3595,5,12,12,12,57,55,2,48
Airdrieon,3595,6,13,9,14,56,56,0,48
East Fife,3595,7,11,10,15,55,53,2,43
Queen's Park,3595,8,11,7,18,41,64,-23,40
Stranraer,3595,9,9,8,19,51,68,-17,35
Stenhousem'r,3595,10,8,7,21,47,77,-30,31
Alloa,3596,1,20,6,10,65,41,24,66
Livingston,3596,2,21,1,14,70,46,24,64
Brechin,3596,3,19,7,10,60,45,15,64
Airdrieon,3596,4,17,5,14,61,59,2,56
East Fife,3596,5,15,10,11,56,39,17,55
Queen's Park,3596,6,14,9,13,39,42,-3,51
Peterhead,3596,7,13,8,15,49,53,-4,47
Albion,3596,8,13,8,15,45,55,-10,47
Stranraer,3596,9,9,5,22,46,67,-21,32
Stenhousem'r,3596,10,7,5,24,41,85,-44,26
Livingston,3597,1,20,5,11,84,58,26,65
Airdrieon,3597,2,19,4,13,69,57,12,61
Alloa,3597,3,17,9,10,65,48,17,60
Peterhead,3597,4,17,7,12,61,52,9,58
Albion,3597,5,17,7,12,56,50,6,58
Brechin,3597,6,15,6,15,45,46,-1,51
Stranraer,3597,7,12,7,17,61,69,-8,43
East Fife,3597,8,11,8,17,46,48,-2,41
Queen's Park,3597,9,10,8,18,34,57,-23,38
Stenhousem'r,3597,10,7,9,20,44,80,-36,30
Livingston,3598,1,20,4,12,78,53,25,64
Airdrieon,3598,2,18,9,9,54,44,10,63
Alloa,3598,3,18,8,10,77,47,30,62
Brechin,3598,4,15,6,15,56,54,2,51
East Fife,3598,5,14,8,14,56,49,7,50
Peterhead,3598,6,14,8,14,43,46,-3,50
Albion,3598,7,13,9,14,50,57,-7,48
Queen's Park,3598,8,14,6,16,37,50,-13,48
Stranraer,3598,9,11,4,21,42,65,-23,37
Stenhousem'r,3598,10,8,8,20,43,71,-28,32
Albion,3599,1,19,5,12,61,51,10,62
Alloa,3599,2,18,7,11,65,44,21,61
Livingston,3599,3,19,3,14,81,61,20,60
Airdrieon,3599,4,17,6,13,62,58,4,57
Peterhead,3599,5,16,7,13,68,56,12,55
Brechin,3599,6,16,4,16,44,45,-1,52
Stranraer,3599,7,14,5,17,50,61,-11,47
East Fife,3599,8,12,9,15,58,56,2,45
Queen's Park,3599,9,12,8,16,41,53,-12,44
Stenhousem'r,3599,10,8,4,24,44,89,-45,28
Airdrieon,3600,1,21,4,11,65,45,20,67
Alloa,3600,2,17,10,9,67,46,21,61
Brechin,3600,3,18,7,11,63,51,12,61
Livingston,3600,4,18,6,12,65,45,20,60
Peterhead,3600,5,15,12,9,49,43,6,57
East Fife,3600,6,13,9,14,49,39,10,48
Albion,3600,7,11,10,15,51,52,-1,43
Stranraer,3600,8,11,6,19,47,66,-19,39
Queen's Park,3600,9,10,5,21,32,61,-29,35
Stenhousem'r,3600,10,7,9,20,43,83,-40,30
Livingston,3601,1,24,3,9,81,37,44,75
Alloa,3601,2,21,6,9,76,44,32,69
Airdrieon,3601,3,18,9,9,65,59,6,63
Brechin,3601,4,16,7,13,54,55,-1,55
East Fife,3601,5,15,8,13,63,48,15,53
Peterhead,3601,6,13,5,18,47,62,-15,44
Stranraer,3601,7,11,7,18,48,66,-18,40
Albion,3601,8,10,9,17,47,58,-11,39
Queen's Park,3601,9,11,5,20,44,64,-20,38
Stenhousem'r,3601,10,9,5,22,48,80,-32,32
Brechin,3602,1,23,6,7,57,32,25,75
Livingston,3602,2,22,5,9,81,42,39,71
Alloa,3602,3,18,8,10,66,38,28,62
East Fife,3602,4,13,10,13,50,42,8,49
Airdrieon,3602,5,15,4,17,59,66,-7,49
Albion,3602,6,14,6,16,52,48,4,48
Peterhead,3602,7,11,11,14,46,57,-11,44
Queen's Park,3602,8,12,5,19,32,60,-28,41
Stranraer,3602,9,10,5,21,44,66,-22,35
Stenhousem'r,3602,10,8,8,20,45,81,-36,32
Alloa,3603,1,17,9,10,62,42,20,60
Livingston,3603,2,17,8,11,69,46,23,59
Brechin,3603,3,16,9,11,52,46,6,57
Peterhead,3603,4,16,8,12,58,44,14,56
Airdrieon,3603,5,16,8,12,54,58,-4,56
Queen's Park,3603,6,13,9,14,42,45,-3,48
Albion,3603,7,13,8,15,59,58,1,47
Stranraer,3603,8,10,10,16,46,62,-16,40
Stenhousem'r,3603,9,11,5,20,46,79,-33,38
East Fife,3603,10,9,10,17,44,52,-8,37
Alloa,3604,1,19,10,7,75,44,31,67
Brechin,3604,2,17,7,12,58,51,7,58
Airdrieon,3604,3,16,9,11,69,52,17,57
Livingston,3604,4,16,9,11,73,58,15,57
Peterhead,3604,5,15,8,13,40,51,-11,53
Albion,3604,6,13,9,14,55,49,6,48
Stranraer,3604,7,12,7,17,53,66,-13,43
Stenhousem'r,3604,8,11,7,18,52,70,-18,40
East Fife,3604,9,9,10,17,43,53,-10,37
Queen's Park,3604,10,9,10,17,32,56,-24,37
Alloa,3605,1,21,8,7,72,45,27,71
Livingston,3605,2,18,8,10,70,49,21,62
Airdrieon,3605,3,18,7,11,63,53,10,61
Brechin,3605,4,14,7,15,49,50,-1,49
Queen's Park,3605,5,14,6,16,30,40,-10,48
East Fife,3605,6,11,12,13,47,48,-1,45
Stranraer,3605,7,12,8,16,55,62,-7,44
Albion,3605,8,11,10,15,42,48,-6,43
Peterhead,3605,9,12,7,17,51,59,-8,43
Stenhousem'r,3605,10,9,7,20,43,68,-25,34
Alloa,3606,1,22,6,8,72,37,35,72
Brechin,3606,2,19,8,9,60,41,19,65
Livingston,3606,3,17,7,12,76,54,22,58
Queen's Park,3606,4,17,6,13,44,47,-3,57
Airdrieon,3606,5,16,8,12,61,57,4,56
Albion,3606,6,14,6,16,62,60,2,48
Peterhead,3606,7,10,11,15,41,56,-15,41
Stranraer,3606,8,11,6,19,36,58,-22,39
East Fife,3606,9,9,10,17,50,60,-10,37
Stenhousem'r,3606,10,6,10,20,46,78,-32,28
Alloa,3607,1,22,8,6,75,38,37,74
Airdrieon,3607,2,21,7,8,69,47,22,70
Brechin,3607,3,20,5,11,57,44,13,65
Livingston,3607,4,18,8,10,78,51,27,62
East Fife,3607,5,14,7,15,49,45,4,49
Albion,3607,6,12,8,16,58,62,-4,44
Stranraer,3607,7,10,9,17,44,53,-9,39
Queen's Park,3607,8,10,9,17,31,53,-22,39
Peterhead,3607,9,7,9,20,40,68,-28,30
Stenhousem'r,3607,10,7,8,21,47,87,-40,29
Livingston,3608,1,18,9,9,78,48,30,63
Alloa,3608,2,17,11,8,74,45,29,62
Airdrieon,3608,3,18,8,10,58,42,16,62
East Fife,3608,4,14,10,12,54,43,11,52
Stranraer,3608,5,15,6,15,51,51,0,51
Queen's Park,3608,6,14,8,14,39,47,-8,50
Brechin,3608,7,14,4,18,45,58,-13,46
Albion,3608,8,12,8,16,50,60,-10,44
Peterhead,3608,9,13,5,18,52,64,-12,44
Stenhousem'r,3608,10,8,5,23,43,86,-43,29
Livingston,3609,1,22,2,12,80,46,34,68
Alloa,3609,2,19,6,11,68,41,27,63
Brechin,3609,3,18,5,13,63,56,7,59
Peterhead,3609,4,17,7,12,55,50,5,58
Albion,3609,5,16,5,15,52,50,2,53
Airdrieon,3609,6,15,7,14,54,54,0,52
Queen's Park,3609,7,13,7,16,39,54,-15,46
East Fife,3609,8,9,13,14,44,45,-1,40
Stranraer,3609,9,11,7,18,46,62,-16,40
Stenhousem'r,3609,10,7,7,22,43,86,-43,28
Airdrieon,3610,1,18,7,11,60,50,10,61
Alloa,3610,2,16,11,9,68,49,19,59
Brechin,3610,3,19,2,15,52,47,5,59
Livingston,3610,4,17,7,12,73,54,19,58
Peterhead,3610,5,16,9,11,46,42,4,57
Albion,3610,6,15,9,12,58,50,8,54
East Fife,3610,7,13,7,16,51,53,-2,46
Queen's Park,3610,8,12,9,15,41,54,-13,45
Stranraer,3610,9,12,8,16,56,60,-4,44
Stenhousem'r,3610,10,5,5,26,49,95,-46,20
Alloa,3611,1,17,9,10,69,40,29,60
Peterhead,3611,2,16,9,11,52,42,10,57
Airdrieon,3611,3,15,11,10,55,53,2,56
Queen's Park,3611,4,15,8,13,40,40,0,53
Livingston,3611,5,15,4,17,69,59,10,49
Albion,3611,6,13,9,14,46,52,-6,48
East Fife,3611,7,12,8,16,53,49,4,44
Stranraer,3611,8,13,5,18,42,54,-12,44
Stenhousem'r,3611,9,11,11,14,48,73,-25,44
Brechin,3611,10,11,10,15,43,55,-12,43
Alloa,3612,1,21,5,10,76,47,29,68
Livingston,3612,2,18,5,13,78,60,18,59
Airdrieon,3612,3,17,7,12,57,49,8,58
Brechin,3612,4,16,7,13,51,50,1,55
Peterhead,3612,5,16,6,14,53,50,3,54
Albion,3612,6,13,10,13,47,50,-3,49
Queen's Park,3612,7,13,9,14,47,55,-8,48
East Fife,3612,8,10,11,15,45,49,-4,41
Stranraer,3612,9,10,7,19,49,69,-20,37
Stenhousem'r,3612,10,8,9,19,48,72,-24,33
Livingston,3613,1,23,5,8,87,43,44,74
Airdrieon,3613,2,21,5,10,74,53,21,68
Alloa,3613,3,19,7,10,80,49,31,64
Albion,3613,4,17,8,11,60,51,9,59
Brechin,3613,5,15,10,11,45,40,5,55
East Fife,3613,6,15,8,13,49,45,4,53
Peterhead,3613,7,9,12,15,51,60,-9,39
Queen's Park,3613,8,10,7,19,33,58,-25,37
Stranraer,3613,9,8,5,23,45,82,-37,29
Stenhousem'r,3613,10,6,7,23,47,90,-43,25
Livingston,3614,1,25,1,10,78,39,39,76
Brechin,3614,2,17,10,9,53,39,14,61
Alloa,3614,3,16,8,12,69,54,15,56
Peterhead,3614,4,16,7,13,56,43,13,55
Stranraer,3614,5,15,6,15,57,65,-8,51
Airdrieon,3614,6,14,7,15,57,56,1,49
Albion,3614,7,13,8,15,42,55,-13,47
East Fife,3614,8,9,14,13,46,45,1,41
Stenhousem'r,3614,9,9,10,17,48,75,-27,37
Queen's Park,3614,10,8,5,23,27,62,-35,29
Livingston,3615,1,18,7,11,73,59,14,61
Queen's Park,3615,2,17,9,10,45,44,1,60
Airdrieon,3615,3,16,9,11,61,43,18,57
East Fife,3615,4,14,8,14,60,54,6,50
Brechin,3615,5,14,8,14,54,56,-2,50
Albion,3615,6,14,7,15,53,55,-2,49
Alloa,3615,7,13,9,14,66,54,12,48
Stranraer,3615,8,13,8,15,55,60,-5,47
Peterhead,3615,9,12,10,14,55,57,-2,46
Stenhousem'r,3615,10,6,11,19,48,88,-40,29
Airdrieon,3616,1,22,6,8,64,47,17,72
Alloa,3616,2,17,9,10,72,50,22,60
Livingston,3616,3,19,1,16,68,56,12,58
Brechin,3616,4,17,3,16,46,44,2,54
Peterhead,3616,5,14,9,13,54,54,0,51
Queen's Park,3616,6,15,6,15,38,47,-9,51
East Fife,3616,7,12,11,13,50,52,-2,47
Stranraer,3616,8,13,3,20,52,60,-8,42
Albion,3616,9,12,5,19,54,65,-11,41
Stenhousem'r,3616,10,10,5,21,55,78,-23,35
Airdrieon,3617,1,23,9,4,70,38,32,78
Livingston,3617,2,20,5,11,71,47,24,65
Alloa,3617,3,18,7,11,71,44,27,61
Peterhead,3617,4,13,13,10,49,45,4,52
East Fife,3617,5,12,12,12,56,48,8,48
Albion,3617,6,13,8,15,51,55,-4,47
Brechin,3617,7,13,7,16,48,55,-7,46
Stranraer,3617,8,12,5,19,42,58,-16,41
Queen's Park,3617,9,10,7,19,31,57,-26,37
Stenhousem'r,3617,10,6,7,23,46,88,-42,25
Livingston,3618,1,19,7,10,79,45,34,64
Alloa,3618,2,17,8,11,63,52,11,59
Queen's Park,3618,3,17,8,11,45,40,5,59
Airdrieon,3618,4,17,5,14,54,50,4,56
Albion,3618,5,13,11,12,55,53,2,50
Brechin,3618,6,14,6,16,47,53,-6,48
Peterhead,3618,7,13,8,15,37,47,-10,47
Stranraer,3618,8,14,4,18,54,57,-3,46
East Fife,3618,9,10,9,17,52,60,-8,39
Stenhousem'r,3618,10,6,14,16,43,72,-29,32
Livingston,3619,1,20,5,11,80,49,31,65
Alloa,3619,2,19,8,9,66,44,22,65
Airdrieon,3619,3,19,5,12,67,57,10,62
Brechin,3619,4,16,7,13,48,49,-1,55
Queen's Park,3619,5,17,4,15,42,49,-7,55
East Fife,3619,6,14,7,15,51,44,7,49
Albion,3619,7,13,6,17,52,54,-2,45
Peterhead,3619,8,11,9,16,48,58,-10,42
Stranraer,3619,9,8,10,18,49,65,-16,34
Stenhousem'r,3619,10,9,7,20,49,83,-34,34
Alloa,3620,1,18,11,7,71,41,30,65
Livingston,3620,2,18,7,11,76,51,25,61
Stranraer,3620,3,17,5,14,57,54,3,56
East Fife,3620,4,15,10,11,56,45,11,55
Albion,3620,5,14,10,12,51,53,-2,52
Airdrieon,3620,6,14,7,15,60,62,-2,49
Brechin,3620,7,12,9,15,48,56,-8,45
Peterhead,3620,8,11,9,16,50,60,-10,42
Queen's Park,3620,9,11,8,17,37,56,-19,41
Stenhousem'r,3620,10,8,8,20,47,75,-28,32
Livingston,3621,1,23,4,9,83,54,29,73
Airdrieon,3621,2,20,6,10,57,43,14,66
Alloa,3621,3,18,9,9,74,45,29,63
Peterhead,3621,4,14,11,11,51,44,7,53
Albion,3621,5,14,9,13,55,51,4,51
Queen's Park,3621,6,13,6,17,45,50,-5,45
Brechin,3621,7,11,8,17,43,69,-26,41
East Fife,3621,8,10,10,16,51,52,-1,40
Stranraer,3621,9,10,9,17,42,55,-13,39
Stenhousem'r,3621,10,6,10,20,43,81,-38,28
Livingston,3622,1,21,4,11,70,44,26,67
Albion,3622,2,16,10,10,57,42,15,58
Airdrieon,3622,3,18,4,14,58,52,6,58
Alloa,3622,4,16,9,11,70,51,19,57
Brechin,3622,5,16,8,12,53,51,2,56
East Fife,3622,6,13,11,12,47,47,0,50
Queen's Park,3622,7,15,5,16,42,51,-9,50
Peterhead,3622,8,11,7,18,44,54,-10,40
Stranraer,3622,9,12,4,20,54,70,-16,40
Stenhousem'r,3622,10,8,6,22,48,81,-33,30
Livingston,3623,1,23,4,9,73,41,32,73
Alloa,3623,2,17,11,8,64,38,26,62
Peterhead,3623,3,17,6,13,61,55,6,57
East Fife,3623,4,14,9,13,50,45,5,51
Airdrieon,3623,5,15,6,15,54,59,-5,51
Brechin,3623,6,14,6,16,52,55,-3,48
Queen's Park,3623,7,14,5,17,48,57,-9,47
Stranraer,3623,8,12,7,17,53,60,-7,43
Albion,3623,9,11,9,16,48,56,-8,42
Stenhousem'r,3623,10,8,7,21,40,77,-37,31
Alloa,3624,1,23,7,6,78,36,42,76
Livingston,3624,2,19,8,9,76,50,26,65
Brechin,3624,3,17,6,13,47,47,0,57
Peterhead,3624,4,16,8,12,52,44,8,56
Airdrieon,3624,5,14,8,14,55,59,-4,50
Albion,3624,6,14,7,15,55,50,5,49
Stenhousem'r,3624,7,12,7,17,56,75,-19,43
Stranraer,3624,8,10,7,19,44,64,-20,37
Queen's Park,3624,9,10,6,20,35,60,-25,36
East Fife,3624,10,8,10,18,44,57,-13,34
Livingston,3625,1,23,3,10,79,53,26,72
Alloa,3625,2,21,5,10,69,40,29,68
Airdrieon,3625,3,17,7,12,64,57,7,58
Brechin,3625,4,16,9,11,49,42,7,57
Peterhead,3625,5,14,6,16,50,60,-10,48
Queen's Park,3625,6,14,5,17,40,52,-12,47
Albion,3625,7,12,9,15,50,55,-5,45
East Fife,3625,8,11,8,17,48,54,-6,41
Stranraer,3625,9,11,8,17,47,57,-10,41
Stenhousem'r,3625,10,8,6,22,45,71,-26,30
Brechin,3626,1,20,5,11,61,47,14,65
Livingston,3626,2,17,11,8,73,48,25,62
Alloa,3626,3,16,9,11,63,48,15,57
Stranraer,3626,4,16,4,16,53,62,-9,52
Queen's Park,3626,5,14,9,13,44,48,-4,51
Albion,3626,6,13,9,14,51,52,-1,48
Peterhead,3626,7,11,12,13,50,52,-2,45
Airdrieon,3626,8,13,6,17,55,59,-4,45
East Fife,3626,9,11,11,14,43,45,-2,44
Stenhousem'r,3626,10,6,10,20,42,74,-32,28
Livingston,3627,1,21,5,10,78,50,28,68
Alloa,3627,2,20,6,10,76,50,26,66
East Fife,3627,3,17,9,10,63,43,20,60
Stranraer,3627,4,15,6,15,68,59,9,51
Peterhead,3627,5,14,9,13,46,58,-12,51
Queen's Park,3627,6,14,7,15,44,49,-5,49
Albion,3627,7,13,8,15,44,51,-7,47
Airdrieon,3627,8,13,5,18,53,63,-10,44
Brechin,3627,9,13,4,19,45,57,-12,43
Stenhousem'r,3627,10,7,7,22,43,80,-37,28
Alloa,3628,1,21,8,7,61,31,30,71
Airdrieon,3628,2,21,2,13,61,50,11,65
Livingston,3628,3,19,7,10,69,46,23,64
Albion,3628,4,13,12,11,54,45,9,51
Peterhead,3628,5,15,4,17,51,62,-11,49
East Fife,3628,6,13,9,14,56,54,2,48
Brechin,3628,7,14,6,16,47,53,-6,48
Queen's Park,3628,8,14,6,16,37,49,-12,48
Stranraer,3628,9,11,5,20,49,60,-11,38
Stenhousem'r,3628,10,7,5,24,50,85,-35,26
Alloa,3629,1,22,8,6,71,42,29,74
Brechin,3629,2,20,5,11,57,48,9,65
Livingston,3629,3,18,9,9,82,52,30,63
Airdrieon,3629,4,18,5,13,58,56,2,59
Albion,3629,5,15,6,15,46,46,0,51
Peterhead,3629,6,12,8,16,53,61,-8,44
East Fife,3629,7,11,10,15,47,41,6,43
Queen's Park,3629,8,10,10,16,33,52,-19,40
Stranraer,3629,9,10,9,17,48,61,-13,39
Stenhousem'r,3629,10,5,8,23,40,76,-36,23
Livingston,3630,1,24,5,7,80,39,41,77
Alloa,3630,2,22,9,5,80,40,40,75
Brechin,3630,3,16,7,13,52,44,8,55
Airdrieon,3630,4,15,8,13,55,58,-3,53
Albion,3630,5,12,12,12,51,48,3,48
East Fife,3630,6,13,9,14,46,43,3,48
Peterhead,3630,7,11,6,19,47,66,-19,39
Stranraer,3630,8,12,2,22,50,68,-18,38
Queen's Park,3630,9,9,9,18,39,62,-23,36
Stenhousem'r,3630,10,8,9,19,47,79,-32,33
Airdrieon,3631,1,20,6,10,60,46,14,66
Alloa,3631,2,19,8,9,71,46,25,65
Livingston,3631,3,18,6,12,79,54,25,60
Albion,3631,4,13,12,11,57,53,4,51
Brechin,3631,5,15,5,16,54,54,0,50
Stranraer,3631,6,13,8,15,52,60,-8,47
Peterhead,3631,7,12,10,14,39,46,-7,46
Queen's Park,3631,8,12,9,15,38,49,-11,45
East Fife,3631,9,9,12,15,38,45,-7,39
Stenhousem'r,3631,10,6,10,20,45,80,-35,28
Alloa,3632,1,20,9,7,76,43,33,69
Livingston,3632,2,21,6,9,74,44,30,69
Airdrieon,3632,3,17,9,10,65,50,15,60
East Fife,3632,4,13,12,11,55,42,13,51
Peterhead,3632,5,11,14,11,57,61,-4,47
Albion,3632,6,12,9,15,47,54,-7,45
Brechin,3632,7,12,5,19,40,56,-16,41
Stenhousem'r,3632,8,11,8,17,46,67,-21,41
Stranraer,3632,9,10,10,16,47,57,-10,40
Queen's Park,3632,10,10,4,22,32,65,-33,34
Alloa,3633,1,18,8,10,71,41,30,62
Stranraer,3633,2,18,4,14,58,48,10,58
Airdrieon,3633,3,17,7,12,52,48,4,58
Livingston,3633,4,16,6,14,63,52,11,54
Brechin,3633,5,15,7,14,53,44,9,52
Albion,3633,6,13,10,13,45,46,-1,49
Peterhead,3633,7,13,10,13,49,57,-8,49
Queen's Park,3633,8,11,10,15,42,60,-18,43
East Fife,3633,9,10,12,14,46,51,-5,42
Stenhousem'r,3633,10,8,8,20,50,82,-32,32
Livingston,3634,1,20,7,9,78,55,23,67
Peterhead,3634,2,18,8,10,51,37,14,62
Albion,3634,3,17,7,12,63,50,13,58
Airdrieon,3634,4,17,7,12,63,52,11,58
Alloa,3634,5,15,10,11,63,49,14,55
East Fife,3634,6,14,10,12,54,43,11,52
Stranraer,3634,7,15,4,17,60,57,3,49
Brechin,3634,8,13,6,17,47,63,-16,45
Queen's Park,3634,9,10,7,19,41,65,-24,37
Stenhousem'r,3634,10,5,6,25,43,92,-49,21
Livingston,3635,1,21,6,9,75,51,24,69
Brechin,3635,2,17,7,12,52,46,6,58
Alloa,3635,3,15,11,10,70,52,18,56
Queen's Park,3635,4,16,8,12,50,46,4,56
Airdrieon,3635,5,14,9,13,49,56,-7,51
Stranraer,3635,6,13,8,15,59,59,0,47
Peterhead,3635,7,13,7,16,47,51,-4,46
East Fife,3635,8,11,9,16,50,51,-1,42
Albion,3635,9,12,5,19,48,62,-14,41
Stenhousem'r,3635,10,8,10,18,51,77,-26,34
Brechin,3636,1,21,7,8,61,43,18,70
Airdrieon,3636,2,19,6,11,59,47,12,63
Alloa,3636,3,16,7,13,63,48,15,55
Livingston,3636,4,16,6,14,69,58,11,54
Peterhead,3636,5,15,8,13,60,53,7,53
Albion,3636,6,14,9,13,52,47,5,51
East Fife,3636,7,12,10,14,52,47,5,46
Queen's Park,3636,8,10,10,16,37,56,-19,40
Stranraer,3636,9,9,9,18,50,71,-21,36
Stenhousem'r,3636,10,8,8,20,48,81,-33,32
Livingston,3637,1,20,6,10,77,52,25,66
Alloa,3637,2,17,12,7,71,42,29,63
Brechin,3637,3,16,10,10,53,50,3,58
East Fife,3637,4,14,8,14,53,49,4,50
Airdrieon,3637,5,14,8,14,57,61,-4,50
Stranraer,3637,6,14,7,15,49,52,-3,49
Albion,3637,7,13,6,17,56,58,-2,45
Peterhead,3637,8,12,7,17,41,49,-8,43
Queen's Park,3637,9,11,10,15,38,52,-14,43
Stenhousem'r,3637,10,8,8,20,53,83,-30,32
Livingston,3638,1,21,5,10,77,45,32,68
Airdrieon,3638,2,20,7,9,70,51,19,67
Alloa,3638,3,18,8,10,73,46,27,62
Stranraer,3638,4,17,3,16,65,63,2,54
Brechin,3638,5,15,6,15,39,48,-9,51
Albion,3638,6,13,10,13,60,62,-2,49
East Fife,3638,7,11,10,15,58,56,2,43
Peterhead,3638,8,12,7,17,59,69,-10,43
Queen's Park,3638,9,9,8,19,32,60,-28,35
Stenhousem'r,3638,10,8,8,20,55,88,-33,32
Alloa,3639,1,21,7,8,76,41,35,70
Livingston,3639,2,19,8,9,81,52,29,65
Airdrieon,3639,3,16,10,10,59,51,8,58
Peterhead,3639,4,16,7,13,50,52,-2,55
Stranraer,3639,5,14,8,14,52,48,4,50
Albion,3639,6,14,7,15,54,51,3,49
Queen's Park,3639,7,12,9,15,39,55,-16,45
East Fife,3639,8,11,10,15,53,50,3,43
Brechin,3639,9,11,5,20,36,60,-24,38
Stenhousem'r,3639,10,8,5,23,41,81,-40,29
Livingston,3640,1,21,6,9,82,47,35,69
Airdrieon,3640,2,17,6,13,61,56,5,57
Alloa,3640,3,16,8,12,64,51,13,56
Albion,3640,4,15,10,11,59,54,5,55
Peterhead,3640,5,15,10,11,48,48,0,55
Brechin,3640,6,16,6,14,56,49,7,54
Stranraer,3640,7,12,7,17,49,60,-11,43
East Fife,3640,8,9,13,14,51,54,-3,40
Queen's Park,3640,9,10,9,17,33,54,-21,39
Stenhousem'r,3640,10,8,7,21,40,70,-30,31
Alloa,3641,1,22,6,8,73,38,35,72
Livingston,3641,2,19,6,11,66,48,18,63
Airdrieon,3641,3,19,5,12,57,47,10,62
Brechin,3641,4,18,8,10,56,50,6,62
Albion,3641,5,12,14,10,53,51,2,50
Peterhead,3641,6,13,8,15,54,55,-1,47
Stranraer,3641,7,12,5,19,53,63,-10,41
Queen's Park,3641,8,10,9,17,34,49,-15,39
East Fife,3641,9,9,11,16,45,54,-9,38
Stenhousem'r,3641,10,6,8,22,48,84,-36,26
Alloa,3642,1,20,8,8,74,43,31,68
Livingston,3642,2,20,6,10,74,51,23,66
Brechin,3642,3,17,9,10,51,43,8,60
Albion,3642,4,16,9,11,54,48,6,57
Airdrieon,3642,5,16,6,14,56,48,8,54
Peterhead,3642,6,14,8,14,50,48,2,50
Queen's Park,3642,7,12,10,14,40,48,-8,46
East Fife,3642,8,11,9,16,52,53,-1,42
Stranraer,3642,9,10,6,20,50,76,-26,36
Stenhousem'r,3642,10,3,11,22,40,83,-43,20
Alloa,3643,1,21,7,8,76,41,35,70
Livingston,3643,2,21,4,11,74,50,24,67
Brechin,3643,3,16,5,15,48,48,0,53
Stranraer,3643,4,15,6,15,59,68,-9,51
Albion,3643,5,15,5,16,65,59,6,50
Peterhead,3643,6,13,10,13,56,56,0,49
Queen's Park,3643,7,15,4,17,41,49,-8,49
Airdrieon,3643,8,12,10,14,54,58,-4,46
East Fife,3643,9,10,7,19,44,56,-12,37
Stenhousem'r,3643,10,10,6,20,47,79,-32,36
Alloa,3644,1,19,11,6,78,41,37,68
Livingston,3644,2,21,5,10,71,40,31,68
Albion,3644,3,15,10,11,51,49,2,55
Brechin,3644,4,16,6,14,52,52,0,54
Airdrieon,3644,5,14,9,13,54,52,2,51
Peterhead,3644,6,13,12,11,49,52,-3,51
Queen's Park,3644,7,13,7,16,37,50,-13,46
East Fife,3644,8,8,12,16,43,52,-9,36
Stranraer,3644,9,9,9,18,51,64,-13,36
Stenhousem'r,3644,10,7,9,20,42,76,-34,30
Brechin,3645,1,19,7,10,53,44,9,64
Livingston,3645,2,19,5,12,79,54,25,62
Airdrieon,3645,3,17,8,11,55,51,4,59
Alloa,3645,4,14,10,12,67,53,14,52
East Fife,3645,5,15,7,14,55,48,7,52
Albion,3645,6,15,7,14,58,52,6,52
Queen's Park,3645,7,13,6,17,38,52,-14,45
Stranraer,3645,8,13,5,18,47,61,-14,44
Peterhead,3645,9,10,8,18,44,59,-15,38
Stenhousem'r,3645,10,9,9,18,54,76,-22,36
Alloa,3646,1,21,6,9,72,42,30,69
Livingston,3646,2,20,5,11,72,45,27,65
Brechin,3646,3,20,5,11,51,42,9,65
Airdrieon,3646,4,15,10,11,54,49,5,55
Peterhead,3646,5,15,6,15,42,43,-1,51
Albion,3646,6,13,10,13,57,58,-1,49
Queen's Park,3646,7,13,6,17,37,56,-19,45
East Fife,3646,8,11,8,17,41,45,-4,41
Stranraer,3646,9,9,8,19,46,62,-16,35
Stenhousem'r,3646,10,7,8,21,38,68,-30,29
Livingston,3647,1,20,5,11,73,47,26,65
Alloa,3647,2,17,12,7,77,50,27,63
Brechin,3647,3,16,5,15,53,53,0,53
Queen's Park,3647,4,15,8,13,43,46,-3,53
Airdrieon,3647,5,16,4,16,59,58,1,52
Peterhead,3647,6,14,7,15,46,49,-3,49
East Fife,3647,7,12,12,12,52,49,3,48
Albion,3647,8,13,7,16,49,56,-7,46
Stranraer,3647,9,11,8,17,50,63,-13,41
Stenhousem'r,3647,10,9,6,21,47,78,-31,33
Livingston,3648,1,18,9,9,81,50,31,63
Alloa,3648,2,18,8,10,67,45,22,62
Airdrieon,3648,3,16,12,8,65,57,8,60
Brechin,3648,4,17,6,13,52,48,4,57
Queen's Park,3648,5,14,9,13,44,43,1,51
Peterhead,3648,6,11,10,15,57,66,-9,43
Stranraer,3648,7,12,7,17,53,76,-23,43
Albion,3648,8,11,9,16,55,56,-1,42
East Fife,3648,9,12,6,18,52,56,-4,42
Stenhousem'r,3648,10,7,12,17,51,80,-29,33
Livingston,3649,1,19,5,12,75,50,25,62
Alloa,3649,2,17,8,11,59,42,17,59
Stranraer,3649,3,17,4,15,57,51,6,55
Albion,3649,4,15,8,13,58,47,11,53
Peterhead,3649,5,15,8,13,50,53,-3,53
Brechin,3649,6,15,3,18,49,53,-4,48
Airdrieon,3649,7,13,8,15,50,56,-6,47
Queen's Park,3649,8,13,8,15,36,47,-11,47
East Fife,3649,9,11,8,17,52,57,-5,41
Stenhousem'r,3649,10,11,8,17,45,75,-30,41
Alloa,3650,1,22,7,7,69,38,31,73
Livingston,3650,2,21,4,11,73,42,31,67
Airdrieon,3650,3,16,10,10,65,60,5,58
Brechin,3650,4,15,7,14,51,49,2,52
Peterhead,3650,5,14,7,15,47,48,-1,49
Albion,3650,6,12,12,12,49,45,4,48
Queen's Park,3650,7,13,6,17,39,57,-18,45
East Fife,3650,8,11,8,17,44,52,-8,41
Stranraer,3650,9,9,10,17,43,57,-14,37
Stenhousem'r,3650,10,5,13,18,42,74,-32,28
Livingston,3651,1,23,3,10,82,49,33,72
Alloa,3651,2,17,8,11,66,53,13,59
Brechin,3651,3,17,8,11,58,50,8,59
Albion,3651,4,16,6,14,52,53,-1,54
Peterhead,3651,5,13,8,15,51,58,-7,47
Airdrieon,3651,6,13,7,16,57,63,-6,46
Stranraer,3651,7,13,5,18,49,58,-9,44
East Fife,3651,8,11,10,15,53,52,1,43
Queen's Park,3651,9,10,10,16,38,50,-12,40
Stenhousem'r,3651,10,10,9,17,51,71,-20,39
Alloa,3652,1,22,7,7,83,41,42,73
Livingston,3652,2,17,10,9,75,54,21,61
Stranraer,3652,3,16,6,14,52,50,2,54
Airdrieon,3652,4,14,10,12,55,56,-1,52
Peterhead,3652,5,15,7,14,53,55,-2,52
Brechin,3652,6,12,12,12,48,49,-1,48
Albion,3652,7,12,12,12,47,50,-3,48
East Fife,3652,8,12,10,14,56,48,8,46
Queen's Park,3652,9,8,12,16,41,64,-23,36
Stenhousem'r,3652,10,6,6,24,44,87,-43,24
Livingston,3653,1,18,8,10,65,46,19,62
Alloa,3653,2,18,6,12,73,45,28,60
Brechin,3653,3,19,3,14,58,49,9,60
Airdrieon,3653,4,16,10,10,59,57,2,58
Stranraer,3653,5,15,6,15,58,55,3,51
Peterhead,3653,6,12,11,13,47,54,-7,47
Queen's Park,3653,7,13,8,15,45,52,-7,47
Albion,3653,8,10,12,14,50,59,-9,42
East Fife,3653,9,10,9,17,47,56,-9,39
Stenhousem'r,3653,10,9,7,20,48,77,-29,34
Livingston,3654,1,25,6,5,82,40,42,81
Alloa,3654,2,17,9,10,66,51,15,60
Airdrieon,3654,3,15,12,9,69,59,10,57
Brechin,3654,4,16,6,14,50,52,-2,54
Queen's Park,3654,5,12,10,14,34,48,-14,46
East Fife,3654,6,12,9,15,55,52,3,45
Stranraer,3654,7,13,5,18,59,64,-5,44
Albion,3654,8,12,6,18,51,64,-13,42
Peterhead,3654,9,10,8,18,45,55,-10,38
Stenhousem'r,3654,10,9,7,20,49,75,-26,34
Livingston,3655,1,24,7,5,81,32,49,79
Alloa,3655,2,22,5,9,87,55,32,71
Airdrieon,3655,3,19,5,12,61,59,2,62
Brechin,3655,4,16,6,14,48,54,-6,54
Peterhead,3655,5,14,5,17,55,56,-1,47
Albion,3655,6,12,8,16,55,58,-3,44
Queen's Park,3655,7,13,5,18,44,55,-11,44
East Fife,3655,8,10,9,17,46,60,-14,39
Stenhousem'r,3655,9,10,7,19,48,82,-34,37
Stranraer,3655,10,8,7,21,50,64,-14,31
Airdrieon,3656,1,21,3,12,70,46,24,66
Alloa,3656,2,19,6,11,76,45,31,63
Livingston,3656,3,18,7,11,71,51,20,61
Albion,3656,4,16,10,10,57,50,7,58
Brechin,3656,5,16,9,11,47,42,5,57
East Fife,3656,6,15,8,13,52,49,3,53
Queen's Park,3656,7,13,8,15,42,51,-9,47
Peterhead,3656,8,13,7,16,50,62,-12,46
Stranraer,3656,9,10,7,19,42,61,-19,37
Stenhousem'r,3656,10,3,7,26,37,87,-50,16
Livingston,3657,1,22,1,13,77,49,28,67
Alloa,3657,2,18,8,10,65,42,23,62
Brechin,3657,3,16,9,11,48,45,3,57
Airdrieon,3657,4,15,10,11,59,53,6,55
Stranraer,3657,5,16,6,14,49,50,-1,54
Peterhead,3657,6,15,7,14,47,50,-3,52
Albion,3657,7,14,8,14,46,47,-1,50
Queen's Park,3657,8,13,8,15,34,42,-8,47
East Fife,3657,9,9,7,20,48,52,-4,34
Stenhousem'r,3657,10,6,8,22,42,85,-43,26
Livingston,3658,1,23,4,9,80,48,32,73
Alloa,3658,2,20,7,9,71,42,29,67
Brechin,3658,3,16,9,11,53,48,5,57
Albion,3658,4,16,8,12,53,45,8,56
Airdrieon,3658,5,16,6,14,56,60,-4,54
Queen's Park,3658,6,14,5,17,34,47,-13,47
Stranraer,3658,7,13,5,18,51,59,-8,44
Peterhead,3658,8,10,9,17,38,60,-22,39
East Fife,3658,9,10,7,19,51,53,-2,37
Stenhousem'r,3658,10,9,6,21,48,73,-25,33
Livingston,3659,1,20,5,11,71,48,23,65
Alloa,3659,2,17,12,7,69,42,27,63
Peterhead,3659,3,17,10,9,63,47,16,61
Airdrieon,3659,4,16,5,15,64,61,3,53
Albion,3659,5,13,10,13,55,51,4,49
Brechin,3659,6,14,7,15,47,56,-9,49
Stranraer,3659,7,14,6,16,52,59,-7,48
Queen's Park,3659,8,13,7,16,40,53,-13,46
East Fife,3659,9,13,4,19,50,48,2,43
Stenhousem'r,3659,10,6,8,22,42,88,-46,26
Livingston,3660,1,23,4,9,67,37,30,73
Alloa,3660,2,20,6,10,71,43,28,66
Brechin,3660,3,17,5,14,61,55,6,56
Peterhead,3660,4,15,10,11,57,50,7,55
Airdrieon,3660,5,16,6,14,52,49,3,54
Stranraer,3660,6,14,6,16,52,55,-3,48
East Fife,3660,7,13,7,16,53,52,1,46
Queen's Park,3660,8,12,4,20,30,47,-17,40
Stenhousem'r,3660,9,11,6,19,53,87,-34,39
Albion,3660,10,8,8,20,42,63,-21,32
Livingston,3661,1,22,2,12,74,46,28,68
Queen's Park,3661,2,20,6,10,42,41,1,66
Brechin,3661,3,18,7,11,58,49,9,61
Airdrieon,3661,4,16,5,15,60,57,3,53
Alloa,3661,5,14,10,12,64,51,13,52
Peterhead,3661,6,13,7,16,57,58,-1,46
Albion,3661,7,12,10,14,51,56,-5,46
East Fife,3661,8,10,12,14,56,54,2,42
Stranraer,3661,9,12,5,19,46,57,-11,41
Stenhousem'r,3661,10,8,6,22,42,81,-39,30
Livingston,3662,1,18,10,8,81,48,33,64
Alloa,3662,2,18,8,10,73,47,26,62
Peterhead,3662,3,15,8,13,54,52,2,53
Albion,3662,4,13,12,11,50,41,9,51
Stranraer,3662,5,15,6,15,48,54,-6,51
Queen's Park,3662,6,14,9,13,33,41,-8,51
Airdrieon,3662,7,15,5,16,55,64,-9,50
East Fife,3662,8,10,10,16,48,53,-5,40
Brechin,3662,9,9,12,15,46,56,-10,39
Stenhousem'r,3662,10,9,8,19,43,75,-32,35
Livingston,3663,1,22,5,9,80,45,35,71
Alloa,3663,2,19,6,11,68,50,18,63
Airdrieon,3663,3,19,5,12,60,60,0,62
Brechin,3663,4,18,5,13,47,45,2,59
Peterhead,3663,5,14,8,14,43,50,-7,50
Queen's Park,3663,6,14,7,15,46,52,-6,49
Stranraer,3663,7,12,8,16,48,52,-4,44
East Fife,3663,8,12,7,17,58,51,7,43
Albion,3663,9,10,7,19,49,64,-15,37
Stenhousem'r,3663,10,6,10,20,46,76,-30,28
Livingston,3664,1,23,4,9,75,44,31,73
Alloa,3664,2,18,12,6,67,44,23,66
Brechin,3664,3,18,4,14,46,43,3,58
Airdrieon,3664,4,17,4,15,61,62,-1,55
Albion,3664,5,15,7,14,52,51,1,52
Stranraer,3664,6,13,8,15,57,61,-4,47
East Fife,3664,7,12,8,16,49,49,0,44
Peterhead,3664,8,10,7,19,42,58,-16,37
Queen's Park,3664,9,10,6,20,35,51,-16,36
Stenhousem'r,3664,10,8,12,16,48,69,-21,36
Brechin,3665,1,21,6,9,61,45,16,69
Livingston,3665,2,20,7,9,67,43,24,67
Alloa,3665,3,18,7,11,62,41,21,61
Queen's Park,3665,4,16,6,14,45,43,2,54
Airdrieon,3665,5,15,8,13,66,61,5,53
Albion,3665,6,13,10,13,51,51,0,49
Stranraer,3665,7,14,5,17,49,56,-7,47
Peterhead,3665,8,8,15,13,44,54,-10,39
Stenhousem'r,3665,9,8,9,19,43,78,-35,33
East Fife,3665,10,6,9,21,47,63,-16,27
Alloa,3666,1,19,9,8,69,37,32,66
Livingston,3666,2,20,6,10,66,43,23,66
Airdrieon,3666,3,16,9,11,55,53,2,57
Peterhead,3666,4,14,8,14,52,52,0,50
Brechin,3666,5,15,5,16,42,51,-9,50
East Fife,3666,6,13,9,14,51,49,2,48
Queen's Park,3666,7,13,8,15,38,45,-7,47
Albion,3666,8,13,5,18,46,56,-10,44
Stenhousem'r,3666,9,11,6,19,49,71,-22,39
Stranraer,3666,10,10,7,19,47,58,-11,37
Livingston,3667,1,20,8,8,79,53,26,68
Alloa,3667,2,20,6,10,73,44,29,66
Brechin,3667,3,17,10,9,57,44,13,61
Airdrieon,3667,4,15,9,12,56,51,5,54
East Fife,3667,5,13,10,13,55,46,9,49
Albion,3667,6,14,6,16,56,59,-3,48
Stranraer,3667,7,12,8,16,57,62,-5,44
Queen's Park,3667,8,11,6,19,36,60,-24,39
Peterhead,3667,9,9,10,17,40,63,-23,37
Stenhousem'r,3667,10,8,9,19,51,78,-27,33
Livingston,3668,1,24,5,7,89,37,52,77
Alloa,3668,2,19,10,7,66,38,28,67
Albion,3668,3,18,4,14,54,48,6,58
Brechin,3668,4,14,8,14,51,44,7,50
East Fife,3668,5,13,10,13,49,38,11,49
Peterhead,3668,6,14,6,16,44,52,-8,48
Stranraer,3668,7,13,6,17,54,63,-9,45
Queen's Park,3668,8,12,7,17,32,46,-14,43
Airdrieon,3668,9,11,7,18,46,72,-26,40
Stenhousem'r,3668,10,7,7,22,43,90,-47,28
Livingston,3669,1,22,3,11,78,51,27,69
Airdrieon,3669,2,19,4,13,64,51,13,61
Queen's Park,3669,3,16,6,14,42,47,-5,54
Brechin,3669,4,16,5,15,50,52,-2,53
Stranraer,3669,5,16,4,16,59,58,1,52
Alloa,3669,6,13,9,14,57,53,4,48
Peterhead,3669,7,14,6,16,47,54,-7,48
East Fife,3669,8,12,11,13,42,41,1,47
Albion,3669,9,13,6,17,55,57,-2,45
Stenhousem'r,3669,10,10,4,22,55,85,-30,34
Livingston,3670,1,18,12,6,74,41,33,66
Alloa,3670,2,16,10,10,72,49,23,58
Albion,3670,3,16,9,11,56,52,4,57
Airdrieon,3670,4,16,5,15,55,54,1,53
Peterhead,3670,5,14,8,14,52,55,-3,50
East Fife,3670,6,13,8,15,60,57,3,47
Brechin,3670,7,13,6,17,48,62,-14,45
Stranraer,3670,8,10,10,16,51,58,-7,40
Stenhousem'r,3670,9,10,10,16,47,67,-20,40
Queen's Park,3670,10,10,10,16,31,51,-20,40
Alloa,3671,1,22,6,8,77,42,35,72
Livingston,3671,2,22,4,10,81,46,35,70
Brechin,3671,3,20,4,12,57,45,12,64
Airdrieon,3671,4,16,5,15,61,62,-1,53
Albion,3671,5,14,9,13,53,51,2,51
Peterhead,3671,6,13,10,13,52,55,-3,49
Queen's Park,3671,7,12,7,17,40,56,-16,43
East Fife,3671,8,9,11,16,46,54,-8,38
Stranraer,3671,9,10,6,20,47,71,-24,36
Stenhousem'r,3671,10,7,8,21,48,80,-32,29
Livingston,3672,1,21,3,12,74,49,25,66
Alloa,3672,2,17,8,11,66,44,22,59
Peterhead,3672,3,16,9,11,47,38,9,57
Brechin,3672,4,17,6,13,48,48,0,57
Airdrieon,3672,5,15,6,15,61,61,0,51
Albion,3672,6,14,8,14,54,51,3,50
Queen's Park,3672,7,14,6,16,39,52,-13,48
Stranraer,3672,8,13,5,18,53,56,-3,44
East Fife,3672,9,9,11,16,49,54,-5,38
Stenhousem'r,3672,10,9,8,19,39,77,-38,35
Airdrieon,3673,1,19,8,9,63,51,12,65
Livingston,3673,2,19,6,11,77,46,31,63
Brechin,3673,3,19,6,11,70,49,21,63
Alloa,3673,4,15,7,14,63,56,7,52
Queen's Park,3673,5,15,6,15,40,52,-12,51
Albion,3673,6,14,7,15,45,48,-3,49
Peterhead,3673,7,11,11,14,57,61,-4,44
Stranraer,3673,8,13,2,21,57,75,-18,41
East Fife,3673,9,11,7,18,50,58,-8,40
Stenhousem'r,3673,10,11,6,19,56,82,-26,39
Livingston,3674,1,24,5,7,80,43,37,77
Alloa,3674,2,20,9,7,68,39,29,69
Airdrieon,3674,3,16,9,11,55,50,5,57
East Fife,3674,4,13,13,10,64,48,16,52
Brechin,3674,5,15,7,14,49,48,1,52
Stranraer,3674,6,13,7,16,54,55,-1,46
Albion,3674,7,11,11,14,52,56,-4,44
Peterhead,3674,8,9,10,17,49,64,-15,37
Queen's Park,3674,9,9,9,18,32,56,-24,36
Stenhousem'r,3674,10,4,12,20,46,90,-44,24
Livingston,3675,1,21,6,9,87,48,39,69
Alloa,3675,2,20,6,10,73,48,25,66
Airdrieon,3675,3,20,5,11,59,53,6,65
Stranraer,3675,4,19,2,15,62,57,5,59
Queen's Park,3675,5,16,4,16,45,55,-10,52
Brechin,3675,6,15,3,18,52,52,0,48
Albion,3675,7,13,5,18,44,55,-11,44
Peterhead,3675,8,11,8,17,47,65,-18,41
East Fife,3675,9,9,10,17,53,52,1,37
Stenhousem'r,3675,10,8,7,21,48,85,-37,31
Alloa,3676,1,21,6,9,72,42,30,69
Livingston,3676,2,20,5,11,77,47,30,65
Airdrieon,3676,3,18,6,12,63,51,12,60
Peterhead,3676,4,17,6,13,50,50,0,57
Brechin,3676,5,18,3,15,51,55,-4,57
Queen's Park,3676,6,12,8,16,39,52,-13,44
Stranraer,3676,7,11,9,16,53,59,-6,42
Albion,3676,8,11,9,16,52,59,-7,42
Stenhousem'r,3676,9,11,5,20,51,73,-22,38
East Fife,3676,10,8,9,19,40,60,-20,33
Alloa,3677,1,18,9,9,68,50,18,63
Peterhead,3677,2,17,8,11,49,49,0,59
East Fife,3677,3,16,10,10,57,42,15,58
Livingston,3677,4,17,3,16,64,52,12,54
Airdrieon,3677,5,16,6,14,60,56,4,54
Albion,3677,6,13,14,9,58,52,6,53
Brechin,3677,7,15,7,14,59,57,2,52
Stranraer,3677,8,11,5,20,43,58,-15,38
Queen's Park,3677,9,10,8,18,39,58,-19,38
Stenhousem'r,3677,10,9,6,21,48,71,-23,33
Livingston,3678,1,20,8,8,73,48,25,68
Alloa,3678,2,19,9,8,65,37,28,66
Airdrieon,3678,3,15,10,11,62,56,6,55
East Fife,3678,4,15,8,13,56,47,9,53
Brechin,3678,5,15,6,15,48,51,-3,51
Stranraer,3678,6,13,6,17,49,56,-7,45
Albion,3678,7,12,7,17,52,57,-5,43
Queen's Park,3678,8,11,8,17,43,58,-15,41
Stenhousem'r,3678,9,10,10,16,53,72,-19,40
Peterhead,3678,10,8,12,16,34,53,-19,36
Alloa,3679,1,22,7,7,78,42,36,73
Brechin,3679,2,17,8,11,56,48,8,59
Livingston,3679,3,18,4,14,67,56,11,58
Airdrieon,3679,4,14,10,12,55,48,7,52
Stranraer,3679,5,15,5,16,51,59,-8,50
Peterhead,3679,6,13,10,13,51,55,-4,49
East Fife,3679,7,11,10,15,52,55,-3,43
Albion,3679,8,10,12,14,53,56,-3,42
Queen's Park,3679,9,12,6,18,37,57,-20,42
Stenhousem'r,3679,10,7,10,19,55,79,-24,31
Livingston,3680,1,22,5,9,85,55,30,71
Alloa,3680,2,19,8,9,72,44,28,65
Airdrieon,3680,3,19,8,9,65,43,22,65
Brechin,3680,4,17,3,16,55,52,3,54
Queen's Park,3680,5,15,7,14,49,58,-9,52
Peterhead,3680,6,14,7,15,49,58,-9,49
Albion,3680,7,10,11,15,44,46,-2,41
Stranraer,3680,8,12,4,20,53,76,-23,40
East Fife,3680,9,9,12,15,50,54,-4,39
Stenhousem'r,3680,10,8,5,23,53,89,-36,29
Alloa,3681,1,18,7,11,70,48,22,61
Stranraer,3681,2,17,9,10,63,51,12,60
Livingston,3681,3,18,5,13,60,46,14,59
Brechin,3681,4,17,8,11,53,49,4,59
Peterhead,3681,5,14,10,12,49,42,7,52
Airdrieon,3681,6,15,7,14,55,54,1,52
East Fife,3681,7,11,8,17,46,46,0,41
Queen's Park,3681,8,11,7,18,33,51,-18,40
Albion,3681,9,9,12,15,45,57,-12,39
Stenhousem'r,3681,10,9,9,18,48,78,-30,36
Livingston,3682,1,23,6,7,80,39,41,75
Brechin,3682,2,19,6,11,51,43,8,63
Alloa,3682,3,18,7,11,62,41,21,61
Peterhead,3682,4,17,6,13,59,53,6,57
Airdrieon,3682,5,16,7,13,64,59,5,55
Albion,3682,6,14,11,11,53,53,0,53
East Fife,3682,7,15,6,15,54,53,1,51
Queen's Park,3682,8,9,7,20,33,61,-28,34
Stranraer,3682,9,9,4,23,48,67,-19,31
Stenhousem'r,3682,10,7,6,23,43,78,-35,27
Livingston,3683,1,22,6,8,78,35,43,72
Alloa,3683,2,21,5,10,68,45,23,68
Brechin,3683,3,18,5,13,44,46,-2,59
Stranraer,3683,4,15,7,14,60,55,5,52
Airdrieon,3683,5,16,3,17,47,59,-12,51
Peterhead,3683,6,12,9,15,54,53,1,45
Albion,3683,7,12,8,16,42,53,-11,44
Queen's Park,3683,8,10,9,17,32,50,-18,39
East Fife,3683,9,9,11,16,44,47,-3,38
Stenhousem'r,3683,10,8,11,17,40,66,-26,35
Livingston,3684,1,20,6,10,76,47,29,66
Brechin,3684,2,21,3,12,66,47,19,66
Airdrieon,3684,3,19,4,13,62,53,9,61
Alloa,3684,4,17,9,10,67,47,20,60
Peterhead,3684,5,14,10,12,51,50,1,52
Albion,3684,6,15,5,16,53,54,-1,50
Stranraer,3684,7,12,6,18,44,64,-20,42
East Fife,3684,8,11,7,18,49,54,-5,40
Queen's Park,3684,9,9,10,17,41,64,-23,37
Stenhousem'r,3684,10,7,10,19,45,74,-29,31
Livingston,3685,1,22,4,10,76,48,28,70
Airdrieon,3685,2,19,6,11,51,54,-3,63
Brechin,3685,3,18,5,13,54,46,8,59
Alloa,3685,4,17,7,12,73,47,26,58
Albion,3685,5,15,9,12,54,49,5,54
Peterhead,3685,6,15,5,16,53,58,-5,50
Queen's Park,3685,7,15,3,18,44,55,-11,48
East Fife,3685,8,12,9,15,51,52,-1,45
Stranraer,3685,9,10,6,20,50,65,-15,36
Stenhousem'r,3685,10,5,10,21,48,80,-32,25
Alloa,3686,1,19,8,9,68,44,24,65
Livingston,3686,2,18,6,12,67,44,23,60
Peterhead,3686,3,15,9,12,48,44,4,54
Albion,3686,4,15,8,13,60,54,6,53
Airdrieon,3686,5,15,8,13,58,56,2,53
Brechin,3686,6,15,5,16,40,45,-5,50
Queen's Park,3686,7,12,9,15,43,55,-12,45
Stranraer,3686,8,12,6,18,50,63,-13,42
East Fife,3686,9,9,13,14,49,52,-3,40
Stenhousem'r,3686,10,9,10,17,56,82,-26,37
Alloa,3687,1,23,6,7,72,34,38,75
Livingston,3687,2,17,8,11,71,56,15,59
Albion,3687,3,17,7,12,59,47,12,58
Airdrieon,3687,4,17,6,13,54,50,4,57
Brechin,3687,5,17,4,15,52,49,3,55
Stranraer,3687,6,14,6,16,50,59,-9,48
Peterhead,3687,7,13,6,17,52,59,-7,45
East Fife,3687,8,10,11,15,48,47,1,41
Queen's Park,3687,9,10,9,17,38,58,-20,39
Stenhousem'r,3687,10,8,5,23,49,86,-37,29
Alloa,3688,1,20,7,9,72,37,35,67
Livingston,3688,2,18,7,11,61,46,15,61
Brechin,3688,3,17,6,13,51,45,6,57
Peterhead,3688,4,17,6,13,52,50,2,57
Albion,3688,5,14,9,13,51,47,4,51
Airdrieon,3688,6,14,8,14,63,66,-3,50
East Fife,3688,7,13,10,13,53,46,7,49
Queen's Park,3688,8,12,10,14,36,52,-16,46
Stranraer,3688,9,9,8,19,55,67,-12,35
Stenhousem'r,3688,10,7,7,22,45,83,-38,28
Alloa,3689,1,21,6,9,79,47,32,69
Livingston,3689,2,20,5,11,62,44,18,65
Airdrieon,3689,3,17,5,14,58,54,4,56
East Fife,3689,4,15,8,13,54,42,12,53
Brechin,3689,5,16,5,15,47,50,-3,53
Albion,3689,6,13,12,11,49,48,1,51
Stranraer,3689,7,13,7,16,47,53,-6,46
Peterhead,3689,8,13,6,17,45,55,-10,45
Queen's Park,3689,9,11,5,20,31,49,-18,38
Stenhousem'r,3689,10,6,11,19,40,70,-30,29
Livingston,3690,1,22,5,9,72,42,30,71
Peterhead,3690,2,17,8,11,56,46,10,59
East Fife,3690,3,16,8,12,56,44,12,56
Airdrieon,3690,4,15,10,11,55,53,2,55
Alloa,3690,5,15,8,13,63,50,13,53
Brechin,3690,6,14,8,14,48,46,2,50
Albion,3690,7,14,5,17,50,54,-4,47
Queen's Park,3690,8,13,6,17,41,51,-10,45
Stranraer,3690,9,12,8,16,50,60,-10,44
Stenhousem'r,3690,10,4,10,22,40,85,-45,22
Alloa,3691,1,20,9,7,75,44,31,69
Airdrieon,3691,2,19,8,9,62,46,16,65
Livingston,3691,3,19,5,12,74,52,22,62
Albion,3691,4,17,7,12,63,49,14,58
Brechin,3691,5,15,9,12,55,56,-1,54
Peterhead,3691,6,12,11,13,52,47,5,47
Queen's Park,3691,7,13,7,16,44,56,-12,46
Stranraer,3691,8,12,6,18,48,65,-17,42
East Fife,3691,9,9,9,18,40,52,-12,36
Stenhousem'r,3691,10,4,9,23,44,90,-46,21
Livingston,3692,1,24,5,7,87,40,47,77
Alloa,3692,2,17,8,11,60,42,18,59
Peterhead,3692,3,17,6,13,54,50,4,57
East Fife,3692,4,14,10,12,61,53,8,52
Albion,3692,5,15,7,14,53,52,1,52
Brechin,3692,6,14,8,14,49,59,-10,50
Queen's Park,3692,7,13,6,17,35,45,-10,45
Airdrieon,3692,8,11,10,15,51,57,-6,43
Stranraer,3692,9,10,6,20,45,67,-22,36
Stenhousem'r,3692,10,8,8,20,55,85,-30,32
Airdrieon,3693,1,20,6,10,72,62,10,66
Livingston,3693,2,18,5,13,76,55,21,59
Alloa,3693,3,18,5,13,70,49,21,59
Brechin,3693,4,18,5,13,61,51,10,59
Peterhead,3693,5,18,4,14,67,50,17,58
Albion,3693,6,17,7,12,66,56,10,58
Queen's Park,3693,7,14,5,17,43,58,-15,47
East Fife,3693,8,13,7,16,59,56,3,46
Stranraer,3693,9,9,5,22,45,73,-28,32
Stenhousem'r,3693,10,6,9,21,38,87,-49,27
Livingston,3694,1,20,6,10,84,57,27,66
Airdrieon,3694,2,18,7,11,65,53,12,61
Alloa,3694,3,17,6,13,66,49,17,57
Albion,3694,4,14,10,12,63,51,12,52
Peterhead,3694,5,15,7,14,49,53,-4,52
Stranraer,3694,6,15,5,16,64,54,10,50
East Fife,3694,7,14,7,15,50,49,1,49
Brechin,3694,8,13,8,15,45,50,-5,47
Queen's Park,3694,9,13,5,18,36,58,-22,44
Stenhousem'r,3694,10,7,7,22,46,94,-48,28
Alloa,3695,1,20,8,8,82,42,40,68
Livingston,3695,2,21,3,12,62,48,14,66
Airdrieon,3695,3,20,5,11,60,50,10,65
Brechin,3695,4,18,4,14,51,40,11,58
Queen's Park,3695,5,15,6,15,42,43,-1,51
Albion,3695,6,13,9,14,53,56,-3,48
Peterhead,3695,7,11,11,14,51,55,-4,44
Stranraer,3695,8,11,6,19,39,63,-24,39
Stenhousem'r,3695,9,10,7,19,52,74,-22,37
East Fife,3695,10,7,9,20,39,60,-21,30
Livingston,3696,1,19,4,13,68,51,17,61
Alloa,3696,2,18,6,12,70,50,20,60
Albion,3696,3,16,9,11,64,47,17,57
Brechin,3696,4,18,3,15,51,46,5,57
Airdrieon,3696,5,16,6,14,67,57,10,54
Peterhead,3696,6,14,9,13,55,53,2,51
Stranraer,3696,7,14,5,17,56,58,-2,47
Queen's Park,3696,8,13,8,15,44,52,-8,47
Stenhousem'r,3696,9,11,7,18,50,82,-32,40
East Fife,3696,10,9,7,20,38,67,-29,34
Alloa,3697,1,18,8,10,69,51,18,62
Livingston,3697,2,18,5,13,75,58,17,59
Airdrieon,3697,3,15,9,12,53,51,2,54
Peterhead,3697,4,15,9,12,49,48,1,54
Brechin,3697,5,16,5,15,51,50,1,53
East Fife,3697,6,13,8,15,55,49,6,47
Albion,3697,7,13,7,16,50,53,-3,46
Queen's Park,3697,8,12,8,16,36,47,-11,44
Stranraer,3697,9,14,2,20,49,61,-12,44
Stenhousem'r,3697,10,11,9,16,50,69,-19,42
Livingston,3698,1,22,6,8,75,41,34,72
Brechin,3698,2,21,6,9,58,43,15,69
Alloa,3698,3,19,9,8,80,44,36,66
Airdrieon,3698,4,18,7,11,53,43,10,61
Peterhead,3698,5,15,6,15,47,53,-6,51
Stranraer,3698,6,14,5,17,53,61,-8,47
Albion,3698,7,12,6,18,53,60,-7,42
Queen's Park,3698,8,10,8,18,36,46,-10,38
East Fife,3698,9,7,9,20,37,61,-24,30
Stenhousem'r,3698,10,7,8,21,44,84,-40,29
Livingston,3699,1,21,5,10,74,49,25,68
Airdrieon,3699,2,18,4,14,56,59,-3,58
Peterhead,3699,3,15,10,11,60,53,7,55
Alloa,3699,4,15,9,12,61,54,7,54
Brechin,3699,5,15,6,15,44,41,3,51
East Fife,3699,6,14,8,14,57,50,7,50
Stranraer,3699,7,14,8,14,62,56,6,50
Albion,3699,8,13,6,17,50,60,-10,45
Queen's Park,3699,9,12,8,16,36,43,-7,44
Stenhousem'r,3699,10,9,4,23,53,88,-35,31
Livingston,3700,1,19,8,9,72,50,22,65
Peterhead,3700,2,18,6,12,58,45,13,60
Alloa,3700,3,17,8,11,72,50,22,59
Albion,3700,4,14,11,11,59,50,9,53
Brechin,3700,5,16,5,15,57,54,3,53
Airdrieon,3700,6,16,4,16,62,70,-8,52
East Fife,3700,7,13,7,16,59,60,-1,46
Stenhousem'r,3700,8,12,5,19,54,72,-18,41
Stranraer,3700,9,12,4,20,44,57,-13,40
Queen's Park,3700,10,12,4,20,30,59,-29,40
Alloa,3701,1,24,4,8,64,38,26,76
Livingston,3701,2,23,6,7,83,42,41,75
Airdrieon,3701,3,16,6,14,54,52,2,54
Brechin,3701,4,16,5,15,50,48,2,53
Albion,3701,5,14,9,13,49,48,1,51
Queen's Park,3701,6,16,3,17,32,47,-15,51
East Fife,3701,7,11,9,16,49,46,3,42
Peterhead,3701,8,11,9,16,35,44,-9,42
Stranraer,3701,9,10,6,20,46,63,-17,36
Stenhousem'r,3701,10,6,9,21,40,74,-34,27
Livingston,3702,1,21,3,12,83,53,30,66
Alloa,3702,2,19,7,10,79,50,29,64
Albion,3702,3,17,8,11,59,51,8,59
Brechin,3702,4,18,5,13,54,47,7,59
Airdrieon,3702,5,16,9,11,61,58,3,57
Stranraer,3702,6,15,10,11,57,52,5,55
Queen's Park,3702,7,12,7,17,42,51,-9,43
Peterhead,3702,8,9,11,16,43,62,-19,38
East Fife,3702,9,9,8,19,46,57,-11,35
Stenhousem'r,3702,10,6,8,22,46,89,-43,26
Livingston,3703,1,22,3,11,71,48,23,69
Airdrieon,3703,2,19,5,12,71,62,9,62
Brechin,3703,3,18,5,13,50,49,1,59
Alloa,3703,4,16,8,12,66,46,20,56
Albion,3703,5,14,9,13,54,48,6,51
Peterhead,3703,6,14,9,13,50,51,-1,51
Queen's Park,3703,7,13,8,15,46,51,-5,47
East Fife,3703,8,11,10,15,54,53,1,43
Stranraer,3703,9,12,2,22,45,67,-22,38
Stenhousem'r,3703,10,8,7,21,48,80,-32,31
Alloa,3704,1,23,5,8,85,49,36,74
Livingston,3704,2,21,6,9,83,46,37,69
Brechin,3704,3,21,5,10,68,49,19,68
Airdrieon,3704,4,16,6,14,58,53,5,54
Queen's Park,3704,5,13,9,14,37,43,-6,48
Peterhead,3704,6,12,11,13,47,56,-9,47
Stranraer,3704,7,12,6,18,47,66,-19,42
East Fife,3704,8,11,8,17,53,59,-6,41
Albion,3704,9,9,7,20,44,61,-17,34
Stenhousem'r,3704,10,7,7,22,46,86,-40,28
Livingston,3705,1,21,5,10,77,41,36,68
Alloa,3705,2,18,11,7,76,49,27,65
Brechin,3705,3,16,7,13,50,46,4,55
Stranraer,3705,4,15,5,16,62,52,10,50
Airdrieon,3705,5,14,8,14,53,67,-14,50
Peterhead,3705,6,13,9,14,53,57,-4,48
Albion,3705,7,12,10,14,45,54,-9,46
Queen's Park,3705,8,12,9,15,38,47,-9,45
East Fife,3705,9,9,11,16,43,51,-8,38
Stenhousem'r,3705,10,10,5,21,43,76,-33,35
Brechin,3706,1,20,6,10,58,45,13,66
Queen's Park,3706,2,16,8,12,53,46,7,56
Alloa,3706,3,17,4,15,62,55,7,55
Airdrieon,3706,4,17,4,15,52,49,3,55
Livingston,3706,5,16,6,14,71,57,14,54
Peterhead,3706,6,13,8,15,47,55,-8,47
Stranraer,3706,7,14,5,17,51,61,-10,47
East Fife,3706,8,13,7,16,48,50,-2,46
Albion,3706,9,11,8,17,50,59,-9,41
Stenhousem'r,3706,10,11,8,17,54,69,-15,41
Livingston,3707,1,22,4,10,73,42,31,70
Alloa,3707,2,19,7,10,64,40,24,64
Airdrieon,3707,3,16,9,11,56,52,4,57
Brechin,3707,4,17,4,15,51,54,-3,55
Peterhead,3707,5,14,8,14,60,55,5,50
Albion,3707,6,13,9,14,52,52,0,48
Stenhousem'r,3707,7,12,7,17,56,77,-21,43
East Fife,3707,8,10,10,16,52,54,-2,40
Queen's Park,3707,9,9,12,15,34,58,-24,39
Stranraer,3707,10,12,2,22,50,64,-14,38
Alloa,3708,1,23,6,7,81,33,48,75
Livingston,3708,2,20,5,11,76,47,29,65
Peterhead,3708,3,16,7,13,61,53,8,55
Brechin,3708,4,15,8,13,53,58,-5,53
Airdrieon,3708,5,14,10,12,46,53,-7,52
East Fife,3708,6,14,8,14,56,49,7,50
Queen's Park,3708,7,13,6,17,40,50,-10,45
Albion,3708,8,12,7,17,48,59,-11,43
Stranraer,3708,9,9,9,18,55,69,-14,36
Stenhousem'r,3708,10,8,6,22,44,89,-45,30
Alloa,3709,1,20,8,8,70,38,32,68
Livingston,3709,2,18,7,11,76,48,28,61
Brechin,3709,3,17,7,12,51,45,6,58
Stranraer,3709,4,16,6,14,53,53,0,54
East Fife,3709,5,15,6,15,53,50,3,51
Airdrieon,3709,6,13,9,14,61,67,-6,48
Albion,3709,7,11,13,12,58,54,4,46
Peterhead,3709,8,13,6,17,47,61,-14,45
Queen's Park,3709,9,12,7,17,41,55,-14,43
Stenhousem'r,3709,10,7,7,22,51,90,-39,28
Alloa,3710,1,17,9,10,73,50,23,60
Livingston,3710,2,18,3,15,63,44,19,57
Stranraer,3710,3,17,5,14,44,46,-2,56
Albion,3710,4,15,8,13,53,48,5,53
East Fife,3710,5,15,7,14,52,47,5,52
Airdrieon,3710,6,16,4,16,57,57,0,52
Brechin,3710,7,11,13,12,43,47,-4,46
Queen's Park,3710,8,13,6,17,33,51,-18,45
Stenhousem'r,3710,9,11,9,16,50,66,-16,42
Peterhead,3710,10,11,8,17,49,61,-12,41
Brechin,3711,1,19,6,11,54,46,8,63
Albion,3711,2,17,8,11,62,47,15,59
Alloa,3711,3,16,9,11,62,46,16,57
Livingston,3711,4,15,11,10,67,51,16,56
Airdrieon,3711,5,15,8,13,56,54,2,53
East Fife,3711,6,14,8,14,56,48,8,50
Peterhead,3711,7,11,13,12,43,52,-9,46
Queen's Park,3711,8,12,8,16,41,55,-14,44
Stranraer,3711,9,11,5,20,42,50,-8,38
Stenhousem'r,3711,10,9,6,21,50,84,-34,33
Livingston,3712,1,23,5,8,88,52,36,74
Brechin,3712,2,15,9,12,55,51,4,54
Queen's Park,3712,3,14,11,11,44,45,-1,53
Alloa,3712,4,14,10,12,66,55,11,52
East Fife,3712,5,14,10,12,59,48,11,52
Peterhead,3712,6,14,7,15,48,61,-13,49
Albion,3712,7,12,10,14,51,49,2,46
Airdrieon,3712,8,12,7,17,47,66,-19,43
Stranraer,3712,9,11,9,16,57,59,-2,42
Stenhousem'r,3712,10,7,10,19,61,90,-29,31
Livingston,3713,1,22,5,9,89,49,40,71
Alloa,3713,2,19,8,9,77,51,26,65
Airdrieon,3713,3,18,6,12,66,56,10,60
Brechin,3713,4,16,7,13,57,52,5,55
Peterhead,3713,5,14,8,14,59,62,-3,50
Albion,3713,6,14,7,15,56,61,-5,49
East Fife,3713,7,12,11,13,54,49,5,47
Stranraer,3713,8,13,4,19,49,60,-11,43
Queen's Park,3713,9,9,7,20,42,70,-28,34
Stenhousem'r,3713,10,9,5,22,42,81,-39,32
Livingston,3714,1,21,5,10,79,45,34,68
Alloa,3714,2,18,10,8,68,40,28,64
Airdrieon,3714,3,17,10,9,59,50,9,61
Queen's Park,3714,4,14,8,14,38,45,-7,50
Peterhead,3714,5,13,10,13,59,52,7,49
Brechin,3714,6,13,7,16,46,64,-18,46
Albion,3714,7,12,9,15,44,48,-4,45
East Fife,3714,8,11,8,17,49,50,-1,41
Stranraer,3714,9,11,8,17,45,59,-14,41
Stenhousem'r,3714,10,9,7,20,49,83,-34,34
Airdrieon,3715,1,18,9,9,64,52,12,63
Peterhead,3715,2,18,9,9,56,45,11,63
Alloa,3715,3,18,5,13,72,49,23,59
Brechin,3715,4,17,5,14,53,52,1,56
Livingston,3715,5,15,6,15,61,50,11,51
Albion,3715,6,14,7,15,49,53,-4,49
East Fife,3715,7,12,11,13,52,50,2,47
Stranraer,3715,8,13,3,20,49,60,-11,42
Queen's Park,3715,9,10,11,15,33,47,-14,41
Stenhousem'r,3715,10,8,8,20,48,79,-31,32
Livingston,3716,1,22,3,11,80,45,35,69
Airdrieon,3716,2,19,6,11,63,51,12,63
Alloa,3716,3,17,9,10,70,53,17,60
Peterhead,3716,4,18,5,13,50,46,4,59
Brechin,3716,5,18,3,15,57,52,5,57
Queen's Park,3716,6,13,7,16,42,57,-15,46
Albion,3716,7,12,8,16,59,62,-3,44
East Fife,3716,8,10,13,13,52,52,0,43
Stranraer,3716,9,12,6,18,46,60,-14,42
Stenhousem'r,3716,10,5,8,23,40,81,-41,23
Alloa,3717,1,16,10,10,67,55,12,58
Brechin,3717,2,17,7,12,54,51,3,58
Airdrieon,3717,3,16,8,12,56,60,-4,56
Livingston,3717,4,16,7,13,81,59,22,55
Queen's Park,3717,5,14,11,11,52,53,-1,53
Peterhead,3717,6,13,10,13,51,51,0,49
Albion,3717,7,14,6,16,56,54,2,48
East Fife,3717,8,12,9,15,56,53,3,45
Stranraer,3717,9,11,8,17,48,60,-12,41
Stenhousem'r,3717,10,10,6,20,65,90,-25,36
Livingston,3718,1,23,4,9,85,48,37,73
Brechin,3718,2,17,9,10,54,40,14,60
Alloa,3718,3,17,7,12,58,39,19,58
Peterhead,3718,4,16,10,10,55,46,9,58
Albion,3718,5,14,9,13,57,51,6,51
Airdrieon,3718,6,15,5,16,47,60,-13,50
Stranraer,3718,7,13,6,17,47,57,-10,45
Queen's Park,3718,8,11,5,20,31,59,-28,38
East Fife,3718,9,10,7,19,41,51,-10,37
Stenhousem'r,3718,10,9,8,19,44,68,-24,35
Livingston,3719,1,21,6,9,83,43,40,69
Airdrieon,3719,2,20,9,7,61,41,20,69
Alloa,3719,3,19,8,9,58,43,15,65
Brechin,3719,4,17,5,14,49,44,5,56
Albion,3719,5,13,8,15,53,53,0,47
Queen's Park,3719,6,12,8,16,40,46,-6,44
Stranraer,3719,7,11,9,16,42,51,-9,42
East Fife,3719,8,10,10,16,49,53,-4,40
Peterhead,3719,9,10,10,16,56,70,-14,40
Stenhousem'r,3719,10,7,7,22,39,86,-47,28
Livingston,3720,1,22,3,11,74,44,30,69
Airdrieon,3720,2,19,4,13,74,56,18,61
Alloa,3720,3,18,6,12,71,55,16,60
Albion,3720,4,15,8,13,57,54,3,53
Stranraer,3720,5,14,6,16,58,60,-2,48
Queen's Park,3720,6,14,6,16,43,49,-6,48
East Fife,3720,7,12,11,13,51,50,1,47
Peterhead,3720,8,12,10,14,49,63,-14,46
Brechin,3720,9,13,6,17,47,60,-13,45
Stenhousem'r,3720,10,6,10,20,41,74,-33,28
Livingston,3721,1,21,4,11,72,47,25,67
Airdrieon,3721,2,18,5,13,60,49,11,59
Alloa,3721,3,16,8,12,65,51,14,56
Albion,3721,4,16,8,12,54,46,8,56
Peterhead,3721,5,14,7,15,50,56,-6,49
Brechin,3721,6,14,5,17,51,56,-5,47
Queen's Park,3721,7,13,6,17,42,58,-16,45
Stenhousem'r,3721,8,12,8,16,50,67,-17,44
East Fife,3721,9,11,10,15,47,50,-3,43
Stranraer,3721,10,11,7,18,41,52,-11,40
Livingston,3722,1,24,3,9,77,47,30,75
Alloa,3722,2,18,5,13,64,57,7,59
East Fife,3722,3,16,10,10,61,42,19,58
Stranraer,3722,4,17,5,14,59,55,4,56
Peterhead,3722,5,14,7,15,55,57,-2,49
Albion,3722,6,13,9,14,53,47,6,48
Brechin,3722,7,14,6,16,55,52,3,48
Airdrieon,3722,8,15,3,18,56,65,-9,48
Queen's Park,3722,9,12,11,13,43,50,-7,47
Stenhousem'r,3722,10,5,5,26,42,93,-51,20
Livingston,3723,1,23,4,9,79,54,25,73
Airdrieon,3723,2,19,7,10,63,50,13,64
Alloa,3723,3,17,10,9,72,51,21,61
Albion,3723,4,13,10,13,58,52,6,49
East Fife,3723,5,13,9,14,55,50,5,48
Brechin,3723,6,13,8,15,49,52,-3,47
Peterhead,3723,7,12,11,13,48,53,-5,47
Stranraer,3723,8,12,4,20,46,64,-18,40
Queen's Park,3723,9,9,9,18,33,60,-27,36
Stenhousem'r,3723,10,9,8,19,48,65,-17,35
Livingston,3724,1,23,3,10,71,40,31,72
Alloa,3724,2,21,7,8,74,46,28,70
Airdrieon,3724,3,18,7,11,56,54,2,61
Albion,3724,4,17,7,12,70,53,17,58
Peterhead,3724,5,16,7,13,57,54,3,55
Brechin,3724,6,16,4,16,48,46,2,52
Queen's Park,3724,7,11,7,18,35,53,-18,40
East Fife,3724,8,10,7,19,41,55,-14,37
Stranraer,3724,9,10,6,20,42,60,-18,36
Stenhousem'r,3724,10,7,7,22,49,82,-33,28
Livingston,3725,1,26,1,9,91,46,45,79
Brechin,3725,2,18,6,12,50,44,6,60
Alloa,3725,3,17,7,12,65,45,20,58
Stranraer,3725,4,16,5,15,52,48,4,53
Airdrieon,3725,5,16,5,15,52,52,0,53
Peterhead,3725,6,13,8,15,47,50,-3,47
East Fife,3725,7,12,9,15,48,45,3,45
Albion,3725,8,12,5,19,48,57,-9,41
Stenhousem'r,3725,9,10,10,16,53,76,-23,40
Queen's Park,3725,10,9,6,21,29,72,-43,33
Livingston,3726,1,22,3,11,71,49,22,69
Albion,3726,2,18,9,9,58,41,17,63
Alloa,3726,3,18,7,11,73,51,22,61
Peterhead,3726,4,17,8,11,61,51,10,59
Airdrieon,3726,5,15,9,12,61,51,10,54
Brechin,3726,6,15,9,12,51,44,7,54
Queen's Park,3726,7,12,5,19,36,54,-18,41
East Fife,3726,8,9,8,19,43,54,-11,35
Stranraer,3726,9,9,7,20,40,66,-26,34
Stenhousem'r,3726,10,6,13,17,45,78,-33,31
Livingston,3727,1,21,4,11,76,49,27,67
Alloa,3727,2,20,5,11,71,42,29,65
Brechin,3727,3,20,5,11,64,46,18,65
Stranraer,3727,4,16,6,14,63,61,2,54
Airdrieon,3727,5,15,6,15,53,54,-1,51
Albion,3727,6,14,8,14,58,66,-8,50
Queen's Park,3727,7,12,9,15,40,49,-9,45
East Fife,3727,8,10,9,17,45,47,-2,39
Stenhousem'r,3727,9,11,5,20,46,80,-34,38
Peterhead,3727,10,9,7,20,45,67,-22,34
Airdrieon,3728,1,19,8,9,58,53,5,65
Livingston,3728,2,18,5,13,72,49,23,59
Alloa,3728,3,14,11,11,49,38,11,53
Brechin,3728,4,13,11,12,49,49,0,50
Stranraer,3728,5,14,7,15,60,60,0,49
Albion,3728,6,13,9,14,50,52,-2,48
Queen's Park,3728,7,10,17,9,42,43,-1,47
Peterhead,3728,8,13,8,15,46,54,-8,47
East Fife,3728,9,12,10,14,47,38,9,46
Stenhousem'r,3728,10,8,6,22,34,71,-37,30
Livingston,3729,1,24,3,9,81,44,37,75
Alloa,3729,2,19,7,10,74,42,32,64
Brechin,3729,3,15,11,10,48,44,4,56
Albion,3729,4,15,10,11,50,49,1,55
Airdrieon,3729,5,14,8,14,53,55,-2,50
Peterhead,3729,6,11,13,12,44,44,0,46
East Fife,3729,7,10,14,12,39,36,3,44
Queen's Park,3729,8,9,11,16,34,48,-14,38
Stranraer,3729,9,8,10,18,46,67,-21,34
Stenhousem'r,3729,10,6,11,19,38,78,-40,29
Livingston,3730,1,21,5,10,73,42,31,68
Alloa,3730,2,17,9,10,65,47,18,60
Albion,3730,3,16,10,10,52,43,9,58
Brechin,3730,4,18,4,14,53,45,8,58
Airdrieon,3730,5,16,5,15,53,64,-11,53
Stranraer,3730,6,14,6,16,48,53,-5,48
East Fife,3730,7,12,11,13,50,43,7,47
Queen's Park,3730,8,13,6,17,41,50,-9,45
Peterhead,3730,9,12,6,18,48,57,-9,42
Stenhousem'r,3730,10,6,8,22,43,82,-39,26
Alloa,3731,1,22,4,10,68,37,31,70
Livingston,3731,2,21,4,11,78,51,27,67
Airdrieon,3731,3,19,6,11,56,45,11,63
Brechin,3731,4,18,6,12,47,47,0,60
Albion,3731,5,16,11,9,61,54,7,59
Queen's Park,3731,6,14,5,17,39,47,-8,47
Stranraer,3731,7,13,3,20,41,57,-16,42
Peterhead,3731,8,10,8,18,46,59,-13,38
East Fife,3731,9,7,11,18,42,51,-9,32
Stenhousem'r,3731,10,7,8,21,43,73,-30,29
Alloa,3732,1,23,5,8,77,43,34,74
Livingston,3732,2,22,4,10,64,38,26,70
Albion,3732,3,18,7,11,55,47,8,61
Brechin,3732,4,16,7,13,58,46,12,55
Stranraer,3732,5,17,3,16,52,58,-6,54
Airdrieon,3732,6,15,3,18,59,69,-10,48
East Fife,3732,7,12,10,14,54,47,7,46
Peterhead,3732,8,13,6,17,46,56,-10,45
Queen's Park,3732,9,10,8,18,32,49,-17,38
Stenhousem'r,3732,10,5,5,26,37,81,-44,20
Livingston,3733,1,23,3,10,71,40,31,72
Airdrieon,3733,2,18,5,13,59,56,3,59
Alloa,3733,3,16,8,12,59,45,14,56
Stranraer,3733,4,17,4,15,58,57,1,55
Brechin,3733,5,17,4,15,56,55,1,55
Queen's Park,3733,6,13,8,15,39,51,-12,47
Albion,3733,7,13,7,16,50,53,-3,46
Peterhead,3733,8,13,4,19,50,55,-5,43
East Fife,3733,9,10,9,17,40,45,-5,39
Stenhousem'r,3733,10,11,6,19,58,83,-25,39
Peterhead,3734,1,20,7,9,54,43,11,67
Airdrieon,3734,2,20,4,12,63,54,9,64
Alloa,3734,3,18,6,12,67,45,22,60
Livingston,3734,4,19,2,15,70,48,22,59
Brechin,3734,5,16,7,13,48,51,-3,55
Queen's Park,3734,6,14,9,13,43,48,-5,51
Albion,3734,7,15,5,16,57,57,0,50
East Fife,3734,8,12,7,17,52,53,-1,43
Stranraer,3734,9,12,3,21,46,57,-11,39
Stenhousem'r,3734,10,6,6,24,40,84,-44,24
Livingston,3735,1,22,5,9,74,40,34,71
Alloa,3735,2,18,8,10,66,40,26,62
Albion,3735,3,17,6,13,50,46,4,57
Airdrieon,3735,4,16,7,13,53,51,2,55
Brechin,3735,5,16,6,14,51,47,4,54
Queen's Park,3735,6,13,7,16,34,54,-20,46
Peterhead,3735,7,12,7,17,45,53,-8,43
Stranraer,3735,8,12,5,19,45,57,-12,41
East Fife,3735,9,11,7,18,43,51,-8,40
Stenhousem'r,3735,10,11,6,19,45,67,-22,39
Alloa,3736,1,19,10,7,73,40,33,67
Livingston,3736,2,18,6,12,77,52,25,60
Airdrieon,3736,3,17,6,13,62,53,9,57
Brechin,3736,4,16,5,15,52,65,-13,53
Albion,3736,5,14,9,13,53,47,6,51
Stranraer,3736,6,14,9,13,60,57,3,51
Peterhead,3736,7,14,8,14,54,49,5,50
Queen's Park,3736,8,9,10,17,39,63,-24,37
Stenhousem'r,3736,9,10,7,19,49,90,-41,37
East Fife,3736,10,7,14,15,46,49,-3,35
Livingston,3737,1,25,4,7,84,41,43,79
Alloa,3737,2,22,5,9,72,41,31,71
Brechin,3737,3,18,3,15,59,49,10,57
Queen's Park,3737,4,15,8,13,48,44,4,53
Airdrieon,3737,5,14,7,15,62,58,4,49
Albion,3737,6,13,6,17,47,63,-16,45
Peterhead,3737,7,11,8,17,47,60,-13,41
Stranraer,3737,8,12,5,19,53,71,-18,41
East Fife,3737,9,10,10,16,43,53,-10,40
Stenhousem'r,3737,10,9,6,21,47,82,-35,33
Livingston,3738,1,19,9,8,86,50,36,66
Alloa,3738,2,19,9,8,63,34,29,66
Airdrieon,3738,3,20,6,10,60,49,11,66
Brechin,3738,4,13,10,13,40,43,-3,49
East Fife,3738,5,12,10,14,48,48,0,46
Peterhead,3738,6,12,9,15,46,52,-6,45
Queen's Park,3738,7,11,11,14,36,48,-12,44
Albion,3738,8,11,8,17,50,53,-3,41
Stranraer,3738,9,10,9,17,38,59,-21,39
Stenhousem'r,3738,10,9,7,20,45,76,-31,34
Alloa,3739,1,19,9,8,80,48,32,66
Airdrieon,3739,2,19,5,12,64,59,5,62
Brechin,3739,3,17,8,11,48,45,3,59
Livingston,3739,4,17,7,12,75,52,23,58
Queen's Park,3739,5,16,9,11,48,45,3,57
Albion,3739,6,12,15,9,47,44,3,51
East Fife,3739,7,11,9,16,54,53,1,42
Peterhead,3739,8,10,8,18,44,62,-18,38
Stranraer,3739,9,11,4,21,46,66,-20,37
Stenhousem'r,3739,10,7,8,21,39,71,-32,29
Alloa,3740,1,23,6,7,81,34,47,75
Livingston,3740,2,21,4,11,69,49,20,67
Airdrieon,3740,3,19,6,11,62,49,13,63
Brechin,3740,4,19,6,11,59,50,9,63
Albion,3740,5,14,8,14,54,49,5,50
Stranraer,3740,6,12,8,16,47,56,-9,44
Peterhead,3740,7,11,9,16,47,52,-5,42
Queen's Park,3740,8,12,4,20,34,67,-33,40
East Fife,3740,9,8,10,18,49,55,-6,34
Stenhousem'r,3740,10,7,7,22,42,83,-41,28
Livingston,3741,1,20,4,12,69,50,19,64
Brechin,3741,2,19,7,10,56,45,11,64
Alloa,3741,3,17,11,8,72,45,27,62
Peterhead,3741,4,15,8,13,54,55,-1,53
Albion,3741,5,14,7,15,53,64,-11,49
Airdrieon,3741,6,13,9,14,57,60,-3,48
Queen's Park,3741,7,12,8,16,45,52,-7,44
Stranraer,3741,8,12,7,17,48,58,-10,43
East Fife,3741,9,11,9,16,49,51,-2,42
Stenhousem'r,3741,10,9,6,21,48,71,-23,33
Livingston,3742,1,18,6,12,67,53,14,60
Alloa,3742,2,16,10,10,67,47,20,58
Brechin,3742,3,18,4,14,52,45,7,58
Airdrieon,3742,4,16,7,13,51,52,-1,55
Queen's Park,3742,5,15,8,13,44,43,1,53
Peterhead,3742,6,16,5,15,56,61,-5,53
East Fife,3742,7,14,8,14,53,46,7,50
Albion,3742,8,13,9,14,50,54,-4,48
Stranraer,3742,9,12,6,18,49,57,-8,42
Stenhousem'r,3742,10,6,9,21,43,74,-31,27
Livingston,3743,1,26,2,8,80,41,39,80
Alloa,3743,2,19,6,11,65,46,19,63
Brechin,3743,3,18,6,12,51,48,3,60
Albion,3743,4,15,7,14,56,50,6,52
Airdrieon,3743,5,15,7,14,58,55,3,52
Peterhead,3743,6,13,11,12,52,56,-4,50
East Fife,3743,7,11,7,18,44,53,-9,40
Queen's Park,3743,8,11,7,18,39,55,-16,40
Stranraer,3743,9,11,5,20,46,59,-13,38
Stenhousem'r,3743,10,8,8,20,43,71,-28,32
Alloa,3744,1,20,8,8,67,44,23,68
Livingston,3744,2,19,6,11,71,46,25,63
Albion,3744,3,17,7,12,53,44,9,58
Airdrieon,3744,4,16,8,12,56,48,8,56
Brechin,3744,5,15,7,14,43,44,-1,52
Stranraer,3744,6,14,5,17,47,53,-6,47
East Fife,3744,7,12,9,15,49,48,1,45
Queen's Park,3744,8,12,8,16,35,50,-15,44
Peterhead,3744,9,10,11,15,43,56,-13,41
Stenhousem'r,3744,10,6,9,21,48,79,-31,27
Livingston,3745,1,25,4,7,90,40,50,79
Brechin,3745,2,21,9,6,58,34,24,72
Alloa,3745,3,18,8,10,81,50,31,62
Albion,3745,4,14,8,14,54,61,-7,50
Airdrieon,3745,5,13,8,15,53,65,-12,47
Peterhead,3745,6,10,12,14,50,61,-11,42
East Fife,3745,7,10,10,16,52,52,0,40
Stranraer,3745,8,10,10,16,45,68,-23,40
Queen's Park,3745,9,8,11,17,42,60,-18,35
Stenhousem'r,3745,10,7,8,21,50,84,-34,29
Alloa,3746,1,20,8,8,76,42,34,68
Livingston,3746,2,19,7,10,80,53,27,64
Brechin,3746,3,15,11,10,51,39,12,56
Airdrieon,3746,4,16,8,12,52,48,4,56
Albion,3746,5,14,10,12,49,41,8,52
Peterhead,3746,6,14,9,13,49,58,-9,51
Queen's Park,3746,7,13,4,19,43,65,-22,43
Stenhousem'r,3746,8,11,6,19,47,70,-23,39
Stranraer,3746,9,11,5,20,53,71,-18,38
East Fife,3746,10,8,10,18,45,58,-13,34
Alloa,3747,1,24,5,7,79,29,50,77
Livingston,3747,2,20,6,10,64,41,23,66
Albion,3747,3,17,8,11,58,42,16,59
Airdrieon,3747,4,15,8,13,52,53,-1,53
Brechin,3747,5,15,4,17,40,50,-10,49
Peterhead,3747,6,14,4,18,44,57,-13,46
Queen's Park,3747,7,12,7,17,31,52,-21,43
Stranraer,3747,8,12,5,19,46,51,-5,41
East Fife,3747,9,10,10,16,47,45,2,40
Stenhousem'r,3747,10,9,7,20,44,85,-41,34
Livingston,3748,1,20,6,10,68,43,25,66
Brechin,3748,2,18,8,10,46,36,10,62
Airdrieon,3748,3,16,8,12,63,52,11,56
Alloa,3748,4,16,6,14,66,51,15,54
Albion,3748,5,14,11,11,61,49,12,53
Peterhead,3748,6,13,11,12,61,65,-4,50
Queen's Park,3748,7,11,10,15,33,53,-20,43
Stranraer,3748,8,11,7,18,52,64,-12,40
East Fife,3748,9,9,10,17,52,63,-11,37
Stenhousem'r,3748,10,10,7,19,50,76,-26,37
Alloa,3749,1,21,8,7,78,46,32,71
Livingston,3749,2,20,7,9,73,41,32,67
Brechin,3749,3,19,5,12,60,48,12,62
Airdrieon,3749,4,16,7,13,54,59,-5,55
Peterhead,3749,5,14,7,15,57,56,1,49
Queen's Park,3749,6,12,11,13,42,46,-4,47
Albion,3749,7,11,11,14,53,57,-4,44
Stranraer,3749,8,11,8,17,53,70,-17,41
East Fife,3749,9,8,9,19,44,59,-15,33
Stenhousem'r,3749,10,7,9,20,44,76,-32,30
Alloa,3750,1,20,8,8,77,45,32,68
Livingston,3750,2,20,5,11,67,48,19,65
Stranraer,3750,3,15,7,14,53,50,3,52
Peterhead,3750,4,13,12,11,59,57,2,51
Brechin,3750,5,15,5,16,48,53,-5,50
Airdrieon,3750,6,15,5,16,58,71,-13,50
East Fife,3750,7,11,13,12,47,46,1,46
Albion,3750,8,12,8,16,52,52,0,44
Queen's Park,3750,9,10,11,15,39,48,-9,41
Stenhousem'r,3750,10,8,8,20,54,84,-30,32
Alloa,3751,1,23,7,6,82,45,37,76
Livingston,3751,2,18,7,11,83,53,30,61
Brechin,3751,3,17,7,12,50,47,3,58
Albion,3751,4,15,7,14,64,54,10,52
Peterhead,3751,5,14,10,12,55,53,2,52
Airdrieon,3751,6,14,7,15,49,62,-13,49
East Fife,3751,7,13,7,16,49,51,-2,46
Stranraer,3751,8,13,6,17,58,65,-7,45
Queen's Park,3751,9,13,3,20,40,59,-19,42
Stenhousem'r,3751,10,6,7,23,42,83,-41,25
Alloa,3752,1,21,7,8,76,46,30,70
Livingston,3752,2,19,7,10,74,47,27,64
Airdrieon,3752,3,16,10,10,53,43,10,58
Brechin,3752,4,16,7,13,54,54,0,55
Queen's Park,3752,5,13,10,13,39,43,-4,49
East Fife,3752,6,13,9,14,60,47,13,48
Albion,3752,7,12,8,16,51,60,-9,44
Peterhead,3752,8,12,5,19,48,56,-8,41
Stranraer,3752,9,12,5,19,48,69,-21,41
Stenhousem'r,3752,10,7,10,19,45,83,-38,31
Alloa,3753,1,20,8,8,81,53,28,68
Airdrieon,3753,2,18,9,9,62,52,10,63
Livingston,3753,3,17,9,10,77,53,24,60
Brechin,3753,4,17,3,16,56,48,8,54
Queen's Park,3753,5,14,6,16,51,57,-6,48
Peterhead,3753,6,13,8,15,47,57,-10,47
Albion,3753,7,12,10,14,46,59,-13,46
East Fife,3753,8,11,9,16,55,57,-2,42
Stenhousem'r,3753,9,10,11,15,59,69,-10,41
Stranraer,3753,10,10,3,23,46,75,-29,33
Alloa,3754,1,21,7,8,74,44,30,70
Airdrieon,3754,2,19,7,10,63,50,13,64
Livingston,3754,3,16,10,10,71,50,21,58
Queen's Park,3754,4,13,10,13,39,41,-2,49
Peterhead,3754,5,13,10,13,42,48,-6,49
East Fife,3754,6,12,11,13,61,48,13,47
Brechin,3754,7,14,5,17,47,51,-4,47
Albion,3754,8,12,10,14,50,51,-1,46
Stranraer,3754,9,13,5,18,50,62,-12,44
Stenhousem'r,3754,10,6,7,23,41,93,-52,25
Livingston,3755,1,21,6,9,84,44,40,69
Peterhead,3755,2,19,9,8,55,42,13,66
Albion,3755,3,17,8,11,56,47,9,59
Brechin,3755,4,16,10,10,57,48,9,58
Alloa,3755,5,17,6,13,66,49,17,57
Airdrieon,3755,6,16,7,13,59,55,4,55
Queen's Park,3755,7,13,5,18,39,57,-18,44
Stranraer,3755,8,11,5,20,44,62,-18,38
East Fife,3755,9,8,10,18,43,53,-10,34
Stenhousem'r,3755,10,6,6,24,40,86,-46,24
Alloa,3756,1,21,6,9,76,41,35,69
Livingston,3756,2,21,4,11,76,51,25,67
Brechin,3756,3,18,5,13,54,43,11,59
Airdrieon,3756,4,15,7,14,55,56,-1,52
Queen's Park,3756,5,14,6,16,47,52,-5,48
Peterhead,3756,6,13,9,14,41,47,-6,48
East Fife,3756,7,10,13,13,46,42,4,43
Stranraer,3756,8,13,4,19,49,62,-13,43
Albion,3756,9,11,10,15,46,59,-13,43
Stenhousem'r,3756,10,8,8,20,44,81,-37,32
Livingston,3757,1,25,4,7,79,41,38,79
Alloa,3757,2,20,9,7,75,44,31,69
Airdrieon,3757,3,17,9,10,62,44,18,60
Queen's Park,3757,4,14,8,14,32,43,-11,50
Brechin,3757,5,14,6,16,52,53,-1,48
Albion,3757,6,13,7,16,59,60,-1,46
Stranraer,3757,7,12,5,19,46,64,-18,41
East Fife,3757,8,10,10,16,44,51,-7,40
Peterhead,3757,9,8,15,13,47,57,-10,39
Stenhousem'r,3757,10,7,7,22,40,79,-39,28
Livingston,3758,1,23,6,7,81,39,42,75
Alloa,3758,2,18,9,9,68,48,20,63
Airdrieon,3758,3,18,8,10,68,52,16,62
Brechin,3758,4,15,7,14,60,54,6,52
Peterhead,3758,5,14,10,12,52,51,1,52
East Fife,3758,6,13,9,14,51,49,2,48
Albion,3758,7,11,13,12,46,52,-6,46
Queen's Park,3758,8,11,8,17,38,55,-17,41
Stenhousem'r,3758,9,8,7,21,44,82,-38,31
Stranraer,3758,10,8,5,23,49,75,-26,29
Livingston,3759,1,25,3,8,87,48,39,78
Brechin,3759,2,21,3,12,53,49,4,66
Airdrieon,3759,3,19,5,12,65,56,9,62
Albion,3759,4,16,7,13,58,44,14,55
Alloa,3759,5,15,7,14,64,51,13,52
Peterhead,3759,6,14,9,13,61,56,5,51
Stranraer,3759,7,14,4,18,49,55,-6,46
East Fife,3759,8,10,10,16,52,50,2,40
Queen's Park,3759,9,10,8,18,38,68,-30,38
Stenhousem'r,3759,10,5,6,25,43,93,-50,21
Livingston,3760,1,19,8,9,76,48,28,65
Alloa,3760,2,18,11,7,71,43,28,65
Brechin,3760,3,16,6,14,51,44,7,54
East Fife,3760,4,14,12,10,48,42,6,54
Albion,3760,5,13,10,13,50,49,1,49
Airdrieon,3760,6,13,10,13,59,64,-5,49
Peterhead,3760,7,14,6,16,53,53,0,48
Stranraer,3760,8,12,7,17,55,64,-9,43
Queen's Park,3760,9,11,10,15,39,54,-15,43
Stenhousem'r,3760,10,5,10,21,45,86,-41,25
Airdrieon,3761,1,18,6,12,55,45,10,60
Livingston,3761,2,19,2,15,73,55,18,59
Brechin,3761,3,17,8,11,63,54,9,59
Alloa,3761,4,17,6,13,66,45,21,57
Stranraer,3761,5,17,4,15,60,52,8,55
East Fife,3761,6,14,8,14,50,45,5,50
Albion,3761,7,14,5,17,57,71,-14,47
Queen's Park,3761,8,13,8,15,46,60,-14,47
Peterhead,3761,9,12,5,19,40,53,-13,41
Stenhousem'r,3761,10,10,6,20,53,83,-30,36
Livingston,3762,1,24,6,6,88,45,43,78
Alloa,3762,2,21,7,8,73,38,35,70
Brechin,3762,3,19,6,11,61,44,17,63
Queen's Park,3762,4,14,8,14,45,48,-3,50
Airdrieon,3762,5,14,6,16,50,65,-15,48
Stranraer,3762,6,13,7,16,47,54,-7,46
Peterhead,3762,7,12,9,15,47,54,-7,45
East Fife,3762,8,11,10,15,52,48,4,43
Albion,3762,9,12,6,18,49,67,-18,42
Stenhousem'r,3762,10,3,9,24,34,83,-49,18
Livingston,3763,1,24,1,11,86,48,38,73
Airdrieon,3763,2,18,6,12,72,63,9,60
Brechin,3763,3,16,7,13,42,40,2,55
Alloa,3763,4,14,9,13,73,63,10,51
Albion,3763,5,14,8,14,51,45,6,50
Stenhousem'r,3763,6,13,9,14,50,63,-13,48
Queen's Park,3763,7,14,5,17,41,51,-10,47
Stranraer,3763,8,12,9,15,50,63,-13,45
East Fife,3763,9,11,9,16,52,56,-4,42
Peterhead,3763,10,10,5,21,42,67,-25,35
Livingston,3764,1,22,6,8,76,41,35,72
Alloa,3764,2,19,5,12,63,46,17,62
Brechin,3764,3,16,11,9,57,43,14,59
Peterhead,3764,4,18,5,13,46,41,5,59
Airdrieon,3764,5,16,7,13,60,52,8,55
East Fife,3764,6,13,6,17,49,46,3,45
Albion,3764,7,12,9,15,46,53,-7,45
Queen's Park,3764,8,10,10,16,34,47,-13,40
Stranraer,3764,9,10,8,18,42,64,-22,38
Stenhousem'r,3764,10,6,9,21,40,80,-40,27
Airdrieon,3765,1,22,5,9,63,42,21,71
Alloa,3765,2,21,5,10,67,40,27,68
Livingston,3765,3,20,2,14,68,45,23,62
Brechin,3765,4,17,6,13,44,40,4,57
Albion,3765,5,15,6,15,52,53,-1,51
Peterhead,3765,6,14,5,17,53,63,-10,47
Queen's Park,3765,7,14,5,17,33,52,-19,47
Stranraer,3765,8,12,5,19,54,61,-7,41
East Fife,3765,9,10,10,16,49,51,-2,40
Stenhousem'r,3765,10,7,7,22,46,82,-36,28
Peterhead,3766,1,17,9,10,59,48,11,60
Brechin,3766,2,17,9,10,51,42,9,60
Airdrieon,3766,3,18,6,12,56,51,5,60
Alloa,3766,4,16,10,10,59,47,12,58
Livingston,3766,5,15,10,11,76,52,24,55
Albion,3766,6,12,13,11,58,58,0,49
Stranraer,3766,7,12,7,17,56,56,0,43
Queen's Park,3766,8,11,7,18,38,56,-18,40
East Fife,3766,9,9,10,17,41,53,-12,37
Stenhousem'r,3766,10,9,7,20,51,82,-31,34
Alloa,3767,1,20,7,9,89,45,44,67
Livingston,3767,2,22,1,13,77,49,28,67
Brechin,3767,3,20,1,15,53,56,-3,61
Peterhead,3767,4,14,10,12,51,48,3,52
Airdrieon,3767,5,15,5,16,52,62,-10,50
Stranraer,3767,6,14,6,16,58,55,3,48
East Fife,3767,7,13,7,16,53,50,3,46
Queen's Park,3767,8,12,8,16,41,55,-14,44
Albion,3767,9,10,8,18,40,60,-20,38
Stenhousem'r,3767,10,10,7,19,43,77,-34,37
Livingston,3768,1,23,2,11,72,45,27,71
Alloa,3768,2,18,10,8,62,41,21,64
Brechin,3768,3,18,9,9,61,46,15,63
Queen's Park,3768,4,16,8,12,46,42,4,56
Airdrieon,3768,5,16,6,14,61,57,4,54
Albion,3768,6,14,8,14,50,48,2,50
Stranraer,3768,7,13,7,16,48,53,-5,46
East Fife,3768,8,10,9,17,51,57,-6,39
Peterhead,3768,9,10,7,19,44,56,-12,37
Stenhousem'r,3768,10,5,8,23,43,93,-50,23
Airdrieon,3769,1,19,7,10,58,52,6,64
Alloa,3769,2,17,8,11,64,42,22,59
Brechin,3769,3,16,10,10,50,40,10,58
Peterhead,3769,4,17,7,12,46,37,9,58
Livingston,3769,5,17,6,13,60,45,15,57
Albion,3769,6,13,9,14,48,47,1,48
Stranraer,3769,7,14,5,17,52,55,-3,47
East Fife,3769,8,12,10,14,47,49,-2,46
Queen's Park,3769,9,9,8,19,32,53,-21,35
Stenhousem'r,3769,10,8,6,22,37,74,-37,30
Livingston,3770,1,23,4,9,80,47,33,73
Alloa,3770,2,17,8,11,67,50,17,59
Airdrieon,3770,3,17,5,14,60,52,8,56
Peterhead,3770,4,14,11,11,55,52,3,53
Brechin,3770,5,16,5,15,52,58,-6,53
Albion,3770,6,13,12,11,52,48,4,51
East Fife,3770,7,10,11,15,44,43,1,41
Queen's Park,3770,8,11,8,17,38,53,-15,41
Stranraer,3770,9,10,8,18,53,66,-13,38
Stenhousem'r,3770,10,9,8,19,44,76,-32,35
Alloa,3771,1,20,9,7,74,43,31,69
Livingston,3771,2,19,3,14,72,56,16,60
Albion,3771,3,16,8,12,51,38,13,56
Stranraer,3771,4,17,5,14,51,47,4,56
Peterhead,3771,5,15,8,13,49,53,-4,53
Brechin,3771,6,13,9,14,46,54,-8,48
Airdrieon,3771,7,13,6,17,49,62,-13,45
East Fife,3771,8,10,11,15,51,48,3,41
Stenhousem'r,3771,9,10,9,17,45,63,-18,39
Queen's Park,3771,10,10,6,20,28,52,-24,36
Livingston,3772,1,20,5,11,75,52,23,65
Alloa,3772,2,18,9,9,67,44,23,63
Peterhead,3772,3,16,10,10,52,44,8,58
Stranraer,3772,4,17,4,15,57,59,-2,55
Airdrieon,3772,5,16,5,15,55,52,3,53
Brechin,3772,6,15,7,14,58,52,6,52
Queen's Park,3772,7,15,5,16,42,48,-6,50
Albion,3772,8,13,5,18,50,59,-9,44
East Fife,3772,9,8,11,17,42,55,-13,35
Stenhousem'r,3772,10,7,9,20,46,79,-33,30
Livingston,3773,1,23,2,11,82,51,31,71
Brechin,3773,2,18,7,11,53,47,6,61
Alloa,3773,3,17,8,11,75,47,28,59
Airdrieon,3773,4,16,9,11,61,55,6,57
Albion,3773,5,16,6,14,61,55,6,54
East Fife,3773,6,11,13,12,48,45,3,46
Peterhead,3773,7,13,7,16,53,61,-8,46
Queen's Park,3773,8,12,6,18,37,59,-22,42
Stranraer,3773,9,12,3,21,54,67,-13,39
Stenhousem'r,3773,10,8,7,21,49,86,-37,31
Livingston,3774,1,22,5,9,78,51,27,71
Airdrieon,3774,2,20,5,11,59,45,14,65
Alloa,3774,3,18,6,12,62,41,21,60
Brechin,3774,4,17,7,12,57,51,6,58
Albion,3774,5,16,8,12,53,39,14,56
Peterhead,3774,6,15,7,14,50,54,-4,52
Stranraer,3774,7,12,9,15,41,48,-7,45
Queen's Park,3774,8,11,6,19,37,50,-13,39
East Fife,3774,9,8,12,16,44,56,-12,36
Stenhousem'r,3774,10,4,9,23,44,90,-46,21
Livingston,3775,1,22,4,10,79,46,33,70
Alloa,3775,2,16,13,7,63,40,23,61
Airdrieon,3775,3,18,5,13,54,52,2,59
Brechin,3775,4,15,8,13,48,49,-1,53
Peterhead,3775,5,14,10,12,52,51,1,52
Albion,3775,6,14,9,13,52,50,2,51
Queen's Park,3775,7,12,10,14,35,50,-15,46
East Fife,3775,8,12,7,17,49,52,-3,43
Stranraer,3775,9,11,8,17,46,52,-6,41
Stenhousem'r,3775,10,5,8,23,40,76,-36,23
Livingston,3776,1,20,7,9,79,46,33,67
Airdrieon,3776,2,18,7,11,68,55,13,61
Alloa,3776,3,15,9,12,64,50,14,54
Peterhead,3776,4,15,9,12,56,51,5,54
Albion,3776,5,12,11,13,55,59,-4,47
Stenhousem'r,3776,6,13,7,16,53,68,-15,46
Brechin,3776,7,13,7,16,40,59,-19,46
East Fife,3776,8,11,9,16,56,56,0,42
Queen's Park,3776,9,11,9,16,33,48,-15,42
Stranraer,3776,10,12,5,19,43,55,-12,41
Livingston,3777,1,20,5,11,73,49,24,65
Alloa,3777,2,17,8,11,71,51,20,59
Airdrieon,3777,3,17,7,12,63,54,9,58
Peterhead,3777,4,16,9,11,47,40,7,57
Brechin,3777,5,17,5,14,50,51,-1,56
Stranraer,3777,6,14,7,15,55,58,-3,49
Queen's Park,3777,7,12,6,18,39,56,-17,42
East Fife,3777,8,10,10,16,54,56,-2,40
Stenhousem'r,3777,9,10,9,17,52,74,-22,39
Albion,3777,10,9,10,17,46,61,-15,37
Alloa,3778,1,18,8,10,69,47,22,62
Brechin,3778,2,18,8,10,55,43,12,62
Airdrieon,3778,3,17,10,9,62,48,14,61
Livingston,3778,4,16,8,12,69,46,23,56
Peterhead,3778,5,16,6,14,50,50,0,54
Albion,3778,6,12,10,14,54,57,-3,46
Queen's Park,3778,7,11,11,14,37,46,-9,44
Stenhousem'r,3778,8,11,7,18,47,75,-28,40
Stranraer,3778,9,12,3,21,49,66,-17,39
East Fife,3778,10,9,9,18,38,52,-14,36
Livingston,3779,1,21,9,6,77,42,35,72
Airdrieon,3779,2,20,7,9,69,44,25,67
Alloa,3779,3,20,6,10,80,48,32,66
Brechin,3779,4,15,10,11,56,54,2,55
Albion,3779,5,13,8,15,56,55,1,47
Stranraer,3779,6,11,11,14,59,61,-2,44
East Fife,3779,7,10,12,14,55,48,7,42
Peterhead,3779,8,10,9,17,39,61,-22,39
Queen's Park,3779,9,9,7,20,33,65,-32,34
Stenhousem'r,3779,10,8,7,21,42,88,-46,31
Livingston,3780,1,21,5,10,72,51,21,68
Alloa,3780,2,20,7,9,66,36,30,67
Brechin,3780,3,20,4,12,63,47,16,64
Airdrieon,3780,4,17,6,13,61,51,10,57
Albion,3780,5,16,8,12,59,51,8,56
Peterhead,3780,6,13,7,16,41,52,-11,46
Queen's Park,3780,7,14,4,18,37,51,-14,46
Stranraer,3780,8,11,9,16,49,56,-7,42
East Fife,3780,9,7,14,15,46,54,-8,35
Stenhousem'r,3780,10,6,6,24,39,84,-45,24
Alloa,3781,1,19,8,9,68,35,33,65
Livingston,3781,2,20,5,11,76,53,23,65
Airdrieon,3781,3,17,7,12,65,55,10,58
Brechin,3781,4,17,6,13,50,49,1,57
Albion,3781,5,13,9,14,55,56,-1,48
Stranraer,3781,6,14,6,16,50,55,-5,48
Peterhead,3781,7,12,11,13,40,48,-8,47
East Fife,3781,8,11,10,15,45,46,-1,43
Queen's Park,3781,9,12,7,17,38,52,-14,43
Stenhousem'r,3781,10,7,7,22,49,87,-38,28
Livingston,3782,1,23,4,9,84,48,36,73
Airdrieon,3782,2,20,4,12,69,52,17,64
Alloa,3782,3,17,10,9,74,47,27,61
Brechin,3782,4,16,7,13,45,41,4,55
Peterhead,3782,5,14,8,14,52,57,-5,50
Albion,3782,6,13,7,16,45,60,-15,46
East Fife,3782,7,12,9,15,47,43,4,45
Queen's Park,3782,8,12,7,17,36,51,-15,43
Stranraer,3782,9,12,4,20,46,64,-18,40
Stenhousem'r,3782,10,7,8,21,41,76,-35,29
Alloa,3783,1,20,6,10,65,39,26,66
Livingston,3783,2,19,5,12,75,56,19,62
Brechin,3783,3,17,8,11,53,43,10,59
Peterhead,3783,4,16,7,13,63,53,10,55
Airdrieon,3783,5,15,7,14,55,59,-4,52
Stranraer,3783,6,15,6,15,52,59,-7,51
Albion,3783,7,14,8,14,49,43,6,50
East Fife,3783,8,12,8,16,45,46,-1,44
Queen's Park,3783,9,10,7,19,29,58,-29,37
Stenhousem'r,3783,10,7,8,21,48,78,-30,29
Livingston,3784,1,20,4,12,90,51,39,64
Airdrieon,3784,2,18,8,10,58,56,2,62
Alloa,3784,3,18,6,12,70,51,19,60
Brechin,3784,4,15,10,11,56,48,8,55
Peterhead,3784,5,14,9,13,52,54,-2,51
Albion,3784,6,14,8,14,53,53,0,50
Queen's Park,3784,7,14,8,14,40,47,-7,50
Stranraer,3784,8,10,10,16,49,63,-14,40
East Fife,3784,9,9,10,17,43,51,-8,37
Stenhousem'r,3784,10,9,5,22,43,80,-37,32
Livingston,3785,1,23,4,9,84,52,32,73
Airdrieon,3785,2,22,4,10,73,48,25,70
Alloa,3785,3,17,8,11,63,43,20,59
East Fife,3785,4,15,11,10,58,46,12,56
Albion,3785,5,14,8,14,58,56,2,50
Brechin,3785,6,15,5,16,52,61,-9,50
Peterhead,3785,7,14,7,15,50,50,0,49
Queen's Park,3785,8,12,6,18,40,53,-13,42
Stranraer,3785,9,10,8,18,52,70,-18,38
Stenhousem'r,3785,10,6,3,27,40,91,-51,21
Brechin,3786,1,18,8,10,51,38,13,62
Airdrieon,3786,2,18,7,11,63,59,4,61
Alloa,3786,3,18,6,12,65,42,23,60
Livingston,3786,4,16,9,11,82,57,25,57
Albion,3786,5,16,7,13,54,51,3,55
Stranraer,3786,6,16,6,14,59,62,-3,54
Queen's Park,3786,7,16,5,15,48,45,3,53
Peterhead,3786,8,14,5,17,50,60,-10,47
East Fife,3786,9,7,11,18,48,60,-12,32
Stenhousem'r,3786,10,5,8,23,42,88,-46,23
Livingston,3787,1,19,2,15,61,55,6,59
Airdrieon,3787,2,17,7,12,54,49,5,58
Alloa,3787,3,16,9,11,70,51,19,57
Albion,3787,4,16,5,15,54,48,6,53
Brechin,3787,5,15,8,13,48,46,2,53
Peterhead,3787,6,13,11,12,50,50,0,50
East Fife,3787,7,12,11,13,45,40,5,47
Stranraer,3787,8,13,6,17,48,56,-8,45
Queen's Park,3787,9,11,9,16,40,56,-16,42
Stenhousem'r,3787,10,8,12,16,49,68,-19,36
Albion,3788,1,19,5,12,63,53,10,62
Alloa,3788,2,18,7,11,70,49,21,61
Livingston,3788,3,18,4,14,67,52,15,58
Airdrieon,3788,4,15,9,12,62,56,6,54
Brechin,3788,5,16,4,16,48,50,-2,52
Queen's Park,3788,6,15,6,15,42,50,-8,51
East Fife,3788,7,12,10,14,46,46,0,46
Stranraer,3788,8,12,7,17,49,60,-11,43
Peterhead,3788,9,11,9,16,45,55,-10,42
Stenhousem'r,3788,10,10,7,19,45,66,-21,37
Alloa,3789,1,23,7,6,81,41,40,76
Livingston,3789,2,20,7,9,72,44,28,67
Albion,3789,3,18,10,8,52,43,9,64
Airdrieon,3789,4,18,8,10,62,51,11,62
Brechin,3789,5,16,6,14,55,53,2,54
East Fife,3789,6,11,12,13,45,43,2,45
Stranraer,3789,7,12,7,17,49,57,-8,43
Peterhead,3789,8,10,10,16,50,66,-16,40
Queen's Park,3789,9,9,6,21,28,54,-26,33
Stenhousem'r,3789,10,3,7,26,32,74,-42,16
Livingston,3790,1,21,5,10,70,47,23,68
East Fife,3790,2,18,10,8,66,38,28,64
Alloa,3790,3,17,7,12,73,48,25,58
Brechin,3790,4,17,7,12,50,47,3,58
Airdrieon,3790,5,13,9,14,43,49,-6,48
Queen's Park,3790,6,13,7,16,34,52,-18,46
Albion,3790,7,12,9,15,57,61,-4,45
Peterhead,3790,8,10,11,15,45,55,-10,41
Stranraer,3790,9,12,4,20,46,59,-13,40
Stenhousem'r,3790,10,7,11,18,46,74,-28,32
Livingston,3791,1,21,6,9,80,50,30,69
Airdrieon,3791,2,18,7,11,65,50,15,61
Alloa,3791,3,17,7,12,68,47,21,58
East Fife,3791,4,14,9,13,52,44,8,51
Albion,3791,5,15,6,15,57,60,-3,51
Brechin,3791,6,13,10,13,41,46,-5,49
Peterhead,3791,7,13,9,14,49,54,-5,48
Queen's Park,3791,8,13,7,16,47,56,-9,46
Stenhousem'r,3791,9,8,11,17,53,79,-26,35
Stranraer,3791,10,10,4,22,46,72,-26,34
Alloa,3792,1,22,7,7,86,42,44,73
Airdrieon,3792,2,17,5,14,58,53,5,56
Brechin,3792,3,16,8,12,52,56,-4,56
Livingston,3792,4,15,5,16,67,58,9,50
Albion,3792,5,14,7,15,52,51,1,49
Peterhead,3792,6,13,10,13,58,59,-1,49
Stranraer,3792,7,14,5,17,56,59,-3,47
Queen's Park,3792,8,13,7,16,39,60,-21,46
East Fife,3792,9,10,10,16,50,57,-7,40
Stenhousem'r,3792,10,11,6,19,53,76,-23,39
Alloa,3793,1,22,7,7,75,38,37,73
Livingston,3793,2,21,2,13,84,51,33,65
Airdrieon,3793,3,19,6,11,63,62,1,63
Brechin,3793,4,17,5,14,60,62,-2,56
Peterhead,3793,5,15,5,16,52,61,-9,50
Albion,3793,6,13,5,18,55,56,-1,44
Stranraer,3793,7,13,5,18,57,64,-7,44
Queen's Park,3793,8,13,5,18,37,55,-18,44
East Fife,3793,9,10,8,18,44,56,-12,38
Stenhousem'r,3793,10,9,8,19,57,79,-22,35
Livingston,3794,1,22,6,8,78,43,35,72
Brechin,3794,2,19,6,11,50,41,9,63
Alloa,3794,3,17,10,9,64,38,26,61
Peterhead,3794,4,15,10,11,51,45,6,55
Albion,3794,5,13,11,12,52,53,-1,50
Airdrieon,3794,6,14,6,16,50,61,-11,48
Queen's Park,3794,7,12,7,17,41,56,-15,43
Stranraer,3794,8,12,4,20,51,60,-9,40
Stenhousem'r,3794,9,10,9,17,51,72,-21,39
East Fife,3794,10,7,9,20,46,65,-19,30
Livingston,3795,1,22,5,9,85,46,39,71
Brechin,3795,2,20,6,10,57,42,15,66
Airdrieon,3795,3,20,4,12,64,55,9,64
Albion,3795,4,17,8,11,70,52,18,59
East Fife,3795,5,15,8,13,50,43,7,53
Alloa,3795,6,15,8,13,62,56,6,53
Peterhead,3795,7,14,8,14,48,45,3,50
Stranraer,3795,8,11,5,20,41,62,-21,38
Queen's Park,3795,9,8,5,23,34,74,-40,29
Stenhousem'r,3795,10,6,7,23,41,77,-36,25
Livingston,3796,1,21,8,7,76,40,36,71
Alloa,3796,2,21,3,12,65,47,18,66
Albion,3796,3,17,9,10,60,48,12,60
Brechin,3796,4,18,5,13,54,43,11,59
Airdrieon,3796,5,17,6,13,57,53,4,57
Peterhead,3796,6,11,10,15,43,50,-7,43
East Fife,3796,7,12,6,18,49,49,0,42
Queen's Park,3796,8,12,5,19,31,49,-18,41
Stenhousem'r,3796,9,10,5,21,46,81,-35,35
Stranraer,3796,10,9,7,20,41,62,-21,34
Livingston,3797,1,20,5,11,78,52,26,65
Airdrieon,3797,2,19,7,10,61,49,12,64
Stranraer,3797,3,18,3,15,58,58,0,57
Alloa,3797,4,15,7,14,67,53,14,52
Brechin,3797,5,15,7,14,50,49,1,52
Peterhead,3797,6,15,6,15,55,57,-2,51
East Fife,3797,7,13,8,15,65,56,9,47
Queen's Park,3797,8,13,7,16,33,48,-15,46
Albion,3797,9,11,9,16,51,60,-9,42
Stenhousem'r,3797,10,9,5,22,46,82,-36,32
Livingston,3798,1,23,4,9,76,47,29,73
Airdrieon,3798,2,19,7,10,58,47,11,64
Alloa,3798,3,18,7,11,74,50,24,61
Brechin,3798,4,16,4,16,51,52,-1,52
Albion,3798,5,14,8,14,51,50,1,50
Queen's Park,3798,6,14,6,16,44,54,-10,48
Stranraer,3798,7,13,8,15,53,59,-6,47
Peterhead,3798,8,10,12,14,52,54,-2,42
East Fife,3798,9,9,9,18,44,54,-10,36
Stenhousem'r,3798,10,8,7,21,49,85,-36,31
Livingston,3799,1,24,3,9,85,41,44,75
Alloa,3799,2,18,12,6,66,38,28,66
Brechin,3799,3,18,9,9,48,38,10,63
Peterhead,3799,4,17,7,12,51,42,9,58
Airdrieon,3799,5,14,11,11,50,44,6,53
Albion,3799,6,15,7,14,48,56,-8,52
East Fife,3799,7,10,9,17,44,51,-7,39
Stranraer,3799,8,9,9,18,42,58,-16,36
Queen's Park,3799,9,8,7,21,29,61,-32,31
Stenhousem'r,3799,10,8,4,24,46,80,-34,28
Alloa,3800,1,18,11,7,71,43,28,65
Livingston,3800,2,20,3,13,83,49,34,63
Airdrieon,3800,3,17,6,13,59,61,-2,57
Peterhead,3800,4,16,7,13,54,49,5,55
Queen's Park,3800,5,15,5,16,39,53,-14,50
East Fife,3800,6,13,10,13,56,52,4,49
Brechin,3800,7,15,4,17,53,56,-3,49
Albion,3800,8,12,10,14,59,61,-2,46
Stranraer,3800,9,12,5,19,61,73,-12,41
Stenhousem'r,3800,10,6,11,19,49,87,-38,29
Livingston,3801,1,25,0,11,81,41,40,75
Alloa,3801,2,18,7,11,68,50,18,61
Albion,3801,3,17,6,13,59,46,13,57
Airdrieon,3801,4,17,5,14,54,50,4,56
Peterhead,3801,5,16,5,15,45,51,-6,53
Stranraer,3801,6,15,5,16,48,53,-5,50
Brechin,3801,7,15,5,16,43,49,-6,50
Queen's Park,3801,8,12,7,17,41,51,-10,43
East Fife,3801,9,8,11,17,37,52,-15,35
Stenhousem'r,3801,10,7,9,20,46,79,-33,30
Livingston,3802,1,24,6,6,91,40,51,78
Alloa,3802,2,22,6,8,85,41,44,72
Brechin,3802,3,18,7,11,58,45,13,61
Airdrieon,3802,4,15,9,12,49,53,-4,54
Albion,3802,5,13,9,14,51,55,-4,48
East Fife,3802,6,12,11,13,50,47,3,47
Queen's Park,3802,7,11,7,18,39,68,-29,40
Peterhead,3802,8,11,6,19,46,67,-21,39
Stranraer,3802,9,10,6,20,58,71,-13,36
Stenhousem'r,3802,10,7,7,22,38,78,-40,28
Alloa,3803,1,21,6,9,80,41,39,69
Livingston,3803,2,21,4,11,75,43,32,67
Albion,3803,3,17,6,13,64,57,7,57
Brechin,3803,4,16,8,12,55,51,4,56
Airdrieon,3803,5,15,9,12,53,53,0,54
Peterhead,3803,6,13,9,14,46,45,1,48
East Fife,3803,7,12,8,16,38,45,-7,44
Queen's Park,3803,8,11,6,19,37,52,-15,39
Stranraer,3803,9,9,9,18,35,59,-24,36
Stenhousem'r,3803,10,9,7,20,46,83,-37,34
Livingston,3804,1,22,5,9,73,42,31,71
Alloa,3804,2,21,6,9,77,46,31,69
Albion,3804,3,18,6,12,57,47,10,60
Brechin,3804,4,17,6,13,48,42,6,57
Peterhead,3804,5,15,9,12,55,51,4,54
Queen's Park,3804,6,14,6,16,38,49,-11,48
Airdrieon,3804,7,13,7,16,51,61,-10,46
East Fife,3804,8,12,7,17,41,48,-7,43
Stranraer,3804,9,12,5,19,53,59,-6,41
Stenhousem'r,3804,10,6,3,27,40,88,-48,21
Livingston,3805,1,21,6,9,80,47,33,69
Alloa,3805,2,17,9,10,66,52,14,60
Albion,3805,3,14,12,10,67,52,15,54
Brechin,3805,4,15,8,13,47,42,5,53
Airdrieon,3805,5,13,8,15,53,65,-12,47
Peterhead,3805,6,11,13,12,44,50,-6,46
Queen's Park,3805,7,13,7,16,41,55,-14,46
East Fife,3805,8,12,9,15,47,52,-5,45
Stranraer,3805,9,11,5,20,49,67,-18,38
Stenhousem'r,3805,10,8,13,15,52,64,-12,37
Livingston,3806,1,21,2,13,78,53,25,65
Airdrieon,3806,2,18,8,10,62,52,10,62
Alloa,3806,3,17,10,9,58,39,19,61
Albion,3806,4,14,12,10,52,40,12,54
Brechin,3806,5,16,5,15,47,50,-3,53
Stranraer,3806,6,13,6,17,48,59,-11,45
Peterhead,3806,7,12,8,16,48,50,-2,44
East Fife,3806,8,12,8,16,41,45,-4,44
Queen's Park,3806,9,13,5,18,36,46,-10,44
Stenhousem'r,3806,10,7,10,19,42,78,-36,31
Alloa,3807,1,19,8,9,73,40,33,65
Brechin,3807,2,18,9,9,61,49,12,63
Livingston,3807,3,17,9,10,72,55,17,60
Airdrieon,3807,4,16,7,13,64,60,4,55
Albion,3807,5,14,9,13,60,55,5,51
East Fife,3807,6,13,11,12,51,44,7,50
Peterhead,3807,7,11,9,16,42,53,-11,42
Stenhousem'r,3807,8,11,9,16,54,68,-14,42
Queen's Park,3807,9,9,8,19,35,64,-29,35
Stranraer,3807,10,9,7,20,39,63,-24,34
Livingston,3808,1,20,5,11,81,52,29,65
Alloa,3808,2,19,7,10,77,45,32,64
Airdrieon,3808,3,17,10,9,55,40,15,61
Albion,3808,4,17,10,9,53,46,7,61
Queen's Park,3808,5,15,7,14,38,47,-9,52
East Fife,3808,6,12,10,14,48,46,2,46
Peterhead,3808,7,13,7,16,54,58,-4,46
Stranraer,3808,8,11,7,18,48,62,-14,40
Brechin,3808,9,12,4,20,43,59,-16,40
Stenhousem'r,3808,10,8,5,23,46,88,-42,29
Alloa,3809,1,21,7,8,70,39,31,70
Albion,3809,2,19,6,11,55,40,15,63
Livingston,3809,3,19,2,15,66,58,8,59
Airdrieon,3809,4,16,9,11,57,55,2,57
Brechin,3809,5,15,5,16,45,44,1,50
Queen's Park,3809,6,14,7,15,41,49,-8,49
East Fife,3809,7,10,12,14,46,42,4,42
Peterhead,3809,8,11,8,17,47,61,-14,41
Stranraer,3809,9,12,3,21,54,65,-11,39
Stenhousem'r,3809,10,10,7,19,46,74,-28,37
Alloa,3810,1,22,6,8,88,42,46,72
Brechin,3810,2,22,4,10,66,42,24,70
Livingston,3810,3,20,5,11,67,40,27,65
Airdrieon,3810,4,17,6,13,64,52,12,57
Peterhead,3810,5,14,9,13,58,50,8,51
Albion,3810,6,13,7,16,50,53,-3,46
Stranraer,3810,7,13,4,19,50,65,-15,43
Queen's Park,3810,8,12,6,18,33,58,-25,42
East Fife,3810,9,10,6,20,38,59,-21,36
Stenhousem'r,3810,10,9,3,24,41,94,-53,30
Alloa,3811,1,19,8,9,74,45,29,65
Albion,3811,2,17,8,11,66,52,14,59
Brechin,3811,3,18,5,13,58,48,10,59
Livingston,3811,4,17,6,13,61,50,11,57
Airdrieon,3811,5,15,7,14,60,64,-4,52
Queen's Park,3811,6,14,8,14,40,46,-6,50
East Fife,3811,7,12,11,13,44,42,2,47
Peterhead,3811,8,12,11,13,55,59,-4,47
Stranraer,3811,9,12,6,18,50,61,-11,42
Stenhousem'r,3811,10,5,8,23,42,83,-41,23
Livingston,3812,1,18,8,10,79,47,32,62
Albion,3812,2,17,7,12,67,52,15,58
Peterhead,3812,3,16,8,12,56,51,5,56
Brechin,3812,4,15,9,12,50,56,-6,54
Airdrieon,3812,5,14,9,13,53,56,-3,51
Alloa,3812,6,14,7,15,57,51,6,49
Queen's Park,3812,7,14,7,15,39,48,-9,49
East Fife,3812,8,12,10,14,46,50,-4,46
Stranraer,3812,9,10,11,15,55,60,-5,41
Stenhousem'r,3812,10,7,10,19,49,80,-31,31
Livingston,3813,1,22,4,10,81,44,37,70
Alloa,3813,2,20,6,10,62,39,23,66
Brechin,3813,3,20,6,10,59,39,20,66
Airdrieon,3813,4,18,7,11,57,49,8,61
Albion,3813,5,16,9,11,58,50,8,57
Peterhead,3813,6,14,6,16,43,51,-8,48
East Fife,3813,7,11,10,15,49,49,0,43
Queen's Park,3813,8,10,8,18,30,46,-16,38
Stranraer,3813,9,11,4,21,38,62,-24,37
Stenhousem'r,3813,10,4,8,24,37,85,-48,20
Livingston,3814,1,21,5,10,79,47,32,68
Airdrieon,3814,2,18,11,7,60,45,15,65
Alloa,3814,3,19,7,10,71,46,25,64
Brechin,3814,4,17,5,14,54,54,0,56
Stranraer,3814,5,15,3,18,51,60,-9,48
Albion,3814,6,12,11,13,58,53,5,47
East Fife,3814,7,11,11,14,47,47,0,44
Stenhousem'r,3814,8,10,10,16,48,68,-20,40
Peterhead,3814,9,9,8,19,34,57,-23,35
Queen's Park,3814,10,8,9,19,33,58,-25,33
Alloa,3815,1,21,6,9,69,37,32,69
Livingston,3815,2,21,5,10,71,43,28,68
Airdrieon,3815,3,18,7,11,59,49,10,61
Brechin,3815,4,18,3,15,45,51,-6,57
Albion,3815,5,15,8,13,55,49,6,53
Peterhead,3815,6,13,11,12,49,47,2,50
Stranraer,3815,7,11,7,18,57,71,-14,40
East Fife,3815,8,9,9,18,42,56,-14,36
Queen's Park,3815,9,10,6,20,41,56,-15,36
Stenhousem'r,3815,10,10,6,20,46,75,-29,36
Livingston,3816,1,22,6,8,79,47,32,72
Alloa,3816,2,21,7,8,73,38,35,70
Brechin,3816,3,19,3,14,50,49,1,60
Albion,3816,4,16,6,14,58,54,4,54
Airdrieon,3816,5,15,8,13,54,54,0,53
Peterhead,3816,6,15,7,14,49,50,-1,52
East Fife,3816,7,11,10,15,53,57,-4,43
Queen's Park,3816,8,12,6,18,33,51,-18,42
Stenhousem'r,3816,9,7,9,20,54,76,-22,30
Stranraer,3816,10,8,6,22,41,68,-27,30
Alloa,3817,1,20,8,8,65,35,30,68
Livingston,3817,2,16,8,12,66,58,8,56
Airdrieon,3817,3,15,8,13,53,53,0,53
East Fife,3817,4,13,10,13,52,50,2,49
Peterhead,3817,5,14,7,15,49,55,-6,49
Brechin,3817,6,13,8,15,53,54,-1,47
Queen's Park,3817,7,11,13,12,41,47,-6,46
Albion,3817,8,11,12,13,52,50,2,45
Stranraer,3817,9,13,6,17,44,49,-5,45
Stenhousem'r,3817,10,10,8,18,50,74,-24,38
Alloa,3818,1,18,8,10,71,43,28,62
Brechin,3818,2,17,8,11,53,52,1,59
Airdrieon,3818,3,16,6,14,60,58,2,54
Peterhead,3818,4,14,10,12,47,46,1,52
Livingston,3818,5,16,3,17,67,61,6,51
Albion,3818,6,14,9,13,54,54,0,51
Queen's Park,3818,7,14,7,15,43,51,-8,49
Stranraer,3818,8,13,6,17,50,57,-7,45
East Fife,3818,9,11,9,16,49,46,3,42
Stenhousem'r,3818,10,11,6,19,50,76,-26,39
Alloa,3819,1,21,7,8,75,44,31,70
Livingston,3819,2,20,7,9,80,51,29,67
Queen's Park,3819,3,14,12,10,38,37,1,54
Airdrieon,3819,4,16,6,14,59,59,0,54
Brechin,3819,5,14,7,15,44,53,-9,49
Stranraer,3819,6,14,6,16,55,61,-6,48
East Fife,3819,7,12,9,15,50,43,7,45
Albion,3819,8,10,9,17,47,57,-10,39
Stenhousem'r,3819,9,10,9,17,47,66,-19,39
Peterhead,3819,10,8,10,18,40,64,-24,34
Livingston,3820,1,20,8,8,69,44,25,68
Airdrieon,3820,2,19,7,10,63,44,19,64
Alloa,3820,3,18,9,9,61,42,19,63
Albion,3820,4,16,7,13,56,51,5,55
Brechin,3820,5,16,6,14,50,45,5,54
Queen's Park,3820,6,15,7,14,38,45,-7,52
East Fife,3820,7,10,8,18,42,48,-6,38
Peterhead,3820,8,9,10,17,40,56,-16,37
Stenhousem'r,3820,9,9,10,17,51,77,-26,37
Stranraer,3820,10,9,6,21,47,65,-18,33
Livingston,3821,1,20,6,10,78,46,32,66
Alloa,3821,2,19,8,9,71,45,26,65
Albion,3821,3,14,8,14,59,56,3,50
Peterhead,3821,4,14,8,14,52,57,-5,50
Brechin,3821,5,13,11,12,47,52,-5,50
Airdrieon,3821,6,14,7,15,53,60,-7,49
Stranraer,3821,7,13,7,16,57,58,-1,46
Queen's Park,3821,8,13,6,17,42,53,-11,45
East Fife,3821,9,11,9,16,52,54,-2,42
Stenhousem'r,3821,10,9,10,17,51,81,-30,37
Livingston,3822,1,20,9,7,71,40,31,69
Alloa,3822,2,19,6,11,60,40,20,63
Brechin,3822,3,17,7,12,48,43,5,58
Peterhead,3822,4,16,8,12,55,46,9,56
Albion,3822,5,15,8,13,59,50,9,53
Airdrieon,3822,6,14,8,14,49,51,-2,50
East Fife,3822,7,12,9,15,55,53,2,45
Queen's Park,3822,8,11,8,17,29,51,-22,41
Stranraer,3822,9,10,7,19,49,67,-18,37
Stenhousem'r,3822,10,8,6,22,45,79,-34,30
Alloa,3823,1,19,9,8,66,43,23,66
Livingston,3823,2,21,2,13,74,53,21,65
Queen's Park,3823,3,17,6,13,56,51,5,57
Brechin,3823,4,16,8,12,52,44,8,56
Peterhead,3823,5,15,8,13,49,47,2,53
Albion,3823,6,15,8,13,47,48,-1,53
Airdrieon,3823,7,14,6,16,46,49,-3,48
East Fife,3823,8,12,8,16,51,52,-1,44
Stranraer,3823,9,10,5,21,43,65,-22,35
Stenhousem'r,3823,10,7,8,21,47,79,-32,29
Brechin,3824,1,22,5,9,63,39,24,71
Livingston,3824,2,21,5,10,73,51,22,68
Alloa,3824,3,18,7,11,76,52,24,61
Airdrieon,3824,4,16,7,13,54,51,3,55
Albion,3824,5,14,8,14,53,51,2,50
East Fife,3824,6,13,8,15,54,58,-4,47
Peterhead,3824,7,13,8,15,57,63,-6,47
Queen's Park,3824,8,11,6,19,39,58,-19,39
Stenhousem'r,3824,9,11,5,20,60,86,-26,38
Stranraer,3824,10,8,7,21,38,58,-20,31
Airdrieon,3825,1,21,5,10,56,49,7,68
Livingston,3825,2,21,4,11,77,45,32,67
Alloa,3825,3,17,8,11,70,49,21,59
Brechin,3825,4,15,6,15,46,53,-7,51
Stranraer,3825,5,13,10,13,50,49,1,49
Albion,3825,6,13,9,14,53,50,3,48
Queen's Park,3825,7,13,8,15,41,49,-8,47
Peterhead,3825,8,12,8,16,47,45,2,44
East Fife,3825,9,11,10,15,42,45,-3,43
Stenhousem'r,3825,10,7,6,23,34,82,-48,27
Livingston,3826,1,24,8,4,85,39,46,80
Brechin,3826,2,19,3,14,62,52,10,60
Alloa,3826,3,17,7,12,61,48,13,58
Airdrieon,3826,4,17,7,12,63,59,4,58
Albion,3826,5,14,10,12,54,46,8,52
Peterhead,3826,6,15,6,15,51,52,-1,51
East Fife,3826,7,12,9,15,49,54,-5,45
Stranraer,3826,8,12,3,21,51,72,-21,39
Queen's Park,3826,9,10,8,18,34,48,-14,38
Stenhousem'r,3826,10,6,7,23,38,78,-40,25
Alloa,3827,1,21,7,8,68,41,27,70
Livingston,3827,2,18,6,12,63,44,19,60
Albion,3827,3,18,5,13,59,53,6,59
Airdrieon,3827,4,17,7,12,62,56,6,58
Brechin,3827,5,17,4,15,56,52,4,55
Queen's Park,3827,6,15,5,16,40,48,-8,50
Stranraer,3827,7,15,4,17,55,53,2,49
Peterhead,3827,8,11,8,17,48,61,-13,41
East Fife,3827,9,10,5,21,50,60,-10,35
Stenhousem'r,3827,10,9,7,20,51,84,-33,34
Alloa,3828,1,19,8,9,67,38,29,65
Brechin,3828,2,18,8,10,57,42,15,62
Livingston,3828,3,19,3,14,69,55,14,60
Airdrieon,3828,4,16,9,11,54,47,7,57
Albion,3828,5,16,7,13,50,46,4,55
Peterhead,3828,6,13,9,14,51,55,-4,48
Stranraer,3828,7,11,9,16,49,64,-15,42
Queen's Park,3828,8,10,11,15,33,49,-16,41
East Fife,3828,9,7,13,16,41,50,-9,34
Stenhousem'r,3828,10,9,7,20,57,82,-25,34
Livingston,3829,1,21,6,9,79,43,36,69
Alloa,3829,2,20,7,9,78,37,41,67
Airdrieon,3829,3,20,2,14,57,61,-4,62
Brechin,3829,4,18,7,11,57,53,4,61
Queen's Park,3829,5,15,4,17,41,54,-13,49
Stenhousem'r,3829,6,13,9,14,67,77,-10,48
Peterhead,3829,7,12,8,16,43,60,-17,44
East Fife,3829,8,10,9,17,56,55,1,39
Albion,3829,9,10,6,20,48,63,-15,36
Stranraer,3829,10,10,4,22,46,69,-23,34
Livingston,3830,1,21,5,10,78,47,31,68
Alloa,3830,2,20,8,8,73,46,27,68
Brechin,3830,3,17,7,12,48,42,6,58
Airdrieon,3830,4,16,8,12,60,56,4,56
Peterhead,3830,5,15,8,13,50,49,1,53
Albion,3830,6,14,9,13,61,53,8,51
Stranraer,3830,7,13,4,19,46,61,-15,43
East Fife,3830,8,9,15,12,48,49,-1,42
Queen's Park,3830,9,8,10,18,33,53,-20,34
Stenhousem'r,3830,10,7,6,23,51,92,-41,27
Alloa,3831,1,19,6,11,78,46,32,63
Airdrieon,3831,2,18,8,10,68,57,11,62
Brechin,3831,3,17,7,12,48,44,4,58
Livingston,3831,4,17,5,14,67,49,18,56
Peterhead,3831,5,17,5,14,50,51,-1,56
East Fife,3831,6,14,12,10,54,47,7,54
Queen's Park,3831,7,10,13,13,36,46,-10,43
Stranraer,3831,8,12,6,18,43,59,-16,42
Albion,3831,9,11,8,17,53,57,-4,41
Stenhousem'r,3831,10,7,6,23,45,86,-41,27
Albion,3832,1,17,10,9,72,56,16,61
Alloa,3832,2,18,6,12,77,52,25,60
Brechin,3832,3,17,7,12,53,44,9,58
Livingston,3832,4,17,7,12,61,53,8,58
Airdrieon,3832,5,17,6,13,64,53,11,57
Stranraer,3832,6,18,2,16,56,57,-1,56
Peterhead,3832,7,15,7,14,61,56,5,52
East Fife,3832,8,11,8,17,44,54,-10,41
Queen's Park,3832,9,10,9,17,35,58,-23,39
Stenhousem'r,3832,10,6,6,24,41,81,-40,24
Livingston,3833,1,23,3,10,73,37,36,72
Peterhead,3833,2,19,3,14,58,50,8,60
Albion,3833,3,16,10,10,51,43,8,58
Alloa,3833,4,17,5,14,60,44,16,56
Queen's Park,3833,5,14,10,12,35,37,-2,52
East Fife,3833,6,15,6,15,51,48,3,51
Airdrieon,3833,7,15,6,15,48,54,-6,51
Brechin,3833,8,13,7,16,41,47,-6,46
Stranraer,3833,9,8,8,20,45,64,-19,32
Stenhousem'r,3833,10,8,6,22,38,76,-38,30
Livingston,3834,1,24,5,7,80,38,42,77
Alloa,3834,2,20,8,8,80,50,30,68
Brechin,3834,3,14,9,13,53,51,2,51
Airdrieon,3834,4,14,7,15,56,71,-15,49
Peterhead,3834,5,13,9,14,52,58,-6,48
East Fife,3834,6,13,8,15,59,51,8,47
Queen's Park,3834,7,10,11,15,44,54,-10,41
Stranraer,3834,8,12,5,19,48,65,-17,41
Stenhousem'r,3834,9,11,6,19,43,70,-27,39
Albion,3834,10,8,14,14,42,49,-7,38
Livingston,3835,1,21,5,10,70,46,24,68
Alloa,3835,2,18,9,9,67,46,21,63
Albion,3835,3,15,12,9,57,46,11,57
Brechin,3835,4,14,8,14,45,44,1,50
Airdrieon,3835,5,13,10,13,53,60,-7,49
Queen's Park,3835,6,13,10,13,35,43,-8,49
Peterhead,3835,7,13,9,14,51,55,-4,48
East Fife,3835,8,11,10,15,48,47,1,43
Stranraer,3835,9,12,7,17,51,59,-8,43
Stenhousem'r,3835,10,6,8,22,46,77,-31,26
Airdrieon,3836,1,19,6,11,58,44,14,63
Alloa,3836,2,17,11,8,67,45,22,62
Livingston,3836,3,19,2,15,66,50,16,59
Brechin,3836,4,18,5,13,49,40,9,59
Albion,3836,5,13,10,13,55,55,0,49
Peterhead,3836,6,13,8,15,50,57,-7,47
East Fife,3836,7,11,13,12,45,40,5,46
Queen's Park,3836,8,12,7,17,39,55,-16,43
Stranraer,3836,9,11,8,17,45,52,-7,41
Stenhousem'r,3836,10,10,4,22,47,83,-36,34
Livingston,3837,1,26,0,10,86,43,43,78
Alloa,3837,2,23,5,8,71,40,31,74
Brechin,3837,3,19,7,10,57,37,20,64
Airdrieon,3837,4,16,6,14,57,57,0,54
Albion,3837,5,12,9,15,54,62,-8,45
Queen's Park,3837,6,13,6,17,33,46,-13,45
Stranraer,3837,7,12,6,18,49,57,-8,42
Peterhead,3837,8,13,3,20,45,62,-17,42
Stenhousem'r,3837,9,10,9,17,56,78,-22,39
East Fife,3837,10,6,9,21,36,62,-26,27
Alloa,3838,1,18,12,6,68,43,25,66
Livingston,3838,2,19,4,13,74,62,12,61
Brechin,3838,3,18,7,11,56,47,9,61
Airdrieon,3838,4,18,6,12,63,52,11,60
Peterhead,3838,5,13,7,16,47,53,-6,46
East Fife,3838,6,11,12,13,41,40,1,45
Stranraer,3838,7,13,6,17,61,62,-1,45
Queen's Park,3838,8,10,10,16,38,49,-11,40
Albion,3838,9,10,10,16,43,55,-12,40
Stenhousem'r,3838,10,8,10,18,43,71,-28,34
Alloa,3839,1,25,5,6,70,35,35,80
Livingston,3839,2,22,5,9,79,48,31,71
Brechin,3839,3,18,7,11,61,49,12,61
Airdrieon,3839,4,16,8,12,60,48,12,56
Albion,3839,5,16,7,13,55,56,-1,55
Peterhead,3839,6,13,4,19,45,61,-16,43
Queen's Park,3839,7,11,7,18,39,55,-16,40
East Fife,3839,8,10,8,18,51,58,-7,38
Stranraer,3839,9,9,7,20,46,62,-16,34
Stenhousem'r,3839,10,7,8,21,42,76,-34,29
Airdrieon,3840,1,20,8,8,65,44,21,68
Brechin,3840,2,19,4,13,58,48,10,61
Alloa,3840,3,16,11,9,73,44,29,59
Livingston,3840,4,18,3,15,63,48,15,57
Queen's Park,3840,5,15,8,13,42,48,-6,53
Albion,3840,6,14,8,14,52,51,1,50
Stranraer,3840,7,14,6,16,51,62,-11,48
East Fife,3840,8,11,11,14,51,53,-2,44
Peterhead,3840,9,11,7,18,41,50,-9,40
Stenhousem'r,3840,10,5,8,23,35,83,-48,23
Livingston,3841,1,21,4,11,82,49,33,67
Alloa,3841,2,18,11,7,62,33,29,65
Airdrieon,3841,3,16,6,14,57,61,-4,54
Brechin,3841,4,16,6,14,43,47,-4,54
East Fife,3841,5,15,6,15,53,44,9,51
Queen's Park,3841,6,14,7,15,37,43,-6,49
Albion,3841,7,12,11,13,50,50,0,47
Stranraer,3841,8,13,4,19,44,61,-17,43
Peterhead,3841,9,10,12,14,42,51,-9,42
Stenhousem'r,3841,10,8,7,21,38,69,-31,31
Livingston,3842,1,21,5,10,82,48,34,68
Albion,3842,2,17,7,12,58,43,15,58
East Fife,3842,3,17,5,14,61,48,13,56
Peterhead,3842,4,15,8,13,49,54,-5,53
Alloa,3842,5,14,9,13,67,51,16,51
Airdrieon,3842,6,13,9,14,54,67,-13,48
Brechin,3842,7,13,8,15,53,62,-9,47
Queen's Park,3842,8,13,7,16,46,57,-11,46
Stranraer,3842,9,13,3,20,52,62,-10,42
Stenhousem'r,3842,10,9,9,18,47,77,-30,36
Brechin,3843,1,20,8,8,55,37,18,68
Livingston,3843,2,20,2,14,69,56,13,62
Alloa,3843,3,17,8,11,63,39,24,59
Airdrieon,3843,4,16,5,15,62,62,0,53
Peterhead,3843,5,14,8,14,58,63,-5,50
Albion,3843,6,14,7,15,57,56,1,49
Stranraer,3843,7,13,5,18,45,53,-8,44
Stenhousem'r,3843,8,12,6,18,55,77,-22,42
East Fife,3843,9,11,8,17,47,51,-4,41
Queen's Park,3843,10,11,7,18,36,53,-17,40
Livingston,3844,1,24,2,10,79,51,28,74
Alloa,3844,2,22,7,7,88,47,41,73
Brechin,3844,3,17,8,11,57,50,7,59
Airdrieon,3844,4,16,7,13,66,65,1,55
Stenhousem'r,3844,5,13,8,15,53,62,-9,47
Albion,3844,6,11,9,16,43,48,-5,42
Queen's Park,3844,7,11,8,17,38,60,-22,41
East Fife,3844,8,11,7,18,48,60,-12,40
Peterhead,3844,9,10,10,16,42,54,-12,40
Stranraer,3844,10,9,6,21,49,66,-17,33
Livingston,3845,1,21,7,8,72,41,31,70
Alloa,3845,2,17,8,11,60,47,13,59
Airdrieon,3845,3,18,4,14,60,58,2,58
Brechin,3845,4,16,9,11,51,45,6,57
Stranraer,3845,5,16,3,17,50,50,0,51
Queen's Park,3845,6,14,9,13,45,50,-5,51
Albion,3845,7,12,8,16,44,50,-6,44
Peterhead,3845,8,12,5,19,42,52,-10,41
East Fife,3845,9,9,12,15,47,51,-4,39
Stenhousem'r,3845,10,7,11,18,47,74,-27,32
Alloa,3846,1,22,6,8,84,43,41,72
Livingston,3846,2,20,7,9,80,47,33,67
Brechin,3846,3,17,7,12,52,46,6,58
Airdrieon,3846,4,17,6,13,60,48,12,57
Peterhead,3846,5,14,8,14,44,47,-3,50
Albion,3846,6,13,10,13,53,59,-6,49
Stranraer,3846,7,11,9,16,52,67,-15,42
Queen's Park,3846,8,9,10,17,41,67,-26,37
East Fife,3846,9,8,10,18,43,54,-11,34
Stenhousem'r,3846,10,9,7,20,47,78,-31,34
Livingston,3847,1,21,6,9,82,47,35,69
Brechin,3847,2,21,3,12,57,42,15,66
Albion,3847,3,18,7,11,59,47,12,61
Alloa,3847,4,17,6,13,67,50,17,57
Airdrieon,3847,5,17,6,13,60,52,8,57
Stranraer,3847,6,13,6,17,47,63,-16,45
Queen's Park,3847,7,13,6,17,34,56,-22,45
Peterhead,3847,8,12,7,17,48,63,-15,43
East Fife,3847,9,10,8,18,49,56,-7,38
Stenhousem'r,3847,10,6,9,21,43,70,-27,27
Livingston,3848,1,23,6,7,93,48,45,75
Queen's Park,3848,2,18,6,12,40,43,-3,60
Alloa,3848,3,15,11,10,62,45,17,56
Brechin,3848,4,15,7,14,42,50,-8,52
Airdrieon,3848,5,13,12,11,54,53,1,51
Albion,3848,6,14,5,17,55,55,0,47
East Fife,3848,7,13,6,17,54,53,1,45
Peterhead,3848,8,12,9,15,53,58,-5,45
Stranraer,3848,9,10,11,15,49,56,-7,41
Stenhousem'r,3848,10,7,7,22,47,88,-41,28
Livingston,3849,1,22,6,8,80,49,31,72
Alloa,3849,2,16,9,11,63,49,14,57
East Fife,3849,3,16,8,12,52,38,14,56
Peterhead,3849,4,14,11,11,49,47,2,53
Brechin,3849,5,14,10,12,47,42,5,52
Queen's Park,3849,6,14,9,13,43,46,-3,51
Airdrieon,3849,7,13,8,15,49,58,-9,47
Albion,3849,8,12,10,14,53,48,5,46
Stranraer,3849,9,8,11,17,42,62,-20,35
Stenhousem'r,3849,10,5,10,21,46,85,-39,25
Alloa,3850,1,22,5,9,74,46,28,71
Livingston,3850,2,21,6,9,80,47,33,69
Airdrieon,3850,3,18,7,11,60,50,10,61
Brechin,3850,4,16,5,15,55,53,2,53
Albion,3850,5,13,11,12,60,55,5,50
Queen's Park,3850,6,12,10,14,43,54,-11,46
Peterhead,3850,7,12,8,16,52,60,-8,44
East Fife,3850,8,10,10,16,48,52,-4,40
Stranraer,3850,9,11,5,20,50,65,-15,38
Stenhousem'r,3850,10,8,7,21,49,89,-40,31
Alloa,3851,1,20,9,7,79,45,34,69
Livingston,3851,2,20,5,11,85,47,38,65
Peterhead,3851,3,15,7,14,50,51,-1,52
Airdrieon,3851,4,14,9,13,53,53,0,51
Brechin,3851,5,14,7,15,45,54,-9,49
Stenhousem'r,3851,6,13,8,15,52,69,-17,47
East Fife,3851,7,11,11,14,50,47,3,44
Queen's Park,3851,8,12,8,16,37,58,-21,44
Stranraer,3851,9,12,6,18,47,61,-14,42
Albion,3851,10,10,8,18,44,57,-13,38
Livingston,3852,1,25,3,8,91,51,40,78
Brechin,3852,2,19,4,13,58,48,10,61
Airdrieon,3852,3,16,10,10,56,52,4,58
Alloa,3852,4,16,9,11,64,50,14,57
Peterhead,3852,5,12,11,13,45,46,-1,47
East Fife,3852,6,13,6,17,41,44,-3,45
Stranraer,3852,7,13,6,17,47,54,-7,45
Queen's Park,3852,8,12,8,16,30,43,-13,44
Albion,3852,9,9,11,16,50,60,-10,38
Stenhousem'r,3852,10,7,8,21,40,74,-34,29
Alloa,3853,1,20,8,8,78,51,27,68
Livingston,3853,2,18,6,12,73,52,21,60
East Fife,3853,3,15,12,9,58,42,16,57
Airdrieon,3853,4,16,8,12,59,55,4,56
Brechin,3853,5,16,6,14,51,56,-5,54
Stranraer,3853,6,14,3,19,53,60,-7,45
Albion,3853,7,10,14,12,45,51,-6,44
Peterhead,3853,8,12,7,17,46,53,-7,43
Queen's Park,3853,9,10,10,16,35,55,-20,40
Stenhousem'r,3853,10,7,10,19,45,68,-23,31
Alloa,3854,1,19,7,10,80,45,35,64
Brechin,3854,2,19,6,11,61,49,12,63
Livingston,3854,3,17,8,11,70,48,22,59
Peterhead,3854,4,15,8,13,61,61,0,53
Queen's Park,3854,5,13,11,12,40,48,-8,50
Airdrieon,3854,6,13,10,13,47,46,1,49
Stranraer,3854,7,12,8,16,48,66,-18,44
Albion,3854,8,10,10,16,54,57,-3,40
East Fife,3854,9,10,10,16,47,51,-4,40
Stenhousem'r,3854,10,9,8,19,46,83,-37,35
Livingston,3855,1,23,0,13,79,55,24,69
Airdrieon,3855,2,19,10,7,78,52,26,67
Albion,3855,3,19,7,10,62,48,14,64
Alloa,3855,4,17,9,10,79,45,34,60
Brechin,3855,5,15,9,12,51,49,2,54
Queen's Park,3855,6,11,7,18,38,53,-15,40
Peterhead,3855,7,11,7,18,37,58,-21,40
Stranraer,3855,8,11,6,19,47,61,-14,39
East Fife,3855,9,10,8,18,52,63,-11,38
Stenhousem'r,3855,10,9,7,20,43,82,-39,34
Brechin,3856,1,21,5,10,50,42,8,68
Livingston,3856,2,16,9,11,67,49,18,57
Airdrieon,3856,3,17,6,13,58,55,3,57
Alloa,3856,4,16,8,12,65,50,15,56
Stranraer,3856,5,16,5,15,55,51,4,53
Peterhead,3856,6,14,8,14,51,46,5,50
Albion,3856,7,13,7,16,49,58,-9,46
Queen's Park,3856,8,12,7,17,38,46,-8,43
East Fife,3856,9,11,7,18,45,54,-9,40
Stenhousem'r,3856,10,10,6,20,51,78,-27,36
Alloa,3857,1,19,10,7,72,45,27,67
Livingston,3857,2,19,4,13,73,48,25,61
Airdrieon,3857,3,16,10,10,67,55,12,58
Brechin,3857,4,17,6,13,56,51,5,57
Queen's Park,3857,5,15,7,14,41,47,-6,52
Albion,3857,6,14,9,13,53,53,0,51
Stranraer,3857,7,11,11,14,47,53,-6,44
East Fife,3857,8,10,10,16,46,50,-4,40
Peterhead,3857,9,12,4,20,45,62,-17,40
Stenhousem'r,3857,10,6,11,19,43,79,-36,29
Livingston,3858,1,21,6,9,85,55,30,69
Alloa,3858,2,19,10,7,83,43,40,67
Airdrieon,3858,3,17,8,11,72,59,13,59
Albion,3858,4,15,10,11,56,53,3,55
East Fife,3858,5,14,10,12,59,44,15,52
Brechin,3858,6,15,6,15,54,57,-3,51
Queen's Park,3858,7,13,9,14,43,51,-8,48
Peterhead,3858,8,13,8,15,45,50,-5,47
Stranraer,3858,9,10,5,21,49,74,-25,35
Stenhousem'r,3858,10,4,6,26,33,93,-60,18
Livingston,3859,1,23,5,8,92,47,45,74
Brechin,3859,2,19,1,16,53,52,1,58
Alloa,3859,3,16,9,11,62,45,17,57
Albion,3859,4,16,6,14,50,54,-4,54
Airdrieon,3859,5,13,12,11,57,54,3,51
Peterhead,3859,6,14,8,14,49,52,-3,50
East Fife,3859,7,13,8,15,46,40,6,47
Stranraer,3859,8,12,5,19,50,60,-10,41
Queen's Park,3859,9,10,8,18,39,59,-20,38
Stenhousem'r,3859,10,9,8,19,46,81,-35,35
Livingston,3860,1,21,5,10,78,49,29,68
Alloa,3860,2,19,9,8,70,40,30,66
Brechin,3860,3,16,7,13,52,51,1,55
Albion,3860,4,14,11,11,54,46,8,53
Airdrieon,3860,5,14,8,14,53,57,-4,50
Peterhead,3860,6,15,4,17,39,46,-7,49
Stranraer,3860,7,13,8,15,49,59,-10,47
East Fife,3860,8,13,6,17,58,53,5,45
Queen's Park,3860,9,9,10,17,33,50,-17,37
Stenhousem'r,3860,10,9,6,21,47,82,-35,33
Livingston,3861,1,23,5,8,82,43,39,74
Alloa,3861,2,21,7,8,72,47,25,70
Airdrieon,3861,3,16,9,11,57,49,8,57
Albion,3861,4,13,9,14,55,51,4,48
Brechin,3861,5,12,11,13,44,49,-5,47
Peterhead,3861,6,13,8,15,45,55,-10,47
East Fife,3861,7,12,8,16,48,47,1,44
Stranraer,3861,8,12,5,19,47,60,-13,41
Stenhousem'r,3861,9,9,10,17,46,69,-23,37
Queen's Park,3861,10,8,10,18,28,54,-26,34
Alloa,3862,1,24,3,9,86,47,39,75
Livingston,3862,2,22,6,8,81,54,27,72
Queen's Park,3862,3,16,4,16,47,50,-3,52
Brechin,3862,4,17,1,18,50,54,-4,52
Stranraer,3862,5,16,3,17,60,61,-1,51
Peterhead,3862,6,13,8,15,45,59,-14,47
Airdrieon,3862,7,13,6,17,58,73,-15,45
East Fife,3862,8,10,11,15,52,51,1,41
Albion,3862,9,11,7,18,48,56,-8,40
Stenhousem'r,3862,10,10,7,19,60,82,-22,37
Alloa,3863,1,25,6,5,98,39,59,81
Livingston,3863,2,21,4,11,74,56,18,67
Brechin,3863,3,14,9,13,48,45,3,51
Albion,3863,4,14,8,14,59,54,5,50
Stranraer,3863,5,15,5,16,57,56,1,50
Airdrieon,3863,6,13,9,14,50,54,-4,48
Peterhead,3863,7,11,10,15,45,59,-14,43
Queen's Park,3863,8,11,7,18,37,64,-27,40
East Fife,3863,9,9,12,15,52,56,-4,39
Stenhousem'r,3863,10,7,10,19,45,82,-37,31
Livingston,3864,1,19,6,11,75,49,26,63
Alloa,3864,2,19,6,11,60,41,19,63
Albion,3864,3,16,8,12,57,46,11,56
Peterhead,3864,4,16,8,12,55,50,5,56
Brechin,3864,5,13,12,11,43,43,0,51
Airdrieon,3864,6,15,6,15,59,60,-1,51
Stranraer,3864,7,14,7,15,50,49,1,49
East Fife,3864,8,10,10,16,45,52,-7,40
Queen's Park,3864,9,9,11,16,32,48,-16,38
Stenhousem'r,3864,10,8,8,20,38,76,-38,32
Livingston,3865,1,20,5,11,72,45,27,65
Alloa,3865,2,19,5,12,71,46,25,62
Airdrieon,3865,3,19,4,13,59,55,4,61
Peterhead,3865,4,15,6,15,50,46,4,51
Queen's Park,3865,5,15,6,15,41,49,-8,51
Brechin,3865,6,15,5,16,41,51,-10,50
Stranraer,3865,7,15,4,17,48,53,-5,49
Albion,3865,8,12,9,15,40,47,-7,45
East Fife,3865,9,10,12,14,52,50,2,42
Stenhousem'r,3865,10,8,8,20,48,80,-32,32
Airdrieon,3866,1,20,7,9,65,43,22,67
Brechin,3866,2,19,6,11,52,39,13,63
Alloa,3866,3,16,10,10,54,37,17,58
Livingston,3866,4,17,7,12,61,48,13,58
East Fife,3866,5,14,13,9,51,40,11,55
Albion,3866,6,13,7,16,43,50,-7,46
Peterhead,3866,7,11,10,15,39,56,-17,43
Stranraer,3866,8,11,8,17,41,53,-12,41
Stenhousem'r,3866,9,9,7,20,38,58,-20,34
Queen's Park,3866,10,9,7,20,29,49,-20,34
Livingston,3867,1,22,6,8,88,50,38,72
Alloa,3867,2,17,10,9,64,41,23,61
Brechin,3867,3,16,8,12,51,53,-2,56
Airdrieon,3867,4,16,7,13,58,52,6,55
Albion,3867,5,15,10,11,57,51,6,55
Queen's Park,3867,6,15,9,12,49,43,6,54
Peterhead,3867,7,14,7,15,55,57,-2,49
East Fife,3867,8,11,9,16,48,53,-5,42
Stranraer,3867,9,8,5,23,40,65,-25,29
Stenhousem'r,3867,10,5,11,20,44,89,-45,26
Brechin,3868,1,19,7,10,67,46,21,64
Livingston,3868,2,17,8,11,63,49,14,59
Albion,3868,3,16,10,10,65,47,18,58
Alloa,3868,4,16,7,13,64,49,15,55
Airdrieon,3868,5,16,7,13,61,63,-2,55
Peterhead,3868,6,15,9,12,49,52,-3,54
East Fife,3868,7,11,8,17,51,54,-3,41
Stranraer,3868,8,11,8,17,44,63,-19,41
Queen's Park,3868,9,8,12,16,37,49,-12,36
Stenhousem'r,3868,10,9,8,19,50,79,-29,35
Livingston,3869,1,22,4,10,75,43,32,70
Alloa,3869,2,18,7,11,64,45,19,61
Airdrieon,3869,3,15,9,12,56,52,4,54
Brechin,3869,4,16,5,15,42,45,-3,53
East Fife,3869,5,14,9,13,47,40,7,51
Albion,3869,6,14,8,14,48,46,2,50
Stranraer,3869,7,14,7,15,53,58,-5,49
Queen's Park,3869,8,11,10,15,30,44,-14,43
Stenhousem'r,3869,9,8,11,17,49,74,-25,35
Peterhead,3869,10,8,10,18,38,55,-17,34
Alloa,3870,1,23,6,7,80,43,37,75
Livingston,3870,2,19,6,11,80,49,31,63
Peterhead,3870,3,16,6,14,45,46,-1,54
Airdrieon,3870,4,15,7,14,49,51,-2,52
East Fife,3870,5,13,10,13,57,50,7,49
Albion,3870,6,13,8,15,60,58,2,47
Brechin,3870,7,14,3,19,45,58,-13,45
Queen's Park,3870,8,13,6,17,35,52,-17,45
Stranraer,3870,9,13,4,19,54,58,-4,43
Stenhousem'r,3870,10,9,8,19,45,85,-40,35
Alloa,3871,1,22,6,8,74,34,40,72
Livingston,3871,2,22,5,9,75,45,30,71
Airdrieon,3871,3,17,6,13,59,56,3,57
East Fife,3871,4,16,7,13,56,45,11,55
Brechin,3871,5,16,3,17,50,52,-2,51
Peterhead,3871,6,14,8,14,47,48,-1,50
Albion,3871,7,13,9,14,50,48,2,48
Stranraer,3871,8,12,5,19,46,57,-11,41
Queen's Park,3871,9,11,8,17,38,57,-19,41
Stenhousem'r,3871,10,7,3,26,34,87,-53,24
Livingston,3872,1,22,4,10,79,44,35,70
Alloa,3872,2,20,10,6,75,45,30,70
Albion,3872,3,15,10,11,62,54,8,55
Brechin,3872,4,16,6,14,58,55,3,54
Stranraer,3872,5,15,6,15,52,56,-4,51
Airdrieon,3872,6,12,10,14,49,56,-7,46
Peterhead,3872,7,12,9,15,44,49,-5,45
Stenhousem'r,3872,8,12,3,21,45,69,-24,39
East Fife,3872,9,8,12,16,41,54,-13,36
Queen's Park,3872,10,9,8,19,36,59,-23,35
Livingston,3873,1,20,7,9,73,48,25,67
Brechin,3873,2,20,3,13,50,51,-1,63
Alloa,3873,3,17,11,8,63,40,23,62
Airdrieon,3873,4,18,6,12,52,51,1,60
Stranraer,3873,5,16,5,15,65,51,14,53
Peterhead,3873,6,15,6,15,45,51,-6,51
Albion,3873,7,14,5,17,58,54,4,47
East Fife,3873,8,13,5,18,57,58,-1,44
Queen's Park,3873,9,13,3,20,38,55,-17,42
Stenhousem'r,3873,10,7,3,26,47,89,-42,24
Alloa,3874,1,21,9,6,69,35,34,72
Livingston,3874,2,20,8,8,67,46,21,68
Brechin,3874,3,18,5,13,54,50,4,59
Airdrieon,3874,4,15,10,11,60,53,7,55
Albion,3874,5,11,12,13,49,56,-7,45
Queen's Park,3874,6,12,9,15,37,47,-10,45
Peterhead,3874,7,12,8,16,44,54,-10,44
Stranraer,3874,8,12,6,18,46,53,-7,42
East Fife,3874,9,8,13,15,43,52,-9,37
Stenhousem'r,3874,10,8,6,22,47,70,-23,30
Livingston,3875,1,21,5,10,77,41,36,68
Airdrieon,3875,2,18,8,10,57,50,7,62
Brechin,3875,3,15,7,14,44,43,1,52
Alloa,3875,4,13,11,12,57,49,8,50
East Fife,3875,5,12,11,13,49,47,2,47
Stranraer,3875,6,12,11,13,50,52,-2,47
Albion,3875,7,12,11,13,47,55,-8,47
Peterhead,3875,8,13,6,17,50,51,-1,45
Queen's Park,3875,9,12,6,18,31,52,-21,42
Stenhousem'r,3875,10,7,14,15,51,73,-22,35
Airdrieon,3876,1,20,7,9,67,44,23,67
Livingston,3876,2,19,7,10,73,44,29,64
Alloa,3876,3,17,10,9,65,42,23,61
Brechin,3876,4,18,7,11,57,43,14,61
Peterhead,3876,5,13,11,12,50,51,-1,50
Stranraer,3876,6,12,8,16,50,54,-4,44
Queen's Park,3876,7,11,8,17,36,57,-21,41
Albion,3876,8,10,10,16,47,60,-13,40
Stenhousem'r,3876,9,10,7,19,47,82,-35,37
East Fife,3876,10,7,11,18,40,55,-15,32
Brechin,3877,1,19,7,10,57,49,8,64
Airdrieon,3877,2,18,8,10,60,52,8,62
Livingston,3877,3,19,4,13,79,59,20,61
Alloa,3877,4,16,10,10,59,44,15,58
Peterhead,3877,5,16,8,12,55,42,13,56
Queen's Park,3877,6,14,3,19,46,53,-7,45
Albion,3877,7,13,6,17,45,53,-8,45
Stranraer,3877,8,10,10,16,48,55,-7,40
East Fife,3877,9,10,9,17,48,52,-4,39
Stenhousem'r,3877,10,9,7,20,46,84,-38,34
Livingston,3878,1,25,1,10,83,45,38,76
Alloa,3878,2,20,6,10,66,46,20,66
Brechin,3878,3,18,5,13,56,53,3,59
Albion,3878,4,15,10,11,52,42,10,55
Airdrieon,3878,5,13,9,14,58,57,1,48
East Fife,3878,6,12,9,15,54,55,-1,45
Stranraer,3878,7,12,7,17,45,60,-15,43
Peterhead,3878,8,11,9,16,43,50,-7,42
Queen's Park,3878,9,11,7,18,37,58,-21,40
Stenhousem'r,3878,10,8,7,21,49,77,-28,31
Alloa,3879,1,21,7,8,81,50,31,70
Livingston,3879,2,20,6,10,76,48,28,66
Airdrieon,3879,3,15,12,9,60,51,9,57
Albion,3879,4,16,6,14,63,58,5,54
Brechin,3879,5,15,5,16,46,45,1,50
Peterhead,3879,6,14,7,15,45,51,-6,49
Queen's Park,3879,7,13,7,16,43,55,-12,46
Stranraer,3879,8,12,7,17,49,61,-12,43
East Fife,3879,9,10,9,17,48,52,-4,39
Stenhousem'r,3879,10,5,12,19,40,80,-40,27
Livingston,3880,1,24,3,9,86,47,39,75
Alloa,3880,2,22,7,7,67,34,33,73
Brechin,3880,3,19,5,12,58,47,11,62
Airdrieon,3880,4,16,6,14,57,55,2,54
Albion,3880,5,15,8,13,51,48,3,53
Stranraer,3880,6,14,4,18,52,56,-4,46
Peterhead,3880,7,13,5,18,45,53,-8,44
East Fife,3880,8,11,9,16,39,46,-7,42
Queen's Park,3880,9,11,9,16,36,51,-15,42
Stenhousem'r,3880,10,4,6,26,40,94,-54,18
Alloa,3881,1,21,5,10,71,48,23,68
Brechin,3881,2,20,7,9,55,40,15,67
Livingston,3881,3,16,6,14,74,57,17,54
Albion,3881,4,16,6,14,63,51,12,54
Airdrieon,3881,5,14,9,13,53,52,1,51
Peterhead,3881,6,13,11,12,53,50,3,50
Queen's Park,3881,7,11,9,16,42,52,-10,42
Stranraer,3881,8,11,8,17,53,69,-16,41
East Fife,3881,9,9,11,16,41,58,-17,38
Stenhousem'r,3881,10,8,10,18,50,78,-28,34
Livingston,3882,1,23,5,8,79,48,31,74
Alloa,3882,2,18,7,11,59,44,15,61
Brechin,3882,3,18,5,13,54,41,13,59
Airdrieon,3882,4,17,7,12,63,54,9,58
Peterhead,3882,5,13,9,14,49,57,-8,48
Queen's Park,3882,6,13,8,15,41,46,-5,47
Albion,3882,7,12,9,15,54,59,-5,45
Stranraer,3882,8,12,7,17,56,60,-4,43
East Fife,3882,9,12,6,18,49,56,-7,42
Stenhousem'r,3882,10,6,9,21,48,87,-39,27
Livingston,3883,1,23,5,8,72,39,33,74
Peterhead,3883,2,18,7,11,60,43,17,61
Alloa,3883,3,17,10,9,66,51,15,61
Airdrieon,3883,4,15,7,14,54,56,-2,52
Brechin,3883,5,15,6,15,57,53,4,51
Albion,3883,6,12,11,13,53,54,-1,47
Queen's Park,3883,7,13,4,19,41,53,-12,43
Stenhousem'r,3883,8,11,8,17,43,70,-27,41
Stranraer,3883,9,12,3,21,44,58,-14,39
East Fife,3883,10,10,7,19,38,51,-13,37
Livingston,3884,1,23,2,11,87,46,41,71
Alloa,3884,2,20,8,8,69,44,25,68
Brechin,3884,3,19,8,9,56,46,10,65
Airdrieon,3884,4,18,9,9,61,51,10,63
Queen's Park,3884,5,14,8,14,50,54,-4,50
Peterhead,3884,6,12,8,16,50,60,-10,44
Stranraer,3884,7,13,5,18,50,62,-12,44
East Fife,3884,8,11,8,17,40,46,-6,41
Stenhousem'r,3884,9,7,8,21,42,76,-34,29
Albion,3884,10,6,10,20,40,60,-20,28
Livingston,3885,1,26,5,5,80,34,46,83
Airdrieon,3885,2,20,7,9,65,52,13,67
Alloa,3885,3,16,6,14,66,45,21,54
Brechin,3885,4,16,6,14,54,51,3,54
Peterhead,3885,5,14,10,12,44,49,-5,52
Albion,3885,6,13,11,12,53,45,8,50
Stranraer,3885,7,13,5,18,50,59,-9,44
East Fife,3885,8,8,13,15,40,48,-8,37
Queen's Park,3885,9,9,7,20,33,67,-34,34
Stenhousem'r,3885,10,6,8,22,50,85,-35,26
Livingston,3886,1,25,3,8,84,42,42,78
Alloa,3886,2,18,8,10,57,39,18,62
Brechin,3886,3,17,8,11,53,41,12,59
Albion,3886,4,13,17,6,63,46,17,56
Airdrieon,3886,5,15,8,13,62,64,-2,53
Stranraer,3886,6,13,7,16,48,56,-8,46
Peterhead,3886,7,10,10,16,39,50,-11,40
East Fife,3886,8,8,14,14,49,49,0,38
Queen's Park,3886,9,11,2,23,40,65,-25,35
Stenhousem'r,3886,10,8,7,21,47,90,-43,31
Livingston,3887,1,23,6,7,88,42,46,75
Airdrieon,3887,2,20,8,8,57,41,16,68
Alloa,3887,3,18,6,12,65,43,22,60
Peterhead,3887,4,17,7,12,58,49,9,58
East Fife,3887,5,13,9,14,54,50,4,48
Brechin,3887,6,15,3,18,49,62,-13,48
Queen's Park,3887,7,14,6,16,38,51,-13,48
Albion,3887,8,11,11,14,50,62,-12,44
Stranraer,3887,9,10,6,20,47,67,-20,36
Stenhousem'r,3887,10,4,8,24,42,81,-39,20
Alloa,3888,1,21,6,9,72,47,25,69
Livingston,3888,2,21,4,11,78,45,33,67
Airdrieon,3888,3,19,6,11,60,49,11,63
Brechin,3888,4,16,4,16,45,49,-4,52
Albion,3888,5,13,10,13,45,49,-4,49
East Fife,3888,6,13,7,16,55,50,5,46
Stranraer,3888,7,14,4,18,57,56,1,46
Queen's Park,3888,8,13,6,17,32,50,-18,45
Peterhead,3888,9,13,4,19,46,54,-8,43
Stenhousem'r,3888,10,7,9,20,48,89,-41,30
Alloa,3889,1,19,8,9,72,40,32,65
Brechin,3889,2,20,4,12,52,45,7,64
Livingston,3889,3,19,4,13,64,45,19,61
Airdrieon,3889,4,17,6,13,61,46,15,57
Albion,3889,5,14,9,13,48,53,-5,51
Queen's Park,3889,6,14,7,15,45,50,-5,49
Stranraer,3889,7,13,8,15,48,51,-3,47
Peterhead,3889,8,11,7,18,42,59,-17,40
Stenhousem'r,3889,9,10,8,18,48,75,-27,38
East Fife,3889,10,9,7,20,37,53,-16,34
Livingston,3890,1,21,7,8,80,43,37,70
Brechin,3890,2,20,6,10,53,45,8,66
Airdrieon,3890,3,18,3,15,60,51,9,57
Alloa,3890,4,15,8,13,65,49,16,53
Peterhead,3890,5,13,12,11,49,46,3,51
Albion,3890,6,14,7,15,51,56,-5,49
Stranraer,3890,7,13,7,16,48,59,-11,46
East Fife,3890,8,12,7,17,52,53,-1,43
Queen's Park,3890,9,10,8,18,35,52,-17,38
Stenhousem'r,3890,10,8,7,21,43,82,-39,31
Alloa,3891,1,18,10,8,77,49,28,64
East Fife,3891,2,19,7,10,61,42,19,64
Airdrieon,3891,3,15,11,10,56,54,2,56
Brechin,3891,4,15,9,12,47,47,0,54
Livingston,3891,5,15,8,13,76,63,13,53
Albion,3891,6,13,9,14,57,61,-4,48
Peterhead,3891,7,12,8,16,44,57,-13,44
Queen's Park,3891,8,11,11,14,35,48,-13,44
Stranraer,3891,9,10,7,19,54,60,-6,37
Stenhousem'r,3891,10,7,10,19,46,72,-26,31
Livingston,3892,1,23,1,12,82,50,32,70
Alloa,3892,2,17,11,8,66,40,26,62
East Fife,3892,3,17,8,11,62,45,17,59
Stranraer,3892,4,16,7,13,53,51,2,55
Albion,3892,5,16,6,14,59,55,4,54
Airdrieon,3892,6,14,9,13,58,59,-1,51
Brechin,3892,7,15,3,18,47,57,-10,48
Peterhead,3892,8,11,10,15,42,52,-10,43
Queen's Park,3892,9,9,8,19,32,60,-28,35
Stenhousem'r,3892,10,7,7,22,45,77,-32,28
Alloa,3893,1,18,9,9,75,46,29,63
Livingston,3893,2,19,5,12,85,56,29,62
Brechin,3893,3,15,9,12,48,51,-3,54
East Fife,3893,4,14,11,11,57,50,7,53
Peterhead,3893,5,14,11,11,54,48,6,53
Albion,3893,6,13,8,15,45,58,-13,47
Airdrieon,3893,7,12,10,14,52,62,-10,46
Stranraer,3893,8,13,6,17,54,62,-8,45
Queen's Park,3893,9,13,6,17,38,53,-15,45
Stenhousem'r,3893,10,7,9,20,48,70,-22,30
Livingston,3894,1,22,4,10,77,47,30,70
Alloa,3894,2,18,11,7,73,45,28,65
Albion,3894,3,17,9,10,58,37,21,60
Brechin,3894,4,15,8,13,53,46,7,53
Stranraer,3894,5,14,10,12,52,63,-11,52
Peterhead,3894,6,13,10,13,58,55,3,49
Airdrieon,3894,7,11,10,15,47,59,-12,43
Queen's Park,3894,8,11,9,16,38,55,-17,42
East Fife,3894,9,9,11,16,41,51,-10,38
Stenhousem'r,3894,10,5,8,23,38,77,-39,23
Livingston,3895,1,21,3,12,78,47,31,66
Alloa,3895,2,19,7,10,80,54,26,64
Queen's Park,3895,3,17,8,11,40,31,9,59
Airdrieon,3895,4,18,5,13,71,67,4,59
Albion,3895,5,13,12,11,47,48,-1,51
Peterhead,3895,6,14,8,14,43,44,-1,50
Stranraer,3895,7,14,6,16,48,54,-6,48
East Fife,3895,8,14,6,16,42,49,-7,48
Brechin,3895,9,12,2,22,40,62,-22,38
Stenhousem'r,3895,10,5,9,22,45,78,-33,24
Livingston,3896,1,21,5,10,74,42,32,68
Alloa,3896,2,21,5,10,66,44,22,68
Airdrieon,3896,3,17,8,11,59,55,4,59
Brechin,3896,4,14,8,14,55,54,1,50
Albion,3896,5,13,10,13,56,51,5,49
Stranraer,3896,6,14,5,17,54,56,-2,47
Peterhead,3896,7,12,11,13,41,49,-8,47
East Fife,3896,8,11,9,16,36,42,-6,42
Queen's Park,3896,9,10,10,16,34,54,-20,40
Stenhousem'r,3896,10,7,9,20,40,68,-28,30
Livingston,3897,1,22,5,9,80,47,33,71
Alloa,3897,2,20,5,11,65,44,21,65
Airdrieon,3897,3,16,5,15,59,60,-1,53
Brechin,3897,4,15,7,14,51,52,-1,52
Peterhead,3897,5,15,6,15,59,58,1,51
Albion,3897,6,14,8,14,53,54,-1,50
East Fife,3897,7,13,7,16,60,49,11,46
Queen's Park,3897,8,11,8,17,36,62,-26,41
Stranraer,3897,9,11,7,18,50,61,-11,40
Stenhousem'r,3897,10,12,4,20,59,85,-26,40
Peterhead,3898,1,21,5,10,58,44,14,68
Livingston,3898,2,20,5,11,73,51,22,65
Alloa,3898,3,18,9,9,68,39,29,63
Airdrieon,3898,4,18,7,11,67,56,11,61
Queen's Park,3898,5,14,10,12,47,51,-4,52
Brechin,3898,6,15,3,18,55,56,-1,48
Albion,3898,7,11,11,14,53,56,-3,44
East Fife,3898,8,12,8,16,54,58,-4,44
Stranraer,3898,9,11,6,19,46,59,-13,39
Stenhousem'r,3898,10,4,8,24,44,95,-51,20
Alloa,3899,1,19,8,9,63,39,24,65
Livingston,3899,2,18,6,12,75,48,27,60
Airdrieon,3899,3,17,9,10,58,46,12,60
Albion,3899,4,17,8,11,58,48,10,59
Brechin,3899,5,16,3,17,49,53,-4,51
Peterhead,3899,6,13,9,14,44,49,-5,48
Stranraer,3899,7,13,5,18,54,56,-2,44
East Fife,3899,8,11,10,15,50,58,-8,43
Queen's Park,3899,9,12,7,17,34,52,-18,43
Stenhousem'r,3899,10,8,7,21,51,87,-36,31
Alloa,3900,1,23,7,6,75,37,38,76
Brechin,3900,2,18,8,10,63,43,20,62
Albion,3900,3,17,7,12,59,62,-3,58
Livingston,3900,4,16,7,13,64,48,16,55
Airdrieon,3900,5,17,4,15,60,61,-1,55
Queen's Park,3900,6,13,8,15,44,58,-14,47
Stranraer,3900,7,12,5,19,48,62,-14,41
East Fife,3900,8,10,10,16,52,51,1,40
Peterhead,3900,9,11,7,18,43,57,-14,40
Stenhousem'r,3900,10,8,7,21,41,70,-29,31
Alloa,3901,1,22,6,8,85,46,39,72
Livingston,3901,2,19,6,11,69,48,21,63
Brechin,3901,3,17,8,11,59,53,6,59
Airdrieon,3901,4,16,6,14,52,54,-2,54
Peterhead,3901,5,15,6,15,58,50,8,51
Stranraer,3901,6,15,4,17,56,58,-2,49
Queen's Park,3901,7,13,7,16,36,57,-21,46
Albion,3901,8,12,9,15,51,53,-2,45
East Fife,3901,9,9,9,18,45,60,-15,36
Stenhousem'r,3901,10,7,9,20,49,81,-32,30
Livingston,3902,1,19,5,12,75,49,26,62
Stranraer,3902,2,19,1,16,61,54,7,58
Alloa,3902,3,15,10,11,68,51,17,55
Brechin,3902,4,16,6,14,45,40,5,54
Queen's Park,3902,5,14,9,13,38,45,-7,51
Airdrieon,3902,6,15,6,15,53,62,-9,51
Peterhead,3902,7,14,8,14,51,58,-7,50
East Fife,3902,8,12,8,16,55,56,-1,44
Albion,3902,9,11,11,14,44,47,-3,44
Stenhousem'r,3902,10,10,6,20,52,80,-28,36
Livingston,3903,1,20,5,11,73,59,14,65
Alloa,3903,2,18,9,9,68,40,28,63
Airdrieon,3903,3,16,6,14,62,57,5,54
Queen's Park,3903,4,12,15,9,40,42,-2,51
East Fife,3903,5,12,13,11,60,47,13,49
Albion,3903,6,13,10,13,59,58,1,49
Brechin,3903,7,13,10,13,49,50,-1,49
Peterhead,3903,8,13,8,15,46,57,-11,47
Stranraer,3903,9,11,6,19,54,68,-14,39
Stenhousem'r,3903,10,7,8,21,53,86,-33,29
Livingston,3904,1,23,5,8,85,44,41,74
Alloa,3904,2,21,7,8,74,42,32,70
Airdrieon,3904,3,19,6,11,68,60,8,63
Brechin,3904,4,17,5,14,53,52,1,56
Albion,3904,5,14,11,11,59,54,5,53
Stranraer,3904,6,14,6,16,64,67,-3,48
East Fife,3904,7,11,10,15,46,49,-3,43
Queen's Park,3904,8,10,5,21,39,60,-21,35
Peterhead,3904,9,10,4,22,43,68,-25,34
Stenhousem'r,3904,10,8,7,21,44,79,-35,31
Livingston,3905,1,23,3,10,81,49,32,72
Alloa,3905,2,19,6,11,77,45,32,63
Airdrieon,3905,3,19,3,14,57,52,5,60
East Fife,3905,4,18,5,13,57,43,14,59
Albion,3905,5,15,7,14,53,54,-1,52
Peterhead,3905,6,15,6,15,50,56,-6,51
Queen's Park,3905,7,14,6,16,47,46,1,48
Stranraer,3905,8,14,2,20,57,69,-12,44
Brechin,3905,9,11,4,21,45,67,-22,37
Stenhousem'r,3905,10,8,6,22,44,87,-43,30
Alloa,3906,1,21,7,8,73,44,29,70
Livingston,3906,2,20,7,9,64,36,28,67
Airdrieon,3906,3,17,6,13,63,58,5,57
Queen's Park,3906,4,17,4,15,48,47,1,55
Brechin,3906,5,16,7,13,45,44,1,55
Stranraer,3906,6,15,6,15,46,50,-4,51
East Fife,3906,7,12,10,14,49,48,1,46
Peterhead,3906,8,11,8,17,50,60,-10,41
Albion,3906,9,10,9,17,40,51,-11,39
Stenhousem'r,3906,10,5,8,23,46,86,-40,23
Alloa,3907,1,21,6,9,71,44,27,69
Brechin,3907,2,18,6,12,52,44,8,60
Livingston,3907,3,16,9,11,65,50,15,57
Albion,3907,4,16,6,14,62,58,4,54
Airdrieon,3907,5,15,5,16,57,61,-4,50
Stranraer,3907,6,14,7,15,57,56,1,49
East Fife,3907,7,12,8,16,45,44,1,44
Queen's Park,3907,8,12,8,16,33,47,-14,44
Peterhead,3907,9,12,6,18,42,55,-13,42
Stenhousem'r,3907,10,9,9,18,44,69,-25,36
Alloa,3908,1,20,10,6,82,51,31,70
Livingston,3908,2,18,6,12,67,51,16,60
Airdrieon,3908,3,17,8,11,65,56,9,59
Stranraer,3908,4,17,7,12,62,53,9,58
Brechin,3908,5,17,3,16,50,50,0,54
Peterhead,3908,6,13,9,14,48,46,2,48
Albion,3908,7,11,10,15,48,51,-3,43
Stenhousem'r,3908,8,11,7,18,47,77,-30,40
Queen's Park,3908,9,11,5,20,34,57,-23,38
East Fife,3908,10,9,7,20,44,55,-11,34
Livingston,3909,1,20,1,15,63,48,15,61
Alloa,3909,2,18,6,12,67,49,18,60
Airdrieon,3909,3,17,8,11,57,47,10,59
Brechin,3909,4,17,5,14,49,45,4,56
Peterhead,3909,5,14,8,14,44,49,-5,50
Stranraer,3909,6,13,10,13,51,49,2,49
East Fife,3909,7,12,11,13,47,39,8,47
Queen's Park,3909,8,13,6,17,38,51,-13,45
Albion,3909,9,13,6,17,49,63,-14,45
Stenhousem'r,3909,10,7,11,18,46,71,-25,32
Alloa,3910,1,23,7,6,79,42,37,76
Livingston,3910,2,20,5,11,72,52,20,65
Stranraer,3910,3,16,3,17,57,51,6,51
East Fife,3910,4,14,9,13,50,44,6,51
Airdrieon,3910,5,15,5,16,52,57,-5,50
Peterhead,3910,6,12,10,14,58,63,-5,46
Albion,3910,7,12,10,14,55,61,-6,46
Brechin,3910,8,13,7,16,41,50,-9,46
Queen's Park,3910,9,10,7,19,40,62,-22,37
Stenhousem'r,3910,10,9,9,18,48,70,-22,36
Livingston,3911,1,22,4,10,78,42,36,70
Alloa,3911,2,19,6,11,74,47,27,63
Brechin,3911,3,18,5,13,55,49,6,59
Airdrieon,3911,4,17,5,14,55,60,-5,56
Peterhead,3911,5,15,6,15,51,56,-5,51
East Fife,3911,6,13,9,14,60,47,13,48
Albion,3911,7,13,9,14,52,51,1,48
Stranraer,3911,8,12,6,18,50,54,-4,42
Queen's Park,3911,9,11,5,20,30,58,-28,38
Stenhousem'r,3911,10,9,7,20,42,83,-41,34
Alloa,3912,1,22,6,8,90,41,49,72
Livingston,3912,2,23,3,10,82,47,35,72
Brechin,3912,3,19,7,10,53,46,7,64
Airdrieon,3912,4,15,8,13,52,56,-4,53
Albion,3912,5,14,9,13,54,56,-2,51
Stranraer,3912,6,13,5,18,54,62,-8,44
Peterhead,3912,7,12,7,17,51,63,-12,43
East Fife,3912,8,11,8,17,48,56,-8,41
Queen's Park,3912,9,9,9,18,33,55,-22,36
Stenhousem'r,3912,10,8,6,22,45,80,-35,30
Livingston,3913,1,23,5,8,89,42,47,74
Brechin,3913,2,16,9,11,48,45,3,57
Alloa,3913,3,13,12,11,60,42,18,51
Queen's Park,3913,4,15,6,15,41,50,-9,51
Airdrieon,3913,5,12,13,11,55,62,-7,49
Stranraer,3913,6,13,8,15,50,54,-4,47
East Fife,3913,7,13,8,15,45,51,-6,47
Albion,3913,8,12,8,16,60,59,1,44
Peterhead,3913,9,12,8,16,51,61,-10,44
Stenhousem'r,3913,10,9,7,20,46,79,-33,34
Alloa,3914,1,21,8,7,73,39,34,71
Livingston,3914,2,21,7,8,79,47,32,70
Airdrieon,3914,3,16,8,12,61,58,3,56
Albion,3914,4,14,11,11,46,51,-5,53
East Fife,3914,5,13,9,14,52,50,2,48
Stranraer,3914,6,14,6,16,54,60,-6,48
Peterhead,3914,7,13,6,17,40,45,-5,45
Brechin,3914,8,14,3,19,48,59,-11,45
Queen's Park,3914,9,10,7,19,37,57,-20,37
Stenhousem'r,3914,10,7,9,20,50,74,-24,30
Livingston,3915,1,22,5,9,80,47,33,71
Alloa,3915,2,17,10,9,62,42,20,61
Brechin,3915,3,15,12,9,52,42,10,57
Airdrieon,3915,4,17,6,13,63,58,5,57
Albion,3915,5,15,9,12,51,50,1,54
Peterhead,3915,6,13,6,17,43,53,-10,45
Queen's Park,3915,7,13,6,17,44,57,-13,45
East Fife,3915,8,10,11,15,51,52,-1,41
Stranraer,3915,9,11,4,21,43,61,-18,37
Stenhousem'r,3915,10,8,9,19,43,70,-27,33
Alloa,3916,1,19,5,12,66,44,22,62
Queen's Park,3916,2,17,8,11,47,46,1,59
Livingston,3916,3,17,7,12,66,44,22,58
Peterhead,3916,4,16,6,14,52,53,-1,54
Brechin,3916,5,15,6,15,51,49,2,51
East Fife,3916,6,14,8,14,55,50,5,50
Airdrieon,3916,7,14,7,15,56,63,-7,49
Albion,3916,8,11,10,15,50,56,-6,43
Stranraer,3916,9,11,6,19,35,52,-17,39
Stenhousem'r,3916,10,10,9,17,51,72,-21,39
Livingston,3917,1,21,8,7,82,45,37,71
Alloa,3917,2,16,11,9,70,49,21,59
Brechin,3917,3,17,5,14,51,51,0,56
Peterhead,3917,4,15,10,11,50,46,4,55
Albion,3917,5,15,7,14,51,50,1,52
Queen's Park,3917,6,13,9,14,42,46,-4,48
Airdrieon,3917,7,13,7,16,49,53,-4,46
Stranraer,3917,8,9,13,14,44,51,-7,40
East Fife,3917,9,10,9,17,49,59,-10,39
Stenhousem'r,3917,10,7,9,20,44,82,-38,30
Alloa,3918,1,19,9,8,72,43,29,66
Livingston,3918,2,20,6,10,77,54,23,66
Airdrieon,3918,3,18,6,12,56,46,10,60
Albion,3918,4,16,8,12,63,56,7,56
Queen's Park,3918,5,15,6,15,49,55,-6,51
Peterhead,3918,6,13,10,13,52,54,-2,49
Brechin,3918,7,14,6,16,54,56,-2,48
Stranraer,3918,8,14,3,19,49,61,-12,45
East Fife,3918,9,10,12,14,52,54,-2,42
Stenhousem'r,3918,10,4,8,24,41,86,-45,20
Alloa,3919,1,19,9,8,75,45,30,66
Livingston,3919,2,20,5,11,66,49,17,65
Airdrieon,3919,3,14,9,13,57,55,2,51
Peterhead,3919,4,14,9,13,54,53,1,51
Brechin,3919,5,14,8,14,43,48,-5,50
Stranraer,3919,6,14,7,15,55,50,5,49
Albion,3919,7,13,8,15,53,56,-3,47
East Fife,3919,8,12,8,16,49,46,3,44
Queen's Park,3919,9,12,7,17,34,52,-18,43
Stenhousem'r,3919,10,7,12,17,44,76,-32,33
Livingston,3920,1,21,6,9,76,42,34,69
Alloa,3920,2,19,9,8,67,44,23,66
Brechin,3920,3,18,5,13,55,53,2,59
Airdrieon,3920,4,17,3,16,52,60,-8,54
Peterhead,3920,5,14,10,12,50,46,4,52
Albion,3920,6,14,6,16,61,62,-1,48
Stranraer,3920,7,13,4,19,51,61,-10,43
Queen's Park,3920,8,12,7,17,35,49,-14,43
East Fife,3920,9,11,9,16,53,55,-2,42
Stenhousem'r,3920,10,7,9,20,45,73,-28,30
Alloa,3921,1,23,5,8,88,46,42,74
Livingston,3921,2,21,8,7,85,45,40,71
Airdrieon,3921,3,18,6,12,62,59,3,60
Albion,3921,4,15,10,11,60,52,8,55
Brechin,3921,5,15,5,16,50,59,-9,50
Peterhead,3921,6,11,11,14,50,60,-10,44
Queen's Park,3921,7,12,7,17,38,54,-16,43
East Fife,3921,8,9,13,14,42,54,-12,40
Stranraer,3921,9,10,6,20,55,69,-14,36
Stenhousem'r,3921,10,5,11,20,46,78,-32,26
Livingston,3922,1,25,6,5,77,35,42,81
Airdrieon,3922,2,16,12,8,60,54,6,60
Alloa,3922,3,16,10,10,72,41,31,58
East Fife,3922,4,16,7,13,55,48,7,55
Peterhead,3922,5,14,10,12,51,51,0,52
Stranraer,3922,6,13,8,15,53,57,-4,47
Albion,3922,7,12,9,15,52,52,0,45
Brechin,3922,8,11,8,17,43,54,-11,41
Queen's Park,3922,9,9,8,19,27,57,-30,35
Stenhousem'r,3922,10,6,6,24,43,84,-41,24
Livingston,3923,1,21,4,11,69,47,22,67
Alloa,3923,2,17,9,10,62,40,22,60
Albion,3923,3,17,6,13,66,53,13,57
Peterhead,3923,4,17,6,13,50,46,4,57
Airdrieon,3923,5,16,8,12,64,52,12,56
East Fife,3923,6,12,10,14,47,49,-2,46
Brechin,3923,7,13,6,17,48,60,-12,45
Stranraer,3923,8,12,8,16,50,59,-9,44
Queen's Park,3923,9,11,9,16,39,58,-19,42
Stenhousem'r,3923,10,8,6,22,46,77,-31,30
Livingston,3924,1,23,4,9,79,39,40,73
Alloa,3924,2,16,9,11,58,37,21,57
Brechin,3924,3,16,7,13,58,55,3,55
Airdrieon,3924,4,15,8,13,53,59,-6,53
Stranraer,3924,5,16,4,16,52,50,2,52
Peterhead,3924,6,15,7,14,45,50,-5,52
Albion,3924,7,13,7,16,50,52,-2,46
Queen's Park,3924,8,12,8,16,39,56,-17,44
East Fife,3924,9,12,6,18,42,50,-8,42
Stenhousem'r,3924,10,7,10,19,50,78,-28,31
Alloa,3925,1,22,6,8,74,39,35,72
Livingston,3925,2,21,6,9,82,44,38,69
Albion,3925,3,19,8,9,68,48,20,65
Brechin,3925,4,20,5,11,57,48,9,65
Airdrieon,3925,5,13,7,16,53,61,-8,46
Peterhead,3925,6,13,6,17,52,61,-9,45
Stranraer,3925,7,14,2,20,41,55,-14,44
Stenhousem'r,3925,8,12,7,17,46,69,-23,43
Queen's Park,3925,9,9,5,22,34,61,-27,32
East Fife,3925,10,8,6,22,41,62,-21,30
Livingston,3926,1,19,9,8,74,45,29,66
Alloa,3926,2,20,6,10,73,45,28,66
Queen's Park,3926,3,20,2,14,43,39,4,62
Brechin,3926,4,17,6,13,50,51,-1,57
Airdrieon,3926,5,15,8,13,47,47,0,53
Albion,3926,6,14,9,13,54,53,1,51
Peterhead,3926,7,10,10,16,47,56,-9,40
East Fife,3926,8,9,10,17,44,55,-11,37
Stranraer,3926,9,10,7,19,42,54,-12,37
Stenhousem'r,3926,10,8,9,19,47,76,-29,33
Livingston,3927,1,24,3,9,82,44,38,75
Stranraer,3927,2,18,3,15,52,52,0,57
Alloa,3927,3,16,7,13,63,53,10,55
Peterhead,3927,4,16,7,13,56,51,5,55
Brechin,3927,5,16,6,14,43,46,-3,54
Airdrieon,3927,6,16,5,15,51,52,-1,53
Albion,3927,7,16,3,17,47,46,1,51
East Fife,3927,8,13,8,15,50,47,3,47
Queen's Park,3927,9,10,7,19,36,57,-21,37
Stenhousem'r,3927,10,8,5,23,48,80,-32,29
Livingston,3928,1,23,5,8,88,48,40,74
Queen's Park,3928,2,18,5,13,52,53,-1,59
Alloa,3928,3,17,7,12,66,52,14,58
Peterhead,3928,4,15,6,15,55,56,-1,51
Albion,3928,5,15,5,16,56,53,3,50
Airdrieon,3928,6,14,8,14,53,52,1,50
Stranraer,3928,7,14,5,17,56,61,-5,47
Brechin,3928,8,14,4,18,46,59,-13,46
East Fife,3928,9,10,8,18,43,51,-8,38
Stenhousem'r,3928,10,10,7,19,44,74,-30,37
Alloa,3929,1,23,6,7,79,41,38,75
Livingston,3929,2,22,2,12,82,48,34,68
Airdrieon,3929,3,18,8,10,59,50,9,62
East Fife,3929,4,15,11,10,55,46,9,56
Brechin,3929,5,16,6,14,47,45,2,54
Queen's Park,3929,6,14,7,15,42,47,-5,49
Albion,3929,7,12,7,17,52,60,-8,43
Peterhead,3929,8,10,8,18,38,57,-19,38
Stranraer,3929,9,8,9,19,46,64,-18,33
Stenhousem'r,3929,10,6,8,22,36,78,-42,26
Airdrieon,3930,1,22,4,10,57,44,13,70
Livingston,3930,2,18,5,13,72,59,13,59
Brechin,3930,3,17,5,14,54,51,3,56
Albion,3930,4,14,11,11,54,46,8,53
Peterhead,3930,5,14,11,11,53,50,3,53
Alloa,3930,6,14,9,13,59,47,12,51
Stranraer,3930,7,14,8,14,56,53,3,50
Queen's Park,3930,8,10,13,13,38,47,-9,43
Stenhousem'r,3930,9,8,8,20,46,78,-32,32
East Fife,3930,10,6,12,18,39,53,-14,30
Livingston,3931,1,24,4,8,80,43,37,76
Alloa,3931,2,20,8,8,72,42,30,68
Peterhead,3931,3,19,9,8,59,42,17,66
Airdrieon,3931,4,18,3,15,61,53,8,57
Albion,3931,5,14,6,16,52,58,-6,48
Queen's Park,3931,6,14,5,17,50,56,-6,47
Stranraer,3931,7,11,7,18,51,61,-10,40
Brechin,3931,8,10,9,17,43,65,-22,39
East Fife,3931,9,11,4,21,47,57,-10,37
Stenhousem'r,3931,10,7,9,20,42,80,-38,30
Alloa,3932,1,19,9,8,67,40,27,66
Livingston,3932,2,19,8,9,82,44,38,65
Brechin,3932,3,19,6,11,60,48,12,63
Albion,3932,4,17,7,12,59,45,14,58
Airdrieon,3932,5,15,7,14,56,57,-1,52
Peterhead,3932,6,13,9,14,49,55,-6,48
Stranraer,3932,7,13,5,18,54,61,-7,44
Queen's Park,3932,8,11,8,17,29,48,-19,41
East Fife,3932,9,7,13,16,40,56,-16,34
Stenhousem'r,3932,10,5,12,19,43,85,-42,27
Livingston,3933,1,24,6,6,85,38,47,78
Brechin,3933,2,18,7,11,53,40,13,61
Alloa,3933,3,16,11,9,66,46,20,59
Queen's Park,3933,4,15,6,15,44,47,-3,51
Albion,3933,5,12,11,13,46,53,-7,47
Airdrieon,3933,6,12,10,14,43,51,-8,46
Peterhead,3933,7,10,10,16,40,54,-14,40
Stranraer,3933,8,11,6,19,43,59,-16,39
East Fife,3933,9,9,11,16,43,46,-3,38
Stenhousem'r,3933,10,9,10,17,42,71,-29,37
Livingston,3934,1,21,5,10,82,43,39,68
Brechin,3934,2,20,8,8,53,35,18,68
Alloa,3934,3,19,8,9,68,44,24,65
Albion,3934,4,16,10,10,54,49,5,58
Airdrieon,3934,5,15,8,13,57,56,1,53
Peterhead,3934,6,14,5,17,46,60,-14,47
East Fife,3934,7,11,9,16,45,48,-3,42
Stranraer,3934,8,10,8,18,48,69,-21,38
Queen's Park,3934,9,11,4,21,35,54,-19,37
Stenhousem'r,3934,10,6,9,21,43,73,-30,27
Alloa,3935,1,22,6,8,78,41,37,72
Livingston,3935,2,18,8,10,74,50,24,62
Peterhead,3935,3,17,7,12,51,42,9,58
Brechin,3935,4,17,5,14,61,52,9,56
Airdrieon,3935,5,14,9,13,55,59,-4,51
Queen's Park,3935,6,12,10,14,50,60,-10,46
East Fife,3935,7,11,10,15,42,51,-9,43
Albion,3935,8,11,9,16,45,57,-12,42
Stranraer,3935,9,10,6,20,51,69,-18,36
Stenhousem'r,3935,10,9,8,19,55,81,-26,35
Alloa,3936,1,18,8,10,76,48,28,62
Livingston,3936,2,18,6,12,74,57,17,60
Brechin,3936,3,16,7,13,63,56,7,55
Peterhead,3936,4,15,9,12,52,53,-1,54
Airdrieon,3936,5,13,9,14,55,61,-6,48
Queen's Park,3936,6,11,11,14,37,46,-9,44
Stranraer,3936,7,12,8,16,48,62,-14,44
East Fife,3936,8,10,13,13,53,53,0,43
Albion,3936,9,9,14,13,44,47,-3,41
Stenhousem'r,3936,10,9,13,14,50,69,-19,40
Alloa,3937,1,19,9,8,69,42,27,66
Brechin,3937,2,19,5,12,61,50,11,62
Livingston,3937,3,16,9,11,74,50,24,57
East Fife,3937,4,14,10,12,56,44,12,52
Airdrieon,3937,5,14,10,12,59,56,3,52
Queen's Park,3937,6,15,6,15,40,47,-7,51
Peterhead,3937,7,14,7,15,49,56,-7,49
Albion,3937,8,11,10,15,45,49,-4,43
Stranraer,3937,9,8,10,18,43,63,-20,34
Stenhousem'r,3937,10,7,10,19,36,75,-39,31
Livingston,3938,1,23,3,10,79,36,43,72
Albion,3938,2,16,9,11,64,43,21,57
East Fife,3938,3,16,7,13,55,44,11,55
Queen's Park,3938,4,16,6,14,39,44,-5,54
Airdrieon,3938,5,14,11,11,48,53,-5,53
Brechin,3938,6,16,5,15,47,53,-6,53
Peterhead,3938,7,12,10,14,50,63,-13,46
Alloa,3938,8,11,12,13,54,48,6,45
Stranraer,3938,9,12,6,18,45,53,-8,42
Stenhousem'r,3938,10,6,7,23,42,86,-44,25
Livingston,3939,1,22,5,9,89,48,41,71
Alloa,3939,2,16,8,12,65,45,20,56
Airdrieon,3939,3,16,8,12,57,58,-1,56
Brechin,3939,4,17,4,15,45,44,1,55
Peterhead,3939,5,16,6,14,46,47,-1,54
East Fife,3939,6,15,8,13,58,48,10,53
Queen's Park,3939,7,14,9,13,41,50,-9,51
Stranraer,3939,8,13,4,19,50,57,-7,43
Albion,3939,9,9,10,17,47,62,-15,37
Stenhousem'r,3939,10,9,4,23,45,84,-39,31
Livingston,3940,1,23,7,6,76,42,34,76
Alloa,3940,2,18,9,9,74,43,31,63
Brechin,3940,3,17,6,13,56,49,7,57
Albion,3940,4,16,8,12,54,51,3,56
Peterhead,3940,5,15,5,16,45,51,-6,50
Queen's Park,3940,6,14,5,17,47,61,-14,47
Airdrieon,3940,7,14,5,17,57,74,-17,47
East Fife,3940,8,11,7,18,51,51,0,40
Stranraer,3940,9,10,6,20,46,59,-13,36
Stenhousem'r,3940,10,10,6,20,52,77,-25,36
Alloa,3941,1,23,6,7,83,32,51,75
Livingston,3941,2,22,3,11,65,43,22,69
Airdrieon,3941,3,17,9,10,74,55,19,60
Brechin,3941,4,19,2,15,59,49,10,59
Albion,3941,5,15,8,13,54,52,2,53
East Fife,3941,6,12,10,14,49,52,-3,46
Peterhead,3941,7,13,5,18,49,66,-17,44
Stranraer,3941,8,11,6,19,45,69,-24,39
Queen's Park,3941,9,9,7,20,33,58,-25,34
Stenhousem'r,3941,10,8,6,22,48,83,-35,30
Livingston,3942,1,24,6,6,81,40,41,78
Brechin,3942,2,21,4,11,58,38,20,67
Alloa,3942,3,17,8,11,66,49,17,59
Airdrieon,3942,4,15,7,14,50,51,-1,52
Albion,3942,5,14,8,14,56,50,6,50
Queen's Park,3942,6,14,6,16,41,51,-10,48
Peterhead,3942,7,14,5,17,46,57,-11,47
East Fife,3942,8,10,8,18,42,49,-7,38
Stranraer,3942,9,12,2,22,42,64,-22,38
Stenhousem'r,3942,10,9,6,21,47,80,-33,33
Livingston,3943,1,22,6,8,77,43,34,72
Alloa,3943,2,21,4,11,76,49,27,67
Brechin,3943,3,16,6,14,55,64,-9,54
Queen's Park,3943,4,14,10,12,46,50,-4,52
Airdrieon,3943,5,15,6,15,52,50,2,51
Albion,3943,6,14,7,15,50,53,-3,49
Stranraer,3943,7,14,5,17,54,58,-4,47
East Fife,3943,8,10,10,16,40,41,-1,40
Peterhead,3943,9,11,6,19,46,59,-13,39
Stenhousem'r,3943,10,9,8,19,49,78,-29,35
Alloa,3944,1,23,7,6,79,39,40,76
Livingston,3944,2,22,5,9,79,45,34,71
Albion,3944,3,15,8,13,57,51,6,53
Peterhead,3944,4,14,10,12,46,45,1,52
Airdrieon,3944,5,15,6,15,55,54,1,51
Stranraer,3944,6,15,4,17,52,57,-5,49
Brechin,3944,7,14,3,19,44,61,-17,45
East Fife,3944,8,11,11,14,56,53,3,44
Queen's Park,3944,9,9,8,19,32,56,-24,35
Stenhousem'r,3944,10,7,8,21,39,78,-39,29
Alloa,3945,1,21,8,7,88,41,47,71
Livingston,3945,2,19,5,12,77,53,24,62
Airdrieon,3945,3,18,5,13,62,65,-3,59
Brechin,3945,4,15,7,14,42,55,-13,52
Peterhead,3945,5,14,9,13,56,53,3,51
Queen's Park,3945,6,13,8,15,43,53,-10,47
Stranraer,3945,7,11,11,14,54,58,-4,44
Albion,3945,8,10,12,14,45,49,-4,42
East Fife,3945,9,10,11,15,46,54,-8,41
Stenhousem'r,3945,10,6,10,20,49,81,-32,28
Livingston,3946,1,26,3,7,76,36,40,81
Alloa,3946,2,20,5,11,72,42,30,65
Airdrieon,3946,3,18,7,11,61,55,6,61
Brechin,3946,4,15,6,15,51,50,1,51
East Fife,3946,5,13,7,16,49,54,-5,46
Albion,3946,6,13,6,17,52,59,-7,45
Queen's Park,3946,7,13,4,19,37,49,-12,43
Stranraer,3946,8,12,6,18,51,64,-13,42
Peterhead,3946,9,10,10,16,39,51,-12,40
Stenhousem'r,3946,10,11,4,21,53,81,-28,37
Alloa,3947,1,21,7,8,70,42,28,70
Livingston,3947,2,20,5,11,81,52,29,65
Airdrieon,3947,3,17,8,11,59,51,8,59
Queen's Park,3947,4,16,4,16,40,41,-1,52
East Fife,3947,5,12,11,13,46,44,2,47
Brechin,3947,6,13,7,16,46,53,-7,46
Stranraer,3947,7,12,9,15,47,56,-9,45
Peterhead,3947,8,11,10,15,44,59,-15,43
Albion,3947,9,11,7,18,49,61,-12,40
Stenhousem'r,3947,10,8,10,18,40,63,-23,34
Livingston,3948,1,21,7,8,87,51,36,70
Airdrieon,3948,2,17,10,9,57,47,10,61
Alloa,3948,3,17,9,10,71,52,19,60
Brechin,3948,4,15,12,9,56,48,8,57
Stranraer,3948,5,15,5,16,48,53,-5,50
Queen's Park,3948,6,13,8,15,41,48,-7,47
Peterhead,3948,7,12,9,15,46,48,-2,45
East Fife,3948,8,10,12,14,46,48,-2,42
Albion,3948,9,11,6,19,43,66,-23,39
Stenhousem'r,3948,10,6,8,22,41,75,-34,26
Livingston,3949,1,19,5,12,78,52,26,62
Alloa,3949,2,18,7,11,62,42,20,61
Brechin,3949,3,17,7,12,52,48,4,58
Albion,3949,4,15,8,13,57,52,5,53
Stranraer,3949,5,16,5,15,56,55,1,53
Airdrieon,3949,6,15,6,15,57,55,2,51
East Fife,3949,7,11,10,15,48,55,-7,43
Peterhead,3949,8,11,10,15,47,59,-12,43
Stenhousem'r,3949,9,10,10,16,47,70,-23,40
Queen's Park,3949,10,11,6,19,30,46,-16,39
Livingston,3950,1,24,4,8,87,46,41,76
Alloa,3950,2,19,6,11,77,48,29,63
Brechin,3950,3,20,3,13,46,46,0,63
Airdrieon,3950,4,16,7,13,62,54,8,55
Albion,3950,5,13,9,14,52,60,-8,48
East Fife,3950,6,13,8,15,52,48,4,47
Queen's Park,3950,7,13,7,16,39,54,-15,46
Stranraer,3950,8,13,4,19,59,69,-10,43
Peterhead,3950,9,10,11,15,40,54,-14,41
Stenhousem'r,3950,10,6,7,23,35,70,-35,25
Alloa,3951,1,20,8,8,71,37,34,68
Livingston,3951,2,19,6,11,69,51,18,63
Airdrieon,3951,3,18,7,11,59,53,6,61
Queen's Park,3951,4,16,8,12,40,45,-5,56
Albion,3951,5,15,5,16,50,48,2,50
Peterhead,3951,6,13,10,13,41,45,-4,49
Brechin,3951,7,12,11,13,43,50,-7,47
Stranraer,3951,8,13,6,17,41,56,-15,45
East Fife,3951,9,7,11,18,47,47,0,32
Stenhousem'r,3951,10,6,10,20,50,79,-29,28
Alloa,3952,1,19,8,9,72,48,24,65
Brechin,3952,2,18,7,11,54,42,12,61
Livingston,3952,3,17,7,12,73,55,18,58
Airdrieon,3952,4,16,8,12,58,54,4,56
Peterhead,3952,5,13,10,13,49,55,-6,49
East Fife,3952,6,12,9,15,55,45,10,45
Stranraer,3952,7,13,5,18,46,57,-11,44
Albion,3952,8,12,7,17,47,58,-11,43
Stenhousem'r,3952,9,11,10,15,66,82,-16,43
Queen's Park,3952,10,9,9,18,27,51,-24,36
Livingston,3953,1,20,7,9,78,48,30,67
Airdrieon,3953,2,20,6,10,67,50,17,66
Alloa,3953,3,16,9,11,68,49,19,57
Queen's Park,3953,4,15,6,15,43,48,-5,51
Brechin,3953,5,15,4,17,50,51,-1,49
Peterhead,3953,6,14,7,15,50,54,-4,49
Stranraer,3953,7,15,3,18,50,55,-5,48
Albion,3953,8,13,7,16,52,54,-2,46
East Fife,3953,9,11,9,16,46,51,-5,42
Stenhousem'r,3953,10,8,8,20,52,96,-44,32
Livingston,3954,1,21,6,9,66,42,24,69
Alloa,3954,2,17,13,6,73,42,31,64
Queen's Park,3954,3,16,8,12,42,44,-2,56
Airdrieon,3954,4,15,10,11,53,52,1,55
East Fife,3954,5,13,10,13,52,41,11,49
Albion,3954,6,14,6,16,54,57,-3,48
Peterhead,3954,7,13,6,17,52,54,-2,45
Brechin,3954,8,11,12,13,46,54,-8,45
Stenhousem'r,3954,9,11,5,20,64,82,-18,38
Stranraer,3954,10,9,4,23,43,77,-34,31
Brechin,3955,1,21,4,11,50,41,9,67
Airdrieon,3955,2,18,8,10,65,47,18,62
Alloa,3955,3,17,7,12,64,46,18,58
Livingston,3955,4,17,6,13,71,53,18,57
Albion,3955,5,16,7,13,59,47,12,55
Queen's Park,3955,6,14,6,16,40,52,-12,48
East Fife,3955,7,13,7,16,43,41,2,46
Peterhead,3955,8,9,12,15,40,58,-18,39
Stenhousem'r,3955,9,10,7,19,41,71,-30,37
Stranraer,3955,10,10,6,20,42,59,-17,36
Livingston,3956,1,24,5,7,83,42,41,77
Airdrieon,3956,2,19,7,10,68,50,18,64
Alloa,3956,3,19,5,12,68,40,28,62
Albion,3956,4,18,5,13,57,49,8,59
Brechin,3956,5,17,4,15,56,63,-7,55
Peterhead,3956,6,13,6,17,56,61,-5,45
Queen's Park,3956,7,14,2,20,41,65,-24,44
East Fife,3956,8,11,7,18,50,54,-4,40
Stranraer,3956,9,12,3,21,47,67,-20,39
Stenhousem'r,3956,10,8,6,22,47,82,-35,30
Livingston,3957,1,21,9,6,78,42,36,72
Airdrieon,3957,2,21,4,11,64,52,12,67
Brechin,3957,3,18,8,10,52,48,4,62
Alloa,3957,4,16,9,11,61,45,16,57
Albion,3957,5,13,9,14,52,54,-2,48
Peterhead,3957,6,13,8,15,48,48,0,47
Queen's Park,3957,7,11,8,17,34,48,-14,41
Stranraer,3957,8,10,7,19,48,61,-13,37
East Fife,3957,9,8,11,17,40,51,-11,35
Stenhousem'r,3957,10,8,9,19,49,77,-28,33
Livingston,3958,1,22,4,10,83,46,37,70
Alloa,3958,2,16,10,10,70,49,21,58
Stranraer,3958,3,18,4,14,57,56,1,58
Brechin,3958,4,15,9,12,57,55,2,54
Peterhead,3958,5,15,8,13,63,57,6,53
Airdrieon,3958,6,15,6,15,50,54,-4,51
Albion,3958,7,13,7,16,54,59,-5,46
Queen's Park,3958,8,12,8,16,40,50,-10,44
East Fife,3958,9,10,8,18,56,63,-7,38
Stenhousem'r,3958,10,8,8,20,45,86,-41,32
Livingston,3959,1,20,5,11,71,53,18,65
Albion,3959,2,18,8,10,62,47,15,62
Alloa,3959,3,17,10,9,73,46,27,61
Airdrieon,3959,4,16,9,11,60,49,11,57
Stranraer,3959,5,15,7,14,48,50,-2,52
Brechin,3959,6,13,12,11,48,43,5,51
Peterhead,3959,7,13,11,12,49,47,2,50
East Fife,3959,8,9,11,16,43,51,-8,38
Queen's Park,3959,9,9,7,20,37,61,-24,34
Stenhousem'r,3959,10,6,8,22,43,87,-44,26
Airdrieon,3960,1,19,8,9,62,54,8,65
Livingston,3960,2,19,4,13,68,47,21,61
Brechin,3960,3,16,11,9,50,46,4,59
Alloa,3960,4,16,9,11,70,49,21,57
Peterhead,3960,5,14,9,13,51,52,-1,51
Queen's Park,3960,6,13,9,14,46,51,-5,48
Stranraer,3960,7,13,4,19,49,55,-6,43
East Fife,3960,8,11,9,16,41,46,-5,42
Albion,3960,9,11,8,17,45,53,-8,41
Stenhousem'r,3960,10,8,9,19,46,75,-29,33
Livingston,3961,1,22,4,10,84,52,32,70
Alloa,3961,2,19,6,11,68,43,25,63
Brechin,3961,3,19,6,11,61,52,9,63
Airdrieon,3961,4,17,8,11,60,57,3,59
Peterhead,3961,5,15,10,11,52,48,4,55
Queen's Park,3961,6,13,8,15,41,50,-9,47
East Fife,3961,7,13,7,16,55,50,5,46
Albion,3961,8,12,8,16,47,49,-2,44
Stenhousem'r,3961,9,7,9,20,49,84,-35,30
Stranraer,3961,10,7,6,23,45,77,-32,27
Livingston,3962,1,21,4,11,68,44,24,67
Airdrieon,3962,2,18,6,12,55,51,4,60
Albion,3962,3,17,8,11,62,48,14,59
Alloa,3962,4,16,7,13,65,46,19,55
Brechin,3962,5,14,9,13,48,50,-2,51
Queen's Park,3962,6,15,6,15,44,46,-2,51
Peterhead,3962,7,14,7,15,45,56,-11,49
East Fife,3962,8,10,10,16,46,48,-2,40
Stenhousem'r,3962,9,9,10,17,47,71,-24,37
Stranraer,3962,10,9,7,20,44,64,-20,34
Alloa,3963,1,21,6,9,75,43,32,69
Airdrieon,3963,2,19,6,11,68,57,11,63
Livingston,3963,3,17,10,9,75,53,22,61
Albion,3963,4,16,5,15,57,49,8,53
Peterhead,3963,5,14,9,13,59,58,1,51
East Fife,3963,6,13,11,12,48,41,7,50
Brechin,3963,7,14,7,15,48,52,-4,49
Queen's Park,3963,8,12,10,14,39,49,-10,46
Stenhousem'r,3963,9,7,9,20,49,86,-37,30
Stranraer,3963,10,7,7,22,40,70,-30,28
Livingston,3964,1,23,5,8,78,42,36,74
Alloa,3964,2,19,5,12,65,45,20,62
Airdrieon,3964,3,19,5,12,61,53,8,62
Albion,3964,4,13,11,12,51,54,-3,50
Peterhead,3964,5,14,6,16,46,51,-5,48
Brechin,3964,6,13,7,16,43,48,-5,46
Queen's Park,3964,7,12,9,15,41,51,-10,45
Stranraer,3964,8,12,6,18,53,60,-7,42
East Fife,3964,9,11,8,17,45,49,-4,41
Stenhousem'r,3964,10,10,6,20,47,77,-30,36
Livingston,3965,1,22,7,7,76,39,37,73
Alloa,3965,2,18,10,8,67,43,24,64
East Fife,3965,3,14,10,12,44,37,7,52
Peterhead,3965,4,14,10,12,53,51,2,52
Brechin,3965,5,15,4,17,46,55,-9,49
Stranraer,3965,6,14,5,17,47,54,-7,47
Queen's Park,3965,7,12,9,15,37,50,-13,45
Airdrieon,3965,8,13,5,18,48,59,-11,44
Albion,3965,9,10,11,15,45,50,-5,41
Stenhousem'r,3965,10,9,7,20,45,70,-25,34
Livingston,3966,1,24,4,8,79,42,37,76
Alloa,3966,2,19,8,9,79,47,32,65
Brechin,3966,3,19,5,12,49,46,3,62
Airdrieon,3966,4,17,5,14,61,56,5,56
Albion,3966,5,13,10,13,55,57,-2,49
Peterhead,3966,6,11,11,14,48,55,-7,44
Queen's Park,3966,7,10,11,15,43,62,-19,41
Stranraer,3966,8,11,7,18,49,64,-15,40
East Fife,3966,9,9,9,18,48,53,-5,36
Stenhousem'r,3966,10,9,6,21,48,77,-29,33
Livingston,3967,1,20,6,10,82,50,32,66
Alloa,3967,2,18,10,8,69,50,19,64
Brechin,3967,3,18,4,14,46,47,-1,58
Albion,3967,4,16,9,11,61,48,13,57
Airdrieon,3967,5,16,6,14,61,71,-10,54
Queen's Park,3967,6,13,6,17,44,50,-6,45
East Fife,3967,7,11,10,15,47,48,-1,43
Stranraer,3967,8,12,7,17,57,59,-2,43
Peterhead,3967,9,12,7,17,51,60,-9,43
Stenhousem'r,3967,10,8,7,21,48,83,-35,31
Alloa,3968,1,20,9,7,69,42,27,69
Brechin,3968,2,19,6,11,57,42,15,63
Livingston,3968,3,18,4,14,78,58,20,58
Stranraer,3968,4,15,7,14,53,52,1,52
Airdrieon,3968,5,15,5,16,57,68,-11,50
Albion,3968,6,13,10,13,58,54,4,49
Queen's Park,3968,7,15,3,18,48,56,-8,48
Peterhead,3968,8,10,13,13,45,58,-13,43
East Fife,3968,9,10,10,16,52,56,-4,40
Stenhousem'r,3968,10,7,9,20,49,80,-31,30
Brechin,3969,1,21,7,8,64,44,20,70
Livingston,3969,2,21,5,10,72,49,23,68
Airdrieon,3969,3,18,6,12,64,57,7,60
Alloa,3969,4,16,8,12,72,51,21,56
Peterhead,3969,5,13,9,14,55,63,-8,48
Albion,3969,6,10,13,13,48,54,-6,43
Queen's Park,3969,7,10,11,15,40,55,-15,41
East Fife,3969,8,10,10,16,50,54,-4,40
Stranraer,3969,9,10,8,18,52,65,-13,38
Stenhousem'r,3969,10,9,7,20,52,77,-25,34
Alloa,3970,1,19,8,9,70,44,26,65
Livingston,3970,2,18,8,10,74,54,20,62
Peterhead,3970,3,16,11,9,50,45,5,59
Airdrieon,3970,4,16,10,10,54,44,10,58
Albion,3970,5,14,9,13,58,50,8,51
Brechin,3970,6,14,8,14,46,50,-4,50
Queen's Park,3970,7,12,8,16,36,51,-15,44
East Fife,3970,8,12,7,17,49,52,-3,43
Stranraer,3970,9,11,7,18,52,59,-7,40
Stenhousem'r,3970,10,5,10,21,39,79,-40,25
Livingston,3971,1,22,6,8,89,39,50,72
Alloa,3971,2,18,5,13,65,44,21,59
Peterhead,3971,3,17,8,11,56,47,9,59
Brechin,3971,4,16,8,12,51,46,5,56
Airdrieon,3971,5,16,5,15,66,65,1,53
Queen's Park,3971,6,15,6,15,41,51,-10,51
Stranraer,3971,7,14,6,16,51,62,-11,48
Albion,3971,8,11,8,17,41,52,-11,41
East Fife,3971,9,8,10,18,40,53,-13,34
Stenhousem'r,3971,10,9,6,21,40,81,-41,33
Livingston,3972,1,22,6,8,77,41,36,72
Airdrieon,3972,2,17,9,10,58,53,5,60
Alloa,3972,3,15,11,10,58,43,15,56
Brechin,3972,4,17,5,14,53,49,4,56
Albion,3972,5,15,5,16,55,59,-4,50
East Fife,3972,6,14,7,15,54,48,6,49
Queen's Park,3972,7,13,7,16,42,56,-14,46
Peterhead,3972,8,11,10,15,43,55,-12,43
Stranraer,3972,9,11,9,16,45,50,-5,42
Stenhousem'r,3972,10,8,5,23,45,76,-31,29
Alloa,3973,1,23,5,8,83,46,37,74
Albion,3973,2,18,7,11,66,44,22,61
Livingston,3973,3,19,3,14,86,59,27,60
Airdrieon,3973,4,16,7,13,48,56,-8,55
Brechin,3973,5,16,5,15,59,60,-1,53
Peterhead,3973,6,14,7,15,47,55,-8,49
Queen's Park,3973,7,15,4,17,39,51,-12,49
East Fife,3973,8,11,7,18,52,53,-1,40
Stranraer,3973,9,11,5,20,53,72,-19,38
Stenhousem'r,3973,10,9,6,21,43,80,-37,33
Livingston,3974,1,23,3,10,74,43,31,72
Alloa,3974,2,16,8,12,67,43,24,56
Albion,3974,3,15,10,11,62,51,11,55
Peterhead,3974,4,16,7,13,51,40,11,55
Brechin,3974,5,15,7,14,47,56,-9,52
Airdrieon,3974,6,15,6,15,50,60,-10,51
East Fife,3974,7,11,11,14,56,49,7,44
Queen's Park,3974,8,13,5,18,31,45,-14,44
Stranraer,3974,9,12,5,19,58,73,-15,41
Stenhousem'r,3974,10,10,6,20,39,75,-36,36
Brechin,3975,1,23,6,7,63,35,28,75
Airdrieon,3975,2,19,6,11,60,54,6,63
Alloa,3975,3,18,7,11,75,51,24,61
Livingston,3975,4,16,4,16,72,58,14,52
Peterhead,3975,5,14,9,13,60,59,1,51
Albion,3975,6,13,10,13,48,49,-1,49
Stranraer,3975,7,13,6,17,57,67,-10,45
East Fife,3975,8,11,10,15,53,50,3,43
Queen's Park,3975,9,10,6,20,35,60,-25,36
Stenhousem'r,3975,10,8,6,22,45,85,-40,30
Livingston,3976,1,21,6,9,74,50,24,69
Alloa,3976,2,18,11,7,65,44,21,65
Peterhead,3976,3,17,7,12,55,47,8,58
Brechin,3976,4,17,5,14,61,49,12,56
Stranraer,3976,5,14,8,14,56,56,0,50
Airdrieon,3976,6,13,11,12,51,55,-4,50
East Fife,3976,7,12,9,15,48,41,7,45
Albion,3976,8,12,7,17,51,58,-7,43
Queen's Park,3976,9,10,8,18,33,56,-23,38
Stenhousem'r,3976,10,5,10,21,35,73,-38,25
Livingston,3977,1,22,5,9,76,43,33,71
Airdrieon,3977,2,18,7,11,55,42,13,61
Alloa,3977,3,16,11,9,69,45,24,59
Albion,3977,4,15,10,11,55,43,12,55
Queen's Park,3977,5,16,2,18,37,53,-16,50
Brechin,3977,6,14,6,16,44,47,-3,48
East Fife,3977,7,13,6,17,51,60,-9,45
Peterhead,3977,8,11,10,15,43,48,-5,43
Stranraer,3977,9,10,7,19,43,63,-20,37
Stenhousem'r,3977,10,10,6,20,50,79,-29,36
Queen's Park,3978,1,19,6,11,51,40,11,63
Airdrieon,3978,2,16,11,9,58,44,14,59
Albion,3978,3,17,8,11,48,41,7,59
Livingston,3978,4,16,10,10,68,53,15,58
Alloa,3978,5,17,6,13,65,49,16,57
Brechin,3978,6,16,5,15,46,47,-1,53
Peterhead,3978,7,14,9,13,54,49,5,51
East Fife,3978,8,10,11,15,46,48,-2,41
Stranraer,3978,9,10,5,21,45,64,-19,35
Stenhousem'r,3978,10,5,9,22,36,82,-46,24
Alloa,3979,1,19,8,9,77,51,26,65
Brechin,3979,2,19,7,10,54,37,17,64
Airdrieon,3979,3,19,5,12,60,54,6,62
Livingston,3979,4,19,3,14,68,52,16,60
Peterhead,3979,5,15,6,15,63,63,0,51
Albion,3979,6,15,5,16,53,51,2,50
Queen's Park,3979,7,12,6,18,38,62,-24,42
Stranraer,3979,8,12,5,19,54,62,-8,41
Stenhousem'r,3979,9,12,5,19,52,76,-24,41
East Fife,3979,10,7,12,17,43,54,-11,33
Livingston,3980,1,20,6,10,76,45,31,66
Alloa,3980,2,20,5,11,64,43,21,65
Brechin,3980,3,20,4,12,62,51,11,64
Airdrieon,3980,4,16,5,15,62,52,10,53
Queen's Park,3980,5,16,5,15,42,46,-4,53
Peterhead,3980,6,14,7,15,55,62,-7,49
Albion,3980,7,14,6,16,54,57,-3,48
East Fife,3980,8,13,7,16,49,50,-1,46
Stenhousem'r,3980,9,9,9,18,46,78,-32,36
Stranraer,3980,10,7,8,21,44,70,-26,29
Livingston,3981,1,22,4,10,77,50,27,70
Alloa,3981,2,20,6,10,75,50,25,66
Airdrieon,3981,3,17,5,14,65,56,9,56
Brechin,3981,4,16,8,12,53,47,6,56
Queen's Park,3981,5,14,10,12,37,41,-4,52
Stranraer,3981,6,14,6,16,53,60,-7,48
Albion,3981,7,12,11,13,48,49,-1,47
East Fife,3981,8,10,10,16,49,47,2,40
Peterhead,3981,9,9,9,18,49,72,-23,36
Stenhousem'r,3981,10,7,9,20,42,76,-34,30
Alloa,3982,1,18,9,9,65,39,26,63
Livingston,3982,2,17,9,10,76,56,20,60
Airdrieon,3982,3,17,6,13,58,61,-3,57
Peterhead,3982,4,15,10,11,55,49,6,55
Stranraer,3982,5,14,8,14,56,55,1,50
Brechin,3982,6,15,5,16,45,49,-4,50
East Fife,3982,7,12,9,15,49,46,3,45
Queen's Park,3982,8,10,11,15,39,51,-12,41
Stenhousem'r,3982,9,11,8,17,44,66,-22,41
Albion,3982,10,9,9,18,53,68,-15,36
Livingston,3983,1,22,3,11,81,52,29,69
Airdrieon,3983,2,20,8,8,62,39,23,68
Alloa,3983,3,19,5,12,72,51,21,62
Albion,3983,4,16,10,10,60,48,12,58
Brechin,3983,5,17,5,14,53,54,-1,56
East Fife,3983,6,14,9,13,55,50,5,51
Queen's Park,3983,7,13,8,15,36,43,-7,47
Peterhead,3983,8,10,7,19,40,57,-17,37
Stranraer,3983,9,9,7,20,44,68,-24,34
Stenhousem'r,3983,10,4,10,22,35,76,-41,22
Livingston,3984,1,24,3,9,79,42,37,75
Brechin,3984,2,16,9,11,49,46,3,57
Airdrieon,3984,3,16,7,13,61,56,5,55
Stranraer,3984,4,15,7,14,51,55,-4,52
Alloa,3984,5,13,12,11,59,50,9,51
Albion,3984,6,14,9,13,55,54,1,51
Peterhead,3984,7,13,11,12,43,49,-6,50
Queen's Park,3984,8,12,7,17,49,57,-8,43
East Fife,3984,9,11,9,16,48,45,3,42
Stenhousem'r,3984,10,5,8,23,43,83,-40,23
Airdrieon,3985,1,21,7,8,70,51,19,70
Alloa,3985,2,18,10,8,72,47,25,64
Livingston,3985,3,19,6,11,77,55,22,63
Brechin,3985,4,15,10,11,52,46,6,55
Peterhead,3985,5,16,7,13,50,49,1,55
Stranraer,3985,6,14,7,15,55,57,-2,49
Albion,3985,7,14,6,16,55,59,-4,48
Queen's Park,3985,8,11,7,18,33,51,-18,40
East Fife,3985,9,8,12,16,42,46,-4,36
Stenhousem'r,3985,10,5,6,25,35,80,-45,21
Livingston,3986,1,22,7,7,87,50,37,73
Alloa,3986,2,18,6,12,69,40,29,60
Albion,3986,3,18,5,13,57,52,5,59
Peterhead,3986,4,15,10,11,48,39,9,55
Airdrieon,3986,5,15,8,13,59,62,-3,53
Brechin,3986,6,15,7,14,47,48,-1,52
East Fife,3986,7,15,6,15,56,53,3,51
Queen's Park,3986,8,12,7,17,34,53,-19,43
Stranraer,3986,9,10,6,20,47,65,-18,36
Stenhousem'r,3986,10,4,10,22,43,85,-42,22
Livingston,3987,1,21,8,7,87,48,39,71
Alloa,3987,2,19,9,8,78,51,27,66
Brechin,3987,3,17,8,11,58,52,6,59
Airdrieon,3987,4,18,3,15,63,59,4,57
Albion,3987,5,15,6,15,65,56,9,51
East Fife,3987,6,10,14,12,50,55,-5,44
Queen's Park,3987,7,11,8,17,35,52,-17,41
Peterhead,3987,8,11,7,18,43,57,-14,40
Stenhousem'r,3987,9,10,8,18,45,77,-32,38
Stranraer,3987,10,10,5,21,43,60,-17,35
Alloa,3988,1,24,6,6,76,33,43,78
Livingston,3988,2,20,4,12,72,45,27,64
Brechin,3988,3,18,6,12,49,45,4,60
Airdrieon,3988,4,17,7,12,53,49,4,58
East Fife,3988,5,15,7,14,51,41,10,52
Queen's Park,3988,6,14,6,16,39,51,-12,48
Albion,3988,7,12,6,18,48,58,-10,42
Peterhead,3988,8,11,9,16,38,48,-10,42
Stranraer,3988,9,9,6,21,45,70,-25,33
Stenhousem'r,3988,10,8,7,21,41,72,-31,31
Alloa,3989,1,22,8,6,77,36,41,74
Livingston,3989,2,19,5,12,66,47,19,62
Airdrieon,3989,3,17,7,12,63,54,9,58
Peterhead,3989,4,16,5,15,51,48,3,53
Brechin,3989,5,14,9,13,38,45,-7,51
Albion,3989,6,15,5,16,60,55,5,50
Stranraer,3989,7,14,6,16,51,53,-2,48
East Fife,3989,8,11,8,17,50,54,-4,41
Queen's Park,3989,9,10,8,18,39,64,-25,38
Stenhousem'r,3989,10,7,9,20,46,85,-39,30
Livingston,3990,1,23,4,9,83,45,38,73
Alloa,3990,2,19,6,11,67,41,26,63
Brechin,3990,3,17,7,12,45,40,5,58
Peterhead,3990,4,16,8,12,55,54,1,56
Airdrieon,3990,5,15,10,11,51,51,0,55
East Fife,3990,6,12,10,14,58,55,3,46
Queen's Park,3990,7,13,7,16,46,49,-3,46
Albion,3990,8,12,10,14,43,50,-7,46
Stranraer,3990,9,12,6,18,38,54,-16,42
Stenhousem'r,3990,10,2,10,24,36,83,-47,16
Livingston,3991,1,21,2,13,78,49,29,65
Alloa,3991,2,19,6,11,70,46,24,63
Airdrieon,3991,3,18,4,14,56,50,6,58
Stranraer,3991,4,16,6,14,49,49,0,54
Peterhead,3991,5,15,7,14,54,48,6,52
Brechin,3991,6,16,4,16,40,46,-6,52
Albion,3991,7,14,9,13,53,57,-4,51
East Fife,3991,8,13,6,17,44,48,-4,45
Queen's Park,3991,9,13,5,18,37,51,-14,44
Stenhousem'r,3991,10,8,5,23,53,90,-37,29
Livingston,3992,1,23,4,9,86,56,30,73
Brechin,3992,2,16,9,11,58,50,8,57
Albion,3992,3,17,6,13,60,53,7,57
Alloa,3992,4,16,8,12,63,46,17,56
Airdrieon,3992,5,15,6,15,49,57,-8,51
Peterhead,3992,6,14,8,14,52,57,-5,50
Queen's Park,3992,7,15,4,17,43,51,-8,49
Stranraer,3992,8,12,5,19,47,60,-13,41
Stenhousem'r,3992,9,10,9,17,50,72,-22,39
East Fife,3992,10,9,7,20,47,53,-6,34
Alloa,3993,1,20,5,11,74,54,20,65
Livingston,3993,2,19,7,10,72,47,25,64
Brechin,3993,3,16,13,7,55,40,15,61
Airdrieon,3993,4,16,9,11,62,51,11,57
Peterhead,3993,5,11,13,12,47,48,-1,46
Queen's Park,3993,6,12,10,14,39,54,-15,46
Albion,3993,7,12,9,15,41,47,-6,45
East Fife,3993,8,10,12,14,44,46,-2,42
Stranraer,3993,9,8,10,18,43,61,-18,34
Stenhousem'r,3993,10,6,12,18,47,76,-29,30
Livingston,3994,1,27,1,8,82,41,41,82
Alloa,3994,2,21,7,8,78,47,31,70
Brechin,3994,3,19,5,12,59,40,19,62
Airdrieon,3994,4,16,8,12,66,57,9,56
Albion,3994,5,14,9,13,52,48,4,51
East Fife,3994,6,11,9,16,49,50,-1,42
Peterhead,3994,7,11,9,16,47,58,-11,42
Stranraer,3994,8,13,3,20,52,70,-18,42
Queen's Park,3994,9,8,9,19,30,64,-34,33
Stenhousem'r,3994,10,6,8,22,47,87,-40,26
Livingston,3995,1,22,1,13,78,51,27,67
Airdrieon,3995,2,19,5,12,56,44,12,62
Brechin,3995,3,17,7,12,51,43,8,58
Alloa,3995,4,17,5,14,65,51,14,56
Albion,3995,5,15,6,15,48,56,-8,51
Stranraer,3995,6,16,2,18,58,59,-1,50
East Fife,3995,7,14,6,16,47,51,-4,48
Stenhousem'r,3995,8,13,8,15,51,62,-11,47
Peterhead,3995,9,11,5,20,48,61,-13,38
Queen's Park,3995,10,11,5,20,36,60,-24,38
Livingston,3996,1,21,5,10,75,51,24,68
Alloa,3996,2,20,6,10,75,49,26,66
Airdrieon,3996,3,17,8,11,67,50,17,59
Brechin,3996,4,17,5,14,53,50,3,56
Albion,3996,5,15,7,14,55,51,4,52
East Fife,3996,6,13,7,16,56,56,0,46
Stranraer,3996,7,14,3,19,55,61,-6,45
Peterhead,3996,8,12,8,16,48,63,-15,44
Queen's Park,3996,9,11,8,17,38,57,-19,41
Stenhousem'r,3996,10,6,11,19,54,88,-34,29
Airdrieon,3997,1,20,8,8,62,42,20,68
Livingston,3997,2,20,3,13,65,51,14,63
Alloa,3997,3,16,11,9,66,45,21,59
Brechin,3997,4,16,8,12,56,44,12,56
Peterhead,3997,5,15,9,12,58,54,4,54
Albion,3997,6,13,10,13,49,50,-1,49
East Fife,3997,7,11,9,16,47,52,-5,42
Stenhousem'r,3997,8,11,6,19,44,70,-26,39
Queen's Park,3997,9,8,12,16,34,51,-17,36
Stranraer,3997,10,9,6,21,42,64,-22,33
Livingston,3998,1,25,5,6,80,45,35,80
Alloa,3998,2,21,7,8,74,38,36,70
Albion,3998,3,16,6,14,60,51,9,54
Brechin,3998,4,15,7,14,48,50,-2,52
Airdrieon,3998,5,14,7,15,54,53,1,49
East Fife,3998,6,13,8,15,50,45,5,47
Queen's Park,3998,7,11,8,17,34,50,-16,41
Stranraer,3998,8,12,5,19,46,64,-18,41
Peterhead,3998,9,10,9,17,42,60,-18,39
Stenhousem'r,3998,10,7,10,19,43,75,-32,31
Livingston,3999,1,25,2,9,81,42,39,77
Alloa,3999,2,21,7,8,73,41,32,70
Airdrieon,3999,3,16,11,9,60,48,12,59
Brechin,3999,4,17,6,13,48,39,9,57
Albion,3999,5,14,5,17,48,52,-4,47
East Fife,3999,6,14,4,18,48,47,1,46
Queen's Park,3999,7,13,7,16,47,56,-9,46
Peterhead,3999,8,11,8,17,52,59,-7,41
Stranraer,3999,9,9,7,20,39,71,-32,34
Stenhousem'r,3999,10,8,7,21,41,82,-41,31
Airdrieon,4000,1,20,3,13,67,56,11,63
Alloa,4000,2,18,8,10,72,48,24,62
Livingston,4000,3,16,5,15,62,54,8,53
Albion,4000,4,14,11,11,53,48,5,53
Queen's Park,4000,5,16,5,15,44,51,-7,53
Peterhead,4000,6,16,4,16,50,53,-3,52
East Fife,4000,7,14,7,15,52,49,3,49
Brechin,4000,8,14,6,16,49,53,-4,48
Stranraer,4000,9,11,7,18,51,60,-9,40
Stenhousem'r,4000,10,10,6,20,53,81,-28,36
Livingston,4001,1,20,7,9,74,51,23,67
Albion,4001,2,16,9,11,62,59,3,57
Alloa,4001,3,14,12,10,66,47,19,54
Airdrieon,4001,4,15,8,13,60,57,3,53
Peterhead,4001,5,12,15,9,53,48,5,51
Brechin,4001,6,12,13,11,50,49,1,49
East Fife,4001,7,11,12,13,52,50,2,45
Queen's Park,4001,8,12,9,15,45,55,-10,45
Stranraer,4001,9,9,12,15,37,50,-13,39
Stenhousem'r,4001,10,7,7,22,49,82,-33,28
Alloa,4002,1,21,4,11,77,46,31,67
Livingston,4002,2,20,2,14,70,48,22,62
Airdrieon,4002,3,17,8,11,58,54,4,59
Brechin,4002,4,17,3,16,54,55,-1,54
East Fife,4002,5,14,8,14,52,44,8,50
Stranraer,4002,6,15,4,17,56,59,-3,49
Albion,4002,7,14,6,16,47,49,-2,48
Peterhead,4002,8,12,9,15,48,51,-3,45
Queen's Park,4002,9,12,6,18,40,67,-27,42
Stenhousem'r,4002,10,9,8,19,49,78,-29,35
Livingston,4003,1,22,2,12,77,54,23,68
Alloa,4003,2,18,9,9,68,38,30,63
Brechin,4003,3,17,7,12,53,46,7,58
Albion,4003,4,16,7,13,56,53,3,55
Airdrieon,4003,5,17,4,15,65,68,-3,55
Stranraer,4003,6,15,5,16,57,57,0,50
Queen's Park,4003,7,13,10,13,33,40,-7,49
East Fife,4003,8,10,12,14,52,50,2,42
Peterhead,4003,9,11,5,20,54,67,-13,38
Stenhousem'r,4003,10,6,9,21,44,86,-42,27
Alloa,4004,1,21,11,4,73,37,36,74
Livingston,4004,2,18,7,11,70,47,23,61
Peterhead,4004,3,17,7,12,57,52,5,58
Albion,4004,4,16,9,11,57,44,13,57
Brechin,4004,5,15,6,15,48,47,1,51
Airdrieon,4004,6,14,8,14,54,52,2,50
Queen's Park,4004,7,13,8,15,43,48,-5,47
Stranraer,4004,8,11,9,16,43,53,-10,42
East Fife,4004,9,9,9,18,38,51,-13,36
Stenhousem'r,4004,10,6,6,24,43,95,-52,24
Alloa,4005,1,20,9,7,77,43,34,69
Livingston,4005,2,21,6,9,80,47,33,69
Airdrieon,4005,3,18,7,11,70,57,13,61
Brechin,4005,4,16,9,11,55,46,9,57
Peterhead,4005,5,16,7,13,56,53,3,55
Albion,4005,6,13,6,17,50,62,-12,45
Queen's Park,4005,7,11,11,14,34,47,-13,44
East Fife,4005,8,8,15,13,54,51,3,39
Stranraer,4005,9,11,6,19,59,73,-14,39
Stenhousem'r,4005,10,5,6,25,44,100,-56,21
Livingston,4006,1,23,4,9,78,42,36,73
Alloa,4006,2,19,11,6,76,42,34,68
Brechin,4006,3,22,2,12,52,37,15,68
Airdrieon,4006,4,18,6,12,78,58,20,60
Queen's Park,4006,5,14,8,14,41,54,-13,50
Peterhead,4006,6,12,6,18,38,53,-15,42
Albion,4006,7,11,8,17,50,59,-9,41
Stenhousem'r,4006,8,11,7,18,41,69,-28,40
East Fife,4006,9,10,9,17,43,50,-7,39
Stranraer,4006,10,6,7,23,39,72,-33,25
Livingston,4007,1,21,5,10,72,49,23,68
Alloa,4007,2,17,11,8,70,48,22,62
Albion,4007,3,17,8,11,57,45,12,59
Airdrieon,4007,4,17,6,13,70,57,13,57
Peterhead,4007,5,15,9,12,49,51,-2,54
Stranraer,4007,6,14,7,15,49,48,1,49
Brechin,4007,7,12,10,14,38,43,-5,46
East Fife,4007,8,12,8,16,52,54,-2,44
Queen's Park,4007,9,9,8,19,33,55,-22,35
Stenhousem'r,4007,10,7,6,23,38,78,-40,27
Airdrieon,4008,1,18,10,8,61,48,13,64
Brechin,4008,2,18,10,8,55,47,8,64
Livingston,4008,3,18,8,10,76,55,21,62
Alloa,4008,4,16,10,10,69,49,20,58
Albion,4008,5,16,5,15,65,57,8,53
Peterhead,4008,6,10,11,15,49,58,-9,41
East Fife,4008,7,10,10,16,49,55,-6,40
Stranraer,4008,8,10,9,17,55,62,-7,39
Stenhousem'r,4008,9,9,11,16,51,74,-23,38
Queen's Park,4008,10,9,8,19,37,62,-25,35
Livingston,4009,1,22,5,9,79,44,35,71
Brechin,4009,2,21,5,10,55,39,16,68
Alloa,4009,3,19,4,13,61,45,16,61
Airdrieon,4009,4,17,5,14,55,60,-5,56
Queen's Park,4009,5,16,6,14,39,41,-2,54
Peterhead,4009,6,14,6,16,53,51,2,48
Stranraer,4009,7,13,6,17,55,65,-10,45
Albion,4009,8,11,8,17,45,52,-7,41
East Fife,4009,9,10,8,18,53,57,-4,38
Stenhousem'r,4009,10,7,7,22,51,92,-41,28
Alloa,4010,1,20,8,8,72,37,35,68
Livingston,4010,2,20,6,10,68,50,18,66
Albion,4010,3,18,6,12,63,48,15,60
Airdrieon,4010,4,16,9,11,51,43,8,57
Brechin,4010,5,13,10,13,41,37,4,49
Peterhead,4010,6,11,10,15,48,60,-12,43
Stenhousem'r,4010,7,12,5,19,50,71,-21,41
Stranraer,4010,8,10,10,16,43,51,-8,40
Queen's Park,4010,9,11,6,19,39,61,-22,39
East Fife,4010,10,9,10,17,48,65,-17,37
Livingston,4011,1,20,7,9,81,56,25,67
Airdrieon,4011,2,19,5,12,63,56,7,62
Alloa,4011,3,18,6,12,70,45,25,60
Queen's Park,4011,4,15,9,12,47,43,4,54
Brechin,4011,5,14,8,14,45,54,-9,50
Albion,4011,6,13,10,13,56,55,1,49
Peterhead,4011,7,12,8,16,46,58,-12,44
Stranraer,4011,8,12,6,18,51,59,-8,42
East Fife,4011,9,9,13,14,41,48,-7,40
Stenhousem'r,4011,10,8,8,20,51,77,-26,32
Alloa,4012,1,23,6,7,83,46,37,75
Livingston,4012,2,21,4,11,86,51,35,67
Airdrieon,4012,3,18,5,13,63,57,6,59
Brechin,4012,4,18,4,14,61,53,8,58
Albion,4012,5,15,9,12,54,51,3,54
Queen's Park,4012,6,17,3,16,41,49,-8,54
Stranraer,4012,7,11,7,18,45,59,-14,40
Peterhead,4012,8,11,5,20,47,68,-21,38
East Fife,4012,9,10,7,19,41,57,-16,37
Stenhousem'r,4012,10,8,6,22,53,83,-30,30
Brechin,4013,1,19,8,9,53,41,12,65
Peterhead,4013,2,18,4,14,48,49,-1,58
Livingston,4013,3,17,6,13,73,56,17,57
Alloa,4013,4,15,11,10,70,46,24,56
Airdrieon,4013,5,16,5,15,60,57,3,53
Stranraer,4013,6,15,7,14,56,52,4,52
Albion,4013,7,14,9,13,56,57,-1,51
Queen's Park,4013,8,11,5,20,42,64,-22,38
East Fife,4013,9,9,10,17,50,53,-3,37
Stenhousem'r,4013,10,10,7,19,54,87,-33,37
Livingston,4014,1,19,6,11,75,46,29,63
Brechin,4014,2,19,4,13,55,47,8,61
Airdrieon,4014,3,19,3,14,64,56,8,60
Alloa,4014,4,17,7,12,64,47,17,58
East Fife,4014,5,13,11,12,52,45,7,50
Albion,4014,6,13,8,15,50,51,-1,47
Queen's Park,4014,7,13,6,17,42,59,-17,45
Stranraer,4014,8,13,5,18,49,60,-11,44
Stenhousem'r,4014,9,12,6,18,47,70,-23,42
Peterhead,4014,10,11,6,19,43,60,-17,39
Livingston,4015,1,19,5,12,79,62,17,62
Airdrieon,4015,2,19,5,12,67,53,14,62
Alloa,4015,3,16,10,10,65,51,14,58
Peterhead,4015,4,17,6,13,50,50,0,57
Stranraer,4015,5,17,4,15,60,60,0,55
Brechin,4015,6,13,9,14,49,53,-4,48
East Fife,4015,7,12,8,16,53,50,3,44
Albion,4015,8,10,10,16,56,56,0,40
Queen's Park,4015,9,11,7,18,40,61,-21,40
Stenhousem'r,4015,10,11,6,19,62,85,-23,39
Alloa,4016,1,23,5,8,71,38,33,74
Livingston,4016,2,18,7,11,71,53,18,61
Airdrieon,4016,3,15,10,11,59,54,5,55
Peterhead,4016,4,13,9,14,49,50,-1,48
Queen's Park,4016,5,12,11,13,38,47,-9,47
Albion,4016,6,12,10,14,53,54,-1,46
Brechin,4016,7,13,7,16,54,62,-8,46
Stranraer,4016,8,12,6,18,45,57,-12,42
East Fife,4016,9,10,10,16,52,56,-4,40
Stenhousem'r,4016,10,9,11,16,42,63,-21,38
Livingston,4017,1,23,5,8,80,44,36,74
Alloa,4017,2,19,6,11,65,41,24,63
Brechin,4017,3,16,10,10,51,38,13,58
Albion,4017,4,14,8,14,52,53,-1,50
Queen's Park,4017,5,13,10,13,36,37,-1,49
Peterhead,4017,6,14,7,15,51,56,-5,49
Stranraer,4017,7,14,6,16,50,53,-3,48
Airdrieon,4017,8,13,6,17,50,69,-19,45
East Fife,4017,9,12,6,18,50,51,-1,42
Stenhousem'r,4017,10,7,6,23,43,86,-43,27
Alloa,4018,1,20,7,9,73,44,29,67
Livingston,4018,2,18,9,9,79,52,27,63
Brechin,4018,3,18,5,13,58,51,7,59
Airdrieon,4018,4,14,10,12,60,55,5,52
Albion,4018,5,14,10,12,55,53,2,52
Peterhead,4018,6,12,12,12,43,48,-5,48
East Fife,4018,7,12,11,13,54,48,6,47
Stranraer,4018,8,11,9,16,49,63,-14,42
Queen's Park,4018,9,11,7,18,33,55,-22,40
Stenhousem'r,4018,10,6,8,22,50,85,-35,26
Alloa,4019,1,20,11,5,73,37,36,71
Livingston,4019,2,20,2,14,70,47,23,62
Airdrieon,4019,3,16,11,9,61,53,8,59
Peterhead,4019,4,13,9,14,52,58,-6,48
Brechin,4019,5,14,6,16,50,61,-11,48
East Fife,4019,6,12,10,14,55,40,15,46
Stranraer,4019,7,13,7,16,49,56,-7,46
Albion,4019,8,13,6,17,48,50,-2,45
Queen's Park,4019,9,12,8,16,36,46,-10,44
Stenhousem'r,4019,10,8,8,20,48,94,-46,32
Livingston,4020,1,21,3,12,75,50,25,66
Airdrieon,4020,2,17,11,8,67,50,17,62
Alloa,4020,3,18,6,12,70,50,20,60
Peterhead,4020,4,16,8,12,45,46,-1,56
East Fife,4020,5,14,10,12,45,40,5,52
Brechin,4020,6,13,8,15,55,52,3,47
Albion,4020,7,12,10,14,51,50,1,46
Queen's Park,4020,8,12,8,16,35,54,-19,44
Stranraer,4020,9,9,10,17,48,65,-17,37
Stenhousem'r,4020,10,6,10,20,43,77,-34,28
Alloa,4021,1,21,8,7,78,39,39,71
Airdrieon,4021,2,18,9,9,65,52,13,63
Livingston,4021,3,18,6,12,73,48,25,60
Brechin,4021,4,18,6,12,53,45,8,60
Albion,4021,5,14,11,11,57,55,2,53
Peterhead,4021,6,14,10,12,57,58,-1,52
Stranraer,4021,7,12,6,18,43,59,-16,42
Queen's Park,4021,8,11,8,17,37,55,-18,41
East Fife,4021,9,7,11,18,47,57,-10,32
Stenhousem'r,4021,10,5,9,22,45,87,-42,24
Alloa,4022,1,20,8,8,79,43,36,68
Livingston,4022,2,20,6,10,81,47,34,66
Airdrieon,4022,3,19,5,12,63,54,9,62
Brechin,4022,4,15,7,14,49,47,2,52
Queen's Park,4022,5,14,9,13,43,47,-4,51
East Fife,4022,6,13,9,14,52,45,7,48
Peterhead,4022,7,14,6,16,45,51,-6,48
Albion,4022,8,11,8,17,53,65,-12,41
Stranraer,4022,9,11,7,18,47,67,-20,40
Stenhousem'r,4022,10,7,7,22,41,87,-46,28
Livingston,4023,1,21,6,9,73,43,30,69
Alloa,4023,2,20,7,9,69,47,22,67
Brechin,4023,3,18,6,12,54,46,8,60
Peterhead,4023,4,17,5,14,65,55,10,56
Airdrieon,4023,5,15,5,16,61,61,0,50
Albion,4023,6,13,9,14,51,52,-1,48
Stranraer,4023,7,13,6,17,50,63,-13,45
East Fife,4023,8,9,14,13,47,47,0,41
Queen's Park,4023,9,10,5,21,29,52,-23,35
Stenhousem'r,4023,10,7,11,18,42,75,-33,32
Alloa,4024,1,20,10,6,69,38,31,70
Airdrieon,4024,2,19,8,9,59,47,12,65
Livingston,4024,3,17,8,11,70,51,19,59
East Fife,4024,4,15,8,13,59,42,17,53
Albion,4024,5,14,8,14,50,52,-2,50
Brechin,4024,6,14,7,15,50,58,-8,49
Stranraer,4024,7,14,5,17,57,56,1,47
Queen's Park,4024,8,13,6,17,37,50,-13,45
Peterhead,4024,9,11,4,21,41,66,-25,37
Stenhousem'r,4024,10,7,8,21,43,75,-32,29
Livingston,4025,1,24,4,8,83,41,42,76
Alloa,4025,2,19,6,11,70,47,23,63
Brechin,4025,3,18,7,11,50,39,11,61
Albion,4025,4,16,6,14,56,58,-2,54
Peterhead,4025,5,14,8,14,47,49,-2,50
East Fife,4025,6,12,9,15,55,51,4,45
Airdrieon,4025,7,12,9,15,53,56,-3,45
Queen's Park,4025,8,12,6,18,36,60,-24,42
Stranraer,4025,9,10,5,21,51,69,-18,35
Stenhousem'r,4025,10,9,8,19,43,74,-31,35
Alloa,4026,1,21,7,8,79,44,35,70
Livingston,4026,2,21,2,13,79,60,19,65
Airdrieon,4026,3,19,5,12,57,49,8,62
Brechin,4026,4,18,7,11,55,43,12,61
Albion,4026,5,15,7,14,55,47,8,52
Stranraer,4026,6,12,9,15,47,49,-2,45
East Fife,4026,7,12,8,16,43,56,-13,44
Peterhead,4026,8,11,8,17,42,53,-11,41
Queen's Park,4026,9,10,6,20,34,59,-25,36
Stenhousem'r,4026,10,6,11,19,42,73,-31,29
Alloa,4027,1,19,9,8,62,38,24,66
Livingston,4027,2,20,4,12,73,48,25,64
Brechin,4027,3,19,6,11,57,47,10,63
Airdrieon,4027,4,17,10,9,52,43,9,61
Albion,4027,5,15,9,12,59,49,10,54
Peterhead,4027,6,13,7,16,54,56,-2,46
Stranraer,4027,7,12,6,18,42,52,-10,42
East Fife,4027,8,10,10,16,50,60,-10,40
Queen's Park,4027,9,9,9,18,31,50,-19,36
Stenhousem'r,4027,10,5,12,19,47,84,-37,27
Livingston,4028,1,24,5,7,88,49,39,77
Alloa,4028,2,18,7,11,69,49,20,61
Airdrieon,4028,3,18,5,13,61,50,11,59
Brechin,4028,4,16,6,14,46,45,1,54
Peterhead,4028,5,15,8,13,53,51,2,53
Albion,4028,6,14,8,14,50,53,-3,50
East Fife,4028,7,12,9,15,50,54,-4,45
Stranraer,4028,8,13,4,19,48,63,-15,43
Queen's Park,4028,9,11,6,19,40,55,-15,39
Stenhousem'r,4028,10,7,6,23,48,84,-36,27
Livingston,4029,1,20,8,8,72,44,28,68
Alloa,4029,2,15,13,8,64,44,20,58
Brechin,4029,3,16,7,13,47,41,6,55
Peterhead,4029,4,16,7,13,55,56,-1,55
Airdrieon,4029,5,16,4,16,57,61,-4,52
Stranraer,4029,6,14,7,15,56,55,1,49
Queen's Park,4029,7,13,7,16,44,51,-7,46
East Fife,4029,8,12,9,15,52,51,1,45
Albion,4029,9,12,7,17,47,59,-12,43
Stenhousem'r,4029,10,8,7,21,48,80,-32,31
Brechin,4030,1,21,6,9,55,36,19,69
Alloa,4030,2,19,6,11,74,42,32,63
Livingston,4030,3,20,3,13,68,47,21,63
Albion,4030,4,16,7,13,50,45,5,55
Stranraer,4030,5,15,6,15,56,60,-4,51
Queen's Park,4030,6,13,9,14,37,43,-6,48
Airdrieon,4030,7,11,10,15,54,65,-11,43
Stenhousem'r,4030,8,11,8,17,43,72,-29,41
East Fife,4030,9,9,10,17,37,44,-7,37
Peterhead,4030,10,9,7,20,43,63,-20,34
Livingston,4031,1,20,7,9,71,41,30,67
Alloa,4031,2,21,4,11,67,40,27,67
Airdrieon,4031,3,18,6,12,64,54,10,60
Peterhead,4031,4,15,6,15,55,56,-1,51
Stranraer,4031,5,14,8,14,54,58,-4,50
Brechin,4031,6,14,7,15,43,42,1,49
Albion,4031,7,12,11,13,50,46,4,47
East Fife,4031,8,12,8,16,52,53,-1,44
Queen's Park,4031,9,12,7,17,39,58,-19,43
Stenhousem'r,4031,10,7,6,23,39,86,-47,27
Alloa,4032,1,19,7,10,81,47,34,64
Livingston,4032,2,21,1,14,84,62,22,64
Albion,4032,3,18,7,11,69,49,20,61
Airdrieon,4032,4,17,7,12,56,55,1,58
Brechin,4032,5,17,5,14,56,53,3,56
East Fife,4032,6,14,8,14,52,49,3,50
Peterhead,4032,7,12,10,14,45,54,-9,46
Stranraer,4032,8,12,7,17,45,55,-10,43
Stenhousem'r,4032,9,10,6,20,49,88,-39,36
Queen's Park,4032,10,8,6,22,31,56,-25,30
Alloa,4033,1,22,7,7,70,38,32,73
Airdrieon,4033,2,21,6,9,69,51,18,69
Livingston,4033,3,19,6,11,73,46,27,63
Brechin,4033,4,13,12,11,49,47,2,51
Peterhead,4033,5,14,7,15,50,55,-5,49
Queen's Park,4033,6,13,6,17,37,53,-16,45
Stranraer,4033,7,13,5,18,44,57,-13,44
Albion,4033,8,9,14,13,49,50,-1,41
East Fife,4033,9,9,11,16,46,49,-3,38
Stenhousem'r,4033,10,5,10,21,41,82,-41,25
Alloa,4034,1,18,11,7,73,41,32,65
Livingston,4034,2,19,3,14,73,53,20,60
Brechin,4034,3,16,10,10,50,41,9,58
Airdrieon,4034,4,16,8,12,59,61,-2,56
East Fife,4034,5,14,9,13,46,38,8,51
Albion,4034,6,15,6,15,48,54,-6,51
Peterhead,4034,7,12,8,16,48,52,-4,44
Stranraer,4034,8,13,4,19,47,61,-14,43
Queen's Park,4034,9,9,10,17,31,49,-18,37
Stenhousem'r,4034,10,8,11,17,56,81,-25,35
Alloa,4035,1,18,8,10,59,41,18,62
Livingston,4035,2,19,4,13,70,50,20,61
Queen's Park,4035,3,18,6,12,46,45,1,60
Brechin,4035,4,18,5,13,58,49,9,59
Airdrieon,4035,5,16,8,12,58,54,4,56
Stranraer,4035,6,13,8,15,52,55,-3,47
Albion,4035,7,13,8,15,40,46,-6,47
Peterhead,4035,8,10,10,16,54,61,-7,40
East Fife,4035,9,9,11,16,46,49,-3,38
Stenhousem'r,4035,10,6,12,18,46,79,-33,30
Livingston,4036,1,21,5,10,74,43,31,68
Albion,4036,2,19,8,9,63,45,18,65
Alloa,4036,3,18,8,10,55,35,20,62
Airdrieon,4036,4,17,4,15,53,54,-1,55
Stranraer,4036,5,16,6,14,56,55,1,54
Brechin,4036,6,16,6,14,50,49,1,54
Queen's Park,4036,7,12,10,14,34,43,-9,46
Stenhousem'r,4036,8,9,10,17,51,70,-19,37
Peterhead,4036,9,9,8,19,35,57,-22,35
East Fife,4036,10,6,9,21,34,54,-20,27
Alloa,4037,1,21,9,6,68,38,30,72
Livingston,4037,2,20,5,11,69,45,24,65
Airdrieon,4037,3,18,7,11,59,56,3,61
Brechin,4037,4,16,7,13,51,46,5,55
Queen's Park,4037,5,14,7,15,36,45,-9,49
East Fife,4037,6,13,7,16,48,45,3,46
Stranraer,4037,7,12,4,20,50,60,-10,40
Peterhead,4037,8,11,7,18,44,56,-12,40
Stenhousem'r,4037,9,11,7,18,57,73,-16,40
Albion,4037,10,9,10,17,43,61,-18,37
Livingston,4038,1,21,5,10,80,49,31,68
Alloa,4038,2,19,7,10,66,46,20,64
Airdrieon,4038,3,18,4,14,67,61,6,58
Albion,4038,4,15,8,13,53,45,8,53
Brechin,4038,5,16,4,16,49,58,-9,52
Queen's Park,4038,6,13,7,16,46,55,-9,46
Peterhead,4038,7,12,8,16,44,50,-6,44
Stranraer,4038,8,13,5,18,56,63,-7,44
East Fife,4038,9,11,9,16,47,49,-2,42
Stenhousem'r,4038,10,11,5,20,47,79,-32,38
Alloa,4039,1,20,7,9,70,44,26,67
Livingston,4039,2,19,4,13,68,51,17,61
Brechin,4039,3,18,5,13,58,49,9,59
Stranraer,4039,4,17,5,14,57,53,4,56
Airdrieon,4039,5,16,6,14,58,56,2,54
Queen's Park,4039,6,15,6,15,41,43,-2,51
Peterhead,4039,7,11,10,15,48,55,-7,43
Albion,4039,8,11,7,18,46,56,-10,40
East Fife,4039,9,10,8,18,47,54,-7,38
Stenhousem'r,4039,10,9,10,17,45,77,-32,37
Livingston,4040,1,24,4,8,93,52,41,76
Alloa,4040,2,21,8,7,72,42,30,71
Peterhead,4040,3,17,7,12,59,42,17,58
Airdrieon,4040,4,18,4,14,61,57,4,58
Brechin,4040,5,15,7,14,40,44,-4,52
Albion,4040,6,13,8,15,48,54,-6,47
Queen's Park,4040,7,13,5,18,32,50,-18,44
East Fife,4040,8,8,11,17,46,53,-7,35
Stranraer,4040,9,10,5,21,43,64,-21,35
Stenhousem'r,4040,10,6,11,19,42,78,-36,29
Livingston,4041,1,20,2,14,67,51,16,62
Alloa,4041,2,16,12,8,66,45,21,60
Airdrieon,4041,3,17,7,12,64,55,9,58
Albion,4041,4,16,8,12,54,42,12,56
Brechin,4041,5,15,7,14,45,43,2,52
Peterhead,4041,6,15,7,14,51,53,-2,52
Stranraer,4041,7,15,6,15,52,50,2,51
Queen's Park,4041,8,13,7,16,32,53,-21,46
East Fife,4041,9,9,8,19,47,54,-7,35
Stenhousem'r,4041,10,10,4,22,47,79,-32,34
Alloa,4042,1,19,7,10,71,43,28,64
Livingston,4042,2,20,3,13,69,54,15,63
Brechin,4042,3,17,7,12,52,45,7,58
Peterhead,4042,4,17,6,13,52,50,2,57
Albion,4042,5,16,8,12,56,54,2,56
Airdrieon,4042,6,15,7,14,60,56,4,52
Queen's Park,4042,7,15,5,16,45,48,-3,50
Stranraer,4042,8,11,8,17,46,56,-10,41
East Fife,4042,9,10,9,17,50,58,-8,39
Stenhousem'r,4042,10,7,6,23,41,78,-37,27
Airdrieon,4043,1,21,6,9,69,46,23,69
Alloa,4043,2,19,10,7,69,39,30,67
Livingston,4043,3,19,3,14,67,56,11,60
Albion,4043,4,14,11,11,53,47,6,53
Peterhead,4043,5,13,12,11,49,51,-2,51
Brechin,4043,6,14,8,14,49,54,-5,50
Queen's Park,4043,7,13,8,15,41,44,-3,47
East Fife,4043,8,10,11,15,41,48,-7,41
Stranraer,4043,9,9,10,17,45,57,-12,37
Stenhousem'r,4043,10,4,9,23,36,77,-41,21
Livingston,4044,1,19,3,14,71,44,27,60
Peterhead,4044,2,17,7,12,55,46,9,58
Alloa,4044,3,16,8,12,64,49,15,56
East Fife,4044,4,15,11,10,45,39,6,56
Brechin,4044,5,13,14,9,54,44,10,53
Airdrieon,4044,6,14,9,13,57,57,0,51
Queen's Park,4044,7,14,6,16,40,48,-8,48
Albion,4044,8,13,8,15,55,64,-9,47
Stranraer,4044,9,12,6,18,54,62,-8,42
Stenhousem'r,4044,10,7,8,21,37,79,-42,29
Brechin,4045,1,19,8,9,50,40,10,65
Alloa,4045,2,19,7,10,76,47,29,64
Airdrieon,4045,3,19,6,11,66,51,15,63
Albion,4045,4,17,10,9,61,48,13,61
Livingston,4045,5,17,8,11,69,49,20,59
Stranraer,4045,6,14,6,16,51,60,-9,48
Peterhead,4045,7,12,8,16,54,61,-7,44
East Fife,4045,8,9,9,18,48,58,-10,36
Queen's Park,4045,9,9,9,18,38,57,-19,36
Stenhousem'r,4045,10,6,7,23,49,91,-42,25
Alloa,4046,1,21,7,8,69,41,28,70
Livingston,4046,2,19,8,9,73,44,29,65
Albion,4046,3,13,10,13,55,50,5,49
Stranraer,4046,4,14,6,16,57,58,-1,48
Peterhead,4046,5,13,9,14,46,52,-6,48
Airdrieon,4046,6,14,5,17,48,63,-15,47
Queen's Park,4046,7,11,12,13,42,51,-9,45
Brechin,4046,8,12,7,17,39,50,-11,43
East Fife,4046,9,10,12,14,47,48,-1,42
Stenhousem'r,4046,10,10,10,16,48,67,-19,40
Livingston,4047,1,22,5,9,92,50,42,71
Alloa,4047,2,21,5,10,67,46,21,68
Brechin,4047,3,19,5,12,57,50,7,62
Airdrieon,4047,4,16,8,12,59,55,4,56
Peterhead,4047,5,16,7,13,52,52,0,55
Albion,4047,6,12,8,16,47,58,-11,44
Queen's Park,4047,7,11,7,18,42,54,-12,40
East Fife,4047,8,8,14,14,47,53,-6,38
Stenhousem'r,4047,9,11,5,20,52,76,-24,38
Stranraer,4047,10,9,6,21,38,59,-21,33
Alloa,4048,1,18,9,9,69,42,27,63
Albion,4048,2,16,11,9,58,43,15,59
Airdrieon,4048,3,17,7,12,61,49,12,58
Peterhead,4048,4,16,9,11,58,50,8,57
Livingston,4048,5,16,5,15,61,53,8,53
Queen's Park,4048,6,15,6,15,46,46,0,51
Brechin,4048,7,14,6,16,47,57,-10,48
East Fife,4048,8,12,11,13,49,55,-6,47
Stranraer,4048,9,9,7,20,44,64,-20,34
Stenhousem'r,4048,10,7,9,20,44,78,-34,30
Alloa,4049,1,23,7,6,76,41,35,76
Livingston,4049,2,21,7,8,83,43,40,70
Airdrieon,4049,3,17,6,13,51,48,3,57
Queen's Park,4049,4,13,11,12,36,38,-2,50
Brechin,4049,5,13,11,12,51,55,-4,50
East Fife,4049,6,12,11,13,57,54,3,47
Peterhead,4049,7,13,8,15,45,48,-3,47
Albion,4049,8,12,7,17,39,52,-13,43
Stranraer,4049,9,11,6,19,50,62,-12,39
Stenhousem'r,4049,10,4,8,24,39,86,-47,20
Livingston,4050,1,22,5,9,72,39,33,71
Brechin,4050,2,21,5,10,50,41,9,68
Alloa,4050,3,19,7,10,65,42,23,64
Peterhead,4050,4,15,9,12,56,46,10,54
Albion,4050,5,12,11,13,48,49,-1,47
Stranraer,4050,6,13,8,15,49,60,-11,47
Airdrieon,4050,7,13,7,16,53,65,-12,46
Queen's Park,4050,8,11,10,15,30,41,-11,43
East Fife,4050,9,6,13,17,38,51,-13,31
Stenhousem'r,4050,10,7,7,22,49,76,-27,28
Alloa,4051,1,20,10,6,78,38,40,70
Livingston,4051,2,20,7,9,75,48,27,67
Brechin,4051,3,19,5,12,55,45,10,62
Albion,4051,4,14,9,13,56,51,5,51
Queen's Park,4051,5,14,6,16,43,57,-14,48
Peterhead,4051,6,12,11,13,56,51,5,47
Airdrieon,4051,7,13,6,17,44,61,-17,45
Stranraer,4051,8,12,7,17,47,58,-11,43
East Fife,4051,9,9,11,16,42,51,-9,38
Stenhousem'r,4051,10,7,8,21,49,85,-36,29
Alloa,4052,1,21,8,7,76,37,39,71
Brechin,4052,2,18,6,12,53,44,9,60
Airdrieon,4052,3,17,7,12,65,55,10,58
Livingston,4052,4,16,8,12,80,61,19,56
Peterhead,4052,5,12,13,11,52,51,1,49
Queen's Park,4052,6,12,12,12,41,53,-12,48
Stranraer,4052,7,12,6,18,50,70,-20,42
Albion,4052,8,9,13,14,40,51,-11,40
East Fife,4052,9,9,10,17,51,54,-3,37
Stenhousem'r,4052,10,9,7,20,48,80,-32,34
Alloa,4053,1,19,10,7,72,44,28,67
Livingston,4053,2,17,8,11,77,53,24,59
Brechin,4053,3,16,10,10,45,36,9,58
Peterhead,4053,4,17,7,12,55,54,1,58
Airdrieon,4053,5,15,8,13,61,54,7,53
Queen's Park,4053,6,14,8,14,43,48,-5,50
Albion,4053,7,13,7,16,59,63,-4,46
East Fife,4053,8,9,15,12,49,48,1,42
Stranraer,4053,9,8,9,19,42,65,-23,33
Stenhousem'r,4053,10,7,8,21,49,87,-38,29
Alloa,4054,1,25,5,6,85,38,47,80
Livingston,4054,2,23,3,10,87,48,39,72
Brechin,4054,3,17,2,17,52,49,3,53
Peterhead,4054,4,16,4,16,55,61,-6,52
Airdrieon,4054,5,15,7,14,54,60,-6,52
Queen's Park,4054,6,12,12,12,37,47,-10,48
Albion,4054,7,13,8,15,47,49,-2,47
Stranraer,4054,8,12,3,21,48,66,-18,39
East Fife,4054,9,8,10,18,43,56,-13,34
Stenhousem'r,4054,10,9,6,21,49,83,-34,33
Livingston,4055,1,23,4,9,86,45,41,73
Alloa,4055,2,19,8,9,66,39,27,65
Brechin,4055,3,15,6,15,42,49,-7,51
Airdrieon,4055,4,14,7,15,50,56,-6,49
Peterhead,4055,5,14,6,16,39,49,-10,48
Albion,4055,6,12,9,15,50,55,-5,45
East Fife,4055,7,12,8,16,53,48,5,44
Stenhousem'r,4055,8,12,8,16,51,66,-15,44
Stranraer,4055,9,13,5,18,45,60,-15,44
Queen's Park,4055,10,12,7,17,38,53,-15,43
Airdrieon,4056,1,21,6,9,64,42,22,69
Alloa,4056,2,19,7,10,70,43,27,64
Brechin,4056,3,19,7,10,56,47,9,64
Livingston,4056,4,18,2,16,58,52,6,56
Stranraer,4056,5,16,5,15,69,62,7,53
Queen's Park,4056,6,15,4,17,35,55,-20,49
Albion,4056,7,12,8,16,55,60,-5,44
East Fife,4056,8,11,8,17,55,53,2,41
Peterhead,4056,9,11,6,19,39,54,-15,39
Stenhousem'r,4056,10,7,9,20,44,77,-33,30
Livingston,4057,1,23,6,7,82,37,45,75
Alloa,4057,2,20,9,7,76,45,31,69
Brechin,4057,3,17,7,12,55,47,8,58
Airdrieon,4057,4,15,8,13,54,52,2,53
Peterhead,4057,5,15,6,15,48,56,-8,51
Albion,4057,6,15,5,16,43,52,-9,50
Queen's Park,4057,7,13,6,17,36,54,-18,45
Stranraer,4057,8,13,3,20,54,51,3,42
East Fife,4057,9,11,8,17,52,47,5,41
Stenhousem'r,4057,10,7,4,25,39,98,-59,25
Alloa,4058,1,18,9,9,63,40,23,63
Livingston,4058,2,20,3,13,80,60,20,63
Airdrieon,4058,3,18,5,13,62,63,-1,59
Brechin,4058,4,17,7,12,48,44,4,58
Peterhead,4058,5,16,8,12,60,49,11,56
Queen's Park,4058,6,13,8,15,56,60,-4,47
Stranraer,4058,7,12,10,14,49,52,-3,46
East Fife,4058,8,9,11,16,49,55,-6,38
Albion,4058,9,9,10,17,57,65,-8,37
Stenhousem'r,4058,10,7,11,18,41,77,-36,32
Livingston,4059,1,23,3,10,81,42,39,72
Alloa,4059,2,20,9,7,71,42,29,69
Brechin,4059,3,15,8,13,50,50,0,53
Airdrieon,4059,4,14,10,12,52,55,-3,52
Peterhead,4059,5,15,6,15,57,57,0,51
Albion,4059,6,13,11,12,57,49,8,50
Stranraer,4059,7,13,7,16,60,63,-3,46
Queen's Park,4059,8,12,5,19,36,62,-26,41
East Fife,4059,9,7,13,16,41,55,-14,34
Stenhousem'r,4059,10,9,6,21,42,72,-30,33
Livingston,4060,1,21,5,10,71,51,20,68
Alloa,4060,2,21,4,11,74,39,35,67
Brechin,4060,3,17,5,14,49,57,-8,56
Airdrieon,4060,4,16,7,13,64,61,3,55
Albion,4060,5,15,5,16,53,55,-2,50
Queen's Park,4060,6,14,8,14,43,49,-6,50
Peterhead,4060,7,14,6,16,43,55,-12,48
Stranraer,4060,8,11,8,17,51,57,-6,41
East Fife,4060,9,8,12,16,39,41,-2,36
Stenhousem'r,4060,10,8,10,18,54,76,-22,34
Livingston,4061,1,20,7,9,74,43,31,67
Airdrieon,4061,2,18,7,11,63,54,9,61
Alloa,4061,3,16,12,8,68,49,19,60
Albion,4061,4,16,12,8,65,47,18,60
Peterhead,4061,5,14,10,12,66,58,8,52
Brechin,4061,6,16,4,16,60,59,1,52
Stranraer,4061,7,12,8,16,48,59,-11,44
East Fife,4061,8,11,9,16,51,55,-4,42
Queen's Park,4061,9,10,8,18,42,66,-24,38
Stenhousem'r,4061,10,6,5,25,43,90,-47,23
Alloa,4062,1,25,7,4,83,46,37,82
Livingston,4062,2,20,6,10,77,49,28,66
Airdrieon,4062,3,17,7,12,58,51,7,58
Brechin,4062,4,16,5,15,44,50,-6,53
Albion,4062,5,14,9,13,50,44,6,51
Peterhead,4062,6,14,8,14,45,44,1,50
East Fife,4062,7,9,10,17,37,43,-6,37
Stranraer,4062,8,10,5,21,45,62,-17,35
Queen's Park,4062,9,8,11,17,29,52,-23,35
Stenhousem'r,4062,10,8,10,18,43,70,-27,34
Livingston,4063,1,21,7,8,80,50,30,70
Brechin,4063,2,18,6,12,57,53,4,60
East Fife,4063,3,17,6,13,65,52,13,57
Alloa,4063,4,16,8,12,72,46,26,56
Albion,4063,5,15,7,14,57,52,5,52
Queen's Park,4063,6,13,7,16,45,60,-15,46
Peterhead,4063,7,12,8,16,46,55,-9,44
Stranraer,4063,8,12,7,17,53,64,-11,43
Airdrieon,4063,9,11,8,17,47,57,-10,41
Stenhousem'r,4063,10,10,6,20,43,76,-33,36
Alloa,4064,1,20,7,9,73,44,29,67
Airdrieon,4064,2,20,4,12,66,64,2,64
Livingston,4064,3,20,3,13,80,52,28,63
Brechin,4064,4,16,7,13,55,54,1,55
Albion,4064,5,16,6,14,59,65,-6,54
Peterhead,4064,6,15,7,14,51,52,-1,52
Stranraer,4064,7,15,5,16,63,53,10,50
Queen's Park,4064,8,12,7,17,31,45,-14,43
East Fife,4064,9,8,9,19,49,54,-5,33
Stenhousem'r,4064,10,7,7,22,46,90,-44,28
Livingston,4065,1,22,3,11,75,48,27,69
Alloa,4065,2,18,10,8,69,39,30,64
Brechin,4065,3,18,5,13,60,45,15,59
Albion,4065,4,17,7,12,63,54,9,58
Peterhead,4065,5,16,9,11,58,55,3,57
Airdrieon,4065,6,13,9,14,50,56,-6,48
Queen's Park,4065,7,14,4,18,42,53,-11,46
East Fife,4065,8,10,10,16,48,48,0,40
Stranraer,4065,9,10,7,19,44,62,-18,37
Stenhousem'r,4065,10,7,6,23,47,96,-49,27
Livingston,4066,1,25,4,7,81,45,36,79
Albion,4066,2,17,7,12,58,46,12,58
Alloa,4066,3,15,12,9,60,39,21,57
Queen's Park,4066,4,17,5,14,42,47,-5,56
Airdrieon,4066,5,15,9,12,59,53,6,54
Peterhead,4066,6,15,7,14,51,54,-3,52
Brechin,4066,7,13,12,11,55,50,5,51
Stranraer,4066,8,11,6,19,46,61,-15,39
East Fife,4066,9,9,8,19,44,48,-4,35
Stenhousem'r,4066,10,5,6,25,45,98,-53,21
Airdrieon,4067,1,20,8,8,66,48,18,68
Alloa,4067,2,18,9,9,67,48,19,63
Brechin,4067,3,19,6,11,55,40,15,63
Livingston,4067,4,18,4,14,74,60,14,58
Albion,4067,5,13,12,11,62,57,5,51
Peterhead,4067,6,14,8,14,52,49,3,50
East Fife,4067,7,12,8,16,46,54,-8,44
Queen's Park,4067,8,12,6,18,47,55,-8,42
Stranraer,4067,9,11,2,23,49,67,-18,35
Stenhousem'r,4067,10,7,9,20,44,84,-40,30
Livingston,4068,1,26,3,7,87,39,48,81
Alloa,4068,2,17,7,12,74,52,22,58
Airdrieon,4068,3,15,7,14,58,65,-7,52
Stranraer,4068,4,14,8,14,57,58,-1,50
East Fife,4068,5,12,12,12,47,44,3,48
Albion,4068,6,11,13,12,57,54,3,46
Brechin,4068,7,13,7,16,38,47,-9,46
Queen's Park,4068,8,12,8,16,39,49,-10,44
Peterhead,4068,9,10,10,16,44,60,-16,40
Stenhousem'r,4068,10,9,7,20,47,80,-33,34
Alloa,4069,1,23,6,7,81,40,41,75
Airdrieon,4069,2,18,7,11,70,46,24,61
Brechin,4069,3,17,7,12,63,53,10,58
Livingston,4069,4,16,9,11,71,57,14,57
Peterhead,4069,5,14,9,13,48,53,-5,51
East Fife,4069,6,13,11,12,59,57,2,50
Queen's Park,4069,7,14,8,14,39,48,-9,50
Stranraer,4069,8,12,7,17,48,64,-16,43
Albion,4069,9,8,9,19,49,66,-17,33
Stenhousem'r,4069,10,7,3,26,39,83,-44,24
Alloa,4070,1,18,9,9,64,41,23,63
Airdrieon,4070,2,19,6,11,60,45,15,63
Livingston,4070,3,18,6,12,69,43,26,60
Brechin,4070,4,16,8,12,48,39,9,56
Stranraer,4070,5,16,5,15,51,56,-5,53
Albion,4070,6,12,11,13,53,52,1,47
Peterhead,4070,7,13,7,16,47,60,-13,46
East Fife,4070,8,10,11,15,48,50,-2,41
Queen's Park,4070,9,10,8,18,30,54,-24,38
Stenhousem'r,4070,10,10,5,21,45,75,-30,35
Livingston,4071,1,21,7,8,80,51,29,70
Alloa,4071,2,17,12,7,71,43,28,63
Brechin,4071,3,16,8,12,50,45,5,56
Airdrieon,4071,4,15,9,12,56,57,-1,54
Queen's Park,4071,5,14,8,14,36,56,-20,50
Albion,4071,6,13,10,13,53,49,4,49
Peterhead,4071,7,12,10,14,50,51,-1,46
East Fife,4071,8,12,8,16,43,43,0,44
Stranraer,4071,9,11,6,19,51,62,-11,39
Stenhousem'r,4071,10,7,6,23,42,75,-33,27
Livingston,4072,1,25,3,8,74,40,34,78
Alloa,4072,2,18,9,9,72,41,31,63
Queen's Park,4072,3,17,8,11,44,39,5,59
Airdrieon,4072,4,16,9,11,62,52,10,57
Albion,4072,5,14,7,15,63,54,9,49
Brechin,4072,6,13,6,17,46,58,-12,45
Stranraer,4072,7,13,5,18,51,64,-13,44
East Fife,4072,8,11,9,16,50,54,-4,42
Peterhead,4072,9,10,9,17,46,65,-19,39
Stenhousem'r,4072,10,7,7,22,45,86,-41,28
Livingston,4073,1,23,4,9,88,50,38,73
Airdrieon,4073,2,19,6,11,65,48,17,63
East Fife,4073,3,16,9,11,60,45,15,57
Albion,4073,4,15,9,12,64,49,15,54
Alloa,4073,5,16,5,15,70,52,18,53
Brechin,4073,6,15,8,13,52,56,-4,53
Stranraer,4073,7,10,12,14,43,54,-11,42
Peterhead,4073,8,10,9,17,42,64,-22,39
Queen's Park,4073,9,9,10,17,40,62,-22,37
Stenhousem'r,4073,10,6,10,20,44,88,-44,28
Livingston,4074,1,20,8,8,68,40,28,68
Alloa,4074,2,16,10,10,66,49,17,58
Airdrieon,4074,3,16,9,11,57,54,3,57
Brechin,4074,4,15,8,13,56,59,-3,53
Queen's Park,4074,5,13,12,11,32,39,-7,51
East Fife,4074,6,11,13,12,49,42,7,46
Stranraer,4074,7,12,10,14,47,48,-1,46
Albion,4074,8,11,8,17,50,54,-4,41
Peterhead,4074,9,11,8,17,46,52,-6,41
Stenhousem'r,4074,10,8,8,20,44,78,-34,32
Livingston,4075,1,20,6,10,79,48,31,66
Alloa,4075,2,19,7,10,78,47,31,64
Albion,4075,3,16,9,11,58,55,3,57
Stranraer,4075,4,17,5,14,62,56,6,56
East Fife,4075,5,15,7,14,55,52,3,52
Queen's Park,4075,6,15,6,15,41,54,-13,51
Brechin,4075,7,13,9,14,50,51,-1,48
Peterhead,4075,8,12,6,18,58,61,-3,42
Airdrieon,4075,9,11,7,18,54,62,-8,40
Stenhousem'r,4075,10,7,8,21,45,94,-49,29
Alloa,4076,1,19,7,10,75,52,23,64
Livingston,4076,2,19,5,12,72,50,22,62
Albion,4076,3,17,9,10,66,38,28,60
Airdrieon,4076,4,16,7,13,61,55,6,55
Brechin,4076,5,17,4,15,57,59,-2,55
Peterhead,4076,6,14,7,15,47,56,-9,49
East Fife,4076,7,12,8,16,50,48,2,44
Stranraer,4076,8,13,5,18,53,65,-12,44
Queen's Park,4076,9,10,9,17,35,60,-25,39
Stenhousem'r,4076,10,7,11,18,49,82,-33,32
Livingston,4077,1,23,5,8,84,51,33,74
Alloa,4077,2,22,4,10,82,48,34,70
Airdrieon,4077,3,18,5,13,59,54,5,59
Brechin,4077,4,17,5,14,42,49,-7,56
Peterhead,4077,5,13,9,14,55,58,-3,48
Stranraer,4077,6,14,4,18,54,54,0,46
East Fife,4077,7,12,9,15,54,57,-3,45
Albion,4077,8,10,8,18,53,65,-12,38
Queen's Park,4077,9,9,9,18,38,60,-22,36
Stenhousem'r,4077,10,9,8,19,57,82,-25,35
Livingston,4078,1,21,9,6,76,32,44,72
Alloa,4078,2,19,8,9,65,39,26,65
Airdrieon,4078,3,18,6,12,55,48,7,60
Albion,4078,4,16,9,11,46,43,3,57
Stranraer,4078,5,17,4,15,58,52,6,55
Peterhead,4078,6,13,7,16,43,52,-9,46
Stenhousem'r,4078,7,11,7,18,48,74,-26,40
Brechin,4078,8,11,5,20,40,59,-19,38
Queen's Park,4078,9,8,13,15,30,47,-17,37
East Fife,4078,10,8,8,20,41,56,-15,32
Livingston,4079,1,20,6,10,65,46,19,66
Albion,4079,2,17,9,10,55,44,11,60
Airdrieon,4079,3,17,4,15,55,57,-2,55
Brechin,4079,4,15,9,12,58,49,9,54
Alloa,4079,5,14,11,11,63,53,10,53
Peterhead,4079,6,14,7,15,53,54,-1,49
East Fife,4079,7,11,11,14,46,46,0,44
Queen's Park,4079,8,11,10,15,32,42,-10,43
Stenhousem'r,4079,9,8,12,16,47,65,-18,36
Stranraer,4079,9,9,9,18,47,65,-18,36
Livingston,4080,1,21,6,9,81,52,29,69
Alloa,4080,2,18,10,8,81,48,33,64
Airdrieon,4080,3,18,8,10,71,58,13,62
Brechin,4080,4,15,6,15,59,57,2,51
Albion,4080,5,14,9,13,53,53,0,51
Peterhead,4080,6,13,8,15,42,54,-12,47
Queen's Park,4080,7,12,9,15,39,56,-17,45
East Fife,4080,8,11,11,14,46,47,-1,44
Stranraer,4080,9,12,4,20,56,65,-9,40
Stenhousem'r,4080,10,6,9,21,50,88,-38,27
Livingston,4081,1,21,6,9,72,41,31,69
Alloa,4081,2,18,8,10,64,46,18,62
Airdrieon,4081,3,16,10,10,55,54,1,58
Albion,4081,4,15,8,13,51,51,0,53
Brechin,4081,5,16,5,15,50,51,-1,53
East Fife,4081,6,12,10,14,47,38,9,46
Stranraer,4081,7,12,10,14,50,54,-4,46
Peterhead,4081,8,11,6,19,38,52,-14,39
Stenhousem'r,4081,9,10,7,19,52,72,-20,37
Queen's Park,4081,10,9,10,17,28,48,-20,37
Brechin,4082,1,19,7,10,62,44,18,64
Airdrieon,4082,2,18,9,9,76,62,14,63
Queen's Park,4082,3,17,6,13,51,49,2,57
Livingston,4082,4,16,6,14,70,60,10,54
Peterhead,4082,5,14,9,13,53,52,1,51
Alloa,4082,6,14,8,14,66,54,12,50
Albion,4082,7,14,5,17,51,51,0,47
Stranraer,4082,8,14,4,18,61,69,-8,46
East Fife,4082,9,11,10,15,39,51,-12,43
Stenhousem'r,4082,10,7,8,21,49,86,-37,29
Livingston,4083,1,22,6,8,83,50,33,72
Alloa,4083,2,16,9,11,73,52,21,57
Airdrieon,4083,3,15,9,12,57,50,7,54
Brechin,4083,4,15,9,12,47,44,3,54
Queen's Park,4083,5,16,5,15,44,48,-4,53
East Fife,4083,6,14,10,12,59,48,11,52
Peterhead,4083,7,14,7,15,45,53,-8,49
Albion,4083,8,12,9,15,48,53,-5,45
Stranraer,4083,9,12,5,19,58,72,-14,41
Stenhousem'r,4083,10,6,7,23,44,88,-44,25
Livingston,4084,1,22,5,9,82,50,32,71
Alloa,4084,2,20,9,7,69,37,32,69
Peterhead,4084,3,16,7,13,55,48,7,55
Albion,4084,4,16,7,13,53,50,3,55
Airdrieon,4084,5,16,6,14,56,51,5,54
Brechin,4084,6,15,4,17,47,50,-3,49
Queen's Park,4084,7,11,11,14,36,52,-16,44
East Fife,4084,8,10,11,15,43,49,-6,41
Stranraer,4084,9,11,7,18,49,60,-11,40
Stenhousem'r,4084,10,7,5,24,45,88,-43,26
Brechin,4085,1,16,9,11,56,45,11,57
Airdrieon,4085,2,16,9,11,54,48,6,57
Alloa,4085,3,15,11,10,71,50,21,56
Livingston,4085,4,14,9,13,66,58,8,51
East Fife,4085,5,14,9,13,51,44,7,51
Peterhead,4085,6,14,6,16,50,55,-5,48
Albion,4085,7,13,8,15,53,51,2,47
Stranraer,4085,8,13,8,15,43,56,-13,47
Queen's Park,4085,9,13,7,16,46,58,-12,46
Stenhousem'r,4085,10,9,10,17,46,71,-25,37
Alloa,4086,1,23,4,9,79,46,33,73
Livingston,4086,2,19,5,12,88,51,37,62
Airdrieon,4086,3,17,11,8,57,49,8,62
Brechin,4086,4,17,8,11,50,44,6,59
Queen's Park,4086,5,14,9,13,38,46,-8,51
Albion,4086,6,15,5,16,53,54,-1,50
Peterhead,4086,7,13,7,16,45,60,-15,46
Stranraer,4086,8,12,5,19,44,62,-18,41
East Fife,4086,9,10,7,19,42,49,-7,37
Stenhousem'r,4086,10,7,5,24,48,83,-35,26
Alloa,4087,1,21,6,9,77,46,31,69
Livingston,4087,2,20,3,13,65,48,17,63
Airdrieon,4087,3,18,4,14,56,51,5,58
Peterhead,4087,4,17,6,13,50,47,3,57
Brechin,4087,5,16,8,12,52,51,1,56
East Fife,4087,6,14,9,13,58,43,15,51
Albion,4087,7,14,8,14,56,56,0,50
Queen's Park,4087,8,15,5,16,44,52,-8,50
Stranraer,4087,9,9,5,22,39,61,-22,32
Stenhousem'r,4087,10,6,6,24,40,82,-42,24
Livingston,4088,1,24,3,9,78,43,35,75
Alloa,4088,2,19,9,8,74,44,30,66
Airdrieon,4088,3,17,6,13,64,57,7,57
Brechin,4088,4,16,6,14,50,53,-3,54
Albion,4088,5,16,4,16,53,49,4,52
Stranraer,4088,6,15,7,14,60,58,2,52
Peterhead,4088,7,13,7,16,51,62,-11,46
Queen's Park,4088,8,12,6,18,43,58,-15,42
East Fife,4088,9,9,9,18,43,52,-9,36
Stenhousem'r,4088,10,8,5,23,47,87,-40,29
Airdrieon,4089,1,24,3,9,73,46,27,75
Brechin,4089,2,19,7,10,56,51,5,64
Livingston,4089,3,18,6,12,84,58,26,60
Alloa,4089,4,18,6,12,69,43,26,60
Peterhead,4089,5,14,8,14,50,56,-6,50
East Fife,4089,6,13,8,15,55,50,5,47
Queen's Park,4089,7,15,2,19,41,52,-11,47
Albion,4089,8,10,11,15,47,52,-5,41
Stenhousem'r,4089,9,8,10,18,54,91,-37,34
Stranraer,4089,10,8,5,23,45,75,-30,29
Alloa,4090,1,24,5,7,80,38,42,77
Livingston,4090,2,24,2,10,76,42,34,74
Brechin,4090,3,17,5,14,57,52,5,56
East Fife,4090,4,14,11,11,52,49,3,53
Peterhead,4090,5,15,7,14,51,54,-3,52
Airdrieon,4090,6,15,7,14,56,63,-7,52
Albion,4090,7,12,10,14,53,50,3,46
Queen's Park,4090,8,9,8,19,32,58,-26,35
Stranraer,4090,9,9,7,20,44,61,-17,34
Stenhousem'r,4090,10,5,10,21,47,81,-34,25
Alloa,4091,1,20,6,10,80,52,28,66
Livingston,4091,2,21,3,12,79,58,21,66
Airdrieon,4091,3,19,7,10,66,48,18,64
Albion,4091,4,16,8,12,60,48,12,56
Brechin,4091,5,15,5,16,44,54,-10,50
Queen's Park,4091,6,15,4,17,42,55,-13,49
Stranraer,4091,7,14,6,16,60,61,-1,48
East Fife,4091,8,10,10,16,50,57,-7,40
Peterhead,4091,9,9,11,16,40,53,-13,38
Stenhousem'r,4091,10,8,6,22,55,90,-35,30
Livingston,4092,1,22,7,7,77,41,36,73
Queen's Park,4092,2,18,6,12,44,47,-3,60
Alloa,4092,3,17,8,11,62,47,15,59
Brechin,4092,4,16,8,12,55,51,4,56
Albion,4092,5,15,7,14,53,50,3,52
Airdrieon,4092,6,15,7,14,51,53,-2,52
Peterhead,4092,7,12,8,16,45,49,-4,44
Stranraer,4092,8,13,4,19,47,61,-14,43
East Fife,4092,9,11,7,18,45,48,-3,40
Stenhousem'r,4092,10,6,8,22,44,76,-32,26
Brechin,4093,1,20,5,11,64,46,18,65
Livingston,4093,2,18,8,10,66,40,26,62
Alloa,4093,3,17,7,12,74,48,26,58
Airdrieon,4093,4,15,10,11,56,53,3,55
Peterhead,4093,5,13,14,9,53,50,3,53
East Fife,4093,6,14,7,15,52,53,-1,49
Queen's Park,4093,7,14,6,16,43,56,-13,48
Stranraer,4093,8,12,9,15,53,61,-8,45
Albion,4093,9,9,11,16,54,70,-16,38
Stenhousem'r,4093,10,6,7,23,42,80,-38,25
Alloa,4094,1,22,6,8,67,39,28,72
Livingston,4094,2,19,7,10,69,42,27,64
Peterhead,4094,3,18,9,9,61,45,16,63
Airdrieon,4094,4,15,9,12,60,57,3,54
Albion,4094,5,14,8,14,48,48,0,50
Stranraer,4094,6,14,5,17,47,54,-7,47
Brechin,4094,7,12,8,16,44,49,-5,44
Queen's Park,4094,8,12,7,17,40,59,-19,43
East Fife,4094,9,8,13,15,42,51,-9,37
Stenhousem'r,4094,10,5,10,21,49,83,-34,25
Livingston,4095,1,23,4,9,79,50,29,73
Alloa,4095,2,19,8,9,72,46,26,65
Brechin,4095,3,16,9,11,55,45,10,57
Airdrieon,4095,4,15,7,14,57,52,5,52
East Fife,4095,5,12,12,12,55,48,7,48
Stranraer,4095,6,14,5,17,52,60,-8,47
Peterhead,4095,7,13,7,16,52,61,-9,46
Queen's Park,4095,8,11,10,15,28,44,-16,43
Albion,4095,9,11,7,18,51,61,-10,40
Stenhousem'r,4095,10,8,7,21,49,83,-34,31
Alloa,4096,1,18,9,9,75,51,24,63
Livingston,4096,2,18,8,10,80,52,28,62
Brechin,4096,3,17,8,11,57,53,4,59
Queen's Park,4096,4,16,7,13,53,55,-2,55
Airdrieon,4096,5,16,6,14,57,58,-1,54
Peterhead,4096,6,12,14,10,45,45,0,50
Albion,4096,7,12,11,13,50,54,-4,47
East Fife,4096,8,10,10,16,50,57,-7,40
Stranraer,4096,9,10,7,19,41,57,-16,37
Stenhousem'r,4096,10,7,8,21,50,76,-26,29
Livingston,4097,1,24,4,8,77,39,38,76
Alloa,4097,2,19,7,10,75,42,33,64
Peterhead,4097,3,16,7,13,58,55,3,55
Airdrieon,4097,4,16,4,16,50,56,-6,52
Albion,4097,5,14,7,15,46,50,-4,49
East Fife,4097,6,12,10,14,51,44,7,46
Stranraer,4097,7,14,3,19,49,65,-16,45
Queen's Park,4097,8,12,8,16,33,46,-13,44
Brechin,4097,9,12,6,18,47,56,-9,42
Stenhousem'r,4097,10,9,8,19,41,74,-33,35
Alloa,4098,1,18,11,7,62,38,24,65
Livingston,4098,2,19,6,11,77,48,29,63
Airdrieon,4098,3,16,7,13,61,60,1,55
Peterhead,4098,4,15,9,12,49,52,-3,54
Albion,4098,5,13,11,12,48,46,2,50
Brechin,4098,6,13,9,14,46,44,2,48
Queen's Park,4098,7,12,9,15,33,49,-16,45
Stranraer,4098,8,11,9,16,48,57,-9,42
Stenhousem'r,4098,9,10,9,17,55,79,-24,39
East Fife,4098,10,7,12,17,38,44,-6,33
Livingston,4099,1,24,3,9,73,41,32,75
Alloa,4099,2,17,9,10,74,45,29,60
Brechin,4099,3,17,8,11,61,50,11,59
Stranraer,4099,4,15,8,13,58,47,11,53
Airdrieon,4099,5,14,9,13,56,59,-3,51
Peterhead,4099,6,13,8,15,53,62,-9,47
Albion,4099,7,13,5,18,49,57,-8,44
Stenhousem'r,4099,8,12,7,17,44,75,-31,43
Queen's Park,4099,9,12,6,18,39,57,-18,42
East Fife,4099,10,7,9,20,43,57,-14,30
Livingston,4100,1,21,6,9,78,58,20,69
Alloa,4100,2,18,8,10,64,43,21,62
Stranraer,4100,3,18,6,12,63,56,7,60
Queen's Park,4100,4,17,6,13,47,47,0,57
Brechin,4100,5,16,8,12,57,54,3,56
Airdrieon,4100,6,13,7,16,59,61,-2,46
Peterhead,4100,7,12,8,16,56,61,-5,44
Albion,4100,8,11,6,19,47,67,-20,39
East Fife,4100,9,9,11,16,51,52,-1,38
Stenhousem'r,4100,10,6,12,18,50,73,-23,30
Livingston,4101,1,23,2,11,82,47,35,71
Alloa,4101,2,18,7,11,71,43,28,61
Brechin,4101,3,18,6,12,57,56,1,60
Airdrieon,4101,4,17,8,11,62,48,14,59
Albion,4101,5,15,7,14,51,52,-1,52
Queen's Park,4101,6,14,7,15,49,56,-7,49
East Fife,4101,7,13,6,17,59,57,2,45
Stranraer,4101,8,13,6,17,49,59,-10,45
Peterhead,4101,9,11,7,18,41,62,-21,40
Stenhousem'r,4101,10,6,8,22,40,81,-41,26
Alloa,4102,1,20,5,11,76,53,23,65
Brechin,4102,2,21,2,13,59,47,12,65
Airdrieon,4102,3,19,7,10,64,50,14,64
Livingston,4102,4,17,6,13,72,50,22,57
Albion,4102,5,14,12,10,57,51,6,54
Peterhead,4102,6,15,8,13,56,58,-2,53
Stranraer,4102,7,16,4,16,54,57,-3,52
Queen's Park,4102,8,10,7,19,46,62,-16,37
Stenhousem'r,4102,9,9,5,22,56,89,-33,32
East Fife,4102,10,6,10,20,37,60,-23,28
Alloa,4103,1,21,8,7,77,40,37,71
Brechin,4103,2,20,4,12,52,42,10,64
Livingston,4103,3,19,5,12,73,55,18,62
Airdrieon,4103,4,18,5,13,69,54,15,59
Peterhead,4103,5,13,6,17,43,53,-10,45
Queen's Park,4103,6,12,9,15,36,50,-14,45
East Fife,4103,7,12,6,18,48,53,-5,42
Stranraer,4103,8,11,8,17,46,58,-12,41
Albion,4103,9,10,9,17,48,63,-15,39
Stenhousem'r,4103,10,11,6,19,48,72,-24,39
Livingston,4104,1,22,6,8,79,52,27,72
Airdrieon,4104,2,18,8,10,59,53,6,62
Alloa,4104,3,17,10,9,58,39,19,61
East Fife,4104,4,14,9,13,52,43,9,51
Brechin,4104,5,15,6,15,46,48,-2,51
Stranraer,4104,6,14,7,15,49,53,-4,49
Peterhead,4104,7,11,9,16,40,50,-10,42
Albion,4104,8,10,10,16,49,55,-6,40
Queen's Park,4104,9,11,6,19,37,50,-13,39
Stenhousem'r,4104,10,7,11,18,45,71,-26,32
Alloa,4105,1,21,10,5,75,40,35,73
Airdrieon,4105,2,19,10,7,65,49,16,67
Livingston,4105,3,17,4,15,63,52,11,55
Brechin,4105,4,15,7,14,47,48,-1,52
Albion,4105,5,15,6,15,49,52,-3,51
Peterhead,4105,6,13,6,17,47,57,-10,45
East Fife,4105,7,12,8,16,54,48,6,44
Stranraer,4105,8,12,5,19,49,61,-12,41
Queen's Park,4105,9,11,6,19,35,54,-19,39
Stenhousem'r,4105,10,11,6,19,50,73,-23,39
Livingston,4106,1,22,6,8,69,41,28,72
Airdrieon,4106,2,21,8,7,66,44,22,71
Alloa,4106,3,18,7,11,67,40,27,61
East Fife,4106,4,14,11,11,47,38,9,53
Brechin,4106,5,13,9,14,38,41,-3,48
Queen's Park,4106,6,12,8,16,39,49,-10,44
Peterhead,4106,7,11,10,15,47,58,-11,43
Albion,4106,8,10,11,15,42,55,-13,41
Stranraer,4106,9,10,9,17,45,54,-9,39
Stenhousem'r,4106,10,6,7,23,42,82,-40,25
Livingston,4107,1,21,6,9,81,49,32,69
Alloa,4107,2,19,6,11,71,46,25,63
Albion,4107,3,17,5,14,57,49,8,56
Peterhead,4107,4,15,8,13,51,46,5,53
Airdrieon,4107,5,15,8,13,52,57,-5,53
Brechin,4107,6,15,5,16,48,52,-4,50
Stranraer,4107,7,13,6,17,50,53,-3,45
Stenhousem'r,4107,8,11,8,17,49,72,-23,41
East Fife,4107,9,9,11,16,42,48,-6,38
Queen's Park,4107,10,10,7,19,37,66,-29,37
Airdrieon,4108,1,19,7,10,63,43,20,64
Livingston,4108,2,18,7,11,70,51,19,61
Brechin,4108,3,18,7,11,51,41,10,61
Albion,4108,4,17,7,12,49,41,8,58
Alloa,4108,5,15,8,13,69,51,18,53
Peterhead,4108,6,14,7,15,41,55,-14,49
East Fife,4108,7,13,6,17,50,52,-2,45
Stranraer,4108,8,13,5,18,46,52,-6,44
Queen's Park,4108,9,12,7,17,35,56,-21,43
Stenhousem'r,4108,10,7,7,22,51,83,-32,28
Alloa,4109,1,20,6,10,78,51,27,66
Livingston,4109,2,19,2,15,62,52,10,59
Albion,4109,3,16,7,13,70,52,18,55
Queen's Park,4109,4,16,7,13,43,46,-3,55
Peterhead,4109,5,15,7,14,53,54,-1,52
Brechin,4109,6,15,7,14,48,53,-5,52
Stranraer,4109,7,16,4,16,54,61,-7,52
Airdrieon,4109,8,14,7,15,63,62,1,49
East Fife,4109,9,11,10,15,58,57,1,43
Stenhousem'r,4109,10,5,9,22,42,83,-41,24
Livingston,4110,1,19,6,11,69,46,23,63
Brechin,4110,2,18,7,11,49,38,11,61
Peterhead,4110,3,16,10,10,55,47,8,58
Alloa,4110,4,16,9,11,63,48,15,57
Airdrieon,4110,5,15,9,12,56,51,5,54
Albion,4110,6,13,10,13,50,52,-2,49
Queen's Park,4110,7,12,6,18,49,62,-13,42
Stranraer,4110,8,11,8,17,47,58,-11,41
Stenhousem'r,4110,9,10,8,18,51,75,-24,38
East Fife,4110,10,10,7,19,53,65,-12,37
Alloa,4111,1,20,6,10,60,41,19,66
Livingston,4111,2,20,3,13,72,42,30,63
Airdrieon,4111,3,16,9,11,55,51,4,57
Brechin,4111,4,14,10,12,51,45,6,52
Peterhead,4111,5,14,9,13,57,53,4,51
Queen's Park,4111,6,12,11,13,36,46,-10,47
Albion,4111,7,13,7,16,47,52,-5,46
Stenhousem'r,4111,8,11,9,16,40,64,-24,42
Stranraer,4111,9,11,7,18,45,55,-10,40
East Fife,4111,10,9,9,18,41,55,-14,36
Livingston,4112,1,24,1,11,82,43,39,73
Airdrieon,4112,2,19,4,13,53,45,8,61
Alloa,4112,3,18,5,13,68,52,16,59
Brechin,4112,4,16,9,11,51,44,7,57
Albion,4112,5,14,10,12,50,47,3,52
Stranraer,4112,6,14,4,18,44,54,-10,46
Peterhead,4112,7,13,6,17,47,56,-9,45
Stenhousem'r,4112,8,12,7,17,46,64,-18,43
East Fife,4112,9,8,12,16,38,49,-11,36
Queen's Park,4112,10,9,8,19,38,63,-25,35
Livingston,4113,1,21,6,9,74,42,32,69
Airdrieon,4113,2,18,5,13,58,54,4,59
Alloa,4113,3,16,8,12,62,45,17,56
Brechin,4113,4,17,4,15,57,48,9,55
Stranraer,4113,5,16,6,14,57,53,4,54
Peterhead,4113,6,12,10,14,50,54,-4,46
Albion,4113,7,12,10,14,56,63,-7,46
Queen's Park,4113,8,12,9,15,32,44,-12,45
East Fife,4113,9,11,11,14,50,53,-3,44
Stenhousem'r,4113,10,5,11,20,41,81,-40,26
Livingston,4114,1,22,6,8,84,49,35,72
Brechin,4114,2,18,9,9,60,47,13,63
Alloa,4114,3,18,8,10,69,47,22,62
Airdrieon,4114,4,15,9,12,59,57,2,54
Albion,4114,5,13,9,14,49,51,-2,48
Peterhead,4114,6,12,8,16,47,55,-8,44
Queen's Park,4114,7,12,8,16,38,52,-14,44
Stranraer,4114,8,13,5,18,48,63,-15,44
East Fife,4114,9,9,11,16,50,55,-5,38
Stenhousem'r,4114,10,7,9,20,43,71,-28,30
Alloa,4115,1,21,8,7,72,42,30,71
Livingston,4115,2,21,2,13,74,43,31,65
Albion,4115,3,18,5,13,54,50,4,59
Airdrieon,4115,4,17,6,13,57,56,1,57
Brechin,4115,5,17,5,14,50,50,0,56
Peterhead,4115,6,14,9,13,57,56,1,51
East Fife,4115,7,11,9,16,43,45,-2,42
Queen's Park,4115,8,11,6,19,33,57,-24,39
Stranraer,4115,9,9,8,19,52,59,-7,35
Stenhousem'r,4115,10,9,6,21,48,82,-34,33
Livingston,4116,1,23,4,9,83,42,41,73
Alloa,4116,2,21,8,7,82,45,37,71
Albion,4116,3,17,10,9,61,42,19,61
Airdrieon,4116,4,14,10,12,65,66,-1,52
Brechin,4116,5,15,5,16,55,62,-7,50
Peterhead,4116,6,13,8,15,51,52,-1,47
Queen's Park,4116,7,12,6,18,38,58,-20,42
East Fife,4116,8,9,12,15,58,60,-2,39
Stranraer,4116,9,8,9,19,42,74,-32,33
Stenhousem'r,4116,10,6,12,18,51,85,-34,30
Alloa,4117,1,23,6,7,77,38,39,75
Livingston,4117,2,20,4,12,72,48,24,64
Albion,4117,3,14,8,14,47,47,0,50
East Fife,4117,4,13,9,14,55,60,-5,48
Airdrieon,4117,5,14,6,16,56,65,-9,48
Peterhead,4117,6,13,8,15,49,54,-5,47
Stranraer,4117,7,14,4,18,56,53,3,46
Brechin,4117,8,14,4,18,45,52,-7,46
Queen's Park,4117,9,12,6,18,34,51,-17,42
Stenhousem'r,4117,10,10,11,15,53,76,-23,41
Livingston,4118,1,23,3,10,89,46,43,72
Albion,4118,2,21,4,11,63,50,13,67
Alloa,4118,3,18,7,11,66,51,15,61
Airdrieon,4118,4,16,9,11,62,55,7,57
Stranraer,4118,5,15,4,17,50,61,-11,49
Brechin,4118,6,14,5,17,54,51,3,47
East Fife,4118,7,11,8,17,45,52,-7,41
Queen's Park,4118,8,11,8,17,37,53,-16,41
Stenhousem'r,4118,9,10,9,17,47,76,-29,39
Peterhead,4118,10,9,7,20,44,62,-18,34
Livingston,4119,1,23,4,9,80,42,38,73
Alloa,4119,2,20,6,10,71,45,26,66
Airdrieon,4119,3,19,7,10,61,47,14,64
Brechin,4119,4,16,8,12,51,50,1,56
Albion,4119,5,11,14,11,51,49,2,47
Queen's Park,4119,6,13,5,18,37,60,-23,44
Stranraer,4119,7,12,7,17,48,56,-8,43
Peterhead,4119,8,12,6,18,44,51,-7,42
East Fife,4119,9,9,9,18,39,49,-10,36
Stenhousem'r,4119,10,8,8,20,38,71,-33,32
Alloa,4120,1,21,7,8,75,41,34,70
Livingston,4120,2,21,6,9,76,48,28,69
Peterhead,4120,3,16,8,12,59,46,13,56
Airdrieon,4120,4,16,7,13,50,49,1,55
Brechin,4120,5,16,6,14,52,48,4,54
Albion,4120,6,13,8,15,52,58,-6,47
Queen's Park,4120,7,13,4,19,35,51,-16,43
Stranraer,4120,8,12,6,18,55,66,-11,42
East Fife,4120,9,10,10,16,50,50,0,40
Stenhousem'r,4120,10,7,8,21,40,87,-47,29
Livingston,4121,1,20,8,8,83,50,33,68
Alloa,4121,2,19,7,10,71,43,28,64
Brechin,4121,3,16,8,12,49,43,6,56
Stranraer,4121,4,16,7,13,59,52,7,55
Airdrieon,4121,5,15,7,14,51,51,0,52
East Fife,4121,6,12,9,15,52,50,2,45
Albion,4121,7,12,9,15,48,55,-7,45
Queen's Park,4121,8,12,9,15,37,49,-12,45
Peterhead,4121,9,10,9,17,46,60,-14,39
Stenhousem'r,4121,10,6,11,19,40,83,-43,29
Alloa,4122,1,18,7,11,61,45,16,61
Livingston,4122,2,17,8,11,66,54,12,59
Brechin,4122,3,18,5,13,60,49,11,59
Airdrieon,4122,4,17,7,12,51,48,3,58
East Fife,4122,5,14,8,14,49,49,0,50
Queen's Park,4122,6,15,4,17,38,47,-9,49
Albion,4122,7,12,9,15,52,50,2,45
Stranraer,4122,8,13,5,18,58,60,-2,44
Peterhead,4122,9,12,7,17,54,62,-8,43
Stenhousem'r,4122,10,11,6,19,53,78,-25,39
Airdrieon,4123,1,20,8,8,67,39,28,68
Alloa,4123,2,21,5,10,65,45,20,68
Livingston,4123,3,21,3,12,84,59,25,66
Albion,4123,4,18,6,12,59,56,3,60
Peterhead,4123,5,17,7,12,56,45,11,58
Brechin,4123,6,16,4,16,54,53,1,52
East Fife,4123,7,12,8,16,51,49,2,44
Stranraer,4123,8,12,5,19,46,60,-14,41
Queen's Park,4123,9,9,7,20,29,60,-31,34
Stenhousem'r,4123,10,2,11,23,33,78,-45,17
Airdrieon,4124,1,19,7,10,63,51,12,64
Alloa,4124,2,17,9,10,69,42,27,60
Brechin,4124,3,15,10,11,57,54,3,55
Livingston,4124,4,16,6,14,59,55,4,54
Albion,4124,5,13,12,11,62,50,12,51
East Fife,4124,6,13,12,11,52,44,8,51
Stranraer,4124,7,15,4,17,56,62,-6,49
Stenhousem'r,4124,8,10,9,17,48,71,-23,39
Peterhead,4124,9,10,8,18,44,54,-10,38
Queen's Park,4124,10,8,11,17,22,49,-27,35
Livingston,4125,1,25,5,6,75,35,40,80
Alloa,4125,2,18,9,9,70,42,28,63
Brechin,4125,3,17,8,11,53,41,12,59
Airdrieon,4125,4,16,10,10,61,60,1,58
Albion,4125,5,16,9,11,58,47,11,57
East Fife,4125,6,11,9,16,47,51,-4,42
Stranraer,4125,7,11,4,21,52,68,-16,37
Queen's Park,4125,8,9,10,17,26,49,-23,37
Peterhead,4125,9,10,6,20,50,62,-12,36
Stenhousem'r,4125,10,8,8,20,39,76,-37,32
Livingston,4126,1,21,7,8,84,41,43,70
Alloa,4126,2,21,6,9,72,38,34,69
Airdrieon,4126,3,17,7,12,59,56,3,58
Stranraer,4126,4,15,6,15,50,53,-3,51
East Fife,4126,5,14,7,15,53,46,7,49
Peterhead,4126,6,13,9,14,41,47,-6,48
Brechin,4126,7,14,6,16,47,61,-14,48
Queen's Park,4126,8,13,5,18,38,57,-19,44
Albion,4126,9,12,5,19,45,56,-11,41
Stenhousem'r,4126,10,7,8,21,42,76,-34,29
Alloa,4127,1,19,8,9,78,46,32,65
Livingston,4127,2,20,3,13,73,54,19,63
Airdrieon,4127,3,18,4,14,65,56,9,58
Albion,4127,4,16,7,13,55,56,-1,55
Brechin,4127,5,16,4,16,46,45,1,52
Peterhead,4127,6,16,4,16,53,55,-2,52
East Fife,4127,7,14,7,15,54,51,3,49
Queen's Park,4127,8,12,8,16,40,52,-12,44
Stranraer,4127,9,12,5,19,55,73,-18,41
Stenhousem'r,4127,10,8,8,20,44,75,-31,32
Livingston,4128,1,20,7,9,73,41,32,67
Airdrieon,4128,2,18,6,12,61,55,6,60
Alloa,4128,3,15,12,9,69,45,24,57
Brechin,4128,4,17,6,13,48,47,1,57
Albion,4128,5,14,11,11,64,44,20,53
East Fife,4128,6,13,13,10,49,36,13,52
Queen's Park,4128,7,14,7,15,37,50,-13,49
Stranraer,4128,8,12,7,17,54,56,-2,43
Peterhead,4128,9,10,10,16,44,71,-27,40
Stenhousem'r,4128,10,4,7,25,39,93,-54,19
Livingston,4129,1,23,2,11,83,45,38,71
Alloa,4129,2,18,8,10,66,42,24,62
Peterhead,4129,3,17,9,10,65,49,16,60
Brechin,4129,4,17,5,14,43,43,0,56
Airdrieon,4129,5,16,6,14,50,56,-6,54
Stranraer,4129,6,14,7,15,50,53,-3,49
Albion,4129,7,12,7,17,48,58,-10,43
Queen's Park,4129,8,11,8,17,34,53,-19,41
East Fife,4129,9,10,10,16,46,54,-8,40
Stenhousem'r,4129,10,8,6,22,50,82,-32,30
Livingston,4130,1,22,3,11,88,51,37,69
Alloa,4130,2,17,8,11,67,49,18,59
Brechin,4130,3,17,8,11,52,51,1,59
Airdrieon,4130,4,16,7,13,60,53,7,55
Peterhead,4130,5,16,7,13,53,59,-6,55
Albion,4130,6,14,8,14,53,47,6,50
Queen's Park,4130,7,14,6,16,36,47,-11,48
East Fife,4130,8,10,9,17,55,55,0,39
Stenhousem'r,4130,9,9,9,18,54,86,-32,36
Stranraer,4130,10,9,7,20,44,64,-20,34
Livingston,4131,1,23,5,8,87,47,40,74
Alloa,4131,2,20,7,9,67,45,22,67
Airdrieon,4131,3,18,5,13,52,53,-1,59
Albion,4131,4,15,9,12,62,46,16,54
Peterhead,4131,5,14,9,13,55,57,-2,51
Brechin,4131,6,14,7,15,56,52,4,49
Queen's Park,4131,7,13,7,16,32,50,-18,46
East Fife,4131,8,11,9,16,49,59,-10,42
Stranraer,4131,9,9,4,23,44,63,-19,31
Stenhousem'r,4131,10,7,10,19,45,77,-32,31
Airdrieon,4132,1,20,6,10,61,47,14,66
Livingston,4132,2,20,3,13,74,55,19,63
Alloa,4132,3,18,8,10,62,43,19,62
Albion,4132,4,16,8,12,62,48,14,56
Brechin,4132,5,15,6,15,49,53,-4,51
East Fife,4132,6,14,8,14,61,46,15,50
Stranraer,4132,7,12,5,19,50,58,-8,41
Peterhead,4132,8,10,10,16,44,65,-21,40
Queen's Park,4132,9,11,6,19,32,50,-18,39
Stenhousem'r,4132,10,10,8,18,56,86,-30,38
Livingston,4133,1,20,7,9,83,54,29,67
Alloa,4133,2,19,8,9,78,54,24,65
Albion,4133,3,15,8,13,54,51,3,53
Airdrieon,4133,4,15,6,15,66,54,12,51
Peterhead,4133,5,14,9,13,55,58,-3,51
Brechin,4133,6,14,8,14,42,47,-5,50
East Fife,4133,7,10,14,12,44,40,4,44
Queen's Park,4133,8,12,8,16,47,62,-15,44
Stranraer,4133,9,13,4,19,54,64,-10,43
Stenhousem'r,4133,10,9,6,21,49,88,-39,33
Alloa,4134,1,19,9,8,74,47,27,66
Livingston,4134,1,19,9,8,74,47,27,66
Albion,4134,3,17,8,11,59,48,11,59
Brechin,4134,4,17,6,13,57,59,-2,57
East Fife,4134,5,15,9,12,52,44,8,54
Airdrieon,4134,6,14,8,14,57,56,1,50
Stranraer,4134,7,15,5,16,53,56,-3,50
Peterhead,4134,8,9,11,16,45,57,-12,38
Queen's Park,4134,9,8,8,20,31,56,-25,32
Stenhousem'r,4134,10,7,7,22,50,82,-32,28
Airdrieon,4135,1,21,6,9,72,49,23,69
Alloa,4135,2,19,9,8,75,48,27,66
Livingston,4135,3,19,9,8,74,49,25,66
Brechin,4135,4,15,6,15,57,59,-2,51
Albion,4135,5,14,7,15,54,56,-2,49
East Fife,4135,6,13,9,14,52,48,4,48
Stranraer,4135,7,14,6,16,58,59,-1,48
Peterhead,4135,8,10,10,16,48,56,-8,40
Queen's Park,4135,9,9,7,20,36,59,-23,34
Stenhousem'r,4135,10,7,9,20,49,92,-43,30
Livingston,4136,1,24,4,8,92,46,46,76
Brechin,4136,2,18,6,12,58,49,9,60
Airdrieon,4136,3,16,10,10,56,52,4,58
Alloa,4136,4,14,10,12,64,50,14,52
Albion,4136,5,15,7,14,50,51,-1,52
Peterhead,4136,6,14,9,13,45,48,-3,51
Stranraer,4136,7,13,8,15,49,55,-6,47
East Fife,4136,8,9,11,16,48,48,0,38
Stenhousem'r,4136,9,8,9,19,45,78,-33,33
Queen's Park,4136,10,7,10,19,31,61,-30,31
Alloa,4137,1,20,9,7,71,37,34,69
Brechin,4137,2,20,6,10,60,42,18,66
Livingston,4137,3,20,5,11,79,57,22,65
Airdrieon,4137,4,15,7,14,63,64,-1,52
Stranraer,4137,5,15,7,14,55,57,-2,52
Queen's Park,4137,6,13,4,19,39,55,-16,43
Peterhead,4137,7,12,6,18,44,55,-11,42
East Fife,4137,8,11,8,17,60,57,3,41
Albion,4137,9,10,11,15,52,64,-12,41
Stenhousem'r,4137,10,8,9,19,46,81,-35,33
Brechin,4138,1,21,6,9,59,41,18,69
Livingston,4138,2,21,4,11,82,53,29,67
Stranraer,4138,3,17,7,12,54,52,2,58
Alloa,4138,4,14,11,11,59,49,10,53
Peterhead,4138,5,13,13,10,48,45,3,52
Airdrieon,4138,6,14,9,13,60,62,-2,51
Albion,4138,7,13,9,14,50,46,4,48
Queen's Park,4138,8,10,7,19,33,53,-20,37
Stenhousem'r,4138,9,8,8,20,47,74,-27,32
East Fife,4138,10,7,10,19,45,62,-17,31
Livingston,4139,1,24,2,10,78,41,37,74
Alloa,4139,2,19,6,11,60,38,22,63
Peterhead,4139,3,17,6,13,58,59,-1,57
Brechin,4139,4,16,5,15,44,47,-3,53
Albion,4139,5,14,9,13,61,50,11,51
Queen's Park,4139,6,14,9,13,39,46,-7,51
Airdrieon,4139,7,14,8,14,61,55,6,50
Stenhousem'r,4139,8,10,8,18,43,76,-33,38
East Fife,4139,9,9,8,19,45,52,-7,35
Stranraer,4139,10,10,5,21,43,68,-25,35
Livingston,4140,1,22,3,11,80,51,29,69
Alloa,4140,2,20,7,9,68,37,31,67
Airdrieon,4140,3,17,5,14,58,47,11,56
Peterhead,4140,4,15,9,12,52,44,8,54
Brechin,4140,5,15,7,14,49,47,2,52
Stranraer,4140,6,14,7,15,52,58,-6,49
Albion,4140,7,12,11,13,49,55,-6,47
Queen's Park,4140,8,13,7,16,35,50,-15,46
East Fife,4140,9,9,12,15,43,45,-2,39
Stenhousem'r,4140,10,6,6,24,37,89,-52,24
Peterhead,4141,1,20,7,9,58,44,14,67
Alloa,4141,2,19,9,8,70,46,24,66
Livingston,4141,3,19,6,11,71,47,24,63
Airdrieon,4141,4,17,9,10,65,53,12,60
Brechin,4141,5,17,6,13,48,49,-1,57
Stranraer,4141,6,14,6,16,57,57,0,48
East Fife,4141,7,10,11,15,54,58,-4,41
Albion,4141,8,10,10,16,49,58,-9,40
Queen's Park,4141,9,10,8,18,34,52,-18,38
Stenhousem'r,4141,10,5,6,25,39,81,-42,21
Livingston,4142,1,20,8,8,74,41,33,68
Alloa,4142,2,16,9,11,72,48,24,57
Albion,4142,3,15,10,11,64,58,6,55
Airdrieon,4142,4,15,10,11,57,61,-4,55
Brechin,4142,5,15,7,14,47,49,-2,52
Peterhead,4142,6,13,12,11,54,44,10,51
East Fife,4142,7,11,10,15,53,57,-4,43
Stranraer,4142,8,11,7,18,44,59,-15,40
Queen's Park,4142,9,9,10,17,34,54,-20,37
Stenhousem'r,4142,10,9,9,18,52,80,-28,36
Airdrieon,4143,1,22,6,8,60,46,14,72
Alloa,4143,2,21,7,8,65,36,29,70
Livingston,4143,3,21,3,12,73,43,30,66
Brechin,4143,4,19,3,14,60,55,5,60
Albion,4143,5,12,11,13,52,49,3,47
Peterhead,4143,6,13,7,16,50,54,-4,46
East Fife,4143,7,10,10,16,51,56,-5,40
Stranraer,4143,8,11,5,20,43,67,-24,38
Queen's Park,4143,9,9,8,19,34,53,-19,35
Stenhousem'r,4143,10,8,8,20,50,79,-29,32
Alloa,4144,1,19,7,10,72,42,30,64
Brechin,4144,2,18,6,12,59,42,17,60
Albion,4144,3,16,10,10,55,43,12,58
Livingston,4144,4,17,5,14,70,50,20,56
Airdrieon,4144,5,15,7,14,52,54,-2,52
Peterhead,4144,6,14,7,15,47,52,-5,49
Stranraer,4144,7,14,6,16,53,66,-13,48
East Fife,4144,8,10,9,17,46,55,-9,39
Queen's Park,4144,9,10,9,17,34,54,-20,39
Stenhousem'r,4144,10,10,8,18,47,77,-30,38
Livingston,4145,1,24,4,8,88,51,37,76
Alloa,4145,2,21,8,7,84,47,37,71
East Fife,4145,3,14,8,14,58,50,8,50
Airdrieon,4145,4,14,8,14,58,67,-9,50
Albion,4145,5,14,7,15,51,59,-8,49
Stranraer,4145,6,14,6,16,58,52,6,48
Brechin,4145,7,12,9,15,45,53,-8,45
Queen's Park,4145,8,13,6,17,37,46,-9,45
Peterhead,4145,9,13,6,17,42,55,-13,45
Stenhousem'r,4145,10,6,8,22,46,87,-41,26
Alloa,4146,1,20,8,8,68,39,29,68
Livingston,4146,2,20,5,11,75,49,26,65
Airdrieon,4146,3,19,6,11,69,55,14,63
Peterhead,4146,4,16,7,13,51,46,5,55
Brechin,4146,5,15,8,13,44,56,-12,53
Albion,4146,6,14,7,15,56,56,0,49
East Fife,4146,7,13,9,14,50,42,8,48
Stenhousem'r,4146,8,11,9,16,50,72,-22,42
Queen's Park,4146,9,8,9,19,23,47,-24,33
Stranraer,4146,10,9,2,25,42,66,-24,29
Airdrieon,4147,1,20,5,11,62,53,9,65
Livingston,4147,2,20,4,12,76,50,26,64
Brechin,4147,3,18,7,11,51,46,5,61
Alloa,4147,4,18,6,12,70,47,23,60
Albion,4147,5,17,5,14,65,59,6,56
Peterhead,4147,6,16,6,14,59,56,3,54
Stranraer,4147,7,14,2,20,51,65,-14,44
East Fife,4147,8,9,9,18,48,53,-5,36
Queen's Park,4147,9,10,6,20,30,54,-24,36
Stenhousem'r,4147,10,10,6,20,55,84,-29,36
Alloa,4148,1,20,8,8,73,46,27,68
Livingston,4148,2,21,4,11,79,57,22,67
Airdrieon,4148,3,18,8,10,66,52,14,62
Brechin,4148,4,18,6,12,53,46,7,60
Peterhead,4148,5,14,7,15,58,54,4,49
Stranraer,4148,6,14,6,16,52,64,-12,48
East Fife,4148,7,12,9,15,54,49,5,45
Albion,4148,8,10,12,14,45,52,-7,42
Queen's Park,4148,9,9,9,18,32,52,-20,36
Stenhousem'r,4148,10,6,7,23,39,79,-40,25
Livingston,4149,1,23,6,7,74,37,37,75
Brechin,4149,2,17,8,11,57,46,11,59
Alloa,4149,3,16,9,11,70,51,19,57
Airdrieon,4149,4,16,9,11,59,51,8,57
Stranraer,4149,5,15,6,15,52,54,-2,51
Peterhead,4149,6,11,14,11,41,49,-8,47
East Fife,4149,7,11,12,13,46,41,5,45
Queen's Park,4149,8,12,6,18,42,58,-16,42
Albion,4149,9,9,8,19,50,66,-16,35
Stenhousem'r,4149,10,6,10,20,44,82,-38,28
Livingston,4150,1,21,5,10,75,47,28,68
Alloa,4150,2,18,7,11,65,50,15,61
Airdrieon,4150,3,17,6,13,59,47,12,57
Peterhead,4150,4,16,8,12,56,51,5,56
Albion,4150,5,14,11,11,55,45,10,53
Brechin,4150,6,15,6,15,48,55,-7,51
Stranraer,4150,7,15,5,16,56,57,-1,50
Queen's Park,4150,8,12,6,18,41,62,-21,42
East Fife,4150,9,10,11,15,43,46,-3,41
Stenhousem'r,4150,10,6,7,23,44,82,-38,25
Livingston,4151,1,22,3,11,84,52,32,69
Alloa,4151,2,21,6,9,71,44,27,69
Brechin,4151,3,19,4,13,59,44,15,61
Airdrieon,4151,4,15,9,12,55,57,-2,54
Stranraer,4151,5,15,5,16,54,61,-7,50
Albion,4151,6,13,9,14,48,50,-2,48
Peterhead,4151,7,12,9,15,45,54,-9,45
Queen's Park,4151,8,12,5,19,38,48,-10,41
East Fife,4151,9,9,10,17,44,60,-16,37
Stenhousem'r,4151,10,9,6,21,35,63,-28,33
Livingston,4152,1,23,3,10,80,43,37,72
Alloa,4152,2,22,6,8,77,40,37,72
Airdrieon,4152,3,18,7,11,61,56,5,61
Peterhead,4152,4,17,7,12,50,50,0,58
Stranraer,4152,5,15,6,15,58,55,3,51
Brechin,4152,6,15,5,16,51,60,-9,50
Albion,4152,7,13,6,17,49,55,-6,45
Queen's Park,4152,8,11,7,18,36,58,-22,40
East Fife,4152,9,10,9,17,49,54,-5,39
Stenhousem'r,4152,10,4,8,24,41,81,-40,20
Airdrieon,4153,1,20,6,10,63,52,11,66
Livingston,4153,2,18,8,10,76,48,28,62
Alloa,4153,3,17,10,9,66,44,22,61
Albion,4153,4,16,3,17,56,55,1,51
East Fife,4153,5,12,10,14,49,50,-1,46
Peterhead,4153,6,12,10,14,42,51,-9,46
Queen's Park,4153,7,13,7,16,40,55,-15,46
Brechin,4153,8,12,8,16,51,61,-10,44
Stranraer,4153,9,13,4,19,54,62,-8,43
Stenhousem'r,4153,10,9,10,17,55,74,-19,37
Alloa,4154,1,21,7,8,71,41,30,70
Livingston,4154,2,17,8,11,64,49,15,59
Airdrieon,4154,3,16,10,10,54,52,2,58
Brechin,4154,4,17,6,13,51,45,6,57
Peterhead,4154,5,16,8,12,52,43,9,56
Albion,4154,6,16,6,14,53,49,4,54
Queen's Park,4154,7,12,8,16,48,58,-10,44
East Fife,4154,8,12,7,17,50,51,-1,43
Stranraer,4154,9,9,5,22,44,67,-23,32
Stenhousem'r,4154,10,8,7,21,39,71,-32,31
Alloa,4155,1,22,7,7,72,43,29,73
Livingston,4155,2,21,6,9,85,45,40,69
Brechin,4155,3,17,7,12,45,41,4,58
Airdrieon,4155,4,14,10,12,51,52,-1,52
Stranraer,4155,5,14,8,14,55,53,2,50
Peterhead,4155,6,12,10,14,47,58,-11,46
Albion,4155,7,11,11,14,47,53,-6,44
Queen's Park,4155,8,10,10,16,36,48,-12,40
East Fife,4155,9,9,8,19,43,54,-11,35
Stenhousem'r,4155,10,8,7,21,46,80,-34,31
Livingston,4156,1,22,5,9,76,38,38,71
Brechin,4156,2,19,5,12,46,40,6,62
Alloa,4156,3,18,6,12,70,52,18,60
Peterhead,4156,4,18,6,12,61,60,1,60
Albion,4156,5,13,9,14,47,48,-1,48
Airdrieon,4156,6,14,5,17,58,59,-1,47
Queen's Park,4156,7,12,9,15,45,50,-5,45
East Fife,4156,8,11,8,17,49,58,-9,41
Stranraer,4156,9,12,5,19,51,66,-15,41
Stenhousem'r,4156,10,9,6,21,49,81,-32,33
Livingston,4157,1,23,5,8,91,47,44,74
Alloa,4157,2,20,8,8,67,40,27,68
Albion,4157,3,15,6,15,57,54,3,51
Brechin,4157,4,14,7,15,51,50,1,49
Airdrieon,4157,5,14,6,16,55,58,-3,48
Peterhead,4157,6,12,11,13,46,51,-5,47
Stranraer,4157,7,13,8,15,44,60,-16,47
Queen's Park,4157,8,12,9,15,35,49,-14,45
East Fife,4157,9,11,8,17,42,49,-7,41
Stenhousem'r,4157,10,9,6,21,43,73,-30,33
Alloa,4158,1,18,9,9,77,43,34,63
Airdrieon,4158,2,19,6,11,64,58,6,63
Livingston,4158,3,19,4,13,76,53,23,61
Brechin,4158,4,16,10,10,52,48,4,58
Stranraer,4158,5,15,9,12,52,53,-1,54
Albion,4158,6,14,8,14,48,52,-4,50
Peterhead,4158,7,12,10,14,56,54,2,46
Stenhousem'r,4158,8,11,6,19,52,86,-34,39
Queen's Park,4158,9,7,12,17,34,48,-14,33
East Fife,4158,10,5,14,17,43,59,-16,29
Livingston,4159,1,21,3,12,79,51,28,66
Alloa,4159,2,18,9,9,76,47,29,63
Airdrieon,4159,3,18,4,14,62,56,6,58
Brechin,4159,4,17,5,14,53,56,-3,56
Peterhead,4159,5,17,4,15,59,61,-2,55
Stranraer,4159,6,14,6,16,54,60,-6,48
Queen's Park,4159,7,12,12,12,40,53,-13,48
Albion,4159,8,11,12,13,45,48,-3,45
East Fife,4159,9,11,8,17,52,50,2,41
Stenhousem'r,4159,10,6,7,23,43,81,-38,25
Livingston,4160,1,24,6,6,76,42,34,78
Alloa,4160,2,17,8,11,71,50,21,59
Albion,4160,3,16,9,11,62,49,13,57
Airdrieon,4160,4,15,9,12,60,56,4,54
Brechin,4160,5,14,9,13,46,47,-1,51
East Fife,4160,6,13,8,15,55,50,5,47
Peterhead,4160,7,12,9,15,48,56,-8,45
Queen's Park,4160,8,12,6,18,37,52,-15,42
Stranraer,4160,9,9,9,18,44,65,-21,36
Stenhousem'r,4160,10,7,9,20,47,79,-32,30
Livingston,4161,1,21,5,10,78,51,27,68
Alloa,4161,2,19,8,9,69,43,26,65
Airdrieon,4161,3,20,4,12,62,47,15,64
Brechin,4161,4,15,6,15,51,55,-4,51
East Fife,4161,5,13,11,12,56,46,10,50
Peterhead,4161,6,13,10,13,56,53,3,49
Albion,4161,7,13,10,13,45,42,3,49
Queen's Park,4161,8,13,4,19,37,55,-18,43
Stranraer,4161,9,13,3,20,49,64,-15,42
Stenhousem'r,4161,10,7,5,24,40,87,-47,26
Alloa,4162,1,20,9,7,78,48,30,69
Livingston,4162,2,20,5,11,78,50,28,65
Albion,4162,3,18,5,13,66,52,14,59
Airdrieon,4162,4,17,7,12,60,51,9,58
Brechin,4162,5,13,10,13,44,42,2,49
East Fife,4162,6,13,7,16,49,47,2,46
Peterhead,4162,7,12,9,15,47,60,-13,45
Queen's Park,4162,8,11,8,17,41,62,-21,41
Stranraer,4162,9,10,10,16,58,69,-11,40
Stenhousem'r,4162,10,9,4,23,39,79,-40,31
Alloa,4163,1,17,10,9,74,42,32,61
Brechin,4163,2,19,3,14,55,52,3,60
Airdrieon,4163,3,16,9,11,56,46,10,57
Stranraer,4163,4,16,4,16,64,65,-1,52
Albion,4163,5,14,9,13,49,50,-1,51
Livingston,4163,6,14,6,16,62,57,5,48
East Fife,4163,7,12,11,13,48,41,7,47
Peterhead,4163,8,14,5,17,53,60,-7,47
Queen's Park,4163,9,12,8,16,40,56,-16,44
Stenhousem'r,4163,10,10,7,19,47,79,-32,37
Alloa,4164,1,18,8,10,74,50,24,62
Airdrieon,4164,2,17,11,8,62,44,18,62
Livingston,4164,3,19,4,13,80,53,27,61
Brechin,4164,4,19,4,13,48,46,2,61
Peterhead,4164,5,14,8,14,48,54,-6,50
Albion,4164,6,12,11,13,48,46,2,47
East Fife,4164,7,10,12,14,41,40,1,42
Queen's Park,4164,8,11,7,18,37,57,-20,40
Stenhousem'r,4164,9,11,7,18,46,74,-28,40
Stranraer,4164,10,9,8,19,44,64,-20,35
Livingston,4165,1,20,7,9,72,48,24,67
Alloa,4165,2,19,6,11,61,40,21,63
Airdrieon,4165,3,16,10,10,69,55,14,58
Brechin,4165,4,15,8,13,53,49,4,53
Queen's Park,4165,5,14,7,15,44,54,-10,49
East Fife,4165,6,13,9,14,49,47,2,48
Peterhead,4165,7,13,7,16,50,54,-4,46
Stranraer,4165,8,12,8,16,60,61,-1,44
Albion,4165,9,12,7,17,51,59,-8,43
Stenhousem'r,4165,10,8,7,21,44,86,-42,31
Alloa,4166,1,20,8,8,74,45,29,68
Livingston,4166,2,20,5,11,66,45,21,65
Airdrieon,4166,3,16,6,14,52,52,0,54
Albion,4166,4,13,13,10,63,50,13,52
Stranraer,4166,5,15,7,14,53,49,4,52
East Fife,4166,6,13,12,11,55,46,9,51
Queen's Park,4166,7,11,12,13,39,46,-7,45
Brechin,4166,8,13,6,17,48,63,-15,45
Peterhead,4166,9,10,9,17,45,61,-16,39
Stenhousem'r,4166,10,7,6,23,54,92,-38,27
Alloa,4167,1,21,10,5,75,37,38,73
Livingston,4167,2,22,1,13,86,47,39,67
Airdrieon,4167,3,17,7,12,53,54,-1,58
Peterhead,4167,4,15,8,13,46,47,-1,53
Brechin,4167,5,15,7,14,48,52,-4,52
Stranraer,4167,6,14,6,16,57,59,-2,48
East Fife,4167,7,12,10,14,44,38,6,46
Albion,4167,8,12,9,15,45,52,-7,45
Queen's Park,4167,9,8,9,19,31,55,-24,33
Stenhousem'r,4167,10,6,9,21,39,83,-44,27
Livingston,4168,1,20,5,11,78,48,30,65
Brechin,4168,2,18,9,9,64,44,20,63
Peterhead,4168,3,19,4,13,61,56,5,61
Alloa,4168,4,15,9,12,67,51,16,54
Airdrieon,4168,5,16,6,14,58,62,-4,54
Albion,4168,6,13,11,12,53,56,-3,50
Queen's Park,4168,7,11,10,15,33,47,-14,43
Stranraer,4168,8,11,9,16,51,57,-6,42
East Fife,4168,9,11,8,17,50,53,-3,41
Stenhousem'r,4168,10,7,7,22,43,84,-41,28
Livingston,4169,1,21,5,10,69,45,24,68
Alloa,4169,2,17,8,11,70,50,20,59
Albion,4169,3,17,7,12,59,49,10,58
Brechin,4169,4,15,7,14,43,46,-3,52
Airdrieon,4169,5,15,6,15,50,55,-5,51
Stranraer,4169,6,14,7,15,54,55,-1,49
Peterhead,4169,7,13,9,14,46,54,-8,48
East Fife,4169,8,11,13,12,46,36,10,46
Queen's Park,4169,9,12,7,17,42,58,-16,43
Stenhousem'r,4169,10,8,5,23,47,78,-31,29
Livingston,4170,1,20,5,11,74,44,30,65
Alloa,4170,2,16,11,9,67,49,18,59
Airdrieon,4170,3,17,7,12,55,50,5,58
Albion,4170,4,15,7,14,56,52,4,52
Queen's Park,4170,5,15,7,14,46,48,-2,52
Brechin,4170,6,14,8,14,48,51,-3,50
Peterhead,4170,7,14,7,15,47,53,-6,49
East Fife,4170,8,12,9,15,56,51,5,45
Stenhousem'r,4170,9,10,8,18,53,75,-22,38
Stranraer,4170,10,10,5,21,40,69,-29,35
Alloa,4171,1,20,5,11,71,43,28,65
Livingston,4171,2,19,7,10,79,56,23,64
Airdrieon,4171,3,16,6,14,63,59,4,54
Albion,4171,4,15,9,12,48,44,4,54
Brechin,4171,5,15,8,13,49,46,3,53
Queen's Park,4171,6,14,9,13,40,46,-6,51
Peterhead,4171,7,14,5,17,51,57,-6,47
East Fife,4171,8,11,10,15,50,58,-8,43
Stranraer,4171,9,12,6,18,45,56,-11,42
Stenhousem'r,4171,10,8,7,21,45,76,-31,31
Brechin,4172,1,22,3,11,66,40,26,69
Airdrieon,4172,2,19,8,9,60,45,15,65
Livingston,4172,3,17,10,9,73,54,19,61
Albion,4172,4,16,9,11,48,44,4,57
Alloa,4172,5,13,12,11,62,49,13,51
Queen's Park,4172,6,14,7,15,36,45,-9,49
Peterhead,4172,7,13,8,15,46,54,-8,47
East Fife,4172,8,9,12,15,39,43,-4,39
Stranraer,4172,9,10,6,20,40,56,-16,36
Stenhousem'r,4172,10,6,7,23,36,76,-40,25
Alloa,4173,1,19,9,8,71,42,29,66
Airdrieon,4173,2,18,8,10,60,46,14,62
Livingston,4173,3,18,3,15,70,53,17,57
Stranraer,4173,4,17,5,14,56,51,5,56
Brechin,4173,5,16,8,12,51,46,5,56
Peterhead,4173,6,17,3,16,55,62,-7,54
Queen's Park,4173,7,13,8,15,37,52,-15,47
Albion,4173,8,12,10,14,55,55,0,46
East Fife,4173,9,12,5,19,46,49,-3,41
Stenhousem'r,4173,10,5,7,24,42,87,-45,22
Livingston,4174,1,23,5,8,84,47,37,74
Brechin,4174,2,19,4,13,50,48,2,61
Alloa,4174,3,16,10,10,68,51,17,58
Airdrieon,4174,4,17,7,12,55,48,7,58
Peterhead,4174,5,15,11,10,47,46,1,56
Albion,4174,6,13,8,15,54,56,-2,47
Queen's Park,4174,7,14,3,19,47,53,-6,45
East Fife,4174,8,11,9,16,55,57,-2,42
Stranraer,4174,9,11,6,19,44,56,-12,39
Stenhousem'r,4174,10,6,7,23,44,86,-42,25
Livingston,4175,1,21,8,7,82,48,34,71
Albion,4175,2,16,9,11,57,43,14,57
Airdrieon,4175,3,16,8,12,73,63,10,56
Alloa,4175,4,15,8,13,65,52,13,53
East Fife,4175,5,13,10,13,57,55,2,49
Queen's Park,4175,6,13,8,15,37,51,-14,47
Brechin,4175,7,13,7,16,53,58,-5,46
Peterhead,4175,8,12,7,17,49,59,-10,43
Stranraer,4175,9,10,11,15,56,72,-16,41
Stenhousem'r,4175,10,9,8,19,43,71,-28,35
Alloa,4176,1,21,7,8,70,41,29,70
Airdrieon,4176,2,18,7,11,55,47,8,61
Peterhead,4176,3,17,5,14,59,55,4,56
Brechin,4176,4,17,4,15,49,49,0,55
Livingston,4176,5,16,4,16,71,56,15,52
East Fife,4176,6,13,10,13,51,45,6,49
Stranraer,4176,7,12,8,16,56,61,-5,44
Albion,4176,8,10,11,15,47,55,-8,41
Stenhousem'r,4176,9,11,7,18,55,83,-28,40
Queen's Park,4176,10,11,5,20,32,53,-21,38
Livingston,4177,1,24,4,8,85,44,41,76
Alloa,4177,2,19,8,9,69,41,28,65
Airdrieon,4177,3,18,6,12,74,60,14,60
Brechin,4177,4,17,7,12,51,50,1,58
Albion,4177,5,16,7,13,59,56,3,55
Peterhead,4177,6,14,6,16,54,57,-3,48
East Fife,4177,7,10,9,17,46,55,-9,39
Queen's Park,4177,8,9,11,16,34,55,-21,38
Stenhousem'r,4177,9,10,5,21,56,91,-35,35
Stranraer,4177,10,8,7,21,45,64,-19,31
Livingston,4178,1,24,3,9,85,53,32,75
Alloa,4178,2,17,9,10,75,50,25,60
Airdrieon,4178,3,15,6,15,56,60,-4,51
East Fife,4178,4,14,8,14,53,45,8,50
Albion,4178,5,14,8,14,59,56,3,50
Brechin,4178,6,13,9,14,48,52,-4,48
Queen's Park,4178,7,12,10,14,38,50,-12,46
Stranraer,4178,8,13,4,19,54,66,-12,43
Peterhead,4178,9,11,9,16,45,54,-9,42
Stenhousem'r,4178,10,11,6,19,57,84,-27,39
Livingston,4179,1,22,4,10,78,37,41,70
Airdrieon,4179,2,20,3,13,68,59,9,63
Alloa,4179,3,17,7,12,65,50,15,58
Queen's Park,4179,4,16,6,14,45,44,1,54
Brechin,4179,5,16,5,15,50,56,-6,53
Albion,4179,6,14,10,12,57,53,4,52
Stranraer,4179,7,13,7,16,53,53,0,46
East Fife,4179,8,10,11,15,50,59,-9,41
Peterhead,4179,9,11,5,20,45,62,-17,38
Stenhousem'r,4179,10,9,6,21,44,82,-38,33
Livingston,4180,1,24,3,9,75,42,33,75
Alloa,4180,2,16,10,10,65,49,16,58
Stranraer,4180,3,17,4,15,57,58,-1,55
Brechin,4180,4,14,10,12,42,43,-1,52
East Fife,4180,5,14,7,15,56,49,7,49
Queen's Park,4180,6,14,6,16,36,43,-7,48
Peterhead,4180,7,13,7,16,47,49,-2,46
Albion,4180,8,12,8,16,49,51,-2,44
Airdrieon,4180,9,12,7,17,55,71,-16,43
Stenhousem'r,4180,10,8,10,18,48,75,-27,34
Livingston,4181,1,26,1,9,76,46,30,79
Alloa,4181,2,18,7,11,69,40,29,61
Brechin,4181,3,18,5,13,56,50,6,59
Airdrieon,4181,4,18,3,15,61,54,7,57
Queen's Park,4181,5,17,5,14,52,55,-3,56
Albion,4181,6,14,8,14,56,49,7,50
Peterhead,4181,7,13,7,16,51,58,-7,46
Stranraer,4181,8,13,4,19,43,59,-16,43
East Fife,4181,9,11,6,19,43,52,-9,39
Stenhousem'r,4181,10,7,4,25,49,93,-44,25
Livingston,4182,1,21,5,10,84,48,36,68
Brechin,4182,2,21,4,11,61,41,20,67
Airdrieon,4182,3,18,7,11,66,58,8,61
Alloa,4182,4,17,9,10,74,46,28,60
Peterhead,4182,5,17,7,12,51,41,10,58
Albion,4182,6,13,5,18,45,68,-23,44
Stranraer,4182,7,12,7,17,54,59,-5,43
East Fife,4182,8,10,8,18,45,57,-12,38
Queen's Park,4182,9,10,7,19,36,66,-30,37
Stenhousem'r,4182,10,7,9,20,51,83,-32,30
Livingston,4183,1,19,9,8,78,53,25,66
Alloa,4183,2,18,9,9,77,52,25,63
Airdrieon,4183,3,16,7,13,56,62,-6,55
Brechin,4183,4,16,5,15,49,48,1,53
Stranraer,4183,5,15,7,14,64,54,10,52
Albion,4183,6,13,9,14,54,54,0,48
Stenhousem'r,4183,7,13,5,18,55,80,-25,44
Queen's Park,4183,8,13,3,20,39,53,-14,42
Peterhead,4183,9,11,8,17,50,61,-11,41
East Fife,4183,10,10,10,16,44,49,-5,40
Alloa,4184,1,20,9,7,72,43,29,69
Livingston,4184,2,21,5,10,81,44,37,68
Brechin,4184,3,18,5,13,51,49,2,59
Albion,4184,4,15,8,13,50,46,4,53
East Fife,4184,5,13,10,13,61,46,15,49
Peterhead,4184,6,13,10,13,45,47,-2,49
Queen's Park,4184,7,12,7,17,37,49,-12,43
Airdrieon,4184,8,12,6,18,53,68,-15,42
Stranraer,4184,9,12,3,21,44,64,-20,39
Stenhousem'r,4184,10,9,7,20,41,79,-38,34
Livingston,4185,1,23,1,12,80,48,32,70
Airdrieon,4185,2,19,4,13,55,47,8,61
Brechin,4185,3,17,6,13,63,51,12,57
Alloa,4185,4,16,8,12,65,46,19,56
Peterhead,4185,5,15,6,15,46,46,0,51
Stranraer,4185,6,16,3,17,50,56,-6,51
Queen's Park,4185,7,15,4,17,41,59,-18,49
East Fife,4185,8,13,7,16,43,45,-2,46
Albion,4185,9,12,7,17,49,57,-8,43
Stenhousem'r,4185,10,8,6,22,53,90,-37,30
Livingston,4186,1,21,4,11,83,57,26,67
Alloa,4186,2,20,6,10,74,37,37,66
East Fife,4186,3,15,9,12,59,48,11,54
Brechin,4186,4,16,6,14,52,59,-7,54
Airdrieon,4186,5,16,5,15,60,61,-1,53
Albion,4186,6,15,8,13,54,57,-3,53
Stranraer,4186,7,13,10,13,49,53,-4,49
Queen's Park,4186,8,13,8,15,50,57,-7,47
Peterhead,4186,9,10,11,15,54,56,-2,41
Stenhousem'r,4186,10,4,7,25,45,95,-50,19
Livingston,4187,1,23,2,11,73,49,24,71
Alloa,4187,2,18,9,9,76,49,27,63
Airdrieon,4187,3,17,7,12,59,56,3,58
Albion,4187,4,16,8,12,62,48,14,56
Brechin,4187,5,16,6,14,52,50,2,54
Peterhead,4187,6,15,9,12,49,51,-2,54
East Fife,4187,7,10,11,15,46,53,-7,41
Queen's Park,4187,8,10,11,15,36,48,-12,41
Stranraer,4187,9,10,8,18,48,60,-12,38
Stenhousem'r,4187,10,5,9,22,46,83,-37,24
Alloa,4188,1,19,10,7,61,32,29,67
Airdrieon,4188,2,19,6,11,59,44,15,63
Livingston,4188,3,18,6,12,68,50,18,60
Albion,4188,4,16,8,12,56,50,6,56
Stranraer,4188,5,15,4,17,53,57,-4,49
Queen's Park,4188,6,12,12,12,47,56,-9,48
East Fife,4188,7,12,9,15,46,45,1,45
Brechin,4188,8,12,9,15,41,42,-1,45
Peterhead,4188,9,9,8,19,37,62,-25,35
Stenhousem'r,4188,10,9,6,21,49,79,-30,33
Livingston,4189,1,22,2,12,70,49,21,68
Alloa,4189,2,19,4,13,77,50,27,61
Airdrieon,4189,3,18,6,12,59,58,1,60
Queen's Park,4189,4,16,6,14,47,53,-6,54
Brechin,4189,5,14,8,14,61,59,2,50
East Fife,4189,6,14,7,15,55,46,9,49
Albion,4189,7,13,10,13,56,60,-4,49
Peterhead,4189,8,14,6,16,57,60,-3,48
Stranraer,4189,9,12,5,19,48,64,-16,41
Stenhousem'r,4189,10,9,4,23,49,80,-31,31
Livingston,4190,1,19,6,11,76,55,21,63
Alloa,4190,2,18,8,10,70,41,29,62
Airdrieon,4190,3,17,5,14,56,52,4,56
Brechin,4190,4,16,6,14,53,51,2,54
Albion,4190,5,16,6,14,50,55,-5,54
East Fife,4190,6,15,7,14,53,44,9,52
Peterhead,4190,7,14,6,16,50,58,-8,48
Stranraer,4190,8,14,4,18,49,58,-9,46
Queen's Park,4190,9,10,8,18,38,54,-16,38
Stenhousem'r,4190,10,9,8,19,50,77,-27,35
Livingston,4191,1,26,1,9,92,46,46,79
Alloa,4191,2,19,9,8,77,49,28,66
Brechin,4191,3,19,3,14,50,47,3,60
Airdrieon,4191,4,15,9,12,52,47,5,54
Peterhead,4191,5,15,7,14,65,56,9,52
Albion,4191,6,15,7,14,53,55,-2,52
Queen's Park,4191,7,11,9,16,34,49,-15,42
Stranraer,4191,8,11,4,21,52,76,-24,37
Stenhousem'r,4191,9,8,9,19,52,84,-32,33
East Fife,4191,10,8,8,20,40,58,-18,32
Livingston,4192,1,22,3,11,74,41,33,69
Alloa,4192,2,20,5,11,71,44,27,65
Brechin,4192,3,17,8,11,54,49,5,59
Airdrieon,4192,4,17,6,13,59,60,-1,57
Peterhead,4192,5,15,7,14,53,53,0,52
Queen's Park,4192,6,15,5,16,46,55,-9,50
Albion,4192,7,13,6,17,57,61,-4,45
Stranraer,4192,8,13,3,20,44,53,-9,42
East Fife,4192,9,10,8,18,44,57,-13,38
Stenhousem'r,4192,10,9,7,20,50,79,-29,34
Livingston,4193,1,19,5,12,70,52,18,62
Brechin,4193,2,17,9,10,48,39,9,60
Alloa,4193,3,17,7,12,66,50,16,58
Airdrieon,4193,4,16,6,14,62,65,-3,54
Stranraer,4193,5,16,4,16,53,57,-4,52
Queen's Park,4193,6,16,4,16,38,46,-8,52
East Fife,4193,7,12,12,12,53,43,10,48
Peterhead,4193,8,11,11,14,48,54,-6,44
Albion,4193,9,11,7,18,44,48,-4,40
Stenhousem'r,4193,10,9,7,20,54,82,-28,34
Alloa,4194,1,17,12,7,68,48,20,63
Livingston,4194,2,18,6,12,75,53,22,60
Brechin,4194,3,16,7,13,60,52,8,55
Airdrieon,4194,4,15,10,11,59,52,7,55
Peterhead,4194,5,14,11,11,54,50,4,53
Albion,4194,6,12,11,13,46,50,-4,47
East Fife,4194,7,11,10,15,53,57,-4,43
Queen's Park,4194,8,12,5,19,38,59,-21,41
Stenhousem'r,4194,9,11,7,18,43,65,-22,40
Stranraer,4194,10,9,11,16,38,48,-10,38
Livingston,4195,1,22,1,13,74,49,25,67
Alloa,4195,2,19,7,10,71,48,23,64
Brechin,4195,3,19,6,11,66,48,18,63
Peterhead,4195,4,16,6,14,51,43,8,54
Albion,4195,5,15,9,12,56,51,5,54
Stranraer,4195,6,16,4,16,57,55,2,52
Airdrieon,4195,7,12,6,18,53,70,-17,42
Stenhousem'r,4195,8,12,5,19,46,86,-40,41
Queen's Park,4195,9,10,8,18,36,53,-17,38
East Fife,4195,10,9,8,19,52,59,-7,35
Livingston,4196,1,19,6,11,67,47,20,63
Airdrieon,4196,2,18,9,9,64,49,15,63
Alloa,4196,3,17,10,9,67,40,27,61
Peterhead,4196,4,14,11,11,55,52,3,53
Albion,4196,5,15,7,14,43,41,2,52
Brechin,4196,6,15,5,16,49,43,6,50
Queen's Park,4196,7,12,7,17,32,45,-13,43
Stranraer,4196,8,12,6,18,48,66,-18,42
East Fife,4196,9,9,12,15,39,46,-7,39
Stenhousem'r,4196,10,9,7,20,48,83,-35,34
Alloa,4197,1,20,8,8,78,38,40,68
Airdrieon,4197,2,19,5,12,63,52,11,62
Livingston,4197,3,19,4,13,74,58,16,61
Brechin,4197,4,16,9,11,52,50,2,57
Queen's Park,4197,5,14,6,16,33,46,-13,48
Peterhead,4197,6,13,8,15,51,62,-11,47
Albion,4197,7,12,10,14,52,57,-5,46
East Fife,4197,8,11,12,13,54,48,6,45
Stranraer,4197,9,11,3,22,43,62,-19,36
Stenhousem'r,4197,10,9,7,20,49,76,-27,34
Alloa,4198,1,20,9,7,81,43,38,69
Brechin,4198,2,20,6,10,51,46,5,66
Livingston,4198,3,20,4,12,78,48,30,64
Albion,4198,4,14,8,14,61,62,-1,50
Stranraer,4198,5,14,6,16,56,60,-4,48
Queen's Park,4198,6,14,6,16,49,53,-4,48
Airdrieon,4198,7,14,5,17,59,74,-15,47
Peterhead,4198,8,12,10,14,50,61,-11,46
East Fife,4198,9,10,7,19,49,55,-6,37
Stenhousem'r,4198,10,7,9,20,54,86,-32,30
Alloa,4199,1,22,6,8,78,41,37,72
Livingston,4199,2,22,4,10,77,53,24,70
East Fife,4199,3,17,8,11,60,45,15,59
Airdrieon,4199,4,16,6,14,63,50,13,54
Albion,4199,5,13,9,14,49,51,-2,48
Queen's Park,4199,6,13,8,15,37,48,-11,47
Stranraer,4199,7,13,4,19,47,70,-23,43
Peterhead,4199,8,12,6,18,49,58,-9,42
Brechin,4199,9,11,8,17,45,55,-10,41
Stenhousem'r,4199,10,6,11,19,52,86,-34,29
Alloa,4200,1,22,6,8,71,45,26,72
Livingston,4200,2,21,2,13,76,51,25,65
Albion,4200,3,18,8,10,61,42,19,62
Airdrieon,4200,4,18,8,10,68,52,16,62
Brechin,4200,5,15,5,16,51,53,-2,50
Peterhead,4200,6,14,7,15,44,58,-14,49
Queen's Park,4200,7,13,6,17,42,50,-8,45
Stranraer,4200,8,10,8,18,52,62,-10,38
East Fife,4200,9,8,9,19,38,53,-15,33
Stenhousem'r,4200,10,8,7,21,40,77,-37,31
Alloa,4201,1,20,8,8,78,46,32,68
Livingston,4201,2,19,5,12,84,51,33,62
Brechin,4201,3,18,4,14,45,48,-3,58
Peterhead,4201,4,16,9,11,54,41,13,57
Airdrieon,4201,5,17,6,13,59,55,4,57
Albion,4201,6,15,7,14,61,57,4,52
Queen's Park,4201,7,14,5,17,44,51,-7,47
East Fife,4201,8,12,10,14,62,56,6,46
Stranraer,4201,9,12,7,17,42,58,-16,43
Stenhousem'r,4201,10,4,5,27,34,100,-66,17
Airdrieon,4202,1,18,7,11,59,53,6,61
Alloa,4202,2,17,9,10,63,44,19,60
Livingston,4202,3,18,2,16,68,57,11,56
Brechin,4202,4,17,5,14,51,44,7,56
Peterhead,4202,5,14,9,13,59,62,-3,51
Albion,4202,6,14,8,14,51,55,-4,50
Queen's Park,4202,7,13,11,12,41,45,-4,50
Stranraer,4202,8,13,10,13,53,52,1,49
East Fife,4202,9,10,11,15,54,53,1,41
Stenhousem'r,4202,10,7,6,23,50,84,-34,27
Livingston,4203,1,21,6,9,87,47,40,69
Brechin,4203,2,21,5,10,64,47,17,68
Alloa,4203,3,15,10,11,69,52,17,55
Airdrieon,4203,4,16,6,14,64,62,2,54
Albion,4203,5,13,8,15,52,57,-5,47
Stranraer,4203,6,11,9,16,47,58,-11,42
Peterhead,4203,7,9,15,12,43,56,-13,42
East Fife,4203,8,10,10,16,46,53,-7,40
Queen's Park,4203,9,9,13,14,36,50,-14,40
Stenhousem'r,4203,10,7,14,15,49,75,-26,35
Livingston,4204,1,20,4,12,76,50,26,64
Alloa,4204,2,17,10,9,80,49,31,61
Airdrieon,4204,3,17,7,12,62,61,1,58
Albion,4204,4,16,9,11,54,49,5,57
Brechin,4204,5,16,7,13,56,52,4,55
Peterhead,4204,6,17,4,15,53,53,0,55
Queen's Park,4204,7,11,12,13,42,51,-9,45
East Fife,4204,8,10,10,16,59,61,-2,40
Stranraer,4204,9,10,10,16,43,51,-8,40
Stenhousem'r,4204,10,7,5,24,49,97,-48,26
Livingston,4205,1,21,6,9,84,46,38,69
Albion,4205,2,19,8,9,60,43,17,65
Alloa,4205,3,18,6,12,65,50,15,60
Brechin,4205,4,15,12,9,63,50,13,57
Queen's Park,4205,5,13,8,15,37,49,-12,47
East Fife,4205,6,12,10,14,49,45,4,46
Peterhead,4205,7,13,7,16,49,57,-8,46
Airdrieon,4205,8,12,7,17,54,65,-11,43
Stranraer,4205,9,10,7,19,49,68,-19,37
Stenhousem'r,4205,10,7,9,20,45,82,-37,30
Livingston,4206,1,24,2,10,80,41,39,74
Alloa,4206,2,22,7,7,70,33,37,73
Brechin,4206,3,19,5,12,53,47,6,62
Airdrieon,4206,4,14,11,11,56,56,0,53
Albion,4206,5,14,10,12,58,53,5,52
East Fife,4206,6,13,7,16,49,45,4,46
Queen's Park,4206,7,13,5,18,40,53,-13,44
Stranraer,4206,8,13,3,20,50,60,-10,42
Peterhead,4206,9,9,9,18,35,56,-21,36
Stenhousem'r,4206,10,7,5,24,35,82,-47,26
Livingston,4207,1,25,5,6,85,44,41,80
Brechin,4207,2,18,9,9,57,47,10,63
Alloa,4207,3,16,8,12,76,49,27,56
Airdrieon,4207,4,14,7,15,55,53,2,49
Albion,4207,5,13,9,14,51,53,-2,48
East Fife,4207,6,12,10,14,52,47,5,46
Queen's Park,4207,7,12,9,15,40,51,-11,45
Peterhead,4207,8,12,8,16,48,60,-12,44
Stranraer,4207,9,11,7,18,45,61,-16,40
Stenhousem'r,4207,10,8,6,22,48,92,-44,30
Brechin,4208,1,20,3,13,47,41,6,63
Livingston,4208,2,19,5,12,73,47,26,62
Airdrieon,4208,3,18,7,11,64,53,11,61
Alloa,4208,4,17,9,10,60,40,20,60
Stranraer,4208,5,14,6,16,44,55,-11,48
East Fife,4208,6,12,9,15,46,46,0,45
Albion,4208,7,10,12,14,46,49,-3,42
Queen's Park,4208,8,12,6,18,29,49,-20,42
Peterhead,4208,9,10,11,15,48,55,-7,41
Stenhousem'r,4208,10,11,6,19,49,71,-22,39
Alloa,4209,1,22,4,10,86,42,44,70
Airdrieon,4209,2,18,8,10,56,48,8,62
Livingston,4209,3,18,5,13,66,52,14,59
Albion,4209,4,15,12,9,56,46,10,57
Peterhead,4209,5,15,9,12,54,46,8,54
Brechin,4209,6,13,9,14,42,48,-6,48
Stranraer,4209,7,14,4,18,60,67,-7,46
Queen's Park,4209,8,13,5,18,41,55,-14,44
East Fife,4209,9,9,9,18,49,62,-13,36
Stenhousem'r,4209,10,7,7,22,46,90,-44,28
Alloa,4210,1,21,5,10,70,42,28,68
Livingston,4210,2,22,1,13,80,54,26,67
Airdrieon,4210,3,18,9,9,65,45,20,63
Brechin,4210,4,16,8,12,53,54,-1,56
Albion,4210,5,15,5,16,53,54,-1,50
Stranraer,4210,6,13,5,18,52,63,-11,44
Peterhead,4210,7,12,8,16,48,59,-11,44
East Fife,4210,8,10,12,14,46,47,-1,42
Queen's Park,4210,9,10,8,18,34,50,-16,38
Stenhousem'r,4210,10,6,13,17,42,75,-33,31
Livingston,4211,1,23,6,7,73,39,34,75
Alloa,4211,2,16,11,9,62,47,15,59
Brechin,4211,3,17,6,13,54,61,-7,57
Albion,4211,4,15,7,14,60,47,13,52
Peterhead,4211,5,15,7,14,57,55,2,52
Queen's Park,4211,6,14,7,15,37,45,-8,49
Airdrieon,4211,7,12,10,14,54,54,0,46
Stenhousem'r,4211,8,11,5,20,56,79,-23,38
East Fife,4211,9,9,10,17,48,57,-9,37
Stranraer,4211,10,10,7,19,53,70,-17,37
Airdrieon,4212,1,22,7,7,79,54,25,73
Alloa,4212,2,19,7,10,77,54,23,64
Livingston,4212,3,17,7,12,76,56,20,58
Brechin,4212,4,15,8,13,46,44,2,53
Peterhead,4212,5,15,5,16,51,57,-6,50
East Fife,4212,6,13,9,14,50,47,3,48
Albion,4212,7,12,9,15,58,59,-1,45
Stenhousem'r,4212,8,11,7,18,56,73,-17,40
Queen's Park,4212,9,9,10,17,31,55,-24,37
Stranraer,4212,10,9,7,20,39,64,-25,34
Livingston,4213,1,21,4,11,74,45,29,67
Albion,4213,2,18,6,12,59,50,9,60
Alloa,4213,3,15,12,9,71,54,17,57
Brechin,4213,4,16,8,12,50,49,1,56
Airdrieon,4213,5,15,8,13,56,57,-1,53
Queen's Park,4213,6,15,7,14,43,45,-2,52
East Fife,4213,7,13,9,14,50,48,2,48
Stranraer,4213,8,13,6,17,46,50,-4,45
Peterhead,4213,9,11,9,16,53,60,-7,42
Stenhousem'r,4213,10,6,5,25,36,80,-44,23
Alloa,4214,1,21,8,7,73,41,32,71
Livingston,4214,2,21,5,10,74,50,24,68
Airdrieon,4214,3,16,7,13,53,46,7,55
Queen's Park,4214,4,15,7,14,45,49,-4,52
Albion,4214,5,13,9,14,61,58,3,48
Brechin,4214,6,14,6,16,41,49,-8,48
Peterhead,4214,7,13,8,15,47,49,-2,47
East Fife,4214,8,12,10,14,50,50,0,46
Stranraer,4214,9,14,3,19,46,54,-8,45
Stenhousem'r,4214,10,7,5,24,45,89,-44,26
Livingston,4215,1,21,5,10,79,51,28,68
East Fife,4215,2,18,6,12,69,44,25,60
Alloa,4215,3,16,11,9,78,53,25,59
Brechin,4215,4,17,7,12,53,51,2,58
Queen's Park,4215,5,14,6,16,49,52,-3,48
Airdrieon,4215,6,12,12,12,50,55,-5,48
Peterhead,4215,7,13,8,15,54,69,-15,47
Albion,4215,8,13,7,16,52,59,-7,46
Stranraer,4215,9,11,8,17,48,68,-20,41
Stenhousem'r,4215,10,5,10,21,52,82,-30,25
Brechin,4216,1,22,4,10,62,41,21,70
Livingston,4216,2,22,3,11,78,55,23,69
Alloa,4216,3,18,8,10,63,47,16,62
Airdrieon,4216,4,18,6,12,62,53,9,60
Peterhead,4216,5,13,10,13,46,48,-2,49
Stranraer,4216,6,14,4,18,50,58,-8,46
East Fife,4216,7,12,8,16,51,50,1,44
Albion,4216,8,11,11,14,55,62,-7,44
Stenhousem'r,4216,9,9,7,20,53,75,-22,34
Queen's Park,4216,10,7,7,22,34,65,-31,28
Alloa,4217,1,21,6,9,77,46,31,69
Livingston,4217,2,20,7,9,76,44,32,67
Brechin,4217,3,17,6,13,55,41,14,57
Airdrieon,4217,4,16,7,13,59,60,-1,55
Peterhead,4217,5,15,7,14,52,53,-1,52
Albion,4217,6,13,12,11,49,45,4,51
East Fife,4217,7,12,12,12,48,45,3,48
Stranraer,4217,8,12,6,18,49,56,-7,42
Queen's Park,4217,9,10,5,21,28,63,-35,35
Stenhousem'r,4217,10,7,6,23,44,84,-40,27
Alloa,4218,1,22,9,5,75,34,41,75
Airdrieon,4218,2,19,7,10,59,46,13,64
Livingston,4218,3,19,5,12,69,47,22,62
Brechin,4218,4,17,6,13,50,38,12,57
Albion,4218,5,14,7,15,49,53,-4,49
Queen's Park,4218,6,13,6,17,30,49,-19,45
Peterhead,4218,7,11,10,15,37,51,-14,43
East Fife,4218,8,11,7,18,46,54,-8,40
Stranraer,4218,9,10,7,19,43,58,-15,37
Stenhousem'r,4218,10,8,8,20,47,75,-28,32
Livingston,4219,1,25,4,7,79,38,41,79
Alloa,4219,2,23,4,9,68,38,30,73
Brechin,4219,3,19,4,13,56,47,9,61
Airdrieon,4219,4,17,7,12,60,59,1,58
Stranraer,4219,5,13,6,17,51,56,-5,45
East Fife,4219,6,11,9,16,44,53,-9,42
Peterhead,4219,7,11,8,17,49,55,-6,41
Albion,4219,8,11,6,19,48,64,-16,39
Stenhousem'r,4219,9,10,9,17,55,78,-23,39
Queen's Park,4219,10,8,7,21,37,59,-22,31
Brechin,4220,1,20,8,8,59,34,25,68
Livingston,4220,2,21,3,12,72,44,28,66
Alloa,4220,3,18,9,9,64,44,20,63
Albion,4220,4,16,10,10,59,47,12,58
Airdrieon,4220,5,16,6,14,53,54,-1,54
Peterhead,4220,6,13,7,16,47,56,-9,46
Queen's Park,4220,7,11,8,17,29,46,-17,41
Stranraer,4220,8,11,7,18,42,56,-14,40
East Fife,4220,9,8,11,17,41,53,-12,35
Stenhousem'r,4220,10,8,7,21,44,76,-32,31
Livingston,4221,1,23,5,8,88,48,40,74
Airdrieon,4221,2,17,8,11,62,56,6,59
Stranraer,4221,3,17,5,14,59,60,-1,56
Alloa,4221,4,14,10,12,62,50,12,52
Albion,4221,5,15,7,14,45,47,-2,52
Queen's Park,4221,6,14,8,14,37,44,-7,50
Brechin,4221,7,13,5,18,42,50,-8,44
Peterhead,4221,8,11,10,15,45,53,-8,43
East Fife,4221,9,9,13,14,43,44,-1,40
Stenhousem'r,4221,10,6,11,19,50,81,-31,29
Livingston,4222,1,20,5,11,78,48,30,65
Brechin,4222,2,18,7,11,52,45,7,61
Alloa,4222,3,16,10,10,56,42,14,58
Airdrieon,4222,4,14,10,12,56,60,-4,52
Albion,4222,5,13,11,12,59,52,7,50
East Fife,4222,6,11,9,16,45,43,2,42
Peterhead,4222,7,11,9,16,48,56,-8,42
Queen's Park,4222,8,10,12,14,38,46,-8,42
Stranraer,4222,9,11,9,16,51,66,-15,42
Stenhousem'r,4222,10,12,6,18,57,82,-25,42
Livingston,4223,1,21,6,9,79,43,36,69
Alloa,4223,2,18,11,7,79,44,35,65
Airdrieon,4223,3,19,6,11,67,54,13,63
Brechin,4223,4,14,9,13,51,59,-8,51
East Fife,4223,5,12,10,14,52,47,5,46
Peterhead,4223,6,13,6,17,49,57,-8,45
Queen's Park,4223,7,12,9,15,48,61,-13,45
Stranraer,4223,8,12,8,16,51,65,-14,44
Albion,4223,9,11,10,15,53,61,-8,43
Stenhousem'r,4223,10,7,7,22,46,84,-38,28
Brechin,4224,1,19,6,11,56,47,9,63
Livingston,4224,2,17,10,9,78,54,24,61
Alloa,4224,3,16,10,10,69,48,21,58
Albion,4224,4,15,13,8,68,52,16,58
Airdrieon,4224,5,14,9,13,54,52,2,51
Stranraer,4224,6,14,6,16,54,58,-4,48
Queen's Park,4224,7,12,9,15,33,48,-15,45
East Fife,4224,8,11,8,17,49,53,-4,41
Peterhead,4224,9,9,9,18,40,55,-15,36
Stenhousem'r,4224,10,10,6,20,48,82,-34,36
Livingston,4225,1,22,4,10,82,48,34,70
Alloa,4225,2,21,4,11,73,43,30,67
Brechin,4225,3,19,5,12,57,54,3,62
Stranraer,4225,4,17,5,14,62,57,5,56
East Fife,4225,5,14,10,12,54,42,12,52
Airdrieon,4225,6,16,4,16,49,60,-11,52
Albion,4225,7,13,7,16,50,46,4,46
Peterhead,4225,8,12,6,18,51,64,-13,42
Queen's Park,4225,9,10,8,18,39,59,-20,38
Stenhousem'r,4225,10,6,7,23,46,90,-44,25
Livingston,4226,1,23,7,6,74,38,36,76
Brechin,4226,2,21,5,10,64,40,24,68
Alloa,4226,3,19,7,10,69,46,23,64
Airdrieon,4226,4,17,5,14,67,56,11,56
Peterhead,4226,5,13,10,13,46,51,-5,49
Albion,4226,6,12,5,19,48,62,-14,41
Queen's Park,4226,7,12,5,19,31,58,-27,41
East Fife,4226,8,10,9,17,54,50,4,39
Stenhousem'r,4226,9,11,5,20,51,83,-32,38
Stranraer,4226,10,11,4,21,45,65,-20,37
Livingston,4227,1,21,6,9,73,37,36,69
Alloa,4227,2,17,8,11,67,45,22,59
Airdrieon,4227,3,17,7,12,57,51,6,58
East Fife,4227,4,15,10,11,58,46,12,55
Queen's Park,4227,5,12,10,14,50,54,-4,46
Brechin,4227,6,13,7,16,47,59,-12,46
Peterhead,4227,7,11,12,13,44,50,-6,45
Albion,4227,8,11,11,14,48,60,-12,44
Stranraer,4227,9,12,5,19,48,66,-18,41
Stenhousem'r,4227,10,9,8,19,51,75,-24,35
Alloa,4228,1,21,6,9,81,42,39,69
Livingston,4228,2,22,3,11,79,41,38,69
Airdrieon,4228,3,16,6,14,54,58,-4,54
Queen's Park,4228,4,16,3,17,42,51,-9,51
Brechin,4228,5,14,8,14,45,47,-2,50
Peterhead,4228,6,15,5,16,49,54,-5,50
Stranraer,4228,7,15,5,16,54,66,-12,50
Albion,4228,8,12,9,15,50,57,-7,45
East Fife,4228,9,9,10,17,53,63,-10,37
Stenhousem'r,4228,10,8,9,19,47,75,-28,33
Alloa,4229,1,22,8,6,72,35,37,74
Livingston,4229,2,22,2,12,66,47,19,68
Albion,4229,3,15,7,14,61,58,3,52
East Fife,4229,4,13,12,11,50,38,12,51
Brechin,4229,5,15,4,17,46,44,2,49
Peterhead,4229,6,12,11,13,44,45,-1,47
Airdrieon,4229,7,12,10,14,49,64,-15,46
Stranraer,4229,8,13,6,17,53,58,-5,45
Queen's Park,4229,9,11,8,17,41,54,-13,41
Stenhousem'r,4229,10,7,8,21,47,86,-39,29
Livingston,4230,1,21,6,9,82,51,31,69
Alloa,4230,2,21,6,9,66,42,24,69
Brechin,4230,3,19,7,10,53,36,17,64
Peterhead,4230,4,15,7,14,48,41,7,52
Airdrieon,4230,5,15,7,14,52,56,-4,52
Queen's Park,4230,6,14,9,13,41,50,-9,51
East Fife,4230,7,12,12,12,53,45,8,48
Stranraer,4230,8,11,5,20,54,67,-13,38
Albion,4230,9,9,8,19,45,61,-16,35
Stenhousem'r,4230,10,5,9,22,42,87,-45,24
Livingston,4231,1,22,2,12,83,55,28,68
Airdrieon,4231,2,20,7,9,63,48,15,67
Alloa,4231,3,19,6,11,65,45,20,63
Brechin,4231,4,16,9,11,52,43,9,57
Albion,4231,5,14,9,13,55,48,7,51
Peterhead,4231,6,13,9,14,47,46,1,48
East Fife,4231,7,10,10,16,44,50,-6,40
Queen's Park,4231,8,12,4,20,33,56,-23,40
Stranraer,4231,9,11,4,21,47,70,-23,37
Stenhousem'r,4231,10,9,8,19,47,75,-28,35
Airdrieon,4232,1,25,4,7,76,38,38,79
Livingston,4232,2,21,5,10,80,48,32,68
Alloa,4232,3,17,6,13,70,53,17,57
Albion,4232,4,16,8,12,63,54,9,56
Peterhead,4232,5,16,7,13,61,59,2,55
Brechin,4232,6,15,6,15,47,50,-3,51
Stranraer,4232,7,14,6,16,47,61,-14,48
Queen's Park,4232,8,10,7,19,31,57,-26,37
East Fife,4232,9,9,7,20,42,56,-14,34
Stenhousem'r,4232,10,5,8,23,33,74,-41,23
Livingston,4233,1,25,4,7,88,49,39,79
Alloa,4233,2,19,8,9,69,37,32,65
Brechin,4233,3,16,9,11,56,47,9,57
Albion,4233,4,16,5,15,53,58,-5,53
Airdrieon,4233,5,14,10,12,53,57,-4,52
Queen's Park,4233,6,12,9,15,37,53,-16,45
Peterhead,4233,7,10,14,12,44,51,-7,44
East Fife,4233,8,7,15,14,48,49,-1,36
Stranraer,4233,9,8,9,19,40,56,-16,33
Stenhousem'r,4233,10,6,11,19,46,77,-31,29
Livingston,4234,1,23,5,8,79,44,35,74
Alloa,4234,2,17,9,10,74,52,22,60
Brechin,4234,3,16,6,14,57,63,-6,54
Peterhead,4234,4,14,9,13,53,54,-1,51
Airdrieon,4234,5,15,6,15,57,59,-2,51
Albion,4234,6,14,7,15,60,56,4,49
East Fife,4234,7,11,13,12,54,50,4,46
Queen's Park,4234,8,13,6,17,45,55,-10,45
Stranraer,4234,9,10,8,18,56,68,-12,38
Stenhousem'r,4234,10,8,9,19,47,81,-34,33
Airdrieon,4235,1,23,5,8,67,47,20,74
Alloa,4235,2,18,7,11,67,45,22,61
Livingston,4235,3,17,9,10,64,49,15,60
Peterhead,4235,4,15,7,14,57,49,8,52
Brechin,4235,5,14,7,15,43,44,-1,49
Stranraer,4235,6,13,8,15,54,54,0,47
Albion,4235,7,10,14,12,47,51,-4,44
East Fife,4235,8,10,11,15,47,49,-2,41
Queen's Park,4235,9,9,9,18,31,63,-32,36
Stenhousem'r,4235,10,7,11,18,50,76,-26,32
Livingston,4236,1,22,4,10,83,49,34,70
Alloa,4236,2,18,7,11,71,47,24,61
Albion,4236,3,17,7,12,53,45,8,58
Airdrieon,4236,4,17,7,12,53,50,3,58
Brechin,4236,5,16,5,15,47,60,-13,53
East Fife,4236,6,14,8,14,60,45,15,50
Peterhead,4236,7,14,7,15,48,50,-2,49
Queen's Park,4236,8,11,10,15,43,53,-10,43
Stranraer,4236,9,12,2,22,47,67,-20,38
Stenhousem'r,4236,10,8,5,23,41,80,-39,29
Livingston,4237,1,22,6,8,88,48,40,72
Alloa,4237,2,21,5,10,78,50,28,68
Airdrieon,4237,3,19,4,13,66,57,9,61
Albion,4237,4,14,15,7,58,46,12,57
Brechin,4237,5,14,10,12,54,53,1,52
East Fife,4237,6,14,9,13,63,49,14,51
Peterhead,4237,7,10,7,19,37,65,-28,37
Stenhousem'r,4237,8,9,9,18,54,79,-25,36
Queen's Park,4237,9,8,11,17,35,59,-24,35
Stranraer,4237,10,9,4,23,49,76,-27,31
Livingston,4238,1,21,6,9,77,38,39,69
Alloa,4238,2,22,3,11,68,45,23,69
Brechin,4238,3,19,4,13,56,42,14,61
Peterhead,4238,4,17,5,14,48,52,-4,56
Airdrieon,4238,5,13,12,11,64,62,2,51
Queen's Park,4238,6,15,5,16,43,55,-12,50
Albion,4238,7,13,10,13,58,59,-1,49
East Fife,4238,8,13,6,17,52,52,0,45
Stranraer,4238,9,9,6,21,41,69,-28,33
Stenhousem'r,4238,10,6,7,23,49,82,-33,25
Livingston,4239,1,22,6,8,70,38,32,72
Alloa,4239,2,20,7,9,75,42,33,67
Brechin,4239,3,17,6,13,56,45,11,57
Peterhead,4239,4,17,5,14,50,52,-2,56
Airdrieon,4239,5,16,6,14,52,51,1,54
Albion,4239,6,14,11,11,40,37,3,53
East Fife,4239,7,12,8,16,44,51,-7,44
Queen's Park,4239,8,12,7,17,43,60,-17,43
Stranraer,4239,9,11,5,20,50,64,-14,38
Stenhousem'r,4239,10,4,9,23,37,77,-40,21
Livingston,4240,1,21,3,12,74,55,19,66
Alloa,4240,2,19,8,9,80,45,35,65
Brechin,4240,3,18,8,10,58,50,8,62
Airdrieon,4240,4,17,5,14,55,54,1,56
Queen's Park,4240,5,14,6,16,34,50,-16,48
Albion,4240,6,13,8,15,50,52,-2,47
Stenhousem'r,4240,7,13,7,16,56,74,-18,46
East Fife,4240,8,12,5,19,44,53,-9,41
Peterhead,4240,9,10,10,16,49,57,-8,40
Stranraer,4240,10,10,6,20,54,64,-10,36
Albion,4241,1,19,6,11,61,46,15,63
Alloa,4241,2,18,7,11,67,44,23,61
Livingston,4241,3,19,3,14,74,61,13,60
Peterhead,4241,4,16,9,11,53,46,7,57
Queen's Park,4241,5,16,7,13,45,43,2,55
Brechin,4241,6,15,6,15,51,50,1,51
Stranraer,4241,7,14,5,17,54,62,-8,47
Airdrieon,4241,8,14,4,18,55,63,-8,46
East Fife,4241,9,10,8,18,43,55,-12,38
Stenhousem'r,4241,10,7,9,20,48,81,-33,30
Livingston,4242,1,24,3,9,81,42,39,75
Alloa,4242,2,19,8,9,70,40,30,65
Airdrieon,4242,3,17,9,10,55,46,9,60
Brechin,4242,4,18,4,14,52,50,2,58
Albion,4242,5,14,8,14,53,54,-1,50
Queen's Park,4242,6,14,8,14,34,41,-7,50
East Fife,4242,7,11,11,14,50,45,5,44
Peterhead,4242,8,13,5,18,44,56,-12,44
Stranraer,4242,9,9,5,22,44,70,-26,32
Stenhousem'r,4242,10,7,7,22,41,80,-39,28
Livingston,4243,1,25,2,9,77,38,39,77
Alloa,4243,2,20,6,10,74,49,25,66
Albion,4243,3,16,6,14,56,59,-3,54
Airdrieon,4243,4,15,8,13,59,57,2,53
Brechin,4243,5,15,7,14,53,51,2,52
Peterhead,4243,6,14,5,17,52,57,-5,47
Stranraer,4243,7,14,5,17,45,60,-15,47
Queen's Park,4243,8,13,6,17,48,56,-8,45
Stenhousem'r,4243,9,8,10,18,49,77,-28,34
East Fife,4243,10,8,9,19,49,58,-9,33
Livingston,4244,1,20,4,12,78,49,29,64
Alloa,4244,2,17,10,9,58,39,19,61
Brechin,4244,3,17,4,15,54,51,3,55
Albion,4244,4,15,8,13,53,57,-4,53
Queen's Park,4244,5,15,7,14,45,45,0,52
Peterhead,4244,6,14,8,14,42,48,-6,50
Airdrieon,4244,7,14,7,15,54,59,-5,49
Stranraer,4244,8,14,6,16,50,55,-5,48
East Fife,4244,9,10,9,17,53,56,-3,39
Stenhousem'r,4244,10,8,9,19,50,78,-28,33
Livingston,4245,1,22,8,6,75,41,34,74
Alloa,4245,2,17,8,11,73,48,25,59
Albion,4245,3,15,11,10,47,45,2,56
Airdrieon,4245,4,15,10,11,52,51,1,55
Peterhead,4245,5,15,9,12,56,47,9,54
Queen's Park,4245,6,13,8,15,36,48,-12,47
Brechin,4245,7,12,7,17,43,58,-15,43
East Fife,4245,8,11,8,17,41,44,-3,41
Stranraer,4245,9,10,7,19,49,60,-11,37
Stenhousem'r,4245,10,9,6,21,47,77,-30,33
Livingston,4246,1,23,3,10,80,44,36,72
Alloa,4246,2,19,9,8,72,41,31,66
Brechin,4246,3,19,5,12,56,42,14,62
Queen's Park,4246,4,16,4,16,42,49,-7,52
East Fife,4246,5,13,10,13,52,46,6,49
Peterhead,4246,6,14,7,15,54,56,-2,49
Albion,4246,7,13,7,16,46,52,-6,46
Airdrieon,4246,8,12,8,16,49,70,-21,44
Stranraer,4246,9,10,7,19,53,62,-9,37
Stenhousem'r,4246,10,9,4,23,45,87,-42,31
Alloa,4247,1,20,7,9,62,39,23,67
Livingston,4247,2,19,6,11,69,48,21,63
Airdrieon,4247,3,15,14,7,51,40,11,59
Albion,4247,4,15,11,10,54,42,12,56
Brechin,4247,5,16,7,13,54,49,5,55
Stranraer,4247,6,11,10,15,46,49,-3,43
Queen's Park,4247,7,11,10,15,44,57,-13,43
East Fife,4247,8,9,13,14,42,46,-4,40
Peterhead,4247,9,10,10,16,43,56,-13,40
Stenhousem'r,4247,10,5,10,21,46,85,-39,25
Alloa,4248,1,20,8,8,72,47,25,68
Livingston,4248,2,20,7,9,68,43,25,67
Airdrieon,4248,3,19,4,13,66,52,14,61
Albion,4248,4,17,6,13,57,45,12,57
Brechin,4248,5,18,3,15,53,48,5,57
Stranraer,4248,6,13,8,15,43,52,-9,47
Peterhead,4248,7,12,11,13,52,62,-10,47
Queen's Park,4248,8,13,5,18,38,56,-18,44
East Fife,4248,9,11,9,16,49,50,-1,42
Stenhousem'r,4248,10,3,7,26,39,82,-43,16
Livingston,4249,1,22,5,9,71,40,31,71
Alloa,4249,2,19,7,10,79,53,26,64
Airdrieon,4249,3,19,5,12,60,51,9,62
Brechin,4249,4,16,6,14,46,50,-4,54
Stranraer,4249,5,17,3,16,47,52,-5,54
Albion,4249,6,14,8,14,51,48,3,50
East Fife,4249,7,12,8,16,55,52,3,44
Peterhead,4249,8,11,5,20,39,59,-20,38
Queen's Park,4249,9,9,9,18,31,50,-19,36
Stenhousem'r,4249,10,9,8,19,46,70,-24,35
Alloa,4250,1,20,7,9,74,40,34,67
Airdrieon,4250,2,16,9,11,58,51,7,57
Brechin,4250,3,17,5,14,49,46,3,56
Livingston,4250,4,16,5,15,61,56,5,53
Queen's Park,4250,5,14,9,13,45,49,-4,51
Peterhead,4250,6,14,8,14,42,50,-8,50
Stranraer,4250,7,14,7,15,49,50,-1,49
East Fife,4250,8,13,6,17,51,47,4,45
Albion,4250,9,10,8,18,43,58,-15,38
Stenhousem'r,4250,10,10,8,18,51,76,-25,38
Airdrieon,4251,1,23,4,9,73,41,32,73
Livingston,4251,2,21,5,10,83,58,25,68
Alloa,4251,3,19,6,11,67,48,19,63
Peterhead,4251,4,15,8,13,47,54,-7,53
Brechin,4251,5,15,6,15,49,51,-2,51
Albion,4251,6,12,11,13,54,50,4,47
East Fife,4251,7,11,8,17,46,50,-4,41
Queen's Park,4251,8,11,7,18,33,49,-16,40
Stranraer,4251,9,11,5,20,48,67,-19,38
Stenhousem'r,4251,10,8,8,20,46,78,-32,32
Livingston,4252,1,22,4,10,74,52,22,70
Alloa,4252,2,18,9,9,66,45,21,63
Brechin,4252,3,18,6,12,56,50,6,60
Airdrieon,4252,4,17,9,10,52,48,4,60
Albion,4252,5,13,12,11,55,52,3,51
Peterhead,4252,6,14,6,16,58,56,2,48
East Fife,4252,7,12,7,17,56,50,6,43
Stranraer,4252,8,11,6,19,45,59,-14,39
Queen's Park,4252,9,10,7,19,47,67,-20,37
Stenhousem'r,4252,10,7,10,19,45,75,-30,31
Livingston,4253,1,23,4,9,84,51,33,73
Alloa,4253,2,19,8,9,80,49,31,65
Airdrieon,4253,3,20,4,12,68,56,12,64
Albion,4253,4,16,9,11,61,49,12,57
Brechin,4253,5,15,7,14,57,55,2,52
East Fife,4253,6,9,13,14,47,46,1,40
Stranraer,4253,7,10,9,17,50,68,-18,39
Peterhead,4253,8,10,8,18,45,62,-17,38
Stenhousem'r,4253,9,10,8,18,55,82,-27,38
Queen's Park,4253,10,10,6,20,30,59,-29,36
Livingston,4254,1,23,3,10,78,48,30,72
Brechin,4254,2,18,7,11,65,45,20,61
Airdrieon,4254,3,17,5,14,60,60,0,56
Queen's Park,4254,4,16,7,13,46,53,-7,55
Alloa,4254,5,16,6,14,64,49,15,54
Peterhead,4254,6,16,6,14,64,62,2,54
East Fife,4254,7,15,7,14,56,47,9,52
Albion,4254,8,11,6,19,53,65,-12,39
Stranraer,4254,9,10,9,17,50,64,-14,39
Stenhousem'r,4254,10,7,6,23,53,96,-43,27
Livingston,4255,1,22,3,11,74,43,31,69
Alloa,4255,2,19,8,9,67,41,26,65
Airdrieon,4255,3,18,4,14,50,51,-1,58
Brechin,4255,4,17,6,13,50,45,5,57
Peterhead,4255,5,17,5,14,53,51,2,56
Stranraer,4255,6,12,7,17,48,57,-9,43
Albion,4255,7,11,10,15,47,59,-12,43
Queen's Park,4255,8,12,5,19,42,55,-13,41
East Fife,4255,9,10,10,16,51,51,0,40
Stenhousem'r,4255,10,8,10,18,46,75,-29,34
Alloa,4256,1,20,8,8,67,40,27,68
Livingston,4256,2,18,10,8,76,49,27,64
Brechin,4256,3,18,9,9,56,40,16,63
Airdrieon,4256,4,16,10,10,51,48,3,58
Queen's Park,4256,5,14,7,15,44,51,-7,49
Peterhead,4256,6,13,8,15,55,54,1,47
Albion,4256,7,12,9,15,48,55,-7,45
East Fife,4256,8,11,10,15,49,53,-4,43
Stranraer,4256,9,9,10,17,44,59,-15,37
Stenhousem'r,4256,10,4,9,23,41,82,-41,21
Livingston,4257,1,20,8,8,78,49,29,68
Alloa,4257,2,19,9,8,75,44,31,66
Airdrieon,4257,3,18,6,12,66,51,15,60
Brechin,4257,4,18,6,12,56,61,-5,60
Peterhead,4257,5,12,13,11,53,51,2,49
Albion,4257,6,13,8,15,57,55,2,47
East Fife,4257,7,12,9,15,52,58,-6,45
Queen's Park,4257,8,11,8,17,40,56,-16,41
Stranraer,4257,9,9,8,19,44,59,-15,35
Stenhousem'r,4257,10,6,9,21,40,77,-37,27
Livingston,4258,1,24,4,8,79,43,36,76
Alloa,4258,2,19,7,10,67,41,26,64
Brechin,4258,3,19,6,11,47,39,8,63
Albion,4258,4,13,10,13,55,64,-9,49
Airdrieon,4258,5,13,9,14,51,46,5,48
Queen's Park,4258,6,14,4,18,41,55,-14,46
Peterhead,4258,7,13,6,17,48,57,-9,45
East Fife,4258,8,11,10,15,53,56,-3,43
Stenhousem'r,4258,9,9,9,18,52,66,-14,36
Stranraer,4258,10,9,7,20,41,67,-26,34
Alloa,4259,1,22,8,6,71,33,38,74
Livingston,4259,2,18,6,12,63,50,13,60
Airdrieon,4259,3,16,7,13,56,48,8,55
Queen's Park,4259,4,17,4,15,42,45,-3,55
Brechin,4259,5,16,5,15,44,42,2,53
Peterhead,4259,6,13,8,15,44,51,-7,47
Stranraer,4259,7,13,6,17,43,60,-17,45
East Fife,4259,8,11,10,15,48,46,2,43
Albion,4259,9,11,10,15,47,51,-4,43
Stenhousem'r,4259,10,7,8,21,42,74,-32,29
Livingston,4260,1,22,6,8,79,45,34,72
Alloa,4260,2,19,9,8,75,47,28,66
Airdrieon,4260,3,17,7,12,67,59,8,58
Albion,4260,4,16,9,11,61,55,6,57
East Fife,4260,5,15,9,12,64,46,18,54
Brechin,4260,6,13,9,14,58,59,-1,48
Stranraer,4260,7,12,6,18,54,65,-11,42
Queen's Park,4260,8,11,9,16,40,59,-19,42
Peterhead,4260,9,8,11,17,45,61,-16,35
Stenhousem'r,4260,10,6,7,23,50,97,-47,25
Livingston,4261,1,24,1,11,79,47,32,73
Brechin,4261,2,21,5,10,58,47,11,68
Airdrieon,4261,3,20,7,9,66,38,28,67
Alloa,4261,4,18,7,11,57,48,9,61
Albion,4261,5,15,7,14,52,49,3,52
Queen's Park,4261,6,11,8,17,37,54,-17,41
Stranraer,4261,7,11,6,19,47,62,-15,39
East Fife,4261,8,9,11,16,41,46,-5,38
Peterhead,4261,9,8,11,17,36,55,-19,35
Stenhousem'r,4261,10,7,9,20,41,68,-27,30
Livingston,4262,1,21,6,9,69,42,27,69
Alloa,4262,2,21,5,10,72,36,36,68
Brechin,4262,3,17,6,13,48,46,2,57
Airdrieon,4262,4,16,7,13,55,46,9,55
Peterhead,4262,5,14,11,11,46,44,2,53
Stranraer,4262,6,14,8,14,50,57,-7,50
Albion,4262,7,12,9,15,48,54,-6,45
Queen's Park,4262,8,12,9,15,38,52,-14,45
East Fife,4262,9,7,11,18,39,50,-11,32
Stenhousem'r,4262,10,6,8,22,41,79,-38,26
Alloa,4263,1,20,8,8,84,43,41,68
Livingston,4263,2,20,8,8,85,49,36,68
Brechin,4263,3,18,6,12,50,50,0,60
Airdrieon,4263,4,15,11,10,61,57,4,56
Peterhead,4263,5,13,9,14,47,48,-1,48
Queen's Park,4263,6,12,10,14,36,52,-16,46
Albion,4263,7,13,6,17,45,59,-14,45
Stranraer,4263,8,11,8,17,52,63,-11,41
East Fife,4263,9,9,11,16,41,48,-7,38
Stenhousem'r,4263,10,6,9,21,53,85,-32,27
Airdrieon,4264,1,19,7,10,65,54,11,64
Alloa,4264,2,17,11,8,73,46,27,62
Livingston,4264,3,19,4,13,74,53,21,61
Brechin,4264,4,17,7,12,58,50,8,58
Peterhead,4264,5,14,10,12,48,54,-6,52
East Fife,4264,6,13,9,14,53,51,2,48
Albion,4264,7,12,7,17,50,56,-6,43
Stranraer,4264,8,11,7,18,54,63,-9,40
Queen's Park,4264,9,9,12,15,39,52,-13,39
Stenhousem'r,4264,10,8,8,20,45,80,-35,32
Livingston,4265,1,22,5,9,85,50,35,71
Alloa,4265,2,18,8,10,76,46,30,62
Albion,4265,3,14,13,9,54,45,9,55
Brechin,4265,4,15,9,12,45,48,-3,54
Airdrieon,4265,5,16,6,14,58,65,-7,54
Peterhead,4265,6,14,6,16,53,62,-9,48
Queen's Park,4265,7,12,10,14,41,47,-6,46
Stranraer,4265,8,11,6,19,54,65,-11,39
East Fife,4265,9,9,10,17,41,49,-8,37
Stenhousem'r,4265,10,9,7,20,47,77,-30,34
Livingston,4266,1,22,5,9,87,51,36,71
Alloa,4266,2,19,8,9,71,50,21,65
Stranraer,4266,3,16,4,16,52,48,4,52
Peterhead,4266,4,14,10,12,49,49,0,52
Airdrieon,4266,5,16,4,16,53,56,-3,52
Brechin,4266,6,15,5,16,52,59,-7,50
Albion,4266,7,15,4,17,45,50,-5,49
Queen's Park,4266,8,13,6,17,43,51,-8,45
East Fife,4266,9,10,10,16,46,47,-1,40
Stenhousem'r,4266,10,9,6,21,45,82,-37,33
Livingston,4267,1,21,6,9,81,49,32,69
Alloa,4267,2,20,7,9,76,41,35,67
Airdrieon,4267,3,18,4,14,63,58,5,58
Brechin,4267,4,17,5,14,47,39,8,56
Queen's Park,4267,5,15,10,11,53,55,-2,55
Peterhead,4267,6,13,5,18,46,56,-10,44
Stranraer,4267,7,12,6,18,54,65,-11,42
East Fife,4267,8,10,11,15,47,52,-5,41
Stenhousem'r,4267,9,10,8,18,45,72,-27,38
Albion,4267,10,8,10,18,49,74,-25,34
Livingston,4268,1,23,2,11,73,48,25,71
Brechin,4268,2,18,6,12,58,51,7,60
Stranraer,4268,3,18,5,13,59,48,11,59
Alloa,4268,4,16,8,12,74,52,22,56
Airdrieon,4268,5,15,7,14,52,47,5,52
Albion,4268,6,15,7,14,62,58,4,52
Peterhead,4268,7,13,8,15,55,53,2,47
East Fife,4268,8,11,9,16,54,66,-12,42
Queen's Park,4268,9,10,6,20,29,57,-28,36
Stenhousem'r,4268,10,8,8,20,45,81,-36,32
Livingston,4269,1,20,8,8,72,40,32,68
Brechin,4269,2,19,6,11,51,46,5,63
Alloa,4269,3,16,11,9,75,47,28,59
Peterhead,4269,4,12,12,12,48,51,-3,48
Airdrieon,4269,5,13,6,17,52,55,-3,45
Stranraer,4269,6,14,3,19,48,58,-10,45
Queen's Park,4269,7,12,9,15,35,49,-14,45
East Fife,4269,8,10,14,12,52,47,5,44
Albion,4269,9,10,10,16,46,57,-11,40
Stenhousem'r,4269,10,10,9,17,58,87,-29,39
Alloa,4270,1,21,8,7,78,47,31,71
Livingston,4270,2,21,5,10,84,45,39,68
Airdrieon,4270,3,19,7,10,67,55,12,64
Brechin,4270,4,17,6,13,57,45,12,57
Queen's Park,4270,5,15,8,13,48,53,-5,53
Stranraer,4270,6,13,6,17,51,64,-13,45
East Fife,4270,7,11,10,15,54,51,3,43
Albion,4270,8,9,8,19,45,60,-15,35
Peterhead,4270,9,8,10,18,39,66,-27,34
Stenhousem'r,4270,10,7,10,19,47,84,-37,31
Alloa,4271,1,18,9,9,68,44,24,63
Livingston,4271,2,19,5,12,68,50,18,62
Airdrieon,4271,3,17,6,13,60,54,6,57
Albion,4271,4,16,8,12,66,53,13,56
Brechin,4271,5,16,6,14,49,44,5,54
East Fife,4271,6,14,9,13,54,48,6,51
Peterhead,4271,7,15,6,15,45,44,1,51
Queen's Park,4271,8,14,7,15,38,57,-19,49
Stranraer,4271,9,9,6,21,42,65,-23,33
Stenhousem'r,4271,10,7,8,21,46,77,-31,29
Alloa,4272,1,22,6,8,69,35,34,72
Livingston,4272,2,21,6,9,76,49,27,69
Albion,4272,3,18,6,12,64,48,16,60
Brechin,4272,4,18,6,12,55,46,9,60
Airdrieon,4272,5,17,7,12,58,48,10,58
Peterhead,4272,6,13,8,15,54,60,-6,47
Queen's Park,4272,7,11,6,19,31,47,-16,39
East Fife,4272,8,8,11,17,44,52,-8,35
Stranraer,4272,9,10,4,22,45,74,-29,34
Stenhousem'r,4272,10,9,6,21,40,77,-37,33
Airdrieon,4273,1,19,5,12,65,56,9,62
Alloa,4273,2,17,8,11,70,50,20,59
Livingston,4273,3,18,5,13,69,52,17,59
Stranraer,4273,4,16,5,15,58,55,3,53
Brechin,4273,5,16,5,15,51,54,-3,53
Albion,4273,6,14,8,14,56,61,-5,50
Peterhead,4273,7,14,7,15,48,46,2,49
Queen's Park,4273,8,12,7,17,39,55,-16,43
East Fife,4273,9,10,11,15,47,50,-3,41
Stenhousem'r,4273,10,9,9,18,53,77,-24,36
Alloa,4274,1,21,6,9,70,41,29,69
Livingston,4274,2,21,2,13,66,50,16,65
Brechin,4274,3,16,7,13,50,48,2,55
East Fife,4274,4,15,8,13,52,40,12,53
Queen's Park,4274,5,15,6,15,44,45,-1,51
Albion,4274,6,15,5,16,48,50,-2,50
Peterhead,4274,7,13,9,14,42,53,-11,48
Airdrieon,4274,8,13,8,15,56,58,-2,47
Stranraer,4274,9,12,8,16,58,66,-8,44
Stenhousem'r,4274,10,7,5,24,39,74,-35,26
Alloa,4275,1,23,5,8,77,40,37,74
Livingston,4275,2,22,4,10,83,41,42,70
Airdrieon,4275,3,18,7,11,57,44,13,61
Brechin,4275,4,17,7,12,48,43,5,58
Peterhead,4275,5,11,13,12,40,51,-11,46
Albion,4275,6,11,11,14,44,43,1,44
Queen's Park,4275,7,11,7,18,34,58,-24,40
East Fife,4275,8,9,9,18,42,50,-8,36
Stranraer,4275,9,9,9,18,42,60,-18,36
Stenhousem'r,4275,10,9,8,19,45,82,-37,35
Alloa,4276,1,19,7,10,69,38,31,64
Albion,4276,2,19,5,12,58,47,11,62
Brechin,4276,3,19,4,13,56,47,9,61
Airdrieon,4276,4,17,5,14,48,56,-8,56
Livingston,4276,5,17,4,15,76,61,15,55
East Fife,4276,6,15,8,13,57,50,7,53
Peterhead,4276,7,14,8,14,54,51,3,50
Stranraer,4276,8,12,6,18,49,51,-2,42
Queen's Park,4276,9,10,6,20,30,61,-31,36
Stenhousem'r,4276,10,7,9,20,50,85,-35,30
Alloa,4277,1,19,9,8,74,39,35,66
Livingston,4277,2,21,3,12,76,50,26,66
Airdrieon,4277,3,19,7,10,65,46,19,64
Albion,4277,4,17,9,10,56,44,12,60
Brechin,4277,5,15,6,15,57,61,-4,51
Queen's Park,4277,6,14,8,14,38,49,-11,50
Stranraer,4277,7,13,4,19,47,61,-14,43
East Fife,4277,8,9,11,16,45,57,-12,38
Peterhead,4277,9,11,5,20,54,71,-17,38
Stenhousem'r,4277,10,8,6,22,45,79,-34,30
Alloa,4278,1,21,9,6,70,40,30,72
Livingston,4278,2,23,2,11,76,42,34,71
Brechin,4278,3,19,4,13,54,48,6,61
Airdrieon,4278,4,16,5,15,64,56,8,53
Albion,4278,5,14,7,15,62,62,0,49
Peterhead,4278,6,13,8,15,55,56,-1,47
Queen's Park,4278,7,13,8,15,45,55,-10,47
East Fife,4278,8,11,8,17,48,55,-7,41
Stranraer,4278,9,11,6,19,56,75,-19,39
Stenhousem'r,4278,10,8,5,23,49,90,-41,29
Alloa,4279,1,22,5,9,81,42,39,71
Livingston,4279,2,18,7,11,67,46,21,61
Albion,4279,3,17,5,14,62,48,14,56
Airdrieon,4279,4,16,8,12,56,46,10,56
Queen's Park,4279,5,15,10,11,43,44,-1,55
Brechin,4279,6,17,4,15,46,52,-6,55
Stranraer,4279,7,14,3,19,60,67,-7,45
East Fife,4279,8,11,8,17,43,52,-9,41
Peterhead,4279,9,11,6,19,38,58,-20,39
Stenhousem'r,4279,10,7,8,21,44,85,-41,29
Alloa,4280,1,22,6,8,73,39,34,72
Livingston,4280,2,18,5,13,70,52,18,59
Brechin,4280,3,17,7,12,49,46,3,58
Peterhead,4280,4,14,9,13,49,49,0,51
Airdrieon,4280,5,15,6,15,57,60,-3,51
Stranraer,4280,6,14,5,17,50,54,-4,47
Queen's Park,4280,7,13,8,15,41,48,-7,47
Albion,4280,8,12,7,17,52,60,-8,43
East Fife,4280,9,11,7,18,44,55,-11,40
Stenhousem'r,4280,10,9,10,17,53,75,-22,37
Livingston,4281,1,22,4,10,85,55,30,70
Airdrieon,4281,2,19,4,13,64,53,11,61
Alloa,4281,3,17,9,10,76,53,23,60
Brechin,4281,4,16,8,12,50,44,6,56
Stranraer,4281,5,15,6,15,45,41,4,51
Queen's Park,4281,6,14,8,14,39,50,-11,50
Peterhead,4281,7,12,8,16,50,60,-10,44
Stenhousem'r,4281,8,12,6,18,49,70,-21,42
East Fife,4281,9,10,8,18,48,63,-15,38
Albion,4281,10,8,9,19,49,66,-17,33
Livingston,4282,1,21,5,10,73,52,21,68
Alloa,4282,2,17,11,8,63,43,20,62
Brechin,4282,3,18,7,11,48,41,7,61
Airdrieon,4282,4,17,9,10,55,49,6,60
Albion,4282,5,14,10,12,58,49,9,52
East Fife,4282,6,13,9,14,56,43,13,48
Peterhead,4282,7,13,7,16,45,46,-1,46
Queen's Park,4282,8,12,7,17,34,43,-9,43
Stranraer,4282,9,10,2,24,37,65,-28,32
Stenhousem'r,4282,10,8,7,21,48,86,-38,31
Brechin,4283,1,21,4,11,60,38,22,67
Alloa,4283,2,19,6,11,67,49,18,63
Peterhead,4283,3,17,7,12,50,42,8,58
Livingston,4283,4,16,7,13,72,54,18,55
Airdrieon,4283,5,16,6,14,51,49,2,54
Stranraer,4283,6,16,5,15,54,56,-2,53
Albion,4283,7,13,6,17,58,59,-1,45
Queen's Park,4283,8,12,6,18,40,55,-15,42
East Fife,4283,9,9,10,17,40,53,-13,37
Stenhousem'r,4283,10,9,7,20,42,79,-37,34
Livingston,4284,1,21,9,6,78,48,30,72
Brechin,4284,2,19,7,10,59,43,16,64
Airdrieon,4284,3,18,8,10,65,60,5,62
Alloa,4284,4,16,9,11,66,50,16,57
Queen's Park,4284,5,15,7,14,42,49,-7,52
Albion,4284,6,15,6,15,50,44,6,51
Peterhead,4284,7,14,4,18,49,54,-5,46
East Fife,4284,8,8,13,15,49,54,-5,37
Stenhousem'r,4284,9,8,7,21,46,80,-34,31
Stranraer,4284,10,8,6,22,44,66,-22,30
Airdrieon,4285,1,21,5,10,63,50,13,68
Alloa,4285,2,19,8,9,68,44,24,65
East Fife,4285,3,16,9,11,60,43,17,57
Brechin,4285,4,16,6,14,51,52,-1,54
Queen's Park,4285,5,16,6,14,48,52,-4,54
Livingston,4285,6,16,5,15,66,56,10,53
Stranraer,4285,7,14,8,14,54,51,3,50
Peterhead,4285,8,13,8,15,41,47,-6,47
Albion,4285,9,9,6,21,42,67,-25,33
Stenhousem'r,4285,10,7,5,24,43,74,-31,26
Albion,4286,1,20,5,11,70,45,25,65
Brechin,4286,2,19,7,10,54,42,12,64
Livingston,4286,3,20,3,13,80,50,30,63
Alloa,4286,4,16,9,11,61,45,16,57
Airdrieon,4286,5,17,4,15,57,62,-5,55
Peterhead,4286,6,15,8,13,55,56,-1,53
Queen's Park,4286,7,15,7,14,46,56,-10,52
Stranraer,4286,8,10,7,19,51,63,-12,37
East Fife,4286,9,7,10,19,46,66,-20,31
Stenhousem'r,4286,10,7,8,21,41,76,-35,29
Alloa,4287,1,21,8,7,76,41,35,71
Airdrieon,4287,2,20,7,9,64,45,19,67
Livingston,4287,3,20,6,10,69,45,24,66
Brechin,4287,4,15,5,16,52,51,1,50
Queen's Park,4287,5,14,4,18,40,51,-11,46
Albion,4287,6,11,12,13,47,62,-15,45
East Fife,4287,7,11,11,14,50,46,4,44
Stranraer,4287,8,13,4,19,50,62,-12,43
Peterhead,4287,9,10,7,19,37,61,-24,37
Stenhousem'r,4287,10,9,8,19,49,70,-21,35
Alloa,4288,1,18,10,8,67,47,20,64
Livingston,4288,2,18,8,10,73,55,18,62
Peterhead,4288,3,16,8,12,57,48,9,56
Airdrieon,4288,4,14,9,13,52,52,0,51
East Fife,4288,5,14,8,14,54,47,7,50
Brechin,4288,6,12,9,15,46,59,-13,45
Albion,4288,7,12,8,16,51,51,0,44
Stranraer,4288,8,12,8,16,53,62,-9,44
Queen's Park,4288,9,12,8,16,35,48,-13,44
Stenhousem'r,4288,10,12,4,20,51,70,-19,40
Livingston,4289,1,22,2,12,84,52,32,68
Brechin,4289,2,19,5,12,60,53,7,62
Alloa,4289,3,16,12,8,72,48,24,60
Airdrieon,4289,4,16,5,15,68,62,6,53
East Fife,4289,5,14,8,14,58,46,12,50
Albion,4289,6,14,8,14,55,56,-1,50
Queen's Park,4289,7,12,10,14,43,50,-7,46
Peterhead,4289,8,12,8,16,47,61,-14,44
Stranraer,4289,9,12,6,18,56,63,-7,42
Stenhousem'r,4289,10,8,6,22,45,97,-52,30
Livingston,4290,1,23,4,9,89,54,35,73
Airdrieon,4290,2,18,7,11,64,58,6,61
Brechin,4290,3,17,7,12,60,55,5,58
Peterhead,4290,4,16,7,13,58,60,-2,55
Alloa,4290,5,16,6,14,66,53,13,54
East Fife,4290,6,12,12,12,59,51,8,48
Albion,4290,7,12,10,14,51,51,0,46
Queen's Park,4290,8,11,8,17,41,59,-18,41
Stranraer,4290,9,11,3,22,51,69,-18,36
Stenhousem'r,4290,10,9,6,21,54,83,-29,33
Livingston,4291,1,21,3,12,74,43,31,66
Peterhead,4291,2,19,6,11,55,50,5,63
Alloa,4291,3,16,11,9,64,36,28,59
East Fife,4291,4,14,11,11,47,42,5,53
Brechin,4291,5,14,9,13,50,50,0,51
Airdrieon,4291,6,13,9,14,50,55,-5,48
Queen's Park,4291,7,11,11,14,33,45,-12,44
Stranraer,4291,8,11,7,18,43,57,-14,40
Albion,4291,9,8,13,15,46,57,-11,37
Stenhousem'r,4291,10,9,8,19,44,71,-27,35
Alloa,4292,1,19,8,9,66,46,20,65
Livingston,4292,2,17,6,13,79,52,27,57
Peterhead,4292,3,15,11,10,56,45,11,56
Brechin,4292,4,16,7,13,57,58,-1,55
Airdrieon,4292,5,14,10,12,62,58,4,52
Albion,4292,6,13,7,16,50,45,5,46
Stenhousem'r,4292,7,13,6,17,54,77,-23,45
East Fife,4292,8,11,10,15,45,46,-1,43
Stranraer,4292,9,11,7,18,51,68,-17,40
Queen's Park,4292,10,10,10,16,23,48,-25,40
Airdrieon,4293,1,18,10,8,64,43,21,64
Livingston,4293,2,19,6,11,72,53,19,63
Alloa,4293,3,17,9,10,67,49,18,60
Queen's Park,4293,4,15,8,13,46,48,-2,53
Peterhead,4293,5,14,8,14,52,59,-7,50
Brechin,4293,6,14,7,15,45,49,-4,49
Albion,4293,7,11,12,13,54,57,-3,45
Stranraer,4293,8,12,9,15,53,56,-3,45
East Fife,4293,9,9,10,17,43,50,-7,37
Stenhousem'r,4293,10,8,7,21,49,81,-32,31
Livingston,4294,1,24,2,10,83,50,33,74
Alloa,4294,2,20,9,7,74,39,35,69
Brechin,4294,3,19,4,13,55,49,6,61
Airdrieon,4294,4,16,7,13,58,59,-1,55
Albion,4294,5,15,7,14,59,58,1,52
Peterhead,4294,6,14,6,16,57,53,4,48
Stranraer,4294,7,14,6,16,52,54,-2,48
East Fife,4294,8,12,10,14,50,47,3,46
Queen's Park,4294,9,8,10,18,31,60,-29,34
Stenhousem'r,4294,10,4,7,25,37,87,-50,19
Livingston,4295,1,22,3,11,74,54,20,69
Brechin,4295,2,21,5,10,61,42,19,68
Alloa,4295,3,18,6,12,77,50,27,60
Airdrieon,4295,4,16,6,14,60,64,-4,54
Peterhead,4295,5,15,7,14,58,51,7,52
Albion,4295,6,14,7,15,53,46,7,49
East Fife,4295,7,14,7,15,49,50,-1,49
Queen's Park,4295,8,13,7,16,43,52,-9,46
Stranraer,4295,9,9,6,21,50,69,-19,33
Stenhousem'r,4295,10,8,6,22,42,89,-47,30
Airdrieon,4296,1,19,9,8,71,45,26,66
Alloa,4296,2,18,10,8,73,39,34,64
Brechin,4296,3,16,11,9,57,47,10,59
Livingston,4296,4,17,5,14,75,55,20,56
East Fife,4296,5,14,9,13,57,55,2,51
Stranraer,4296,6,14,4,18,56,68,-12,46
Albion,4296,7,12,8,16,52,60,-8,44
Peterhead,4296,8,11,10,15,43,62,-19,43
Queen's Park,4296,9,9,9,18,31,57,-26,36
Stenhousem'r,4296,10,10,5,21,47,74,-27,35
Livingston,4297,1,24,3,9,81,41,40,75
Albion,4297,2,21,5,10,62,42,20,68
Alloa,4297,3,19,7,10,70,45,25,64
Airdrieon,4297,4,17,7,12,53,49,4,58
Brechin,4297,5,15,5,16,46,54,-8,50
Peterhead,4297,6,14,7,15,41,49,-8,49
Queen's Park,4297,7,13,4,19,36,57,-21,43
Stranraer,4297,8,9,9,18,45,62,-17,36
East Fife,4297,9,8,10,18,39,48,-9,34
Stenhousem'r,4297,10,7,9,20,44,70,-26,30
Livingston,4298,1,24,2,10,84,52,32,74
Alloa,4298,2,19,9,8,69,38,31,66
Brechin,4298,3,16,7,13,62,57,5,55
Stranraer,4298,4,16,6,14,61,58,3,54
Peterhead,4298,5,14,11,11,53,47,6,53
Airdrieon,4298,6,14,10,12,61,60,1,52
Queen's Park,4298,7,12,6,18,34,54,-20,42
Albion,4298,8,10,9,17,50,58,-8,39
East Fife,4298,9,9,11,16,46,55,-9,38
Stenhousem'r,4298,10,7,7,22,51,92,-41,28
Livingston,4299,1,22,6,8,78,48,30,72
Brechin,4299,2,17,13,6,43,29,14,64
Alloa,4299,3,15,9,12,61,46,15,54
Albion,4299,4,15,8,13,50,43,7,53
Airdrieon,4299,5,15,8,13,56,51,5,53
Peterhead,4299,6,13,7,16,42,54,-12,46
Queen's Park,4299,7,11,8,17,35,49,-14,41
East Fife,4299,8,10,10,16,51,49,2,40
Stranraer,4299,9,11,7,18,48,65,-17,40
Stenhousem'r,4299,10,7,12,17,47,77,-30,33
Livingston,4300,1,19,5,12,72,52,20,62
Airdrieon,4300,2,19,5,12,62,51,11,62
Alloa,4300,3,18,6,12,68,49,19,60
Brechin,4300,4,18,6,12,61,49,12,60
Stranraer,4300,5,17,4,15,55,53,2,55
Peterhead,4300,6,13,8,15,49,53,-4,47
Albion,4300,7,13,8,15,57,66,-9,47
East Fife,4300,8,13,7,16,47,46,1,46
Queen's Park,4300,9,12,5,19,35,57,-22,41
Stenhousem'r,4300,10,8,6,22,55,85,-30,30
East Fife,4301,1,17,8,11,60,45,15,59
Peterhead,4301,2,18,5,13,63,54,9,59
Livingston,4301,3,17,7,12,82,64,18,58
Albion,4301,4,16,6,14,57,49,8,54
Alloa,4301,5,15,8,13,72,56,16,53
Airdrieon,4301,6,14,8,14,56,53,3,50
Brechin,4301,7,15,5,16,56,63,-7,50
Stranraer,4301,8,12,8,16,53,61,-8,44
Queen's Park,4301,9,12,8,16,34,54,-20,44
Stenhousem'r,4301,10,8,9,19,48,82,-34,33
Livingston,4302,1,22,3,11,81,44,37,69
Brechin,4302,2,19,5,12,53,46,7,62
Alloa,4302,3,18,7,11,74,50,24,61
Stranraer,4302,4,15,6,15,53,61,-8,51
Airdrieon,4302,5,14,7,15,63,62,1,49
Queen's Park,4302,6,14,7,15,49,57,-8,49
Stenhousem'r,4302,7,14,5,17,49,71,-22,47
Albion,4302,8,13,6,17,52,66,-14,45
East Fife,4302,9,11,7,18,44,49,-5,40
Peterhead,4302,10,11,5,20,43,55,-12,38
Livingston,4303,1,22,9,5,79,39,40,75
Alloa,4303,2,18,8,10,67,45,22,62
Airdrieon,4303,3,17,7,12,68,57,11,58
Queen's Park,4303,4,16,6,14,48,61,-13,54
Brechin,4303,5,15,6,15,46,46,0,51
Peterhead,4303,6,13,9,14,46,54,-8,48
East Fife,4303,7,10,11,15,49,48,1,41
Albion,4303,8,10,11,15,51,56,-5,41
Stenhousem'r,4303,9,10,7,19,47,72,-25,37
Stranraer,4303,10,8,8,20,45,68,-23,32
Alloa,4304,1,21,7,8,69,44,25,70
Livingston,4304,2,20,7,9,78,47,31,67
Brechin,4304,3,18,5,13,63,53,10,59
Peterhead,4304,4,17,7,12,57,52,5,58
Albion,4304,5,16,7,13,59,53,6,55
Airdrieon,4304,6,15,4,17,54,57,-3,49
Queen's Park,4304,7,11,9,16,44,59,-15,42
East Fife,4304,8,10,11,15,47,51,-4,41
Stranraer,4304,9,12,5,19,52,61,-9,41
Stenhousem'r,4304,10,4,10,22,44,90,-46,22
Livingston,4305,1,21,4,11,81,51,30,67
Alloa,4305,2,17,13,6,64,38,26,64
Airdrieon,4305,3,18,6,12,53,49,4,60
Brechin,4305,4,17,6,13,46,40,6,57
Albion,4305,5,15,10,11,60,54,6,55
Stranraer,4305,6,14,5,17,50,57,-7,47
Peterhead,4305,7,11,9,16,39,55,-16,42
East Fife,4305,8,9,12,15,45,45,0,39
Queen's Park,4305,9,10,6,20,40,60,-20,36
Stenhousem'r,4305,10,7,11,18,51,80,-29,32
Livingston,4306,1,18,6,12,67,48,19,60
Alloa,4306,2,17,8,11,61,45,16,59
Peterhead,4306,3,16,9,11,54,44,10,57
Airdrieon,4306,4,16,7,13,60,48,12,55
Albion,4306,5,14,11,11,49,44,5,53
Brechin,4306,6,13,9,14,45,48,-3,48
East Fife,4306,7,12,9,15,51,58,-7,45
Stranraer,4306,8,12,8,16,47,56,-9,44
Queen's Park,4306,9,11,10,15,29,46,-17,43
Stenhousem'r,4306,10,8,9,19,41,67,-26,33
Livingston,4307,1,21,5,10,79,52,27,68
Brechin,4307,2,18,8,10,53,45,8,62
Alloa,4307,3,18,6,12,68,50,18,60
Airdrieon,4307,4,15,7,14,52,58,-6,52
Albion,4307,5,11,12,13,54,51,3,45
East Fife,4307,6,11,12,13,46,45,1,45
Stranraer,4307,7,12,9,15,52,55,-3,45
Queen's Park,4307,8,12,8,16,35,52,-17,44
Peterhead,4307,9,11,9,16,45,49,-4,42
Stenhousem'r,4307,10,9,8,19,53,80,-27,35
Livingston,4308,1,24,4,8,80,38,42,76
Alloa,4308,2,18,7,11,59,43,16,61
Brechin,4308,3,17,9,10,52,37,15,60
Airdrieon,4308,4,15,10,11,56,51,5,55
Peterhead,4308,5,15,10,11,50,50,0,55
Albion,4308,6,13,9,14,61,60,1,48
Queen's Park,4308,7,10,11,15,32,52,-20,41
Stranraer,4308,8,9,8,19,45,60,-15,35
East Fife,4308,9,8,10,18,49,65,-16,34
Stenhousem'r,4308,10,8,8,20,48,76,-28,32
Alloa,4309,1,20,8,8,67,43,24,68
Livingston,4309,2,19,9,8,72,42,30,66
Airdrieon,4309,3,18,8,10,60,46,14,62
Brechin,4309,4,17,7,12,52,46,6,58
East Fife,4309,5,13,10,13,62,53,9,49
Albion,4309,6,12,11,13,51,54,-3,47
Queen's Park,4309,7,13,8,15,35,48,-13,47
Peterhead,4309,8,13,7,16,48,55,-7,46
Stranraer,4309,9,8,6,22,46,78,-32,30
Stenhousem'r,4309,10,6,8,22,47,75,-28,26
Alloa,4310,1,20,7,9,73,43,30,67
Livingston,4310,2,19,5,12,74,49,25,62
Airdrieon,4310,3,18,7,11,54,48,6,61
Albion,4310,4,16,9,11,60,53,7,57
Stranraer,4310,5,13,9,14,60,65,-5,48
Queen's Park,4310,6,13,6,17,45,57,-12,45
East Fife,4310,7,11,10,15,51,50,1,43
Brechin,4310,8,11,9,16,42,55,-13,42
Peterhead,4310,9,10,11,15,51,57,-6,41
Stenhousem'r,4310,10,7,11,18,47,80,-33,32
Alloa,4311,1,18,8,10,81,52,29,62
Livingston,4311,2,18,7,11,74,50,24,61
Albion,4311,3,17,7,12,62,43,19,58
Brechin,4311,4,17,7,12,59,49,10,58
Airdrieon,4311,5,15,8,13,60,59,1,53
Queen's Park,4311,6,13,9,14,45,53,-8,48
Peterhead,4311,7,12,9,15,46,58,-12,45
Stranraer,4311,8,13,6,17,55,72,-17,45
East Fife,4311,9,9,12,15,50,52,-2,39
Stenhousem'r,4311,10,8,7,21,43,87,-44,31
Livingston,4312,1,24,3,9,78,38,40,75
Airdrieon,4312,2,20,4,12,60,51,9,64
Brechin,4312,3,16,7,13,50,49,1,55
Albion,4312,4,13,11,12,54,50,4,50
Alloa,4312,5,14,7,15,55,51,4,49
East Fife,4312,6,12,10,14,49,47,2,46
Queen's Park,4312,7,10,13,13,38,50,-12,43
Stranraer,4312,8,12,6,18,50,60,-10,42
Peterhead,4312,9,11,7,18,37,56,-19,40
Stenhousem'r,4312,10,10,8,18,57,76,-19,38
Livingston,4313,1,22,4,10,77,46,31,70
Alloa,4313,2,21,5,10,72,47,25,68
Albion,4313,3,19,4,13,59,43,16,61
Brechin,4313,4,16,6,14,52,46,6,54
Airdrieon,4313,5,15,9,12,57,53,4,54
Peterhead,4313,6,11,11,14,52,59,-7,44
Queen's Park,4313,7,11,9,16,37,55,-18,42
East Fife,4313,8,9,11,16,47,45,2,38
Stranraer,4313,9,10,8,18,39,64,-25,38
Stenhousem'r,4313,10,8,9,19,39,73,-34,33
Livingston,4314,1,19,8,9,81,43,38,65
Peterhead,4314,2,19,6,11,62,43,19,63
Brechin,4314,3,18,8,10,56,44,12,62
Alloa,4314,4,16,7,13,67,54,13,55
Airdrieon,4314,5,14,11,11,57,56,1,53
Stranraer,4314,6,14,7,15,53,58,-5,49
Albion,4314,7,12,8,16,44,57,-13,44
East Fife,4314,8,11,10,15,49,43,6,43
Queen's Park,4314,9,9,8,19,33,57,-24,35
Stenhousem'r,4314,10,8,7,21,37,84,-47,31
Livingston,4315,1,23,3,10,80,48,32,72
Alloa,4315,2,21,7,8,68,39,29,70
Airdrieon,4315,3,17,8,11,61,54,7,59
Brechin,4315,4,17,6,13,52,44,8,57
Albion,4315,5,15,6,15,56,55,1,51
Peterhead,4315,6,14,7,15,56,56,0,49
Queen's Park,4315,7,13,7,16,38,56,-18,46
East Fife,4315,8,12,7,17,50,47,3,43
Stranraer,4315,9,9,8,19,47,65,-18,35
Stenhousem'r,4315,10,4,11,21,37,81,-44,23
Alloa,4316,1,20,7,9,67,35,32,67
Airdrieon,4316,2,20,7,9,66,53,13,67
Livingston,4316,3,21,3,12,72,49,23,66
Brechin,4316,4,17,6,13,47,48,-1,57
Albion,4316,5,16,7,13,61,53,8,55
Peterhead,4316,6,13,10,13,49,49,0,49
Queen's Park,4316,7,12,6,18,37,51,-14,42
Stranraer,4316,8,12,4,20,46,66,-20,40
East Fife,4316,9,8,9,19,51,56,-5,33
Stenhousem'r,4316,10,8,7,21,45,81,-36,31
Livingston,4317,1,25,3,8,75,36,39,78
Alloa,4317,2,20,5,11,69,42,27,65
Brechin,4317,3,20,4,12,56,46,10,64
Airdrieon,4317,4,16,10,10,64,49,15,58
Albion,4317,5,14,6,16,54,62,-8,48
Queen's Park,4317,6,14,6,16,35,48,-13,48
East Fife,4317,7,12,8,16,58,57,1,44
Peterhead,4317,8,11,10,15,46,56,-10,43
Stenhousem'r,4317,9,8,8,20,51,84,-33,32
Stranraer,4317,10,8,4,24,33,61,-28,28
Alloa,4318,1,19,9,8,74,48,26,66
Livingston,4318,2,18,8,10,73,50,23,62
Albion,4318,3,17,8,11,59,57,2,59
Airdrieon,4318,4,17,6,13,57,52,5,57
Brechin,4318,5,14,8,14,54,53,1,50
Queen's Park,4318,6,13,8,15,46,49,-3,47
Peterhead,4318,7,12,8,16,56,64,-8,44
East Fife,4318,8,11,10,15,53,56,-3,43
Stranraer,4318,9,11,4,21,46,58,-12,37
Stenhousem'r,4318,10,8,11,17,49,80,-31,35
Livingston,4319,1,20,8,8,80,55,25,68
Airdrieon,4319,2,18,8,10,65,53,12,62
Alloa,4319,3,15,9,12,64,56,8,54
East Fife,4319,4,15,7,14,50,40,10,52
Peterhead,4319,5,15,6,15,60,58,2,51
Albion,4319,6,15,5,16,54,52,2,50
Stranraer,4319,7,14,7,15,55,59,-4,49
Queen's Park,4319,8,13,10,13,48,52,-4,49
Brechin,4319,9,14,6,16,47,51,-4,48
Stenhousem'r,4319,10,3,10,23,42,89,-47,19
Livingston,4320,1,21,3,12,74,52,22,66
Alloa,4320,2,18,6,12,77,52,25,60
Brechin,4320,3,18,6,12,56,46,10,60
Airdrieon,4320,4,18,5,13,62,51,11,59
Albion,4320,5,16,6,14,56,58,-2,54
Peterhead,4320,6,12,11,13,50,51,-1,47
Queen's Park,4320,7,12,9,15,41,55,-14,45
Stranraer,4320,8,13,5,18,48,61,-13,44
East Fife,4320,9,11,7,18,52,59,-7,40
Stenhousem'r,4320,10,9,6,21,46,77,-31,33
Livingston,4321,1,23,3,10,85,47,38,72
Alloa,4321,2,17,12,7,68,42,26,63
Airdrieon,4321,3,15,8,13,56,52,4,53
Brechin,4321,4,15,7,14,45,45,0,52
Peterhead,4321,5,13,10,13,50,49,1,49
Stranraer,4321,6,14,5,17,47,56,-9,47
Albion,4321,7,12,8,16,49,59,-10,44
Queen's Park,4321,8,11,9,16,39,56,-17,42
East Fife,4321,9,9,13,14,45,47,-2,40
Stenhousem'r,4321,10,10,7,19,50,81,-31,37
Livingston,4322,1,21,6,9,71,48,23,69
Alloa,4322,2,19,8,9,76,34,42,65
Airdrieon,4322,3,16,10,10,60,46,14,58
Albion,4322,4,16,7,13,54,46,8,55
Brechin,4322,5,14,9,13,48,51,-3,51
East Fife,4322,6,14,8,14,43,40,3,50
Stranraer,4322,7,13,8,15,47,59,-12,47
Peterhead,4322,8,13,7,16,44,49,-5,46
Queen's Park,4322,9,9,5,22,35,66,-31,32
Stenhousem'r,4322,10,7,8,21,39,78,-39,29
Alloa,4323,1,21,7,8,69,40,29,70
Livingston,4323,2,17,9,10,70,44,26,60
Brechin,4323,3,17,5,14,51,47,4,56
East Fife,4323,4,12,13,11,56,45,11,49
Airdrieon,4323,5,12,11,13,52,52,0,47
Queen's Park,4323,6,12,10,14,37,44,-7,46
Albion,4323,7,11,13,12,42,54,-12,46
Peterhead,4323,8,11,10,15,53,63,-10,43
Stenhousem'r,4323,9,11,9,16,50,70,-20,42
Stranraer,4323,10,10,5,21,37,58,-21,35
Livingston,4324,1,21,4,11,77,51,26,67
Alloa,4324,2,19,8,9,72,42,30,65
Albion,4324,3,18,7,11,63,52,11,61
Brechin,4324,4,18,5,13,55,51,4,59
Airdrieon,4324,5,19,2,15,58,57,1,59
Peterhead,4324,6,15,6,15,45,52,-7,51
East Fife,4324,7,12,8,16,50,48,2,44
Stenhousem'r,4324,8,11,7,18,56,69,-13,40
Queen's Park,4324,9,10,9,17,36,59,-23,39
Stranraer,4324,10,7,4,25,50,81,-31,25
Livingston,4325,1,21,4,11,76,46,30,67
Alloa,4325,2,19,7,10,71,47,24,64
Peterhead,4325,3,17,7,12,60,46,14,58
Airdrieon,4325,4,17,7,12,68,65,3,58
Brechin,4325,5,15,8,13,56,47,9,53
Albion,4325,6,15,8,13,52,51,1,53
Stranraer,4325,7,12,7,17,54,62,-8,43
Queen's Park,4325,8,12,5,19,43,65,-22,41
East Fife,4325,9,8,12,16,39,47,-8,36
Stenhousem'r,4325,10,8,7,21,45,88,-43,31
Livingston,4326,1,21,5,10,76,44,32,68
Alloa,4326,2,17,7,12,60,44,16,58
Brechin,4326,3,17,7,12,49,42,7,58
Peterhead,4326,4,17,6,13,53,54,-1,57
Airdrieon,4326,5,16,5,15,48,52,-4,53
Albion,4326,6,14,6,16,55,57,-2,48
Stranraer,4326,7,14,3,19,54,60,-6,45
Queen's Park,4326,8,13,6,17,39,51,-12,45
Stenhousem'r,4326,9,11,7,18,49,68,-19,40
East Fife,4326,10,9,10,17,44,55,-11,37
Alloa,4327,1,22,7,7,85,55,30,73
Livingston,4327,2,22,4,10,80,49,31,70
Albion,4327,3,15,9,12,56,49,7,54
Airdrieon,4327,4,16,5,15,59,61,-2,53
Queen's Park,4327,5,14,8,14,47,53,-6,50
Brechin,4327,6,13,9,14,52,53,-1,48
East Fife,4327,7,13,6,17,48,58,-10,45
Peterhead,4327,8,13,5,18,50,61,-11,44
Stranraer,4327,9,11,9,16,54,59,-5,42
Stenhousem'r,4327,10,7,6,23,40,73,-33,27
Albion,4328,1,21,8,7,69,43,26,71
Alloa,4328,2,19,8,9,79,55,24,65
Livingston,4328,3,19,5,12,76,50,26,62
Airdrieon,4328,4,16,9,11,64,57,7,57
Brechin,4328,5,15,4,17,54,65,-11,49
East Fife,4328,6,12,9,15,52,55,-3,45
Stranraer,4328,7,12,9,15,50,58,-8,45
Peterhead,4328,8,12,8,16,52,55,-3,44
Queen's Park,4328,9,12,6,18,38,55,-17,42
Stenhousem'r,4328,10,6,6,24,39,80,-41,24
Livingston,4329,1,22,3,11,69,43,26,69
Alloa,4329,2,17,10,9,70,45,25,61
Airdrieon,4329,3,18,7,11,68,49,19,61
Peterhead,4329,4,15,8,13,55,55,0,53
Brechin,4329,5,16,5,15,49,49,0,53
East Fife,4329,6,15,7,14,58,46,12,52
Albion,4329,7,14,8,14,57,57,0,50
Stranraer,4329,8,13,8,15,48,59,-11,47
Queen's Park,4329,9,11,10,15,37,54,-17,43
Stenhousem'r,4329,10,3,6,27,30,84,-54,15
Livingston,4330,1,22,4,10,91,54,37,70
Alloa,4330,2,18,8,10,59,41,18,62
Brechin,4330,3,18,5,13,55,44,11,59
Airdrieon,4330,4,16,4,16,58,60,-2,52
Peterhead,4330,5,15,7,14,49,51,-2,52
Albion,4330,6,13,11,12,55,55,0,50
Queen's Park,4330,7,12,9,15,46,58,-12,45
Stranraer,4330,8,12,5,19,51,72,-21,41
East Fife,4330,9,9,13,14,46,49,-3,40
Stenhousem'r,4330,10,8,8,20,50,76,-26,32
Livingston,4331,1,22,6,8,82,38,44,72
Alloa,4331,2,16,11,9,64,47,17,59
Albion,4331,3,17,8,11,56,45,11,59
Stranraer,4331,4,16,7,13,58,48,10,55
Brechin,4331,5,16,6,14,39,44,-5,54
Airdrieon,4331,6,14,10,12,61,54,7,52
Queen's Park,4331,7,14,5,17,41,54,-13,47
Peterhead,4331,8,12,6,18,45,62,-17,42
Stenhousem'r,4331,9,9,5,22,48,83,-35,32
East Fife,4331,10,7,10,19,41,60,-19,31
Livingston,4332,1,20,4,12,76,53,23,64
Alloa,4332,2,18,10,8,64,46,18,64
Airdrieon,4332,3,17,9,10,64,54,10,60
Brechin,4332,4,16,7,13,66,53,13,55
Queen's Park,4332,5,15,6,15,45,53,-8,51
East Fife,4332,6,13,8,15,58,52,6,47
Albion,4332,7,11,13,12,49,51,-2,46
Peterhead,4332,8,11,10,15,50,56,-6,43
Stranraer,4332,9,10,7,19,49,66,-17,37
Stenhousem'r,4332,10,8,8,20,40,77,-37,32
Alloa,4333,1,25,5,6,91,33,58,80
Livingston,4333,2,21,5,10,80,53,27,68
Airdrieon,4333,3,18,4,14,63,60,3,58
Brechin,4333,4,16,7,13,51,47,4,55
Stranraer,4333,5,15,7,14,47,52,-5,52
East Fife,4333,6,11,11,14,45,42,3,44
Peterhead,4333,7,12,8,16,50,60,-10,44
Albion,4333,8,9,9,18,43,63,-20,36
Queen's Park,4333,9,8,10,18,35,60,-25,34
Stenhousem'r,4333,10,7,10,19,47,82,-35,31
Alloa,4334,1,24,5,7,69,32,37,77
Livingston,4334,2,20,7,9,73,47,26,67
Airdrieon,4334,3,19,6,11,61,49,12,63
Brechin,4334,4,17,5,14,51,43,8,56
Stranraer,4334,5,15,2,19,54,54,0,47
Peterhead,4334,6,13,8,15,43,46,-3,47
Albion,4334,7,10,11,15,45,61,-16,41
East Fife,4334,8,10,10,16,45,53,-8,40
Queen's Park,4334,9,10,9,17,29,49,-20,39
Stenhousem'r,4334,10,4,13,19,38,74,-36,25
Alloa,4335,1,21,5,10,75,44,31,68
Livingston,4335,2,19,4,13,70,49,21,61
Airdrieon,4335,3,18,5,13,62,47,15,59
Brechin,4335,4,16,7,13,48,55,-7,55
Albion,4335,5,16,6,14,52,56,-4,54
Queen's Park,4335,6,16,5,15,48,51,-3,53
Peterhead,4335,7,13,8,15,41,46,-5,47
East Fife,4335,8,13,7,16,47,39,8,46
Stranraer,4335,9,11,6,19,46,66,-20,39
Stenhousem'r,4335,10,8,5,23,40,76,-36,29
Livingston,4336,1,23,5,8,79,40,39,74
Alloa,4336,2,22,6,8,63,36,27,72
Airdrieon,4336,3,19,7,10,54,41,13,64
Peterhead,4336,4,16,5,15,47,52,-5,53
Brechin,4336,5,15,6,15,49,47,2,51
Albion,4336,6,11,9,16,53,58,-5,42
East Fife,4336,7,10,10,16,43,48,-5,40
Queen's Park,4336,8,10,10,16,36,56,-20,40
Stenhousem'r,4336,9,9,9,18,44,65,-21,36
Stranraer,4336,10,9,5,22,38,63,-25,32
Alloa,4337,1,20,8,8,68,36,32,68
Livingston,4337,2,20,5,11,64,46,18,65
Airdrieon,4337,3,18,9,9,57,52,5,63
Albion,4337,4,16,9,11,60,47,13,57
Peterhead,4337,5,15,9,12,51,47,4,54
Brechin,4337,6,13,7,16,52,54,-2,46
Queen's Park,4337,7,12,9,15,36,48,-12,45
Stranraer,4337,8,11,6,19,45,55,-10,39
East Fife,4337,9,10,8,18,46,54,-8,38
Stenhousem'r,4337,10,6,8,22,37,77,-40,26
Livingston,4338,1,25,2,9,80,44,36,77
Airdrieon,4338,2,19,5,12,74,58,16,62
Brechin,4338,3,15,10,11,49,51,-2,55
Albion,4338,4,15,9,12,54,50,4,54
Alloa,4338,5,14,11,11,61,43,18,53
Peterhead,4338,6,13,7,16,40,48,-8,46
Queen's Park,4338,7,12,9,15,39,48,-9,45
East Fife,4338,8,11,10,15,52,50,2,43
Stenhousem'r,4338,9,10,8,18,48,75,-27,38
Stranraer,4338,10,8,5,23,43,73,-30,29
Alloa,4339,1,19,5,12,75,48,27,62
Livingston,4339,2,19,4,13,69,42,27,61
Albion,4339,3,16,11,9,65,50,15,59
Peterhead,4339,4,16,9,11,65,58,7,57
Airdrieon,4339,5,16,7,13,63,62,1,55
Brechin,4339,6,14,6,16,41,59,-18,48
Queen's Park,4339,7,13,8,15,41,49,-8,47
Stranraer,4339,8,13,5,18,45,62,-17,44
East Fife,4339,9,11,9,16,57,58,-1,42
Stenhousem'r,4339,10,7,8,21,45,78,-33,29
Livingston,4340,1,20,4,12,74,50,24,64
Alloa,4340,2,17,11,8,65,44,21,62
Airdrieon,4340,3,18,8,10,61,52,9,62
Albion,4340,4,16,9,11,65,58,7,57
Brechin,4340,5,16,6,14,62,57,5,54
Peterhead,4340,6,14,9,13,52,54,-2,51
Queen's Park,4340,7,14,8,14,49,58,-9,50
Stranraer,4340,8,9,8,19,53,68,-15,35
East Fife,4340,9,8,9,19,40,52,-12,33
Stenhousem'r,4340,10,9,6,21,50,78,-28,33
Alloa,4341,1,21,7,8,78,45,33,70
Livingston,4341,2,20,8,8,74,41,33,68
Airdrieon,4341,3,21,4,11,64,48,16,67
Brechin,4341,4,16,6,14,53,51,2,54
Albion,4341,5,15,6,15,56,56,0,51
Stranraer,4341,6,15,3,18,46,57,-11,48
East Fife,4341,7,13,8,15,52,45,7,47
Peterhead,4341,8,12,5,19,47,60,-13,41
Queen's Park,4341,9,11,7,18,41,61,-20,40
Stenhousem'r,4341,10,6,6,24,37,84,-47,24
Livingston,4342,1,21,7,8,76,47,29,70
Alloa,4342,2,18,11,7,71,41,30,65
Airdrieon,4342,3,16,7,13,57,47,10,55
Peterhead,4342,4,16,7,13,56,48,8,55
Brechin,4342,5,14,10,12,52,54,-2,52
Stranraer,4342,6,12,8,16,50,59,-9,44
East Fife,4342,7,11,10,15,48,47,1,43
Albion,4342,8,11,10,15,49,61,-12,43
Queen's Park,4342,9,11,8,17,37,54,-17,41
Stenhousem'r,4342,10,8,6,22,51,89,-38,30
Livingston,4343,1,19,7,10,67,39,28,64
Brechin,4343,2,19,7,10,51,42,9,64
Alloa,4343,3,18,9,9,77,46,31,63
Airdrieon,4343,4,14,9,13,58,60,-2,51
Stranraer,4343,5,14,7,15,55,53,2,49
Queen's Park,4343,6,14,6,16,42,52,-10,48
East Fife,4343,7,10,12,14,38,47,-9,42
Peterhead,4343,8,10,11,15,37,48,-11,41
Albion,4343,9,10,8,18,45,56,-11,38
Stenhousem'r,4343,10,9,10,17,50,77,-27,37
Alloa,4344,1,20,6,10,62,41,21,66
Livingston,4344,2,21,3,12,71,52,19,66
Brechin,4344,3,20,5,11,65,49,16,65
Airdrieon,4344,4,17,7,12,56,47,9,58
Albion,4344,5,16,7,13,61,43,18,55
Queen's Park,4344,6,14,6,16,46,56,-10,48
Stranraer,4344,7,11,9,16,44,54,-10,42
Stenhousem'r,4344,8,10,7,19,46,74,-28,37
Peterhead,4344,9,8,10,18,40,64,-24,34
East Fife,4344,10,7,12,17,39,50,-11,33
Alloa,4345,1,23,5,8,74,40,34,74
Brechin,4345,2,20,4,12,53,45,8,64
Livingston,4345,3,19,2,15,69,60,9,59
Peterhead,4345,4,16,7,13,57,47,10,55
Stranraer,4345,5,17,3,16,60,57,3,54
Airdrieon,4345,6,14,8,14,53,52,1,50
East Fife,4345,7,12,10,14,47,45,2,46
Albion,4345,8,13,6,17,51,61,-10,45
Queen's Park,4345,9,12,7,17,41,51,-10,43
Stenhousem'r,4345,10,4,8,24,40,87,-47,20
Alloa,4346,1,20,7,9,80,51,29,67
Peterhead,4346,2,19,5,12,60,50,10,62
Albion,4346,3,17,6,13,48,45,3,57
Livingston,4346,4,17,5,14,68,52,16,56
Airdrieon,4346,5,16,6,14,63,62,1,54
Brechin,4346,6,17,2,17,55,57,-2,53
East Fife,4346,7,13,7,16,62,47,15,46
Stranraer,4346,8,13,4,19,49,59,-10,43
Stenhousem'r,4346,9,9,10,17,53,85,-32,37
Queen's Park,4346,10,10,6,20,35,65,-30,36
Livingston,4347,1,25,1,10,80,44,36,76
Albion,4347,2,19,8,9,65,40,25,65
Airdrieon,4347,3,19,6,11,67,53,14,63
Alloa,4347,4,17,8,11,68,43,25,59
Brechin,4347,5,15,4,17,41,48,-7,49
East Fife,4347,6,13,9,14,45,45,0,48
Queen's Park,4347,7,13,9,14,44,59,-15,48
Peterhead,4347,8,12,8,16,46,53,-7,44
Stranraer,4347,9,11,10,15,41,49,-8,43
Stenhousem'r,4347,10,2,5,29,34,97,-63,11
Livingston,4348,1,21,9,6,79,43,36,72
Airdrieon,4348,2,18,7,11,60,51,9,61
Alloa,4348,3,17,7,12,67,49,18,58
Peterhead,4348,4,15,11,10,56,49,7,56
East Fife,4348,5,15,6,15,54,45,9,51
Albion,4348,6,12,9,15,47,50,-3,45
Brechin,4348,7,12,9,15,43,54,-11,45
Queen's Park,4348,8,12,9,15,35,50,-15,45
Stranraer,4348,9,10,7,19,51,67,-16,37
Stenhousem'r,4348,10,8,6,22,45,79,-34,30
Livingston,4349,1,20,8,8,73,50,23,68
Alloa,4349,2,19,9,8,78,53,25,66
Airdrieon,4349,3,19,6,11,69,52,17,63
Brechin,4349,4,14,10,12,55,47,8,52
Albion,4349,5,14,10,12,59,52,7,52
East Fife,4349,6,10,13,13,49,55,-6,43
Stranraer,4349,7,13,4,19,58,65,-7,43
Queen's Park,4349,8,11,10,15,40,54,-14,43
Peterhead,4349,9,9,9,18,47,61,-14,36
Stenhousem'r,4349,10,7,9,20,41,80,-39,30
Livingston,4350,1,22,4,10,80,47,33,70
Alloa,4350,2,16,9,11,63,50,13,57
Airdrieon,4350,3,15,11,10,57,51,6,56
Peterhead,4350,4,15,9,12,61,52,9,54
Brechin,4350,5,14,10,12,53,58,-5,52
Albion,4350,6,14,9,13,55,51,4,51
Stranraer,4350,7,14,7,15,51,55,-4,49
East Fife,4350,8,11,10,15,58,59,-1,43
Queen's Park,4350,9,10,6,20,33,55,-22,36
Stenhousem'r,4350,10,7,9,20,52,85,-33,30
Alloa,4351,1,20,10,6,75,43,32,70
Airdrieon,4351,2,20,4,12,65,64,1,64
Livingston,4351,3,17,7,12,80,55,25,58
Peterhead,4351,4,15,9,12,47,47,0,54
Stranraer,4351,5,16,5,15,60,52,8,53
Brechin,4351,6,14,5,17,37,47,-10,47
Queen's Park,4351,7,11,9,16,40,52,-12,42
East Fife,4351,8,11,8,17,44,53,-9,41
Albion,4351,9,11,6,19,58,63,-5,39
Stenhousem'r,4351,10,9,9,18,45,75,-30,36
Airdrieon,4352,1,21,4,11,64,56,8,67
Alloa,4352,2,18,8,10,60,41,19,62
Livingston,4352,3,18,5,13,72,53,19,59
Peterhead,4352,4,15,9,12,48,44,4,54
Brechin,4352,5,15,7,14,53,47,6,52
Queen's Park,4352,6,15,7,14,48,51,-3,52
Albion,4352,7,15,6,15,53,54,-1,51
East Fife,4352,8,8,12,16,44,52,-8,36
Stranraer,4352,9,9,9,18,52,68,-16,36
Stenhousem'r,4352,10,10,5,21,49,77,-28,35
Alloa,4353,1,21,9,6,74,38,36,72
Livingston,4353,2,20,5,11,74,49,25,65
Brechin,4353,3,18,4,14,55,51,4,58
Airdrieon,4353,4,18,3,15,55,48,7,57
East Fife,4353,5,13,10,13,60,50,10,49
Peterhead,4353,6,13,9,14,51,59,-8,48
Stranraer,4353,7,13,7,16,51,60,-9,46
Queen's Park,4353,8,12,8,16,34,46,-12,44
Albion,4353,9,10,9,17,48,57,-9,39
Stenhousem'r,4353,10,5,10,21,35,79,-44,25
Brechin,4354,1,20,5,11,55,38,17,65
Alloa,4354,2,19,7,10,66,37,29,64
Livingston,4354,3,19,4,13,67,53,14,61
Stranraer,4354,4,17,6,13,55,51,4,57
Airdrieon,4354,5,17,5,14,67,57,10,56
Queen's Park,4354,6,15,8,13,42,45,-3,53
Albion,4354,7,13,8,15,48,48,0,47
Peterhead,4354,8,13,8,15,50,56,-6,47
East Fife,4354,9,10,9,17,52,58,-6,39
Stenhousem'r,4354,10,4,6,26,36,95,-59,18
Alloa,4355,1,22,5,9,81,55,26,71
Brechin,4355,2,19,5,12,51,43,8,62
Livingston,4355,3,18,7,11,74,50,24,61
Airdrieon,4355,4,16,9,11,62,49,13,57
East Fife,4355,5,14,6,16,45,41,4,48
Stranraer,4355,6,14,6,16,53,55,-2,48
Queen's Park,4355,7,13,8,15,40,54,-14,47
Albion,4355,8,13,7,16,49,56,-7,46
Peterhead,4355,9,11,8,17,41,53,-12,41
Stenhousem'r,4355,10,7,5,24,39,79,-40,26
Livingston,4356,1,22,5,9,71,41,30,71
Brechin,4356,2,22,4,10,67,48,19,70
Alloa,4356,3,20,7,9,69,36,33,67
Airdrieon,4356,4,17,9,10,57,45,12,60
Albion,4356,5,14,9,13,56,53,3,51
Queen's Park,4356,6,14,5,17,40,53,-13,47
East Fife,4356,7,12,8,16,53,48,5,44
Peterhead,4356,8,9,11,16,41,64,-23,38
Stranraer,4356,9,9,7,20,48,67,-19,34
Stenhousem'r,4356,10,5,7,24,42,89,-47,22
Alloa,4357,1,21,6,9,80,45,35,69
Livingston,4357,2,19,7,10,71,48,23,64
East Fife,4357,3,14,10,12,59,51,8,52
Airdrieon,4357,4,16,4,16,64,60,4,52
Brechin,4357,5,15,6,15,50,55,-5,51
Peterhead,4357,6,13,10,13,48,56,-8,49
Stranraer,4357,7,13,8,15,52,54,-2,47
Albion,4357,8,13,5,18,45,51,-6,44
Queen's Park,4357,9,10,12,14,34,49,-15,42
Stenhousem'r,4357,10,7,10,19,50,84,-34,31
Alloa,4358,1,18,8,10,72,47,25,62
Airdrieon,4358,2,17,7,12,57,52,5,58
Brechin,4358,3,16,8,12,56,51,5,56
Livingston,4358,4,16,6,14,61,52,9,54
Albion,4358,5,15,7,14,62,59,3,52
Stranraer,4358,6,15,6,15,57,57,0,51
Peterhead,4358,7,15,6,15,47,50,-3,51
Queen's Park,4358,8,14,7,15,47,53,-6,49
East Fife,4358,9,9,13,14,42,45,-3,40
Stenhousem'r,4358,10,6,10,20,49,84,-35,28
Alloa,4359,1,19,6,11,66,43,23,63
Livingston,4359,2,19,4,13,75,55,20,61
Airdrieon,4359,3,17,7,12,61,55,6,58
Peterhead,4359,4,15,9,12,53,55,-2,54
Queen's Park,4359,5,15,7,14,49,48,1,52
Albion,4359,6,14,9,13,61,58,3,51
Brechin,4359,7,15,6,15,46,47,-1,51
East Fife,4359,8,11,11,14,57,57,0,44
Stranraer,4359,9,12,6,18,48,58,-10,42
Stenhousem'r,4359,10,7,7,22,40,80,-40,28
Alloa,4360,1,20,8,8,73,43,30,68
Livingston,4360,2,21,3,12,76,52,24,66
Airdrieon,4360,3,19,6,11,67,56,11,63
East Fife,4360,4,15,9,12,52,42,10,54
Brechin,4360,5,16,5,15,52,49,3,53
Albion,4360,6,15,7,14,54,48,6,52
Peterhead,4360,7,12,8,16,50,57,-7,44
Stranraer,4360,8,13,5,18,52,62,-10,44
Queen's Park,4360,9,12,4,20,41,58,-17,40
Stenhousem'r,4360,10,5,9,22,48,98,-50,24
Alloa,4361,1,20,8,8,72,42,30,68
Airdrieon,4361,2,20,6,10,66,54,12,66
Livingston,4361,3,18,5,13,69,58,11,59
Albion,4361,4,15,10,11,52,41,11,55
East Fife,4361,5,14,10,12,56,43,13,52
Brechin,4361,6,16,4,16,48,59,-11,52
Queen's Park,4361,7,12,9,15,39,49,-10,45
Peterhead,4361,8,12,5,19,44,50,-6,41
Stranraer,4361,9,11,3,22,45,66,-21,36
Stenhousem'r,4361,10,8,8,20,49,78,-29,32
Alloa,4362,1,20,8,8,68,39,29,68
Livingston,4362,2,20,5,11,76,49,27,65
Airdrieon,4362,3,19,8,9,69,55,14,65
Brechin,4362,4,15,12,9,52,49,3,57
Peterhead,4362,5,12,12,12,54,53,1,48
Albion,4362,6,12,8,16,50,54,-4,44
Stranraer,4362,7,11,9,16,55,62,-7,42
East Fife,4362,8,11,8,17,44,48,-4,41
Queen's Park,4362,9,12,4,20,35,62,-27,40
Stenhousem'r,4362,10,8,6,22,43,75,-32,30
Livingston,4363,1,21,4,11,72,55,17,67
Brechin,4363,2,19,7,10,54,42,12,64
Alloa,4363,3,16,11,9,63,42,21,59
Peterhead,4363,4,16,8,12,46,46,0,56
Albion,4363,5,12,12,12,50,45,5,48
Stranraer,4363,6,13,9,14,56,53,3,48
Airdrieon,4363,7,13,8,15,50,56,-6,47
East Fife,4363,8,11,11,14,50,48,2,44
Queen's Park,4363,9,9,10,17,32,49,-17,37
Stenhousem'r,4363,10,7,6,23,40,77,-37,27
Livingston,4364,1,26,1,9,81,41,40,79
Airdrieon,4364,2,21,4,11,69,48,21,67
Alloa,4364,3,18,9,9,69,49,20,63
Brechin,4364,4,19,5,12,58,40,18,62
Albion,4364,5,14,8,14,48,55,-7,50
Peterhead,4364,6,13,8,15,45,46,-1,47
East Fife,4364,7,11,9,16,55,53,2,42
Stranraer,4364,8,11,4,21,44,61,-17,37
Queen's Park,4364,9,10,6,20,33,57,-24,36
Stenhousem'r,4364,10,7,6,23,41,93,-52,27
Airdrieon,4365,1,18,9,9,59,51,8,63
Alloa,4365,2,17,10,9,68,44,24,61
Livingston,4365,3,15,11,10,69,51,18,56
Brechin,4365,4,15,8,13,51,45,6,53
East Fife,4365,5,12,14,10,53,46,7,50
Albion,4365,6,14,7,15,49,54,-5,49
Peterhead,4365,7,11,13,12,53,59,-6,46
Queen's Park,4365,8,11,9,16,43,52,-9,42
Stranraer,4365,9,10,6,20,47,64,-17,36
Stenhousem'r,4365,10,9,9,18,57,83,-26,36
Alloa,4366,1,19,10,7,75,43,32,67
Livingston,4366,2,20,6,10,84,52,32,66
Albion,4366,3,15,10,11,55,45,10,55
Brechin,4366,4,16,4,16,54,58,-4,52
Airdrieon,4366,5,15,7,14,53,58,-5,52
Queen's Park,4366,6,14,8,14,39,45,-6,50
Stranraer,4366,7,13,6,17,51,60,-9,45
Peterhead,4366,8,10,11,15,44,57,-13,41
East Fife,4366,9,10,10,16,49,47,2,40
Stenhousem'r,4366,10,8,8,20,45,84,-39,32
Alloa,4367,1,19,11,6,80,49,31,68
Livingston,4367,2,20,8,8,66,44,22,68
Brechin,4367,3,18,4,14,49,49,0,58
Airdrieon,4367,4,16,7,13,59,55,4,55
Peterhead,4367,5,16,6,14,52,51,1,54
Albion,4367,6,14,8,14,63,57,6,50
Queen's Park,4367,7,11,9,16,43,59,-16,42
East Fife,4367,8,10,11,15,50,47,3,41
Stranraer,4367,9,11,7,18,44,57,-13,40
Stenhousem'r,4367,10,5,9,22,41,79,-38,24
Brechin,4368,1,23,3,10,56,37,19,72
Livingston,4368,2,20,7,9,79,48,31,67
Alloa,4368,3,19,9,8,75,43,32,66
Albion,4368,4,13,12,11,55,51,4,51
Airdrieon,4368,5,15,6,15,58,66,-8,51
Queen's Park,4368,6,14,8,14,44,49,-5,50
Peterhead,4368,7,11,10,15,48,61,-13,43
East Fife,4368,8,11,6,19,47,53,-6,39
Stranraer,4368,9,10,7,19,43,62,-19,37
Stenhousem'r,4368,10,7,6,23,41,76,-35,27
Livingston,4369,1,23,3,10,77,49,28,72
Peterhead,4369,2,18,7,11,52,41,11,61
Alloa,4369,3,17,7,12,65,44,21,58
Queen's Park,4369,4,15,9,12,43,43,0,54
Airdrieon,4369,5,15,8,13,59,58,1,53
Brechin,4369,6,14,10,12,59,54,5,52
Albion,4369,7,11,11,14,45,58,-13,44
East Fife,4369,8,11,8,17,48,47,1,41
Stranraer,4369,9,11,6,19,48,60,-12,39
Stenhousem'r,4369,10,6,9,21,45,87,-42,27
Airdrieon,4370,1,21,5,10,58,49,9,68
Livingston,4370,2,20,4,12,75,48,27,64
Brechin,4370,3,19,4,13,57,47,10,61
Alloa,4370,4,17,8,11,65,51,14,59
Queen's Park,4370,5,15,6,15,43,47,-4,51
East Fife,4370,6,14,8,14,49,46,3,50
Albion,4370,7,13,8,15,59,56,3,47
Peterhead,4370,8,11,11,14,44,54,-10,44
Stranraer,4370,9,10,5,21,45,61,-16,35
Stenhousem'r,4370,10,7,7,22,38,74,-36,28
Livingston,4371,1,24,3,9,91,43,48,75
Alloa,4371,2,17,12,7,72,36,36,63
Airdrieon,4371,3,14,10,12,56,59,-3,52
Queen's Park,4371,4,16,3,17,39,47,-8,51
Brechin,4371,5,14,8,14,41,52,-11,50
Peterhead,4371,6,12,11,13,45,51,-6,47
Albion,4371,7,13,5,18,58,67,-9,44
East Fife,4371,8,10,12,14,52,54,-2,42
Stranraer,4371,9,11,9,16,51,66,-15,42
Stenhousem'r,4371,10,9,7,20,51,81,-30,34
Livingston,4372,1,19,6,11,75,41,34,63
Alloa,4372,2,18,9,9,65,46,19,63
Airdrieon,4372,3,16,11,9,57,44,13,59
East Fife,4372,4,15,9,12,52,41,11,54
Brechin,4372,5,15,7,14,48,50,-2,52
Albion,4372,6,13,8,15,55,55,0,47
Stranraer,4372,7,13,6,17,48,62,-14,45
Peterhead,4372,8,12,4,20,45,63,-18,40
Queen's Park,4372,9,10,9,17,38,57,-19,39
Stenhousem'r,4372,10,9,11,16,48,72,-24,38
Alloa,4373,1,23,7,6,77,41,36,76
Albion,4373,2,19,7,10,59,39,20,64
Livingston,4373,3,18,4,14,64,50,14,58
Brechin,4373,4,17,7,12,55,57,-2,58
Airdrieon,4373,5,14,10,12,55,55,0,52
Peterhead,4373,6,15,6,15,45,49,-4,51
Queen's Park,4373,7,12,6,18,39,50,-11,42
East Fife,4373,8,11,8,17,52,58,-6,41
Stranraer,4373,9,11,7,18,58,63,-5,40
Stenhousem'r,4373,10,6,6,24,44,86,-42,24
Alloa,4374,1,22,3,11,76,50,26,69
Livingston,4374,2,16,10,10,67,56,11,58
Brechin,4374,3,17,7,12,54,48,6,58
Peterhead,4374,4,15,6,15,47,49,-2,51
East Fife,4374,5,13,10,13,47,41,6,49
Stranraer,4374,6,15,4,17,55,60,-5,49
Airdrieon,4374,7,14,6,16,48,49,-1,48
Albion,4374,8,13,8,15,57,54,3,47
Queen's Park,4374,9,12,8,16,38,54,-16,44
Stenhousem'r,4374,10,8,8,20,45,73,-28,32
Alloa,4375,1,19,8,9,62,45,17,65
Airdrieon,4375,2,20,5,11,64,48,16,65
Livingston,4375,3,18,5,13,64,46,18,59
Brechin,4375,4,18,5,13,50,43,7,59
Queen's Park,4375,5,15,9,12,41,38,3,54
Peterhead,4375,6,13,10,13,47,47,0,49
Albion,4375,7,11,13,12,45,47,-2,46
East Fife,4375,8,10,9,17,48,50,-2,39
Stranraer,4375,9,10,5,21,40,65,-25,35
Stenhousem'r,4375,10,7,9,20,50,82,-32,30
Alloa,4376,1,22,7,7,76,36,40,73
Livingston,4376,2,21,4,11,77,44,33,67
Airdrieon,4376,3,17,7,12,56,58,-2,58
Peterhead,4376,4,14,11,11,54,50,4,53
East Fife,4376,5,13,11,12,49,45,4,50
Brechin,4376,6,10,13,13,52,55,-3,43
Albion,4376,7,10,11,15,49,55,-6,41
Stranraer,4376,8,11,6,19,47,61,-14,39
Queen's Park,4376,9,10,9,17,26,50,-24,39
Stenhousem'r,4376,10,8,9,19,44,76,-32,33
Livingston,4377,1,22,6,8,81,47,34,72
Alloa,4377,2,18,6,12,75,49,26,60
Brechin,4377,3,17,6,13,49,41,8,57
Peterhead,4377,4,16,5,15,55,54,1,53
Airdrieon,4377,5,14,9,13,56,60,-4,51
Stranraer,4377,6,13,6,17,49,63,-14,45
East Fife,4377,7,10,12,14,51,56,-5,42
Albion,4377,8,11,9,16,43,50,-7,42
Queen's Park,4377,9,11,9,16,37,54,-17,42
Stenhousem'r,4377,10,8,12,16,48,70,-22,36
Livingston,4378,1,27,2,7,86,35,51,83
Alloa,4378,2,20,5,11,72,50,22,65
Brechin,4378,3,18,3,15,55,56,-1,57
Airdrieon,4378,4,17,5,14,58,61,-3,56
East Fife,4378,5,15,6,15,48,43,5,51
Albion,4378,6,14,8,14,53,54,-1,50
Stranraer,4378,7,14,5,17,54,54,0,47
Peterhead,4378,8,13,6,17,49,55,-6,45
Queen's Park,4378,9,12,4,20,32,52,-20,40
Stenhousem'r,4378,10,5,6,25,41,88,-47,21
Alloa,4379,1,19,7,10,75,45,30,64
Livingston,4379,2,20,4,12,71,53,18,64
Airdrieon,4379,3,17,8,11,65,56,9,59
Queen's Park,4379,4,16,5,15,41,49,-8,53
Albion,4379,5,13,11,12,55,54,1,50
East Fife,4379,6,13,10,13,50,43,7,49
Stranraer,4379,7,13,4,19,51,61,-10,43
Stenhousem'r,4379,8,11,9,16,55,68,-13,42
Peterhead,4379,9,11,8,17,46,59,-13,41
Brechin,4379,10,11,6,19,38,59,-21,39
Alloa,4380,1,22,6,8,77,34,43,72
Livingston,4380,2,19,5,12,77,50,27,62
Brechin,4380,3,18,7,11,48,37,11,61
Albion,4380,4,15,10,11,53,48,5,55
Peterhead,4380,5,13,9,14,49,56,-7,48
East Fife,4380,6,13,8,15,58,50,8,47
Stranraer,4380,7,12,9,15,54,65,-11,45
Airdrieon,4380,8,11,10,15,41,61,-20,43
Queen's Park,4380,9,9,6,21,26,53,-27,33
Stenhousem'r,4380,10,7,12,17,45,74,-29,33
Livingston,4381,1,21,5,10,77,52,25,68
Airdrieon,4381,2,20,4,12,64,48,16,64
Alloa,4381,3,17,10,9,62,38,24,61
Brechin,4381,4,16,5,15,53,54,-1,53
Albion,4381,5,14,7,15,45,47,-2,49
Stranraer,4381,6,14,6,16,57,61,-4,48
Peterhead,4381,7,11,10,15,44,54,-10,43
Queen's Park,4381,8,12,7,17,36,54,-18,43
East Fife,4381,9,12,6,18,50,54,-4,42
Stenhousem'r,4381,10,8,10,18,42,68,-26,34
Brechin,4382,1,23,5,8,59,30,29,74
Airdrieon,4382,2,19,10,7,72,49,23,67
Alloa,4382,3,16,9,11,68,53,15,57
Livingston,4382,4,17,5,14,68,58,10,56
Albion,4382,5,15,8,13,66,64,2,53
Peterhead,4382,6,13,8,15,50,57,-7,47
Queen's Park,4382,7,11,11,14,39,51,-12,44
East Fife,4382,8,11,7,18,58,60,-2,40
Stranraer,4382,9,10,6,20,46,65,-19,36
Stenhousem'r,4382,10,6,9,21,45,84,-39,27
Livingston,4383,1,20,8,8,88,49,39,68
Alloa,4383,2,19,7,10,74,53,21,64
Brechin,4383,3,19,7,10,51,38,13,64
Airdrieon,4383,4,17,6,13,59,58,1,57
Albion,4383,5,13,10,13,53,48,5,49
Stranraer,4383,6,13,7,16,51,57,-6,46
Peterhead,4383,7,12,8,16,48,57,-9,44
East Fife,4383,8,10,11,15,50,55,-5,41
Queen's Park,4383,9,10,9,17,34,56,-22,39
Stenhousem'r,4383,10,8,5,23,44,81,-37,29
Alloa,4384,1,21,5,10,70,36,34,68
Livingston,4384,2,17,8,11,68,47,21,59
Airdrieon,4384,3,16,10,10,59,54,5,58
Brechin,4384,4,16,3,17,54,53,1,51
Peterhead,4384,5,12,12,12,48,46,2,48
Stranraer,4384,6,13,7,16,53,61,-8,46
Albion,4384,7,11,11,14,49,60,-11,44
Stenhousem'r,4384,8,11,11,14,55,68,-13,44
Queen's Park,4384,9,12,8,16,29,42,-13,44
East Fife,4384,10,8,11,17,40,58,-18,35
Livingston,4385,1,19,7,10,76,46,30,64
Peterhead,4385,2,16,8,12,63,48,15,56
Alloa,4385,3,16,8,12,67,54,13,56
Airdrieon,4385,4,16,8,12,58,56,2,56
Queen's Park,4385,5,16,5,15,51,55,-4,53
Brechin,4385,6,14,7,15,52,59,-7,49
Stranraer,4385,7,14,6,16,54,60,-6,48
East Fife,4385,8,12,11,13,59,55,4,47
Albion,4385,9,12,7,17,49,63,-14,43
Stenhousem'r,4385,10,8,7,21,43,76,-33,31
Livingston,4386,1,19,6,11,77,50,27,63
Alloa,4386,2,18,9,9,68,41,27,63
Airdrieon,4386,3,17,12,7,61,41,20,63
Stranraer,4386,4,18,3,15,51,52,-1,57
Brechin,4386,5,17,5,14,50,50,0,56
Peterhead,4386,6,16,6,14,45,44,1,54
Queen's Park,4386,7,15,5,16,44,55,-11,50
Albion,4386,8,10,9,17,51,59,-8,39
East Fife,4386,9,9,7,20,45,52,-7,34
Stenhousem'r,4386,10,7,6,23,41,89,-48,27
Livingston,4387,1,22,4,10,92,51,41,70
Airdrieon,4387,2,19,7,10,67,61,6,64
Alloa,4387,3,17,11,8,75,51,24,62
Stranraer,4387,4,17,5,14,51,48,3,56
Brechin,4387,5,15,6,15,51,53,-2,51
East Fife,4387,6,13,8,15,50,50,0,47
Peterhead,4387,7,13,6,17,58,62,-4,45
Albion,4387,8,11,9,16,48,63,-15,42
Queen's Park,4387,9,11,9,16,42,60,-18,42
Stenhousem'r,4387,10,6,7,23,42,77,-35,25
Livingston,4388,1,20,7,9,84,51,33,67
Alloa,4388,2,19,6,11,66,44,22,63
Airdrieon,4388,3,18,6,12,62,50,12,60
Albion,4388,4,16,7,13,58,58,0,55
Peterhead,4388,5,16,5,15,53,50,3,53
Brechin,4388,6,14,8,14,46,52,-6,50
Queen's Park,4388,7,13,6,17,42,59,-17,45
Stranraer,4388,8,11,6,19,52,72,-20,39
East Fife,4388,9,9,10,17,51,59,-8,37
Stenhousem'r,4388,10,10,7,19,62,81,-19,37
Alloa,4389,1,21,5,10,71,42,29,68
Airdrieon,4389,2,21,4,11,66,53,13,67
Livingston,4389,3,20,4,12,65,42,23,64
East Fife,4389,4,16,8,12,61,40,21,56
Albion,4389,5,16,5,15,62,58,4,53
Stranraer,4389,6,16,4,16,56,59,-3,52
Peterhead,4389,7,14,7,15,51,56,-5,49
Brechin,4389,8,14,3,19,45,58,-13,45
Queen's Park,4389,9,12,5,19,47,62,-15,41
Stenhousem'r,4389,10,6,3,27,41,95,-54,21
Livingston,4390,1,24,1,11,81,44,37,73
Alloa,4390,2,19,7,10,66,42,24,64
Peterhead,4390,3,17,8,11,59,52,7,59
Brechin,4390,4,18,5,13,61,57,4,59
Airdrieon,4390,5,17,6,13,62,62,0,57
Albion,4390,6,13,6,17,55,50,5,45
East Fife,4390,7,12,8,16,49,52,-3,44
Queen's Park,4390,8,11,9,16,38,57,-19,42
Stenhousem'r,4390,9,10,6,20,52,79,-27,36
Stranraer,4390,10,8,6,22,38,66,-28,30
Airdrieon,4391,1,20,4,12,64,49,15,64
Livingston,4391,2,19,6,11,72,51,21,63
Alloa,4391,3,18,8,10,65,41,24,62
Albion,4391,4,17,8,11,58,49,9,59
Queen's Park,4391,5,15,7,14,49,46,3,52
Brechin,4391,6,13,8,15,48,57,-9,47
East Fife,4391,7,12,7,17,50,49,1,43
Peterhead,4391,8,12,7,17,41,51,-10,43
Stranraer,4391,9,11,5,20,43,62,-19,38
Stenhousem'r,4391,10,9,8,19,46,81,-35,35
Livingston,4392,1,23,6,7,77,38,39,75
Alloa,4392,2,21,8,7,80,40,40,71
Brechin,4392,3,20,5,11,57,47,10,65
Peterhead,4392,4,16,4,16,52,54,-2,52
Airdrieon,4392,5,15,7,14,46,51,-5,52
East Fife,4392,6,12,7,17,48,53,-5,43
Albion,4392,7,11,9,16,54,68,-14,42
Stranraer,4392,8,10,6,20,47,64,-17,36
Queen's Park,4392,9,10,5,21,26,55,-29,35
Stenhousem'r,4392,10,6,15,15,53,70,-17,33
Livingston,4393,1,23,4,9,85,41,44,73
Airdrieon,4393,2,17,11,8,59,52,7,62
Alloa,4393,3,16,11,9,63,48,15,59
Albion,4393,4,14,11,11,57,49,8,53
Peterhead,4393,5,14,6,16,52,51,1,48
Stranraer,4393,6,13,6,17,47,55,-8,45
Brechin,4393,7,12,9,15,49,59,-10,45
Stenhousem'r,4393,8,11,7,18,45,74,-29,40
East Fife,4393,9,11,6,19,49,49,0,39
Queen's Park,4393,10,10,7,19,31,59,-28,37
Alloa,4394,1,21,8,7,80,37,43,71
Livingston,4394,2,20,6,10,72,55,17,66
Airdrieon,4394,3,17,6,13,61,59,2,57
Stranraer,4394,4,16,3,17,52,51,1,51
Brechin,4394,5,15,5,16,45,48,-3,50
Peterhead,4394,6,14,7,15,57,67,-10,49
East Fife,4394,7,13,9,14,60,48,12,48
Albion,4394,8,13,6,17,49,58,-9,45
Queen's Park,4394,9,11,8,17,30,50,-20,41
Stenhousem'r,4394,10,8,6,22,35,68,-33,30
Livingston,4395,1,22,5,9,84,49,35,71
Alloa,4395,2,17,10,9,61,40,21,61
Airdrieon,4395,3,17,6,13,51,43,8,57
Brechin,4395,4,16,9,11,53,50,3,57
Peterhead,4395,5,16,6,14,50,49,1,54
Queen's Park,4395,6,12,10,14,41,50,-9,46
Albion,4395,7,10,13,13,48,56,-8,43
East Fife,4395,8,9,12,15,52,54,-2,39
Stranraer,4395,9,10,6,20,51,73,-22,36
Stenhousem'r,4395,10,9,7,20,49,76,-27,34
Livingston,4396,1,22,6,8,86,49,37,72
Brechin,4396,2,19,6,11,61,46,15,63
Alloa,4396,3,17,8,11,74,52,22,59
Airdrieon,4396,4,18,5,13,56,48,8,59
Albion,4396,5,14,9,13,57,56,1,51
Peterhead,4396,6,13,7,16,46,60,-14,46
Queen's Park,4396,7,12,9,15,34,48,-14,45
East Fife,4396,8,11,10,15,44,42,2,43
Stranraer,4396,9,11,6,19,50,64,-14,39
Stenhousem'r,4396,10,6,8,22,42,85,-43,26
Livingston,4397,1,23,5,8,83,46,37,74
Alloa,4397,2,17,8,11,73,48,25,59
Airdrieon,4397,3,17,6,13,59,52,7,57
Brechin,4397,4,17,4,15,51,51,0,55
Peterhead,4397,5,15,6,15,51,55,-4,51
East Fife,4397,6,12,10,14,47,47,0,46
Queen's Park,4397,7,12,9,15,48,59,-11,45
Stranraer,4397,8,13,6,17,46,57,-11,45
Albion,4397,9,10,8,18,45,58,-13,38
Stenhousem'r,4397,10,9,8,19,44,74,-30,35
Alloa,4398,1,21,5,10,71,42,29,68
Brechin,4398,2,19,5,12,57,49,8,62
Livingston,4398,3,18,4,14,69,51,18,58
Airdrieon,4398,4,17,7,12,65,53,12,58
Albion,4398,5,16,8,12,63,49,14,56
Queen's Park,4398,6,13,9,14,37,47,-10,48
Peterhead,4398,7,11,11,14,41,52,-11,44
East Fife,4398,8,11,9,16,42,50,-8,42
Stranraer,4398,9,13,2,21,49,67,-18,41
Stenhousem'r,4398,10,8,6,22,45,79,-34,30
Alloa,4399,1,21,7,8,73,42,31,70
Livingston,4399,2,18,5,13,68,59,9,59
Airdrieon,4399,3,16,9,11,58,57,1,57
Stranraer,4399,4,16,6,14,60,53,7,54
Brechin,4399,5,15,8,13,47,43,4,53
Peterhead,4399,6,12,11,13,48,50,-2,47
Albion,4399,7,12,10,14,46,47,-1,46
Queen's Park,4399,8,12,9,15,36,47,-11,45
East Fife,4399,9,11,10,15,43,41,2,43
Stenhousem'r,4399,10,5,9,22,46,86,-40,24
Livingston,4400,1,19,7,10,75,53,22,64
Alloa,4400,2,17,11,8,65,40,25,62
Brechin,4400,3,14,12,10,43,46,-3,54
Airdrieon,4400,4,14,11,11,47,43,4,53
Albion,4400,5,16,3,17,58,53,5,51
East Fife,4400,6,13,11,12,58,50,8,50
Peterhead,4400,7,12,11,13,46,51,-5,47
Stranraer,4400,8,13,6,17,58,64,-6,45
Queen's Park,4400,9,11,12,13,40,52,-12,45
Stenhousem'r,4400,10,5,8,23,39,77,-38,23
Livingston,4401,1,22,3,11,82,47,35,69
Alloa,4401,2,20,6,10,64,40,24,66
Brechin,4401,3,17,7,12,56,47,9,58
Airdrieon,4401,4,17,7,12,55,51,4,58
Peterhead,4401,5,16,7,13,53,44,9,55
Queen's Park,4401,6,13,8,15,40,49,-9,47
Albion,4401,7,12,8,16,44,53,-9,44
Stenhousem'r,4401,8,11,7,18,56,84,-28,40
Stranraer,4401,9,10,6,20,42,61,-19,36
East Fife,4401,10,6,13,17,37,53,-16,31
Alloa,4402,1,20,8,8,79,46,33,68
Livingston,4402,2,18,8,10,70,48,22,62
Albion,4402,3,16,8,12,53,53,0,56
Airdrieon,4402,4,16,6,14,69,58,11,54
Brechin,4402,5,16,6,14,55,53,2,54
Queen's Park,4402,6,16,6,14,48,53,-5,54
Stranraer,4402,7,14,5,17,50,56,-6,47
East Fife,4402,8,11,9,16,50,47,3,42
Peterhead,4402,9,10,9,17,33,48,-15,39
Stenhousem'r,4402,10,6,9,21,39,84,-45,27
Livingston,4403,1,24,3,9,78,45,33,75
Alloa,4403,2,18,9,9,76,42,34,63
Brechin,4403,3,16,7,13,51,60,-9,55
Airdrieon,4403,4,15,6,15,60,58,2,51
Peterhead,4403,5,14,8,14,49,50,-1,50
Albion,4403,6,13,9,14,54,55,-1,48
Stranraer,4403,7,15,3,18,45,53,-8,48
Queen's Park,4403,8,12,9,15,42,57,-15,45
East Fife,4403,9,10,8,18,55,55,0,38
Stenhousem'r,4403,10,9,6,21,48,83,-35,33
Alloa,4404,1,20,8,8,86,45,41,68
Albion,4404,2,18,8,10,59,46,13,62
Livingston,4404,3,18,7,11,70,51,19,61
Brechin,4404,4,17,5,14,54,61,-7,56
Airdrieon,4404,5,15,8,13,56,62,-6,53
Peterhead,4404,6,12,8,16,51,54,-3,44
Stranraer,4404,7,13,5,18,52,65,-13,44
Queen's Park,4404,8,11,7,18,35,52,-17,40
Stenhousem'r,4404,9,11,7,18,51,76,-25,40
East Fife,4404,10,9,9,18,55,57,-2,36
Alloa,4405,1,20,8,8,70,44,26,68
Airdrieon,4405,2,21,5,10,66,51,15,68
Livingston,4405,3,17,5,14,73,55,18,56
Brechin,4405,4,16,6,14,52,54,-2,54
Peterhead,4405,5,13,11,12,57,51,6,50
Stranraer,4405,6,14,6,16,50,56,-6,48
East Fife,4405,7,9,15,12,45,48,-3,42
Albion,4405,8,12,6,18,48,58,-10,42
Queen's Park,4405,9,11,9,16,42,53,-11,42
Stenhousem'r,4405,10,7,9,20,42,75,-33,30
Livingston,4406,1,20,8,8,83,51,32,68
Peterhead,4406,2,21,4,11,58,48,10,67
Airdrieon,4406,3,20,4,12,70,55,15,64
Alloa,4406,4,17,8,11,75,55,20,59
Brechin,4406,5,15,10,11,55,54,1,55
Queen's Park,4406,6,14,7,15,52,56,-4,49
Albion,4406,7,13,7,16,60,60,0,46
East Fife,4406,8,8,10,18,46,60,-14,34
Stranraer,4406,9,9,5,22,41,65,-24,32
Stenhousem'r,4406,10,7,9,20,49,85,-36,30
Alloa,4407,1,20,7,9,71,46,25,67
Livingston,4407,2,20,4,12,84,57,27,64
Airdrieon,4407,3,15,12,9,52,48,4,57
Albion,4407,4,16,7,13,63,49,14,55
Brechin,4407,5,11,13,12,43,47,-4,46
East Fife,4407,6,11,12,13,47,47,0,45
Queen's Park,4407,7,12,8,16,36,51,-15,44
Peterhead,4407,8,11,10,15,45,55,-10,43
Stenhousem'r,4407,9,9,10,17,47,69,-22,37
Stranraer,4407,10,9,9,18,49,68,-19,36
Alloa,4408,1,21,9,6,73,39,34,72
Livingston,4408,2,23,2,11,78,44,34,71
Albion,4408,3,14,8,14,59,60,-1,50
Airdrieon,4408,4,13,9,14,58,61,-3,48
Queen's Park,4408,5,14,6,16,39,50,-11,48
Brechin,4408,6,12,11,13,45,52,-7,47
Stranraer,4408,7,14,4,18,46,61,-15,46
Peterhead,4408,8,11,10,15,43,51,-8,43
East Fife,4408,9,10,11,15,47,43,4,41
Stenhousem'r,4408,10,8,10,18,43,70,-27,34
Livingston,4409,1,21,3,12,77,56,21,66
Alloa,4409,2,15,14,7,68,51,17,59
Airdrieon,4409,3,17,7,12,59,54,5,58
Brechin,4409,4,17,3,16,52,51,1,54
Peterhead,4409,5,14,11,11,53,48,5,53
Albion,4409,6,15,7,14,56,50,6,52
Queen's Park,4409,7,14,5,17,38,46,-8,47
East Fife,4409,8,10,12,14,48,51,-3,42
Stranraer,4409,9,11,7,18,49,56,-7,40
Stenhousem'r,4409,10,9,5,22,43,80,-37,32
Livingston,4410,1,26,4,6,85,39,46,82
Alloa,4410,2,19,7,10,73,45,28,64
Albion,4410,3,16,7,13,53,52,1,55
Stranraer,4410,4,16,4,16,57,59,-2,52
Peterhead,4410,5,15,6,15,51,56,-5,51
Brechin,4410,6,13,7,16,52,58,-6,46
Airdrieon,4410,7,13,7,16,53,64,-11,46
Queen's Park,4410,8,12,7,17,39,54,-15,43
East Fife,4410,9,9,9,18,45,51,-6,36
Stenhousem'r,4410,10,9,6,21,44,74,-30,33
Alloa,4411,1,20,8,8,71,43,28,68
Airdrieon,4411,2,19,10,7,67,44,23,67
Livingston,4411,3,20,5,11,72,49,23,65
Brechin,4411,4,16,5,15,52,56,-4,53
East Fife,4411,5,14,8,14,55,44,11,50
Peterhead,4411,6,13,8,15,42,47,-5,47
Albion,4411,7,12,10,14,59,58,1,46
Queen's Park,4411,8,12,8,16,49,59,-10,44
Stranraer,4411,9,9,8,19,43,63,-20,35
Stenhousem'r,4411,10,7,6,23,42,89,-47,27
Livingston,4412,1,22,5,9,81,46,35,71
Alloa,4412,2,17,10,9,61,47,14,61
Airdrieon,4412,3,17,7,12,56,54,2,58
Brechin,4412,4,14,11,11,46,45,1,53
Peterhead,4412,5,14,8,14,45,50,-5,50
Queen's Park,4412,6,12,11,13,32,49,-17,47
East Fife,4412,7,11,10,15,49,47,2,43
Albion,4412,8,11,9,16,54,54,0,42
Stranraer,4412,9,12,5,19,49,59,-10,41
Stenhousem'r,4412,10,8,8,20,45,67,-22,32
Livingston,4413,1,23,3,10,90,53,37,72
Airdrieon,4413,2,20,5,11,71,57,14,65
Alloa,4413,3,19,5,12,65,41,24,62
Brechin,4413,4,15,9,12,62,55,7,54
Queen's Park,4413,5,15,5,16,41,55,-14,50
Stranraer,4413,6,15,4,17,60,65,-5,49
Albion,4413,7,14,6,16,53,58,-5,48
Peterhead,4413,8,12,8,16,51,60,-9,44
East Fife,4413,9,8,9,19,42,58,-16,33
Stenhousem'r,4413,10,8,8,20,49,82,-33,32
Livingston,4414,1,22,3,11,76,46,30,69
Alloa,4414,2,18,6,12,74,45,29,60
Airdrieon,4414,3,17,9,10,50,42,8,60
Albion,4414,4,14,12,10,57,52,5,54
Brechin,4414,5,15,6,15,50,43,7,51
Queen's Park,4414,6,14,7,15,43,53,-10,49
Peterhead,4414,7,12,11,13,41,55,-14,47
Stranraer,4414,8,13,5,18,51,64,-13,44
East Fife,4414,9,10,8,18,48,56,-8,38
Stenhousem'r,4414,10,7,9,20,44,78,-34,30
Livingston,4415,1,19,7,10,66,44,22,64
Alloa,4415,2,17,8,11,63,40,23,59
Brechin,4415,3,17,8,11,46,40,6,59
Peterhead,4415,4,15,10,11,46,39,7,55
Airdrieon,4415,5,15,10,11,52,51,1,55
Stranraer,4415,6,16,6,14,57,47,10,54
Queen's Park,4415,7,13,9,14,36,48,-12,48
Albion,4415,8,12,7,17,51,58,-7,43
East Fife,4415,9,8,12,16,48,55,-7,36
Stenhousem'r,4415,10,4,11,21,39,82,-43,23
Livingston,4416,1,17,11,8,66,48,18,62
Alloa,4416,2,16,13,7,68,38,30,61
Airdrieon,4416,3,17,10,9,67,50,17,61
Brechin,4416,4,15,12,9,58,49,9,57
East Fife,4416,5,15,10,11,52,49,3,55
Peterhead,4416,6,14,6,16,47,57,-10,48
Albion,4416,7,13,8,15,53,54,-1,47
Queen's Park,4416,8,12,5,19,39,52,-13,41
Stranraer,4416,9,9,11,16,45,61,-16,38
Stenhousem'r,4416,10,5,8,23,43,80,-37,23
Livingston,4417,1,22,2,12,76,46,30,68
Brechin,4417,2,18,8,10,52,44,8,62
Airdrieon,4417,3,17,6,13,57,53,4,57
Peterhead,4417,4,15,8,13,53,47,6,53
Queen's Park,4417,5,15,6,15,42,46,-4,51
Albion,4417,6,14,8,14,54,46,8,50
Alloa,4417,7,13,9,14,54,57,-3,48
East Fife,4417,8,13,5,18,51,53,-2,44
Stranraer,4417,9,11,6,19,48,64,-16,39
Stenhousem'r,4417,10,10,6,20,47,78,-31,36
Alloa,4418,1,22,8,6,76,40,36,74
Livingston,4418,2,18,6,12,76,48,28,60
Airdrieon,4418,3,17,7,12,71,55,16,58
Peterhead,4418,4,13,9,14,57,60,-3,48
Stranraer,4418,5,13,8,15,52,62,-10,47
Albion,4418,6,14,5,17,51,61,-10,47
Brechin,4418,7,13,7,16,43,53,-10,46
Stenhousem'r,4418,8,12,8,16,57,75,-18,44
East Fife,4418,9,11,9,16,48,52,-4,42
Queen's Park,4418,10,8,11,17,35,60,-25,35
Livingston,4419,1,23,4,9,77,47,30,73
Albion,4419,2,17,7,12,63,52,11,58
Airdrieon,4419,3,16,8,12,67,59,8,56
Brechin,4419,4,14,11,11,49,45,4,53
Queen's Park,4419,5,15,8,13,36,42,-6,53
Peterhead,4419,6,15,6,15,59,57,2,51
Alloa,4419,7,13,11,12,65,48,17,50
Stranraer,4419,8,11,9,16,46,63,-17,42
East Fife,4419,9,7,11,18,51,58,-7,32
Stenhousem'r,4419,10,9,5,22,37,79,-42,32
Livingston,4420,1,24,5,7,78,38,40,77
Alloa,4420,2,21,7,8,66,40,26,70
Airdrieon,4420,3,17,7,12,58,50,8,58
Albion,4420,4,15,8,13,54,49,5,53
Brechin,4420,5,16,5,15,47,44,3,53
Stranraer,4420,6,14,8,14,52,51,1,50
Peterhead,4420,7,13,6,17,48,63,-15,45
East Fife,4420,8,10,8,18,43,56,-13,38
Queen's Park,4420,9,10,7,19,35,53,-18,37
Stenhousem'r,4420,10,6,7,23,43,80,-37,25
Alloa,4421,1,20,10,6,66,32,34,70
Brechin,4421,2,19,6,11,55,44,11,63
Livingston,4421,3,19,5,12,69,52,17,62
Airdrieon,4421,4,17,6,13,55,52,3,57
Peterhead,4421,5,13,10,13,63,51,12,49
Albion,4421,6,14,6,16,52,52,0,48
Queen's Park,4421,7,13,8,15,39,49,-10,47
East Fife,4421,8,11,11,14,58,55,3,44
Stranraer,4421,9,11,5,20,50,65,-15,38
Stenhousem'r,4421,10,7,5,24,43,98,-55,26
Alloa,4422,1,22,6,8,71,44,27,72
Livingston,4422,2,21,6,9,85,49,36,69
Airdrieon,4422,3,17,6,13,60,55,5,57
Albion,4422,4,17,6,13,59,55,4,57
Stranraer,4422,5,17,5,14,58,55,3,56
Brechin,4422,6,15,10,11,48,44,4,55
Peterhead,4422,7,13,7,16,54,61,-7,46
Queen's Park,4422,8,8,8,20,33,59,-26,32
East Fife,4422,9,7,9,20,46,58,-12,30
Stenhousem'r,4422,10,5,13,18,43,77,-34,28
Livingston,4423,1,20,6,10,83,47,36,66
Airdrieon,4423,2,18,7,11,61,59,2,61
Alloa,4423,3,15,11,10,64,46,18,56
Albion,4423,4,11,17,8,53,44,9,50
Stranraer,4423,5,14,7,15,65,63,2,49
Brechin,4423,6,13,9,14,40,49,-9,48
East Fife,4423,7,12,11,13,55,54,1,47
Queen's Park,4423,8,11,11,14,46,59,-13,44
Peterhead,4423,9,9,9,18,45,64,-19,36
Stenhousem'r,4423,10,9,8,19,53,80,-27,35
Livingston,4424,1,21,5,10,72,49,23,68
Brechin,4424,2,19,7,10,60,48,12,64
Alloa,4424,3,17,10,9,56,40,16,61
Airdrieon,4424,4,16,7,13,59,52,7,55
Albion,4424,5,14,10,12,49,45,4,52
East Fife,4424,6,13,7,16,48,47,1,46
Queen's Park,4424,7,13,7,16,38,46,-8,46
Stranraer,4424,8,13,5,18,48,61,-13,44
Peterhead,4424,9,12,6,18,52,63,-11,42
Stenhousem'r,4424,10,8,4,24,47,78,-31,28
Alloa,4425,1,22,7,7,70,37,33,73
Brechin,4425,2,20,7,9,55,41,14,67
Livingston,4425,3,17,7,12,59,40,19,58
Peterhead,4425,4,15,10,11,50,48,2,55
Airdrieon,4425,5,16,4,16,60,55,5,52
Albion,4425,6,12,10,14,51,58,-7,46
Queen's Park,4425,7,13,6,17,41,53,-12,45
East Fife,4425,8,10,10,16,43,46,-3,40
Stranraer,4425,9,10,6,20,41,57,-16,36
Stenhousem'r,4425,10,7,9,20,39,74,-35,30
Airdrieon,4426,1,19,8,9,55,49,6,65
Livingston,4426,2,19,6,11,75,51,24,63
Alloa,4426,3,16,11,9,62,42,20,59
Peterhead,4426,4,15,10,11,50,42,8,55
Brechin,4426,5,16,5,15,54,54,0,53
Queen's Park,4426,6,13,9,14,43,53,-10,48
Albion,4426,7,13,6,17,55,61,-6,45
East Fife,4426,8,10,10,16,49,55,-6,40
Stranraer,4426,9,11,7,18,51,58,-7,40
Stenhousem'r,4426,10,9,6,21,43,72,-29,33
Livingston,4427,1,23,3,10,72,45,27,72
Alloa,4427,2,17,12,7,63,38,25,63
Airdrieon,4427,3,14,11,11,56,51,5,53
Brechin,4427,4,14,10,12,47,47,0,52
Peterhead,4427,5,13,9,14,49,54,-5,48
Stranraer,4427,6,13,7,16,55,56,-1,46
Albion,4427,7,12,9,15,48,58,-10,45
Queen's Park,4427,8,11,10,15,43,52,-9,43
East Fife,4427,9,9,14,13,42,48,-6,41
Stenhousem'r,4427,10,7,9,20,45,71,-26,30
Livingston,4428,1,19,8,9,75,46,29,65
Brechin,4428,2,18,7,11,56,55,1,61
Alloa,4428,3,16,11,9,63,45,18,59
Stranraer,4428,4,17,6,13,55,52,3,57
Albion,4428,5,15,9,12,57,52,5,54
Airdrieon,4428,6,15,7,14,55,52,3,52
Peterhead,4428,7,11,10,15,43,51,-8,43
Queen's Park,4428,8,11,7,18,39,54,-15,40
East Fife,4428,9,10,9,17,46,50,-4,39
Stenhousem'r,4428,10,6,10,20,40,72,-32,28
Livingston,4429,1,21,3,12,76,58,18,66
Airdrieon,4429,2,18,8,10,58,42,16,62
Brechin,4429,3,17,6,13,50,48,2,57
Alloa,4429,4,15,10,11,60,45,15,55
Albion,4429,5,15,10,11,60,53,7,55
Peterhead,4429,6,13,12,11,57,50,7,51
Stranraer,4429,7,13,8,15,47,51,-4,47
Queen's Park,4429,8,11,7,18,36,57,-21,40
East Fife,4429,9,9,10,17,50,52,-2,37
Stenhousem'r,4429,10,8,6,22,39,77,-38,30
Livingston,4430,1,22,3,11,72,45,27,69
Alloa,4430,2,20,8,8,69,41,28,68
Airdrieon,4430,3,20,6,10,71,48,23,66
Brechin,4430,4,20,5,11,56,43,13,65
Stranraer,4430,5,13,7,16,45,54,-9,46
Peterhead,4430,6,12,9,15,52,54,-2,45
Queen's Park,4430,7,12,8,16,38,51,-13,44
Albion,4430,8,10,9,17,51,64,-13,39
East Fife,4430,9,10,7,19,43,54,-11,37
Stenhousem'r,4430,10,7,6,23,43,86,-43,27
Livingston,4431,1,23,3,10,79,49,30,72
Alloa,4431,2,20,7,9,69,44,25,67
Brechin,4431,3,19,5,12,48,47,1,62
Albion,4431,4,16,7,13,56,49,7,55
Airdrieon,4431,5,15,9,12,56,59,-3,54
Peterhead,4431,6,13,9,14,51,52,-1,48
Queen's Park,4431,7,12,8,16,39,50,-11,44
East Fife,4431,8,10,12,14,46,45,1,42
Stranraer,4431,9,10,3,23,42,62,-20,33
Stenhousem'r,4431,10,6,9,21,48,77,-29,27
Livingston,4432,1,20,5,11,71,47,24,65
Airdrieon,4432,2,19,5,12,60,46,14,62
Alloa,4432,3,18,5,13,68,50,18,59
East Fife,4432,4,17,7,12,55,47,8,58
Stranraer,4432,5,15,8,13,55,52,3,53
Brechin,4432,6,15,5,16,47,49,-2,50
Albion,4432,7,13,8,15,51,51,0,47
Peterhead,4432,8,10,9,17,44,57,-13,39
Queen's Park,4432,9,10,8,18,35,59,-24,38
Stenhousem'r,4432,10,8,10,18,44,72,-28,34
Livingston,4433,1,25,4,7,78,38,40,79
Brechin,4433,2,18,7,11,54,49,5,61
Alloa,4433,3,17,7,12,63,42,21,58
Airdrieon,4433,4,16,6,14,56,55,1,54
Albion,4433,5,14,11,11,51,46,5,53
Peterhead,4433,6,14,10,12,48,45,3,52
Queen's Park,4433,7,11,6,19,33,57,-24,39
East Fife,4433,8,10,8,18,51,60,-9,38
Stranraer,4433,9,10,8,18,44,58,-14,38
Stenhousem'r,4433,10,8,7,21,43,71,-28,31
Livingston,4434,1,22,7,7,75,42,33,73
Alloa,4434,2,18,5,13,67,50,17,59
Airdrieon,4434,3,16,8,12,62,57,5,56
Brechin,4434,4,16,7,13,53,48,5,55
Peterhead,4434,5,16,5,15,48,56,-8,53
Queen's Park,4434,6,13,10,13,49,46,3,49
East Fife,4434,7,12,8,16,48,45,3,44
Albion,4434,8,11,11,14,53,62,-9,44
Stranraer,4434,9,10,7,19,45,61,-16,37
Stenhousem'r,4434,10,8,8,20,50,83,-33,32
Alloa,4435,1,18,7,11,69,45,24,61
Peterhead,4435,2,17,10,9,59,46,13,61
Airdrieon,4435,3,17,5,14,67,63,4,56
Livingston,4435,4,16,6,14,69,55,14,54
Brechin,4435,5,15,5,16,57,62,-5,50
East Fife,4435,6,15,5,16,52,60,-8,50
Queen's Park,4435,7,13,9,14,39,49,-10,48
Stranraer,4435,8,14,5,17,57,59,-2,47
Albion,4435,9,10,13,13,54,58,-4,43
Stenhousem'r,4435,10,8,9,19,46,72,-26,33
Livingston,4436,1,20,4,12,76,50,26,64
Alloa,4436,2,17,6,13,62,52,10,57
Albion,4436,3,15,12,9,62,55,7,57
Airdrieon,4436,4,16,8,12,56,52,4,56
Peterhead,4436,5,15,6,15,48,45,3,51
Brechin,4436,6,13,9,14,60,58,2,48
Queen's Park,4436,7,13,9,14,54,64,-10,48
Stranraer,4436,8,13,8,15,58,60,-2,47
East Fife,4436,9,11,10,15,53,62,-9,43
Stenhousem'r,4436,10,6,10,20,47,78,-31,28
Livingston,4437,1,20,9,7,74,42,32,69
Alloa,4437,2,15,11,10,67,44,23,56
Airdrieon,4437,3,16,7,13,59,58,1,55
Brechin,4437,4,15,8,13,49,48,1,53
Albion,4437,5,15,7,14,55,50,5,52
East Fife,4437,6,14,8,14,63,56,7,50
Peterhead,4437,7,15,5,16,49,59,-10,50
Stranraer,4437,8,13,7,16,48,56,-8,46
Queen's Park,4437,9,9,8,19,36,57,-21,35
Stenhousem'r,4437,10,8,10,18,48,78,-30,34
Brechin,4438,1,21,4,11,53,38,15,67
Albion,4438,2,19,7,10,62,49,13,64
Livingston,4438,3,18,5,13,71,50,21,59
Airdrieon,4438,4,17,8,11,56,43,13,59
Peterhead,4438,5,17,5,14,51,49,2,56
Alloa,4438,6,12,12,12,59,48,11,48
Queen's Park,4438,7,12,6,18,32,49,-17,42
East Fife,4438,8,10,11,15,44,46,-2,41
Stranraer,4438,9,9,9,18,47,63,-16,36
Stenhousem'r,4438,10,8,7,21,41,81,-40,31
Livingston,4439,1,25,3,8,92,52,40,78
Alloa,4439,2,21,8,7,81,46,35,71
Peterhead,4439,3,17,8,11,66,51,15,59
Airdrieon,4439,4,16,8,12,60,55,5,56
Brechin,4439,5,15,5,16,43,56,-13,50
East Fife,4439,6,10,14,12,57,52,5,44
Albion,4439,7,12,8,16,52,59,-7,44
Queen's Park,4439,8,11,8,17,43,60,-17,41
Stranraer,4439,9,11,6,19,44,61,-17,39
Stenhousem'r,4439,10,5,6,25,40,86,-46,21
Brechin,4440,1,20,7,9,53,38,15,67
Livingston,4440,2,20,5,11,82,50,32,65
Airdrieon,4440,3,19,6,11,70,51,19,63
Alloa,4440,4,16,9,11,68,44,24,57
Albion,4440,5,12,13,11,53,55,-2,49
Peterhead,4440,6,12,9,15,48,50,-2,45
Stranraer,4440,7,13,6,17,52,62,-10,45
Queen's Park,4440,8,11,5,20,30,61,-31,38
Stenhousem'r,4440,9,10,7,19,50,86,-36,37
East Fife,4440,10,9,9,18,42,51,-9,36
Livingston,4441,1,20,5,11,70,45,25,65
Alloa,4441,2,18,8,10,78,46,32,62
Queen's Park,4441,3,17,6,13,44,45,-1,57
Brechin,4441,4,16,8,12,55,52,3,56
Airdrieon,4441,5,13,9,14,45,55,-10,48
East Fife,4441,6,12,10,14,44,39,5,46
Albion,4441,7,12,10,14,49,52,-3,46
Peterhead,4441,8,12,9,15,44,55,-11,45
Stranraer,4441,9,12,5,19,55,60,-5,41
Stenhousem'r,4441,10,10,6,20,50,85,-35,36
Livingston,4442,1,22,3,11,79,45,34,69
Brechin,4442,2,20,8,8,61,42,19,68
Airdrieon,4442,3,20,4,12,61,50,11,64
Alloa,4442,4,18,7,11,61,47,14,61
Albion,4442,5,16,5,15,48,48,0,53
Queen's Park,4442,6,15,8,13,42,49,-7,53
East Fife,4442,7,10,8,18,46,51,-5,38
Peterhead,4442,8,9,9,18,36,51,-15,36
Stranraer,4442,9,10,5,21,39,62,-23,35
Stenhousem'r,4442,10,6,11,19,51,79,-28,29
Alloa,4443,1,18,7,11,65,48,17,61
Brechin,4443,2,19,4,13,51,35,16,61
Airdrieon,4443,3,18,7,11,62,54,8,61
Livingston,4443,4,17,3,16,61,52,9,54
Queen's Park,4443,5,14,9,13,53,53,0,51
East Fife,4443,6,14,7,15,48,46,2,49
Albion,4443,7,13,9,14,47,50,-3,48
Peterhead,4443,8,13,6,17,50,64,-14,45
Stenhousem'r,4443,9,9,11,16,52,70,-18,38
Stranraer,4443,10,10,7,19,42,59,-17,37
Livingston,4444,1,22,5,9,83,49,34,71
Airdrieon,4444,2,18,6,12,63,48,15,60
Alloa,4444,3,17,8,11,68,50,18,59
Brechin,4444,4,17,8,11,49,42,7,59
East Fife,4444,5,15,9,12,59,43,16,54
Peterhead,4444,6,13,11,12,49,50,-1,50
Albion,4444,7,10,9,17,39,52,-13,39
Stranraer,4444,8,12,3,21,49,63,-14,39
Queen's Park,4444,9,9,11,16,34,57,-23,38
Stenhousem'r,4444,10,9,6,21,50,89,-39,33
Livingston,4445,1,25,5,6,83,37,46,80
Albion,4445,2,20,5,11,58,44,14,65
Alloa,4445,3,19,7,10,71,41,30,64
Airdrieon,4445,4,19,5,12,62,51,11,62
Brechin,4445,5,14,7,15,56,55,1,49
Stranraer,4445,6,14,6,16,56,63,-7,48
Queen's Park,4445,7,13,3,20,37,53,-16,42
Peterhead,4445,8,12,4,20,39,66,-27,40
East Fife,4445,9,10,9,17,56,57,-1,39
Stenhousem'r,4445,10,6,5,25,35,86,-51,23
Livingston,4446,1,24,5,7,82,40,42,77
Brechin,4446,2,19,8,9,62,43,19,65
Airdrieon,4446,3,15,11,10,68,54,14,56
Alloa,4446,4,16,6,14,61,51,10,54
Albion,4446,5,14,10,12,48,44,4,52
East Fife,4446,6,14,8,14,56,44,12,50
Queen's Park,4446,7,12,9,15,45,51,-6,45
Peterhead,4446,8,10,11,15,49,65,-16,41
Stranraer,4446,9,9,8,19,41,63,-22,35
Stenhousem'r,4446,10,4,10,22,30,87,-57,22
Alloa,4447,1,19,9,8,71,50,21,66
Airdrieon,4447,2,17,9,10,69,53,16,60
Livingston,4447,3,18,5,13,80,50,30,59
Brechin,4447,4,18,4,14,55,49,6,58
Peterhead,4447,5,16,7,13,57,58,-1,55
East Fife,4447,6,14,7,15,54,50,4,49
Queen's Park,4447,7,14,4,18,41,62,-21,46
Albion,4447,8,12,9,15,49,55,-6,45
Stranraer,4447,9,12,5,19,56,68,-12,41
Stenhousem'r,4447,10,7,7,22,47,84,-37,28
Livingston,4448,1,23,3,10,73,53,20,72
Brechin,4448,2,17,6,13,52,53,-1,57
Peterhead,4448,3,14,13,9,56,50,6,55
Alloa,4448,4,13,14,9,56,39,17,53
Queen's Park,4448,5,15,6,15,43,43,0,51
Stranraer,4448,6,14,8,14,51,55,-4,50
Albion,4448,7,12,8,16,47,48,-1,44
Airdrieon,4448,8,12,6,18,49,63,-14,42
East Fife,4448,9,10,9,17,57,56,1,39
Stenhousem'r,4448,10,10,7,19,44,68,-24,37
Livingston,4449,1,20,4,12,71,57,14,64
Airdrieon,4449,2,18,5,13,54,46,8,59
Alloa,4449,3,17,7,12,62,43,19,58
Stranraer,4449,4,16,5,15,55,48,7,53
Peterhead,4449,5,15,5,16,47,53,-6,50
Brechin,4449,6,15,4,17,42,45,-3,49
Albion,4449,7,13,8,15,57,56,1,47
East Fife,4449,8,12,10,14,47,49,-2,46
Queen's Park,4449,9,12,8,16,35,44,-9,44
Stenhousem'r,4449,10,11,6,19,43,72,-29,39
Airdrieon,4450,1,23,5,8,70,43,27,74
Livingston,4450,2,20,5,11,71,50,21,65
Alloa,4450,3,19,6,11,72,45,27,63
Brechin,4450,4,20,3,13,63,51,12,63
Queen's Park,4450,5,15,5,16,39,48,-9,50
Albion,4450,6,13,8,15,51,54,-3,47
East Fife,4450,7,12,7,17,54,57,-3,43
Peterhead,4450,8,11,8,17,46,57,-11,41
Stranraer,4450,9,9,7,20,50,71,-21,34
Stenhousem'r,4450,10,7,8,21,45,85,-40,29
Alloa,4451,1,20,7,9,65,34,31,67
Livingston,4451,2,20,7,9,69,39,30,67
Brechin,4451,3,16,5,15,50,45,5,53
Stranraer,4451,4,15,8,13,55,53,2,53
Queen's Park,4451,5,16,4,16,37,43,-6,52
Peterhead,4451,6,14,8,14,49,52,-3,50
Albion,4451,7,14,7,15,44,46,-2,49
Airdrieon,4451,8,15,3,18,47,60,-13,48
East Fife,4451,9,13,6,17,48,48,0,45
Stenhousem'r,4451,10,6,7,23,35,79,-44,25
Livingston,4452,1,21,6,9,78,45,33,69
Brechin,4452,2,21,5,10,65,49,16,68
Airdrieon,4452,3,19,4,13,62,56,6,61
East Fife,4452,4,15,8,13,53,41,12,53
Albion,4452,5,15,8,13,61,55,6,53
Alloa,4452,6,13,11,12,61,50,11,50
Stranraer,4452,7,14,5,17,54,57,-3,47
Peterhead,4452,8,13,7,16,39,50,-11,46
Queen's Park,4452,9,9,10,17,36,58,-22,37
Stenhousem'r,4452,10,5,6,25,44,92,-48,21
Alloa,4453,1,24,6,6,84,41,43,78
Airdrieon,4453,2,22,4,10,60,46,14,70
Livingston,4453,3,21,5,10,80,45,35,68
Brechin,4453,4,16,4,16,56,54,2,52
Peterhead,4453,5,13,6,17,43,55,-12,45
Albion,4453,6,12,6,18,52,55,-3,42
Stranraer,4453,7,12,5,19,40,60,-20,41
Queen's Park,4453,8,11,8,17,38,59,-21,41
East Fife,4453,9,10,9,17,44,48,-4,39
Stenhousem'r,4453,10,8,9,19,48,82,-34,33
Alloa,4454,1,19,7,10,74,49,25,64
Livingston,4454,2,20,2,14,92,65,27,62
Albion,4454,3,16,6,14,54,54,0,54
Airdrieon,4454,4,16,3,17,61,61,0,51
East Fife,4454,5,14,8,14,52,50,2,50
Queen's Park,4454,6,14,8,14,48,53,-5,50
Stranraer,4454,7,15,4,17,60,62,-2,49
Brechin,4454,8,15,4,17,45,54,-9,49
Peterhead,4454,9,13,5,18,43,58,-15,44
Stenhousem'r,4454,10,11,7,18,47,70,-23,40
Alloa,4455,1,21,8,7,77,43,34,71
Livingston,4455,2,22,3,11,85,52,33,69
Airdrieon,4455,3,19,9,8,65,47,18,66
Peterhead,4455,4,18,4,14,60,57,3,58
East Fife,4455,5,13,11,12,56,46,10,50
Stranraer,4455,6,14,8,14,53,53,0,50
Queen's Park,4455,7,12,7,17,54,60,-6,43
Albion,4455,8,11,8,17,51,69,-18,41
Brechin,4455,9,11,3,22,39,65,-26,36
Stenhousem'r,4455,10,6,5,25,56,104,-48,23
Livingston,4456,1,21,7,8,82,48,34,70
Airdrieon,4456,2,20,7,9,58,41,17,67
Alloa,4456,3,13,14,9,69,47,22,53
Brechin,4456,4,15,6,15,45,48,-3,51
Peterhead,4456,5,13,7,16,54,68,-14,46
Queen's Park,4456,6,13,7,16,38,61,-23,46
Stranraer,4456,7,13,6,17,58,53,5,45
East Fife,4456,8,12,8,16,52,54,-2,44
Albion,4456,9,10,10,16,51,58,-7,40
Stenhousem'r,4456,10,9,10,17,50,79,-29,37
Livingston,4457,1,21,8,7,82,44,38,71
Alloa,4457,2,20,8,8,82,50,32,68
Brechin,4457,3,19,5,12,52,48,4,62
Airdrieon,4457,4,17,7,12,56,52,4,58
Queen's Park,4457,5,14,6,16,40,49,-9,48
Albion,4457,6,10,11,15,50,53,-3,41
East Fife,4457,7,10,11,15,43,46,-3,41
Peterhead,4457,8,11,8,17,43,58,-15,41
Stranraer,4457,9,11,7,18,47,58,-11,40
Stenhousem'r,4457,10,9,5,22,48,85,-37,32
Livingston,4458,1,22,3,11,81,50,31,69
Airdrieon,4458,2,20,4,12,61,57,4,64
Brechin,4458,3,17,10,9,56,44,12,61
Alloa,4458,4,16,10,10,59,47,12,58
Stranraer,4458,5,13,7,16,55,64,-9,46
Albion,4458,6,12,7,17,48,54,-6,43
Peterhead,4458,7,12,7,17,43,50,-7,43
Queen's Park,4458,8,11,10,15,32,41,-9,43
East Fife,4458,9,11,9,16,51,49,2,42
Stenhousem'r,4458,10,9,7,20,44,74,-30,34
Livingston,4459,1,19,10,7,73,47,26,67
Alloa,4459,2,18,7,11,67,47,20,61
Brechin,4459,3,19,1,16,62,54,8,58
Airdrieon,4459,4,17,6,13,63,54,9,57
Queen's Park,4459,5,16,6,14,51,49,2,54
Albion,4459,6,14,6,16,55,57,-2,48
Peterhead,4459,7,13,7,16,46,49,-3,46
Stranraer,4459,8,13,4,19,48,67,-19,43
East Fife,4459,9,12,6,18,45,50,-5,42
Stenhousem'r,4459,10,9,7,20,48,84,-36,34
Livingston,4460,1,17,6,13,61,46,15,57
Stranraer,4460,2,17,6,13,55,52,3,57
Albion,4460,3,14,14,8,72,53,19,56
Alloa,4460,4,16,7,13,74,55,19,55
Airdrieon,4460,5,15,8,13,63,65,-2,53
Brechin,4460,6,15,6,15,53,62,-9,51
Peterhead,4460,7,13,10,13,48,50,-2,49
Queen's Park,4460,8,12,9,15,35,45,-10,45
East Fife,4460,9,11,9,16,57,52,5,42
Stenhousem'r,4460,10,9,7,20,41,79,-38,34
Livingston,4461,1,24,2,10,98,64,34,74
Alloa,4461,2,18,9,9,76,47,29,63
Brechin,4461,3,18,8,10,66,49,17,62
Peterhead,4461,4,16,7,13,57,53,4,55
Albion,4461,5,15,9,12,64,55,9,54
Airdrieon,4461,6,15,7,14,52,61,-9,52
Stranraer,4461,7,13,5,18,54,69,-15,44
East Fife,4461,8,11,6,19,46,56,-10,39
Queen's Park,4461,9,10,7,19,40,62,-22,37
Stenhousem'r,4461,10,7,6,23,48,85,-37,27
Alloa,4462,1,22,5,9,71,44,27,71
Brechin,4462,2,20,7,9,51,38,13,67
Livingston,4462,3,20,3,13,83,58,25,63
Airdrieon,4462,4,17,7,12,59,52,7,58
Albion,4462,5,13,12,11,52,45,7,51
Peterhead,4462,6,15,6,15,48,50,-2,51
Queen's Park,4462,7,12,10,14,37,52,-15,46
East Fife,4462,8,11,7,18,44,48,-4,40
Stranraer,4462,9,9,9,18,49,64,-15,36
Stenhousem'r,4462,10,6,4,26,39,82,-43,22
Alloa,4463,1,21,7,8,73,43,30,70
Livingston,4463,2,21,3,12,74,50,24,66
Brechin,4463,3,20,1,15,62,53,9,61
Airdrieon,4463,4,16,7,13,55,48,7,55
Stranraer,4463,5,16,5,15,55,50,5,53
East Fife,4463,6,14,8,14,48,46,2,50
Queen's Park,4463,7,15,5,16,38,50,-12,50
Peterhead,4463,8,13,8,15,56,56,0,47
Albion,4463,9,12,6,18,53,67,-14,42
Stenhousem'r,4463,10,3,8,25,42,93,-51,17
Livingston,4464,1,22,2,12,85,41,44,68
Alloa,4464,2,18,6,12,80,46,34,60
Airdrieon,4464,3,17,9,10,52,49,3,60
Brechin,4464,4,17,8,11,54,48,6,59
Albion,4464,5,17,5,14,54,52,2,56
East Fife,4464,6,13,10,13,47,46,1,49
Peterhead,4464,7,12,8,16,48,61,-13,44
Queen's Park,4464,8,11,9,16,34,53,-19,42
Stranraer,4464,9,9,10,17,46,61,-15,37
Stenhousem'r,4464,10,6,9,21,32,75,-43,27
Livingston,4465,1,23,5,8,75,41,34,74
Alloa,4465,2,19,9,8,70,42,28,66
Brechin,4465,3,17,9,10,55,39,16,60
Airdrieon,4465,4,17,8,11,56,51,5,59
Albion,4465,5,14,6,16,49,50,-1,48
East Fife,4465,6,12,9,15,48,46,2,45
Queen's Park,4465,7,13,5,18,39,64,-25,44
Peterhead,4465,8,12,6,18,40,51,-11,42
Stranraer,4465,9,9,7,20,43,60,-17,34
Stenhousem'r,4465,10,8,8,20,50,81,-31,32
Livingston,4466,1,21,7,8,67,42,25,70
Alloa,4466,2,19,12,5,72,38,34,69
Airdrieon,4466,3,20,8,8,66,45,21,68
Brechin,4466,4,13,12,11,45,41,4,51
Stranraer,4466,5,13,6,17,56,63,-7,45
Peterhead,4466,6,12,8,16,42,51,-9,44
East Fife,4466,7,10,11,15,44,48,-4,41
Queen's Park,4466,8,12,5,19,36,50,-14,41
Albion,4466,9,10,9,17,44,59,-15,39
Stenhousem'r,4466,10,6,10,20,41,76,-35,28
Livingston,4467,1,21,6,9,74,43,31,69
Airdrieon,4467,2,19,6,11,55,45,10,63
Alloa,4467,3,17,11,8,67,42,25,62
Peterhead,4467,4,15,8,13,49,49,0,53
Brechin,4467,5,16,5,15,40,41,-1,53
Albion,4467,6,12,11,13,52,56,-4,47
East Fife,4467,7,11,9,16,50,54,-4,42
Stranraer,4467,8,10,9,17,45,55,-10,39
Queen's Park,4467,9,9,11,16,29,44,-15,38
Stenhousem'r,4467,10,9,6,21,47,79,-32,33
Livingston,4468,1,23,6,7,85,47,38,75
Alloa,4468,2,22,6,8,69,35,34,72
Airdrieon,4468,3,17,8,11,58,50,8,59
Brechin,4468,4,13,9,14,40,49,-9,48
Peterhead,4468,5,13,8,15,52,58,-6,47
Queen's Park,4468,6,12,10,14,46,53,-7,46
East Fife,4468,7,10,13,13,46,43,3,43
Albion,4468,8,11,9,16,49,60,-11,42
Stranraer,4468,9,10,8,18,48,64,-16,38
Stenhousem'r,4468,10,6,9,21,41,75,-34,27
Alloa,4469,1,21,10,5,81,37,44,73
Livingston,4469,2,19,6,11,71,46,25,63
Airdrieon,4469,3,19,5,12,62,54,8,62
Brechin,4469,4,19,3,14,55,50,5,60
Albion,4469,5,16,6,14,76,64,12,54
East Fife,4469,6,14,7,15,53,51,2,49
Peterhead,4469,7,14,6,16,46,50,-4,48
Stranraer,4469,8,10,8,18,43,69,-26,38
Queen's Park,4469,9,9,9,18,27,48,-21,36
Stenhousem'r,4469,10,5,8,23,44,89,-45,23
Alloa,4470,1,19,11,6,72,35,37,68
Livingston,4470,2,21,5,10,80,50,30,68
Airdrieon,4470,3,20,6,10,59,48,11,66
Brechin,4470,4,17,9,10,53,46,7,60
Albion,4470,5,12,9,15,52,52,0,45
East Fife,4470,6,13,5,18,57,59,-2,44
Queen's Park,4470,7,13,5,18,39,58,-19,44
Stranraer,4470,8,11,6,19,52,69,-17,39
Stenhousem'r,4470,9,9,9,18,51,73,-22,36
Peterhead,4470,10,7,11,18,43,68,-25,32
Livingston,4471,1,23,2,11,80,50,30,71
Airdrieon,4471,2,19,3,14,58,51,7,60
Alloa,4471,3,17,7,12,74,52,22,58
Albion,4471,4,15,8,13,58,51,7,53
East Fife,4471,5,13,10,13,51,50,1,49
Queen's Park,4471,6,15,3,18,42,54,-12,48
Stranraer,4471,7,14,5,17,48,63,-15,47
Peterhead,4471,8,12,10,14,65,66,-1,46
Brechin,4471,9,13,6,17,45,52,-7,45
Stenhousem'r,4471,10,8,8,20,54,86,-32,32
Airdrieon,4472,1,22,7,7,70,53,17,73
Alloa,4472,2,17,10,9,67,41,26,61
Livingston,4472,3,18,6,12,71,47,24,60
Albion,4472,4,17,8,11,64,41,23,59
Queen's Park,4472,5,16,6,14,45,52,-7,54
Brechin,4472,6,15,6,15,42,54,-12,51
Peterhead,4472,7,12,7,17,50,59,-9,43
Stranraer,4472,8,13,3,20,43,58,-15,42
East Fife,4472,9,10,8,18,46,52,-6,38
Stenhousem'r,4472,10,4,11,21,41,82,-41,23
Livingston,4473,1,21,6,9,85,50,35,69
Brechin,4473,2,19,9,8,62,40,22,66
Alloa,4473,3,16,10,10,65,50,15,58
Peterhead,4473,4,17,7,12,60,46,14,58
Airdrieon,4473,5,15,6,15,59,71,-12,51
Albion,4473,6,15,5,16,51,58,-7,50
Stranraer,4473,7,12,7,17,55,70,-15,43
East Fife,4473,8,10,10,16,52,50,2,40
Queen's Park,4473,9,10,9,17,38,53,-15,39
Stenhousem'r,4473,10,6,9,21,42,81,-39,27
Alloa,4474,1,20,7,9,72,46,26,67
Airdrieon,4474,2,18,9,9,53,45,8,63
Brechin,4474,3,18,5,13,54,50,4,59
Livingston,4474,4,17,7,12,69,48,21,58
Albion,4474,5,14,8,14,50,49,1,50
Peterhead,4474,6,13,10,13,47,50,-3,49
Stranraer,4474,7,12,6,18,49,60,-11,42
East Fife,4474,8,10,11,15,51,47,4,41
Queen's Park,4474,9,9,10,17,32,55,-23,37
Stenhousem'r,4474,10,6,13,17,42,69,-27,31
Alloa,4475,1,20,7,9,75,40,35,67
Livingston,4475,2,20,0,16,68,53,15,60
Peterhead,4475,3,17,8,11,53,44,9,59
Albion,4475,4,17,6,13,56,50,6,57
Airdrieon,4475,5,17,6,13,53,47,6,57
Queen's Park,4475,6,15,3,18,36,55,-19,48
Brechin,4475,7,13,5,18,48,50,-2,44
Stranraer,4475,8,12,8,16,44,50,-6,44
Stenhousem'r,4475,9,11,7,18,57,81,-24,40
East Fife,4475,10,9,8,19,42,62,-20,35
Livingston,4476,1,20,6,10,80,51,29,66
Airdrieon,4476,2,19,6,11,63,47,16,63
Peterhead,4476,3,17,7,12,51,49,2,58
Alloa,4476,4,14,14,8,60,43,17,56
Queen's Park,4476,5,16,4,16,51,48,3,52
Albion,4476,6,13,10,13,54,57,-3,49
East Fife,4476,7,12,11,13,49,47,2,47
Stranraer,4476,8,13,6,17,47,53,-6,45
Brechin,4476,9,13,5,18,44,57,-13,44
Stenhousem'r,4476,10,5,7,24,40,87,-47,22
Livingston,4477,1,23,4,9,79,44,35,73
Alloa,4477,2,20,7,9,68,35,33,67
Albion,4477,3,14,10,12,49,46,3,52
Airdrieon,4477,4,15,6,15,62,62,0,51
Stranraer,4477,5,15,5,16,56,60,-4,50
Brechin,4477,6,15,5,16,42,48,-6,50
Peterhead,4477,7,14,7,15,47,50,-3,49
Queen's Park,4477,8,13,6,17,37,51,-14,45
East Fife,4477,9,9,10,17,39,49,-10,37
Stenhousem'r,4477,10,8,8,20,45,79,-34,32
Alloa,4478,1,21,5,10,76,51,25,68
Airdrieon,4478,2,17,9,10,64,46,18,60
Livingston,4478,3,17,7,12,63,49,14,58
Stranraer,4478,4,17,5,14,60,57,3,56
Albion,4478,5,14,8,14,51,45,6,50
Queen's Park,4478,6,12,13,11,36,43,-7,49
Brechin,4478,7,13,8,15,41,50,-9,47
Peterhead,4478,8,13,7,16,43,57,-14,46
East Fife,4478,9,9,11,16,46,50,-4,38
Stenhousem'r,4478,10,5,11,20,44,76,-32,26
Livingston,4479,1,22,3,11,76,49,27,69
Alloa,4479,2,20,8,8,68,39,29,68
Brechin,4479,3,18,5,13,52,42,10,59
Airdrieon,4479,4,16,6,14,57,57,0,54
Stranraer,4479,5,15,6,15,54,56,-2,51
Albion,4479,6,13,10,13,54,56,-2,49
Peterhead,4479,7,13,9,14,45,48,-3,48
Queen's Park,4479,8,12,7,17,38,57,-19,43
East Fife,4479,9,10,9,17,46,49,-3,39
Stenhousem'r,4479,10,5,9,22,43,80,-37,24
Airdrieon,4480,1,22,6,8,77,52,25,72
Alloa,4480,2,19,9,8,73,39,34,66
Livingston,4480,3,17,8,11,64,47,17,59
Brechin,4480,4,16,8,12,45,42,3,56
Albion,4480,5,13,9,14,55,62,-7,48
Peterhead,4480,6,12,11,13,52,46,6,47
East Fife,4480,7,12,10,14,46,41,5,46
Queen's Park,4480,8,11,12,13,36,47,-11,45
Stranraer,4480,9,9,5,22,50,75,-25,32
Stenhousem'r,4480,10,5,10,21,40,87,-47,25
Peterhead,4481,1,19,8,9,70,47,23,65
Alloa,4481,2,17,8,11,65,46,19,59
Airdrieon,4481,3,16,10,10,63,56,7,58
Albion,4481,4,16,9,11,60,54,6,57
Livingston,4481,5,16,7,13,70,61,9,55
Brechin,4481,6,13,10,13,49,49,0,49
East Fife,4481,7,11,9,16,45,46,-1,42
Stranraer,4481,8,12,6,18,55,65,-10,42
Queen's Park,4481,9,11,9,16,40,57,-17,42
Stenhousem'r,4481,10,8,6,22,47,83,-36,30
Alloa,4482,1,20,10,6,76,43,33,70
Livingston,4482,2,21,4,11,78,47,31,67
Airdrieon,4482,3,18,4,14,63,59,4,58
Brechin,4482,4,14,13,9,45,43,2,55
Queen's Park,4482,5,14,5,17,37,52,-15,47
Peterhead,4482,6,13,5,18,49,55,-6,44
Stenhousem'r,4482,7,11,9,16,49,69,-20,42
Albion,4482,8,11,8,17,52,59,-7,41
Stranraer,4482,9,11,7,18,47,63,-16,40
East Fife,4482,10,9,11,16,47,53,-6,38
Airdrieon,4483,1,21,6,9,63,43,20,69
Alloa,4483,2,21,5,10,63,38,25,68
Livingston,4483,3,20,4,12,78,49,29,64
Brechin,4483,4,17,7,12,50,46,4,58
Peterhead,4483,5,14,8,14,47,50,-3,50
Albion,4483,6,12,11,13,51,46,5,47
Stranraer,4483,7,13,4,19,49,64,-15,43
Queen's Park,4483,8,10,8,18,32,52,-20,38
East Fife,4483,9,10,7,19,39,54,-15,37
Stenhousem'r,4483,10,8,8,20,44,74,-30,32
Livingston,4484,1,21,3,12,80,53,27,66
Alloa,4484,2,19,7,10,83,44,39,64
Albion,4484,3,16,6,14,57,51,6,54
Queen's Park,4484,4,15,6,15,42,53,-11,51
Brechin,4484,5,14,6,16,48,53,-5,48
Peterhead,4484,6,12,12,12,49,57,-8,48
Airdrieon,4484,7,13,8,15,55,61,-6,47
Stranraer,4484,8,13,7,16,52,59,-7,46
East Fife,4484,9,11,10,15,52,47,5,43
Stenhousem'r,4484,10,10,7,19,45,85,-40,37
Alloa,4485,1,21,9,6,75,40,35,72
Brechin,4485,2,18,6,12,56,43,13,60
Livingston,4485,3,17,5,14,64,54,10,56
Airdrieon,4485,4,17,5,14,55,58,-3,56
Albion,4485,5,14,9,13,47,44,3,51
Stranraer,4485,6,16,2,18,51,58,-7,50
Peterhead,4485,7,11,10,15,44,54,-10,43
Queen's Park,4485,8,12,7,17,26,41,-15,43
East Fife,4485,9,10,9,17,43,50,-7,39
Stenhousem'r,4485,10,9,8,19,41,60,-19,35
Alloa,4486,1,21,7,8,73,37,36,70
Livingston,4486,2,20,3,13,66,45,21,63
Queen's Park,4486,3,17,5,14,40,45,-5,56
East Fife,4486,4,15,8,13,58,49,9,53
Airdrieon,4486,5,14,10,12,59,54,5,52
Albion,4486,6,12,13,11,52,54,-2,49
Brechin,4486,7,12,6,18,36,55,-19,42
Stranraer,4486,8,11,7,18,47,59,-12,40
Peterhead,4486,9,8,14,14,42,56,-14,38
Stenhousem'r,4486,10,9,9,18,48,67,-19,36
Airdrieon,4487,1,21,7,8,64,46,18,70
Livingston,4487,2,21,6,9,77,48,29,69
Alloa,4487,3,18,10,8,64,37,27,64
Albion,4487,4,14,10,12,57,49,8,52
Brechin,4487,5,14,10,12,45,48,-3,52
Peterhead,4487,6,13,5,18,45,59,-14,44
East Fife,4487,7,10,11,15,40,42,-2,41
Queen's Park,4487,8,11,7,18,38,54,-16,40
Stranraer,4487,9,10,5,21,45,65,-20,35
Stenhousem'r,4487,10,8,9,19,46,73,-27,33
Livingston,4488,1,23,1,12,83,48,35,70
Peterhead,4488,2,16,10,10,60,49,11,58
Airdrieon,4488,3,17,6,13,58,51,7,57
Alloa,4488,4,16,8,12,64,46,18,56
Brechin,4488,5,14,9,13,49,50,-1,51
Stranraer,4488,6,14,7,15,51,56,-5,49
Queen's Park,4488,7,14,7,15,43,58,-15,49
Albion,4488,8,13,9,14,50,54,-4,48
East Fife,4488,9,9,12,15,41,49,-8,39
Stenhousem'r,4488,10,5,9,22,45,83,-38,24
Livingston,4489,1,20,5,11,71,50,21,65
Airdrieon,4489,2,18,9,9,60,49,11,63
Albion,4489,3,16,8,12,60,48,12,56
Alloa,4489,4,17,5,14,65,55,10,56
Brechin,4489,5,16,5,15,48,46,2,53
Peterhead,4489,6,13,8,15,47,48,-1,47
Queen's Park,4489,7,13,8,15,34,47,-13,47
East Fife,4489,8,12,9,15,45,45,0,45
Stranraer,4489,9,13,5,18,50,53,-3,44
Stenhousem'r,4489,10,7,8,21,44,83,-39,29
Livingston,4490,1,21,3,12,82,49,33,66
Peterhead,4490,2,18,7,11,60,48,12,61
Albion,4490,3,15,13,8,56,45,11,58
Alloa,4490,4,17,6,13,73,54,19,57
Brechin,4490,5,15,8,13,45,48,-3,53
Airdrieon,4490,6,14,8,14,56,62,-6,50
Stranraer,4490,7,12,11,13,59,63,-4,47
East Fife,4490,8,10,10,16,47,55,-8,40
Queen's Park,4490,9,9,8,19,39,62,-23,35
Stenhousem'r,4490,10,7,10,19,50,81,-31,31
Brechin,4491,1,17,7,12,52,48,4,58
Alloa,4491,2,16,9,11,68,54,14,57
Airdrieon,4491,3,16,8,12,59,51,8,56
Albion,4491,4,14,10,12,52,45,7,52
Stranraer,4491,5,16,4,16,56,58,-2,52
Peterhead,4491,6,13,12,11,55,53,2,51
Livingston,4491,7,14,5,17,67,61,6,47
East Fife,4491,8,10,14,12,54,54,0,44
Queen's Park,4491,9,10,10,16,34,50,-16,40
Stenhousem'r,4491,10,10,9,17,56,79,-23,39
Livingston,4492,1,21,7,8,80,53,27,70
Alloa,4492,2,19,10,7,71,42,29,67
Peterhead,4492,3,16,8,12,58,46,12,56
Airdrieon,4492,4,17,3,16,60,54,6,54
Brechin,4492,5,16,5,15,54,50,4,53
Albion,4492,6,12,11,13,46,46,0,47
Queen's Park,4492,7,12,7,17,41,56,-15,43
Stranraer,4492,8,11,8,17,45,56,-11,41
East Fife,4492,9,8,15,13,48,52,-4,39
Stenhousem'r,4492,10,7,8,21,39,87,-48,29
Livingston,4493,1,22,5,9,80,42,38,71
Alloa,4493,2,19,7,10,63,41,22,64
Brechin,4493,3,19,6,11,68,49,19,63
Airdrieon,4493,4,17,6,13,52,45,7,57
Peterhead,4493,5,14,11,11,49,47,2,53
Albion,4493,6,14,7,15,55,54,1,49
Queen's Park,4493,7,12,9,15,34,48,-14,45
Stranraer,4493,8,10,7,19,44,59,-15,37
East Fife,4493,9,8,11,17,41,53,-12,35
Stenhousem'r,4493,10,5,11,20,40,88,-48,26
Livingston,4494,1,22,5,9,81,45,36,71
Brechin,4494,2,20,3,13,55,47,8,63
Alloa,4494,3,16,9,11,66,47,19,57
Airdrieon,4494,4,15,10,11,60,54,6,55
Albion,4494,5,14,8,14,55,56,-1,50
Peterhead,4494,6,14,6,16,44,51,-7,48
Stranraer,4494,7,15,3,18,59,69,-10,48
Stenhousem'r,4494,8,10,10,16,54,74,-20,40
Queen's Park,4494,9,10,8,18,31,57,-26,38
East Fife,4494,10,10,6,20,44,49,-5,36
Livingston,4495,1,25,3,8,82,37,45,78
Alloa,4495,2,21,6,9,70,37,33,69
Brechin,4495,3,19,3,14,49,46,3,60
Airdrieon,4495,4,16,8,12,52,59,-7,56
Albion,4495,5,14,7,15,57,61,-4,49
Peterhead,4495,6,13,7,16,50,61,-11,46
Queen's Park,4495,7,13,6,17,39,45,-6,45
East Fife,4495,8,10,9,17,47,49,-2,39
Stranraer,4495,9,11,6,19,48,60,-12,39
Stenhousem'r,4495,10,6,9,21,47,86,-39,27
Alloa,4496,1,20,9,7,69,37,32,69
Livingston,4496,2,18,7,11,70,51,19,61
Airdrieon,4496,3,18,7,11,68,56,12,61
Peterhead,4496,4,16,7,13,61,50,11,55
Albion,4496,5,15,7,14,69,54,15,52
Queen's Park,4496,6,14,10,12,41,43,-2,52
East Fife,4496,7,14,7,15,53,55,-2,49
Stranraer,4496,8,12,7,17,58,66,-8,43
Brechin,4496,9,11,7,18,49,69,-20,40
Stenhousem'r,4496,10,3,10,23,36,93,-57,19
Brechin,4497,1,19,7,10,54,41,13,64
Livingston,4497,2,19,6,11,77,44,33,63
Alloa,4497,3,18,9,9,66,43,23,63
Airdrieon,4497,4,18,6,12,67,60,7,60
Albion,4497,5,15,10,11,49,47,2,55
Stranraer,4497,6,13,8,15,58,64,-6,47
East Fife,4497,7,9,13,14,43,49,-6,40
Peterhead,4497,8,11,7,18,52,61,-9,40
Queen's Park,4497,9,11,6,19,39,60,-21,39
Stenhousem'r,4497,10,8,6,22,39,75,-36,30
Alloa,4498,1,18,8,10,69,45,24,62
Livingston,4498,2,18,4,14,77,51,26,58
Brechin,4498,3,18,3,15,43,45,-2,57
Airdrieon,4498,4,16,8,12,65,60,5,56
Albion,4498,5,14,11,11,54,52,2,53
Peterhead,4498,6,15,8,13,50,49,1,53
Queen's Park,4498,7,14,8,14,38,46,-8,50
Stranraer,4498,8,12,8,16,51,62,-11,44
East Fife,4498,9,9,12,15,47,48,-1,39
Stenhousem'r,4498,10,7,8,21,43,79,-36,29
Alloa,4499,1,17,10,9,64,40,24,61
Airdrieon,4499,2,18,6,12,72,56,16,60
Brechin,4499,3,17,7,12,52,60,-8,58
Livingston,4499,4,17,5,14,65,55,10,56
Peterhead,4499,5,15,8,13,59,53,6,53
Stranraer,4499,6,14,6,16,53,55,-2,48
East Fife,4499,7,12,8,16,50,50,0,44
Queen's Park,4499,8,12,7,17,39,53,-14,43
Albion,4499,9,11,9,16,48,58,-10,42
Stenhousem'r,4499,10,10,8,18,52,74,-22,38
Livingston,4500,1,19,6,11,68,44,24,63
Alloa,4500,2,17,9,10,65,42,23,60
Airdrieon,4500,3,17,5,14,53,47,6,56
Brechin,4500,4,16,8,12,46,45,1,56
East Fife,4500,5,14,9,13,52,49,3,51
Queen's Park,4500,6,14,8,14,49,52,-3,50
Stranraer,4500,7,14,8,14,53,58,-5,50
Peterhead,4500,8,14,6,16,50,61,-11,48
Albion,4500,9,11,5,20,43,54,-11,38
Stenhousem'r,4500,10,8,8,20,50,77,-27,32
Alloa,4501,1,20,8,8,78,47,31,68
Livingston,4501,2,21,5,10,71,44,27,68
Brechin,4501,3,20,6,10,62,42,20,66
Albion,4501,4,18,5,13,54,50,4,59
Airdrieon,4501,5,17,4,15,57,63,-6,55
Peterhead,4501,6,13,5,18,51,57,-6,44
Stranraer,4501,7,13,4,19,44,60,-16,43
East Fife,4501,8,11,9,16,41,43,-2,42
Queen's Park,4501,9,9,7,20,33,53,-20,34
Stenhousem'r,4501,10,8,7,21,50,82,-32,31
Livingston,4502,1,22,5,9,77,44,33,71
Alloa,4502,2,17,8,11,58,43,15,59
Airdrieon,4502,3,15,9,12,54,48,6,54
Brechin,4502,4,14,10,12,49,49,0,52
East Fife,4502,5,14,8,14,51,51,0,50
Queen's Park,4502,6,13,11,12,44,45,-1,50
Peterhead,4502,7,12,11,13,52,50,2,47
Albion,4502,8,11,13,12,45,44,1,46
Stranraer,4502,9,11,7,18,49,66,-17,40
Stenhousem'r,4502,10,7,6,23,41,80,-39,27
Livingston,4503,1,24,4,8,75,45,30,76
Alloa,4503,2,17,11,8,69,43,26,62
Airdrieon,4503,3,13,12,11,53,52,1,51
Peterhead,4503,4,14,9,13,49,52,-3,51
Brechin,4503,5,14,8,14,56,49,7,50
Stenhousem'r,4503,6,13,9,14,56,67,-11,48
Albion,4503,7,12,10,14,47,50,-3,46
Stranraer,4503,8,12,6,18,44,52,-8,42
Queen's Park,4503,9,9,11,16,33,51,-18,38
East Fife,4503,10,8,8,20,34,55,-21,32
Livingston,4504,1,22,3,11,86,51,35,69
Airdrieon,4504,2,18,5,13,61,59,2,59
Alloa,4504,3,15,10,11,66,49,17,55
Brechin,4504,4,15,8,13,47,48,-1,53
Peterhead,4504,5,14,10,12,53,53,0,52
Albion,4504,6,12,10,14,49,49,0,46
East Fife,4504,7,10,14,12,51,47,4,44
Stranraer,4504,8,12,7,17,46,59,-13,43
Queen's Park,4504,9,10,8,18,39,59,-20,38
Stenhousem'r,4504,10,9,11,16,43,67,-24,38
Alloa,4505,1,20,5,11,75,41,34,65
Livingston,4505,2,19,6,11,76,54,22,63
Peterhead,4505,3,16,9,11,55,46,9,57
Airdrieon,4505,4,14,9,13,56,64,-8,51
Brechin,4505,5,15,5,16,50,51,-1,50
Queen's Park,4505,6,14,8,14,44,51,-7,50
East Fife,4505,7,12,12,12,50,45,5,48
Albion,4505,8,12,11,13,51,45,6,47
Stranraer,4505,9,12,8,16,48,62,-14,44
Stenhousem'r,4505,10,7,5,24,46,92,-46,26
Livingston,4506,1,20,5,11,78,55,23,65
Alloa,4506,2,18,7,11,69,47,22,61
Brechin,4506,3,17,5,14,55,51,4,56
Peterhead,4506,4,16,6,14,62,58,4,54
Airdrieon,4506,5,15,5,16,59,61,-2,50
East Fife,4506,6,13,10,13,53,50,3,49
Albion,4506,7,13,8,15,60,66,-6,47
Queen's Park,4506,8,12,8,16,36,55,-19,44
Stranraer,4506,9,12,6,18,49,55,-6,42
Stenhousem'r,4506,10,11,6,19,51,74,-23,39
Alloa,4507,1,21,7,8,81,41,40,70
Livingston,4507,2,21,7,8,79,45,34,70
Brechin,4507,3,18,7,11,56,46,10,61
Airdrieon,4507,4,16,6,14,60,62,-2,54
Stranraer,4507,5,13,8,15,48,52,-4,47
Queen's Park,4507,6,12,10,14,36,53,-17,46
Peterhead,4507,7,11,12,13,51,58,-7,45
East Fife,4507,8,9,15,12,45,47,-2,42
Albion,4507,9,11,8,17,50,53,-3,41
Stenhousem'r,4507,10,4,8,24,39,88,-49,20
Alloa,4508,1,20,9,7,81,43,38,69
Livingston,4508,2,21,4,11,74,55,19,67
Brechin,4508,3,17,7,12,49,39,10,58
Airdrieon,4508,4,18,4,14,60,52,8,58
Albion,4508,5,13,9,14,57,61,-4,48
Stranraer,4508,6,14,5,17,43,59,-16,47
Peterhead,4508,7,13,6,17,50,54,-4,45
Queen's Park,4508,8,12,7,17,45,59,-14,43
East Fife,4508,9,10,11,15,52,50,2,41
Stenhousem'r,4508,10,8,6,22,44,83,-39,30
Alloa,4509,1,17,12,7,81,54,27,63
Livingston,4509,2,18,9,9,75,49,26,63
Airdrieon,4509,3,18,8,10,62,50,12,62
Brechin,4509,4,18,4,14,55,51,4,58
Albion,4509,5,13,11,12,56,55,1,50
Peterhead,4509,6,13,9,14,49,55,-6,48
East Fife,4509,7,13,7,16,50,50,0,46
Stranraer,4509,8,12,5,19,49,69,-20,41
Queen's Park,4509,9,9,10,17,39,52,-13,37
Stenhousem'r,4509,10,8,7,21,58,89,-31,31
Alloa,4510,1,20,6,10,80,43,37,66
Livingston,4510,2,20,5,11,66,57,9,65
Brechin,4510,3,16,6,14,48,47,1,54
Albion,4510,4,16,5,15,58,52,6,53
Airdrieon,4510,5,15,8,13,57,55,2,53
East Fife,4510,6,15,6,15,49,39,10,51
Stranraer,4510,7,14,7,15,51,51,0,49
Peterhead,4510,8,12,9,15,47,57,-10,45
Queen's Park,4510,9,10,7,19,29,55,-26,37
Stenhousem'r,4510,10,7,11,18,46,75,-29,32
Alloa,4511,1,21,7,8,72,45,27,70
Livingston,4511,2,20,3,13,68,44,24,63
Airdrieon,4511,3,18,9,9,64,44,20,63
Peterhead,4511,4,16,8,12,51,48,3,56
Brechin,4511,5,15,7,14,47,50,-3,52
Albion,4511,6,11,12,13,43,43,0,45
Queen's Park,4511,7,11,10,15,36,55,-19,43
East Fife,4511,8,11,9,16,50,47,3,42
Stranraer,4511,9,12,6,18,43,53,-10,42
Stenhousem'r,4511,10,6,7,23,45,90,-45,25
Airdrieon,4512,1,20,4,12,59,45,14,64
Livingston,4512,2,19,6,11,64,48,16,63
Brechin,4512,3,17,11,8,56,46,10,62
Alloa,4512,4,15,8,13,66,53,13,53
Albion,4512,5,12,14,10,54,53,1,50
Peterhead,4512,6,14,6,16,62,56,6,48
East Fife,4512,7,11,14,11,50,47,3,47
Queen's Park,4512,8,12,5,19,41,62,-21,41
Stenhousem'r,4512,9,11,6,19,53,73,-20,39
Stranraer,4512,10,7,10,19,52,74,-22,31
Livingston,4513,1,22,1,13,74,53,21,67
Brechin,4513,2,19,9,8,58,44,14,66
Peterhead,4513,3,18,8,10,57,47,10,62
Alloa,4513,4,17,9,10,73,49,24,60
Airdrieon,4513,5,16,8,12,48,44,4,56
Albion,4513,6,13,8,15,52,53,-1,47
East Fife,4513,7,11,10,15,52,52,0,43
Stranraer,4513,8,12,5,19,41,57,-16,41
Queen's Park,4513,9,9,10,17,30,47,-17,37
Stenhousem'r,4513,10,5,8,23,39,78,-39,23
Alloa,4514,1,20,8,8,82,48,34,68
Airdrieon,4514,2,19,5,12,62,54,8,62
Livingston,4514,3,18,7,11,67,46,21,61
Brechin,4514,4,18,6,12,51,48,3,60
Albion,4514,5,16,8,12,57,46,11,56
East Fife,4514,6,14,10,12,47,45,2,52
Peterhead,4514,7,14,7,15,49,55,-6,49
Queen's Park,4514,8,11,9,16,42,52,-10,42
Stranraer,4514,9,11,3,22,47,67,-20,36
Stenhousem'r,4514,10,4,7,25,35,78,-43,19
Alloa,4515,1,18,9,9,74,47,27,63
Livingston,4515,2,20,2,14,76,50,26,62
Airdrieon,4515,3,15,13,8,60,51,9,58
Albion,4515,4,17,5,14,59,53,6,56
Brechin,4515,5,15,8,13,54,51,3,53
Peterhead,4515,6,13,13,10,56,54,2,52
Queen's Park,4515,7,13,8,15,41,51,-10,47
Stranraer,4515,8,10,10,16,54,61,-7,40
East Fife,4515,9,10,8,18,43,55,-12,38
Stenhousem'r,4515,10,7,8,21,39,83,-44,29
Alloa,4516,1,22,7,7,80,47,33,73
Livingston,4516,2,21,3,12,81,52,29,66
Airdrieon,4516,3,18,5,13,56,50,6,59
Brechin,4516,4,17,5,14,55,48,7,56
Albion,4516,5,13,7,16,46,55,-9,46
Peterhead,4516,6,12,9,15,46,57,-11,45
Stranraer,4516,7,13,5,18,55,62,-7,44
Queen's Park,4516,8,12,8,16,37,54,-17,44
East Fife,4516,9,11,8,17,42,47,-5,41
Stenhousem'r,4516,10,9,7,20,47,73,-26,34
Alloa,4517,1,21,9,6,77,42,35,72
Airdrieon,4517,2,21,5,10,60,51,9,68
Livingston,4517,3,18,5,13,76,52,24,59
Brechin,4517,4,15,10,11,53,52,1,55
Stranraer,4517,5,15,7,14,54,48,6,52
Albion,4517,6,12,10,14,53,54,-1,46
Peterhead,4517,7,13,7,16,45,55,-10,46
Queen's Park,4517,8,11,8,17,38,59,-21,41
East Fife,4517,9,10,9,17,46,46,0,39
Stenhousem'r,4517,10,4,10,22,37,80,-43,22
Livingston,4518,1,26,2,8,88,39,49,80
Airdrieon,4518,2,20,5,11,59,46,13,65
Alloa,4518,3,14,13,9,63,41,22,55
Brechin,4518,4,15,10,11,43,38,5,55
Peterhead,4518,5,15,9,12,57,56,1,54
Stranraer,4518,6,12,7,17,51,56,-5,43
Albion,4518,7,11,8,17,48,59,-11,41
East Fife,4518,8,10,10,16,44,53,-9,40
Queen's Park,4518,9,11,6,19,42,64,-22,39
Stenhousem'r,4518,10,7,8,21,42,85,-43,29
Livingston,4519,1,21,6,9,89,43,46,69
Brechin,4519,2,18,9,9,44,37,7,63
Alloa,4519,3,17,9,10,64,44,20,60
Albion,4519,4,15,10,11,50,39,11,55
Airdrieon,4519,5,14,6,16,49,57,-8,48
Queen's Park,4519,6,13,9,14,33,42,-9,48
Peterhead,4519,7,12,11,13,36,40,-4,47
East Fife,4519,8,11,13,12,38,37,1,46
Stranraer,4519,9,11,5,20,41,60,-19,38
Stenhousem'r,4519,10,6,6,24,39,84,-45,24
Livingston,4520,1,21,4,11,79,50,29,67
Alloa,4520,2,18,8,10,69,48,21,62
Queen's Park,4520,3,16,7,13,42,39,3,55
Albion,4520,4,15,9,12,57,46,11,54
Brechin,4520,5,15,7,14,52,52,0,52
Airdrieon,4520,6,14,9,13,50,56,-6,51
Peterhead,4520,7,13,10,13,44,48,-4,49
East Fife,4520,8,11,9,16,43,44,-1,42
Stranraer,4520,9,11,7,18,46,62,-16,40
Stenhousem'r,4520,10,7,8,21,44,81,-37,29
Livingston,4521,1,21,2,13,74,48,26,65
Alloa,4521,2,19,6,11,73,48,25,63
Brechin,4521,3,19,5,12,55,44,11,62
Airdrieon,4521,4,18,5,13,60,56,4,59
East Fife,4521,5,14,7,15,49,46,3,49
Stranraer,4521,6,15,3,18,57,71,-14,48
Albion,4521,7,12,11,13,58,56,2,47
Queen's Park,4521,8,12,6,18,36,52,-16,42
Peterhead,4521,9,11,7,18,51,61,-10,40
Stenhousem'r,4521,10,10,6,20,43,74,-31,36
Livingston,4522,1,20,7,9,81,59,22,67
Airdrieon,4522,2,19,5,12,64,54,10,62
Albion,4522,3,17,10,9,68,51,17,61
Alloa,4522,4,18,6,12,66,43,23,60
Brechin,4522,5,18,5,13,56,46,10,59
Peterhead,4522,6,15,5,16,51,62,-11,50
Queen's Park,4522,7,12,8,16,54,60,-6,44
Stranraer,4522,8,12,5,19,56,65,-9,41
East Fife,4522,9,9,8,19,50,61,-11,35
Stenhousem'r,4522,10,8,5,23,54,99,-45,29
Airdrieon,4523,1,20,8,8,64,45,19,68
Livingston,4523,2,20,5,11,62,44,18,65
Brechin,4523,3,19,5,12,54,44,10,62
Alloa,4523,4,16,8,12,75,53,22,56
East Fife,4523,5,15,7,14,55,44,11,52
Albion,4523,6,13,10,13,54,50,4,49
Queen's Park,4523,7,13,8,15,42,51,-9,47
Peterhead,4523,8,10,11,15,41,56,-15,41
Stranraer,4523,9,10,5,21,50,66,-16,35
Stenhousem'r,4523,10,8,5,23,35,79,-44,29
Livingston,4524,1,22,5,9,84,43,41,71
Alloa,4524,2,19,7,10,69,47,22,64
Airdrieon,4524,3,18,8,10,58,48,10,62
Albion,4524,4,16,9,11,59,50,9,57
Brechin,4524,5,15,6,15,46,41,5,51
Queen's Park,4524,6,14,7,15,51,58,-7,49
Peterhead,4524,7,11,9,16,39,56,-17,42
Stranraer,4524,8,12,5,19,43,58,-15,41
East Fife,4524,9,10,8,18,46,52,-6,38
Stenhousem'r,4524,10,9,4,23,43,85,-42,31
Livingston,4525,1,22,6,8,86,50,36,72
Alloa,4525,2,17,6,13,65,44,21,57
Brechin,4525,3,17,6,13,42,43,-1,57
Albion,4525,4,15,6,15,53,53,0,51
Peterhead,4525,5,13,9,14,55,61,-6,48
Stranraer,4525,6,14,5,17,48,53,-5,47
Airdrieon,4525,7,14,5,17,52,63,-11,47
East Fife,4525,8,12,8,16,57,59,-2,44
Queen's Park,4525,9,12,8,16,39,53,-14,44
Stenhousem'r,4525,10,13,3,20,55,73,-18,42
Alloa,4526,1,22,5,9,80,43,37,71
Livingston,4526,2,22,4,10,87,51,36,70
Brechin,4526,3,16,7,13,58,50,8,55
Airdrieon,4526,4,14,10,12,59,60,-1,52
Peterhead,4526,5,14,8,14,57,57,0,50
Queen's Park,4526,6,15,5,16,41,51,-10,50
Albion,4526,7,10,11,15,48,60,-12,41
East Fife,4526,8,10,10,16,45,55,-10,40
Stranraer,4526,9,10,8,18,48,63,-15,38
Stenhousem'r,4526,10,8,10,18,50,83,-33,34
Livingston,4527,1,18,5,13,72,56,16,59
Alloa,4527,2,15,11,10,64,49,15,56
Airdrieon,4527,3,15,10,11,60,59,1,55
Queen's Park,4527,4,15,10,11,45,44,1,55
Albion,4527,5,15,9,12,57,50,7,54
Brechin,4527,6,15,9,12,52,47,5,54
Peterhead,4527,7,14,9,13,59,60,-1,51
East Fife,4527,8,11,10,15,47,50,-3,43
Stranraer,4527,9,11,9,16,54,55,-1,42
Stenhousem'r,4527,10,7,6,23,46,86,-40,27
Livingston,4528,1,20,6,10,73,51,22,66
Brechin,4528,2,19,6,11,63,46,17,63
Albion,4528,3,16,8,12,59,51,8,56
Alloa,4528,4,14,12,10,62,46,16,54
Peterhead,4528,5,16,6,14,57,54,3,54
Airdrieon,4528,6,15,5,16,59,66,-7,50
Queen's Park,4528,7,13,9,14,37,44,-7,48
East Fife,4528,8,13,7,16,49,51,-2,46
Stranraer,4528,9,12,6,18,53,62,-9,42
Stenhousem'r,4528,10,7,5,24,42,83,-41,26
Livingston,4529,1,21,7,8,87,52,35,70
Alloa,4529,2,20,7,9,75,48,27,67
Stranraer,4529,3,14,7,15,50,55,-5,49
Airdrieon,4529,4,14,6,16,51,57,-6,48
Brechin,4529,5,13,8,15,55,61,-6,47
Peterhead,4529,6,13,8,15,44,53,-9,47
Queen's Park,4529,7,14,5,17,42,51,-9,47
East Fife,4529,8,10,15,11,47,39,8,45
Albion,4529,9,13,6,17,49,58,-9,45
Stenhousem'r,4529,10,9,9,18,50,76,-26,36
Livingston,4530,1,20,5,11,76,48,28,65
Alloa,4530,2,18,8,10,70,47,23,62
East Fife,4530,3,15,12,9,59,45,14,57
Airdrieon,4530,4,16,9,11,57,50,7,57
Peterhead,4530,5,14,10,12,49,58,-9,52
Stranraer,4530,6,15,5,16,50,55,-5,50
Brechin,4530,7,14,7,15,45,47,-2,49
Albion,4530,8,12,9,15,52,53,-1,45
Queen's Park,4530,9,8,9,19,28,51,-23,33
Stenhousem'r,4530,10,7,8,21,48,80,-32,29
Airdrieon,4531,1,20,7,9,60,50,10,67
Livingston,4531,2,20,3,13,81,59,22,63
Alloa,4531,3,17,10,9,63,46,17,61
Brechin,4531,4,18,7,11,59,43,16,61
Peterhead,4531,5,15,10,11,56,49,7,55
East Fife,4531,6,11,11,14,49,44,5,44
Albion,4531,7,11,10,15,54,55,-1,43
Queen's Park,4531,8,11,7,18,37,55,-18,40
Stenhousem'r,4531,9,10,6,20,53,87,-34,36
Stranraer,4531,10,9,5,22,45,69,-24,32
Livingston,4532,1,23,8,5,79,40,39,77
Brechin,4532,2,19,6,11,58,50,8,63
Alloa,4532,3,17,7,12,66,51,15,58
Airdrieon,4532,4,15,8,13,59,55,4,53
Peterhead,4532,5,13,8,15,51,51,0,47
Queen's Park,4532,6,13,7,16,37,48,-11,46
Stranraer,4532,7,12,9,15,55,63,-8,45
Albion,4532,8,12,8,16,52,55,-3,44
East Fife,4532,9,10,12,14,40,40,0,42
Stenhousem'r,4532,10,7,5,24,42,86,-44,26
Livingston,4533,1,24,5,7,73,37,36,77
Alloa,4533,2,17,8,11,68,48,20,59
Albion,4533,3,18,5,13,61,49,12,59
Brechin,4533,4,17,7,12,46,44,2,58
Peterhead,4533,5,14,11,11,46,43,3,53
East Fife,4533,6,14,7,15,50,50,0,49
Airdrieon,4533,7,14,7,15,52,55,-3,49
Stranraer,4533,8,10,8,18,45,61,-16,38
Queen's Park,4533,9,9,7,20,33,53,-20,34
Stenhousem'r,4533,10,6,9,21,45,79,-34,27
Livingston,4534,1,19,5,12,76,50,26,62
Alloa,4534,2,19,5,12,64,43,21,62
Brechin,4534,3,16,9,11,55,52,3,57
Stranraer,4534,4,15,7,14,47,47,0,52
Peterhead,4534,5,15,7,14,49,51,-2,52
Queen's Park,4534,6,16,4,16,42,51,-9,52
Airdrieon,4534,7,15,5,16,53,59,-6,50
East Fife,4534,8,11,10,15,49,48,1,43
Albion,4534,9,12,6,18,55,57,-2,42
Stenhousem'r,4534,10,10,6,20,47,79,-32,36
Airdrieon,4535,1,19,11,6,71,53,18,68
Livingston,4535,2,20,6,10,75,47,28,66
Alloa,4535,3,17,11,8,64,47,17,62
Brechin,4535,4,16,5,15,47,46,1,53
Peterhead,4535,5,14,9,13,54,57,-3,51
Stranraer,4535,6,15,4,17,65,64,1,49
East Fife,4535,7,11,10,15,48,47,1,43
Albion,4535,8,11,10,15,49,60,-11,43
Queen's Park,4535,9,10,6,20,42,57,-15,36
Stenhousem'r,4535,10,6,10,20,49,86,-37,28
Alloa,4536,1,18,9,9,67,46,21,63
Airdrieon,4536,2,19,4,13,64,54,10,61
Livingston,4536,3,19,3,14,75,66,9,60
East Fife,4536,4,15,8,13,69,51,18,53
Queen's Park,4536,5,14,9,13,45,48,-3,51
Brechin,4536,6,15,4,17,46,54,-8,49
Peterhead,4536,7,14,5,17,50,55,-5,47
Stenhousem'r,4536,8,13,7,16,57,70,-13,46
Albion,4536,9,11,8,17,48,60,-12,41
Stranraer,4536,10,9,9,18,50,67,-17,36
Livingston,4537,1,23,8,5,72,38,34,77
Alloa,4537,2,19,11,6,72,44,28,68
Airdrieon,4537,3,15,5,16,46,53,-7,50
Peterhead,4537,4,14,5,17,50,56,-6,47
Albion,4537,5,12,10,14,50,46,4,46
East Fife,4537,6,12,10,14,46,44,2,46
Brechin,4537,7,14,4,18,46,55,-9,46
Stranraer,4537,8,12,9,15,45,52,-7,45
Queen's Park,4537,9,10,13,13,36,47,-11,43
Stenhousem'r,4537,10,7,9,20,52,80,-28,30
Livingston,4538,1,24,4,8,79,44,35,76
Airdrieon,4538,2,17,9,10,66,51,15,60
Peterhead,4538,3,17,7,12,53,45,8,58
Albion,4538,4,16,6,14,57,50,7,54
Alloa,4538,5,13,10,13,59,52,7,49
Queen's Park,4538,6,14,5,17,34,49,-15,47
East Fife,4538,7,11,12,13,52,43,9,45
Stranraer,4538,8,12,9,15,48,56,-8,45
Brechin,4538,9,13,6,17,35,50,-15,45
Stenhousem'r,4538,10,5,8,23,37,80,-43,23
Airdrieon,4539,1,17,10,9,61,54,7,61
Brechin,4539,2,17,9,10,48,43,5,60
Livingston,4539,3,17,6,13,68,50,18,57
Alloa,4539,4,15,10,11,58,45,13,55
Stranraer,4539,5,15,8,13,55,47,8,53
Queen's Park,4539,6,13,9,14,44,47,-3,48
Albion,4539,7,12,7,17,42,44,-2,43
Peterhead,4539,8,12,7,17,46,56,-10,43
East Fife,4539,9,10,10,16,40,46,-6,40
Stenhousem'r,4539,10,11,6,19,44,74,-30,39
Alloa,4540,1,20,8,8,80,46,34,68
Livingston,4540,2,20,8,8,74,47,27,68
Airdrieon,4540,3,15,9,12,59,52,7,54
Peterhead,4540,4,15,8,13,58,55,3,53
Albion,4540,5,13,7,16,50,66,-16,46
Brechin,4540,6,12,8,16,46,51,-5,44
Stranraer,4540,7,12,8,16,55,69,-14,44
Stenhousem'r,4540,8,12,6,18,51,70,-19,42
Queen's Park,4540,9,11,8,17,38,57,-19,41
East Fife,4540,10,10,10,16,59,57,2,40
Alloa,4541,1,27,4,5,92,38,54,85
Livingston,4541,2,25,3,8,86,40,46,78
Airdrieon,4541,3,16,6,14,61,71,-10,54
Brechin,4541,4,16,5,15,56,60,-4,53
Albion,4541,5,15,7,14,58,51,7,52
Peterhead,4541,6,14,7,15,48,52,-4,49
East Fife,4541,7,11,10,15,54,52,2,43
Queen's Park,4541,8,11,3,22,33,54,-21,36
Stranraer,4541,9,9,5,22,38,70,-32,32
Stenhousem'r,4541,10,8,6,22,43,81,-38,30
Livingston,4542,1,21,4,11,80,58,22,67
Alloa,4542,2,18,6,12,69,47,22,60
Airdrieon,4542,3,18,6,12,66,60,6,60
Albion,4542,4,13,12,11,56,49,7,51
Stranraer,4542,5,13,9,14,56,52,4,48
Queen's Park,4542,6,14,6,16,37,49,-12,48
East Fife,4542,7,11,11,14,59,63,-4,44
Brechin,4542,8,13,5,18,47,59,-12,44
Peterhead,4542,9,11,9,16,45,56,-11,42
Stenhousem'r,4542,10,11,6,19,57,79,-22,39
Alloa,4543,1,22,4,10,74,40,34,70
Stranraer,4543,2,18,4,14,58,53,5,58
Albion,4543,3,17,6,13,66,52,14,57
Airdrieon,4543,4,16,9,11,61,47,14,57
Brechin,4543,5,16,8,12,47,41,6,56
Livingston,4543,6,14,10,12,66,57,9,52
Peterhead,4543,7,12,8,16,46,55,-9,44
Queen's Park,4543,8,12,5,19,35,57,-22,41
East Fife,4543,9,10,10,16,46,58,-12,40
Stenhousem'r,4543,10,6,10,20,47,86,-39,28
Alloa,4544,1,20,8,8,69,39,30,68
Livingston,4544,2,21,2,13,78,49,29,65
Brechin,4544,3,18,9,9,55,41,14,63
Airdrieon,4544,4,17,5,14,57,59,-2,56
Peterhead,4544,5,12,10,14,56,54,2,46
East Fife,4544,6,12,9,15,49,49,0,45
Queen's Park,4544,7,13,6,17,39,49,-10,45
Stranraer,4544,8,11,8,17,44,62,-18,41
Albion,4544,9,11,6,19,49,61,-12,39
Stenhousem'r,4544,10,10,7,19,47,80,-33,37
Alloa,4545,1,19,6,11,66,44,22,63
Albion,4545,2,16,9,11,55,45,10,57
Airdrieon,4545,3,16,9,11,53,46,7,57
Brechin,4545,4,17,6,13,59,54,5,57
Livingston,4545,5,16,7,13,75,60,15,55
Stranraer,4545,6,14,7,15,49,53,-4,49
East Fife,4545,7,13,9,14,56,45,11,48
Queen's Park,4545,8,14,6,16,36,47,-11,48
Peterhead,4545,9,11,8,17,50,65,-15,41
Stenhousem'r,4545,10,7,7,22,42,82,-40,28
Airdrieon,4546,1,20,6,10,62,51,11,66
Livingston,4546,2,20,3,13,71,51,20,63
Brechin,4546,3,19,5,12,60,50,10,62
Peterhead,4546,4,17,6,13,49,46,3,57
Albion,4546,5,17,6,13,51,50,1,57
Alloa,4546,6,16,8,12,63,43,20,56
East Fife,4546,7,13,6,17,55,57,-2,45
Stranraer,4546,8,14,2,20,44,57,-13,44
Queen's Park,4546,9,10,7,19,32,50,-18,37
Stenhousem'r,4546,10,7,5,24,45,77,-32,26
Livingston,4547,1,25,4,7,84,45,39,79
Alloa,4547,2,16,10,10,70,53,17,58
Brechin,4547,3,15,9,12,51,49,2,54
Albion,4547,4,13,10,13,55,57,-2,49
East Fife,4547,5,12,11,13,57,48,9,47
Stranraer,4547,6,13,8,15,52,52,0,47
Peterhead,4547,7,13,7,16,45,55,-10,46
Airdrieon,4547,8,12,9,15,50,58,-8,45
Queen's Park,4547,9,10,7,19,37,57,-20,37
Stenhousem'r,4547,10,9,9,18,49,76,-27,36
Livingston,4548,1,23,2,11,82,46,36,71
Alloa,4548,2,17,11,8,73,40,33,62
Airdrieon,4548,3,18,6,12,59,55,4,60
Albion,4548,4,16,8,12,63,57,6,56
Brechin,4548,5,14,8,14,45,58,-13,50
Queen's Park,4548,6,14,6,16,39,48,-9,48
East Fife,4548,7,12,9,15,49,45,4,45
Stranraer,4548,8,11,10,15,53,65,-12,43
Peterhead,4548,9,8,10,18,38,59,-21,34
Stenhousem'r,4548,10,8,8,20,51,79,-28,32
Livingston,4549,1,23,1,12,75,46,29,70
Alloa,4549,2,20,6,10,68,44,24,66
Airdrieon,4549,3,19,5,12,70,54,16,62
Brechin,4549,4,16,4,16,48,48,0,52
Albion,4549,5,13,10,13,45,45,0,49
East Fife,4549,6,13,8,15,50,51,-1,47
Stranraer,4549,7,14,5,17,55,61,-6,47
Peterhead,4549,8,13,7,16,45,55,-10,46
Queen's Park,4549,9,13,6,17,48,58,-10,45
Stenhousem'r,4549,10,6,8,22,38,80,-42,26
Livingston,4550,1,23,4,9,77,51,26,73
Airdrieon,4550,2,18,9,9,59,46,13,63
Alloa,4550,3,15,13,8,64,46,18,58
Brechin,4550,4,17,4,15,49,47,2,55
East Fife,4550,5,15,7,14,61,43,18,52
Stranraer,4550,6,14,4,18,49,58,-9,46
Queen's Park,4550,7,13,7,16,38,48,-10,46
Peterhead,4550,8,12,9,15,37,48,-11,45
Albion,4550,9,10,6,20,48,60,-12,36
Stenhousem'r,4550,10,7,9,20,41,76,-35,30
Stranraer,4551,1,20,3,13,65,53,12,63
Livingston,4551,2,18,7,11,70,47,23,61
Alloa,4551,3,16,11,9,64,47,17,59
Airdrieon,4551,4,16,6,14,58,58,0,54
Albion,4551,5,14,11,11,60,48,12,53
Peterhead,4551,6,14,8,14,47,53,-6,50
East Fife,4551,7,14,7,15,62,44,18,49
Brechin,4551,8,13,8,15,38,50,-12,47
Queen's Park,4551,9,10,10,16,38,55,-17,40
Stenhousem'r,4551,10,6,7,23,38,85,-47,25
Livingston,4552,1,23,8,5,76,42,34,77
Airdrieon,4552,2,18,8,10,59,45,14,62
Alloa,4552,3,16,10,10,69,52,17,58
Peterhead,4552,4,13,11,12,58,58,0,50
Queen's Park,4552,5,14,8,14,49,54,-5,50
Albion,4552,6,14,6,16,54,51,3,48
Brechin,4552,7,13,7,16,41,51,-10,46
Stranraer,4552,8,13,5,18,44,52,-8,44
East Fife,4552,9,9,11,16,45,49,-4,38
Stenhousem'r,4552,10,6,8,22,41,82,-41,26
Livingston,4553,1,24,3,9,86,51,35,75
Alloa,4553,2,19,6,11,69,47,22,63
Airdrieon,4553,3,15,10,11,68,62,6,55
Albion,4553,4,16,7,13,55,54,1,55
Brechin,4553,5,16,6,14,55,59,-4,54
Queen's Park,4553,6,15,9,12,45,50,-5,54
Stranraer,4553,7,14,6,16,61,61,0,48
East Fife,4553,8,10,8,18,53,58,-5,38
Peterhead,4553,9,9,10,17,41,60,-19,37
Stenhousem'r,4553,10,6,7,23,58,89,-31,25
Livingston,4554,1,19,5,12,70,51,19,62
Alloa,4554,2,17,10,9,64,41,23,61
East Fife,4554,3,16,7,13,56,45,11,55
Airdrieon,4554,4,15,8,13,57,53,4,53
Albion,4554,5,13,9,14,44,46,-2,48
Peterhead,4554,6,13,8,15,49,56,-7,47
Brechin,4554,7,13,8,15,47,55,-8,47
Stenhousem'r,4554,8,12,9,15,48,68,-20,45
Queen's Park,4554,9,11,9,16,33,44,-11,42
Stranraer,4554,10,12,5,19,52,61,-9,41
Livingston,4555,1,23,4,9,77,45,32,73
Brechin,4555,2,17,7,12,56,45,11,58
Alloa,4555,3,16,9,11,65,43,22,57
Peterhead,4555,4,15,9,12,48,49,-1,54
Albion,4555,5,15,8,13,60,48,12,53
Airdrieon,4555,6,14,7,15,50,53,-3,49
Stranraer,4555,7,13,5,18,46,55,-9,44
Queen's Park,4555,8,10,9,17,33,54,-21,39
East Fife,4555,9,9,11,16,50,59,-9,38
Stenhousem'r,4555,10,9,9,18,46,80,-34,36
Livingston,4556,1,22,5,9,74,41,33,71
Alloa,4556,2,16,11,9,57,41,16,59
Airdrieon,4556,3,15,10,11,57,55,2,55
East Fife,4556,4,14,11,11,49,37,12,53
Peterhead,4556,5,14,10,12,55,52,3,52
Brechin,4556,6,12,14,10,41,39,2,50
Queen's Park,4556,7,14,7,15,43,54,-11,49
Albion,4556,8,13,6,17,52,53,-1,45
Stranraer,4556,9,8,7,21,45,65,-20,31
Stenhousem'r,4556,10,7,9,20,47,83,-36,30
Livingston,4557,1,22,5,9,74,47,27,71
Brechin,4557,2,16,11,9,50,38,12,59
Alloa,4557,3,16,9,11,63,43,20,57
Albion,4557,4,13,11,12,51,48,3,50
East Fife,4557,5,12,13,11,51,46,5,49
Airdrieon,4557,6,13,10,13,61,57,4,49
Peterhead,4557,7,13,9,14,44,46,-2,48
Stranraer,4557,8,11,11,14,55,61,-6,44
Queen's Park,4557,9,11,8,17,37,55,-18,41
Stenhousem'r,4557,10,6,7,23,41,86,-45,25
Alloa,4558,1,20,7,9,75,46,29,67
Brechin,4558,2,20,4,12,57,48,9,64
Livingston,4558,3,19,5,12,68,53,15,62
Airdrieon,4558,4,17,5,14,57,50,7,56
Albion,4558,5,17,4,15,58,62,-4,55
Peterhead,4558,6,13,8,15,60,64,-4,47
East Fife,4558,7,11,11,14,56,53,3,44
Queen's Park,4558,8,12,6,18,42,53,-11,42
Stranraer,4558,9,11,4,21,44,68,-24,37
Stenhousem'r,4558,10,9,8,19,53,73,-20,35
Brechin,4559,1,20,6,10,51,39,12,66
Livingston,4559,2,20,2,14,72,50,22,62
Alloa,4559,3,17,8,11,62,43,19,59
Airdrieon,4559,4,15,9,12,59,55,4,54
Albion,4559,5,14,9,13,55,53,2,51
Stranraer,4559,6,15,6,15,43,46,-3,51
Peterhead,4559,7,13,10,13,52,54,-2,49
East Fife,4559,8,11,10,15,44,47,-3,43
Stenhousem'r,4559,9,9,8,19,40,63,-23,35
Queen's Park,4559,10,9,6,21,30,58,-28,33
Alloa,4560,1,20,8,8,70,42,28,68
Livingston,4560,2,21,4,11,76,46,30,67
Airdrieon,4560,3,19,8,9,70,47,23,65
Peterhead,4560,4,15,9,12,51,49,2,54
Brechin,4560,5,15,5,16,44,52,-8,50
Queen's Park,4560,6,14,7,15,42,46,-4,49
Stranraer,4560,7,13,8,15,44,54,-10,47
East Fife,4560,8,10,9,17,50,59,-9,39
Albion,4560,9,11,6,19,47,56,-9,39
Stenhousem'r,4560,10,5,10,21,42,85,-43,25
Alloa,4561,1,20,6,10,75,50,25,66
Livingston,4561,2,19,5,12,77,49,28,62
Airdrieon,4561,3,17,8,11,61,56,5,59
Peterhead,4561,4,17,5,14,50,47,3,56
Queen's Park,4561,5,16,7,13,46,53,-7,55
Brechin,4561,6,15,5,16,43,42,1,50
Albion,4561,7,11,8,17,45,56,-11,41
East Fife,4561,8,10,9,17,45,55,-10,39
Stenhousem'r,4561,9,11,6,19,47,71,-24,39
Stranraer,4561,10,9,11,16,44,54,-10,38
Livingston,4562,1,25,2,9,86,50,36,77
Alloa,4562,2,22,5,9,80,51,29,71
Peterhead,4562,3,16,7,13,55,53,2,55
Airdrieon,4562,4,16,6,14,57,55,2,54
Albion,4562,5,13,10,13,57,49,8,49
Queen's Park,4562,6,14,7,15,41,59,-18,49
Brechin,4562,7,14,4,18,45,55,-10,46
Stranraer,4562,8,12,5,19,52,59,-7,41
East Fife,4562,9,9,12,15,44,48,-4,39
Stenhousem'r,4562,10,8,4,24,44,82,-38,28
Livingston,4563,1,23,6,7,84,40,44,75
Alloa,4563,2,20,9,7,68,38,30,69
Brechin,4563,3,19,7,10,53,41,12,64
Peterhead,4563,4,16,7,13,51,46,5,55
Airdrieon,4563,5,14,6,16,54,61,-7,48
East Fife,4563,6,11,10,15,53,49,4,43
Queen's Park,4563,7,11,10,15,33,52,-19,43
Albion,4563,8,11,8,17,49,60,-11,41
Stranraer,4563,9,10,9,17,47,58,-11,39
Stenhousem'r,4563,10,5,8,23,43,90,-47,23
Livingston,4564,1,20,8,8,78,39,39,68
Alloa,4564,2,20,4,12,73,42,31,64
Airdrieon,4564,3,18,6,12,60,53,7,60
Brechin,4564,4,16,7,13,46,47,-1,55
Peterhead,4564,5,14,9,13,54,58,-4,51
East Fife,4564,6,13,11,12,61,48,13,50
Albion,4564,7,12,10,14,49,53,-4,46
Queen's Park,4564,8,13,6,17,42,51,-9,45
Stranraer,4564,9,12,6,18,52,70,-18,42
Stenhousem'r,4564,10,4,9,23,36,90,-54,21
Livingston,4565,1,21,7,8,78,43,35,70
Airdrieon,4565,2,19,9,8,71,52,19,66
Alloa,4565,3,19,5,12,71,43,28,62
Brechin,4565,4,18,7,11,54,41,13,61
Queen's Park,4565,5,15,6,15,46,53,-7,51
Albion,4565,6,15,5,16,56,56,0,50
Peterhead,4565,7,12,6,18,39,58,-19,42
East Fife,4565,8,11,8,17,52,57,-5,41
Stenhousem'r,4565,9,9,7,20,49,87,-38,34
Stranraer,4565,10,8,6,22,50,76,-26,30
Livingston,4566,1,22,4,10,75,46,29,70
Brechin,4566,2,20,5,11,61,50,11,65
Airdrieon,4566,3,17,7,12,64,51,13,58
Alloa,4566,4,15,11,10,58,44,14,56
East Fife,4566,5,14,6,16,51,45,6,48
Albion,4566,6,14,6,16,52,53,-1,48
Stenhousem'r,4566,7,12,6,18,49,70,-21,42
Stranraer,4566,8,11,8,17,46,56,-10,41
Queen's Park,4566,9,11,7,18,30,49,-19,40
Peterhead,4566,10,10,8,18,37,59,-22,38
Brechin,4567,1,20,7,9,61,45,16,67
Alloa,4567,2,19,6,11,72,48,24,63
Livingston,4567,3,18,5,13,62,43,19,59
Peterhead,4567,4,16,6,14,50,48,2,54
Albion,4567,5,14,9,13,53,52,1,51
Airdrieon,4567,6,14,7,15,55,61,-6,49
Queen's Park,4567,7,14,7,15,38,45,-7,49
East Fife,4567,8,12,8,16,52,59,-7,44
Stranraer,4567,9,10,9,17,41,53,-12,39
Stenhousem'r,4567,10,8,6,22,45,75,-30,30
Livingston,4568,1,22,3,11,80,51,29,69
Alloa,4568,2,18,6,12,74,54,20,60
Brechin,4568,3,17,8,11,56,52,4,59
Airdrieon,4568,4,15,8,13,66,51,15,53
Albion,4568,5,12,13,11,59,58,1,49
Peterhead,4568,6,13,8,15,49,59,-10,47
East Fife,4568,7,12,9,15,48,47,1,45
Stranraer,4568,8,12,7,17,54,58,-4,43
Queen's Park,4568,9,11,9,16,37,54,-17,42
Stenhousem'r,4568,10,7,11,18,41,80,-39,32
Livingston,4569,1,21,7,8,85,52,33,70
Brechin,4569,2,18,5,13,54,42,12,59
Alloa,4569,3,16,7,13,61,48,13,55
Airdrieon,4569,4,15,6,15,48,48,0,51
Peterhead,4569,5,15,6,15,47,52,-5,51
Albion,4569,6,14,7,15,55,56,-1,49
East Fife,4569,7,12,12,12,47,43,4,48
Stranraer,4569,8,15,1,20,49,59,-10,46
Queen's Park,4569,9,11,11,14,37,50,-13,44
Stenhousem'r,4569,10,7,10,19,49,82,-33,31
Peterhead,4570,1,19,8,9,63,42,21,65
Livingston,4570,2,19,7,10,77,56,21,64
Brechin,4570,3,18,10,8,56,37,19,64
Alloa,4570,4,18,8,10,82,61,21,62
Airdrieon,4570,5,15,7,14,57,56,1,52
Albion,4570,6,12,9,15,48,55,-7,45
Queen's Park,4570,7,11,9,16,46,54,-8,42
East Fife,4570,8,10,10,16,42,51,-9,40
Stranraer,4570,9,11,7,18,47,63,-16,40
Stenhousem'r,4570,10,5,9,22,40,83,-43,24
Alloa,4571,1,21,7,8,76,38,38,70
Brechin,4571,2,20,5,11,62,51,11,65
Airdrieon,4571,3,16,10,10,62,51,11,58
Livingston,4571,4,16,6,14,73,61,12,54
Albion,4571,5,13,10,13,52,53,-1,49
East Fife,4571,6,12,9,15,52,49,3,45
Stranraer,4571,7,13,6,17,50,59,-9,45
Peterhead,4571,8,12,8,16,51,66,-15,44
Queen's Park,4571,9,9,9,18,36,52,-16,36
Stenhousem'r,4571,10,8,10,18,44,78,-34,34
Livingston,4572,1,22,6,8,78,44,34,72
Alloa,4572,2,21,6,9,79,46,33,69
Peterhead,4572,3,17,8,11,49,44,5,59
Albion,4572,4,15,11,10,58,46,12,56
Airdrieon,4572,5,13,9,14,52,56,-4,48
East Fife,4572,6,13,8,15,46,47,-1,47
Brechin,4572,7,14,4,18,43,48,-5,46
Stranraer,4572,8,13,5,18,47,54,-7,44
Stenhousem'r,4572,9,10,5,21,41,71,-30,35
Queen's Park,4572,10,7,8,21,26,63,-37,29
Livingston,4573,1,24,4,8,79,45,34,76
Alloa,4573,2,20,6,10,79,47,32,66
Airdrieon,4573,3,15,9,12,55,53,2,54
East Fife,4573,4,14,11,11,48,41,7,53
Albion,4573,5,14,8,14,50,44,6,50
Brechin,4573,6,13,8,15,48,54,-6,47
Peterhead,4573,7,12,10,14,47,48,-1,46
Queen's Park,4573,8,11,8,17,36,56,-20,41
Stranraer,4573,9,11,6,19,45,64,-19,39
Stenhousem'r,4573,10,7,8,21,47,82,-35,29
Alloa,4574,1,21,8,7,85,44,41,71
Livingston,4574,2,21,6,9,79,50,29,69
Airdrieon,4574,3,19,8,9,69,51,18,65
Brechin,4574,4,17,5,14,52,55,-3,56
Peterhead,4574,5,15,9,12,57,54,3,54
Albion,4574,6,15,5,16,53,50,3,50
East Fife,4574,7,11,8,17,49,50,-1,41
Queen's Park,4574,8,11,6,19,34,57,-23,39
Stranraer,4574,9,9,7,20,40,63,-23,34
Stenhousem'r,4574,10,8,4,24,47,91,-44,28
Livingston,4575,1,22,6,8,89,43,46,72
Alloa,4575,2,19,11,6,76,36,40,68
Brechin,4575,3,16,6,14,46,45,1,54
Airdrieon,4575,4,16,5,15,68,64,4,53
East Fife,4575,5,12,10,14,54,48,6,46
Stranraer,4575,6,13,6,17,46,61,-15,45
Albion,4575,7,11,11,14,49,60,-11,44
Peterhead,4575,8,12,6,18,46,65,-19,42
Queen's Park,4575,9,11,9,16,36,56,-20,42
Stenhousem'r,4575,10,9,8,19,47,79,-32,35
Alloa,4576,1,20,6,10,73,44,29,66
Airdrieon,4576,2,20,6,10,69,52,17,66
Livingston,4576,3,21,2,13,69,50,19,65
Brechin,4576,4,18,5,13,61,53,8,59
Albion,4576,5,16,8,12,56,54,2,56
Peterhead,4576,6,12,9,15,52,55,-3,45
Stranraer,4576,7,11,9,16,54,63,-9,42
Queen's Park,4576,8,10,8,18,32,53,-21,38
East Fife,4576,9,7,13,16,47,55,-8,34
Stenhousem'r,4576,10,8,8,20,53,87,-34,32
Airdrieon,4577,1,19,7,10,58,45,13,64
Brechin,4577,2,18,9,9,60,48,12,63
Albion,4577,3,16,9,11,50,44,6,57
Alloa,4577,4,16,7,13,65,52,13,55
Peterhead,4577,5,15,9,12,50,50,0,54
Livingston,4577,6,14,9,13,65,58,7,51
Stranraer,4577,7,15,5,16,61,57,4,50
Queen's Park,4577,8,13,6,17,43,54,-11,45
East Fife,4577,9,9,11,16,43,49,-6,38
Stenhousem'r,4577,10,4,10,22,41,79,-38,22
Alloa,4578,1,20,6,10,68,44,24,66
Livingston,4578,2,19,6,11,70,47,23,63
Brechin,4578,3,19,4,13,66,54,12,61
Albion,4578,4,16,8,12,65,63,2,56
Airdrieon,4578,5,16,4,16,59,57,2,52
Stranraer,4578,6,15,4,17,61,65,-4,49
Queen's Park,4578,7,13,6,17,39,54,-15,45
East Fife,4578,8,12,8,16,51,48,3,44
Peterhead,4578,9,11,5,20,52,74,-22,38
Stenhousem'r,4578,10,11,5,20,58,83,-25,38
Livingston,4579,1,22,4,10,76,42,34,70
Alloa,4579,2,17,8,11,74,50,24,59
Airdrieon,4579,3,18,5,13,56,62,-6,59
Brechin,4579,4,16,7,13,61,49,12,55
Peterhead,4579,5,15,7,14,55,61,-6,52
Stranraer,4579,6,15,5,16,50,48,2,50
Albion,4579,7,14,6,16,55,68,-13,48
East Fife,4579,8,12,10,14,56,48,8,46
Queen's Park,4579,9,12,10,14,39,45,-6,46
Stenhousem'r,4579,10,6,4,26,37,86,-49,22
Livingston,4580,1,24,2,10,91,44,47,74
Brechin,4580,2,17,8,11,52,47,5,59
Alloa,4580,3,14,11,11,55,43,12,53
Queen's Park,4580,4,14,10,12,39,48,-9,52
Airdrieon,4580,5,15,5,16,68,68,0,50
Albion,4580,6,13,9,14,49,52,-3,48
Peterhead,4580,7,13,7,16,50,60,-10,46
Stranraer,4580,8,12,6,18,60,65,-5,42
East Fife,4580,9,9,14,13,40,42,-2,41
Stenhousem'r,4580,10,10,6,20,50,85,-35,36
Alloa,4581,1,21,8,7,74,39,35,71
Livingston,4581,2,18,8,10,66,43,23,62
Airdrieon,4581,3,17,9,10,62,47,15,60
Brechin,4581,4,16,11,9,58,44,14,59
Albion,4581,5,15,7,14,58,48,10,52
Queen's Park,4581,6,13,10,13,42,50,-8,49
Peterhead,4581,7,13,9,14,51,54,-3,48
Stranraer,4581,8,12,4,20,41,65,-24,40
East Fife,4581,9,9,6,21,42,54,-12,33
Stenhousem'r,4581,10,5,10,21,41,91,-50,25
Livingston,4582,1,23,6,7,75,38,37,75
Alloa,4582,2,19,7,10,67,43,24,64
Brechin,4582,3,19,5,12,48,40,8,62
Airdrieon,4582,4,18,6,12,67,54,13,60
Peterhead,4582,5,14,8,14,56,52,4,50
East Fife,4582,6,14,5,17,49,48,1,47
Albion,4582,7,12,8,16,52,62,-10,44
Stranraer,4582,8,11,7,18,52,63,-11,40
Queen's Park,4582,9,12,4,20,37,58,-21,40
Stenhousem'r,4582,10,8,4,24,49,94,-45,28
Livingston,4583,1,19,6,11,79,52,27,63
Brechin,4583,2,19,5,12,52,50,2,62
Airdrieon,4583,3,18,6,12,69,58,11,60
Albion,4583,4,15,7,14,51,53,-2,52
Queen's Park,4583,5,14,9,13,40,41,-1,51
Alloa,4583,6,13,8,15,64,52,12,47
Stranraer,4583,7,14,3,19,50,53,-3,45
East Fife,4583,8,12,9,15,44,50,-6,45
Stenhousem'r,4583,9,10,11,15,55,72,-17,41
Peterhead,4583,10,9,10,17,36,59,-23,37
Alloa,4584,1,20,6,10,71,39,32,66
Livingston,4584,2,19,5,12,70,46,24,62
Brechin,4584,3,19,3,14,51,50,1,60
Airdrieon,4584,4,17,6,13,52,49,3,57
Albion,4584,5,12,12,12,50,44,6,48
Queen's Park,4584,6,13,9,14,39,51,-12,48
Stranraer,4584,7,14,5,17,54,60,-6,47
Peterhead,4584,8,13,6,17,44,51,-7,45
East Fife,4584,9,11,9,16,39,46,-7,42
Stenhousem'r,4584,10,7,9,20,34,68,-34,30
Alloa,4585,1,17,11,8,68,39,29,62
Livingston,4585,2,19,4,13,70,48,22,61
Brechin,4585,3,15,9,12,44,37,7,54
Peterhead,4585,4,15,7,14,48,55,-7,52
East Fife,4585,5,15,6,15,50,43,7,51
Stranraer,4585,6,15,5,16,52,54,-2,50
Albion,4585,7,14,6,16,45,50,-5,48
Airdrieon,4585,8,13,6,17,60,65,-5,45
Queen's Park,4585,9,11,10,15,34,54,-20,43
Stenhousem'r,4585,10,11,6,19,51,77,-26,39
Livingston,4586,1,22,5,9,85,46,39,71
Airdrieon,4586,2,18,8,10,65,46,19,62
Albion,4586,3,17,7,12,65,48,17,58
Brechin,4586,4,17,3,16,49,53,-4,54
Alloa,4586,5,15,8,13,64,56,8,53
Peterhead,4586,6,14,10,12,57,55,2,52
Stranraer,4586,7,13,5,18,54,66,-12,44
Queen's Park,4586,8,11,8,17,38,52,-14,41
East Fife,4586,9,10,7,19,45,60,-15,37
Stenhousem'r,4586,10,9,7,20,46,86,-40,34
Airdrieon,4587,1,21,6,9,64,50,14,69
Alloa,4587,2,17,12,7,68,44,24,63
Livingston,4587,3,19,4,13,76,46,30,61
Brechin,4587,4,16,6,14,57,48,9,54
Queen's Park,4587,5,13,8,15,38,54,-16,47
Peterhead,4587,6,12,10,14,46,53,-7,46
Albion,4587,7,12,9,15,53,53,0,45
East Fife,4587,8,11,12,13,51,52,-1,45
Stranraer,4587,9,10,6,20,36,60,-24,36
Stenhousem'r,4587,10,7,11,18,44,73,-29,32
Alloa,4588,1,19,9,8,75,44,31,66
Airdrieon,4588,2,17,10,9,69,55,14,61
Livingston,4588,3,18,6,12,72,56,16,60
Albion,4588,4,13,13,10,52,48,4,52
Peterhead,4588,5,14,8,14,40,44,-4,50
East Fife,4588,6,12,10,14,56,56,0,46
Brechin,4588,7,13,6,17,48,55,-7,45
Stranraer,4588,8,12,7,17,48,50,-2,43
Queen's Park,4588,9,11,9,16,42,59,-17,42
Stenhousem'r,4588,10,8,8,20,46,81,-35,32
Alloa,4589,1,23,5,8,75,42,33,74
Livingston,4589,2,22,5,9,69,41,28,71
Airdrieon,4589,3,17,5,14,52,53,-1,56
Albion,4589,4,14,9,13,57,53,4,51
Stranraer,4589,5,15,6,15,51,53,-2,51
Brechin,4589,6,13,10,13,42,44,-2,49
Peterhead,4589,7,13,7,16,46,48,-2,46
Queen's Park,4589,8,10,10,16,33,48,-15,40
East Fife,4589,9,8,15,13,48,49,-1,39
Stenhousem'r,4589,10,4,10,22,37,79,-42,22
Livingston,4590,1,19,8,9,84,58,26,65
Albion,4590,2,18,9,9,66,51,15,63
Alloa,4590,3,16,9,11,61,49,12,57
Queen's Park,4590,4,16,7,13,39,50,-11,55
Brechin,4590,5,15,6,15,50,50,0,51
Peterhead,4590,6,13,11,12,53,49,4,50
Airdrieon,4590,7,13,7,16,56,59,-3,46
Stranraer,4590,8,12,8,16,57,57,0,44
East Fife,4590,9,10,9,17,46,61,-15,39
Stenhousem'r,4590,10,9,4,23,52,80,-28,31
Livingston,4591,1,21,3,12,69,46,23,66
Alloa,4591,2,18,11,7,69,45,24,65
Airdrieon,4591,3,17,10,9,55,42,13,61
Albion,4591,4,15,11,10,57,52,5,56
Brechin,4591,5,15,8,13,52,43,9,53
Queen's Park,4591,6,14,7,15,32,41,-9,49
Stranraer,4591,7,13,5,18,45,60,-15,44
Peterhead,4591,8,11,7,18,48,66,-18,40
East Fife,4591,9,9,11,16,44,44,0,38
Stenhousem'r,4591,10,7,7,22,45,77,-32,28
Livingston,4592,1,20,7,9,79,55,24,67
Alloa,4592,2,18,7,11,82,49,33,61
Airdrieon,4592,3,16,10,10,67,54,13,58
East Fife,4592,4,13,13,10,56,49,7,52
Brechin,4592,5,14,7,15,54,57,-3,49
Peterhead,4592,6,12,9,15,52,58,-6,45
Albion,4592,7,13,5,18,48,57,-9,44
Queen's Park,4592,8,12,8,16,35,54,-19,44
Stranraer,4592,9,11,7,18,44,63,-19,40
Stenhousem'r,4592,10,11,7,18,51,72,-21,40
Livingston,4593,1,22,6,8,74,43,31,72
Brechin,4593,2,20,9,7,68,42,26,69
Peterhead,4593,3,15,8,13,55,51,4,53
Alloa,4593,4,13,13,10,61,45,16,52
Airdrieon,4593,5,14,6,16,59,61,-2,48
Queen's Park,4593,6,13,9,14,36,43,-7,48
Albion,4593,7,11,7,18,47,67,-20,40
East Fife,4593,8,9,12,15,45,52,-7,39
Stranraer,4593,9,10,9,17,54,71,-17,39
Stenhousem'r,4593,10,9,9,18,52,76,-24,36
Livingston,4594,1,20,6,10,76,40,36,66
Alloa,4594,2,19,9,8,71,42,29,66
Airdrieon,4594,3,18,8,10,61,54,7,62
Brechin,4594,4,15,8,13,44,42,2,53
East Fife,4594,5,14,9,13,52,44,8,51
Albion,4594,6,13,10,13,41,47,-6,49
Peterhead,4594,7,12,11,13,46,47,-1,47
Queen's Park,4594,8,12,7,17,39,48,-9,43
Stranraer,4594,9,10,6,20,50,73,-23,36
Stenhousem'r,4594,10,6,8,22,39,82,-43,26
Alloa,4595,1,21,8,7,79,43,36,71
Livingston,4595,2,21,4,11,77,55,22,67
Brechin,4595,3,19,8,9,61,47,14,65
Albion,4595,4,17,10,9,57,42,15,61
Airdrieon,4595,5,14,9,13,53,60,-7,51
Peterhead,4595,6,13,8,15,46,54,-8,47
Stranraer,4595,7,11,9,16,49,52,-3,42
East Fife,4595,8,8,11,17,46,51,-5,35
Stenhousem'r,4595,9,8,7,21,46,83,-37,31
Queen's Park,4595,10,7,8,21,37,64,-27,29
Alloa,4596,1,22,6,8,71,40,31,72
Livingston,4596,2,19,4,13,70,47,23,61
Airdrieon,4596,3,17,6,13,56,44,12,57
Brechin,4596,4,17,4,15,52,53,-1,55
East Fife,4596,5,15,6,15,48,39,9,51
Albion,4596,6,14,9,13,52,44,8,51
Peterhead,4596,7,14,6,16,47,54,-7,48
Stranraer,4596,8,14,2,20,41,54,-13,44
Queen's Park,4596,9,11,7,18,36,57,-21,40
Stenhousem'r,4596,10,9,6,21,49,90,-41,33
Brechin,4597,1,21,6,9,62,38,24,69
Alloa,4597,2,18,9,9,66,44,22,63
Airdrieon,4597,3,19,6,11,65,53,12,63
Livingston,4597,4,16,5,15,68,62,6,53
Queen's Park,4597,5,14,6,16,38,51,-13,48
Peterhead,4597,6,13,8,15,53,53,0,47
Albion,4597,7,12,11,13,52,54,-2,47
East Fife,4597,8,12,9,15,42,43,-1,45
Stranraer,4597,9,12,6,18,45,54,-9,42
Stenhousem'r,4597,10,6,8,22,47,86,-39,26
Alloa,4598,1,22,7,7,72,40,32,73
Airdrieon,4598,2,19,9,8,57,43,14,66
Brechin,4598,3,18,8,10,48,40,8,62
Livingston,4598,4,18,5,13,68,49,19,59
Albion,4598,5,15,11,10,50,42,8,56
Queen's Park,4598,6,13,4,19,38,49,-11,43
Stranraer,4598,7,12,6,18,48,53,-5,42
East Fife,4598,8,8,15,13,44,45,-1,39
Peterhead,4598,9,8,10,18,38,56,-18,34
Stenhousem'r,4598,10,6,7,23,36,82,-46,25
Livingston,4599,1,24,3,9,81,50,31,75
Brechin,4599,2,18,7,11,57,47,10,61
Peterhead,4599,3,17,7,12,54,49,5,58
Alloa,4599,4,17,5,14,65,45,20,56
Airdrieon,4599,5,14,9,13,56,46,10,51
Albion,4599,6,13,9,14,49,52,-3,48
Queen's Park,4599,7,11,8,17,37,50,-13,41
Stranraer,4599,8,12,4,20,54,68,-14,40
East Fife,4599,9,9,10,17,43,60,-17,37
Stenhousem'r,4599,10,9,10,17,43,72,-29,37
Alloa,4600,1,19,8,9,72,49,23,65
Livingston,4600,2,19,6,11,71,50,21,63
East Fife,4600,3,16,10,10,59,46,13,58
Airdrieon,4600,4,15,8,13,57,59,-2,53
Brechin,4600,5,15,7,14,47,45,2,52
Peterhead,4600,6,14,8,14,47,47,0,50
Stranraer,4600,7,15,5,16,48,51,-3,50
Albion,4600,8,14,6,16,53,53,0,48
Queen's Park,4600,9,11,8,17,35,51,-16,41
Stenhousem'r,4600,10,6,6,24,43,81,-38,24
Livingston,4601,1,24,1,11,82,50,32,73
Alloa,4601,2,18,8,10,81,49,32,62
Brechin,4601,3,19,3,14,45,44,1,60
Airdrieon,4601,4,16,6,14,56,57,-1,54
Albion,4601,5,14,9,13,52,54,-2,51
Queen's Park,4601,6,14,6,16,39,48,-9,48
Stenhousem'r,4601,7,12,8,16,54,68,-14,44
Stranraer,4601,8,12,6,18,52,59,-7,42
Peterhead,4601,9,11,8,17,39,46,-7,41
East Fife,4601,10,8,9,19,35,60,-25,33
Livingston,4602,1,20,5,11,70,50,20,65
Alloa,4602,2,16,7,13,60,42,18,55
Brechin,4602,3,15,10,11,54,40,14,55
Albion,4602,4,15,7,14,53,54,-1,52
Airdrieon,4602,5,15,6,15,56,53,3,51
Peterhead,4602,6,13,9,14,45,56,-11,48
East Fife,4602,7,11,13,12,59,52,7,46
Queen's Park,4602,8,13,7,16,35,49,-14,46
Stranraer,4602,9,11,9,16,44,54,-10,42
Stenhousem'r,4602,10,11,7,18,45,71,-26,40
Alloa,4603,1,22,6,8,72,37,35,72
Livingston,4603,2,20,3,13,76,50,26,63
Airdrieon,4603,3,16,7,13,57,48,9,55
Brechin,4603,4,16,7,13,48,48,0,55
East Fife,4603,5,14,10,12,56,53,3,52
Albion,4603,6,12,10,14,48,52,-4,46
Peterhead,4603,7,12,8,16,45,53,-8,44
Queen's Park,4603,8,12,7,17,31,51,-20,43
Stranraer,4603,9,12,4,20,47,62,-15,40
Stenhousem'r,4603,10,10,6,20,40,66,-26,36
Livingston,4604,1,24,4,8,78,44,34,76
Brechin,4604,2,19,6,11,59,52,7,63
Alloa,4604,3,17,9,10,68,46,22,60
Stranraer,4604,4,16,3,17,50,51,-1,51
Queen's Park,4604,5,15,6,15,46,48,-2,51
Airdrieon,4604,6,16,3,17,58,65,-7,51
Peterhead,4604,7,14,7,15,46,52,-6,49
Albion,4604,8,12,9,15,59,58,1,45
East Fife,4604,9,11,9,16,50,56,-6,42
Stenhousem'r,4604,10,5,6,25,46,88,-42,21
Livingston,4605,1,26,3,7,79,38,41,81
Brechin,4605,2,19,6,11,52,37,15,63
Alloa,4605,3,17,8,11,69,48,21,59
Albion,4605,4,14,12,10,52,47,5,54
Peterhead,4605,5,13,8,15,43,46,-3,47
Stranraer,4605,6,12,9,15,47,54,-7,45
Airdrieon,4605,7,12,8,16,44,59,-15,44
East Fife,4605,8,10,10,16,44,52,-8,40
Queen's Park,4605,9,11,5,20,35,54,-19,38
Stenhousem'r,4605,10,8,7,21,46,76,-30,31
Livingston,4606,1,25,5,6,80,40,40,80
Brechin,4606,2,17,6,13,53,51,2,57
Albion,4606,3,16,7,13,63,52,11,55
Airdrieon,4606,4,15,9,12,60,55,5,54
Alloa,4606,5,15,7,14,56,47,9,52
Peterhead,4606,6,13,8,15,48,54,-6,47
Stranraer,4606,7,13,4,19,53,61,-8,43
Queen's Park,4606,8,11,8,17,34,53,-19,41
Stenhousem'r,4606,9,10,9,17,51,73,-22,39
East Fife,4606,10,9,9,18,47,59,-12,36
Livingston,4607,1,21,3,12,84,54,30,66
Alloa,4607,2,19,7,10,80,48,32,64
Brechin,4607,3,18,7,11,54,45,9,61
Airdrieon,4607,4,17,8,11,58,53,5,59
East Fife,4607,5,13,10,13,53,50,3,49
Peterhead,4607,6,12,9,15,52,61,-9,45
Queen's Park,4607,7,10,11,15,36,53,-17,41
Stranraer,4607,8,11,7,18,50,61,-11,40
Albion,4607,9,10,8,18,51,70,-19,38
Stenhousem'r,4607,10,9,10,17,55,78,-23,37
Airdrieon,4608,1,20,7,9,62,46,16,67
Alloa,4608,2,18,11,7,72,45,27,65
Livingston,4608,3,18,6,12,74,52,22,60
Brechin,4608,4,16,8,12,44,42,2,56
Albion,4608,5,14,6,16,54,55,-1,48
Queen's Park,4608,6,14,3,19,41,57,-16,45
Peterhead,4608,7,12,8,16,40,48,-8,44
East Fife,4608,8,11,10,15,49,55,-6,43
Stranraer,4608,9,12,3,21,46,63,-17,39
Stenhousem'r,4608,10,9,10,17,51,70,-19,37
Livingston,4609,1,21,7,8,75,38,37,70
Alloa,4609,2,21,5,10,73,46,27,68
Brechin,4609,3,15,12,9,56,46,10,57
Queen's Park,4609,4,14,8,14,46,54,-8,50
Airdrieon,4609,5,14,6,16,51,53,-2,48
Albion,4609,6,13,8,15,53,60,-7,47
Peterhead,4609,7,12,9,15,51,54,-3,45
Stranraer,4609,8,12,7,17,47,60,-13,43
East Fife,4609,9,9,10,17,44,51,-7,37
Stenhousem'r,4609,10,7,12,17,53,87,-34,33
Alloa,4610,1,20,8,8,73,44,29,68
Livingston,4610,2,19,8,9,79,47,32,65
Albion,4610,3,18,7,11,61,48,13,61
Brechin,4610,4,18,7,11,58,52,6,61
East Fife,4610,5,13,10,13,61,49,12,49
Stranraer,4610,6,12,8,16,51,65,-14,44
Airdrieon,4610,7,11,10,15,49,59,-10,43
Queen's Park,4610,8,11,7,18,33,53,-20,40
Peterhead,4610,9,10,8,18,43,58,-15,38
Stenhousem'r,4610,10,8,7,21,45,78,-33,31
Livingston,4611,1,23,4,9,80,45,35,73
Brechin,4611,2,18,6,12,54,51,3,60
Alloa,4611,3,15,9,12,75,54,21,54
Albion,4611,4,15,8,13,56,49,7,53
Airdrieon,4611,5,15,7,14,61,57,4,52
Stranraer,4611,6,15,4,17,54,53,1,49
Peterhead,4611,7,13,8,15,53,67,-14,47
East Fife,4611,8,11,12,13,50,54,-4,45
Queen's Park,4611,9,12,7,17,30,44,-14,43
Stenhousem'r,4611,10,6,9,21,46,85,-39,27
Alloa,4612,1,20,6,10,66,44,22,66
Airdrieon,4612,2,19,8,9,64,49,15,65
Livingston,4612,3,18,7,11,75,46,29,61
Brechin,4612,4,17,8,11,54,45,9,59
Albion,4612,5,13,11,12,47,50,-3,50
Queen's Park,4612,6,13,9,14,38,53,-15,48
Peterhead,4612,7,11,8,17,48,61,-13,41
East Fife,4612,8,10,10,16,48,51,-3,40
Stranraer,4612,9,10,9,17,53,67,-14,39
Stenhousem'r,4612,10,7,8,21,49,76,-27,29
Livingston,4613,1,22,5,9,82,49,33,71
Alloa,4613,2,18,11,7,63,37,26,65
Airdrieon,4613,3,16,8,12,59,61,-2,56
Albion,4613,4,15,10,11,63,51,12,55
Peterhead,4613,5,13,9,14,50,53,-3,48
Brechin,4613,6,15,3,18,47,53,-6,48
Queen's Park,4613,7,12,10,14,36,46,-10,46
Stranraer,4613,8,12,6,18,48,61,-13,42
East Fife,4613,9,9,12,15,48,53,-5,39
Stenhousem'r,4613,10,7,8,21,46,78,-32,29
Brechin,4614,1,21,6,9,60,45,15,69
Livingston,4614,2,20,4,12,76,52,24,64
Alloa,4614,3,18,7,11,69,46,23,61
Peterhead,4614,4,15,8,13,56,54,2,53
Airdrieon,4614,5,14,8,14,56,61,-5,50
Stranraer,4614,6,13,6,17,50,53,-3,45
Albion,4614,7,11,11,14,50,59,-9,44
East Fife,4614,8,11,8,17,49,52,-3,41
Queen's Park,4614,9,10,10,16,39,57,-18,40
Stenhousem'r,4614,10,8,10,18,50,76,-26,34
Livingston,4615,1,20,5,11,78,53,25,65
Alloa,4615,2,18,9,9,71,42,29,63
Airdrieon,4615,3,19,5,12,63,57,6,62
Stranraer,4615,4,16,5,15,61,57,4,53
Brechin,4615,5,15,6,15,56,53,3,51
East Fife,4615,6,14,9,13,50,48,2,51
Peterhead,4615,7,13,6,17,51,58,-7,45
Queen's Park,4615,8,12,9,15,30,49,-19,45
Albion,4615,9,13,5,18,48,55,-7,44
Stenhousem'r,4615,10,7,7,22,46,82,-36,28
Livingston,4616,1,25,3,8,80,40,40,78
Alloa,4616,2,20,7,9,81,46,35,67
Brechin,4616,3,19,6,11,59,43,16,63
Airdrieon,4616,4,16,6,14,59,57,2,54
Peterhead,4616,5,14,9,13,57,59,-2,51
East Fife,4616,6,10,10,16,48,57,-9,40
Stranraer,4616,7,11,7,18,52,65,-13,40
Albion,4616,8,10,9,17,54,65,-11,39
Queen's Park,4616,9,7,14,15,32,50,-18,35
Stenhousem'r,4616,10,10,5,21,48,88,-40,35
Alloa,4617,1,25,6,5,74,34,40,81
Livingston,4617,2,19,5,12,67,47,20,62
Brechin,4617,3,19,4,13,61,47,14,61
Airdrieon,4617,4,14,9,13,54,56,-2,51
Queen's Park,4617,5,16,3,17,43,50,-7,51
Peterhead,4617,6,12,10,14,49,55,-6,46
Albion,4617,7,13,7,16,49,60,-11,46
Stenhousem'r,4617,8,11,8,17,51,71,-20,41
East Fife,4617,9,10,8,18,39,49,-10,38
Stranraer,4617,10,9,4,23,45,63,-18,31
Livingston,4618,1,22,5,9,74,42,32,71
Brechin,4618,2,22,4,10,55,41,14,70
Alloa,4618,3,20,3,13,71,48,23,63
Airdrieon,4618,4,17,5,14,59,58,1,56
East Fife,4618,5,13,9,14,51,49,2,48
Peterhead,4618,6,13,5,18,50,56,-6,44
Queen's Park,4618,7,12,8,16,38,47,-9,44
Stranraer,4618,8,13,4,19,58,67,-9,43
Albion,4618,9,10,9,17,46,63,-17,39
Stenhousem'r,4618,10,8,8,20,49,80,-31,32
Livingston,4619,1,22,3,11,73,48,25,69
Alloa,4619,2,16,9,11,70,48,22,57
Peterhead,4619,3,16,7,13,54,54,0,55
Airdrieon,4619,4,15,7,14,50,54,-4,52
Queen's Park,4619,5,15,7,14,39,44,-5,52
Albion,4619,6,14,9,13,51,52,-1,51
Brechin,4619,7,15,6,15,42,43,-1,51
Stranraer,4619,8,13,4,19,42,50,-8,43
East Fife,4619,9,11,7,18,44,47,-3,40
Stenhousem'r,4619,10,10,7,19,50,75,-25,37
Brechin,4620,1,22,5,9,54,36,18,71
Airdrieon,4620,2,18,9,9,65,45,20,63
Alloa,4620,3,18,8,10,58,45,13,62
Livingston,4620,4,17,5,14,77,59,18,56
Albion,4620,5,13,11,12,66,61,5,50
Peterhead,4620,6,14,7,15,54,59,-5,49
Queen's Park,4620,7,12,7,17,44,55,-11,43
East Fife,4620,8,11,9,16,52,53,-1,42
Stranraer,4620,9,10,8,18,46,63,-17,38
Stenhousem'r,4620,10,6,9,21,43,83,-40,27
Livingston,4621,1,21,7,8,77,41,36,70
Alloa,4621,2,17,8,11,66,50,16,59
Airdrieon,4621,3,18,5,13,59,53,6,59
Brechin,4621,4,16,10,10,55,42,13,58
Peterhead,4621,5,13,10,13,54,59,-5,49
Stranraer,4621,6,13,8,15,52,62,-10,47
East Fife,4621,7,12,9,15,52,50,2,45
Albion,4621,8,12,9,15,51,54,-3,45
Queen's Park,4621,9,10,10,16,36,51,-15,40
Stenhousem'r,4621,10,7,6,23,47,87,-40,27
Livingston,4622,1,23,3,10,79,39,40,72
Alloa,4622,2,20,9,7,76,51,25,69
Brechin,4622,3,18,7,11,57,51,6,61
Queen's Park,4622,4,15,8,13,42,39,3,53
Airdrieon,4622,5,15,7,14,56,57,-1,52
Albion,4622,6,14,9,13,42,40,2,51
Peterhead,4622,7,14,6,16,54,60,-6,48
East Fife,4622,8,10,8,18,43,60,-17,38
Stranraer,4622,9,9,6,21,47,63,-16,33
Stenhousem'r,4622,10,8,5,23,43,79,-36,29
Alloa,4623,1,21,6,9,71,41,30,69
Livingston,4623,2,19,7,10,73,52,21,64
Airdrieon,4623,3,17,7,12,58,54,4,58
East Fife,4623,4,16,7,13,54,40,14,55
Peterhead,4623,5,15,5,16,50,53,-3,50
Stranraer,4623,6,13,8,15,53,59,-6,47
Brechin,4623,7,12,10,14,50,56,-6,46
Albion,4623,8,12,9,15,58,62,-4,45
Queen's Park,4623,9,12,3,21,40,60,-20,39
Stenhousem'r,4623,10,9,6,21,43,73,-30,33
Livingston,4624,1,20,6,10,73,53,20,66
Airdrieon,4624,2,19,7,10,57,48,9,64
Brechin,4624,3,18,8,10,56,44,12,62
Alloa,4624,4,18,6,12,71,47,24,60
Albion,4624,5,17,8,11,55,47,8,59
Peterhead,4624,6,12,9,15,46,59,-13,45
Stranraer,4624,7,13,5,18,44,55,-11,44
Queen's Park,4624,8,10,7,19,47,62,-15,37
Stenhousem'r,4624,9,10,7,19,57,78,-21,37
East Fife,4624,10,8,7,21,38,51,-13,31
Alloa,4625,1,25,7,4,80,37,43,82
Airdrieon,4625,2,20,4,12,55,48,7,64
Livingston,4625,3,18,5,13,70,46,24,59
Albion,4625,4,18,5,13,55,46,9,59
Brechin,4625,5,17,5,14,50,42,8,56
Queen's Park,4625,6,12,7,17,33,47,-14,43
East Fife,4625,7,10,10,16,46,50,-4,40
Peterhead,4625,8,10,9,17,42,59,-17,39
Stenhousem'r,4625,9,8,9,19,41,74,-33,33
Stranraer,4625,10,8,7,21,38,61,-23,31
Airdrieon,4626,1,20,6,10,64,51,13,66
Livingston,4626,2,18,8,10,73,55,18,62
Brechin,4626,3,18,7,11,60,48,12,61
Albion,4626,4,16,5,15,60,56,4,53
Queen's Park,4626,5,16,5,15,39,44,-5,53
Alloa,4626,6,13,11,12,67,56,11,50
East Fife,4626,7,11,11,14,48,44,4,44
Peterhead,4626,8,10,12,14,46,53,-7,42
Stranraer,4626,9,9,7,20,43,66,-23,34
Stenhousem'r,4626,10,7,12,17,50,77,-27,33
Livingston,4627,1,21,7,8,87,49,38,70
Brechin,4627,2,20,6,10,58,47,11,66
Alloa,4627,3,17,10,9,64,42,22,61
Queen's Park,4627,4,14,6,16,45,51,-6,48
Airdrieon,4627,5,14,6,16,47,55,-8,48
Albion,4627,6,12,10,14,55,59,-4,46
Peterhead,4627,7,12,9,15,47,58,-11,45
Stranraer,4627,8,10,11,15,44,51,-7,41
East Fife,4627,9,8,13,15,49,57,-8,37
Stenhousem'r,4627,10,8,10,18,52,79,-27,34
Livingston,4628,1,22,6,8,75,40,35,72
Alloa,4628,2,17,7,12,74,51,23,58
Brechin,4628,3,15,9,12,52,53,-1,54
Queen's Park,4628,4,15,8,13,45,46,-1,53
East Fife,4628,5,15,6,15,55,50,5,51
Airdrieon,4628,6,14,9,13,49,49,0,51
Albion,4628,7,13,9,14,47,50,-3,48
Peterhead,4628,8,13,7,16,49,60,-11,46
Stranraer,4628,9,11,5,20,47,61,-14,38
Stenhousem'r,4628,10,7,10,19,48,81,-33,31
Livingston,4629,1,24,4,8,73,37,36,76
Alloa,4629,2,19,8,9,74,43,31,65
Airdrieon,4629,3,19,8,9,69,48,21,65
Brechin,4629,4,17,10,9,50,40,10,61
Albion,4629,5,14,8,14,60,58,2,50
Peterhead,4629,6,13,7,16,47,57,-10,46
East Fife,4629,7,10,13,13,51,49,2,43
Stenhousem'r,4629,8,9,7,20,47,81,-34,34
Queen's Park,4629,9,8,7,21,32,64,-32,31
Stranraer,4629,10,8,6,22,47,73,-26,30
Airdrieon,4630,1,21,7,8,64,44,20,70
Livingston,4630,2,20,5,11,80,52,28,65
Alloa,4630,3,17,6,13,60,43,17,57
Peterhead,4630,4,14,11,11,54,50,4,53
Brechin,4630,5,14,9,13,48,46,2,51
Albion,4630,6,15,6,15,50,58,-8,51
Stranraer,4630,7,13,5,18,55,64,-9,44
Queen's Park,4630,8,12,7,17,39,51,-12,43
East Fife,4630,9,8,11,17,42,51,-9,35
Stenhousem'r,4630,10,8,9,19,41,74,-33,33
Livingston,4631,1,23,2,11,74,40,34,71
Brechin,4631,2,19,7,10,49,46,3,64
Airdrieon,4631,3,17,8,11,56,46,10,59
Alloa,4631,4,17,6,13,63,49,14,57
Albion,4631,5,16,5,15,60,53,7,53
Peterhead,4631,6,14,10,12,55,53,2,52
Stranraer,4631,7,12,6,18,51,62,-11,42
Queen's Park,4631,8,9,9,18,36,55,-19,36
East Fife,4631,9,8,11,17,42,55,-13,35
Stenhousem'r,4631,10,7,12,17,47,74,-27,33
Alloa,4632,1,21,7,8,76,40,36,70
Brechin,4632,2,20,6,10,54,42,12,66
Livingston,4632,3,18,7,11,80,47,33,61
Albion,4632,4,17,8,11,55,48,7,59
Airdrieon,4632,5,16,8,12,63,61,2,56
Queen's Park,4632,6,11,9,16,39,51,-12,42
Peterhead,4632,7,10,11,15,50,60,-10,41
Stenhousem'r,4632,8,9,10,17,46,76,-30,37
Stranraer,4632,9,10,6,20,43,68,-25,36
East Fife,4632,10,6,12,18,36,49,-13,30
Livingston,4633,1,22,4,10,69,38,31,70
Airdrieon,4633,2,16,12,8,64,47,17,60
Peterhead,4633,3,16,8,12,52,47,5,56
Alloa,4633,4,15,8,13,62,57,5,53
Queen's Park,4633,5,14,8,14,45,46,-1,50
Brechin,4633,6,14,8,14,48,52,-4,50
Albion,4633,7,13,10,13,56,51,5,49
East Fife,4633,8,11,11,14,53,50,3,44
Stranraer,4633,9,8,9,19,44,69,-25,33
Stenhousem'r,4633,10,7,10,19,41,77,-36,31
Livingston,4634,1,23,7,6,83,40,43,76
Alloa,4634,2,19,8,9,71,42,29,65
Albion,4634,3,15,12,9,65,52,13,57
Airdrieon,4634,4,18,3,15,61,58,3,57
Brechin,4634,5,16,5,15,55,59,-4,53
Peterhead,4634,6,15,5,16,47,52,-5,50
East Fife,4634,7,11,10,15,51,53,-2,43
Queen's Park,4634,8,12,6,18,37,54,-17,42
Stranraer,4634,9,11,5,20,51,65,-14,38
Stenhousem'r,4634,10,6,7,23,46,92,-46,25
Livingston,4635,1,19,5,12,75,49,26,62
Albion,4635,2,17,7,12,58,51,7,58
Alloa,4635,3,16,9,11,63,43,20,57
Stranraer,4635,4,16,9,11,59,49,10,57
Brechin,4635,5,15,6,15,46,52,-6,51
Peterhead,4635,6,12,12,12,48,48,0,48
Airdrieon,4635,7,12,11,13,52,57,-5,47
East Fife,4635,8,12,9,15,50,50,0,45
Queen's Park,4635,9,11,5,20,36,58,-22,38
Stenhousem'r,4635,10,8,11,17,48,78,-30,35
Livingston,4636,1,24,6,6,86,41,45,78
Alloa,4636,2,22,7,7,71,37,34,73
Airdrieon,4636,3,15,8,13,53,53,0,53
Albion,4636,4,13,10,13,44,45,-1,49
Brechin,4636,5,13,9,14,47,48,-1,48
Peterhead,4636,6,12,8,16,48,57,-9,44
Queen's Park,4636,7,11,9,16,36,52,-16,42
Stranraer,4636,8,9,10,17,43,57,-14,37
Stenhousem'r,4636,9,10,7,19,41,67,-26,37
East Fife,4636,10,8,12,16,44,56,-12,36
Livingston,4637,1,21,3,12,77,42,35,66
Alloa,4637,2,17,12,7,60,42,18,63
Airdrieon,4637,3,18,8,10,63,45,18,62
Brechin,4637,4,18,7,11,60,49,11,61
Queen's Park,4637,5,15,6,15,40,46,-6,51
Peterhead,4637,6,15,5,16,43,52,-9,50
Stranraer,4637,7,14,6,16,44,49,-5,48
East Fife,4637,8,11,11,14,50,51,-1,44
Albion,4637,9,12,8,16,48,54,-6,44
Stenhousem'r,4637,10,2,8,26,33,88,-55,14
Alloa,4638,1,18,8,10,69,44,25,62
Livingston,4638,2,19,4,13,75,55,20,61
Peterhead,4638,3,17,8,11,59,52,7,59
Stranraer,4638,4,16,7,13,59,51,8,55
East Fife,4638,5,15,9,12,50,40,10,54
Albion,4638,6,13,9,14,51,57,-6,48
Airdrieon,4638,7,13,9,14,48,54,-6,48
Queen's Park,4638,8,14,3,19,42,54,-12,45
Brechin,4638,9,12,7,17,45,56,-11,43
Stenhousem'r,4638,10,8,6,22,43,78,-35,30
Livingston,4639,1,25,4,7,79,44,35,79
Alloa,4639,2,22,7,7,71,37,34,73
Airdrieon,4639,3,19,4,13,71,59,12,61
Peterhead,4639,4,16,8,12,53,48,5,56
Brechin,4639,5,15,6,15,55,52,3,51
Queen's Park,4639,6,14,8,14,40,46,-6,50
Albion,4639,7,11,7,18,51,62,-11,40
East Fife,4639,8,9,10,17,45,53,-8,37
Stranraer,4639,9,10,4,22,48,69,-21,34
Stenhousem'r,4639,10,8,4,24,41,84,-43,28
Alloa,4640,1,22,5,9,85,42,43,71
Livingston,4640,2,22,4,10,82,45,37,70
Albion,4640,3,17,6,13,57,50,7,57
East Fife,4640,4,17,6,13,55,50,5,57
Peterhead,4640,5,14,7,15,48,56,-8,49
Brechin,4640,6,14,6,16,46,54,-8,48
Airdrieon,4640,7,14,5,17,63,67,-4,47
Queen's Park,4640,8,12,8,16,45,59,-14,44
Stranraer,4640,9,11,3,22,47,69,-22,36
Stenhousem'r,4640,10,9,6,21,49,85,-36,33
Livingston,4641,1,21,5,10,79,45,34,68
Alloa,4641,2,17,9,10,65,47,18,60
Brechin,4641,3,17,9,10,57,45,12,60
Albion,4641,4,15,8,13,59,49,10,53
Airdrieon,4641,5,15,7,14,55,60,-5,52
East Fife,4641,6,12,10,14,51,50,1,46
Stranraer,4641,7,14,4,18,64,64,0,46
Queen's Park,4641,8,11,9,16,38,56,-18,42
Peterhead,4641,9,11,8,17,45,58,-13,41
Stenhousem'r,4641,10,8,9,19,51,90,-39,33
Livingston,4642,1,19,6,11,65,41,24,63
Alloa,4642,2,17,12,7,66,43,23,63
Airdrieon,4642,3,15,10,11,66,57,9,55
Peterhead,4642,4,15,10,11,55,51,4,55
Albion,4642,5,14,9,13,55,53,2,51
Brechin,4642,6,14,9,13,49,51,-2,51
Stranraer,4642,7,13,5,18,50,59,-9,44
East Fife,4642,8,12,6,18,51,57,-6,42
Queen's Park,4642,9,11,8,17,39,55,-16,41
Stenhousem'r,4642,10,7,11,18,49,78,-29,32
Alloa,4643,1,22,8,6,85,38,47,74
Livingston,4643,2,23,5,8,69,38,31,74
Brechin,4643,3,21,9,6,53,29,24,72
Stranraer,4643,4,14,6,16,51,56,-5,48
Albion,4643,5,12,11,13,47,58,-11,47
Airdrieon,4643,6,13,8,15,54,66,-12,47
East Fife,4643,7,9,11,16,44,47,-3,38
Queen's Park,4643,8,10,6,20,34,53,-19,36
Stenhousem'r,4643,9,10,6,20,49,77,-28,36
Peterhead,4643,10,7,8,21,31,55,-24,29
Alloa,4644,1,22,7,7,72,37,35,73
Livingston,4644,2,20,6,10,74,48,26,66
Airdrieon,4644,3,19,5,12,63,48,15,62
Brechin,4644,4,19,5,12,50,41,9,62
Peterhead,4644,5,14,7,15,55,57,-2,49
Stranraer,4644,6,11,10,15,49,52,-3,43
East Fife,4644,7,10,10,16,45,53,-8,40
Queen's Park,4644,8,10,9,17,39,56,-17,39
Albion,4644,9,10,8,18,42,61,-19,38
Stenhousem'r,4644,10,8,7,21,47,83,-36,31
Airdrieon,4645,1,21,7,8,59,38,21,70
Livingston,4645,2,20,4,12,76,45,31,64
Brechin,4645,3,17,4,15,50,55,-5,55
Alloa,4645,4,15,9,12,67,49,18,54
Queen's Park,4645,5,14,9,13,41,42,-1,51
Albion,4645,6,15,6,15,52,56,-4,51
Stranraer,4645,7,14,6,16,52,56,-4,48
Peterhead,4645,8,13,7,16,51,55,-4,46
East Fife,4645,9,9,8,19,38,51,-13,35
Stenhousem'r,4645,10,9,6,21,46,85,-39,33
Livingston,4646,1,20,4,12,64,38,26,64
Alloa,4646,2,18,6,12,71,45,26,60
Brechin,4646,3,17,5,14,56,46,10,56
Airdrieon,4646,4,17,4,15,54,57,-3,55
East Fife,4646,5,15,8,13,45,40,5,53
Albion,4646,6,13,9,14,45,50,-5,48
Peterhead,4646,7,13,8,15,47,55,-8,47
Queen's Park,4646,8,13,8,15,34,45,-11,47
Stranraer,4646,9,13,6,17,47,56,-9,45
Stenhousem'r,4646,10,7,10,19,44,75,-31,31
Alloa,4647,1,22,6,8,70,38,32,72
Livingston,4647,2,21,5,10,81,48,33,68
Airdrieon,4647,3,17,10,9,60,48,12,61
Brechin,4647,4,17,8,11,49,35,14,59
Albion,4647,5,13,7,16,50,56,-6,46
East Fife,4647,6,11,12,13,51,53,-2,45
Peterhead,4647,7,13,6,17,50,53,-3,45
Stranraer,4647,8,12,8,16,43,56,-13,44
Queen's Park,4647,9,12,5,19,41,55,-14,41
Stenhousem'r,4647,10,5,7,24,38,91,-53,22
Livingston,4648,1,21,5,10,82,49,33,68
Albion,4648,2,19,6,11,56,42,14,63
Alloa,4648,3,17,9,10,76,47,29,60
Peterhead,4648,4,17,7,12,58,49,9,58
Airdrieon,4648,5,16,8,12,62,59,3,56
Brechin,4648,6,16,7,13,56,54,2,55
Queen's Park,4648,7,14,5,17,38,51,-13,47
East Fife,4648,8,11,10,15,38,46,-8,43
Stranraer,4648,9,10,5,21,44,60,-16,35
Stenhousem'r,4648,10,4,8,24,39,92,-53,20
Livingston,4649,1,23,3,10,82,52,30,72
Alloa,4649,2,19,5,12,70,44,26,62
Brechin,4649,3,16,6,14,53,50,3,54
Airdrieon,4649,4,15,7,14,56,57,-1,52
East Fife,4649,5,15,6,15,51,53,-2,51
Queen's Park,4649,6,14,7,15,47,52,-5,49
Albion,4649,7,13,8,15,60,60,0,47
Peterhead,4649,8,11,9,16,48,58,-10,42
Stenhousem'r,4649,9,11,7,18,54,82,-28,40
Stranraer,4649,10,9,10,17,43,56,-13,37
Livingston,4650,1,21,6,9,80,48,32,69
Alloa,4650,2,18,9,9,68,43,25,63
Brechin,4650,3,18,7,11,56,50,6,61
Peterhead,4650,4,14,10,12,54,53,1,52
Airdrieon,4650,5,15,5,16,61,59,2,50
Albion,4650,6,14,6,16,54,62,-8,48
East Fife,4650,7,12,8,16,53,54,-1,44
Queen's Park,4650,8,12,7,17,37,56,-19,43
Stenhousem'r,4650,9,11,8,17,57,77,-20,41
Stranraer,4650,10,8,8,20,42,60,-18,32
Livingston,4651,1,25,1,10,82,46,36,76
Albion,4651,2,16,8,12,58,51,7,56
Brechin,4651,3,16,8,12,54,49,5,56
Airdrieon,4651,4,16,8,12,66,63,3,56
Alloa,4651,5,15,10,11,61,39,22,55
Peterhead,4651,6,15,5,16,47,55,-8,50
Stranraer,4651,7,15,4,17,53,61,-8,49
Queen's Park,4651,8,12,7,17,37,50,-13,43
East Fife,4651,9,10,11,15,45,49,-4,41
Stenhousem'r,4651,10,6,6,24,41,81,-40,24
Livingston,4652,1,23,4,9,85,52,33,73
Alloa,4652,2,17,9,10,67,42,25,60
Albion,4652,3,15,10,11,56,47,9,55
Brechin,4652,4,16,7,13,43,42,1,55
Airdrieon,4652,5,16,5,15,57,47,10,53
Stranraer,4652,6,13,8,15,44,51,-7,47
Queen's Park,4652,7,13,8,15,32,48,-16,47
Peterhead,4652,8,14,5,17,38,56,-18,47
East Fife,4652,9,9,10,17,42,46,-4,37
Stenhousem'r,4652,10,7,8,21,43,76,-33,29
Livingston,4653,1,20,5,11,79,57,22,65
Alloa,4653,2,18,10,8,76,46,30,64
Airdrieon,4653,3,17,6,13,53,52,1,57
Albion,4653,4,15,8,13,60,60,0,53
East Fife,4653,5,15,7,14,53,43,10,52
Peterhead,4653,6,14,7,15,52,54,-2,49
Brechin,4653,7,13,7,16,38,52,-14,46
Stranraer,4653,8,12,6,18,57,64,-7,42
Queen's Park,4653,9,11,7,18,35,56,-21,40
Stenhousem'r,4653,10,9,9,18,49,68,-19,36
Brechin,4654,1,24,5,7,60,34,26,77
Alloa,4654,2,19,9,8,65,43,22,66
Airdrieon,4654,3,16,12,8,56,52,4,60
Livingston,4654,4,17,6,13,70,53,17,57
Peterhead,4654,5,15,6,15,58,55,3,51
Albion,4654,6,11,12,13,56,57,-1,45
East Fife,4654,7,9,11,16,50,60,-10,38
Queen's Park,4654,8,11,5,20,40,56,-16,38
Stranraer,4654,9,9,7,20,45,63,-18,34
Stenhousem'r,4654,10,9,7,20,45,72,-27,34
Brechin,4655,1,24,3,9,56,35,21,75
Airdrieon,4655,2,19,9,8,61,43,18,66
Livingston,4655,3,19,4,13,79,59,20,61
Alloa,4655,4,17,9,10,72,47,25,60
Peterhead,4655,5,15,7,14,54,58,-4,52
Stranraer,4655,6,14,5,17,53,51,2,47
Albion,4655,7,12,10,14,48,57,-9,46
Queen's Park,4655,8,10,7,19,34,58,-24,37
East Fife,4655,9,8,10,18,46,58,-12,34
Stenhousem'r,4655,10,5,10,21,41,78,-37,25
Livingston,4656,1,19,6,11,76,52,24,63
Alloa,4656,2,17,10,9,69,48,21,61
Airdrieon,4656,3,17,7,12,64,60,4,58
Brechin,4656,4,16,6,14,49,44,5,54
Peterhead,4656,5,13,12,11,48,45,3,51
Albion,4656,6,15,6,15,56,54,2,51
East Fife,4656,7,11,11,14,54,54,0,44
Stranraer,4656,8,12,8,16,52,62,-10,44
Queen's Park,4656,9,11,8,17,35,51,-16,41
Stenhousem'r,4656,10,9,6,21,52,85,-33,33
Airdrieon,4657,1,20,8,8,71,49,22,68
Alloa,4657,2,20,7,9,77,47,30,67
Livingston,4657,3,20,3,13,73,54,19,63
Albion,4657,4,15,5,16,54,53,1,50
Stranraer,4657,5,15,4,17,63,59,4,49
East Fife,4657,6,13,9,14,52,51,1,48
Peterhead,4657,7,12,10,14,56,62,-6,46
Brechin,4657,8,13,6,17,50,56,-6,45
Queen's Park,4657,9,11,7,18,38,58,-20,40
Stenhousem'r,4657,10,8,7,21,45,90,-45,31
Alloa,4658,1,18,9,9,76,49,27,63
Airdrieon,4658,2,16,10,10,65,48,17,58
Livingston,4658,3,16,7,13,65,59,6,55
Brechin,4658,4,15,9,12,53,50,3,54
Stranraer,4658,5,16,5,15,61,59,2,53
Queen's Park,4658,6,13,9,14,42,54,-12,48
East Fife,4658,7,12,11,13,58,52,6,47
Albion,4658,8,11,13,12,52,54,-2,46
Peterhead,4658,9,11,10,15,46,51,-5,43
Stenhousem'r,4658,10,5,11,20,42,84,-42,26
Alloa,4659,1,22,7,7,67,37,30,73
Livingston,4659,2,19,6,11,71,42,29,63
Brechin,4659,3,17,7,12,54,46,8,58
Airdrieon,4659,4,16,8,12,60,64,-4,56
Albion,4659,5,15,8,13,54,43,11,53
Queen's Park,4659,6,15,6,15,45,46,-1,51
Peterhead,4659,7,13,7,16,48,61,-13,46
Stranraer,4659,8,11,10,15,49,54,-5,43
East Fife,4659,9,10,7,19,46,55,-9,37
Stenhousem'r,4659,10,4,10,22,36,82,-46,22
Livingston,4660,1,21,8,7,73,48,25,71
Alloa,4660,2,21,5,10,79,43,36,68
Brechin,4660,3,19,2,15,50,51,-1,59
Peterhead,4660,4,15,10,11,48,44,4,55
Airdrieon,4660,5,15,7,14,56,54,2,52
Stranraer,4660,6,14,4,18,43,51,-8,46
Queen's Park,4660,7,13,7,16,40,50,-10,46
Albion,4660,8,11,11,14,52,57,-5,44
Stenhousem'r,4660,9,8,10,18,44,71,-27,34
East Fife,4660,10,6,10,20,43,59,-16,28
Alloa,4661,1,23,4,9,79,46,33,73
Livingston,4661,2,19,8,9,71,47,24,65
Brechin,4661,3,18,9,9,55,40,15,63
Stranraer,4661,4,15,7,14,52,52,0,52
Airdrieon,4661,5,15,6,15,56,49,7,51
East Fife,4661,6,12,8,16,56,55,1,44
Albion,4661,7,9,15,12,40,48,-8,42
Peterhead,4661,8,9,11,16,43,60,-17,38
Queen's Park,4661,9,10,6,20,34,56,-22,36
Stenhousem'r,4661,10,9,8,19,45,78,-33,35
Livingston,4662,1,21,4,11,76,53,23,67
Airdrieon,4662,2,20,6,10,67,47,20,66
Alloa,4662,3,18,10,8,71,40,31,64
Queen's Park,4662,4,17,9,10,54,42,12,60
Brechin,4662,5,17,4,15,51,51,0,55
Albion,4662,6,12,11,13,54,57,-3,47
Stranraer,4662,7,11,7,18,46,62,-16,40
Peterhead,4662,8,10,9,17,45,60,-15,39
East Fife,4662,9,9,10,17,49,52,-3,37
Stenhousem'r,4662,10,6,8,22,36,85,-49,26
Alloa,4663,1,21,5,10,74,44,30,68
Livingston,4663,2,18,6,12,67,54,13,60
Brechin,4663,3,16,8,12,49,45,4,56
Albion,4663,4,16,7,13,60,46,14,55
Peterhead,4663,5,14,9,13,47,50,-3,51
Airdrieon,4663,6,13,9,14,54,52,2,48
East Fife,4663,7,11,11,14,47,49,-2,44
Queen's Park,4663,8,12,8,16,36,47,-11,44
Stranraer,4663,9,12,7,17,56,68,-12,43
Stenhousem'r,4663,10,7,10,19,47,82,-35,31
Alloa,4664,1,21,7,8,72,41,31,70
Brechin,4664,2,21,2,13,58,48,10,65
Peterhead,4664,3,16,10,10,56,46,10,58
Airdrieon,4664,4,16,7,13,52,63,-11,55
Albion,4664,5,14,10,12,58,53,5,52
Livingston,4664,6,15,6,15,72,60,12,51
Stranraer,4664,7,14,8,14,53,51,2,50
Queen's Park,4664,8,10,8,18,36,55,-19,38
East Fife,4664,9,9,9,18,56,54,2,36
Stenhousem'r,4664,10,6,9,21,45,87,-42,27
Alloa,4665,1,23,5,8,68,39,29,74
Livingston,4665,2,23,4,9,77,49,28,73
Airdrieon,4665,3,18,5,13,54,51,3,59
Albion,4665,4,15,10,11,48,41,7,55
Brechin,4665,5,15,5,16,50,57,-7,50
East Fife,4665,6,13,8,15,55,47,8,47
Stranraer,4665,7,14,4,18,52,53,-1,46
Queen's Park,4665,8,11,11,14,32,47,-15,44
Peterhead,4665,9,9,7,20,45,57,-12,34
Stenhousem'r,4665,10,5,9,22,45,85,-40,24
Livingston,4666,1,20,6,10,83,55,28,66
Alloa,4666,2,19,7,10,72,49,23,64
Airdrieon,4666,3,18,6,12,64,53,11,60
Brechin,4666,4,17,9,10,47,43,4,60
Peterhead,4666,5,16,8,12,52,48,4,56
Albion,4666,6,14,6,16,53,55,-2,48
Queen's Park,4666,7,13,8,15,44,49,-5,47
East Fife,4666,8,11,9,16,53,51,2,42
Stranraer,4666,9,9,6,21,50,75,-25,33
Stenhousem'r,4666,10,5,11,20,51,91,-40,26
Livingston,4667,1,22,3,11,77,50,27,69
Alloa,4667,2,19,9,8,65,40,25,66
Brechin,4667,3,18,4,14,63,54,9,58
Airdrieon,4667,4,15,11,10,57,49,8,56
Albion,4667,5,14,6,16,47,52,-5,48
Stranraer,4667,5,14,6,16,47,52,-5,48
Queen's Park,4667,7,13,7,16,41,51,-10,46
Peterhead,4667,8,11,10,15,48,55,-7,43
East Fife,4667,9,8,10,18,46,55,-9,34
Stenhousem'r,4667,10,8,10,18,46,79,-33,34
Livingston,4668,1,18,8,10,68,42,26,62
Airdrieon,4668,2,17,6,13,63,61,2,57
Alloa,4668,3,15,8,13,68,53,15,53
Albion,4668,4,16,5,15,52,45,7,53
Stranraer,4668,5,16,5,15,57,54,3,53
Peterhead,4668,6,14,7,15,48,53,-5,49
Brechin,4668,7,14,7,15,47,52,-5,49
East Fife,4668,8,12,9,15,47,48,-1,45
Queen's Park,4668,9,12,9,15,33,53,-20,45
Stenhousem'r,4668,10,11,6,19,53,75,-22,39
Brechin,4669,1,18,6,12,52,44,8,60
Livingston,4669,2,17,8,11,66,52,14,59
Alloa,4669,3,15,9,12,64,49,15,54
East Fife,4669,4,15,8,13,56,40,16,53
Albion,4669,5,14,11,11,55,48,7,53
Peterhead,4669,6,13,11,12,50,48,2,50
Airdrieon,4669,7,15,5,16,53,57,-4,50
Queen's Park,4669,8,12,8,16,35,53,-18,44
Stenhousem'r,4669,9,10,10,16,51,72,-21,40
Stranraer,4669,10,9,8,19,49,68,-19,35
Livingston,4670,1,19,7,10,68,48,20,64
Queen's Park,4670,2,18,6,12,52,46,6,60
Alloa,4670,3,16,10,10,64,47,17,58
Brechin,4670,4,17,4,15,54,45,9,55
Airdrieon,4670,5,14,11,11,58,52,6,53
Peterhead,4670,6,15,7,14,53,53,0,52
East Fife,4670,7,13,11,12,46,39,7,50
Albion,4670,8,11,7,18,49,61,-12,40
Stranraer,4670,9,11,6,19,49,65,-16,39
Stenhousem'r,4670,10,9,5,22,41,78,-37,32
Livingston,4671,1,22,6,8,75,41,34,72
Albion,4671,2,20,7,9,61,41,20,67
Alloa,4671,3,17,6,13,63,49,14,57
Airdrieon,4671,4,16,5,15,63,61,2,53
Peterhead,4671,5,15,7,14,56,48,8,52
Queen's Park,4671,6,15,7,14,43,48,-5,52
Brechin,4671,7,14,5,17,45,61,-16,47
Stranraer,4671,8,12,6,18,53,64,-11,42
Stenhousem'r,4671,9,8,11,17,46,73,-27,35
East Fife,4671,10,7,8,21,41,60,-19,29
Alloa,4672,1,23,3,10,82,43,39,72
Livingston,4672,2,22,4,10,71,43,28,70
Brechin,4672,3,18,5,13,55,52,3,59
Airdrieon,4672,4,17,6,13,58,58,0,57
Stranraer,4672,5,16,5,15,49,46,3,53
Albion,4672,6,15,6,15,47,51,-4,51
Peterhead,4672,7,12,8,16,38,50,-12,44
Queen's Park,4672,8,11,8,17,39,51,-12,41
East Fife,4672,9,8,10,18,47,60,-13,34
Stenhousem'r,4672,10,6,9,21,37,69,-32,27
Livingston,4673,1,23,5,8,84,47,37,74
Airdrieon,4673,2,19,8,9,62,43,19,65
Alloa,4673,3,18,9,9,69,43,26,63
Albion,4673,4,16,7,13,55,43,12,55
Brechin,4673,5,12,9,15,49,55,-6,45
Queen's Park,4673,6,12,9,15,38,51,-13,45
Stranraer,4673,7,12,6,18,48,67,-19,42
Peterhead,4673,8,10,10,16,52,67,-15,40
East Fife,4673,9,8,12,16,51,58,-7,36
Stenhousem'r,4673,10,6,13,17,47,81,-34,31
Airdrieon,4674,1,21,3,12,52,43,9,66
Brechin,4674,2,20,5,11,57,43,14,65
Livingston,4674,3,20,4,12,81,55,26,64
Albion,4674,4,16,7,13,51,46,5,55
Alloa,4674,5,14,11,11,66,46,20,53
Queen's Park,4674,6,14,7,15,35,45,-10,49
Peterhead,4674,7,13,6,17,38,55,-17,45
Stranraer,4674,8,12,8,16,54,55,-1,44
East Fife,4674,9,12,7,17,50,49,1,43
Stenhousem'r,4674,10,7,4,25,42,89,-47,25
Livingston,4675,1,21,4,11,67,48,19,67
Peterhead,4675,2,18,7,11,61,51,10,61
Brechin,4675,3,18,6,12,52,41,11,60
Airdrieon,4675,4,17,7,12,54,43,11,58
Stranraer,4675,5,15,5,16,54,58,-4,50
Alloa,4675,6,13,8,15,55,47,8,47
Albion,4675,7,13,8,15,46,49,-3,47
Queen's Park,4675,8,12,8,16,32,43,-11,44
East Fife,4675,9,12,6,18,47,48,-1,42
Stenhousem'r,4675,10,8,7,21,39,79,-40,31
Alloa,4676,1,21,6,9,76,45,31,69
Livingston,4676,2,20,8,8,80,48,32,68
Airdrieon,4676,3,16,9,11,58,54,4,57
Brechin,4676,4,13,11,12,51,54,-3,50
Albion,4676,5,13,9,14,55,57,-2,48
Queen's Park,4676,6,13,8,15,44,55,-11,47
Peterhead,4676,7,12,10,14,52,58,-6,46
Stenhousem'r,4676,8,11,8,17,56,76,-20,41
East Fife,4676,9,11,7,18,46,54,-8,40
Stranraer,4676,10,8,8,20,46,63,-17,32
Alloa,4677,1,22,4,10,75,39,36,70
Livingston,4677,2,19,3,14,69,43,26,60
Airdrieon,4677,3,16,8,12,60,52,8,56
Albion,4677,4,15,8,13,52,49,3,53
Peterhead,4677,5,13,10,13,52,54,-2,49
Brechin,4677,6,14,5,17,52,59,-7,47
Stenhousem'r,4677,7,13,7,16,56,76,-20,46
Queen's Park,4677,8,13,6,17,45,56,-11,45
Stranraer,4677,9,13,4,19,43,65,-22,43
East Fife,4677,10,11,7,18,43,54,-11,40
Livingston,4678,1,24,2,10,87,46,41,74
Alloa,4678,2,18,8,10,66,45,21,62
Peterhead,4678,3,16,8,12,52,45,7,56
Stranraer,4678,4,16,7,13,55,51,4,55
Brechin,4678,5,15,6,15,49,52,-3,51
Airdrieon,4678,6,13,6,17,55,65,-10,45
Albion,4678,7,11,11,14,53,57,-4,44
Queen's Park,4678,8,11,10,15,45,59,-14,43
East Fife,4678,9,11,9,16,49,53,-4,42
Stenhousem'r,4678,10,8,7,21,53,91,-38,31
Livingston,4679,1,21,5,10,79,44,35,68
Alloa,4679,2,20,6,10,72,42,30,66
Brechin,4679,3,18,6,12,51,42,9,60
Stranraer,4679,4,17,6,13,53,46,7,57
Airdrieon,4679,5,15,6,15,48,50,-2,51
East Fife,4679,6,13,9,14,44,48,-4,48
Peterhead,4679,7,13,7,16,44,56,-12,46
Queen's Park,4679,8,11,7,18,32,49,-17,40
Albion,4679,9,10,9,17,42,55,-13,39
Stenhousem'r,4679,10,9,5,22,53,86,-33,32
Livingston,4680,1,24,3,9,85,49,36,75
Alloa,4680,2,20,7,9,73,48,25,67
Brechin,4680,3,18,5,13,52,49,3,59
Airdrieon,4680,4,16,7,13,57,58,-1,55
Peterhead,4680,5,15,7,14,54,58,-4,52
Albion,4680,6,15,6,15,54,49,5,51
Stranraer,4680,7,13,5,18,41,53,-12,44
Queen's Park,4680,8,10,10,16,33,49,-16,40
East Fife,4680,9,10,6,20,54,60,-6,36
Stenhousem'r,4680,10,7,8,21,42,72,-30,29
Livingston,4681,1,23,5,8,81,43,38,74
Alloa,4681,2,19,7,10,74,48,26,64
Brechin,4681,3,19,7,10,58,51,7,64
Airdrieon,4681,4,15,6,15,50,52,-2,51
Albion,4681,5,13,8,15,52,56,-4,47
Peterhead,4681,6,12,10,14,54,57,-3,46
Queen's Park,4681,7,12,8,16,35,49,-14,44
Stenhousem'r,4681,8,12,8,16,52,70,-18,44
Stranraer,4681,9,12,5,19,52,64,-12,41
East Fife,4681,10,6,10,20,38,56,-18,28
Livingston,4682,1,22,6,8,77,37,40,72
Airdrieon,4682,2,19,4,13,59,49,10,61
Brechin,4682,3,17,7,12,61,54,7,58
Alloa,4682,4,16,5,15,68,59,9,53
East Fife,4682,5,13,11,12,52,42,10,50
Queen's Park,4682,6,12,9,15,34,43,-9,45
Albion,4682,7,10,11,15,45,56,-11,41
Peterhead,4682,8,11,8,17,36,59,-23,41
Stranraer,4682,9,11,7,18,50,61,-11,40
Stenhousem'r,4682,10,10,10,16,53,75,-22,40
Alloa,4683,1,19,6,11,80,48,32,63
Livingston,4683,2,19,5,12,66,46,20,62
Peterhead,4683,3,18,8,10,58,44,14,62
Brechin,4683,4,16,7,13,58,54,4,55
East Fife,4683,5,14,8,14,49,46,3,50
Airdrieon,4683,6,14,6,16,63,66,-3,48
Albion,4683,7,14,5,17,54,62,-8,47
Queen's Park,4683,8,12,8,16,39,59,-20,44
Stranraer,4683,9,12,5,19,53,62,-9,41
Stenhousem'r,4683,10,9,8,19,50,83,-33,35
Alloa,4684,1,21,7,8,71,39,32,70
Airdrieon,4684,2,19,8,9,61,45,16,65
Livingston,4684,3,20,2,14,78,53,25,62
Brechin,4684,4,16,7,13,55,50,5,55
Peterhead,4684,5,13,9,14,43,51,-8,48
Albion,4684,6,12,9,15,46,53,-7,45
Stranraer,4684,7,13,5,18,54,61,-7,44
East Fife,4684,8,10,11,15,43,52,-9,41
Queen's Park,4684,9,11,8,17,33,54,-21,41
Stenhousem'r,4684,10,9,6,21,47,73,-26,33
Alloa,4685,1,22,7,7,76,46,30,73
Livingston,4685,2,21,5,10,82,53,29,68
Airdrieon,4685,3,19,7,10,62,44,18,64
Queen's Park,4685,4,16,5,15,46,46,0,53
Brechin,4685,5,14,8,14,43,46,-3,50
Peterhead,4685,6,14,8,14,50,54,-4,50
Stranraer,4685,7,12,8,16,44,57,-13,44
Albion,4685,8,10,8,18,49,61,-12,38
East Fife,4685,9,10,7,19,48,57,-9,37
Stenhousem'r,4685,10,7,7,22,50,86,-36,28
Alloa,4686,1,20,8,8,70,37,33,68
Livingston,4686,2,20,7,9,74,47,27,67
Airdrieon,4686,3,18,7,11,65,53,12,61
Peterhead,4686,4,15,9,12,53,54,-1,54
Albion,4686,5,15,5,16,60,54,6,50
East Fife,4686,6,11,12,13,51,48,3,45
Queen's Park,4686,7,12,7,17,41,52,-11,43
Brechin,4686,8,13,4,19,43,60,-17,43
Stranraer,4686,9,12,7,17,45,65,-20,43
Stenhousem'r,4686,10,7,8,21,49,81,-32,29
Alloa,4687,1,20,7,9,74,40,34,67
Airdrieon,4687,2,18,8,10,55,49,6,62
Livingston,4687,3,17,5,14,63,52,11,56
Brechin,4687,4,16,7,13,45,44,1,55
Albion,4687,5,15,6,15,42,45,-3,51
Stenhousem'r,4687,6,13,9,14,50,61,-11,48
Queen's Park,4687,7,11,13,12,30,38,-8,46
Peterhead,4687,8,9,12,15,43,55,-12,39
Stranraer,4687,9,10,7,19,48,61,-13,37
East Fife,4687,10,8,12,16,51,56,-5,36
Alloa,4688,1,22,5,9,81,47,34,71
Livingston,4688,2,20,5,11,74,48,26,65
Airdrieon,4688,3,18,6,12,64,55,9,60
Brechin,4688,4,16,7,13,49,44,5,55
East Fife,4688,5,15,9,12,59,41,18,54
Albion,4688,6,16,6,14,52,51,1,54
Queen's Park,4688,7,11,8,17,34,50,-16,41
Stranraer,4688,8,10,8,18,52,63,-11,38
Peterhead,4688,9,9,8,19,33,57,-24,35
Stenhousem'r,4688,10,8,8,20,42,84,-42,32
Livingston,4689,1,22,3,11,80,46,34,69
Stranraer,4689,2,19,3,14,55,51,4,60
Albion,4689,3,15,8,13,57,61,-4,53
Alloa,4689,4,14,10,12,62,50,12,52
Airdrieon,4689,5,14,10,12,62,60,2,52
Peterhead,4689,6,14,6,16,49,55,-6,48
Queen's Park,4689,7,13,8,15,37,49,-12,47
East Fife,4689,8,13,6,17,48,48,0,45
Brechin,4689,9,12,7,17,46,56,-10,43
Stenhousem'r,4689,10,9,9,18,49,69,-20,36
Livingston,4690,1,23,5,8,92,50,42,74
Alloa,4690,2,19,6,11,68,48,20,63
Stranraer,4690,3,14,9,13,53,50,3,51
Peterhead,4690,4,15,6,15,54,59,-5,51
Brechin,4690,5,13,10,13,55,53,2,49
Albion,4690,6,13,9,14,51,53,-2,48
Airdrieon,4690,7,13,7,16,54,64,-10,46
East Fife,4690,8,12,8,16,55,50,5,44
Queen's Park,4690,9,9,12,15,38,62,-24,39
Stenhousem'r,4690,10,9,8,19,46,77,-31,35
Livingston,4691,1,23,2,11,78,54,24,71
Brechin,4691,2,21,3,12,64,48,16,66
Alloa,4691,3,19,6,11,81,46,35,63
Airdrieon,4691,4,16,9,11,59,57,2,57
Albion,4691,5,16,7,13,64,54,10,55
Queen's Park,4691,6,12,8,16,41,51,-10,44
Peterhead,4691,7,11,9,16,53,69,-16,42
Stranraer,4691,8,12,4,20,46,73,-27,40
Stenhousem'r,4691,9,9,8,19,46,75,-29,35
East Fife,4691,10,7,12,17,57,62,-5,33
Alloa,4692,1,21,6,9,78,40,38,69
Brechin,4692,2,20,9,7,54,36,18,69
Livingston,4692,3,19,4,13,70,51,19,61
Airdrieon,4692,4,15,9,12,57,53,4,54
Stranraer,4692,5,16,3,17,47,56,-9,51
Albion,4692,6,13,8,15,51,57,-6,47
Peterhead,4692,7,11,8,17,47,54,-7,41
East Fife,4692,8,9,12,15,61,60,1,39
Queen's Park,4692,9,10,9,17,38,58,-20,39
Stenhousem'r,4692,10,9,6,21,42,80,-38,33
Livingston,4693,1,24,5,7,75,40,35,77
Alloa,4693,2,19,12,5,82,36,46,69
Airdrieon,4693,3,17,8,11,60,51,9,59
Brechin,4693,4,15,9,12,38,41,-3,54
Peterhead,4693,5,12,9,15,53,49,4,45
Albion,4693,6,12,8,16,54,62,-8,44
Queen's Park,4693,7,11,7,18,35,46,-11,40
Stranraer,4693,8,11,7,18,45,70,-25,40
East Fife,4693,9,9,12,15,47,55,-8,39
Stenhousem'r,4693,10,8,7,21,49,88,-39,31
Livingston,4694,1,19,4,13,79,53,26,61
Alloa,4694,2,18,6,12,65,45,20,60
Airdrieon,4694,3,18,6,12,59,55,4,60
Brechin,4694,4,18,4,14,54,51,3,58
Peterhead,4694,5,17,6,13,55,48,7,57
Queen's Park,4694,6,14,7,15,40,48,-8,49
Albion,4694,7,12,11,13,50,50,0,47
Stranraer,4694,8,14,4,18,52,61,-9,46
East Fife,4694,9,9,10,17,53,64,-11,37
Stenhousem'r,4694,10,9,6,21,45,77,-32,33
Livingston,4695,1,24,6,6,78,38,40,78
Alloa,4695,2,18,7,11,64,45,19,61
Airdrieon,4695,3,14,10,12,59,59,0,52
Brechin,4695,4,13,11,12,45,44,1,50
Queen's Park,4695,5,14,8,14,39,50,-11,50
Peterhead,4695,6,14,6,16,47,48,-1,48
Stranraer,4695,7,13,7,16,55,61,-6,46
Albion,4695,8,10,12,14,45,48,-3,42
East Fife,4695,9,7,13,16,46,55,-9,34
Stenhousem'r,4695,10,8,10,18,45,75,-30,34
Airdrieon,4696,1,22,5,9,65,47,18,71
Alloa,4696,2,20,7,9,70,44,26,67
Livingston,4696,3,21,3,12,73,50,23,66
Albion,4696,4,18,5,13,70,50,20,59
Brechin,4696,5,16,7,13,51,45,6,55
Stranraer,4696,6,13,7,16,54,59,-5,46
Queen's Park,4696,7,13,7,16,39,55,-16,46
Peterhead,4696,8,10,10,16,45,58,-13,40
East Fife,4696,9,7,11,18,42,63,-21,32
Stenhousem'r,4696,10,5,8,23,44,82,-38,23
Alloa,4697,1,19,10,7,87,47,40,67
Livingston,4697,2,20,5,11,84,45,39,65
Albion,4697,3,18,6,12,70,54,16,60
Brechin,4697,4,16,10,10,59,52,7,58
Airdrieon,4697,5,15,9,12,49,52,-3,54
Peterhead,4697,6,15,8,13,51,57,-6,53
Stranraer,4697,7,13,4,19,51,65,-14,43
East Fife,4697,8,9,13,14,44,46,-2,40
Queen's Park,4697,9,9,11,16,33,58,-25,38
Stenhousem'r,4697,10,4,8,24,44,96,-52,20
Livingston,4698,1,21,5,10,78,48,30,68
Airdrieon,4698,2,19,8,9,70,50,20,65
Alloa,4698,3,18,7,11,61,50,11,61
Brechin,4698,4,17,3,16,46,60,-14,54
Peterhead,4698,5,15,8,13,47,49,-2,53
Queen's Park,4698,6,15,5,16,42,43,-1,50
East Fife,4698,7,11,11,14,51,48,3,44
Albion,4698,8,11,9,16,48,54,-6,42
Stranraer,4698,9,11,7,18,37,52,-15,40
Stenhousem'r,4698,10,7,7,22,51,77,-26,28
Livingston,4699,1,20,8,8,75,44,31,68
Alloa,4699,2,19,8,9,80,42,38,65
Albion,4699,3,14,11,11,49,50,-1,53
Peterhead,4699,4,14,9,13,52,49,3,51
East Fife,4699,5,14,8,14,56,54,2,50
Airdrieon,4699,6,13,11,12,53,55,-2,50
Brechin,4699,7,13,11,12,40,49,-9,50
Queen's Park,4699,8,13,9,14,43,42,1,48
Stranraer,4699,9,9,7,20,37,67,-30,34
Stenhousem'r,4699,10,4,12,20,43,76,-33,24
Livingston,4700,1,21,6,9,80,42,38,69
Alloa,4700,2,20,9,7,76,42,34,69
Airdrieon,4700,3,19,5,12,54,48,6,62
Brechin,4700,4,19,4,13,56,47,9,61
Stranraer,4700,5,15,5,16,61,59,2,50
East Fife,4700,6,13,6,17,54,51,3,45
Queen's Park,4700,7,13,6,17,42,55,-13,45
Albion,4700,8,11,9,16,55,70,-15,42
Peterhead,4700,9,9,9,18,46,61,-15,36
Stenhousem'r,4700,10,6,9,21,36,85,-49,27
Alloa,4701,1,22,9,5,87,43,44,75
Livingston,4701,2,18,7,11,74,53,21,61
Brechin,4701,3,18,6,12,53,40,13,60
Airdrieon,4701,4,16,10,10,58,52,6,58
Albion,4701,5,13,8,15,55,63,-8,47
Stenhousem'r,4701,6,11,9,16,56,74,-18,42
Peterhead,4701,7,11,8,17,47,53,-6,41
Queen's Park,4701,8,11,8,17,34,53,-19,41
East Fife,4701,9,9,12,15,52,57,-5,39
Stranraer,4701,10,10,5,21,45,73,-28,35
Livingston,4702,1,24,3,9,74,42,32,75
Airdrieon,4702,2,18,7,11,58,48,10,61
Brechin,4702,3,18,6,12,53,47,6,60
Alloa,4702,4,16,8,12,65,45,20,56
Peterhead,4702,5,17,5,14,51,53,-2,56
Albion,4702,6,15,6,15,58,52,6,51
East Fife,4702,7,12,6,18,59,63,-4,42
Stranraer,4702,8,13,3,20,46,62,-16,42
Queen's Park,4702,9,10,8,18,33,60,-27,38
Stenhousem'r,4702,10,8,6,22,46,71,-25,30
Brechin,4703,1,24,5,7,63,37,26,77
Livingston,4703,2,20,6,10,74,43,31,66
Alloa,4703,3,16,11,9,59,43,16,59
Albion,4703,4,17,8,11,50,43,7,59
Stranraer,4703,5,13,8,15,50,56,-6,47
Peterhead,4703,6,13,7,16,45,51,-6,46
Airdrieon,4703,7,12,8,16,53,59,-6,44
Queen's Park,4703,8,10,11,15,36,50,-14,41
East Fife,4703,9,7,9,20,37,53,-16,30
Stenhousem'r,4703,10,7,9,20,49,81,-32,30
Airdrieon,4704,1,19,8,9,69,52,17,65
Alloa,4704,2,19,5,12,73,56,17,62
Livingston,4704,3,18,6,12,70,49,21,60
Brechin,4704,4,17,6,13,51,56,-5,57
East Fife,4704,5,15,7,14,51,43,8,52
Stranraer,4704,6,15,5,16,49,55,-6,50
Peterhead,4704,7,12,8,16,49,54,-5,44
Albion,4704,8,11,10,15,47,52,-5,43
Queen's Park,4704,9,12,7,17,45,54,-9,43
Stenhousem'r,4704,10,6,10,20,43,76,-33,28
Livingston,4705,1,21,6,9,79,43,36,69
Airdrieon,4705,2,17,8,11,73,60,13,59
Brechin,4705,3,18,5,13,52,49,3,59
Alloa,4705,4,16,8,12,62,40,22,56
Stranraer,4705,5,15,8,13,54,51,3,53
Peterhead,4705,6,15,7,14,53,58,-5,52
East Fife,4705,7,12,10,14,62,54,8,46
Albion,4705,8,13,7,16,58,63,-5,46
Queen's Park,4705,9,13,6,17,39,53,-14,45
Stenhousem'r,4705,10,4,7,25,35,96,-61,19
Livingston,4706,1,24,4,8,85,43,42,76
Brechin,4706,2,19,5,12,55,50,5,62
Airdrieon,4706,3,17,5,14,55,55,0,56
Alloa,4706,4,14,8,14,69,51,18,50
East Fife,4706,5,14,8,14,48,45,3,50
Albion,4706,6,14,8,14,51,56,-5,50
Queen's Park,4706,7,15,5,16,39,52,-13,50
Peterhead,4706,8,13,9,14,46,49,-3,48
Stranraer,4706,9,12,5,19,50,63,-13,41
Stenhousem'r,4706,10,4,11,21,38,72,-34,23
Livingston,4707,1,22,4,10,67,39,28,70
Peterhead,4707,2,20,6,10,56,44,12,66
Airdrieon,4707,3,18,9,9,63,47,16,63
Brechin,4707,4,16,9,11,47,45,2,57
Alloa,4707,5,15,7,14,64,47,17,52
Albion,4707,6,13,10,13,48,51,-3,49
Queen's Park,4707,7,12,5,19,37,53,-16,41
East Fife,4707,8,9,13,14,45,56,-11,40
Stranraer,4707,9,10,9,17,46,52,-6,39
Stenhousem'r,4707,10,6,6,24,37,76,-39,24
Livingston,4708,1,23,3,10,81,45,36,72
Alloa,4708,2,18,9,9,74,49,25,63
Airdrieon,4708,3,20,3,13,59,46,13,63
Peterhead,4708,4,14,10,12,47,49,-2,52
Brechin,4708,5,15,6,15,60,60,0,51
Stranraer,4708,6,15,3,18,46,60,-14,48
Albion,4708,7,10,12,14,45,50,-5,42
Queen's Park,4708,8,11,6,19,33,61,-28,39
Stenhousem'r,4708,9,10,8,18,52,70,-18,38
East Fife,4708,10,9,10,17,48,55,-7,37
Airdrieon,4709,1,20,8,8,61,42,19,68
Livingston,4709,2,17,9,10,74,55,19,60
Albion,4709,3,16,7,13,66,54,12,55
Queen's Park,4709,4,14,11,11,45,54,-9,53
Alloa,4709,5,15,7,14,66,57,9,52
Brechin,4709,6,15,6,15,47,49,-2,51
Peterhead,4709,7,13,11,12,50,49,1,50
Stranraer,4709,8,13,9,14,48,50,-2,48
East Fife,4709,9,9,8,19,43,54,-11,35
Stenhousem'r,4709,10,5,10,21,45,81,-36,25
Alloa,4710,1,23,6,7,74,35,39,75
Livingston,4710,2,16,8,12,75,53,22,56
Airdrieon,4710,3,16,6,14,57,56,1,54
Albion,4710,4,15,7,14,52,54,-2,52
Brechin,4710,5,14,7,15,48,53,-5,49
Queen's Park,4710,6,13,9,14,36,45,-9,48
East Fife,4710,7,11,13,12,48,40,8,46
Peterhead,4710,8,12,7,17,48,63,-15,43
Stranraer,4710,9,10,11,15,43,51,-8,41
Stenhousem'r,4710,10,8,10,18,46,77,-31,34
Livingston,4711,1,22,5,9,76,43,33,71
Alloa,4711,2,18,7,11,68,44,24,61
Albion,4711,3,16,9,11,60,51,9,57
Airdrieon,4711,4,17,5,14,52,48,4,56
Brechin,4711,5,15,7,14,52,51,1,52
Peterhead,4711,6,14,7,15,49,51,-2,49
Queen's Park,4711,7,14,4,18,36,55,-19,46
East Fife,4711,8,12,9,15,45,45,0,45
Stranraer,4711,9,11,4,21,45,62,-17,37
Stenhousem'r,4711,10,7,11,18,42,75,-33,32
Airdrieon,4712,1,19,6,11,66,47,19,63
Albion,4712,2,18,7,11,61,44,17,61
East Fife,4712,3,18,6,12,53,45,8,60
Livingston,4712,4,18,5,13,63,42,21,59
Alloa,4712,5,15,11,10,60,39,21,56
Peterhead,4712,6,15,5,16,52,58,-6,50
Brechin,4712,7,12,7,17,44,54,-10,43
Stenhousem'r,4712,8,11,8,17,46,71,-25,41
Stranraer,4712,9,10,7,19,46,68,-22,37
Queen's Park,4712,10,10,6,20,37,60,-23,36
Livingston,4713,1,21,4,11,76,53,23,67
Airdrieon,4713,2,17,7,12,63,51,12,58
Alloa,4713,3,16,8,12,69,50,19,56
Albion,4713,4,16,5,15,65,63,2,53
Stranraer,4713,5,15,7,14,62,57,5,52
Brechin,4713,6,14,6,16,42,46,-4,48
Queen's Park,4713,7,14,6,16,41,53,-12,48
East Fife,4713,8,12,9,15,48,49,-1,45
Peterhead,4713,9,12,9,15,54,58,-4,45
Stenhousem'r,4713,10,8,9,19,49,89,-40,33
Alloa,4714,1,19,8,9,66,43,23,65
Albion,4714,2,18,8,10,66,48,18,62
Brechin,4714,3,19,3,14,53,50,3,60
Peterhead,4714,4,16,7,13,57,46,11,55
Airdrieon,4714,5,16,7,13,56,61,-5,55
Livingston,4714,6,14,11,11,67,50,17,53
Queen's Park,4714,7,11,12,13,36,43,-7,45
East Fife,4714,8,11,9,16,53,53,0,42
Stranraer,4714,9,12,5,19,47,65,-18,41
Stenhousem'r,4714,10,6,6,24,41,83,-42,24
Alloa,4715,1,20,6,10,67,38,29,66
Livingston,4715,2,20,5,11,80,48,32,65
Brechin,4715,3,16,8,12,46,43,3,56
Airdrieon,4715,4,15,10,11,55,51,4,55
Albion,4715,5,16,6,14,51,52,-1,54
Peterhead,4715,6,15,8,13,42,49,-7,53
East Fife,4715,7,11,15,10,52,39,13,48
Stranraer,4715,8,13,7,16,44,47,-3,46
Stenhousem'r,4715,9,7,9,20,42,81,-39,30
Queen's Park,4715,10,7,6,23,36,67,-31,27
Livingston,4716,1,22,5,9,83,53,30,71
Brechin,4716,2,21,4,11,63,43,20,67
Airdrieon,4716,3,18,9,9,58,50,8,63
Alloa,4716,4,17,9,10,64,44,20,60
Peterhead,4716,5,13,11,12,52,54,-2,50
East Fife,4716,6,13,7,16,53,44,9,46
Queen's Park,4716,7,10,10,16,36,55,-19,40
Albion,4716,8,10,9,17,45,60,-15,39
Stranraer,4716,9,9,6,21,44,69,-25,33
Stenhousem'r,4716,10,7,10,19,44,70,-26,31
Alloa,4717,1,17,10,9,71,49,22,61
Livingston,4717,2,19,3,14,74,48,26,60
Peterhead,4717,3,17,8,11,54,49,5,59
Airdrieon,4717,4,15,8,13,56,53,3,53
Brechin,4717,5,14,9,13,43,43,0,51
Albion,4717,6,13,10,13,55,57,-2,49
Queen's Park,4717,7,14,6,16,40,54,-14,48
East Fife,4717,8,12,9,15,50,50,0,45
Stranraer,4717,9,12,8,16,50,61,-11,44
Stenhousem'r,4717,10,7,9,20,45,74,-29,30
Livingston,4718,1,21,5,10,82,47,35,68
Alloa,4718,2,18,10,8,68,46,22,64
Airdrieon,4718,3,17,9,10,57,50,7,60
Brechin,4718,4,14,8,14,45,51,-6,50
Queen's Park,4718,5,13,11,12,37,43,-6,50
Albion,4718,6,12,13,11,55,54,1,49
East Fife,4718,7,11,11,14,54,50,4,44
Peterhead,4718,8,12,7,17,56,57,-1,43
Stranraer,4718,9,10,9,17,43,57,-14,39
Stenhousem'r,4718,10,7,7,22,44,86,-42,28
Livingston,4719,1,22,4,10,78,45,33,70
Alloa,4719,2,19,9,8,82,45,37,66
Airdrieon,4719,3,19,3,14,70,55,15,60
Brechin,4719,4,16,8,12,57,54,3,56
Peterhead,4719,5,15,8,13,45,48,-3,53
Queen's Park,4719,6,13,8,15,33,51,-18,47
Stranraer,4719,7,13,4,19,52,68,-16,43
East Fife,4719,8,9,12,15,47,51,-4,39
Albion,4719,9,11,6,19,47,66,-19,39
Stenhousem'r,4719,10,9,6,21,49,77,-28,33
Alloa,4720,1,23,6,7,78,36,42,75
Livingston,4720,2,23,1,12,73,54,19,70
Albion,4720,3,17,10,9,55,39,16,61
Airdrieon,4720,4,18,3,15,63,52,11,57
Brechin,4720,5,18,3,15,54,50,4,57
East Fife,4720,6,13,7,16,62,48,14,46
Peterhead,4720,7,12,8,16,46,59,-13,44
Queen's Park,4720,8,12,6,18,37,53,-16,42
Stranraer,4720,9,11,5,20,44,74,-30,38
Stenhousem'r,4720,10,6,5,25,40,87,-47,23
Livingston,4721,1,24,3,9,89,46,43,75
Brechin,4721,2,20,6,10,56,45,11,66
Queen's Park,4721,3,18,3,15,49,48,1,57
East Fife,4721,4,15,8,13,58,44,14,53
Peterhead,4721,5,15,6,15,49,52,-3,51
Alloa,4721,6,13,10,13,53,44,9,49
Albion,4721,7,13,9,14,51,53,-2,48
Airdrieon,4721,8,14,6,16,51,67,-16,48
Stranraer,4721,9,8,8,20,40,56,-16,32
Stenhousem'r,4721,10,6,9,21,38,79,-41,27
Livingston,4722,1,21,6,9,76,53,23,69
Alloa,4722,2,19,8,9,64,38,26,65
Queen's Park,4722,3,15,7,14,46,43,3,52
Airdrieon,4722,4,14,10,12,59,61,-2,52
Stranraer,4722,5,14,9,13,53,53,0,51
Albion,4722,6,14,6,16,53,59,-6,48
Peterhead,4722,7,14,6,16,49,56,-7,48
East Fife,4722,8,12,10,14,50,44,6,46
Brechin,4722,9,13,7,16,50,49,1,46
Stenhousem'r,4722,10,5,9,22,41,85,-44,24
Alloa,4723,1,20,7,9,70,43,27,67
Livingston,4723,2,19,5,12,75,53,22,62
Brechin,4723,3,17,5,14,45,49,-4,56
Airdrieon,4723,4,16,6,14,65,59,6,54
Albion,4723,5,14,8,14,52,51,1,50
Peterhead,4723,6,14,8,14,56,57,-1,50
East Fife,4723,7,13,9,14,51,48,3,48
Stranraer,4723,8,12,6,18,59,69,-10,42
Stenhousem'r,4723,9,12,5,19,53,75,-22,41
Queen's Park,4723,10,9,9,18,33,55,-22,36
Livingston,4724,1,21,2,13,67,44,23,65
Alloa,4724,2,19,7,10,72,49,23,64
Airdrieon,4724,3,19,6,11,72,53,19,63
Brechin,4724,4,17,6,13,55,50,5,57
Stranraer,4724,5,16,4,16,54,54,0,52
Albion,4724,6,14,8,14,50,46,4,50
Peterhead,4724,7,15,5,16,50,59,-9,50
Queen's Park,4724,8,11,7,18,35,58,-23,40
East Fife,4724,9,10,8,18,43,50,-7,38
Stenhousem'r,4724,10,8,7,21,36,71,-35,31
Alloa,4725,1,22,6,8,72,36,36,72
Airdrieon,4725,2,22,4,10,83,56,27,70
Livingston,4725,3,21,3,12,75,50,25,66
Brechin,4725,4,15,7,14,58,56,2,52
Stranraer,4725,5,16,3,17,55,57,-2,51
Peterhead,4725,6,12,9,15,47,52,-5,45
East Fife,4725,7,13,6,17,50,57,-7,45
Albion,4725,8,11,7,18,45,59,-14,40
Queen's Park,4725,9,11,6,19,32,55,-23,39
Stenhousem'r,4725,10,7,9,20,46,85,-39,30
Alloa,4726,1,22,4,10,75,44,31,70
Livingston,4726,2,22,2,12,79,51,28,68
Brechin,4726,3,17,8,11,54,45,9,59
Airdrieon,4726,4,17,8,11,69,61,8,59
Albion,4726,5,14,7,15,51,58,-7,49
Peterhead,4726,6,15,3,18,60,63,-3,48
Queen's Park,4726,7,13,8,15,44,50,-6,47
East Fife,4726,8,11,10,15,46,48,-2,43
Stranraer,4726,9,11,5,20,57,72,-15,38
Stenhousem'r,4726,10,8,5,23,43,86,-43,29
Airdrieon,4727,1,21,6,9,66,45,21,69
Alloa,4727,2,19,6,11,75,46,29,63
Livingston,4727,3,19,5,12,69,49,20,62
Brechin,4727,4,18,4,14,57,54,3,58
Stranraer,4727,5,17,2,17,60,57,3,53
Albion,4727,6,14,10,12,59,55,4,52
Peterhead,4727,7,15,5,16,53,59,-6,50
East Fife,4727,8,14,7,15,49,44,5,49
Queen's Park,4727,9,11,5,20,27,55,-28,38
Stenhousem'r,4727,10,3,8,25,33,84,-51,17
Alloa,4728,1,22,4,10,82,53,29,70
Livingston,4728,2,21,5,10,70,43,27,68
Airdrieon,4728,3,16,11,9,54,43,11,59
Stranraer,4728,4,15,6,15,48,58,-10,51
Brechin,4728,5,14,8,14,48,49,-1,50
East Fife,4728,6,12,11,13,48,45,3,47
Queen's Park,4728,7,12,8,16,36,47,-11,44
Albion,4728,8,11,10,15,54,57,-3,43
Peterhead,4728,9,10,6,20,35,54,-19,36
Stenhousem'r,4728,10,7,11,18,43,69,-26,32
Livingston,4729,1,22,4,10,73,44,29,70
Albion,4729,2,17,11,8,54,41,13,62
Brechin,4729,3,17,7,12,57,46,11,58
Alloa,4729,4,16,9,11,63,42,21,57
Peterhead,4729,5,15,11,10,51,49,2,56
Airdrieon,4729,6,13,7,16,44,53,-9,46
Queen's Park,4729,7,13,4,19,38,55,-17,43
East Fife,4729,8,10,11,15,46,53,-7,41
Stranraer,4729,9,11,7,18,51,60,-9,40
Stenhousem'r,4729,10,7,7,22,45,79,-34,28
Livingston,4730,1,20,6,10,72,48,24,66
Albion,4730,2,18,5,13,58,54,4,59
Alloa,4730,3,16,9,11,65,48,17,57
Airdrieon,4730,4,16,6,14,60,54,6,54
Peterhead,4730,5,14,12,10,51,46,5,54
Brechin,4730,6,16,4,16,44,48,-4,52
East Fife,4730,7,14,7,15,54,49,5,49
Stranraer,4730,8,11,10,15,47,54,-7,43
Queen's Park,4730,9,10,6,20,35,60,-25,36
Stenhousem'r,4730,10,8,9,19,53,78,-25,33
Livingston,4731,1,22,5,9,82,49,33,71
Alloa,4731,2,20,8,8,75,40,35,68
Stranraer,4731,3,16,4,16,58,50,8,52
Airdrieon,4731,4,15,7,14,52,60,-8,52
Queen's Park,4731,5,14,7,15,34,49,-15,49
Peterhead,4731,6,13,9,14,47,55,-8,48
Brechin,4731,7,13,8,15,46,53,-7,47
Albion,4731,8,12,8,16,49,57,-8,44
Stenhousem'r,4731,9,9,10,17,38,58,-20,37
East Fife,4731,10,8,10,18,44,54,-10,34
Livingston,4732,1,20,6,10,71,43,28,66
Alloa,4732,2,20,5,11,66,39,27,65
Brechin,4732,3,16,9,11,50,39,11,57
Airdrieon,4732,4,17,6,13,54,54,0,57
Queen's Park,4732,5,15,7,14,42,42,0,52
East Fife,4732,6,12,13,11,51,42,9,49
Albion,4732,7,14,6,16,44,58,-14,48
Peterhead,4732,8,12,8,16,49,54,-5,44
Stranraer,4732,9,8,9,19,44,61,-17,33
Stenhousem'r,4732,10,7,9,20,48,87,-39,30
Alloa,4733,1,21,5,10,69,41,28,68
Livingston,4733,2,20,6,10,73,43,30,66
Brechin,4733,3,18,8,10,55,45,10,62
Airdrieon,4733,4,17,6,13,56,48,8,57
Queen's Park,4733,5,15,7,14,41,46,-5,52
Stranraer,4733,6,13,6,17,58,67,-9,45
East Fife,4733,7,11,8,17,47,49,-2,41
Peterhead,4733,8,11,8,17,38,53,-15,41
Albion,4733,9,10,10,16,41,52,-11,40
Stenhousem'r,4733,10,8,8,20,39,73,-34,32
Brechin,4734,1,19,7,10,56,42,14,64
Alloa,4734,2,18,7,11,68,42,26,61
Airdrieon,4734,3,16,9,11,56,57,-1,57
Livingston,4734,4,16,4,16,71,60,11,52
Stenhousem'r,4734,5,14,9,13,52,60,-8,51
Albion,4734,6,13,9,14,57,52,5,48
Queen's Park,4734,7,12,10,14,42,57,-15,46
East Fife,4734,8,12,7,17,54,55,-1,43
Peterhead,4734,9,11,9,16,44,62,-18,42
Stranraer,4734,10,9,9,18,38,51,-13,36
Alloa,4735,1,24,6,6,90,35,55,78
Livingston,4735,2,24,4,8,84,48,36,76
Albion,4735,3,16,8,12,60,54,6,56
Brechin,4735,4,15,7,14,45,46,-1,52
East Fife,4735,5,12,12,12,52,48,4,48
Peterhead,4735,6,12,10,14,45,57,-12,46
Queen's Park,4735,7,12,6,18,37,59,-22,42
Airdrieon,4735,8,10,7,19,48,67,-19,37
Stenhousem'r,4735,9,10,6,20,46,70,-24,36
Stranraer,4735,10,8,8,20,39,62,-23,32
Alloa,4736,1,22,7,7,82,39,43,73
Livingston,4736,2,19,8,9,79,51,28,65
Airdrieon,4736,3,15,10,11,56,54,2,55
Albion,4736,4,14,9,13,52,53,-1,51
Brechin,4736,5,14,7,15,52,54,-2,49
Queen's Park,4736,6,13,7,16,44,57,-13,46
Peterhead,4736,7,10,11,15,44,58,-14,41
East Fife,4736,8,8,15,13,46,48,-2,39
Stenhousem'r,4736,9,9,12,15,47,63,-16,39
Stranraer,4736,10,11,4,21,50,75,-25,37
Livingston,4737,1,20,2,14,76,53,23,62
Brechin,4737,2,19,5,12,61,51,10,62
Alloa,4737,3,18,6,12,64,44,20,60
Stranraer,4737,4,17,3,16,57,56,1,54
Airdrieon,4737,5,16,6,14,53,59,-6,54
Peterhead,4737,6,14,6,16,46,47,-1,48
Albion,4737,7,14,5,17,52,53,-1,47
East Fife,4737,8,12,10,14,51,53,-2,46
Stenhousem'r,4737,9,12,7,17,59,81,-22,43
Queen's Park,4737,10,10,6,20,38,60,-22,36
Livingston,4738,1,20,5,11,76,50,26,65
Alloa,4738,2,18,9,9,79,51,28,63
Brechin,4738,3,18,7,11,59,51,8,61
Stranraer,4738,4,15,6,15,48,51,-3,51
Albion,4738,5,13,10,13,48,49,-1,49
Airdrieon,4738,6,14,6,16,55,60,-5,48
Queen's Park,4738,7,14,5,17,44,53,-9,47
Peterhead,4738,8,11,10,15,44,55,-11,43
East Fife,4738,9,11,9,16,44,47,-3,42
Stenhousem'r,4738,10,8,9,19,51,81,-30,33
Livingston,4739,1,25,3,8,81,42,39,78
Alloa,4739,2,20,5,11,76,49,27,65
Brechin,4739,3,18,7,11,46,35,11,61
Airdrieon,4739,4,16,8,12,57,59,-2,56
Albion,4739,5,14,7,15,52,54,-2,49
Stranraer,4739,6,14,6,16,58,60,-2,48
Queen's Park,4739,7,13,6,17,35,51,-16,45
Peterhead,4739,8,11,7,18,49,61,-12,40
East Fife,4739,9,8,11,17,46,49,-3,35
Stenhousem'r,4739,10,7,8,21,47,87,-40,29
Alloa,4740,1,21,10,5,75,45,30,73
Brechin,4740,2,20,6,10,57,38,19,66
Livingston,4740,3,20,5,11,75,46,29,65
Airdrieon,4740,4,18,6,12,63,54,9,60
Peterhead,4740,5,14,9,13,50,58,-8,51
Albion,4740,6,12,9,15,54,58,-4,45
Stranraer,4740,7,10,9,17,51,62,-11,39
East Fife,4740,8,8,12,16,47,50,-3,36
Queen's Park,4740,9,9,7,20,43,73,-30,34
Stenhousem'r,4740,10,9,5,22,48,79,-31,32
Livingston,4741,1,25,3,8,82,45,37,78
Alloa,4741,2,16,10,10,66,44,22,58
Albion,4741,3,17,4,15,69,48,21,55
Airdrieon,4741,4,14,9,13,57,57,0,51
Stranraer,4741,5,14,6,16,44,48,-4,48
Brechin,4741,6,12,12,12,54,65,-11,48
East Fife,4741,7,13,7,16,52,52,0,46
Peterhead,4741,8,12,9,15,47,51,-4,45
Queen's Park,4741,9,12,8,16,36,50,-14,44
Stenhousem'r,4741,10,8,6,22,42,89,-47,30
Livingston,4742,1,23,5,8,75,44,31,74
Alloa,4742,2,17,9,10,69,48,21,60
Airdrieon,4742,3,16,10,10,58,53,5,58
Brechin,4742,4,16,9,11,49,45,4,57
Albion,4742,5,16,6,14,54,54,0,54
Stranraer,4742,6,13,9,14,47,51,-4,48
East Fife,4742,7,12,9,15,50,45,5,45
Queen's Park,4742,8,13,5,18,42,53,-11,44
Peterhead,4742,9,8,9,19,42,62,-20,33
Stenhousem'r,4742,10,7,7,22,48,79,-31,28
Alloa,4743,1,21,8,7,73,35,38,71
Airdrieon,4743,2,19,4,13,71,59,12,61
Livingston,4743,3,18,4,14,69,55,14,58
East Fife,4743,4,13,12,11,58,43,15,51
Peterhead,4743,5,14,7,15,48,55,-7,49
Brechin,4743,6,15,4,17,44,51,-7,49
Albion,4743,7,12,12,12,47,45,2,48
Queen's Park,4743,8,13,8,15,42,53,-11,47
Stranraer,4743,9,11,7,18,44,65,-21,40
Stenhousem'r,4743,10,7,8,21,38,73,-35,29
Alloa,4744,1,20,9,7,66,37,29,69
Livingston,4744,2,20,5,11,75,48,27,65
Brechin,4744,3,18,6,12,51,40,11,60
Airdrieon,4744,4,17,7,12,61,48,13,58
Peterhead,4744,5,14,9,13,44,52,-8,51
East Fife,4744,6,13,5,18,53,62,-9,44
Stranraer,4744,7,10,13,13,43,48,-5,43
Albion,4744,8,12,7,17,46,56,-10,43
Queen's Park,4744,9,12,6,18,41,57,-16,42
Stenhousem'r,4744,10,5,11,20,43,75,-32,26
Alloa,4745,1,21,8,7,69,37,32,71
Livingston,4745,2,20,5,11,72,51,21,65
Airdrieon,4745,3,21,2,13,57,47,10,65
Peterhead,4745,4,15,6,15,46,51,-5,51
Albion,4745,5,14,8,14,54,51,3,50
Brechin,4745,6,14,5,17,45,43,2,47
East Fife,4745,7,12,9,15,50,52,-2,45
Queen's Park,4745,8,12,9,15,35,50,-15,45
Stranraer,4745,9,12,6,18,49,61,-12,42
Stenhousem'r,4745,10,6,8,22,49,83,-34,26
Alloa,4746,1,24,8,4,86,36,50,80
Livingston,4746,2,21,6,9,64,37,27,69
East Fife,4746,3,14,9,13,57,47,10,51
Albion,4746,4,14,9,13,52,51,1,51
Airdrieon,4746,5,14,8,14,54,58,-4,50
Brechin,4746,6,14,7,15,47,53,-6,49
Peterhead,4746,7,13,6,17,43,51,-8,45
Queen's Park,4746,8,11,11,14,43,53,-10,44
Stenhousem'r,4746,9,7,13,16,50,78,-28,34
Stranraer,4746,10,7,5,24,39,71,-32,26
Livingston,4747,1,25,4,7,83,37,46,79
Alloa,4747,2,17,6,13,64,45,19,57
Brechin,4747,3,17,6,13,54,42,12,57
Airdrieon,4747,4,16,7,13,59,56,3,55
Albion,4747,5,15,9,12,52,52,0,54
East Fife,4747,6,15,7,14,46,40,6,52
Peterhead,4747,7,14,8,14,43,52,-9,50
Stranraer,4747,8,13,5,18,45,62,-17,44
Queen's Park,4747,9,10,5,21,35,57,-22,35
Stenhousem'r,4747,10,5,9,22,36,74,-38,24
Livingston,4748,1,22,5,9,78,48,30,71
Alloa,4748,2,21,7,8,75,38,37,70
East Fife,4748,3,17,8,11,68,51,17,59
Airdrieon,4748,4,17,7,12,60,55,5,58
Brechin,4748,5,16,5,15,50,54,-4,53
Stenhousem'r,4748,6,12,8,16,53,65,-12,44
Peterhead,4748,7,10,10,16,43,62,-19,40
Stranraer,4748,8,11,5,20,51,67,-16,38
Albion,4748,9,8,13,15,47,59,-12,37
Queen's Park,4748,10,10,4,22,28,54,-26,34
Livingston,4749,1,24,3,9,94,51,43,75
Peterhead,4749,2,16,6,14,51,49,2,54
Alloa,4749,3,14,11,11,57,49,8,53
Brechin,4749,4,13,11,12,44,49,-5,50
Albion,4749,5,12,13,11,49,49,0,49
Airdrieon,4749,6,14,7,15,51,58,-7,49
Stranraer,4749,7,13,9,14,56,62,-6,48
Queen's Park,4749,8,12,9,15,45,55,-10,45
East Fife,4749,9,12,8,16,49,47,2,44
Stenhousem'r,4749,10,8,7,21,45,72,-27,31
Livingston,4750,1,24,3,9,99,53,46,75
Brechin,4750,2,18,6,12,53,41,12,60
Alloa,4750,3,16,10,10,66,52,14,58
Albion,4750,4,17,7,12,59,52,7,58
Stranraer,4750,5,15,5,16,51,56,-5,50
Airdrieon,4750,6,15,4,17,52,54,-2,49
Peterhead,4750,7,11,12,13,53,63,-10,45
East Fife,4750,8,10,10,16,56,54,2,40
Queen's Park,4750,9,11,6,19,39,64,-25,39
Stenhousem'r,4750,10,9,5,22,46,85,-39,32
Alloa,4751,1,22,5,9,74,39,35,71
Livingston,4751,2,18,4,14,64,49,15,58
Albion,4751,3,18,3,15,52,57,-5,57
Airdrieon,4751,4,15,8,13,54,55,-1,53
Queen's Park,4751,5,16,5,15,41,42,-1,53
Brechin,4751,6,15,6,15,50,51,-1,51
Peterhead,4751,7,13,11,12,52,47,5,50
East Fife,4751,8,12,10,14,42,42,0,46
Stranraer,4751,9,12,8,16,46,52,-6,44
Stenhousem'r,4751,10,7,4,25,41,82,-41,25
Livingston,4752,1,24,3,9,86,38,48,75
Alloa,4752,2,20,5,11,68,43,25,65
Brechin,4752,3,17,8,11,57,48,9,59
Queen's Park,4752,4,17,4,15,45,52,-7,55
Airdrieon,4752,5,16,6,14,57,53,4,54
Albion,4752,6,16,5,15,51,58,-7,53
Peterhead,4752,7,14,6,16,47,56,-9,48
Stranraer,4752,8,11,7,18,42,56,-14,40
East Fife,4752,9,9,9,18,45,54,-9,36
Stenhousem'r,4752,10,5,9,22,37,77,-40,24
Brechin,4753,1,21,5,10,57,46,11,68
Alloa,4753,2,19,7,10,65,41,24,64
Airdrieon,4753,3,18,8,10,60,52,8,62
Livingston,4753,4,18,7,11,70,54,16,61
Peterhead,4753,5,15,7,14,49,49,0,52
Albion,4753,6,14,6,16,54,53,1,48
East Fife,4753,7,11,8,17,52,52,0,41
Stenhousem'r,4753,8,11,8,17,52,73,-21,41
Stranraer,4753,9,12,3,21,37,53,-16,39
Queen's Park,4753,10,7,9,20,28,51,-23,30
Livingston,4754,1,19,7,10,73,51,22,64
Airdrieon,4754,2,19,6,11,62,45,17,63
Alloa,4754,3,19,5,12,77,46,31,62
Brechin,4754,4,17,5,14,38,51,-13,56
Albion,4754,5,14,8,14,56,53,3,50
Peterhead,4754,6,14,8,14,45,52,-7,50
Stranraer,4754,7,13,8,15,50,52,-2,47
Queen's Park,4754,8,14,5,17,30,42,-12,47
East Fife,4754,9,12,8,16,49,51,-2,44
Stenhousem'r,4754,10,7,4,25,41,78,-37,25
Alloa,4755,1,21,7,8,73,42,31,70
Airdrieon,4755,2,19,5,12,53,53,0,62
Brechin,4755,3,19,3,14,56,49,7,60
Livingston,4755,4,17,5,14,77,57,20,56
East Fife,4755,5,15,7,14,60,50,10,52
Albion,4755,6,15,6,15,51,55,-4,51
Queen's Park,4755,7,14,7,15,33,41,-8,49
Stranraer,4755,8,12,6,18,59,63,-4,42
Peterhead,4755,9,11,7,18,50,63,-13,40
Stenhousem'r,4755,10,7,7,22,48,87,-39,28
Livingston,4756,1,21,3,12,83,51,32,66
Alloa,4756,2,19,6,11,79,51,28,63
Brechin,4756,3,19,4,13,58,56,2,61
Airdrieon,4756,4,17,6,13,60,49,11,57
Queen's Park,4756,5,17,4,15,46,48,-2,55
Albion,4756,6,15,8,13,51,47,4,53
Stranraer,4756,7,14,7,15,55,59,-4,49
Peterhead,4756,8,12,7,17,48,55,-7,43
East Fife,4756,9,11,8,17,37,53,-16,41
Stenhousem'r,4756,10,5,7,24,39,87,-48,22
Alloa,4757,1,19,6,11,74,53,21,63
Airdrieon,4757,2,16,11,9,52,50,2,59
Queen's Park,4757,3,17,7,12,46,39,7,58
Livingston,4757,4,17,5,14,72,59,13,56
Brechin,4757,5,17,5,14,48,45,3,56
Albion,4757,6,15,9,12,51,40,11,54
Peterhead,4757,7,13,7,16,39,49,-10,46
Stranraer,4757,8,12,5,19,52,64,-12,41
East Fife,4757,9,9,8,19,49,62,-13,35
Stenhousem'r,4757,10,8,11,17,45,67,-22,35
Livingston,4758,1,21,7,8,78,43,35,70
Airdrieon,4758,2,18,7,11,63,55,8,61
Brechin,4758,3,16,10,10,46,41,5,58
Peterhead,4758,4,16,10,10,52,48,4,58
Alloa,4758,5,16,9,11,66,42,24,57
Queen's Park,4758,6,12,9,15,38,47,-9,45
Albion,4758,7,11,10,15,51,61,-10,43
East Fife,4758,8,9,10,17,48,57,-9,37
Stranraer,4758,9,10,7,19,46,60,-14,37
Stenhousem'r,4758,10,8,7,21,40,74,-34,31
Livingston,4759,1,24,2,10,79,42,37,74
Alloa,4759,2,18,8,10,63,50,13,62
Airdrieon,4759,3,17,5,14,60,63,-3,56
Peterhead,4759,4,16,4,16,59,59,0,52
Brechin,4759,5,14,8,14,48,55,-7,50
Queen's Park,4759,6,14,4,18,38,51,-13,46
Stranraer,4759,7,12,8,16,60,58,2,44
Albion,4759,8,12,7,17,50,48,2,43
East Fife,4759,9,11,9,16,48,52,-4,42
Stenhousem'r,4759,10,11,7,18,50,77,-27,40
Livingston,4760,1,21,4,11,80,55,25,67
Alloa,4760,2,17,8,11,67,49,18,59
Brechin,4760,3,17,6,13,52,43,9,57
Airdrieon,4760,4,16,9,11,65,61,4,57
East Fife,4760,5,16,7,13,61,39,22,55
Queen's Park,4760,6,16,7,13,46,45,1,55
Stranraer,4760,7,15,6,15,60,58,2,51
Peterhead,4760,8,12,8,16,51,62,-11,44
Albion,4760,9,10,8,18,41,53,-12,38
Stenhousem'r,4760,10,5,7,24,36,94,-58,22
Livingston,4761,1,24,3,9,88,47,41,75
Alloa,4761,2,19,8,9,82,46,36,65
Airdrieon,4761,3,18,8,10,67,56,11,62
Brechin,4761,4,15,6,15,52,54,-2,51
East Fife,4761,5,14,8,14,52,48,4,50
Peterhead,4761,6,14,7,15,50,63,-13,49
Albion,4761,7,13,9,14,58,56,2,48
Stranraer,4761,8,10,7,19,45,64,-19,37
Queen's Park,4761,9,9,8,19,36,67,-31,35
Stenhousem'r,4761,10,8,8,20,48,77,-29,32
Livingston,4762,1,23,4,9,78,45,33,73
Brechin,4762,2,18,8,10,53,46,7,62
Alloa,4762,3,18,6,12,71,52,19,60
Albion,4762,4,16,7,13,56,47,9,55
Peterhead,4762,5,15,9,12,48,50,-2,54
Airdrieon,4762,6,15,8,13,58,54,4,53
East Fife,4762,7,9,10,17,51,54,-3,37
Stranraer,4762,8,9,10,17,45,59,-14,37
Queen's Park,4762,9,10,6,20,30,51,-21,36
Stenhousem'r,4762,10,9,8,19,43,75,-32,35
Alloa,4763,1,19,11,6,75,39,36,68
Livingston,4763,2,17,8,11,68,47,21,59
Airdrieon,4763,3,17,8,11,64,60,4,59
Brechin,4763,4,16,10,10,65,46,19,58
Queen's Park,4763,5,14,9,13,46,51,-5,51
East Fife,4763,6,13,10,13,53,48,5,49
Peterhead,4763,7,11,10,15,44,56,-12,43
Albion,4763,8,11,8,17,48,55,-7,41
Stenhousem'r,4763,9,9,7,20,49,79,-30,34
Stranraer,4763,10,9,7,20,45,76,-31,34
Livingston,4764,1,22,5,9,78,46,32,71
Alloa,4764,2,18,7,11,65,40,25,61
Airdrieon,4764,3,17,10,9,57,45,12,61
Brechin,4764,4,17,3,16,48,51,-3,54
Albion,4764,5,12,13,11,47,46,1,49
East Fife,4764,6,13,7,16,48,51,-3,46
Stranraer,4764,7,13,4,19,47,51,-4,43
Peterhead,4764,8,9,13,14,43,55,-12,40
Queen's Park,4764,9,9,10,17,39,59,-20,37
Stenhousem'r,4764,10,9,10,17,46,74,-28,37
Livingston,4765,1,22,5,9,78,46,32,71
Airdrieon,4765,2,19,8,9,66,48,18,65
Alloa,4765,3,19,7,10,78,49,29,64
Peterhead,4765,4,16,6,14,47,51,-4,54
Brechin,4765,5,13,6,17,43,47,-4,45
Queen's Park,4765,6,13,6,17,41,51,-10,45
East Fife,4765,7,11,9,16,45,46,-1,42
Stenhousem'r,4765,8,11,9,16,58,84,-26,42
Albion,4765,9,11,6,19,50,65,-15,39
Stranraer,4765,10,11,6,19,48,67,-19,39
Livingston,4766,1,21,4,11,79,48,31,67
Alloa,4766,2,19,8,9,80,51,29,65
Queen's Park,4766,3,16,4,16,39,51,-12,52
Airdrieon,4766,4,14,9,13,54,51,3,51
Peterhead,4766,5,14,8,14,59,59,0,50
Brechin,4766,6,14,7,15,44,53,-9,49
Stranraer,4766,7,15,3,18,51,61,-10,48
East Fife,4766,8,12,8,16,52,50,2,44
Albion,4766,9,11,8,17,47,57,-10,41
Stenhousem'r,4766,10,12,5,19,48,72,-24,41
Alloa,4767,1,19,10,7,69,42,27,67
Livingston,4767,2,18,6,12,74,55,19,60
Brechin,4767,3,16,8,12,55,55,0,56
Airdrieon,4767,4,14,11,11,60,49,11,53
Queen's Park,4767,5,13,9,14,33,46,-13,48
Albion,4767,6,12,11,13,53,60,-7,47
Stranraer,4767,7,12,9,15,55,56,-1,45
Peterhead,4767,8,10,14,12,49,51,-2,44
East Fife,4767,9,10,9,17,48,53,-5,39
Stenhousem'r,4767,10,8,9,19,44,73,-29,33
Livingston,4768,1,23,5,8,85,48,37,74
Alloa,4768,2,17,11,8,66,38,28,62
Airdrieon,4768,3,18,6,12,60,49,11,60
Brechin,4768,4,15,9,12,46,42,4,54
Peterhead,4768,5,16,5,15,54,52,2,53
Albion,4768,6,15,7,14,47,44,3,52
Queen's Park,4768,7,11,9,16,37,51,-14,42
Stranraer,4768,8,10,9,17,47,61,-14,39
Stenhousem'r,4768,9,10,6,20,44,80,-36,36
East Fife,4768,10,5,13,18,34,55,-21,28
Alloa,4769,1,23,5,8,76,47,29,74
Livingston,4769,2,22,5,9,77,44,33,71
Brechin,4769,3,21,3,12,61,49,12,66
Airdrieon,4769,4,19,6,11,64,54,10,63
Peterhead,4769,5,15,5,16,53,54,-1,50
Queen's Park,4769,6,14,7,15,38,47,-9,49
Albion,4769,7,13,7,16,57,55,2,46
East Fife,4769,8,10,7,19,46,54,-8,37
Stranraer,4769,9,9,4,23,37,65,-28,31
Stenhousem'r,4769,10,7,5,24,45,85,-40,26
Livingston,4770,1,23,4,9,88,50,38,73
Airdrieon,4770,2,20,5,11,65,48,17,65
Albion,4770,3,17,7,12,56,52,4,58
Alloa,4770,4,15,11,10,60,47,13,56
Peterhead,4770,5,15,8,13,60,51,9,53
Brechin,4770,6,15,6,15,47,52,-5,51
Queen's Park,4770,7,13,5,18,41,60,-19,44
East Fife,4770,8,9,13,14,46,49,-3,40
Stranraer,4770,9,10,8,18,50,66,-16,38
Stenhousem'r,4770,10,5,9,22,45,83,-38,24
Alloa,4771,1,23,8,5,74,37,37,77
Livingston,4771,2,20,7,9,71,47,24,67
Airdrieon,4771,3,15,9,12,56,48,8,54
East Fife,4771,4,14,8,14,51,49,2,50
Queen's Park,4771,5,14,7,15,38,48,-10,49
Peterhead,4771,6,14,6,16,49,48,1,48
Albion,4771,7,13,8,15,51,53,-2,47
Brechin,4771,8,12,7,17,38,51,-13,43
Stranraer,4771,9,12,6,18,53,60,-7,42
Stenhousem'r,4771,10,6,8,22,46,86,-40,26
Livingston,4772,1,24,4,8,78,45,33,76
Alloa,4772,2,22,9,5,80,35,45,75
Airdrieon,4772,3,15,11,10,62,60,2,56
Peterhead,4772,4,15,8,13,59,60,-1,53
Albion,4772,5,15,6,15,51,56,-5,51
Brechin,4772,6,14,7,15,43,47,-4,49
Queen's Park,4772,7,13,3,20,37,52,-15,42
Stranraer,4772,8,11,7,18,53,62,-9,40
East Fife,4772,9,11,6,19,49,57,-8,39
Stenhousem'r,4772,10,7,5,24,44,82,-38,26
Livingston,4773,1,22,2,12,70,49,21,68
Alloa,4773,2,20,7,9,68,44,24,67
Peterhead,4773,3,19,5,12,59,44,15,62
Airdrieon,4773,4,18,5,13,57,53,4,59
Brechin,4773,5,16,6,14,48,45,3,54
Queen's Park,4773,6,15,7,14,44,49,-5,52
Albion,4773,7,13,9,14,50,51,-1,48
Stranraer,4773,8,10,6,20,42,57,-15,36
East Fife,4773,9,8,9,19,43,54,-11,33
Stenhousem'r,4773,10,5,12,19,46,81,-35,27
Livingston,4774,1,22,4,10,74,49,25,70
Alloa,4774,2,21,6,9,73,43,30,69
Airdrieon,4774,3,18,5,13,68,67,1,59
Albion,4774,4,15,10,11,56,48,8,55
Brechin,4774,5,16,6,14,53,44,9,54
Stranraer,4774,6,13,5,18,56,62,-6,44
Queen's Park,4774,7,12,6,18,39,58,-19,42
Peterhead,4774,8,10,11,15,50,57,-7,41
East Fife,4774,9,10,8,18,44,57,-13,38
Stenhousem'r,4774,10,9,7,20,46,74,-28,34
Livingston,4775,1,22,3,11,76,49,27,69
Brechin,4775,2,20,3,13,55,45,10,63
Albion,4775,3,16,11,9,55,44,11,59
Alloa,4775,4,17,7,12,70,49,21,58
Airdrieon,4775,5,15,9,12,64,61,3,54
Queen's Park,4775,6,14,8,14,41,44,-3,50
Peterhead,4775,7,12,9,15,46,54,-8,45
Stranraer,4775,8,11,6,19,50,67,-17,39
East Fife,4775,9,9,7,20,47,58,-11,34
Stenhousem'r,4775,10,9,7,20,49,82,-33,34
Alloa,4776,1,19,10,7,72,43,29,67
Airdrieon,4776,2,19,5,12,63,48,15,62
Livingston,4776,3,19,4,13,76,53,23,61
Brechin,4776,4,16,11,9,52,43,9,59
Albion,4776,5,17,7,12,50,46,4,58
Peterhead,4776,6,13,7,16,44,50,-6,46
Queen's Park,4776,7,13,7,16,36,51,-15,46
East Fife,4776,8,11,8,17,49,51,-2,41
Stranraer,4776,9,11,7,18,49,63,-14,40
Stenhousem'r,4776,10,6,6,24,43,86,-43,24
Alloa,4777,1,21,6,9,81,44,37,69
Airdrieon,4777,2,18,6,12,54,50,4,60
Livingston,4777,3,17,7,12,75,60,15,58
Brechin,4777,4,17,5,14,48,39,9,56
Peterhead,4777,5,15,7,14,56,58,-2,52
East Fife,4777,6,14,9,13,45,40,5,51
Stranraer,4777,7,13,8,15,49,56,-7,47
Queen's Park,4777,8,12,7,17,39,51,-12,43
Albion,4777,9,10,7,19,44,63,-19,37
Stenhousem'r,4777,10,8,8,20,43,73,-30,32
Brechin,4778,1,18,10,8,52,36,16,64
Livingston,4778,2,20,3,13,79,57,22,63
Alloa,4778,3,15,14,7,67,43,24,59
Airdrieon,4778,4,17,8,11,48,42,6,59
Albion,4778,5,14,8,14,59,60,-1,50
East Fife,4778,6,11,12,13,47,47,0,45
Queen's Park,4778,7,12,8,16,37,56,-19,44
Peterhead,4778,8,11,10,15,42,53,-11,43
Stenhousem'r,4778,9,10,7,19,50,69,-19,37
Stranraer,4778,10,9,6,21,47,65,-18,33
Alloa,4779,1,18,9,9,66,43,23,63
Livingston,4779,2,19,4,13,78,61,17,61
Albion,4779,3,17,9,10,58,46,12,60
Airdrieon,4779,4,18,6,12,67,58,9,60
Peterhead,4779,5,14,9,13,47,47,0,51
Brechin,4779,6,15,5,16,47,51,-4,50
Stranraer,4779,7,13,5,18,52,60,-8,44
Queen's Park,4779,8,13,5,18,30,44,-14,44
Stenhousem'r,4779,9,11,5,20,45,70,-25,38
East Fife,4779,10,7,13,16,44,54,-10,34
Livingston,4780,1,23,6,7,75,37,38,75
Alloa,4780,2,16,11,9,70,47,23,59
Airdrieon,4780,3,15,7,14,59,61,-2,52
Albion,4780,4,13,10,13,55,54,1,49
Stranraer,4780,5,15,3,18,46,58,-12,48
East Fife,4780,6,12,8,16,37,43,-6,44
Peterhead,4780,7,10,13,13,49,55,-6,43
Brechin,4780,8,11,9,16,42,45,-3,42
Stenhousem'r,4780,9,10,12,14,53,68,-15,42
Queen's Park,4780,10,11,9,16,34,52,-18,42
Livingston,4781,1,22,4,10,87,54,33,70
Airdrieon,4781,2,19,7,10,64,49,15,64
Brechin,4781,3,19,6,11,68,52,16,63
Alloa,4781,4,17,10,9,74,52,22,61
Albion,4781,5,15,9,12,56,58,-2,54
Peterhead,4781,6,13,12,11,49,53,-4,51
Queen's Park,4781,7,11,8,17,34,53,-19,41
Stranraer,4781,8,10,6,20,53,67,-14,36
East Fife,4781,9,8,11,17,47,58,-11,35
Stenhousem'r,4781,10,6,7,23,45,81,-36,25
Livingston,4782,1,24,7,5,83,41,42,79
Alloa,4782,2,23,6,7,77,40,37,75
Albion,4782,3,13,11,12,50,46,4,50
Peterhead,4782,4,13,11,12,52,50,2,50
Airdrieon,4782,5,14,8,14,56,57,-1,50
Queen's Park,4782,6,13,7,16,37,44,-7,46
Brechin,4782,7,13,6,17,41,54,-13,45
East Fife,4782,8,11,11,14,50,48,2,44
Stranraer,4782,9,12,5,19,47,60,-13,41
Stenhousem'r,4782,10,4,8,24,33,86,-53,20
Livingston,4783,1,24,3,9,79,38,41,75
Alloa,4783,2,19,8,9,70,44,26,65
Airdrieon,4783,3,18,4,14,69,61,8,58
Brechin,4783,4,16,5,15,43,46,-3,53
Albion,4783,5,14,4,18,48,56,-8,46
Peterhead,4783,6,12,8,16,42,47,-5,44
Stranraer,4783,7,13,5,18,49,59,-10,44
East Fife,4783,8,10,12,14,51,50,1,42
Queen's Park,4783,9,12,6,18,48,62,-14,42
Stenhousem'r,4783,10,11,7,18,48,84,-36,40
Livingston,4784,1,24,3,9,77,35,42,75
Alloa,4784,2,18,9,9,77,49,28,63
Brechin,4784,3,17,8,11,50,43,7,59
Airdrieon,4784,4,16,6,14,55,56,-1,54
Peterhead,4784,5,14,8,14,49,54,-5,50
East Fife,4784,6,13,9,14,50,44,6,48
Albion,4784,7,13,8,15,50,50,0,47
Stranraer,4784,8,11,8,17,47,62,-15,41
Queen's Park,4784,9,12,5,19,34,53,-19,41
Stenhousem'r,4784,10,6,8,22,42,85,-43,26
Livingston,4785,1,21,5,10,75,50,25,68
Brechin,4785,2,18,8,10,49,43,6,62
Alloa,4785,3,17,5,14,71,53,18,56
Albion,4785,4,15,10,11,59,51,8,55
Airdrieon,4785,5,16,6,14,62,57,5,54
Stranraer,4785,6,14,7,15,61,56,5,49
Queen's Park,4785,7,13,5,18,42,56,-14,44
East Fife,4785,8,11,8,17,49,54,-5,41
Peterhead,4785,9,9,12,15,36,55,-19,39
Stenhousem'r,4785,10,9,8,19,50,79,-29,35
Alloa,4786,1,20,9,7,74,43,31,69
Airdrieon,4786,2,19,6,11,57,47,10,63
Livingston,4786,3,18,4,14,75,53,22,58
Albion,4786,4,16,6,14,53,52,1,54
Stranraer,4786,5,16,4,16,53,58,-5,52
Brechin,4786,6,14,8,14,44,50,-6,50
Queen's Park,4786,7,12,8,16,39,52,-13,44
East Fife,4786,8,11,10,15,52,48,4,43
Peterhead,4786,9,12,6,18,46,60,-14,42
Stenhousem'r,4786,10,6,11,19,43,73,-30,29
Alloa,4787,1,20,6,10,72,42,30,66
Brechin,4787,2,20,5,11,61,45,16,65
Livingston,4787,3,19,5,12,65,47,18,62
Airdrieon,4787,4,17,8,11,56,48,8,59
Albion,4787,5,14,11,11,51,45,6,53
Peterhead,4787,6,12,9,15,52,60,-8,45
Queen's Park,4787,7,12,9,15,35,48,-13,45
East Fife,4787,8,11,9,16,46,48,-2,42
Stranraer,4787,9,11,9,16,57,64,-7,42
Stenhousem'r,4787,10,5,7,24,41,89,-48,22
Livingston,4788,1,24,1,11,84,44,40,73
Airdrieon,4788,2,20,6,10,65,51,14,66
Alloa,4788,3,18,9,9,73,48,25,63
East Fife,4788,4,15,9,12,67,57,10,54
Brechin,4788,5,17,3,16,52,60,-8,54
Peterhead,4788,6,12,8,16,51,61,-10,44
Queen's Park,4788,7,11,8,17,38,52,-14,41
Stenhousem'r,4788,8,11,7,18,53,74,-21,40
Albion,4788,9,11,6,19,52,66,-14,39
Stranraer,4788,10,10,5,21,42,64,-22,35
Alloa,4789,1,19,6,11,69,47,22,63
Livingston,4789,2,20,2,14,71,50,21,62
Brechin,4789,3,17,7,12,49,47,2,58
Airdrieon,4789,4,16,7,13,53,51,2,55
Albion,4789,5,15,7,14,55,57,-2,52
Stranraer,4789,6,16,3,17,58,57,1,51
Queen's Park,4789,7,14,7,15,37,51,-14,49
Peterhead,4789,8,14,6,16,50,53,-3,48
East Fife,4789,9,14,5,17,53,46,7,47
Stenhousem'r,4789,10,7,6,23,51,87,-36,27
Livingston,4790,1,21,7,8,73,44,29,70
Brechin,4790,2,19,5,12,55,48,7,62
Alloa,4790,3,18,5,13,64,45,19,59
Airdrieon,4790,4,15,12,9,60,50,10,57
Albion,4790,5,14,9,13,53,48,5,51
Queen's Park,4790,6,13,9,14,36,44,-8,48
Stranraer,4790,7,12,7,17,51,56,-5,43
East Fife,4790,8,11,8,17,41,52,-11,41
Peterhead,4790,9,10,11,15,41,53,-12,41
Stenhousem'r,4790,10,7,7,22,47,81,-34,28
Livingston,4791,1,23,3,10,86,52,34,72
Alloa,4791,2,21,6,9,76,41,35,69
Brechin,4791,3,18,4,14,50,46,4,58
Airdrieon,4791,4,15,7,14,58,57,1,52
Peterhead,4791,5,15,4,17,49,49,0,49
Albion,4791,6,12,13,11,49,51,-2,49
Stranraer,4791,7,14,6,16,48,53,-5,48
East Fife,4791,8,12,10,14,44,48,-4,46
Queen's Park,4791,9,9,7,20,29,56,-27,34
Stenhousem'r,4791,10,7,8,21,40,76,-36,29
Livingston,4792,1,25,6,5,82,47,35,81
Brechin,4792,2,21,6,9,65,41,24,69
Airdrieon,4792,3,17,4,15,65,62,3,55
Alloa,4792,4,16,6,14,64,48,16,54
Stranraer,4792,5,16,5,15,56,56,0,53
Albion,4792,6,15,6,15,51,48,3,51
Queen's Park,4792,7,13,6,17,37,51,-14,45
Peterhead,4792,8,11,8,17,41,56,-15,41
East Fife,4792,9,10,7,19,50,60,-10,37
Stenhousem'r,4792,10,6,6,24,51,93,-42,24
Albion,4793,1,19,7,10,60,52,8,64
Queen's Park,4793,2,16,8,12,44,43,1,56
Alloa,4793,3,15,10,11,60,47,13,55
Livingston,4793,4,17,3,16,68,58,10,54
Peterhead,4793,5,14,10,12,49,47,2,52
Brechin,4793,6,14,9,13,48,46,2,51
Airdrieon,4793,7,15,6,15,55,54,1,51
Stranraer,4793,8,15,3,18,57,59,-2,48
East Fife,4793,9,9,12,15,50,53,-3,39
Stenhousem'r,4793,10,8,8,20,44,76,-32,32
Alloa,4794,1,21,8,7,81,42,39,71
Livingston,4794,2,19,5,12,74,53,21,62
Airdrieon,4794,3,17,7,12,61,53,8,58
Brechin,4794,4,16,6,14,51,56,-5,54
Albion,4794,5,15,7,14,55,47,8,52
Stranraer,4794,6,12,9,15,51,62,-11,45
Queen's Park,4794,7,13,6,17,41,58,-17,45
East Fife,4794,8,12,8,16,54,50,4,44
Peterhead,4794,9,12,8,16,50,66,-16,44
Stenhousem'r,4794,10,6,10,20,46,77,-31,28
Airdrieon,4795,1,21,5,10,75,53,22,68
Alloa,4795,2,19,8,9,71,48,23,65
Brechin,4795,3,18,6,12,53,45,8,60
Livingston,4795,4,18,5,13,83,54,29,59
Peterhead,4795,5,15,8,13,63,66,-3,53
East Fife,4795,6,11,14,11,45,38,7,47
Albion,4795,7,12,8,16,51,63,-12,44
Stranraer,4795,8,12,5,19,51,61,-10,41
Queen's Park,4795,9,8,9,19,25,52,-27,33
Stenhousem'r,4795,10,9,6,21,47,84,-37,33
Livingston,4796,1,26,3,7,87,48,39,81
Alloa,4796,2,19,7,10,72,44,28,64
Peterhead,4796,3,17,9,10,59,53,6,60
Airdrieon,4796,4,17,3,16,49,57,-8,54
Brechin,4796,5,16,5,15,46,48,-2,53
Albion,4796,6,13,10,13,61,54,7,49
East Fife,4796,7,11,10,15,53,58,-5,43
Stranraer,4796,8,13,4,19,44,55,-11,43
Queen's Park,4796,9,10,5,21,34,50,-16,35
Stenhousem'r,4796,10,6,8,22,41,79,-38,26
Livingston,4797,1,21,6,9,74,41,33,69
Alloa,4797,2,19,10,7,72,40,32,67
Queen's Park,4797,3,17,8,11,46,42,4,59
Airdrieon,4797,4,15,9,12,65,58,7,54
Brechin,4797,5,14,9,13,39,51,-12,51
East Fife,4797,6,14,7,15,50,44,6,49
Albion,4797,7,12,11,13,44,53,-9,47
Peterhead,4797,8,12,7,17,46,56,-10,43
Stranraer,4797,9,11,8,17,53,60,-7,41
Stenhousem'r,4797,10,4,7,25,42,86,-44,19
Livingston,4798,1,25,5,6,96,47,49,80
Alloa,4798,2,19,10,7,78,47,31,67
Airdrieon,4798,3,17,5,14,56,54,2,56
Brechin,4798,4,14,9,13,48,52,-4,51
East Fife,4798,5,11,14,11,46,43,3,47
Stranraer,4798,6,11,9,16,45,57,-12,42
Stenhousem'r,4798,7,11,9,16,43,64,-21,42
Queen's Park,4798,8,10,10,16,32,53,-21,40
Albion,4798,9,9,9,18,49,55,-6,36
Peterhead,4798,10,9,8,19,46,67,-21,35
Alloa,4799,1,19,8,9,75,37,38,65
Livingston,4799,2,19,5,12,82,50,32,62
Airdrieon,4799,3,18,4,14,61,59,2,58
East Fife,4799,4,15,8,13,51,46,5,53
Brechin,4799,5,13,9,14,49,55,-6,48
Stranraer,4799,6,14,5,17,53,59,-6,47
Albion,4799,7,12,9,15,46,51,-5,45
Peterhead,4799,8,12,9,15,48,61,-13,45
Queen's Park,4799,9,11,11,14,40,52,-12,44
Stenhousem'r,4799,10,9,8,19,47,82,-35,35
Livingston,4800,1,23,3,10,80,42,38,72
Alloa,4800,2,17,10,9,62,39,23,61
Airdrieon,4800,3,15,7,14,46,47,-1,52
East Fife,4800,4,13,12,11,52,42,10,51
Stranraer,4800,5,14,6,16,56,63,-7,48
Queen's Park,4800,6,13,9,14,38,53,-15,48
Brechin,4800,7,13,7,16,51,49,2,46
Albion,4800,8,12,10,14,54,58,-4,46
Peterhead,4800,9,11,7,18,41,55,-14,40
Stenhousem'r,4800,10,10,7,19,46,78,-32,37
Livingston,4801,1,22,6,8,75,39,36,72
Alloa,4801,2,20,6,10,73,48,25,66
Airdrieon,4801,3,20,6,10,65,48,17,66
Peterhead,4801,4,16,8,12,53,50,3,56
Stranraer,4801,5,14,5,17,51,58,-7,47
Albion,4801,6,10,10,16,46,54,-8,40
Brechin,4801,7,12,4,20,40,53,-13,40
Queen's Park,4801,8,11,7,18,33,58,-25,40
East Fife,4801,9,10,9,17,42,45,-3,39
Stenhousem'r,4801,10,9,11,16,49,74,-25,38
Livingston,4802,1,23,6,7,83,48,35,75
Airdrieon,4802,2,18,4,14,62,53,9,58
Alloa,4802,3,15,11,10,69,51,18,56
Albion,4802,4,15,9,12,53,47,6,54
East Fife,4802,5,14,9,13,51,46,5,51
Brechin,4802,6,14,6,16,54,54,0,48
Peterhead,4802,7,12,7,17,40,51,-11,43
Queen's Park,4802,8,12,6,18,46,66,-20,42
Stranraer,4802,9,9,11,16,45,59,-14,38
Stenhousem'r,4802,10,8,11,17,45,73,-28,35
Livingston,4803,1,23,5,8,88,52,36,74
Airdrieon,4803,2,18,8,10,76,51,25,62
Alloa,4803,3,17,8,11,63,48,15,59
Albion,4803,4,15,8,13,63,56,7,53
Brechin,4803,5,16,5,15,44,49,-5,53
Stranraer,4803,6,13,6,17,49,56,-7,45
Queen's Park,4803,7,12,8,16,37,57,-20,44
East Fife,4803,8,10,12,14,51,55,-4,42
Peterhead,4803,9,9,13,14,49,60,-11,40
Stenhousem'r,4803,10,6,9,21,45,81,-36,27
Livingston,4804,1,22,8,6,89,43,46,74
Airdrieon,4804,2,17,10,9,65,45,20,61
Brechin,4804,3,17,8,11,56,44,12,59
Alloa,4804,4,16,9,11,64,47,17,57
East Fife,4804,5,13,10,13,54,48,6,49
Queen's Park,4804,6,11,10,15,38,54,-16,43
Peterhead,4804,7,11,8,17,43,61,-18,41
Albion,4804,8,10,9,17,45,60,-15,39
Stranraer,4804,9,11,4,21,48,66,-18,37
Stenhousem'r,4804,10,9,10,17,44,78,-34,37
Alloa,4805,1,21,8,7,71,40,31,71
Brechin,4805,2,20,6,10,54,33,21,66
Livingston,4805,3,18,7,11,73,51,22,61
Peterhead,4805,4,17,7,12,54,43,11,58
Airdrieon,4805,5,15,9,12,59,51,8,54
Albion,4805,6,15,8,13,48,54,-6,53
Stranraer,4805,7,12,8,16,46,61,-15,44
Queen's Park,4805,8,8,10,18,36,60,-24,34
East Fife,4805,9,6,12,18,39,53,-14,30
Stenhousem'r,4805,10,7,7,22,41,75,-34,28
Livingston,4806,1,26,1,9,87,40,47,79
Alloa,4806,2,17,11,8,70,43,27,62
Airdrieon,4806,3,16,9,11,67,62,5,57
Albion,4806,4,16,7,13,49,55,-6,55
East Fife,4806,5,14,11,11,52,39,13,53
Brechin,4806,6,14,7,15,52,52,0,49
Peterhead,4806,7,11,11,14,52,60,-8,44
Stranraer,4806,8,13,4,19,58,72,-14,43
Queen's Park,4806,9,11,9,16,33,46,-13,42
Stenhousem'r,4806,10,4,6,26,45,96,-51,18
Livingston,4807,1,19,7,10,71,43,28,64
Brechin,4807,2,19,7,10,54,42,12,64
Alloa,4807,3,19,5,12,74,47,27,62
Albion,4807,4,16,8,12,62,50,12,56
Peterhead,4807,5,16,7,13,58,56,2,55
Airdrieon,4807,6,16,6,14,56,55,1,54
Queen's Park,4807,7,13,8,15,35,48,-13,47
East Fife,4807,8,12,8,16,52,54,-2,44
Stranraer,4807,9,9,11,16,44,57,-13,38
Stenhousem'r,4807,10,5,5,26,39,93,-54,20
Livingston,4808,1,19,7,10,77,48,29,64
Alloa,4808,2,19,7,10,74,48,26,64
Airdrieon,4808,3,18,6,12,56,44,12,60
Brechin,4808,4,15,8,13,47,49,-2,53
Peterhead,4808,5,15,7,14,49,44,5,52
Albion,4808,6,12,11,13,48,46,2,47
Stranraer,4808,7,13,7,16,47,58,-11,46
Queen's Park,4808,8,12,9,15,37,50,-13,45
East Fife,4808,9,11,8,17,46,49,-3,41
Stenhousem'r,4808,10,7,8,21,39,84,-45,29
Livingston,4809,1,22,7,7,83,45,38,73
Alloa,4809,2,21,7,8,75,40,35,70
Brechin,4809,3,17,8,11,50,43,7,59
East Fife,4809,4,16,9,11,54,43,11,57
Airdrieon,4809,5,16,8,12,66,57,9,56
Peterhead,4809,6,14,5,17,48,55,-7,47
Queen's Park,4809,7,12,7,17,47,63,-16,43
Albion,4809,8,10,8,18,42,65,-23,38
Stranraer,4809,9,8,8,20,42,60,-18,32
Stenhousem'r,4809,10,7,7,22,50,86,-36,28
Alloa,4810,1,23,4,9,84,40,44,73
Livingston,4810,2,20,3,13,66,46,20,63
Airdrieon,4810,3,17,9,10,64,45,19,60
Brechin,4810,4,18,4,14,54,51,3,58
Albion,4810,5,14,8,14,50,50,0,50
East Fife,4810,6,14,6,16,50,50,0,48
Stranraer,4810,7,14,4,18,56,62,-6,46
Peterhead,4810,8,11,7,18,42,60,-18,40
Queen's Park,4810,9,11,6,19,28,56,-28,39
Stenhousem'r,4810,10,9,7,20,45,79,-34,34
Alloa,4811,1,21,6,9,73,46,27,69
Livingston,4811,2,21,5,10,71,43,28,68
Airdrieon,4811,3,18,8,10,57,52,5,62
East Fife,4811,4,13,12,11,53,41,12,51
Stranraer,4811,5,14,8,14,53,52,1,50
Brechin,4811,6,15,5,16,44,45,-1,50
Peterhead,4811,7,13,8,15,46,51,-5,47
Queen's Park,4811,8,11,12,13,47,52,-5,45
Albion,4811,9,8,11,17,36,55,-19,35
Stenhousem'r,4811,10,6,5,25,41,84,-43,23
Livingston,4812,1,23,5,8,71,42,29,74
Airdrieon,4812,2,18,10,8,62,48,14,64
Albion,4812,3,17,10,9,56,43,13,61
Alloa,4812,4,16,10,10,65,41,24,58
Brechin,4812,5,16,6,14,53,49,4,54
Peterhead,4812,6,11,13,12,48,55,-7,46
East Fife,4812,7,10,11,15,48,48,0,41
Queen's Park,4812,8,10,7,19,30,49,-19,37
Stranraer,4812,9,9,6,21,45,67,-22,33
Stenhousem'r,4812,10,5,12,19,46,82,-36,27
Airdrieon,4813,1,20,8,8,67,48,19,68
Brechin,4813,2,20,4,12,60,45,15,64
Alloa,4813,3,19,5,12,73,47,26,62
East Fife,4813,4,17,6,13,60,43,17,57
Livingston,4813,5,16,4,16,71,61,10,52
Queen's Park,4813,6,14,7,15,43,52,-9,49
Albion,4813,7,11,12,13,52,57,-5,45
Peterhead,4813,8,10,12,14,44,55,-11,42
Stranraer,4813,9,10,6,20,44,66,-22,36
Stenhousem'r,4813,10,7,8,21,42,82,-40,29
Livingston,4814,1,25,4,7,90,57,33,79
Airdrieon,4814,2,18,7,11,61,51,10,61
Alloa,4814,3,16,7,13,68,47,21,55
Brechin,4814,4,15,7,14,52,50,2,52
Peterhead,4814,5,13,8,15,55,56,-1,47
Albion,4814,6,12,11,13,46,51,-5,47
Stranraer,4814,7,14,5,17,49,58,-9,47
East Fife,4814,8,12,10,14,57,55,2,46
Queen's Park,4814,9,12,10,14,50,59,-9,46
Stenhousem'r,4814,10,5,7,24,35,79,-44,22
Alloa,4815,1,20,7,9,75,48,27,67
Livingston,4815,2,20,5,11,73,58,15,65
Brechin,4815,3,18,4,14,58,47,11,58
Queen's Park,4815,4,16,8,12,43,44,-1,56
Airdrieon,4815,5,15,7,14,65,65,0,52
East Fife,4815,6,13,8,15,60,48,12,47
Stranraer,4815,7,13,6,17,56,62,-6,45
Albion,4815,8,12,7,17,47,54,-7,43
Peterhead,4815,9,10,10,16,38,51,-13,40
Stenhousem'r,4815,10,9,6,21,45,83,-38,33
Alloa,4816,1,20,7,9,73,45,28,67
Brechin,4816,2,19,3,14,55,52,3,60
Livingston,4816,3,16,8,12,63,47,16,56
Airdrieon,4816,4,16,6,14,53,53,0,54
Albion,4816,5,12,13,11,55,50,5,49
Stranraer,4816,6,14,6,16,53,56,-3,48
Peterhead,4816,7,13,7,16,41,50,-9,46
East Fife,4816,8,11,11,14,48,50,-2,44
Queen's Park,4816,9,10,11,15,40,50,-10,41
Stenhousem'r,4816,10,9,8,19,45,73,-28,35
Livingston,4817,1,18,9,9,72,44,28,63
Airdrieon,4817,2,19,6,11,64,52,12,63
Alloa,4817,3,19,5,12,68,42,26,62
Brechin,4817,4,17,5,14,53,51,2,56
Queen's Park,4817,5,16,4,16,43,46,-3,52
Peterhead,4817,6,13,10,13,48,53,-5,49
Albion,4817,7,12,8,16,60,63,-3,44
Stranraer,4817,8,13,5,18,52,66,-14,44
East Fife,4817,9,11,9,16,56,62,-6,42
Stenhousem'r,4817,10,6,11,19,43,80,-37,29
Alloa,4818,1,24,6,6,80,37,43,78
Livingston,4818,2,20,4,12,68,46,22,64
Airdrieon,4818,3,17,5,14,62,61,1,56
Brechin,4818,4,16,8,12,54,56,-2,56
Albion,4818,5,15,9,12,63,50,13,54
Stranraer,4818,6,15,7,14,66,64,2,52
Peterhead,4818,7,14,5,17,54,57,-3,47
East Fife,4818,8,12,5,19,46,57,-11,41
Queen's Park,4818,9,11,6,19,45,63,-18,39
Stenhousem'r,4818,10,6,5,25,48,95,-47,23
Livingston,4819,1,25,3,8,82,38,44,78
Alloa,4819,2,21,7,8,72,38,34,70
Brechin,4819,3,18,5,13,57,58,-1,59
Stranraer,4819,4,14,6,16,56,61,-5,48
Airdrieon,4819,5,14,5,17,58,64,-6,47
Albion,4819,6,13,7,16,57,62,-5,46
Queen's Park,4819,7,13,6,17,44,56,-12,45
East Fife,4819,8,12,6,18,47,58,-11,42
Peterhead,4819,9,10,10,16,42,49,-7,40
Stenhousem'r,4819,10,9,7,20,51,82,-31,34
Livingston,4820,1,22,5,9,85,51,34,71
Airdrieon,4820,2,18,8,10,68,47,21,62
Alloa,4820,3,17,9,10,64,40,24,60
Brechin,4820,4,15,6,15,44,54,-10,51
Albion,4820,5,15,5,16,55,55,0,50
Queen's Park,4820,6,14,8,14,46,55,-9,50
Peterhead,4820,7,13,8,15,50,55,-5,47
Stranraer,4820,8,13,6,17,46,59,-13,45
East Fife,4820,9,10,10,16,43,47,-4,40
Stenhousem'r,4820,10,7,7,22,47,85,-38,28
Livingston,4821,1,20,8,8,73,39,34,68
Alloa,4821,2,20,7,9,71,45,26,67
Albion,4821,3,17,6,13,61,49,12,57
Airdrieon,4821,4,16,9,11,56,52,4,57
Queen's Park,4821,5,15,6,15,44,51,-7,51
Peterhead,4821,6,12,12,12,51,48,3,48
Brechin,4821,7,14,6,16,50,54,-4,48
East Fife,4821,8,10,11,15,41,47,-6,41
Stranraer,4821,9,11,4,21,41,65,-24,37
Stenhousem'r,4821,10,8,5,23,38,76,-38,29
Alloa,4822,1,19,8,9,72,43,29,65
Livingston,4822,2,20,3,13,78,51,27,63
Albion,4822,3,16,5,15,54,48,6,53
Airdrieon,4822,4,15,8,13,53,52,1,53
Stranraer,4822,5,15,6,15,57,58,-1,51
Queen's Park,4822,6,16,3,17,43,49,-6,51
Peterhead,4822,7,14,8,14,45,55,-10,50
Brechin,4822,8,14,5,17,46,60,-14,47
East Fife,4822,9,12,9,15,47,51,-4,45
Stenhousem'r,4822,10,8,7,21,39,67,-28,31
Alloa,4823,1,20,10,6,80,52,28,70
Livingston,4823,2,19,6,11,78,57,21,63
Albion,4823,3,15,10,11,49,49,0,55
Stranraer,4823,4,16,6,14,62,53,9,54
Brechin,4823,5,16,6,14,53,48,5,54
Airdrieon,4823,6,15,8,13,52,57,-5,53
East Fife,4823,7,12,10,14,54,45,9,46
Queen's Park,4823,8,11,6,19,30,49,-19,39
Peterhead,4823,9,9,7,20,47,64,-17,34
Stenhousem'r,4823,10,9,7,20,48,79,-31,34
Alloa,4824,1,21,7,8,74,38,36,70
Livingston,4824,2,19,9,8,71,45,26,66
Airdrieon,4824,3,16,9,11,63,49,14,57
Albion,4824,4,13,13,10,47,46,1,52
East Fife,4824,5,13,7,16,50,49,1,46
Brechin,4824,6,13,7,16,41,54,-13,46
Peterhead,4824,7,11,12,13,52,53,-1,45
Stranraer,4824,8,12,9,15,42,52,-10,45
Queen's Park,4824,9,10,9,17,42,50,-8,39
Stenhousem'r,4824,10,6,10,20,42,88,-46,28
Livingston,4825,1,20,4,12,60,42,18,64
Alloa,4825,2,18,8,10,59,36,23,62
East Fife,4825,3,18,7,11,60,38,22,61
Brechin,4825,4,18,2,16,51,46,5,56
Albion,4825,5,15,9,12,57,47,10,54
Airdrieon,4825,6,13,8,15,62,67,-5,47
Peterhead,4825,7,12,11,13,44,50,-6,47
Queen's Park,4825,8,12,9,15,31,46,-15,45
Stranraer,4825,9,12,4,20,43,62,-19,40
Stenhousem'r,4825,10,7,8,21,45,78,-33,29
Alloa,4826,1,19,9,8,66,46,20,66
Livingston,4826,2,19,3,14,78,47,31,60
Brechin,4826,3,18,5,13,47,49,-2,59
Peterhead,4826,4,14,9,13,47,46,1,51
Airdrieon,4826,5,14,8,14,52,57,-5,50
Albion,4826,6,13,9,14,51,55,-4,48
Stranraer,4826,7,14,5,17,53,58,-5,47
East Fife,4826,8,12,10,14,52,50,2,46
Queen's Park,4826,9,11,7,18,32,48,-16,40
Stenhousem'r,4826,10,9,9,18,48,70,-22,36
Alloa,4827,1,21,6,9,74,41,33,69
Livingston,4827,2,18,5,13,71,51,20,59
Peterhead,4827,3,16,8,12,55,49,6,56
Brechin,4827,4,16,7,13,47,45,2,55
Stranraer,4827,5,17,3,16,60,57,3,54
Airdrieon,4827,6,15,5,16,56,64,-8,50
East Fife,4827,7,11,9,16,48,51,-3,42
Albion,4827,8,10,12,14,49,60,-11,42
Queen's Park,4827,9,10,10,16,31,48,-17,40
Stenhousem'r,4827,10,8,11,17,51,76,-25,35
Livingston,4828,1,21,2,13,68,44,24,65
Brechin,4828,2,19,5,12,50,41,9,62
Airdrieon,4828,3,17,8,11,57,54,3,59
Alloa,4828,4,17,4,15,75,48,27,55
Peterhead,4828,5,14,7,15,49,52,-3,49
Stenhousem'r,4828,6,14,4,18,48,73,-25,46
East Fife,4828,7,12,9,15,52,57,-5,45
Albion,4828,8,12,8,16,53,48,5,44
Queen's Park,4828,9,13,5,18,33,51,-18,44
Stranraer,4828,10,12,6,18,52,69,-17,42
Livingston,4829,1,23,5,8,77,44,33,74
Airdrieon,4829,2,19,5,12,59,50,9,62
Alloa,4829,3,17,8,11,70,51,19,59
Peterhead,4829,4,15,8,13,60,53,7,53
Queen's Park,4829,5,16,5,15,50,61,-11,53
Brechin,4829,6,15,6,15,49,51,-2,51
Albion,4829,7,11,10,15,49,53,-4,43
Stranraer,4829,8,12,6,18,40,57,-17,42
East Fife,4829,9,8,11,17,40,51,-11,35
Stenhousem'r,4829,10,8,8,20,48,71,-23,32
Livingston,4830,1,20,6,10,81,50,31,66
Airdrieon,4830,2,19,6,11,65,55,10,63
Alloa,4830,3,18,8,10,69,47,22,62
Brechin,4830,4,15,9,12,46,44,2,54
Peterhead,4830,5,15,9,12,54,56,-2,54
Albion,4830,6,13,10,13,61,58,3,49
Queen's Park,4830,7,13,7,16,45,59,-14,46
Stranraer,4830,8,12,7,17,60,63,-3,43
East Fife,4830,9,10,9,17,47,52,-5,39
Stenhousem'r,4830,10,6,7,23,42,86,-44,25
Alloa,4831,1,24,6,6,76,33,43,78
Livingston,4831,2,23,1,12,80,51,29,70
Brechin,4831,3,17,7,12,54,44,10,58
Airdrieon,4831,4,14,8,14,55,58,-3,50
Albion,4831,5,13,8,15,56,54,2,47
East Fife,4831,6,13,7,16,50,49,1,46
Queen's Park,4831,7,11,9,16,38,57,-19,42
Peterhead,4831,8,10,9,17,36,53,-17,39
Stenhousem'r,4831,9,10,9,17,42,69,-27,39
Stranraer,4831,10,9,8,19,45,64,-19,35
Livingston,4832,1,22,4,10,78,47,31,70
Alloa,4832,2,20,6,10,64,45,19,66
Airdrieon,4832,3,17,10,9,69,57,12,61
Brechin,4832,4,15,8,13,47,46,1,53
Albion,4832,5,15,7,14,62,48,14,52
East Fife,4832,6,13,11,12,56,47,9,50
Stranraer,4832,7,14,4,18,57,61,-4,46
Queen's Park,4832,8,11,7,18,35,53,-18,40
Peterhead,4832,9,11,5,20,44,69,-25,38
Stenhousem'r,4832,10,7,8,21,45,84,-39,29
Livingston,4833,1,20,8,8,78,45,33,68
Alloa,4833,2,19,7,10,64,47,17,64
Airdrieon,4833,3,17,8,11,64,53,11,59
Brechin,4833,4,17,6,13,60,55,5,57
Peterhead,4833,5,15,9,12,53,49,4,54
Queen's Park,4833,6,12,9,15,39,48,-9,45
Albion,4833,7,10,11,15,50,52,-2,41
Stranraer,4833,8,11,8,17,44,55,-11,41
East Fife,4833,9,8,15,13,46,47,-1,39
Stenhousem'r,4833,10,7,7,22,50,97,-47,28
Alloa,4834,1,21,9,6,78,36,42,72
Livingston,4834,2,19,5,12,75,52,23,62
Brechin,4834,3,17,7,12,49,44,5,58
Airdrieon,4834,4,15,11,10,64,54,10,56
East Fife,4834,5,13,11,12,53,47,6,50
Peterhead,4834,6,13,9,14,53,57,-4,48
Albion,4834,7,12,10,14,56,58,-2,46
Stranraer,4834,8,12,5,19,43,58,-15,41
Queen's Park,4834,9,9,8,19,34,64,-30,35
Stenhousem'r,4834,10,8,7,21,46,81,-35,31
Livingston,4835,1,21,6,9,78,46,32,69
Alloa,4835,2,19,8,9,74,45,29,65
Brechin,4835,3,19,5,12,58,47,11,62
Albion,4835,4,16,5,15,52,47,5,53
Queen's Park,4835,5,15,4,17,35,52,-17,49
Airdrieon,4835,6,13,9,14,50,64,-14,48
Peterhead,4835,7,12,10,14,46,48,-2,46
Stranraer,4835,8,12,7,17,57,67,-10,43
East Fife,4835,9,11,8,17,42,47,-5,41
Stenhousem'r,4835,10,6,10,20,38,67,-29,28
Alloa,4836,1,17,8,11,70,51,19,59
Airdrieon,4836,2,17,6,13,60,57,3,57
East Fife,4836,3,16,8,12,54,47,7,56
Peterhead,4836,4,14,10,12,46,47,-1,52
Livingston,4836,5,15,6,15,65,53,12,51
Albion,4836,6,15,6,15,49,50,-1,51
Stranraer,4836,7,14,7,15,54,52,2,49
Queen's Park,4836,8,14,7,15,37,48,-11,49
Brechin,4836,9,14,4,18,47,47,0,46
Stenhousem'r,4836,10,8,10,18,46,76,-30,34
Airdrieon,4837,1,20,5,11,65,62,3,65
Alloa,4837,2,19,6,11,74,43,31,63
Brechin,4837,3,19,6,11,57,46,11,63
Livingston,4837,4,19,4,13,71,54,17,61
Peterhead,4837,5,15,7,14,49,46,3,52
Albion,4837,6,14,9,13,61,62,-1,51
East Fife,4837,7,13,9,14,54,43,11,48
Stranraer,4837,8,13,2,21,52,61,-9,41
Queen's Park,4837,9,12,5,19,39,61,-22,41
Stenhousem'r,4837,10,7,5,24,42,86,-44,26
Brechin,4838,1,21,4,11,51,36,15,67
Alloa,4838,2,19,8,9,69,48,21,65
Livingston,4838,3,20,5,11,68,47,21,65
Airdrieon,4838,4,16,11,9,54,39,15,59
Albion,4838,5,14,12,10,56,51,5,54
Queen's Park,4838,6,11,9,16,37,47,-10,42
Stranraer,4838,7,11,8,17,41,61,-20,41
Peterhead,4838,8,9,11,16,47,57,-10,38
Stenhousem'r,4838,9,9,6,21,49,79,-30,33
East Fife,4838,10,6,14,16,39,46,-7,32
Livingston,4839,1,22,6,8,76,43,33,72
Brechin,4839,2,18,6,12,52,41,11,60
Airdrieon,4839,3,16,7,13,54,53,1,55
Alloa,4839,4,14,11,11,62,49,13,53
Albion,4839,5,14,9,13,51,52,-1,51
Peterhead,4839,6,14,7,15,45,48,-3,49
Stranraer,4839,7,12,11,13,43,45,-2,47
East Fife,4839,8,13,7,16,51,49,2,46
Queen's Park,4839,9,11,7,18,39,55,-16,40
Stenhousem'r,4839,10,7,7,22,38,76,-38,28
Livingston,4840,1,21,7,8,87,49,38,70
Alloa,4840,2,20,5,11,63,44,19,65
Airdrieon,4840,3,20,5,11,60,49,11,65
Peterhead,4840,4,15,8,13,47,47,0,53
Brechin,4840,5,12,12,12,43,45,-2,48
Stranraer,4840,6,13,6,17,48,51,-3,45
Albion,4840,7,10,12,14,46,55,-9,42
Queen's Park,4840,8,12,5,19,29,51,-22,41
Stenhousem'r,4840,9,9,9,18,51,79,-28,36
East Fife,4840,10,8,11,17,45,49,-4,35
Alloa,4841,1,20,11,5,71,39,32,71
Livingston,4841,2,17,10,9,62,46,16,61
Brechin,4841,3,17,7,12,51,43,8,58
Airdrieon,4841,4,15,6,15,61,54,7,51
Albion,4841,5,13,10,13,49,48,1,49
Stranraer,4841,6,14,6,16,54,53,1,48
East Fife,4841,7,12,10,14,50,43,7,46
Peterhead,4841,8,13,7,16,44,57,-13,46
Queen's Park,4841,9,11,10,15,32,44,-12,43
Stenhousem'r,4841,10,5,9,22,44,91,-47,24
Livingston,4842,1,20,6,10,78,52,26,66
Airdrieon,4842,2,18,7,11,63,52,11,61
Brechin,4842,3,19,4,13,50,47,3,61
Queen's Park,4842,4,18,5,13,41,38,3,59
Alloa,4842,5,17,7,12,68,45,23,58
Peterhead,4842,6,16,5,15,50,50,0,53
Stranraer,4842,7,14,4,18,51,55,-4,46
East Fife,4842,8,11,9,16,47,53,-6,42
Albion,4842,9,11,8,17,43,50,-7,41
Stenhousem'r,4842,10,5,7,24,43,92,-49,22
Livingston,4843,1,23,4,9,88,47,41,73
Airdrieon,4843,2,20,6,10,60,45,15,66
Peterhead,4843,3,19,6,11,63,49,14,63
Brechin,4843,4,16,10,10,60,56,4,58
Alloa,4843,5,13,10,13,60,47,13,49
Albion,4843,6,13,9,14,50,51,-1,48
Queen's Park,4843,7,12,8,16,38,55,-17,44
Stranraer,4843,8,11,7,18,46,59,-13,40
East Fife,4843,9,9,8,19,43,62,-19,35
Stenhousem'r,4843,10,5,10,21,40,77,-37,25
Alloa,4844,1,20,8,8,78,44,34,68
Livingston,4844,2,19,7,10,77,53,24,64
Stranraer,4844,3,18,7,11,65,45,20,61
Airdrieon,4844,4,13,13,10,65,61,4,52
Brechin,4844,5,15,5,16,53,58,-5,50
Peterhead,4844,6,13,9,14,49,54,-5,48
Albion,4844,7,13,8,15,60,62,-2,47
Queen's Park,4844,8,11,10,15,39,54,-15,43
East Fife,4844,9,10,9,17,41,50,-9,39
Stenhousem'r,4844,10,6,8,22,40,86,-46,26
Alloa,4845,1,21,5,10,74,48,26,68
Livingston,4845,2,20,5,11,68,49,19,65
Airdrieon,4845,3,18,6,12,55,49,6,60
Stranraer,4845,4,16,6,14,56,55,1,54
Brechin,4845,5,16,5,15,50,40,10,53
East Fife,4845,6,13,9,14,54,46,8,48
Peterhead,4845,7,13,8,15,50,50,0,47
Queen's Park,4845,8,12,8,16,39,52,-13,44
Albion,4845,9,13,4,19,47,61,-14,43
Stenhousem'r,4845,10,8,4,24,46,89,-43,28
Alloa,4846,1,23,5,8,74,47,27,74
Livingston,4846,2,21,4,11,70,48,22,67
Brechin,4846,3,18,8,10,50,40,10,62
Airdrieon,4846,4,18,5,13,54,47,7,59
Albion,4846,5,14,8,14,51,51,0,50
Peterhead,4846,5,14,8,14,51,51,0,50
Queen's Park,4846,7,13,6,17,40,52,-12,45
East Fife,4846,8,13,5,18,42,43,-1,44
Stranraer,4846,9,10,4,22,43,58,-15,34
Stenhousem'r,4846,10,6,7,23,45,83,-38,25
Livingston,4847,1,24,4,8,74,39,35,76
Alloa,4847,2,15,12,9,59,48,11,57
Peterhead,4847,3,15,8,13,48,49,-1,53
Brechin,4847,4,16,4,16,54,49,5,52
Albion,4847,5,13,10,13,46,48,-2,49
East Fife,4847,6,13,9,14,49,46,3,48
Queen's Park,4847,7,13,8,15,41,47,-6,47
Airdrieon,4847,8,14,5,17,56,67,-11,47
Stranraer,4847,9,12,8,16,46,50,-4,44
Stenhousem'r,4847,10,7,8,21,45,75,-30,29
Alloa,4848,1,21,8,7,71,43,28,71
Livingston,4848,2,18,9,9,78,49,29,63
Airdrieon,4848,3,17,8,11,67,57,10,59
Albion,4848,4,14,11,11,55,45,10,53
Brechin,4848,5,15,6,15,54,51,3,51
Peterhead,4848,6,14,8,14,60,53,7,50
Queen's Park,4848,7,12,8,16,40,60,-20,44
Stranraer,4848,8,11,10,15,51,60,-9,43
East Fife,4848,9,6,15,15,43,55,-12,33
Stenhousem'r,4848,10,6,9,21,46,92,-46,27
Livingston,4849,1,22,2,12,84,54,30,68
Alloa,4849,2,20,6,10,81,50,31,66
Albion,4849,3,19,8,9,55,39,16,65
Brechin,4849,4,19,4,13,61,45,16,61
Peterhead,4849,5,15,10,11,53,52,1,55
Airdrieon,4849,6,16,7,13,54,56,-2,55
Stranraer,4849,7,14,3,19,49,67,-18,45
Queen's Park,4849,8,12,6,18,35,54,-19,42
East Fife,4849,9,6,9,21,38,55,-17,27
Stenhousem'r,4849,10,5,9,22,38,76,-38,24
Livingston,4850,1,19,8,9,85,57,28,65
Alloa,4850,2,19,7,10,71,45,26,64
Brechin,4850,3,16,9,11,49,45,4,57
Airdrieon,4850,4,17,6,13,58,56,2,57
Peterhead,4850,5,15,7,14,59,47,12,52
Albion,4850,6,15,6,15,64,55,9,51
East Fife,4850,7,15,4,17,50,52,-2,49
Stranraer,4850,8,12,5,19,46,58,-12,41
Queen's Park,4850,9,10,7,19,33,65,-32,37
Stenhousem'r,4850,10,9,7,20,47,82,-35,34
Livingston,4851,1,21,6,9,79,48,31,69
Brechin,4851,2,17,5,14,56,54,2,56
Albion,4851,3,16,6,14,54,50,4,54
Alloa,4851,4,14,11,11,67,50,17,53
Airdrieon,4851,5,15,5,16,56,57,-1,50
Stranraer,4851,6,14,6,16,49,56,-7,48
Queen's Park,4851,7,12,9,15,41,55,-14,45
East Fife,4851,8,11,10,15,46,46,0,43
Stenhousem'r,4851,9,11,10,15,47,69,-22,43
Peterhead,4851,10,10,10,16,51,61,-10,40
Livingston,4852,1,23,4,9,73,45,28,73
Alloa,4852,2,20,5,11,79,50,29,65
Airdrieon,4852,3,18,6,12,65,50,15,60
Albion,4852,4,17,9,10,54,45,9,60
Brechin,4852,5,15,5,16,42,52,-10,50
Stranraer,4852,6,13,9,14,51,54,-3,48
East Fife,4852,7,11,10,15,46,44,2,43
Queen's Park,4852,8,11,9,16,34,56,-22,42
Peterhead,4852,9,7,10,19,47,58,-11,31
Stenhousem'r,4852,10,7,9,20,39,76,-37,30
Livingston,4853,1,23,4,9,81,51,30,73
Alloa,4853,2,19,9,8,75,43,32,66
Airdrieon,4853,3,18,8,10,60,49,11,62
Stranraer,4853,4,14,9,13,62,59,3,51
Peterhead,4853,5,14,8,14,45,51,-6,50
East Fife,4853,6,13,10,13,54,41,13,49
Albion,4853,7,12,11,13,49,52,-3,47
Brechin,4853,8,10,7,19,42,64,-22,37
Queen's Park,4853,9,9,9,18,32,50,-18,36
Stenhousem'r,4853,10,7,7,22,42,82,-40,28
Alloa,4854,1,19,9,8,66,42,24,66
Livingston,4854,2,19,6,11,78,51,27,63
Airdrieon,4854,3,17,8,11,64,54,10,59
Brechin,4854,4,14,8,14,41,40,1,50
Queen's Park,4854,5,14,8,14,44,49,-5,50
Stranraer,4854,6,15,4,17,56,72,-16,49
East Fife,4854,7,14,6,16,54,51,3,48
Peterhead,4854,8,13,9,14,50,54,-4,48
Albion,4854,9,10,7,19,48,62,-14,37
Stenhousem'r,4854,10,9,7,20,53,79,-26,34
Alloa,4855,1,21,7,8,80,43,37,70
Livingston,4855,2,20,3,13,74,51,23,63
Airdrieon,4855,3,18,5,13,56,49,7,59
Albion,4855,4,16,6,14,55,46,9,54
East Fife,4855,5,16,5,15,50,42,8,53
Brechin,4855,6,15,7,14,46,58,-12,52
Stranraer,4855,7,14,5,17,54,54,0,47
Stenhousem'r,4855,8,12,8,16,54,67,-13,44
Peterhead,4855,9,11,7,18,40,62,-22,40
Queen's Park,4855,10,7,7,22,23,60,-37,28
Alloa,4856,1,19,7,10,75,47,28,64
Brechin,4856,2,19,6,11,49,40,9,63
Livingston,4856,3,19,3,14,71,50,21,60
Airdrieon,4856,4,18,5,13,62,54,8,59
Albion,4856,5,15,8,13,50,43,7,53
Peterhead,4856,6,15,6,15,48,48,0,51
Queen's Park,4856,7,13,8,15,44,54,-10,47
East Fife,4856,8,12,7,17,46,45,1,43
Stranraer,4856,9,11,5,20,41,63,-22,38
Stenhousem'r,4856,10,8,7,21,39,81,-42,31
Alloa,4857,1,22,5,9,85,50,35,71
Airdrieon,4857,2,19,4,13,69,54,15,61
Brechin,4857,3,19,4,13,54,55,-1,61
Livingston,4857,4,19,3,14,68,50,18,60
Stranraer,4857,5,16,3,17,57,65,-8,51
Albion,4857,6,15,4,17,60,63,-3,49
Peterhead,4857,7,14,6,16,46,53,-7,48
Queen's Park,4857,8,11,10,15,38,52,-14,43
East Fife,4857,9,11,7,18,50,52,-2,40
Stenhousem'r,4857,10,8,6,22,50,83,-33,30
Livingston,4858,1,24,3,9,85,51,34,75
Airdrieon,4858,2,21,5,10,69,51,18,68
Brechin,4858,3,20,4,12,62,47,15,64
Alloa,4858,4,16,7,13,61,52,9,55
East Fife,4858,5,15,6,15,57,51,6,51
Peterhead,4858,6,14,8,14,50,57,-7,50
Albion,4858,7,14,7,15,48,51,-3,49
Queen's Park,4858,8,12,6,18,41,56,-15,42
Stranraer,4858,9,9,3,24,49,71,-22,30
Stenhousem'r,4858,10,7,7,22,48,83,-35,28
Alloa,4859,1,20,8,8,72,52,20,68
Airdrieon,4859,2,18,3,15,53,51,2,57
Livingston,4859,3,18,2,16,76,56,20,56
Albion,4859,4,15,10,11,63,51,12,55
Peterhead,4859,5,14,7,15,56,53,3,49
East Fife,4859,6,13,10,13,47,46,1,49
Queen's Park,4859,7,13,7,16,40,48,-8,46
Brechin,4859,8,12,10,14,47,58,-11,46
Stranraer,4859,9,11,9,16,44,55,-11,42
Stenhousem'r,4859,10,9,8,19,45,73,-28,35
Brechin,4860,1,21,6,9,54,37,17,69
Livingston,4860,2,20,3,13,80,61,19,63
Alloa,4860,3,16,7,13,62,52,10,55
Albion,4860,4,15,7,14,56,56,0,52
Airdrieon,4860,5,15,6,15,60,59,1,51
Peterhead,4860,6,14,7,15,61,62,-1,49
Queen's Park,4860,7,15,4,17,43,44,-1,49
Stranraer,4860,8,14,4,18,54,65,-11,46
East Fife,4860,9,13,6,17,60,57,3,45
Stenhousem'r,4860,10,9,6,21,46,83,-37,33
Livingston,4861,1,20,6,10,67,42,25,66
Alloa,4861,2,16,9,11,61,49,12,57
Airdrieon,4861,3,15,11,10,64,47,17,56
Stranraer,4861,4,15,6,15,51,52,-1,51
Peterhead,4861,5,13,11,12,60,59,1,50
Brechin,4861,6,14,8,14,47,49,-2,50
Queen's Park,4861,7,13,9,14,34,45,-11,48
Albion,4861,8,11,10,15,53,61,-8,43
East Fife,4861,9,11,9,16,52,55,-3,42
Stenhousem'r,4861,10,9,7,20,48,78,-30,34
Livingston,4862,1,24,4,8,82,51,31,76
Alloa,4862,2,19,8,9,75,46,29,65
Airdrieon,4862,3,19,4,13,79,70,9,61
Albion,4862,4,16,9,11,59,44,15,57
Peterhead,4862,5,17,5,14,48,49,-1,56
Brechin,4862,6,17,4,15,54,52,2,55
Queen's Park,4862,7,11,8,17,38,56,-18,41
East Fife,4862,8,11,6,19,55,66,-11,39
Stranraer,4862,9,8,7,21,44,69,-25,31
Stenhousem'r,4862,10,6,9,21,44,75,-31,27
Livingston,4863,1,22,6,8,84,50,34,72
Brechin,4863,2,19,6,11,62,42,20,63
Airdrieon,4863,3,17,7,12,70,63,7,58
Queen's Park,4863,4,17,7,12,49,48,1,58
Alloa,4863,5,14,9,13,59,48,11,51
Albion,4863,6,13,9,14,56,56,0,48
Peterhead,4863,7,12,9,15,47,58,-11,45
East Fife,4863,8,11,10,15,42,44,-2,43
Stranraer,4863,9,11,4,21,48,66,-18,37
Stenhousem'r,4863,10,7,7,22,44,86,-42,28
Livingston,4864,1,20,6,10,75,55,20,66
Alloa,4864,2,18,11,7,74,42,32,65
Airdrieon,4864,3,16,7,13,59,58,1,55
Brechin,4864,4,13,11,12,51,51,0,50
Peterhead,4864,5,13,10,13,58,53,5,49
Stranraer,4864,6,13,8,15,56,61,-5,47
Albion,4864,7,13,6,17,48,52,-4,45
Queen's Park,4864,8,10,13,13,34,45,-11,43
Stenhousem'r,4864,9,9,10,17,49,78,-29,37
East Fife,4864,10,7,14,15,43,52,-9,35
Alloa,4865,1,21,7,8,66,40,26,70
Livingston,4865,2,21,5,10,74,47,27,68
Airdrieon,4865,3,19,5,12,63,46,17,62
Brechin,4865,4,17,7,12,55,42,13,58
Peterhead,4865,5,14,8,14,45,52,-7,50
Queen's Park,4865,6,12,7,17,39,59,-20,43
Albion,4865,7,10,12,14,43,47,-4,42
Stranraer,4865,8,11,7,18,48,63,-15,40
Stenhousem'r,4865,9,9,9,18,45,75,-30,36
East Fife,4865,10,7,11,18,56,63,-7,32
Livingston,4866,1,22,3,11,69,38,31,69
Alloa,4866,2,17,9,10,65,46,19,60
Airdrieon,4866,3,18,6,12,62,56,6,60
Albion,4866,4,17,5,14,62,50,12,56
Peterhead,4866,5,16,7,13,53,46,7,55
Brechin,4866,6,14,4,18,45,56,-11,46
East Fife,4866,7,12,9,15,44,43,1,45
Queen's Park,4866,8,12,7,17,37,54,-17,43
Stranraer,4866,9,11,7,18,48,57,-9,40
Stenhousem'r,4866,10,10,5,21,42,81,-39,35
Airdrieon,4867,1,21,7,8,65,47,18,70
Livingston,4867,2,20,5,11,81,51,30,65
Alloa,4867,3,14,11,11,60,49,11,53
Brechin,4867,4,15,7,14,46,46,0,52
Peterhead,4867,5,13,11,12,52,49,3,50
East Fife,4867,6,14,5,17,49,46,3,47
Albion,4867,7,13,8,15,48,51,-3,47
Stranraer,4867,8,12,7,17,45,55,-10,43
Queen's Park,4867,9,11,9,16,36,54,-18,42
Stenhousem'r,4867,10,7,10,19,45,79,-34,31
Alloa,4868,1,25,4,7,91,44,47,79
Livingston,4868,2,20,5,11,75,51,24,65
Albion,4868,3,18,6,12,63,47,16,60
Brechin,4868,4,16,6,14,45,49,-4,54
Airdrieon,4868,5,15,3,18,58,60,-2,48
Peterhead,4868,6,14,6,16,54,63,-9,48
East Fife,4868,7,12,9,15,45,45,0,45
Stranraer,4868,8,12,4,20,41,59,-18,40
Queen's Park,4868,9,10,7,19,36,54,-18,37
Stenhousem'r,4868,10,9,8,19,44,80,-36,35
Livingston,4869,1,24,2,10,81,46,35,74
Alloa,4869,2,18,7,11,65,49,16,61
Airdrieon,4869,3,17,9,10,56,43,13,60
Peterhead,4869,4,15,7,14,49,46,3,52
Queen's Park,4869,5,11,15,10,43,43,0,48
Brechin,4869,6,13,8,15,48,61,-13,47
Stranraer,4869,7,13,7,16,57,56,1,46
Albion,4869,8,12,10,14,51,55,-4,46
Stenhousem'r,4869,9,9,7,20,47,79,-32,34
East Fife,4869,10,7,10,19,37,56,-19,31
Livingston,4870,1,25,3,8,82,49,33,78
Alloa,4870,2,20,7,9,64,42,22,67
Queen's Park,4870,3,18,5,13,65,54,11,59
Brechin,4870,4,17,6,13,46,43,3,57
Airdrieon,4870,5,15,6,15,53,59,-6,51
Peterhead,4870,6,12,10,14,56,59,-3,46
Stranraer,4870,7,14,3,19,53,66,-13,45
Albion,4870,8,11,10,15,50,55,-5,43
East Fife,4870,9,6,11,19,40,54,-14,29
Stenhousem'r,4870,10,6,11,19,48,76,-28,29
Livingston,4871,1,22,4,10,78,46,32,70
Alloa,4871,2,20,5,11,71,43,28,65
Brechin,4871,3,19,6,11,52,41,11,63
Airdrieon,4871,4,16,9,11,59,52,7,57
Peterhead,4871,5,14,11,11,50,48,2,53
Albion,4871,6,13,10,13,51,51,0,49
Stranraer,4871,7,12,7,17,52,61,-9,43
East Fife,4871,8,9,9,18,47,58,-11,36
Queen's Park,4871,9,9,8,19,32,59,-27,35
Stenhousem'r,4871,10,8,7,21,44,77,-33,31
Livingston,4872,1,23,3,10,94,51,43,72
Airdrieon,4872,2,21,5,10,72,55,17,68
Peterhead,4872,3,17,9,10,67,57,10,60
Brechin,4872,4,18,6,12,53,52,1,60
Alloa,4872,5,17,7,12,71,56,15,58
East Fife,4872,6,13,9,14,54,50,4,48
Albion,4872,7,12,7,17,52,60,-8,43
Stranraer,4872,8,12,6,18,43,57,-14,42
Stenhousem'r,4872,9,7,7,22,44,73,-29,28
Queen's Park,4872,10,7,7,22,33,72,-39,28
Livingston,4873,1,20,8,8,71,43,28,68
Alloa,4873,2,20,7,9,71,45,26,67
Brechin,4873,3,15,11,10,52,43,9,56
Peterhead,4873,4,15,9,12,50,50,0,54
Airdrieon,4873,5,15,7,14,54,57,-3,52
Stranraer,4873,6,11,11,14,43,47,-4,44
East Fife,4873,7,10,11,15,48,51,-3,41
Albion,4873,8,10,11,15,46,53,-7,41
Queen's Park,4873,9,11,8,17,40,55,-15,41
Stenhousem'r,4873,10,7,9,20,52,83,-31,30
Livingston,4874,1,23,4,9,78,46,32,73
Airdrieon,4874,2,19,5,12,58,48,10,62
Brechin,4874,3,19,4,13,55,46,9,61
Alloa,4874,4,15,10,11,64,47,17,55
Queen's Park,4874,5,15,7,14,40,49,-9,52
Albion,4874,6,13,10,13,59,55,4,49
Peterhead,4874,7,14,4,18,47,50,-3,46
Stranraer,4874,8,13,7,16,50,56,-6,46
East Fife,4874,9,12,9,15,49,53,-4,45
Stenhousem'r,4874,10,3,8,25,34,84,-50,17
Livingston,4875,1,24,5,7,81,45,36,77
Alloa,4875,2,17,11,8,70,42,28,62
Brechin,4875,3,17,7,12,47,45,2,58
East Fife,4875,4,15,8,13,59,45,14,53
Stranraer,4875,5,14,6,16,53,56,-3,48
Queen's Park,4875,6,12,11,13,38,51,-13,47
Peterhead,4875,7,13,6,17,50,60,-10,45
Airdrieon,4875,8,12,8,16,53,63,-10,44
Albion,4875,9,11,6,19,53,61,-8,39
Stenhousem'r,4875,10,7,8,21,50,86,-36,29
Livingston,4876,1,20,4,12,76,55,21,64
Albion,4876,2,19,6,11,63,44,19,63
Alloa,4876,3,17,10,9,67,44,23,61
Airdrieon,4876,4,18,7,11,54,53,1,61
East Fife,4876,5,15,6,15,56,44,12,51
Stranraer,4876,6,14,4,18,48,53,-5,46
Queen's Park,4876,7,12,9,15,43,48,-5,45
Brechin,4876,8,12,8,16,38,51,-13,44
Peterhead,4876,9,9,9,18,40,65,-25,36
Stenhousem'r,4876,10,9,7,20,45,73,-28,34
Alloa,4877,1,22,7,7,77,37,40,73
Livingston,4877,2,18,5,13,68,52,16,59
Brechin,4877,3,17,6,13,57,45,12,57
Peterhead,4877,4,15,9,12,52,46,6,54
Albion,4877,5,16,5,15,48,52,-4,53
Airdrieon,4877,6,14,7,15,48,52,-4,49
Stranraer,4877,7,14,4,18,47,57,-10,46
Queen's Park,4877,8,12,9,15,42,56,-14,45
East Fife,4877,9,9,8,19,45,59,-14,35
Stenhousem'r,4877,10,8,10,18,44,72,-28,34
Livingston,4878,1,22,3,11,79,56,23,69
Airdrieon,4878,2,21,3,12,65,49,16,66
Brechin,4878,3,17,9,10,54,43,11,60
Alloa,4878,4,18,5,13,63,42,21,59
Peterhead,4878,5,17,4,15,57,55,2,55
Albion,4878,6,14,8,14,49,56,-7,50
Stranraer,4878,7,13,7,16,57,57,0,46
Queen's Park,4878,8,12,8,16,35,55,-20,44
East Fife,4878,9,10,8,18,42,47,-5,38
Stenhousem'r,4878,10,7,3,26,47,88,-41,24
Livingston,4879,1,23,5,8,81,43,38,74
Alloa,4879,2,20,7,9,77,45,32,67
Airdrieon,4879,3,15,9,12,56,52,4,54
Albion,4879,4,15,7,14,52,49,3,52
Brechin,4879,5,14,8,14,46,53,-7,50
Stranraer,4879,6,13,9,14,52,59,-7,48
East Fife,4879,7,11,10,15,53,49,4,43
Peterhead,4879,8,11,9,16,42,45,-3,42
Queen's Park,4879,9,9,12,15,29,48,-19,39
Stenhousem'r,4879,10,7,8,21,42,87,-45,29
Alloa,4880,1,25,4,7,79,40,39,79
Livingston,4880,2,19,4,13,70,48,22,61
Airdrieon,4880,3,17,6,13,60,54,6,57
Brechin,4880,4,16,6,14,53,47,6,54
Stranraer,4880,5,15,5,16,50,64,-14,50
East Fife,4880,6,13,8,15,59,55,4,47
Queen's Park,4880,7,13,8,15,37,52,-15,47
Albion,4880,8,11,12,13,54,53,1,45
Peterhead,4880,9,11,8,17,49,53,-4,41
Stenhousem'r,4880,10,6,7,23,42,87,-45,25
Alloa,4881,1,22,6,8,70,46,24,72
Livingston,4881,2,21,7,8,84,52,32,70
Airdrieon,4881,3,21,4,11,69,55,14,67
Albion,4881,4,16,9,11,63,49,14,57
Brechin,4881,5,15,7,14,49,50,-1,52
Peterhead,4881,6,15,6,15,52,54,-2,51
East Fife,4881,7,12,8,16,47,42,5,44
Stranraer,4881,8,10,7,19,48,60,-12,37
Queen's Park,4881,9,9,7,20,32,58,-26,34
Stenhousem'r,4881,10,4,9,23,45,93,-48,21
Alloa,4882,1,20,5,11,71,46,25,65
Airdrieon,4882,2,19,6,11,67,52,15,63
Brechin,4882,3,19,4,13,50,51,-1,61
Livingston,4882,4,19,3,14,69,59,10,60
Albion,4882,5,15,7,14,49,46,3,52
Peterhead,4882,6,14,8,14,52,46,6,50
East Fife,4882,7,13,10,13,54,46,8,49
Queen's Park,4882,8,11,7,18,33,51,-18,40
Stranraer,4882,9,10,6,20,49,63,-14,36
Stenhousem'r,4882,10,8,8,20,40,74,-34,32
Alloa,4883,1,19,7,10,75,43,32,64
Brechin,4883,2,19,7,10,48,40,8,64
Livingston,4883,3,19,6,11,79,51,28,63
Airdrieon,4883,4,15,8,13,53,50,3,53
Albion,4883,5,14,10,12,63,54,9,52
East Fife,4883,6,12,11,13,40,45,-5,47
Queen's Park,4883,7,13,8,15,34,43,-9,47
Peterhead,4883,8,11,10,15,45,51,-6,43
Stranraer,4883,9,9,9,18,44,64,-20,36
Stenhousem'r,4883,10,8,6,22,48,88,-40,30
Livingston,4884,1,23,3,10,85,51,34,72
Alloa,4884,2,18,9,9,76,50,26,63
Airdrieon,4884,3,17,9,10,60,57,3,60
Brechin,4884,4,15,9,12,53,47,6,54
Albion,4884,5,16,5,15,59,57,2,53
Queen's Park,4884,6,13,7,16,37,51,-14,46
Stranraer,4884,7,13,3,20,49,59,-10,42
Peterhead,4884,8,11,9,16,42,53,-11,42
East Fife,4884,9,8,12,16,44,54,-10,36
Stenhousem'r,4884,10,6,14,16,51,77,-26,32
Livingston,4885,1,23,2,11,73,48,25,71
Alloa,4885,2,18,9,9,65,42,23,63
Airdrieon,4885,3,18,5,13,64,63,1,59
Brechin,4885,4,14,6,16,50,55,-5,48
East Fife,4885,5,12,11,13,51,46,5,47
Albion,4885,6,13,7,16,53,58,-5,46
Peterhead,4885,7,11,13,12,44,49,-5,46
Stenhousem'r,4885,8,13,7,16,59,68,-9,46
Queen's Park,4885,9,10,8,18,32,49,-17,38
Stranraer,4885,10,8,12,16,50,63,-13,36
Livingston,4886,1,22,7,7,81,42,39,73
Alloa,4886,2,21,5,10,65,42,23,68
Brechin,4886,3,17,3,16,51,55,-4,54
Airdrieon,4886,4,16,5,15,54,58,-4,53
Queen's Park,4886,5,14,6,16,50,61,-11,48
Stranraer,4886,6,13,7,16,51,48,3,46
East Fife,4886,7,10,12,14,49,51,-2,42
Albion,4886,8,12,6,18,40,51,-11,42
Peterhead,4886,9,11,8,17,46,61,-15,41
Stenhousem'r,4886,10,11,7,18,53,71,-18,40
Livingston,4887,1,22,3,11,86,49,37,69
Alloa,4887,2,18,9,9,71,45,26,63
Albion,4887,3,16,9,11,53,44,9,57
Brechin,4887,4,18,3,15,47,50,-3,57
Airdrieon,4887,5,16,7,13,61,65,-4,55
Peterhead,4887,6,12,9,15,56,63,-7,45
East Fife,4887,7,9,13,14,49,52,-3,40
Stenhousem'r,4887,8,9,11,16,53,72,-19,38
Queen's Park,4887,9,9,11,16,36,57,-21,38
Stranraer,4887,10,10,7,19,44,59,-15,37
Alloa,4888,1,22,6,8,82,44,38,72
Peterhead,4888,2,17,8,11,53,47,6,59
Brechin,4888,3,17,7,12,55,44,11,58
Livingston,4888,4,18,4,14,65,56,9,58
Albion,4888,5,15,9,12,62,49,13,54
Airdrieon,4888,6,14,11,11,56,54,2,53
Stranraer,4888,7,12,7,17,41,55,-14,43
Queen's Park,4888,8,11,7,18,32,51,-19,40
East Fife,4888,9,9,11,16,44,59,-15,38
Stenhousem'r,4888,10,5,10,21,41,72,-31,25
Livingston,4889,1,21,7,8,77,44,33,70
Alloa,4889,2,20,8,8,77,40,37,68
Brechin,4889,3,17,9,10,53,46,7,60
Airdrieon,4889,4,16,7,13,58,58,0,55
Stranraer,4889,5,14,8,14,61,62,-1,50
Queen's Park,4889,6,11,9,16,42,55,-13,42
Peterhead,4889,7,11,9,16,48,65,-17,42
Albion,4889,8,10,11,15,48,54,-6,41
East Fife,4889,9,10,10,16,47,49,-2,40
Stenhousem'r,4889,10,6,10,20,46,84,-38,28
Airdrieon,4890,1,19,8,9,64,49,15,65
Livingston,4890,2,17,6,13,63,52,11,57
Alloa,4890,3,17,5,14,66,47,19,56
Peterhead,4890,4,16,7,13,50,53,-3,55
Brechin,4890,5,15,7,14,45,40,5,52
Albion,4890,6,14,8,14,53,54,-1,50
East Fife,4890,7,12,10,14,48,44,4,46
Queen's Park,4890,8,13,6,17,30,42,-12,45
Stranraer,4890,9,14,2,20,47,59,-12,44
Stenhousem'r,4890,10,8,11,17,46,72,-26,35
Livingston,4891,1,23,5,8,89,44,45,74
Alloa,4891,2,18,6,12,68,48,20,60
Airdrieon,4891,3,16,8,12,56,51,5,56
Stranraer,4891,4,14,8,14,53,58,-5,50
East Fife,4891,5,14,7,15,59,53,6,49
Brechin,4891,6,15,4,17,40,49,-9,49
Queen's Park,4891,7,14,5,17,32,44,-12,47
Peterhead,4891,8,13,6,17,46,55,-9,45
Albion,4891,9,11,8,17,55,61,-6,41
Stenhousem'r,4891,10,11,5,20,49,84,-35,38
Livingston,4892,1,24,3,9,90,45,45,75
Alloa,4892,2,20,8,8,76,38,38,68
Brechin,4892,3,16,7,13,55,53,2,55
Airdrieon,4892,4,15,8,13,64,62,2,53
Albion,4892,5,15,7,14,64,59,5,52
Peterhead,4892,6,13,8,15,50,57,-7,47
Stranraer,4892,7,12,7,17,53,71,-18,43
East Fife,4892,8,11,9,16,49,54,-5,42
Queen's Park,4892,9,12,6,18,37,58,-21,42
Stenhousem'r,4892,10,6,9,21,37,78,-41,27
Alloa,4893,1,21,5,10,70,44,26,68
Queen's Park,4893,2,18,5,13,41,38,3,59
Brechin,4893,3,17,6,13,53,45,8,57
Airdrieon,4893,4,17,6,13,56,60,-4,57
Albion,4893,5,15,10,11,56,44,12,55
Livingston,4893,6,15,4,17,62,62,0,49
East Fife,4893,7,12,9,15,49,51,-2,45
Peterhead,4893,8,11,7,18,49,62,-13,40
Stenhousem'r,4893,9,11,6,19,56,77,-21,39
Stranraer,4893,10,10,8,18,46,55,-9,38
Livingston,4894,1,21,5,10,69,41,28,68
Alloa,4894,2,19,8,9,75,45,30,65
Airdrieon,4894,3,19,7,10,63,43,20,64
Brechin,4894,4,17,7,12,60,50,10,58
Peterhead,4894,5,14,8,14,46,54,-8,50
Stranraer,4894,6,14,6,16,52,61,-9,48
Queen's Park,4894,7,13,6,17,33,47,-14,45
East Fife,4894,8,11,8,17,46,53,-7,41
Albion,4894,9,12,5,19,47,56,-9,41
Stenhousem'r,4894,10,6,8,22,43,84,-41,26
Brechin,4895,1,23,6,7,63,36,27,75
Alloa,4895,2,19,8,9,67,49,18,65
Airdrieon,4895,3,16,8,12,63,64,-1,56
Livingston,4895,4,16,7,13,78,59,19,55
Peterhead,4895,5,14,8,14,57,60,-3,50
Stranraer,4895,6,15,4,17,65,62,3,49
Albion,4895,7,11,10,15,44,55,-11,43
East Fife,4895,8,11,8,17,51,54,-3,41
Queen's Park,4895,9,8,11,17,40,59,-19,35
Stenhousem'r,4895,10,9,6,21,46,76,-30,33
Livingston,4896,1,21,6,9,75,44,31,69
Alloa,4896,2,18,5,13,59,48,11,59
East Fife,4896,3,15,10,11,45,35,10,55
Albion,4896,4,16,7,13,54,52,2,55
Airdrieon,4896,5,15,7,14,60,54,6,52
Peterhead,4896,6,13,10,13,52,56,-4,49
Brechin,4896,7,14,7,15,40,48,-8,49
Stranraer,4896,8,12,9,15,48,52,-4,45
Stenhousem'r,4896,9,11,8,17,60,75,-15,41
Queen's Park,4896,10,6,9,21,29,58,-29,27
Alloa,4897,1,19,9,8,66,39,27,66
Livingston,4897,2,19,5,12,79,57,22,62
Airdrieon,4897,3,17,10,9,70,54,16,61
Brechin,4897,4,15,6,15,56,51,5,51
Peterhead,4897,5,15,6,15,57,57,0,51
East Fife,4897,6,13,10,13,50,56,-6,49
Queen's Park,4897,7,13,8,15,40,55,-15,47
Albion,4897,8,13,7,16,52,54,-2,46
Stranraer,4897,9,13,5,18,57,63,-6,44
Stenhousem'r,4897,10,6,8,22,41,82,-41,26
Alloa,4898,1,20,9,7,76,46,30,69
Livingston,4898,2,20,3,13,78,53,25,63
Airdrieon,4898,3,17,11,8,62,43,19,62
Brechin,4898,4,18,4,14,58,49,9,58
East Fife,4898,5,16,6,14,64,53,11,54
Queen's Park,4898,6,13,9,14,42,46,-4,48
Albion,4898,7,12,7,17,51,61,-10,43
Stranraer,4898,8,12,5,19,49,69,-20,41
Peterhead,4898,9,11,5,20,44,71,-27,38
Stenhousem'r,4898,10,7,9,20,46,79,-33,30
Livingston,4899,1,23,3,10,70,42,28,72
Alloa,4899,2,20,8,8,74,39,35,68
Brechin,4899,3,17,6,13,57,52,5,57
Albion,4899,4,15,8,13,55,53,2,53
Airdrieon,4899,5,14,10,12,63,65,-2,52
East Fife,4899,6,13,8,15,56,54,2,47
Stranraer,4899,7,13,7,16,61,59,2,46
Peterhead,4899,8,11,10,15,42,47,-5,43
Queen's Park,4899,9,11,5,20,39,58,-19,38
Stenhousem'r,4899,10,7,7,22,37,85,-48,28
Livingston,4900,1,20,4,12,76,45,31,64
Alloa,4900,2,17,9,10,60,40,20,60
Airdrieon,4900,3,17,9,10,66,59,7,60
Brechin,4900,4,17,7,12,54,44,10,58
Peterhead,4900,5,17,7,12,49,45,4,58
Albion,4900,6,15,6,15,51,49,2,51
Queen's Park,4900,7,11,10,15,40,58,-18,43
East Fife,4900,8,11,9,16,58,54,4,42
Stranraer,4900,9,12,4,20,46,73,-27,40
Stenhousem'r,4900,10,6,9,21,51,84,-33,27
Livingston,4901,1,22,5,9,89,55,34,71
Alloa,4901,2,17,9,10,72,43,29,60
Brechin,4901,3,17,6,13,50,47,3,57
Albion,4901,4,16,8,12,50,44,6,56
Queen's Park,4901,4,16,8,12,50,44,6,56
Airdrieon,4901,6,16,6,14,54,59,-5,54
Peterhead,4901,7,13,8,15,44,48,-4,47
Stranraer,4901,8,11,8,17,47,58,-11,41
East Fife,4901,9,10,8,18,44,54,-10,38
Stenhousem'r,4901,10,6,6,24,35,83,-48,24
Livingston,4902,1,23,6,7,86,43,43,75
Alloa,4902,2,19,8,9,75,45,30,65
Queen's Park,4902,3,16,8,12,45,43,2,56
Brechin,4902,4,17,3,16,52,55,-3,54
Albion,4902,5,13,11,12,50,50,0,50
Stranraer,4902,6,14,4,18,50,60,-10,46
Airdrieon,4902,7,12,9,15,52,58,-6,45
Peterhead,4902,8,13,5,18,50,56,-6,44
East Fife,4902,9,10,11,15,42,45,-3,41
Stenhousem'r,4902,10,7,7,22,38,85,-47,28
Alloa,4903,1,23,6,7,75,41,34,75
Airdrieon,4903,2,22,3,11,72,51,21,69
Livingston,4903,3,16,8,12,68,55,13,56
Brechin,4903,4,14,9,13,42,48,-6,51
East Fife,4903,5,14,7,15,48,51,-3,49
Peterhead,4903,6,13,9,14,45,49,-4,48
Queen's Park,4903,7,11,10,15,44,52,-8,43
Albion,4903,8,11,9,16,48,50,-2,42
Stranraer,4903,9,13,3,20,53,67,-14,42
Stenhousem'r,4903,10,7,8,21,51,82,-31,29
Livingston,4904,1,21,4,11,83,53,30,67
Alloa,4904,2,18,11,7,70,45,25,65
Airdrieon,4904,3,16,7,13,61,58,3,55
Queen's Park,4904,4,15,8,13,38,40,-2,53
Stranraer,4904,5,16,4,16,62,53,9,52
Peterhead,4904,6,14,7,15,54,55,-1,49
Brechin,4904,7,14,6,16,46,56,-10,48
Albion,4904,8,11,11,14,52,58,-6,44
East Fife,4904,9,10,8,18,45,52,-7,38
Stenhousem'r,4904,10,8,8,20,52,93,-41,32
Livingston,4905,1,22,3,11,87,54,33,69
Alloa,4905,2,20,8,8,80,48,32,68
Airdrieon,4905,3,15,8,13,56,52,4,53
Brechin,4905,4,15,7,14,49,57,-8,52
Albion,4905,5,14,9,13,44,47,-3,51
Peterhead,4905,6,12,12,12,48,55,-7,48
Stenhousem'r,4905,7,13,8,15,51,71,-20,47
Stranraer,4905,8,12,7,17,55,59,-4,43
East Fife,4905,9,9,9,18,51,55,-4,36
Queen's Park,4905,10,8,9,19,38,61,-23,33
Airdrieon,4906,1,20,6,10,62,48,14,66
Alloa,4906,2,20,5,11,69,45,24,65
Livingston,4906,3,19,4,13,69,53,16,61
Queen's Park,4906,4,16,7,13,48,54,-6,55
Peterhead,4906,5,14,8,14,45,50,-5,50
Brechin,4906,6,14,6,16,45,46,-1,48
East Fife,4906,7,12,10,14,46,44,2,46
Stranraer,4906,8,12,5,19,53,63,-10,41
Stenhousem'r,4906,9,11,6,19,51,71,-20,39
Albion,4906,10,10,7,19,38,52,-14,37
Alloa,4907,1,21,5,10,83,46,37,68
Peterhead,4907,2,18,8,10,61,49,12,62
Brechin,4907,3,17,10,9,51,45,6,61
Livingston,4907,4,17,5,14,66,51,15,56
Airdrieon,4907,5,17,5,14,62,58,4,56
Albion,4907,6,13,6,17,52,58,-6,45
East Fife,4907,7,12,8,16,50,50,0,44
Stranraer,4907,8,13,4,19,50,65,-15,43
Queen's Park,4907,9,10,8,18,40,57,-17,38
Stenhousem'r,4907,10,10,5,21,40,76,-36,35
Livingston,4908,1,22,6,8,82,44,38,72
Alloa,4908,2,20,7,9,80,50,30,67
Albion,4908,3,19,7,10,58,39,19,64
Brechin,4908,4,17,5,14,48,49,-1,56
Peterhead,4908,5,13,11,12,48,50,-2,50
Queen's Park,4908,6,14,5,17,37,54,-17,47
Stranraer,4908,7,13,6,17,58,57,1,45
Airdrieon,4908,8,13,5,18,44,59,-15,44
East Fife,4908,9,9,9,18,39,56,-17,36
Stenhousem'r,4908,10,6,7,23,44,80,-36,25
Livingston,4909,1,26,1,9,77,35,42,79
Albion,4909,2,18,7,11,66,43,23,61
Alloa,4909,3,16,12,8,62,40,22,60
Airdrieon,4909,4,17,6,13,59,66,-7,57
East Fife,4909,5,16,7,13,53,43,10,55
Brechin,4909,6,15,7,14,49,46,3,52
Peterhead,4909,7,13,5,18,49,61,-12,44
Queen's Park,4909,8,11,7,18,38,53,-15,40
Stranraer,4909,9,9,8,19,42,67,-25,35
Stenhousem'r,4909,10,6,6,24,42,83,-41,24
Alloa,4910,1,20,8,8,73,44,29,68
Airdrieon,4910,2,18,8,10,64,56,8,62
Queen's Park,4910,3,17,8,11,40,43,-3,59
Livingston,4910,4,17,5,14,72,58,14,56
Brechin,4910,5,14,7,15,46,52,-6,49
Albion,4910,6,13,8,15,60,56,4,47
Peterhead,4910,7,13,8,15,49,56,-7,47
Stranraer,4910,8,13,3,20,56,65,-9,42
East Fife,4910,9,11,6,19,44,48,-4,39
Stenhousem'r,4910,10,10,7,19,50,76,-26,37
Alloa,4911,1,21,7,8,65,39,26,70
Livingston,4911,2,19,6,11,70,55,15,63
Brechin,4911,3,16,7,13,51,44,7,55
Peterhead,4911,4,16,6,14,48,51,-3,54
Airdrieon,4911,5,12,11,13,52,52,0,47
Stranraer,4911,6,14,4,18,39,49,-10,46
Queen's Park,4911,7,11,12,13,39,48,-9,45
Albion,4911,8,11,10,15,47,52,-5,43
East Fife,4911,9,10,11,15,52,49,3,41
Stenhousem'r,4911,10,9,8,19,51,75,-24,35
Livingston,4912,1,22,5,9,82,52,30,71
Alloa,4912,2,15,14,7,69,39,30,59
Airdrieon,4912,3,16,8,12,63,64,-1,56
Peterhead,4912,4,15,10,11,56,51,5,55
Albion,4912,5,13,8,15,57,60,-3,47
Brechin,4912,6,12,10,14,41,52,-11,46
Queen's Park,4912,7,12,9,15,34,48,-14,45
East Fife,4912,8,9,16,11,52,48,4,43
Stranraer,4912,9,10,9,17,44,53,-9,39
Stenhousem'r,4912,10,6,11,19,46,77,-31,29
Livingston,4913,1,24,4,8,83,44,39,76
Airdrieon,4913,2,19,8,9,61,44,17,65
Alloa,4913,3,19,7,10,76,42,34,64
Albion,4913,4,15,10,11,55,47,8,55
Brechin,4913,5,14,7,15,45,57,-12,49
Queen's Park,4913,6,12,12,12,36,43,-7,48
East Fife,4913,7,11,9,16,52,50,2,42
Peterhead,4913,8,11,9,16,45,55,-10,42
Stenhousem'r,4913,9,7,10,19,42,90,-48,31
Stranraer,4913,10,8,4,24,41,64,-23,28
Livingston,4914,1,19,3,14,69,52,17,60
Airdrieon,4914,2,19,2,15,60,60,0,59
Alloa,4914,3,16,10,10,68,50,18,58
Stranraer,4914,4,17,4,15,55,55,0,55
Queen's Park,4914,5,16,6,14,36,41,-5,54
Brechin,4914,6,15,7,14,56,52,4,52
East Fife,4914,7,15,6,15,43,45,-2,51
Albion,4914,8,12,7,17,50,52,-2,43
Peterhead,4914,9,11,7,18,47,55,-8,40
Stenhousem'r,4914,10,11,6,19,59,81,-22,39
Livingston,4915,1,23,3,10,92,51,41,72
Airdrieon,4915,2,20,4,12,65,55,10,64
Alloa,4915,3,17,10,9,61,40,21,61
Brechin,4915,4,18,3,15,61,56,5,57
Queen's Park,4915,5,14,8,14,37,43,-6,50
Stranraer,4915,6,13,7,16,52,62,-10,46
Peterhead,4915,7,12,8,16,43,57,-14,44
East Fife,4915,8,12,7,17,48,51,-3,43
Albion,4915,9,11,5,20,53,72,-19,38
Stenhousem'r,4915,10,9,7,20,50,75,-25,34
Livingston,4916,1,22,7,7,77,41,36,73
Alloa,4916,2,19,7,10,74,45,29,64
Airdrieon,4916,3,14,13,9,60,54,6,55
Peterhead,4916,4,16,7,13,57,52,5,55
Brechin,4916,5,15,7,14,51,49,2,52
Albion,4916,6,13,9,14,55,60,-5,48
Stranraer,4916,7,13,5,18,44,58,-14,44
East Fife,4916,8,11,8,17,45,48,-3,41
Queen's Park,4916,9,11,7,18,41,60,-19,40
Stenhousem'r,4916,10,7,8,21,39,76,-37,29
Livingston,4917,1,19,9,8,76,51,25,66
Alloa,4917,2,19,7,10,71,45,26,64
Brechin,4917,3,19,5,12,52,47,5,62
Albion,4917,4,17,7,12,61,49,12,58
Airdrieon,4917,5,17,6,13,63,61,2,57
East Fife,4917,6,13,8,15,57,46,11,47
Peterhead,4917,7,11,7,18,44,56,-12,40
Stranraer,4917,8,10,8,18,43,60,-17,38
Queen's Park,4917,9,10,7,19,38,62,-24,37
Stenhousem'r,4917,10,11,4,21,42,70,-28,37
Livingston,4918,1,23,3,10,80,44,36,72
Airdrieon,4918,2,19,7,10,69,56,13,64
Alloa,4918,3,18,5,13,64,43,21,59
Peterhead,4918,4,16,10,10,55,44,11,58
Albion,4918,5,16,5,15,52,46,6,53
Brechin,4918,6,15,5,16,42,52,-10,50
Queen's Park,4918,7,13,5,18,38,51,-13,44
Stranraer,4918,8,10,10,16,48,56,-8,40
East Fife,4918,9,9,12,15,45,52,-7,39
Stenhousem'r,4918,10,5,10,21,44,93,-49,25
Livingston,4919,1,22,3,11,77,47,30,69
Airdrieon,4919,2,17,9,10,66,54,12,60
Alloa,4919,3,15,9,12,64,52,12,54
Brechin,4919,4,15,9,12,53,50,3,54
Stranraer,4919,5,14,9,13,52,56,-4,51
Albion,4919,6,13,11,12,54,53,1,50
Peterhead,4919,7,13,9,14,52,61,-9,48
East Fife,4919,8,11,11,14,50,47,3,44
Queen's Park,4919,9,11,8,17,29,47,-18,41
Stenhousem'r,4919,10,6,8,22,41,71,-30,26
Livingston,4920,1,21,5,10,79,47,32,68
Airdrieon,4920,2,18,9,9,70,56,14,63
Alloa,4920,3,15,9,12,64,49,15,54
Brechin,4920,4,16,6,14,45,44,1,54
Peterhead,4920,5,15,6,15,45,51,-6,51
Queen's Park,4920,6,14,8,14,39,42,-3,50
Albion,4920,7,13,7,16,51,54,-3,46
East Fife,4920,8,12,10,14,43,47,-4,46
Stranraer,4920,9,12,8,16,53,56,-3,44
Stenhousem'r,4920,10,5,10,21,38,81,-43,25
Livingston,4921,1,22,6,8,78,44,34,72
Airdrieon,4921,2,20,4,12,68,49,19,64
Alloa,4921,3,16,6,14,61,49,12,54
Albion,4921,4,14,9,13,54,52,2,51
Queen's Park,4921,5,13,12,11,40,47,-7,51
Stranraer,4921,6,14,8,14,52,52,0,50
Brechin,4921,7,14,6,16,50,58,-8,48
Peterhead,4921,8,13,8,15,45,50,-5,47
East Fife,4921,9,12,6,18,53,52,1,42
Stenhousem'r,4921,10,7,5,24,38,86,-48,26
Livingston,4922,1,17,10,9,72,49,23,61
Brechin,4922,2,18,6,12,59,52,7,60
Airdrieon,4922,3,16,10,10,64,54,10,58
Alloa,4922,4,16,8,12,63,50,13,56
Stranraer,4922,5,14,9,13,54,52,2,51
Albion,4922,6,13,9,14,56,60,-4,48
Peterhead,4922,7,12,12,12,52,56,-4,48
Queen's Park,4922,8,13,5,18,45,62,-17,44
East Fife,4922,9,10,10,16,57,58,-1,40
Stenhousem'r,4922,10,7,9,20,53,82,-29,30
Livingston,4923,1,24,3,9,70,38,32,75
Airdrieon,4923,2,20,6,10,59,45,14,66
Alloa,4923,3,15,10,11,65,51,14,55
Stranraer,4923,4,14,9,13,55,46,9,51
Brechin,4923,5,15,6,15,49,47,2,51
Albion,4923,6,14,7,15,53,50,3,49
Queen's Park,4923,7,13,9,14,34,47,-13,48
Peterhead,4923,8,10,10,16,44,53,-9,40
East Fife,4923,9,11,7,18,42,53,-11,40
Stenhousem'r,4923,10,7,7,22,39,80,-41,28
Livingston,4924,1,21,2,13,76,54,22,65
Alloa,4924,2,18,10,8,73,46,27,64
Airdrieon,4924,3,18,9,9,53,42,11,63
Brechin,4924,4,16,7,13,51,48,3,55
Albion,4924,5,15,9,12,52,49,3,54
East Fife,4924,6,14,6,16,52,53,-1,48
Peterhead,4924,7,11,11,14,50,52,-2,44
Queen's Park,4924,8,10,10,16,35,45,-10,40
Stenhousem'r,4924,9,10,7,19,55,85,-30,37
Stranraer,4924,10,8,7,21,40,63,-23,31
Livingston,4925,1,24,2,10,72,42,30,74
Brechin,4925,2,17,10,9,54,45,9,61
Albion,4925,3,17,7,12,62,45,17,58
Alloa,4925,4,15,12,9,66,41,25,57
Peterhead,4925,5,16,6,14,52,55,-3,54
Airdrieon,4925,6,13,10,13,64,57,7,49
East Fife,4925,7,10,9,17,52,64,-12,39
Stranraer,4925,8,10,9,17,52,66,-14,39
Queen's Park,4925,9,9,10,17,33,58,-25,37
Stenhousem'r,4925,10,7,9,20,60,94,-34,30
Alloa,4926,1,20,9,7,70,34,36,69
Brechin,4926,2,21,2,13,53,39,14,65
Livingston,4926,3,17,5,14,68,49,19,56
Airdrieon,4926,4,16,8,12,54,60,-6,56
Albion,4926,5,15,7,14,52,51,1,52
East Fife,4926,6,12,12,12,50,46,4,48
Peterhead,4926,7,13,7,16,51,53,-2,46
Queen's Park,4926,8,11,10,15,37,49,-12,43
Stranraer,4926,9,11,6,19,49,68,-19,39
Stenhousem'r,4926,10,7,8,21,49,84,-35,29
Alloa,4927,1,19,8,9,75,45,30,65
Airdrieon,4927,2,16,9,11,62,59,3,57
Brechin,4927,3,18,3,15,54,56,-2,57
Livingston,4927,4,18,2,16,67,51,16,56
Queen's Park,4927,5,16,7,13,37,39,-2,55
Stranraer,4927,6,16,6,14,49,47,2,54
Peterhead,4927,7,14,6,16,44,50,-6,48
East Fife,4927,8,13,6,17,49,48,1,45
Stenhousem'r,4927,9,10,7,19,44,69,-25,37
Albion,4927,10,9,8,19,37,54,-17,35
Livingston,4928,1,21,5,10,73,48,25,68
Airdrieon,4928,2,19,4,13,57,42,15,61
Albion,4928,3,18,6,12,58,49,9,60
Alloa,4928,4,16,10,10,65,46,19,58
Stranraer,4928,5,15,5,16,53,56,-3,50
Brechin,4928,6,15,5,16,49,56,-7,50
Peterhead,4928,7,13,9,14,53,56,-3,48
Queen's Park,4928,8,10,13,13,36,47,-11,43
East Fife,4928,9,10,9,17,49,52,-3,39
Stenhousem'r,4928,10,6,8,22,37,78,-41,26
Alloa,4929,1,18,8,10,74,50,24,62
Livingston,4929,2,18,5,13,75,53,22,59
Peterhead,4929,3,17,8,11,59,45,14,59
Brechin,4929,4,16,10,10,47,44,3,58
Airdrieon,4929,5,14,8,14,54,53,1,50
Queen's Park,4929,6,14,8,14,45,53,-8,50
Albion,4929,7,13,9,14,50,53,-3,48
East Fife,4929,8,11,11,14,51,54,-3,44
Stranraer,4929,9,11,8,17,49,60,-11,41
Stenhousem'r,4929,10,7,7,22,36,75,-39,28
Livingston,4930,1,21,3,12,75,48,27,66
Alloa,4930,2,18,10,8,70,42,28,64
Brechin,4930,3,16,9,11,54,50,4,57
Airdrieon,4930,4,16,7,13,64,61,3,55
Queen's Park,4930,5,15,8,13,36,38,-2,53
Albion,4930,6,12,9,15,58,62,-4,45
Peterhead,4930,7,12,9,15,52,59,-7,45
East Fife,4930,8,10,12,14,53,52,1,42
Stranraer,4930,9,10,7,19,38,59,-21,37
Stenhousem'r,4930,10,10,6,20,49,78,-29,36
Brechin,4931,1,23,4,9,72,48,24,73
Livingston,4931,2,21,6,9,82,53,29,69
Alloa,4931,3,18,9,9,66,47,19,63
Peterhead,4931,4,14,8,14,57,55,2,50
Albion,4931,5,13,7,16,51,59,-8,46
East Fife,4931,6,12,9,15,46,47,-1,45
Queen's Park,4931,7,12,9,15,45,55,-10,45
Airdrieon,4931,8,12,8,16,56,64,-8,44
Stenhousem'r,4931,9,11,6,19,51,71,-20,39
Stranraer,4931,10,10,2,24,38,65,-27,32
Airdrieon,4932,1,22,8,6,78,48,30,74
Alloa,4932,2,22,7,7,84,43,41,73
Livingston,4932,3,20,8,8,90,58,32,68
Brechin,4932,4,16,5,15,55,52,3,53
Queen's Park,4932,5,15,5,16,46,63,-17,50
Peterhead,4932,6,11,13,12,43,44,-1,46
East Fife,4932,7,13,7,16,52,57,-5,46
Albion,4932,8,11,9,16,61,62,-1,42
Stranraer,4932,9,10,5,21,42,71,-29,35
Stenhousem'r,4932,10,3,7,26,41,94,-53,16
Livingston,4933,1,21,8,7,80,47,33,71
Alloa,4933,2,21,4,11,71,42,29,67
East Fife,4933,3,18,9,9,61,42,19,63
Airdrieon,4933,4,17,6,13,57,57,0,57
Brechin,4933,5,17,5,14,53,47,6,56
Peterhead,4933,6,11,11,14,40,49,-9,44
Albion,4933,7,9,15,12,47,50,-3,42
Stranraer,4933,8,10,9,17,44,57,-13,39
Queen's Park,4933,9,9,6,21,34,58,-24,33
Stenhousem'r,4933,10,8,5,23,49,87,-38,29
Alloa,4934,1,20,9,7,77,40,37,69
Livingston,4934,2,20,4,12,75,48,27,64
Brechin,4934,3,18,5,13,57,49,8,59
Albion,4934,4,15,9,12,52,45,7,54
Airdrieon,4934,5,15,8,13,60,60,0,53
Queen's Park,4934,6,14,6,16,36,51,-15,48
East Fife,4934,7,13,8,15,55,48,7,47
Peterhead,4934,8,10,11,15,47,59,-12,41
Stranraer,4934,9,11,3,22,46,68,-22,36
Stenhousem'r,4934,10,8,9,19,41,78,-37,33
Alloa,4935,1,19,8,9,71,50,21,65
Livingston,4935,2,20,3,13,72,43,29,63
Brechin,4935,3,20,3,13,59,48,11,63
Airdrieon,4935,4,18,8,10,58,48,10,62
Albion,4935,5,17,5,14,50,46,4,56
Peterhead,4935,6,13,7,16,51,49,2,46
Queen's Park,4935,7,13,7,16,37,58,-21,46
Stranraer,4935,8,11,7,18,42,55,-13,40
East Fife,4935,9,8,13,15,48,55,-7,37
Stenhousem'r,4935,10,8,5,23,44,80,-36,29
Livingston,4936,1,22,5,9,80,47,33,71
Alloa,4936,2,20,7,9,73,45,28,67
Brechin,4936,3,18,4,14,56,53,3,58
Airdrieon,4936,4,16,7,13,59,59,0,55
Peterhead,4936,5,15,7,14,55,49,6,52
Stranraer,4936,6,15,5,16,53,54,-1,50
Albion,4936,7,14,8,14,52,54,-2,50
Queen's Park,4936,8,13,8,15,43,50,-7,47
East Fife,4936,9,6,10,20,41,62,-21,28
Stenhousem'r,4936,10,7,7,22,50,89,-39,28
Livingston,4937,1,21,5,10,70,43,27,68
Alloa,4937,2,18,11,7,68,40,28,65
Airdrieon,4937,3,20,4,12,58,46,12,64
East Fife,4937,4,14,10,12,62,49,13,52
Queen's Park,4937,5,13,10,13,38,44,-6,49
Stranraer,4937,6,15,2,19,61,65,-4,47
Peterhead,4937,7,13,7,16,46,57,-11,46
Brechin,4937,8,12,5,19,47,68,-21,41
Albion,4937,9,12,4,20,48,59,-11,40
Stenhousem'r,4937,10,9,8,19,45,72,-27,35
Alloa,4938,1,22,8,6,82,42,40,74
Livingston,4938,2,22,5,9,88,48,40,71
Brechin,4938,3,17,7,12,52,52,0,58
Airdrieon,4938,4,17,5,14,66,71,-5,56
Queen's Park,4938,5,14,9,13,43,48,-5,51
Albion,4938,6,14,8,14,56,61,-5,50
Peterhead,4938,7,13,7,16,57,49,8,46
Stranraer,4938,8,12,4,20,58,69,-11,40
East Fife,4938,9,8,10,18,41,52,-11,34
Stenhousem'r,4938,10,5,9,22,45,96,-51,24
Livingston,4939,1,23,2,11,86,47,39,71
Alloa,4939,2,20,9,7,74,46,28,69
Airdrieon,4939,3,19,6,11,67,53,14,63
Albion,4939,4,16,9,11,57,49,8,57
Peterhead,4939,5,15,7,14,56,54,2,52
Brechin,4939,6,16,3,17,57,57,0,51
Queen's Park,4939,7,14,4,18,33,51,-18,46
East Fife,4939,8,9,8,19,48,58,-10,35
Stranraer,4939,9,10,3,23,42,70,-28,33
Stenhousem'r,4939,10,8,9,19,42,77,-35,33
Livingston,4940,1,22,4,10,74,43,31,70
Alloa,4940,2,21,6,9,77,48,29,69
Airdrieon,4940,3,18,7,11,56,49,7,61
Brechin,4940,4,18,6,12,55,46,9,60
East Fife,4940,5,12,11,13,53,46,7,47
Albion,4940,6,14,5,17,58,58,0,47
Peterhead,4940,7,13,7,16,43,52,-9,46
Queen's Park,4940,8,12,5,19,32,56,-24,41
Stranraer,4940,9,10,6,20,41,55,-14,36
Stenhousem'r,4940,10,9,5,22,43,79,-36,32
Livingston,4941,1,21,4,11,77,54,23,67
Alloa,4941,2,19,9,8,66,40,26,66
Brechin,4941,3,17,7,12,53,49,4,58
Airdrieon,4941,4,16,8,12,55,57,-2,56
Peterhead,4941,5,14,6,16,48,58,-10,48
Albion,4941,6,12,11,13,54,50,4,47
Stenhousem'r,4941,7,12,6,18,54,73,-19,42
Queen's Park,4941,8,10,11,15,42,57,-15,41
Stranraer,4941,9,11,6,19,48,56,-8,39
East Fife,4941,10,9,10,17,54,57,-3,37
Airdrieon,4942,1,20,8,8,59,45,14,68
Brechin,4942,2,17,10,9,49,39,10,61
Livingston,4942,3,16,9,11,64,46,18,57
Alloa,4942,4,15,11,10,65,50,15,56
Albion,4942,5,15,8,13,53,55,-2,53
Peterhead,4942,6,13,9,14,46,46,0,48
East Fife,4942,7,12,8,16,50,49,1,44
Stranraer,4942,8,12,8,16,46,53,-7,44
Queen's Park,4942,9,13,5,18,42,56,-14,44
Stenhousem'r,4942,10,5,8,23,38,73,-35,23
Alloa,4943,1,19,8,9,76,51,25,65
Livingston,4943,2,17,8,11,65,45,20,59
Albion,4943,3,15,10,11,59,50,9,55
Brechin,4943,4,17,3,16,51,42,9,54
Stranraer,4943,5,15,8,13,53,55,-2,53
Airdrieon,4943,6,13,9,14,51,54,-3,48
Queen's Park,4943,7,14,6,16,40,50,-10,48
East Fife,4943,8,12,9,15,46,42,4,45
Peterhead,4943,9,11,7,18,45,65,-20,40
Stenhousem'r,4943,10,9,8,19,47,79,-32,35
Livingston,4944,1,24,6,6,82,38,44,78
Brechin,4944,2,19,6,11,55,44,11,63
Alloa,4944,3,17,8,11,60,45,15,59
Airdrieon,4944,4,16,7,13,59,54,5,55
Peterhead,4944,5,15,6,15,49,51,-2,51
East Fife,4944,6,12,13,11,49,45,4,49
Stranraer,4944,7,12,6,18,46,60,-14,42
Albion,4944,8,10,11,15,49,51,-2,41
Queen's Park,4944,9,11,7,18,32,52,-20,40
Stenhousem'r,4944,10,5,8,23,39,80,-41,23
Alloa,4945,1,21,6,9,76,42,34,69
Livingston,4945,2,20,6,10,72,52,20,66
Airdrieon,4945,3,17,7,12,61,54,7,58
Brechin,4945,4,17,4,15,46,48,-2,55
Peterhead,4945,5,12,12,12,50,55,-5,48
Albion,4945,6,11,10,15,56,57,-1,43
East Fife,4945,7,11,10,15,52,56,-4,43
Stranraer,4945,8,13,4,19,49,57,-8,43
Queen's Park,4945,9,11,6,19,42,58,-16,39
Stenhousem'r,4945,10,9,11,16,46,71,-25,38
Livingston,4946,1,22,4,10,76,41,35,70
Alloa,4946,2,21,7,8,67,38,29,70
Brechin,4946,3,19,6,11,55,45,10,63
Airdrieon,4946,4,16,9,11,50,44,6,57
Peterhead,4946,5,15,7,14,50,49,1,52
Stranraer,4946,6,14,5,17,57,65,-8,47
Albion,4946,7,13,7,16,54,54,0,46
East Fife,4946,8,11,7,18,53,57,-4,40
Queen's Park,4946,9,10,4,22,31,66,-35,34
Stenhousem'r,4946,10,9,4,23,44,78,-34,31
Alloa,4947,1,20,8,8,70,40,30,68
Livingston,4947,2,21,5,10,73,48,25,68
Airdrieon,4947,3,18,7,11,62,57,5,61
East Fife,4947,4,15,8,13,51,43,8,53
Peterhead,4947,5,14,9,13,49,49,0,51
Brechin,4947,6,14,9,13,41,43,-2,51
Albion,4947,7,11,9,16,46,49,-3,42
Queen's Park,4947,8,9,13,14,34,50,-16,40
Stranraer,4947,9,11,5,20,50,66,-16,38
Stenhousem'r,4947,10,6,9,21,44,75,-31,27
Alloa,4948,1,19,10,7,85,48,37,67
Brechin,4948,2,18,8,10,56,48,8,62
Airdrieon,4948,3,17,5,14,56,50,6,56
Livingston,4948,4,17,4,15,73,52,21,55
Peterhead,4948,5,15,6,15,44,46,-2,51
Stranraer,4948,6,15,6,15,48,53,-5,51
Albion,4948,7,14,5,17,53,64,-11,47
East Fife,4948,8,11,9,16,46,52,-6,42
Queen's Park,4948,9,11,8,17,39,53,-14,41
Stenhousem'r,4948,10,10,5,21,46,80,-34,35
Livingston,4949,1,22,5,9,73,45,28,71
Alloa,4949,2,17,9,10,63,43,20,60
Airdrieon,4949,3,16,8,12,57,58,-1,56
Peterhead,4949,4,16,5,15,54,49,5,53
Albion,4949,5,14,10,12,56,50,6,52
Brechin,4949,6,15,4,17,53,51,2,49
Queen's Park,4949,7,13,10,13,44,52,-8,49
East Fife,4949,8,11,10,15,45,49,-4,43
Stranraer,4949,9,12,5,19,48,59,-11,41
Stenhousem'r,4949,10,6,10,20,39,76,-37,28
Livingston,4950,1,22,7,7,78,46,32,73
Alloa,4950,2,18,8,10,74,46,28,62
Brechin,4950,3,17,7,12,51,47,4,58
Peterhead,4950,4,16,9,11,58,55,3,57
East Fife,4950,5,13,12,11,53,41,12,51
Albion,4950,6,13,11,12,60,62,-2,50
Stranraer,4950,7,13,6,17,58,57,1,45
Airdrieon,4950,8,12,8,16,56,67,-11,44
Queen's Park,4950,9,12,6,18,35,55,-20,42
Stenhousem'r,4950,10,5,4,27,47,94,-47,19
Livingston,4951,1,23,5,8,79,36,43,74
Alloa,4951,2,20,7,9,76,45,31,67
Airdrieon,4951,3,17,8,11,60,52,8,59
Peterhead,4951,4,14,9,13,46,46,0,51
Brechin,4951,5,14,8,14,41,48,-7,50
East Fife,4951,6,12,7,17,50,53,-3,43
Queen's Park,4951,7,12,7,17,36,52,-16,43
Albion,4951,8,10,9,17,49,59,-10,39
Stranraer,4951,9,11,6,19,40,55,-15,39
Stenhousem'r,4951,10,10,8,18,44,75,-31,38
Livingston,4952,1,20,5,11,73,47,26,65
Alloa,4952,2,17,9,10,66,44,22,60
Airdrieon,4952,3,17,7,12,55,48,7,58
Brechin,4952,4,15,10,11,54,48,6,55
Albion,4952,5,15,7,14,49,54,-5,52
Peterhead,4952,6,11,13,12,50,53,-3,46
Stranraer,4952,7,13,6,17,49,60,-11,45
East Fife,4952,8,12,8,16,44,46,-2,44
Stenhousem'r,4952,9,10,9,17,48,65,-17,39
Queen's Park,4952,10,9,8,19,34,57,-23,35
Alloa,4953,1,21,8,7,73,41,32,71
Airdrieon,4953,2,21,7,8,65,41,24,70
Livingston,4953,3,19,3,14,77,61,16,60
East Fife,4953,4,15,7,14,56,45,11,52
Albion,4953,5,13,9,14,51,53,-2,48
Brechin,4953,6,14,5,17,42,50,-8,47
Peterhead,4953,7,12,8,16,51,57,-6,44
Queen's Park,4953,8,13,5,18,39,55,-16,44
Stranraer,4953,9,11,6,19,48,69,-21,39
Stenhousem'r,4953,10,9,6,21,49,79,-30,33
Livingston,4954,1,21,7,8,67,38,29,70
Brechin,4954,2,16,8,12,53,44,9,56
Airdrieon,4954,3,15,8,13,49,54,-5,53
Alloa,4954,4,13,13,10,63,57,6,52
East Fife,4954,5,14,9,13,53,45,8,51
Peterhead,4954,6,14,8,14,58,54,4,50
Albion,4954,7,12,10,14,49,47,2,46
Stranraer,4954,8,12,8,16,49,52,-3,44
Queen's Park,4954,9,11,7,18,37,49,-12,40
Stenhousem'r,4954,10,10,6,20,52,90,-38,36
Livingston,4955,1,21,5,10,74,42,32,68
Brechin,4955,2,20,5,11,55,44,11,65
Airdrieon,4955,3,17,9,10,52,51,1,60
Peterhead,4955,4,17,8,11,48,40,8,59
Alloa,4955,5,14,9,13,60,47,13,51
Albion,4955,6,14,8,14,52,46,6,50
Queen's Park,4955,7,13,9,14,38,44,-6,48
Stranraer,4955,8,12,6,18,46,56,-10,42
East Fife,4955,9,11,7,18,46,53,-7,40
Stenhousem'r,4955,10,3,10,23,34,82,-48,19
Alloa,4956,1,21,7,8,82,47,35,70
Airdrieon,4956,2,19,8,9,65,54,11,65
Brechin,4956,3,16,6,14,59,58,1,54
Queen's Park,4956,4,15,9,12,48,49,-1,54
Livingston,4956,5,14,9,13,60,49,11,51
Albion,4956,6,12,11,13,51,54,-3,47
East Fife,4956,7,11,12,13,49,44,5,45
Peterhead,4956,8,10,9,17,49,65,-16,39
Stranraer,4956,9,10,8,18,42,56,-14,38
Stenhousem'r,4956,10,7,11,18,47,76,-29,32
Airdrieon,4957,1,18,8,10,62,46,16,62
Queen's Park,4957,2,18,8,10,49,44,5,62
Brechin,4957,3,18,6,12,48,44,4,60
Alloa,4957,4,18,5,13,68,51,17,59
Livingston,4957,5,18,5,13,61,45,16,59
Peterhead,4957,6,15,7,14,56,46,10,52
Stranraer,4957,7,13,4,19,50,62,-12,43
Albion,4957,8,10,8,18,45,57,-12,38
Stenhousem'r,4957,9,9,8,19,37,74,-37,35
East Fife,4957,10,6,15,15,40,47,-7,33
Livingston,4958,1,22,5,9,69,40,29,71
Alloa,4958,2,20,8,8,86,53,33,68
Airdrieon,4958,3,16,7,13,54,53,1,55
Queen's Park,4958,4,16,7,13,41,46,-5,55
Brechin,4958,5,14,8,14,54,56,-2,50
Peterhead,4958,6,14,6,16,54,53,1,48
Albion,4958,7,13,9,14,50,51,-1,48
Stranraer,4958,8,15,3,18,53,63,-10,48
East Fife,4958,9,8,9,19,41,53,-12,33
Stenhousem'r,4958,10,6,10,20,45,79,-34,28
Livingston,4959,1,24,1,11,75,41,34,73
Brechin,4959,2,20,4,12,54,42,12,64
Alloa,4959,3,17,8,11,73,54,19,59
Queen's Park,4959,4,15,4,17,40,50,-10,49
Airdrieon,4959,5,13,9,14,55,62,-7,48
East Fife,4959,6,13,8,15,55,51,4,47
Peterhead,4959,7,13,8,15,42,52,-10,47
Albion,4959,8,11,11,14,58,57,1,44
Stranraer,4959,9,11,5,20,44,61,-17,38
Stenhousem'r,4959,10,10,8,18,55,81,-26,38
Livingston,4960,1,24,3,9,81,38,43,75
Alloa,4960,2,19,5,12,69,42,27,62
Airdrieon,4960,3,16,9,11,63,58,5,57
Brechin,4960,4,15,7,14,51,52,-1,52
Peterhead,4960,5,15,7,14,51,53,-2,52
Albion,4960,6,15,5,16,54,58,-4,50
East Fife,4960,7,13,9,14,51,52,-1,48
Stranraer,4960,8,13,5,18,52,54,-2,44
Queen's Park,4960,9,11,7,18,32,54,-22,40
Stenhousem'r,4960,10,5,11,20,51,94,-43,26
Alloa,4961,1,19,8,9,66,44,22,65
Airdrieon,4961,2,20,5,11,64,53,11,65
Livingston,4961,3,19,6,11,77,48,29,63
Albion,4961,4,16,6,14,53,54,-1,54
Brechin,4961,5,14,7,15,61,56,5,49
Stranraer,4961,6,14,7,15,59,60,-1,49
Peterhead,4961,7,14,7,15,53,57,-4,49
Queen's Park,4961,8,12,7,17,35,50,-15,43
East Fife,4961,9,10,10,16,39,48,-9,40
Stenhousem'r,4961,10,7,7,22,48,85,-37,28
Alloa,4962,1,22,8,6,73,41,32,74
Brechin,4962,2,17,11,8,54,37,17,62
Livingston,4962,3,18,6,12,70,48,22,60
Peterhead,4962,4,14,11,11,43,45,-2,53
Airdrieon,4962,5,14,10,12,50,54,-4,52
Stranraer,4962,6,12,9,15,47,51,-4,45
Albion,4962,7,12,8,16,50,51,-1,44
Queen's Park,4962,8,9,10,17,32,51,-19,37
East Fife,4962,9,9,9,18,35,48,-13,36
Stenhousem'r,4962,10,8,8,20,45,73,-28,32
Livingston,4963,1,23,2,11,78,49,29,71
Alloa,4963,2,17,10,9,71,50,21,61
Airdrieon,4963,3,18,7,11,63,47,16,61
Albion,4963,4,14,8,14,54,52,2,50
Brechin,4963,5,15,5,16,49,59,-10,50
Stenhousem'r,4963,6,11,12,13,62,71,-9,45
Peterhead,4963,7,10,14,12,48,56,-8,44
Stranraer,4963,8,11,8,17,53,69,-16,41
East Fife,4963,9,9,10,17,54,60,-6,37
Queen's Park,4963,10,8,12,16,35,54,-19,36
Livingston,4964,1,20,6,10,77,45,32,66
Alloa,4964,2,18,7,11,62,40,22,61
Albion,4964,3,16,10,10,54,50,4,58
Brechin,4964,4,16,7,13,59,46,13,55
Airdrieon,4964,5,16,6,14,55,57,-2,54
Peterhead,4964,6,13,7,16,42,50,-8,46
Queen's Park,4964,7,12,9,15,40,53,-13,45
East Fife,4964,8,11,10,15,55,63,-8,43
Stranraer,4964,9,12,7,17,58,70,-12,43
Stenhousem'r,4964,10,6,11,19,47,75,-28,29
Livingston,4965,1,22,5,9,85,49,36,71
Airdrieon,4965,2,18,8,10,70,51,19,62
Alloa,4965,3,17,10,9,66,44,22,61
Brechin,4965,4,16,5,15,48,48,0,53
Albion,4965,5,14,9,13,57,56,1,51
Peterhead,4965,6,14,7,15,50,56,-6,49
Stranraer,4965,7,14,6,16,55,52,3,48
Queen's Park,4965,8,13,8,15,38,51,-13,47
East Fife,4965,9,11,9,16,56,56,0,42
Stenhousem'r,4965,10,3,9,24,39,101,-62,18
Livingston,4966,1,20,7,9,78,48,30,67
Alloa,4966,2,18,9,9,76,45,31,63
Albion,4966,3,15,9,12,52,46,6,54
Airdrieon,4966,4,16,6,14,60,64,-4,54
Peterhead,4966,5,15,7,14,51,53,-2,52
Brechin,4966,6,13,8,15,40,51,-11,47
Queen's Park,4966,7,13,7,16,49,58,-9,46
East Fife,4966,8,11,10,15,57,54,3,43
Stranraer,4966,9,12,6,18,54,66,-12,42
Stenhousem'r,4966,10,8,9,19,44,76,-32,33
Queen's Park,4967,1,20,5,11,58,49,9,65
Brechin,4967,2,20,3,13,57,45,12,63
Livingston,4967,3,19,4,13,67,57,10,61
Alloa,4967,4,17,7,12,72,46,26,58
Airdrieon,4967,5,16,6,14,61,56,5,54
Peterhead,4967,6,13,10,13,46,58,-12,49
East Fife,4967,7,11,11,14,52,51,1,44
Stranraer,4967,8,12,6,18,52,71,-19,42
Albion,4967,9,9,9,18,53,59,-6,36
Stenhousem'r,4967,10,8,9,19,54,80,-26,33
Livingston,4968,1,22,6,8,80,45,35,72
Brechin,4968,2,18,7,11,60,43,17,61
Airdrieon,4968,3,13,12,11,47,51,-4,51
Peterhead,4968,4,14,9,13,47,53,-6,51
Alloa,4968,5,13,10,13,55,46,9,49
Albion,4968,6,13,10,13,48,49,-1,49
Stranraer,4968,7,12,7,17,51,61,-10,43
Queen's Park,4968,8,11,10,15,34,46,-12,43
East Fife,4968,9,11,9,16,48,45,3,42
Stenhousem'r,4968,10,7,12,17,51,82,-31,33
Alloa,4969,1,22,7,7,73,38,35,73
Livingston,4969,2,19,6,11,75,47,28,63
Airdrieon,4969,3,17,9,10,61,54,7,60
Queen's Park,4969,4,14,10,12,40,44,-4,52
Brechin,4969,5,15,6,15,50,51,-1,51
Albion,4969,6,13,11,12,63,56,7,50
Stranraer,4969,7,15,4,17,47,50,-3,49
East Fife,4969,8,12,6,18,52,57,-5,42
Peterhead,4969,9,6,13,17,36,64,-28,31
Stenhousem'r,4969,10,7,8,21,51,87,-36,29
Livingston,4970,1,24,4,8,77,42,35,76
Airdrieon,4970,2,20,4,12,65,53,12,64
Alloa,4970,3,18,7,11,76,49,27,61
Brechin,4970,4,18,3,15,53,51,2,57
Queen's Park,4970,5,15,8,13,37,46,-9,53
Albion,4970,6,15,6,15,56,58,-2,51
Stranraer,4970,7,15,3,18,55,60,-5,48
Peterhead,4970,8,12,6,18,49,61,-12,42
East Fife,4970,9,11,6,19,54,61,-7,39
Stenhousem'r,4970,10,5,7,24,43,84,-41,22
Livingston,4971,1,24,5,7,75,42,33,77
Brechin,4971,2,19,7,10,59,40,19,64
Alloa,4971,3,16,9,11,68,46,22,57
Airdrieon,4971,4,16,6,14,58,59,-1,54
Queen's Park,4971,5,13,10,13,40,46,-6,49
Albion,4971,6,12,10,14,53,60,-7,46
Peterhead,4971,7,11,12,13,46,52,-6,45
Stranraer,4971,8,12,6,18,49,62,-13,42
East Fife,4971,9,8,10,18,46,57,-11,34
Stenhousem'r,4971,10,7,9,20,40,70,-30,30
Alloa,4972,1,19,9,8,70,35,35,66
Livingston,4972,2,18,8,10,72,44,28,62
Peterhead,4972,3,17,9,10,48,38,10,60
Airdrieon,4972,4,15,12,9,56,48,8,57
Brechin,4972,5,16,7,13,48,45,3,55
Albion,4972,6,13,8,15,54,53,1,47
East Fife,4972,7,11,10,15,49,52,-3,43
Queen's Park,4972,8,9,10,17,35,59,-24,37
Stenhousem'r,4972,9,10,7,19,43,72,-29,37
Stranraer,4972,10,10,4,22,41,70,-29,34
Alloa,4973,1,22,6,8,72,38,34,72
Livingston,4973,2,21,4,11,76,47,29,67
Airdrieon,4973,3,18,6,12,66,51,15,60
Peterhead,4973,4,18,4,14,52,44,8,58
Stranraer,4973,5,17,3,16,53,60,-7,54
Queen's Park,4973,6,15,4,17,38,53,-15,49
Brechin,4973,7,14,5,17,51,57,-6,47
Albion,4973,8,11,10,15,48,55,-7,43
East Fife,4973,9,9,12,15,39,48,-9,39
Stenhousem'r,4973,10,5,6,25,43,85,-42,21
Alloa,4974,1,20,9,7,81,43,38,69
Livingston,4974,2,18,8,10,81,56,25,62
Airdrieon,4974,3,17,5,14,61,60,1,56
Brechin,4974,4,16,8,12,48,48,0,56
Peterhead,4974,5,13,9,14,52,52,0,48
Albion,4974,6,13,8,15,47,53,-6,47
Queen's Park,4974,7,14,5,17,38,52,-14,47
East Fife,4974,8,9,13,14,61,56,5,40
Stranraer,4974,9,12,4,20,61,80,-19,40
Stenhousem'r,4974,10,9,9,18,40,70,-30,36
Livingston,4975,1,22,4,10,78,43,35,70
Brechin,4975,2,18,4,14,46,46,0,58
Alloa,4975,3,16,9,11,59,46,13,57
East Fife,4975,4,15,10,11,53,39,14,55
Airdrieon,4975,5,15,8,13,56,66,-10,53
Stranraer,4975,6,14,10,12,60,52,8,52
Peterhead,4975,7,13,7,16,58,55,3,46
Queen's Park,4975,8,12,9,15,34,43,-9,45
Albion,4975,9,11,10,15,46,57,-11,43
Stenhousem'r,4975,10,5,7,24,34,77,-43,22
Livingston,4976,1,21,4,11,75,46,29,67
Albion,4976,2,19,8,9,53,38,15,65
Brechin,4976,3,18,6,12,55,47,8,60
Airdrieon,4976,4,17,7,12,61,54,7,58
Alloa,4976,5,14,8,14,59,57,2,50
Stranraer,4976,6,14,7,15,54,49,5,49
East Fife,4976,7,13,9,14,43,42,1,48
Queen's Park,4976,8,12,5,19,43,62,-19,41
Peterhead,4976,9,11,7,18,47,56,-9,40
Stenhousem'r,4976,10,7,7,22,39,78,-39,28
Livingston,4977,1,22,6,8,77,43,34,72
Alloa,4977,2,19,7,10,74,41,33,64
Airdrieon,4977,3,17,4,15,58,57,1,55
East Fife,4977,4,15,9,12,60,41,19,54
Albion,4977,5,16,6,14,58,60,-2,54
Peterhead,4977,6,13,10,13,50,54,-4,49
Brechin,4977,7,12,8,16,46,65,-19,44
Queen's Park,4977,8,11,9,16,39,55,-16,42
Stranraer,4977,9,10,6,20,50,68,-18,36
Stenhousem'r,4977,10,9,7,20,48,76,-28,34
Livingston,4978,1,22,5,9,77,44,33,71
Alloa,4978,2,20,10,6,72,41,31,70
Brechin,4978,3,18,8,10,57,46,11,62
Airdrieon,4978,4,17,9,10,61,54,7,60
Stranraer,4978,5,12,9,15,53,60,-7,45
Peterhead,4978,6,9,12,15,43,55,-12,39
Stenhousem'r,4978,7,9,11,16,45,77,-32,38
East Fife,4978,8,9,10,17,55,51,4,37
Queen's Park,4978,9,8,12,16,27,47,-20,36
Albion,4978,10,8,10,18,45,60,-15,34
Livingston,4979,1,23,6,7,76,44,32,75
Alloa,4979,2,19,7,10,74,45,29,64
Albion,4979,3,16,10,10,55,48,7,58
Brechin,4979,4,15,8,13,56,51,5,53
Airdrieon,4979,5,14,10,12,53,49,4,52
Peterhead,4979,6,12,10,14,49,58,-9,46
Stranraer,4979,7,12,7,17,42,54,-12,43
Queen's Park,4979,8,9,11,16,32,55,-23,38
Stenhousem'r,4979,9,9,8,19,52,79,-27,35
East Fife,4979,10,7,11,18,53,59,-6,32
Alloa,4980,1,22,5,9,78,47,31,71
Brechin,4980,2,17,8,11,55,48,7,59
Livingston,4980,3,17,7,12,71,54,17,58
Peterhead,4980,4,16,7,13,55,58,-3,55
Albion,4980,5,15,7,14,57,51,6,52
Airdrieon,4980,6,13,13,10,53,47,6,52
Stranraer,4980,7,12,6,18,52,60,-8,42
Queen's Park,4980,8,11,9,16,39,53,-14,42
East Fife,4980,9,9,9,18,40,51,-11,36
Stenhousem'r,4980,10,8,9,19,42,73,-31,33
Livingston,4981,1,24,1,11,80,49,31,73
Alloa,4981,2,20,8,8,75,45,30,68
Airdrieon,4981,3,17,7,12,59,54,5,58
Brechin,4981,4,17,5,14,54,51,3,56
Stranraer,4981,5,13,10,13,51,47,4,49
Albion,4981,6,12,9,15,56,60,-4,45
Queen's Park,4981,7,13,5,18,32,49,-17,44
Peterhead,4981,8,11,10,15,45,54,-9,43
East Fife,4981,9,11,8,17,38,45,-7,41
Stenhousem'r,4981,10,7,7,22,47,83,-36,28
Livingston,4982,1,21,7,8,83,52,31,70
Airdrieon,4982,2,19,9,8,67,53,14,66
Alloa,4982,3,18,9,9,77,45,32,63
Albion,4982,4,14,9,13,57,60,-3,51
Brechin,4982,5,14,9,13,52,58,-6,51
Peterhead,4982,6,11,12,13,44,50,-6,45
East Fife,4982,7,11,10,15,54,42,12,43
Stranraer,4982,8,11,7,18,45,57,-12,40
Queen's Park,4982,9,9,11,16,39,64,-25,38
Stenhousem'r,4982,10,7,7,22,49,86,-37,28
Livingston,4983,1,23,6,7,81,44,37,75
Alloa,4983,2,18,8,10,70,46,24,62
Brechin,4983,3,18,6,12,50,48,2,60
Airdrieon,4983,4,16,10,10,57,52,5,58
Queen's Park,4983,5,13,8,15,43,53,-10,47
Peterhead,4983,6,12,9,15,54,63,-9,45
Stranraer,4983,7,12,7,17,50,62,-12,43
Albion,4983,8,10,12,14,39,47,-8,42
East Fife,4983,9,10,10,16,50,48,2,40
Stenhousem'r,4983,10,6,8,22,49,80,-31,26
Alloa,4984,1,22,6,8,86,45,41,72
Livingston,4984,2,21,3,12,81,55,26,66
Brechin,4984,3,20,6,10,63,53,10,66
Airdrieon,4984,4,18,7,11,70,61,9,61
Peterhead,4984,5,14,8,14,57,58,-1,50
East Fife,4984,6,12,10,14,49,49,0,46
Albion,4984,7,11,10,15,50,53,-3,43
Stranraer,4984,8,11,6,19,51,67,-16,39
Queen's Park,4984,9,11,4,21,33,62,-29,37
Stenhousem'r,4984,10,6,8,22,50,87,-37,26
Livingston,4985,1,17,11,8,74,51,23,62
Alloa,4985,2,16,12,8,62,38,24,60
Airdrieon,4985,3,17,8,11,59,46,13,59
Brechin,4985,4,15,11,10,55,49,6,56
Queen's Park,4985,5,11,14,11,40,47,-7,47
Peterhead,4985,6,12,10,14,42,49,-7,46
Albion,4985,7,10,13,13,54,59,-5,43
Stranraer,4985,8,10,10,16,52,68,-16,40
East Fife,4985,9,9,11,16,49,51,-2,38
Stenhousem'r,4985,10,7,12,17,48,77,-29,33
Livingston,4986,1,20,7,9,68,40,28,67
Alloa,4986,2,17,9,10,57,37,20,60
Brechin,4986,3,17,5,14,52,42,10,56
Airdrieon,4986,4,16,7,13,56,52,4,55
Albion,4986,5,15,6,15,50,59,-9,51
Peterhead,4986,6,14,8,14,54,54,0,50
Queen's Park,4986,7,13,8,15,46,47,-1,47
East Fife,4986,8,13,8,15,47,49,-2,47
Stranraer,4986,9,12,8,16,53,55,-2,44
Stenhousem'r,4986,10,7,6,23,42,90,-48,27
Livingston,4987,1,22,5,9,80,41,39,71
Alloa,4987,2,20,5,11,76,49,27,65
Airdrieon,4987,3,19,6,11,68,52,16,63
Albion,4987,4,17,8,11,60,50,10,59
Brechin,4987,5,14,4,18,50,63,-13,46
East Fife,4987,6,13,6,17,50,51,-1,45
Peterhead,4987,7,12,8,16,49,61,-12,44
Stranraer,4987,8,13,5,18,45,61,-16,44
Stenhousem'r,4987,9,10,10,16,51,70,-19,40
Queen's Park,4987,10,8,7,21,34,65,-31,31
Alloa,4988,1,21,3,12,71,49,22,66
Airdrieon,4988,2,19,8,9,65,48,17,65
Livingston,4988,3,20,3,13,70,48,22,63
Brechin,4988,4,18,5,13,62,53,9,59
Albion,4988,5,17,5,14,64,54,10,56
Queen's Park,4988,6,14,9,13,35,45,-10,51
Peterhead,4988,7,12,10,14,43,59,-16,46
Stranraer,4988,8,12,8,16,55,59,-4,44
East Fife,4988,9,9,6,21,44,60,-16,33
Stenhousem'r,4988,10,7,5,24,48,82,-34,26
Livingston,4989,1,21,9,6,83,45,38,72
Alloa,4989,2,21,6,9,72,46,26,69
Brechin,4989,3,20,2,14,58,51,7,62
Airdrieon,4989,4,17,5,14,62,61,1,56
Peterhead,4989,5,15,6,15,48,48,0,51
Albion,4989,6,15,5,16,60,69,-9,50
Queen's Park,4989,7,12,8,16,34,44,-10,44
East Fife,4989,8,9,9,18,51,55,-4,36
Stenhousem'r,4989,9,8,10,18,53,79,-26,34
Stranraer,4989,10,9,6,21,44,67,-23,33
Livingston,4990,1,26,4,6,81,34,47,82
Alloa,4990,2,18,8,10,64,46,18,62
Peterhead,4990,3,17,7,12,57,52,5,58
Brechin,4990,4,15,10,11,48,42,6,55
Airdrieon,4990,5,14,7,15,58,60,-2,49
Albion,4990,6,12,8,16,48,58,-10,44
East Fife,4990,7,11,7,18,47,55,-8,40
Queen's Park,4990,8,11,7,18,34,53,-19,40
Stranraer,4990,9,8,14,14,56,66,-10,38
Stenhousem'r,4990,10,7,10,19,47,74,-27,31
Alloa,4991,1,22,5,9,70,38,32,71
Airdrieon,4991,2,21,4,11,71,59,12,67
Brechin,4991,3,19,6,11,72,53,19,63
Livingston,4991,4,17,5,14,65,55,10,56
Albion,4991,5,14,9,13,56,54,2,51
East Fife,4991,6,13,10,13,53,41,12,49
Stranraer,4991,7,11,7,18,46,61,-15,40
Peterhead,4991,8,10,9,17,49,65,-16,39
Queen's Park,4991,9,10,8,18,34,60,-26,38
Stenhousem'r,4991,10,8,7,21,50,80,-30,31
Livingston,4992,1,19,7,10,72,50,22,64
Airdrieon,4992,2,18,7,11,59,48,11,61
Alloa,4992,3,16,9,11,58,46,12,57
Peterhead,4992,4,15,10,11,60,48,12,55
Brechin,4992,5,16,5,15,47,50,-3,53
Stranraer,4992,6,13,7,16,55,57,-2,46
Albion,4992,7,12,9,15,55,59,-4,45
Queen's Park,4992,8,11,8,17,35,56,-21,41
East Fife,4992,9,9,11,16,48,48,0,38
Stenhousem'r,4992,10,9,11,16,49,76,-27,38
Livingston,4993,1,26,2,8,89,42,47,80
Alloa,4993,2,22,6,8,70,44,26,72
Brechin,4993,3,16,8,12,52,50,2,56
Airdrieon,4993,4,15,9,12,59,56,3,54
East Fife,4993,5,13,8,15,56,48,8,47
Albion,4993,6,13,8,15,52,50,2,47
Stranraer,4993,7,13,6,17,53,60,-7,45
Peterhead,4993,8,11,10,15,55,62,-7,43
Queen's Park,4993,9,11,5,20,41,74,-33,38
Stenhousem'r,4993,10,6,6,24,44,85,-41,24
Livingston,4994,1,21,6,9,78,45,33,69
Airdrieon,4994,2,16,10,10,66,56,10,58
Brechin,4994,3,16,7,13,51,41,10,55
Stranraer,4994,4,15,9,12,55,50,5,54
Alloa,4994,5,14,8,14,56,47,9,50
Peterhead,4994,6,13,11,12,44,43,1,50
Albion,4994,7,13,11,12,55,56,-1,50
Queen's Park,4994,8,12,8,16,35,53,-18,44
East Fife,4994,9,11,8,17,49,48,1,41
Stenhousem'r,4994,10,6,8,22,43,93,-50,26
Livingston,4995,1,21,6,9,70,45,25,69
Alloa,4995,2,19,9,8,71,40,31,66
Brechin,4995,3,19,6,11,62,45,17,63
Airdrieon,4995,4,16,8,12,55,53,2,56
Peterhead,4995,5,14,7,15,44,52,-8,49
Albion,4995,6,11,13,12,53,59,-6,46
East Fife,4995,7,11,12,13,55,50,5,45
Queen's Park,4995,8,10,9,17,27,48,-21,39
Stranraer,4995,9,11,4,21,53,62,-9,37
Stenhousem'r,4995,10,6,10,20,44,80,-36,28
Alloa,4996,1,21,5,10,72,48,24,68
Livingston,4996,2,20,4,12,73,47,26,64
Queen's Park,4996,3,20,4,12,49,45,4,64
Brechin,4996,4,18,7,11,55,50,5,61
Airdrieon,4996,5,17,7,12,52,49,3,58
Peterhead,4996,6,12,8,16,53,52,1,44
Albion,4996,7,11,9,16,48,51,-3,42
Stranraer,4996,8,12,5,19,40,59,-19,41
East Fife,4996,9,9,9,18,50,54,-4,36
Stenhousem'r,4996,10,7,8,21,49,86,-37,29
Livingston,4997,1,21,3,12,74,44,30,66
Albion,4997,2,16,10,10,57,50,7,58
Airdrieon,4997,3,15,11,10,55,49,6,56
Alloa,4997,4,16,7,13,59,50,9,55
Brechin,4997,5,14,8,14,43,48,-5,50
Stranraer,4997,6,14,7,15,49,46,3,49
Peterhead,4997,7,13,8,15,48,54,-6,47
East Fife,4997,8,10,11,15,48,53,-5,41
Stenhousem'r,4997,9,11,7,18,54,76,-22,40
Queen's Park,4997,10,9,10,17,33,50,-17,37
Alloa,4998,1,20,7,9,67,43,24,67
Brechin,4998,2,18,9,9,60,49,11,63
Livingston,4998,3,19,5,12,78,48,30,62
Albion,4998,4,16,7,13,63,60,3,55
Queen's Park,4998,5,13,10,13,45,52,-7,49
Peterhead,4998,6,12,10,14,51,57,-6,46
East Fife,4998,7,11,10,15,52,48,4,43
Airdrieon,4998,8,11,8,17,49,66,-17,41
Stranraer,4998,9,11,7,18,42,59,-17,40
Stenhousem'r,4998,10,8,9,19,49,74,-25,33
Livingston,4999,1,21,4,11,84,58,26,67
Peterhead,4999,2,19,3,14,63,54,9,60
Alloa,4999,3,15,9,12,66,46,20,54
Albion,4999,4,16,5,15,66,61,5,53
Airdrieon,4999,5,15,7,14,57,55,2,52
Brechin,4999,6,14,8,14,43,44,-1,50
Stranraer,4999,7,12,10,14,42,52,-10,46
Queen's Park,4999,8,13,6,17,40,60,-20,45
East Fife,4999,9,11,10,15,51,52,-1,43
Stenhousem'r,4999,10,9,8,19,49,79,-30,35
Alloa,5000,1,22,5,9,73,42,31,71
Livingston,5000,2,19,6,11,81,50,31,63
Queen's Park,5000,3,17,6,13,53,46,7,57
Airdrieon,5000,4,17,5,14,55,52,3,56
Brechin,5000,5,15,6,15,42,49,-7,51
Peterhead,5000,6,12,10,14,39,50,-11,46
Stranraer,5000,7,12,9,15,49,58,-9,45
Albion,5000,8,14,3,19,52,64,-12,45
East Fife,5000,9,10,12,14,41,46,-5,42
Stenhousem'r,5000,10,6,10,20,47,75,-28,28
Airdrieon,5001,1,19,7,10,63,54,9,64
Livingston,5001,2,19,4,13,82,58,24,61
Alloa,5001,3,18,7,11,67,44,23,61
Brechin,5001,4,16,9,11,54,44,10,57
Albion,5001,5,15,9,12,52,53,-1,54
East Fife,5001,6,13,9,14,50,47,3,48
Peterhead,5001,7,12,9,15,47,53,-6,45
Stranraer,5001,8,13,6,17,57,65,-8,45
Queen's Park,5001,9,10,6,20,31,54,-23,36
Stenhousem'r,5001,10,9,6,21,50,81,-31,33
Alloa,5002,1,22,7,7,76,41,35,73
Livingston,5002,2,19,8,9,75,52,23,65
Brechin,5002,3,18,6,12,53,48,5,60
Albion,5002,4,15,9,12,61,55,6,54
Airdrieon,5002,5,15,8,13,62,60,2,53
East Fife,5002,6,13,11,12,54,48,6,50
Peterhead,5002,7,13,9,14,61,60,1,48
Stranraer,5002,8,11,6,19,52,67,-15,39
Queen's Park,5002,9,9,5,22,44,70,-26,32
Stenhousem'r,5002,10,7,7,22,44,81,-37,28
Livingston,5003,1,22,5,9,74,43,31,71
Alloa,5003,2,17,9,10,61,41,20,60
Brechin,5003,3,16,8,12,42,39,3,56
Airdrieon,5003,4,15,7,14,50,50,0,52
East Fife,5003,5,14,8,14,52,49,3,50
Stranraer,5003,6,14,7,15,43,48,-5,49
Peterhead,5003,7,13,9,14,49,52,-3,48
Queen's Park,5003,8,12,8,16,34,41,-7,44
Albion,5003,9,11,9,16,44,55,-11,42
Stenhousem'r,5003,10,8,6,22,51,82,-31,30
Brechin,5004,1,18,8,10,55,38,17,62
Livingston,5004,2,19,3,14,72,49,23,60
Alloa,5004,3,18,6,12,71,49,22,60
Peterhead,5004,4,17,8,11,48,53,-5,59
Albion,5004,5,15,7,14,53,51,2,52
Airdrieon,5004,6,15,6,15,53,54,-1,51
East Fife,5004,7,12,11,13,54,50,4,47
Queen's Park,5004,8,13,7,16,34,52,-18,46
Stranraer,5004,9,12,3,21,44,60,-16,39
Stenhousem'r,5004,10,9,5,22,52,80,-28,32
Livingston,5005,1,20,6,10,64,44,20,66
Brechin,5005,2,18,7,11,64,56,8,61
Peterhead,5005,3,16,10,10,60,52,8,58
Airdrieon,5005,4,17,7,12,61,54,7,58
Alloa,5005,5,17,6,13,74,54,20,57
Queen's Park,5005,6,15,4,17,47,50,-3,49
Stranraer,5005,7,12,8,16,52,60,-8,44
Albion,5005,8,12,8,16,57,69,-12,44
Stenhousem'r,5005,9,8,11,17,55,78,-23,35
East Fife,5005,10,7,9,20,47,64,-17,30
Alloa,5006,1,24,8,4,94,41,53,80
Livingston,5006,2,19,6,11,77,53,24,63
Albion,5006,3,13,10,13,46,50,-4,49
Airdrieon,5006,4,15,4,17,50,56,-6,49
Queen's Park,5006,5,14,7,15,37,48,-11,49
Peterhead,5006,6,13,7,16,52,56,-4,46
Brechin,5006,7,13,7,16,40,45,-5,46
East Fife,5006,8,11,12,13,47,50,-3,45
Stenhousem'r,5006,9,12,6,18,52,71,-19,42
Stranraer,5006,10,10,5,21,41,66,-25,35
Airdrieon,5007,1,20,6,10,60,51,9,66
Livingston,5007,2,20,4,12,75,49,26,64
Alloa,5007,3,17,11,8,56,36,20,62
Brechin,5007,4,17,7,12,60,43,17,58
Peterhead,5007,5,16,7,13,49,54,-5,55
Queen's Park,5007,6,14,9,13,49,49,0,51
Albion,5007,7,13,7,16,50,57,-7,46
Stranraer,5007,8,10,7,19,39,61,-22,37
East Fife,5007,9,9,9,18,51,57,-6,36
Stenhousem'r,5007,10,6,9,21,48,80,-32,27
Airdrieon,5008,1,22,4,10,72,56,16,70
Alloa,5008,2,20,7,9,74,44,30,67
Livingston,5008,3,19,2,15,68,50,18,59
Albion,5008,4,17,7,12,57,46,11,58
Peterhead,5008,5,13,11,12,51,52,-1,50
East Fife,5008,6,12,8,16,49,49,0,44
Brechin,5008,7,12,7,17,46,59,-13,43
Queen's Park,5008,8,12,6,18,27,51,-24,42
Stranraer,5008,9,12,5,19,50,62,-12,41
Stenhousem'r,5008,10,9,7,20,46,71,-25,34
Alloa,5009,1,20,7,9,75,41,34,67
Livingston,5009,2,21,4,11,76,49,27,67
Airdrieon,5009,3,19,6,11,60,44,16,63
Brechin,5009,4,17,5,14,50,50,0,56
Peterhead,5009,5,15,8,13,48,47,1,53
Queen's Park,5009,6,14,8,14,50,56,-6,50
Albion,5009,7,13,4,19,53,60,-7,43
Stranraer,5009,8,12,5,19,55,69,-14,41
East Fife,5009,9,8,14,14,41,53,-12,38
Stenhousem'r,5009,10,7,7,22,40,79,-39,28
Brechin,5010,1,18,8,10,59,43,16,62
Livingston,5010,2,18,5,13,62,49,13,59
Alloa,5010,3,16,9,11,62,49,13,57
Peterhead,5010,4,15,11,10,57,43,14,56
Queen's Park,5010,5,17,4,15,45,49,-4,55
Airdrieon,5010,6,15,7,14,57,57,0,52
East Fife,5010,7,14,8,14,55,44,11,50
Albion,5010,8,12,11,13,52,52,0,47
Stranraer,5010,9,12,4,20,49,68,-19,40
Stenhousem'r,5010,10,6,7,23,35,79,-44,25
Livingston,5011,1,25,2,9,90,45,45,77
Albion,5011,2,20,6,10,61,41,20,66
Airdrieon,5011,3,19,6,11,61,49,12,63
Alloa,5011,4,18,7,11,66,49,17,61
Brechin,5011,5,15,5,16,50,54,-4,50
Peterhead,5011,6,13,7,16,50,53,-3,46
East Fife,5011,7,12,8,16,52,57,-5,44
Queen's Park,5011,8,13,4,19,38,49,-11,43
Stranraer,5011,9,9,6,21,42,72,-30,33
Stenhousem'r,5011,10,7,7,22,42,83,-41,28
Livingston,5012,1,21,5,10,72,40,32,68
Alloa,5012,2,19,8,9,65,40,25,65
Brechin,5012,3,19,5,12,51,43,8,62
Airdrieon,5012,4,17,7,12,65,50,15,58
Stranraer,5012,5,15,7,14,53,58,-5,52
Albion,5012,6,10,14,12,47,52,-5,44
Peterhead,5012,7,11,11,14,40,48,-8,44
East Fife,5012,8,11,9,16,50,52,-2,42
Stenhousem'r,5012,9,9,7,20,42,74,-32,34
Queen's Park,5012,10,6,11,19,22,50,-28,29
Alloa,5013,1,22,6,8,79,43,36,72
Livingston,5013,2,21,2,13,78,46,32,65
Airdrieon,5013,3,20,3,13,65,64,1,63
Albion,5013,4,17,5,14,57,53,4,56
Peterhead,5013,5,14,10,12,57,54,3,52
Brechin,5013,6,14,7,15,46,57,-11,49
East Fife,5013,7,11,10,15,56,59,-3,43
Stranraer,5013,8,11,10,15,47,54,-7,43
Queen's Park,5013,9,11,9,16,37,48,-11,42
Stenhousem'r,5013,10,4,8,24,41,85,-44,20
Alloa,5014,1,20,9,7,81,44,37,69
Livingston,5014,2,21,3,12,79,54,25,66
Brechin,5014,3,19,5,12,58,49,9,62
Peterhead,5014,4,15,9,12,48,49,-1,54
Queen's Park,5014,5,14,8,14,39,42,-3,50
Airdrieon,5014,6,14,8,14,52,56,-4,50
Albion,5014,7,12,8,16,44,51,-7,44
East Fife,5014,8,9,9,18,47,62,-15,36
Stranraer,5014,9,10,6,20,46,64,-18,36
Stenhousem'r,5014,10,7,13,16,50,73,-23,34
Livingston,5015,1,21,6,9,75,47,28,69
Alloa,5015,2,18,6,12,62,50,12,60
Airdrieon,5015,3,17,5,14,61,54,7,56
Brechin,5015,4,16,6,14,46,48,-2,54
Peterhead,5015,5,15,7,14,51,55,-4,52
Queen's Park,5015,6,15,6,15,35,42,-7,51
Stranraer,5015,7,14,5,17,62,65,-3,47
East Fife,5015,8,12,8,16,48,48,0,44
Albion,5015,9,11,7,18,48,61,-13,40
Stenhousem'r,5015,10,10,6,20,53,71,-18,36
Airdrieon,5016,1,20,7,9,64,55,9,67
Alloa,5016,2,19,9,8,70,46,24,66
Livingston,5016,3,20,5,11,78,52,26,65
Albion,5016,4,16,10,10,54,40,14,58
Peterhead,5016,5,13,9,14,45,49,-4,48
Stranraer,5016,6,12,8,16,53,54,-1,44
Brechin,5016,7,13,4,19,46,65,-19,43
Queen's Park,5016,8,11,9,16,41,51,-10,42
East Fife,5016,9,10,10,16,48,54,-6,40
Stenhousem'r,5016,10,6,9,21,50,83,-33,27
Livingston,5017,1,21,5,10,83,53,30,68
Alloa,5017,2,17,10,9,60,45,15,61
Airdrieon,5017,3,18,6,12,69,48,21,60
Brechin,5017,4,18,6,12,63,55,8,60
East Fife,5017,5,15,7,14,52,48,4,52
Peterhead,5017,6,13,10,13,44,50,-6,49
Queen's Park,5017,7,12,8,16,48,54,-6,44
Albion,5017,8,11,9,16,51,62,-11,42
Stranraer,5017,9,11,8,17,48,59,-11,41
Stenhousem'r,5017,10,6,7,23,45,89,-44,25
Airdrieon,5018,1,18,8,10,68,50,18,62
Livingston,5018,2,18,7,11,71,51,20,61
Alloa,5018,3,16,12,8,61,36,25,60
Brechin,5018,4,17,7,12,53,42,11,58
Albion,5018,5,15,9,12,55,47,8,54
Peterhead,5018,6,13,8,15,47,56,-9,47
East Fife,5018,7,11,10,15,47,49,-2,43
Stenhousem'r,5018,8,10,9,17,50,79,-29,39
Stranraer,5018,9,11,5,20,48,62,-14,38
Queen's Park,5018,10,11,5,20,37,65,-28,38
Livingston,5019,1,21,8,7,77,38,39,71
Alloa,5019,2,17,8,11,67,48,19,59
Airdrieon,5019,3,15,12,9,51,45,6,57
Brechin,5019,4,17,5,14,52,43,9,56
Peterhead,5019,5,16,7,13,53,49,4,55
Albion,5019,6,15,9,12,45,48,-3,54
Stranraer,5019,7,14,6,16,55,58,-3,48
Queen's Park,5019,8,13,4,19,39,56,-17,43
East Fife,5019,9,8,10,18,41,52,-11,34
Stenhousem'r,5019,10,5,9,22,40,83,-43,24
Livingston,5020,1,20,8,8,72,40,32,68
Alloa,5020,2,16,10,10,65,48,17,58
Brechin,5020,3,16,9,11,51,44,7,57
Airdrieon,5020,4,15,8,13,53,57,-4,53
Peterhead,5020,5,12,15,9,52,44,8,51
Albion,5020,6,13,10,13,48,49,-1,49
East Fife,5020,7,11,12,13,48,46,2,45
Queen's Park,5020,8,11,10,15,40,53,-13,43
Stranraer,5020,9,12,3,21,49,64,-15,39
Stenhousem'r,5020,10,7,9,20,50,83,-33,30
Alloa,5021,1,20,9,7,71,45,26,69
Livingston,5021,2,20,8,8,76,43,33,68
Brechin,5021,3,18,7,11,57,46,11,61
Airdrieon,5021,4,17,5,14,61,54,7,56
Albion,5021,5,15,7,14,54,58,-4,52
Peterhead,5021,6,13,11,12,45,48,-3,50
East Fife,5021,7,11,12,13,45,41,4,45
Queen's Park,5021,8,10,8,18,34,55,-21,38
Stranraer,5021,9,8,7,21,50,71,-21,31
Stenhousem'r,5021,10,7,8,21,55,87,-32,29
Alloa,5022,1,20,9,7,74,44,30,69
Airdrieon,5022,2,21,5,10,63,55,8,68
Livingston,5022,3,17,7,12,71,51,20,58
Peterhead,5022,4,17,7,12,61,51,10,58
Brechin,5022,5,17,5,14,51,46,5,56
Queen's Park,5022,6,14,6,16,44,46,-2,48
Albion,5022,7,13,7,16,54,58,-4,46
Stranraer,5022,8,13,5,18,46,56,-10,44
East Fife,5022,9,8,7,21,33,51,-18,31
Stenhousem'r,5022,10,8,6,22,44,83,-39,30
Livingston,5023,1,25,2,9,77,44,33,77
Alloa,5023,2,21,8,7,68,35,33,71
Airdrieon,5023,3,18,7,11,59,54,5,61
Brechin,5023,4,16,8,12,59,52,7,56
Peterhead,5023,5,13,9,14,44,52,-8,48
Albion,5023,6,12,11,13,47,55,-8,47
East Fife,5023,7,11,8,17,52,56,-4,41
Queen's Park,5023,8,10,10,16,36,52,-16,40
Stranraer,5023,9,10,6,20,54,67,-13,36
Stenhousem'r,5023,10,6,7,23,41,70,-29,25
Livingston,5024,1,20,5,11,82,52,30,65
Alloa,5024,2,18,7,11,65,50,15,61
Brechin,5024,3,17,4,15,52,54,-2,55
Albion,5024,4,15,8,13,54,52,2,53
Airdrieon,5024,5,14,11,11,51,49,2,53
Stranraer,5024,6,14,7,15,61,60,1,49
Peterhead,5024,7,14,6,16,54,57,-3,48
East Fife,5024,8,12,8,16,51,53,-2,44
Queen's Park,5024,9,11,7,18,41,59,-18,40
Stenhousem'r,5024,10,9,9,18,47,72,-25,36
Livingston,5025,1,23,5,8,88,52,36,74
Alloa,5025,2,19,7,10,68,41,27,64
Brechin,5025,3,19,4,13,55,48,7,61
Airdrieon,5025,4,16,9,11,59,53,6,57
Albion,5025,5,16,8,12,59,52,7,56
Peterhead,5025,6,14,7,15,54,52,2,49
East Fife,5025,7,11,9,16,44,46,-2,42
Queen's Park,5025,8,12,5,19,36,55,-19,41
Stranraer,5025,9,11,7,18,47,62,-15,40
Stenhousem'r,5025,10,6,5,25,39,88,-49,23
Livingston,5026,1,18,7,11,70,49,21,61
Brechin,5026,2,19,3,14,53,44,9,60
Alloa,5026,3,17,7,12,71,56,15,58
Airdrieon,5026,4,16,10,10,63,52,11,58
Peterhead,5026,5,15,9,12,56,54,2,54
Albion,5026,6,15,6,15,55,52,3,51
East Fife,5026,7,14,9,13,47,45,2,51
Queen's Park,5026,8,11,11,14,37,49,-12,44
Stranraer,5026,9,11,4,21,48,64,-16,37
Stenhousem'r,5026,10,6,10,20,40,75,-35,28
Livingston,5027,1,25,1,10,68,31,37,76
Alloa,5027,2,23,6,7,65,35,30,75
Airdrieon,5027,3,16,6,14,58,57,1,54
Brechin,5027,4,15,7,14,56,53,3,52
Stranraer,5027,5,14,6,16,51,60,-9,48
Albion,5027,6,13,7,16,48,53,-5,46
Queen's Park,5027,7,13,5,18,38,55,-17,44
Stenhousem'r,5027,8,9,12,15,49,72,-23,39
Peterhead,5027,9,10,8,18,41,53,-12,38
East Fife,5027,10,9,8,19,49,54,-5,35
Livingston,5028,1,22,5,9,77,44,33,71
Airdrieon,5028,2,17,7,12,62,51,11,58
Brechin,5028,3,18,4,14,54,44,10,58
East Fife,5028,4,16,7,13,48,37,11,55
Stranraer,5028,5,16,7,13,62,58,4,55
Albion,5028,6,15,9,12,53,51,2,54
Peterhead,5028,7,14,6,16,42,53,-11,48
Alloa,5028,8,12,7,17,52,51,1,43
Queen's Park,5028,9,12,6,18,43,54,-11,42
Stenhousem'r,5028,10,5,8,23,44,94,-50,23
Alloa,5029,1,22,4,10,79,41,38,70
Livingston,5029,2,20,3,13,72,59,13,63
Peterhead,5029,3,16,5,15,54,52,2,53
Albion,5029,4,12,15,9,55,49,6,51
Brechin,5029,5,15,6,15,48,52,-4,51
Airdrieon,5029,6,15,6,15,54,60,-6,51
Queen's Park,5029,7,13,8,15,40,49,-9,47
Stranraer,5029,8,13,5,18,50,56,-6,44
East Fife,5029,9,11,10,15,48,51,-3,43
Stenhousem'r,5029,10,9,6,21,43,74,-31,33
Livingston,5030,1,23,3,10,82,52,30,72
Alloa,5030,2,17,12,7,72,43,29,63
Peterhead,5030,3,15,8,13,53,48,5,53
Albion,5030,4,13,13,10,60,52,8,52
Airdrieon,5030,5,14,8,14,55,54,1,50
Stranraer,5030,6,15,5,16,46,49,-3,50
East Fife,5030,7,13,8,15,55,53,2,47
Queen's Park,5030,8,12,6,18,35,52,-17,42
Brechin,5030,9,11,7,18,42,67,-25,40
Stenhousem'r,5030,10,6,12,18,43,73,-30,30
Alloa,5031,1,22,6,8,81,42,39,72
Brechin,5031,2,22,6,8,58,32,26,72
Livingston,5031,3,16,6,14,59,51,8,54
Peterhead,5031,4,15,7,14,47,46,1,52
Albion,5031,5,14,9,13,52,50,2,51
Airdrieon,5031,6,12,12,12,56,48,8,48
Stranraer,5031,7,13,6,17,51,61,-10,45
Queen's Park,5031,8,10,11,15,29,51,-22,41
East Fife,5031,9,9,9,18,44,59,-15,36
Stenhousem'r,5031,10,6,10,20,44,81,-37,28
Livingston,5032,1,23,1,12,78,56,22,70
Airdrieon,5032,2,18,5,13,62,53,9,59
Brechin,5032,3,17,6,13,55,44,11,57
Alloa,5032,4,14,12,10,62,44,18,54
Peterhead,5032,5,16,5,15,52,47,5,53
East Fife,5032,6,13,9,14,48,46,2,48
Queen's Park,5032,7,13,7,16,42,55,-13,46
Albion,5032,8,12,8,16,52,61,-9,44
Stranraer,5032,9,13,5,18,48,60,-12,44
Stenhousem'r,5032,10,8,8,20,52,85,-33,32
Livingston,5033,1,21,3,12,76,47,29,66
Alloa,5033,2,19,8,9,66,40,26,65
Airdrieon,5033,3,17,9,10,55,47,8,60
Brechin,5033,4,17,6,13,53,48,5,57
East Fife,5033,5,14,10,12,56,41,15,52
Albion,5033,6,16,4,16,56,52,4,52
Stranraer,5033,7,14,6,16,50,60,-10,48
Peterhead,5033,8,12,9,15,45,54,-9,45
Stenhousem'r,5033,9,8,11,17,47,82,-35,35
Queen's Park,5033,10,6,6,24,33,66,-33,24
Livingston,5034,1,22,6,8,85,49,36,72
Brechin,5034,2,18,9,9,58,48,10,63
Albion,5034,3,16,10,10,61,50,11,58
Alloa,5034,4,15,9,12,64,58,6,54
Airdrieon,5034,5,15,7,14,58,59,-1,52
East Fife,5034,6,12,11,13,54,48,6,47
Peterhead,5034,7,13,7,16,47,52,-5,46
Stranraer,5034,8,13,3,20,49,61,-12,42
Stenhousem'r,5034,9,8,10,18,50,74,-24,34
Queen's Park,5034,10,9,6,21,26,53,-27,33
Livingston,5035,1,22,7,7,85,49,36,73
Alloa,5035,2,18,9,9,70,43,27,63
Airdrieon,5035,3,17,8,11,59,49,10,59
Brechin,5035,4,18,4,14,51,47,4,58
Albion,5035,5,16,7,13,58,52,6,55
Peterhead,5035,6,12,11,13,52,53,-1,47
Stranraer,5035,7,12,9,15,60,64,-4,45
East Fife,5035,8,9,11,16,42,53,-11,38
Queen's Park,5035,9,8,11,17,29,55,-26,35
Stenhousem'r,5035,10,6,7,23,39,80,-41,25
Livingston,5036,1,19,5,12,68,46,22,62
Airdrieon,5036,2,18,7,11,56,51,5,61
Alloa,5036,3,17,8,11,68,49,19,59
Peterhead,5036,4,17,8,11,56,45,11,59
Brechin,5036,5,14,11,11,46,44,2,53
Albion,5036,6,15,6,15,44,42,2,51
Queen's Park,5036,7,12,9,15,34,45,-11,45
East Fife,5036,8,10,10,16,47,49,-2,40
Stranraer,5036,9,11,5,20,45,60,-15,38
Stenhousem'r,5036,10,9,7,20,41,74,-33,34
Brechin,5037,1,21,9,6,57,33,24,72
Airdrieon,5037,2,21,7,8,65,42,23,70
Livingston,5037,3,21,4,11,71,49,22,67
Alloa,5037,4,18,8,10,68,44,24,62
East Fife,5037,5,14,8,14,66,51,15,50
Peterhead,5037,6,15,5,16,49,58,-9,50
Albion,5037,7,11,10,15,45,53,-8,43
Stranraer,5037,8,10,5,21,44,65,-21,35
Queen's Park,5037,9,8,5,23,24,54,-30,29
Stenhousem'r,5037,10,7,7,22,42,82,-40,28
Livingston,5038,1,23,3,10,72,43,29,72
Alloa,5038,2,16,11,9,58,43,15,59
East Fife,5038,3,15,10,11,58,44,14,55
Peterhead,5038,4,15,9,12,57,51,6,54
Queen's Park,5038,5,15,8,13,42,48,-6,53
Airdrieon,5038,6,15,6,15,63,61,2,51
Brechin,5038,7,15,4,17,48,55,-7,49
Albion,5038,8,15,4,17,47,54,-7,49
Stranraer,5038,9,12,6,18,57,63,-6,42
Stenhousem'r,5038,10,6,5,25,50,90,-40,23
Alloa,5039,1,21,7,8,77,40,37,70
Livingston,5039,2,18,6,12,67,43,24,60
Brechin,5039,3,19,3,14,52,46,6,60
Airdrieon,5039,4,17,8,11,58,56,2,59
Albion,5039,5,16,9,11,57,51,6,57
Peterhead,5039,6,14,10,12,56,52,4,52
Stranraer,5039,7,13,3,20,46,62,-16,42
Queen's Park,5039,8,12,6,18,32,53,-21,42
East Fife,5039,9,10,10,16,51,53,-2,40
Stenhousem'r,5039,10,5,8,23,49,89,-40,23
Livingston,5040,1,25,2,9,79,48,31,77
Alloa,5040,2,18,9,9,71,45,26,63
Brechin,5040,3,19,3,14,62,53,9,60
Airdrieon,5040,4,17,6,13,57,51,6,57
Albion,5040,5,13,9,14,61,60,1,48
East Fife,5040,6,12,10,14,49,47,2,46
Peterhead,5040,7,12,8,16,51,61,-10,44
Queen's Park,5040,8,12,6,18,35,61,-26,42
Stranraer,5040,9,11,5,20,59,65,-6,38
Stenhousem'r,5040,10,9,6,21,48,81,-33,33
Alloa,5041,1,19,9,8,66,38,28,66
Airdrieon,5041,2,19,7,10,61,45,16,64
Albion,5041,3,19,5,12,53,44,9,62
Livingston,5041,4,16,9,11,67,48,19,57
Brechin,5041,5,16,7,13,54,55,-1,55
Stranraer,5041,6,13,6,17,51,56,-5,45
Queen's Park,5041,7,11,9,16,38,53,-15,42
East Fife,5041,8,10,9,17,50,53,-3,39
Peterhead,5041,9,10,8,18,42,57,-15,38
Stenhousem'r,5041,10,9,7,20,49,82,-33,34
Alloa,5042,1,19,8,9,68,44,24,65
Airdrieon,5042,2,19,5,12,62,54,8,62
Livingston,5042,3,18,7,11,68,45,23,61
Brechin,5042,4,16,9,11,47,43,4,57
Peterhead,5042,5,14,8,14,54,58,-4,50
Stranraer,5042,6,13,9,14,52,50,2,48
Albion,5042,7,11,12,13,46,49,-3,45
Stenhousem'r,5042,8,9,11,16,37,55,-18,38
East Fife,5042,9,8,12,16,46,53,-7,36
Queen's Park,5042,10,8,9,19,26,55,-29,33
Alloa,5043,1,17,9,10,68,43,25,60
Livingston,5043,2,19,2,15,77,65,12,59
Airdrieon,5043,3,17,6,13,56,55,1,57
Stranraer,5043,4,16,8,12,60,51,9,56
Albion,5043,5,15,10,11,61,55,6,55
Brechin,5043,6,15,9,12,52,44,8,54
Peterhead,5043,7,14,11,11,48,47,1,53
East Fife,5043,8,10,12,14,50,53,-3,42
Queen's Park,5043,9,9,12,15,42,60,-18,39
Stenhousem'r,5043,10,4,9,23,44,85,-41,21
Livingston,5044,1,20,5,11,78,57,21,65
Alloa,5044,2,19,8,9,68,47,21,65
Airdrieon,5044,3,18,4,14,69,64,5,58
Brechin,5044,4,18,3,15,48,45,3,57
Queen's Park,5044,5,14,7,15,37,44,-7,49
Albion,5044,6,13,7,16,58,50,8,46
Peterhead,5044,7,12,10,14,47,56,-9,46
Stranraer,5044,8,11,9,16,55,59,-4,42
Stenhousem'r,5044,9,10,9,17,48,79,-31,39
East Fife,5044,10,9,10,17,51,58,-7,37
Alloa,5045,1,21,5,10,73,45,28,68
Livingston,5045,2,18,5,13,57,37,20,59
Brechin,5045,3,15,11,10,44,39,5,56
Airdrieon,5045,4,17,4,15,51,55,-4,55
Stranraer,5045,5,14,7,15,49,51,-2,49
Peterhead,5045,6,12,10,14,47,50,-3,46
Queen's Park,5045,7,13,7,16,35,47,-12,46
East Fife,5045,8,11,12,13,46,43,3,45
Stenhousem'r,5045,9,11,8,17,54,78,-24,41
Albion,5045,10,9,9,18,48,59,-11,36
Alloa,5046,1,22,6,8,74,40,34,72
Livingston,5046,2,22,6,8,77,45,32,72
Queen's Park,5046,3,17,7,12,50,43,7,58
Brechin,5046,4,14,11,11,54,51,3,53
Airdrieon,5046,5,16,5,15,59,63,-4,53
Peterhead,5046,6,13,8,15,50,52,-2,47
Stranraer,5046,7,12,7,17,49,61,-12,43
Albion,5046,8,10,9,17,45,60,-15,39
East Fife,5046,9,9,8,19,46,56,-10,35
Stenhousem'r,5046,10,6,11,19,42,75,-33,29
Livingston,5047,1,21,5,10,81,46,35,68
Brechin,5047,2,18,5,13,53,45,8,59
Alloa,5047,3,16,8,12,62,45,17,56
Airdrieon,5047,4,17,5,14,65,59,6,56
Albion,5047,5,15,7,14,63,57,6,52
East Fife,5047,6,13,11,12,50,49,1,50
Queen's Park,5047,7,14,8,14,40,49,-9,50
Peterhead,5047,8,11,9,16,46,57,-11,42
Stenhousem'r,5047,9,12,5,19,54,74,-20,41
Stranraer,5047,10,8,7,21,45,78,-33,31
Livingston,5048,1,19,6,11,74,54,20,63
Airdrieon,5048,2,19,6,11,60,46,14,63
Alloa,5048,3,14,13,9,71,47,24,55
Peterhead,5048,4,14,9,13,50,50,0,51
East Fife,5048,5,13,10,13,55,50,5,49
Stranraer,5048,6,12,9,15,49,53,-4,45
Queen's Park,5048,7,12,8,16,38,56,-18,44
Brechin,5048,8,12,7,17,47,64,-17,43
Stenhousem'r,5048,9,11,9,16,49,69,-20,42
Albion,5048,10,10,11,15,49,53,-4,41
Alloa,5049,1,22,8,6,82,38,44,74
Livingston,5049,2,22,6,8,77,41,36,72
Brechin,5049,3,21,4,11,52,46,6,67
Albion,5049,4,13,9,14,47,54,-7,48
Airdrieon,5049,5,12,11,13,50,57,-7,47
Stranraer,5049,6,13,5,18,44,55,-11,44
Peterhead,5049,7,11,8,17,46,54,-8,41
Queen's Park,5049,8,10,9,17,38,51,-13,39
East Fife,5049,9,10,7,19,41,52,-11,37
Stenhousem'r,5049,10,11,3,22,45,74,-29,36
Livingston,5050,1,21,6,9,86,47,39,69
Alloa,5050,2,20,8,8,77,43,34,68
Brechin,5050,3,17,6,13,54,52,2,57
Queen's Park,5050,4,15,6,15,42,49,-7,51
Peterhead,5050,5,15,5,16,57,51,6,50
Airdrieon,5050,6,13,9,14,52,56,-4,48
Stranraer,5050,7,14,5,17,54,58,-4,47
East Fife,5050,8,11,9,16,44,55,-11,42
Albion,5050,9,12,6,18,45,66,-21,42
Stenhousem'r,5050,10,8,8,20,42,76,-34,32
Livingston,5051,1,27,1,8,89,48,41,82
Peterhead,5051,2,18,8,10,59,43,16,62
Brechin,5051,3,16,10,10,53,45,8,58
Alloa,5051,4,15,9,12,62,48,14,54
Airdrieon,5051,5,15,9,12,54,52,2,54
Stranraer,5051,6,16,6,14,60,64,-4,54
Albion,5051,7,11,7,18,45,57,-12,40
Queen's Park,5051,8,11,7,18,35,59,-24,40
East Fife,5051,9,10,9,17,52,60,-8,39
Stenhousem'r,5051,10,5,6,25,44,77,-33,21
Livingston,5052,1,22,4,10,82,53,29,70
Alloa,5052,2,17,12,7,74,44,30,63
Albion,5052,3,15,11,10,64,48,16,56
Queen's Park,5052,4,16,8,12,45,40,5,56
Brechin,5052,5,15,7,14,48,59,-11,52
Airdrieon,5052,6,12,7,17,50,58,-8,43
East Fife,5052,7,12,6,18,43,51,-8,42
Peterhead,5052,8,12,6,18,45,61,-16,42
Stenhousem'r,5052,9,10,9,17,50,68,-18,39
Stranraer,5052,10,11,6,19,45,64,-19,39
Alloa,5053,1,21,7,8,78,40,38,70
Livingston,5053,2,21,5,10,79,56,23,68
Brechin,5053,3,20,2,14,62,54,8,62
Albion,5053,4,17,8,11,59,51,8,59
Airdrieon,5053,5,17,7,12,56,45,11,58
Peterhead,5053,6,13,7,16,47,54,-7,46
East Fife,5053,7,11,11,14,46,43,3,44
Queen's Park,5053,8,12,6,18,37,60,-23,42
Stranraer,5053,9,11,5,20,43,64,-21,38
Stenhousem'r,5053,10,5,6,25,40,80,-40,21
Livingston,5054,1,21,3,12,79,53,26,66
Airdrieon,5054,2,18,9,9,67,55,12,63
Alloa,5054,3,16,10,10,60,46,14,58
Brechin,5054,4,16,10,10,55,47,8,58
Albion,5054,5,13,10,13,65,61,4,49
Peterhead,5054,6,14,4,18,51,53,-2,46
East Fife,5054,7,11,11,14,50,50,0,44
Queen's Park,5054,8,12,6,18,38,57,-19,42
Stranraer,5054,9,8,12,16,44,56,-12,36
Stenhousem'r,5054,10,9,9,18,56,87,-31,36
Alloa,5055,1,20,8,8,72,40,32,68
Livingston,5055,2,20,7,9,70,40,30,67
Albion,5055,3,19,7,10,61,44,17,64
Brechin,5055,4,16,6,14,48,45,3,54
Peterhead,5055,5,15,8,13,51,58,-7,53
Stranraer,5055,6,12,7,17,48,59,-11,43
East Fife,5055,7,9,15,12,56,49,7,42
Airdrieon,5055,8,12,6,18,53,71,-18,42
Queen's Park,5055,9,12,6,18,36,58,-22,42
Stenhousem'r,5055,10,6,8,22,45,76,-31,26
Livingston,5056,1,22,3,11,72,48,24,69
Alloa,5056,2,17,9,10,66,42,24,60
Brechin,5056,3,17,5,14,46,51,-5,56
Airdrieon,5056,4,15,8,13,60,54,6,53
Peterhead,5056,5,14,9,13,53,51,2,51
Stranraer,5056,6,14,4,18,55,57,-2,46
East Fife,5056,7,13,7,16,47,55,-8,46
Albion,5056,8,11,11,14,48,56,-8,44
Queen's Park,5056,9,11,8,17,39,51,-12,41
Stenhousem'r,5056,10,8,12,16,45,66,-21,36
Alloa,5057,1,25,6,5,83,35,48,81
Livingston,5057,2,20,7,9,84,55,29,67
Albion,5057,3,16,9,11,56,51,5,57
Airdrieon,5057,4,17,6,13,60,58,2,57
Peterhead,5057,5,12,12,12,51,48,3,48
Brechin,5057,6,13,8,15,36,41,-5,47
Stranraer,5057,7,10,9,17,51,60,-9,39
East Fife,5057,8,9,10,17,45,60,-15,37
Queen's Park,5057,9,8,10,18,36,57,-21,34
Stenhousem'r,5057,10,6,11,19,54,91,-37,29
Airdrieon,5058,1,22,5,9,76,49,27,71
Alloa,5058,2,20,10,6,84,46,38,70
Livingston,5058,3,15,8,13,59,51,8,53
Albion,5058,4,15,8,13,57,56,1,53
Peterhead,5058,5,12,11,13,53,54,-1,47
Brechin,5058,6,13,8,15,49,55,-6,47
Queen's Park,5058,7,12,9,15,41,52,-11,45
Stranraer,5058,8,12,8,16,45,54,-9,44
East Fife,5058,9,8,10,18,35,50,-15,34
Stenhousem'r,5058,10,9,7,20,49,81,-32,34
Livingston,5059,1,21,6,9,80,52,28,69
Alloa,5059,2,21,6,9,71,43,28,69
Airdrieon,5059,3,15,8,13,60,55,5,53
Brechin,5059,4,14,9,13,52,50,2,51
Stranraer,5059,5,14,6,16,49,54,-5,48
Albion,5059,6,12,9,15,46,52,-6,45
East Fife,5059,7,11,10,15,46,47,-1,43
Queen's Park,5059,8,10,11,15,38,51,-13,41
Stenhousem'r,5059,9,9,13,14,52,75,-23,40
Peterhead,5059,10,8,12,16,38,53,-15,36
Livingston,5060,1,19,6,11,70,45,25,63
Brechin,5060,2,16,8,12,44,41,3,56
East Fife,5060,3,15,9,12,51,42,9,54
Alloa,5060,4,16,6,14,62,55,7,54
Queen's Park,5060,5,15,6,15,40,48,-8,51
Airdrieon,5060,6,13,11,12,65,58,7,50
Albion,5060,7,13,11,12,61,58,3,50
Peterhead,5060,8,15,5,16,48,59,-11,50
Stranraer,5060,9,13,6,17,43,47,-4,45
Stenhousem'r,5060,10,4,14,18,49,80,-31,26
Alloa,5061,1,16,12,8,63,41,22,60
Airdrieon,5061,2,16,11,9,60,57,3,59
Livingston,5061,3,16,8,12,75,57,18,56
Brechin,5061,4,17,5,14,53,48,5,56
Peterhead,5061,5,15,8,13,53,48,5,53
Queen's Park,5061,6,15,8,13,47,54,-7,53
East Fife,5061,7,13,10,13,56,46,10,49
Albion,5061,8,10,11,15,53,64,-11,41
Stranraer,5061,9,10,6,20,44,62,-18,36
Stenhousem'r,5061,10,8,9,19,49,76,-27,33
Livingston,5062,1,19,5,12,79,59,20,62
Brechin,5062,2,18,7,11,56,43,13,61
Alloa,5062,3,16,10,10,74,58,16,58
Airdrieon,5062,4,16,7,13,62,61,1,55
Queen's Park,5062,5,14,11,11,38,41,-3,53
East Fife,5062,6,12,11,13,55,53,2,47
Peterhead,5062,7,11,11,14,56,57,-1,44
Albion,5062,8,10,10,16,49,57,-8,40
Stranraer,5062,9,11,6,19,55,66,-11,39
Stenhousem'r,5062,10,9,10,17,44,73,-29,37
Alloa,5063,1,21,6,9,73,43,30,69
Livingston,5063,2,21,4,11,67,41,26,67
Airdrieon,5063,3,20,6,10,71,53,18,66
Peterhead,5063,4,15,7,14,55,52,3,52
Albion,5063,5,14,9,13,54,50,4,51
Brechin,5063,6,15,6,15,48,49,-1,51
East Fife,5063,7,12,9,15,51,50,1,45
Queen's Park,5063,8,10,9,17,30,50,-20,39
Stranraer,5063,9,10,6,20,45,75,-30,36
Stenhousem'r,5063,10,8,6,22,45,76,-31,30
Livingston,5064,1,21,7,8,80,39,41,70
Alloa,5064,2,18,11,7,74,43,31,65
Airdrieon,5064,3,16,9,11,61,53,8,57
East Fife,5064,4,15,8,13,59,62,-3,53
Albion,5064,5,14,10,12,53,49,4,52
Peterhead,5064,6,11,12,13,54,57,-3,45
Brechin,5064,7,12,7,17,53,61,-8,43
Queen's Park,5064,8,12,7,17,32,51,-19,43
Stranraer,5064,9,11,8,17,58,64,-6,41
Stenhousem'r,5064,10,6,9,21,39,84,-45,27
Livingston,5065,1,19,8,9,70,46,24,65
Airdrieon,5065,2,17,10,9,59,49,10,61
Albion,5065,3,17,9,10,57,39,18,60
Alloa,5065,4,17,9,10,66,49,17,60
East Fife,5065,5,14,9,13,54,42,12,51
Brechin,5065,6,14,8,14,46,46,0,50
Queen's Park,5065,7,12,8,16,41,55,-14,44
Stranraer,5065,8,10,11,15,44,57,-13,41
Peterhead,5065,9,8,10,18,33,52,-19,34
Stenhousem'r,5065,10,6,10,20,41,76,-35,28
Alloa,5066,1,23,5,8,80,39,41,74
Livingston,5066,2,23,3,10,67,38,29,72
Brechin,5066,3,15,7,14,52,56,-4,52
Peterhead,5066,4,14,7,15,50,58,-8,49
Albion,5066,5,13,9,14,44,45,-1,48
Stranraer,5066,6,13,7,16,55,64,-9,46
East Fife,5066,7,11,11,14,53,44,9,44
Airdrieon,5066,8,13,5,18,56,65,-9,44
Stenhousem'r,5066,9,10,9,17,51,74,-23,39
Queen's Park,5066,10,9,9,18,38,63,-25,36
Alloa,5067,1,20,8,8,72,43,29,68
Livingston,5067,2,18,6,12,75,55,20,60
Brechin,5067,3,17,7,12,52,48,4,58
Airdrieon,5067,4,15,8,13,59,59,0,53
Stranraer,5067,5,15,8,13,61,62,-1,53
Peterhead,5067,6,12,10,14,50,50,0,46
East Fife,5067,7,12,7,17,47,53,-6,43
Albion,5067,8,11,8,17,59,61,-2,41
Queen's Park,5067,9,10,9,17,35,54,-19,39
Stenhousem'r,5067,10,9,11,16,53,78,-25,38
Livingston,5068,1,23,3,10,80,52,28,72
Alloa,5068,2,20,8,8,72,35,37,68
Airdrieon,5068,3,17,5,14,65,57,8,56
Brechin,5068,4,15,7,14,44,42,2,52
Peterhead,5068,5,13,9,14,43,48,-5,48
East Fife,5068,6,12,11,13,42,42,0,47
Queen's Park,5068,7,13,8,15,44,53,-9,47
Stranraer,5068,8,14,3,19,42,58,-16,45
Albion,5068,9,10,11,15,43,53,-10,41
Stenhousem'r,5068,10,6,9,21,44,79,-35,27
Livingston,5069,1,24,7,5,85,40,45,79
Airdrieon,5069,2,19,7,10,67,44,23,64
Alloa,5069,3,16,9,11,70,46,24,57
Albion,5069,4,15,9,12,55,53,2,54
Peterhead,5069,5,15,5,16,57,60,-3,50
Brechin,5069,6,13,9,14,48,56,-8,48
Queen's Park,5069,7,14,6,16,43,59,-16,48
East Fife,5069,8,11,10,15,52,51,1,43
Stranraer,5069,9,10,8,18,45,63,-18,38
Stenhousem'r,5069,10,5,6,25,45,95,-50,21
Airdrieon,5070,1,21,6,9,72,48,24,69
Alloa,5070,2,19,7,10,70,48,22,64
East Fife,5070,3,17,9,10,56,43,13,60
Livingston,5070,4,18,4,14,68,53,15,58
Queen's Park,5070,5,16,6,14,47,52,-5,54
Albion,5070,6,12,10,14,56,53,3,46
Stranraer,5070,7,14,2,20,51,59,-8,44
Peterhead,5070,8,12,8,16,43,51,-8,44
Brechin,5070,9,13,3,20,50,63,-13,42
Stenhousem'r,5070,10,8,5,23,36,79,-43,29
Livingston,5071,1,22,4,10,82,49,33,70
Airdrieon,5071,2,19,5,12,67,53,14,62
Alloa,5071,3,16,8,12,67,48,19,56
Brechin,5071,4,15,7,14,51,52,-1,52
Albion,5071,5,15,5,16,57,56,1,50
East Fife,5071,6,13,9,14,53,52,1,48
Queen's Park,5071,7,13,8,15,33,51,-18,47
Stranraer,5071,8,14,2,20,45,60,-15,44
Peterhead,5071,9,11,8,17,47,56,-9,41
Stenhousem'r,5071,10,11,6,19,56,81,-25,39
Livingston,5072,1,21,3,12,71,45,26,66
Peterhead,5072,2,20,5,11,57,49,8,65
Airdrieon,5072,3,17,6,13,70,53,17,57
Alloa,5072,4,16,9,11,63,46,17,57
Brechin,5072,5,14,7,15,40,50,-10,49
Queen's Park,5072,6,14,7,15,29,41,-12,49
Stranraer,5072,7,15,3,18,45,60,-15,48
Albion,5072,8,14,5,17,50,53,-3,47
Stenhousem'r,5072,9,10,7,19,54,71,-17,37
East Fife,5072,10,9,8,19,39,50,-11,35
Livingston,5073,1,21,5,10,66,42,24,68
Brechin,5073,2,17,10,9,61,48,13,61
Alloa,5073,3,16,8,12,72,50,22,56
Albion,5073,4,15,10,11,54,42,12,55
Airdrieon,5073,5,15,9,12,56,54,2,54
Peterhead,5073,6,15,8,13,48,52,-4,53
Queen's Park,5073,7,11,8,17,45,56,-11,41
Stranraer,5073,8,11,7,18,47,66,-19,40
East Fife,5073,9,9,11,16,45,52,-7,38
Stenhousem'r,5073,10,10,4,22,48,80,-32,34
Alloa,5074,1,18,7,11,74,55,19,61
Livingston,5074,2,18,6,12,77,56,21,60
Albion,5074,3,16,10,10,54,42,12,58
Brechin,5074,4,16,9,11,51,44,7,57
Airdrieon,5074,5,15,7,14,69,64,5,52
East Fife,5074,6,12,12,12,51,47,4,48
Peterhead,5074,7,13,8,15,51,59,-8,47
Queen's Park,5074,8,14,5,17,38,54,-16,47
Stranraer,5074,9,13,7,16,59,59,0,46
Stenhousem'r,5074,10,6,7,23,38,82,-44,25
Livingston,5075,1,19,7,10,79,56,23,64
Alloa,5075,2,18,9,9,71,44,27,63
Brechin,5075,3,18,8,10,57,44,13,62
Airdrieon,5075,4,15,12,9,56,49,7,57
Albion,5075,5,14,9,13,50,41,9,51
Queen's Park,5075,6,15,6,15,44,50,-6,51
Stranraer,5075,7,12,7,17,56,66,-10,43
Peterhead,5075,8,10,12,14,51,62,-11,42
Stenhousem'r,5075,9,8,9,19,46,79,-33,33
East Fife,5075,10,6,11,19,42,61,-19,29
Alloa,5076,1,19,9,8,70,40,30,66
Livingston,5076,2,18,9,9,73,44,29,63
Airdrieon,5076,3,18,7,11,63,54,9,61
Albion,5076,4,15,12,9,58,44,14,57
Brechin,5076,5,16,6,14,45,44,1,54
Queen's Park,5076,6,14,7,15,38,56,-18,49
Peterhead,5076,7,12,10,14,51,55,-4,46
Stranraer,5076,8,12,6,18,47,60,-13,42
East Fife,5076,9,8,9,19,48,56,-8,33
Stenhousem'r,5076,10,7,7,22,45,85,-40,28
Alloa,5077,1,21,7,8,71,43,28,70
Airdrieon,5077,2,18,8,10,64,51,13,62
Brechin,5077,3,18,6,12,50,42,8,60
Livingston,5077,4,18,5,13,76,55,21,59
Stranraer,5077,5,16,3,17,52,54,-2,51
Albion,5077,6,14,8,14,53,56,-3,50
Queen's Park,5077,7,14,4,18,41,50,-9,46
East Fife,5077,8,12,8,16,56,55,1,44
Peterhead,5077,9,12,8,16,44,51,-7,44
Stenhousem'r,5077,10,6,5,25,37,87,-50,23
Livingston,5078,1,22,4,10,82,47,35,70
Alloa,5078,2,21,6,9,77,39,38,69
Brechin,5078,3,17,7,12,53,43,10,58
Airdrieon,5078,4,14,9,13,55,55,0,51
East Fife,5078,5,12,13,11,44,38,6,49
Albion,5078,6,14,7,15,47,55,-8,49
Peterhead,5078,7,12,7,17,37,53,-16,43
Stranraer,5078,8,11,9,16,48,62,-14,42
Queen's Park,5078,9,10,7,19,33,54,-21,37
Stenhousem'r,5078,10,7,11,18,42,72,-30,32
Airdrieon,5079,1,18,7,11,62,58,4,61
Queen's Park,5079,2,17,9,10,43,38,5,60
Livingston,5079,3,17,7,12,74,58,16,58
Alloa,5079,4,15,10,11,55,39,16,55
Brechin,5079,5,15,9,12,44,41,3,54
Albion,5079,6,13,12,11,50,52,-2,51
Stranraer,5079,7,14,4,18,53,54,-1,46
East Fife,5079,8,10,11,15,52,46,6,41
Peterhead,5079,9,10,10,16,37,52,-15,40
Stenhousem'r,5079,10,8,7,21,44,76,-32,31
Airdrieon,5080,1,18,7,11,67,45,22,61
Albion,5080,2,18,7,11,63,50,13,61
Alloa,5080,3,16,11,9,72,48,24,59
Brechin,5080,4,17,6,13,50,55,-5,57
Livingston,5080,5,16,5,15,70,56,14,53
Peterhead,5080,6,16,5,15,53,60,-7,53
Queen's Park,5080,7,13,9,14,43,48,-5,48
Stranraer,5080,8,13,5,18,48,58,-10,44
Stenhousem'r,5080,9,10,6,20,53,87,-34,36
East Fife,5080,10,8,9,19,43,55,-12,33
Alloa,5081,1,21,5,10,64,43,21,68
Livingston,5081,2,19,6,11,78,53,25,63
Peterhead,5081,3,16,9,11,55,53,2,57
Airdrieon,5081,4,15,8,13,59,52,7,53
Albion,5081,5,14,11,11,49,44,5,53
Brechin,5081,6,14,9,13,45,42,3,51
East Fife,5081,7,12,10,14,41,40,1,46
Queen's Park,5081,8,13,6,17,38,51,-13,45
Stranraer,5081,9,11,6,19,53,64,-11,39
Stenhousem'r,5081,10,6,8,22,49,89,-40,26
Alloa,5082,1,21,6,9,70,42,28,69
Livingston,5082,2,19,6,11,71,47,24,63
Peterhead,5082,3,19,6,11,59,45,14,63
Airdrieon,5082,4,18,3,15,61,57,4,57
Albion,5082,5,15,7,14,60,58,2,52
Brechin,5082,6,16,3,17,54,63,-9,51
East Fife,5082,7,14,8,14,53,47,6,50
Stranraer,5082,8,11,5,20,52,61,-9,38
Queen's Park,5082,9,11,5,20,39,63,-24,38
Stenhousem'r,5082,10,9,5,22,47,83,-36,32
Livingston,5083,1,22,3,11,80,46,34,69
Airdrieon,5083,2,20,6,10,68,42,26,66
Alloa,5083,3,18,6,12,72,45,27,60
Brechin,5083,4,16,6,14,45,45,0,54
Peterhead,5083,5,15,8,13,47,43,4,53
Albion,5083,6,16,5,15,53,60,-7,53
Stranraer,5083,7,14,3,19,49,63,-14,45
East Fife,5083,8,12,7,17,48,60,-12,43
Queen's Park,5083,9,10,6,20,30,57,-27,36
Stenhousem'r,5083,10,8,8,20,49,80,-31,32
Livingston,5084,1,23,4,9,78,43,35,73
Alloa,5084,2,21,8,7,77,38,39,71
Airdrieon,5084,3,17,6,13,58,55,3,57
Albion,5084,4,16,8,12,60,58,2,56
Peterhead,5084,5,15,8,13,49,54,-5,53
East Fife,5084,6,12,10,14,58,52,6,46
Queen's Park,5084,7,13,5,18,47,54,-7,44
Stranraer,5084,8,12,4,20,51,63,-12,40
Brechin,5084,9,10,6,20,42,64,-22,36
Stenhousem'r,5084,10,8,7,21,44,83,-39,31
Livingston,5085,1,22,2,12,72,43,29,68
Alloa,5085,2,19,6,11,64,41,23,63
Airdrieon,5085,3,18,7,11,65,51,14,61
Brechin,5085,4,19,3,14,50,47,3,60
Queen's Park,5085,5,16,6,14,43,48,-5,54
Peterhead,5085,6,14,10,12,50,50,0,52
Stranraer,5085,7,13,7,16,49,56,-7,46
Albion,5085,8,10,7,19,50,65,-15,37
East Fife,5085,9,8,11,17,48,56,-8,35
Stenhousem'r,5085,10,7,9,20,50,84,-34,30
Alloa,5086,1,19,9,8,72,43,29,66
Livingston,5086,2,20,3,13,83,55,28,63
Albion,5086,3,16,11,9,63,42,21,59
Peterhead,5086,4,15,9,12,51,48,3,54
Airdrieon,5086,5,15,7,14,54,55,-1,52
Brechin,5086,6,14,8,14,48,56,-8,50
Stranraer,5086,7,13,8,15,59,60,-1,47
East Fife,5086,8,11,8,17,52,56,-4,41
Queen's Park,5086,9,9,11,16,38,64,-26,38
Stenhousem'r,5086,10,7,8,21,44,85,-41,29
Livingston,5087,1,23,4,9,84,47,37,73
Alloa,5087,2,21,3,12,74,51,23,66
Airdrieon,5087,3,19,7,10,61,49,12,64
Albion,5087,4,14,11,11,52,52,0,53
Brechin,5087,5,13,9,14,40,45,-5,48
Peterhead,5087,6,14,5,17,50,51,-1,47
Queen's Park,5087,7,13,8,15,42,50,-8,47
East Fife,5087,8,11,10,15,45,50,-5,43
Stranraer,5087,9,9,6,21,45,65,-20,33
Stenhousem'r,5087,10,7,9,20,46,79,-33,30
Livingston,5088,1,21,7,8,83,52,31,70
Alloa,5088,2,17,9,10,56,36,20,60
Airdrieon,5088,3,17,6,13,56,53,3,57
Albion,5088,4,15,7,14,49,48,1,52
Stranraer,5088,5,14,7,15,57,53,4,49
Queen's Park,5088,6,14,5,17,39,55,-16,47
East Fife,5088,7,12,10,14,58,51,7,46
Brechin,5088,8,13,6,17,44,54,-10,45
Peterhead,5088,9,12,8,16,60,62,-2,44
Stenhousem'r,5088,10,8,9,19,53,91,-38,33
Livingston,5089,1,22,4,10,90,58,32,70
Alloa,5089,2,17,9,10,66,49,17,60
Stranraer,5089,3,16,6,14,54,53,1,54
Airdrieon,5089,4,15,7,14,57,52,5,52
Albion,5089,5,14,9,13,53,49,4,51
Brechin,5089,6,14,5,17,47,58,-11,47
Peterhead,5089,7,12,10,14,50,55,-5,46
East Fife,5089,8,12,8,16,48,53,-5,44
Queen's Park,5089,9,11,10,15,42,52,-10,43
Stenhousem'r,5089,10,7,12,17,43,71,-28,33
Alloa,5090,1,18,13,5,71,37,34,67
Livingston,5090,2,20,4,12,66,50,16,64
Airdrieon,5090,3,18,10,8,61,47,14,64
Brechin,5090,4,14,8,14,56,60,-4,50
Peterhead,5090,5,13,10,13,47,44,3,49
Queen's Park,5090,6,13,6,17,39,54,-15,45
Albion,5090,7,10,14,12,45,45,0,44
Stenhousem'r,5090,8,10,9,17,40,67,-27,39
Stranraer,5090,9,10,8,18,48,55,-7,38
East Fife,5090,10,8,10,18,46,60,-14,34
Livingston,5091,1,22,7,7,76,38,38,73
Alloa,5091,2,18,8,10,67,42,25,62
Brechin,5091,3,16,9,11,54,49,5,57
East Fife,5091,4,13,10,13,54,50,4,49
Queen's Park,5091,5,14,7,15,38,47,-9,49
Airdrieon,5091,6,14,6,16,58,64,-6,48
Albion,5091,7,12,9,15,52,55,-3,45
Stranraer,5091,8,13,5,18,50,63,-13,44
Peterhead,5091,9,12,5,19,50,57,-7,41
Stenhousem'r,5091,10,8,10,18,48,82,-34,34
Livingston,5092,1,22,5,9,71,39,32,71
Queen's Park,5092,2,19,5,12,45,38,7,62
Alloa,5092,3,17,7,12,68,49,19,58
Brechin,5092,4,17,5,14,53,44,9,56
Airdrieon,5092,5,14,8,14,53,55,-2,50
Albion,5092,6,13,9,14,52,57,-5,48
Stranraer,5092,7,15,2,19,48,59,-11,47
Peterhead,5092,8,13,6,17,43,50,-7,45
East Fife,5092,9,8,11,17,44,52,-8,35
Stenhousem'r,5092,10,9,8,19,51,85,-34,35
Alloa,5093,1,22,7,7,78,44,34,73
Livingston,5093,2,19,7,10,73,45,28,64
Airdrieon,5093,3,16,9,11,52,55,-3,57
Albion,5093,4,14,11,11,68,54,14,53
Brechin,5093,5,14,7,15,49,55,-6,49
Queen's Park,5093,6,13,10,13,44,52,-8,49
Stranraer,5093,7,12,8,16,55,66,-11,44
Peterhead,5093,8,11,10,15,59,62,-3,43
Stenhousem'r,5093,9,10,5,21,45,76,-31,35
East Fife,5093,10,8,8,20,43,57,-14,32
Livingston,5094,1,20,7,9,77,50,27,67
Airdrieon,5094,2,17,9,10,67,54,13,60
Alloa,5094,3,15,12,9,67,42,25,57
Brechin,5094,4,14,11,11,53,49,4,53
East Fife,5094,5,14,7,15,55,58,-3,49
Albion,5094,6,13,9,14,52,54,-2,48
Peterhead,5094,7,13,8,15,48,54,-6,47
Queen's Park,5094,8,11,11,14,44,55,-11,44
Stranraer,5094,9,11,10,15,48,57,-9,43
Stenhousem'r,5094,10,7,6,23,50,88,-38,27
Alloa,5095,1,19,9,8,65,41,24,66
Airdrieon,5095,2,18,9,9,54,45,9,63
Livingston,5095,3,19,4,13,78,48,30,61
Stranraer,5095,4,18,5,13,60,48,12,59
Albion,5095,5,12,9,15,50,52,-2,45
East Fife,5095,6,11,11,14,45,51,-6,44
Queen's Park,5095,7,12,7,17,34,48,-14,43
Brechin,5095,8,12,6,18,49,61,-12,42
Peterhead,5095,9,11,9,16,41,54,-13,42
Stenhousem'r,5095,10,8,11,17,53,81,-28,35
Alloa,5096,1,21,5,10,83,47,36,68
Livingston,5096,2,21,4,11,71,45,26,67
Airdrieon,5096,3,18,7,11,59,52,7,61
Albion,5096,4,14,14,8,60,44,16,56
Brechin,5096,5,14,10,12,52,50,2,52
Peterhead,5096,6,13,10,13,44,45,-1,49
East Fife,5096,7,11,10,15,45,47,-2,43
Stranraer,5096,8,10,9,17,49,60,-11,39
Queen's Park,5096,9,7,10,19,28,64,-36,31
Stenhousem'r,5096,10,7,9,20,46,83,-37,30
Alloa,5097,1,18,10,8,65,45,20,64
Brechin,5097,2,18,7,11,52,43,9,61
Albion,5097,3,18,5,13,61,51,10,59
Livingston,5097,4,18,4,14,69,57,12,58
Airdrieon,5097,5,16,6,14,59,50,9,54
East Fife,5097,6,13,8,15,50,45,5,47
Stranraer,5097,7,14,5,17,62,66,-4,47
Peterhead,5097,8,12,8,16,38,49,-11,44
Stenhousem'r,5097,9,10,7,19,53,70,-17,37
Queen's Park,5097,10,10,6,20,29,62,-33,36
Livingston,5098,1,22,1,13,88,57,31,67
Alloa,5098,2,18,8,10,63,41,22,62
Peterhead,5098,3,16,9,11,45,47,-2,57
Brechin,5098,4,16,8,12,42,39,3,56
Albion,5098,5,15,6,15,61,57,4,51
Stranraer,5098,6,14,7,15,53,57,-4,49
Airdrieon,5098,7,13,7,16,55,59,-4,46
Queen's Park,5098,8,13,6,17,41,56,-15,45
East Fife,5098,9,8,12,16,42,49,-7,36
Stenhousem'r,5098,10,9,8,19,42,70,-28,35
Livingston,5099,1,21,6,9,81,50,31,69
Alloa,5099,2,16,11,9,62,45,17,59
Airdrieon,5099,3,16,10,10,60,54,6,58
East Fife,5099,4,15,7,14,52,37,15,52
Peterhead,5099,5,14,8,14,54,49,5,50
Albion,5099,6,12,12,12,53,48,5,48
Brechin,5099,7,13,8,15,39,52,-13,47
Queen's Park,5099,8,12,6,18,32,55,-23,42
Stenhousem'r,5099,9,9,10,17,48,70,-22,37
Stranraer,5099,10,10,6,20,46,67,-21,36
Livingston,5100,1,22,4,10,81,46,35,70
Brechin,5100,2,19,7,10,61,46,15,64
Alloa,5100,3,18,8,10,78,54,24,62
Airdrieon,5100,4,18,6,12,61,51,10,60
Queen's Park,5100,5,12,12,12,39,47,-8,48
Albion,5100,6,11,11,14,48,51,-3,44
Stranraer,5100,7,12,5,19,55,75,-20,41
Peterhead,5100,8,10,10,16,46,58,-12,40
East Fife,5100,9,10,9,17,44,52,-8,39
Stenhousem'r,5100,10,6,12,18,41,74,-33,30
Livingston,5101,1,20,5,11,74,46,28,65
Alloa,5101,2,18,9,9,70,45,25,63
Peterhead,5101,3,18,6,12,55,51,4,60
Airdrieon,5101,4,16,8,12,69,60,9,56
Albion,5101,5,15,8,13,61,54,7,53
Queen's Park,5101,6,15,7,14,44,49,-5,52
Brechin,5101,7,14,7,15,50,53,-3,49
East Fife,5101,8,12,10,14,53,55,-2,46
Stranraer,5101,9,12,4,20,45,65,-20,40
Stenhousem'r,5101,10,4,8,24,40,83,-43,20
Livingston,5102,1,21,4,11,76,52,24,67
Alloa,5102,2,19,6,11,64,41,23,63
Albion,5102,3,17,8,11,56,47,9,59
Brechin,5102,4,18,3,15,46,48,-2,57
Airdrieon,5102,5,16,5,15,64,57,7,53
Peterhead,5102,6,13,7,16,46,53,-7,46
Stranraer,5102,7,12,8,16,48,57,-9,44
Queen's Park,5102,8,11,11,14,32,47,-15,44
East Fife,5102,9,11,10,15,43,42,1,43
Stenhousem'r,5102,10,7,8,21,48,79,-31,29
Livingston,5103,1,23,4,9,83,55,28,73
Alloa,5103,2,16,11,9,66,40,26,59
Brechin,5103,3,15,10,11,52,48,4,55
Airdrieon,5103,4,16,7,13,52,52,0,55
Albion,5103,5,15,9,12,61,52,9,54
Peterhead,5103,6,15,7,14,54,54,0,52
East Fife,5103,7,12,9,15,50,48,2,45
Queen's Park,5103,8,11,9,16,39,56,-17,42
Stranraer,5103,9,10,7,19,45,63,-18,37
Stenhousem'r,5103,10,6,9,21,43,77,-34,27
Livingston,5104,1,21,3,12,78,49,29,66
Alloa,5104,2,16,11,9,72,45,27,59
Albion,5104,3,16,8,12,60,45,15,56
Airdrieon,5104,4,16,5,15,60,64,-4,53
Brechin,5104,5,16,4,16,41,50,-9,52
Peterhead,5104,6,14,9,13,49,58,-9,51
Stranraer,5104,7,16,2,18,51,59,-8,50
East Fife,5104,8,13,9,14,48,42,6,48
Queen's Park,5104,9,11,12,13,43,49,-6,45
Stenhousem'r,5104,10,7,5,24,37,78,-41,26
Livingston,5105,1,23,3,10,79,40,39,72
Alloa,5105,2,22,6,8,72,41,31,72
Airdrieon,5105,3,18,8,10,67,51,16,62
Brechin,5105,4,16,8,12,56,47,9,56
Queen's Park,5105,5,15,7,14,38,41,-3,52
Albion,5105,6,12,10,14,51,61,-10,46
Peterhead,5105,7,12,8,16,38,55,-17,44
East Fife,5105,8,9,9,18,45,60,-15,36
Stranraer,5105,9,9,8,19,45,59,-14,35
Stenhousem'r,5105,10,7,7,22,57,93,-36,28
Livingston,5106,1,23,5,8,78,41,37,74
Alloa,5106,2,17,7,12,66,43,23,58
Albion,5106,3,17,7,12,56,45,11,58
Airdrieon,5106,4,18,3,15,58,58,0,57
Queen's Park,5106,5,16,6,14,42,47,-5,54
Peterhead,5106,6,16,5,15,46,50,-4,53
Brechin,5106,7,15,7,14,47,53,-6,52
Stranraer,5106,8,13,7,16,47,50,-3,46
East Fife,5106,9,10,10,16,45,46,-1,40
Stenhousem'r,5106,10,4,5,27,40,92,-52,17
Livingston,5107,1,21,4,11,77,50,27,67
Alloa,5107,2,19,6,11,77,49,28,63
Airdrieon,5107,3,18,7,11,70,58,12,61
Albion,5107,4,17,6,13,56,54,2,57
Peterhead,5107,5,15,5,16,51,56,-5,50
Brechin,5107,6,15,4,17,48,48,0,49
East Fife,5107,7,11,10,15,52,52,0,43
Queen's Park,5107,8,12,7,17,38,59,-21,43
Stranraer,5107,9,11,8,17,46,59,-13,41
Stenhousem'r,5107,10,8,9,19,44,74,-30,33
Livingston,5108,1,21,5,10,81,53,28,68
Alloa,5108,2,20,7,9,61,41,20,67
Brechin,5108,3,17,5,14,48,43,5,56
Airdrieon,5108,4,16,7,13,64,57,7,55
Stranraer,5108,5,16,6,14,54,49,5,54
Albion,5108,6,14,5,17,55,56,-1,47
Peterhead,5108,7,11,11,14,49,52,-3,44
East Fife,5108,8,12,8,16,40,43,-3,44
Stenhousem'r,5108,9,11,7,18,47,71,-24,40
Queen's Park,5108,10,9,5,22,25,59,-34,32
Airdrieon,5109,1,21,5,10,67,47,20,68
Alloa,5109,2,18,9,9,68,41,27,63
Peterhead,5109,3,15,9,12,54,50,4,54
Livingston,5109,4,15,7,14,64,46,18,52
Albion,5109,5,14,8,14,46,46,0,50
Brechin,5109,6,13,9,14,46,57,-11,48
Queen's Park,5109,7,13,7,16,43,55,-12,46
Stranraer,5109,8,12,8,16,45,59,-14,44
East Fife,5109,9,10,13,13,45,44,1,43
Stenhousem'r,5109,10,7,9,20,44,77,-33,30
Alloa,5110,1,19,6,11,73,46,27,63
Airdrieon,5110,2,19,6,11,58,50,8,63
Livingston,5110,3,18,4,14,72,55,17,58
Brechin,5110,4,17,7,12,53,42,11,58
Albion,5110,5,14,11,11,56,51,5,53
Stranraer,5110,6,13,6,17,50,59,-9,45
Peterhead,5110,7,12,9,15,54,65,-11,45
East Fife,5110,8,10,12,14,56,54,2,42
Queen's Park,5110,9,12,5,19,37,57,-20,41
Stenhousem'r,5110,10,9,8,19,55,85,-30,35
Albion,5111,1,21,4,11,70,51,19,67
Livingston,5111,2,20,2,14,74,48,26,62
Airdrieon,5111,3,18,5,13,61,56,5,59
Alloa,5111,4,16,7,13,81,65,16,55
Peterhead,5111,5,15,9,12,53,52,1,54
East Fife,5111,6,15,8,13,52,42,10,53
Brechin,5111,7,15,4,17,48,46,2,49
Queen's Park,5111,8,15,3,18,44,62,-18,48
Stranraer,5111,9,10,4,22,43,68,-25,34
Stenhousem'r,5111,10,9,6,21,43,79,-36,33
Livingston,5112,1,21,5,10,73,49,24,68
Alloa,5112,2,18,9,9,69,44,25,63
Airdrieon,5112,3,18,7,11,65,48,17,61
East Fife,5112,4,16,7,13,55,47,8,55
Brechin,5112,5,14,5,17,45,49,-4,47
Peterhead,5112,6,14,5,17,49,57,-8,47
Stranraer,5112,7,12,8,16,56,61,-5,44
Albion,5112,8,11,11,14,44,49,-5,44
Queen's Park,5112,9,12,8,16,33,52,-19,44
Stenhousem'r,5112,10,7,9,20,45,78,-33,30
Albion,5113,1,19,7,10,57,43,14,64
Livingston,5113,2,19,4,13,80,50,30,61
Brechin,5113,3,17,7,12,55,46,9,58
Alloa,5113,4,15,12,9,61,47,14,57
Peterhead,5113,5,14,9,13,54,52,2,51
Airdrieon,5113,6,14,8,14,53,57,-4,50
Queen's Park,5113,7,13,9,14,35,52,-17,48
Stenhousem'r,5113,8,13,7,16,55,75,-20,46
East Fife,5113,9,8,9,19,42,51,-9,33
Stranraer,5113,10,7,10,19,45,64,-19,31
Alloa,5114,1,22,6,8,83,40,43,72
Livingston,5114,2,21,5,10,68,43,25,68
Peterhead,5114,3,15,8,13,44,49,-5,53
Airdrieon,5114,4,15,7,14,45,49,-4,52
Brechin,5114,5,14,9,13,46,47,-1,51
Queen's Park,5114,6,15,4,17,41,48,-7,49
East Fife,5114,7,12,9,15,48,43,5,45
Albion,5114,8,12,8,16,41,49,-8,44
Stranraer,5114,9,12,7,17,49,54,-5,43
Stenhousem'r,5114,10,6,9,21,40,83,-43,27
Livingston,5115,1,22,6,8,86,45,41,72
Alloa,5115,2,21,6,9,79,44,35,69
Brechin,5115,3,17,5,14,46,47,-1,56
Airdrieon,5115,4,17,5,14,57,60,-3,56
Queen's Park,5115,5,14,8,14,35,47,-12,50
East Fife,5115,6,13,10,13,56,48,8,49
Peterhead,5115,7,14,5,17,48,50,-2,47
Albion,5115,8,13,6,17,54,62,-8,45
Stranraer,5115,9,9,6,21,52,66,-14,33
Stenhousem'r,5115,10,8,7,21,41,85,-44,31
Livingston,5116,1,22,2,12,81,51,30,68
Alloa,5116,2,18,11,7,62,39,23,65
Airdrieon,5116,3,16,6,14,51,54,-3,54
Albion,5116,4,14,10,12,63,59,4,52
Brechin,5116,5,14,6,16,47,48,-1,48
Peterhead,5116,6,12,12,12,47,50,-3,48
Stranraer,5116,7,14,4,18,52,56,-4,46
Queen's Park,5116,8,11,10,15,38,50,-12,43
East Fife,5116,9,11,9,16,37,43,-6,42
Stenhousem'r,5116,10,10,6,20,51,79,-28,36
Livingston,5117,1,21,5,10,76,50,26,68
Alloa,5117,2,19,8,9,67,47,20,65
Airdrieon,5117,3,16,11,9,59,49,10,59
Brechin,5117,4,18,4,14,50,47,3,58
Peterhead,5117,5,15,8,13,63,50,13,53
Queen's Park,5117,6,14,8,14,43,48,-5,50
Albion,5117,7,15,4,17,56,54,2,49
East Fife,5117,8,12,7,17,51,53,-2,43
Stranraer,5117,9,11,6,19,46,67,-21,39
Stenhousem'r,5117,10,6,5,25,46,92,-46,23
Alloa,5118,1,20,9,7,71,38,33,69
Brechin,5118,2,20,4,12,49,40,9,64
Livingston,5118,3,20,3,13,75,49,26,63
Albion,5118,4,15,9,12,61,54,7,54
Queen's Park,5118,5,14,8,14,47,53,-6,50
Airdrieon,5118,6,14,6,16,50,59,-9,48
Peterhead,5118,7,11,12,13,49,52,-3,45
East Fife,5118,8,10,11,15,52,62,-10,41
Stranraer,5118,9,12,5,19,51,62,-11,41
Stenhousem'r,5118,10,9,3,24,50,86,-36,30
Livingston,5119,1,22,5,9,81,48,33,71
Airdrieon,5119,2,20,7,9,62,47,15,67
Alloa,5119,3,16,9,11,66,50,16,57
Stranraer,5119,4,17,5,14,57,53,4,56
Albion,5119,5,14,10,12,59,56,3,52
Brechin,5119,6,15,5,16,47,54,-7,50
Queen's Park,5119,7,13,9,14,47,46,1,48
Peterhead,5119,8,13,5,18,47,51,-4,44
East Fife,5119,9,8,10,18,44,53,-9,34
Stenhousem'r,5119,10,5,9,22,36,88,-52,24
Alloa,5120,1,22,9,5,76,42,34,75
Livingston,5120,2,20,5,11,76,56,20,65
Albion,5120,3,14,11,11,53,51,2,53
Brechin,5120,4,14,11,11,50,48,2,53
Airdrieon,5120,5,14,7,15,62,62,0,49
Peterhead,5120,6,13,9,14,54,58,-4,48
East Fife,5120,7,13,8,15,54,53,1,47
Stranraer,5120,8,11,8,17,54,63,-9,41
Queen's Park,5120,9,9,9,18,30,49,-19,36
Stenhousem'r,5120,10,7,9,20,40,67,-27,30
Livingston,5121,1,19,7,10,73,41,32,64
Alloa,5121,2,17,10,9,66,45,21,61
Airdrieon,5121,3,18,6,12,49,55,-6,60
Albion,5121,4,16,7,13,50,49,1,55
Peterhead,5121,5,15,8,13,61,47,14,53
Brechin,5121,6,16,5,15,44,47,-3,53
Queen's Park,5121,7,14,8,14,42,45,-3,50
Stranraer,5121,8,12,7,17,56,65,-9,43
East Fife,5121,9,10,7,19,45,49,-4,37
Stenhousem'r,5121,10,6,9,21,41,84,-43,27
Livingston,5122,1,24,2,10,82,41,41,74
Alloa,5122,2,20,8,8,66,41,25,68
Brechin,5122,3,17,9,10,51,42,9,60
Airdrieon,5122,4,16,5,15,49,47,2,53
Stranraer,5122,5,15,5,16,49,58,-9,50
Albion,5122,6,13,8,15,49,57,-8,47
Peterhead,5122,7,12,10,14,52,50,2,46
Queen's Park,5122,8,12,8,16,37,44,-7,44
East Fife,5122,9,9,9,18,47,56,-9,36
Stenhousem'r,5122,10,8,4,24,41,87,-46,28
Livingston,5123,1,21,7,8,72,44,28,70
Brechin,5123,2,20,7,9,59,40,19,67
Alloa,5123,3,17,10,9,71,45,26,61
Airdrieon,5123,4,17,10,9,63,52,11,61
Stranraer,5123,5,14,6,16,48,53,-5,48
Peterhead,5123,6,12,8,16,47,54,-7,44
East Fife,5123,7,12,7,17,55,54,1,43
Albion,5123,8,10,12,14,51,55,-4,42
Queen's Park,5123,9,12,6,18,39,63,-24,42
Stenhousem'r,5123,10,5,7,24,33,78,-45,22
Livingston,5124,1,22,5,9,79,47,32,71
Brechin,5124,2,16,9,11,51,45,6,57
Alloa,5124,3,16,7,13,64,46,18,55
Airdrieon,5124,4,15,10,11,54,50,4,55
Peterhead,5124,5,16,7,13,51,48,3,55
Albion,5124,6,14,10,12,54,60,-6,52
Queen's Park,5124,7,12,11,13,44,46,-2,47
Stranraer,5124,8,11,7,18,54,62,-8,40
East Fife,5124,9,8,12,16,46,61,-15,36
Stenhousem'r,5124,10,6,10,20,46,78,-32,28
Livingston,5125,1,24,3,9,93,52,41,75
Alloa,5125,2,21,5,10,71,41,30,68
Airdrieon,5125,3,18,4,14,63,57,6,58
Brechin,5125,4,15,7,14,53,55,-2,52
Stranraer,5125,5,14,5,17,53,61,-8,47
Queen's Park,5125,6,14,5,17,44,61,-17,47
Albion,5125,7,12,8,16,51,56,-5,44
Peterhead,5125,8,11,9,16,50,60,-10,42
East Fife,5125,9,10,11,15,51,53,-2,41
Stenhousem'r,5125,10,9,7,20,51,84,-33,34
Alloa,5126,1,26,4,6,78,32,46,82
Livingston,5126,2,19,5,12,72,46,26,62
Brechin,5126,3,17,7,12,56,46,10,58
Stranraer,5126,4,17,4,15,59,52,7,55
Albion,5126,5,15,7,14,55,56,-1,52
Airdrieon,5126,6,15,7,14,55,60,-5,52
Peterhead,5126,7,13,6,17,46,57,-11,45
Queen's Park,5126,8,11,5,20,37,60,-23,38
East Fife,5126,9,9,8,19,45,55,-10,35
Stenhousem'r,5126,10,7,9,20,40,79,-39,30
Livingston,5127,1,22,5,9,81,54,27,71
Alloa,5127,2,18,8,10,78,49,29,62
Peterhead,5127,3,15,10,11,56,49,7,55
East Fife,5127,4,13,13,10,59,49,10,52
Albion,5127,5,15,6,15,58,55,3,51
Airdrieon,5127,6,15,5,16,49,59,-10,50
Queen's Park,5127,7,13,7,16,46,57,-11,46
Brechin,5127,8,13,7,16,43,54,-11,46
Stranraer,5127,9,12,4,20,45,57,-12,40
Stenhousem'r,5127,10,9,5,22,47,79,-32,32
Livingston,5128,1,18,7,11,73,60,13,61
Albion,5128,2,15,9,12,49,42,7,54
Peterhead,5128,3,16,6,14,54,48,6,54
Airdrieon,5128,4,16,6,14,55,51,4,54
Brechin,5128,5,16,6,14,45,49,-4,54
East Fife,5128,6,13,12,11,58,49,9,51
Alloa,5128,7,15,5,16,64,56,8,50
Stranraer,5128,8,14,7,15,53,55,-2,49
Queen's Park,5128,9,12,7,17,36,50,-14,43
Stenhousem'r,5128,10,8,9,19,46,73,-27,33
Airdrieon,5129,1,20,8,8,74,55,19,68
Alloa,5129,2,17,11,8,68,47,21,62
Livingston,5129,3,16,6,14,74,57,17,54
Brechin,5129,4,14,10,12,51,47,4,52
East Fife,5129,5,11,14,11,57,53,4,47
Peterhead,5129,6,12,10,14,50,55,-5,46
Albion,5129,7,12,10,14,55,61,-6,46
Stranraer,5129,8,12,7,17,51,63,-12,43
Queen's Park,5129,9,11,8,17,39,58,-19,41
Stenhousem'r,5129,10,8,10,18,64,87,-23,34
Livingston,5130,1,21,4,11,75,46,29,67
Alloa,5130,2,16,12,8,67,45,22,60
Airdrieon,5130,3,18,6,12,61,56,5,60
Brechin,5130,4,15,10,11,56,47,9,55
Albion,5130,5,15,10,11,53,52,1,55
Queen's Park,5130,6,15,5,16,41,55,-14,50
Peterhead,5130,7,12,9,15,47,50,-3,45
Stranraer,5130,8,12,7,17,51,55,-4,43
East Fife,5130,9,10,10,16,43,45,-2,40
Stenhousem'r,5130,10,4,11,21,37,80,-43,23
Livingston,5131,1,22,3,11,75,44,31,69
Alloa,5131,2,20,8,8,82,50,32,68
Peterhead,5131,3,17,12,7,52,39,13,63
Brechin,5131,4,17,7,12,51,44,7,58
Airdrieon,5131,5,13,9,14,52,58,-6,48
East Fife,5131,6,11,11,14,48,50,-2,44
Albion,5131,7,12,8,16,41,48,-7,44
Queen's Park,5131,8,12,8,16,37,50,-13,44
Stranraer,5131,9,11,6,19,49,62,-13,39
Stenhousem'r,5131,10,4,10,22,34,76,-42,22
Livingston,5132,1,22,6,8,87,49,38,72
Alloa,5132,2,20,7,9,66,41,25,67
Airdrieon,5132,3,16,10,10,59,48,11,58
Peterhead,5132,4,13,10,13,54,57,-3,49
East Fife,5132,5,13,9,14,53,49,4,48
Stranraer,5132,6,13,7,16,54,62,-8,46
Brechin,5132,7,12,10,14,45,55,-10,46
Albion,5132,8,13,5,18,56,63,-7,44
Queen's Park,5132,9,10,8,18,41,57,-16,38
Stenhousem'r,5132,10,7,10,19,48,82,-34,31
Livingston,5133,1,22,2,12,76,46,30,68
Alloa,5133,2,19,6,11,69,52,17,63
Airdrieon,5133,3,17,5,14,60,58,2,56
Brechin,5133,4,15,10,11,53,48,5,55
East Fife,5133,5,14,7,15,49,51,-2,49
Peterhead,5133,6,13,7,16,52,59,-7,46
Albion,5133,7,12,9,15,59,62,-3,45
Stranraer,5133,8,13,6,17,54,64,-10,45
Queen's Park,5133,9,12,8,16,41,48,-7,44
Stenhousem'r,5133,10,9,8,19,43,68,-25,35
Livingston,5134,1,23,4,9,82,49,33,73
Airdrieon,5134,2,20,5,11,68,55,13,65
Alloa,5134,3,16,9,11,69,50,19,57
Peterhead,5134,4,16,7,13,44,45,-1,55
Brechin,5134,5,17,4,15,45,50,-5,55
East Fife,5134,6,14,7,15,49,44,5,49
Stranraer,5134,7,15,3,18,64,63,1,48
Queen's Park,5134,8,14,6,16,40,52,-12,48
Stenhousem'r,5134,9,8,7,21,47,80,-33,31
Albion,5134,10,7,8,21,42,62,-20,29
Livingston,5135,1,23,5,8,85,44,41,74
Alloa,5135,2,22,7,7,65,35,30,73
Airdrieon,5135,3,19,6,11,62,52,10,63
Queen's Park,5135,4,14,7,15,47,53,-6,49
East Fife,5135,5,12,12,12,49,54,-5,48
Brechin,5135,6,13,4,19,56,68,-12,43
Albion,5135,7,9,14,13,47,53,-6,41
Stranraer,5135,8,12,5,19,48,59,-11,41
Peterhead,5135,9,10,9,17,45,55,-10,39
Stenhousem'r,5135,10,8,7,21,51,82,-31,31
Alloa,5136,1,20,6,10,69,43,26,66
Livingston,5136,2,19,6,11,76,50,26,63
Brechin,5136,3,18,9,9,59,53,6,63
Airdrieon,5136,4,18,6,12,61,55,6,60
Peterhead,5136,5,13,11,12,53,48,5,50
East Fife,5136,6,11,13,12,54,52,2,46
Albion,5136,7,12,10,14,53,54,-1,46
Queen's Park,5136,8,12,5,19,37,58,-21,41
Stranraer,5136,9,11,6,19,52,63,-11,39
Stenhousem'r,5136,10,6,8,22,40,78,-38,26
Livingston,5137,1,25,1,10,84,43,41,76
Airdrieon,5137,2,22,4,10,63,45,18,70
Alloa,5137,3,17,8,11,62,41,21,59
Albion,5137,4,16,7,13,54,51,3,55
Peterhead,5137,5,14,7,15,53,55,-2,49
Stranraer,5137,6,13,5,18,55,60,-5,44
Queen's Park,5137,7,12,7,17,29,52,-23,43
Brechin,5137,8,10,10,16,44,61,-17,40
East Fife,5137,9,9,11,16,50,52,-2,38
Stenhousem'r,5137,10,9,6,21,36,70,-34,33
Livingston,5138,1,18,6,12,72,51,21,60
Alloa,5138,2,17,8,11,68,47,21,59
Airdrieon,5138,3,17,7,12,66,59,7,58
Brechin,5138,4,16,9,11,58,55,3,57
Queen's Park,5138,5,16,7,13,43,46,-3,55
Peterhead,5138,6,14,6,16,56,61,-5,48
Albion,5138,7,13,8,15,56,54,2,47
Stranraer,5138,8,12,8,16,53,61,-8,44
East Fife,5138,9,8,13,15,43,53,-10,37
Stenhousem'r,5138,10,9,8,19,47,75,-28,35
Alloa,5139,1,22,7,7,81,43,38,73
Livingston,5139,2,19,7,10,78,51,27,64
Airdrieon,5139,3,16,12,8,60,47,13,60
Brechin,5139,4,16,8,12,48,45,3,56
Albion,5139,5,14,7,15,49,56,-7,49
Peterhead,5139,6,13,8,15,51,53,-2,47
East Fife,5139,7,11,13,12,50,44,6,46
Stranraer,5139,8,11,8,17,47,59,-12,41
Queen's Park,5139,9,10,6,20,37,61,-24,36
Stenhousem'r,5139,10,5,10,21,41,83,-42,25
Alloa,5140,1,21,8,7,74,47,27,71
Livingston,5140,2,22,3,11,76,46,30,69
Airdrieon,5140,3,18,7,11,66,62,4,61
Brechin,5140,4,18,4,14,59,57,2,58
Queen's Park,5140,5,15,4,17,45,51,-6,49
East Fife,5140,6,12,8,16,50,46,4,44
Peterhead,5140,7,8,16,12,43,54,-11,40
Albion,5140,8,11,6,19,47,58,-11,39
Stenhousem'r,5140,9,10,9,17,58,79,-21,39
Stranraer,5140,10,9,7,20,42,60,-18,34
Alloa,5141,1,21,6,9,70,38,32,69
Airdrieon,5141,2,18,10,8,62,47,15,64
Livingston,5141,3,16,7,13,62,43,19,55
Brechin,5141,4,16,7,13,54,49,5,55
Albion,5141,5,15,7,14,60,55,5,52
East Fife,5141,6,13,7,16,51,53,-2,46
Peterhead,5141,7,13,7,16,48,56,-8,46
Stranraer,5141,8,12,8,16,46,56,-10,44
Queen's Park,5141,9,11,6,19,34,58,-24,39
Stenhousem'r,5141,10,9,7,20,46,78,-32,34
Alloa,5142,1,20,8,8,69,39,30,68
Airdrieon,5142,2,19,6,11,64,47,17,63
Brechin,5142,3,19,6,11,55,43,12,63
Livingston,5142,4,18,5,13,74,55,19,59
Queen's Park,5142,5,14,8,14,39,57,-18,50
Albion,5142,6,14,5,17,53,56,-3,47
Peterhead,5142,7,13,6,17,54,60,-6,45
Stranraer,5142,8,13,5,18,43,54,-11,44
East Fife,5142,9,11,10,15,47,47,0,43
Stenhousem'r,5142,10,4,11,21,36,76,-40,23
Livingston,5143,1,19,6,11,75,52,23,63
Alloa,5143,2,18,6,12,71,52,19,60
Albion,5143,3,16,9,11,50,47,3,57
Queen's Park,5143,4,16,7,13,39,40,-1,55
Stranraer,5143,5,14,8,14,52,54,-2,50
Airdrieon,5143,6,14,6,16,57,58,-1,48
East Fife,5143,7,12,11,13,57,51,6,47
Brechin,5143,8,11,10,15,43,51,-8,43
Peterhead,5143,9,10,9,17,47,55,-8,39
Stenhousem'r,5143,10,9,10,17,40,71,-31,37
Livingston,5144,1,24,3,9,78,44,34,75
Alloa,5144,2,19,9,8,68,39,29,66
Brechin,5144,3,17,6,13,56,53,3,57
Airdrieon,5144,4,15,10,11,62,57,5,55
Queen's Park,5144,5,14,10,12,45,47,-2,52
Peterhead,5144,6,14,9,13,50,47,3,51
Albion,5144,7,11,8,17,43,51,-8,41
Stranraer,5144,8,12,5,19,45,59,-14,41
East Fife,5144,9,9,9,18,49,54,-5,36
Stenhousem'r,5144,10,6,9,21,33,78,-45,27
Livingston,5145,1,22,1,13,71,47,24,67
Peterhead,5145,2,18,8,10,52,42,10,62
Alloa,5145,3,17,10,9,66,44,22,61
Brechin,5145,4,14,12,10,47,42,5,54
Airdrieon,5145,5,15,6,15,57,59,-2,51
Queen's Park,5145,6,15,6,15,42,50,-8,51
East Fife,5145,7,13,8,15,50,47,3,47
Albion,5145,8,12,7,17,54,55,-1,43
Stranraer,5145,9,10,8,18,46,65,-19,38
Stenhousem'r,5145,10,7,8,21,46,80,-34,29
Livingston,5146,1,21,5,10,92,50,42,68
Brechin,5146,2,21,4,11,60,45,15,67
Alloa,5146,3,19,5,12,78,59,19,62
Airdrieon,5146,4,17,10,9,61,52,9,61
Stranraer,5146,5,14,7,15,54,62,-8,49
Albion,5146,6,13,9,14,62,59,3,48
Peterhead,5146,7,12,7,17,40,57,-17,43
Queen's Park,5146,8,11,6,19,34,50,-16,39
East Fife,5146,9,10,8,18,49,53,-4,38
Stenhousem'r,5146,10,8,7,21,46,89,-43,31
Livingston,5147,1,22,5,9,82,50,32,71
Alloa,5147,2,19,11,6,67,38,29,68
Airdrieon,5147,3,17,8,11,63,52,11,59
Brechin,5147,4,16,6,14,48,50,-2,54
Albion,5147,5,14,7,15,55,57,-2,49
East Fife,5147,6,14,5,17,49,50,-1,47
Queen's Park,5147,7,12,8,16,41,49,-8,44
Peterhead,5147,8,11,6,19,44,58,-14,39
Stenhousem'r,5147,9,9,10,17,48,76,-28,37
Stranraer,5147,10,9,8,19,40,57,-17,35
Livingston,5148,1,21,2,13,82,50,32,65
Alloa,5148,2,17,10,9,69,51,18,61
Airdrieon,5148,3,17,5,14,63,53,10,56
Queen's Park,5148,4,16,7,13,41,46,-5,55
East Fife,5148,5,15,7,14,54,47,7,52
Brechin,5148,6,15,6,15,50,52,-2,51
Peterhead,5148,7,15,6,15,47,57,-10,51
Albion,5148,8,11,9,16,47,52,-5,42
Stranraer,5148,9,11,7,18,48,56,-8,40
Stenhousem'r,5148,10,9,7,20,45,82,-37,34
Livingston,5149,1,20,8,8,77,47,30,68
Alloa,5149,2,17,10,9,63,43,20,61
Airdrieon,5149,3,16,9,11,66,59,7,57
Queen's Park,5149,4,14,9,13,42,42,0,51
Brechin,5149,5,15,5,16,56,60,-4,50
Albion,5149,6,14,7,15,59,59,0,49
Peterhead,5149,7,12,8,16,48,58,-10,44
Stranraer,5149,8,12,8,16,44,58,-14,44
East Fife,5149,9,10,12,14,53,51,2,42
Stenhousem'r,5149,10,6,12,18,44,75,-31,30
Livingston,5150,1,20,6,10,77,45,32,66
Alloa,5150,2,18,8,10,65,42,23,62
Airdrieon,5150,3,19,5,12,62,55,7,62
Stranraer,5150,4,17,6,13,56,55,1,57
Brechin,5150,5,15,6,15,52,52,0,51
Albion,5150,6,14,7,15,55,54,1,49
Queen's Park,5150,7,13,8,15,35,46,-11,47
Peterhead,5150,8,12,10,14,46,62,-16,46
East Fife,5150,9,9,10,17,45,47,-2,37
Stenhousem'r,5150,10,5,10,21,42,77,-35,25
Alloa,5151,1,21,8,7,75,38,37,71
Airdrieon,5151,2,18,6,12,59,48,11,60
Brechin,5151,3,17,8,11,50,45,5,59
Queen's Park,5151,4,17,8,11,40,43,-3,59
Peterhead,5151,5,15,8,13,46,47,-1,53
Livingston,5151,6,15,4,17,57,50,7,49
Albion,5151,7,12,8,16,54,55,-1,44
Stranraer,5151,8,12,6,18,52,57,-5,42
East Fife,5151,9,9,10,17,45,54,-9,37
Stenhousem'r,5151,10,7,8,21,47,88,-41,29
Livingston,5152,1,27,2,7,89,41,48,83
Alloa,5152,2,16,9,11,71,56,15,57
Airdrieon,5152,3,16,9,11,62,52,10,57
Brechin,5152,4,15,4,17,51,61,-10,49
Peterhead,5152,5,14,7,15,46,59,-13,49
Albion,5152,6,13,8,15,54,57,-3,47
Queen's Park,5152,7,13,6,17,41,52,-11,45
Stenhousem'r,5152,8,11,10,15,52,69,-17,43
East Fife,5152,9,9,11,16,47,55,-8,38
Stranraer,5152,10,11,4,21,52,63,-11,37
Brechin,5153,1,18,11,7,56,36,20,65
Livingston,5153,2,17,10,9,72,50,22,61
Alloa,5153,3,17,9,10,68,45,23,60
Airdrieon,5153,4,17,9,10,65,55,10,60
Queen's Park,5153,5,14,9,13,45,49,-4,51
Albion,5153,6,14,7,15,55,58,-3,49
East Fife,5153,7,11,11,14,45,44,1,44
Stranraer,5153,8,12,7,17,51,62,-11,43
Stenhousem'r,5153,9,8,10,18,48,75,-27,34
Peterhead,5153,10,7,7,22,33,64,-31,28
Livingston,5154,1,21,4,11,73,46,27,67
Alloa,5154,2,19,8,9,72,40,32,65
Airdrieon,5154,3,19,6,11,63,53,10,63
Albion,5154,4,14,13,9,56,50,6,55
East Fife,5154,5,16,5,15,52,41,11,53
Brechin,5154,6,15,6,15,47,50,-3,51
Queen's Park,5154,7,14,8,14,41,49,-8,50
Peterhead,5154,8,13,8,15,50,58,-8,47
Stranraer,5154,9,10,7,19,45,61,-16,37
Stenhousem'r,5154,10,4,5,27,39,90,-51,17
Alloa,5155,1,19,7,10,69,42,27,64
Brechin,5155,2,18,8,10,52,42,10,62
Airdrieon,5155,3,16,7,13,57,52,5,55
Queen's Park,5155,4,16,7,13,47,46,1,55
Livingston,5155,5,16,5,15,62,52,10,53
Peterhead,5155,6,15,6,15,50,54,-4,51
Stranraer,5155,7,15,5,16,52,58,-6,50
Albion,5155,8,12,7,17,46,57,-11,43
East Fife,5155,9,10,8,18,47,51,-4,38
Stenhousem'r,5155,10,10,6,20,44,72,-28,36
Livingston,5156,1,20,4,12,65,44,21,64
Alloa,5156,2,18,8,10,63,46,17,62
Airdrieon,5156,3,16,9,11,53,44,9,57
Brechin,5156,4,16,8,12,54,44,10,56
East Fife,5156,5,16,7,13,55,44,11,55
Albion,5156,6,13,9,14,48,51,-3,48
Peterhead,5156,7,13,7,16,50,54,-4,46
Stranraer,5156,8,12,10,14,46,52,-6,46
Queen's Park,5156,9,13,5,18,38,53,-15,44
Stenhousem'r,5156,10,5,9,22,38,78,-40,24
Livingston,5157,1,19,6,11,74,48,26,63
Airdrieon,5157,2,19,5,12,63,53,10,62
Alloa,5157,3,18,6,12,65,41,24,60
Brechin,5157,4,18,4,14,59,54,5,58
Queen's Park,5157,5,16,7,13,41,47,-6,55
Peterhead,5157,6,14,7,15,56,53,3,49
East Fife,5157,7,12,9,15,60,58,2,45
Stranraer,5157,8,14,2,20,51,66,-15,44
Albion,5157,9,11,7,18,46,57,-11,40
Stenhousem'r,5157,10,9,7,20,44,82,-38,34
Alloa,5158,1,20,9,7,71,39,32,69
Livingston,5158,2,18,4,14,62,52,10,58
Brechin,5158,3,17,5,14,57,60,-3,56
Albion,5158,4,13,12,11,50,42,8,51
Queen's Park,5158,5,14,9,13,46,46,0,51
East Fife,5158,6,13,10,13,55,45,10,49
Airdrieon,5158,7,12,11,13,64,61,3,47
Peterhead,5158,8,13,6,17,47,64,-17,45
Stranraer,5158,9,10,7,19,47,57,-10,37
Stenhousem'r,5158,10,9,9,18,43,76,-33,36
Livingston,5159,1,23,4,9,84,51,33,73
Alloa,5159,2,21,6,9,83,52,31,69
Peterhead,5159,3,18,6,12,56,46,10,60
Albion,5159,4,16,8,12,62,51,11,56
Brechin,5159,5,16,5,15,54,48,6,53
Airdrieon,5159,6,15,6,15,49,58,-9,51
East Fife,5159,7,13,8,15,49,40,9,47
Queen's Park,5159,8,12,6,18,39,57,-18,42
Stranraer,5159,9,10,3,23,37,70,-33,33
Stenhousem'r,5159,10,6,8,22,43,83,-40,26
Livingston,5160,1,22,5,9,76,45,31,71
Alloa,5160,2,19,6,11,69,44,25,63
Airdrieon,5160,3,19,5,12,65,61,4,62
Queen's Park,5160,4,17,5,14,48,48,0,56
Brechin,5160,5,15,8,13,49,51,-2,53
Albion,5160,6,11,10,15,54,56,-2,43
Stranraer,5160,7,12,7,17,56,65,-9,43
East Fife,5160,8,12,6,18,51,57,-6,42
Peterhead,5160,9,10,11,15,51,61,-10,41
Stenhousem'r,5160,10,5,13,18,47,78,-31,28
Livingston,5161,1,25,4,7,78,42,36,79
Brechin,5161,2,20,4,12,69,55,14,64
Alloa,5161,3,18,7,11,76,55,21,61
Peterhead,5161,4,13,15,8,65,56,9,54
Stranraer,5161,5,15,8,13,54,48,6,53
Airdrieon,5161,6,14,5,17,50,58,-8,47
Albion,5161,7,12,7,17,51,60,-9,43
Queen's Park,5161,8,11,8,17,39,51,-12,41
East Fife,5161,9,9,9,18,42,58,-16,36
Stenhousem'r,5161,10,6,7,23,49,90,-41,25
Livingston,5162,1,24,2,10,81,41,40,74
Brechin,5162,2,18,9,9,55,41,14,63
Alloa,5162,3,16,10,10,58,40,18,58
Peterhead,5162,4,15,7,14,46,50,-4,52
Albion,5162,5,14,8,14,58,52,6,50
Airdrieon,5162,6,14,7,15,52,59,-7,49
Queen's Park,5162,7,12,8,16,31,48,-17,44
East Fife,5162,8,11,9,16,46,46,0,42
Stranraer,5162,9,12,5,19,48,62,-14,41
Stenhousem'r,5162,10,8,7,21,46,82,-36,31
Alloa,5163,1,21,9,6,85,44,41,72
Livingston,5163,2,22,6,8,84,47,37,72
Peterhead,5163,3,16,4,16,55,57,-2,52
Brechin,5163,4,16,3,17,49,54,-5,51
Albion,5163,5,13,11,12,51,50,1,50
Airdrieon,5163,6,14,8,14,63,69,-6,50
Queen's Park,5163,7,14,7,15,46,55,-9,49
Stranraer,5163,8,14,6,16,61,66,-5,48
East Fife,5163,9,9,7,20,47,59,-12,34
Stenhousem'r,5163,10,6,9,21,44,84,-40,27
Livingston,5164,1,20,5,11,69,50,19,65
Peterhead,5164,2,18,6,12,56,43,13,60
Airdrieon,5164,3,18,6,12,59,55,4,60
Alloa,5164,4,16,9,11,56,40,16,57
Stranraer,5164,5,17,5,14,64,60,4,56
Queen's Park,5164,6,13,7,16,34,43,-9,46
East Fife,5164,7,12,9,15,55,52,3,45
Albion,5164,8,12,8,16,51,56,-5,44
Brechin,5164,9,12,8,16,53,59,-6,44
Stenhousem'r,5164,10,6,9,21,42,81,-39,27
Livingston,5165,1,20,7,9,66,35,31,67
Brechin,5165,2,20,4,12,56,48,8,64
Alloa,5165,3,18,9,9,65,42,23,63
Albion,5165,4,13,12,11,54,48,6,51
Peterhead,5165,5,13,9,14,47,49,-2,48
Airdrieon,5165,6,14,6,16,50,54,-4,48
Stranraer,5165,7,13,7,16,48,55,-7,46
East Fife,5165,8,10,11,15,40,49,-9,41
Queen's Park,5165,9,11,8,17,37,52,-15,41
Stenhousem'r,5165,10,6,11,19,44,75,-31,29
Livingston,5166,1,23,2,11,77,46,31,71
Alloa,5166,2,19,9,8,70,42,28,66
Airdrieon,5166,3,18,8,10,68,53,15,62
Brechin,5166,4,15,10,11,51,44,7,55
Peterhead,5166,5,14,7,15,53,59,-6,49
Queen's Park,5166,6,12,9,15,45,57,-12,45
Albion,5166,7,11,11,14,56,61,-5,44
Stranraer,5166,8,12,7,17,56,59,-3,43
Stenhousem'r,5166,9,10,9,17,49,75,-26,39
East Fife,5166,10,5,10,21,34,63,-29,25
Livingston,5167,1,21,6,9,75,42,33,69
Brechin,5167,2,19,7,10,54,40,14,64
Albion,5167,3,17,9,10,61,45,16,60
Alloa,5167,4,17,7,12,70,57,13,58
Airdrieon,5167,5,17,4,15,67,55,12,55
Stranraer,5167,6,14,7,15,55,61,-6,49
Queen's Park,5167,7,12,8,16,35,50,-15,44
Stenhousem'r,5167,8,10,8,18,52,78,-26,38
East Fife,5167,9,8,13,15,39,47,-8,37
Peterhead,5167,10,7,7,22,39,72,-33,28
Alloa,5168,1,21,8,7,79,45,34,71
Brechin,5168,2,21,7,8,62,43,19,70
Livingston,5168,3,18,7,11,77,48,29,61
Airdrieon,5168,4,16,8,12,60,55,5,56
Peterhead,5168,5,12,10,14,45,56,-11,46
Stranraer,5168,6,12,7,17,51,61,-10,43
Albion,5168,7,10,9,17,42,53,-11,39
East Fife,5168,8,9,11,16,46,54,-8,38
Queen's Park,5168,9,9,11,16,38,57,-19,38
Stenhousem'r,5168,10,8,10,18,49,77,-28,34
Alloa,5169,1,23,6,7,74,39,35,75
Livingston,5169,2,22,5,9,74,43,31,71
Airdrieon,5169,3,17,9,10,57,49,8,60
Brechin,5169,4,16,7,13,47,43,4,55
Albion,5169,5,14,6,16,50,45,5,48
Peterhead,5169,6,14,5,17,52,57,-5,47
Stenhousem'r,5169,7,10,9,17,48,70,-22,39
Queen's Park,5169,8,10,8,18,30,50,-20,38
Stranraer,5169,9,9,9,18,45,64,-19,36
East Fife,5169,10,9,8,19,46,63,-17,35
Alloa,5170,1,19,9,8,65,42,23,66
Livingston,5170,2,20,2,14,83,57,26,62
Albion,5170,3,15,11,10,62,54,8,56
Airdrieon,5170,4,15,7,14,61,63,-2,52
Queen's Park,5170,5,16,3,17,40,44,-4,51
East Fife,5170,6,13,11,12,51,43,8,50
Brechin,5170,7,13,10,13,50,53,-3,49
Stranraer,5170,8,14,5,17,55,58,-3,47
Peterhead,5170,9,10,8,18,43,59,-16,38
Stenhousem'r,5170,10,8,8,20,49,86,-37,32
Livingston,5171,1,19,9,8,77,37,40,66
Alloa,5171,2,19,9,8,73,42,31,66
Peterhead,5171,3,17,9,10,47,43,4,60
Albion,5171,4,14,10,12,51,53,-2,52
Brechin,5171,5,14,9,13,43,45,-2,51
Queen's Park,5171,6,14,6,16,46,49,-3,48
Airdrieon,5171,7,14,4,18,54,67,-13,46
East Fife,5171,8,10,12,14,47,55,-8,42
Stranraer,5171,9,11,6,19,40,53,-13,39
Stenhousem'r,5171,10,7,8,21,40,74,-34,29
Livingston,5172,1,24,5,7,76,37,39,77
Brechin,5172,2,22,3,11,57,42,15,69
Alloa,5172,3,19,6,11,71,45,26,63
Airdrieon,5172,4,16,6,14,55,49,6,54
Queen's Park,5172,5,14,7,15,37,49,-12,49
Peterhead,5172,6,12,8,16,45,54,-9,44
Albion,5172,7,10,13,13,41,51,-10,43
Stranraer,5172,8,12,3,21,44,58,-14,39
East Fife,5172,9,9,7,20,44,60,-16,34
Stenhousem'r,5172,10,8,10,18,47,72,-25,34
Livingston,5173,1,23,6,7,78,34,44,75
Alloa,5173,2,17,8,11,65,52,13,59
Brechin,5173,3,17,7,12,52,43,9,58
Airdrieon,5173,4,16,8,12,63,53,10,56
Albion,5173,5,16,6,14,57,53,4,54
Stranraer,5173,6,13,10,13,53,59,-6,49
Queen's Park,5173,7,10,9,17,35,53,-18,39
East Fife,5173,8,8,12,16,42,52,-10,36
Peterhead,5173,9,8,11,17,44,59,-15,35
Stenhousem'r,5173,10,8,11,17,43,74,-31,35
Livingston,5174,1,24,5,7,97,42,55,77
Brechin,5174,2,18,8,10,48,37,11,62
Alloa,5174,3,18,7,11,61,39,22,61
Airdrieon,5174,4,17,7,12,60,59,1,58
Peterhead,5174,5,14,8,14,44,45,-1,50
Stranraer,5174,6,15,4,17,45,53,-8,49
East Fife,5174,7,12,8,16,51,49,2,44
Queen's Park,5174,8,10,8,18,29,51,-22,38
Albion,5174,9,9,9,18,46,70,-24,36
Stenhousem'r,5174,10,7,8,21,34,70,-36,29
Livingston,5175,1,24,3,9,74,35,39,75
Alloa,5175,2,22,6,8,73,38,35,72
Airdrieon,5175,3,17,7,12,58,49,9,58
Brechin,5175,4,17,4,15,42,46,-4,55
Queen's Park,5175,5,15,6,15,49,53,-4,51
Albion,5175,6,12,10,14,50,54,-4,46
Peterhead,5175,7,11,8,17,35,49,-14,41
Stranraer,5175,8,10,9,17,43,56,-13,39
East Fife,5175,9,9,8,19,43,58,-15,35
Stenhousem'r,5175,10,9,7,20,44,73,-29,34
Livingston,5176,1,21,4,11,76,47,29,67
Brechin,5176,2,20,7,9,53,35,18,67
Alloa,5176,3,19,6,11,67,48,19,63
Peterhead,5176,4,17,5,14,53,50,3,56
Airdrieon,5176,5,16,5,15,63,65,-2,53
East Fife,5176,6,14,8,14,60,53,7,50
Stranraer,5176,7,14,3,19,56,61,-5,45
Queen's Park,5176,8,10,11,15,40,51,-11,41
Albion,5176,9,11,8,17,46,61,-15,41
Stenhousem'r,5176,10,5,9,22,44,87,-43,24
Livingston,5177,1,18,7,11,66,45,21,61
Peterhead,5177,2,18,7,11,65,45,20,61
Brechin,5177,3,17,9,10,54,43,11,60
Alloa,5177,4,16,10,10,79,56,23,58
Airdrieon,5177,5,14,9,13,53,54,-1,51
Albion,5177,6,14,9,13,48,50,-2,51
East Fife,5177,7,11,12,13,51,46,5,45
Stranraer,5177,8,11,7,18,50,64,-14,40
Queen's Park,5177,9,9,8,19,32,61,-29,35
Stenhousem'r,5177,10,9,8,19,45,79,-34,35
Airdrieon,5178,1,21,5,10,68,54,14,68
Alloa,5178,2,20,7,9,70,40,30,67
Brechin,5178,3,19,5,12,48,41,7,62
Livingston,5178,4,17,5,14,69,48,21,56
Albion,5178,5,15,6,15,51,51,0,51
Queen's Park,5178,6,14,6,16,37,51,-14,48
East Fife,5178,7,13,8,15,51,48,3,47
Peterhead,5178,8,12,7,17,45,53,-8,43
Stranraer,5178,9,11,5,20,47,59,-12,38
Stenhousem'r,5178,10,8,6,22,51,92,-41,30
Alloa,5179,1,23,7,6,80,35,45,76
Brechin,5179,2,18,5,13,56,50,6,59
Livingston,5179,3,17,7,12,66,47,19,58
Airdrieon,5179,4,15,10,11,59,48,11,55
Albion,5179,5,15,6,15,57,61,-4,51
East Fife,5179,6,12,12,12,56,47,9,48
Peterhead,5179,7,14,6,16,45,54,-9,48
Stranraer,5179,8,12,9,15,55,58,-3,45
Queen's Park,5179,9,9,11,16,34,49,-15,38
Stenhousem'r,5179,10,5,7,24,34,93,-59,22
Alloa,5180,1,21,7,8,84,53,31,70
Livingston,5180,2,20,6,10,81,55,26,66
Airdrieon,5180,3,19,6,11,68,57,11,63
Brechin,5180,4,19,3,14,55,43,12,60
Peterhead,5180,5,15,6,15,56,58,-2,51
Albion,5180,6,14,8,14,61,59,2,50
Queen's Park,5180,7,11,9,16,35,53,-18,42
East Fife,5180,8,10,9,17,44,52,-8,39
Stranraer,5180,9,11,6,19,51,67,-16,39
Stenhousem'r,5180,10,5,10,21,47,85,-38,25
Alloa,5181,1,19,8,9,75,47,28,65
Livingston,5181,2,19,7,10,69,36,33,64
Airdrieon,5181,3,17,8,11,61,60,1,59
Brechin,5181,4,17,5,14,57,54,3,56
Queen's Park,5181,5,15,7,14,53,51,2,52
East Fife,5181,6,12,10,14,58,50,8,46
Albion,5181,7,12,10,14,52,53,-1,46
Peterhead,5181,8,11,8,17,39,55,-16,41
Stranraer,5181,9,11,6,19,46,65,-19,39
Stenhousem'r,5181,10,9,7,20,44,83,-39,34
Alloa,5182,1,18,8,10,72,57,15,62
Albion,5182,2,18,5,13,51,44,7,59
Airdrieon,5182,3,17,7,12,64,56,8,58
Brechin,5182,4,18,4,14,60,56,4,58
East Fife,5182,5,14,9,13,51,41,10,51
Livingston,5182,6,15,5,16,67,54,13,50
Queen's Park,5182,7,13,7,16,34,49,-15,46
Stenhousem'r,5182,8,11,9,16,53,69,-16,42
Peterhead,5182,9,10,10,16,46,55,-9,40
Stranraer,5182,10,11,6,19,45,62,-17,39
Alloa,5183,1,19,8,9,71,47,24,65
Airdrieon,5183,2,20,5,11,70,48,22,65
Livingston,5183,3,19,3,14,74,56,18,60
East Fife,5183,4,18,4,14,57,43,14,58
Peterhead,5183,5,15,6,15,50,51,-1,51
Albion,5183,6,13,9,14,63,59,4,48
Queen's Park,5183,7,14,6,16,40,54,-14,48
Stranraer,5183,8,14,5,17,47,59,-12,47
Brechin,5183,9,11,6,19,45,60,-15,39
Stenhousem'r,5183,10,7,8,21,42,82,-40,29
Alloa,5184,1,20,9,7,67,40,27,69
Livingston,5184,2,20,6,10,78,46,32,66
Brechin,5184,3,16,11,9,45,38,7,59
Peterhead,5184,4,15,7,14,52,53,-1,52
Airdrieon,5184,5,14,6,16,60,59,1,48
Albion,5184,6,13,9,14,52,58,-6,48
Queen's Park,5184,7,10,11,15,35,48,-13,41
Stranraer,5184,8,11,7,18,50,57,-7,40
East Fife,5184,9,9,12,15,46,50,-4,39
Stenhousem'r,5184,10,7,12,17,43,79,-36,33
Alloa,5185,1,20,4,12,66,42,24,64
Airdrieon,5185,2,19,6,11,71,52,19,63
Brechin,5185,3,19,5,12,48,50,-2,62
East Fife,5185,4,16,8,12,51,43,8,56
Livingston,5185,5,16,5,15,62,47,15,53
Albion,5185,6,15,7,14,60,56,4,52
Peterhead,5185,7,13,7,16,48,56,-8,46
Stranraer,5185,8,12,7,17,45,53,-8,43
Queen's Park,5185,9,9,9,18,38,59,-21,36
Stenhousem'r,5185,10,8,8,20,45,76,-31,32
Livingston,5186,1,20,5,11,72,44,28,65
Alloa,5186,2,18,9,9,77,44,33,63
Airdrieon,5186,3,18,8,10,63,51,12,62
Peterhead,5186,4,17,6,13,51,48,3,57
Brechin,5186,5,15,8,13,48,48,0,53
Albion,5186,6,14,9,13,53,52,1,51
Queen's Park,5186,7,14,9,13,38,44,-6,51
East Fife,5186,8,10,9,17,43,57,-14,39
Stenhousem'r,5186,9,9,6,21,45,79,-34,33
Stranraer,5186,10,8,5,23,44,67,-23,29
Alloa,5187,1,20,6,10,78,44,34,66
Livingston,5187,2,20,4,12,64,44,20,64
Airdrieon,5187,3,19,7,10,53,42,11,64
Brechin,5187,4,16,5,15,50,52,-2,53
Queen's Park,5187,5,15,6,15,40,45,-5,51
Albion,5187,6,14,7,15,56,49,7,49
Peterhead,5187,7,12,9,15,48,64,-16,45
East Fife,5187,8,11,9,16,44,49,-5,42
Stenhousem'r,5187,9,10,7,19,39,67,-28,37
Stranraer,5187,10,9,8,19,42,58,-16,35
Livingston,5188,1,23,3,10,75,44,31,72
Queen's Park,5188,2,18,4,14,54,52,2,58
Brechin,5188,3,17,6,13,56,55,1,57
Airdrieon,5188,4,16,7,13,60,60,0,55
Peterhead,5188,5,16,6,14,55,55,0,54
Alloa,5188,6,15,7,14,73,56,17,52
East Fife,5188,7,15,4,17,57,55,2,49
Albion,5188,8,12,6,18,60,66,-6,42
Stenhousem'r,5188,9,9,12,15,54,76,-22,39
Stranraer,5188,10,10,3,23,40,65,-25,33
Brechin,5189,1,22,4,10,68,41,27,70
Livingston,5189,2,20,6,10,74,55,19,66
Airdrieon,5189,3,18,7,11,65,51,14,61
Alloa,5189,4,17,9,10,64,43,21,60
Peterhead,5189,5,18,6,12,64,53,11,60
Albion,5189,6,13,7,16,52,64,-12,46
Queen's Park,5189,7,11,9,16,45,59,-14,42
Stranraer,5189,8,10,9,17,54,63,-9,39
East Fife,5189,9,7,12,17,42,54,-12,33
Stenhousem'r,5189,10,6,7,23,38,83,-45,25
Alloa,5190,1,22,6,8,85,50,35,72
Livingston,5190,2,19,5,12,79,50,29,62
Airdrieon,5190,3,18,8,10,58,48,10,62
Peterhead,5190,4,15,10,11,51,49,2,55
Albion,5190,5,13,9,14,60,53,7,48
Stranraer,5190,6,13,7,16,53,57,-4,46
Brechin,5190,7,12,9,15,50,55,-5,45
East Fife,5190,8,9,12,15,50,55,-5,39
Stenhousem'r,5190,9,10,7,19,47,90,-43,37
Queen's Park,5190,10,8,9,19,30,56,-26,33
Livingston,5191,1,21,7,8,76,44,32,70
Alloa,5191,2,19,7,10,71,38,33,64
Queen's Park,5191,3,15,8,13,38,49,-11,53
Peterhead,5191,4,15,7,14,49,47,2,52
Airdrieon,5191,5,15,6,15,54,51,3,51
Albion,5191,6,15,5,16,50,49,1,50
Stranraer,5191,7,13,7,16,46,57,-11,46
Brechin,5191,8,11,11,14,48,55,-7,44
East Fife,5191,9,11,9,16,37,43,-6,42
Stenhousem'r,5191,10,7,9,20,46,82,-36,30
Livingston,5192,1,24,4,8,82,43,39,76
Brechin,5192,2,18,7,11,47,39,8,61
Airdrieon,5192,3,16,7,13,55,52,3,55
Alloa,5192,4,15,8,13,56,41,15,53
Peterhead,5192,5,14,11,11,47,47,0,53
Albion,5192,6,13,11,12,54,52,2,50
Queen's Park,5192,7,14,5,17,38,48,-10,47
Stranraer,5192,8,13,5,18,47,56,-9,44
East Fife,5192,9,10,9,17,42,49,-7,39
Stenhousem'r,5192,10,5,9,22,35,76,-41,24
Livingston,5193,1,24,4,8,81,43,38,76
Alloa,5193,2,17,8,11,67,42,25,59
Brechin,5193,3,18,4,14,56,46,10,58
Airdrieon,5193,4,15,8,13,60,60,0,53
East Fife,5193,5,14,8,14,54,47,7,50
Albion,5193,6,13,6,17,51,54,-3,45
Peterhead,5193,7,13,6,17,40,54,-14,45
Stranraer,5193,8,13,5,18,55,58,-3,44
Stenhousem'r,5193,9,13,3,20,55,89,-34,42
Queen's Park,5193,10,11,6,19,25,51,-26,39
Alloa,5194,1,22,5,9,77,41,36,71
Livingston,5194,2,21,5,10,76,45,31,68
Airdrieon,5194,3,19,7,10,65,52,13,64
Albion,5194,4,15,11,10,60,44,16,56
Stranraer,5194,5,16,4,16,59,50,9,52
Queen's Park,5194,6,15,4,17,44,57,-13,49
Brechin,5194,7,14,6,16,40,55,-15,48
Peterhead,5194,8,11,9,16,47,64,-17,42
East Fife,5194,9,6,12,18,38,55,-17,30
Stenhousem'r,5194,10,6,7,23,41,84,-43,25
Alloa,5195,1,22,6,8,67,40,27,72
Livingston,5195,2,22,5,9,79,56,23,71
Airdrieon,5195,3,17,7,12,67,53,14,58
Brechin,5195,4,16,10,10,56,46,10,58
Albion,5195,5,13,11,12,57,47,10,50
East Fife,5195,6,12,9,15,47,52,-5,45
Peterhead,5195,7,10,12,14,46,54,-8,42
Queen's Park,5195,8,11,8,17,34,50,-16,41
Stranraer,5195,9,10,7,19,41,64,-23,37
Stenhousem'r,5195,10,6,7,23,47,79,-32,25
Alloa,5196,1,20,8,8,79,46,33,68
Livingston,5196,2,20,7,9,69,41,28,67
Airdrieon,5196,3,17,9,10,51,41,10,60
Albion,5196,4,16,7,13,66,54,12,55
Brechin,5196,5,14,10,12,48,56,-8,52
Queen's Park,5196,6,14,9,13,40,48,-8,51
Peterhead,5196,7,11,10,15,45,52,-7,43
Stranraer,5196,8,9,10,17,48,61,-13,37
East Fife,5196,9,9,8,19,42,54,-12,35
Stenhousem'r,5196,10,8,6,22,42,77,-35,30
Livingston,5197,1,26,3,7,90,42,48,81
Alloa,5197,2,21,7,8,69,41,28,70
Albion,5197,3,17,7,12,57,45,12,58
Airdrieon,5197,4,18,4,14,57,52,5,58
Brechin,5197,5,15,5,16,56,53,3,50
Peterhead,5197,6,15,5,16,51,57,-6,50
Queen's Park,5197,7,12,8,16,35,46,-11,44
East Fife,5197,8,9,9,18,36,52,-16,36
Stranraer,5197,9,10,6,20,42,60,-18,36
Stenhousem'r,5197,10,5,10,21,38,83,-45,25
Alloa,5198,1,20,7,9,74,45,29,67
Brechin,5198,2,20,2,14,57,48,9,62
Airdrieon,5198,3,18,5,13,54,54,0,59
East Fife,5198,4,17,7,12,65,40,25,58
Livingston,5198,5,17,5,14,66,53,13,56
Queen's Park,5198,6,16,4,16,46,44,2,52
Albion,5198,7,14,5,17,54,59,-5,47
Stranraer,5198,8,12,5,19,48,61,-13,41
Peterhead,5198,9,11,8,17,41,54,-13,41
Stenhousem'r,5198,10,7,8,21,46,93,-47,29
Livingston,5199,1,22,4,10,70,49,21,70
Airdrieon,5199,2,19,6,11,63,46,17,63
Brechin,5199,3,19,6,11,47,52,-5,63
Alloa,5199,4,18,7,11,77,45,32,61
East Fife,5199,5,15,8,13,52,42,10,53
Queen's Park,5199,6,14,5,17,35,48,-13,47
Stranraer,5199,7,13,4,19,53,59,-6,43
Peterhead,5199,8,11,8,17,50,57,-7,41
Albion,5199,9,10,9,17,44,54,-10,39
Stenhousem'r,5199,10,6,9,21,38,77,-39,27
Brechin,5200,1,18,10,8,59,40,19,64
Livingston,5200,2,20,4,12,73,56,17,64
Alloa,5200,3,18,8,10,80,44,36,62
Airdrieon,5200,4,16,9,11,54,51,3,57
Albion,5200,5,13,9,14,53,54,-1,48
Peterhead,5200,6,13,9,14,55,60,-5,48
Stranraer,5200,7,13,7,16,50,60,-10,46
Queen's Park,5200,8,12,8,16,46,58,-12,44
Stenhousem'r,5200,9,9,7,20,48,83,-35,34
East Fife,5200,10,7,11,18,46,58,-12,32
Livingston,5201,1,22,5,9,71,44,27,71
Alloa,5201,2,17,10,9,63,41,22,61
Airdrieon,5201,3,17,7,12,59,56,3,58
Brechin,5201,4,16,7,13,51,51,0,55
Albion,5201,5,15,9,12,56,45,11,54
Stranraer,5201,6,14,6,16,55,58,-3,48
Peterhead,5201,7,11,13,12,48,52,-4,46
Queen's Park,5201,8,11,9,16,38,51,-13,42
East Fife,5201,9,9,13,14,46,49,-3,40
Stenhousem'r,5201,10,4,9,23,40,80,-40,21
Alloa,5202,1,18,10,8,69,43,26,64
Livingston,5202,2,17,8,11,70,52,18,59
Airdrieon,5202,3,16,10,10,60,54,6,58
Brechin,5202,4,19,1,16,59,56,3,58
Albion,5202,5,14,8,14,67,59,8,50
Stranraer,5202,6,13,9,14,57,54,3,48
East Fife,5202,7,11,11,14,59,62,-3,44
Queen's Park,5202,8,11,8,17,35,50,-15,41
Peterhead,5202,9,9,14,13,48,64,-16,41
Stenhousem'r,5202,10,7,11,18,44,74,-30,32
Alloa,5203,1,18,10,8,69,42,27,64
Livingston,5203,2,20,3,13,62,54,8,63
Albion,5203,3,17,11,8,54,41,13,62
Airdrieon,5203,4,19,5,12,65,57,8,62
Brechin,5203,5,15,8,13,57,48,9,53
Queen's Park,5203,6,15,6,15,43,50,-7,51
Peterhead,5203,7,14,7,15,60,61,-1,49
Stranraer,5203,8,12,7,17,55,62,-7,43
East Fife,5203,9,8,9,19,50,59,-9,33
Stenhousem'r,5203,10,5,8,23,38,79,-41,23
Livingston,5204,1,26,2,8,93,47,46,80
Alloa,5204,2,21,7,8,79,46,33,70
Airdrieon,5204,3,19,8,9,65,47,18,65
Brechin,5204,4,14,8,14,45,55,-10,50
Albion,5204,5,11,10,15,52,49,3,43
Peterhead,5204,6,11,10,15,48,53,-5,43
Queen's Park,5204,7,11,10,15,30,47,-17,43
Stenhousem'r,5204,8,11,9,16,48,65,-17,42
East Fife,5204,9,9,7,20,39,61,-22,34
Stranraer,5204,10,9,5,22,43,72,-29,32
Alloa,5205,1,24,5,7,75,40,35,77
Airdrieon,5205,2,21,6,9,63,45,18,69
Stranraer,5205,3,16,5,15,49,49,0,53
Brechin,5205,4,15,6,15,39,39,0,51
Queen's Park,5205,5,13,9,14,40,52,-12,48
Peterhead,5205,6,13,7,16,44,53,-9,46
Livingston,5205,7,13,4,19,54,54,0,43
Stenhousem'r,5205,8,11,9,16,56,76,-20,42
Albion,5205,9,12,5,19,45,48,-3,41
East Fife,5205,10,10,8,18,40,49,-9,38
Livingston,5206,1,24,3,9,71,37,34,75
Alloa,5206,2,20,8,8,68,38,30,68
Airdrieon,5206,3,19,5,12,66,43,23,62
Albion,5206,4,17,11,8,56,38,18,62
Brechin,5206,5,14,7,15,41,50,-9,49
Peterhead,5206,6,12,9,15,38,48,-10,45
Queen's Park,5206,7,12,8,16,39,49,-10,44
East Fife,5206,8,9,10,17,36,46,-10,37
Stranraer,5206,9,10,7,19,46,62,-16,37
Stenhousem'r,5206,10,5,8,23,33,83,-50,23
Livingston,5207,1,22,5,9,65,37,28,71
Alloa,5207,2,19,10,7,71,42,29,67
Brechin,5207,3,15,13,8,53,38,15,58
Albion,5207,4,14,12,10,59,53,6,54
Peterhead,5207,5,13,10,13,45,52,-7,49
Stranraer,5207,6,14,4,18,54,66,-12,46
Airdrieon,5207,7,12,7,17,46,55,-9,43
Queen's Park,5207,8,12,7,17,35,46,-11,43
East Fife,5207,9,9,9,18,42,47,-5,36
Stenhousem'r,5207,10,7,9,20,39,73,-34,30
Airdrieon,5208,1,21,4,11,56,50,6,67
Alloa,5208,2,20,4,12,77,53,24,64
Brechin,5208,3,19,7,10,62,43,19,64
Livingston,5208,4,19,4,13,72,48,24,61
Queen's Park,5208,5,14,7,15,43,49,-6,49
Peterhead,5208,6,13,8,15,53,61,-8,47
Stranraer,5208,7,13,6,17,55,60,-5,45
East Fife,5208,8,12,6,18,50,58,-8,42
Stenhousem'r,5208,9,10,6,20,51,82,-31,36
Albion,5208,10,9,8,19,42,57,-15,35
Livingston,5209,1,25,2,9,88,42,46,77
Alloa,5209,2,21,6,9,69,40,29,69
Airdrieon,5209,3,19,5,12,57,51,6,62
Albion,5209,4,12,11,13,57,57,0,47
Peterhead,5209,5,12,11,13,49,54,-5,47
Queen's Park,5209,6,13,7,16,42,53,-11,46
Brechin,5209,7,11,8,17,52,61,-9,41
East Fife,5209,8,9,12,15,48,49,-1,39
Stranraer,5209,9,11,5,20,48,71,-23,38
Stenhousem'r,5209,10,8,11,17,42,74,-32,35
Airdrieon,5210,1,20,7,9,64,47,17,67
Alloa,5210,2,17,10,9,67,43,24,61
Livingston,5210,3,18,5,13,67,53,14,59
Albion,5210,4,14,11,11,59,51,8,53
Peterhead,5210,5,14,8,14,51,51,0,50
Brechin,5210,6,15,5,16,47,63,-16,50
Queen's Park,5210,7,14,7,15,47,44,3,49
East Fife,5210,8,10,10,16,52,55,-3,40
Stranraer,5210,9,10,8,18,47,67,-20,38
Stenhousem'r,5210,10,8,9,19,50,77,-27,33
Livingston,5211,1,19,5,12,64,47,17,62
Brechin,5211,2,17,10,9,50,38,12,61
Alloa,5211,3,16,9,11,60,45,15,57
Airdrieon,5211,4,15,12,9,50,44,6,57
Albion,5211,5,15,8,13,44,39,5,53
East Fife,5211,6,13,6,17,40,48,-8,45
Queen's Park,5211,7,11,11,14,45,46,-1,44
Stenhousem'r,5211,8,11,9,16,52,70,-18,42
Stranraer,5211,9,11,6,19,52,61,-9,39
Peterhead,5211,10,8,12,16,40,59,-19,36
Livingston,5212,1,21,7,8,76,46,30,70
Alloa,5212,2,19,9,8,73,44,29,66
Brechin,5212,3,16,5,15,52,55,-3,53
Peterhead,5212,4,15,7,14,60,56,4,52
Airdrieon,5212,5,14,9,13,50,57,-7,51
East Fife,5212,6,13,8,15,51,51,0,47
Stranraer,5212,7,13,8,15,52,54,-2,47
Albion,5212,8,12,10,14,46,46,0,46
Queen's Park,5212,9,8,13,15,39,56,-17,37
Stenhousem'r,5212,10,5,12,19,39,73,-34,27
Alloa,5213,1,21,6,9,70,40,30,69
Livingston,5213,2,21,5,10,75,47,28,68
Brechin,5213,3,15,6,15,50,51,-1,51
East Fife,5213,4,14,8,14,55,50,5,50
Airdrieon,5213,5,14,8,14,47,51,-4,50
Albion,5213,6,13,8,15,51,62,-11,47
Peterhead,5213,7,11,12,13,45,47,-2,45
Queen's Park,5213,8,13,6,17,36,48,-12,45
Stranraer,5213,9,12,5,19,49,62,-13,41
Stenhousem'r,5213,10,8,12,16,48,68,-20,36
Livingston,5214,1,22,6,8,84,45,39,72
Alloa,5214,2,18,10,8,73,40,33,64
Stranraer,5214,3,15,8,13,57,57,0,53
Albion,5214,4,14,9,13,53,54,-1,51
Queen's Park,5214,5,13,10,13,41,44,-3,49
Airdrieon,5214,6,13,6,17,58,69,-11,45
East Fife,5214,7,11,11,14,45,41,4,44
Brechin,5214,8,12,7,17,41,62,-21,43
Stenhousem'r,5214,9,10,9,17,47,73,-26,39
Peterhead,5214,10,10,8,18,41,55,-14,38
Livingston,5215,1,24,5,7,83,48,35,77
Brechin,5215,2,21,6,9,54,36,18,69
Alloa,5215,3,19,7,10,74,45,29,64
Airdrieon,5215,4,17,8,11,57,50,7,59
Albion,5215,5,13,9,14,50,48,2,48
East Fife,5215,6,10,9,17,40,49,-9,39
Stranraer,5215,7,10,9,17,46,56,-10,39
Queen's Park,5215,8,11,6,19,30,54,-24,39
Stenhousem'r,5215,9,10,7,19,46,75,-29,37
Peterhead,5215,10,8,8,20,40,59,-19,32
Brechin,5216,1,21,5,10,62,42,20,68
Airdrieon,5216,2,20,5,11,63,49,14,65
Alloa,5216,3,18,10,8,71,44,27,64
Livingston,5216,4,17,5,14,72,60,12,56
Albion,5216,5,14,9,13,57,48,9,51
East Fife,5216,6,14,7,15,49,51,-2,49
Peterhead,5216,7,13,7,16,47,53,-6,46
Stranraer,5216,8,11,6,19,45,57,-12,39
Queen's Park,5216,9,11,6,19,41,62,-21,39
Stenhousem'r,5216,10,7,8,21,42,83,-41,29
Livingston,5217,1,20,7,9,85,55,30,67
Alloa,5217,2,19,8,9,82,56,26,65
Airdrieon,5217,3,17,7,12,63,56,7,58
Brechin,5217,4,16,6,14,50,54,-4,54
Albion,5217,5,13,9,14,51,52,-1,48
Queen's Park,5217,6,13,9,14,37,47,-10,48
East Fife,5217,7,11,10,15,48,48,0,43
Stenhousem'r,5217,8,11,8,17,59,79,-20,41
Stranraer,5217,9,10,8,18,52,65,-13,38
Peterhead,5217,10,10,8,18,51,66,-15,38
Alloa,5218,1,20,11,5,80,41,39,71
Airdrieon,5218,2,17,10,9,56,54,2,61
Brechin,5218,3,17,7,12,56,43,13,58
Livingston,5218,4,18,3,15,74,59,15,57
Stranraer,5218,5,13,8,15,53,52,1,47
Albion,5218,6,12,10,14,49,51,-2,46
East Fife,5218,7,10,14,12,52,46,6,44
Peterhead,5218,8,10,12,14,44,52,-8,42
Queen's Park,5218,9,10,7,19,31,58,-27,37
Stenhousem'r,5218,10,8,8,20,44,83,-39,32
Livingston,5219,1,24,4,8,90,41,49,76
Alloa,5219,2,18,12,6,65,40,25,66
Airdrieon,5219,3,16,8,12,65,58,7,56
Stranraer,5219,4,16,5,15,61,65,-4,53
Albion,5219,5,14,8,14,52,52,0,50
Brechin,5219,6,12,10,14,51,58,-7,46
Peterhead,5219,7,12,8,16,59,65,-6,44
East Fife,5219,8,10,11,15,47,52,-5,41
Queen's Park,5219,9,8,10,18,27,53,-26,34
Stenhousem'r,5219,10,9,6,21,45,78,-33,33
Livingston,5220,1,25,5,6,84,41,43,80
Alloa,5220,2,20,7,9,66,41,25,67
Airdrieon,5220,3,16,5,15,57,58,-1,53
Brechin,5220,4,14,8,14,56,58,-2,50
Albion,5220,5,14,6,16,51,57,-6,48
Peterhead,5220,6,14,4,18,51,55,-4,46
East Fife,5220,7,12,7,17,51,55,-4,43
Queen's Park,5220,8,12,6,18,40,58,-18,42
Stranraer,5220,9,10,11,15,45,58,-13,41
Stenhousem'r,5220,10,10,7,19,50,70,-20,37
Airdrieon,5221,1,20,6,10,62,43,19,66
Livingston,5221,2,17,9,10,75,52,23,60
Brechin,5221,3,17,8,11,52,50,2,59
Peterhead,5221,4,16,8,12,50,47,3,56
Albion,5221,5,16,7,13,53,54,-1,55
Queen's Park,5221,6,15,7,14,44,48,-4,52
Alloa,5221,7,14,9,13,59,49,10,51
Stranraer,5221,8,14,7,15,57,56,1,49
East Fife,5221,9,9,9,18,48,56,-8,36
Stenhousem'r,5221,10,4,6,26,37,82,-45,18
Brechin,5222,1,19,7,10,64,49,15,64
Alloa,5222,2,19,6,11,69,41,28,63
Airdrieon,5222,3,18,7,11,54,48,6,61
Livingston,5222,4,17,6,13,63,47,16,57
East Fife,5222,5,15,8,13,57,46,11,53
Peterhead,5222,6,15,4,17,44,58,-14,49
Albion,5222,7,12,11,13,54,54,0,47
Stranraer,5222,8,12,7,17,52,60,-8,43
Queen's Park,5222,9,12,5,19,35,53,-18,41
Stenhousem'r,5222,10,7,7,22,45,81,-36,28
Livingston,5223,1,21,5,10,71,46,25,68
Airdrieon,5223,2,17,12,7,63,49,14,63
Brechin,5223,3,18,6,12,61,44,17,60
Albion,5223,4,16,8,12,61,54,7,56
Stranraer,5223,5,16,7,13,63,57,6,55
Alloa,5223,6,15,6,15,63,60,3,51
Peterhead,5223,7,11,11,14,46,59,-13,44
East Fife,5223,8,12,7,17,51,46,5,43
Queen's Park,5223,9,9,7,20,39,57,-18,34
Stenhousem'r,5223,10,6,9,21,49,95,-46,27
Airdrieon,5224,1,17,7,12,61,55,6,58
Stranraer,5224,2,17,6,13,50,46,4,57
Livingston,5224,3,16,7,13,66,49,17,55
Alloa,5224,4,15,10,11,58,45,13,55
Albion,5224,5,15,10,11,56,50,6,55
Brechin,5224,6,16,6,14,52,44,8,54
Queen's Park,5224,7,16,6,14,42,47,-5,54
Peterhead,5224,8,12,9,15,48,55,-7,45
East Fife,5224,9,8,15,13,49,51,-2,39
Stenhousem'r,5224,10,6,8,22,47,87,-40,26
Airdrieon,5225,1,17,8,11,52,50,2,59
Alloa,5225,2,16,10,10,55,38,17,58
Livingston,5225,3,17,6,13,73,54,19,57
Brechin,5225,4,17,5,14,55,56,-1,56
East Fife,5225,5,15,10,11,48,39,9,55
Albion,5225,6,16,6,14,54,48,6,54
Queen's Park,5225,7,14,7,15,40,47,-7,49
Peterhead,5225,8,13,9,14,52,50,2,48
Stranraer,5225,9,11,7,18,42,54,-12,40
Stenhousem'r,5225,10,6,8,22,46,81,-35,26
Livingston,5226,1,23,3,10,84,53,31,72
Alloa,5226,2,19,7,10,66,39,27,64
Airdrieon,5226,3,18,5,13,59,54,5,59
Brechin,5226,4,17,4,15,52,51,1,55
Peterhead,5226,5,14,8,14,55,58,-3,50
East Fife,5226,6,10,12,14,57,55,2,42
Albion,5226,7,11,9,16,55,63,-8,42
Stranraer,5226,8,12,6,18,45,58,-13,42
Stenhousem'r,5226,9,11,8,17,52,77,-25,41
Queen's Park,5226,10,11,6,19,39,56,-17,39
Alloa,5227,1,21,8,7,72,39,33,71
Livingston,5227,2,20,4,12,75,55,20,64
Brechin,5227,3,19,5,12,47,41,6,62
Airdrieon,5227,4,15,8,13,63,59,4,53
East Fife,5227,5,14,8,14,45,41,4,50
Stranraer,5227,6,15,5,16,56,60,-4,50
Albion,5227,7,10,13,13,42,42,0,43
Queen's Park,5227,8,10,10,16,37,57,-20,40
Peterhead,5227,9,9,10,17,44,59,-15,37
Stenhousem'r,5227,10,8,7,21,41,69,-28,31
Livingston,5228,1,24,4,8,96,48,48,76
Alloa,5228,2,19,9,8,64,40,24,66
Airdrieon,5228,3,18,6,12,60,53,7,60
Brechin,5228,4,16,7,13,43,41,2,55
Stranraer,5228,5,16,3,17,58,54,4,51
Peterhead,5228,6,12,10,14,39,43,-4,46
Albion,5228,7,12,9,15,49,57,-8,45
East Fife,5228,8,11,11,14,44,43,1,44
Queen's Park,5228,9,8,7,21,33,63,-30,31
Stenhousem'r,5228,10,5,12,19,44,88,-44,27
Brechin,5229,1,20,7,9,63,45,18,67
Livingston,5229,2,20,6,10,71,42,29,66
Airdrieon,5229,3,18,8,10,67,51,16,62
Alloa,5229,4,18,7,11,72,44,28,61
Albion,5229,5,13,10,13,53,57,-4,49
Peterhead,5229,6,13,9,14,48,53,-5,48
East Fife,5229,7,10,11,15,52,50,2,41
Stranraer,5229,8,12,5,19,52,69,-17,41
Queen's Park,5229,9,10,5,21,28,54,-26,35
Stenhousem'r,5229,10,9,6,21,50,91,-41,33
Alloa,5230,1,19,9,8,61,38,23,66
Brechin,5230,2,20,6,10,54,41,13,66
Livingston,5230,3,19,6,11,68,46,22,63
Stranraer,5230,4,18,5,13,63,52,11,59
Peterhead,5230,5,15,11,10,61,50,11,56
Airdrieon,5230,6,14,9,13,56,56,0,51
Albion,5230,7,12,6,18,50,57,-7,42
Queen's Park,5230,8,9,9,18,37,65,-28,36
East Fife,5230,9,8,10,18,44,56,-12,34
Stenhousem'r,5230,10,7,7,22,48,81,-33,28
Airdrieon,5231,1,22,6,8,62,42,20,72
Alloa,5231,2,20,7,9,67,45,22,67
Livingston,5231,3,19,3,14,68,50,18,60
East Fife,5231,4,14,7,15,47,40,7,49
Brechin,5231,5,12,12,12,50,51,-1,48
Stranraer,5231,6,14,4,18,55,59,-4,46
Peterhead,5231,7,12,9,15,47,54,-7,45
Stenhousem'r,5231,8,12,4,20,45,77,-32,40
Albion,5231,9,10,9,17,41,47,-6,39
Queen's Park,5231,10,10,9,17,30,47,-17,39
Alloa,5232,1,23,4,9,80,40,40,73
Peterhead,5232,2,16,7,13,53,46,7,55
Queen's Park,5232,3,16,7,13,43,51,-8,55
Brechin,5232,4,14,9,13,49,49,0,51
Livingston,5232,5,14,8,14,59,53,6,50
Stranraer,5232,6,14,7,15,53,59,-6,49
Albion,5232,7,13,9,14,48,46,2,48
Airdrieon,5232,8,13,8,15,54,63,-9,47
East Fife,5232,9,9,10,17,43,51,-8,37
Stenhousem'r,5232,10,10,7,19,45,69,-24,37
Livingston,5233,1,21,4,11,78,49,29,67
Alloa,5233,2,19,9,8,66,39,27,66
Airdrieon,5233,3,17,7,12,65,55,10,58
Brechin,5233,4,17,6,13,53,47,6,57
Albion,5233,5,16,7,13,58,45,13,55
Queen's Park,5233,6,17,4,15,43,48,-5,55
East Fife,5233,7,10,13,13,45,50,-5,43
Peterhead,5233,8,11,7,18,49,58,-9,40
Stranraer,5233,9,10,7,19,49,71,-22,37
Stenhousem'r,5233,10,6,8,22,44,88,-44,26
Livingston,5234,1,24,2,10,74,44,30,74
Alloa,5234,2,22,5,9,77,38,39,71
Brechin,5234,3,17,6,13,50,48,2,57
Albion,5234,4,14,9,13,49,44,5,51
Airdrieon,5234,5,15,5,16,58,55,3,50
East Fife,5234,6,13,8,15,48,50,-2,47
Peterhead,5234,7,14,5,17,45,57,-12,47
Queen's Park,5234,8,13,6,17,36,51,-15,45
Stranraer,5234,9,12,4,20,43,57,-14,40
Stenhousem'r,5234,10,7,8,21,52,88,-36,29
Livingston,5235,1,18,6,12,70,56,14,60
Airdrieon,5235,2,17,7,12,61,54,7,58
Alloa,5235,3,16,9,11,64,45,19,57
Peterhead,5235,4,16,9,11,52,42,10,57
Albion,5235,5,16,7,13,62,56,6,55
Stranraer,5235,6,16,5,15,58,54,4,53
East Fife,5235,7,13,10,13,49,39,10,49
Brechin,5235,8,12,9,15,38,48,-10,45
Queen's Park,5235,9,9,9,18,31,54,-23,36
Stenhousem'r,5235,10,8,7,21,44,81,-37,31
Alloa,5236,1,21,8,7,82,42,40,71
Livingston,5236,2,19,7,10,77,50,27,64
Airdrieon,5236,3,18,6,12,54,49,5,60
Brechin,5236,4,15,7,14,45,50,-5,52
Peterhead,5236,5,13,12,11,49,47,2,51
Albion,5236,6,13,8,15,60,56,4,47
Queen's Park,5236,7,12,8,16,46,60,-14,44
Stranraer,5236,8,11,5,20,44,64,-20,38
Stenhousem'r,5236,9,9,10,17,54,75,-21,37
East Fife,5236,10,9,9,18,46,64,-18,36
Alloa,5237,1,23,5,8,75,41,34,74
Livingston,5237,2,20,6,10,85,52,33,66
Brechin,5237,3,17,6,13,52,45,7,57
Airdrieon,5237,4,14,7,15,52,59,-7,49
Peterhead,5237,5,12,11,13,44,50,-6,47
East Fife,5237,6,10,13,13,46,44,2,43
Queen's Park,5237,7,11,10,15,42,55,-13,43
Stranraer,5237,8,13,4,19,52,66,-14,43
Albion,5237,9,11,9,16,54,58,-4,42
Stenhousem'r,5237,10,8,11,17,45,77,-32,35
Livingston,5238,1,24,5,7,75,46,29,77
Alloa,5238,2,18,6,12,61,43,18,60
Airdrieon,5238,3,17,9,10,67,56,11,60
Brechin,5238,4,16,8,12,53,46,7,56
Albion,5238,5,13,9,14,57,56,1,48
East Fife,5238,6,12,10,14,61,54,7,46
Stranraer,5238,7,14,3,19,54,60,-6,45
Peterhead,5238,8,11,11,14,50,60,-10,44
Queen's Park,5238,9,8,10,18,31,57,-26,34
Stenhousem'r,5238,10,7,9,20,45,76,-31,30
Airdrieon,5239,1,21,6,9,72,50,22,69
Livingston,5239,2,20,4,12,74,57,17,64
Brechin,5239,3,18,7,11,50,36,14,61
Alloa,5239,4,17,9,10,65,41,24,60
Albion,5239,5,16,7,13,60,55,5,55
Peterhead,5239,6,15,10,11,47,50,-3,55
Stranraer,5239,7,9,8,19,52,71,-19,35
East Fife,5239,8,8,10,18,42,55,-13,34
Stenhousem'r,5239,9,9,7,20,58,81,-23,34
Queen's Park,5239,10,8,10,18,29,53,-24,34
Livingston,5240,1,23,2,11,80,47,33,71
Alloa,5240,2,19,9,8,68,38,30,66
Albion,5240,3,17,9,10,63,47,16,60
Airdrieon,5240,4,16,7,13,51,51,0,55
East Fife,5240,5,13,10,13,42,42,0,49
Brechin,5240,6,13,8,15,45,50,-5,47
Stranraer,5240,7,13,7,16,51,57,-6,46
Peterhead,5240,8,11,7,18,46,60,-14,40
Queen's Park,5240,9,9,11,16,35,47,-12,38
Stenhousem'r,5240,10,8,6,22,46,88,-42,30
Livingston,5241,1,25,3,8,84,46,38,78
Alloa,5241,2,17,10,9,74,43,31,61
Brechin,5241,3,18,5,13,51,44,7,59
Airdrieon,5241,4,17,5,14,59,57,2,56
Peterhead,5241,5,15,5,16,55,57,-2,50
Queen's Park,5241,6,13,9,14,46,54,-8,48
Albion,5241,7,13,5,18,61,63,-2,44
Stranraer,5241,8,13,5,18,53,68,-15,44
East Fife,5241,9,9,12,15,48,55,-7,39
Stenhousem'r,5241,10,6,9,21,48,92,-44,27
Livingston,5242,1,24,0,12,72,51,21,72
Airdrieon,5242,2,19,8,9,65,53,12,65
Alloa,5242,3,19,7,10,73,46,27,64
Albion,5242,4,18,4,14,64,43,21,58
Brechin,5242,5,18,4,14,50,54,-4,58
Queen's Park,5242,6,14,8,14,38,44,-6,50
Peterhead,5242,7,12,6,18,47,57,-10,42
East Fife,5242,8,10,11,15,43,45,-2,41
Stranraer,5242,9,11,4,21,44,61,-17,37
Stenhousem'r,5242,10,4,10,22,35,77,-42,22
Alloa,5243,1,21,9,6,72,40,32,72
Livingston,5243,2,18,6,12,72,52,20,60
Airdrieon,5243,3,16,7,13,56,55,1,55
Albion,5243,4,16,6,14,59,50,9,54
Peterhead,5243,5,13,12,11,51,54,-3,51
Stranraer,5243,6,12,8,16,49,60,-11,44
Queen's Park,5243,7,13,5,18,43,55,-12,44
Stenhousem'r,5243,8,11,8,17,51,70,-19,41
Brechin,5243,9,10,10,16,43,56,-13,40
East Fife,5243,10,8,13,15,38,42,-4,37
Livingston,5244,1,24,3,9,92,50,42,75
Alloa,5244,2,17,11,8,70,49,21,62
Airdrieon,5244,3,17,7,12,66,61,5,58
Brechin,5244,4,15,5,16,39,50,-11,50
Queen's Park,5244,5,13,8,15,42,55,-13,47
Albion,5244,6,12,10,14,55,56,-1,46
East Fife,5244,7,10,13,13,53,51,2,43
Stranraer,5244,8,11,8,17,50,59,-9,41
Peterhead,5244,9,10,9,17,51,63,-12,39
Stenhousem'r,5244,10,11,6,19,50,74,-24,39
Alloa,5245,1,22,4,10,73,48,25,70
Livingston,5245,2,18,5,13,67,48,19,59
Queen's Park,5245,3,16,8,12,40,42,-2,56
Albion,5245,4,14,9,13,52,52,0,51
Brechin,5245,5,15,6,15,44,46,-2,51
Airdrieon,5245,6,14,7,15,60,59,1,49
East Fife,5245,7,13,8,15,53,44,9,47
Stranraer,5245,8,14,4,18,51,59,-8,46
Peterhead,5245,9,12,10,14,52,62,-10,46
Stenhousem'r,5245,10,9,5,22,53,85,-32,32
Livingston,5246,1,24,3,9,79,42,37,75
Alloa,5246,2,17,8,11,67,46,21,59
Peterhead,5246,3,17,7,12,59,54,5,58
Brechin,5246,4,16,7,13,49,48,1,55
Airdrieon,5246,5,15,4,17,55,60,-5,49
Stranraer,5246,6,13,8,15,54,57,-3,47
Albion,5246,7,12,9,15,53,59,-6,45
Queen's Park,5246,8,10,11,15,26,45,-19,41
East Fife,5246,9,9,10,17,49,53,-4,37
Stenhousem'r,5246,10,10,7,19,50,77,-27,37
Livingston,5247,1,21,6,9,73,44,29,69
Alloa,5247,2,17,8,11,80,54,26,59
Airdrieon,5247,3,17,4,15,60,55,5,55
Queen's Park,5247,4,16,4,16,37,47,-10,52
Peterhead,5247,5,14,9,13,60,57,3,51
Brechin,5247,6,14,7,15,52,58,-6,49
Albion,5247,7,13,9,14,53,57,-4,48
East Fife,5247,8,12,9,15,51,52,-1,45
Stranraer,5247,9,12,7,17,48,55,-7,43
Stenhousem'r,5247,10,9,7,20,52,87,-35,34
Livingston,5248,1,23,5,8,75,44,31,74
Alloa,5248,2,15,13,8,70,48,22,58
Brechin,5248,3,18,4,14,50,47,3,58
Airdrieon,5248,4,14,7,15,53,53,0,49
Albion,5248,5,13,9,14,53,53,0,48
Queen's Park,5248,6,13,9,14,46,50,-4,48
East Fife,5248,7,12,11,13,52,49,3,47
Peterhead,5248,8,12,10,14,53,55,-2,46
Stranraer,5248,9,11,7,18,45,59,-14,40
Stenhousem'r,5248,10,4,15,17,39,78,-39,27
Alloa,5249,1,19,7,10,64,40,24,64
Airdrieon,5249,2,18,7,11,60,53,7,61
Brechin,5249,3,17,6,13,49,48,1,57
Livingston,5249,4,17,4,15,74,57,17,55
Peterhead,5249,5,16,7,13,63,54,9,55
Stranraer,5249,6,13,6,17,59,64,-5,45
Albion,5249,7,12,7,17,41,55,-14,43
East Fife,5249,8,11,9,16,52,53,-1,42
Queen's Park,5249,9,10,11,15,34,56,-22,41
Stenhousem'r,5249,10,10,10,16,46,62,-16,40
Alloa,5250,1,18,10,8,78,39,39,64
Livingston,5250,2,20,4,12,78,50,28,64
Peterhead,5250,3,17,6,13,52,52,0,57
Albion,5250,4,16,8,12,51,43,8,56
Brechin,5250,5,17,4,15,45,51,-6,55
Airdrieon,5250,6,15,5,16,53,56,-3,50
East Fife,5250,7,12,8,16,52,51,1,44
Stenhousem'r,5250,8,12,6,18,51,75,-24,42
Stranraer,5250,9,11,8,17,43,61,-18,41
Queen's Park,5250,10,10,5,21,38,63,-25,35
Brechin,5251,1,18,9,9,65,49,16,63
Livingston,5251,2,18,5,13,78,57,21,59
Alloa,5251,3,17,8,11,62,49,13,59
Airdrieon,5251,4,16,9,11,57,57,0,57
Albion,5251,5,14,8,14,46,58,-12,50
Queen's Park,5251,6,13,7,16,48,49,-1,46
Stranraer,5251,7,11,11,14,52,55,-3,44
Peterhead,5251,8,11,11,14,51,54,-3,44
East Fife,5251,9,7,15,14,46,50,-4,36
Stenhousem'r,5251,10,9,9,18,54,81,-27,36
Livingston,5252,1,18,8,10,74,47,27,62
Airdrieon,5252,2,16,11,9,64,52,12,59
Alloa,5252,3,15,11,10,64,47,17,56
Brechin,5252,4,16,8,12,45,41,4,56
Stranraer,5252,5,17,5,14,64,65,-1,56
Peterhead,5252,6,15,8,13,47,52,-5,53
Albion,5252,7,13,10,13,52,47,5,49
East Fife,5252,8,11,11,14,40,38,2,44
Queen's Park,5252,9,9,12,15,36,53,-17,39
Stenhousem'r,5252,10,4,8,24,41,85,-44,20
Airdrieon,5253,1,20,8,8,62,45,17,68
Alloa,5253,2,20,7,9,75,44,31,67
Livingston,5253,3,19,7,10,72,46,26,64
Brechin,5253,4,14,12,10,44,40,4,54
East Fife,5253,5,13,10,13,49,42,7,49
Albion,5253,6,12,11,13,46,51,-5,47
Peterhead,5253,7,12,8,16,44,50,-6,44
Stranraer,5253,8,10,6,20,49,65,-16,36
Queen's Park,5253,9,9,9,18,31,57,-26,36
Stenhousem'r,5253,10,8,8,20,44,76,-32,32
Livingston,5254,1,23,2,11,80,48,32,71
Alloa,5254,2,17,8,11,63,45,18,59
Airdrieon,5254,3,18,5,13,59,53,6,59
Brechin,5254,4,18,3,15,52,45,7,57
Peterhead,5254,5,14,9,13,41,49,-8,51
Albion,5254,6,14,8,14,56,51,5,50
East Fife,5254,7,12,9,15,46,47,-1,45
Stranraer,5254,8,12,6,18,43,59,-16,42
Stenhousem'r,5254,9,11,5,20,45,72,-27,38
Queen's Park,5254,10,9,9,18,39,55,-16,36
Livingston,5255,1,21,4,11,75,48,27,67
Alloa,5255,2,18,10,8,70,38,32,64
Airdrieon,5255,3,18,5,13,66,52,14,59
Queen's Park,5255,4,17,7,12,41,36,5,58
Brechin,5255,5,18,4,14,53,60,-7,58
Albion,5255,6,16,8,12,58,54,4,56
East Fife,5255,7,10,13,13,44,45,-1,43
Peterhead,5255,8,12,7,17,43,50,-7,43
Stranraer,5255,9,8,7,21,36,62,-26,31
Stenhousem'r,5255,10,7,5,24,39,80,-41,26
Livingston,5256,1,18,7,11,71,51,20,61
Airdrieon,5256,2,18,7,11,65,53,12,61
Alloa,5256,3,16,9,11,57,42,15,57
Peterhead,5256,4,15,11,10,53,49,4,56
Brechin,5256,5,15,9,12,56,51,5,54
East Fife,5256,6,13,13,10,57,49,8,52
Albion,5256,7,12,9,15,55,51,4,45
Queen's Park,5256,8,12,7,17,41,56,-15,43
Stenhousem'r,5256,9,9,9,18,63,90,-27,36
Stranraer,5256,10,10,3,23,40,66,-26,33
Alloa,5257,1,21,8,7,71,35,36,71
Livingston,5257,2,21,4,11,81,54,27,67
Airdrieon,5257,3,17,10,9,61,44,17,61
Brechin,5257,4,18,6,12,51,42,9,60
East Fife,5257,5,14,8,14,47,43,4,50
Albion,5257,6,13,10,13,52,50,2,49
Peterhead,5257,7,13,10,13,45,55,-10,49
Stranraer,5257,8,10,8,18,53,66,-13,38
Queen's Park,5257,9,9,10,17,30,47,-17,37
Stenhousem'r,5257,10,3,8,25,37,92,-55,17
Livingston,5258,1,23,4,9,75,47,28,73
Alloa,5258,2,19,9,8,69,43,26,66
Albion,5258,3,17,7,12,69,55,14,58
East Fife,5258,4,15,9,12,50,41,9,54
Peterhead,5258,5,15,7,14,48,49,-1,52
Brechin,5258,6,14,10,12,45,47,-2,52
Airdrieon,5258,7,15,5,16,57,60,-3,50
Stranraer,5258,8,9,8,19,49,64,-15,35
Queen's Park,5258,9,7,12,17,32,51,-19,33
Stenhousem'r,5258,10,7,7,22,44,81,-37,28
Livingston,5259,1,26,4,6,80,37,43,82
Alloa,5259,2,21,5,10,72,46,26,68
Airdrieon,5259,3,18,5,13,72,59,13,59
Brechin,5259,4,18,5,13,56,46,10,59
Albion,5259,5,17,5,14,61,50,11,56
Peterhead,5259,6,16,6,14,61,53,8,54
Queen's Park,5259,7,11,5,20,35,57,-22,38
East Fife,5259,8,8,10,18,44,57,-13,34
Stranraer,5259,9,8,10,18,47,68,-21,34
Stenhousem'r,5259,10,6,7,23,40,95,-55,25
Livingston,5260,1,23,4,9,75,38,37,73
Alloa,5260,2,19,7,10,74,54,20,64
Brechin,5260,3,19,5,12,45,36,9,62
Airdrieon,5260,4,17,8,11,62,51,11,59
Stranraer,5260,5,18,4,14,55,50,5,58
Albion,5260,6,15,6,15,51,57,-6,51
East Fife,5260,7,12,9,15,41,40,1,45
Peterhead,5260,8,13,5,18,48,57,-9,44
Queen's Park,5260,9,8,7,21,32,64,-32,31
Stenhousem'r,5260,10,3,11,22,37,73,-36,20
Alloa,5261,1,20,6,10,68,47,21,66
Livingston,5261,2,20,5,11,77,52,25,65
Brechin,5261,3,20,4,12,57,44,13,64
Airdrieon,5261,4,17,6,13,55,50,5,57
Peterhead,5261,5,14,9,13,54,48,6,51
Stranraer,5261,6,15,3,18,53,62,-9,48
Queen's Park,5261,7,12,8,16,34,50,-16,44
Albion,5261,8,10,10,16,47,57,-10,40
East Fife,5261,9,8,11,17,40,52,-12,35
Stenhousem'r,5261,10,9,8,19,52,75,-23,35
Livingston,5262,1,20,4,12,78,60,18,64
Brechin,5262,2,18,7,11,60,47,13,61
Alloa,5262,3,16,10,10,66,48,18,58
Airdrieon,5262,4,16,9,11,50,43,7,57
Peterhead,5262,5,15,8,13,48,53,-5,53
Queen's Park,5262,6,13,10,13,46,53,-7,49
Albion,5262,7,12,11,13,48,54,-6,47
East Fife,5262,8,10,9,17,45,56,-11,39
Stranraer,5262,9,11,5,20,50,57,-7,38
Stenhousem'r,5262,10,10,5,21,58,78,-20,35
Alloa,5263,1,20,5,11,70,43,27,65
Livingston,5263,2,19,6,11,65,50,15,63
Airdrieon,5263,3,19,5,12,69,54,15,62
Brechin,5263,4,18,5,13,49,45,4,59
Albion,5263,5,15,11,10,46,38,8,56
East Fife,5263,6,13,8,15,48,49,-1,47
Peterhead,5263,7,12,8,16,50,59,-9,44
Stranraer,5263,8,11,6,19,54,65,-11,39
Queen's Park,5263,9,9,8,19,37,60,-23,35
Stenhousem'r,5263,10,8,10,18,49,74,-25,34
Livingston,5264,1,21,6,9,72,40,32,69
Alloa,5264,2,19,9,8,67,45,22,66
Albion,5264,3,18,8,10,57,45,12,62
Airdrieon,5264,4,15,9,12,57,57,0,54
Brechin,5264,5,17,3,16,50,56,-6,54
Queen's Park,5264,6,14,8,14,40,43,-3,50
Peterhead,5264,7,13,8,15,49,51,-2,47
East Fife,5264,8,11,7,18,44,45,-1,40
Stranraer,5264,9,11,3,22,44,64,-20,36
Stenhousem'r,5264,10,7,7,22,47,81,-34,28
Alloa,5265,1,22,5,9,76,49,27,71
Brechin,5265,2,21,3,12,58,48,10,66
Livingston,5265,3,20,5,11,79,60,19,65
Airdrieon,5265,4,18,8,10,62,48,14,62
Queen's Park,5265,5,15,8,13,39,44,-5,53
Albion,5265,6,15,7,14,56,50,6,52
Peterhead,5265,7,12,7,17,49,53,-4,43
Stranraer,5265,8,10,8,18,44,55,-11,38
East Fife,5265,9,9,8,19,46,60,-14,35
Stenhousem'r,5265,10,5,7,24,35,77,-42,22
Albion,5266,1,20,7,9,64,50,14,67
Livingston,5266,2,20,5,11,81,50,31,65
Alloa,5266,3,19,7,10,72,44,28,64
Peterhead,5266,4,16,7,13,60,56,4,55
Airdrieon,5266,5,15,6,15,58,62,-4,51
Stranraer,5266,6,15,5,16,63,67,-4,50
Brechin,5266,7,13,8,15,54,62,-8,47
Queen's Park,5266,8,11,7,18,35,55,-20,40
East Fife,5266,9,10,8,18,49,59,-10,38
Stenhousem'r,5266,10,8,6,22,49,80,-31,30
Livingston,5267,1,22,7,7,79,43,36,73
Alloa,5267,2,20,4,12,70,40,30,64
Brechin,5267,3,19,5,12,56,55,1,62
Airdrieon,5267,4,16,10,10,65,56,9,58
Peterhead,5267,5,17,7,12,45,47,-2,58
Albion,5267,6,15,7,14,62,57,5,52
Stranraer,5267,7,12,5,19,50,59,-9,41
East Fife,5267,8,9,10,17,50,52,-2,37
Queen's Park,5267,9,8,8,20,36,64,-28,32
Stenhousem'r,5267,10,6,9,21,38,78,-40,27
Alloa,5268,1,19,8,9,72,47,25,65
Livingston,5268,2,20,5,11,70,45,25,65
Airdrieon,5268,3,17,9,10,65,53,12,60
Brechin,5268,4,18,6,12,53,45,8,60
East Fife,5268,5,12,13,11,57,45,12,49
Albion,5268,6,12,12,12,57,58,-1,48
Peterhead,5268,7,11,11,14,42,57,-15,44
Queen's Park,5268,8,11,7,18,34,54,-20,40
Stranraer,5268,9,11,4,21,45,55,-10,37
Stenhousem'r,5268,10,7,9,20,49,85,-36,30
Livingston,5269,1,23,5,8,78,34,44,74
Alloa,5269,2,22,6,8,76,49,27,72
Albion,5269,3,17,7,12,54,40,14,58
Brechin,5269,4,16,6,14,45,42,3,54
Airdrieon,5269,5,15,8,13,54,48,6,53
Peterhead,5269,6,13,9,14,46,51,-5,48
Stranraer,5269,7,12,8,16,40,52,-12,44
East Fife,5269,8,11,8,17,42,46,-4,41
Queen's Park,5269,9,10,4,22,31,54,-23,34
Stenhousem'r,5269,10,7,7,22,32,82,-50,28
Livingston,5270,1,20,5,11,65,41,24,65
Alloa,5270,2,19,7,10,71,40,31,64
Airdrieon,5270,3,17,8,11,59,53,6,59
East Fife,5270,4,14,9,13,53,49,4,51
Brechin,5270,5,15,6,15,49,49,0,51
Albion,5270,6,13,9,14,45,46,-1,48
Queen's Park,5270,7,14,5,17,39,51,-12,47
Peterhead,5270,8,12,8,16,43,47,-4,44
Stranraer,5270,9,13,5,18,52,62,-10,44
Stenhousem'r,5270,10,9,6,21,46,84,-38,33
Alloa,5271,1,20,6,10,67,37,30,66
Livingston,5271,2,19,5,12,67,57,10,62
Airdrieon,5271,3,17,6,13,54,52,2,57
Brechin,5271,4,16,7,13,45,47,-2,55
Queen's Park,5271,5,16,7,13,41,44,-3,55
Peterhead,5271,6,16,6,14,53,53,0,54
Albion,5271,7,15,6,15,51,50,1,51
East Fife,5271,8,10,10,16,52,48,4,40
Stranraer,5271,9,11,7,18,46,57,-11,40
Stenhousem'r,5271,10,6,8,22,49,80,-31,26
Alloa,5272,1,21,7,8,72,44,28,70
Livingston,5272,2,21,4,11,75,40,35,67
Airdrieon,5272,3,16,8,12,61,52,9,56
Brechin,5272,4,15,7,14,46,54,-8,52
Peterhead,5272,5,14,9,13,49,53,-4,51
Queen's Park,5272,6,14,9,13,39,44,-5,51
East Fife,5272,7,14,8,14,46,39,7,50
Albion,5272,8,14,7,15,52,55,-3,49
Stranraer,5272,9,7,7,22,39,62,-23,28
Stenhousem'r,5272,10,6,10,20,42,78,-36,28
Airdrieon,5273,1,22,5,9,72,52,20,71
Livingston,5273,2,21,5,10,73,42,31,68
Alloa,5273,3,18,10,8,68,42,26,64
Brechin,5273,4,16,7,13,53,50,3,55
Albion,5273,5,15,6,15,59,54,5,51
Peterhead,5273,6,13,9,14,48,51,-3,48
Stranraer,5273,7,13,6,17,49,56,-7,45
East Fife,5273,8,10,10,16,42,53,-11,40
Stenhousem'r,5273,9,8,10,18,48,74,-26,34
Queen's Park,5273,10,8,4,24,22,60,-38,28
Livingston,5274,1,19,9,8,79,51,28,66
Alloa,5274,2,17,7,12,72,44,28,58
Airdrieon,5274,3,17,6,13,59,51,8,57
Albion,5274,4,17,5,14,55,47,8,56
Brechin,5274,5,14,10,12,46,44,2,52
Stranraer,5274,6,14,5,17,54,62,-8,47
Queen's Park,5274,7,14,5,17,38,50,-12,47
Peterhead,5274,8,13,6,17,48,55,-7,45
Stenhousem'r,5274,9,11,6,19,50,82,-32,39
East Fife,5274,10,9,11,16,37,52,-15,38
Livingston,5275,1,21,5,10,71,44,27,68
Airdrieon,5275,2,21,5,10,60,42,18,68
Alloa,5275,3,17,10,9,69,44,25,61
Queen's Park,5275,4,18,4,14,51,49,2,58
Brechin,5275,5,18,3,15,50,53,-3,57
Albion,5275,6,14,7,15,50,50,0,49
Stranraer,5275,7,12,8,16,47,51,-4,44
Peterhead,5275,8,11,9,16,43,53,-10,42
East Fife,5275,9,7,10,19,39,58,-19,31
Stenhousem'r,5275,10,7,7,22,39,75,-36,28
Alloa,5276,1,18,9,9,78,43,35,63
Livingston,5276,2,19,3,14,69,51,18,60
Airdrieon,5276,3,18,6,12,59,53,6,60
Brechin,5276,4,15,9,12,50,47,3,54
Queen's Park,5276,5,14,11,11,41,44,-3,53
Peterhead,5276,6,13,8,15,46,53,-7,47
East Fife,5276,7,11,13,12,53,45,8,46
Albion,5276,8,11,11,14,52,62,-10,44
Stranraer,5276,9,11,6,19,52,69,-17,39
Stenhousem'r,5276,10,7,10,19,47,80,-33,31
Alloa,5277,1,23,6,7,83,47,36,75
Brechin,5277,2,17,7,12,52,44,8,58
Livingston,5277,3,17,6,13,71,55,16,57
Albion,5277,4,14,9,13,53,53,0,51
Queen's Park,5277,5,14,8,14,41,45,-4,50
Airdrieon,5277,6,13,10,13,56,56,0,49
Peterhead,5277,7,15,3,18,47,63,-16,48
East Fife,5277,8,11,9,16,49,56,-7,42
Stranraer,5277,9,10,8,18,51,59,-8,38
Stenhousem'r,5277,10,10,6,20,55,80,-25,36
Livingston,5278,1,24,1,11,81,49,32,73
Alloa,5278,2,18,9,9,74,49,25,63
Airdrieon,5278,3,18,5,13,68,58,10,59
Brechin,5278,4,15,9,12,57,52,5,54
Albion,5278,5,14,10,12,54,50,4,52
Stranraer,5278,6,15,6,15,58,57,1,51
Peterhead,5278,7,13,7,16,45,55,-10,46
Queen's Park,5278,8,11,7,18,40,58,-18,40
East Fife,5278,9,10,8,18,45,61,-16,38
Stenhousem'r,5278,10,5,12,19,46,79,-33,27
Livingston,5279,1,21,4,11,80,54,26,67
Airdrieon,5279,2,18,9,9,67,57,10,63
Alloa,5279,3,18,7,11,64,49,15,61
Brechin,5279,4,17,6,13,62,50,12,57
Albion,5279,5,15,10,11,59,52,7,55
Stranraer,5279,6,17,3,16,56,54,2,54
Queen's Park,5279,7,14,7,15,38,44,-6,49
Peterhead,5279,8,11,7,18,50,61,-11,40
East Fife,5279,9,8,8,20,43,64,-21,32
Stenhousem'r,5279,10,7,7,22,53,87,-34,28
Livingston,5280,1,24,6,6,86,41,45,78
Alloa,5280,2,18,9,9,69,47,22,63
Airdrieon,5280,3,16,6,14,55,59,-4,54
Brechin,5280,4,16,5,15,56,57,-1,53
Peterhead,5280,5,13,11,12,47,44,3,50
Stranraer,5280,6,14,7,15,59,59,0,49
Albion,5280,7,12,9,15,52,60,-8,45
East Fife,5280,8,12,7,17,46,48,-2,43
Queen's Park,5280,9,10,8,18,39,59,-20,38
Stenhousem'r,5280,10,7,8,21,56,91,-35,29
Livingston,5281,1,21,4,11,77,49,28,67
Alloa,5281,2,19,7,10,81,48,33,64
Brechin,5281,3,18,4,14,55,49,6,58
Airdrieon,5281,4,16,9,11,64,60,4,57
Stranraer,5281,5,14,7,15,50,60,-10,49
Albion,5281,6,13,7,16,49,48,1,46
Peterhead,5281,7,11,9,16,46,60,-14,42
Queen's Park,5281,8,11,8,17,34,52,-18,41
East Fife,5281,9,10,10,16,44,51,-7,40
Stenhousem'r,5281,10,10,9,17,48,71,-23,39
Alloa,5282,1,18,8,10,68,45,23,62
Albion,5282,2,16,11,9,57,41,16,59
Livingston,5282,3,18,4,14,64,55,9,58
Brechin,5282,4,15,9,12,58,51,7,54
Airdrieon,5282,5,15,6,15,61,69,-8,51
Stranraer,5282,6,14,8,14,58,52,6,50
East Fife,5282,7,13,10,13,55,48,7,49
Peterhead,5282,8,13,8,15,45,60,-15,47
Queen's Park,5282,9,9,11,16,39,58,-19,38
Stenhousem'r,5282,10,7,9,20,39,65,-26,30
Alloa,5283,1,19,12,5,71,41,30,69
Livingston,5283,2,19,7,10,76,47,29,64
Brechin,5283,3,16,4,16,54,55,-1,52
Stranraer,5283,4,15,6,15,47,52,-5,51
Queen's Park,5283,5,15,6,15,43,49,-6,51
Airdrieon,5283,6,15,4,17,62,62,0,49
East Fife,5283,7,12,8,16,54,53,1,44
Albion,5283,8,12,7,17,42,49,-7,43
Peterhead,5283,9,12,7,17,49,59,-10,43
Stenhousem'r,5283,10,10,9,17,49,80,-31,39
Alloa,5284,1,21,7,8,80,45,35,70
Airdrieon,5284,2,18,7,11,62,50,12,61
Livingston,5284,3,18,6,12,64,52,12,60
Brechin,5284,4,16,6,14,46,46,0,54
Albion,5284,5,14,11,11,53,49,4,53
Stranraer,5284,6,16,5,15,52,52,0,53
Queen's Park,5284,7,12,8,16,38,54,-16,44
Peterhead,5284,8,11,9,16,48,58,-10,42
Stenhousem'r,5284,9,8,9,19,49,78,-29,33
East Fife,5284,10,6,12,18,43,51,-8,30
Alloa,5285,1,19,9,8,69,46,23,66
Livingston,5285,2,19,8,9,77,54,23,65
Airdrieon,5285,3,17,8,11,63,54,9,59
Peterhead,5285,4,17,7,12,53,45,8,58
Albion,5285,5,16,7,13,61,55,6,55
Stranraer,5285,6,14,6,16,49,52,-3,48
Brechin,5285,7,12,6,18,48,52,-4,42
East Fife,5285,8,12,5,19,47,57,-10,41
Queen's Park,5285,9,10,9,17,41,59,-18,39
Stenhousem'r,5285,10,8,7,21,43,77,-34,31
Alloa,5286,1,18,8,10,72,47,25,62
Brechin,5286,2,18,6,12,50,43,7,60
Livingston,5286,3,19,2,15,69,57,12,59
Airdrieon,5286,4,18,5,13,61,53,8,59
Peterhead,5286,5,16,7,13,53,45,8,55
Albion,5286,6,13,9,14,57,56,1,48
Stranraer,5286,7,14,5,17,53,62,-9,47
East Fife,5286,8,11,9,16,45,53,-8,42
Queen's Park,5286,9,11,7,18,37,55,-18,40
Stenhousem'r,5286,10,9,8,19,52,78,-26,35
Livingston,5287,1,23,3,10,77,43,34,72
Alloa,5287,2,17,10,9,64,45,19,61
Airdrieon,5287,3,15,9,12,58,52,6,54
Brechin,5287,4,16,6,14,48,46,2,54
Peterhead,5287,5,15,8,13,58,55,3,53
Albion,5287,6,14,10,12,56,53,3,52
East Fife,5287,7,12,8,16,50,52,-2,44
Stranraer,5287,8,12,3,21,46,68,-22,39
Stenhousem'r,5287,9,8,12,16,48,72,-24,36
Queen's Park,5287,10,8,11,17,30,49,-19,35
Albion,5288,1,19,8,9,73,46,27,65
Livingston,5288,2,19,7,10,73,54,19,64
Alloa,5288,3,17,10,9,71,46,25,61
Brechin,5288,4,18,5,13,55,51,4,59
East Fife,5288,5,13,10,13,55,48,7,49
Peterhead,5288,6,14,7,15,54,59,-5,49
Airdrieon,5288,7,13,9,14,64,63,1,48
Stenhousem'r,5288,8,11,9,16,54,75,-21,42
Stranraer,5288,9,9,6,21,41,69,-28,33
Queen's Park,5288,10,7,9,20,27,56,-29,30
Livingston,5289,1,20,5,11,75,46,29,65
East Fife,5289,2,18,6,12,67,45,22,60
Airdrieon,5289,3,17,9,10,68,55,13,60
Alloa,5289,4,17,8,11,67,49,18,59
Brechin,5289,5,17,7,12,55,46,9,58
Albion,5289,6,17,4,15,63,66,-3,55
Queen's Park,5289,7,15,5,16,44,53,-9,50
Peterhead,5289,8,13,6,17,41,51,-10,45
Stranraer,5289,9,11,4,21,54,70,-16,37
Stenhousem'r,5289,10,4,8,24,39,92,-53,20
Livingston,5290,1,19,9,8,81,56,25,66
Alloa,5290,2,18,10,8,70,42,28,64
Airdrieon,5290,3,15,11,10,62,49,13,56
Stranraer,5290,4,15,6,15,55,55,0,51
Brechin,5290,5,16,3,17,49,51,-2,51
East Fife,5290,6,13,10,13,49,49,0,49
Peterhead,5290,7,14,7,15,49,61,-12,49
Albion,5290,8,14,5,17,62,60,2,47
Queen's Park,5290,9,14,4,18,44,63,-19,46
Stenhousem'r,5290,10,5,9,22,46,81,-35,24
Livingston,5291,1,20,5,11,80,50,30,65
Alloa,5291,2,17,8,11,74,53,21,59
Airdrieon,5291,3,17,8,11,59,54,5,59
Peterhead,5291,4,16,9,11,48,50,-2,57
Brechin,5291,5,16,6,14,52,52,0,54
Albion,5291,6,12,14,10,48,43,5,50
Queen's Park,5291,7,12,7,17,36,48,-12,43
East Fife,5291,8,10,11,15,52,57,-5,41
Stranraer,5291,9,9,8,19,41,55,-14,35
Stenhousem'r,5291,10,9,8,19,44,72,-28,35
Alloa,5292,1,23,6,7,85,41,44,75
Livingston,5292,2,19,8,9,65,45,20,65
Brechin,5292,3,17,7,12,47,45,2,58
Airdrieon,5292,4,16,6,14,61,61,0,54
East Fife,5292,5,14,9,13,54,48,6,51
Peterhead,5292,6,13,7,16,45,52,-7,46
Queen's Park,5292,7,12,9,15,37,48,-11,45
Albion,5292,8,11,9,16,52,52,0,42
Stranraer,5292,9,10,7,19,43,57,-14,37
Stenhousem'r,5292,10,5,12,19,44,84,-40,27
Livingston,5293,1,21,5,10,78,50,28,68
Alloa,5293,2,19,7,10,84,52,32,64
Brechin,5293,3,17,6,13,51,43,8,57
Airdrieon,5293,4,17,6,13,59,59,0,57
Albion,5293,5,16,8,12,73,59,14,56
Peterhead,5293,6,14,8,14,44,48,-4,50
Stranraer,5293,7,12,8,16,47,61,-14,44
Queen's Park,5293,8,11,8,17,41,57,-16,41
East Fife,5293,9,10,8,18,40,46,-6,38
Stenhousem'r,5293,10,8,6,22,46,88,-42,30
Livingston,5294,1,20,7,9,81,50,31,67
Alloa,5294,2,19,8,9,58,35,23,65
Brechin,5294,3,19,8,9,58,38,20,65
Peterhead,5294,4,14,8,14,46,56,-10,50
Albion,5294,5,12,13,11,51,47,4,49
East Fife,5294,6,12,11,13,57,44,13,47
Airdrieon,5294,7,12,7,17,48,61,-13,43
Queen's Park,5294,8,11,7,18,35,50,-15,40
Stranraer,5294,9,11,7,18,45,63,-18,40
Stenhousem'r,5294,10,9,6,21,50,85,-35,33
Livingston,5295,1,24,1,11,87,49,38,73
Alloa,5295,2,19,9,8,71,47,24,66
Airdrieon,5295,3,17,6,13,57,62,-5,57
Albion,5295,4,15,9,12,56,52,4,54
Brechin,5295,5,15,7,14,52,50,2,52
Peterhead,5295,6,15,7,14,46,44,2,52
Queen's Park,5295,7,15,4,17,40,49,-9,49
East Fife,5295,8,11,10,15,46,47,-1,43
Stranraer,5295,9,12,4,20,47,61,-14,40
Stenhousem'r,5295,10,4,9,23,36,77,-41,21
Alloa,5296,1,17,11,8,64,42,22,62
Livingston,5296,2,20,2,14,73,53,20,62
Albion,5296,3,17,5,14,64,57,7,56
Brechin,5296,4,16,6,14,47,43,4,54
Stranraer,5296,5,17,2,17,59,55,4,53
Airdrieon,5296,6,15,7,14,49,57,-8,52
Queen's Park,5296,7,14,7,15,40,45,-5,49
East Fife,5296,8,13,8,15,58,53,5,47
Peterhead,5296,9,11,8,17,45,65,-20,41
Stenhousem'r,5296,10,8,8,20,48,77,-29,32
Livingston,5297,1,20,6,10,70,45,25,66
Brechin,5297,2,17,5,14,51,48,3,56
Alloa,5297,3,15,9,12,61,50,11,54
Airdrieon,5297,4,14,10,12,57,53,4,52
Peterhead,5297,5,15,7,14,54,52,2,52
Albion,5297,6,14,8,14,48,47,1,50
Stranraer,5297,7,14,8,14,60,61,-1,50
East Fife,5297,8,11,11,14,47,45,2,44
Queen's Park,5297,9,12,8,16,36,49,-13,44
Stenhousem'r,5297,10,9,6,21,49,83,-34,33
Alloa,5298,1,22,6,8,68,32,36,72
Livingston,5298,2,22,6,8,77,51,26,72
Airdrieon,5298,3,16,5,15,52,53,-1,53
Albion,5298,4,14,9,13,47,46,1,51
Queen's Park,5298,5,14,8,14,42,49,-7,50
Brechin,5298,6,15,3,18,44,48,-4,48
Stranraer,5298,7,14,5,17,42,54,-12,47
East Fife,5298,8,11,9,16,47,50,-3,42
Peterhead,5298,9,11,7,18,46,60,-14,40
Stenhousem'r,5298,10,10,4,22,46,68,-22,34
Alloa,5299,1,20,8,8,73,37,36,68
Livingston,5299,2,19,6,11,78,48,30,63
Albion,5299,3,18,6,12,52,42,10,60
Airdrieon,5299,4,16,9,11,53,51,2,57
Brechin,5299,5,13,10,13,55,54,1,49
East Fife,5299,6,14,7,15,49,48,1,49
Peterhead,5299,7,14,7,15,52,55,-3,49
Stranraer,5299,8,11,10,15,55,66,-11,43
Queen's Park,5299,9,9,10,17,34,58,-24,37
Stenhousem'r,5299,10,5,9,22,47,89,-42,24
Alloa,5300,1,23,7,6,80,37,43,76
Livingston,5300,2,22,5,9,78,41,37,71
Brechin,5300,3,19,8,9,55,43,12,65
Airdrieon,5300,4,18,5,13,53,53,0,59
Peterhead,5300,5,12,8,16,48,51,-3,44
Albion,5300,6,12,8,16,54,60,-6,44
Queen's Park,5300,7,12,7,17,41,55,-14,43
Stranraer,5300,8,10,8,18,45,61,-16,38
East Fife,5300,9,8,10,18,43,60,-17,34
Stenhousem'r,5300,10,6,10,20,50,86,-36,28
Alloa,5301,1,20,8,8,72,40,32,68
Livingston,5301,2,20,5,11,73,52,21,65
Albion,5301,3,18,7,11,61,52,9,61
Queen's Park,5301,4,17,5,14,44,44,0,56
East Fife,5301,5,13,9,14,51,54,-3,48
Brechin,5301,6,13,6,17,45,51,-6,45
Stranraer,5301,7,13,5,18,45,51,-6,44
Airdrieon,5301,8,13,5,18,48,65,-17,44
Peterhead,5301,9,10,11,15,47,57,-10,41
Stenhousem'r,5301,10,9,7,20,46,66,-20,34
Alloa,5302,1,21,6,9,77,44,33,69
Livingston,5302,2,19,5,12,72,51,21,62
Brechin,5302,3,18,8,10,56,47,9,62
Albion,5302,4,16,7,13,42,41,1,55
Peterhead,5302,5,15,6,15,55,57,-2,51
East Fife,5302,6,12,10,14,50,45,5,46
Stranraer,5302,7,13,7,16,53,63,-10,46
Airdrieon,5302,8,12,6,18,49,55,-6,42
Stenhousem'r,5302,9,10,8,18,52,74,-22,38
Queen's Park,5302,10,9,7,20,36,65,-29,34
Livingston,5303,1,18,8,10,83,60,23,62
Alloa,5303,2,18,8,10,68,47,21,62
Airdrieon,5303,3,17,6,13,61,61,0,57
Brechin,5303,4,15,6,15,44,47,-3,51
Queen's Park,5303,5,14,7,15,48,53,-5,49
Stranraer,5303,6,13,7,16,53,53,0,46
Albion,5303,7,12,9,15,44,47,-3,45
Stenhousem'r,5303,8,13,6,17,53,79,-26,45
Peterhead,5303,9,11,10,15,45,56,-11,43
East Fife,5303,10,9,13,14,50,46,4,40
Alloa,5304,1,21,8,7,74,48,26,71
Livingston,5304,2,20,5,11,72,40,32,65
Peterhead,5304,3,17,9,10,65,49,16,60
Airdrieon,5304,4,16,6,14,55,50,5,54
Brechin,5304,5,16,5,15,55,47,8,53
Albion,5304,6,14,6,16,45,55,-10,48
East Fife,5304,7,12,10,14,46,48,-2,46
Queen's Park,5304,8,11,10,15,40,56,-16,43
Stranraer,5304,9,11,4,21,45,70,-25,37
Stenhousem'r,5304,10,5,11,20,43,77,-34,26
Airdrieon,5305,1,20,7,9,67,50,17,67
Brechin,5305,2,19,5,12,52,42,10,62
Alloa,5305,3,17,9,10,72,54,18,60
Livingston,5305,4,16,9,11,70,55,15,57
Albion,5305,5,14,9,13,55,52,3,51
Peterhead,5305,6,14,9,13,59,62,-3,51
Stranraer,5305,7,15,5,16,54,56,-2,50
East Fife,5305,8,12,6,18,53,56,-3,42
Queen's Park,5305,9,9,5,22,35,61,-26,32
Stenhousem'r,5305,10,8,8,20,48,77,-29,32
Livingston,5306,1,24,3,9,80,44,36,75
Airdrieon,5306,2,18,9,9,55,41,14,63
Alloa,5306,3,17,8,11,69,45,24,59
East Fife,5306,4,14,9,13,54,41,13,51
Brechin,5306,5,13,8,15,41,46,-5,47
Albion,5306,6,11,13,12,47,46,1,46
Peterhead,5306,7,11,11,14,41,53,-12,44
Stranraer,5306,8,10,9,17,40,53,-13,39
Queen's Park,5306,9,10,9,17,32,53,-21,39
Stenhousem'r,5306,10,9,7,20,43,80,-37,34
Alloa,5307,1,18,7,11,75,54,21,61
Livingston,5307,2,19,4,13,68,56,12,61
Peterhead,5307,3,16,7,13,53,47,6,55
Airdrieon,5307,4,15,9,12,60,56,4,54
Stranraer,5307,5,15,7,14,59,61,-2,52
Brechin,5307,6,15,6,15,51,52,-1,51
East Fife,5307,7,13,9,14,51,46,5,48
Queen's Park,5307,8,13,9,14,51,57,-6,48
Albion,5307,9,12,6,18,54,64,-10,42
Stenhousem'r,5307,10,8,8,20,48,77,-29,32
Livingston,5308,1,20,8,8,73,48,25,68
Alloa,5308,2,21,5,10,67,42,25,68
Brechin,5308,3,17,5,14,54,48,6,56
Albion,5308,4,16,6,14,51,42,9,54
Airdrieon,5308,5,15,8,13,57,52,5,53
Stranraer,5308,6,15,5,16,51,58,-7,50
Queen's Park,5308,7,12,7,17,39,48,-9,43
Peterhead,5308,8,10,10,16,37,56,-19,40
East Fife,5308,9,9,11,16,48,55,-7,38
Stenhousem'r,5308,10,8,9,19,42,70,-28,33
Alloa,5309,1,21,7,8,69,37,32,70
Livingston,5309,2,20,4,12,76,47,29,64
Airdrieon,5309,3,18,10,8,60,45,15,64
Brechin,5309,4,18,7,11,57,45,12,61
Peterhead,5309,5,15,5,16,48,59,-11,50
Albion,5309,6,13,7,16,46,51,-5,46
Queen's Park,5309,7,12,7,17,40,54,-14,43
East Fife,5309,8,9,11,16,40,41,-1,38
Stranraer,5309,9,9,10,17,46,65,-19,37
Stenhousem'r,5309,10,6,10,20,39,77,-38,28
Livingston,5310,1,21,5,10,79,47,32,68
Peterhead,5310,2,19,6,11,59,50,9,63
Alloa,5310,3,18,8,10,74,45,29,62
Albion,5310,4,16,8,12,51,43,8,56
Airdrieon,5310,5,15,10,11,57,61,-4,55
Brechin,5310,6,12,10,14,47,57,-10,46
Stranraer,5310,7,11,7,18,50,62,-12,40
East Fife,5310,8,11,6,19,46,54,-8,39
Stenhousem'r,5310,9,10,7,19,54,75,-21,37
Queen's Park,5310,10,8,11,17,33,56,-23,35
Livingston,5311,1,20,4,12,77,51,26,64
Brechin,5311,2,18,4,14,54,53,1,58
Alloa,5311,3,15,11,10,64,51,13,56
Airdrieon,5311,4,15,9,12,57,52,5,54
Albion,5311,5,14,10,12,55,49,6,52
Stranraer,5311,6,14,7,15,53,60,-7,49
East Fife,5311,7,13,9,14,53,43,10,48
Peterhead,5311,8,13,8,15,46,53,-7,47
Queen's Park,5311,9,11,6,19,35,58,-23,39
Stenhousem'r,5311,10,8,10,18,43,67,-24,34
Livingston,5312,1,22,2,12,83,54,29,68
Alloa,5312,2,18,8,10,72,50,22,62
East Fife,5312,3,15,7,14,50,43,7,52
Brechin,5312,4,16,4,16,56,61,-5,52
Stranraer,5312,5,15,6,15,58,51,7,51
Airdrieon,5312,6,13,11,12,52,49,3,50
Albion,5312,7,14,8,14,47,46,1,50
Queen's Park,5312,8,13,8,15,42,54,-12,47
Peterhead,5312,9,11,11,14,47,55,-8,44
Stenhousem'r,5312,10,6,9,21,44,88,-44,27
Livingston,5313,1,22,2,12,81,48,33,68
Alloa,5313,2,15,13,8,64,43,21,58
Airdrieon,5313,3,17,4,15,67,63,4,55
Peterhead,5313,4,14,12,10,46,39,7,54
Brechin,5313,5,15,6,15,45,52,-7,51
East Fife,5313,6,13,9,14,48,50,-2,48
Queen's Park,5313,7,13,8,15,36,48,-12,47
Albion,5313,8,12,9,15,50,53,-3,45
Stranraer,5313,9,13,6,17,52,60,-8,45
Stenhousem'r,5313,10,8,7,21,48,81,-33,31
Livingston,5314,1,22,6,8,78,45,33,72
Alloa,5314,2,16,10,10,63,44,19,58
East Fife,5314,3,16,9,11,60,42,18,57
Airdrieon,5314,4,15,9,12,53,54,-1,54
Brechin,5314,5,16,6,14,41,42,-1,54
Peterhead,5314,6,14,9,13,47,47,0,51
Albion,5314,7,13,9,14,51,53,-2,48
Queen's Park,5314,8,10,10,16,39,55,-16,40
Stenhousem'r,5314,9,8,9,19,48,77,-29,33
Stranraer,5314,10,9,5,22,41,62,-21,32
Alloa,5315,1,19,10,7,62,38,24,67
Livingston,5315,2,21,4,11,69,48,21,67
Airdrieon,5315,3,17,8,11,56,46,10,59
Brechin,5315,4,15,6,15,52,51,1,51
Queen's Park,5315,5,13,11,12,39,36,3,50
Stranraer,5315,6,15,4,17,52,59,-7,49
Peterhead,5315,7,15,4,17,51,61,-10,49
Albion,5315,8,13,7,16,48,52,-4,46
East Fife,5315,9,10,12,14,50,51,-1,42
Stenhousem'r,5315,10,4,10,22,42,79,-37,22
Livingston,5316,1,23,3,10,82,47,35,72
Alloa,5316,2,19,7,10,72,51,21,64
Airdrieon,5316,3,19,7,10,64,56,8,64
Peterhead,5316,4,16,7,13,57,52,5,55
Brechin,5316,5,15,7,14,58,51,7,52
Albion,5316,6,12,8,16,55,58,-3,44
East Fife,5316,7,12,8,16,44,48,-4,44
Queen's Park,5316,8,12,8,16,36,49,-13,44
Stranraer,5316,9,12,2,22,44,64,-20,38
Stenhousem'r,5316,10,8,7,21,45,81,-36,31
Airdrieon,5317,1,19,7,10,74,51,23,64
Brechin,5317,2,19,7,10,59,50,9,64
Livingston,5317,3,18,9,9,75,47,28,63
Alloa,5317,4,18,9,9,70,44,26,63
Stranraer,5317,5,15,7,14,66,60,6,52
Albion,5317,6,12,6,18,48,62,-14,42
Peterhead,5317,7,12,6,18,47,67,-20,42
East Fife,5317,8,10,11,15,47,53,-6,41
Queen's Park,5317,9,9,9,18,37,59,-22,36
Stenhousem'r,5317,10,10,5,21,48,78,-30,35
Alloa,5318,1,22,5,9,74,47,27,71
Albion,5318,2,20,7,9,74,51,23,67
Airdrieon,5318,3,18,8,10,66,50,16,62
Peterhead,5318,4,14,8,14,53,53,0,50
Brechin,5318,5,15,5,16,51,59,-8,50
Livingston,5318,6,14,4,18,56,56,0,46
Queen's Park,5318,7,13,5,18,42,59,-17,44
Stranraer,5318,8,12,6,18,51,58,-7,42
East Fife,5318,9,10,10,16,51,55,-4,40
Stenhousem'r,5318,10,10,6,20,51,81,-30,36
Livingston,5319,1,20,8,8,82,46,36,68
Alloa,5319,2,19,9,8,71,47,24,66
Brechin,5319,3,16,7,13,50,52,-2,55
Albion,5319,4,17,3,16,51,50,1,54
Peterhead,5319,5,14,8,14,48,47,1,50
Airdrieon,5319,6,15,5,16,53,56,-3,50
Queen's Park,5319,7,12,8,16,39,56,-17,44
Stranraer,5319,8,13,4,19,43,60,-17,43
East Fife,5319,9,10,12,14,50,48,2,42
Stenhousem'r,5319,10,7,10,19,48,73,-25,31
Livingston,5320,1,23,4,9,76,36,40,73
Alloa,5320,2,16,12,8,69,42,27,60
Airdrieon,5320,3,15,10,11,56,54,2,55
East Fife,5320,4,14,9,13,49,42,7,51
Peterhead,5320,5,13,10,13,46,52,-6,49
Queen's Park,5320,6,13,9,14,36,49,-13,48
Brechin,5320,7,13,8,15,43,54,-11,47
Stranraer,5320,8,12,5,19,48,59,-11,41
Albion,5320,9,10,8,18,48,59,-11,38
Stenhousem'r,5320,10,9,9,18,53,77,-24,36
Airdrieon,5321,1,22,5,9,69,53,16,71
Livingston,5321,2,21,5,10,79,52,27,68
Alloa,5321,3,18,6,12,86,55,31,60
Brechin,5321,4,17,4,15,60,55,5,55
Queen's Park,5321,5,14,6,16,46,60,-14,48
Peterhead,5321,6,12,10,14,57,61,-4,46
East Fife,5321,7,12,8,16,46,47,-1,44
Albion,5321,8,12,7,17,52,66,-14,43
Stenhousem'r,5321,9,10,8,18,48,69,-21,38
Stranraer,5321,10,8,9,19,40,65,-25,33
Airdrieon,5322,1,20,9,7,62,49,13,69
Alloa,5322,2,17,8,11,60,41,19,59
Livingston,5322,3,16,8,12,67,53,14,56
Brechin,5322,4,16,7,13,52,50,2,55
Stranraer,5322,5,16,5,15,55,53,2,53
East Fife,5322,6,13,9,14,46,43,3,48
Queen's Park,5322,7,12,11,13,33,40,-7,47
Peterhead,5322,8,11,8,17,47,55,-8,41
Albion,5322,9,11,6,19,50,56,-6,39
Stenhousem'r,5322,10,8,9,19,40,72,-32,33
Brechin,5323,1,20,7,9,59,45,14,67
Livingston,5323,2,21,3,12,70,41,29,66
Alloa,5323,3,20,6,10,71,44,27,66
Albion,5323,4,19,5,12,55,46,9,62
Airdrieon,5323,5,19,5,12,52,49,3,62
Stranraer,5323,6,12,6,18,47,54,-7,42
East Fife,5323,7,11,6,19,54,55,-1,39
Peterhead,5323,8,12,3,21,38,60,-22,39
Stenhousem'r,5323,9,9,8,19,51,78,-27,35
Queen's Park,5323,10,8,9,19,29,54,-25,33
Livingston,5324,1,23,3,10,87,53,34,72
Brechin,5324,2,18,4,14,51,49,2,58
Alloa,5324,3,16,9,11,69,51,18,57
Albion,5324,4,17,3,16,54,51,3,54
Peterhead,5324,5,15,7,14,45,45,0,52
Airdrieon,5324,6,13,9,14,56,62,-6,48
Queen's Park,5324,7,13,7,16,41,56,-15,46
East Fife,5324,8,12,9,15,54,47,7,45
Stranraer,5324,9,12,7,17,49,59,-10,43
Stenhousem'r,5324,10,8,8,20,43,76,-33,32
Livingston,5325,1,23,4,9,79,44,35,73
Alloa,5325,2,20,9,7,83,44,39,69
Airdrieon,5325,3,19,6,11,64,52,12,63
Albion,5325,4,17,9,10,56,45,11,60
Brechin,5325,5,17,7,12,57,51,6,58
Peterhead,5325,6,9,12,15,47,59,-12,39
Queen's Park,5325,7,10,8,18,36,60,-24,38
East Fife,5325,8,9,9,18,50,58,-8,36
Stranraer,5325,9,11,3,22,41,72,-31,36
Stenhousem'r,5325,10,7,9,20,49,77,-28,30
Livingston,5326,1,23,4,9,86,46,40,73
Alloa,5326,2,17,9,10,71,49,22,60
Airdrieon,5326,3,17,7,12,59,56,3,58
Brechin,5326,4,17,6,13,58,49,9,57
East Fife,5326,5,15,9,12,61,51,10,54
Albion,5326,6,13,10,13,54,58,-4,49
Peterhead,5326,7,12,7,17,47,57,-10,43
Stranraer,5326,8,11,8,17,55,64,-9,41
Queen's Park,5326,9,11,7,18,38,57,-19,40
Stenhousem'r,5326,10,7,7,22,43,85,-42,28
Alloa,5327,1,19,7,10,69,48,21,64
Livingston,5327,2,19,3,14,70,56,14,60
Airdrieon,5327,3,17,7,12,63,52,11,58
Albion,5327,4,16,9,11,62,50,12,57
Peterhead,5327,5,15,8,13,47,47,0,53
East Fife,5327,6,15,7,14,53,52,1,52
Brechin,5327,7,15,7,14,54,57,-3,52
Stranraer,5327,8,13,4,19,62,60,2,43
Queen's Park,5327,9,10,8,18,42,61,-19,38
Stenhousem'r,5327,10,8,6,22,41,80,-39,30
Airdrieon,5328,1,20,6,10,59,49,10,66
Livingston,5328,2,18,7,11,68,51,17,61
Brechin,5328,3,16,6,14,53,53,0,54
Alloa,5328,4,15,8,13,72,48,24,53
Albion,5328,5,14,10,12,46,46,0,52
Stranraer,5328,6,14,6,16,49,57,-8,48
Peterhead,5328,7,12,9,15,43,52,-9,45
Queen's Park,5328,8,11,11,14,41,49,-8,44
East Fife,5328,9,11,10,15,50,51,-1,43
Stenhousem'r,5328,10,8,9,19,53,78,-25,33
Livingston,5329,1,21,7,8,92,49,43,70
Alloa,5329,2,18,11,7,74,47,27,65
Airdrieon,5329,3,16,7,13,61,61,0,55
Peterhead,5329,4,15,9,12,45,47,-2,54
Brechin,5329,5,14,9,13,57,55,2,51
East Fife,5329,6,12,13,11,47,43,4,49
Albion,5329,7,11,12,13,52,49,3,45
Stranraer,5329,8,12,7,17,49,58,-9,43
Queen's Park,5329,9,11,6,19,36,60,-24,39
Stenhousem'r,5329,10,4,11,21,44,88,-44,23
Livingston,5330,1,20,9,7,76,44,32,69
Alloa,5330,2,20,5,11,78,51,27,65
Brechin,5330,3,18,5,13,42,38,4,59
Airdrieon,5330,4,17,7,12,60,63,-3,58
Peterhead,5330,5,14,10,12,58,54,4,52
Albion,5330,6,12,9,15,48,49,-1,45
East Fife,5330,7,12,9,15,52,54,-2,45
Stranraer,5330,8,13,2,21,54,59,-5,41
Queen's Park,5330,9,8,11,17,32,53,-21,35
Stenhousem'r,5330,10,8,9,19,45,80,-35,33
Alloa,5331,1,24,4,8,72,37,35,76
Livingston,5331,2,22,5,9,81,43,38,71
Albion,5331,3,16,8,12,60,50,10,56
Brechin,5331,4,17,2,17,58,55,3,53
Peterhead,5331,5,14,8,14,50,55,-5,50
East Fife,5331,6,12,13,11,47,45,2,49
Airdrieon,5331,7,13,6,17,48,66,-18,45
Stranraer,5331,8,11,8,17,47,58,-11,41
Queen's Park,5331,9,10,7,19,41,60,-19,37
Stenhousem'r,5331,10,6,9,21,40,75,-35,27
Alloa,5332,1,24,4,8,80,35,45,76
Livingston,5332,2,19,7,10,85,47,38,64
Peterhead,5332,3,17,8,11,55,46,9,59
Brechin,5332,4,16,8,12,54,49,5,56
Albion,5332,5,14,8,14,52,55,-3,50
Airdrieon,5332,6,13,8,15,50,59,-9,47
East Fife,5332,7,12,7,17,56,55,1,43
Queen's Park,5332,8,11,5,20,33,58,-25,38
Stranraer,5332,9,10,7,19,45,72,-27,37
Stenhousem'r,5332,10,9,8,19,48,82,-34,35
Livingston,5333,1,21,3,12,74,46,28,66
Alloa,5333,2,17,11,8,56,37,19,62
Brechin,5333,3,18,6,12,47,38,9,60
Albion,5333,4,13,11,12,54,52,2,50
Airdrieon,5333,5,14,8,14,54,55,-1,50
Peterhead,5333,6,11,13,12,47,52,-5,46
Queen's Park,5333,7,13,7,16,46,55,-9,46
East Fife,5333,8,11,8,17,46,52,-6,41
Stenhousem'r,5333,9,11,8,17,56,78,-22,41
Stranraer,5333,10,11,5,20,43,58,-15,38
Livingston,5334,1,21,5,10,69,43,26,68
Alloa,5334,2,18,10,8,74,44,30,64
Brechin,5334,3,16,11,9,52,44,8,59
Airdrieon,5334,4,16,7,13,71,58,13,55
Peterhead,5334,5,14,11,11,59,57,2,53
Stranraer,5334,6,13,8,15,49,53,-4,47
Albion,5334,7,11,10,15,55,58,-3,43
Queen's Park,5334,8,9,11,16,37,66,-29,38
East Fife,5334,9,8,13,15,44,51,-7,37
Stenhousem'r,5334,10,8,6,22,45,81,-36,30
Alloa,5335,1,20,8,8,72,37,35,68
Airdrieon,5335,2,20,7,9,57,45,12,67
Brechin,5335,3,16,11,9,58,43,15,59
Livingston,5335,4,17,7,12,72,59,13,58
Albion,5335,5,16,5,15,57,52,5,53
Peterhead,5335,6,15,6,15,43,51,-8,51
East Fife,5335,7,13,10,13,57,49,8,49
Queen's Park,5335,8,9,6,21,30,54,-24,33
Stranraer,5335,9,9,6,21,33,59,-26,33
Stenhousem'r,5335,10,9,6,21,48,78,-30,33
Livingston,5336,1,25,3,8,89,53,36,78
Alloa,5336,2,20,7,9,73,49,24,67
Airdrieon,5336,3,18,6,12,62,59,3,60
East Fife,5336,4,15,8,13,59,43,16,53
Peterhead,5336,5,13,8,15,49,54,-5,47
Stranraer,5336,6,14,4,18,51,51,0,46
Brechin,5336,7,13,6,17,47,55,-8,45
Queen's Park,5336,8,12,8,16,44,53,-9,44
Albion,5336,9,10,8,18,40,53,-13,38
Stenhousem'r,5336,10,9,4,23,43,87,-44,31
Alloa,5337,1,23,6,7,77,38,39,75
Livingston,5337,2,21,3,12,76,46,30,66
Airdrieon,5337,3,20,4,12,59,56,3,64
Peterhead,5337,4,17,8,11,56,51,5,59
Albion,5337,5,14,8,14,53,54,-1,50
East Fife,5337,6,13,8,15,57,50,7,47
Brechin,5337,7,13,7,16,40,47,-7,46
Stranraer,5337,8,12,4,20,48,65,-17,40
Queen's Park,5337,9,9,8,19,37,56,-19,35
Stenhousem'r,5337,10,6,8,22,46,86,-40,26
Livingston,5338,1,23,5,8,82,50,32,74
Brechin,5338,2,18,9,9,59,41,18,63
Alloa,5338,3,16,10,10,70,45,25,58
Peterhead,5338,4,15,7,14,54,50,4,52
Airdrieon,5338,5,14,9,13,50,54,-4,51
East Fife,5338,6,12,9,15,58,56,2,45
Stranraer,5338,7,12,7,17,44,61,-17,43
Albion,5338,8,12,5,19,57,65,-8,41
Stenhousem'r,5338,9,10,7,19,51,85,-34,37
Queen's Park,5338,10,8,12,16,29,47,-18,36
Brechin,5339,1,22,6,8,63,36,27,72
Alloa,5339,2,19,7,10,78,45,33,64
Livingston,5339,3,17,8,11,75,52,23,59
East Fife,5339,4,15,6,15,53,55,-2,51
Airdrieon,5339,5,14,8,14,57,49,8,50
Stranraer,5339,6,15,4,17,48,54,-6,49
Queen's Park,5339,7,14,7,15,42,57,-15,49
Albion,5339,8,13,7,16,53,51,2,46
Peterhead,5339,9,12,7,17,45,59,-14,43
Stenhousem'r,5339,10,5,8,23,45,101,-56,23
Airdrieon,5340,1,21,4,11,69,56,13,67
Alloa,5340,2,19,9,8,74,43,31,66
Livingston,5340,3,19,5,12,69,51,18,62
Brechin,5340,4,15,10,11,57,48,9,55
Albion,5340,5,14,9,13,50,47,3,51
East Fife,5340,6,13,10,13,48,38,10,49
Peterhead,5340,7,15,4,17,52,61,-9,49
Queen's Park,5340,8,14,6,16,44,53,-9,48
Stranraer,5340,9,8,11,17,47,67,-20,35
Stenhousem'r,5340,10,4,8,24,41,87,-46,20
Alloa,5341,1,19,9,8,75,45,30,66
Livingston,5341,2,17,9,10,71,53,18,60
Peterhead,5341,3,15,7,14,46,46,0,52
Airdrieon,5341,4,14,8,14,48,47,1,50
Stranraer,5341,5,15,5,16,50,58,-8,50
Brechin,5341,6,15,5,16,48,56,-8,50
East Fife,5341,7,13,10,13,58,48,10,49
Queen's Park,5341,8,12,9,15,41,52,-11,45
Albion,5341,9,12,8,16,52,52,0,44
Stenhousem'r,5341,10,10,6,20,54,86,-32,36
Livingston,5342,1,20,7,9,82,52,30,67
Alloa,5342,2,16,12,8,62,42,20,60
Airdrieon,5342,3,14,14,8,62,49,13,56
Brechin,5342,4,15,10,11,48,45,3,55
Queen's Park,5342,5,14,9,13,43,47,-4,51
Peterhead,5342,6,13,10,13,51,54,-3,49
Albion,5342,7,11,14,11,51,49,2,47
East Fife,5342,8,12,10,14,57,58,-1,46
Stranraer,5342,9,9,5,22,45,64,-19,32
Stenhousem'r,5342,10,4,13,19,47,88,-41,25
Livingston,5343,1,21,3,12,76,52,24,66
Peterhead,5343,2,18,7,11,59,47,12,61
Alloa,5343,3,15,14,7,69,50,19,59
Brechin,5343,4,15,9,12,57,49,8,54
Airdrieon,5343,5,15,9,12,58,55,3,54
Stranraer,5343,6,14,5,17,56,62,-6,47
Stenhousem'r,5343,7,11,9,16,49,74,-25,42
East Fife,5343,8,11,7,18,53,50,3,40
Queen's Park,5343,9,11,7,18,36,57,-21,40
Albion,5343,10,11,6,19,41,58,-17,39
Livingston,5344,1,23,2,11,76,45,31,71
Alloa,5344,2,16,11,9,71,44,27,59
East Fife,5344,3,17,8,11,51,42,9,59
Airdrieon,5344,4,17,7,12,64,51,13,58
Albion,5344,5,15,7,14,58,54,4,52
Stranraer,5344,6,15,7,14,57,60,-3,52
Brechin,5344,7,14,7,15,51,59,-8,49
Peterhead,5344,8,13,7,16,45,51,-6,46
Queen's Park,5344,9,10,6,20,30,56,-26,36
Stenhousem'r,5344,10,5,8,23,39,80,-41,23
Alloa,5345,1,23,5,8,83,46,37,74
Livingston,5345,2,23,3,10,75,37,38,72
Brechin,5345,3,19,4,13,62,46,16,61
Airdrieon,5345,4,17,6,13,57,54,3,57
Queen's Park,5345,5,16,5,15,42,49,-7,53
Peterhead,5345,6,14,9,13,57,62,-5,51
Albion,5345,7,12,6,18,46,59,-13,42
Stranraer,5345,8,12,2,22,42,63,-21,38
East Fife,5345,9,10,7,19,49,57,-8,37
Stenhousem'r,5345,10,9,3,24,50,90,-40,30
Livingston,5346,1,20,4,12,77,59,18,64
Alloa,5346,2,18,9,9,80,44,36,63
Queen's Park,5346,3,16,7,13,40,43,-3,55
Brechin,5346,4,15,6,15,50,48,2,51
Airdrieon,5346,5,14,8,14,52,57,-5,50
Albion,5346,6,14,6,16,68,67,1,48
East Fife,5346,7,12,10,14,47,46,1,46
Peterhead,5346,8,11,11,14,51,61,-10,44
Stenhousem'r,5346,9,12,7,17,58,82,-24,43
Stranraer,5346,10,12,4,20,52,68,-16,40
Alloa,5347,1,21,8,7,77,43,34,71
Albion,5347,2,17,7,12,65,56,9,58
Airdrieon,5347,3,18,4,14,58,53,5,58
Livingston,5347,4,16,8,12,68,56,12,56
Peterhead,5347,5,15,10,11,51,51,0,55
Brechin,5347,6,15,9,12,45,42,3,54
Stranraer,5347,7,14,5,17,50,60,-10,47
Queen's Park,5347,8,11,6,19,37,56,-19,39
Stenhousem'r,5347,9,8,9,19,58,80,-22,33
East Fife,5347,10,8,8,20,38,50,-12,32
Livingston,5348,1,21,6,9,66,37,29,69
Alloa,5348,2,20,7,9,71,46,25,67
Airdrieon,5348,3,18,8,10,57,43,14,62
Peterhead,5348,4,12,12,12,45,47,-2,48
Albion,5348,5,13,9,14,48,53,-5,48
Brechin,5348,6,14,4,18,48,60,-12,46
Queen's Park,5348,7,12,9,15,43,53,-10,45
East Fife,5348,8,11,10,15,49,49,0,43
Stranraer,5348,9,13,4,19,45,52,-7,43
Stenhousem'r,5348,10,7,9,20,42,74,-32,30
Alloa,5349,1,20,5,11,77,41,36,65
Livingston,5349,2,19,3,14,76,63,13,60
Albion,5349,3,17,8,11,53,46,7,59
Airdrieon,5349,4,16,8,12,54,42,12,56
Peterhead,5349,5,14,12,10,48,45,3,54
Stranraer,5349,6,15,6,15,46,51,-5,51
Brechin,5349,7,15,4,17,44,52,-8,49
East Fife,5349,8,12,10,14,46,44,2,46
Queen's Park,5349,9,9,6,21,29,60,-31,33
Stenhousem'r,5349,10,8,8,20,45,74,-29,32
Livingston,5350,1,23,4,9,81,50,31,73
Alloa,5350,2,19,8,9,76,51,25,65
Airdrieon,5350,3,19,7,10,61,54,7,64
Brechin,5350,4,17,6,13,60,54,6,57
Albion,5350,5,17,5,14,57,48,9,56
East Fife,5350,6,11,10,15,52,48,4,43
Stranraer,5350,7,12,7,17,43,57,-14,43
Queen's Park,5350,8,11,9,16,42,62,-20,42
Peterhead,5350,9,9,8,19,37,54,-17,35
Stenhousem'r,5350,10,6,8,22,44,75,-31,26
Alloa,5351,1,19,10,7,78,48,30,67
Brechin,5351,2,20,5,11,50,37,13,65
Airdrieon,5351,3,19,7,10,72,51,21,64
Livingston,5351,4,20,2,14,71,54,17,62
Queen's Park,5351,5,16,5,15,47,51,-4,53
Albion,5351,6,14,8,14,50,54,-4,50
Peterhead,5351,7,13,7,16,45,60,-15,46
East Fife,5351,8,11,8,17,39,45,-6,41
Stranraer,5351,9,8,9,19,48,66,-18,33
Stenhousem'r,5351,10,5,9,22,43,77,-34,24
Livingston,5352,1,20,5,11,79,49,30,65
Albion,5352,2,18,9,9,69,56,13,63
Alloa,5352,3,17,9,10,69,48,21,60
Peterhead,5352,4,18,6,12,59,54,5,60
Airdrieon,5352,5,14,9,13,57,63,-6,51
Stranraer,5352,6,14,8,14,53,52,1,50
Brechin,5352,7,14,7,15,44,53,-9,49
Queen's Park,5352,8,12,6,18,41,51,-10,42
East Fife,5352,9,8,11,17,50,54,-4,35
Stenhousem'r,5352,10,7,6,23,47,88,-41,27
Livingston,5353,1,19,6,11,71,53,18,63
Alloa,5353,2,18,7,11,64,48,16,61
Airdrieon,5353,3,17,9,10,61,47,14,60
Albion,5353,4,14,10,12,60,47,13,52
Brechin,5353,5,14,8,14,51,58,-7,50
Stranraer,5353,6,12,9,15,56,61,-5,45
Queen's Park,5353,7,12,8,16,37,46,-9,44
Stenhousem'r,5353,8,11,9,16,49,72,-23,42
East Fife,5353,9,10,10,16,47,48,-1,40
Peterhead,5353,10,10,10,16,39,55,-16,40
Alloa,5354,1,20,10,6,70,42,28,70
Brechin,5354,2,21,4,11,59,37,22,67
Livingston,5354,3,17,6,13,66,49,17,57
Albion,5354,4,16,5,15,65,62,3,53
East Fife,5354,5,15,5,16,52,49,3,50
Airdrieon,5354,6,15,5,16,55,58,-3,50
Stranraer,5354,7,13,9,14,50,58,-8,48
Peterhead,5354,8,13,6,17,53,60,-7,45
Queen's Park,5354,9,13,6,17,42,50,-8,45
Stenhousem'r,5354,10,5,8,23,42,89,-47,23
Livingston,5355,1,24,3,9,76,39,37,75
Alloa,5355,2,22,5,9,77,34,43,71
Airdrieon,5355,3,18,7,11,55,47,8,61
Queen's Park,5355,4,17,6,13,45,49,-4,57
Brechin,5355,5,15,7,14,49,44,5,52
Stranraer,5355,6,13,4,19,43,63,-20,43
Peterhead,5355,7,11,8,17,40,55,-15,41
Albion,5355,8,11,7,18,57,65,-8,40
East Fife,5355,9,10,10,16,40,52,-12,40
Stenhousem'r,5355,10,7,7,22,44,78,-34,28
Alloa,5356,1,20,8,8,77,44,33,68
Livingston,5356,2,20,5,11,65,42,23,65
Airdrieon,5356,3,19,6,11,60,47,13,63
Brechin,5356,4,17,5,14,54,49,5,56
Peterhead,5356,5,14,9,13,53,49,4,51
Albion,5356,6,13,10,13,48,47,1,49
Stranraer,5356,7,13,4,19,48,58,-10,43
Queen's Park,5356,8,11,10,15,33,47,-14,43
East Fife,5356,9,9,11,16,46,56,-10,38
Stenhousem'r,5356,10,7,6,23,34,79,-45,27
Airdrieon,5357,1,19,6,11,62,49,13,63
Livingston,5357,2,19,4,13,72,44,28,61
Albion,5357,3,17,10,9,59,49,10,61
Brechin,5357,4,19,4,13,55,45,10,61
East Fife,5357,5,15,9,12,59,45,14,54
Alloa,5357,6,12,12,12,56,48,8,48
Queen's Park,5357,7,13,7,16,36,54,-18,46
Peterhead,5357,8,11,10,15,47,54,-7,43
Stranraer,5357,9,10,8,18,49,62,-13,38
Stenhousem'r,5357,10,7,6,23,37,82,-45,27
Livingston,5358,1,21,5,10,76,48,28,68
Alloa,5358,2,20,7,9,77,43,34,67
Brechin,5358,3,20,2,14,54,56,-2,62
Peterhead,5358,4,15,7,14,49,52,-3,52
Airdrieon,5358,5,13,9,14,55,60,-5,48
Stranraer,5358,6,13,8,15,48,55,-7,47
Albion,5358,7,12,8,16,46,49,-3,44
Queen's Park,5358,8,11,8,17,41,57,-16,41
Stenhousem'r,5358,9,11,6,19,53,72,-19,39
East Fife,5358,10,10,8,18,46,53,-7,38
Livingston,5359,1,22,5,9,79,43,36,71
Airdrieon,5359,2,18,6,12,61,50,11,60
Alloa,5359,3,17,6,13,62,49,13,57
Queen's Park,5359,4,17,4,15,42,47,-5,55
Peterhead,5359,5,16,6,14,51,52,-1,54
Stranraer,5359,6,15,6,15,56,53,3,51
Brechin,5359,7,13,9,14,51,60,-9,48
Albion,5359,8,12,8,16,51,58,-7,44
East Fife,5359,9,11,8,17,49,54,-5,41
Stenhousem'r,5359,10,8,4,24,43,79,-36,28
Livingston,5360,1,20,7,9,69,42,27,67
Alloa,5360,2,18,9,9,64,42,22,63
Brechin,5360,3,17,9,10,54,44,10,60
Peterhead,5360,4,17,5,14,58,50,8,56
Albion,5360,5,16,5,15,47,45,2,53
East Fife,5360,6,13,9,14,62,57,5,48
Stranraer,5360,7,12,8,16,45,53,-8,44
Airdrieon,5360,8,12,8,16,57,66,-9,44
Queen's Park,5360,9,11,6,19,43,50,-7,39
Stenhousem'r,5360,10,7,8,21,37,87,-50,29
Livingston,5361,1,22,4,10,71,42,29,70
Alloa,5361,2,21,6,9,77,43,34,69
Brechin,5361,3,18,4,14,52,46,6,58
Albion,5361,4,13,12,11,58,49,9,51
Peterhead,5361,5,14,6,16,47,47,0,48
Airdrieon,5361,6,13,9,14,48,54,-6,48
Stranraer,5361,7,14,5,17,58,63,-5,47
Queen's Park,5361,8,12,8,16,33,52,-19,44
East Fife,5361,9,8,12,16,36,47,-11,36
Stenhousem'r,5361,10,9,6,21,45,82,-37,33
Alloa,5362,1,23,6,7,75,38,37,75
Livingston,5362,2,20,5,11,70,50,20,65
Airdrieon,5362,3,17,6,13,64,53,11,57
Queen's Park,5362,4,14,8,14,43,54,-11,50
Stranraer,5362,5,15,4,17,50,52,-2,49
Albion,5362,6,14,7,15,47,49,-2,49
Brechin,5362,7,13,8,15,48,48,0,47
East Fife,5362,8,12,9,15,57,51,6,45
Peterhead,5362,9,12,8,16,39,55,-16,44
Stenhousem'r,5362,10,6,7,23,40,83,-43,25
Livingston,5363,1,22,4,10,76,44,32,70
Alloa,5363,2,18,7,11,69,51,18,61
Albion,5363,3,14,12,10,50,40,10,54
Airdrieon,5363,4,15,9,12,64,56,8,54
Peterhead,5363,5,15,6,15,50,54,-4,51
Brechin,5363,6,14,5,17,49,48,1,47
Stranraer,5363,7,14,5,17,54,55,-1,47
Queen's Park,5363,8,13,8,15,38,57,-19,47
East Fife,5363,9,9,9,18,40,57,-17,36
Stenhousem'r,5363,10,8,11,17,50,78,-28,35
Alloa,5364,1,22,6,8,88,39,49,72
Livingston,5364,2,21,5,10,74,47,27,68
Brechin,5364,3,18,7,11,52,45,7,61
Albion,5364,4,15,7,14,55,48,7,52
Queen's Park,5364,5,14,10,12,41,43,-2,52
Airdrieon,5364,6,16,3,17,56,68,-12,51
Stranraer,5364,7,14,5,17,56,64,-8,47
Peterhead,5364,8,11,7,18,49,60,-11,40
Stenhousem'r,5364,9,8,8,20,44,82,-38,32
East Fife,5364,10,7,10,19,44,63,-19,31
Airdrieon,5365,1,19,8,9,61,47,14,65
Alloa,5365,2,18,10,8,72,49,23,64
Livingston,5365,3,18,3,15,70,59,11,57
East Fife,5365,4,14,12,10,57,46,11,54
Brechin,5365,5,15,5,16,47,50,-3,50
Peterhead,5365,6,13,6,17,51,57,-6,45
Queen's Park,5365,7,10,13,13,33,41,-8,43
Stranraer,5365,8,12,7,17,50,61,-11,43
Albion,5365,9,11,9,16,53,57,-4,42
Stenhousem'r,5365,10,10,7,19,50,77,-27,37
Alloa,5366,1,21,10,5,75,37,38,73
Livingston,5366,2,18,7,11,68,45,23,61
Airdrieon,5366,3,18,7,11,57,50,7,61
Brechin,5366,4,13,10,13,57,56,1,49
Queen's Park,5366,5,12,10,14,42,57,-15,46
Peterhead,5366,6,11,11,14,47,57,-10,44
Albion,5366,7,11,10,15,55,59,-4,43
Stranraer,5366,8,12,7,17,52,59,-7,43
Stenhousem'r,5366,9,11,9,16,49,65,-16,42
East Fife,5366,10,7,11,18,45,62,-17,32
Livingston,5367,1,23,2,11,79,51,28,71
Brechin,5367,2,21,6,9,62,46,16,69
Alloa,5367,3,21,5,10,81,44,37,68
Albion,5367,4,15,8,13,57,56,1,53
Airdrieon,5367,5,15,6,15,64,63,1,51
Peterhead,5367,6,15,6,15,53,60,-7,51
Queen's Park,5367,7,14,3,19,40,56,-16,45
Stranraer,5367,8,12,4,20,54,66,-12,40
East Fife,5367,9,9,6,21,47,65,-18,33
Stenhousem'r,5367,10,7,10,19,44,74,-30,31
Alloa,5368,1,22,9,5,83,44,39,75
Livingston,5368,2,22,6,8,82,45,37,72
Brechin,5368,3,18,5,13,45,43,2,59
Airdrieon,5368,4,15,8,13,51,53,-2,53
East Fife,5368,5,13,11,12,52,41,11,50
Albion,5368,6,12,11,13,57,57,0,47
Stranraer,5368,7,13,6,17,49,56,-7,45
Queen's Park,5368,8,13,5,18,38,54,-16,44
Peterhead,5368,9,10,7,19,46,66,-20,37
Stenhousem'r,5368,10,5,6,25,37,81,-44,21
Airdrieon,5369,1,19,10,7,56,40,16,67
Alloa,5369,2,18,8,10,73,45,28,62
Livingston,5369,3,19,5,12,77,52,25,62
Brechin,5369,4,16,10,10,57,43,14,58
Peterhead,5369,5,15,10,11,54,49,5,55
East Fife,5369,6,11,13,12,53,52,1,46
Albion,5369,7,11,12,13,58,57,1,45
Queen's Park,5369,8,7,13,16,27,55,-28,34
Stranraer,5369,9,7,12,17,41,64,-23,33
Stenhousem'r,5369,10,5,11,20,42,81,-39,26
Livingston,5370,1,22,5,9,77,47,30,71
Alloa,5370,2,21,5,10,73,43,30,68
Airdrieon,5370,3,18,9,9,63,46,17,63
Brechin,5370,4,17,3,16,52,55,-3,54
Albion,5370,5,13,7,16,50,59,-9,46
Stranraer,5370,6,13,6,17,52,61,-9,45
Queen's Park,5370,7,13,6,17,40,54,-14,45
Peterhead,5370,8,11,10,15,52,57,-5,43
East Fife,5370,9,11,9,16,47,50,-3,42
Stenhousem'r,5370,10,7,8,21,45,79,-34,29
Livingston,5371,1,23,4,9,80,48,32,73
Alloa,5371,2,18,8,10,68,47,21,62
Airdrieon,5371,3,16,8,12,64,59,5,56
Brechin,5371,4,16,7,13,56,53,3,55
Peterhead,5371,5,14,9,13,50,49,1,51
Queen's Park,5371,6,14,9,13,46,47,-1,51
Stranraer,5371,7,13,6,17,56,60,-4,45
Albion,5371,8,12,9,15,53,58,-5,45
East Fife,5371,9,8,12,16,41,52,-11,36
Stenhousem'r,5371,10,5,10,21,41,82,-41,25
Airdrieon,5372,1,18,10,8,60,49,11,64
Brechin,5372,2,18,7,11,50,43,7,61
Alloa,5372,3,16,11,9,70,44,26,59
Stranraer,5372,4,16,7,13,53,48,5,55
Albion,5372,5,15,6,15,51,48,3,51
Livingston,5372,6,16,2,18,67,55,12,50
Peterhead,5372,7,11,10,15,40,53,-13,43
Queen's Park,5372,8,11,10,15,31,44,-13,43
East Fife,5372,9,11,9,16,45,43,2,42
Stenhousem'r,5372,10,7,10,19,39,79,-40,31
Airdrieon,5373,1,21,7,8,69,47,22,70
Livingston,5373,2,21,4,11,81,53,28,67
Alloa,5373,3,18,5,13,63,42,21,59
Peterhead,5373,4,17,5,14,47,52,-5,56
Brechin,5373,5,15,8,13,46,42,4,53
Albion,5373,6,11,13,12,52,52,0,46
Queen's Park,5373,7,13,7,16,36,45,-9,46
East Fife,5373,8,9,13,14,46,53,-7,40
Stranraer,5373,9,11,7,18,49,62,-13,40
Stenhousem'r,5373,10,6,7,23,45,86,-41,25
Livingston,5374,1,18,8,10,72,55,17,62
Alloa,5374,2,17,10,9,73,50,23,61
Brechin,5374,3,18,7,11,58,41,17,61
Airdrieon,5374,4,17,6,13,65,68,-3,57
Albion,5374,5,14,8,14,49,46,3,50
Stranraer,5374,6,15,3,18,60,55,5,48
Stenhousem'r,5374,7,13,7,16,61,79,-18,46
Peterhead,5374,8,11,10,15,49,63,-14,43
Queen's Park,5374,9,11,6,19,38,56,-18,39
East Fife,5374,10,10,7,19,45,57,-12,37
Livingston,5375,1,20,6,10,76,48,28,66
Alloa,5375,2,18,5,13,64,48,16,59
Albion,5375,3,15,11,10,59,47,12,56
Peterhead,5375,4,15,10,11,54,50,4,55
Airdrieon,5375,5,15,9,12,57,59,-2,54
Brechin,5375,6,15,7,14,43,46,-3,52
Stranraer,5375,7,14,8,14,60,55,5,50
East Fife,5375,8,10,12,14,46,40,6,42
Queen's Park,5375,9,9,11,16,32,56,-24,38
Stenhousem'r,5375,10,4,11,21,41,83,-42,23
Livingston,5376,1,22,7,7,76,37,39,73
Alloa,5376,2,18,8,10,76,46,30,62
Brechin,5376,3,20,2,14,57,51,6,62
Stranraer,5376,4,13,11,12,57,53,4,50
Peterhead,5376,5,12,10,14,57,59,-2,46
Airdrieon,5376,6,13,7,16,47,60,-13,46
Albion,5376,7,12,8,16,58,59,-1,44
East Fife,5376,8,11,10,15,47,54,-7,43
Queen's Park,5376,9,12,7,17,38,54,-16,43
Stenhousem'r,5376,10,9,6,21,47,87,-40,33
Alloa,5377,1,20,6,10,73,45,28,66
Livingston,5377,2,19,8,9,79,44,35,65
Airdrieon,5377,3,19,6,11,65,58,7,63
Brechin,5377,4,16,7,13,52,51,1,55
Peterhead,5377,5,14,9,13,49,52,-3,51
Stranraer,5377,6,14,6,16,58,64,-6,48
East Fife,5377,7,11,11,14,46,45,1,44
Queen's Park,5377,8,12,8,16,42,59,-17,44
Albion,5377,9,9,9,18,43,61,-18,36
Stenhousem'r,5377,10,7,8,21,54,82,-28,29
Livingston,5378,1,25,1,10,72,39,33,76
Alloa,5378,2,18,9,9,65,42,23,63
East Fife,5378,3,15,9,12,47,43,4,54
Stranraer,5378,4,16,4,16,47,52,-5,52
Airdrieon,5378,5,15,6,15,55,51,4,51
Peterhead,5378,6,14,7,15,45,50,-5,49
Albion,5378,7,12,10,14,52,55,-3,46
Brechin,5378,8,12,9,15,47,51,-4,45
Queen's Park,5378,9,11,7,18,38,49,-11,40
Stenhousem'r,5378,10,6,10,20,39,75,-36,28
Livingston,5379,1,21,9,6,81,47,34,72
Airdrieon,5379,2,17,7,12,58,53,5,58
Queen's Park,5379,3,16,6,14,44,45,-1,54
Brechin,5379,4,17,3,16,53,59,-6,54
Albion,5379,5,13,14,9,55,54,1,53
Peterhead,5379,6,14,8,14,55,56,-1,50
Alloa,5379,7,12,13,11,59,49,10,49
Stranraer,5379,8,12,6,18,59,59,0,42
East Fife,5379,9,8,10,18,45,57,-12,34
Stenhousem'r,5379,10,8,8,20,46,76,-30,32
Livingston,5380,1,22,6,8,77,45,32,72
Alloa,5380,2,17,12,7,72,44,28,63
Airdrieon,5380,3,17,6,13,55,50,5,57
Albion,5380,4,13,12,11,57,47,10,51
Brechin,5380,5,15,5,16,56,55,1,50
Stranraer,5380,6,14,8,14,54,59,-5,50
Queen's Park,5380,7,12,7,17,37,52,-15,43
Peterhead,5380,8,10,8,18,44,54,-10,38
East Fife,5380,9,10,8,18,42,64,-22,38
Stenhousem'r,5380,10,8,12,16,49,73,-24,36
Airdrieon,5381,1,20,6,10,70,45,25,66
Livingston,5381,2,19,7,10,73,40,33,64
Alloa,5381,3,17,7,12,69,46,23,58
Brechin,5381,4,16,5,15,53,51,2,53
Peterhead,5381,5,15,7,14,42,47,-5,52
Albion,5381,6,12,12,12,51,52,-1,48
East Fife,5381,7,11,11,14,46,54,-8,44
Stranraer,5381,8,13,4,19,51,72,-21,43
Queen's Park,5381,9,10,8,18,37,56,-19,38
Stenhousem'r,5381,10,10,7,19,42,71,-29,37
Airdrieon,5382,1,18,10,8,64,42,22,64
Livingston,5382,2,18,8,10,68,45,23,62
Alloa,5382,3,18,7,11,71,48,23,61
Albion,5382,4,15,7,14,44,56,-12,52
Brechin,5382,5,13,10,13,43,53,-10,49
East Fife,5382,6,13,9,14,60,47,13,48
Peterhead,5382,7,13,9,14,51,56,-5,48
Stranraer,5382,8,14,5,17,52,57,-5,47
Queen's Park,5382,9,13,8,15,36,46,-10,47
Stenhousem'r,5382,10,6,5,25,45,84,-39,23
Alloa,5383,1,18,9,9,71,48,23,63
Livingston,5383,2,18,5,13,75,47,28,59
Brechin,5383,3,16,6,14,49,48,1,54
Airdrieon,5383,4,15,9,12,56,57,-1,54
Queen's Park,5383,5,13,10,13,46,51,-5,49
Albion,5383,6,13,10,13,52,58,-6,49
Peterhead,5383,7,12,11,13,54,61,-7,47
Stranraer,5383,8,12,10,14,56,61,-5,46
East Fife,5383,9,11,8,17,53,54,-1,41
Stenhousem'r,5383,10,6,14,16,43,70,-27,32
Alloa,5384,1,19,7,10,74,42,32,64
Livingston,5384,2,20,4,12,72,58,14,64
Brechin,5384,3,18,6,12,50,40,10,60
Airdrieon,5384,4,17,8,11,60,51,9,59
Queen's Park,5384,5,14,6,16,41,52,-11,48
East Fife,5384,6,12,11,13,54,55,-1,47
Stranraer,5384,7,14,5,17,57,59,-2,47
Peterhead,5384,8,11,10,15,54,59,-5,43
Albion,5384,9,11,8,17,47,58,-11,41
Stenhousem'r,5384,10,6,11,19,46,81,-35,29
Alloa,5385,1,20,5,11,68,37,31,65
Livingston,5385,2,20,4,12,74,47,27,64
Brechin,5385,3,17,9,10,43,37,6,60
Albion,5385,4,17,5,14,54,51,3,56
Airdrieon,5385,5,15,8,13,54,59,-5,53
Stranraer,5385,6,14,5,17,50,53,-3,47
Peterhead,5385,7,13,7,16,48,54,-6,46
East Fife,5385,8,12,9,15,67,56,11,45
Queen's Park,5385,9,11,7,18,36,57,-21,40
Stenhousem'r,5385,10,8,7,21,48,91,-43,31
Livingston,5386,1,21,6,9,76,40,36,69
Alloa,5386,2,18,11,7,70,36,34,65
Brechin,5386,3,18,6,12,53,44,9,60
Airdrieon,5386,4,16,5,15,55,59,-4,53
East Fife,5386,5,15,7,14,54,52,2,52
Peterhead,5386,6,15,6,15,55,62,-7,51
Stranraer,5386,7,14,5,17,46,53,-7,47
Albion,5386,8,12,9,15,55,54,1,45
Queen's Park,5386,9,10,8,18,31,51,-20,38
Stenhousem'r,5386,10,5,9,22,42,86,-44,24
Livingston,5387,1,20,6,10,75,49,26,66
Alloa,5387,2,18,8,10,67,40,27,62
Peterhead,5387,3,15,9,12,53,47,6,54
Albion,5387,4,15,8,13,55,54,1,53
Airdrieon,5387,5,14,9,13,56,52,4,51
Brechin,5387,6,14,9,13,44,52,-8,51
Queen's Park,5387,7,14,6,16,43,47,-4,48
East Fife,5387,8,9,13,14,46,53,-7,40
Stranraer,5387,9,12,3,21,46,64,-18,39
Stenhousem'r,5387,10,10,7,19,47,74,-27,37
Brechin,5388,1,19,9,8,56,44,12,66
Livingston,5388,2,20,5,11,75,53,22,65
Airdrieon,5388,3,19,7,10,62,49,13,64
Alloa,5388,4,15,14,7,65,42,23,59
Albion,5388,5,15,8,13,51,48,3,53
East Fife,5388,6,11,11,14,49,51,-2,44
Queen's Park,5388,7,12,6,18,37,52,-15,42
Stranraer,5388,8,10,5,21,37,56,-19,35
Stenhousem'r,5388,9,8,11,17,42,64,-22,35
Peterhead,5388,10,8,10,18,39,54,-15,34
Airdrieon,5389,1,20,5,11,57,53,4,65
Livingston,5389,2,19,6,11,73,48,25,63
Alloa,5389,3,17,10,9,73,49,24,61
Peterhead,5389,4,18,6,12,60,50,10,60
Brechin,5389,5,17,5,14,46,47,-1,56
Albion,5389,6,13,9,14,51,50,1,48
East Fife,5389,7,12,9,15,49,53,-4,45
Stranraer,5389,8,12,6,18,52,59,-7,42
Stenhousem'r,5389,9,8,8,20,43,68,-25,32
Queen's Park,5389,10,7,10,19,28,55,-27,31
Livingston,5390,1,20,6,10,79,57,22,66
Brechin,5390,2,17,6,13,49,45,4,57
Airdrieon,5390,3,16,9,11,55,57,-2,57
Albion,5390,4,16,7,13,67,49,18,55
Alloa,5390,5,15,7,14,69,45,24,52
Peterhead,5390,6,14,6,16,49,62,-13,48
Queen's Park,5390,7,12,11,13,36,48,-12,47
East Fife,5390,8,12,9,15,47,44,3,45
Stranraer,5390,9,12,8,16,51,61,-10,44
Stenhousem'r,5390,10,7,9,20,47,81,-34,30
Livingston,5391,1,23,3,10,77,45,32,72
Peterhead,5391,2,17,8,11,50,41,9,59
Alloa,5391,3,16,8,12,65,49,16,56
Albion,5391,4,15,8,13,58,60,-2,53
Airdrieon,5391,5,14,9,13,55,55,0,51
Brechin,5391,6,15,5,16,49,50,-1,50
Queen's Park,5391,7,14,6,16,39,44,-5,48
East Fife,5391,8,10,8,18,43,53,-10,38
Stranraer,5391,9,9,11,16,48,65,-17,38
Stenhousem'r,5391,10,10,8,18,52,74,-22,38
Livingston,5392,1,20,4,12,74,53,21,64
Airdrieon,5392,2,17,8,11,53,45,8,59
Brechin,5392,3,18,4,14,58,49,9,58
Alloa,5392,4,16,8,12,59,45,14,56
East Fife,5392,5,14,9,13,53,44,9,51
Albion,5392,6,13,9,14,47,47,0,48
Stranraer,5392,7,15,3,18,60,66,-6,48
Peterhead,5392,8,13,9,14,41,54,-13,48
Stenhousem'r,5392,9,8,12,16,49,72,-23,36
Queen's Park,5392,10,8,10,18,36,55,-19,34
Alloa,5393,1,21,7,8,68,37,31,70
Livingston,5393,2,22,3,11,67,45,22,69
Brechin,5393,3,15,8,13,50,47,3,53
Airdrieon,5393,4,14,10,12,48,52,-4,52
Peterhead,5393,5,13,11,12,49,40,9,50
Albion,5393,6,13,11,12,55,54,1,50
Queen's Park,5393,7,13,6,17,36,43,-7,45
East Fife,5393,8,10,8,18,50,61,-11,38
Stranraer,5393,9,11,5,20,51,64,-13,38
Stenhousem'r,5393,10,10,7,19,58,89,-31,37
Livingston,5394,1,23,3,10,75,48,27,72
Alloa,5394,2,22,3,11,67,42,25,69
Airdrieon,5394,3,16,9,11,61,50,11,57
Brechin,5394,4,16,6,14,48,52,-4,54
Stranraer,5394,5,16,5,15,58,53,5,53
Queen's Park,5394,6,13,9,14,45,53,-8,48
Albion,5394,7,12,10,14,57,57,0,46
Peterhead,5394,8,11,7,18,43,62,-19,40
East Fife,5394,9,10,8,18,46,55,-9,38
Stenhousem'r,5394,10,7,8,21,46,74,-28,29
Alloa,5395,1,20,8,8,69,41,28,68
Livingston,5395,2,21,3,12,75,49,26,66
Albion,5395,3,17,8,11,57,49,8,59
East Fife,5395,4,15,12,9,51,38,13,57
Brechin,5395,5,15,7,14,55,53,2,52
Airdrieon,5395,6,15,7,14,57,58,-1,52
Queen's Park,5395,7,13,8,15,40,52,-12,47
Peterhead,5395,8,12,8,16,45,51,-6,44
Stranraer,5395,9,11,7,18,53,62,-9,40
Stenhousem'r,5395,10,4,6,26,34,83,-49,18
Alloa,5396,1,19,9,8,68,43,25,66
Livingston,5396,2,19,6,11,83,44,39,63
Airdrieon,5396,3,17,6,13,58,66,-8,57
Brechin,5396,4,17,4,15,53,52,1,55
Stranraer,5396,5,16,4,16,56,59,-3,52
Peterhead,5396,6,14,9,13,49,51,-2,51
East Fife,5396,7,14,6,16,57,48,9,48
Albion,5396,8,12,10,14,57,57,0,46
Queen's Park,5396,9,9,11,16,35,55,-20,38
Stenhousem'r,5396,10,6,9,21,48,89,-41,27
Alloa,5397,1,21,8,7,70,41,29,71
Livingston,5397,2,19,7,10,75,44,31,64
Albion,5397,3,19,7,10,60,48,12,64
Airdrieon,5397,4,20,3,13,73,63,10,63
Brechin,5397,5,14,7,15,46,58,-12,49
East Fife,5397,6,14,6,16,59,49,10,48
Peterhead,5397,7,14,5,17,43,50,-7,47
Queen's Park,5397,8,12,8,16,39,56,-17,44
Stranraer,5397,9,7,9,20,42,65,-23,30
Stenhousem'r,5397,10,5,10,21,42,75,-33,25
Alloa,5398,1,21,9,6,66,36,30,72
Livingston,5398,2,19,6,11,78,45,33,63
Albion,5398,3,18,8,10,65,40,25,62
Airdrieon,5398,4,18,7,11,58,56,2,61
Peterhead,5398,5,16,7,13,54,53,1,55
Brechin,5398,6,14,7,15,48,58,-10,49
East Fife,5398,7,11,8,17,45,52,-7,41
Stranraer,5398,8,11,7,18,49,62,-13,40
Queen's Park,5398,9,9,4,23,28,58,-30,31
Stenhousem'r,5398,10,8,7,21,45,76,-31,31
Livingston,5399,1,20,5,11,83,51,32,65
Airdrieon,5399,2,17,11,8,55,43,12,62
Brechin,5399,3,17,7,12,54,50,4,58
Peterhead,5399,4,14,10,12,53,50,3,52
Alloa,5399,5,13,9,14,68,64,4,48
Queen's Park,5399,6,13,9,14,37,45,-8,48
Stranraer,5399,7,13,6,17,54,64,-10,45
Albion,5399,8,11,9,16,45,52,-7,42
Stenhousem'r,5399,9,10,10,16,47,68,-21,40
East Fife,5399,10,10,8,18,45,54,-9,38
Livingston,5400,1,24,5,7,89,40,49,77
Airdrieon,5400,2,17,7,12,55,46,9,58
Brechin,5400,3,16,5,15,48,56,-8,53
Alloa,5400,4,15,6,15,60,50,10,51
Queen's Park,5400,5,13,11,12,42,48,-6,50
East Fife,5400,6,13,9,14,44,49,-5,48
Stranraer,5400,7,13,7,16,53,56,-3,46
Albion,5400,8,11,12,13,54,56,-2,45
Peterhead,5400,9,12,9,15,43,51,-8,45
Stenhousem'r,5400,10,7,7,22,40,76,-36,28
Alloa,5401,1,23,6,7,79,37,42,75
Livingston,5401,2,20,5,11,73,45,28,65
Brechin,5401,3,19,8,9,59,44,15,65
Albion,5401,4,14,10,12,58,50,8,52
Airdrieon,5401,5,15,7,14,56,59,-3,52
Peterhead,5401,6,12,8,16,45,60,-15,44
Queen's Park,5401,7,12,7,17,35,53,-18,43
East Fife,5401,8,11,8,17,48,59,-11,41
Stranraer,5401,9,10,7,19,46,62,-16,37
Stenhousem'r,5401,10,8,6,22,47,77,-30,30
Livingston,5402,1,23,6,7,85,46,39,75
Alloa,5402,2,20,7,9,72,48,24,67
Brechin,5402,3,17,9,10,54,45,9,60
Albion,5402,4,14,14,8,61,51,10,56
Airdrieon,5402,5,16,5,15,60,65,-5,53
Peterhead,5402,6,13,6,17,49,53,-4,45
Queen's Park,5402,7,12,8,16,41,52,-11,44
East Fife,5402,8,10,9,17,50,59,-9,39
Stranraer,5402,9,8,7,21,55,80,-25,31
Stenhousem'r,5402,10,8,7,21,41,69,-28,31
Livingston,5403,1,22,7,7,83,47,36,73
Brechin,5403,2,19,3,14,48,42,6,60
Albion,5403,3,16,11,9,54,43,11,59
Airdrieon,5403,4,16,7,13,63,58,5,55
Alloa,5403,5,14,9,13,63,53,10,51
Stranraer,5403,6,13,10,13,52,51,1,49
Queen's Park,5403,7,13,8,15,45,52,-7,47
Peterhead,5403,8,11,11,14,55,66,-11,44
East Fife,5403,9,8,8,20,46,59,-13,32
Stenhousem'r,5403,10,6,10,20,47,85,-38,28
Alloa,5404,1,18,9,9,75,48,27,63
Livingston,5404,2,19,5,12,71,47,24,62
Airdrieon,5404,3,18,5,13,64,50,14,59
Albion,5404,4,15,10,11,52,49,3,55
Peterhead,5404,5,13,11,12,45,48,-3,50
Brechin,5404,6,15,3,18,50,57,-7,48
Queen's Park,5404,7,12,10,14,39,53,-14,46
East Fife,5404,8,11,11,14,48,48,0,44
Stranraer,5404,9,12,6,18,48,59,-11,42
Stenhousem'r,5404,10,8,8,20,44,77,-33,32
Alloa,5405,1,20,5,11,72,49,23,65
Livingston,5405,2,19,6,11,72,48,24,63
Airdrieon,5405,3,19,5,12,64,47,17,62
Stranraer,5405,4,16,5,15,55,59,-4,53
Queen's Park,5405,5,15,7,14,43,48,-5,52
Brechin,5405,6,13,7,16,45,50,-5,46
Albion,5405,7,13,7,16,59,65,-6,46
East Fife,5405,8,12,9,15,55,50,5,45
Peterhead,5405,9,13,6,17,51,55,-4,45
Stenhousem'r,5405,10,9,5,22,41,86,-45,32
Brechin,5406,1,18,7,11,56,43,13,61
Airdrieon,5406,2,17,7,12,61,64,-3,58
Livingston,5406,3,17,6,13,65,47,18,57
Queen's Park,5406,4,17,6,13,43,43,0,57
Alloa,5406,5,15,10,11,58,45,13,55
Peterhead,5406,6,14,9,13,51,49,2,51
East Fife,5406,7,11,12,13,45,42,3,45
Stranraer,5406,8,13,5,18,55,63,-8,44
Albion,5406,9,10,11,15,44,49,-5,41
Stenhousem'r,5406,10,8,7,21,43,76,-33,31
Livingston,5407,1,24,4,8,89,52,37,76
Albion,5407,2,17,8,11,60,49,11,59
Alloa,5407,3,16,8,12,68,46,22,56
Airdrieon,5407,4,16,7,13,62,59,3,55
Brechin,5407,5,14,7,15,50,52,-2,49
Peterhead,5407,6,13,9,14,60,63,-3,48
Queen's Park,5407,7,12,8,16,36,54,-18,44
East Fife,5407,8,10,10,16,49,54,-5,40
Stenhousem'r,5407,9,9,10,17,62,86,-24,37
Stranraer,5407,10,9,9,18,44,65,-21,36
Alloa,5408,1,23,7,6,77,40,37,76
Livingston,5408,2,22,6,8,86,50,36,72
Airdrieon,5408,3,17,6,13,65,59,6,57
Peterhead,5408,4,17,4,15,48,46,2,55
Brechin,5408,5,16,5,15,50,47,3,53
Stranraer,5408,6,14,4,18,47,57,-10,46
Albion,5408,7,12,7,17,52,62,-10,43
East Fife,5408,8,11,6,19,47,50,-3,39
Queen's Park,5408,9,9,9,18,36,60,-24,36
Stenhousem'r,5408,10,7,10,19,41,78,-37,31
Livingston,5409,1,20,5,11,68,45,23,65
Alloa,5409,2,18,10,8,70,41,29,64
Stranraer,5409,3,18,8,10,68,53,15,62
Brechin,5409,4,16,8,12,50,54,-4,56
Airdrieon,5409,5,15,7,14,65,59,6,52
Queen's Park,5409,6,14,7,15,47,59,-12,49
Albion,5409,7,12,7,17,46,49,-3,43
Peterhead,5409,8,11,9,16,46,58,-12,42
East Fife,5409,9,10,7,19,43,56,-13,37
Stenhousem'r,5409,10,8,8,20,52,81,-29,32
Livingston,5410,1,21,7,8,82,54,28,70
Alloa,5410,2,19,8,9,77,43,34,65
Airdrieon,5410,3,18,8,10,61,54,7,62
Albion,5410,4,16,7,13,59,54,5,55
Brechin,5410,5,14,8,14,49,47,2,50
Stranraer,5410,6,13,4,19,49,58,-9,43
Peterhead,5410,7,11,10,15,38,50,-12,43
East Fife,5410,8,10,12,14,44,50,-6,42
Queen's Park,5410,9,10,10,16,34,49,-15,40
Stenhousem'r,5410,10,8,6,22,38,72,-34,30
Livingston,5411,1,21,6,9,76,43,33,69
Alloa,5411,2,20,6,10,70,48,22,66
East Fife,5411,3,14,11,11,51,45,6,53
Stranraer,5411,4,15,6,15,53,54,-1,51
Peterhead,5411,5,13,10,13,46,49,-3,49
Airdrieon,5411,6,13,8,15,61,59,2,47
Brechin,5411,7,12,7,17,49,51,-2,43
Albion,5411,8,11,10,15,39,47,-8,43
Stenhousem'r,5411,9,12,7,17,53,77,-24,43
Queen's Park,5411,10,9,9,18,28,53,-25,36
Alloa,5412,1,21,4,11,65,39,26,67
Airdrieon,5412,2,18,5,13,65,51,14,59
Livingston,5412,3,18,3,15,65,52,13,57
Peterhead,5412,4,18,3,15,53,46,7,57
Brechin,5412,5,15,9,12,49,41,8,54
Albion,5412,6,13,11,12,57,50,7,50
Stranraer,5412,7,13,9,14,52,60,-8,48
East Fife,5412,8,13,7,16,48,49,-1,46
Queen's Park,5412,9,12,7,17,39,60,-21,43
Stenhousem'r,5412,10,7,6,23,42,87,-45,27
Livingston,5413,1,23,6,7,74,36,38,75
Alloa,5413,2,19,7,10,67,43,24,64
Brechin,5413,3,16,10,10,58,51,7,58
Airdrieon,5413,4,15,8,13,60,60,0,53
Peterhead,5413,5,14,9,13,45,46,-1,51
Queen's Park,5413,6,14,7,15,44,53,-9,49
East Fife,5413,7,12,9,15,45,45,0,45
Stranraer,5413,8,10,8,18,47,60,-13,38
Albion,5413,9,10,7,19,46,54,-8,37
Stenhousem'r,5413,10,6,11,19,36,74,-38,29
Airdrieon,5414,1,18,12,6,60,36,24,66
Livingston,5414,2,18,8,10,72,50,22,62
Alloa,5414,3,17,10,9,66,46,20,61
Brechin,5414,4,17,7,12,54,47,7,58
East Fife,5414,5,13,9,14,56,49,7,48
Albion,5414,6,13,9,14,53,53,0,48
Stranraer,5414,7,13,9,14,56,63,-7,48
Queen's Park,5414,8,11,8,17,39,57,-18,41
Peterhead,5414,9,7,10,19,40,65,-25,31
Stenhousem'r,5414,10,7,10,19,40,70,-30,31
Livingston,5415,1,20,7,9,83,50,33,67
Airdrieon,5415,2,20,4,12,63,53,10,64
Alloa,5415,3,18,9,9,71,51,20,63
Brechin,5415,4,15,8,13,42,45,-3,53
Albion,5415,5,13,11,12,55,49,6,50
Queen's Park,5415,6,13,9,14,41,48,-7,48
Peterhead,5415,7,13,6,17,41,50,-9,45
East Fife,5415,8,11,9,16,56,60,-4,42
Stranraer,5415,9,12,6,18,42,54,-12,42
Stenhousem'r,5415,10,6,9,21,44,78,-34,27
Alloa,5416,1,20,8,8,69,39,30,68
Livingston,5416,2,19,6,11,72,46,26,63
Brechin,5416,3,18,6,12,44,41,3,60
Albion,5416,4,16,9,11,58,47,11,57
Airdrieon,5416,5,15,7,14,55,53,2,52
Peterhead,5416,6,15,7,14,50,52,-2,52
Stranraer,5416,7,15,4,17,52,55,-3,49
East Fife,5416,8,12,7,17,42,48,-6,43
Queen's Park,5416,9,9,9,18,27,48,-21,36
Stenhousem'r,5416,10,6,7,23,34,74,-40,25
Livingston,5417,1,26,2,8,90,45,45,80
Alloa,5417,2,21,5,10,70,46,24,68
Airdrieon,5417,3,19,7,10,63,58,5,64
Albion,5417,4,16,8,12,58,47,11,56
Brechin,5417,5,15,6,15,43,49,-6,51
Queen's Park,5417,6,12,6,18,40,49,-9,42
East Fife,5417,7,11,8,17,49,56,-7,41
Stranraer,5417,8,10,7,19,52,65,-13,37
Peterhead,5417,9,9,9,18,43,58,-15,36
Stenhousem'r,5417,10,7,10,19,44,79,-35,31
Alloa,5418,1,21,8,7,73,48,25,71
Livingston,5418,2,20,8,8,82,56,26,68
Brechin,5418,3,15,6,15,59,52,7,51
Queen's Park,5418,4,13,9,14,43,45,-2,48
Airdrieon,5418,5,13,9,14,58,62,-4,48
Peterhead,5418,6,13,8,15,44,52,-8,47
Albion,5418,7,12,9,15,56,55,1,45
Stranraer,5418,8,12,9,15,48,58,-10,45
East Fife,5418,9,11,10,15,50,54,-4,43
Stenhousem'r,5418,10,9,6,21,48,79,-31,33
Alloa,5419,1,22,8,6,73,37,36,74
Livingston,5419,2,22,3,11,80,46,34,69
Airdrieon,5419,3,18,6,12,58,54,4,60
Brechin,5419,4,15,6,15,49,46,3,51
Stranraer,5419,5,12,9,15,49,48,1,45
East Fife,5419,6,13,6,17,49,49,0,45
Peterhead,5419,7,13,6,17,48,59,-11,45
Queen's Park,5419,8,12,7,17,39,63,-24,43
Stenhousem'r,5419,9,11,7,18,54,73,-19,40
Albion,5419,10,11,4,21,51,75,-24,37
Alloa,5420,1,21,7,8,81,41,40,70
Livingston,5420,2,21,3,12,75,51,24,66
Brechin,5420,3,18,7,11,57,47,10,61
Airdrieon,5420,4,17,6,13,55,54,1,57
East Fife,5420,5,13,10,13,53,47,6,49
Albion,5420,6,13,6,17,54,61,-7,45
Queen's Park,5420,7,12,8,16,42,54,-12,44
Peterhead,5420,8,12,6,18,48,59,-11,42
Stranraer,5420,9,12,5,19,49,63,-14,41
Stenhousem'r,5420,10,8,8,20,45,82,-37,32
Alloa,5421,1,21,6,9,72,38,34,69
Airdrieon,5421,2,19,6,11,62,55,7,63
Livingston,5421,3,19,4,13,67,43,24,61
Brechin,5421,4,16,4,16,51,50,1,52
Stranraer,5421,5,15,4,17,52,66,-14,49
Peterhead,5421,6,13,9,14,49,51,-2,48
East Fife,5421,7,11,11,14,48,46,2,44
Albion,5421,8,12,8,16,53,56,-3,44
Queen's Park,5421,9,10,9,17,37,57,-20,39
Stenhousem'r,5421,10,10,7,19,46,75,-29,37
Livingston,5422,1,21,4,11,81,51,30,67
Airdrieon,5422,2,20,6,10,71,56,15,66
Brechin,5422,3,17,8,11,47,42,5,59
Alloa,5422,4,17,7,12,71,55,16,58
East Fife,5422,5,14,9,13,60,57,3,51
Peterhead,5422,6,13,10,13,50,52,-2,49
Queen's Park,5422,7,12,7,17,47,59,-12,43
Albion,5422,8,11,8,17,52,62,-10,41
Stranraer,5422,9,11,6,19,50,61,-11,39
Stenhousem'r,5422,10,7,9,20,44,78,-34,30
Livingston,5423,1,19,6,11,73,46,27,63
Alloa,5423,2,18,9,9,64,45,19,63
Airdrieon,5423,3,19,6,11,55,48,7,63
Brechin,5423,4,18,5,13,59,54,5,59
Albion,5423,5,16,6,14,54,50,4,54
Peterhead,5423,6,14,9,13,53,46,7,51
Stranraer,5423,7,13,5,18,60,62,-2,44
East Fife,5423,8,11,8,17,49,55,-6,41
Queen's Park,5423,9,10,6,20,37,56,-19,36
Stenhousem'r,5423,10,9,6,21,48,90,-42,33
Airdrieon,5424,1,20,6,10,68,48,20,66
Alloa,5424,2,19,8,9,71,44,27,65
Livingston,5424,3,19,5,12,71,45,26,62
Stranraer,5424,4,15,6,15,47,53,-6,51
Brechin,5424,5,14,8,14,49,52,-3,50
Peterhead,5424,6,14,8,14,51,55,-4,50
Albion,5424,7,13,8,15,49,48,1,47
East Fife,5424,8,11,10,15,46,52,-6,43
Queen's Park,5424,9,9,11,16,37,55,-18,38
Stenhousem'r,5424,10,7,8,21,43,80,-37,29
Alloa,5425,1,22,7,7,79,43,36,73
Livingston,5425,2,19,6,11,71,49,22,63
Airdrieon,5425,3,17,6,13,61,52,9,57
Peterhead,5425,4,14,10,12,56,53,3,52
Albion,5425,5,13,12,11,52,50,2,51
Queen's Park,5425,6,14,7,15,42,49,-7,49
Brechin,5425,7,13,8,15,46,52,-6,47
Stranraer,5425,8,13,7,16,56,60,-4,46
East Fife,5425,9,7,11,18,34,53,-19,32
Stenhousem'r,5425,10,6,10,20,41,77,-36,28
Alloa,5426,1,21,7,8,76,46,30,70
Livingston,5426,2,20,6,10,79,47,32,66
Airdrieon,5426,3,18,5,13,61,52,9,59
Brechin,5426,4,14,9,13,44,47,-3,51
Peterhead,5426,5,14,7,15,49,54,-5,49
Queen's Park,5426,6,14,7,15,42,48,-6,49
Albion,5426,7,13,8,15,52,56,-4,47
Stranraer,5426,8,13,7,16,48,56,-8,46
East Fife,5426,9,13,6,17,55,53,2,45
Stenhousem'r,5426,10,5,8,23,48,95,-47,23
Alloa,5427,1,22,8,6,72,38,34,74
Livingston,5427,2,20,9,7,82,41,41,69
Airdrieon,5427,3,17,5,14,60,55,5,56
Brechin,5427,4,16,6,14,55,55,0,54
Peterhead,5427,5,15,6,15,50,55,-5,51
Albion,5427,6,14,4,18,56,51,5,46
East Fife,5427,7,11,12,13,45,42,3,45
Queen's Park,5427,8,11,8,17,33,57,-24,41
Stranraer,5427,9,10,5,21,43,73,-30,35
Stenhousem'r,5427,10,9,7,20,46,75,-29,34
Livingston,5428,1,20,6,10,69,45,24,66
Alloa,5428,2,17,13,6,71,40,31,64
Brechin,5428,3,18,10,8,59,40,19,64
Albion,5428,4,14,9,13,55,54,1,51
Airdrieon,5428,5,14,9,13,57,68,-11,51
East Fife,5428,6,12,10,14,46,47,-1,46
Peterhead,5428,7,13,6,17,43,56,-13,45
Stranraer,5428,8,13,4,19,53,63,-10,43
Queen's Park,5428,9,12,6,18,41,51,-10,42
Stenhousem'r,5428,10,7,7,22,49,79,-30,28
Alloa,5429,1,19,8,9,72,37,35,65
Airdrieon,5429,2,18,8,10,61,51,10,62
Livingston,5429,3,19,4,13,79,63,16,61
Brechin,5429,4,17,6,13,54,49,5,57
Stranraer,5429,5,17,2,17,53,52,1,53
Peterhead,5429,6,14,8,14,44,48,-4,50
Albion,5429,7,13,9,14,52,49,3,48
Queen's Park,5429,8,13,7,16,44,58,-14,46
East Fife,5429,9,9,10,17,42,52,-10,37
Stenhousem'r,5429,10,5,10,21,45,87,-42,25
Livingston,5430,1,27,2,7,79,33,46,83
Alloa,5430,2,19,9,8,61,40,21,66
East Fife,5430,3,14,10,12,49,41,8,52
Brechin,5430,4,14,6,16,43,44,-1,48
Stranraer,5430,5,14,5,17,50,51,-1,47
Albion,5430,6,12,11,13,47,49,-2,47
Airdrieon,5430,7,14,5,17,52,59,-7,47
Peterhead,5430,8,11,9,16,43,54,-11,42
Queen's Park,5430,9,12,6,18,36,59,-23,42
Stenhousem'r,5430,10,6,11,19,40,70,-30,29
Livingston,5431,1,21,4,11,82,51,31,67
Alloa,5431,2,18,9,9,73,45,28,63
Airdrieon,5431,3,18,6,12,57,44,13,60
Brechin,5431,4,16,7,13,49,49,0,55
Albion,5431,5,15,6,15,49,47,2,51
East Fife,5431,6,11,12,13,44,44,0,45
Queen's Park,5431,7,12,9,15,36,50,-14,45
Stranraer,5431,8,11,11,14,50,60,-10,44
Peterhead,5431,9,12,6,18,51,58,-7,42
Stenhousem'r,5431,10,6,10,20,47,90,-43,28
Livingston,5432,1,22,4,10,87,53,34,70
Alloa,5432,2,16,10,10,63,50,13,58
Brechin,5432,3,17,7,12,58,52,6,58
Airdrieon,5432,4,16,7,13,68,68,0,55
Peterhead,5432,5,15,8,13,58,54,4,53
Stranraer,5432,6,12,7,17,49,58,-9,43
Albion,5432,7,12,6,18,52,56,-4,42
East Fife,5432,8,11,9,16,50,55,-5,42
Stenhousem'r,5432,9,11,8,17,54,72,-18,41
Queen's Park,5432,10,11,8,17,30,51,-21,41
Alloa,5433,1,22,3,11,74,41,33,69
Livingston,5433,2,21,3,12,70,49,21,66
Brechin,5433,3,16,7,13,46,43,3,55
Airdrieon,5433,4,16,7,13,51,50,1,55
East Fife,5433,5,14,10,12,54,46,8,52
Stranraer,5433,6,14,7,15,50,52,-2,49
Albion,5433,7,12,9,15,59,52,7,45
Peterhead,5433,8,12,7,17,39,51,-12,43
Queen's Park,5433,9,12,6,18,39,53,-14,42
Stenhousem'r,5433,10,8,7,21,44,89,-45,31
Livingston,5434,1,19,7,10,61,46,15,64
Airdrieon,5434,2,20,3,13,58,52,6,63
Alloa,5434,3,17,8,11,68,45,23,59
Queen's Park,5434,4,16,6,14,48,44,4,54
Peterhead,5434,5,15,7,14,50,50,0,52
Brechin,5434,6,15,6,15,49,51,-2,51
Albion,5434,7,13,10,13,53,51,2,49
Stranraer,5434,8,12,6,18,52,59,-7,42
Stenhousem'r,5434,9,9,9,18,40,70,-30,36
East Fife,5434,10,9,8,19,42,53,-11,35
Alloa,5435,1,19,8,9,73,56,17,65
Livingston,5435,2,19,5,12,74,52,22,62
Airdrieon,5435,3,18,7,11,63,48,15,61
Brechin,5435,4,17,3,16,52,52,0,54
Stranraer,5435,5,16,5,15,61,52,9,53
East Fife,5435,6,15,7,14,46,46,0,52
Albion,5435,7,15,5,16,59,54,5,50
Queen's Park,5435,8,14,5,17,44,58,-14,47
Peterhead,5435,9,12,10,14,47,52,-5,46
Stenhousem'r,5435,10,5,5,26,36,85,-49,20
Airdrieon,5436,1,17,9,10,56,47,9,60
Livingston,5436,2,17,6,13,66,51,15,57
Alloa,5436,3,16,8,12,70,48,22,56
Stranraer,5436,4,17,5,14,52,51,1,56
Queen's Park,5436,5,15,7,14,35,51,-16,52
Brechin,5436,6,15,6,15,47,49,-2,51
East Fife,5436,7,14,8,14,54,43,11,50
Albion,5436,8,14,7,15,53,48,5,49
Stenhousem'r,5436,9,9,12,15,51,73,-22,39
Peterhead,5436,10,8,8,20,42,65,-23,32
Livingston,5437,1,23,5,8,84,46,38,74
Alloa,5437,2,19,8,9,65,44,21,65
Albion,5437,3,16,10,10,63,49,14,58
Airdrieon,5437,4,14,9,13,53,49,4,51
Queen's Park,5437,5,15,5,16,41,48,-7,50
Peterhead,5437,6,14,7,15,52,51,1,49
East Fife,5437,7,12,8,16,49,52,-3,44
Stranraer,5437,8,12,8,16,53,64,-11,44
Brechin,5437,9,10,7,19,38,57,-19,37
Stenhousem'r,5437,10,7,9,20,52,90,-38,30
Alloa,5438,1,21,9,6,67,36,31,72
Livingston,5438,2,21,5,10,72,44,28,68
East Fife,5438,3,15,9,12,49,35,14,54
Brechin,5438,4,14,7,15,40,43,-3,49
Airdrieon,5438,5,13,10,13,49,58,-9,49
Peterhead,5438,6,13,8,15,51,58,-7,47
Queen's Park,5438,7,13,6,17,35,48,-13,45
Stranraer,5438,8,13,4,19,51,60,-9,43
Albion,5438,9,11,9,16,45,53,-8,42
Stenhousem'r,5438,10,8,9,19,45,69,-24,33
Alloa,5439,1,24,6,6,77,35,42,78
Airdrieon,5439,2,18,9,9,73,51,22,63
Livingston,5439,3,20,2,14,64,46,18,62
Brechin,5439,4,17,8,11,51,45,6,59
East Fife,5439,5,13,8,15,46,49,-3,47
Peterhead,5439,6,12,11,13,47,57,-10,47
Queen's Park,5439,7,13,7,16,42,52,-10,46
Albion,5439,8,10,8,18,40,55,-15,38
Stranraer,5439,9,11,4,21,49,60,-11,37
Stenhousem'r,5439,10,7,7,22,41,80,-39,28
Livingston,5440,1,23,2,11,82,42,40,71
Alloa,5440,2,19,10,7,67,36,31,67
Airdrieon,5440,3,19,6,11,62,57,5,63
Brechin,5440,4,17,7,12,54,44,10,58
East Fife,5440,5,16,6,14,58,50,8,54
Peterhead,5440,6,12,9,15,50,57,-7,45
Albion,5440,7,11,11,14,48,54,-6,44
Stranraer,5440,8,11,5,20,44,72,-28,38
Queen's Park,5440,9,10,6,20,35,57,-22,36
Stenhousem'r,5440,10,8,6,22,43,74,-31,30
Alloa,5441,1,22,6,8,65,42,23,72
Brechin,5441,2,22,4,10,59,42,17,70
Livingston,5441,3,21,4,11,78,47,31,67
Albion,5441,4,15,6,15,57,57,0,51
Airdrieon,5441,5,14,7,15,55,61,-6,49
Queen's Park,5441,6,14,6,16,36,45,-9,48
East Fife,5441,7,12,7,17,47,50,-3,43
Peterhead,5441,8,12,7,17,42,46,-4,43
Stranraer,5441,9,11,7,18,55,62,-7,40
Stenhousem'r,5441,10,7,6,23,43,85,-42,27
Alloa,5442,1,21,7,8,76,50,26,70
Airdrieon,5442,2,18,7,11,60,49,11,61
Livingston,5442,3,17,7,12,60,48,12,58
Peterhead,5442,4,17,5,14,54,52,2,56
Albion,5442,5,15,8,13,61,53,8,53
Brechin,5442,6,11,10,15,44,50,-6,43
Queen's Park,5442,7,11,10,15,39,52,-13,43
Stranraer,5442,8,12,5,19,50,59,-9,41
East Fife,5442,9,10,8,18,45,54,-9,38
Stenhousem'r,5442,10,9,11,16,49,71,-22,38
Livingston,5443,1,23,3,10,78,47,31,72
Alloa,5443,2,19,9,8,75,50,25,66
Airdrieon,5443,3,18,8,10,70,49,21,62
Stranraer,5443,4,16,5,15,59,45,14,53
Brechin,5443,5,14,8,14,51,51,0,50
East Fife,5443,6,12,9,15,56,53,3,45
Albion,5443,7,11,11,14,49,56,-7,44
Peterhead,5443,8,10,9,17,46,62,-16,39
Stenhousem'r,5443,9,10,6,20,49,92,-43,36
Queen's Park,5443,10,9,8,19,26,54,-28,35
Brechin,5444,1,18,8,10,57,38,19,62
Livingston,5444,2,17,7,12,74,55,19,58
Stranraer,5444,3,15,8,13,50,52,-2,53
Airdrieon,5444,4,14,10,12,53,50,3,52
Queen's Park,5444,5,15,6,15,39,44,-5,51
Albion,5444,6,13,11,12,52,48,4,50
Alloa,5444,7,12,13,11,64,56,8,49
Peterhead,5444,8,11,11,14,42,50,-8,44
East Fife,5444,9,10,10,16,41,48,-7,40
Stenhousem'r,5444,10,9,8,19,40,71,-31,35
Alloa,5445,1,20,7,9,72,43,29,67
Livingston,5445,2,19,5,12,82,49,33,62
Airdrieon,5445,3,19,4,13,58,43,15,61
Brechin,5445,4,17,8,11,51,43,8,59
Queen's Park,5445,5,15,7,14,41,42,-1,52
Stranraer,5445,6,15,5,16,48,57,-9,50
Peterhead,5445,7,14,6,16,48,55,-7,48
Albion,5445,8,12,9,15,49,57,-8,45
East Fife,5445,9,9,9,18,45,56,-11,36
Stenhousem'r,5445,10,7,6,23,37,86,-49,27
Alloa,5446,1,17,8,11,68,49,19,59
Livingston,5446,2,16,7,13,61,50,11,55
Albion,5446,3,15,9,12,61,48,13,54
East Fife,5446,4,15,9,12,51,44,7,54
Airdrieon,5446,5,15,7,14,54,53,1,52
Stranraer,5446,6,13,10,13,47,47,0,49
Queen's Park,5446,7,14,6,16,44,47,-3,48
Brechin,5446,8,13,8,15,52,58,-6,47
Peterhead,5446,9,13,8,15,45,60,-15,47
Stenhousem'r,5446,10,7,12,17,49,76,-27,33
Livingston,5447,1,20,6,10,81,42,39,66
Peterhead,5447,2,19,4,13,59,51,8,61
Brechin,5447,3,18,6,12,50,40,10,60
Airdrieon,5447,4,17,6,13,62,58,4,57
Alloa,5447,5,15,9,12,67,51,16,54
Albion,5447,6,14,10,12,55,50,5,52
Stranraer,5447,7,15,5,16,49,58,-9,50
East Fife,5447,8,11,8,17,50,58,-8,41
Queen's Park,5447,9,10,10,16,34,56,-22,40
Stenhousem'r,5447,10,4,10,22,38,81,-43,22
Livingston,5448,1,22,6,8,76,43,33,72
Airdrieon,5448,2,19,5,12,62,47,15,62
Alloa,5448,3,17,9,10,72,53,19,60
Brechin,5448,4,16,5,15,44,49,-5,53
Albion,5448,5,14,10,12,56,45,11,52
East Fife,5448,6,13,10,13,55,52,3,49
Peterhead,5448,7,14,7,15,54,56,-2,49
Queen's Park,5448,8,11,10,15,38,51,-13,43
Stranraer,5448,9,10,4,22,51,75,-24,34
Stenhousem'r,5448,10,7,8,21,44,81,-37,29
Alloa,5449,1,19,9,8,76,45,31,66
Livingston,5449,2,19,2,15,77,56,21,59
Albion,5449,3,17,5,14,60,50,10,56
Brechin,5449,4,16,6,14,42,49,-7,54
Stranraer,5449,5,16,5,15,59,55,4,53
Peterhead,5449,6,12,13,11,52,54,-2,49
Airdrieon,5449,7,13,8,15,49,54,-5,47
Queen's Park,5449,8,11,9,16,35,54,-19,42
East Fife,5449,9,9,11,16,49,62,-13,38
Stenhousem'r,5449,10,9,10,17,50,70,-20,37
Alloa,5450,1,19,10,7,72,44,28,67
Airdrieon,5450,2,20,6,10,81,58,23,66
Livingston,5450,3,20,3,13,84,54,30,63
Brechin,5450,4,16,8,12,53,54,-1,56
Albion,5450,5,12,10,14,60,59,1,46
Queen's Park,5450,6,12,9,15,39,57,-18,45
Stranraer,5450,7,11,9,16,51,59,-8,42
East Fife,5450,8,10,9,17,47,61,-14,39
Stenhousem'r,5450,9,10,8,18,62,88,-26,38
Peterhead,5450,10,8,12,16,40,55,-15,36
Alloa,5451,1,22,6,8,75,41,34,72
Livingston,5451,2,21,4,11,82,49,33,67
Brechin,5451,3,16,10,10,46,40,6,58
Airdrieon,5451,4,16,7,13,59,58,1,55
Albion,5451,5,14,8,14,48,46,2,50
Queen's Park,5451,6,12,10,14,35,47,-12,46
Peterhead,5451,7,10,10,16,47,59,-12,40
East Fife,5451,8,10,9,17,48,54,-6,39
Stranraer,5451,9,9,9,18,39,63,-24,36
Stenhousem'r,5451,10,7,13,16,49,71,-22,34
Livingston,5452,1,23,4,9,79,37,42,73
Alloa,5452,2,20,6,10,72,44,28,66
Airdrieon,5452,3,17,8,11,63,53,10,59
Brechin,5452,4,17,8,11,53,50,3,59
East Fife,5452,5,13,12,11,53,46,7,51
Peterhead,5452,6,14,8,14,44,55,-11,50
Queen's Park,5452,7,11,9,16,34,46,-12,42
Stranraer,5452,8,13,2,21,45,63,-18,41
Albion,5452,9,9,8,19,59,73,-14,35
Stenhousem'r,5452,10,5,11,20,45,80,-35,26
Livingston,5453,1,23,4,9,86,48,38,73
Alloa,5453,2,19,8,9,70,41,29,65
Airdrieon,5453,3,15,10,11,72,60,12,55
Brechin,5453,4,15,7,14,55,53,2,52
Peterhead,5453,5,15,6,15,54,63,-9,51
Stranraer,5453,6,16,2,18,63,69,-6,50
East Fife,5453,7,13,10,13,55,46,9,49
Albion,5453,8,13,10,13,51,52,-1,49
Queen's Park,5453,9,11,5,20,31,49,-18,38
Stenhousem'r,5453,10,6,6,24,36,92,-56,24
Livingston,5454,1,21,6,9,81,41,40,69
Brechin,5454,2,18,5,13,52,44,8,59
Airdrieon,5454,3,18,5,13,58,58,0,59
Alloa,5454,4,16,9,11,66,46,20,57
Peterhead,5454,5,13,10,13,52,56,-4,49
Queen's Park,5454,6,12,12,12,34,48,-14,48
East Fife,5454,7,13,8,15,54,51,3,47
Stranraer,5454,8,12,9,15,54,60,-6,45
Albion,5454,9,11,9,16,48,55,-7,42
Stenhousem'r,5454,10,6,7,23,40,80,-40,25
Livingston,5455,1,21,5,10,71,47,24,68
Alloa,5455,2,20,7,9,72,42,30,67
Airdrieon,5455,3,15,11,10,65,53,12,56
Albion,5455,4,15,10,11,52,43,9,55
Brechin,5455,5,16,6,14,44,50,-6,54
Peterhead,5455,6,14,11,11,54,45,9,53
Stranraer,5455,7,16,5,15,50,51,-1,53
East Fife,5455,8,12,8,16,58,54,4,44
Queen's Park,5455,9,11,5,20,30,56,-26,38
Stenhousem'r,5455,10,2,8,26,32,87,-55,14
Livingston,5456,1,19,6,11,69,43,26,63
Brechin,5456,2,19,6,11,52,43,9,63
Alloa,5456,3,18,6,12,59,41,18,60
Albion,5456,4,16,8,12,55,43,12,56
East Fife,5456,5,13,10,13,43,40,3,49
Queen's Park,5456,6,13,10,13,31,40,-9,49
Airdrieon,5456,7,12,12,12,54,57,-3,48
Peterhead,5456,8,11,10,15,43,54,-11,43
Stranraer,5456,9,11,5,20,50,62,-12,38
Stenhousem'r,5456,10,8,7,21,56,89,-33,31
Livingston,5457,1,22,8,6,72,40,32,74
Airdrieon,5457,2,19,8,9,65,54,11,65
Alloa,5457,3,15,9,12,65,48,17,54
Peterhead,5457,4,15,8,13,58,52,6,53
Albion,5457,5,13,9,14,48,53,-5,48
East Fife,5457,6,12,10,14,49,48,1,46
Stranraer,5457,7,13,7,16,53,58,-5,46
Brechin,5457,8,12,9,15,44,47,-3,45
Queen's Park,5457,9,10,9,17,35,56,-21,39
Stenhousem'r,5457,10,7,7,22,47,80,-33,28
Airdrieon,5458,1,20,7,9,65,40,25,67
Alloa,5458,2,17,9,10,72,47,25,60
Livingston,5458,3,19,2,15,71,51,20,59
Stranraer,5458,4,17,5,14,59,55,4,56
Brechin,5458,5,16,4,16,53,56,-3,52
Queen's Park,5458,6,14,7,15,41,59,-18,49
Albion,5458,7,12,11,13,48,54,-6,47
East Fife,5458,8,9,12,15,42,49,-7,39
Peterhead,5458,9,9,11,16,43,57,-14,38
Stenhousem'r,5458,10,11,4,21,54,80,-26,37
Livingston,5459,1,18,11,7,83,49,34,65
Albion,5459,2,17,9,10,53,41,12,60
Brechin,5459,3,17,7,12,56,45,11,58
Alloa,5459,4,15,12,9,62,44,18,57
Peterhead,5459,5,14,10,12,48,55,-7,52
Airdrieon,5459,6,15,6,15,64,64,0,51
East Fife,5459,7,13,7,16,54,55,-1,46
Queen's Park,5459,8,10,10,16,36,47,-11,40
Stranraer,5459,9,9,11,16,40,58,-18,38
Stenhousem'r,5459,10,5,11,20,41,79,-38,26
Brechin,5460,1,19,7,10,53,42,11,64
Livingston,5460,2,17,7,12,68,56,12,58
Alloa,5460,3,16,9,11,57,41,16,57
Peterhead,5460,4,16,7,13,53,51,2,55
Airdrieon,5460,5,15,5,16,61,63,-2,50
Albion,5460,6,14,7,15,48,50,-2,49
East Fife,5460,7,13,9,14,52,42,10,48
Stranraer,5460,8,13,7,16,48,48,0,46
Queen's Park,5460,9,13,6,17,41,51,-10,45
Stenhousem'r,5460,10,9,6,21,46,83,-37,33
Livingston,5461,1,21,6,9,79,49,30,69
Alloa,5461,2,20,8,8,77,44,33,68
Airdrieon,5461,3,17,8,11,58,49,9,59
Peterhead,5461,4,15,6,15,46,53,-7,51
Brechin,5461,5,14,8,14,59,58,1,50
Albion,5461,6,12,10,14,52,49,3,46
Stranraer,5461,7,12,8,16,54,62,-8,44
East Fife,5461,8,11,10,15,45,47,-2,43
Queen's Park,5461,9,9,11,16,33,54,-21,38
Stenhousem'r,5461,10,5,13,18,43,81,-38,28
Livingston,5462,1,22,6,8,79,47,32,72
Albion,5462,2,19,7,10,63,45,18,64
Brechin,5462,3,18,5,13,49,45,4,59
Alloa,5462,4,15,7,14,64,56,8,52
Airdrieon,5462,5,13,9,14,46,46,0,48
Queen's Park,5462,6,12,11,13,38,45,-7,47
Peterhead,5462,7,12,9,15,45,46,-1,45
Stranraer,5462,8,11,9,16,45,58,-13,42
East Fife,5462,9,10,9,17,48,55,-7,39
Stenhousem'r,5462,10,8,8,20,42,76,-34,32
Livingston,5463,1,23,3,10,80,47,33,72
Alloa,5463,2,20,8,8,68,35,33,68
Airdrieon,5463,3,17,6,13,56,50,6,57
Queen's Park,5463,4,17,3,16,44,44,0,54
Brechin,5463,5,14,6,16,50,49,1,48
Albion,5463,6,13,7,16,53,63,-10,46
Peterhead,5463,7,12,10,14,43,58,-15,46
East Fife,5463,8,10,12,14,42,46,-4,42
Stranraer,5463,9,11,5,20,43,57,-14,38
Stenhousem'r,5463,10,7,12,17,43,73,-30,33
Livingston,5464,1,22,4,10,74,47,27,70
Alloa,5464,2,20,6,10,82,47,35,66
Airdrieon,5464,3,16,11,9,61,50,11,59
Brechin,5464,4,17,8,11,51,42,9,59
Albion,5464,5,15,8,13,55,52,3,53
Queen's Park,5464,6,13,6,17,50,63,-13,45
East Fife,5464,7,11,11,14,49,48,1,44
Peterhead,5464,8,11,7,18,50,66,-16,40
Stranraer,5464,9,10,7,19,53,69,-16,37
Stenhousem'r,5464,10,7,8,21,41,82,-41,29
Livingston,5465,1,18,8,10,76,51,25,62
Brechin,5465,2,18,6,12,54,46,8,60
Alloa,5465,3,16,8,12,69,49,20,56
Airdrieon,5465,4,16,8,12,61,52,9,56
Peterhead,5465,5,15,7,14,51,50,1,52
Albion,5465,6,14,9,13,52,48,4,51
Queen's Park,5465,7,14,6,16,40,49,-9,48
Stranraer,5465,8,13,8,15,52,58,-6,47
East Fife,5465,9,9,11,16,48,56,-8,38
Stenhousem'r,5465,10,9,5,22,44,88,-44,32
Alloa,5466,1,21,8,7,73,43,30,71
Livingston,5466,2,22,2,12,76,49,27,68
Airdrieon,5466,3,18,6,12,59,49,10,60
Brechin,5466,4,16,9,11,50,46,4,57
Peterhead,5466,5,12,12,12,52,54,-2,48
Queen's Park,5466,6,14,6,16,42,53,-11,48
Albion,5466,7,13,6,17,54,61,-7,45
Stranraer,5466,8,12,6,18,46,55,-9,42
East Fife,5466,9,10,8,18,49,60,-11,38
Stenhousem'r,5466,10,6,9,21,43,74,-31,27
Livingston,5467,1,20,5,11,79,56,23,65
Airdrieon,5467,2,19,6,11,65,53,12,63
Alloa,5467,3,15,11,10,65,43,22,56
Stranraer,5467,4,16,8,12,57,59,-2,56
Brechin,5467,5,15,6,15,49,50,-1,51
Albion,5467,6,12,11,13,57,57,0,47
East Fife,5467,7,12,9,15,48,43,5,45
Peterhead,5467,8,10,12,14,49,57,-8,42
Queen's Park,5467,9,10,10,16,40,59,-19,40
Stenhousem'r,5467,10,8,8,20,48,80,-32,32
Alloa,5468,1,23,6,7,77,44,33,75
Brechin,5468,2,17,8,11,45,41,4,59
Livingston,5468,3,17,6,13,65,51,14,57
Airdrieon,5468,4,15,8,13,60,53,7,53
Queen's Park,5468,5,14,7,15,42,47,-5,49
East Fife,5468,6,13,9,14,58,52,6,48
Albion,5468,7,12,11,13,47,47,0,47
Stranraer,5468,8,13,6,17,50,58,-8,45
Peterhead,5468,9,10,7,19,41,63,-22,37
Stenhousem'r,5468,10,8,8,20,44,73,-29,32
Alloa,5469,1,17,9,10,66,42,24,60
Livingston,5469,2,17,9,10,66,47,19,60
Airdrieon,5469,3,18,6,12,61,54,7,60
Brechin,5469,4,16,7,13,47,47,0,55
Stranraer,5469,5,16,5,15,61,60,1,53
Peterhead,5469,6,15,7,14,47,46,1,52
Queen's Park,5469,7,12,11,13,41,55,-14,47
East Fife,5469,8,13,7,16,54,58,-4,46
Albion,5469,9,9,13,14,50,50,0,40
Stenhousem'r,5469,10,6,8,22,40,74,-34,26
Brechin,5470,1,23,7,6,59,34,25,76
Livingston,5470,2,18,9,9,81,49,32,63
Alloa,5470,3,16,10,10,70,51,19,58
Peterhead,5470,4,13,13,10,62,54,8,52
Albion,5470,5,14,10,12,59,51,8,52
Airdrieon,5470,6,15,7,14,59,55,4,52
Stranraer,5470,7,13,7,16,52,70,-18,46
East Fife,5470,8,9,10,17,43,54,-11,37
Queen's Park,5470,9,7,8,21,35,64,-29,29
Stenhousem'r,5470,10,6,11,19,52,90,-38,29
Airdrieon,5471,1,20,5,11,69,51,18,65
Brechin,5471,2,19,8,9,54,40,14,65
Livingston,5471,3,19,6,11,72,45,27,63
Alloa,5471,4,19,5,12,70,51,19,62
Albion,5471,5,17,7,12,54,48,6,58
East Fife,5471,6,15,5,16,57,52,5,50
Stranraer,5471,7,14,3,19,60,73,-13,45
Queen's Park,5471,8,11,8,17,38,54,-16,41
Peterhead,5471,9,8,9,19,43,57,-14,33
Stenhousem'r,5471,10,6,8,22,46,92,-46,26
Alloa,5472,1,22,7,7,75,42,33,73
Livingston,5472,2,19,8,9,73,50,23,65
Airdrieon,5472,3,17,8,11,62,56,6,59
Brechin,5472,4,15,8,13,49,49,0,53
East Fife,5472,5,15,7,14,64,45,19,52
Albion,5472,6,12,8,16,51,51,0,44
Queen's Park,5472,7,11,10,15,30,46,-16,43
Stranraer,5472,8,12,7,17,43,60,-17,43
Peterhead,5472,9,10,8,18,41,58,-17,38
Stenhousem'r,5472,10,7,9,20,48,79,-31,30
Livingston,5473,1,19,5,12,76,65,11,62
Stranraer,5473,2,17,5,14,65,59,6,56
Airdrieon,5473,3,15,11,10,59,53,6,56
Alloa,5473,4,15,10,11,69,57,12,55
Peterhead,5473,5,16,7,13,68,56,12,55
Queen's Park,5473,6,15,8,13,48,46,2,53
Albion,5473,7,14,8,14,52,48,4,50
East Fife,5473,8,10,15,11,54,47,7,45
Brechin,5473,9,13,5,18,49,65,-16,44
Stenhousem'r,5473,10,5,8,23,49,93,-44,23
Livingston,5474,1,21,6,9,77,43,34,69
Airdrieon,5474,2,19,9,8,73,48,25,66
Alloa,5474,3,17,9,10,72,50,22,60
Brechin,5474,4,15,5,16,56,63,-7,50
Peterhead,5474,5,13,7,16,48,57,-9,46
Albion,5474,6,12,9,15,46,52,-6,45
East Fife,5474,7,10,14,12,47,44,3,44
Queen's Park,5474,8,11,10,15,39,53,-14,43
Stranraer,5474,9,12,6,18,51,61,-10,42
Stenhousem'r,5474,10,9,7,20,50,88,-38,34
Livingston,5475,1,23,5,8,88,51,37,74
Alloa,5475,2,22,6,8,78,50,28,72
Airdrieon,5475,3,17,7,12,61,48,13,58
Brechin,5475,4,15,7,14,51,59,-8,52
East Fife,5475,5,15,5,16,59,49,10,50
Albion,5475,6,14,6,16,51,54,-3,48
Stranraer,5475,7,12,7,17,53,63,-10,43
Peterhead,5475,8,9,9,18,48,64,-16,36
Queen's Park,5475,9,9,9,18,36,59,-23,36
Stenhousem'r,5475,10,8,11,17,51,79,-28,35
Livingston,5476,1,25,2,9,79,48,31,77
Alloa,5476,2,19,8,9,82,50,32,65
Airdrieon,5476,3,17,4,15,62,66,-4,55
Albion,5476,4,16,5,15,61,60,1,53
Stenhousem'r,5476,5,14,5,17,59,71,-12,47
Peterhead,5476,6,12,10,14,60,62,-2,46
Brechin,5476,7,12,7,17,44,58,-14,43
Queen's Park,5476,8,11,10,15,38,52,-14,43
East Fife,5476,9,11,8,17,50,55,-5,41
Stranraer,5476,10,11,5,20,52,65,-13,38
Alloa,5477,1,21,9,6,83,40,43,72
Livingston,5477,2,20,3,13,79,55,24,63
Airdrieon,5477,3,18,7,11,70,57,13,61
Brechin,5477,4,15,7,14,52,49,3,52
Albion,5477,5,14,9,13,51,44,7,51
Stranraer,5477,6,13,9,14,45,47,-2,48
Peterhead,5477,7,11,10,15,44,58,-14,43
East Fife,5477,8,11,9,16,46,53,-7,42
Queen's Park,5477,9,10,7,19,29,52,-23,37
Stenhousem'r,5477,10,9,6,21,42,86,-44,33
Livingston,5478,1,21,4,11,76,47,29,67
Alloa,5478,2,19,8,9,79,46,33,65
Albion,5478,3,18,10,8,62,43,19,64
Brechin,5478,4,14,10,12,48,48,0,52
Peterhead,5478,5,13,13,10,48,52,-4,52
Airdrieon,5478,6,13,8,15,58,62,-4,47
Stranraer,5478,7,12,7,17,54,53,1,43
Queen's Park,5478,8,11,9,16,34,58,-24,42
East Fife,5478,9,8,11,17,49,59,-10,35
Stenhousem'r,5478,10,6,10,20,46,86,-40,28
Alloa,5479,1,21,8,7,79,41,38,71
Livingston,5479,2,19,9,8,75,45,30,66
Airdrieon,5479,3,16,7,13,55,60,-5,55
Albion,5479,4,15,9,12,53,52,1,54
Stranraer,5479,5,17,2,17,48,49,-1,53
Brechin,5479,6,14,5,17,49,48,1,47
Peterhead,5479,7,12,10,14,47,55,-8,46
East Fife,5479,8,11,11,14,47,42,5,44
Queen's Park,5479,9,10,9,17,30,51,-21,39
Stenhousem'r,5479,10,6,8,22,47,87,-40,26
Livingston,5480,1,21,7,8,84,49,35,70
Airdrieon,5480,2,20,8,8,64,47,17,68
Alloa,5480,3,19,8,9,76,46,30,65
Brechin,5480,4,17,5,14,50,49,1,56
Albion,5480,5,12,9,15,54,56,-2,45
Queen's Park,5480,6,12,9,15,43,53,-10,45
Peterhead,5480,7,12,8,16,48,60,-12,44
East Fife,5480,8,9,12,15,46,47,-1,39
Stranraer,5480,9,11,4,21,46,66,-20,37
Stenhousem'r,5480,10,9,6,21,39,77,-38,33
Livingston,5481,1,22,6,8,76,41,35,72
Alloa,5481,2,18,10,8,74,44,30,64
Brechin,5481,3,17,6,13,53,45,8,57
Albion,5481,4,15,10,11,53,50,3,55
Peterhead,5481,5,14,7,15,55,59,-4,49
Stranraer,5481,6,13,9,14,48,55,-7,48
Airdrieon,5481,7,12,10,14,47,50,-3,46
East Fife,5481,8,8,15,13,43,47,-4,39
Stenhousem'r,5481,9,8,9,19,47,74,-27,33
Queen's Park,5481,10,7,10,19,29,60,-31,31
Alloa,5482,1,18,11,7,65,38,27,65
Brechin,5482,2,18,7,11,52,45,7,61
Livingston,5482,3,18,3,15,70,56,14,57
Airdrieon,5482,4,15,8,13,54,49,5,53
Albion,5482,5,15,7,14,51,54,-3,52
Peterhead,5482,6,15,5,16,46,57,-11,50
East Fife,5482,7,12,10,14,52,49,3,46
Stranraer,5482,8,13,7,16,51,55,-4,46
Queen's Park,5482,9,13,5,18,39,58,-19,44
Stenhousem'r,5482,10,8,7,21,45,64,-19,31
Livingston,5483,1,27,4,5,86,41,45,85
Brechin,5483,2,17,8,11,54,51,3,59
Alloa,5483,3,15,11,10,67,47,20,56
Airdrieon,5483,4,16,8,12,63,52,11,56
Stranraer,5483,5,15,6,15,51,56,-5,51
Albion,5483,6,14,6,16,53,51,2,48
Queen's Park,5483,7,10,12,14,39,51,-12,42
Peterhead,5483,8,11,7,18,46,60,-14,40
East Fife,5483,9,7,11,18,45,54,-9,32
Stenhousem'r,5483,10,7,9,20,47,88,-41,30
Livingston,5484,1,21,5,10,87,60,27,68
Alloa,5484,2,18,10,8,64,44,20,64
Airdrieon,5484,3,17,8,11,59,49,10,59
Albion,5484,4,15,10,11,49,45,4,55
Brechin,5484,5,15,9,12,50,48,2,54
Peterhead,5484,6,12,10,14,51,50,1,46
Stranraer,5484,7,12,9,15,50,53,-3,45
Queen's Park,5484,8,10,8,18,38,53,-15,38
East Fife,5484,9,9,10,17,45,62,-17,37
Stenhousem'r,5484,10,8,7,21,48,77,-29,31
Livingston,5485,1,23,4,9,94,51,43,73
Alloa,5485,2,20,5,11,69,43,26,65
Peterhead,5485,3,15,11,10,55,49,6,56
Brechin,5485,4,14,9,13,47,50,-3,51
Albion,5485,5,13,11,12,59,56,3,50
East Fife,5485,6,14,7,15,55,52,3,49
Airdrieon,5485,7,13,7,16,53,58,-5,46
Queen's Park,5485,8,11,8,17,41,57,-16,41
Stranraer,5485,9,10,7,19,44,64,-20,37
Stenhousem'r,5485,10,8,9,19,38,75,-37,33
Livingston,5486,1,22,6,8,79,46,33,72
Alloa,5486,2,22,5,9,75,34,41,71
Airdrieon,5486,3,16,9,11,50,47,3,57
Albion,5486,4,14,9,13,49,44,5,51
Brechin,5486,5,15,6,15,41,48,-7,51
East Fife,5486,6,12,9,15,39,42,-3,45
Peterhead,5486,7,11,11,14,45,50,-5,44
Queen's Park,5486,8,12,7,17,33,50,-17,43
Stenhousem'r,5486,9,11,3,22,42,67,-25,36
Stranraer,5486,10,9,7,20,42,67,-25,34
Livingston,5487,1,23,3,10,86,51,35,72
Alloa,5487,2,20,6,10,88,49,39,66
Airdrieon,5487,3,17,8,11,62,57,5,59
Brechin,5487,4,14,9,13,49,44,5,51
Peterhead,5487,5,15,5,16,44,53,-9,50
East Fife,5487,6,13,9,14,56,53,3,48
Albion,5487,7,12,9,15,54,59,-5,45
Stranraer,5487,8,12,6,18,55,74,-19,42
Queen's Park,5487,9,11,5,20,34,63,-29,38
Stenhousem'r,5487,10,10,6,20,52,77,-25,36
Alloa,5488,1,21,6,9,80,47,33,69
Livingston,5488,2,21,6,9,80,49,31,69
Airdrieon,5488,3,15,9,12,62,54,8,54
Peterhead,5488,4,15,9,12,51,46,5,54
Albion,5488,5,15,7,14,56,51,5,52
Brechin,5488,6,14,8,14,49,56,-7,50
Queen's Park,5488,7,15,5,16,40,51,-11,50
East Fife,5488,8,8,12,16,50,58,-8,36
Stranraer,5488,9,10,6,20,48,72,-24,36
Stenhousem'r,5488,10,6,12,18,43,75,-32,30
Airdrieon,5489,1,19,6,11,65,55,10,63
Livingston,5489,2,18,6,12,75,49,26,60
Alloa,5489,3,15,11,10,63,39,24,56
East Fife,5489,4,15,7,14,51,42,9,52
Stranraer,5489,5,15,6,15,58,57,1,51
Brechin,5489,6,14,9,13,44,45,-1,51
Peterhead,5489,7,13,11,12,48,49,-1,50
Albion,5489,8,12,8,16,50,64,-14,44
Queen's Park,5489,9,12,7,17,38,56,-18,43
Stenhousem'r,5489,10,8,7,21,42,78,-36,31
Livingston,5490,1,21,7,8,81,56,25,70
Alloa,5490,2,20,9,7,76,46,30,69
Airdrieon,5490,3,18,6,12,68,66,2,60
Peterhead,5490,4,16,9,11,73,55,18,57
Brechin,5490,5,15,9,12,60,54,6,54
Albion,5490,6,13,8,15,56,62,-6,47
Stranraer,5490,7,12,7,17,56,62,-6,43
East Fife,5490,8,10,13,13,49,56,-7,43
Queen's Park,5490,9,12,2,22,44,66,-22,38
Stenhousem'r,5490,10,5,6,25,56,96,-40,21
Alloa,5491,1,21,7,8,75,40,35,70
Livingston,5491,2,21,4,11,75,46,29,67
Brechin,5491,3,16,7,13,56,54,2,55
Peterhead,5491,4,16,6,14,55,55,0,54
Airdrieon,5491,5,15,8,13,61,57,4,53
Stranraer,5491,6,13,4,19,51,61,-10,43
East Fife,5491,7,12,6,18,50,53,-3,42
Albion,5491,8,11,9,16,44,52,-8,42
Stenhousem'r,5491,9,11,8,17,43,70,-27,41
Queen's Park,5491,10,11,7,18,39,61,-22,40
Livingston,5492,1,23,7,6,82,44,38,76
Alloa,5492,2,19,6,11,68,44,24,63
Airdrieon,5492,3,18,8,10,60,47,13,62
Albion,5492,4,16,7,13,63,49,14,55
Queen's Park,5492,5,14,9,13,40,47,-7,51
East Fife,5492,6,14,8,14,65,55,10,50
Brechin,5492,7,14,6,16,40,53,-13,48
Stranraer,5492,8,10,7,19,49,62,-13,37
Peterhead,5492,9,9,6,21,42,68,-26,33
Stenhousem'r,5492,10,6,10,20,49,89,-40,28
Livingston,5493,1,20,7,9,84,51,33,67
Airdrieon,5493,2,18,4,14,52,54,-2,58
Alloa,5493,3,15,9,12,59,48,11,54
Albion,5493,4,16,6,14,53,49,4,54
Queen's Park,5493,5,14,8,14,41,46,-5,50
Stranraer,5493,6,13,9,14,51,55,-4,48
Brechin,5493,7,14,6,16,46,56,-10,48
Peterhead,5493,8,13,8,15,52,51,1,47
East Fife,5493,9,12,10,14,50,44,6,46
Stenhousem'r,5493,10,7,9,20,39,73,-34,30
Peterhead,5494,1,20,5,11,49,42,7,65
Livingston,5494,2,20,3,13,81,53,28,63
Brechin,5494,3,19,5,12,48,53,-5,62
Alloa,5494,4,18,4,14,66,47,19,58
Airdrieon,5494,5,16,7,13,55,44,11,55
Queen's Park,5494,6,15,4,17,43,52,-9,49
Albion,5494,7,13,6,17,49,57,-8,45
East Fife,5494,8,12,8,16,48,44,4,44
Stranraer,5494,9,11,4,21,43,63,-20,37
Stenhousem'r,5494,10,10,6,20,57,84,-27,36
Livingston,5495,1,24,5,7,76,41,35,77
Alloa,5495,2,19,9,8,71,45,26,66
Airdrieon,5495,3,20,4,12,70,55,15,64
Albion,5495,4,16,5,15,52,48,4,53
Stranraer,5495,5,15,7,14,57,50,7,52
Peterhead,5495,6,13,7,16,51,59,-8,46
Queen's Park,5495,7,12,8,16,42,51,-9,44
Brechin,5495,8,11,8,17,38,57,-19,41
East Fife,5495,9,10,9,17,40,46,-6,39
Stenhousem'r,5495,10,5,8,23,38,83,-45,23
Livingston,5496,1,21,7,8,89,48,41,70
Alloa,5496,2,20,10,6,76,42,34,70
Airdrieon,5496,3,16,7,13,56,53,3,55
Albion,5496,4,15,7,14,52,47,5,52
Brechin,5496,5,14,9,13,54,55,-1,51
Peterhead,5496,6,13,10,13,47,54,-7,49
Queen's Park,5496,7,11,12,13,39,50,-11,45
East Fife,5496,8,12,7,17,46,44,2,43
Stranraer,5496,9,9,6,21,41,69,-28,33
Stenhousem'r,5496,10,8,7,21,41,79,-38,31
Livingston,5497,1,21,4,11,67,52,15,67
Alloa,5497,2,18,8,10,71,42,29,62
East Fife,5497,3,17,8,11,48,35,13,59
Airdrieon,5497,4,17,8,11,54,47,7,59
Albion,5497,5,17,7,12,59,45,14,58
Brechin,5497,6,16,9,11,52,45,7,57
Stranraer,5497,7,11,6,19,46,65,-19,39
Peterhead,5497,8,9,10,17,29,46,-17,37
Queen's Park,5497,9,11,4,21,36,55,-19,37
Stenhousem'r,5497,10,7,8,21,47,77,-30,29
Alloa,5498,1,20,7,9,81,45,36,67
Livingston,5498,2,17,7,12,78,51,27,58
Albion,5498,3,15,10,11,58,53,5,55
Peterhead,5498,4,14,9,13,56,59,-3,51
Brechin,5498,5,15,6,15,56,61,-5,51
Airdrieon,5498,6,13,11,12,56,62,-6,50
Queen's Park,5498,7,14,6,16,45,53,-8,48
East Fife,5498,8,13,8,15,49,53,-4,47
Stranraer,5498,9,14,5,17,56,63,-7,47
Stenhousem'r,5498,10,5,11,20,43,78,-35,26
Livingston,5499,1,22,6,8,86,50,36,72
Alloa,5499,2,19,10,7,71,42,29,67
Airdrieon,5499,3,19,5,12,64,51,13,62
Brechin,5499,4,17,8,11,45,43,2,59
Peterhead,5499,5,16,9,11,68,61,7,57
Albion,5499,6,13,9,14,60,51,9,48
Stranraer,5499,7,12,6,18,49,66,-17,42
Queen's Park,5499,8,9,10,17,32,52,-20,37
East Fife,5499,9,8,9,19,43,57,-14,33
Stenhousem'r,5499,10,5,8,23,37,82,-45,23
Livingston,5500,1,25,3,8,86,40,46,78
Alloa,5500,2,18,10,8,66,46,20,64
Airdrieon,5500,3,18,7,11,58,51,7,61
Brechin,5500,4,16,6,14,50,56,-6,54
Peterhead,5500,5,13,7,16,49,53,-4,46
East Fife,5500,6,12,9,15,47,47,0,45
Albion,5500,7,11,10,15,42,55,-13,43
Queen's Park,5500,8,11,9,16,39,51,-12,42
Stenhousem'r,5500,9,9,9,18,46,72,-26,36
Stranraer,5500,10,9,6,21,50,62,-12,33
Livingston,5501,1,22,5,9,80,42,38,71
Albion,5501,2,18,8,10,57,46,11,62
Brechin,5501,3,18,5,13,58,50,8,59
Airdrieon,5501,4,17,6,13,67,57,10,57
Alloa,5501,5,15,9,12,62,53,9,54
Peterhead,5501,6,12,10,14,53,54,-1,46
East Fife,5501,7,12,7,17,49,51,-2,43
Stranraer,5501,8,12,5,19,36,53,-17,41
Stenhousem'r,5501,9,10,7,19,48,82,-34,37
Queen's Park,5501,10,10,6,20,36,58,-22,36
Brechin,5502,1,18,7,11,52,42,10,61
Alloa,5502,2,17,8,11,65,48,17,59
Livingston,5502,3,16,7,13,73,61,12,55
Airdrieon,5502,4,16,6,14,59,64,-5,54
Queen's Park,5502,5,15,8,13,48,50,-2,53
Albion,5502,6,14,9,13,61,55,6,51
Stranraer,5502,7,14,6,16,55,55,0,48
Stenhousem'r,5502,8,11,9,16,52,73,-21,42
East Fife,5502,9,10,10,16,50,57,-7,40
Peterhead,5502,10,12,4,20,51,61,-10,40
Livingston,5503,1,21,9,6,79,44,35,72
Alloa,5503,2,18,8,10,67,47,20,62
Albion,5503,3,16,6,14,54,49,5,54
Airdrieon,5503,4,15,9,12,49,48,1,54
Peterhead,5503,5,14,8,14,54,49,5,50
East Fife,5503,6,12,10,14,53,49,4,46
Brechin,5503,7,14,4,18,51,61,-10,46
Queen's Park,5503,8,12,9,15,35,49,-14,45
Stranraer,5503,9,13,3,20,45,59,-14,42
Stenhousem'r,5503,10,9,6,21,49,81,-32,33
Alloa,5504,1,19,10,7,81,45,36,67
Brechin,5504,2,20,4,12,64,51,13,64
Livingston,5504,3,17,7,12,74,53,21,58
Airdrieon,5504,4,16,7,13,58,66,-8,55
Albion,5504,5,15,9,12,60,53,7,54
Peterhead,5504,6,13,9,14,56,58,-2,48
East Fife,5504,7,12,9,15,52,47,5,45
Queen's Park,5504,8,13,6,17,45,65,-20,45
Stranraer,5504,9,11,7,18,53,65,-12,40
Stenhousem'r,5504,10,7,6,23,46,86,-40,27
Brechin,5505,1,23,4,9,65,43,22,73
Alloa,5505,2,21,4,11,77,47,30,67
Livingston,5505,3,19,8,9,80,57,23,65
Airdrieon,5505,4,18,5,13,60,50,10,59
Albion,5505,5,14,9,13,54,53,1,51
Peterhead,5505,6,13,9,14,42,55,-13,48
East Fife,5505,7,11,7,18,46,51,-5,40
Stranraer,5505,8,11,6,19,46,55,-9,39
Queen's Park,5505,9,11,6,19,40,61,-21,39
Stenhousem'r,5505,10,6,8,22,37,75,-38,26
Livingston,5506,1,22,8,6,73,36,37,74
Alloa,5506,2,22,7,7,86,40,46,73
Airdrieon,5506,3,22,6,8,68,51,17,72
Brechin,5506,4,19,4,13,49,42,7,61
Peterhead,5506,5,12,9,15,40,51,-11,45
Albion,5506,6,11,9,16,48,55,-7,42
East Fife,5506,7,9,11,16,51,50,1,38
Stranraer,5506,8,11,2,23,47,65,-18,35
Queen's Park,5506,9,7,12,17,23,53,-30,33
Stenhousem'r,5506,10,7,8,21,42,84,-42,29
Livingston,5507,1,23,3,10,81,47,34,72
Alloa,5507,2,19,8,9,72,44,28,65
Albion,5507,3,18,9,9,61,43,18,63
Airdrieon,5507,4,17,6,13,59,59,0,57
Brechin,5507,5,14,7,15,51,54,-3,49
Peterhead,5507,6,14,6,16,52,58,-6,48
Queen's Park,5507,7,12,8,16,40,57,-17,44
Stranraer,5507,8,12,3,21,53,60,-7,39
East Fife,5507,9,9,10,17,41,55,-14,37
Stenhousem'r,5507,10,9,6,21,47,80,-33,33
Livingston,5508,1,19,8,9,69,47,22,65
Alloa,5508,2,18,8,10,74,49,25,62
Brechin,5508,3,18,6,12,45,49,-4,60
Airdrieon,5508,4,15,9,12,53,50,3,54
Queen's Park,5508,5,15,8,13,40,41,-1,53
Peterhead,5508,6,12,10,14,54,57,-3,46
Albion,5508,7,12,8,16,56,56,0,44
Stranraer,5508,8,11,9,16,56,57,-1,42
East Fife,5508,9,9,11,16,46,56,-10,38
Stenhousem'r,5508,10,6,13,17,51,82,-31,31
Alloa,5509,1,19,7,10,70,47,23,64
Queen's Park,5509,2,16,8,12,43,43,0,56
Airdrieon,5509,3,16,6,14,48,50,-2,54
Livingston,5509,4,16,5,15,66,56,10,53
Peterhead,5509,5,15,7,14,53,52,1,52
Albion,5509,6,15,7,14,56,58,-2,52
Brechin,5509,7,14,9,13,46,48,-2,51
Stranraer,5509,8,14,4,18,60,61,-1,46
East Fife,5509,9,11,8,17,54,56,-2,41
Stenhousem'r,5509,10,8,11,17,51,76,-25,35
Livingston,5510,1,22,6,8,82,46,36,72
Alloa,5510,2,18,10,8,78,50,28,64
Brechin,5510,3,15,7,14,44,42,2,52
Airdrieon,5510,4,14,10,12,55,56,-1,52
Queen's Park,5510,5,16,3,17,43,49,-6,51
Peterhead,5510,6,13,10,13,47,51,-4,49
Stranraer,5510,7,14,4,18,49,62,-13,46
Albion,5510,8,13,6,17,48,58,-10,45
East Fife,5510,9,8,12,16,42,50,-8,36
Stenhousem'r,5510,10,9,8,19,54,78,-24,35
Livingston,5511,1,23,1,12,72,48,24,70
Brechin,5511,2,21,5,10,58,46,12,68
Alloa,5511,3,20,7,9,78,43,35,67
Airdrieon,5511,4,17,5,14,54,47,7,56
Queen's Park,5511,5,13,8,15,36,47,-11,47
Stranraer,5511,6,13,6,17,51,61,-10,45
East Fife,5511,7,11,11,14,54,53,1,44
Peterhead,5511,8,11,9,16,49,63,-14,42
Albion,5511,9,11,6,19,52,59,-7,39
Stenhousem'r,5511,10,6,10,20,46,83,-37,28
Alloa,5512,1,19,10,7,69,36,33,67
Livingston,5512,2,19,6,11,80,49,31,63
Brechin,5512,3,14,9,13,41,40,1,51
Stranraer,5512,4,13,10,13,56,54,2,49
Albion,5512,5,14,6,16,52,56,-4,48
Peterhead,5512,6,13,9,14,50,57,-7,48
Airdrieon,5512,7,13,9,14,46,53,-7,48
Stenhousem'r,5512,8,13,5,18,44,75,-31,44
East Fife,5512,9,11,9,16,51,49,2,42
Queen's Park,5512,10,10,9,17,27,47,-20,39
Alloa,5513,1,21,6,9,78,46,32,69
Livingston,5513,2,19,4,13,67,48,19,61
Airdrieon,5513,3,17,6,13,51,50,1,57
Brechin,5513,4,16,8,12,61,51,10,56
Peterhead,5513,5,15,5,16,48,50,-2,50
East Fife,5513,6,13,8,15,53,54,-1,47
Albion,5513,7,11,13,12,45,54,-9,46
Stranraer,5513,8,13,5,18,49,58,-9,44
Queen's Park,5513,9,11,10,15,37,46,-9,43
Stenhousem'r,5513,10,6,11,19,46,78,-32,29
Livingston,5514,1,25,4,7,83,39,44,79
Alloa,5514,2,18,8,10,77,49,28,62
Airdrieon,5514,3,18,8,10,61,44,17,62
Brechin,5514,4,17,5,14,58,50,8,56
Albion,5514,5,16,7,13,56,53,3,55
Peterhead,5514,6,14,8,14,55,52,3,50
Queen's Park,5514,7,12,10,14,39,45,-6,46
Stranraer,5514,8,11,5,20,49,70,-21,38
East Fife,5514,9,9,8,19,45,58,-13,35
Stenhousem'r,5514,10,6,5,25,39,102,-63,23
Peterhead,5515,1,18,7,11,58,45,13,61
Airdrieon,5515,2,18,7,11,62,54,8,61
Livingston,5515,3,16,7,13,68,52,16,55
Alloa,5515,4,16,6,14,60,52,8,54
Stranraer,5515,5,15,6,15,61,63,-2,51
Albion,5515,6,14,9,13,56,58,-2,51
Brechin,5515,7,15,6,15,52,55,-3,51
Queen's Park,5515,8,14,5,17,38,46,-8,47
East Fife,5515,9,12,8,16,50,54,-4,44
Stenhousem'r,5515,10,7,9,20,42,68,-26,30
Livingston,5516,1,22,4,10,77,47,30,70
Brechin,5516,2,19,9,8,65,42,23,66
Alloa,5516,3,16,10,10,66,46,20,58
Airdrieon,5516,4,16,6,14,56,52,4,54
Peterhead,5516,5,14,7,15,54,58,-4,49
Albion,5516,6,11,13,12,48,51,-3,46
Queen's Park,5516,7,13,7,16,39,50,-11,46
Stranraer,5516,8,13,3,20,55,66,-11,42
East Fife,5516,9,9,11,16,46,53,-7,38
Stenhousem'r,5516,10,8,8,20,45,86,-41,32
Alloa,5517,1,23,5,8,83,41,42,74
Livingston,5517,2,21,8,7,86,50,36,71
Airdrieon,5517,3,19,4,13,61,54,7,61
Albion,5517,4,15,8,13,60,53,7,53
Brechin,5517,5,15,6,15,44,50,-6,51
East Fife,5517,6,13,6,17,52,58,-6,45
Queen's Park,5517,7,12,6,18,38,61,-23,42
Stranraer,5517,8,12,4,20,58,70,-12,40
Peterhead,5517,9,10,7,19,46,60,-14,37
Stenhousem'r,5517,10,10,6,20,52,83,-31,36
Brechin,5518,1,19,6,11,55,42,13,63
Livingston,5518,2,19,4,13,79,50,29,61
Airdrieon,5518,3,19,4,13,69,57,12,61
Alloa,5518,4,16,9,11,67,55,12,57
Stranraer,5518,5,17,6,13,66,60,6,57
Peterhead,5518,6,15,8,13,54,50,4,53
Queen's Park,5518,7,13,5,18,37,56,-19,44
Albion,5518,8,11,8,17,47,62,-15,41
Stenhousem'r,5518,9,10,6,20,48,84,-36,36
East Fife,5518,10,7,12,17,47,53,-6,33
Alloa,5519,1,20,10,6,69,33,36,70
Albion,5519,2,17,11,8,56,41,15,62
Airdrieon,5519,3,17,9,10,59,48,11,60
Peterhead,5519,4,18,6,12,61,52,9,60
Livingston,5519,5,18,3,15,73,53,20,57
Brechin,5519,6,13,9,14,52,52,0,48
Queen's Park,5519,7,12,7,17,37,55,-18,43
Stranraer,5519,8,10,8,18,52,62,-10,38
East Fife,5519,9,9,9,18,43,58,-15,36
Stenhousem'r,5519,10,6,8,22,39,87,-48,26
Alloa,5520,1,22,7,7,79,44,35,73
Livingston,5520,2,21,3,12,68,54,14,66
Airdrieon,5520,3,18,8,10,67,49,18,62
Albion,5520,4,16,9,11,60,49,11,57
Brechin,5520,5,15,6,15,47,49,-2,51
Peterhead,5520,6,12,10,14,43,44,-1,46
Stranraer,5520,7,14,3,19,56,59,-3,45
Queen's Park,5520,8,11,8,17,38,56,-18,41
East Fife,5520,9,9,12,15,43,55,-12,39
Stenhousem'r,5520,10,5,8,23,39,81,-42,23
Livingston,5521,1,20,8,8,76,48,28,68
Alloa,5521,2,19,7,10,73,41,32,64
Airdrieon,5521,3,17,8,11,56,51,5,59
Albion,5521,4,15,10,11,53,49,4,55
Stranraer,5521,5,14,7,15,60,58,2,49
Brechin,5521,6,13,8,15,49,54,-5,47
Queen's Park,5521,7,12,9,15,41,54,-13,45
Peterhead,5521,8,11,10,15,48,55,-7,43
East Fife,5521,9,8,11,17,48,60,-12,35
Stenhousem'r,5521,10,9,6,21,50,84,-34,33
Livingston,5522,1,22,5,9,80,46,34,71
Alloa,5522,2,21,7,8,77,45,32,70
Brechin,5522,3,17,4,15,54,51,3,55
Stranraer,5522,4,16,3,17,47,51,-4,51
East Fife,5522,5,14,8,14,61,50,11,50
Albion,5522,6,12,11,13,49,53,-4,47
Queen's Park,5522,7,12,9,15,36,47,-11,45
Airdrieon,5522,8,12,7,17,44,61,-17,43
Peterhead,5522,9,11,8,17,47,54,-7,41
Stenhousem'r,5522,10,8,8,20,49,86,-37,32
Livingston,5523,1,22,3,11,80,46,34,69
Airdrieon,5523,2,16,9,11,59,55,4,57
Alloa,5523,3,16,7,13,72,56,16,55
Peterhead,5523,4,14,13,9,54,47,7,55
Stranraer,5523,5,16,6,14,60,54,6,54
Albion,5523,6,14,8,14,51,53,-2,50
East Fife,5523,7,12,9,15,45,45,0,45
Brechin,5523,8,13,5,18,45,58,-13,44
Queen's Park,5523,9,11,5,20,32,58,-26,38
Stenhousem'r,5523,10,9,9,18,49,75,-26,36
Alloa,5524,1,21,7,8,89,44,45,70
Livingston,5524,2,19,5,12,75,53,22,62
Brechin,5524,3,16,8,12,55,50,5,56
Airdrieon,5524,4,13,12,11,60,55,5,51
Queen's Park,5524,5,15,6,15,44,46,-2,51
Albion,5524,6,15,5,16,57,60,-3,50
Stranraer,5524,7,14,7,15,59,65,-6,49
Peterhead,5524,8,12,9,15,45,62,-17,45
East Fife,5524,9,11,8,17,52,62,-10,41
Stenhousem'r,5524,10,6,9,21,46,85,-39,27
Livingston,5525,1,20,7,9,81,51,30,67
Airdrieon,5525,2,18,6,12,60,51,9,60
Peterhead,5525,3,18,6,12,52,49,3,60
Alloa,5525,4,17,8,11,59,44,15,59
Albion,5525,5,14,9,13,61,51,10,51
East Fife,5525,6,15,5,16,59,59,0,50
Brechin,5525,7,14,6,16,42,47,-5,48
Queen's Park,5525,8,13,9,14,43,49,-6,48
Stranraer,5525,9,11,5,20,51,63,-12,38
Stenhousem'r,5525,10,6,7,23,41,85,-44,25
Livingston,5526,1,26,1,9,76,45,31,79
Airdrieon,5526,2,17,6,13,60,50,10,57
Alloa,5526,3,16,7,13,59,44,15,55
Brechin,5526,4,16,6,14,46,46,0,54
Albion,5526,5,15,8,13,53,45,8,53
Stranraer,5526,6,16,4,16,56,52,4,52
Peterhead,5526,7,15,6,15,49,52,-3,51
East Fife,5526,8,11,7,18,43,55,-12,40
Queen's Park,5526,9,11,6,19,28,53,-25,39
Stenhousem'r,5526,10,9,5,22,50,78,-28,32
Alloa,5527,1,21,6,9,74,49,25,69
Livingston,5527,2,20,6,10,75,46,29,66
Airdrieon,5527,3,19,3,14,67,62,5,60
East Fife,5527,4,15,6,15,54,43,11,51
Brechin,5527,5,15,5,16,56,57,-1,50
Stranraer,5527,6,14,7,15,58,60,-2,49
Albion,5527,7,14,6,16,54,56,-2,48
Queen's Park,5527,8,13,8,15,39,51,-12,47
Peterhead,5527,9,10,8,18,44,61,-17,38
Stenhousem'r,5527,10,8,7,21,46,82,-36,31
Livingston,5528,1,22,4,10,70,43,27,70
Alloa,5528,2,18,7,11,66,46,20,61
Airdrieon,5528,3,19,3,14,63,56,7,60
Peterhead,5528,4,17,9,10,55,48,7,60
Albion,5528,5,17,6,13,53,45,8,57
Brechin,5528,6,15,3,18,44,51,-7,48
Stranraer,5528,7,13,6,17,47,59,-12,45
Queen's Park,5528,8,10,7,19,28,48,-20,37
Stenhousem'r,5528,9,10,6,20,43,68,-25,36
East Fife,5528,10,8,11,17,50,55,-5,35
Livingston,5529,1,22,7,7,75,37,38,73
Alloa,5529,2,20,4,12,68,44,24,64
Airdrieon,5529,3,19,5,12,69,57,12,62
Albion,5529,4,15,8,13,52,49,3,53
East Fife,5529,5,15,6,15,56,52,4,51
Brechin,5529,6,16,3,17,47,47,0,51
Stranraer,5529,7,13,5,18,55,62,-7,44
Queen's Park,5529,8,13,5,18,40,51,-11,44
Peterhead,5529,9,12,5,19,38,58,-20,41
Stenhousem'r,5529,10,8,6,22,44,87,-43,30
Livingston,5530,1,20,6,10,74,53,21,66
Alloa,5530,2,19,6,11,67,46,21,63
Brechin,5530,3,19,4,13,51,42,9,61
Airdrieon,5530,4,17,8,11,63,51,12,59
Albion,5530,5,18,5,13,62,50,12,59
Queen's Park,5530,6,13,10,13,41,47,-6,49
Stranraer,5530,7,14,3,19,48,57,-9,45
Peterhead,5530,8,11,10,15,44,53,-9,43
East Fife,5530,9,10,6,20,50,61,-11,36
Stenhousem'r,5530,10,6,8,22,48,88,-40,26
Alloa,5531,1,20,9,7,72,41,31,69
Airdrieon,5531,2,18,7,11,56,56,0,61
Livingston,5531,3,18,6,12,63,45,18,60
Brechin,5531,4,17,5,14,45,43,2,56
Stranraer,5531,5,14,8,14,60,58,2,50
Peterhead,5531,6,15,5,16,50,58,-8,50
Albion,5531,7,13,9,14,64,52,12,48
East Fife,5531,8,11,9,16,46,51,-5,42
Queen's Park,5531,9,13,3,20,37,51,-14,42
Stenhousem'r,5531,10,7,7,22,41,79,-38,28
Livingston,5532,1,21,9,6,83,40,43,72
Alloa,5532,2,19,8,9,68,42,26,65
Airdrieon,5532,3,18,6,12,59,58,1,60
Albion,5532,4,16,8,12,56,52,4,56
East Fife,5532,5,15,7,14,51,38,13,52
Brechin,5532,6,14,3,19,54,54,0,45
Queen's Park,5532,7,12,8,16,39,52,-13,44
Stranraer,5532,8,13,4,19,51,69,-18,43
Peterhead,5532,9,11,8,17,40,56,-16,41
Stenhousem'r,5532,10,6,9,21,47,87,-40,27
Livingston,5533,1,22,5,9,78,48,30,71
Alloa,5533,2,20,8,8,63,39,24,68
Airdrieon,5533,3,16,6,14,57,56,1,54
Albion,5533,4,13,10,13,48,43,5,49
Peterhead,5533,5,14,7,15,45,49,-4,49
Queen's Park,5533,6,14,6,16,37,44,-7,48
Brechin,5533,7,14,5,17,47,50,-3,47
Stenhousem'r,5533,8,11,9,16,52,74,-22,42
East Fife,5533,9,8,13,15,41,45,-4,37
Stranraer,5533,10,10,7,19,37,57,-20,37
Livingston,5534,1,20,3,13,82,50,32,63
Airdrieon,5534,2,17,7,12,61,54,7,58
Alloa,5534,3,15,9,12,62,46,16,54
Brechin,5534,4,15,9,12,60,51,9,54
Peterhead,5534,5,15,9,12,52,46,6,54
East Fife,5534,6,15,8,13,59,49,10,53
Stenhousem'r,5534,7,12,8,16,51,80,-29,44
Albion,5534,8,12,7,17,58,72,-14,43
Queen's Park,5534,9,10,11,15,40,55,-15,41
Stranraer,5534,10,10,7,19,47,69,-22,37
Airdrieon,5535,1,22,7,7,66,49,17,73
Alloa,5535,2,18,7,11,66,49,17,61
Livingston,5535,3,19,2,15,70,48,22,59
Brechin,5535,4,16,7,13,56,54,2,55
East Fife,5535,5,15,9,12,61,47,14,54
Albion,5535,6,13,8,15,53,59,-6,47
Peterhead,5535,7,14,5,17,49,59,-10,47
Queen's Park,5535,8,13,6,17,41,53,-12,45
Stenhousem'r,5535,9,9,8,19,51,72,-21,35
Stranraer,5535,10,8,7,21,41,64,-23,31
Livingston,5536,1,21,8,7,75,38,37,71
Airdrieon,5536,2,20,5,11,63,59,4,65
Stranraer,5536,3,15,7,14,52,52,0,52
Brechin,5536,4,15,7,14,49,54,-5,52
Alloa,5536,5,15,6,15,67,51,16,51
Albion,5536,6,13,9,14,61,59,2,48
Queen's Park,5536,7,12,9,15,42,56,-14,45
East Fife,5536,8,11,8,17,45,49,-4,41
Peterhead,5536,9,10,10,16,52,62,-10,40
Stenhousem'r,5536,10,7,13,16,51,77,-26,34
Livingston,5537,1,21,6,9,79,48,31,69
Alloa,5537,2,18,9,9,66,40,26,63
East Fife,5537,3,19,5,12,68,40,28,62
Airdrieon,5537,4,18,5,13,64,60,4,59
Brechin,5537,5,15,5,16,43,46,-3,50
Peterhead,5537,6,13,8,15,49,58,-9,47
Queen's Park,5537,7,14,5,17,39,48,-9,47
Albion,5537,8,12,9,15,59,62,-3,45
Stranraer,5537,9,13,5,18,49,69,-20,44
Stenhousem'r,5537,10,6,5,25,46,91,-45,23
Livingston,5538,1,20,5,11,74,49,25,65
Alloa,5538,2,18,10,8,67,41,26,64
Airdrieon,5538,3,17,7,12,57,54,3,58
Brechin,5538,4,17,6,13,49,45,4,57
Peterhead,5538,5,15,6,15,53,49,4,51
Albion,5538,6,12,10,14,49,54,-5,46
Queen's Park,5538,7,11,11,14,32,41,-9,44
East Fife,5538,8,11,8,17,46,49,-3,41
Stenhousem'r,5538,9,11,5,20,51,74,-23,38
Stranraer,5538,10,9,10,17,44,66,-22,37
Alloa,5539,1,22,7,7,80,43,37,73
Brechin,5539,2,19,4,13,53,44,9,61
Albion,5539,3,17,6,13,53,41,12,57
East Fife,5539,4,16,7,13,57,42,15,55
Livingston,5539,5,14,8,14,67,59,8,50
Airdrieon,5539,6,13,10,13,68,65,3,49
Queen's Park,5539,7,14,7,15,32,45,-13,49
Peterhead,5539,8,12,7,17,49,70,-21,43
Stranraer,5539,9,11,9,16,51,58,-7,42
Stenhousem'r,5539,10,5,9,22,44,87,-43,24
Livingston,5540,1,22,7,7,87,46,41,73
Alloa,5540,2,17,7,12,70,47,23,58
Peterhead,5540,3,17,7,12,59,46,13,58
Airdrieon,5540,4,17,6,13,54,61,-7,57
Brechin,5540,5,16,5,15,58,53,5,53
Queen's Park,5540,6,14,8,14,40,54,-14,50
East Fife,5540,7,12,7,17,44,53,-9,43
Albion,5540,8,12,5,19,41,54,-13,41
Stranraer,5540,9,11,7,18,49,62,-13,40
Stenhousem'r,5540,10,8,9,19,46,72,-26,33
Livingston,5541,1,23,5,8,74,34,40,74
Alloa,5541,2,21,4,11,73,42,31,67
Brechin,5541,3,18,3,15,44,48,-4,57
Airdrieon,5541,4,16,5,15,54,51,3,53
Albion,5541,5,14,10,12,50,49,1,52
Peterhead,5541,6,12,11,13,39,43,-4,47
Stenhousem'r,5541,7,13,8,15,50,65,-15,47
Queen's Park,5541,8,11,6,19,33,51,-18,39
Stranraer,5541,9,10,6,20,38,56,-18,36
East Fife,5541,10,8,10,18,40,56,-16,34
Livingston,5542,1,23,5,8,83,45,38,74
Alloa,5542,2,19,6,11,76,46,30,63
Airdrieon,5542,3,18,7,11,63,56,7,61
Peterhead,5542,4,13,11,12,53,59,-6,50
Brechin,5542,5,14,7,15,51,51,0,49
Queen's Park,5542,6,13,9,14,36,49,-13,48
Albion,5542,7,13,8,15,49,58,-9,47
Stranraer,5542,8,13,6,17,53,57,-4,45
East Fife,5542,9,10,10,16,48,51,-3,40
Stenhousem'r,5542,10,6,7,23,37,77,-40,25
Livingston,5543,1,23,6,7,84,50,34,75
Airdrieon,5543,2,19,8,9,67,53,14,65
Brechin,5543,3,16,6,14,55,55,0,54
Alloa,5543,4,13,11,12,60,57,3,50
Albion,5543,5,14,7,15,53,54,-1,49
Peterhead,5543,6,12,11,13,50,48,2,47
Stranraer,5543,7,14,5,17,50,61,-11,47
East Fife,5543,8,12,8,16,56,46,10,44
Queen's Park,5543,9,11,6,19,34,56,-22,39
Stenhousem'r,5543,10,7,10,19,44,73,-29,31
Livingston,5544,1,21,6,9,73,47,26,69
Brechin,5544,2,21,4,11,57,41,16,67
Alloa,5544,3,19,7,10,66,43,23,64
Airdrieon,5544,4,18,9,9,60,47,13,63
East Fife,5544,5,13,8,15,52,48,4,47
Stranraer,5544,6,13,7,16,50,53,-3,46
Albion,5544,7,11,7,18,46,59,-13,40
Queen's Park,5544,8,11,7,18,39,55,-16,40
Peterhead,5544,9,10,9,17,49,62,-13,39
Stenhousem'r,5544,10,7,8,21,48,85,-37,29
Livingston,5545,1,21,3,12,80,52,28,66
Airdrieon,5545,2,18,7,11,56,51,5,61
Alloa,5545,3,15,11,10,65,43,22,56
Peterhead,5545,4,15,10,11,53,53,0,55
Queen's Park,5545,5,14,12,10,44,42,2,54
Brechin,5545,6,16,5,15,47,44,3,53
Stranraer,5545,7,15,3,18,55,63,-8,48
Albion,5545,8,10,8,18,47,63,-16,38
Stenhousem'r,5545,9,8,10,18,45,70,-25,34
East Fife,5545,10,6,15,15,48,59,-11,33
Livingston,5546,1,19,7,10,79,49,30,64
Alloa,5546,2,18,10,8,72,45,27,64
Brechin,5546,3,18,8,10,56,44,12,62
Airdrieon,5546,4,16,7,13,60,63,-3,55
Albion,5546,5,14,10,12,64,62,2,52
East Fife,5546,6,14,8,14,55,47,8,50
Peterhead,5546,7,12,9,15,63,67,-4,45
Stranraer,5546,8,12,7,17,56,64,-8,43
Queen's Park,5546,9,9,6,21,35,66,-31,33
Stenhousem'r,5546,10,7,10,19,49,82,-33,31
Livingston,5547,1,21,5,10,72,43,29,68
Airdrieon,5547,2,18,9,9,61,52,9,63
Alloa,5547,3,16,10,10,67,45,22,58
Brechin,5547,4,16,6,14,47,49,-2,54
Queen's Park,5547,5,15,8,13,50,44,6,53
Albion,5547,6,16,5,15,58,58,0,53
Peterhead,5547,7,12,9,15,49,54,-5,45
Stranraer,5547,8,11,8,17,50,61,-11,41
East Fife,5547,9,10,8,18,50,64,-14,38
Stenhousem'r,5547,10,6,10,20,44,78,-34,28
Livingston,5548,1,25,3,8,83,36,47,78
Airdrieon,5548,2,19,6,11,64,55,9,63
Brechin,5548,3,19,2,15,47,50,-3,59
Alloa,5548,4,15,11,10,64,48,16,56
East Fife,5548,5,14,8,14,52,49,3,50
Peterhead,5548,6,13,9,14,53,51,2,48
Stranraer,5548,7,13,9,14,59,65,-6,48
Albion,5548,8,11,8,17,45,55,-10,41
Queen's Park,5548,9,9,7,20,30,55,-25,34
Stenhousem'r,5548,10,8,5,23,49,82,-33,29
Livingston,5549,1,23,3,10,77,50,27,72
Alloa,5549,2,20,5,11,69,46,23,65
Airdrieon,5549,3,19,4,13,64,61,3,61
Peterhead,5549,4,15,6,15,45,55,-10,51
East Fife,5549,5,13,10,13,62,48,14,49
Brechin,5549,6,14,7,15,54,55,-1,49
Albion,5549,7,13,6,17,51,55,-4,45
Stranraer,5549,8,11,7,18,50,54,-4,40
Stenhousem'r,5549,9,11,6,19,55,79,-24,39
Queen's Park,5549,10,10,8,18,35,59,-24,38
Livingston,5550,1,19,7,10,83,52,31,64
Alloa,5550,2,18,10,8,66,40,26,64
Albion,5550,3,17,8,11,67,48,19,59
Airdrieon,5550,4,17,4,15,63,60,3,55
Brechin,5550,5,16,5,15,50,51,-1,53
Stranraer,5550,6,16,5,15,49,51,-2,53
East Fife,5550,7,13,6,17,46,47,-1,45
Queen's Park,5550,8,13,6,17,38,54,-16,45
Peterhead,5550,9,13,4,19,49,69,-20,43
Stenhousem'r,5550,10,6,9,21,36,75,-39,27
Brechin,5551,1,24,2,10,64,44,20,74
Alloa,5551,2,20,9,7,68,35,33,69
Livingston,5551,3,21,3,12,79,49,30,66
Airdrieon,5551,4,16,7,13,60,55,5,55
Peterhead,5551,5,15,6,15,48,57,-9,51
East Fife,5551,6,12,8,16,51,48,3,44
Albion,5551,7,12,6,18,51,61,-10,42
Stranraer,5551,8,11,7,18,45,56,-11,40
Queen's Park,5551,9,10,9,17,29,49,-20,39
Stenhousem'r,5551,10,7,7,22,35,76,-41,28
Alloa,5552,1,20,7,9,75,41,34,67
Brechin,5552,2,18,8,10,57,52,5,62
Queen's Park,5552,3,18,4,14,48,49,-1,58
Airdrieon,5552,4,16,7,13,48,52,-4,55
Livingston,5552,5,16,3,17,66,56,10,51
Stranraer,5552,6,14,6,16,55,59,-4,48
Albion,5552,7,13,9,14,57,62,-5,48
East Fife,5552,8,12,10,14,48,44,4,46
Peterhead,5552,9,12,9,15,51,50,1,45
Stenhousem'r,5552,10,5,9,22,39,79,-40,24
Alloa,5553,1,21,7,8,84,47,37,70
Livingston,5553,2,19,7,10,69,42,27,64
Airdrieon,5553,3,20,4,12,63,51,12,64
Peterhead,5553,4,16,7,13,54,51,3,55
Albion,5553,5,13,8,15,50,59,-9,47
East Fife,5553,6,11,12,13,55,53,2,45
Brechin,5553,7,13,5,18,43,48,-5,44
Stranraer,5553,8,11,8,17,44,58,-14,41
Queen's Park,5553,9,10,7,19,34,57,-23,37
Stenhousem'r,5553,10,9,9,18,41,71,-30,36
Alloa,5554,1,24,4,8,71,40,31,76
Livingston,5554,2,22,5,9,75,38,37,71
Brechin,5554,3,16,9,11,52,48,4,57
Queen's Park,5554,4,15,6,15,43,50,-7,51
East Fife,5554,5,13,8,15,55,45,10,47
Airdrieon,5554,6,13,6,17,49,58,-9,45
Peterhead,5554,7,12,9,15,44,57,-13,45
Stranraer,5554,8,13,4,19,44,55,-11,43
Albion,5554,9,10,10,16,58,66,-8,40
Stenhousem'r,5554,10,8,7,21,56,90,-34,31
Alloa,5555,1,19,6,11,73,47,26,63
Livingston,5555,2,18,6,12,74,51,23,60
Airdrieon,5555,3,18,4,14,58,54,4,58
East Fife,5555,4,14,8,14,56,54,2,50
Brechin,5555,5,15,5,16,47,55,-8,50
Albion,5555,6,13,8,15,56,52,4,47
Peterhead,5555,7,12,11,13,47,50,-3,47
Stenhousem'r,5555,8,13,6,17,56,72,-16,45
Queen's Park,5555,9,11,10,15,42,54,-12,43
Stranraer,5555,10,12,6,18,47,67,-20,42
Livingston,5556,1,20,7,9,83,51,32,67
Alloa,5556,2,18,7,11,68,53,15,61
Brechin,5556,3,16,13,7,48,37,11,61
Airdrieon,5556,4,15,9,12,55,56,-1,54
Albion,5556,5,13,13,10,51,46,5,52
East Fife,5556,6,12,10,14,51,47,4,46
Queen's Park,5556,7,11,10,15,42,57,-15,43
Peterhead,5556,8,10,11,15,57,60,-3,41
Stranraer,5556,9,10,8,18,45,57,-12,38
Stenhousem'r,5556,10,7,8,21,41,77,-36,29
Alloa,5557,1,20,7,9,73,47,26,67
Albion,5557,2,18,9,9,54,36,18,63
Livingston,5557,3,18,6,12,76,53,23,60
Stranraer,5557,4,17,6,13,62,52,10,57
Airdrieon,5557,5,14,10,12,61,60,1,52
Queen's Park,5557,6,14,9,13,42,47,-5,51
Brechin,5557,7,14,9,13,55,63,-8,51
Peterhead,5557,8,13,9,14,49,50,-1,48
East Fife,5557,9,6,11,19,49,61,-12,29
Stenhousem'r,5557,10,5,6,25,37,89,-52,21
Alloa,5558,1,19,7,10,66,36,30,64
Livingston,5558,2,19,5,12,65,47,18,62
Albion,5558,3,18,6,12,56,45,11,60
Brechin,5558,4,19,3,14,46,42,4,60
Airdrieon,5558,5,17,7,12,66,56,10,58
Queen's Park,5558,6,13,10,13,46,50,-4,49
Peterhead,5558,7,13,10,13,45,50,-5,49
East Fife,5558,8,11,8,17,47,51,-4,41
Stenhousem'r,5558,9,6,13,17,42,73,-31,31
Stranraer,5558,10,7,7,22,36,65,-29,28
Alloa,5559,1,21,6,9,73,40,33,69
Livingston,5559,2,20,4,12,75,51,24,64
Brechin,5559,3,17,6,13,55,57,-2,57
Peterhead,5559,4,15,10,11,50,49,1,55
Airdrieon,5559,5,14,7,15,52,55,-3,49
Albion,5559,6,12,10,14,49,49,0,46
Queen's Park,5559,7,11,11,14,39,48,-9,44
East Fife,5559,8,10,12,14,53,51,2,42
Stranraer,5559,9,11,7,18,50,68,-18,40
Stenhousem'r,5559,10,8,9,19,50,78,-28,33
Alloa,5560,1,22,6,8,77,40,37,72
Livingston,5560,2,21,5,10,82,43,39,68
Airdrieon,5560,3,19,7,10,62,53,9,64
Albion,5560,4,15,8,13,45,44,1,53
Stranraer,5560,5,16,4,16,58,61,-3,52
Peterhead,5560,6,14,7,15,51,57,-6,49
Brechin,5560,7,12,6,18,49,62,-13,42
East Fife,5560,8,10,9,17,48,50,-2,39
Queen's Park,5560,9,11,6,19,43,63,-20,39
Stenhousem'r,5560,10,8,6,22,44,86,-42,30
Livingston,5561,1,22,4,10,78,46,32,70
Alloa,5561,2,19,11,6,77,41,36,68
Airdrieon,5561,3,17,8,11,56,51,5,59
Albion,5561,4,15,9,12,55,55,0,54
Queen's Park,5561,5,15,9,12,40,40,0,54
East Fife,5561,6,14,10,12,57,43,14,52
Stranraer,5561,7,12,7,17,47,59,-12,43
Brechin,5561,8,13,3,20,45,66,-21,42
Peterhead,5561,9,7,10,19,36,59,-23,31
Stenhousem'r,5561,10,7,7,22,44,75,-31,28
Alloa,5562,1,22,5,9,79,38,41,71
Livingston,5562,2,18,8,10,80,54,26,62
Brechin,5562,3,19,5,12,51,45,6,62
Airdrieon,5562,4,18,5,13,61,56,5,59
Stranraer,5562,5,17,4,15,49,48,1,55
Albion,5562,6,14,8,14,57,57,0,50
Peterhead,5562,7,12,6,18,47,67,-20,42
Queen's Park,5562,8,11,7,18,38,58,-20,40
East Fife,5562,9,9,10,17,43,50,-7,37
Stenhousem'r,5562,10,7,8,21,50,82,-32,29
Livingston,5563,1,24,5,7,87,48,39,77
Peterhead,5563,2,19,6,11,54,37,17,63
Airdrieon,5563,3,17,7,12,57,52,5,58
Albion,5563,4,15,11,10,69,56,13,56
Alloa,5563,5,16,6,14,65,56,9,54
Brechin,5563,6,15,8,13,49,53,-4,53
East Fife,5563,7,12,9,15,43,47,-4,45
Queen's Park,5563,8,10,8,18,37,52,-15,38
Stenhousem'r,5563,9,7,8,21,42,79,-37,29
Stranraer,5563,10,6,10,20,42,65,-23,28
Livingston,5564,1,23,1,12,84,58,26,70
Alloa,5564,2,16,10,10,67,46,21,58
Peterhead,5564,3,15,11,10,54,46,8,56
Brechin,5564,4,16,6,14,47,42,5,54
Albion,5564,5,14,9,13,53,49,4,51
East Fife,5564,6,14,8,14,54,47,7,50
Airdrieon,5564,7,14,6,16,48,56,-8,48
Queen's Park,5564,8,13,9,14,36,52,-16,48
Stranraer,5564,9,13,2,21,55,69,-14,41
Stenhousem'r,5564,10,7,8,21,46,79,-33,29
Brechin,5565,1,24,3,9,62,46,16,75
Livingston,5565,2,22,6,8,85,50,35,72
Alloa,5565,3,18,9,9,70,43,27,63
Airdrieon,5565,4,18,6,12,57,55,2,60
Albion,5565,5,12,14,10,52,44,8,50
Peterhead,5565,6,15,5,16,49,50,-1,50
Stranraer,5565,7,11,8,17,50,64,-14,41
Queen's Park,5565,8,10,6,20,28,54,-26,36
East Fife,5565,9,7,8,21,43,54,-11,29
Stenhousem'r,5565,10,6,9,21,44,80,-36,27
Alloa,5566,1,21,7,8,76,40,36,70
Livingston,5566,2,22,4,10,74,43,31,70
Airdrieon,5566,3,15,9,12,60,52,8,54
East Fife,5566,4,14,10,12,65,48,17,52
Brechin,5566,5,14,9,13,55,60,-5,51
Albion,5566,6,15,5,16,48,51,-3,50
Queen's Park,5566,7,13,6,17,44,61,-17,45
Stranraer,5566,8,12,6,18,56,64,-8,42
Peterhead,5566,9,10,9,17,47,63,-16,39
Stenhousem'r,5566,10,7,9,20,39,82,-43,30
Livingston,5567,1,23,5,8,80,45,35,74
Airdrieon,5567,2,19,7,10,64,56,8,64
Brechin,5567,3,17,9,10,47,36,11,60
Alloa,5567,4,16,10,10,69,47,22,58
Peterhead,5567,5,15,7,14,48,50,-2,52
Albion,5567,6,13,8,15,54,59,-5,47
Stranraer,5567,7,14,3,19,53,58,-5,45
Queen's Park,5567,8,9,12,15,36,50,-14,39
East Fife,5567,9,9,9,18,47,55,-8,36
Stenhousem'r,5567,10,6,8,22,37,79,-42,26
Livingston,5568,1,23,6,7,77,42,35,75
Alloa,5568,2,20,8,8,77,46,31,68
Airdrieon,5568,3,15,6,15,55,68,-13,51
Albion,5568,4,14,8,14,57,45,12,50
Brechin,5568,5,15,5,16,46,52,-6,50
Peterhead,5568,6,13,8,15,43,49,-6,47
Stranraer,5568,7,12,9,15,54,60,-6,45
East Fife,5568,8,11,8,17,51,57,-6,41
Stenhousem'r,5568,9,11,7,18,51,77,-26,40
Queen's Park,5568,10,10,7,19,34,49,-15,37
Livingston,5569,1,23,5,8,83,43,40,74
Alloa,5569,2,20,11,5,67,36,31,71
Airdrieon,5569,3,16,10,10,61,51,10,58
Albion,5569,4,16,8,12,59,47,12,56
Brechin,5569,5,15,6,15,37,41,-4,51
Queen's Park,5569,6,11,10,15,36,54,-18,43
Peterhead,5569,7,10,12,14,46,48,-2,42
East Fife,5569,8,12,6,18,41,47,-6,42
Stranraer,5569,9,9,8,19,42,60,-18,35
Stenhousem'r,5569,10,7,6,23,44,89,-45,27
Livingston,5570,1,20,8,8,71,42,29,68
Airdrieon,5570,2,18,7,11,57,52,5,61
Peterhead,5570,3,15,7,14,55,56,-1,52
Alloa,5570,4,13,11,12,61,54,7,50
Brechin,5570,5,15,5,16,51,47,4,50
East Fife,5570,6,13,9,14,52,45,7,48
Queen's Park,5570,7,13,9,14,42,48,-6,48
Albion,5570,8,12,9,15,46,54,-8,45
Stranraer,5570,9,11,8,17,49,63,-14,41
Stenhousem'r,5570,10,9,9,18,46,69,-23,36
Alloa,5571,1,20,6,10,61,40,21,66
Airdrieon,5571,2,20,6,10,68,53,15,66
Albion,5571,3,19,6,11,58,44,14,63
Livingston,5571,4,18,8,10,73,48,25,62
East Fife,5571,5,14,8,14,54,41,13,50
Stranraer,5571,6,12,9,15,56,61,-5,45
Brechin,5571,7,12,7,17,39,60,-21,43
Queen's Park,5571,8,11,8,17,40,52,-12,41
Peterhead,5571,9,7,15,14,37,53,-16,36
Stenhousem'r,5571,10,8,5,23,38,72,-34,29
Livingston,5572,1,21,5,10,79,42,37,68
Alloa,5572,2,17,10,9,70,53,17,61
Brechin,5572,3,17,8,11,58,43,15,59
Airdrieon,5572,4,15,9,12,56,61,-5,54
Peterhead,5572,5,16,4,16,53,60,-7,52
East Fife,5572,6,12,10,14,46,44,2,46
Albion,5572,7,12,10,14,47,54,-7,46
Queen's Park,5572,8,10,10,16,36,50,-14,40
Stranraer,5572,9,11,6,19,55,68,-13,39
Stenhousem'r,5572,10,8,10,18,51,76,-25,34
Brechin,5573,1,19,7,10,54,41,13,64
Livingston,5573,2,19,3,14,62,45,17,60
Alloa,5573,3,16,11,9,63,37,26,59
Airdrieon,5573,4,17,7,12,54,54,0,58
Peterhead,5573,5,15,8,13,47,53,-6,53
East Fife,5573,6,13,8,15,51,51,0,47
Albion,5573,7,12,8,16,52,55,-3,44
Stranraer,5573,8,12,8,16,49,57,-8,44
Queen's Park,5573,9,10,8,18,37,49,-12,38
Stenhousem'r,5573,10,9,8,19,40,67,-27,35
Livingston,5574,1,21,5,10,73,40,33,68
Alloa,5574,2,16,12,8,65,43,22,60
Airdrieon,5574,3,17,9,10,65,59,6,60
Peterhead,5574,4,14,11,11,57,51,6,53
Brechin,5574,5,14,7,15,48,57,-9,49
Albion,5574,6,13,9,14,51,46,5,48
Stranraer,5574,7,13,6,17,53,64,-11,45
East Fife,5574,8,11,11,14,51,49,2,44
Queen's Park,5574,9,12,8,16,37,50,-13,44
Stenhousem'r,5574,10,6,8,22,43,84,-41,26
Brechin,5575,1,20,7,9,58,47,11,67
Livingston,5575,2,19,6,11,73,46,27,63
Alloa,5575,3,17,9,10,72,55,17,60
Airdrieon,5575,4,16,9,11,61,64,-3,57
Queen's Park,5575,5,15,7,14,49,48,1,52
East Fife,5575,6,13,6,17,48,49,-1,45
Peterhead,5575,7,13,6,17,51,60,-9,45
Albion,5575,8,11,11,14,54,53,1,44
Stenhousem'r,5575,9,10,8,18,54,81,-27,38
Stranraer,5575,10,9,5,22,45,62,-17,32
Livingston,5576,1,21,6,9,72,42,30,69
Brechin,5576,2,19,5,12,59,49,10,62
Alloa,5576,3,18,7,11,79,46,33,61
Peterhead,5576,4,16,6,14,51,52,-1,54
East Fife,5576,5,15,7,14,62,49,13,52
Airdrieon,5576,6,15,6,15,49,54,-5,51
Albion,5576,7,13,10,13,52,51,1,49
Stranraer,5576,8,14,6,16,51,65,-14,48
Queen's Park,5576,9,13,3,20,39,63,-24,42
Stenhousem'r,5576,10,5,6,25,38,81,-43,21
Alloa,5577,1,20,9,7,72,46,26,69
Livingston,5577,1,21,6,9,72,46,26,69
Airdrieon,5577,3,19,8,9,62,49,13,65
Albion,5577,4,13,9,14,56,43,13,48
Brechin,5577,5,14,6,16,44,49,-5,48
Queen's Park,5577,6,14,6,16,48,55,-7,48
Peterhead,5577,7,12,9,15,49,61,-12,45
Stranraer,5577,8,11,8,17,51,63,-12,41
Stenhousem'r,5577,9,9,7,20,53,82,-29,34
East Fife,5577,10,7,12,17,41,54,-13,33
Livingston,5578,1,19,9,8,78,51,27,66
Brechin,5578,2,19,5,12,46,38,8,62
Alloa,5578,3,16,9,11,78,45,33,57
Airdrieon,5578,4,16,9,11,66,60,6,57
Albion,5578,5,16,5,15,56,49,7,53
Peterhead,5578,6,13,11,12,42,52,-10,50
East Fife,5578,7,13,9,14,45,44,1,48
Stranraer,5578,8,11,7,18,52,63,-11,40
Queen's Park,5578,9,10,7,19,42,62,-20,37
Stenhousem'r,5578,10,9,5,22,36,77,-41,32
Alloa,5579,1,21,9,6,75,40,35,72
Livingston,5579,2,20,6,10,77,47,30,66
Brechin,5579,3,18,6,12,54,47,7,60
Airdrieon,5579,4,17,8,11,59,55,4,59
Peterhead,5579,5,13,9,14,52,58,-6,48
Albion,5579,6,12,11,13,47,54,-7,47
Stranraer,5579,7,13,4,19,53,60,-7,43
Queen's Park,5579,8,12,6,18,44,57,-13,42
East Fife,5579,9,10,6,20,50,66,-16,36
Stenhousem'r,5579,10,8,7,21,48,75,-27,31
Alloa,5580,1,22,5,9,76,40,36,71
Airdrieon,5580,2,20,6,10,59,50,9,66
Livingston,5580,3,18,6,12,73,53,20,60
Albion,5580,4,16,7,13,52,45,7,55
Brechin,5580,5,16,4,16,49,51,-2,52
Queen's Park,5580,6,13,8,15,37,51,-14,47
East Fife,5580,7,13,7,16,44,44,0,46
Stranraer,5580,8,13,4,19,49,60,-11,43
Peterhead,5580,9,11,7,18,39,50,-11,40
Stenhousem'r,5580,10,8,6,22,39,73,-34,30
Livingston,5581,1,22,5,9,90,56,34,71
Brechin,5581,2,20,6,10,55,43,12,66
Peterhead,5581,3,18,7,11,56,41,15,61
Airdrieon,5581,4,17,6,13,64,51,13,57
Alloa,5581,5,14,10,12,65,56,9,52
Albion,5581,6,14,8,14,47,45,2,50
East Fife,5581,7,11,9,16,52,61,-9,42
Stranraer,5581,8,11,5,20,40,63,-23,38
Queen's Park,5581,9,9,10,17,32,51,-19,37
Stenhousem'r,5581,10,7,8,21,47,81,-34,29
Livingston,5582,1,22,3,11,89,55,34,69
Brechin,5582,2,17,8,11,59,56,3,59
Airdrieon,5582,3,16,8,12,62,57,5,56
Alloa,5582,4,14,9,13,68,52,16,51
Queen's Park,5582,5,14,9,13,47,51,-4,51
East Fife,5582,6,13,9,14,54,51,3,48
Albion,5582,7,14,6,16,49,63,-14,48
Peterhead,5582,8,13,8,15,53,60,-7,47
Stranraer,5582,9,13,6,17,54,59,-5,45
Stenhousem'r,5582,10,8,6,22,45,76,-31,30
Alloa,5583,1,19,10,7,75,48,27,67
Livingston,5583,2,20,6,10,78,47,31,66
Airdrieon,5583,3,19,4,13,57,52,5,61
Peterhead,5583,4,15,8,13,55,50,5,53
Albion,5583,5,14,8,14,54,58,-4,50
Brechin,5583,6,13,10,13,45,56,-11,49
Queen's Park,5583,7,12,10,14,41,51,-10,46
Stranraer,5583,8,11,6,19,46,59,-13,39
East Fife,5583,9,9,11,16,52,56,-4,38
Stenhousem'r,5583,10,7,9,20,50,76,-26,30
Livingston,5584,1,21,3,12,77,49,28,66
Alloa,5584,2,18,11,7,77,46,31,65
Airdrieon,5584,3,14,9,13,48,47,1,51
Peterhead,5584,4,14,9,13,48,50,-2,51
Albion,5584,5,13,10,13,50,51,-1,49
Brechin,5584,6,14,7,15,46,47,-1,49
Stranraer,5584,7,14,5,17,48,60,-12,47
East Fife,5584,8,11,12,13,46,47,-1,45
Queen's Park,5584,9,12,7,17,36,50,-14,43
Stenhousem'r,5584,10,8,9,19,44,73,-29,33
Livingston,5585,1,23,5,8,88,45,43,74
Alloa,5585,2,19,6,11,70,44,26,63
Airdrieon,5585,3,18,5,13,57,52,5,59
Brechin,5585,4,17,5,14,56,51,5,56
Peterhead,5585,5,15,5,16,54,53,1,50
East Fife,5585,6,14,7,15,54,46,8,49
Albion,5585,7,14,6,16,53,52,1,48
Queen's Park,5585,8,13,6,17,43,60,-17,45
Stranraer,5585,9,12,4,20,42,66,-24,40
Stenhousem'r,5585,10,8,5,23,41,89,-48,29
Alloa,5586,1,20,10,6,66,43,23,70
Livingston,5586,2,20,4,12,61,40,21,64
Airdrieon,5586,3,17,7,12,56,42,14,58
Brechin,5586,4,16,10,10,50,42,8,58
Albion,5586,5,13,9,14,56,56,0,48
Peterhead,5586,6,13,8,15,51,61,-10,47
Stranraer,5586,7,12,7,17,53,59,-6,43
East Fife,5586,8,12,4,20,46,50,-4,40
Queen's Park,5586,9,10,9,17,38,53,-15,39
Stenhousem'r,5586,10,9,8,19,47,78,-31,35
Livingston,5587,1,22,3,11,78,44,34,69
Alloa,5587,2,19,7,10,74,48,26,64
Airdrieon,5587,3,17,6,13,63,56,7,57
Albion,5587,4,15,10,11,51,49,2,55
Peterhead,5587,5,14,10,12,50,46,4,52
Brechin,5587,6,15,5,16,55,57,-2,50
Stranraer,5587,7,14,4,18,48,56,-8,46
Queen's Park,5587,8,14,4,18,41,54,-13,46
East Fife,5587,9,10,10,16,45,57,-12,40
Stenhousem'r,5587,10,5,11,20,41,79,-38,26
Alloa,5588,1,21,7,8,74,40,34,70
Livingston,5588,2,20,5,11,73,54,19,65
Brechin,5588,3,16,10,10,51,39,12,58
Peterhead,5588,4,15,7,14,59,54,5,52
Airdrieon,5588,5,15,6,15,57,63,-6,51
Albion,5588,6,12,11,13,52,51,1,47
Stranraer,5588,7,13,6,17,57,65,-8,45
Stenhousem'r,5588,8,10,10,16,55,81,-26,40
East Fife,5588,9,8,14,14,50,58,-8,38
Queen's Park,5588,10,8,8,20,29,52,-23,32
Livingston,5589,1,21,4,11,80,47,33,67
Alloa,5589,2,20,6,10,76,49,27,66
Airdrieon,5589,3,18,5,13,67,64,3,59
Peterhead,5589,4,16,6,14,49,46,3,54
Brechin,5589,5,15,7,14,45,49,-4,52
Albion,5589,6,14,8,14,50,49,1,50
Queen's Park,5589,7,14,6,16,33,43,-10,48
East Fife,5589,8,11,9,16,46,49,-3,42
Stranraer,5589,9,10,6,20,52,71,-19,36
Stenhousem'r,5589,10,8,9,19,50,81,-31,33
Livingston,5590,1,21,5,10,69,40,29,68
Alloa,5590,2,18,10,8,73,46,27,64
Brechin,5590,3,18,6,12,60,51,9,60
Peterhead,5590,4,17,8,11,60,52,8,59
Albion,5590,5,15,5,16,50,55,-5,50
Airdrieon,5590,6,13,9,14,63,69,-6,48
Stranraer,5590,7,12,7,17,59,62,-3,43
East Fife,5590,8,10,10,16,45,48,-3,40
Queen's Park,5590,9,9,10,17,30,59,-29,37
Stenhousem'r,5590,10,7,10,19,51,78,-27,31
Alloa,5591,1,22,5,9,71,42,29,71
Livingston,5591,2,22,3,11,67,44,23,69
Airdrieon,5591,3,19,6,11,64,55,9,63
Brechin,5591,4,18,6,12,49,41,8,60
Peterhead,5591,5,15,5,16,54,62,-8,50
East Fife,5591,6,13,8,15,53,51,2,47
Queen's Park,5591,7,14,5,17,50,55,-5,47
Stranraer,5591,8,12,6,18,48,57,-9,42
Albion,5591,9,10,8,18,49,54,-5,38
Stenhousem'r,5591,10,5,8,23,52,96,-44,23
Livingston,5592,1,23,5,8,94,42,52,74
Airdrieon,5592,2,23,5,8,71,44,27,74
Alloa,5592,3,20,5,11,76,53,23,65
Brechin,5592,4,15,3,18,55,56,-1,48
East Fife,5592,5,12,10,14,59,63,-4,46
Albion,5592,6,13,7,16,52,66,-14,46
Stranraer,5592,7,13,6,17,54,61,-7,45
Peterhead,5592,8,12,8,16,36,46,-10,44
Queen's Park,5592,9,9,7,20,33,58,-25,34
Stenhousem'r,5592,10,8,8,20,44,85,-41,32
Livingston,5593,1,23,5,8,77,42,35,74
Alloa,5593,2,19,5,12,62,42,20,62
Airdrieon,5593,3,18,7,11,65,51,14,61
Brechin,5593,4,17,9,10,50,42,8,60
Peterhead,5593,5,16,8,12,49,45,4,56
Albion,5593,6,12,8,16,44,51,-7,44
Stranraer,5593,7,13,3,20,44,61,-17,42
East Fife,5593,8,9,11,16,44,46,-2,38
Queen's Park,5593,9,10,5,21,33,54,-21,35
Stenhousem'r,5593,10,9,7,20,45,79,-34,34
Livingston,5594,1,22,5,9,80,45,35,71
Alloa,5594,2,18,10,8,55,37,18,64
Brechin,5594,3,17,6,13,51,47,4,57
Albion,5594,4,15,9,12,55,41,14,54
Stranraer,5594,5,15,6,15,48,47,1,51
Airdrieon,5594,6,15,4,17,50,51,-1,49
Peterhead,5594,7,13,9,14,48,52,-4,48
Queen's Park,5594,8,12,7,17,32,47,-15,43
East Fife,5594,9,9,10,17,47,61,-14,37
Stenhousem'r,5594,10,8,6,22,41,79,-38,30
Livingston,5595,1,24,3,9,76,41,35,75
Alloa,5595,2,20,8,8,76,45,31,68
Brechin,5595,3,15,6,15,48,54,-6,51
Stranraer,5595,4,14,7,15,57,55,2,49
Albion,5595,5,12,13,11,49,51,-2,49
Airdrieon,5595,6,13,9,14,54,59,-5,48
Peterhead,5595,7,14,5,17,54,50,4,47
Queen's Park,5595,8,13,6,17,39,58,-19,45
East Fife,5595,9,7,15,14,39,47,-8,36
Stenhousem'r,5595,10,7,10,19,42,74,-32,31
Airdrieon,5596,1,19,7,10,68,53,15,64
Alloa,5596,2,17,9,10,74,44,30,60
Albion,5596,3,16,9,11,57,45,12,57
Livingston,5596,4,17,5,14,70,60,10,56
Peterhead,5596,5,14,11,11,41,42,-1,53
East Fife,5596,6,13,13,10,51,40,11,52
Queen's Park,5596,7,14,7,15,36,46,-10,49
Brechin,5596,8,14,6,16,37,45,-8,48
Stranraer,5596,9,11,7,18,44,59,-15,40
Stenhousem'r,5596,10,3,10,23,36,80,-44,19
Alloa,5597,1,20,7,9,75,48,27,67
Airdrieon,5597,2,20,7,9,65,48,17,67
Livingston,5597,3,20,5,11,73,50,23,65
Brechin,5597,4,14,10,12,47,44,3,52
Peterhead,5597,5,14,9,13,55,55,0,51
Albion,5597,6,13,12,11,59,61,-2,51
Queen's Park,5597,7,12,7,17,39,52,-13,43
Stranraer,5597,8,10,7,19,45,59,-14,37
East Fife,5597,9,10,6,20,45,51,-6,36
Stenhousem'r,5597,10,9,6,21,46,81,-35,33
Alloa,5598,1,23,6,7,79,36,43,75
Livingston,5598,2,20,4,12,73,52,21,64
Airdrieon,5598,3,16,7,13,54,48,6,55
Brechin,5598,4,14,8,14,48,51,-3,50
Peterhead,5598,5,13,8,15,48,53,-5,47
Stranraer,5598,6,13,8,15,53,61,-8,47
Queen's Park,5598,7,13,8,15,40,51,-11,47
East Fife,5598,8,11,9,16,46,47,-1,42
Albion,5598,9,11,9,16,51,62,-11,42
Stenhousem'r,5598,10,8,9,19,44,75,-31,33
Airdrieon,5599,1,21,4,11,68,51,17,67
Alloa,5599,2,18,9,9,78,45,33,63
Livingston,5599,3,18,2,16,70,53,17,56
Peterhead,5599,4,15,9,12,50,48,2,54
Brechin,5599,5,16,5,15,46,50,-4,53
East Fife,5599,6,14,10,12,57,41,16,52
Albion,5599,7,15,7,14,53,56,-3,52
Queen's Park,5599,8,15,5,16,41,47,-6,50
Stranraer,5599,9,11,5,20,45,67,-22,38
Stenhousem'r,5599,10,6,6,24,48,98,-50,24
Livingston,5600,1,19,8,9,73,50,23,65
Alloa,5600,2,19,7,10,84,43,41,64
Brechin,5600,3,18,6,12,54,48,6,60
Albion,5600,4,14,9,13,58,56,2,51
Airdrieon,5600,5,14,9,13,54,56,-2,51
Peterhead,5600,6,11,13,12,53,55,-2,46
Stranraer,5600,7,12,9,15,46,59,-13,45
Queen's Park,5600,8,10,10,16,36,53,-17,40
East Fife,5600,9,8,13,15,41,45,-4,37
Stenhousem'r,5600,10,10,6,20,49,83,-34,36
Livingston,5601,1,20,5,11,76,43,33,65
Alloa,5601,2,19,6,11,65,46,19,63
Brechin,5601,3,19,5,12,67,46,21,62
Peterhead,5601,4,15,10,11,47,47,0,55
Airdrieon,5601,5,15,9,12,63,65,-2,54
Albion,5601,6,15,6,15,49,56,-7,51
Stranraer,5601,7,13,7,16,55,55,0,46
Queen's Park,5601,8,12,8,16,29,47,-18,44
East Fife,5601,9,12,6,18,52,54,-2,42
Stenhousem'r,5601,10,4,10,22,38,82,-44,22
Alloa,5602,1,20,8,8,79,49,30,68
Livingston,5602,2,18,7,11,69,49,20,61
Albion,5602,3,15,11,10,62,55,7,56
East Fife,5602,4,15,10,11,54,46,8,55
Airdrieon,5602,5,15,9,12,55,62,-7,54
Brechin,5602,6,14,7,15,45,49,-4,49
Peterhead,5602,7,13,7,16,56,55,1,46
Queen's Park,5602,8,13,7,16,43,47,-4,46
Stranraer,5602,9,12,8,16,48,54,-6,44
Stenhousem'r,5602,10,3,10,23,43,88,-45,19
Livingston,5603,1,25,4,7,82,37,45,79
Alloa,5603,2,20,7,9,79,46,33,67
Airdrieon,5603,3,18,5,13,59,50,9,59
East Fife,5603,4,12,10,14,53,56,-3,46
Brechin,5603,5,13,7,16,45,59,-14,46
Peterhead,5603,6,12,9,15,55,59,-4,45
Albion,5603,7,12,9,15,58,66,-8,45
Queen's Park,5603,8,13,5,18,46,51,-5,44
Stranraer,5603,9,13,5,18,55,63,-8,44
Stenhousem'r,5603,10,7,9,20,50,95,-45,30
Alloa,5604,1,22,7,7,85,40,45,73
Livingston,5604,2,20,6,10,71,54,17,66
Airdrieon,5604,3,16,9,11,57,55,2,57
Peterhead,5604,4,16,8,12,58,45,13,56
Albion,5604,5,16,8,12,55,52,3,56
Brechin,5604,6,15,8,13,51,55,-4,53
Queen's Park,5604,7,10,10,16,32,50,-18,40
East Fife,5604,8,7,12,17,46,54,-8,33
Stranraer,5604,9,8,8,20,38,59,-21,32
Stenhousem'r,5604,10,8,8,20,47,76,-29,32
Brechin,5605,1,20,7,9,51,35,16,67
Livingston,5605,2,21,2,13,78,46,32,65
Alloa,5605,3,19,8,9,68,43,25,65
Peterhead,5605,4,17,7,12,55,49,6,58
Airdrieon,5605,5,15,9,12,58,53,5,54
East Fife,5605,6,13,10,13,54,47,7,49
Albion,5605,7,15,4,17,56,59,-3,49
Stenhousem'r,5605,8,8,11,17,37,81,-44,35
Stranraer,5605,9,9,6,21,50,66,-16,33
Queen's Park,5605,10,8,6,22,22,50,-28,30
Livingston,5606,1,25,1,10,83,45,38,76
Alloa,5606,2,21,6,9,73,48,25,69
Peterhead,5606,3,17,5,14,49,44,5,56
Albion,5606,4,16,5,15,53,54,-1,53
Brechin,5606,5,15,6,15,49,55,-6,51
Queen's Park,5606,6,15,4,17,33,40,-7,49
Stranraer,5606,7,14,5,17,49,56,-7,47
Airdrieon,5606,8,13,7,16,59,63,-4,46
East Fife,5606,9,12,6,18,45,47,-2,42
Stenhousem'r,5606,10,7,5,24,40,81,-41,26
Livingston,5607,1,22,3,11,80,50,30,69
Alloa,5607,2,20,7,9,71,45,26,67
Airdrieon,5607,3,16,8,12,62,58,4,56
Peterhead,5607,4,14,10,12,51,51,0,52
Brechin,5607,5,14,6,16,45,48,-3,48
East Fife,5607,6,12,11,13,57,54,3,47
Queen's Park,5607,7,14,5,17,41,48,-7,47
Albion,5607,8,12,9,15,44,50,-6,45
Stranraer,5607,9,13,5,18,49,66,-17,44
Stenhousem'r,5607,10,7,8,21,45,75,-30,29
Alloa,5608,1,20,8,8,65,39,26,68
Livingston,5608,2,20,5,11,76,51,25,65
Brechin,5608,3,15,10,11,53,43,10,55
Peterhead,5608,4,16,5,15,61,56,5,53
East Fife,5608,5,13,11,12,55,47,8,50
Albion,5608,6,14,7,15,49,55,-6,49
Airdrieon,5608,7,14,7,15,51,59,-8,49
Queen's Park,5608,8,12,9,15,35,46,-11,45
Stranraer,5608,9,10,8,18,54,67,-13,38
Stenhousem'r,5608,10,5,12,19,44,80,-36,27
Livingston,5609,1,22,4,10,84,52,32,70
Alloa,5609,2,18,9,9,70,42,28,63
Airdrieon,5609,3,16,9,11,63,56,7,57
Albion,5609,4,16,8,12,61,54,7,56
Brechin,5609,5,15,9,12,49,47,2,54
East Fife,5609,6,13,13,10,54,41,13,52
Stranraer,5609,7,12,9,15,54,58,-4,45
Queen's Park,5609,8,13,6,17,32,49,-17,45
Peterhead,5609,9,10,7,19,42,54,-12,37
Stenhousem'r,5609,10,6,4,26,35,91,-56,22
Alloa,5610,1,19,8,9,80,51,29,65
Livingston,5610,2,18,7,11,71,58,13,61
Brechin,5610,3,18,6,12,57,47,10,60
Airdrieon,5610,4,17,9,10,61,52,9,60
Albion,5610,5,15,9,12,59,52,7,54
Peterhead,5610,6,13,8,15,60,60,0,47
Stranraer,5610,7,14,4,18,50,63,-13,46
Queen's Park,5610,8,9,11,16,35,52,-17,38
East Fife,5610,9,8,11,17,48,57,-9,35
Stenhousem'r,5610,10,9,7,20,45,74,-29,34
Livingston,5611,1,21,8,7,72,41,31,71
Alloa,5611,2,20,6,10,74,50,24,66
Peterhead,5611,3,16,8,12,47,42,5,56
Albion,5611,4,16,7,13,54,49,5,55
Airdrieon,5611,5,16,7,13,55,56,-1,55
Brechin,5611,6,15,8,13,45,50,-5,53
Stenhousem'r,5611,7,11,7,18,52,68,-16,40
Queen's Park,5611,8,10,9,17,38,58,-20,39
Stranraer,5611,9,9,7,20,42,58,-16,34
East Fife,5611,10,8,9,19,45,52,-7,33
Livingston,5612,1,25,3,8,86,44,42,78
Alloa,5612,2,20,9,7,64,37,27,69
Brechin,5612,3,17,5,14,42,38,4,56
Airdrieon,5612,4,15,9,12,59,58,1,54
Albion,5612,5,14,8,14,49,47,2,50
Queen's Park,5612,6,13,9,14,36,43,-7,48
Stranraer,5612,7,12,6,18,46,59,-13,42
Peterhead,5612,8,12,6,18,42,56,-14,42
East Fife,5612,9,9,10,17,48,56,-8,37
Stenhousem'r,5612,10,7,7,22,43,77,-34,28
Livingston,5613,1,21,7,8,84,45,39,70
Alloa,5613,2,21,4,11,74,52,22,67
Airdrieon,5613,3,21,4,11,65,53,12,67
Brechin,5613,4,17,6,13,48,43,5,57
Queen's Park,5613,5,15,8,13,39,44,-5,53
Albion,5613,6,14,8,14,54,45,9,50
Stranraer,5613,7,13,7,16,53,66,-13,46
East Fife,5613,8,10,8,18,49,60,-11,38
Peterhead,5613,9,8,6,22,33,60,-27,30
Stenhousem'r,5613,10,7,8,21,46,77,-31,29
Airdrieon,5614,1,22,3,11,58,48,10,69
Livingston,5614,2,20,5,11,80,52,28,65
Brechin,5614,3,17,5,14,54,45,9,56
Peterhead,5614,4,16,6,14,57,51,6,54
Alloa,5614,5,14,11,11,66,50,16,53
Queen's Park,5614,6,14,9,13,48,47,1,51
Stranraer,5614,7,13,7,16,52,62,-10,46
East Fife,5614,8,12,9,15,49,52,-3,45
Albion,5614,9,10,8,18,47,59,-12,38
Stenhousem'r,5614,10,7,7,22,41,86,-45,28
Livingston,5615,1,21,5,10,82,48,34,68
Airdrieon,5615,2,18,7,11,72,55,17,61
Alloa,5615,3,17,9,10,62,37,25,60
Queen's Park,5615,4,16,8,12,39,46,-7,56
Brechin,5615,5,14,12,10,50,45,5,54
Albion,5615,6,13,8,15,46,49,-3,47
Stenhousem'r,5615,7,13,4,19,54,79,-25,43
Stranraer,5615,8,11,9,16,42,56,-14,42
East Fife,5615,9,10,7,19,52,58,-6,37
Peterhead,5615,10,9,7,20,42,68,-26,34
Livingston,5616,1,22,5,9,74,41,33,71
Alloa,5616,2,21,7,8,73,42,31,70
Brechin,5616,3,20,6,10,50,39,11,66
Albion,5616,4,14,10,12,56,52,4,52
Airdrieon,5616,5,15,7,14,51,52,-1,52
East Fife,5616,6,12,12,12,48,43,5,48
Queen's Park,5616,7,13,6,17,35,49,-14,45
Stranraer,5616,8,12,5,19,49,58,-9,41
Peterhead,5616,9,10,7,19,42,58,-16,37
Stenhousem'r,5616,10,4,9,23,47,91,-44,21
Alloa,5617,1,25,5,6,78,38,40,80
Livingston,5617,2,21,3,12,77,47,30,66
Brechin,5617,3,19,5,12,57,51,6,62
Airdrieon,5617,4,17,4,15,57,59,-2,55
Albion,5617,5,14,9,13,56,48,8,51
Peterhead,5617,6,12,10,14,45,53,-8,46
East Fife,5617,7,11,9,16,45,55,-10,42
Queen's Park,5617,8,11,6,19,34,61,-27,39
Stenhousem'r,5617,9,10,5,21,52,73,-21,35
Stranraer,5617,10,10,4,22,44,60,-16,34
Livingston,5618,1,22,0,14,81,43,38,66
Alloa,5618,2,20,5,11,76,53,23,65
Brechin,5618,3,18,8,10,53,44,9,62
Airdrieon,5618,4,17,8,11,66,55,11,59
Albion,5618,5,15,12,9,49,41,8,57
Stranraer,5618,6,14,5,17,49,57,-8,47
Peterhead,5618,7,13,7,16,48,62,-14,46
Queen's Park,5618,8,10,6,20,28,57,-29,36
East Fife,5618,9,8,11,17,46,49,-3,35
Stenhousem'r,5618,10,8,8,20,41,76,-35,32
Livingston,5619,1,22,7,7,74,46,28,73
Alloa,5619,2,18,8,10,63,37,26,62
Brechin,5619,3,18,5,13,55,47,8,59
Airdrieon,5619,4,17,5,14,65,59,6,56
Peterhead,5619,5,13,12,11,57,59,-2,51
Albion,5619,6,13,10,13,48,55,-7,49
East Fife,5619,7,9,15,12,50,50,0,42
Queen's Park,5619,8,11,7,18,42,54,-12,40
Stranraer,5619,9,11,6,19,58,73,-15,39
Stenhousem'r,5619,10,5,11,20,43,75,-32,26
Livingston,5620,1,22,4,10,86,38,48,70
Brechin,5620,2,19,6,11,60,49,11,63
Alloa,5620,3,19,5,12,71,53,18,62
Airdrieon,5620,4,15,4,17,54,67,-13,49
Albion,5620,5,12,10,14,56,60,-4,46
Peterhead,5620,6,12,9,15,51,52,-1,45
East Fife,5620,7,13,6,17,40,45,-5,45
Queen's Park,5620,8,13,6,17,41,57,-16,45
Stenhousem'r,5620,9,13,5,18,53,77,-24,44
Stranraer,5620,10,11,7,18,52,66,-14,40
Livingston,5621,1,21,1,14,78,56,22,64
Airdrieon,5621,2,18,10,8,62,46,16,64
Alloa,5621,3,18,8,10,60,44,16,62
Brechin,5621,4,18,4,14,54,43,11,58
Albion,5621,5,16,9,11,67,57,10,57
Peterhead,5621,6,12,10,14,45,50,-5,46
Queen's Park,5621,7,13,6,17,35,47,-12,45
Stranraer,5621,8,11,7,18,42,54,-12,40
East Fife,5621,9,9,12,15,41,44,-3,39
Stenhousem'r,5621,10,7,7,22,41,84,-43,28
Livingston,5622,1,20,7,9,75,51,24,67
Alloa,5622,2,19,6,11,71,40,31,63
Airdrieon,5622,3,18,6,12,60,50,10,60
Stranraer,5622,4,15,7,14,64,63,1,52
Brechin,5622,5,14,9,13,50,50,0,51
East Fife,5622,6,13,10,13,55,54,1,49
Queen's Park,5622,7,14,7,15,49,54,-5,49
Albion,5622,8,12,8,16,52,64,-12,44
Peterhead,5622,9,11,8,17,45,50,-5,41
Stenhousem'r,5622,10,6,8,22,43,88,-45,26
Livingston,5623,1,22,6,8,78,42,36,72
Alloa,5623,2,19,9,8,79,49,30,66
Brechin,5623,3,20,2,14,62,48,14,62
Airdrieon,5623,4,17,6,13,55,54,1,57
Albion,5623,5,15,8,13,60,56,4,53
Peterhead,5623,6,11,12,13,56,65,-9,45
Queen's Park,5623,7,10,11,15,34,52,-18,41
Stranraer,5623,8,11,6,19,51,66,-15,39
East Fife,5623,9,7,13,16,45,58,-13,34
Stenhousem'r,5623,10,7,9,20,51,81,-30,30
Alloa,5624,1,24,6,6,83,32,51,78
Airdrieon,5624,2,19,6,11,67,58,9,63
Livingston,5624,3,18,7,11,76,51,25,61
Albion,5624,4,14,7,15,53,67,-14,49
East Fife,5624,5,12,10,14,43,38,5,46
Queen's Park,5624,6,13,7,16,39,51,-12,46
Brechin,5624,7,14,3,19,51,66,-15,45
Stranraer,5624,8,12,7,17,48,58,-10,43
Peterhead,5624,9,12,5,19,43,57,-14,41
Stenhousem'r,5624,10,8,10,18,52,77,-25,34
Livingston,5625,1,26,3,7,82,42,40,81
Brechin,5625,2,21,5,10,61,44,17,68
Alloa,5625,3,17,6,13,68,47,21,57
Airdrieon,5625,4,16,7,13,54,54,0,55
Peterhead,5625,5,15,8,13,58,57,1,53
Albion,5625,6,13,7,16,49,58,-9,46
East Fife,5625,7,13,6,17,45,39,6,45
Stranraer,5625,8,13,2,21,45,63,-18,41
Queen's Park,5625,9,10,5,21,29,51,-22,35
Stenhousem'r,5625,10,8,7,21,44,80,-36,31
Livingston,5626,1,18,9,9,80,52,28,63
Alloa,5626,2,18,7,11,71,46,25,61
Peterhead,5626,3,17,8,11,60,46,14,59
Albion,5626,4,17,6,13,67,50,17,57
Brechin,5626,5,17,6,13,52,50,2,57
Stranraer,5626,6,15,6,15,65,69,-4,51
Queen's Park,5626,7,13,6,17,38,55,-17,45
Airdrieon,5626,8,12,8,16,49,66,-17,44
Stenhousem'r,5626,9,7,12,17,41,68,-27,33
East Fife,5626,10,7,10,19,40,61,-21,31
Livingston,5627,1,19,5,12,75,45,30,62
Alloa,5627,2,18,8,10,66,50,16,62
Brechin,5627,3,16,7,13,60,57,3,55
Peterhead,5627,4,15,8,13,55,50,5,53
Albion,5627,5,14,9,13,46,44,2,51
Stranraer,5627,6,13,10,13,51,56,-5,49
Airdrieon,5627,7,14,6,16,56,64,-8,48
Queen's Park,5627,8,12,9,15,40,52,-12,45
East Fife,5627,9,10,10,16,47,52,-5,40
Stenhousem'r,5627,10,10,6,20,47,73,-26,36
Livingston,5628,1,21,6,9,75,41,34,69
Alloa,5628,2,15,14,7,61,45,16,59
Brechin,5628,3,16,9,11,52,46,6,57
Airdrieon,5628,4,15,8,13,61,54,7,53
East Fife,5628,5,13,11,12,55,49,6,50
Peterhead,5628,6,11,11,14,49,53,-4,44
Queen's Park,5628,7,11,11,14,36,47,-11,44
Albion,5628,8,12,8,16,44,58,-14,44
Stranraer,5628,9,12,5,19,47,57,-10,41
Stenhousem'r,5628,10,8,9,19,53,83,-30,33
Livingston,5629,1,19,6,11,77,52,25,63
Brechin,5629,2,17,5,14,52,45,7,56
Airdrieon,5629,3,17,5,14,52,50,2,56
East Fife,5629,4,15,10,11,61,46,15,55
Queen's Park,5629,5,15,6,15,38,49,-11,51
Alloa,5629,6,13,10,13,60,52,8,49
Peterhead,5629,7,14,7,15,41,51,-10,49
Albion,5629,8,13,9,14,49,50,-1,48
Stranraer,5629,9,13,8,15,51,50,1,47
Stenhousem'r,5629,10,7,8,21,39,75,-36,29
Livingston,5630,1,19,9,8,75,50,25,66
Alloa,5630,2,18,8,10,81,54,27,62
Airdrieon,5630,3,19,5,12,60,54,6,62
Peterhead,5630,4,17,6,13,56,48,8,57
Brechin,5630,5,14,9,13,47,50,-3,51
Queen's Park,5630,6,13,10,13,40,48,-8,49
Albion,5630,7,11,11,14,49,50,-1,44
Stranraer,5630,8,9,12,15,43,54,-11,39
East Fife,5630,9,6,14,16,41,56,-15,32
Stenhousem'r,5630,10,8,8,20,41,69,-28,32
Livingston,5631,1,21,8,7,70,42,28,71
Alloa,5631,2,17,7,12,63,44,19,58
Brechin,5631,3,17,5,14,51,49,2,56
Airdrieon,5631,4,15,9,12,57,54,3,54
Peterhead,5631,5,15,6,15,47,48,-1,51
Albion,5631,6,14,8,14,50,47,3,50
East Fife,5631,7,12,10,14,51,47,4,46
Queen's Park,5631,8,12,8,16,33,46,-13,44
Stenhousem'r,5631,9,10,8,18,48,74,-26,38
Stranraer,5631,10,8,9,19,40,59,-19,33
Livingston,5632,1,23,5,8,80,50,30,74
Airdrieon,5632,2,21,3,12,61,46,15,66
Stranraer,5632,3,18,5,13,62,52,10,59
Alloa,5632,4,15,10,11,56,47,9,55
Albion,5632,5,15,9,12,70,56,14,54
Peterhead,5632,6,14,8,14,49,51,-2,50
Queen's Park,5632,7,11,10,15,37,56,-19,43
East Fife,5632,8,10,8,18,43,57,-14,38
Brechin,5632,9,10,6,20,43,53,-10,36
Stenhousem'r,5632,10,8,6,22,47,80,-33,30
Livingston,5633,1,23,5,8,84,48,36,74
Alloa,5633,2,20,4,12,82,44,38,64
Airdrieon,5633,3,18,7,11,56,52,4,61
Brechin,5633,4,18,3,15,55,51,4,57
Stranraer,5633,5,17,4,15,59,64,-5,55
Peterhead,5633,6,13,10,13,55,62,-7,49
East Fife,5633,7,11,9,16,47,52,-5,42
Queen's Park,5633,8,10,11,15,38,47,-9,41
Albion,5633,9,11,6,19,50,64,-14,39
Stenhousem'r,5633,10,7,5,24,48,90,-42,26
Livingston,5634,1,20,7,9,82,54,28,67
Alloa,5634,2,17,8,11,66,45,21,59
Peterhead,5634,3,17,8,11,56,49,7,59
Airdrieon,5634,4,16,8,12,55,56,-1,56
Brechin,5634,5,14,9,13,46,44,2,51
Albion,5634,6,13,9,14,48,49,-1,48
East Fife,5634,7,13,8,15,52,46,6,47
Queen's Park,5634,8,13,8,15,45,52,-7,47
Stranraer,5634,9,12,8,16,49,57,-8,44
Stenhousem'r,5634,10,6,5,25,41,88,-47,23
Alloa,5635,1,20,7,9,79,48,31,67
Livingston,5635,2,19,5,12,68,51,17,62
Brechin,5635,3,17,4,15,53,52,1,55
Airdrieon,5635,4,17,4,15,61,61,0,55
Peterhead,5635,5,16,4,16,53,55,-2,52
Albion,5635,6,13,11,12,51,51,0,50
Queen's Park,5635,7,14,8,14,51,52,-1,50
East Fife,5635,8,13,8,15,61,64,-3,47
Stranraer,5635,9,12,6,18,46,53,-7,42
Stenhousem'r,5635,10,6,9,21,50,86,-36,27
Alloa,5636,1,18,10,8,65,41,24,64
East Fife,5636,2,18,8,10,53,41,12,62
Livingston,5636,3,19,3,14,75,54,21,60
Airdrieon,5636,4,16,9,11,55,46,9,57
Brechin,5636,5,16,9,11,45,46,-1,57
Stranraer,5636,6,14,8,14,57,57,0,50
Albion,5636,7,11,8,17,46,50,-4,41
Peterhead,5636,8,10,10,16,43,50,-7,40
Queen's Park,5636,9,11,7,18,35,52,-17,40
Stenhousem'r,5636,10,9,4,23,46,83,-37,31
Livingston,5637,1,21,6,9,81,50,31,69
Brechin,5637,2,18,6,12,53,45,8,60
Alloa,5637,3,17,8,11,69,45,24,59
Peterhead,5637,4,16,11,9,59,52,7,59
Airdrieon,5637,5,15,8,13,51,56,-5,53
East Fife,5637,6,13,9,14,51,49,2,48
Queen's Park,5637,7,11,8,17,35,48,-13,41
Albion,5637,8,10,10,16,49,58,-9,40
Stranraer,5637,9,10,8,18,49,61,-12,38
Stenhousem'r,5637,10,8,8,20,45,78,-33,32
Alloa,5638,1,23,7,6,75,41,34,76
Livingston,5638,2,19,4,13,68,50,18,61
Airdrieon,5638,3,18,4,14,65,63,2,58
Brechin,5638,4,16,7,13,48,47,1,55
Stranraer,5638,5,15,4,17,56,56,0,49
Peterhead,5638,6,13,9,14,56,58,-2,48
Albion,5638,7,12,9,15,48,52,-4,45
Queen's Park,5638,8,11,12,13,36,48,-12,45
East Fife,5638,9,11,9,16,44,47,-3,42
Stenhousem'r,5638,10,5,9,22,40,74,-34,24
Livingston,5639,1,22,7,7,79,43,36,73
Brechin,5639,2,22,6,8,67,40,27,72
Alloa,5639,3,19,7,10,69,43,26,64
Airdrieon,5639,4,17,3,16,63,58,5,54
Peterhead,5639,5,14,6,16,43,51,-8,48
Albion,5639,6,13,7,16,56,62,-6,46
Queen's Park,5639,7,13,4,19,36,48,-12,43
East Fife,5639,8,11,8,17,57,62,-5,41
Stranraer,5639,9,11,7,18,46,70,-24,40
Stenhousem'r,5639,10,7,7,22,41,80,-39,28
Alloa,5640,1,21,8,7,71,42,29,71
Airdrieon,5640,2,19,9,8,62,45,17,66
Livingston,5640,3,14,12,10,65,55,10,54
Queen's Park,5640,4,15,9,12,45,43,2,54
Brechin,5640,5,14,9,13,48,43,5,51
East Fife,5640,6,12,12,12,59,48,11,48
Albion,5640,7,11,12,13,52,54,-2,45
Peterhead,5640,8,10,10,16,42,57,-15,40
Stranraer,5640,9,9,8,19,39,57,-18,35
Stenhousem'r,5640,10,7,7,22,43,82,-39,28
Alloa,5641,1,21,7,8,67,39,28,70
Livingston,5641,2,20,5,11,75,40,35,65
Airdrieon,5641,3,16,7,13,58,53,5,55
Brechin,5641,4,16,6,14,50,53,-3,54
Peterhead,5641,5,16,4,16,52,52,0,52
Albion,5641,6,14,10,12,49,51,-2,52
East Fife,5641,7,12,9,15,55,47,8,45
Queen's Park,5641,8,12,5,19,38,58,-20,41
Stranraer,5641,9,9,9,18,44,63,-19,36
Stenhousem'r,5641,10,9,8,19,44,76,-32,35
Livingston,5642,1,24,3,9,101,46,55,75
Alloa,5642,2,21,6,9,72,45,27,69
Brechin,5642,3,19,4,13,52,48,4,61
Airdrieon,5642,4,15,7,14,60,55,5,52
Stranraer,5642,5,16,4,16,58,65,-7,52
Albion,5642,6,13,9,14,67,63,4,48
Peterhead,5642,7,14,5,17,46,55,-9,47
Queen's Park,5642,8,12,6,18,38,57,-19,42
East Fife,5642,9,10,7,19,42,59,-17,37
Stenhousem'r,5642,10,7,7,22,47,90,-43,28
Livingston,5643,1,24,3,9,87,54,33,75
Alloa,5643,2,18,7,11,64,47,17,61
East Fife,5643,3,17,8,11,58,44,14,59
Airdrieon,5643,4,16,8,12,62,52,10,56
Albion,5643,5,15,10,11,55,42,13,55
Brechin,5643,6,15,4,17,41,47,-6,49
Stranraer,5643,7,14,4,18,55,60,-5,46
Peterhead,5643,8,12,7,17,49,62,-13,43
Queen's Park,5643,9,9,8,19,29,49,-20,35
Stenhousem'r,5643,10,8,5,23,41,84,-43,29
Livingston,5644,1,21,4,11,75,53,22,67
Airdrieon,5644,2,18,4,14,59,58,1,58
Brechin,5644,3,17,6,13,59,51,8,57
Albion,5644,4,16,8,12,48,42,6,56
Queen's Park,5644,5,16,7,13,40,55,-15,55
Alloa,5644,6,15,9,12,64,46,18,54
East Fife,5644,7,12,9,15,52,49,3,45
Stranraer,5644,8,13,5,18,53,60,-7,44
Peterhead,5644,9,11,6,19,47,61,-14,39
Stenhousem'r,5644,10,9,6,21,53,75,-22,33
Livingston,5645,1,23,4,9,76,45,31,73
Alloa,5645,2,18,9,9,66,40,26,63
Brechin,5645,3,16,8,12,48,42,6,56
Queen's Park,5645,4,16,7,13,49,44,5,55
Airdrieon,5645,5,15,8,13,54,52,2,53
Albion,5645,6,13,9,14,51,56,-5,48
Peterhead,5645,7,13,8,15,53,61,-8,47
Stranraer,5645,8,11,6,19,48,59,-11,39
East Fife,5645,9,8,13,15,42,51,-9,37
Stenhousem'r,5645,10,7,8,21,38,75,-37,29
Livingston,5646,1,25,2,9,91,44,47,77
Airdrieon,5646,2,18,7,11,64,49,15,61
Alloa,5646,3,17,9,10,79,52,27,60
Stranraer,5646,4,16,6,14,58,57,1,54
Brechin,5646,5,14,7,15,58,67,-9,49
Queen's Park,5646,6,12,8,16,37,55,-18,44
Albion,5646,7,11,9,16,54,64,-10,42
East Fife,5646,8,11,9,16,50,60,-10,42
Peterhead,5646,9,12,5,19,39,59,-20,41
Stenhousem'r,5646,10,10,6,20,50,73,-23,36
Alloa,5647,1,20,8,8,68,38,30,68
Livingston,5647,2,20,7,9,78,52,26,67
Airdrieon,5647,3,19,8,9,74,57,17,65
East Fife,5647,4,15,9,12,53,43,10,54
Brechin,5647,5,16,6,14,46,53,-7,54
Albion,5647,6,12,10,14,52,50,2,46
Stranraer,5647,7,14,4,18,52,58,-6,46
Queen's Park,5647,8,10,7,19,34,54,-20,37
Peterhead,5647,9,9,9,18,38,53,-15,36
Stenhousem'r,5647,10,7,8,21,53,90,-37,29
Alloa,5648,1,20,9,7,77,45,32,69
Livingston,5648,2,21,3,12,81,57,24,66
East Fife,5648,3,17,7,12,63,44,19,58
Brechin,5648,4,18,4,14,51,54,-3,58
Airdrieon,5648,5,16,5,15,53,52,1,53
Albion,5648,6,14,7,15,52,57,-5,49
Stranraer,5648,7,14,5,17,54,63,-9,47
Peterhead,5648,8,13,5,18,50,62,-12,44
Queen's Park,5648,9,10,11,15,40,54,-14,41
Stenhousem'r,5648,10,6,6,24,46,79,-33,24
Alloa,5649,1,20,9,7,76,40,36,69
Livingston,5649,2,19,7,10,79,52,27,64
Airdrieon,5649,3,17,9,10,60,56,4,60
Brechin,5649,4,15,11,10,52,46,6,56
East Fife,5649,5,13,9,14,49,49,0,48
Peterhead,5649,6,11,12,13,45,52,-7,45
Albion,5649,7,10,14,12,44,44,0,44
Stranraer,5649,8,13,3,20,55,67,-12,42
Queen's Park,5649,9,12,3,21,36,62,-26,39
Stenhousem'r,5649,10,6,11,19,47,75,-28,29
Airdrieon,5650,1,20,7,9,71,49,22,67
Livingston,5650,2,19,6,11,72,49,23,63
Alloa,5650,3,17,8,11,60,51,9,59
Albion,5650,4,16,9,11,47,42,5,57
Brechin,5650,5,16,5,15,53,51,2,53
Peterhead,5650,6,14,8,14,51,52,-1,50
East Fife,5650,7,11,13,12,49,43,6,46
Queen's Park,5650,8,10,9,17,27,48,-21,39
Stranraer,5650,9,9,10,17,47,63,-16,37
Stenhousem'r,5650,10,6,9,21,45,74,-29,27
Airdrieon,5651,1,20,5,11,67,51,16,65
Alloa,5651,2,17,9,10,63,47,16,60
Brechin,5651,3,17,9,10,63,52,11,60
Livingston,5651,4,17,6,13,64,44,20,57
Albion,5651,5,14,9,13,63,54,9,51
Stranraer,5651,6,14,8,14,56,58,-2,50
Peterhead,5651,7,13,8,15,49,55,-6,47
East Fife,5651,8,12,9,15,54,60,-6,45
Queen's Park,5651,9,9,8,19,32,58,-26,35
Stenhousem'r,5651,10,6,11,19,40,72,-32,29
Livingston,5652,1,27,0,9,87,44,43,81
Airdrieon,5652,2,17,8,11,59,51,8,59
Alloa,5652,3,17,7,12,67,50,17,58
Brechin,5652,4,17,5,14,54,50,4,56
East Fife,5652,5,14,10,12,53,46,7,52
Albion,5652,6,14,8,14,51,50,1,50
Queen's Park,5652,7,14,7,15,41,46,-5,49
Peterhead,5652,8,13,7,16,43,54,-11,46
Stranraer,5652,9,11,5,20,45,67,-22,38
Stenhousem'r,5652,10,5,5,26,37,79,-42,20
Peterhead,5653,1,19,8,9,60,45,15,65
Albion,5653,2,19,7,10,65,46,19,64
Livingston,5653,3,19,4,13,74,55,19,61
Alloa,5653,4,16,10,10,64,40,24,58
Brechin,5653,5,17,4,15,46,47,-1,55
Airdrieon,5653,6,15,7,14,46,48,-2,52
East Fife,5653,7,11,11,14,62,54,8,44
Stranraer,5653,8,12,7,17,43,55,-12,43
Queen's Park,5653,9,7,10,19,31,62,-31,31
Stenhousem'r,5653,10,7,8,21,42,81,-39,29
Livingston,5654,1,22,6,8,70,41,29,72
Brechin,5654,2,20,5,11,61,50,11,65
Airdrieon,5654,3,17,6,13,61,48,13,57
Queen's Park,5654,4,15,7,14,42,53,-11,52
Alloa,5654,5,14,8,14,62,53,9,50
Peterhead,5654,6,14,8,14,46,47,-1,50
East Fife,5654,7,10,12,14,54,52,2,42
Albion,5654,8,12,6,18,52,63,-11,42
Stranraer,5654,9,12,5,19,47,61,-14,41
Stenhousem'r,5654,10,7,11,18,47,74,-27,32
Livingston,5655,1,20,6,10,77,45,32,66
Alloa,5655,2,19,6,11,66,44,22,63
Airdrieon,5655,3,17,9,10,63,57,6,60
Peterhead,5655,4,17,6,13,58,47,11,57
Brechin,5655,5,17,3,16,50,49,1,54
Stranraer,5655,6,15,6,15,56,59,-3,51
East Fife,5655,7,11,13,12,52,51,1,46
Albion,5655,8,10,13,13,43,49,-6,43
Queen's Park,5655,9,8,9,19,35,58,-23,33
Stenhousem'r,5655,10,6,9,21,48,89,-41,27
Livingston,5656,1,23,3,10,88,48,40,72
Alloa,5656,2,19,7,10,73,39,34,64
Airdrieon,5656,3,17,7,12,62,56,6,58
Peterhead,5656,4,16,6,14,54,48,6,54
Queen's Park,5656,5,15,6,15,41,53,-12,51
Albion,5656,6,14,8,14,46,53,-7,50
East Fife,5656,7,13,6,17,51,55,-4,45
Stranraer,5656,8,13,5,18,63,72,-9,44
Brechin,5656,9,12,6,18,43,55,-12,42
Stenhousem'r,5656,10,8,6,22,41,83,-42,30
Livingston,5657,1,24,3,9,85,47,38,75
Alloa,5657,2,19,6,11,71,44,27,63
Brechin,5657,3,18,6,12,56,44,12,60
Stranraer,5657,4,17,6,13,53,54,-1,57
Airdrieon,5657,5,17,4,15,57,63,-6,55
East Fife,5657,6,13,10,13,48,48,0,49
Peterhead,5657,7,10,8,18,42,63,-21,38
Queen's Park,5657,8,10,7,19,38,55,-17,37
Stenhousem'r,5657,9,9,9,18,50,65,-15,36
Albion,5657,10,9,9,18,46,63,-17,36
Alloa,5658,1,20,8,8,73,44,29,68
Livingston,5658,2,19,10,7,81,47,34,67
Brechin,5658,3,20,5,11,59,47,12,65
Airdrieon,5658,4,16,6,14,59,51,8,54
Peterhead,5658,5,15,5,16,50,57,-7,50
Albion,5658,6,13,10,13,55,53,2,49
Queen's Park,5658,7,14,7,15,38,48,-10,49
East Fife,5658,8,11,8,17,50,52,-2,41
Stranraer,5658,9,11,5,20,40,60,-20,38
Stenhousem'r,5658,10,6,6,24,45,91,-46,24
Livingston,5659,1,25,0,11,80,47,33,75
Alloa,5659,2,17,8,11,74,49,25,59
Albion,5659,3,17,8,11,61,46,15,59
Airdrieon,5659,4,17,8,11,61,50,11,59
Brechin,5659,5,16,8,12,49,45,4,56
Stranraer,5659,6,13,7,16,51,60,-9,46
East Fife,5659,7,11,10,15,43,50,-7,43
Queen's Park,5659,8,11,8,17,44,59,-15,41
Peterhead,5659,9,11,6,19,43,56,-13,39
Stenhousem'r,5659,10,8,5,23,40,84,-44,29
Livingston,5660,1,23,5,8,84,39,45,74
Airdrieon,5660,2,18,9,9,59,51,8,63
Alloa,5660,3,15,11,10,65,50,15,56
Albion,5660,4,16,7,13,62,61,1,55
Peterhead,5660,5,14,5,17,58,55,3,47
Brechin,5660,6,14,5,17,49,58,-9,47
Stranraer,5660,7,13,6,17,50,54,-4,45
Queen's Park,5660,8,12,9,15,42,53,-11,45
East Fife,5660,9,10,11,15,49,52,-3,41
Stenhousem'r,5660,10,7,8,21,44,89,-45,29
Livingston,5661,1,20,5,11,89,54,35,65
Peterhead,5661,2,19,7,10,60,49,11,64
Alloa,5661,3,18,7,11,74,44,30,61
Albion,5661,4,15,9,12,65,57,8,54
Brechin,5661,5,15,9,12,48,48,0,54
Stranraer,5661,6,14,6,16,58,61,-3,48
East Fife,5661,7,12,11,13,49,52,-3,47
Queen's Park,5661,8,13,7,16,47,62,-15,46
Airdrieon,5661,9,13,6,17,51,66,-15,45
Stenhousem'r,5661,10,5,5,26,51,99,-48,20
Alloa,5662,1,20,9,7,79,47,32,69
Livingston,5662,2,22,3,11,71,49,22,69
Brechin,5662,3,18,7,11,57,46,11,61
Airdrieon,5662,4,18,3,15,60,55,5,57
Peterhead,5662,5,16,8,12,55,44,11,56
Albion,5662,6,12,10,14,51,54,-3,46
Stranraer,5662,7,11,9,16,58,64,-6,42
East Fife,5662,8,11,8,17,48,52,-4,41
Queen's Park,5662,9,11,6,19,39,62,-23,39
Stenhousem'r,5662,10,7,5,24,37,82,-45,26
Alloa,5663,1,22,6,8,75,34,41,72
Livingston,5663,2,20,3,13,79,59,20,63
Airdrieon,5663,3,18,5,13,66,61,5,59
Brechin,5663,4,17,5,14,47,47,0,56
Peterhead,5663,5,16,6,14,62,57,5,54
Albion,5663,6,15,6,15,54,54,0,51
East Fife,5663,7,12,10,14,53,52,1,46
Stranraer,5663,8,13,3,20,50,59,-9,42
Queen's Park,5663,9,11,7,18,29,51,-22,40
Stenhousem'r,5663,10,7,7,22,42,83,-41,28
Airdrieon,5664,1,22,5,9,61,46,15,71
Alloa,5664,2,17,7,12,65,52,13,58
Livingston,5664,3,18,3,15,72,55,17,57
Brechin,5664,4,13,10,13,50,51,-1,49
Peterhead,5664,5,13,9,14,55,51,4,48
Stranraer,5664,6,13,9,14,56,56,0,48
Albion,5664,7,12,12,12,50,53,-3,48
Queen's Park,5664,8,12,9,15,37,55,-18,45
East Fife,5664,9,11,9,16,51,50,1,42
Stenhousem'r,5664,10,8,9,19,44,72,-28,33
Livingston,5665,1,24,4,8,80,41,39,76
Brechin,5665,2,20,5,11,46,33,13,65
Alloa,5665,3,17,7,12,68,50,18,58
Queen's Park,5665,4,17,5,14,40,46,-6,56
Peterhead,5665,5,15,8,13,52,51,1,53
Airdrieon,5665,6,15,6,15,57,54,3,51
East Fife,5665,7,13,10,13,53,43,10,49
Stranraer,5665,8,11,6,19,52,65,-13,39
Stenhousem'r,5665,9,9,5,22,44,83,-39,32
Albion,5665,10,8,6,22,38,64,-26,30
Livingston,5666,1,23,1,12,83,47,36,70
Alloa,5666,2,20,7,9,73,56,17,67
Queen's Park,5666,3,18,6,12,52,49,3,60
Airdrieon,5666,4,17,6,13,59,56,3,57
Brechin,5666,5,16,4,16,54,58,-4,52
Albion,5666,6,13,6,17,59,60,-1,45
East Fife,5666,7,10,12,14,53,50,3,42
Stranraer,5666,8,12,6,18,52,65,-13,42
Stenhousem'r,5666,9,9,12,15,61,74,-13,39
Peterhead,5666,10,10,4,22,44,75,-31,34
Alloa,5667,1,22,6,8,71,42,29,72
Livingston,5667,2,22,4,10,82,44,38,70
Airdrieon,5667,3,19,5,12,57,56,1,62
Queen's Park,5667,4,19,3,14,55,53,2,60
Peterhead,5667,5,18,5,13,54,52,2,59
Brechin,5667,6,15,6,15,48,46,2,51
Albion,5667,7,10,9,17,57,63,-6,39
East Fife,5667,8,10,8,18,43,45,-2,38
Stranraer,5667,9,9,6,21,46,69,-23,33
Stenhousem'r,5667,10,7,6,23,43,86,-43,27
Livingston,5668,1,23,4,9,75,39,36,73
Airdrieon,5668,2,22,4,10,62,51,11,70
Alloa,5668,3,18,8,10,64,45,19,62
Brechin,5668,4,18,7,11,55,41,14,61
Albion,5668,5,15,6,15,54,50,4,51
Peterhead,5668,6,14,8,14,50,55,-5,50
Queen's Park,5668,7,12,9,15,40,45,-5,45
East Fife,5668,8,11,7,18,49,50,-1,40
Stranraer,5668,9,11,4,21,47,62,-15,37
Stenhousem'r,5668,10,4,7,25,44,102,-58,19
Alloa,5669,1,18,7,11,84,55,29,61
Airdrieon,5669,2,17,10,9,67,50,17,61
Livingston,5669,3,18,6,12,86,60,26,60
Brechin,5669,4,18,6,12,49,45,4,60
Peterhead,5669,5,15,7,14,53,53,0,52
Stranraer,5669,6,15,6,15,56,55,1,51
Albion,5669,7,15,5,16,54,55,-1,50
East Fife,5669,8,12,9,15,51,59,-8,45
Queen's Park,5669,9,12,6,18,33,60,-27,42
Stenhousem'r,5669,10,6,6,24,49,90,-41,24
Livingston,5670,1,20,6,10,85,50,35,66
Albion,5670,2,17,10,9,57,47,10,61
Alloa,5670,3,17,9,10,64,45,19,60
Airdrieon,5670,4,14,9,13,53,53,0,51
Peterhead,5670,5,14,9,13,48,49,-1,51
Stranraer,5670,6,15,5,16,53,52,1,50
Queen's Park,5670,7,13,8,15,39,50,-11,47
Brechin,5670,8,13,7,16,45,50,-5,46
East Fife,5670,9,9,9,18,44,54,-10,36
Stenhousem'r,5670,10,9,6,21,48,86,-38,33
Livingston,5671,1,23,3,10,88,49,39,72
Alloa,5671,2,20,5,11,78,52,26,65
Airdrieon,5671,3,19,3,14,57,51,6,60
Albion,5671,4,16,5,15,60,55,5,53
Peterhead,5671,5,15,8,13,50,51,-1,53
Brechin,5671,6,15,6,15,43,53,-10,51
Queen's Park,5671,7,13,7,16,37,48,-11,46
East Fife,5671,8,12,8,16,55,51,4,44
Stranraer,5671,9,12,1,23,43,70,-27,37
Stenhousem'r,5671,10,8,8,20,42,73,-31,32
Livingston,5672,1,23,3,10,76,42,34,72
Alloa,5672,2,17,9,10,63,45,18,60
Brechin,5672,3,18,6,12,56,45,11,60
East Fife,5672,4,14,12,10,64,50,14,54
Airdrieon,5672,5,15,9,12,53,51,2,54
Peterhead,5672,6,13,9,14,49,52,-3,48
Stranraer,5672,7,14,3,19,56,65,-9,45
Albion,5672,8,12,7,17,54,61,-7,43
Queen's Park,5672,9,10,9,17,29,52,-23,39
Stenhousem'r,5672,10,8,5,23,45,82,-37,29
Livingston,5673,1,22,2,12,78,49,29,68
Brechin,5673,2,19,5,12,52,43,9,62
Peterhead,5673,3,18,6,12,56,51,5,60
Alloa,5673,4,16,6,14,60,47,13,54
East Fife,5673,5,14,11,11,48,38,10,53
Airdrieon,5673,6,15,6,15,57,59,-2,51
Albion,5673,7,14,5,17,42,50,-8,47
Queen's Park,5673,8,13,8,15,39,48,-9,47
Stranraer,5673,9,13,7,16,55,54,1,46
Stenhousem'r,5673,10,5,6,25,32,80,-48,21
Airdrieon,5674,1,21,6,9,64,45,19,69
Alloa,5674,2,18,9,9,71,53,18,63
Livingston,5674,3,18,3,15,75,57,18,57
Brechin,5674,4,16,6,14,53,50,3,54
Albion,5674,5,15,8,13,51,50,1,53
Queen's Park,5674,6,14,11,11,40,41,-1,53
Peterhead,5674,7,14,8,14,51,52,-1,50
East Fife,5674,8,13,7,16,53,49,4,46
Stranraer,5674,9,10,4,22,48,73,-25,34
Stenhousem'r,5674,10,6,8,22,43,79,-36,26
Alloa,5675,1,17,10,9,65,42,23,61
Livingston,5675,2,18,6,12,72,50,22,60
Airdrieon,5675,3,16,8,12,58,54,4,56
Brechin,5675,4,16,8,12,52,53,-1,56
Peterhead,5675,5,14,12,10,57,46,11,54
Albion,5675,6,14,9,13,56,54,2,51
Queen's Park,5675,7,13,6,17,39,56,-17,45
East Fife,5675,8,10,12,14,45,51,-6,42
Stranraer,5675,9,11,5,20,44,58,-14,38
Stenhousem'r,5675,10,10,6,20,45,69,-24,36
Airdrieon,5676,1,22,6,8,74,53,21,72
Alloa,5676,2,20,6,10,67,46,21,66
Livingston,5676,3,20,5,11,68,46,22,65
Brechin,5676,4,17,5,14,52,49,3,56
Stranraer,5676,5,16,6,14,54,55,-1,54
Queen's Park,5676,6,13,8,15,42,47,-5,47
Peterhead,5676,7,11,8,17,41,52,-11,41
Albion,5676,8,10,10,16,47,55,-8,40
East Fife,5676,9,7,11,18,42,54,-12,32
Stenhousem'r,5676,10,7,9,20,43,73,-30,30
Livingston,5677,1,22,3,11,79,49,30,69
Alloa,5677,2,19,7,10,72,53,19,64
Airdrieon,5677,3,18,8,10,60,46,14,62
Brechin,5677,4,17,10,9,56,41,15,61
Peterhead,5677,5,18,6,12,56,53,3,60
Queen's Park,5677,6,11,9,16,32,52,-20,42
East Fife,5677,7,10,11,15,48,47,1,41
Stranraer,5677,8,11,8,17,47,53,-6,41
Albion,5677,9,11,6,19,51,61,-10,39
Stenhousem'r,5677,10,5,8,23,37,83,-46,23
Alloa,5678,1,19,9,8,68,39,29,66
Livingston,5678,2,19,6,11,63,43,20,63
Airdrieon,5678,3,18,6,12,58,44,14,60
Stranraer,5678,4,18,5,13,52,41,11,59
Brechin,5678,5,14,8,14,42,46,-4,50
Peterhead,5678,6,12,12,12,52,48,4,48
Albion,5678,7,12,11,13,55,65,-10,47
Queen's Park,5678,8,10,9,17,32,48,-16,39
East Fife,5678,9,8,11,17,35,52,-17,35
Stenhousem'r,5678,10,6,11,19,45,76,-31,29
Alloa,5679,1,23,5,8,73,37,36,74
Airdrieon,5679,2,20,5,11,65,48,17,65
Livingston,5679,3,20,3,13,84,47,37,63
Brechin,5679,4,15,7,14,47,52,-5,52
East Fife,5679,5,14,8,14,47,40,7,50
Albion,5679,6,14,6,16,47,57,-10,48
Peterhead,5679,7,13,7,16,45,62,-17,46
Stranraer,5679,8,13,5,18,57,64,-7,44
Queen's Park,5679,9,12,6,18,35,56,-21,42
Stenhousem'r,5679,10,5,10,21,41,78,-37,25
Alloa,5680,1,21,7,8,77,46,31,70
Livingston,5680,2,18,6,12,69,49,20,60
Brechin,5680,3,17,7,12,53,47,6,58
Airdrieon,5680,4,16,6,14,60,57,3,54
Peterhead,5680,5,15,7,14,48,50,-2,52
East Fife,5680,6,14,8,14,48,47,1,50
Queen's Park,5680,7,12,10,14,39,49,-10,46
Stenhousem'r,5680,8,11,9,16,52,70,-18,42
Stranraer,5680,9,11,6,19,39,53,-14,39
Albion,5680,10,8,8,20,50,67,-17,32
Livingston,5681,1,21,5,10,92,59,33,68
Alloa,5681,2,19,5,12,67,44,23,62
Brechin,5681,3,19,2,15,48,48,0,59
Airdrieon,5681,4,16,9,11,56,48,8,57
Albion,5681,5,15,6,15,50,50,0,51
East Fife,5681,6,13,8,15,48,42,6,47
Queen's Park,5681,7,13,6,17,36,46,-10,45
Peterhead,5681,8,12,8,16,48,62,-14,44
Stranraer,5681,9,11,7,18,43,58,-15,40
Stenhousem'r,5681,10,9,8,19,40,71,-31,35
Livingston,5682,1,20,4,12,77,52,25,64
Airdrieon,5682,2,18,6,12,66,55,11,60
Alloa,5682,3,15,10,11,61,51,10,55
Stranraer,5682,4,16,7,13,56,53,3,55
East Fife,5682,5,14,10,12,55,44,11,52
Albion,5682,6,14,9,13,52,51,1,51
Brechin,5682,7,14,7,15,49,58,-9,49
Peterhead,5682,8,12,12,12,56,54,2,48
Queen's Park,5682,9,10,6,20,33,55,-22,36
Stenhousem'r,5682,10,8,7,21,51,83,-32,31
Alloa,5683,1,19,8,9,73,50,23,65
Livingston,5683,2,19,6,11,63,43,20,63
Airdrieon,5683,3,19,6,11,65,50,15,63
Brechin,5683,4,15,4,17,44,49,-5,49
Queen's Park,5683,5,14,7,15,33,43,-10,49
Peterhead,5683,6,13,7,16,47,54,-7,46
Stranraer,5683,7,12,8,16,55,62,-7,44
Albion,5683,8,11,11,14,57,67,-10,44
East Fife,5683,9,10,11,15,50,46,4,41
Stenhousem'r,5683,10,8,12,16,44,67,-23,36
Livingston,5684,1,19,8,9,72,45,27,65
Brechin,5684,2,19,5,12,57,56,1,62
Alloa,5684,3,17,10,9,74,47,27,61
Albion,5684,4,15,9,12,55,46,9,54
Peterhead,5684,5,16,6,14,55,51,4,54
Queen's Park,5684,6,16,6,14,43,45,-2,54
Airdrieon,5684,7,14,7,15,53,60,-7,49
Stranraer,5684,8,11,9,16,47,61,-14,42
East Fife,5684,9,9,9,18,43,48,-5,36
Stenhousem'r,5684,10,6,7,23,43,83,-40,25
Brechin,5685,1,20,6,10,54,44,10,66
Alloa,5685,2,18,7,11,73,53,20,61
Airdrieon,5685,3,17,10,9,65,48,17,61
Livingston,5685,3,19,4,13,65,48,17,61
Peterhead,5685,5,16,9,11,62,47,15,57
Albion,5685,6,15,5,16,61,60,1,50
Queen's Park,5685,7,13,6,17,36,47,-11,45
East Fife,5685,8,11,8,17,45,50,-5,41
Stranraer,5685,9,12,3,21,50,73,-23,39
Stenhousem'r,5685,10,8,4,24,43,84,-41,28
Livingston,5686,1,21,7,8,82,41,41,70
Airdrieon,5686,2,20,7,9,65,50,15,67
Brechin,5686,3,20,5,11,54,41,13,65
Albion,5686,4,16,10,10,53,51,2,58
Alloa,5686,5,15,8,13,59,48,11,53
Peterhead,5686,6,13,6,17,45,51,-6,45
Stranraer,5686,7,12,9,15,49,56,-7,45
Queen's Park,5686,8,13,6,17,40,56,-16,45
East Fife,5686,9,8,8,20,45,58,-13,32
Stenhousem'r,5686,10,4,10,22,44,84,-40,22
Airdrieon,5687,1,18,8,10,63,52,11,62
Alloa,5687,2,17,8,11,58,47,11,59
Livingston,5687,3,16,9,11,76,55,21,57
Albion,5687,4,15,8,13,52,47,5,53
Stranraer,5687,5,16,4,16,60,62,-2,52
Brechin,5687,6,15,5,16,45,49,-4,50
Queen's Park,5687,7,14,7,15,42,50,-8,49
Peterhead,5687,8,11,13,12,50,51,-1,46
East Fife,5687,9,11,11,14,52,49,3,44
Stenhousem'r,5687,10,6,9,21,49,85,-36,27
Airdrieon,5688,1,21,7,8,60,44,16,70
Alloa,5688,2,18,11,7,71,38,33,65
Livingston,5688,3,19,4,13,75,54,21,61
Albion,5688,4,14,10,12,60,55,5,52
Peterhead,5688,5,13,11,12,49,48,1,50
Brechin,5688,6,13,7,16,45,60,-15,46
Stenhousem'r,5688,7,12,7,17,50,72,-22,43
Stranraer,5688,8,10,8,18,48,63,-15,38
East Fife,5688,9,8,13,15,46,51,-5,37
Queen's Park,5688,10,9,8,19,39,58,-19,35
Alloa,5689,1,23,5,8,84,40,44,74
Peterhead,5689,2,18,9,9,65,45,20,63
Livingston,5689,3,18,6,12,81,62,19,60
Brechin,5689,4,19,2,15,52,53,-1,59
Airdrieon,5689,5,15,9,12,61,57,4,54
Albion,5689,6,16,6,14,53,53,0,54
Stranraer,5689,7,13,5,18,59,63,-4,44
East Fife,5689,8,11,6,19,45,52,-7,39
Queen's Park,5689,9,10,7,19,35,58,-23,37
Stenhousem'r,5689,10,6,7,23,39,91,-52,25
Alloa,5690,1,19,9,8,75,48,27,66
Livingston,5690,2,20,4,12,80,51,29,64
Airdrieon,5690,3,18,8,10,59,48,11,62
Albion,5690,4,15,7,14,47,49,-2,52
Stenhousem'r,5690,5,12,12,12,54,60,-6,48
Brechin,5690,6,12,11,13,48,50,-2,47
Stranraer,5690,7,13,7,16,54,59,-5,46
Peterhead,5690,8,11,9,16,48,65,-17,42
East Fife,5690,9,8,12,16,50,57,-7,36
Queen's Park,5690,10,10,5,21,29,57,-28,35
Brechin,5691,1,21,5,10,58,47,11,68
Livingston,5691,2,21,2,13,82,57,25,65
Alloa,5691,3,18,10,8,66,39,27,64
Airdrieon,5691,4,17,4,15,57,55,2,55
Albion,5691,5,16,5,15,54,53,1,53
Peterhead,5691,6,13,8,15,46,50,-4,47
Queen's Park,5691,7,14,5,17,39,51,-12,47
East Fife,5691,8,12,8,16,52,54,-2,44
Stranraer,5691,9,12,2,22,45,63,-18,38
Stenhousem'r,5691,10,7,9,20,43,73,-30,30
Livingston,5692,1,22,5,9,80,45,35,71
Alloa,5692,2,19,7,10,75,47,28,64
Peterhead,5692,3,19,5,12,68,55,13,62
Brechin,5692,4,17,5,14,46,45,1,56
East Fife,5692,5,14,10,12,56,40,16,52
Airdrieon,5692,6,14,6,16,56,61,-5,48
Albion,5692,7,12,8,16,47,60,-13,44
Queen's Park,5692,8,11,9,16,34,52,-18,42
Stranraer,5692,9,11,8,17,49,57,-8,41
Stenhousem'r,5692,10,6,7,23,36,85,-49,25
Alloa,5693,1,23,7,6,75,39,36,76
Livingston,5693,2,24,1,11,79,49,30,73
Albion,5693,3,17,7,12,56,48,8,58
Airdrieon,5693,4,17,6,13,60,50,10,57
Stranraer,5693,5,17,5,14,55,53,2,56
Brechin,5693,6,15,7,14,56,49,7,52
Peterhead,5693,7,12,9,15,47,59,-12,45
East Fife,5693,8,10,9,17,48,50,-2,39
Queen's Park,5693,9,7,6,23,28,71,-43,27
Stenhousem'r,5693,10,7,5,24,43,79,-36,26
Livingston,5694,1,23,5,8,88,50,38,74
Alloa,5694,2,21,7,8,78,47,31,70
Airdrieon,5694,3,17,5,14,65,62,3,56
Peterhead,5694,4,17,5,14,54,53,1,56
Brechin,5694,5,15,9,12,51,48,3,54
Stenhousem'r,5694,6,13,9,14,56,79,-23,48
Albion,5694,7,12,6,18,45,53,-8,42
Queen's Park,5694,8,12,5,19,42,58,-16,41
East Fife,5694,9,9,7,20,52,55,-3,34
Stranraer,5694,10,9,6,21,43,69,-26,33
Alloa,5695,1,18,9,9,65,43,22,63
Livingston,5695,2,18,8,10,68,46,22,62
Airdrieon,5695,3,18,7,11,62,43,19,61
Brechin,5695,4,16,10,10,49,38,11,58
Albion,5695,5,14,13,9,43,35,8,55
Queen's Park,5695,6,14,5,17,30,42,-12,47
Peterhead,5695,7,13,7,16,43,52,-9,46
Stranraer,5695,8,12,6,18,51,63,-12,42
East Fife,5695,9,10,9,17,39,50,-11,39
Stenhousem'r,5695,10,7,6,23,46,84,-38,27
Livingston,5696,1,24,3,9,82,46,36,75
Brechin,5696,2,20,5,11,51,38,13,65
Alloa,5696,3,18,9,9,71,49,22,63
Stranraer,5696,4,15,8,13,57,55,2,53
Albion,5696,5,15,7,14,51,44,7,52
Airdrieon,5696,6,15,7,14,57,59,-2,52
Peterhead,5696,7,12,8,16,45,51,-6,44
East Fife,5696,8,10,7,19,35,51,-16,37
Queen's Park,5696,9,9,7,20,31,57,-26,34
Stenhousem'r,5696,10,8,7,21,41,71,-30,31
Livingston,5697,1,21,5,10,84,54,30,68
Airdrieon,5697,2,20,3,13,56,49,7,63
Brechin,5697,3,18,5,13,58,50,8,59
Alloa,5697,4,16,8,12,68,51,17,56
Stranraer,5697,5,17,5,14,55,48,7,56
Albion,5697,6,12,13,11,50,47,3,49
East Fife,5697,7,13,7,16,53,57,-4,46
Peterhead,5697,8,12,8,16,48,55,-7,44
Queen's Park,5697,9,11,6,19,36,56,-20,39
Stenhousem'r,5697,10,7,6,23,43,84,-41,27
Livingston,5698,1,20,6,10,77,47,30,66
Alloa,5698,2,19,5,12,69,42,27,62
Airdrieon,5698,3,16,8,12,53,58,-5,56
East Fife,5698,4,15,8,13,57,53,4,53
Peterhead,5698,5,15,8,13,51,51,0,53
Brechin,5698,6,15,5,16,47,52,-5,50
Albion,5698,7,12,10,14,54,45,9,46
Queen's Park,5698,8,13,6,17,41,60,-19,45
Stranraer,5698,9,13,5,18,49,53,-4,44
Stenhousem'r,5698,10,8,7,21,39,76,-37,31
Alloa,5699,1,20,5,11,74,44,30,65
Livingston,5699,2,16,11,9,70,47,23,59
Albion,5699,3,17,7,12,73,60,13,58
Airdrieon,5699,4,16,7,13,56,56,0,55
Peterhead,5699,5,15,10,11,52,53,-1,55
Brechin,5699,6,16,7,13,52,54,-2,55
Stranraer,5699,7,14,6,16,50,57,-7,48
Queen's Park,5699,8,11,9,16,32,46,-14,42
East Fife,5699,9,7,12,17,48,55,-7,33
Stenhousem'r,5699,10,6,10,20,46,81,-35,28
Alloa,5700,1,19,11,6,72,37,35,68
Livingston,5700,2,21,5,10,70,52,18,68
Brechin,5700,3,20,3,13,55,41,14,63
Airdrieon,5700,4,16,8,12,55,52,3,56
East Fife,5700,5,15,9,12,50,44,6,54
Queen's Park,5700,6,14,7,15,44,47,-3,49
Peterhead,5700,7,13,8,15,52,56,-4,47
Albion,5700,8,11,8,17,43,48,-5,41
Stranraer,5700,9,10,4,22,46,71,-25,34
Stenhousem'r,5700,10,7,5,24,41,80,-39,26
Alloa,5701,1,22,5,9,76,42,34,71
Brechin,5701,2,21,7,8,60,43,17,70
Livingston,5701,3,21,3,12,71,48,23,66
East Fife,5701,4,14,9,13,57,56,1,51
Airdrieon,5701,5,13,11,12,58,53,5,50
Albion,5701,6,11,9,16,41,51,-10,42
Queen's Park,5701,7,11,8,17,38,55,-17,41
Stranraer,5701,8,12,4,20,52,62,-10,40
Peterhead,5701,9,9,12,15,44,52,-8,39
Stenhousem'r,5701,10,9,6,21,44,79,-35,33
Alloa,5702,1,19,7,10,73,50,23,64
Livingston,5702,2,18,7,11,76,51,25,61
Airdrieon,5702,3,16,9,11,58,60,-2,57
Albion,5702,4,14,12,10,60,49,11,54
Peterhead,5702,5,15,6,15,53,48,5,51
Brechin,5702,6,15,6,15,58,66,-8,51
Queen's Park,5702,7,11,10,15,41,52,-11,43
Stranraer,5702,8,10,10,16,51,57,-6,40
East Fife,5702,9,10,9,17,51,48,3,39
Stenhousem'r,5702,10,9,10,17,53,93,-40,37
Alloa,5703,1,21,8,7,80,39,41,71
Livingston,5703,2,22,4,10,83,49,34,70
Brechin,5703,3,17,9,10,50,39,11,60
Airdrieon,5703,4,17,6,13,49,52,-3,57
Albion,5703,5,14,11,11,53,48,5,53
Peterhead,5703,6,14,10,12,47,45,2,52
East Fife,5703,7,11,7,18,44,54,-10,40
Stranraer,5703,8,11,7,18,43,60,-17,40
Queen's Park,5703,9,8,6,22,29,54,-25,30
Stenhousem'r,5703,10,6,10,20,42,80,-38,28
Alloa,5704,1,22,5,9,73,42,31,71
Brechin,5704,2,17,7,12,47,41,6,58
Livingston,5704,3,16,9,11,72,50,22,57
Albion,5704,4,15,8,13,56,53,3,53
Queen's Park,5704,5,15,8,13,48,50,-2,53
Peterhead,5704,6,14,8,14,47,55,-8,50
Airdrieon,5704,7,14,5,17,52,53,-1,47
Stranraer,5704,8,12,7,17,49,62,-13,43
East Fife,5704,9,8,11,17,46,53,-7,35
Stenhousem'r,5704,10,8,10,18,44,75,-31,34
Livingston,5705,1,20,6,10,67,43,24,66
Peterhead,5705,2,18,8,10,55,41,14,62
Airdrieon,5705,3,18,8,10,60,50,10,62
Alloa,5705,4,15,9,12,55,44,11,54
Brechin,5705,5,14,9,13,45,43,2,51
Albion,5705,6,12,13,11,51,48,3,49
Stranraer,5705,7,14,7,15,46,57,-11,49
East Fife,5705,8,9,11,16,37,41,-4,38
Queen's Park,5705,9,8,10,18,35,57,-22,34
Stenhousem'r,5705,10,6,11,19,48,75,-27,29
Livingston,5706,1,22,7,7,74,42,32,73
Alloa,5706,2,16,8,12,64,47,17,56
Brechin,5706,3,16,6,14,47,44,3,54
Airdrieon,5706,4,15,9,12,54,52,2,54
Stranraer,5706,5,14,8,14,54,52,2,50
Albion,5706,6,13,8,15,51,53,-2,47
Peterhead,5706,7,13,8,15,44,58,-14,47
Queen's Park,5706,8,13,7,16,45,54,-9,46
Stenhousem'r,5706,9,12,6,18,44,58,-14,42
East Fife,5706,10,10,5,21,39,56,-17,35
Livingston,5707,1,21,9,6,77,43,34,72
Alloa,5707,2,19,7,10,82,49,33,64
Brechin,5707,3,18,7,11,51,40,11,61
Airdrieon,5707,4,15,9,12,59,57,2,54
Albion,5707,5,14,8,14,60,60,0,50
Peterhead,5707,6,13,8,15,52,53,-1,47
Queen's Park,5707,7,12,7,17,37,62,-25,43
Stranraer,5707,8,11,8,17,50,64,-14,41
East Fife,5707,9,8,14,14,47,51,-4,38
Stenhousem'r,5707,10,6,9,21,41,77,-36,27
Livingston,5708,1,22,4,10,83,51,32,70
Alloa,5708,2,19,5,12,63,40,23,62
Peterhead,5708,3,16,7,13,60,55,5,55
Airdrieon,5708,4,16,7,13,54,53,1,55
Brechin,5708,5,14,9,13,53,48,5,51
Queen's Park,5708,6,14,9,13,40,43,-3,51
Albion,5708,7,15,5,16,44,48,-4,50
Stranraer,5708,8,13,3,20,46,58,-12,42
East Fife,5708,9,11,8,17,49,56,-7,41
Stenhousem'r,5708,10,8,7,21,43,83,-40,31
Livingston,5709,1,23,0,13,75,51,24,69
Alloa,5709,2,18,11,7,68,39,29,65
Airdrieon,5709,3,17,5,14,55,50,5,56
East Fife,5709,4,15,8,13,54,44,10,53
Peterhead,5709,5,15,7,14,55,58,-3,52
Albion,5709,6,14,8,14,53,50,3,50
Brechin,5709,7,14,6,16,47,53,-6,48
Queen's Park,5709,8,13,6,17,36,53,-17,45
Stranraer,5709,9,12,4,20,48,68,-20,40
Stenhousem'r,5709,10,7,9,20,51,76,-25,30
Livingston,5710,1,19,7,10,76,52,24,64
Brechin,5710,2,19,6,11,53,49,4,63
Airdrieon,5710,3,17,9,10,66,51,15,60
Albion,5710,4,17,6,13,61,50,11,57
Alloa,5710,5,16,7,13,62,46,16,55
Peterhead,5710,6,12,11,13,41,48,-7,47
Queen's Park,5710,7,11,9,16,38,51,-13,42
East Fife,5710,8,11,8,17,47,51,-4,41
Stranraer,5710,9,10,7,19,50,60,-10,37
Stenhousem'r,5710,10,10,6,20,40,76,-36,36
Livingston,5711,1,24,5,7,81,42,39,77
Alloa,5711,2,20,8,8,77,46,31,68
Airdrieon,5711,3,18,5,13,69,49,20,59
Stranraer,5711,4,15,7,14,47,52,-5,52
Brechin,5711,5,16,4,16,50,57,-7,52
Peterhead,5711,6,14,6,16,54,69,-15,48
Albion,5711,7,12,7,17,51,61,-10,43
Queen's Park,5711,8,11,9,16,43,51,-8,42
East Fife,5711,9,10,7,19,44,53,-9,37
Stenhousem'r,5711,10,8,6,22,45,81,-36,30
Brechin,5712,1,20,7,9,60,44,16,67
Alloa,5712,2,19,8,9,88,47,41,65
Livingston,5712,3,18,9,9,77,50,27,63
Albion,5712,4,19,5,12,62,47,15,62
Queen's Park,5712,5,12,10,14,39,52,-13,46
Stranraer,5712,6,12,9,15,56,64,-8,45
Peterhead,5712,7,11,10,15,50,62,-12,43
East Fife,5712,8,11,9,16,45,54,-9,42
Airdrieon,5712,9,11,6,19,51,65,-14,39
Stenhousem'r,5712,10,5,11,20,40,83,-43,26
Alloa,5713,1,19,10,7,77,43,34,67
Livingston,5713,2,19,5,12,73,52,21,62
Peterhead,5713,3,17,8,11,55,49,6,59
Albion,5713,4,16,10,10,58,40,18,58
Airdrieon,5713,5,16,7,13,62,59,3,55
Stranraer,5713,6,13,9,14,45,45,0,48
Brechin,5713,7,14,6,16,41,51,-10,48
East Fife,5713,8,10,10,16,45,53,-8,40
Queen's Park,5713,9,10,5,21,28,51,-23,35
Stenhousem'r,5713,10,7,8,21,40,81,-41,29
Livingston,5714,1,20,9,7,71,46,25,69
Alloa,5714,2,19,3,14,70,49,21,60
Brechin,5714,3,19,3,14,60,52,8,60
Airdrieon,5714,4,17,5,14,57,60,-3,56
Peterhead,5714,5,15,7,14,54,52,2,52
Albion,5714,6,14,6,16,50,54,-4,48
Stranraer,5714,7,13,7,16,53,56,-3,46
Queen's Park,5714,8,13,4,19,41,56,-15,43
East Fife,5714,9,11,7,18,54,55,-1,40
Stenhousem'r,5714,10,10,7,19,52,82,-30,37
Alloa,5715,1,17,11,8,71,40,31,62
Livingston,5715,2,18,8,10,69,45,24,62
Brechin,5715,3,18,6,12,56,52,4,60
Airdrieon,5715,4,18,5,13,68,55,13,59
Peterhead,5715,5,14,7,15,46,54,-8,49
Queen's Park,5715,6,15,4,17,40,49,-9,49
Albion,5715,7,13,7,16,47,56,-9,46
East Fife,5715,8,11,8,17,45,51,-6,41
Stranraer,5715,9,11,6,19,43,64,-21,39
Stenhousem'r,5715,10,10,8,18,57,76,-19,38
Livingston,5716,1,23,3,10,74,40,34,72
Alloa,5716,2,17,9,10,59,42,17,60
Airdrieon,5716,3,17,5,14,60,50,10,56
Brechin,5716,4,16,3,17,45,54,-9,51
Albion,5716,5,15,5,16,51,53,-2,50
Peterhead,5716,6,14,6,16,46,54,-8,48
Queen's Park,5716,7,13,7,16,42,54,-12,46
Stenhousem'r,5716,8,12,8,16,52,66,-14,44
East Fife,5716,9,12,7,17,45,48,-3,43
Stranraer,5716,10,10,9,17,52,65,-13,39
Livingston,5717,1,20,6,10,73,53,20,66
Airdrieon,5717,2,19,7,10,61,56,5,64
Queen's Park,5717,3,17,6,13,40,37,3,57
Albion,5717,4,16,8,12,58,54,4,56
Peterhead,5717,5,17,5,14,58,57,1,56
Alloa,5717,6,16,7,13,71,46,25,55
Brechin,5717,7,16,7,13,54,53,1,55
East Fife,5717,8,11,6,19,43,48,-5,39
Stranraer,5717,9,10,7,19,46,61,-15,37
Stenhousem'r,5717,10,5,7,24,39,78,-39,22
Livingston,5718,1,19,7,10,80,51,29,64
Alloa,5718,2,17,10,9,67,40,27,61
Airdrieon,5718,3,16,10,10,51,47,4,58
Brechin,5718,4,16,7,13,46,43,3,55
Peterhead,5718,5,13,12,11,44,50,-6,51
Albion,5718,6,13,10,13,59,48,11,49
Stranraer,5718,7,14,4,18,54,61,-7,46
Queen's Park,5718,8,12,7,17,37,59,-22,43
East Fife,5718,9,10,11,15,38,47,-9,41
Stenhousem'r,5718,10,7,8,21,46,76,-30,29
Livingston,5719,1,21,7,8,77,41,36,70
Alloa,5719,2,17,8,11,67,47,20,59
Airdrieon,5719,3,15,11,10,60,53,7,56
Brechin,5719,4,17,3,16,44,49,-5,54
Queen's Park,5719,5,16,5,15,49,52,-3,53
East Fife,5719,6,14,10,12,49,41,8,52
Peterhead,5719,7,12,11,13,50,51,-1,47
Stranraer,5719,8,14,4,18,47,62,-15,46
Albion,5719,9,11,7,18,45,52,-7,40
Stenhousem'r,5719,10,6,8,22,44,84,-40,26
Alloa,5720,1,21,5,10,65,47,18,68
Livingston,5720,2,20,6,10,71,46,25,66
Airdrieon,5720,3,19,3,14,54,48,6,60
East Fife,5720,4,16,7,13,56,45,11,55
Albion,5720,5,15,7,14,60,51,9,52
Brechin,5720,6,14,6,16,42,46,-4,48
Stranraer,5720,7,13,3,20,52,64,-12,42
Queen's Park,5720,8,10,11,15,29,43,-14,41
Stenhousem'r,5720,9,12,5,19,40,66,-26,41
Peterhead,5720,10,10,7,19,39,52,-13,37
Alloa,5721,1,21,6,9,73,45,28,69
Livingston,5721,2,19,7,10,84,50,34,64
Albion,5721,3,18,9,9,57,42,15,63
Queen's Park,5721,4,14,10,12,40,43,-3,52
Airdrieon,5721,5,14,8,14,53,55,-2,50
Brechin,5721,6,14,6,16,39,42,-3,48
Peterhead,5721,7,13,9,14,46,57,-11,48
Stranraer,5721,8,11,11,14,49,60,-11,44
East Fife,5721,9,9,8,19,49,57,-8,35
Stenhousem'r,5721,10,6,8,22,41,80,-39,26
Alloa,5722,1,20,10,6,74,38,36,70
Airdrieon,5722,2,19,5,12,58,47,11,62
Livingston,5722,3,17,4,15,64,55,9,55
Brechin,5722,4,16,6,14,45,47,-2,54
East Fife,5722,5,14,11,11,50,40,10,53
Peterhead,5722,6,15,8,13,43,47,-4,53
Albion,5722,7,15,6,15,56,57,-1,51
Queen's Park,5722,8,11,11,14,41,46,-5,44
Stranraer,5722,9,10,4,22,47,68,-21,34
Stenhousem'r,5722,10,7,7,22,45,78,-33,28
Livingston,5723,1,24,4,8,84,46,38,76
Brechin,5723,2,22,3,11,51,36,15,69
Airdrieon,5723,3,19,8,9,64,55,9,65
Alloa,5723,4,19,6,11,71,43,28,63
Peterhead,5723,5,17,7,12,55,45,10,58
Albion,5723,6,13,9,14,55,61,-6,48
Stranraer,5723,7,11,10,15,51,65,-14,43
East Fife,5723,8,9,7,20,42,59,-17,34
Stenhousem'r,5723,9,6,8,22,52,82,-30,26
Queen's Park,5723,10,7,4,25,31,64,-33,25
Alloa,5724,1,23,8,5,75,32,43,77
Livingston,5724,2,22,5,9,73,37,36,71
Brechin,5724,3,17,8,11,55,51,4,59
Albion,5724,4,16,6,14,49,47,2,54
Airdrieon,5724,5,15,6,15,65,59,6,51
Queen's Park,5724,6,13,7,16,43,60,-17,46
East Fife,5724,7,10,12,14,44,50,-6,42
Peterhead,5724,8,11,7,18,38,52,-14,40
Stenhousem'r,5724,9,8,9,19,48,79,-31,33
Stranraer,5724,10,8,6,22,46,69,-23,30
Livingston,5725,1,21,4,11,80,52,28,67
Alloa,5725,2,19,9,8,68,43,25,66
Peterhead,5725,3,15,7,14,56,53,3,52
Brechin,5725,4,14,8,14,48,49,-1,50
Airdrieon,5725,5,13,11,12,57,60,-3,50
Stranraer,5725,6,14,8,14,53,57,-4,50
Albion,5725,7,13,7,16,58,64,-6,46
East Fife,5725,8,10,14,12,47,46,1,44
Queen's Park,5725,9,11,7,18,34,52,-18,40
Stenhousem'r,5725,10,6,13,17,43,68,-25,31
Alloa,5726,1,23,5,8,81,49,32,74
Livingston,5726,2,19,7,10,74,51,23,64
Peterhead,5726,3,17,7,12,55,53,2,58
Stranraer,5726,4,18,3,15,60,51,9,57
Airdrieon,5726,5,15,6,15,54,50,4,51
East Fife,5726,6,14,7,15,50,47,3,49
Brechin,5726,7,13,5,18,44,54,-10,44
Albion,5726,8,12,7,17,55,61,-6,43
Queen's Park,5726,9,12,5,19,36,60,-24,41
Stenhousem'r,5726,10,7,8,21,44,77,-33,29
Livingston,5727,1,23,5,8,88,40,48,74
Alloa,5727,2,20,8,8,77,42,35,68
Brechin,5727,3,18,7,11,56,55,1,61
Airdrieon,5727,4,15,9,12,56,55,1,54
Queen's Park,5727,5,13,6,17,38,54,-16,45
Albion,5727,6,12,8,16,51,63,-12,44
Peterhead,5727,7,11,9,16,42,51,-9,42
Stranraer,5727,8,11,8,17,45,61,-16,41
East Fife,5727,9,8,14,14,50,56,-6,38
Stenhousem'r,5727,10,7,10,19,47,73,-26,31
Livingston,5728,1,21,6,9,77,43,34,69
Brechin,5728,2,18,4,14,51,50,1,58
Albion,5728,3,16,9,11,54,47,7,57
Peterhead,5728,4,16,8,12,61,50,11,56
Alloa,5728,5,16,6,14,65,52,13,54
Queen's Park,5728,6,15,7,14,37,43,-6,52
Stranraer,5728,7,14,6,16,50,56,-6,48
Airdrieon,5728,8,12,10,14,55,71,-16,46
East Fife,5728,9,7,11,18,42,52,-10,32
Stenhousem'r,5728,10,7,9,20,45,73,-28,30
Livingston,5729,1,23,7,6,82,43,39,76
Brechin,5729,2,16,10,10,53,40,13,58
Airdrieon,5729,3,16,8,12,51,48,3,56
Alloa,5729,4,16,6,14,68,55,13,54
Peterhead,5729,5,15,7,14,62,63,-1,52
Queen's Park,5729,6,13,8,15,44,53,-9,47
Albion,5729,7,12,8,16,49,56,-7,44
East Fife,5729,8,11,9,16,54,55,-1,42
Stranraer,5729,9,12,5,19,45,59,-14,41
Stenhousem'r,5729,10,8,8,20,42,78,-36,32
Livingston,5730,1,23,5,8,78,43,35,74
Airdrieon,5730,2,18,7,11,65,54,11,61
Alloa,5730,3,17,8,11,63,49,14,59
Brechin,5730,4,16,8,12,47,38,9,56
Albion,5730,5,15,9,12,58,48,10,54
East Fife,5730,6,13,5,18,52,56,-4,44
Queen's Park,5730,7,11,7,18,34,49,-15,40
Stenhousem'r,5730,8,10,10,16,43,68,-25,40
Stranraer,5730,9,12,3,21,50,70,-20,39
Peterhead,5730,10,10,8,18,40,55,-15,38
Livingston,5731,1,23,4,9,88,51,37,73
Airdrieon,5731,2,18,8,10,65,56,9,62
Alloa,5731,3,14,11,11,62,49,13,53
Brechin,5731,4,15,6,15,47,48,-1,51
Albion,5731,5,13,10,13,54,47,7,49
Peterhead,5731,6,14,6,16,43,55,-12,48
East Fife,5731,7,13,7,16,49,46,3,46
Queen's Park,5731,8,12,8,16,42,53,-11,44
Stranraer,5731,9,11,6,19,53,66,-13,39
Stenhousem'r,5731,10,10,8,18,47,79,-32,38
Alloa,5732,1,22,8,6,82,36,46,74
Livingston,5732,2,23,3,10,71,46,25,72
Airdrieon,5732,3,18,7,11,53,46,7,61
Albion,5732,4,16,6,14,60,52,8,54
Stranraer,5732,5,16,4,16,50,53,-3,52
Peterhead,5732,6,12,10,14,47,53,-6,46
Brechin,5732,7,13,3,20,43,64,-21,42
East Fife,5732,8,11,8,17,49,47,2,41
Queen's Park,5732,9,10,5,21,35,61,-26,35
Stenhousem'r,5732,10,7,10,19,45,77,-32,31
Airdrieon,5733,1,23,6,7,64,43,21,75
Alloa,5733,2,21,7,8,71,41,30,70
Livingston,5733,3,19,3,14,76,53,23,60
Albion,5733,4,15,7,14,55,52,3,52
Brechin,5733,5,15,6,15,47,56,-9,51
Queen's Park,5733,6,14,4,18,51,60,-9,46
Peterhead,5733,7,13,6,17,44,52,-8,45
East Fife,5733,8,10,11,15,42,44,-2,41
Stranraer,5733,9,12,4,20,43,61,-18,40
Stenhousem'r,5733,10,7,8,21,47,78,-31,29
Livingston,5734,1,23,4,9,87,46,41,73
Alloa,5734,2,20,7,9,75,46,29,67
Airdrieon,5734,3,16,6,14,54,61,-7,54
Albion,5734,4,15,5,16,58,55,3,50
East Fife,5734,5,13,10,13,57,51,6,49
Brechin,5734,6,14,7,15,41,42,-1,49
Peterhead,5734,7,14,7,15,49,61,-12,49
Queen's Park,5734,8,14,5,17,40,54,-14,47
Stranraer,5734,9,10,6,20,43,59,-16,36
Stenhousem'r,5734,10,6,13,17,50,79,-29,31
Livingston,5735,1,23,5,8,83,43,40,74
Alloa,5735,2,19,5,12,79,47,32,62
Airdrieon,5735,3,17,7,12,62,51,11,58
Peterhead,5735,4,16,8,12,49,45,4,56
Albion,5735,5,15,9,12,52,53,-1,54
Queen's Park,5735,6,14,7,15,46,57,-11,49
East Fife,5735,7,9,12,15,37,45,-8,39
Stranraer,5735,8,10,9,17,45,56,-11,39
Brechin,5735,9,11,4,21,35,58,-23,37
Stenhousem'r,5735,10,10,6,20,49,82,-33,36
Alloa,5736,1,20,6,10,83,52,31,66
Livingston,5736,2,20,4,12,78,52,26,64
Brechin,5736,3,17,4,15,52,51,1,55
Airdrieon,5736,4,15,10,11,61,61,0,55
Albion,5736,5,13,10,13,55,55,0,49
Stranraer,5736,6,14,7,15,49,53,-4,49
East Fife,5736,7,13,7,16,59,51,8,46
Peterhead,5736,8,12,8,16,43,55,-12,44
Queen's Park,5736,9,12,8,16,38,52,-14,44
Stenhousem'r,5736,10,8,8,20,52,88,-36,32
Livingston,5737,1,20,4,12,79,52,27,64
Alloa,5737,2,17,12,7,74,47,27,63
Airdrieon,5737,3,17,9,10,59,57,2,60
Brechin,5737,4,17,5,14,46,51,-5,56
Peterhead,5737,5,14,9,13,54,51,3,51
Queen's Park,5737,6,15,5,16,31,46,-15,50
Stranraer,5737,7,14,7,15,58,55,3,49
Albion,5737,8,12,7,17,52,56,-4,43
Stenhousem'r,5737,9,8,10,18,58,84,-26,34
East Fife,5737,10,6,12,18,39,51,-12,30
Livingston,5738,1,23,3,10,84,42,42,72
Alloa,5738,2,18,9,9,70,45,25,63
Airdrieon,5738,3,19,3,14,63,59,4,60
Albion,5738,4,17,8,11,52,43,9,59
Brechin,5738,5,17,6,13,51,45,6,57
Peterhead,5738,6,11,11,14,41,47,-6,44
Queen's Park,5738,7,12,6,18,41,52,-11,42
Stranraer,5738,8,12,5,19,50,66,-16,41
East Fife,5738,9,8,12,16,37,49,-12,36
Stenhousem'r,5738,10,8,7,21,40,81,-41,31
Brechin,5739,1,21,6,9,48,29,19,69
Livingston,5739,2,22,2,12,70,42,28,68
Alloa,5739,3,16,9,11,61,39,22,57
Airdrieon,5739,4,16,5,15,66,54,12,53
East Fife,5739,5,13,9,14,50,42,8,48
Stranraer,5739,6,13,9,14,47,56,-9,48
Albion,5739,7,12,9,15,47,54,-7,45
Peterhead,5739,8,13,5,18,45,68,-23,44
Queen's Park,5739,9,10,8,18,24,48,-24,38
Stenhousem'r,5739,10,7,12,17,46,72,-26,33
Livingston,5740,1,23,4,9,85,50,35,73
Alloa,5740,2,20,8,8,65,39,26,68
Brechin,5740,3,19,8,9,55,42,13,65
Peterhead,5740,4,16,10,10,60,50,10,58
Airdrieon,5740,5,12,11,13,52,59,-7,47
Albion,5740,6,11,10,15,47,52,-5,43
Queen's Park,5740,7,11,10,15,41,54,-13,43
East Fife,5740,8,9,10,17,46,55,-9,37
Stranraer,5740,9,8,10,18,45,62,-17,34
Stenhousem'r,5740,10,8,5,23,46,79,-33,29
Livingston,5741,1,24,5,7,84,41,43,77
Alloa,5741,2,22,7,7,83,52,31,73
Brechin,5741,3,19,5,12,59,48,11,62
Airdrieon,5741,4,16,7,13,57,58,-1,55
Albion,5741,5,15,4,17,56,61,-5,49
Stranraer,5741,6,12,6,18,55,59,-4,42
Stenhousem'r,5741,7,12,5,19,49,75,-26,41
East Fife,5741,8,9,12,15,51,57,-6,39
Queen's Park,5741,9,10,7,19,41,66,-25,37
Peterhead,5741,10,9,6,21,47,65,-18,33
Livingston,5742,1,20,7,9,77,48,29,67
Alloa,5742,2,17,10,9,69,49,20,61
Airdrieon,5742,3,19,4,13,66,56,10,61
Brechin,5742,4,18,7,11,54,47,7,61
Stranraer,5742,5,15,7,14,54,48,6,52
Peterhead,5742,6,15,5,16,51,52,-1,50
East Fife,5742,7,12,9,15,52,52,0,45
Queen's Park,5742,8,12,5,19,34,56,-22,41
Stenhousem'r,5742,9,8,10,18,41,70,-29,34
Albion,5742,10,8,8,20,44,64,-20,32
Alloa,5743,1,22,4,10,73,49,24,70
Livingston,5743,2,20,5,11,71,46,25,65
Airdrieon,5743,3,20,5,11,69,55,14,65
Peterhead,5743,4,16,8,12,60,48,12,56
Brechin,5743,5,14,7,15,52,56,-4,49
Albion,5743,6,13,9,14,59,58,1,48
Queen's Park,5743,7,11,8,17,40,58,-18,41
Stranraer,5743,8,12,4,20,51,65,-14,40
Stenhousem'r,5743,9,11,5,20,58,89,-31,38
East Fife,5743,10,9,9,18,48,57,-9,36
Livingston,5744,1,19,5,12,74,45,29,62
Alloa,5744,2,17,8,11,62,39,23,59
Airdrieon,5744,3,18,5,13,61,56,5,59
Albion,5744,4,17,6,13,63,52,11,57
Brechin,5744,5,16,7,13,52,48,4,55
Peterhead,5744,6,14,12,10,48,44,4,54
Stranraer,5744,7,14,5,17,46,50,-4,47
East Fife,5744,8,11,7,18,44,57,-13,40
Queen's Park,5744,9,10,10,16,38,60,-22,40
Stenhousem'r,5744,10,7,9,20,39,76,-37,30
Livingston,5745,1,23,4,9,81,47,34,73
Alloa,5745,2,19,6,11,75,52,23,63
Airdrieon,5745,3,17,5,14,57,52,5,56
Albion,5745,4,15,8,13,56,53,3,53
Brechin,5745,5,16,5,15,53,56,-3,53
East Fife,5745,6,15,6,15,62,50,12,51
Peterhead,5745,7,13,8,15,47,59,-12,47
Queen's Park,5745,8,13,4,19,37,53,-16,43
Stranraer,5745,9,12,5,19,51,65,-14,41
Stenhousem'r,5745,10,7,9,20,46,78,-32,30
Livingston,5746,1,19,8,9,74,52,22,65
Airdrieon,5746,2,19,6,11,69,52,17,63
Brechin,5746,3,15,10,11,43,38,5,55
Alloa,5746,4,15,8,13,64,53,11,53
Peterhead,5746,5,14,8,14,43,48,-5,50
Albion,5746,6,12,12,12,54,48,6,48
East Fife,5746,7,13,8,15,45,46,-1,47
Stranraer,5746,8,14,5,17,44,53,-9,47
Queen's Park,5746,9,13,6,17,39,52,-13,45
Stenhousem'r,5746,10,6,9,21,43,76,-33,27
Alloa,5747,1,21,7,8,72,40,32,70
Livingston,5747,2,20,4,12,79,48,31,64
Airdrieon,5747,3,19,3,14,58,57,1,60
Albion,5747,4,15,8,13,57,65,-8,53
Stranraer,5747,5,16,4,16,59,58,1,52
Peterhead,5747,6,14,7,15,52,55,-3,49
East Fife,5747,7,12,9,15,52,54,-2,45
Brechin,5747,8,13,6,17,38,46,-8,45
Stenhousem'r,5747,9,11,6,19,50,73,-23,39
Queen's Park,5747,10,9,6,21,43,64,-21,33
Livingston,5748,1,24,4,8,90,48,42,76
Alloa,5748,2,17,10,9,64,45,19,61
Brechin,5748,3,17,6,13,57,51,6,57
Airdrieon,5748,4,15,9,12,53,54,-1,54
Albion,5748,5,13,9,14,51,52,-1,48
Stranraer,5748,6,14,6,16,51,56,-5,48
Queen's Park,5748,7,13,6,17,37,55,-18,45
Peterhead,5748,8,12,5,19,50,62,-12,41
East Fife,5748,9,10,10,16,51,53,-2,40
Stenhousem'r,5748,10,7,11,18,49,77,-28,32
Brechin,5749,1,21,5,10,56,38,18,68
Livingston,5749,2,21,2,13,81,51,30,65
Alloa,5749,3,16,10,10,66,46,20,58
Airdrieon,5749,4,17,4,15,47,52,-5,55
Albion,5749,5,14,8,14,55,54,1,50
Peterhead,5749,6,13,9,14,49,53,-4,48
Stenhousem'r,5749,7,14,5,17,59,72,-13,47
Stranraer,5749,8,13,3,20,53,68,-15,42
East Fife,5749,9,9,11,16,46,53,-7,38
Queen's Park,5749,10,10,7,19,31,56,-25,37
Livingston,5750,1,22,4,10,84,53,31,70
Alloa,5750,2,18,10,8,74,47,27,64
Brechin,5750,3,19,4,13,51,44,7,61
East Fife,5750,4,13,11,12,52,43,9,50
Peterhead,5750,5,13,9,14,46,53,-7,48
Albion,5750,6,14,5,17,51,59,-8,47
Airdrieon,5750,7,13,7,16,53,63,-10,46
Stranraer,5750,8,13,6,17,46,59,-13,45
Stenhousem'r,5750,9,10,7,19,54,69,-15,37
Queen's Park,5750,10,8,11,17,32,53,-21,35
Alloa,5751,1,20,10,6,69,40,29,70
Brechin,5751,2,20,5,11,61,47,14,65
Livingston,5751,3,19,7,10,76,44,32,64
Airdrieon,5751,4,16,7,13,59,50,9,55
Albion,5751,5,13,7,16,54,51,3,46
East Fife,5751,6,12,7,17,47,55,-8,43
Stranraer,5751,7,12,7,17,46,57,-11,43
Queen's Park,5751,8,10,11,15,32,43,-11,41
Peterhead,5751,9,10,10,16,35,59,-24,40
Stenhousem'r,5751,10,8,9,19,43,76,-33,33
Livingston,5752,1,20,6,10,84,43,41,66
Airdrieon,5752,2,20,5,11,58,48,10,65
Alloa,5752,3,17,10,9,65,45,20,61
Brechin,5752,4,17,10,9,46,39,7,61
Stranraer,5752,5,16,6,14,59,55,4,54
Peterhead,5752,6,13,9,14,54,59,-5,48
Albion,5752,7,12,8,16,55,58,-3,44
East Fife,5752,8,8,11,17,44,58,-14,35
Queen's Park,5752,9,10,5,21,33,62,-29,35
Stenhousem'r,5752,10,8,8,20,48,79,-31,32
Livingston,5753,1,22,2,12,78,52,26,68
Alloa,5753,2,19,8,9,83,49,34,65
Brechin,5753,3,17,6,13,57,50,7,57
Airdrieon,5753,4,16,8,12,51,51,0,56
Peterhead,5753,5,14,8,14,50,53,-3,50
East Fife,5753,6,14,7,15,46,48,-2,49
Stranraer,5753,7,13,6,17,51,54,-3,45
Queen's Park,5753,8,11,12,13,40,50,-10,45
Albion,5753,9,10,9,17,52,70,-18,39
Stenhousem'r,5753,10,7,8,21,47,78,-31,29
Alloa,5754,1,22,6,8,76,43,33,72
Livingston,5754,2,19,3,14,73,55,18,60
Brechin,5754,3,16,7,13,43,43,0,55
Peterhead,5754,4,15,7,14,48,49,-1,52
Airdrieon,5754,5,14,9,13,50,53,-3,51
Albion,5754,6,14,7,15,50,51,-1,49
Stranraer,5754,7,15,3,18,51,58,-7,48
East Fife,5754,8,12,9,15,50,46,4,45
Queen's Park,5754,9,12,7,17,31,44,-13,43
Stenhousem'r,5754,10,9,6,21,51,81,-30,33
Airdrieon,5755,1,20,8,8,69,52,17,68
Alloa,5755,2,20,6,10,75,42,33,66
Livingston,5755,3,20,6,10,73,48,25,66
Brechin,5755,4,16,5,15,54,48,6,53
Queen's Park,5755,5,15,7,14,34,43,-9,52
Albion,5755,6,14,6,16,48,49,-1,48
Peterhead,5755,7,14,4,18,45,53,-8,46
Stranraer,5755,8,13,5,18,55,68,-13,44
East Fife,5755,9,10,8,18,48,54,-6,38
Stenhousem'r,5755,10,7,7,22,37,81,-44,28
Albion,5756,1,18,7,11,60,44,16,61
Airdrieon,5756,2,17,9,10,65,54,11,60
Alloa,5756,3,16,10,10,69,47,22,58
Stranraer,5756,4,18,4,14,59,53,6,58
Livingston,5756,5,17,5,14,74,64,10,56
Peterhead,5756,6,14,11,11,57,51,6,53
East Fife,5756,7,12,10,14,46,44,2,46
Brechin,5756,8,13,6,17,45,55,-10,45
Queen's Park,5756,9,9,7,20,30,60,-30,34
Stenhousem'r,5756,10,9,5,22,47,80,-33,32
Livingston,5757,1,22,4,10,78,47,31,70
Alloa,5757,2,18,10,8,61,41,20,64
Brechin,5757,3,15,9,12,53,51,2,54
Peterhead,5757,4,14,9,13,52,52,0,51
Airdrieon,5757,5,14,9,13,58,60,-2,51
Albion,5757,6,13,11,12,62,57,5,50
East Fife,5757,7,12,10,14,54,45,9,46
Queen's Park,5757,8,12,7,17,37,59,-22,43
Stranraer,5757,9,10,8,18,51,56,-5,38
Stenhousem'r,5757,10,8,7,21,53,91,-38,31
Livingston,5758,1,21,5,10,70,40,30,68
Brechin,5758,2,20,5,11,64,49,15,65
Airdrieon,5758,3,19,6,11,58,46,12,63
Alloa,5758,4,18,6,12,70,51,19,60
Albion,5758,5,16,11,9,52,38,14,59
East Fife,5758,6,12,10,14,48,49,-1,46
Stranraer,5758,7,13,4,19,47,61,-14,43
Peterhead,5758,8,12,6,18,47,61,-14,42
Queen's Park,5758,9,11,8,17,39,59,-20,41
Stenhousem'r,5758,10,3,9,24,48,89,-41,18
Livingston,5759,1,23,3,10,71,44,27,72
Alloa,5759,2,21,7,8,73,37,36,70
Airdrieon,5759,3,20,3,13,62,51,11,63
Brechin,5759,4,16,6,14,45,49,-4,54
Peterhead,5759,5,14,8,14,48,52,-4,50
Albion,5759,6,13,9,14,45,44,1,48
Stranraer,5759,7,12,6,18,44,65,-21,42
Queen's Park,5759,8,11,8,17,38,47,-9,41
East Fife,5759,9,7,12,17,44,51,-7,33
Stenhousem'r,5759,10,9,6,21,46,76,-30,33
Livingston,5760,1,24,3,9,89,40,49,75
Airdrieon,5760,2,19,7,10,60,51,9,64
Alloa,5760,3,16,13,7,69,42,27,61
Brechin,5760,4,17,6,13,54,61,-7,57
Stranraer,5760,5,14,6,16,53,61,-8,48
Peterhead,5760,6,11,11,14,50,53,-3,44
Queen's Park,5760,7,12,8,16,37,52,-15,44
East Fife,5760,8,10,9,17,45,53,-8,39
Albion,5760,9,11,5,20,46,64,-18,38
Stenhousem'r,5760,10,7,10,19,54,80,-26,31
Peterhead,5761,1,21,4,11,65,58,7,67
Alloa,5761,2,19,8,9,71,44,27,65
Livingston,5761,3,19,7,10,76,49,27,64
Albion,5761,4,15,9,12,56,50,6,54
Brechin,5761,5,15,8,13,52,48,4,53
Airdrieon,5761,6,14,9,13,54,50,4,51
Stranraer,5761,7,13,5,18,46,60,-14,44
Queen's Park,5761,8,10,9,17,38,53,-15,39
East Fife,5761,9,8,13,15,43,53,-10,37
Stenhousem'r,5761,10,7,6,23,49,85,-36,27
Albion,5762,1,21,7,8,67,41,26,70
Livingston,5762,2,21,2,13,77,45,32,65
Queen's Park,5762,3,19,4,13,39,44,-5,61
Alloa,5762,4,15,12,9,62,40,22,57
Airdrieon,5762,5,16,7,13,54,58,-4,55
Brechin,5762,6,14,7,15,50,60,-10,49
Stranraer,5762,7,14,5,17,58,61,-3,47
Peterhead,5762,8,10,11,15,37,52,-15,41
East Fife,5762,9,10,8,18,51,52,-1,38
Stenhousem'r,5762,10,6,5,25,46,88,-42,23
Alloa,5763,1,22,7,7,75,33,42,73
Livingston,5763,2,18,8,10,71,49,22,62
Albion,5763,3,17,6,13,50,47,3,57
Airdrieon,5763,4,16,8,12,50,49,1,56
East Fife,5763,5,15,7,14,51,36,15,52
Brechin,5763,6,15,4,17,45,54,-9,49
Queen's Park,5763,7,14,7,15,39,48,-9,49
Peterhead,5763,8,12,7,17,40,53,-13,43
Stranraer,5763,9,11,4,21,49,65,-16,37
Stenhousem'r,5763,10,7,8,21,45,81,-36,29
Livingston,5764,1,21,5,10,68,41,27,68
Airdrieon,5764,2,18,7,11,70,51,19,61
Alloa,5764,3,17,9,10,69,51,18,60
Peterhead,5764,4,17,5,14,53,49,4,56
Brechin,5764,5,17,4,15,46,42,4,55
Stranraer,5764,6,15,6,15,53,62,-9,51
East Fife,5764,7,14,5,17,54,54,0,47
Albion,5764,8,13,4,19,51,60,-9,43
Queen's Park,5764,9,11,7,18,40,61,-21,40
Stenhousem'r,5764,10,7,8,21,52,85,-33,29
Alloa,5765,1,19,10,7,76,43,33,67
Livingston,5765,2,21,1,14,78,61,17,64
Airdrieon,5765,3,17,8,11,66,54,12,59
Albion,5765,4,15,8,13,53,49,4,53
Peterhead,5765,5,15,8,13,54,51,3,53
Brechin,5765,6,15,6,15,54,57,-3,51
Queen's Park,5765,7,14,8,14,43,48,-5,50
East Fife,5765,8,11,9,16,50,51,-1,42
Stranraer,5765,9,11,6,19,43,60,-17,39
Stenhousem'r,5765,10,7,6,23,46,89,-43,27
Brechin,5766,1,21,7,8,56,42,14,70
Alloa,5766,2,18,11,7,70,39,31,65
Livingston,5766,3,18,5,13,73,53,20,59
East Fife,5766,4,17,6,13,63,42,21,57
Stranraer,5766,5,15,6,15,52,53,-1,51
Airdrieon,5766,6,15,5,16,62,64,-2,50
Albion,5766,7,11,10,15,43,52,-9,43
Peterhead,5766,8,11,8,17,44,63,-19,41
Queen's Park,5766,9,9,10,17,30,56,-26,37
Stenhousem'r,5766,10,8,6,22,52,81,-29,30
Alloa,5767,1,19,9,8,70,44,26,66
Livingston,5767,2,19,4,13,68,51,17,61
Brechin,5767,3,16,7,13,49,45,4,55
Airdrieon,5767,4,14,11,11,56,54,2,53
Peterhead,5767,5,14,11,11,51,52,-1,53
Albion,5767,6,11,11,14,54,57,-3,44
Stranraer,5767,7,13,4,19,56,60,-4,43
Queen's Park,5767,8,11,9,16,36,51,-15,42
Stenhousem'r,5767,9,11,9,16,54,74,-20,42
East Fife,5767,10,8,13,15,40,46,-6,37
Alloa,5768,1,23,7,6,77,38,39,76
Livingston,5768,2,20,6,10,77,47,30,66
Airdrieon,5768,3,18,6,12,57,56,1,60
East Fife,5768,4,14,10,12,57,54,3,52
Brechin,5768,5,13,9,14,51,51,0,48
Stranraer,5768,6,14,5,17,54,53,1,47
Peterhead,5768,7,13,6,17,47,58,-11,45
Queen's Park,5768,8,12,9,15,34,47,-13,45
Albion,5768,9,12,7,17,47,57,-10,43
Stenhousem'r,5768,10,5,7,24,49,89,-40,22
Livingston,5769,1,23,4,9,83,45,38,73
Alloa,5769,2,16,9,11,69,54,15,57
Brechin,5769,3,16,7,13,50,47,3,55
Airdrieon,5769,4,16,7,13,60,62,-2,55
Albion,5769,5,16,6,14,55,44,11,54
Peterhead,5769,6,15,6,15,47,55,-8,51
Stranraer,5769,7,12,8,16,49,52,-3,44
Queen's Park,5769,8,11,8,17,33,52,-19,41
East Fife,5769,9,11,7,18,53,57,-4,40
Stenhousem'r,5769,10,9,8,19,50,81,-31,35
Brechin,5770,1,22,3,11,62,41,21,69
Livingston,5770,2,20,5,11,76,54,22,65
Alloa,5770,3,17,8,11,71,49,22,59
Albion,5770,4,15,9,12,59,53,6,54
Peterhead,5770,5,15,8,13,47,45,2,53
Airdrieon,5770,6,14,8,14,49,45,4,50
Queen's Park,5770,7,14,7,15,45,51,-6,49
Stranraer,5770,8,10,7,19,43,63,-20,37
East Fife,5770,9,9,9,18,50,61,-11,36
Stenhousem'r,5770,10,9,6,21,49,89,-40,33
Livingston,5771,1,22,2,12,71,45,26,68
Alloa,5771,2,18,10,8,80,44,36,64
Airdrieon,5771,3,18,5,13,54,54,0,59
Peterhead,5771,4,15,8,13,54,53,1,53
East Fife,5771,5,15,7,14,57,58,-1,52
Albion,5771,6,14,9,13,55,53,2,51
Brechin,5771,7,14,8,14,49,51,-2,50
Queen's Park,5771,8,11,7,18,38,52,-14,40
Stenhousem'r,5771,9,9,10,17,47,71,-24,37
Stranraer,5771,10,9,4,23,47,71,-24,31
Airdrieon,5772,1,20,8,8,57,49,8,68
Livingston,5772,2,19,7,10,83,50,33,64
Alloa,5772,3,18,9,9,76,35,41,63
Albion,5772,4,15,10,11,61,52,9,55
Brechin,5772,5,15,7,14,50,49,1,52
Queen's Park,5772,6,14,6,16,36,54,-18,48
East Fife,5772,7,11,12,13,51,46,5,45
Stranraer,5772,8,12,7,17,46,60,-14,43
Peterhead,5772,9,11,8,17,44,61,-17,41
Stenhousem'r,5772,10,4,8,24,38,86,-48,20
Livingston,5773,1,24,4,8,82,42,40,76
Alloa,5773,2,18,10,8,68,45,23,64
Brechin,5773,3,14,11,11,48,45,3,53
Albion,5773,4,14,10,12,52,53,-1,52
Stranraer,5773,5,14,8,14,45,47,-2,50
Airdrieon,5773,6,14,6,16,54,60,-6,48
East Fife,5773,7,11,12,13,50,52,-2,45
Peterhead,5773,8,11,10,15,47,53,-6,43
Queen's Park,5773,9,10,9,17,33,47,-14,39
Stenhousem'r,5773,10,6,8,22,45,80,-35,26
Livingston,5774,1,27,3,6,77,39,38,84
Alloa,5774,2,18,8,10,70,44,26,62
Brechin,5774,3,15,10,11,53,47,6,55
Albion,5774,4,15,6,15,50,46,4,51
Stranraer,5774,5,15,5,16,49,52,-3,50
Queen's Park,5774,6,14,7,15,37,46,-9,49
East Fife,5774,7,13,9,14,44,46,-2,48
Airdrieon,5774,8,12,6,18,52,60,-8,42
Peterhead,5774,9,11,6,19,39,53,-14,39
Stenhousem'r,5774,10,7,6,23,32,70,-38,27
Airdrieon,5775,1,24,5,7,72,47,25,77
Livingston,5775,2,22,2,12,74,50,24,68
Brechin,5775,3,17,8,11,53,41,12,59
Alloa,5775,4,14,9,13,62,52,10,51
Queen's Park,5775,5,15,6,15,40,50,-10,51
Stranraer,5775,6,14,8,14,63,60,3,50
Albion,5775,7,13,9,14,50,50,0,48
East Fife,5775,8,10,10,16,45,48,-3,40
Peterhead,5775,9,8,8,20,39,61,-22,32
Stenhousem'r,5775,10,5,11,20,35,74,-39,26
Alloa,5776,1,21,6,9,69,41,28,69
Airdrieon,5776,2,18,9,9,58,44,14,63
Livingston,5776,3,19,4,13,62,48,14,61
Brechin,5776,4,16,8,12,54,41,13,56
Albion,5776,5,14,6,16,60,55,5,48
Peterhead,5776,6,13,9,14,44,52,-8,48
Queen's Park,5776,7,14,6,16,40,52,-12,48
Stranraer,5776,8,13,6,17,49,54,-5,45
East Fife,5776,9,10,11,15,45,55,-10,41
Stenhousem'r,5776,10,6,7,23,46,85,-39,25
Livingston,5777,1,22,6,8,75,43,32,72
Alloa,5777,2,19,6,11,68,43,25,63
Albion,5777,3,17,7,12,56,45,11,58
Queen's Park,5777,4,15,8,13,37,46,-9,53
Brechin,5777,5,14,9,13,54,49,5,51
Airdrieon,5777,6,14,8,14,59,66,-7,50
East Fife,5777,7,12,9,15,46,50,-4,45
Stranraer,5777,8,11,7,18,51,62,-11,40
Peterhead,5777,9,10,9,17,48,52,-4,39
Stenhousem'r,5777,10,8,7,21,44,82,-38,31
Livingston,5778,1,23,5,8,84,46,38,74
Peterhead,5778,2,20,6,10,63,49,14,66
Alloa,5778,3,17,5,14,77,60,17,56
Albion,5778,4,15,9,12,70,57,13,54
Queen's Park,5778,5,15,8,13,48,55,-7,53
Airdrieon,5778,6,16,4,16,63,63,0,52
Brechin,5778,7,14,7,15,46,53,-7,49
East Fife,5778,8,9,9,18,48,56,-8,36
Stranraer,5778,9,10,4,22,43,72,-29,34
Stenhousem'r,5778,10,8,9,19,51,82,-31,33
Alloa,5779,1,22,8,6,75,35,40,74
Livingston,5779,2,20,6,10,76,56,20,66
Peterhead,5779,3,12,14,10,43,47,-4,50
Brechin,5779,4,13,8,15,42,43,-1,47
Airdrieon,5779,5,13,8,15,55,63,-8,47
Stranraer,5779,6,13,7,16,51,56,-5,46
Albion,5779,7,12,9,15,45,49,-4,45
Queen's Park,5779,8,13,5,18,38,46,-8,44
East Fife,5779,9,10,10,16,49,59,-10,40
Stenhousem'r,5779,10,10,9,17,49,69,-20,39
Livingston,5780,1,22,6,8,67,38,29,72
Alloa,5780,2,19,7,10,66,43,23,64
Brechin,5780,3,19,6,11,61,45,16,63
Queen's Park,5780,4,16,8,12,47,45,2,56
Peterhead,5780,5,13,9,14,50,52,-2,48
East Fife,5780,6,12,11,13,52,51,1,47
Airdrieon,5780,7,12,10,14,50,47,3,46
Albion,5780,8,12,7,17,44,59,-15,43
Stranraer,5780,9,12,6,18,46,59,-13,42
Stenhousem'r,5780,10,5,6,25,39,83,-44,21
Airdrieon,5781,1,21,5,10,72,50,22,68
Alloa,5781,2,20,7,9,65,38,27,67
Livingston,5781,3,19,5,12,68,60,8,62
Peterhead,5781,4,15,8,13,60,47,13,53
Brechin,5781,5,15,6,15,54,55,-1,51
East Fife,5781,6,12,9,15,44,46,-2,45
Queen's Park,5781,7,12,9,15,42,58,-16,45
Albion,5781,8,11,11,14,45,50,-5,44
Stranraer,5781,9,13,2,21,59,63,-4,41
Stenhousem'r,5781,10,8,6,22,41,83,-42,30
Livingston,5782,1,21,4,11,78,45,33,67
Queen's Park,5782,2,19,5,12,51,41,10,62
Airdrieon,5782,3,17,7,12,57,55,2,58
Alloa,5782,4,16,9,11,73,49,24,57
Brechin,5782,5,17,6,13,46,45,1,57
Stranraer,5782,6,16,4,16,50,55,-5,52
Albion,5782,7,14,7,15,55,55,0,49
Peterhead,5782,8,13,5,18,51,57,-6,44
East Fife,5782,9,11,8,17,44,51,-7,41
Stenhousem'r,5782,10,5,7,24,39,91,-52,22
Livingston,5783,1,17,8,11,79,54,25,59
Alloa,5783,2,17,8,11,63,47,16,59
East Fife,5783,3,16,9,11,51,44,7,57
Brechin,5783,4,16,8,12,56,51,5,56
Airdrieon,5783,5,17,3,16,57,53,4,54
Albion,5783,6,11,16,9,59,51,8,49
Queen's Park,5783,7,13,6,17,36,48,-12,45
Peterhead,5783,8,13,5,18,41,52,-11,44
Stranraer,5783,9,11,7,18,41,59,-18,40
Stenhousem'r,5783,10,11,6,19,53,77,-24,39
Livingston,5784,1,24,3,9,78,48,30,75
Alloa,5784,2,19,5,12,64,42,22,62
Airdrieon,5784,3,18,7,11,57,43,14,61
Stranraer,5784,4,15,6,15,52,53,-1,51
Brechin,5784,5,15,6,15,43,48,-5,51
Albion,5784,6,14,8,14,59,52,7,50
Peterhead,5784,7,13,10,13,48,50,-2,49
Queen's Park,5784,8,11,7,18,33,49,-16,40
East Fife,5784,9,9,10,17,43,56,-13,37
Stenhousem'r,5784,10,8,6,22,47,83,-36,30
Brechin,5785,1,21,5,10,54,50,4,68
Livingston,5785,2,20,4,12,78,53,25,64
Alloa,5785,3,17,9,10,67,41,26,60
Airdrieon,5785,4,17,9,10,52,40,12,60
East Fife,5785,5,14,10,12,56,48,8,52
Albion,5785,6,11,12,13,52,53,-1,45
Stranraer,5785,7,11,9,16,49,60,-11,42
Peterhead,5785,8,10,10,16,44,52,-8,40
Queen's Park,5785,9,9,7,20,33,58,-25,34
Stenhousem'r,5785,10,8,9,19,49,79,-30,33
Brechin,5786,1,17,12,7,55,38,17,63
Alloa,5786,2,17,11,8,69,45,24,62
Airdrieon,5786,3,18,8,10,62,46,16,62
Livingston,5786,4,18,7,11,64,46,18,61
Queen's Park,5786,5,14,8,14,54,53,1,50
Albion,5786,6,14,7,15,53,57,-4,49
Stranraer,5786,7,13,7,16,44,61,-17,46
Peterhead,5786,8,12,5,19,46,58,-12,41
East Fife,5786,9,10,9,17,52,54,-2,39
Stenhousem'r,5786,10,7,6,23,40,81,-41,27
Livingston,5787,1,27,1,8,79,40,39,82
Alloa,5787,2,18,7,11,69,45,24,61
Brechin,5787,3,19,3,14,49,35,14,60
Peterhead,5787,4,16,8,12,58,52,6,56
Airdrieon,5787,5,17,5,14,52,56,-4,56
Stranraer,5787,6,12,6,18,39,55,-16,42
Albion,5787,7,11,8,17,49,62,-13,41
East Fife,5787,8,9,12,15,47,50,-3,39
Queen's Park,5787,9,10,6,20,32,51,-19,36
Stenhousem'r,5787,10,9,8,19,42,70,-28,35
Livingston,5788,1,21,6,9,78,52,26,69
Brechin,5788,2,21,5,10,68,46,22,68
Alloa,5788,3,19,9,8,74,42,32,66
Airdrieon,5788,4,14,11,11,54,53,1,53
Peterhead,5788,5,14,9,13,48,52,-4,51
Albion,5788,6,13,8,15,45,43,2,47
Queen's Park,5788,7,12,10,14,41,54,-13,46
Stranraer,5788,8,10,8,18,43,57,-14,38
East Fife,5788,9,7,10,19,46,64,-18,31
Stenhousem'r,5788,10,7,8,21,46,80,-34,29
Livingston,5789,1,24,4,8,81,37,44,76
Alloa,5789,2,19,8,9,73,41,32,65
Airdrieon,5789,3,18,6,12,64,59,5,60
Peterhead,5789,4,16,8,12,58,52,6,56
Brechin,5789,5,16,5,15,57,51,6,53
Queen's Park,5789,6,15,3,18,43,55,-12,48
Stranraer,5789,7,12,7,17,55,67,-12,43
East Fife,5789,8,11,8,17,42,50,-8,41
Albion,5789,9,10,10,16,52,58,-6,40
Stenhousem'r,5789,10,6,7,23,40,95,-55,25
Alloa,5790,1,18,13,5,78,39,39,67
Brechin,5790,2,18,6,12,53,49,4,60
Livingston,5790,3,17,7,12,68,50,18,58
East Fife,5790,4,16,8,12,57,47,10,56
Stranraer,5790,5,14,4,18,49,59,-10,46
Queen's Park,5790,6,12,10,14,34,44,-10,46
Airdrieon,5790,7,12,8,16,52,56,-4,44
Albion,5790,8,10,12,14,51,60,-9,42
Peterhead,5790,9,12,6,18,49,63,-14,42
Stenhousem'r,5790,10,11,6,19,52,76,-24,39
Livingston,5791,1,22,4,10,71,46,25,70
Alloa,5791,2,20,7,9,69,41,28,67
Airdrieon,5791,3,18,10,8,66,47,19,64
Albion,5791,4,18,6,12,59,50,9,60
Peterhead,5791,5,14,11,11,49,39,10,53
East Fife,5791,6,12,11,13,49,45,4,47
Brechin,5791,7,12,10,14,48,54,-6,46
Stranraer,5791,8,10,8,18,47,57,-10,38
Queen's Park,5791,9,10,7,19,27,51,-24,37
Stenhousem'r,5791,10,3,8,25,31,86,-55,17
Livingston,5792,1,24,4,8,93,48,45,76
Alloa,5792,2,20,7,9,74,45,29,67
Airdrieon,5792,3,18,5,13,68,63,5,59
Albion,5792,4,15,11,10,58,52,6,56
Peterhead,5792,5,15,6,15,52,54,-2,51
Brechin,5792,6,14,6,16,53,61,-8,48
Stranraer,5792,7,13,6,17,53,57,-4,45
Queen's Park,5792,8,10,10,16,38,57,-19,40
East Fife,5792,9,7,13,16,42,52,-10,34
Stenhousem'r,5792,10,8,4,24,45,87,-42,28
Livingston,5793,1,22,3,11,73,47,26,69
Albion,5793,2,21,6,9,58,36,22,69
Alloa,5793,3,19,9,8,65,32,33,66
Airdrieon,5793,4,19,8,9,63,48,15,65
Brechin,5793,5,14,9,13,47,45,2,51
Peterhead,5793,6,14,9,13,46,45,1,51
East Fife,5793,7,10,9,17,42,49,-7,39
Stranraer,5793,8,11,6,19,39,61,-22,39
Queen's Park,5793,9,6,9,21,23,58,-35,27
Stenhousem'r,5793,10,5,10,21,39,74,-35,25
Alloa,5794,1,21,9,6,74,43,31,72
Livingston,5794,2,18,5,13,73,57,16,59
Airdrieon,5794,3,18,4,14,62,55,7,58
Brechin,5794,4,16,7,13,54,56,-2,55
Queen's Park,5794,5,14,8,14,46,49,-3,50
Albion,5794,6,13,10,13,49,45,4,49
Peterhead,5794,7,13,8,15,48,53,-5,47
Stranraer,5794,8,12,9,15,49,57,-8,45
East Fife,5794,9,10,10,16,48,49,-1,40
Stenhousem'r,5794,10,5,10,21,43,82,-39,25
Livingston,5795,1,21,6,9,76,52,24,69
Brechin,5795,2,19,7,10,45,35,10,64
Alloa,5795,3,18,7,11,71,42,29,61
Albion,5795,4,17,10,9,55,42,13,61
Airdrieon,5795,5,18,6,12,57,48,9,60
Peterhead,5795,6,15,9,12,54,52,2,54
Stranraer,5795,7,9,9,18,48,64,-16,36
East Fife,5795,8,9,8,19,45,58,-13,35
Queen's Park,5795,9,8,8,20,31,54,-23,32
Stenhousem'r,5795,10,8,6,22,40,75,-35,30
Alloa,5796,1,20,8,8,84,49,35,68
Livingston,5796,2,20,7,9,75,48,27,67
Airdrieon,5796,3,20,6,10,59,49,10,66
Queen's Park,5796,4,15,7,14,45,53,-8,52
Peterhead,5796,5,12,10,14,52,59,-7,46
Stranraer,5796,6,13,6,17,49,53,-4,45
Brechin,5796,7,12,8,16,51,58,-7,44
East Fife,5796,8,10,10,16,47,52,-5,40
Albion,5796,9,8,13,15,49,59,-10,37
Stenhousem'r,5796,10,7,11,18,42,73,-31,32
Livingston,5797,1,24,4,8,82,46,36,76
Brechin,5797,2,19,5,12,53,43,10,62
Alloa,5797,3,15,11,10,67,48,19,56
Airdrieon,5797,4,15,11,10,58,49,9,56
Albion,5797,5,13,11,12,66,55,11,50
East Fife,5797,6,14,6,16,53,48,5,48
Peterhead,5797,7,13,9,14,42,47,-5,48
Queen's Park,5797,8,11,9,16,32,53,-21,42
Stranraer,5797,9,11,5,20,47,65,-18,38
Stenhousem'r,5797,10,5,9,22,37,83,-46,24
Brechin,5798,1,19,8,9,52,39,13,65
Alloa,5798,2,18,7,11,67,41,26,61
Livingston,5798,3,20,1,15,71,60,11,61
Queen's Park,5798,4,17,4,15,44,57,-13,55
Airdrieon,5798,5,14,11,11,58,50,8,53
Peterhead,5798,6,13,8,15,57,60,-3,47
Stranraer,5798,7,12,7,17,58,65,-7,43
Stenhousem'r,5798,8,12,6,18,58,79,-21,42
Albion,5798,9,11,8,17,50,61,-11,41
East Fife,5798,10,9,10,17,48,51,-3,37
Livingston,5799,1,24,2,10,85,54,31,74
Alloa,5799,2,18,6,12,66,51,15,60
Peterhead,5799,3,16,8,12,51,53,-2,56
Airdrieon,5799,4,15,8,13,50,51,-1,53
Queen's Park,5799,5,15,7,14,38,39,-1,52
Brechin,5799,6,15,7,14,46,48,-2,52
East Fife,5799,7,12,8,16,51,45,6,44
Albion,5799,8,12,8,16,55,57,-2,44
Stranraer,5799,9,14,2,20,50,61,-11,44
Stenhousem'r,5799,10,7,8,21,41,74,-33,29
Livingston,5800,1,20,7,9,76,45,31,67
Alloa,5800,2,19,8,9,78,53,25,65
Brechin,5800,3,20,5,11,60,58,2,65
Airdrieon,5800,4,17,5,14,56,53,3,56
East Fife,5800,5,12,11,13,57,53,4,47
Albion,5800,6,13,8,15,52,53,-1,47
Stranraer,5800,7,11,10,15,49,57,-8,43
Peterhead,5800,8,12,6,18,55,63,-8,42
Queen's Park,5800,9,10,7,19,41,63,-22,37
Stenhousem'r,5800,10,8,9,19,43,69,-26,33
Airdrieon,5801,1,19,7,10,60,44,16,64
Livingston,5801,2,18,7,11,74,55,19,61
Alloa,5801,3,16,7,13,66,43,23,55
Peterhead,5801,4,16,7,13,47,45,2,55
East Fife,5801,5,15,9,12,51,43,8,54
Brechin,5801,6,14,12,10,52,47,5,54
Albion,5801,7,14,6,16,48,57,-9,48
Queen's Park,5801,8,13,3,20,38,54,-16,42
Stranraer,5801,9,11,8,17,48,64,-16,41
Stenhousem'r,5801,10,5,12,19,43,75,-32,27
Livingston,5802,1,21,5,10,82,50,32,68
Alloa,5802,2,20,5,11,66,47,19,65
Airdrieon,5802,3,17,6,13,62,57,5,57
Brechin,5802,4,15,9,12,49,49,0,54
Peterhead,5802,5,14,9,13,56,53,3,51
Stranraer,5802,6,14,9,13,55,52,3,51
Queen's Park,5802,7,14,7,15,39,52,-13,49
Albion,5802,8,12,10,14,57,55,2,46
East Fife,5802,9,7,10,19,45,55,-10,31
Stenhousem'r,5802,10,6,10,20,42,83,-41,28
Livingston,5803,1,16,10,10,69,49,20,58
Peterhead,5803,2,16,10,10,60,52,8,58
Brechin,5803,3,15,12,9,51,42,9,57
Alloa,5803,4,16,7,13,59,49,10,55
Stranraer,5803,5,14,10,12,44,41,3,52
Airdrieon,5803,6,14,9,13,54,60,-6,51
East Fife,5803,7,12,9,15,48,45,3,45
Albion,5803,8,11,11,14,51,52,-1,44
Queen's Park,5803,9,11,7,18,35,50,-15,40
Stenhousem'r,5803,10,9,7,20,45,76,-31,34
Airdrieon,5804,1,18,11,7,68,56,12,65
Livingston,5804,2,18,7,11,76,54,22,61
Brechin,5804,3,19,4,13,61,47,14,61
Alloa,5804,4,17,8,11,64,41,23,59
Albion,5804,5,14,8,14,50,52,-2,50
Peterhead,5804,6,11,12,13,40,50,-10,45
Queen's Park,5804,7,12,8,16,32,46,-14,44
East Fife,5804,8,10,11,15,42,47,-5,41
Stranraer,5804,9,10,9,17,51,59,-8,39
Stenhousem'r,5804,10,8,8,20,43,75,-32,32
Livingston,5805,1,19,6,11,86,57,29,63
Peterhead,5805,2,18,6,12,52,41,11,60
Airdrieon,5805,3,17,8,11,57,51,6,59
Brechin,5805,4,16,10,10,55,45,10,58
Albion,5805,5,16,5,15,48,50,-2,53
Alloa,5805,6,13,12,11,59,46,13,51
Stranraer,5805,7,13,6,17,49,58,-9,45
East Fife,5805,8,10,8,18,43,53,-10,38
Stenhousem'r,5805,9,10,8,18,48,78,-30,38
Queen's Park,5805,10,10,7,19,38,56,-18,37
Livingston,5806,1,26,5,5,84,41,43,83
Alloa,5806,2,19,7,10,73,44,29,64
Airdrieon,5806,3,18,7,11,59,47,12,61
Albion,5806,4,16,7,13,58,45,13,55
Brechin,5806,5,17,3,16,47,47,0,54
East Fife,5806,6,13,8,15,40,39,1,47
Peterhead,5806,7,10,10,16,42,56,-14,40
Stranraer,5806,8,11,6,19,50,75,-25,39
Stenhousem'r,5806,9,9,6,21,52,86,-34,33
Queen's Park,5806,10,7,9,20,35,60,-25,30
Alloa,5807,1,18,9,9,78,48,30,63
Airdrieon,5807,2,18,8,10,57,49,8,62
Livingston,5807,3,18,7,11,77,49,28,61
Brechin,5807,4,17,7,12,52,51,1,58
Stranraer,5807,5,15,4,17,58,62,-4,49
Queen's Park,5807,6,12,11,13,41,43,-2,47
Peterhead,5807,7,13,7,16,47,60,-13,46
East Fife,5807,8,11,10,15,44,48,-4,43
Albion,5807,9,11,10,15,54,59,-5,43
Stenhousem'r,5807,10,8,5,23,47,86,-39,29
Alloa,5808,1,21,7,8,64,32,32,70
Livingston,5808,2,20,4,12,76,56,20,64
Airdrieon,5808,3,18,10,8,60,45,15,64
Queen's Park,5808,4,16,7,13,39,43,-4,55
Albion,5808,5,13,11,12,61,51,10,50
Brechin,5808,6,14,7,15,39,49,-10,49
Peterhead,5808,7,13,7,16,44,54,-10,46
East Fife,5808,8,11,9,16,47,47,0,42
Stranraer,5808,9,9,6,21,40,63,-23,33
Stenhousem'r,5808,10,7,8,21,48,78,-30,29
Livingston,5809,1,20,7,9,75,49,26,67
Alloa,5809,2,19,7,10,72,42,30,64
Airdrieon,5809,3,16,6,14,62,65,-3,54
Stranraer,5809,4,14,8,14,58,60,-2,50
Queen's Park,5809,5,13,7,16,46,51,-5,46
Brechin,5809,6,13,7,16,52,65,-13,46
Stenhousem'r,5809,7,13,7,16,47,69,-22,46
Peterhead,5809,8,13,5,18,47,54,-7,44
Albion,5809,9,12,8,16,42,49,-7,44
East Fife,5809,10,11,10,15,53,50,3,43
Livingston,5810,1,23,4,9,81,46,35,73
Alloa,5810,2,20,8,8,81,42,39,68
Airdrieon,5810,3,19,6,11,59,50,9,63
Brechin,5810,4,17,5,14,40,45,-5,56
Albion,5810,5,16,4,16,50,45,5,52
Queen's Park,5810,6,14,4,18,30,44,-14,46
East Fife,5810,7,12,8,16,43,45,-2,44
Peterhead,5810,8,11,8,17,43,51,-8,41
Stranraer,5810,9,10,6,20,49,69,-20,36
Stenhousem'r,5810,10,8,7,21,47,86,-39,31
Alloa,5811,1,20,8,8,62,37,25,68
Livingston,5811,2,18,4,14,70,51,19,58
Airdrieon,5811,3,15,10,11,59,59,0,55
Albion,5811,4,15,6,15,54,47,7,51
Brechin,5811,5,14,9,13,47,48,-1,51
Queen's Park,5811,6,15,5,16,36,44,-8,50
East Fife,5811,7,14,7,15,48,46,2,49
Stranraer,5811,8,12,7,17,53,59,-6,43
Stenhousem'r,5811,9,12,5,19,54,82,-28,41
Peterhead,5811,10,10,9,17,45,55,-10,39
Livingston,5812,1,23,3,10,77,39,38,72
Alloa,5812,2,19,10,7,72,43,29,67
Brechin,5812,3,20,3,13,55,52,3,63
Peterhead,5812,4,17,6,13,57,51,6,57
Airdrieon,5812,5,16,7,13,61,61,0,55
Stranraer,5812,6,12,9,15,49,54,-5,45
Albion,5812,7,12,7,17,40,59,-19,43
Queen's Park,5812,8,11,6,19,40,53,-13,39
Stenhousem'r,5812,9,9,8,19,56,79,-23,35
East Fife,5812,10,7,9,20,49,65,-16,30
Livingston,5813,1,23,3,10,80,47,33,72
Alloa,5813,2,17,8,11,75,46,29,59
Airdrieon,5813,3,16,11,9,74,57,17,59
Stranraer,5813,4,17,6,13,60,61,-1,57
Brechin,5813,5,16,5,15,52,56,-4,53
Peterhead,5813,6,15,7,14,53,61,-8,52
Albion,5813,7,16,3,17,53,59,-6,51
East Fife,5813,8,11,7,18,47,47,0,40
Queen's Park,5813,9,11,7,18,40,57,-17,40
Stenhousem'r,5813,10,6,7,23,45,88,-43,25
Airdrieon,5814,1,20,6,10,60,54,6,66
Alloa,5814,2,19,8,9,68,40,28,65
Livingston,5814,3,20,3,13,70,45,25,63
Brechin,5814,4,17,5,14,51,48,3,56
Peterhead,5814,5,16,7,13,54,53,1,55
Stranraer,5814,6,15,5,16,54,56,-2,50
Queen's Park,5814,7,11,9,16,34,48,-14,42
East Fife,5814,8,10,8,18,44,54,-10,38
Albion,5814,9,9,9,18,43,55,-12,36
Stenhousem'r,5814,10,9,8,19,48,73,-25,35
Brechin,5815,1,20,7,9,58,37,21,67
Alloa,5815,2,18,7,11,71,43,28,61
Livingston,5815,3,19,4,13,81,55,26,61
Airdrieon,5815,4,16,8,12,61,57,4,56
Albion,5815,5,15,9,12,58,56,2,54
East Fife,5815,6,13,11,12,49,43,6,50
Peterhead,5815,7,13,7,16,43,54,-11,46
Queen's Park,5815,8,11,9,16,40,63,-23,42
Stranraer,5815,9,10,7,19,51,65,-14,37
Stenhousem'r,5815,10,5,11,20,40,79,-39,26
Alloa,5816,1,18,11,7,74,41,33,65
Livingston,5816,2,20,5,11,75,44,31,65
Airdrieon,5816,3,18,5,13,59,60,-1,59
Peterhead,5816,4,17,4,15,48,48,0,55
Brechin,5816,5,16,5,15,46,51,-5,53
Albion,5816,6,14,7,15,60,53,7,49
East Fife,5816,7,12,8,16,44,49,-5,44
Stranraer,5816,8,12,6,18,49,60,-11,42
Queen's Park,5816,9,9,12,15,38,55,-17,39
Stenhousem'r,5816,10,9,7,20,46,78,-32,34
Livingston,5817,1,20,8,8,71,47,24,68
Airdrieon,5817,2,19,9,8,66,47,19,66
Alloa,5817,3,20,5,11,77,50,27,65
Brechin,5817,4,17,7,12,45,41,4,58
Queen's Park,5817,5,14,8,14,42,47,-5,50
Albion,5817,6,13,8,15,55,55,0,47
Stranraer,5817,7,12,6,18,49,56,-7,42
Peterhead,5817,8,10,11,15,43,51,-8,41
East Fife,5817,9,10,8,18,44,54,-10,38
Stenhousem'r,5817,10,6,8,22,39,83,-44,26
Livingston,5818,1,21,6,9,72,37,35,69
Alloa,5818,2,20,7,9,67,42,25,67
Peterhead,5818,3,16,8,12,50,43,7,56
Brechin,5818,4,17,3,16,54,59,-5,54
East Fife,5818,5,14,8,14,48,39,9,50
Queen's Park,5818,6,14,6,16,38,45,-7,48
Airdrieon,5818,7,14,5,17,58,69,-11,47
Albion,5818,8,12,10,14,48,54,-6,46
Stranraer,5818,9,10,5,21,46,67,-21,35
Stenhousem'r,5818,10,9,8,19,50,76,-26,35
Livingston,5819,1,23,3,10,76,38,38,72
Alloa,5819,2,20,8,8,79,48,31,68
Airdrieon,5819,3,19,6,11,66,56,10,63
Brechin,5819,4,17,5,14,59,54,5,56
East Fife,5819,5,15,6,15,54,46,8,51
Albion,5819,6,12,10,14,49,53,-4,46
Stranraer,5819,7,12,8,16,49,55,-6,44
Queen's Park,5819,8,10,9,17,34,54,-20,39
Peterhead,5819,9,9,11,16,41,56,-15,38
Stenhousem'r,5819,10,7,6,23,42,89,-47,27
Livingston,5820,1,21,4,11,72,50,22,67
Airdrieon,5820,2,19,8,9,64,48,16,65
Brechin,5820,3,18,8,10,51,45,6,62
Alloa,5820,4,17,9,10,69,41,28,60
Albion,5820,5,14,6,16,56,55,1,48
East Fife,5820,6,13,8,15,50,43,7,47
Stranraer,5820,7,13,5,18,53,60,-7,44
Peterhead,5820,8,13,5,18,43,53,-10,44
Queen's Park,5820,9,11,7,18,40,52,-12,40
Stenhousem'r,5820,10,8,6,22,44,95,-51,30
Livingston,5821,1,20,8,8,74,56,18,68
Airdrieon,5821,2,19,9,8,56,41,15,66
Alloa,5821,3,16,9,11,78,56,22,57
Brechin,5821,4,15,8,13,51,56,-5,53
Peterhead,5821,5,13,10,13,49,47,2,49
Albion,5821,6,13,10,13,49,52,-3,49
East Fife,5821,7,13,8,15,57,48,9,47
Queen's Park,5821,8,11,10,15,36,51,-15,43
Stranraer,5821,9,11,8,17,55,57,-2,41
Stenhousem'r,5821,10,4,10,22,39,80,-41,22
Livingston,5822,1,21,6,9,75,43,32,69
Alloa,5822,2,18,11,7,67,40,27,65
Albion,5822,3,17,8,11,66,45,21,59
Brechin,5822,4,17,4,15,49,52,-3,55
Airdrieon,5822,5,15,7,14,58,61,-3,52
East Fife,5822,6,11,12,13,52,46,6,45
Queen's Park,5822,7,12,6,18,36,53,-17,42
Stranraer,5822,8,11,8,17,46,60,-14,41
Peterhead,5822,9,11,8,17,41,58,-17,41
Stenhousem'r,5822,10,8,8,20,38,70,-32,32
Livingston,5823,1,24,3,9,90,50,40,75
Alloa,5823,2,19,10,7,67,37,30,67
Airdrieon,5823,3,15,10,11,59,52,7,55
Brechin,5823,4,15,10,11,52,45,7,55
Peterhead,5823,5,16,7,13,51,47,4,55
Albion,5823,6,16,6,14,54,55,-1,54
Queen's Park,5823,7,12,8,16,34,50,-16,44
Stranraer,5823,8,10,9,17,48,63,-15,39
East Fife,5823,9,9,11,16,41,43,-2,38
Stenhousem'r,5823,10,4,6,26,41,95,-54,18
Livingston,5824,1,21,3,12,69,42,27,66
Alloa,5824,2,19,9,8,62,38,24,66
Peterhead,5824,3,15,10,11,56,52,4,55
Stranraer,5824,4,15,8,13,50,48,2,53
Albion,5824,5,14,8,14,54,56,-2,50
Airdrieon,5824,6,15,5,16,56,61,-5,50
Brechin,5824,7,15,5,16,53,60,-7,50
East Fife,5824,8,10,12,14,51,47,4,42
Queen's Park,5824,9,12,6,18,35,52,-17,42
Stenhousem'r,5824,10,5,12,19,45,75,-30,27
Livingston,5825,1,24,1,11,69,38,31,73
Airdrieon,5825,2,21,6,9,75,55,20,69
Alloa,5825,3,21,5,10,79,51,28,68
Peterhead,5825,4,17,6,13,59,51,8,57
Brechin,5825,5,16,7,13,49,50,-1,55
Queen's Park,5825,6,13,7,16,39,55,-16,46
Albion,5825,7,11,9,16,46,51,-5,42
East Fife,5825,8,11,7,18,50,49,1,40
Stenhousem'r,5825,9,8,7,21,46,79,-33,31
Stranraer,5825,10,8,5,23,37,70,-33,29
Livingston,5826,1,21,5,10,77,52,25,68
Alloa,5826,2,18,10,8,72,49,23,64
Airdrieon,5826,3,17,4,15,56,59,-3,55
Brechin,5826,4,15,9,12,49,50,-1,54
East Fife,5826,5,15,7,14,53,44,9,52
Peterhead,5826,6,15,5,16,54,52,2,50
Albion,5826,7,12,11,13,62,58,4,47
Queen's Park,5826,8,14,4,18,36,52,-16,46
Stranraer,5826,9,11,5,20,50,57,-7,38
Stenhousem'r,5826,10,8,8,20,46,82,-36,32
Alloa,5827,1,18,7,11,69,47,22,61
Peterhead,5827,2,17,9,10,50,43,7,60
Livingston,5827,3,16,9,11,66,47,19,57
Albion,5827,4,15,7,14,54,51,3,52
Brechin,5827,5,14,8,14,46,50,-4,50
Airdrieon,5827,6,15,5,16,53,63,-10,50
East Fife,5827,7,12,11,13,53,46,7,47
Stranraer,5827,8,13,7,16,54,59,-5,46
Queen's Park,5827,9,13,6,17,44,51,-7,45
Stenhousem'r,5827,10,9,7,20,44,76,-32,34
Livingston,5828,1,23,4,9,78,44,34,73
Alloa,5828,2,21,6,9,69,42,27,69
Airdrieon,5828,3,18,4,14,66,55,11,58
Brechin,5828,4,16,7,13,55,47,8,55
Albion,5828,5,14,12,10,54,45,9,54
Queen's Park,5828,6,13,8,15,45,58,-13,47
Peterhead,5828,7,12,9,15,54,51,3,45
East Fife,5828,8,10,12,14,53,58,-5,42
Stranraer,5828,9,8,10,18,45,60,-15,34
Stenhousem'r,5828,10,5,8,23,41,100,-59,23
Alloa,5829,1,22,7,7,84,44,40,73
Livingston,5829,2,23,4,9,77,51,26,73
Brechin,5829,3,17,6,13,55,46,9,57
Airdrieon,5829,4,16,8,12,57,57,0,56
Albion,5829,5,14,8,14,46,49,-3,50
Peterhead,5829,6,12,12,12,53,52,1,48
Stranraer,5829,7,13,5,18,53,60,-7,44
Queen's Park,5829,8,10,7,19,29,51,-22,37
East Fife,5829,9,8,12,16,55,59,-4,36
Stenhousem'r,5829,10,6,9,21,42,82,-40,27
Livingston,5830,1,25,2,9,84,45,39,77
Alloa,5830,2,20,7,9,77,36,41,67
Airdrieon,5830,3,18,6,12,54,40,14,60
Albion,5830,4,16,12,8,59,48,11,60
Brechin,5830,5,14,7,15,48,48,0,49
Peterhead,5830,6,13,7,16,52,61,-9,46
Stranraer,5830,7,12,9,15,45,52,-7,45
East Fife,5830,8,8,11,17,42,51,-9,35
Queen's Park,5830,9,8,9,19,31,71,-40,33
Stenhousem'r,5830,10,7,8,21,45,85,-40,29
Alloa,5831,1,22,6,8,75,43,32,72
Airdrieon,5831,2,18,8,10,69,54,15,62
Livingston,5831,3,18,7,11,80,55,25,61
Stranraer,5831,4,17,4,15,62,60,2,55
Peterhead,5831,5,14,10,12,63,59,4,52
Queen's Park,5831,6,15,7,14,40,48,-8,52
Brechin,5831,7,14,4,18,44,58,-14,46
Albion,5831,8,13,6,17,59,65,-6,45
East Fife,5831,9,10,5,21,45,60,-15,35
Stenhousem'r,5831,10,8,5,23,44,79,-35,29
Livingston,5832,1,21,3,12,79,49,30,66
Alloa,5832,2,20,6,10,77,49,28,66
Albion,5832,3,17,7,12,53,49,4,58
Brechin,5832,4,17,6,13,44,44,0,57
Stranraer,5832,5,17,5,14,53,51,2,56
Airdrieon,5832,6,15,8,13,55,53,2,53
Queen's Park,5832,7,12,7,17,35,49,-14,43
East Fife,5832,8,11,8,17,53,51,2,41
Stenhousem'r,5832,9,6,14,16,47,78,-31,32
Peterhead,5832,10,7,10,19,39,62,-23,31
Alloa,5833,1,22,6,8,72,43,29,72
Brechin,5833,2,20,6,10,63,47,16,66
Livingston,5833,3,19,7,10,80,53,27,64
Airdrieon,5833,4,15,7,14,62,55,7,52
Albion,5833,5,14,8,14,45,48,-3,50
East Fife,5833,6,12,9,15,50,52,-2,45
Queen's Park,5833,7,12,9,15,37,53,-16,45
Peterhead,5833,8,11,10,15,44,50,-6,43
Stranraer,5833,9,9,10,17,46,61,-15,37
Stenhousem'r,5833,10,6,8,22,42,79,-37,26
Livingston,5834,1,22,1,13,81,57,24,67
Alloa,5834,2,19,8,9,78,55,23,65
Airdrieon,5834,3,18,4,14,57,48,9,58
Brechin,5834,4,16,6,14,47,48,-1,54
Albion,5834,5,14,8,14,57,58,-1,50
East Fife,5834,6,13,8,15,56,49,7,47
Stranraer,5834,7,14,5,17,60,65,-5,47
Peterhead,5834,8,12,7,17,44,51,-7,43
Queen's Park,5834,9,11,8,17,42,54,-12,41
Stenhousem'r,5834,10,9,9,18,44,81,-37,36
Alloa,5835,1,23,9,4,75,34,41,78
Livingston,5835,2,22,7,7,86,46,40,73
Airdrieon,5835,3,19,7,10,65,52,13,64
Brechin,5835,4,19,5,12,55,43,12,62
Peterhead,5835,5,15,6,15,53,53,0,51
East Fife,5835,6,10,9,17,42,49,-7,39
Albion,5835,7,9,12,15,52,68,-16,39
Queen's Park,5835,8,9,8,19,31,55,-24,35
Stranraer,5835,9,10,4,22,45,69,-24,34
Stenhousem'r,5835,10,5,11,20,38,73,-35,26
Livingston,5836,1,20,6,10,77,45,32,66
Alloa,5836,2,19,9,8,67,42,25,66
Airdrieon,5836,3,16,9,11,54,55,-1,57
Peterhead,5836,4,16,8,12,56,52,4,56
Brechin,5836,5,16,7,13,51,46,5,55
Albion,5836,6,14,8,14,48,54,-6,50
Stranraer,5836,7,13,4,19,61,67,-6,43
Queen's Park,5836,8,11,10,15,41,53,-12,43
East Fife,5836,9,10,11,15,49,46,3,41
Stenhousem'r,5836,10,5,8,23,33,77,-44,23
Alloa,5837,1,21,10,5,80,41,39,73
Brechin,5837,2,21,4,11,54,41,13,67
Livingston,5837,3,18,7,11,75,51,24,61
Airdrieon,5837,4,15,8,13,52,54,-2,53
Albion,5837,5,15,7,14,60,50,10,52
Stranraer,5837,6,14,4,18,56,66,-10,46
East Fife,5837,7,11,11,14,49,47,2,44
Queen's Park,5837,8,11,10,15,35,48,-13,43
Peterhead,5837,9,11,7,18,48,62,-14,40
Stenhousem'r,5837,10,5,8,23,37,86,-49,23
Brechin,5838,1,22,3,11,56,42,14,69
Livingston,5838,2,22,2,12,83,57,26,68
Alloa,5838,3,20,5,11,71,40,31,65
Airdrieon,5838,4,18,5,13,63,56,7,59
Peterhead,5838,5,14,6,16,49,57,-8,48
East Fife,5838,6,12,9,15,49,50,-1,45
Queen's Park,5838,7,13,6,17,44,56,-12,45
Stranraer,5838,8,12,5,19,47,60,-13,41
Albion,5838,9,10,8,18,51,62,-11,38
Stenhousem'r,5838,10,9,7,20,52,85,-33,34
Brechin,5839,1,24,4,8,62,42,20,76
Livingston,5839,2,20,6,10,83,51,32,66
Alloa,5839,3,17,10,9,65,44,21,61
Peterhead,5839,4,15,8,13,53,54,-1,53
Airdrieon,5839,5,16,5,15,60,66,-6,53
Queen's Park,5839,6,15,6,15,44,49,-5,51
Albion,5839,7,12,10,14,58,56,2,46
Stranraer,5839,8,12,8,16,47,52,-5,44
East Fife,5839,9,7,13,16,52,58,-6,34
Stenhousem'r,5839,10,4,6,26,34,86,-52,18
Livingston,5840,1,22,6,8,73,40,33,72
Alloa,5840,2,19,5,12,69,40,29,62
Airdrieon,5840,3,17,8,11,65,59,6,59
Stranraer,5840,4,17,4,15,53,55,-2,55
Brechin,5840,5,13,8,15,44,44,0,47
Peterhead,5840,6,13,8,15,48,54,-6,47
Albion,5840,7,13,5,18,51,62,-11,44
East Fife,5840,8,10,12,14,43,47,-4,42
Stenhousem'r,5840,9,9,11,16,51,75,-24,38
Queen's Park,5840,10,9,9,18,36,57,-21,36
Livingston,5841,1,22,7,7,83,48,35,73
Brechin,5841,2,19,6,11,55,49,6,63
Alloa,5841,3,16,10,10,73,51,22,58
Peterhead,5841,4,16,9,11,59,51,8,57
Airdrieon,5841,5,14,9,13,56,61,-5,51
Albion,5841,6,12,12,12,51,49,2,48
Stranraer,5841,7,12,5,19,48,60,-12,41
East Fife,5841,8,10,9,17,45,53,-8,39
Queen's Park,5841,9,10,8,18,32,48,-16,38
Stenhousem'r,5841,10,6,11,19,50,82,-32,29
Peterhead,5842,1,18,7,11,57,45,12,61
Livingston,5842,2,19,3,14,65,54,11,60
Alloa,5842,3,16,11,9,73,47,26,59
Brechin,5842,4,17,8,11,45,43,2,59
Airdrieon,5842,5,15,9,12,55,55,0,54
Albion,5842,6,13,11,12,48,47,1,50
East Fife,5842,7,13,9,14,49,43,6,48
Queen's Park,5842,8,10,9,17,29,41,-12,39
Stranraer,5842,9,10,9,17,41,54,-13,39
Stenhousem'r,5842,10,7,8,21,43,76,-33,29
Airdrieon,5843,1,22,3,11,59,45,14,69
Livingston,5843,2,20,7,9,68,44,24,67
Brechin,5843,3,19,6,11,60,49,11,63
Alloa,5843,4,16,6,14,63,48,15,54
Stranraer,5843,5,17,3,16,55,59,-4,54
Albion,5843,6,12,8,16,53,53,0,44
Queen's Park,5843,7,12,8,16,38,53,-15,44
Peterhead,5843,8,11,6,19,42,58,-16,39
Stenhousem'r,5843,9,10,8,18,50,74,-24,38
East Fife,5843,10,9,9,18,46,51,-5,36
Livingston,5844,1,24,3,9,81,43,38,75
Alloa,5844,2,16,8,12,69,48,21,56
Airdrieon,5844,3,16,7,13,54,54,0,55
Peterhead,5844,4,14,8,14,50,58,-8,50
East Fife,5844,5,12,11,13,55,47,8,47
Brechin,5844,6,12,10,14,44,50,-6,46
Albion,5844,7,12,9,15,47,48,-1,45
Stenhousem'r,5844,8,12,9,15,63,83,-20,45
Stranraer,5844,9,12,6,18,51,62,-11,42
Queen's Park,5844,10,12,5,19,37,58,-21,41
Livingston,5845,1,23,4,9,74,42,32,73
Alloa,5845,2,18,10,8,77,54,23,64
Airdrieon,5845,3,18,8,10,69,52,17,62
Brechin,5845,4,13,12,11,51,50,1,51
Albion,5845,5,13,9,14,48,52,-4,48
East Fife,5845,6,11,12,13,55,51,4,45
Stranraer,5845,7,13,6,17,52,59,-7,45
Peterhead,5845,8,11,10,15,46,55,-9,43
Queen's Park,5845,9,11,5,20,38,59,-21,38
Stenhousem'r,5845,10,8,6,22,54,90,-36,30
Livingston,5846,1,23,2,11,81,46,35,71
Airdrieon,5846,2,19,4,13,66,56,10,61
Brechin,5846,3,17,7,12,54,51,3,58
Alloa,5846,4,17,6,13,66,47,19,57
East Fife,5846,5,14,9,13,56,47,9,51
Queen's Park,5846,6,15,6,15,40,49,-9,51
Peterhead,5846,7,12,10,14,46,53,-7,46
Stenhousem'r,5846,8,11,8,17,54,82,-28,41
Albion,5846,9,11,7,18,50,57,-7,40
Stranraer,5846,10,8,7,21,43,68,-25,31
Alloa,5847,1,19,10,7,63,38,25,67
Brechin,5847,2,19,8,9,59,39,20,65
Livingston,5847,3,19,4,13,71,49,22,61
Albion,5847,4,17,7,12,54,46,8,58
Airdrieon,5847,5,15,7,14,48,47,1,52
Peterhead,5847,6,15,6,15,46,46,0,51
Stranraer,5847,7,15,4,17,49,52,-3,49
Queen's Park,5847,8,13,6,17,39,56,-17,45
East Fife,5847,9,10,8,18,38,48,-10,38
Stenhousem'r,5847,10,5,6,25,38,84,-46,21
Livingston,5848,1,24,2,10,76,49,27,74
Alloa,5848,2,17,6,13,67,51,16,57
Albion,5848,3,17,6,13,60,48,12,57
Queen's Park,5848,4,15,6,15,41,49,-8,51
Airdrieon,5848,5,14,8,14,52,63,-11,50
Brechin,5848,6,14,5,17,49,50,-1,47
East Fife,5848,7,12,9,15,54,46,8,45
Stranraer,5848,8,13,5,18,50,56,-6,44
Peterhead,5848,9,12,8,16,52,66,-14,44
Stenhousem'r,5848,10,11,7,18,51,74,-23,40
Airdrieon,5849,1,19,11,6,68,52,16,68
Livingston,5849,2,17,8,11,76,51,25,59
Alloa,5849,3,15,13,8,63,44,19,58
Albion,5849,4,16,9,11,56,50,6,57
Brechin,5849,5,15,5,16,50,53,-3,50
Queen's Park,5849,6,13,10,13,41,47,-6,49
East Fife,5849,7,12,11,13,51,48,3,47
Stranraer,5849,8,11,7,18,43,56,-13,40
Peterhead,5849,9,8,11,17,43,57,-14,35
Stenhousem'r,5849,10,6,11,19,50,83,-33,29
Livingston,5850,1,23,7,6,81,44,37,76
Brechin,5850,2,20,6,10,66,46,20,66
Alloa,5850,3,18,10,8,73,48,25,64
Airdrieon,5850,4,18,7,11,62,50,12,61
Albion,5850,5,14,9,13,50,51,-1,51
East Fife,5850,6,9,13,14,48,48,0,40
Peterhead,5850,7,9,10,17,44,64,-20,37
Queen's Park,5850,8,10,7,19,33,53,-20,37
Stranraer,5850,9,10,5,21,37,54,-17,35
Stenhousem'r,5850,10,7,10,19,45,81,-36,31
Alloa,5851,1,24,6,6,77,37,40,78
Livingston,5851,2,22,4,10,75,43,32,70
Albion,5851,3,14,11,11,51,51,0,53
Brechin,5851,4,14,10,12,46,42,4,52
Airdrieon,5851,5,15,6,15,60,56,4,51
Stranraer,5851,6,12,7,17,41,60,-19,43
Peterhead,5851,7,11,8,17,46,57,-11,41
East Fife,5851,8,10,10,16,42,47,-5,40
Queen's Park,5851,9,10,7,19,38,57,-19,37
Stenhousem'r,5851,10,10,7,19,48,74,-26,37
Livingston,5852,1,20,5,11,73,47,26,65
Alloa,5852,2,17,10,9,67,50,17,61
Brechin,5852,3,18,4,14,51,43,8,58
Queen's Park,5852,4,17,4,15,47,45,2,55
Airdrieon,5852,5,16,7,13,58,58,0,55
Albion,5852,6,14,7,15,49,49,0,49
Peterhead,5852,7,13,10,13,46,54,-8,49
Stranraer,5852,8,11,7,18,45,60,-15,40
East Fife,5852,9,9,12,15,48,50,-2,39
Stenhousem'r,5852,10,10,4,22,49,77,-28,34
Livingston,5853,1,21,4,11,75,59,16,67
Alloa,5853,2,18,8,10,70,46,24,62
Albion,5853,3,17,7,12,55,47,8,58
Airdrieon,5853,4,16,9,11,59,58,1,57
Peterhead,5853,5,15,7,14,51,52,-1,52
Brechin,5853,6,15,5,16,55,54,1,50
Stranraer,5853,7,14,4,18,58,63,-5,46
Queen's Park,5853,8,14,4,18,39,54,-15,46
East Fife,5853,9,10,10,16,54,54,0,40
Stenhousem'r,5853,10,6,10,20,44,73,-29,28
Livingston,5854,1,21,4,11,82,60,22,67
Alloa,5854,2,20,6,10,73,41,32,66
Brechin,5854,3,16,8,12,52,50,2,56
East Fife,5854,4,15,9,12,60,46,14,54
Airdrieon,5854,5,16,5,15,56,59,-3,53
Peterhead,5854,6,13,9,14,51,53,-2,48
Queen's Park,5854,7,12,8,16,44,56,-12,44
Albion,5854,8,11,9,16,56,69,-13,42
Stranraer,5854,9,11,6,19,51,66,-15,39
Stenhousem'r,5854,10,8,10,18,50,75,-25,34
Livingston,5855,1,23,5,8,81,46,35,74
Alloa,5855,2,18,7,11,58,47,11,61
Brechin,5855,3,14,12,10,54,49,5,54
Stranraer,5855,4,16,5,15,67,61,6,53
Airdrieon,5855,5,15,7,14,48,54,-6,52
Peterhead,5855,6,14,8,14,49,48,1,50
Queen's Park,5855,7,12,6,18,38,54,-16,42
East Fife,5855,8,9,12,15,43,44,-1,39
Albion,5855,9,11,6,19,50,60,-10,39
Stenhousem'r,5855,10,11,6,19,45,70,-25,39
Alloa,5856,1,19,9,8,77,43,34,66
Livingston,5856,2,20,3,13,66,43,23,63
Brechin,5856,3,18,5,13,64,54,10,59
Albion,5856,4,17,6,13,55,47,8,57
Peterhead,5856,5,16,7,13,53,46,7,55
Airdrieon,5856,6,16,6,14,59,58,1,54
Stranraer,5856,7,13,3,20,46,71,-25,42
East Fife,5856,8,11,8,17,41,51,-10,41
Queen's Park,5856,9,11,7,18,36,54,-18,40
Stenhousem'r,5856,10,7,10,19,44,74,-30,31
Airdrieon,5857,1,22,6,8,59,45,14,72
Alloa,5857,2,21,7,8,81,49,32,70
Livingston,5857,3,16,10,10,65,41,24,58
Brechin,5857,4,15,11,10,48,38,10,56
Stranraer,5857,5,13,8,15,53,63,-10,47
Queen's Park,5857,6,12,9,15,39,52,-13,45
Peterhead,5857,7,11,9,16,48,58,-10,42
Albion,5857,8,10,11,15,50,53,-3,41
East Fife,5857,9,8,11,17,43,51,-8,35
Stenhousem'r,5857,10,7,8,21,39,75,-36,29
Livingston,5858,1,25,2,9,82,46,36,77
Brechin,5858,2,18,6,12,57,44,13,60
Alloa,5858,3,16,10,10,63,45,18,58
Airdrieon,5858,4,16,6,14,59,57,2,54
Peterhead,5858,5,15,9,12,50,55,-5,54
Stranraer,5858,6,14,4,18,59,60,-1,46
East Fife,5858,7,11,11,14,46,48,-2,44
Queen's Park,5858,8,10,9,17,34,56,-22,39
Albion,5858,9,10,8,18,56,67,-11,38
Stenhousem'r,5858,10,7,11,18,48,76,-28,32
Brechin,5859,1,22,3,11,54,42,12,69
Livingston,5859,2,16,10,10,64,43,21,58
Peterhead,5859,3,17,7,12,61,56,5,58
Alloa,5859,4,16,8,12,65,44,21,56
Albion,5859,5,15,9,12,49,52,-3,54
East Fife,5859,6,13,8,15,55,53,2,47
Queen's Park,5859,7,12,7,17,35,47,-12,43
Stranraer,5859,8,13,3,20,45,54,-9,42
Airdrieon,5859,9,12,5,19,44,60,-16,41
Stenhousem'r,5859,10,10,8,18,49,70,-21,38
Alloa,5860,1,21,7,8,76,47,29,70
Livingston,5860,2,21,4,11,82,48,34,67
Albion,5860,3,19,6,11,62,49,13,63
Airdrieon,5860,4,18,7,11,61,51,10,61
Peterhead,5860,5,14,11,11,55,47,8,53
Brechin,5860,6,13,6,17,41,52,-11,45
East Fife,5860,7,12,8,16,41,43,-2,44
Stranraer,5860,8,12,3,21,45,62,-17,39
Queen's Park,5860,9,10,8,18,31,54,-23,38
Stenhousem'r,5860,10,6,8,22,45,86,-41,26
Alloa,5861,1,21,6,9,80,44,36,69
Livingston,5861,2,21,5,10,80,54,26,68
Brechin,5861,3,20,4,12,53,42,11,64
Airdrieon,5861,4,16,8,12,59,60,-1,56
Peterhead,5861,5,14,8,14,52,53,-1,50
Stranraer,5861,6,14,5,17,51,57,-6,47
Queen's Park,5861,7,12,8,16,38,54,-16,44
East Fife,5861,8,12,6,18,45,55,-10,42
Albion,5861,9,11,6,19,51,58,-7,39
Stenhousem'r,5861,10,6,10,20,48,80,-32,28
Alloa,5862,1,20,7,9,78,54,24,67
Airdrieon,5862,2,17,10,9,67,55,12,61
Livingston,5862,3,17,7,12,75,49,26,58
Brechin,5862,4,16,7,13,57,53,4,55
Albion,5862,5,15,9,12,60,49,11,54
Stranraer,5862,6,16,5,15,56,60,-4,53
East Fife,5862,7,14,9,13,57,52,5,51
Peterhead,5862,8,11,11,14,48,56,-8,44
Queen's Park,5862,9,9,8,19,37,64,-27,35
Stenhousem'r,5862,10,5,7,24,44,87,-43,22
Brechin,5863,1,21,6,9,56,36,20,69
Livingston,5863,2,19,7,10,68,45,23,64
Alloa,5863,3,17,11,8,62,38,24,62
Airdrieon,5863,4,16,8,12,55,48,7,56
Peterhead,5863,5,16,7,13,59,53,6,55
Stranraer,5863,6,16,5,15,52,51,1,53
Queen's Park,5863,7,10,10,16,30,49,-19,40
Albion,5863,8,9,12,15,46,52,-6,39
East Fife,5863,9,9,7,20,43,69,-26,34
Stenhousem'r,5863,10,6,9,21,46,76,-30,27
Livingston,5864,1,24,3,9,81,45,36,75
Alloa,5864,2,20,10,6,67,34,33,70
Airdrieon,5864,3,20,5,11,64,52,12,65
Brechin,5864,4,16,4,16,42,43,-1,52
East Fife,5864,5,13,5,18,48,50,-2,44
Albion,5864,6,12,8,16,41,54,-13,44
Queen's Park,5864,7,11,10,15,34,45,-11,43
Peterhead,5864,8,12,6,18,41,58,-17,42
Stranraer,5864,9,9,10,17,49,62,-13,37
Stenhousem'r,5864,10,9,7,20,42,66,-24,34
Livingston,5865,1,20,6,10,82,45,37,66
Airdrieon,5865,2,17,10,9,62,50,12,61
Alloa,5865,3,16,11,9,64,45,19,59
Peterhead,5865,4,14,12,10,52,44,8,54
Albion,5865,5,15,7,14,56,55,1,52
Brechin,5865,6,14,7,15,44,54,-10,49
Queen's Park,5865,7,12,7,17,41,57,-16,43
East Fife,5865,8,10,10,16,52,53,-1,40
Stranraer,5865,9,11,6,19,48,65,-17,39
Stenhousem'r,5865,10,9,8,19,46,79,-33,35
Alloa,5866,1,23,5,8,72,35,37,74
Livingston,5866,2,23,3,10,85,54,31,72
Brechin,5866,3,19,6,11,54,47,7,63
Airdrieon,5866,4,17,8,11,60,48,12,59
Peterhead,5866,5,14,9,13,50,51,-1,51
East Fife,5866,6,13,10,13,58,52,6,49
Stranraer,5866,7,14,4,18,59,64,-5,46
Queen's Park,5866,8,9,8,19,32,54,-22,35
Albion,5866,9,7,8,21,52,73,-21,29
Stenhousem'r,5866,10,6,9,21,42,86,-44,27
Alloa,5867,1,20,9,7,74,40,34,69
Livingston,5867,2,20,5,11,78,58,20,65
Airdrieon,5867,3,16,10,10,60,56,4,58
Albion,5867,4,14,7,15,45,47,-2,49
Brechin,5867,5,14,6,16,48,47,1,48
Queen's Park,5867,6,12,11,13,35,43,-8,47
Peterhead,5867,7,12,10,14,53,59,-6,46
East Fife,5867,8,8,17,11,49,43,6,41
Stranraer,5867,9,9,9,18,48,64,-16,36
Stenhousem'r,5867,10,9,8,19,49,82,-33,35
Alloa,5868,1,20,8,8,79,49,30,68
Livingston,5868,2,21,4,11,85,46,39,67
Airdrieon,5868,3,19,6,11,69,55,14,63
Peterhead,5868,4,14,9,13,50,55,-5,51
Brechin,5868,5,15,5,16,54,61,-7,50
Queen's Park,5868,6,13,10,13,42,51,-9,49
Albion,5868,7,13,9,14,65,65,0,48
Stranraer,5868,8,12,8,16,53,63,-10,44
East Fife,5868,9,10,10,16,47,47,0,40
Stenhousem'r,5868,10,4,9,23,41,93,-52,21
Alloa,5869,1,22,6,8,82,43,39,72
Stranraer,5869,2,17,6,13,48,45,3,57
Brechin,5869,3,16,7,13,47,46,1,55
Airdrieon,5869,4,16,7,13,59,60,-1,55
Peterhead,5869,5,15,6,15,50,49,1,51
Albion,5869,6,13,10,13,42,46,-4,49
Livingston,5869,7,14,5,17,61,50,11,47
Queen's Park,5869,8,12,8,16,36,53,-17,44
Stenhousem'r,5869,9,9,10,17,52,74,-22,37
East Fife,5869,10,8,11,17,39,50,-11,35
Livingston,5870,1,25,2,9,90,44,46,77
Brechin,5870,2,18,6,12,52,41,11,60
Alloa,5870,3,16,9,11,67,49,18,57
Airdrieon,5870,4,15,8,13,64,61,3,53
Albion,5870,5,11,14,11,49,53,-4,47
Peterhead,5870,6,13,6,17,46,55,-9,45
Stranraer,5870,7,13,6,17,53,63,-10,45
Queen's Park,5870,8,12,6,18,32,53,-21,42
East Fife,5870,9,10,11,15,50,52,-2,41
Stenhousem'r,5870,10,9,8,19,45,77,-32,35
Airdrieon,5871,1,19,6,11,65,45,20,63
Alloa,5871,2,18,7,11,69,46,23,61
Livingston,5871,3,19,3,14,75,56,19,60
Albion,5871,4,18,6,12,53,48,5,60
Brechin,5871,5,17,5,14,48,56,-8,56
Peterhead,5871,6,15,9,12,51,47,4,54
Stranraer,5871,7,15,4,17,54,57,-3,49
East Fife,5871,8,12,9,15,52,47,5,45
Queen's Park,5871,9,8,12,16,36,53,-17,36
Stenhousem'r,5871,10,6,5,25,39,87,-48,23
Livingston,5872,1,24,6,6,80,42,38,78
Alloa,5872,2,22,8,6,76,40,36,74
Brechin,5872,3,17,5,14,51,55,-4,56
Airdrieon,5872,4,16,4,16,68,74,-6,52
Peterhead,5872,5,14,8,14,58,58,0,50
Stranraer,5872,6,13,6,17,49,59,-10,45
Albion,5872,7,10,11,15,51,56,-5,41
Queen's Park,5872,8,11,6,19,45,62,-17,39
East Fife,5872,9,9,10,17,48,48,0,37
Stenhousem'r,5872,10,9,6,21,56,88,-32,33
Alloa,5873,1,20,7,9,70,47,23,67
Livingston,5873,2,20,4,12,70,51,19,64
Airdrieon,5873,3,17,6,13,60,53,7,57
Brechin,5873,4,17,4,15,54,48,6,55
Stranraer,5873,5,16,6,14,54,57,-3,54
Peterhead,5873,6,14,7,15,56,58,-2,49
East Fife,5873,7,12,9,15,42,44,-2,45
Albion,5873,8,12,8,16,44,50,-6,44
Queen's Park,5873,9,11,5,20,27,49,-22,38
Stenhousem'r,5873,10,10,6,20,50,70,-20,36
Alloa,5874,1,22,6,8,72,35,37,72
Livingston,5874,2,20,7,9,73,45,28,67
Airdrieon,5874,3,18,6,12,62,58,4,60
Brechin,5874,4,16,5,15,61,50,11,53
Stranraer,5874,5,14,8,14,51,54,-3,50
East Fife,5874,6,13,9,14,48,45,3,48
Queen's Park,5874,7,12,10,14,38,51,-13,46
Albion,5874,8,12,7,17,50,55,-5,43
Peterhead,5874,9,9,8,19,40,66,-26,35
Stenhousem'r,5874,10,8,6,22,40,76,-36,30
Alloa,5875,1,18,8,10,64,42,22,62
Livingston,5875,2,18,7,11,71,51,20,61
Airdrieon,5875,3,17,8,11,61,49,12,59
Peterhead,5875,4,14,11,11,47,44,3,53
Brechin,5875,5,13,14,9,43,42,1,53
East Fife,5875,6,13,9,14,54,53,1,48
Queen's Park,5875,7,12,10,14,36,46,-10,46
Albion,5875,8,13,5,18,48,57,-9,44
Stranraer,5875,9,10,9,17,42,57,-15,39
Stenhousem'r,5875,10,8,7,21,52,77,-25,31
Livingston,5876,1,18,7,11,70,42,28,61
Peterhead,5876,2,17,9,10,62,55,7,60
Brechin,5876,3,18,4,14,54,49,5,58
Alloa,5876,4,15,11,10,61,45,16,56
Airdrieon,5876,5,17,4,15,56,53,3,55
Albion,5876,6,14,10,12,60,49,11,52
East Fife,5876,7,13,10,13,52,48,4,49
Stranraer,5876,8,13,7,16,49,54,-5,46
Queen's Park,5876,9,11,9,16,34,55,-21,42
Stenhousem'r,5876,10,4,9,23,37,85,-48,21
Alloa,5877,1,23,7,6,71,37,34,76
Livingston,5877,2,19,5,12,75,49,26,62
Brechin,5877,3,16,7,13,55,48,7,55
Albion,5877,4,15,8,13,59,53,6,53
Queen's Park,5877,5,14,8,14,44,52,-8,50
Airdrieon,5877,6,13,10,13,52,53,-1,49
Stranraer,5877,7,13,5,18,48,58,-10,44
East Fife,5877,8,10,11,15,41,42,-1,41
Peterhead,5877,9,11,8,17,46,54,-8,41
Stenhousem'r,5877,10,7,9,20,40,85,-45,30
Airdrieon,5878,1,19,7,10,67,46,21,64
Livingston,5878,2,18,9,9,57,38,19,63
Brechin,5878,3,18,5,13,60,50,10,59
Alloa,5878,4,14,12,10,74,49,25,54
Albion,5878,5,14,9,13,58,55,3,51
East Fife,5878,6,13,8,15,49,48,1,47
Peterhead,5878,7,11,13,12,57,58,-1,46
Queen's Park,5878,8,11,10,15,39,49,-10,43
Stranraer,5878,9,10,8,18,45,64,-19,38
Stenhousem'r,5878,10,8,7,21,47,96,-49,31
Alloa,5879,1,22,6,8,71,37,34,72
Brechin,5879,2,18,8,10,55,46,9,62
Livingston,5879,3,18,4,14,69,56,13,58
Airdrieon,5879,4,17,7,12,60,54,6,58
Queen's Park,5879,5,15,6,15,49,51,-2,51
Albion,5879,6,14,8,14,52,52,0,50
Peterhead,5879,7,14,8,14,44,44,0,50
Stranraer,5879,8,10,12,14,43,58,-15,42
East Fife,5879,9,9,7,20,41,52,-11,34
Stenhousem'r,5879,10,6,8,22,52,86,-34,26
Alloa,5880,1,18,11,7,71,45,26,65
Livingston,5880,2,19,2,15,69,56,13,59
East Fife,5880,3,16,9,11,56,43,13,57
Airdrieon,5880,4,15,8,13,54,50,4,53
Stranraer,5880,5,15,6,15,57,57,0,51
Queen's Park,5880,6,14,7,15,31,43,-12,49
Albion,5880,7,13,8,15,53,52,1,47
Brechin,5880,8,14,5,17,45,53,-8,47
Stenhousem'r,5880,9,12,4,20,58,78,-20,40
Peterhead,5880,10,9,10,17,46,63,-17,37
Alloa,5881,1,19,9,8,63,45,18,66
Livingston,5881,2,20,5,11,81,56,25,65
Brechin,5881,3,17,5,14,49,46,3,56
Airdrieon,5881,4,14,11,11,56,56,0,53
Albion,5881,5,14,9,13,51,45,6,51
East Fife,5881,6,13,8,15,51,47,4,47
Queen's Park,5881,7,13,8,15,46,51,-5,47
Peterhead,5881,8,13,5,18,50,59,-9,44
Stenhousem'r,5881,9,11,6,19,41,73,-32,39
Stranraer,5881,10,10,6,20,53,63,-10,36
Brechin,5882,1,22,1,13,54,48,6,67
Alloa,5882,2,19,8,9,63,35,28,65
Livingston,5882,3,20,5,11,71,48,23,65
Airdrieon,5882,4,16,6,14,51,45,6,54
Albion,5882,5,15,6,15,43,46,-3,51
Stranraer,5882,6,15,4,17,54,68,-14,49
Peterhead,5882,7,15,3,18,45,50,-5,48
East Fife,5882,8,11,6,19,44,50,-6,39
Queen's Park,5882,9,10,9,17,33,50,-17,39
Stenhousem'r,5882,10,10,6,20,50,68,-18,36
Alloa,5883,1,20,8,8,68,41,27,68
Livingston,5883,2,21,4,11,78,44,34,67
Brechin,5883,3,17,4,15,58,51,7,55
Airdrieon,5883,4,16,6,14,55,56,-1,54
Peterhead,5883,5,15,8,13,54,49,5,53
East Fife,5883,6,15,5,16,54,49,5,50
Queen's Park,5883,7,15,5,16,44,63,-19,50
Albion,5883,8,14,5,17,58,57,1,47
Stranraer,5883,9,13,5,18,47,55,-8,44
Stenhousem'r,5883,10,6,6,24,37,88,-51,24
Livingston,5884,1,21,5,10,81,49,32,68
Alloa,5884,2,17,9,10,73,50,23,60
Airdrieon,5884,3,17,8,11,69,55,14,59
Brechin,5884,4,17,8,11,45,38,7,59
Queen's Park,5884,5,16,6,14,35,43,-8,54
Stranraer,5884,6,13,5,18,46,66,-20,44
Peterhead,5884,7,11,9,16,45,58,-13,42
East Fife,5884,8,11,8,17,49,48,1,41
Albion,5884,9,10,10,16,39,49,-10,40
Stenhousem'r,5884,10,9,8,19,43,69,-26,35
Livingston,5885,1,25,3,8,82,39,43,78
Albion,5885,2,20,6,10,59,43,16,66
Airdrieon,5885,3,18,4,14,56,59,-3,58
Queen's Park,5885,4,17,6,13,47,47,0,57
Brechin,5885,5,16,5,15,56,59,-3,53
Alloa,5885,6,12,10,14,54,50,4,46
Peterhead,5885,7,11,9,16,47,63,-16,42
East Fife,5885,8,10,8,18,49,53,-4,38
Stranraer,5885,9,11,5,20,57,68,-11,38
Stenhousem'r,5885,10,8,8,20,43,69,-26,32
Livingston,5886,1,22,5,9,82,50,32,71
Alloa,5886,2,20,4,12,81,46,35,64
Peterhead,5886,3,16,9,11,58,55,3,57
Airdrieon,5886,4,17,6,13,58,57,1,57
Brechin,5886,5,16,7,13,52,52,0,55
Albion,5886,6,14,7,15,55,55,0,49
Queen's Park,5886,7,14,5,17,43,54,-11,47
East Fife,5886,8,13,7,16,50,55,-5,46
Stranraer,5886,9,10,6,20,43,60,-17,36
Stenhousem'r,5886,10,7,6,23,42,80,-38,27
Livingston,5887,1,21,4,11,70,43,27,67
Alloa,5887,2,17,9,10,66,50,16,60
Brechin,5887,3,18,6,12,53,47,6,60
Albion,5887,4,16,10,10,60,47,13,58
Airdrieon,5887,5,17,7,12,67,56,11,58
Peterhead,5887,6,13,8,15,45,47,-2,47
East Fife,5887,7,10,14,12,53,46,7,44
Stranraer,5887,8,12,6,18,52,59,-7,42
Queen's Park,5887,9,9,9,18,29,58,-29,36
Stenhousem'r,5887,10,7,7,22,39,81,-42,28
Airdrieon,5888,1,20,5,11,59,46,13,65
Alloa,5888,2,19,7,10,72,45,27,64
Livingston,5888,3,19,5,12,66,48,18,62
Albion,5888,4,18,8,10,64,50,14,62
Brechin,5888,5,17,10,9,52,45,7,61
Queen's Park,5888,6,15,6,15,43,47,-4,51
Peterhead,5888,7,14,6,16,40,46,-6,48
East Fife,5888,8,10,12,14,44,42,2,42
Stranraer,5888,9,9,5,22,39,64,-25,32
Stenhousem'r,5888,10,3,8,25,35,81,-46,17
Alloa,5889,1,22,5,9,73,36,37,71
Livingston,5889,2,22,5,9,76,45,31,71
Airdrieon,5889,3,21,4,11,61,47,14,67
Albion,5889,4,15,7,14,60,55,5,52
Brechin,5889,5,16,2,18,47,51,-4,50
Peterhead,5889,6,13,7,16,49,62,-13,46
Stranraer,5889,7,12,6,18,48,61,-13,42
Stenhousem'r,5889,8,11,7,18,52,80,-28,40
Queen's Park,5889,9,11,6,19,44,61,-17,39
East Fife,5889,10,9,7,20,44,56,-12,34
Alloa,5890,1,21,5,10,72,43,29,68
Livingston,5890,2,19,6,11,80,51,29,63
Airdrieon,5890,3,18,6,12,58,50,8,60
Albion,5890,4,16,8,12,60,50,10,56
Brechin,5890,5,15,6,15,39,47,-8,51
Stranraer,5890,6,14,6,16,48,52,-4,48
Peterhead,5890,7,11,11,14,47,52,-5,44
Queen's Park,5890,8,12,8,16,30,51,-21,44
East Fife,5890,9,10,9,17,48,54,-6,39
Stenhousem'r,5890,10,8,7,21,42,74,-32,31
Livingston,5891,1,22,5,9,89,48,41,71
Alloa,5891,2,17,10,9,66,43,23,61
Brechin,5891,3,16,9,11,48,47,1,57
Stranraer,5891,4,14,6,16,56,62,-6,48
East Fife,5891,5,12,11,13,46,45,1,47
Airdrieon,5891,6,13,8,15,53,61,-8,47
Stenhousem'r,5891,7,12,8,16,55,67,-12,44
Queen's Park,5891,8,11,10,15,31,46,-15,43
Peterhead,5891,9,11,8,17,41,54,-13,41
Albion,5891,10,11,7,18,55,67,-12,40
Livingston,5892,1,23,4,9,84,46,38,73
Albion,5892,2,17,9,10,66,50,16,60
Brechin,5892,3,18,6,12,58,48,10,60
Peterhead,5892,4,16,7,13,55,50,5,55
Alloa,5892,5,15,8,13,55,44,11,53
Airdrieon,5892,6,15,8,13,58,58,0,53
East Fife,5892,7,13,8,15,50,46,4,47
Queen's Park,5892,8,11,7,18,37,64,-27,40
Stranraer,5892,9,10,6,20,51,69,-18,36
Stenhousem'r,5892,10,7,7,22,45,84,-39,28
Livingston,5893,1,20,11,5,86,44,42,71
Alloa,5893,2,17,10,9,63,50,13,61
Brechin,5893,3,16,8,12,50,45,5,56
Albion,5893,4,16,7,13,55,48,7,55
East Fife,5893,5,15,9,12,62,41,21,54
Airdrieon,5893,6,14,10,12,59,59,0,52
Peterhead,5893,7,13,7,16,44,57,-13,46
Queen's Park,5893,8,10,13,13,38,49,-11,43
Stranraer,5893,9,11,7,18,49,64,-15,40
Stenhousem'r,5893,10,4,6,26,36,85,-49,18
Livingston,5894,1,21,4,11,85,56,29,67
Alloa,5894,2,19,7,10,66,46,20,64
Airdrieon,5894,3,17,8,11,59,50,9,59
Queen's Park,5894,4,15,7,14,43,48,-5,52
Peterhead,5894,5,13,8,15,47,50,-3,47
Brechin,5894,6,13,8,15,41,47,-6,47
Albion,5894,7,13,5,18,51,59,-8,44
Stranraer,5894,8,13,5,18,56,67,-11,44
Stenhousem'r,5894,9,12,6,18,54,79,-25,42
East Fife,5894,10,10,10,16,45,45,0,40
Livingston,5895,1,20,7,9,78,44,34,67
Alloa,5895,2,18,10,8,72,45,27,64
Peterhead,5895,3,15,9,12,52,49,3,54
Albion,5895,4,15,7,14,51,64,-13,52
Airdrieon,5895,5,15,6,15,58,56,2,51
Stranraer,5895,6,15,5,16,51,53,-2,50
Queen's Park,5895,7,15,5,16,37,39,-2,50
Brechin,5895,8,12,7,17,50,50,0,43
East Fife,5895,9,11,6,19,45,57,-12,39
Stenhousem'r,5895,10,10,6,20,49,86,-37,36
Livingston,5896,1,20,9,7,89,45,44,69
Brechin,5896,2,17,12,7,59,44,15,63
Alloa,5896,3,17,6,13,71,51,20,57
Airdrieon,5896,4,15,11,10,55,48,7,56
Peterhead,5896,5,13,11,12,52,56,-4,50
Albion,5896,6,12,10,14,52,54,-2,46
Stranraer,5896,7,13,6,17,51,66,-15,45
Queen's Park,5896,8,11,10,15,35,53,-18,43
East Fife,5896,9,10,8,18,49,55,-6,38
Stenhousem'r,5896,10,6,9,21,38,79,-41,27
Livingston,5897,1,23,8,5,91,49,42,77
Brechin,5897,2,19,8,9,56,42,14,65
Airdrieon,5897,3,17,9,10,59,49,10,60
Albion,5897,4,14,11,11,61,51,10,53
Alloa,5897,5,13,11,12,46,41,5,50
Stranraer,5897,6,12,7,17,47,57,-10,43
East Fife,5897,7,9,13,14,43,47,-4,40
Queen's Park,5897,8,11,7,18,44,57,-13,40
Peterhead,5897,9,9,8,19,45,62,-17,35
Stenhousem'r,5897,10,8,8,20,38,75,-37,32
Brechin,5898,1,22,4,10,56,42,14,70
Livingston,5898,2,20,6,10,76,56,20,66
East Fife,5898,3,17,6,13,62,53,9,57
Airdrieon,5898,4,15,8,13,59,55,4,53
Alloa,5898,5,14,9,13,64,47,17,51
Peterhead,5898,6,14,9,13,51,53,-2,51
Albion,5898,7,13,8,15,47,54,-7,47
Queen's Park,5898,8,11,7,18,43,55,-12,40
Stranraer,5898,9,10,9,17,47,59,-12,39
Stenhousem'r,5898,10,7,8,21,47,78,-31,29
Livingston,5899,1,22,2,12,79,47,32,68
Alloa,5899,2,19,9,8,67,39,28,66
Airdrieon,5899,3,16,8,12,58,55,3,56
Albion,5899,4,15,8,13,52,47,5,53
Brechin,5899,5,15,6,15,45,44,1,51
East Fife,5899,6,13,9,14,54,43,11,48
Peterhead,5899,7,12,8,16,52,64,-12,44
Stranraer,5899,8,12,7,17,51,63,-12,43
Stenhousem'r,5899,9,10,8,18,45,76,-31,38
Queen's Park,5899,10,10,7,19,30,55,-25,37
Livingston,5900,1,20,9,7,84,44,40,69
Alloa,5900,2,20,7,9,75,46,29,67
Airdrieon,5900,3,16,8,12,56,54,2,56
Brechin,5900,4,14,11,11,51,51,0,53
East Fife,5900,5,12,11,13,52,54,-2,47
Stranraer,5900,6,13,7,16,58,63,-5,46
Queen's Park,5900,7,12,10,14,39,52,-13,46
Albion,5900,8,12,8,16,55,61,-6,44
Peterhead,5900,9,10,8,18,47,66,-19,38
Stenhousem'r,5900,10,6,11,19,45,71,-26,29
Alloa,5901,1,23,7,6,78,40,38,76
Livingston,5901,2,21,6,9,72,51,21,69
Brechin,5901,3,17,6,13,49,48,1,57
Airdrieon,5901,4,14,10,12,65,61,4,52
Peterhead,5901,5,14,7,15,56,58,-2,49
Queen's Park,5901,6,13,8,15,43,51,-8,47
Albion,5901,7,13,7,16,59,60,-1,46
Stranraer,5901,8,9,9,18,51,67,-16,36
East Fife,5901,9,10,5,21,42,51,-9,35
Stenhousem'r,5901,10,8,11,17,51,79,-28,35
Alloa,5902,1,19,9,8,76,39,37,66
Airdrieon,5902,2,20,5,11,59,46,13,65
Livingston,5902,3,19,2,15,76,58,18,59
Brechin,5902,4,16,7,13,48,41,7,55
Albion,5902,5,15,10,11,60,58,2,55
East Fife,5902,6,14,7,15,54,50,4,49
Peterhead,5902,7,13,6,17,49,53,-4,45
Stenhousem'r,5902,8,11,7,18,50,75,-25,40
Queen's Park,5902,9,11,5,20,29,64,-35,38
Stranraer,5902,10,11,4,21,44,61,-17,37
Alloa,5903,1,21,9,6,72,35,37,72
Livingston,5903,2,19,9,8,75,45,30,66
Queen's Park,5903,3,15,9,12,43,44,-1,54
Peterhead,5903,4,15,7,14,49,56,-7,52
Airdrieon,5903,5,15,7,14,51,64,-13,52
Albion,5903,6,12,12,12,52,47,5,48
Brechin,5903,7,15,3,18,50,60,-10,48
Stranraer,5903,8,12,7,17,45,54,-9,43
East Fife,5903,9,9,6,21,43,51,-8,33
Stenhousem'r,5903,10,8,9,19,43,67,-24,33
Alloa,5904,1,19,8,9,76,45,31,65
Livingston,5904,2,18,8,10,70,51,19,62
Brechin,5904,3,16,9,11,51,46,5,57
Airdrieon,5904,4,16,8,12,61,54,7,56
Albion,5904,5,11,13,12,45,47,-2,46
East Fife,5904,6,10,15,11,46,46,0,45
Peterhead,5904,7,11,12,13,51,55,-4,45
Stranraer,5904,8,12,6,18,51,67,-16,42
Stenhousem'r,5904,9,11,8,17,49,69,-20,41
Queen's Park,5904,10,10,5,21,37,57,-20,35
Livingston,5905,1,24,3,9,82,46,36,75
Alloa,5905,2,17,6,13,64,47,17,57
Brechin,5905,3,17,6,13,54,47,7,57
Airdrieon,5905,4,15,7,14,67,64,3,52
Peterhead,5905,5,15,4,17,41,46,-5,49
Stranraer,5905,6,15,4,17,52,63,-11,49
Albion,5905,7,13,9,14,45,46,-1,48
Queen's Park,5905,8,12,7,17,34,42,-8,43
East Fife,5905,9,11,9,16,51,59,-8,42
Stenhousem'r,5905,10,10,7,19,49,79,-30,37
Livingston,5906,1,21,4,11,76,52,24,67
Alloa,5906,2,17,10,9,76,40,36,61
Airdrieon,5906,3,17,7,12,56,52,4,58
Brechin,5906,4,14,10,12,50,44,6,52
Albion,5906,5,15,7,14,54,61,-7,52
Peterhead,5906,6,15,6,15,47,57,-10,51
Stenhousem'r,5906,7,11,10,15,54,68,-14,43
Stranraer,5906,8,13,4,19,49,64,-15,43
East Fife,5906,9,11,8,17,46,54,-8,41
Queen's Park,5906,10,8,10,18,34,50,-16,34
Alloa,5907,1,19,9,8,68,44,24,66
Livingston,5907,2,19,6,11,78,50,28,63
Airdrieon,5907,3,18,3,15,69,62,7,57
Brechin,5907,4,17,4,15,44,43,1,55
Albion,5907,5,15,8,13,46,47,-1,53
Stranraer,5907,6,14,5,17,50,55,-5,47
Queen's Park,5907,7,12,10,14,34,47,-13,46
Peterhead,5907,8,11,10,15,41,57,-16,43
Stenhousem'r,5907,9,10,8,18,48,67,-19,38
East Fife,5907,10,10,7,19,38,44,-6,37
Livingston,5908,1,23,3,10,73,45,28,72
Airdrieon,5908,2,19,6,11,67,54,13,63
Alloa,5908,3,19,5,12,63,41,22,62
Brechin,5908,4,20,2,14,52,49,3,62
Peterhead,5908,5,15,5,16,52,49,3,50
Albion,5908,6,14,8,14,52,57,-5,50
Stenhousem'r,5908,7,12,5,19,45,64,-19,41
East Fife,5908,8,11,6,19,49,59,-10,39
Queen's Park,5908,9,11,6,19,30,52,-22,39
Stranraer,5908,10,10,6,20,51,64,-13,36
Livingston,5909,1,19,8,9,75,51,24,65
Alloa,5909,2,17,10,9,70,50,20,61
Brechin,5909,3,17,8,11,50,51,-1,59
Airdrieon,5909,4,16,10,10,65,50,15,58
Albion,5909,5,15,8,13,55,54,1,53
Queen's Park,5909,6,13,10,13,37,46,-9,49
Peterhead,5909,7,13,8,15,54,59,-5,47
Stranraer,5909,8,12,6,18,49,55,-6,42
East Fife,5909,9,10,8,18,51,52,-1,38
Stenhousem'r,5909,10,6,8,22,44,82,-38,26
Alloa,5910,1,22,7,7,76,41,35,73
Livingston,5910,2,21,4,11,64,45,19,67
Airdrieon,5910,3,19,4,13,66,56,10,61
Brechin,5910,4,16,5,15,53,52,1,53
Albion,5910,5,15,5,16,56,52,4,50
Peterhead,5910,6,14,8,14,47,55,-8,50
East Fife,5910,7,13,8,15,57,47,10,47
Queen's Park,5910,8,13,8,15,45,54,-9,47
Stranraer,5910,9,11,4,21,50,67,-17,37
Stenhousem'r,5910,10,6,7,23,44,89,-45,25
Livingston,5911,1,19,8,9,76,48,28,65
Alloa,5911,2,17,10,9,74,50,24,61
Brechin,5911,3,17,9,10,59,47,12,60
Airdrieon,5911,4,16,4,16,54,57,-3,52
Stranraer,5911,5,15,6,15,58,60,-2,51
Peterhead,5911,6,13,8,15,52,56,-4,47
Queen's Park,5911,7,13,7,16,41,53,-12,46
Albion,5911,8,11,11,14,53,55,-2,44
East Fife,5911,9,9,11,16,45,60,-15,38
Stenhousem'r,5911,10,10,6,20,52,78,-26,36
Livingston,5912,1,20,8,8,82,49,33,68
Alloa,5912,2,20,8,8,68,38,30,68
Airdrieon,5912,3,17,6,13,63,58,5,57
Albion,5912,4,14,10,12,52,47,5,52
Peterhead,5912,5,15,7,14,51,52,-1,52
Brechin,5912,6,15,7,14,46,50,-4,52
East Fife,5912,7,10,12,14,51,52,-1,42
Stranraer,5912,8,11,8,17,60,73,-13,41
Queen's Park,5912,9,8,11,17,38,56,-18,35
Stenhousem'r,5912,10,7,9,20,50,86,-36,30
Livingston,5913,1,22,6,8,68,39,29,72
Airdrieon,5913,2,21,2,13,67,59,8,65
Alloa,5913,3,17,10,9,79,44,35,61
Stranraer,5913,4,16,6,14,58,59,-1,54
Albion,5913,5,15,6,15,56,57,-1,51
Brechin,5913,6,15,4,17,52,53,-1,49
East Fife,5913,7,12,6,18,47,50,-3,42
Peterhead,5913,8,10,12,14,40,51,-11,42
Stenhousem'r,5913,9,9,8,19,48,81,-33,35
Queen's Park,5913,10,8,10,18,29,51,-22,34
Livingston,5914,1,21,3,12,74,52,22,66
Alloa,5914,2,18,8,10,64,45,19,62
Airdrieon,5914,3,17,6,13,62,63,-1,57
Brechin,5914,4,17,5,14,54,46,8,56
Albion,5914,5,15,9,12,57,51,6,54
Peterhead,5914,6,14,10,12,51,48,3,52
Stranraer,5914,7,13,8,15,57,58,-1,47
East Fife,5914,8,11,10,15,49,45,4,43
Queen's Park,5914,9,8,10,18,29,55,-26,34
Stenhousem'r,5914,10,9,5,22,49,83,-34,32
Alloa,5915,1,20,5,11,67,47,20,65
Livingston,5915,2,18,6,12,78,58,20,60
Brechin,5915,3,18,6,12,52,44,8,60
Airdrieon,5915,4,17,7,12,67,61,6,58
East Fife,5915,5,16,5,15,62,49,13,53
Queen's Park,5915,6,14,9,13,38,46,-8,51
Albion,5915,7,13,10,13,57,52,5,49
Stranraer,5915,8,14,3,19,57,67,-10,45
Peterhead,5915,9,12,8,16,54,59,-5,44
Stenhousem'r,5915,10,4,9,23,38,87,-49,21
Alloa,5916,1,21,6,9,71,41,30,69
Livingston,5916,2,20,6,10,81,46,35,66
Airdrieon,5916,3,16,11,9,58,47,11,59
Peterhead,5916,4,15,6,15,52,53,-1,51
Albion,5916,5,12,12,12,52,54,-2,48
Brechin,5916,6,14,5,17,45,55,-10,47
East Fife,5916,7,11,11,14,51,47,4,44
Stranraer,5916,8,11,10,15,47,54,-7,43
Queen's Park,5916,9,12,6,18,42,62,-20,42
Stenhousem'r,5916,10,7,9,20,42,82,-40,30
Alloa,5917,1,22,6,8,75,38,37,72
Livingston,5917,2,20,3,13,72,50,22,63
Airdrieon,5917,3,19,4,13,56,50,6,61
Brechin,5917,4,17,7,12,51,48,3,58
Peterhead,5917,5,16,7,13,52,53,-1,55
East Fife,5917,6,13,9,14,46,41,5,48
Queen's Park,5917,7,10,10,16,35,50,-15,40
Stranraer,5917,8,10,7,19,44,56,-12,37
Albion,5917,9,9,10,17,44,58,-14,37
Stenhousem'r,5917,10,9,7,20,47,78,-31,34
Alloa,5918,1,22,7,7,73,44,29,73
Airdrieon,5918,2,16,9,11,62,57,5,57
Livingston,5918,3,15,9,12,64,48,16,54
Brechin,5918,4,15,7,14,58,54,4,52
Albion,5918,5,14,8,14,57,50,7,50
East Fife,5918,6,12,12,12,56,51,5,48
Peterhead,5918,7,13,9,14,57,67,-10,48
Queen's Park,5918,8,12,8,16,48,57,-9,44
Stranraer,5918,9,11,8,17,44,55,-11,41
Stenhousem'r,5918,10,8,7,21,39,75,-36,31
Livingston,5919,1,22,5,9,87,46,41,71
Alloa,5919,2,17,7,12,64,50,14,58
Brechin,5919,3,16,8,12,52,49,3,56
Stranraer,5919,4,16,5,15,60,58,2,53
Albion,5919,5,15,7,14,57,58,-1,52
East Fife,5919,6,12,14,10,51,42,9,50
Peterhead,5919,7,13,10,13,50,53,-3,49
Airdrieon,5919,8,13,7,16,51,64,-13,46
Queen's Park,5919,9,9,11,16,35,49,-14,38
Stenhousem'r,5919,10,5,10,21,44,82,-38,25
Brechin,5920,1,20,7,9,62,44,18,67
Airdrieon,5920,2,19,5,12,66,53,13,62
Livingston,5920,3,18,6,12,76,57,19,60
Alloa,5920,4,17,6,13,65,52,13,57
Queen's Park,5920,5,15,6,15,43,52,-9,51
Stranraer,5920,6,14,6,16,55,56,-1,48
Peterhead,5920,7,13,8,15,47,57,-10,47
Albion,5920,8,14,4,18,57,61,-4,46
East Fife,5920,9,10,12,14,52,51,1,42
Stenhousem'r,5920,10,6,8,22,42,82,-40,26
Livingston,5921,1,23,6,7,72,42,30,75
Alloa,5921,2,18,7,11,60,40,20,61
Peterhead,5921,3,17,5,14,56,51,5,56
Airdrieon,5921,4,16,7,13,53,43,10,55
East Fife,5921,5,14,8,14,53,48,5,50
Albion,5921,6,13,6,17,54,58,-4,45
Brechin,5921,7,11,10,15,42,49,-7,43
Stranraer,5921,8,11,8,17,48,60,-12,41
Queen's Park,5921,9,11,8,17,38,54,-16,41
Stenhousem'r,5921,10,10,7,19,46,77,-31,37
Livingston,5922,1,23,3,10,83,53,30,72
Alloa,5922,2,17,7,12,64,47,17,58
Airdrieon,5922,3,17,6,13,56,53,3,57
Peterhead,5922,4,15,10,11,57,49,8,55
Queen's Park,5922,5,14,7,15,37,50,-13,49
Albion,5922,6,13,9,14,60,59,1,48
Stranraer,5922,7,13,7,16,51,58,-7,46
Brechin,5922,8,13,5,18,46,52,-6,44
East Fife,5922,9,9,11,16,41,49,-8,38
Stenhousem'r,5922,10,9,9,18,50,75,-25,36
Livingston,5923,1,23,5,8,78,37,41,74
Alloa,5923,2,19,8,9,75,50,25,65
Airdrieon,5923,3,18,3,15,54,50,4,57
Albion,5923,4,16,6,14,55,52,3,54
East Fife,5923,5,14,8,14,53,48,5,50
Brechin,5923,6,14,8,14,40,43,-3,50
Peterhead,5923,7,11,9,16,41,56,-15,42
Stranraer,5923,8,11,7,18,43,61,-18,40
Stenhousem'r,5923,9,11,6,19,52,72,-20,39
Queen's Park,5923,10,10,6,20,31,53,-22,36
Livingston,5924,1,19,8,9,82,49,33,65
Brechin,5924,2,19,8,9,55,48,7,65
Airdrieon,5924,3,18,5,13,62,55,7,59
Alloa,5924,4,15,9,12,67,49,18,54
Peterhead,5924,5,15,9,12,56,53,3,54
Stranraer,5924,6,14,6,16,57,57,0,48
Queen's Park,5924,7,14,5,17,40,56,-16,47
East Fife,5924,8,10,11,15,46,49,-3,41
Albion,5924,9,10,10,16,50,58,-8,40
Stenhousem'r,5924,10,8,5,23,51,92,-41,29
Livingston,5925,1,21,7,8,70,43,27,70
Alloa,5925,2,19,10,7,74,43,31,67
Brechin,5925,3,18,6,12,59,43,16,60
Airdrieon,5925,4,18,4,14,58,55,3,58
Peterhead,5925,5,13,6,17,43,52,-9,45
East Fife,5925,6,12,8,16,48,55,-7,44
Queen's Park,5925,7,11,10,15,36,47,-11,43
Albion,5925,8,10,12,14,44,48,-4,42
Stenhousem'r,5925,9,11,5,20,48,76,-28,38
Stranraer,5925,10,10,6,20,45,63,-18,36
Alloa,5926,1,19,8,9,70,43,27,65
Airdrieon,5926,2,17,7,12,67,57,10,58
Livingston,5926,3,16,9,11,69,49,20,57
Brechin,5926,4,16,8,12,53,47,6,56
Stranraer,5926,5,14,6,16,50,49,1,48
Albion,5926,6,13,8,15,46,53,-7,47
East Fife,5926,7,12,10,14,56,53,3,46
Peterhead,5926,8,13,7,16,46,58,-12,46
Queen's Park,5926,9,11,8,17,40,59,-19,41
Stenhousem'r,5926,10,9,9,18,52,81,-29,36
Livingston,5927,1,20,1,15,76,52,24,61
Brechin,5927,2,18,7,11,51,38,13,61
Airdrieon,5927,3,18,5,13,61,60,1,59
Stranraer,5927,4,17,6,13,52,51,1,57
Alloa,5927,5,16,6,14,66,54,12,54
Albion,5927,6,15,9,12,56,46,10,54
East Fife,5927,7,14,7,15,49,44,5,49
Peterhead,5927,8,12,10,14,52,55,-3,46
Queen's Park,5927,9,9,8,19,30,59,-29,35
Stenhousem'r,5927,10,8,7,21,40,74,-34,31
Airdrieon,5928,1,20,7,9,71,59,12,67
Alloa,5928,2,20,6,10,76,44,32,66
Livingston,5928,3,20,6,10,81,51,30,66
Albion,5928,4,16,9,11,64,46,18,57
Brechin,5928,5,17,4,15,61,56,5,55
Peterhead,5928,6,14,8,14,55,57,-2,50
Queen's Park,5928,7,12,6,18,29,57,-28,42
East Fife,5928,8,10,11,15,48,52,-4,41
Stranraer,5928,9,11,5,20,51,72,-21,38
Stenhousem'r,5928,10,6,6,24,43,85,-42,24
Brechin,5929,1,20,6,10,55,37,18,66
Livingston,5929,2,19,8,9,70,50,20,65
Alloa,5929,3,19,5,12,67,52,15,62
Airdrieon,5929,4,15,11,10,52,45,7,56
Albion,5929,5,15,6,15,53,48,5,51
Peterhead,5929,6,13,8,15,45,46,-1,47
Queen's Park,5929,7,12,9,15,43,53,-10,45
East Fife,5929,8,11,11,14,50,48,2,44
Stranraer,5929,9,13,5,18,52,64,-12,44
Stenhousem'r,5929,10,5,7,24,40,84,-44,22
Livingston,5930,1,21,5,10,82,42,40,68
Alloa,5930,2,19,5,12,77,48,29,62
Brechin,5930,3,18,5,13,52,41,11,59
Albion,5930,4,16,5,15,52,53,-1,53
Airdrieon,5930,5,15,7,14,51,47,4,52
East Fife,5930,6,15,6,15,48,47,1,51
Peterhead,5930,7,14,8,14,52,59,-7,50
Queen's Park,5930,8,13,6,17,42,57,-15,45
Stranraer,5930,9,11,6,19,47,72,-25,39
Stenhousem'r,5930,10,7,9,20,41,78,-37,30
Alloa,5931,1,23,6,7,77,41,36,75
Livingston,5931,2,21,7,8,77,45,32,70
Airdrieon,5931,3,16,7,13,60,52,8,55
Albion,5931,4,16,6,14,62,60,2,54
Brechin,5931,5,16,5,15,46,52,-6,53
Peterhead,5931,6,13,7,16,48,56,-8,46
Stranraer,5931,7,14,3,19,53,57,-4,45
Queen's Park,5931,8,12,7,17,45,61,-16,43
East Fife,5931,9,11,8,17,48,57,-9,41
Stenhousem'r,5931,10,6,8,22,44,79,-35,26
Alloa,5932,1,23,5,8,68,41,27,74
Livingston,5932,2,21,6,9,86,51,35,69
Brechin,5932,3,18,5,13,58,46,12,59
Peterhead,5932,4,15,10,11,57,48,9,55
Airdrieon,5932,5,15,9,12,56,58,-2,54
Albion,5932,6,14,7,15,59,58,1,49
East Fife,5932,7,13,9,14,56,56,0,48
Stranraer,5932,8,11,7,18,48,66,-18,40
Queen's Park,5932,9,10,5,21,33,58,-25,35
Stenhousem'r,5932,10,5,7,24,47,86,-39,22
Alloa,5933,1,21,7,8,76,41,35,70
Livingston,5933,2,19,8,9,73,48,25,65
Airdrieon,5933,3,16,6,14,61,53,8,54
Brechin,5933,4,15,6,15,50,55,-5,51
Stranraer,5933,5,15,5,16,56,58,-2,50
Albion,5933,6,12,11,13,54,56,-2,47
Peterhead,5933,7,12,11,13,42,46,-4,47
Queen's Park,5933,8,11,10,15,36,48,-12,43
Stenhousem'r,5933,9,11,8,17,54,77,-23,41
East Fife,5933,10,7,10,19,35,55,-20,31
Alloa,5934,1,22,6,8,79,38,41,72
Livingston,5934,2,21,2,13,77,57,20,65
Brechin,5934,3,16,11,9,60,44,16,59
Peterhead,5934,4,16,8,12,57,51,6,56
Airdrieon,5934,5,16,8,12,59,54,5,56
Albion,5934,6,16,4,16,70,65,5,52
Queen's Park,5934,7,14,6,16,40,57,-17,48
Stenhousem'r,5934,8,11,6,19,49,83,-34,39
East Fife,5934,9,9,7,20,44,56,-12,34
Stranraer,5934,10,8,4,24,44,74,-30,28
Alloa,5935,1,20,7,9,79,43,36,67
Livingston,5935,2,21,4,11,75,56,19,67
Airdrieon,5935,3,17,9,10,56,52,4,60
Albion,5935,4,16,9,11,62,57,5,57
Brechin,5935,5,16,7,13,47,47,0,55
Stranraer,5935,6,12,7,17,56,55,1,43
Peterhead,5935,7,11,8,17,49,59,-10,41
Queen's Park,5935,8,12,5,19,39,54,-15,41
Stenhousem'r,5935,9,11,7,18,50,75,-25,40
East Fife,5935,10,8,9,19,41,56,-15,33
Livingston,5936,1,20,7,9,72,42,30,67
Alloa,5936,2,18,7,11,81,55,26,61
Brechin,5936,3,18,7,11,63,51,12,61
Airdrieon,5936,4,17,4,15,57,56,1,55
Albion,5936,5,16,6,14,58,58,0,54
Peterhead,5936,6,14,11,11,66,59,7,53
East Fife,5936,7,11,9,16,53,55,-2,42
Queen's Park,5936,8,12,6,18,35,46,-11,42
Stranraer,5936,9,10,10,16,48,60,-12,40
Stenhousem'r,5936,10,8,5,23,41,92,-51,29
Livingston,5937,1,21,5,10,77,47,30,68
Alloa,5937,2,18,8,10,65,45,20,62
Brechin,5937,3,18,3,15,57,50,7,57
East Fife,5937,4,16,7,13,60,46,14,55
Airdrieon,5937,5,17,4,15,55,53,2,55
Peterhead,5937,6,14,10,12,54,54,0,52
Stranraer,5937,7,15,4,17,52,55,-3,49
Albion,5937,8,12,7,17,44,59,-15,43
Queen's Park,5937,9,11,7,18,35,53,-18,40
Stenhousem'r,5937,10,7,7,22,38,75,-37,28
Livingston,5938,1,22,4,10,86,42,44,70
Brechin,5938,2,18,12,6,51,35,16,66
Alloa,5938,3,18,7,11,66,46,20,61
Peterhead,5938,4,17,7,12,52,39,13,58
Airdrieon,5938,5,15,8,13,53,52,1,53
Queen's Park,5938,6,13,8,15,37,47,-10,47
Albion,5938,7,9,10,17,47,64,-17,37
East Fife,5938,8,8,12,16,52,66,-14,36
Stranraer,5938,9,10,6,20,39,59,-20,36
Stenhousem'r,5938,10,7,12,17,44,77,-33,33
Livingston,5939,1,24,4,8,80,46,34,76
Alloa,5939,2,20,8,8,75,45,30,68
Brechin,5939,3,17,8,11,54,50,4,59
Albion,5939,4,16,10,10,57,50,7,58
Peterhead,5939,5,13,12,11,58,48,10,51
Airdrieon,5939,6,12,8,16,48,62,-14,44
Stranraer,5939,7,13,4,19,43,55,-12,43
Queen's Park,5939,8,10,9,17,41,61,-20,39
East Fife,5939,9,7,12,17,45,59,-14,33
Stenhousem'r,5939,10,8,5,23,50,75,-25,29
Livingston,5940,1,20,8,8,83,54,29,68
Alloa,5940,2,18,11,7,69,40,29,65
Albion,5940,3,15,10,11,61,51,10,55
Brechin,5940,4,15,7,14,54,56,-2,52
Stranraer,5940,5,14,5,17,53,62,-9,47
Airdrieon,5940,6,12,7,17,52,65,-13,43
Stenhousem'r,5940,7,12,7,17,49,68,-19,43
East Fife,5940,8,10,12,14,46,44,2,42
Peterhead,5940,9,11,9,16,43,56,-13,42
Queen's Park,5940,10,10,10,16,35,49,-14,40
Livingston,5941,1,23,3,10,79,46,33,72
Alloa,5941,2,20,11,5,71,38,33,71
Brechin,5941,3,17,7,12,42,41,1,58
Airdrieon,5941,4,16,4,16,56,58,-2,52
Albion,5941,5,14,8,14,63,54,9,50
Queen's Park,5941,6,13,11,12,42,51,-9,50
Stranraer,5941,7,14,6,16,51,58,-7,48
East Fife,5941,8,8,12,16,50,53,-3,36
Peterhead,5941,9,9,9,18,39,52,-13,36
Stenhousem'r,5941,10,6,9,21,45,87,-42,27
Livingston,5942,1,19,9,8,75,47,28,66
Alloa,5942,2,19,6,11,76,47,29,63
Brechin,5942,3,17,9,10,56,49,7,60
Airdrieon,5942,4,14,9,13,58,58,0,51
Peterhead,5942,5,14,7,15,56,59,-3,49
Stranraer,5942,6,14,5,17,55,62,-7,47
Stenhousem'r,5942,7,11,10,15,58,72,-14,43
Albion,5942,8,10,12,14,46,61,-15,42
Queen's Park,5942,9,11,7,18,42,58,-16,40
East Fife,5942,10,8,12,16,39,48,-9,36
Alloa,5943,1,21,7,8,75,41,34,70
Livingston,5943,2,21,5,10,67,38,29,68
Airdrieon,5943,3,20,4,12,56,49,7,64
Peterhead,5943,4,17,6,13,58,52,6,57
Queen's Park,5943,5,14,9,13,39,41,-2,51
Brechin,5943,6,14,5,17,46,59,-13,47
Albion,5943,7,12,8,16,49,53,-4,44
Stranraer,5943,8,13,5,18,54,60,-6,44
East Fife,5943,9,10,6,20,42,57,-15,36
Stenhousem'r,5943,10,7,7,22,42,78,-36,28
Livingston,5944,1,26,3,7,76,34,42,81
Airdrieon,5944,2,22,4,10,68,47,21,70
Alloa,5944,3,20,7,9,63,36,27,67
Brechin,5944,4,18,4,14,50,41,9,58
Albion,5944,5,12,11,13,53,54,-1,47
East Fife,5944,6,10,12,14,41,44,-3,42
Peterhead,5944,7,11,7,18,46,57,-11,40
Stranraer,5944,8,11,5,20,52,70,-18,38
Queen's Park,5944,9,9,9,18,29,50,-21,36
Stenhousem'r,5944,10,7,6,23,38,83,-45,27
Brechin,5945,1,21,6,9,58,41,17,69
Alloa,5945,2,19,8,9,81,44,37,65
Livingston,5945,3,17,6,13,69,48,21,57
Airdrieon,5945,4,14,11,11,53,55,-2,53
East Fife,5945,5,11,12,13,51,45,6,45
Peterhead,5945,6,12,9,15,47,59,-12,45
Albion,5945,7,11,10,15,53,59,-6,43
Queen's Park,5945,8,12,7,17,29,49,-20,43
Stranraer,5945,9,12,6,18,41,52,-11,42
Stenhousem'r,5945,10,10,7,19,47,77,-30,37
Alloa,5946,1,24,5,7,68,31,37,77
Airdrieon,5946,2,18,7,11,63,61,2,61
Peterhead,5946,3,18,5,13,52,48,4,59
Livingston,5946,4,17,5,14,74,51,23,56
Brechin,5946,5,16,7,13,55,51,4,55
Albion,5946,6,15,6,15,61,59,2,51
Queen's Park,5946,7,14,5,17,47,67,-20,47
East Fife,5946,8,11,11,14,50,45,5,44
Stranraer,5946,9,11,3,22,47,62,-15,36
Stenhousem'r,5946,10,6,6,24,41,83,-42,24
Livingston,5947,1,21,5,10,71,43,28,68
Airdrieon,5947,2,18,9,9,66,50,16,63
Alloa,5947,3,18,7,11,66,48,18,61
Albion,5947,4,14,8,14,56,57,-1,50
Brechin,5947,5,13,8,15,52,59,-7,47
Stranraer,5947,6,13,7,16,52,54,-2,46
Peterhead,5947,7,12,10,14,46,48,-2,46
Queen's Park,5947,8,13,7,16,33,46,-13,46
East Fife,5947,9,9,11,16,43,54,-11,38
Stenhousem'r,5947,10,10,6,20,59,85,-26,36
Livingston,5948,1,23,3,10,90,49,41,72
Brechin,5948,2,20,4,12,53,49,4,64
Alloa,5948,3,18,9,9,68,47,21,63
Stranraer,5948,4,18,4,14,53,52,1,58
Airdrieon,5948,5,15,10,11,60,55,5,55
Peterhead,5948,6,11,12,13,39,48,-9,45
Albion,5948,7,11,9,16,45,51,-6,42
Queen's Park,5948,8,11,6,19,38,54,-16,39
East Fife,5948,9,9,10,17,51,54,-3,37
Stenhousem'r,5948,10,8,5,23,45,83,-38,29
Livingston,5949,1,23,3,10,80,39,41,72
Alloa,5949,2,20,7,9,73,41,32,67
Airdrieon,5949,3,17,7,12,46,40,6,58
Brechin,5949,4,16,9,11,53,44,9,57
East Fife,5949,5,16,6,14,50,50,0,54
Albion,5949,6,15,8,13,52,51,1,53
Stranraer,5949,7,11,6,19,49,69,-20,39
Queen's Park,5949,8,12,3,21,32,56,-24,39
Peterhead,5949,9,10,8,18,45,57,-12,38
Stenhousem'r,5949,10,8,7,21,41,74,-33,31
Alloa,5950,1,18,9,9,76,48,28,63
Livingston,5950,2,19,5,12,81,56,25,62
Brechin,5950,3,19,5,12,59,53,6,62
Airdrieon,5950,4,18,6,12,62,52,10,60
Albion,5950,5,16,9,11,56,50,6,57
Stranraer,5950,6,13,6,17,53,57,-4,45
Peterhead,5950,7,13,6,17,54,61,-7,45
East Fife,5950,8,12,8,16,56,57,-1,44
Queen's Park,5950,9,9,7,20,36,63,-27,34
Stenhousem'r,5950,10,8,9,19,45,81,-36,33
Livingston,5951,1,24,4,8,80,48,32,76
Airdrieon,5951,2,19,7,10,57,44,13,64
Peterhead,5951,3,16,6,14,51,57,-6,54
Alloa,5951,4,14,9,13,60,50,10,51
Stranraer,5951,5,14,9,13,52,53,-1,51
Brechin,5951,6,15,6,15,44,46,-2,51
Albion,5951,7,13,5,18,48,55,-7,44
Queen's Park,5951,8,12,8,16,45,52,-7,44
East Fife,5951,9,10,9,17,46,47,-1,39
Stenhousem'r,5951,10,7,9,20,46,77,-31,30
Alloa,5952,1,21,7,8,67,39,28,70
Livingston,5952,2,20,4,12,82,61,21,64
Peterhead,5952,3,15,9,12,50,45,5,54
Albion,5952,4,15,8,13,65,57,8,53
Brechin,5952,5,16,4,16,56,54,2,52
Airdrieon,5952,6,15,6,15,61,64,-3,51
East Fife,5952,7,13,10,13,54,54,0,49
Queen's Park,5952,8,11,10,15,37,44,-7,43
Stranraer,5952,9,11,6,19,51,66,-15,39
Stenhousem'r,5952,10,9,4,23,40,79,-39,31
Livingston,5953,1,21,5,10,79,44,35,68
Brechin,5953,2,21,5,10,60,45,15,68
Alloa,5953,3,17,7,12,59,46,13,58
Peterhead,5953,4,16,7,13,59,49,10,55
Airdrieon,5953,5,16,6,14,54,55,-1,54
Stranraer,5953,6,14,8,14,51,55,-4,50
Albion,5953,7,12,8,16,52,59,-7,44
Queen's Park,5953,8,12,7,17,32,53,-21,43
East Fife,5953,9,9,11,16,52,54,-2,38
Stenhousem'r,5953,10,6,8,22,40,78,-38,26
Alloa,5954,1,21,8,7,78,38,40,71
Livingston,5954,2,21,6,9,74,42,32,69
Brechin,5954,3,16,6,14,54,53,1,54
Airdrieon,5954,4,14,10,12,58,56,2,52
Albion,5954,5,15,6,15,50,54,-4,51
Queen's Park,5954,6,14,9,13,40,47,-7,51
Peterhead,5954,7,13,9,14,46,52,-6,48
East Fife,5954,8,10,9,17,46,51,-5,39
Stranraer,5954,9,9,8,19,40,64,-24,35
Stenhousem'r,5954,10,6,11,19,42,71,-29,29
Alloa,5955,1,19,8,9,71,42,29,65
Livingston,5955,2,18,9,9,61,40,21,63
Brechin,5955,3,17,11,8,61,49,12,62
Airdrieon,5955,4,15,9,12,57,57,0,54
Peterhead,5955,5,15,9,12,57,59,-2,54
Stranraer,5955,6,12,9,15,54,59,-5,45
East Fife,5955,7,10,12,14,47,50,-3,42
Albion,5955,8,10,10,16,47,57,-10,40
Stenhousem'r,5955,9,9,9,18,47,71,-24,36
Queen's Park,5955,10,8,8,20,38,56,-18,32
Airdrieon,5956,1,20,7,9,65,50,15,67
Alloa,5956,2,17,10,9,73,53,20,61
Brechin,5956,3,16,9,11,49,47,2,57
Livingston,5956,4,16,8,12,74,56,18,56
Albion,5956,5,16,6,14,51,49,2,54
Queen's Park,5956,6,14,10,12,40,48,-8,52
Peterhead,5956,7,11,13,12,53,50,3,46
Stranraer,5956,8,11,6,19,51,60,-9,39
East Fife,5956,9,10,5,21,45,60,-15,35
Stenhousem'r,5956,10,10,4,22,51,79,-28,34
Livingston,5957,1,20,4,12,78,45,33,64
Peterhead,5957,2,19,7,10,55,46,9,64
Alloa,5957,3,18,8,10,66,46,20,62
Brechin,5957,4,16,7,13,52,46,6,55
Queen's Park,5957,5,15,7,14,42,47,-5,52
Airdrieon,5957,6,14,8,14,52,58,-6,50
Stranraer,5957,7,14,6,16,55,53,2,48
Albion,5957,8,11,10,15,49,51,-2,43
East Fife,5957,9,10,11,15,56,59,-3,41
Stenhousem'r,5957,10,6,6,24,45,99,-54,24
Livingston,5958,1,21,5,10,73,43,30,68
Alloa,5958,2,19,10,7,70,42,28,67
Airdrieon,5958,3,18,5,13,62,54,8,59
Albion,5958,4,15,9,12,54,46,8,54
Stranraer,5958,5,16,5,15,61,61,0,53
Brechin,5958,6,15,5,16,44,47,-3,50
Peterhead,5958,7,12,9,15,45,56,-11,45
Queen's Park,5958,8,13,5,18,39,49,-10,44
East Fife,5958,9,9,8,19,44,60,-16,35
Stenhousem'r,5958,10,8,7,21,42,76,-34,31
Livingston,5959,1,24,4,8,93,51,42,76
Alloa,5959,2,21,6,9,76,48,28,69
Airdrieon,5959,3,18,8,10,71,54,17,62
Brechin,5959,4,18,5,13,53,47,6,59
Peterhead,5959,5,13,9,14,55,53,2,48
Queen's Park,5959,6,13,8,15,38,48,-10,47
Albion,5959,7,12,8,16,45,53,-8,44
East Fife,5959,8,10,10,16,42,46,-4,40
Stranraer,5959,9,9,7,20,50,67,-17,34
Stenhousem'r,5959,10,5,9,22,46,102,-56,24
Airdrieon,5960,1,21,5,10,69,52,17,68
Alloa,5960,2,20,6,10,64,47,17,66
Livingston,5960,3,17,8,11,64,50,14,59
Brechin,5960,4,16,8,12,52,51,1,56
Stranraer,5960,5,14,6,16,55,52,3,48
Albion,5960,6,12,10,14,50,53,-3,46
Queen's Park,5960,7,11,9,16,35,52,-17,42
East Fife,5960,8,10,9,17,47,51,-4,39
Peterhead,5960,9,9,12,15,38,49,-11,39
Stenhousem'r,5960,10,9,9,18,55,72,-17,36
Livingston,5961,1,22,4,10,80,42,38,70
Alloa,5961,2,18,9,9,72,52,20,63
Stranraer,5961,3,16,5,15,54,54,0,53
Airdrieon,5961,4,15,8,13,56,60,-4,53
Brechin,5961,5,15,5,16,51,45,6,50
Albion,5961,6,15,5,16,56,58,-2,50
East Fife,5961,7,12,10,14,52,50,2,46
Peterhead,5961,8,13,7,16,49,56,-7,46
Queen's Park,5961,9,13,6,17,38,57,-19,45
Stenhousem'r,5961,10,8,7,21,52,86,-34,31
Livingston,5962,1,22,4,10,85,44,41,70
Alloa,5962,2,20,9,7,70,36,34,69
Airdrieon,5962,3,17,8,11,57,49,8,59
Queen's Park,5962,4,14,8,14,44,56,-12,50
East Fife,5962,5,12,11,13,41,44,-3,47
Brechin,5962,6,14,5,17,47,52,-5,47
Peterhead,5962,7,13,8,15,51,58,-7,47
Stranraer,5962,8,13,6,17,47,62,-15,45
Albion,5962,9,10,9,17,51,58,-7,39
Stenhousem'r,5962,10,7,8,21,52,86,-34,29
Livingston,5963,1,23,4,9,75,36,39,73
Alloa,5963,2,21,7,8,79,43,36,70
Brechin,5963,3,20,4,12,53,42,11,64
Airdrieon,5963,4,19,7,10,63,58,5,64
Albion,5963,5,12,9,15,51,51,0,45
Queen's Park,5963,6,11,10,15,36,52,-16,43
East Fife,5963,7,10,10,16,45,45,0,40
Peterhead,5963,8,10,9,17,40,53,-13,39
Stranraer,5963,9,11,6,19,39,63,-24,39
Stenhousem'r,5963,10,7,6,23,40,78,-38,27
Alloa,5964,1,20,7,9,77,48,29,67
Airdrieon,5964,2,20,5,11,69,51,18,65
Livingston,5964,3,20,4,12,71,51,20,64
Brechin,5964,4,18,8,10,58,44,14,62
Peterhead,5964,5,16,6,14,50,51,-1,54
East Fife,5964,6,12,9,15,53,53,0,45
Albion,5964,7,12,8,16,55,57,-2,44
Queen's Park,5964,8,12,7,17,37,61,-24,43
Stranraer,5964,9,11,5,20,48,65,-17,38
Stenhousem'r,5964,10,5,9,22,51,88,-37,24
Airdrieon,5965,1,18,8,10,72,55,17,62
Alloa,5965,2,16,11,9,68,47,21,59
Livingston,5965,3,18,4,14,70,57,13,58
Queen's Park,5965,4,16,9,11,47,43,4,57
Albion,5965,5,15,9,12,53,48,5,54
Brechin,5965,6,14,10,12,48,49,-1,52
Peterhead,5965,7,11,12,13,53,54,-1,45
Stranraer,5965,8,12,6,18,54,68,-14,42
East Fife,5965,9,9,10,17,41,51,-10,37
Stenhousem'r,5965,10,8,7,21,43,77,-34,31
Livingston,5966,1,20,6,10,75,45,30,66
Alloa,5966,2,17,9,10,66,53,13,60
Airdrieon,5966,3,17,7,12,58,52,6,58
Brechin,5966,4,16,9,11,51,53,-2,57
Queen's Park,5966,5,16,3,17,38,46,-8,51
Albion,5966,6,13,9,14,50,45,5,48
Peterhead,5966,7,13,9,14,50,49,1,48
East Fife,5966,8,11,11,14,44,48,-4,44
Stranraer,5966,9,11,7,18,44,57,-13,40
Stenhousem'r,5966,10,6,10,20,40,68,-28,28
Livingston,5967,1,19,7,10,78,51,27,64
Alloa,5967,2,18,6,12,70,46,24,60
Peterhead,5967,3,15,12,9,44,36,8,57
East Fife,5967,4,15,10,11,57,46,11,55
Airdrieon,5967,5,15,9,12,53,57,-4,54
Brechin,5967,6,16,4,16,46,51,-5,52
Stranraer,5967,7,12,11,13,50,49,1,47
Albion,5967,8,12,8,16,49,50,-1,44
Queen's Park,5967,9,12,7,17,41,53,-12,43
Stenhousem'r,5967,10,5,8,23,36,85,-49,23
Brechin,5968,1,18,9,9,51,40,11,63
Airdrieon,5968,2,19,6,11,56,49,7,63
Alloa,5968,3,18,7,11,64,53,11,61
Livingston,5968,4,18,6,12,70,46,24,60
East Fife,5968,5,14,9,13,55,47,8,51
Albion,5968,6,14,6,16,56,57,-1,48
Stranraer,5968,7,13,5,18,51,59,-8,44
Queen's Park,5968,8,11,10,15,41,56,-15,43
Peterhead,5968,9,11,9,16,41,49,-8,42
Stenhousem'r,5968,10,8,5,23,49,78,-29,29
Alloa,5969,1,22,8,6,75,34,41,74
Livingston,5969,2,21,5,10,82,50,32,68
Brechin,5969,3,17,8,11,50,44,6,59
Airdrieon,5969,4,14,10,12,57,62,-5,52
Albion,5969,5,13,12,11,57,54,3,51
Peterhead,5969,6,13,9,14,52,45,7,48
East Fife,5969,7,11,12,13,45,44,1,45
Stranraer,5969,8,12,4,20,48,56,-8,40
Queen's Park,5969,9,8,9,19,25,56,-31,33
Stenhousem'r,5969,10,5,11,20,38,84,-46,26
Livingston,5970,1,19,8,9,74,50,24,65
Alloa,5970,2,17,9,10,70,44,26,60
Brechin,5970,3,16,6,14,45,46,-1,54
Albion,5970,4,14,9,13,59,54,5,51
Stranraer,5970,5,15,6,15,57,59,-2,51
Airdrieon,5970,6,15,6,15,57,64,-7,51
Peterhead,5970,7,13,10,13,52,58,-6,49
East Fife,5970,8,10,12,14,50,44,6,42
Queen's Park,5970,9,11,7,18,33,49,-16,40
Stenhousem'r,5970,10,10,7,19,52,81,-29,37
Livingston,5971,1,24,2,10,82,48,34,74
Alloa,5971,2,20,9,7,70,44,26,69
Airdrieon,5971,3,17,6,13,55,53,2,57
Brechin,5971,4,14,8,14,52,49,3,50
Albion,5971,5,14,8,14,48,50,-2,50
Peterhead,5971,6,12,11,13,46,48,-2,47
East Fife,5971,7,11,8,17,43,47,-4,41
Stranraer,5971,8,11,7,18,50,60,-10,40
Queen's Park,5971,9,10,9,17,35,52,-17,39
Stenhousem'r,5971,10,10,6,20,47,77,-30,36
Livingston,5972,1,23,4,9,81,46,35,73
Alloa,5972,2,19,8,9,65,41,24,65
Brechin,5972,3,20,5,11,56,44,12,65
Albion,5972,4,18,7,11,63,50,13,61
Airdrieon,5972,5,16,6,14,58,62,-4,54
Stranraer,5972,6,12,8,16,55,60,-5,44
East Fife,5972,7,12,7,17,42,46,-4,43
Peterhead,5972,8,9,11,16,38,54,-16,38
Queen's Park,5972,9,11,5,20,36,56,-20,38
Stenhousem'r,5972,10,6,7,23,45,80,-35,25
Livingston,5973,1,20,5,11,75,46,29,65
Brechin,5973,2,20,3,13,57,48,9,63
Alloa,5973,3,18,7,11,68,43,25,61
Airdrieon,5973,4,17,6,13,51,58,-7,57
Albion,5973,5,15,10,11,54,45,9,55
Peterhead,5973,6,15,9,12,54,46,8,54
Stranraer,5973,7,15,5,16,48,57,-9,50
East Fife,5973,8,11,9,16,44,48,-4,42
Queen's Park,5973,9,9,6,21,34,53,-19,33
Stenhousem'r,5973,10,6,8,22,38,79,-41,26
Livingston,5974,1,26,0,10,87,41,46,78
Airdrieon,5974,2,18,5,13,62,50,12,59
Brechin,5974,3,15,10,11,53,48,5,55
Alloa,5974,4,15,8,13,59,49,10,53
Albion,5974,5,15,6,15,52,50,2,51
Peterhead,5974,6,13,11,12,43,43,0,50
Queen's Park,5974,7,13,8,15,34,49,-15,47
East Fife,5974,8,12,7,17,47,53,-6,43
Stranraer,5974,9,12,4,20,55,67,-12,40
Stenhousem'r,5974,10,7,9,20,41,83,-42,30
Albion,5975,1,20,6,10,61,45,16,66
Livingston,5975,2,19,4,13,71,54,17,61
Alloa,5975,3,15,11,10,69,51,18,56
Airdrieon,5975,4,15,6,15,58,59,-1,51
Peterhead,5975,5,14,8,14,43,53,-10,50
Brechin,5975,6,12,12,12,50,52,-2,48
Stranraer,5975,7,12,10,14,45,46,-1,46
Queen's Park,5975,8,12,10,14,35,45,-10,46
East Fife,5975,9,12,9,15,48,50,-2,45
Stenhousem'r,5975,10,7,8,21,48,73,-25,29
Livingston,5976,1,25,5,6,90,46,44,80
Alloa,5976,2,18,6,12,71,52,19,60
Queen's Park,5976,3,16,7,13,49,51,-2,55
Airdrieon,5976,4,15,6,15,49,57,-8,51
Brechin,5976,5,14,7,15,49,47,2,49
Stranraer,5976,6,14,6,16,51,55,-4,48
East Fife,5976,7,11,14,11,51,47,4,47
Albion,5976,8,12,10,14,51,54,-3,46
Peterhead,5976,9,11,11,14,54,58,-4,44
Stenhousem'r,5976,10,5,6,25,34,82,-48,21
Brechin,5977,1,20,5,11,57,52,5,65
Livingston,5977,2,19,3,14,80,52,28,60
Alloa,5977,3,16,8,12,65,44,21,56
Airdrieon,5977,4,15,9,12,62,67,-5,54
Peterhead,5977,5,14,10,12,53,52,1,52
Albion,5977,6,15,7,14,54,55,-1,52
Stranraer,5977,7,14,5,17,51,63,-12,47
Queen's Park,5977,8,13,5,18,35,51,-16,44
East Fife,5977,9,10,13,13,53,48,5,43
Stenhousem'r,5977,10,7,9,20,49,75,-26,30
Livingston,5978,1,23,5,8,92,55,37,74
Peterhead,5978,2,18,7,11,63,54,9,61
Alloa,5978,3,17,7,12,64,45,19,58
Brechin,5978,4,17,7,12,55,47,8,58
Airdrieon,5978,5,14,8,14,54,55,-1,50
East Fife,5978,6,10,14,12,51,49,2,44
Albion,5978,7,12,8,16,54,62,-8,44
Queen's Park,5978,8,12,8,16,35,54,-19,44
Stranraer,5978,9,9,9,18,46,63,-17,36
Stenhousem'r,5978,10,8,7,21,46,76,-30,31
Livingston,5979,1,22,7,7,79,38,41,73
Brechin,5979,2,19,8,9,58,41,17,65
Airdrieon,5979,3,18,8,10,67,51,16,62
Alloa,5979,4,16,11,9,63,43,20,59
Peterhead,5979,5,14,8,14,47,54,-7,50
Albion,5979,6,13,7,16,57,62,-5,46
Queen's Park,5979,7,12,8,16,42,57,-15,44
Stenhousem'r,5979,8,13,5,18,58,75,-17,44
East Fife,5979,9,9,8,19,41,62,-21,35
Stranraer,5979,10,6,6,24,37,66,-29,24
Livingston,5980,1,23,4,9,68,41,27,73
Airdrieon,5980,2,17,9,10,66,50,16,60
Peterhead,5980,3,14,9,13,45,46,-1,51
Brechin,5980,4,15,6,15,50,56,-6,51
Alloa,5980,5,13,9,14,59,55,4,48
Albion,5980,6,13,9,14,46,46,0,48
Queen's Park,5980,7,11,11,14,35,44,-9,44
East Fife,5980,8,10,11,15,40,43,-3,41
Stranraer,5980,9,10,10,16,55,59,-4,40
Stenhousem'r,5980,10,10,10,16,50,74,-24,40
Livingston,5981,1,21,5,10,73,47,26,68
Alloa,5981,2,18,8,10,66,49,17,62
Airdrieon,5981,3,16,8,12,64,57,7,56
Brechin,5981,4,17,5,14,54,50,4,56
Albion,5981,5,16,7,13,59,54,5,55
Peterhead,5981,6,13,11,12,53,52,1,50
Stranraer,5981,7,13,7,16,54,56,-2,46
East Fife,5981,8,9,11,16,44,49,-5,38
Queen's Park,5981,9,9,9,18,37,60,-23,36
Stenhousem'r,5981,10,10,5,21,49,79,-30,35
Airdrieon,5982,1,21,5,10,59,43,16,68
Alloa,5982,2,20,5,11,75,50,25,65
Brechin,5982,3,17,5,14,43,47,-4,56
Queen's Park,5982,4,15,7,14,51,54,-3,52
Livingston,5982,5,15,6,15,70,68,2,51
East Fife,5982,6,14,8,14,59,44,15,50
Albion,5982,7,12,9,15,50,51,-1,45
Peterhead,5982,8,12,8,16,46,51,-5,44
Stranraer,5982,9,12,8,16,48,62,-14,44
Stenhousem'r,5982,10,8,7,21,44,75,-31,31
Alloa,5983,1,26,5,5,77,33,44,83
Livingston,5983,2,23,4,9,88,44,44,73
Airdrieon,5983,3,15,5,16,58,68,-10,50
East Fife,5983,4,13,10,13,53,45,8,49
Peterhead,5983,5,14,5,17,58,59,-1,47
Albion,5983,6,13,8,15,50,62,-12,47
Brechin,5983,7,14,4,18,41,50,-9,46
Stranraer,5983,8,13,6,17,45,58,-13,45
Queen's Park,5983,9,10,6,20,35,55,-20,36
Stenhousem'r,5983,10,9,7,20,45,76,-31,34
Livingston,5984,1,23,5,8,90,45,45,74
Peterhead,5984,2,16,8,12,61,53,8,56
Alloa,5984,3,14,13,9,63,48,15,55
East Fife,5984,4,14,10,12,55,45,10,52
Stranraer,5984,5,14,5,17,52,54,-2,47
Queen's Park,5984,6,13,8,15,41,52,-11,47
Airdrieon,5984,7,13,7,16,57,68,-11,46
Brechin,5984,8,13,7,16,48,65,-17,46
Albion,5984,9,13,4,19,45,59,-14,43
Stenhousem'r,5984,10,9,9,18,58,81,-23,36
Livingston,5985,1,20,6,10,75,54,21,66
Alloa,5985,2,17,9,10,58,41,17,60
Albion,5985,3,17,9,10,61,46,15,60
Brechin,5985,4,16,7,13,45,49,-4,55
Airdrieon,5985,5,14,8,14,54,54,0,50
Peterhead,5985,6,12,11,13,48,53,-5,47
Queen's Park,5985,7,14,4,18,36,46,-10,46
East Fife,5985,8,10,13,13,52,46,6,43
Stranraer,5985,9,11,8,17,46,57,-11,41
Stenhousem'r,5985,10,7,9,20,43,72,-29,30
Livingston,5986,1,22,4,10,80,44,36,70
Brechin,5986,2,21,4,11,52,38,14,67
Alloa,5986,3,16,12,8,64,42,22,60
Airdrieon,5986,4,17,9,10,58,50,8,60
Stranraer,5986,5,14,6,16,50,49,1,48
East Fife,5986,6,13,7,16,51,46,5,46
Peterhead,5986,7,11,10,15,53,60,-7,43
Queen's Park,5986,8,11,9,16,29,47,-18,42
Albion,5986,9,11,6,19,46,62,-16,39
Stenhousem'r,5986,10,8,5,23,47,92,-45,29
Alloa,5987,1,22,6,8,77,44,33,72
Airdrieon,5987,2,21,5,10,66,47,19,68
Peterhead,5987,3,19,5,12,50,46,4,62
Livingston,5987,4,16,9,11,63,46,17,57
Brechin,5987,5,15,5,16,49,49,0,50
Albion,5987,6,14,8,14,53,55,-2,50
Queen's Park,5987,7,11,10,15,37,51,-14,43
Stranraer,5987,8,11,9,16,52,55,-3,42
East Fife,5987,9,11,8,17,46,51,-5,41
Stenhousem'r,5987,10,5,5,26,42,91,-49,20
Livingston,5988,1,23,4,9,83,47,36,73
Brechin,5988,2,16,8,12,50,44,6,56
Albion,5988,3,16,6,14,52,48,4,54
Alloa,5988,4,13,12,11,65,55,10,51
East Fife,5988,5,12,13,11,56,50,6,49
Airdrieon,5988,6,14,6,16,55,59,-4,48
Peterhead,5988,7,12,12,12,46,50,-4,48
Stranraer,5988,8,12,8,16,49,57,-8,44
Queen's Park,5988,9,11,6,19,35,57,-22,39
Stenhousem'r,5988,10,8,11,17,50,74,-24,35
Livingston,5989,1,19,6,11,83,59,24,63
Alloa,5989,2,17,11,8,68,42,26,62
Brechin,5989,3,17,9,10,52,38,14,60
Airdrieon,5989,4,19,3,14,68,65,3,60
Albion,5989,5,15,8,13,63,54,9,53
Stranraer,5989,6,14,8,14,57,57,0,50
Queen's Park,5989,7,14,7,15,40,50,-10,49
East Fife,5989,8,11,9,16,56,58,-2,42
Peterhead,5989,9,9,8,19,39,59,-20,35
Stenhousem'r,5989,10,6,9,21,51,95,-44,27
Alloa,5990,1,18,12,6,73,36,37,66
Brechin,5990,2,16,10,10,56,45,11,58
Peterhead,5990,3,16,9,11,44,42,2,57
Airdrieon,5990,4,16,8,12,52,53,-1,56
Livingston,5990,5,15,6,15,61,58,3,51
Stranraer,5990,6,14,8,14,50,46,4,50
East Fife,5990,7,12,10,14,49,47,2,46
Queen's Park,5990,8,11,9,16,37,46,-9,42
Albion,5990,9,8,13,15,49,56,-7,37
Stenhousem'r,5990,10,8,7,21,39,81,-42,31
Livingston,5991,1,21,6,9,80,42,38,69
Alloa,5991,2,17,11,8,63,40,23,62
Brechin,5991,3,16,7,13,47,44,3,55
Peterhead,5991,4,15,8,13,55,52,3,53
Airdrieon,5991,5,15,6,15,54,59,-5,51
Albion,5991,6,13,11,12,44,45,-1,50
Queen's Park,5991,7,13,8,15,44,56,-12,47
East Fife,5991,8,10,11,15,41,52,-11,41
Stranraer,5991,9,10,7,19,49,57,-8,37
Stenhousem'r,5991,10,8,9,19,42,72,-30,33
Livingston,5992,1,22,5,9,87,53,34,71
Alloa,5992,2,20,4,12,71,47,24,64
Brechin,5992,3,17,6,13,56,51,5,57
Airdrieon,5992,4,16,8,12,62,57,5,56
Queen's Park,5992,5,16,5,15,43,50,-7,53
Albion,5992,6,12,9,15,55,58,-3,45
East Fife,5992,7,12,8,16,49,52,-3,44
Stranraer,5992,8,13,4,19,59,65,-6,43
Peterhead,5992,9,12,7,17,42,54,-12,43
Stenhousem'r,5992,10,8,8,20,49,86,-37,32
Alloa,5993,1,22,5,9,79,44,35,71
Brechin,5993,2,19,7,10,51,39,12,64
Livingston,5993,3,20,3,13,77,54,23,63
Peterhead,5993,4,18,7,11,62,44,18,61
Airdrieon,5993,5,16,8,12,56,54,2,56
Stranraer,5993,6,13,7,16,57,65,-8,46
Albion,5993,7,10,14,12,48,51,-3,44
Queen's Park,5993,8,9,6,21,39,60,-21,33
East Fife,5993,9,8,9,19,46,70,-24,33
Stenhousem'r,5993,10,9,6,21,43,77,-34,33
Livingston,5994,1,19,11,6,77,47,30,68
Airdrieon,5994,2,18,6,12,54,43,11,60
Alloa,5994,3,17,8,11,66,53,13,59
Brechin,5994,4,16,10,10,40,37,3,58
Albion,5994,5,15,9,12,53,40,13,54
Peterhead,5994,6,12,10,14,51,53,-2,46
East Fife,5994,7,10,12,14,46,47,-1,42
Queen's Park,5994,8,9,11,16,35,51,-16,38
Stranraer,5994,9,10,8,18,40,57,-17,38
Stenhousem'r,5994,10,6,11,19,49,83,-34,29
Livingston,5995,1,19,4,13,70,51,19,61
Albion,5995,2,16,9,11,60,53,7,57
Airdrieon,5995,3,17,6,13,57,55,2,57
Alloa,5995,4,15,9,12,59,47,12,54
Brechin,5995,5,15,8,13,55,56,-1,53
East Fife,5995,6,15,7,14,53,52,1,52
Peterhead,5995,7,14,7,15,42,46,-4,49
Stranraer,5995,8,13,7,16,56,52,4,46
Queen's Park,5995,9,11,6,19,39,50,-11,39
Stenhousem'r,5995,10,11,5,20,56,85,-29,38
Alloa,5996,1,20,6,10,79,40,39,66
Livingston,5996,2,17,7,12,74,55,19,58
Peterhead,5996,3,16,10,10,55,52,3,58
Airdrieon,5996,4,17,6,13,67,56,11,57
Brechin,5996,5,17,4,15,57,57,0,55
Stranraer,5996,6,13,7,16,53,67,-14,46
Albion,5996,7,12,8,16,45,48,-3,44
Queen's Park,5996,8,11,9,16,39,59,-20,42
East Fife,5996,9,9,12,15,48,57,-9,39
Stenhousem'r,5996,10,10,7,19,52,78,-26,37
Livingston,5997,1,23,2,11,77,50,27,71
Alloa,5997,2,19,8,9,67,38,29,65
Airdrieon,5997,3,18,4,14,61,55,6,58
Peterhead,5997,4,16,8,12,53,46,7,56
Brechin,5997,5,15,7,14,58,61,-3,52
East Fife,5997,6,13,10,13,49,45,4,49
Albion,5997,7,13,8,15,52,58,-6,47
Stranraer,5997,8,13,6,17,52,59,-7,45
Stenhousem'r,5997,9,9,7,20,44,74,-30,34
Queen's Park,5997,10,8,6,22,35,62,-27,30
Alloa,5998,1,19,7,10,73,51,22,64
Brechin,5998,2,19,6,11,57,43,14,63
Livingston,5998,3,19,2,15,73,53,20,59
Airdrieon,5998,4,14,12,10,61,57,4,54
Albion,5998,5,14,10,12,51,47,4,52
Peterhead,5998,6,11,11,14,46,53,-7,44
Queen's Park,5998,7,12,7,17,34,52,-18,43
Stenhousem'r,5998,8,11,8,17,49,69,-20,41
East Fife,5998,9,10,10,16,48,53,-5,40
Stranraer,5998,10,10,9,17,48,62,-14,39
Livingston,5999,1,23,3,10,84,39,45,72
Alloa,5999,2,17,9,10,64,49,15,60
Airdrieon,5999,3,18,6,12,51,50,1,60
Peterhead,5999,4,15,7,14,55,58,-3,52
East Fife,5999,5,11,14,11,52,43,9,47
Stranraer,5999,6,13,7,16,57,66,-9,46
Brechin,5999,7,13,6,17,47,53,-6,45
Queen's Park,5999,8,12,9,15,41,52,-11,45
Albion,5999,9,12,8,16,48,48,0,44
Stenhousem'r,5999,10,5,13,18,51,92,-41,28
Alloa,6000,1,23,5,8,74,40,34,74
Livingston,6000,2,21,8,7,74,42,32,71
Airdrieon,6000,3,20,2,14,59,57,2,62
Brechin,6000,4,17,6,13,62,58,4,57
Queen's Park,6000,5,15,3,18,46,57,-11,48
Peterhead,6000,6,11,11,14,50,52,-2,44
East Fife,6000,7,9,13,14,49,53,-4,40
Albion,6000,8,11,5,20,46,63,-17,38
Stenhousem'r,6000,9,9,9,18,54,77,-23,36
Stranraer,6000,10,8,10,18,45,60,-15,34
Livingston,6001,1,23,3,10,80,45,35,72
Alloa,6001,2,19,9,8,72,48,24,66
Airdrieon,6001,3,19,4,13,57,61,-4,61
Brechin,6001,4,17,7,12,53,46,7,58
Stranraer,6001,5,14,7,15,45,48,-3,49
Peterhead,6001,6,13,9,14,54,53,1,48
Albion,6001,7,13,8,15,48,46,2,47
East Fife,6001,8,11,8,17,43,51,-8,41
Queen's Park,6001,9,10,7,19,40,57,-17,37
Stenhousem'r,6001,10,6,8,22,46,83,-37,26
Livingston,6002,1,20,5,11,73,47,26,65
Alloa,6002,2,20,4,12,73,49,24,64
Brechin,6002,3,18,6,12,49,44,5,60
Airdrieon,6002,4,17,5,14,54,54,0,56
Stranraer,6002,5,16,3,17,57,58,-1,51
Albion,6002,6,11,12,13,53,53,0,45
Peterhead,6002,7,12,8,16,35,49,-14,44
Queen's Park,6002,8,12,7,17,34,46,-12,43
East Fife,6002,9,10,11,15,50,57,-7,41
Stenhousem'r,6002,10,10,7,19,49,70,-21,37
Livingston,6003,1,22,4,10,72,39,33,70
Airdrieon,6003,2,20,7,9,65,46,19,67
Alloa,6003,3,18,10,8,75,38,37,64
Brechin,6003,4,15,7,14,46,52,-6,52
Albion,6003,5,13,9,14,59,67,-8,48
East Fife,6003,6,13,8,15,42,43,-1,47
Queen's Park,6003,7,13,5,18,38,55,-17,44
Peterhead,6003,8,12,7,17,40,54,-14,43
Stranraer,6003,9,11,9,16,52,59,-7,42
Stenhousem'r,6003,10,7,6,23,50,86,-36,27
Livingston,6004,1,22,9,5,87,44,43,75
Alloa,6004,2,17,10,9,68,42,26,61
Brechin,6004,3,16,7,13,46,46,0,55
East Fife,6004,4,14,9,13,54,42,12,51
Airdrieon,6004,5,14,9,13,58,56,2,51
Peterhead,6004,6,14,8,14,48,53,-5,50
Stranraer,6004,7,12,8,16,49,56,-7,44
Albion,6004,8,10,12,14,44,51,-7,42
Queen's Park,6004,9,8,10,18,35,59,-24,34
Stenhousem'r,6004,10,8,8,20,45,85,-40,32
Alloa,6005,1,20,7,9,66,42,24,67
Albion,6005,2,18,8,10,64,45,19,62
Livingston,6005,3,17,9,10,77,53,24,60
Brechin,6005,4,17,7,12,58,52,6,58
Peterhead,6005,5,14,9,13,52,52,0,51
Airdrieon,6005,6,14,9,13,52,56,-4,51
Queen's Park,6005,7,12,10,14,41,49,-8,46
East Fife,6005,8,11,11,14,51,49,2,44
Stranraer,6005,9,10,8,18,47,62,-15,38
Stenhousem'r,6005,10,4,8,24,39,87,-48,20
Livingston,6006,1,20,6,10,74,46,28,66
Alloa,6006,2,18,11,7,79,50,29,65
Brechin,6006,3,19,5,12,60,45,15,62
Queen's Park,6006,4,18,5,13,49,57,-8,59
Airdrieon,6006,5,14,9,13,55,55,0,51
Peterhead,6006,6,13,9,14,41,51,-10,48
East Fife,6006,7,12,7,17,53,56,-3,43
Albion,6006,8,11,5,20,54,65,-11,38
Stranraer,6006,9,10,7,19,57,68,-11,37
Stenhousem'r,6006,10,8,10,18,49,78,-29,34
Livingston,6007,1,26,3,7,92,44,48,81
Airdrieon,6007,2,21,5,10,70,53,17,68
Alloa,6007,3,17,7,12,69,47,22,58
Brechin,6007,4,17,7,12,49,39,10,58
Albion,6007,5,14,9,13,56,59,-3,51
Peterhead,6007,6,14,6,16,46,61,-15,48
Queen's Park,6007,7,10,8,18,42,65,-23,38
East Fife,6007,8,10,7,19,53,64,-11,37
Stranraer,6007,9,9,7,20,49,67,-18,34
Stenhousem'r,6007,10,9,7,20,43,70,-27,34
Livingston,6008,1,23,3,10,80,43,37,72
Alloa,6008,2,20,8,8,70,41,29,68
Airdrieon,6008,3,19,3,14,54,52,2,60
Stranraer,6008,4,18,3,15,54,53,1,57
East Fife,6008,5,15,8,13,56,44,12,53
Brechin,6008,6,15,6,15,49,47,2,51
Albion,6008,7,13,8,15,50,49,1,47
Queen's Park,6008,8,13,5,18,39,58,-19,44
Peterhead,6008,9,12,7,17,40,52,-12,43
Stenhousem'r,6008,10,3,7,26,36,89,-53,16
Livingston,6009,1,23,3,10,81,40,41,72
Alloa,6009,2,19,5,12,66,47,19,62
Queen's Park,6009,3,18,5,13,44,54,-10,59
Airdrieon,6009,4,16,7,13,62,53,9,55
Peterhead,6009,5,14,8,14,55,52,3,50
Albion,6009,6,13,10,13,53,51,2,49
Brechin,6009,7,14,6,16,40,50,-10,48
East Fife,6009,8,9,13,14,42,46,-4,40
Stranraer,6009,9,11,7,18,49,60,-11,40
Stenhousem'r,6009,10,7,8,21,43,82,-39,29
Livingston,6010,1,18,6,12,77,56,21,60
Peterhead,6010,2,17,9,10,65,57,8,60
Airdrieon,6010,3,18,6,12,54,51,3,60
Alloa,6010,4,15,12,9,78,48,30,57
Stranraer,6010,5,16,6,14,57,53,4,54
Albion,6010,6,14,9,13,56,51,5,51
Brechin,6010,7,13,8,15,47,50,-3,47
Queen's Park,6010,8,13,5,18,41,54,-13,44
East Fife,6010,9,11,10,15,45,54,-9,43
Stenhousem'r,6010,10,7,5,24,41,87,-46,26
Livingston,6011,1,23,4,9,79,44,35,73
Alloa,6011,2,17,12,7,72,40,32,63
Airdrieon,6011,3,18,6,12,60,54,6,60
Peterhead,6011,4,14,9,13,49,48,1,51
Stranraer,6011,5,14,9,13,59,59,0,51
Albion,6011,6,13,8,15,57,61,-4,47
East Fife,6011,7,11,12,13,51,43,8,45
Brechin,6011,8,11,6,19,41,58,-17,39
Queen's Park,6011,9,10,9,17,36,54,-18,39
Stenhousem'r,6011,10,8,7,21,44,87,-43,31
Alloa,6012,1,21,8,7,82,46,36,71
Livingston,6012,2,22,2,12,77,50,27,68
Airdrieon,6012,3,18,6,12,60,49,11,60
Albion,6012,4,14,8,14,58,60,-2,50
Brechin,6012,5,15,5,16,48,54,-6,50
Peterhead,6012,6,13,9,14,45,54,-9,48
Stranraer,6012,7,13,7,16,59,56,3,46
Queen's Park,6012,8,12,9,15,33,52,-19,45
East Fife,6012,9,11,8,17,45,47,-2,41
Stenhousem'r,6012,10,6,8,22,46,85,-39,26
Alloa,6013,1,21,6,9,77,44,33,69
Livingston,6013,2,21,3,12,76,53,23,66
Brechin,6013,3,19,5,12,51,47,4,62
Peterhead,6013,4,15,8,13,46,50,-4,53
Albion,6013,5,14,8,14,62,59,3,50
East Fife,6013,6,13,10,13,56,47,9,49
Airdrieon,6013,7,14,7,15,59,55,4,49
Stranraer,6013,8,13,5,18,49,59,-10,44
Queen's Park,6013,9,12,6,18,32,48,-16,42
Stenhousem'r,6013,10,7,4,25,40,86,-46,25
Alloa,6014,1,19,10,7,72,45,27,67
Livingston,6014,2,20,5,11,77,52,25,65
Airdrieon,6014,3,16,8,12,58,52,6,56
Albion,6014,4,16,7,13,54,54,0,55
Brechin,6014,5,14,8,14,47,44,3,50
East Fife,6014,6,13,10,13,57,49,8,49
Peterhead,6014,7,11,13,12,49,51,-2,46
Queen's Park,6014,8,12,8,16,35,54,-19,44
Stenhousem'r,6014,9,9,8,19,55,78,-23,35
Stranraer,6014,10,8,7,21,41,66,-25,31
Alloa,6015,1,25,5,6,82,34,48,80
Livingston,6015,2,24,1,11,84,49,35,73
Airdrieon,6015,3,19,6,11,62,57,5,63
Brechin,6015,4,15,9,12,54,53,1,54
Albion,6015,5,15,6,15,56,55,1,51
Peterhead,6015,6,12,9,15,50,59,-9,45
Stranraer,6015,7,11,7,18,48,67,-19,40
East Fife,6015,8,10,7,19,47,52,-5,37
Queen's Park,6015,9,10,6,20,33,58,-25,36
Stenhousem'r,6015,10,9,4,23,49,81,-32,31
Livingston,6016,1,21,3,12,73,48,25,66
Alloa,6016,2,17,9,10,74,43,31,60
Airdrieon,6016,3,18,6,12,59,52,7,60
Stranraer,6016,4,15,8,13,56,53,3,53
Queen's Park,6016,5,15,5,16,43,53,-10,50
Brechin,6016,6,14,7,15,40,50,-10,49
Albion,6016,7,13,7,16,47,59,-12,46
Peterhead,6016,8,11,9,16,47,60,-13,42
East Fife,6016,9,10,10,16,51,52,-1,40
Stenhousem'r,6016,10,10,8,18,57,77,-20,38
Livingston,6017,1,22,2,12,85,50,35,68
Alloa,6017,2,18,8,10,62,39,23,62
Brechin,6017,3,16,7,13,51,42,9,55
Peterhead,6017,4,15,9,12,57,53,4,54
Airdrieon,6017,5,15,6,15,65,69,-4,51
Albion,6017,6,14,8,14,59,62,-3,50
Stranraer,6017,7,14,6,16,53,54,-1,48
Queen's Park,6017,8,12,5,19,39,60,-21,41
East Fife,6017,9,9,13,14,44,51,-7,40
Stenhousem'r,6017,10,9,8,19,51,86,-35,35
Livingston,6018,1,19,5,12,70,49,21,62
Alloa,6018,2,18,5,13,64,45,19,59
Albion,6018,3,16,10,10,58,49,9,58
Airdrieon,6018,4,17,7,12,57,54,3,58
Brechin,6018,5,16,7,13,52,46,6,55
East Fife,6018,6,14,10,12,54,45,9,52
Stranraer,6018,7,15,5,16,61,59,2,50
Peterhead,6018,8,14,4,18,49,57,-8,46
Queen's Park,6018,9,10,6,20,32,54,-22,36
Stenhousem'r,6018,10,8,7,21,41,80,-39,31
Livingston,6019,1,22,5,9,82,45,37,71
Brechin,6019,2,18,9,9,59,41,18,63
Alloa,6019,3,18,8,10,67,41,26,62
Albion,6019,4,16,6,14,60,55,5,54
Airdrieon,6019,5,16,6,14,49,57,-8,54
Peterhead,6019,6,13,7,16,42,48,-6,46
East Fife,6019,7,13,6,17,52,61,-9,45
Stranraer,6019,8,13,4,19,45,61,-16,43
Queen's Park,6019,9,9,9,18,39,60,-21,36
Stenhousem'r,6019,10,8,8,20,43,69,-26,32
Livingston,6020,1,22,6,8,82,37,45,72
Airdrieon,6020,2,19,5,12,60,56,4,62
Peterhead,6020,3,17,7,12,58,50,8,58
Alloa,6020,4,16,6,14,60,50,10,54
Queen's Park,6020,5,14,8,14,39,50,-11,50
Albion,6020,6,14,5,17,50,47,3,47
East Fife,6020,7,12,9,15,55,53,2,45
Brechin,6020,8,12,9,15,38,48,-10,45
Stranraer,6020,9,11,8,17,48,62,-14,41
Stenhousem'r,6020,10,7,9,20,44,81,-37,30
Livingston,6021,1,20,5,11,79,52,27,65
Alloa,6021,2,18,11,7,67,41,26,65
Brechin,6021,3,19,6,11,55,44,11,63
Airdrieon,6021,4,17,8,11,69,63,6,59
Stranraer,6021,5,15,6,15,54,58,-4,51
Peterhead,6021,6,10,15,11,49,56,-7,45
Queen's Park,6021,7,10,13,13,38,44,-6,43
Albion,6021,8,10,10,16,44,52,-8,40
East Fife,6021,9,7,11,18,40,53,-13,32
Stenhousem'r,6021,10,6,11,19,48,80,-32,29
Livingston,6022,1,28,1,7,93,45,48,85
Alloa,6022,2,16,11,9,73,43,30,59
Albion,6022,3,17,7,12,62,54,8,58
Airdrieon,6022,4,18,4,14,67,61,6,58
Brechin,6022,5,14,7,15,39,45,-6,49
Stranraer,6022,6,13,5,18,53,59,-6,44
Peterhead,6022,7,11,10,15,49,58,-9,43
Queen's Park,6022,8,11,7,18,36,59,-23,40
East Fife,6022,9,9,9,18,42,50,-8,36
Stenhousem'r,6022,10,9,7,20,46,86,-40,34
Livingston,6023,1,21,6,9,80,46,34,69
Brechin,6023,2,17,10,9,56,48,8,61
Alloa,6023,3,17,9,10,64,44,20,60
Airdrieon,6023,4,17,7,12,51,52,-1,58
Peterhead,6023,5,13,13,10,53,53,0,52
Stranraer,6023,6,13,6,17,53,54,-1,45
Albion,6023,7,11,10,15,48,54,-6,43
Queen's Park,6023,8,11,7,18,37,50,-13,40
East Fife,6023,9,9,11,16,51,58,-7,38
Stenhousem'r,6023,10,6,11,19,46,80,-34,29
Alloa,6024,1,22,7,7,72,40,32,73
Livingston,6024,2,20,7,9,71,43,28,67
Brechin,6024,3,19,5,12,55,42,13,62
Airdrieon,6024,4,17,8,11,52,43,9,59
Albion,6024,5,15,6,15,50,50,0,51
Stranraer,6024,6,14,4,18,44,57,-13,46
East Fife,6024,7,12,8,16,52,52,0,44
Queen's Park,6024,8,11,9,16,41,47,-6,42
Peterhead,6024,9,8,10,18,34,60,-26,34
Stenhousem'r,6024,10,7,6,23,38,75,-37,27
Livingston,6025,1,23,5,8,75,46,29,74
Alloa,6025,2,18,10,8,71,47,24,64
Brechin,6025,3,16,8,12,46,43,3,56
Albion,6025,4,15,6,15,52,49,3,51
Airdrieon,6025,5,14,8,14,50,47,3,50
Peterhead,6025,6,12,12,12,43,46,-3,48
Stranraer,6025,7,14,4,18,53,56,-3,46
East Fife,6025,8,11,11,14,48,45,3,44
Queen's Park,6025,9,12,6,18,37,53,-16,42
Stenhousem'r,6025,10,6,8,22,44,87,-43,26
Livingston,6026,1,24,4,8,83,42,41,76
Alloa,6026,2,18,9,9,76,50,26,63
Albion,6026,3,14,10,12,56,48,8,52
Airdrieon,6026,4,13,11,12,47,53,-6,50
Brechin,6026,5,14,7,15,44,54,-10,49
Stranraer,6026,6,13,7,16,56,63,-7,46
Queen's Park,6026,7,14,4,18,39,48,-9,46
Peterhead,6026,8,11,11,14,44,50,-6,44
Stenhousem'r,6026,9,10,8,18,52,77,-25,38
East Fife,6026,10,8,11,17,44,56,-12,35
Alloa,6027,1,20,7,9,74,40,34,67
Livingston,6027,2,21,4,11,75,51,24,67
Airdrieon,6027,3,16,10,10,55,50,5,58
Brechin,6027,4,16,7,13,54,50,4,55
Albion,6027,5,13,9,14,48,50,-2,48
Stranraer,6027,6,15,3,18,49,52,-3,48
Peterhead,6027,7,12,9,15,47,55,-8,45
East Fife,6027,8,10,12,14,61,60,1,42
Queen's Park,6027,9,11,7,18,36,60,-24,40
Stenhousem'r,6027,10,10,4,22,51,82,-31,34
Livingston,6028,1,22,3,11,78,49,29,69
Airdrieon,6028,2,17,7,12,60,54,6,58
Alloa,6028,3,15,11,10,64,48,16,56
Brechin,6028,4,17,5,14,53,44,9,56
Albion,6028,5,17,5,14,53,46,7,56
Stranraer,6028,6,16,4,16,53,52,1,52
Queen's Park,6028,7,13,9,14,39,47,-8,48
Peterhead,6028,8,11,9,16,52,68,-16,42
East Fife,6028,9,10,10,16,33,43,-10,40
Stenhousem'r,6028,10,7,7,22,44,78,-34,28
Livingston,6029,1,25,4,7,83,42,41,79
Alloa,6029,2,23,6,7,77,41,36,75
Brechin,6029,3,18,5,13,52,45,7,59
Airdrieon,6029,4,16,6,14,54,60,-6,54
Peterhead,6029,5,15,7,14,51,51,0,52
East Fife,6029,6,12,9,15,45,41,4,45
Stranraer,6029,7,11,8,17,48,64,-16,41
Albion,6029,8,9,8,19,45,60,-15,35
Queen's Park,6029,9,9,8,19,33,54,-21,35
Stenhousem'r,6029,10,8,7,21,46,76,-30,31
Airdrieon,6030,1,24,2,10,63,46,17,74
Alloa,6030,2,22,6,8,75,41,34,72
Albion,6030,3,20,7,9,64,42,22,67
Livingston,6030,4,18,5,13,78,58,20,59
Brechin,6030,5,17,1,18,50,61,-11,52
Stranraer,6030,6,15,4,17,50,55,-5,49
Peterhead,6030,7,14,4,18,53,60,-7,46
East Fife,6030,8,11,5,20,48,57,-9,38
Queen's Park,6030,9,10,4,22,39,66,-27,34
Stenhousem'r,6030,10,6,8,22,46,80,-34,26
Livingston,6031,1,20,5,11,72,46,26,65
Airdrieon,6031,2,19,5,12,61,56,5,62
Alloa,6031,3,16,10,10,71,45,26,58
Peterhead,6031,4,15,11,10,53,51,2,56
Albion,6031,5,15,9,12,60,53,7,54
Queen's Park,6031,6,15,7,14,37,48,-11,52
Brechin,6031,7,14,4,18,44,52,-8,46
East Fife,6031,8,12,7,17,46,46,0,43
Stranraer,6031,9,10,10,16,46,53,-7,40
Stenhousem'r,6031,10,5,10,21,37,77,-40,25
Livingston,6032,1,19,7,10,74,49,25,64
Airdrieon,6032,2,16,12,8,62,50,12,60
Brechin,6032,3,16,10,10,55,42,13,58
Albion,6032,4,15,10,11,61,55,6,55
Alloa,6032,5,14,12,10,66,47,19,54
Stranraer,6032,6,14,6,16,53,60,-7,48
Queen's Park,6032,7,13,9,14,38,48,-10,48
Peterhead,6032,8,11,9,16,46,58,-12,42
East Fife,6032,9,10,8,18,41,52,-11,38
Stenhousem'r,6032,10,6,9,21,40,75,-35,27
Livingston,6033,1,23,3,10,78,47,31,72
Alloa,6033,2,18,11,7,77,42,35,65
Queen's Park,6033,3,17,7,12,50,48,2,58
Albion,6033,4,16,6,14,60,58,2,54
Airdrieon,6033,5,16,6,14,62,62,0,54
Brechin,6033,6,14,5,17,43,51,-8,47
Peterhead,6033,7,12,8,16,44,57,-13,44
East Fife,6033,8,10,9,17,54,58,-4,39
Stranraer,6033,9,10,9,17,55,64,-9,39
Stenhousem'r,6033,10,9,6,21,44,80,-36,33
Alloa,6034,1,20,9,7,70,38,32,69
Airdrieon,6034,2,18,7,11,61,44,17,61
Livingston,6034,3,18,6,12,68,48,20,60
Brechin,6034,4,17,8,11,48,38,10,59
Peterhead,6034,5,17,8,11,50,47,3,59
Albion,6034,6,14,7,15,54,66,-12,49
Queen's Park,6034,7,13,8,15,40,49,-9,47
Stranraer,6034,8,13,5,18,45,57,-12,44
East Fife,6034,9,8,9,19,43,55,-12,33
Stenhousem'r,6034,10,5,7,24,41,78,-37,22
Livingston,6035,1,21,5,10,82,45,37,68
Airdrieon,6035,2,17,9,10,55,44,11,60
Peterhead,6035,3,15,11,10,52,42,10,56
Brechin,6035,4,15,11,10,55,48,7,56
Alloa,6035,5,13,15,8,64,44,20,54
Stranraer,6035,6,14,5,17,47,58,-11,47
Albion,6035,7,12,9,15,49,57,-8,45
East Fife,6035,8,11,8,17,51,57,-6,41
Queen's Park,6035,9,11,7,18,36,61,-25,40
Stenhousem'r,6035,10,5,12,19,49,84,-35,27
Livingston,6036,1,20,6,10,75,46,29,66
Alloa,6036,2,16,10,10,67,51,16,58
Brechin,6036,3,17,4,15,53,47,6,55
Airdrieon,6036,4,15,8,13,65,65,0,53
Albion,6036,5,13,11,12,59,60,-1,50
Stranraer,6036,6,14,7,15,60,61,-1,49
Queen's Park,6036,7,13,7,16,32,43,-11,46
East Fife,6036,8,9,15,12,51,48,3,42
Stenhousem'r,6036,9,9,13,14,53,69,-16,40
Peterhead,6036,10,8,11,17,38,63,-25,35
Livingston,6037,1,21,4,11,75,53,22,67
Alloa,6037,2,19,7,10,76,44,32,64
Airdrieon,6037,3,16,7,13,57,57,0,55
Peterhead,6037,4,14,10,12,55,43,12,52
East Fife,6037,5,14,9,13,55,48,7,51
Stranraer,6037,6,14,7,15,47,51,-4,49
Brechin,6037,7,14,6,16,46,44,2,48
Albion,6037,8,13,9,14,57,67,-10,48
Queen's Park,6037,9,12,10,14,38,44,-6,46
Stenhousem'r,6037,10,6,5,25,39,94,-55,23
Livingston,6038,1,19,8,9,76,47,29,65
Alloa,6038,2,19,8,9,65,38,27,65
Airdrieon,6038,3,17,7,12,54,53,1,58
Queen's Park,6038,4,17,6,13,39,37,2,57
Brechin,6038,5,15,6,15,43,45,-2,51
East Fife,6038,6,13,9,14,51,45,6,48
Albion,6038,7,12,7,17,48,56,-8,43
Peterhead,6038,8,11,8,17,47,62,-15,41
Stranraer,6038,9,11,7,18,42,60,-18,40
Stenhousem'r,6038,10,8,10,18,50,72,-22,34
Alloa,6039,1,23,7,6,81,42,39,76
Livingston,6039,2,20,5,11,69,42,27,65
Brechin,6039,3,18,6,12,55,52,3,60
Albion,6039,4,17,8,11,60,48,12,59
Airdrieon,6039,5,15,6,15,61,68,-7,51
Queen's Park,6039,6,11,8,17,42,63,-21,41
Stranraer,6039,7,12,4,20,52,62,-10,40
Peterhead,6039,8,10,10,16,50,60,-10,40
East Fife,6039,9,10,8,18,40,52,-12,38
Stenhousem'r,6039,10,8,10,18,57,78,-21,34
Livingston,6040,1,22,2,12,76,46,30,68
Alloa,6040,2,20,6,10,71,43,28,66
Airdrieon,6040,3,19,4,13,58,47,11,61
Brechin,6040,4,18,7,11,53,46,7,61
Stranraer,6040,5,14,6,16,44,45,-1,48
Albion,6040,6,13,8,15,45,52,-7,47
Queen's Park,6040,7,12,8,16,36,48,-12,44
Peterhead,6040,8,11,9,16,43,56,-13,42
East Fife,6040,9,10,10,16,46,52,-6,40
Stenhousem'r,6040,10,8,6,22,48,85,-37,30
Alloa,6041,1,22,6,8,87,42,45,72
Livingston,6041,2,20,4,12,71,49,22,64
Brechin,6041,3,19,6,11,51,41,10,63
Airdrieon,6041,4,15,10,11,50,50,0,55
Albion,6041,5,14,7,15,55,59,-4,49
Queen's Park,6041,6,13,9,14,39,46,-7,48
Stranraer,6041,7,12,9,15,45,57,-12,45
Peterhead,6041,8,11,9,16,47,57,-10,42
Stenhousem'r,6041,9,10,5,21,49,77,-28,35
East Fife,6041,10,7,9,20,44,60,-16,30
Livingston,6042,1,23,5,8,66,41,25,74
Brechin,6042,2,18,7,11,52,45,7,61
Airdrieon,6042,3,17,9,10,49,51,-2,60
Alloa,6042,4,17,8,11,75,44,31,59
Peterhead,6042,5,15,3,18,51,52,-1,48
Albion,6042,6,13,8,15,48,52,-4,47
Queen's Park,6042,7,13,6,17,42,52,-10,45
East Fife,6042,8,12,7,17,52,46,6,43
Stranraer,6042,9,11,4,21,45,60,-15,37
Stenhousem'r,6042,10,10,5,21,45,82,-37,35
Livingston,6043,1,20,5,11,80,51,29,65
Alloa,6043,2,18,6,12,74,52,22,60
Peterhead,6043,3,17,4,15,51,55,-4,55
Airdrieon,6043,4,16,6,14,61,63,-2,54
Stranraer,6043,5,15,5,16,59,62,-3,50
Queen's Park,6043,6,14,7,15,47,47,0,49
Brechin,6043,7,15,4,17,40,54,-14,49
Albion,6043,8,14,6,16,49,61,-12,48
East Fife,6043,9,12,10,14,63,50,13,46
Stenhousem'r,6043,10,7,11,18,49,78,-29,32
Alloa,6044,1,20,8,8,78,50,28,68
Livingston,6044,2,20,6,10,73,46,27,66
Brechin,6044,3,20,4,12,58,49,9,64
Airdrieon,6044,4,17,7,12,62,52,10,58
Albion,6044,5,14,6,16,53,56,-3,48
Stranraer,6044,6,13,8,15,52,59,-7,47
Peterhead,6044,7,12,7,17,40,58,-18,43
East Fife,6044,8,11,7,18,44,50,-6,40
Stenhousem'r,6044,9,10,9,17,42,61,-19,39
Queen's Park,6044,10,9,6,21,27,48,-21,33
Livingston,6045,1,25,4,7,77,35,42,79
Brechin,6045,2,21,5,10,64,44,20,68
Airdrieon,6045,3,18,7,11,65,60,5,61
Alloa,6045,4,16,8,12,63,46,17,56
Peterhead,6045,5,14,10,12,54,43,11,52
Stranraer,6045,6,14,5,17,50,49,1,47
East Fife,6045,7,10,12,14,49,47,2,42
Albion,6045,8,11,7,18,46,61,-15,40
Queen's Park,6045,9,8,8,20,30,59,-29,32
Stenhousem'r,6045,10,6,8,22,45,99,-54,26
Livingston,6046,1,21,6,9,75,44,31,69
Alloa,6046,2,20,4,12,66,45,21,64
Albion,6046,3,17,8,11,58,43,15,59
Airdrieon,6046,4,15,10,11,60,51,9,55
Brechin,6046,5,15,7,14,49,49,0,52
East Fife,6046,6,12,11,13,50,47,3,47
Stranraer,6046,7,13,7,16,55,57,-2,46
Queen's Park,6046,8,12,7,17,42,60,-18,43
Peterhead,6046,9,8,10,18,44,65,-21,34
Stenhousem'r,6046,10,7,10,19,46,84,-38,31
Livingston,6047,1,23,5,8,79,49,30,74
Alloa,6047,2,19,10,7,76,37,39,67
Albion,6047,3,16,11,9,58,49,9,59
Airdrieon,6047,4,14,11,11,54,53,1,53
Brechin,6047,5,15,6,15,53,50,3,51
East Fife,6047,6,12,8,16,46,47,-1,44
Peterhead,6047,7,11,11,14,49,55,-6,44
Queen's Park,6047,8,11,8,17,40,61,-21,41
Stranraer,6047,9,11,6,19,46,66,-20,39
Stenhousem'r,6047,10,6,8,22,49,83,-34,26
Alloa,6048,1,20,5,11,72,48,24,65
Livingston,6048,2,20,4,12,78,49,29,64
Peterhead,6048,3,18,6,12,62,51,11,60
Brechin,6048,4,17,8,11,59,43,16,59
Airdrieon,6048,5,15,6,15,61,62,-1,51
Albion,6048,6,15,6,15,55,58,-3,51
Stranraer,6048,7,16,2,18,56,63,-7,50
Queen's Park,6048,8,12,8,16,40,58,-18,44
East Fife,6048,9,11,9,16,48,52,-4,42
Stenhousem'r,6048,10,5,8,23,44,91,-47,23
Livingston,6049,1,18,7,11,81,54,27,61
Albion,6049,2,15,9,12,55,50,5,54
Alloa,6049,3,15,7,14,55,49,6,52
Queen's Park,6049,4,15,7,14,40,52,-12,52
Peterhead,6049,5,15,6,15,60,54,6,51
Airdrieon,6049,6,14,9,13,51,59,-8,51
East Fife,6049,7,13,9,14,52,49,3,48
Stenhousem'r,6049,8,12,10,14,52,64,-12,46
Brechin,6049,9,11,10,15,57,65,-8,43
Stranraer,6049,10,11,8,17,53,60,-7,41
Alloa,6050,1,16,14,6,72,54,18,62
Airdrieon,6050,2,18,8,10,64,50,14,62
Livingston,6050,3,16,8,12,69,55,14,56
Stranraer,6050,4,16,7,13,64,56,8,55
Brechin,6050,5,17,4,15,49,44,5,55
Albion,6050,6,14,11,11,59,56,3,53
East Fife,6050,7,11,10,15,42,46,-4,43
Peterhead,6050,8,10,11,15,54,65,-11,41
Queen's Park,6050,9,10,6,20,44,60,-16,36
Stenhousem'r,6050,10,8,9,19,54,85,-31,33
Livingston,6051,1,20,4,12,75,51,24,64
Airdrieon,6051,2,17,7,12,52,48,4,58
Peterhead,6051,3,17,5,14,54,53,1,56
Alloa,6051,4,15,10,11,70,49,21,55
Brechin,6051,5,15,6,15,56,61,-5,51
Queen's Park,6051,6,13,10,13,43,51,-8,49
Albion,6051,7,13,8,15,55,51,4,47
East Fife,6051,8,13,7,16,50,57,-7,46
Stranraer,6051,9,13,6,17,49,56,-7,45
Stenhousem'r,6051,10,7,11,18,44,71,-27,32
Livingston,6052,1,23,3,10,89,48,41,72
Alloa,6052,2,19,7,10,65,44,21,64
Stranraer,6052,3,17,7,12,57,57,0,58
Airdrieon,6052,4,14,9,13,63,60,3,51
Albion,6052,5,12,12,12,45,44,1,48
Peterhead,6052,6,12,11,13,45,49,-4,47
Brechin,6052,7,13,8,15,45,56,-11,47
East Fife,6052,8,11,11,14,44,44,0,44
Queen's Park,6052,9,12,7,17,37,49,-12,43
Stenhousem'r,6052,10,6,7,23,43,82,-39,25
Livingston,6053,1,23,2,11,84,48,36,71
Alloa,6053,2,18,7,11,76,51,25,61
Peterhead,6053,3,17,7,12,56,49,7,58
Airdrieon,6053,4,16,8,12,57,55,2,56
Brechin,6053,5,16,7,13,54,54,0,55
Albion,6053,6,14,6,16,51,54,-3,48
Stranraer,6053,7,13,5,18,52,66,-14,44
Queen's Park,6053,8,10,11,15,38,52,-14,41
Stenhousem'r,6053,9,10,8,18,52,78,-26,38
East Fife,6053,10,8,9,19,45,58,-13,33
Alloa,6054,1,15,12,9,67,46,21,57
Livingston,6054,2,17,5,14,79,61,18,56
Albion,6054,3,15,11,10,65,58,7,56
Peterhead,6054,4,15,11,10,57,55,2,56
Brechin,6054,5,15,6,15,52,54,-2,51
Airdrieon,6054,6,14,8,14,61,61,0,50
Stranraer,6054,7,14,5,17,53,56,-3,47
Queen's Park,6054,8,12,10,14,37,48,-11,46
East Fife,6054,9,10,14,12,50,47,3,44
Stenhousem'r,6054,10,9,6,21,49,84,-35,33
Livingston,6055,1,21,7,8,81,45,36,70
Alloa,6055,2,17,9,10,60,41,19,60
Airdrieon,6055,3,16,7,13,57,54,3,55
Queen's Park,6055,4,14,11,11,44,50,-6,53
East Fife,6055,5,15,7,14,46,42,4,52
Peterhead,6055,6,15,6,15,53,57,-4,51
Albion,6055,7,14,6,16,58,55,3,48
Brechin,6055,8,14,4,18,37,56,-19,46
Stranraer,6055,9,12,7,17,50,58,-8,43
Stenhousem'r,6055,10,7,6,23,54,82,-28,27
Alloa,6056,1,21,5,10,68,42,26,68
Livingston,6056,2,20,5,11,72,52,20,65
Airdrieon,6056,3,15,9,12,54,52,2,54
Brechin,6056,4,15,9,12,58,58,0,54
Stranraer,6056,5,15,7,14,57,56,1,52
East Fife,6056,6,15,6,15,58,54,4,51
Peterhead,6056,7,14,7,15,41,46,-5,49
Albion,6056,8,13,9,14,59,51,8,48
Queen's Park,6056,9,8,8,20,32,58,-26,32
Stenhousem'r,6056,10,6,11,19,46,76,-30,29
Livingston,6057,1,23,3,10,87,52,35,72
Alloa,6057,2,21,7,8,71,37,34,70
Stranraer,6057,3,17,7,12,56,41,15,58
Airdrieon,6057,4,17,7,12,57,50,7,58
Brechin,6057,5,16,8,12,52,51,1,56
Queen's Park,6057,6,14,6,16,43,54,-11,48
Albion,6057,7,12,7,17,52,59,-7,43
Peterhead,6057,8,12,7,17,47,56,-9,43
East Fife,6057,9,7,9,20,42,60,-18,30
Stenhousem'r,6057,10,7,7,22,43,90,-47,28
Alloa,6058,1,21,7,8,75,49,26,70
Livingston,6058,2,18,6,12,78,53,25,60
Queen's Park,6058,3,17,6,13,47,45,2,57
East Fife,6058,4,14,11,11,41,34,7,53
Airdrieon,6058,5,14,10,12,61,57,4,52
Peterhead,6058,6,13,10,13,50,53,-3,49
Brechin,6058,7,14,6,16,49,53,-4,48
Albion,6058,8,11,11,14,45,47,-2,44
Stranraer,6058,9,11,7,18,41,54,-13,40
Stenhousem'r,6058,10,5,10,21,39,81,-42,25
Alloa,6059,1,21,5,10,78,44,34,68
Livingston,6059,2,20,7,9,68,45,23,67
Peterhead,6059,3,17,8,11,60,56,4,59
Airdrieon,6059,4,16,8,12,59,57,2,56
Albion,6059,5,14,10,12,61,47,14,52
Queen's Park,6059,6,14,7,15,50,57,-7,49
Brechin,6059,7,13,6,17,50,62,-12,45
East Fife,6059,8,9,12,15,47,56,-9,39
Stranraer,6059,9,11,6,19,46,62,-16,39
Stenhousem'r,6059,10,7,7,22,41,74,-33,28
Alloa,6060,1,18,11,7,67,40,27,65
Livingston,6060,2,19,5,12,80,57,23,62
Brechin,6060,3,17,9,10,55,50,5,60
Airdrieon,6060,4,16,10,10,58,48,10,58
Albion,6060,5,13,9,14,51,54,-3,48
East Fife,6060,6,11,12,13,52,41,11,45
Peterhead,6060,7,11,10,15,43,58,-15,43
Queen's Park,6060,8,11,8,17,39,59,-20,41
Stranraer,6060,9,11,6,19,45,57,-12,39
Stenhousem'r,6060,10,10,6,20,54,80,-26,36
Alloa,6061,1,22,4,10,75,42,33,70
Livingston,6061,2,19,7,10,72,51,21,64
Airdrieon,6061,3,16,7,13,58,62,-4,55
Albion,6061,4,15,9,12,60,58,2,54
Brechin,6061,5,15,7,14,49,46,3,52
Stranraer,6061,6,14,5,17,47,49,-2,47
Peterhead,6061,7,13,7,16,44,50,-6,46
East Fife,6061,8,12,9,15,45,44,1,45
Queen's Park,6061,9,11,8,17,31,48,-17,41
Stenhousem'r,6061,10,8,7,21,45,76,-31,31
Brechin,6062,1,20,8,8,66,40,26,68
Livingston,6062,2,20,3,13,78,53,25,63
Airdrieon,6062,3,17,6,13,61,53,8,57
Alloa,6062,4,15,8,13,65,46,19,53
Peterhead,6062,5,14,8,14,49,51,-2,50
Albion,6062,6,14,7,15,56,58,-2,49
Stranraer,6062,7,13,8,15,48,58,-10,47
East Fife,6062,8,12,7,17,47,49,-2,43
Queen's Park,6062,9,13,3,20,46,68,-22,42
Stenhousem'r,6062,10,9,8,19,45,85,-40,35
Livingston,6063,1,21,7,8,72,42,30,70
Alloa,6063,2,19,9,8,71,44,27,66
Airdrieon,6063,3,17,11,8,60,43,17,62
Brechin,6063,4,14,10,12,51,51,0,52
Peterhead,6063,5,13,8,15,47,51,-4,47
Albion,6063,6,11,11,14,47,49,-2,44
East Fife,6063,7,10,12,14,44,47,-3,42
Queen's Park,6063,8,9,12,15,32,47,-15,39
Stranraer,6063,9,9,9,18,49,61,-12,36
Stenhousem'r,6063,10,9,7,20,41,79,-38,34
Alloa,6064,1,20,9,7,75,43,32,69
Livingston,6064,2,20,4,12,83,62,21,64
Airdrieon,6064,3,17,10,9,49,42,7,61
Albion,6064,4,14,9,13,57,54,3,51
Stranraer,6064,5,12,12,12,52,53,-1,48
Queen's Park,6064,6,12,10,14,43,45,-2,46
Brechin,6064,7,12,8,16,48,52,-4,44
East Fife,6064,8,10,12,14,47,50,-3,42
Peterhead,6064,9,8,11,17,43,62,-19,35
Stenhousem'r,6064,10,9,7,20,48,82,-34,34
Livingston,6065,1,21,6,9,75,51,24,69
Alloa,6065,2,16,12,8,63,48,15,60
Brechin,6065,3,17,8,11,58,52,6,59
Airdrieon,6065,4,15,11,10,62,54,8,56
East Fife,6065,5,13,11,12,52,43,9,50
Stranraer,6065,6,15,3,18,57,66,-9,48
Peterhead,6065,7,12,10,14,50,47,3,46
Queen's Park,6065,8,12,7,17,38,57,-19,43
Albion,6065,9,11,9,16,53,57,-4,42
Stenhousem'r,6065,10,5,9,22,48,81,-33,24
Livingston,6066,1,19,8,9,68,38,30,65
Airdrieon,6066,2,18,6,12,56,48,8,60
Alloa,6066,3,17,6,13,65,46,19,57
Stranraer,6066,4,16,8,12,54,52,2,56
Brechin,6066,5,17,5,14,51,52,-1,56
Peterhead,6066,6,15,7,14,55,61,-6,52
Queen's Park,6066,7,14,6,16,42,57,-15,48
Albion,6066,8,12,6,18,47,58,-11,42
East Fife,6066,9,9,11,16,53,49,4,38
Stenhousem'r,6066,10,7,9,20,46,76,-30,30
Livingston,6067,1,21,4,11,76,48,28,67
Airdrieon,6067,2,19,6,11,67,53,14,63
Brechin,6067,3,17,4,15,48,49,-1,55
Peterhead,6067,4,17,4,15,51,55,-4,55
Alloa,6067,5,15,8,13,60,45,15,53
Albion,6067,6,15,5,16,57,53,4,50
Queen's Park,6067,7,14,7,15,45,51,-6,49
East Fife,6067,8,14,5,17,48,57,-9,47
Stranraer,6067,9,14,2,20,53,63,-10,44
Stenhousem'r,6067,10,8,7,21,51,82,-31,31
Airdrieon,6068,1,20,7,9,58,50,8,67
Brechin,6068,2,19,9,8,59,39,20,66
Alloa,6068,3,18,9,9,70,45,25,63
Albion,6068,4,14,11,11,56,45,11,53
Livingston,6068,5,15,8,13,73,64,9,53
Peterhead,6068,6,14,6,16,53,58,-5,48
East Fife,6068,7,12,8,16,42,45,-3,44
Stranraer,6068,8,10,7,19,46,63,-17,37
Queen's Park,6068,9,8,10,18,27,49,-22,34
Stenhousem'r,6068,10,8,9,19,46,72,-26,33
Livingston,6069,1,20,5,11,76,51,25,65
Brechin,6069,2,18,6,12,56,48,8,60
Airdrieon,6069,3,16,10,10,56,50,6,58
Alloa,6069,4,15,10,11,60,47,13,55
Peterhead,6069,5,15,7,14,43,47,-4,52
Albion,6069,6,13,10,13,53,54,-1,49
Stranraer,6069,7,12,8,16,54,64,-10,44
Stenhousem'r,6069,8,13,5,18,55,69,-14,44
East Fife,6069,9,10,8,18,46,49,-3,38
Queen's Park,6069,10,9,9,18,33,53,-20,36
Livingston,6070,1,21,5,10,70,44,26,68
Alloa,6070,2,17,7,12,64,45,19,58
Albion,6070,3,17,7,12,64,53,11,58
Peterhead,6070,4,17,6,13,58,52,6,57
Queen's Park,6070,5,18,3,15,47,44,3,57
Airdrieon,6070,6,16,4,16,59,59,0,52
East Fife,6070,7,14,9,13,53,42,11,51
Brechin,6070,8,15,6,15,49,55,-6,51
Stranraer,6070,9,9,7,20,42,61,-19,34
Stenhousem'r,6070,10,7,4,25,36,87,-51,25
Alloa,6071,1,23,6,7,81,44,37,75
Livingston,6071,2,20,5,11,71,46,25,65
Brechin,6071,3,15,7,14,48,51,-3,52
East Fife,6071,4,13,11,12,59,47,12,50
Airdrieon,6071,5,14,6,16,52,64,-12,48
Stranraer,6071,6,13,7,16,49,56,-7,46
Peterhead,6071,7,10,12,14,51,56,-5,42
Queen's Park,6071,8,12,6,18,39,57,-18,42
Albion,6071,9,11,8,17,49,57,-8,41
Stenhousem'r,6071,10,11,8,17,48,69,-21,41
Alloa,6072,1,24,5,7,74,40,34,77
Livingston,6072,2,22,5,9,74,41,33,71
Airdrieon,6072,3,19,6,11,65,46,19,63
Albion,6072,4,15,6,15,55,48,7,51
Brechin,6072,5,15,6,15,41,49,-8,51
Peterhead,6072,6,14,7,15,49,50,-1,49
East Fife,6072,7,14,6,16,51,49,2,48
Queen's Park,6072,8,9,8,19,28,54,-26,35
Stenhousem'r,6072,9,8,8,20,40,73,-33,32
Stranraer,6072,10,8,7,21,44,71,-27,31
Livingston,6073,1,25,3,8,82,36,46,78
Alloa,6073,2,17,8,11,65,43,22,59
Albion,6073,3,14,9,13,59,59,0,51
Brechin,6073,4,14,9,13,46,46,0,51
Queen's Park,6073,5,12,11,13,46,51,-5,47
Peterhead,6073,6,12,11,13,44,49,-5,47
Stranraer,6073,7,13,7,16,44,59,-15,46
East Fife,6073,8,11,11,14,55,53,2,44
Airdrieon,6073,9,12,8,16,51,61,-10,44
Stenhousem'r,6073,10,7,9,20,49,84,-35,30
Livingston,6074,1,22,5,9,81,51,30,71
Alloa,6074,2,21,7,8,77,46,31,70
Brechin,6074,3,19,5,12,56,40,16,62
Albion,6074,4,16,6,14,53,49,4,54
Queen's Park,6074,5,16,5,15,41,48,-7,53
Airdrieon,6074,6,14,5,17,50,59,-9,47
Stranraer,6074,7,14,2,20,43,60,-17,44
Peterhead,6074,8,12,7,17,46,50,-4,43
Stenhousem'r,6074,9,10,6,20,44,70,-26,36
East Fife,6074,10,8,8,20,42,60,-18,32
Alloa,6075,1,20,7,9,68,40,28,67
Livingston,6075,2,18,9,9,76,49,27,63
Brechin,6075,3,17,5,14,44,43,1,56
Queen's Park,6075,4,15,9,12,46,50,-4,54
Albion,6075,5,14,9,13,50,46,4,51
Stranraer,6075,6,13,10,13,61,57,4,49
Peterhead,6075,7,12,12,12,46,54,-8,48
Airdrieon,6075,8,12,9,15,57,61,-4,45
East Fife,6075,9,9,8,19,45,56,-11,35
Stenhousem'r,6075,10,7,8,21,41,78,-37,29
Airdrieon,6076,1,19,9,8,58,48,10,66
Livingston,6076,2,18,5,13,66,48,18,59
East Fife,6076,3,17,8,11,51,33,18,59
Alloa,6076,4,15,13,8,69,45,24,58
Brechin,6076,5,17,7,12,57,56,1,58
Peterhead,6076,6,14,9,13,48,51,-3,51
Albion,6076,7,10,12,14,51,55,-4,42
Queen's Park,6076,8,8,12,16,29,50,-21,36
Stranraer,6076,9,8,10,18,43,60,-17,34
Stenhousem'r,6076,10,7,9,20,44,70,-26,30
Airdrieon,6077,1,23,4,9,66,40,26,73
Livingston,6077,2,22,2,12,76,52,24,68
Alloa,6077,3,18,6,12,77,50,27,60
Albion,6077,4,16,6,14,63,53,10,54
Brechin,6077,5,15,5,16,49,47,2,50
Stranraer,6077,6,13,8,15,54,70,-16,47
Peterhead,6077,7,14,4,18,51,62,-11,46
Queen's Park,6077,8,12,7,17,39,53,-14,43
East Fife,6077,9,12,6,18,50,56,-6,42
Stenhousem'r,6077,10,7,8,21,45,87,-42,29
Livingston,6078,1,23,5,8,69,39,30,74
Airdrieon,6078,2,18,8,10,59,46,13,62
East Fife,6078,3,12,14,10,49,39,10,50
Alloa,6078,4,13,10,13,54,44,10,49
Stranraer,6078,5,13,9,14,52,49,3,48
Albion,6078,6,12,10,14,43,46,-3,46
Queen's Park,6078,7,13,7,16,34,47,-13,46
Brechin,6078,8,12,9,15,44,55,-11,45
Peterhead,6078,9,10,11,15,44,59,-15,41
Stenhousem'r,6078,10,8,9,19,41,65,-24,33
Livingston,6079,1,23,6,7,90,48,42,75
Airdrieon,6079,2,19,6,11,63,56,7,63
Brechin,6079,3,17,8,11,61,44,17,59
Alloa,6079,4,16,9,11,81,57,24,57
Queen's Park,6079,5,13,12,11,40,51,-11,51
Stranraer,6079,6,14,3,19,53,60,-7,45
Peterhead,6079,7,12,8,16,48,64,-16,44
Albion,6079,8,10,13,13,53,59,-6,43
East Fife,6079,9,10,11,15,50,52,-2,41
Stenhousem'r,6079,10,5,6,25,35,83,-48,21
Alloa,6080,1,20,8,8,68,39,29,68
Livingston,6080,2,20,4,12,80,46,34,64
Airdrieon,6080,3,20,4,12,62,48,14,64
Brechin,6080,4,18,5,13,62,50,12,59
Queen's Park,6080,5,18,3,15,45,49,-4,57
Peterhead,6080,6,13,7,16,51,64,-13,46
East Fife,6080,7,12,9,15,52,56,-4,45
Stranraer,6080,8,12,5,19,45,61,-16,41
Albion,6080,9,11,8,17,46,63,-17,41
Stenhousem'r,6080,10,6,7,23,42,77,-35,25
Brechin,6081,1,18,7,11,55,47,8,61
Airdrieon,6081,2,18,4,14,58,53,5,58
Livingston,6081,3,17,6,13,71,56,15,57
East Fife,6081,4,15,10,11,48,39,9,55
Alloa,6081,5,16,6,14,66,52,14,54
Peterhead,6081,6,14,8,14,47,50,-3,50
Albion,6081,7,14,7,15,59,56,3,49
Stenhousem'r,6081,8,13,5,18,54,70,-16,44
Queen's Park,6081,9,12,7,17,42,59,-17,43
Stranraer,6081,10,10,6,20,42,60,-18,36
Livingston,6082,1,24,1,11,88,51,37,73
Alloa,6082,2,21,6,9,71,47,24,69
Airdrieon,6082,3,18,4,14,62,64,-2,58
Brechin,6082,4,16,6,14,55,61,-6,54
East Fife,6082,5,15,8,13,61,50,11,53
Stranraer,6082,6,16,2,18,56,64,-8,50
Queen's Park,6082,7,14,5,17,41,54,-13,47
Peterhead,6082,8,12,5,19,56,57,-1,41
Albion,6082,9,11,7,18,54,64,-10,40
Stenhousem'r,6082,10,9,4,23,45,77,-32,31
Livingston,6083,1,24,3,9,76,42,34,75
Alloa,6083,2,21,6,9,73,43,30,69
Brechin,6083,3,18,4,14,55,45,10,58
Albion,6083,4,15,8,13,54,51,3,53
Airdrieon,6083,5,15,6,15,44,54,-10,51
East Fife,6083,6,14,7,15,57,55,2,49
Peterhead,6083,7,13,6,17,58,62,-4,45
Stranraer,6083,8,12,5,19,47,59,-12,41
Queen's Park,6083,9,11,8,17,31,47,-16,41
Stenhousem'r,6083,10,8,5,23,41,78,-37,29
Livingston,6084,1,21,5,10,78,47,31,68
Alloa,6084,2,17,12,7,68,44,24,63
Stranraer,6084,3,18,4,14,68,61,7,58
Airdrieon,6084,4,17,7,12,60,57,3,58
Queen's Park,6084,5,15,8,13,39,46,-7,53
Albion,6084,6,14,10,12,56,51,5,52
Peterhead,6084,7,15,6,15,56,55,1,51
Brechin,6084,8,14,7,15,51,47,4,49
East Fife,6084,9,7,6,23,39,69,-30,27
Stenhousem'r,6084,10,6,7,23,44,82,-38,25
Alloa,6085,1,19,8,9,69,44,25,65
Albion,6085,2,17,11,8,67,42,25,62
Livingston,6085,3,19,5,12,72,51,21,62
Brechin,6085,4,18,7,11,51,42,9,61
Airdrieon,6085,5,16,6,14,55,55,0,54
Peterhead,6085,6,13,9,14,49,50,-1,48
East Fife,6085,7,13,6,17,54,53,1,45
Stranraer,6085,8,14,3,19,51,67,-16,45
Queen's Park,6085,9,11,5,20,42,65,-23,38
Stenhousem'r,6085,10,6,8,22,37,78,-41,26
Livingston,6086,1,19,7,10,70,47,23,64
Airdrieon,6086,2,18,5,13,57,56,1,59
Alloa,6086,3,16,8,12,67,50,17,56
Albion,6086,4,14,13,9,50,39,11,55
Peterhead,6086,5,15,8,13,53,49,4,53
Brechin,6086,6,16,4,16,47,45,2,52
Stranraer,6086,7,13,5,18,41,59,-18,44
East Fife,6086,8,9,14,13,47,50,-3,41
Queen's Park,6086,9,10,9,17,33,47,-14,39
Stenhousem'r,6086,10,9,9,18,51,74,-23,36
Alloa,6087,1,19,8,9,75,43,32,65
Livingston,6087,2,18,6,12,60,43,17,60
Brechin,6087,3,18,6,12,50,41,9,60
Airdrieon,6087,4,17,7,12,70,56,14,58
Peterhead,6087,5,17,6,13,51,46,5,57
Albion,6087,6,14,11,11,59,58,1,53
Stranraer,6087,7,14,3,19,49,60,-11,45
Queen's Park,6087,8,12,5,19,34,56,-22,41
East Fife,6087,9,8,11,17,45,59,-14,35
Stenhousem'r,6087,10,8,7,21,46,77,-31,31
Airdrieon,6088,1,23,5,8,69,44,25,74
Livingston,6088,2,20,6,10,87,54,33,66
Alloa,6088,3,19,9,8,70,44,26,66
Albion,6088,4,14,10,12,58,53,5,52
Brechin,6088,5,15,5,16,56,68,-12,50
Peterhead,6088,6,13,7,16,57,55,2,46
East Fife,6088,7,12,10,14,52,52,0,46
Queen's Park,6088,8,12,4,20,35,55,-20,40
Stranraer,6088,9,12,2,22,41,64,-23,38
Stenhousem'r,6088,10,8,6,22,47,83,-36,30
Alloa,6089,1,20,5,11,85,51,34,65
Airdrieon,6089,2,20,5,11,70,58,12,65
Livingston,6089,3,19,5,12,77,54,23,62
Brechin,6089,4,16,8,12,53,52,1,56
East Fife,6089,5,15,7,14,63,53,10,52
Peterhead,6089,6,15,6,15,51,54,-3,51
Albion,6089,7,12,10,14,53,58,-5,46
Queen's Park,6089,8,12,8,16,41,50,-9,44
Stranraer,6089,9,8,10,18,51,77,-26,34
Stenhousem'r,6089,10,8,6,22,50,87,-37,30
Alloa,6090,1,22,8,6,78,40,38,74
Livingston,6090,2,20,6,10,72,42,30,66
Peterhead,6090,3,15,8,13,46,44,2,53
Brechin,6090,4,15,7,14,46,53,-7,52
Albion,6090,5,14,8,14,58,59,-1,50
Queen's Park,6090,6,14,8,14,47,52,-5,50
East Fife,6090,7,11,11,14,50,55,-5,44
Stranraer,6090,8,10,12,14,54,63,-9,42
Airdrieon,6090,9,12,6,18,53,62,-9,42
Stenhousem'r,6090,10,6,8,22,43,77,-34,26
Livingston,6091,1,21,4,11,86,50,36,67
Alloa,6091,2,19,8,9,71,44,27,65
Albion,6091,3,18,5,13,62,55,7,59
Queen's Park,6091,4,17,6,13,47,49,-2,57
Peterhead,6091,5,15,10,11,49,50,-1,55
Airdrieon,6091,6,13,9,14,55,58,-3,48
Brechin,6091,7,14,6,16,43,46,-3,48
East Fife,6091,8,12,9,15,53,52,1,45
Stranraer,6091,9,10,6,20,41,60,-19,36
Stenhousem'r,6091,10,6,7,23,41,84,-43,25
Livingston,6092,1,24,0,12,86,49,37,72
Brechin,6092,2,19,4,13,48,43,5,61
Airdrieon,6092,3,17,6,13,59,51,8,57
Stranraer,6092,4,18,3,15,55,58,-3,57
Peterhead,6092,5,15,8,13,49,51,-2,53
Alloa,6092,6,15,6,15,63,51,12,51
Albion,6092,7,14,6,16,48,51,-3,48
East Fife,6092,8,13,6,17,52,51,1,45
Queen's Park,6092,9,13,5,18,33,46,-13,44
Stenhousem'r,6092,10,5,10,21,44,86,-42,25
Livingston,6093,1,23,4,9,81,46,35,73
Brechin,6093,2,19,8,9,52,36,16,65
Alloa,6093,3,16,11,9,71,45,26,59
Stranraer,6093,4,16,5,15,55,51,4,53
Airdrieon,6093,5,12,12,12,49,53,-4,48
East Fife,6093,6,12,11,13,46,43,3,47
Albion,6093,7,13,8,15,43,48,-5,47
Peterhead,6093,8,10,7,19,40,60,-20,37
Stenhousem'r,6093,9,11,3,22,43,73,-30,36
Queen's Park,6093,10,8,11,17,32,57,-25,35
Livingston,6094,1,19,8,9,84,49,35,65
Alloa,6094,2,17,10,9,72,44,28,61
Airdrieon,6094,3,16,7,13,60,58,2,55
Brechin,6094,4,16,5,15,49,51,-2,53
Queen's Park,6094,5,15,7,14,41,45,-4,52
East Fife,6094,6,13,11,12,59,53,6,50
Albion,6094,7,14,8,14,55,57,-2,50
Peterhead,6094,8,11,10,15,49,64,-15,43
Stranraer,6094,9,11,9,16,54,68,-14,42
Stenhousem'r,6094,10,6,9,21,52,86,-34,27
Livingston,6095,1,25,4,7,72,36,36,79
Alloa,6095,2,18,7,11,68,46,22,61
East Fife,6095,3,14,9,13,44,42,2,51
Airdrieon,6095,4,14,8,14,55,53,2,50
Queen's Park,6095,5,14,6,16,38,47,-9,48
Albion,6095,6,12,9,15,40,42,-2,45
Peterhead,6095,7,12,9,15,46,56,-10,45
Stranraer,6095,8,13,5,18,44,52,-8,44
Brechin,6095,9,11,10,15,49,58,-9,43
Stenhousem'r,6095,10,9,9,18,44,68,-24,36
Alloa,6096,1,19,7,10,77,44,33,64
Albion,6096,2,17,10,9,52,40,12,61
Livingston,6096,3,18,5,13,70,57,13,59
Brechin,6096,4,16,8,12,50,43,7,56
Airdrieon,6096,5,17,5,14,57,62,-5,56
Peterhead,6096,6,13,8,15,46,56,-10,47
Queen's Park,6096,7,12,9,15,36,50,-14,45
East Fife,6096,8,11,11,14,40,41,-1,44
Stranraer,6096,9,12,6,18,51,58,-7,42
Stenhousem'r,6096,10,8,5,23,42,70,-28,29
Alloa,6097,1,23,8,5,67,33,34,77
Livingston,6097,2,20,3,13,69,55,14,63
Brechin,6097,3,18,6,12,51,42,9,60
Airdrieon,6097,4,16,6,14,62,54,8,54
East Fife,6097,5,14,9,13,50,41,9,51
Albion,6097,6,15,5,16,53,58,-5,50
Peterhead,6097,7,14,6,16,52,55,-3,48
Stranraer,6097,8,13,3,20,52,66,-14,42
Stenhousem'r,6097,9,11,6,19,47,71,-24,39
Queen's Park,6097,10,8,4,24,33,61,-28,28
Livingston,6098,1,22,3,11,83,45,38,69
Alloa,6098,2,13,15,8,64,50,14,54
Stranraer,6098,3,17,3,16,62,63,-1,54
Peterhead,6098,4,15,8,13,51,55,-4,53
Airdrieon,6098,5,15,7,14,58,57,1,52
Brechin,6098,6,14,8,14,42,52,-10,50
Albion,6098,7,13,8,15,58,54,4,47
East Fife,6098,8,12,8,16,56,61,-5,44
Queen's Park,6098,9,12,6,18,40,52,-12,42
Stenhousem'r,6098,10,10,8,18,51,76,-25,38
Alloa,6099,1,18,13,5,67,38,29,67
Livingston,6099,2,20,4,12,79,54,25,64
East Fife,6099,3,16,12,8,55,33,22,60
Airdrieon,6099,4,16,10,10,53,51,2,58
Brechin,6099,5,16,7,13,49,48,1,55
Albion,6099,6,13,11,12,48,46,2,50
Peterhead,6099,7,13,9,14,58,60,-2,48
Stranraer,6099,8,11,5,20,42,60,-18,38
Queen's Park,6099,9,9,6,21,25,46,-21,33
Stenhousem'r,6099,10,4,11,21,40,80,-40,23
Alloa,6100,1,16,13,7,68,45,23,61
Livingston,6100,2,17,6,13,78,59,19,57
East Fife,6100,3,15,10,11,69,46,23,55
Brechin,6100,4,15,9,12,50,55,-5,54
Airdrieon,6100,5,14,9,13,48,56,-8,51
Albion,6100,6,13,10,13,54,52,2,49
Queen's Park,6100,7,13,6,17,43,58,-15,45
Stenhousem'r,6100,8,12,8,16,53,72,-19,44
Peterhead,6100,9,10,10,16,46,54,-8,40
Stranraer,6100,10,9,11,16,43,55,-12,38
Livingston,6101,1,21,5,10,78,49,29,68
Airdrieon,6101,2,19,8,9,59,47,12,65
Alloa,6101,3,17,9,10,67,39,28,60
Queen's Park,6101,4,14,10,12,46,45,1,52
East Fife,6101,5,13,10,13,56,40,16,49
Brechin,6101,6,12,10,14,44,56,-12,46
Albion,6101,7,11,12,13,52,55,-3,45
Peterhead,6101,8,10,10,16,44,57,-13,40
Stranraer,6101,9,9,10,17,45,63,-18,37
Stenhousem'r,6101,10,7,10,19,45,85,-40,31
Livingston,6102,1,23,4,9,79,45,34,73
Airdrieon,6102,2,17,8,11,66,58,8,59
Alloa,6102,3,16,9,11,65,44,21,57
Queen's Park,6102,4,16,8,12,51,50,1,56
Peterhead,6102,5,15,10,11,54,48,6,55
Albion,6102,6,15,8,13,51,48,3,53
Brechin,6102,7,14,9,13,48,46,2,51
Stranraer,6102,8,10,8,18,44,60,-16,38
East Fife,6102,9,6,12,18,45,60,-15,30
Stenhousem'r,6102,10,5,10,21,42,86,-44,25
Livingston,6103,1,20,4,12,84,58,26,64
Alloa,6103,2,17,12,7,74,43,31,63
Brechin,6103,3,17,4,15,49,45,4,55
Airdrieon,6103,4,16,6,14,56,61,-5,54
Queen's Park,6103,5,14,9,13,46,52,-6,51
Peterhead,6103,6,12,13,11,60,54,6,49
Stranraer,6103,7,14,6,16,55,66,-11,48
Albion,6103,8,14,5,17,56,55,1,47
East Fife,6103,9,11,9,16,48,61,-13,42
Stenhousem'r,6103,10,8,6,22,48,81,-33,30
Livingston,6104,1,21,6,9,76,52,24,69
Peterhead,6104,2,17,8,11,51,49,2,59
Alloa,6104,3,16,8,12,71,50,21,56
Airdrieon,6104,4,16,8,12,50,44,6,56
Brechin,6104,5,16,5,15,45,44,1,53
Albion,6104,6,14,9,13,56,52,4,51
Stranraer,6104,7,13,5,18,51,58,-7,44
Queen's Park,6104,8,12,6,18,32,47,-15,42
East Fife,6104,9,9,12,15,47,51,-4,39
Stenhousem'r,6104,10,8,9,19,41,73,-32,33
Livingston,6105,1,23,7,6,91,43,48,76
Albion,6105,2,18,7,11,60,43,17,61
Alloa,6105,3,16,8,12,60,44,16,56
Airdrieon,6105,4,16,8,12,63,58,5,56
Brechin,6105,5,17,2,17,53,57,-4,53
Peterhead,6105,6,14,10,12,52,54,-2,52
Stranraer,6105,7,13,5,18,47,56,-9,44
Queen's Park,6105,8,10,10,16,33,47,-14,40
East Fife,6105,9,9,7,20,48,56,-8,34
Stenhousem'r,6105,10,8,8,20,48,97,-49,32
Livingston,6106,1,21,5,10,81,54,27,68
Airdrieon,6106,2,20,6,10,61,44,17,66
Albion,6106,3,17,8,11,55,47,8,59
Alloa,6106,4,17,6,13,62,52,10,57
Brechin,6106,5,15,7,14,54,55,-1,52
Stranraer,6106,6,13,7,16,49,53,-4,46
East Fife,6106,7,12,8,16,50,51,-1,44
Peterhead,6106,8,11,9,16,44,55,-11,42
Queen's Park,6106,9,11,5,20,38,57,-19,38
Stenhousem'r,6106,10,9,7,20,44,70,-26,34
Livingston,6107,1,19,7,10,71,44,27,64
Albion,6107,2,17,9,10,65,51,14,60
Alloa,6107,3,16,9,11,68,55,13,57
Airdrieon,6107,4,16,8,12,59,52,7,56
Brechin,6107,5,16,3,17,43,48,-5,51
Queen's Park,6107,6,14,7,15,43,52,-9,49
East Fife,6107,7,11,14,11,49,48,1,47
Peterhead,6107,8,12,10,14,59,64,-5,46
Stranraer,6107,9,11,6,19,53,67,-14,39
Stenhousem'r,6107,10,8,7,21,52,81,-29,31
Livingston,6108,1,21,6,9,79,46,33,69
Airdrieon,6108,2,20,7,9,59,43,16,67
Alloa,6108,3,18,10,8,73,45,28,64
Brechin,6108,4,20,2,14,57,50,7,62
Stranraer,6108,5,15,7,14,57,58,-1,52
Albion,6108,6,14,8,14,59,59,0,50
Queen's Park,6108,7,11,6,19,38,58,-20,39
East Fife,6108,8,9,10,17,41,52,-11,37
Peterhead,6108,9,7,11,18,32,60,-28,32
Stenhousem'r,6108,10,6,11,19,49,73,-24,29
Livingston,6109,1,20,5,11,83,49,34,65
Alloa,6109,2,20,5,11,73,48,25,65
Airdrieon,6109,3,18,6,12,64,57,7,60
Albion,6109,4,17,8,11,56,45,11,59
Peterhead,6109,5,16,8,12,60,52,8,56
Brechin,6109,6,17,5,14,51,50,1,56
Queen's Park,6109,7,12,8,16,45,57,-12,44
East Fife,6109,8,12,6,18,49,52,-3,42
Stranraer,6109,9,10,7,19,45,62,-17,37
Stenhousem'r,6109,10,6,6,24,37,91,-54,24
Livingston,6110,1,23,1,12,74,41,33,70
Brechin,6110,2,20,2,14,56,44,12,62
Alloa,6110,3,18,6,12,68,52,16,60
Airdrieon,6110,4,15,7,14,53,53,0,52
Peterhead,6110,5,14,10,12,51,51,0,52
Albion,6110,6,14,9,13,57,59,-2,51
Queen's Park,6110,7,13,7,16,35,52,-17,46
Stranraer,6110,8,13,4,19,47,57,-10,43
East Fife,6110,9,10,9,17,45,49,-4,39
Stenhousem'r,6110,10,9,7,20,46,74,-28,34
Livingston,6111,1,20,6,10,69,49,20,66
Alloa,6111,2,17,11,8,75,43,32,62
Airdrieon,6111,3,18,7,11,65,56,9,61
Brechin,6111,4,17,6,13,53,49,4,57
Albion,6111,5,16,7,13,52,42,10,55
Peterhead,6111,6,13,10,13,44,44,0,49
Queen's Park,6111,7,13,6,17,40,54,-14,45
Stranraer,6111,8,12,5,19,44,56,-12,41
East Fife,6111,9,9,8,19,42,53,-11,35
Stenhousem'r,6111,10,7,10,19,42,80,-38,31
Alloa,6112,1,24,5,7,83,34,49,77
Airdrieon,6112,2,18,9,9,63,50,13,63
Brechin,6112,3,19,5,12,56,52,4,62
Peterhead,6112,4,16,9,11,55,58,-3,57
Livingston,6112,5,15,7,14,73,57,16,52
Stranraer,6112,6,12,7,17,52,58,-6,43
Albion,6112,7,12,6,18,42,52,-10,42
Queen's Park,6112,8,12,6,18,35,57,-22,42
East Fife,6112,9,10,10,16,46,52,-6,40
Stenhousem'r,6112,10,7,6,23,46,81,-35,27
Brechin,6113,1,19,6,11,55,46,9,63
Alloa,6113,2,18,8,10,62,41,21,62
Livingston,6113,3,19,3,14,72,46,26,60
Airdrieon,6113,4,18,4,14,50,52,-2,58
Peterhead,6113,5,16,9,11,58,50,8,57
East Fife,6113,6,14,8,14,52,47,5,50
Albion,6113,7,14,6,16,46,55,-9,48
Stranraer,6113,8,13,4,19,57,65,-8,43
Queen's Park,6113,9,9,10,17,33,56,-23,37
Stenhousem'r,6113,10,7,8,21,48,75,-27,29
Alloa,6114,1,21,6,9,73,46,27,69
Livingston,6114,2,20,7,9,91,53,38,67
Airdrieon,6114,3,21,2,13,63,57,6,65
Albion,6114,4,17,5,14,59,53,6,56
Peterhead,6114,5,14,8,14,53,55,-2,50
Brechin,6114,6,15,4,17,50,54,-4,49
Queen's Park,6114,7,14,7,15,42,53,-11,49
Stranraer,6114,8,15,2,19,51,58,-7,47
East Fife,6114,9,9,9,18,47,56,-9,36
Stenhousem'r,6114,10,4,10,22,48,92,-44,22
Livingston,6115,1,22,4,10,83,49,34,70
Airdrieon,6115,2,19,11,6,70,47,23,68
Alloa,6115,3,17,10,9,68,52,16,61
Brechin,6115,4,15,9,12,55,51,4,54
Albion,6115,5,13,13,10,57,54,3,52
Peterhead,6115,6,12,7,17,49,61,-12,43
Stranraer,6115,7,12,6,18,52,62,-10,42
East Fife,6115,8,8,11,17,51,60,-9,35
Queen's Park,6115,9,9,8,19,33,59,-26,35
Stenhousem'r,6115,10,7,13,16,54,77,-23,34
Livingston,6116,1,23,5,8,80,47,33,74
Alloa,6116,2,19,8,9,76,49,27,65
Brechin,6116,3,19,5,12,57,45,12,62
Airdrieon,6116,4,16,7,13,65,54,11,55
Albion,6116,5,14,7,15,46,47,-1,49
Peterhead,6116,6,13,10,13,48,52,-4,49
Queen's Park,6116,7,12,7,17,32,47,-15,43
Stranraer,6116,8,10,9,17,56,70,-14,39
East Fife,6116,9,7,13,16,44,54,-10,34
Stenhousem'r,6116,10,9,5,22,42,81,-39,32
Livingston,6117,1,24,5,7,85,39,46,77
Brechin,6117,2,21,5,10,54,44,10,68
Airdrieon,6117,3,19,7,10,58,48,10,64
Alloa,6117,4,17,7,12,64,42,22,58
Albion,6117,5,15,9,12,57,56,1,54
East Fife,6117,6,11,10,15,43,47,-4,43
Peterhead,6117,7,9,11,16,38,51,-13,38
Queen's Park,6117,8,10,7,19,36,53,-17,37
Stranraer,6117,9,9,5,22,46,65,-19,32
Stenhousem'r,6117,10,8,8,20,38,74,-36,32
Alloa,6118,1,21,10,5,73,35,38,73
Livingston,6118,2,19,4,13,67,46,21,61
Airdrieon,6118,3,19,4,13,61,59,2,61
Brechin,6118,4,16,7,13,52,54,-2,55
Albion,6118,5,13,11,12,54,51,3,50
Stranraer,6118,6,15,5,16,58,56,2,50
Queen's Park,6118,7,13,5,18,44,59,-15,44
Peterhead,6118,8,10,10,16,39,52,-13,40
East Fife,6118,9,8,12,16,44,51,-7,36
Stenhousem'r,6118,10,8,8,20,42,71,-29,32
Livingston,6119,1,23,4,9,86,49,37,73
Alloa,6119,2,20,7,9,82,46,36,67
Airdrieon,6119,3,19,6,11,69,59,10,63
Queen's Park,6119,4,17,3,16,45,48,-3,54
Peterhead,6119,5,14,10,12,51,55,-4,52
Albion,6119,6,15,5,16,51,54,-3,50
Brechin,6119,7,12,7,17,43,57,-14,43
East Fife,6119,8,11,9,16,49,50,-1,42
Stranraer,6119,9,11,6,19,39,56,-17,39
Stenhousem'r,6119,10,7,5,24,45,86,-41,26
Livingston,6120,1,22,3,11,82,43,39,69
Alloa,6120,2,19,8,9,73,46,27,65
Airdrieon,6120,3,18,4,14,61,54,7,58
Peterhead,6120,4,14,10,12,53,55,-2,52
Brechin,6120,5,14,10,12,49,52,-3,52
Albion,6120,6,14,7,15,58,56,2,49
Queen's Park,6120,7,13,9,14,47,52,-5,48
East Fife,6120,8,10,12,14,49,54,-5,42
Stranraer,6120,9,10,7,19,47,65,-18,37
Stenhousem'r,6120,10,6,10,20,52,94,-42,28
Livingston,6121,1,21,7,8,67,42,25,70
Airdrieon,6121,2,17,8,11,59,48,11,59
Alloa,6121,3,16,9,11,68,45,23,57
Brechin,6121,4,16,8,12,47,46,1,56
Albion,6121,5,15,9,12,53,42,11,54
Peterhead,6121,6,15,8,13,47,53,-6,53
East Fife,6121,7,10,13,13,47,42,5,43
Stranraer,6121,8,9,9,18,44,61,-17,36
Stenhousem'r,6121,9,9,8,19,44,73,-29,35
Queen's Park,6121,10,8,9,19,28,52,-24,33
Livingston,6122,1,21,6,9,77,51,26,69
Airdrieon,6122,2,18,8,10,56,42,14,62
Alloa,6122,3,17,10,9,63,46,17,61
Brechin,6122,4,19,4,13,49,40,9,61
Albion,6122,5,15,6,15,57,57,0,51
Peterhead,6122,6,13,7,16,48,58,-10,46
East Fife,6122,7,12,8,16,47,43,4,44
Stranraer,6122,8,12,6,18,48,57,-9,42
Queen's Park,6122,9,8,10,18,34,49,-15,34
Stenhousem'r,6122,10,9,7,20,40,76,-36,34
Livingston,6123,1,23,3,10,73,46,27,72
Brechin,6123,2,20,6,10,66,55,11,66
Alloa,6123,3,17,8,11,67,44,23,59
Airdrieon,6123,4,16,7,13,51,45,6,55
Albion,6123,5,15,8,13,52,48,4,53
Peterhead,6123,6,14,5,17,49,52,-3,47
Stranraer,6123,7,14,4,18,47,52,-5,46
Queen's Park,6123,8,13,7,16,44,61,-17,46
East Fife,6123,9,8,9,19,42,56,-14,33
Stenhousem'r,6123,10,7,9,20,39,71,-32,30
Livingston,6124,1,21,3,12,71,46,25,66
Brechin,6124,2,19,5,12,64,45,19,62
Albion,6124,3,19,5,12,58,45,13,62
Alloa,6124,4,18,6,12,75,62,13,60
Queen's Park,6124,5,17,5,14,53,48,5,56
Peterhead,6124,6,16,7,13,46,51,-5,55
Airdrieon,6124,7,15,5,16,56,61,-5,50
East Fife,6124,8,12,6,18,44,52,-8,42
Stranraer,6124,9,12,3,21,51,63,-12,39
Stenhousem'r,6124,10,5,7,24,43,88,-45,22
Livingston,6125,1,25,4,7,87,47,40,79
Airdrieon,6125,2,19,9,8,62,48,14,66
East Fife,6125,3,16,11,9,53,39,14,59
Alloa,6125,4,14,10,12,61,51,10,52
Peterhead,6125,5,15,7,14,49,55,-6,52
Albion,6125,6,13,6,17,49,53,-4,45
Brechin,6125,7,13,4,19,50,58,-8,43
Queen's Park,6125,8,13,3,20,37,51,-14,42
Stranraer,6125,9,12,4,20,46,60,-14,40
Stenhousem'r,6125,10,8,6,22,46,78,-32,30
Livingston,6126,1,26,0,10,87,47,40,78
Alloa,6126,2,16,9,11,68,46,22,57
Airdrieon,6126,3,17,5,14,54,50,4,56
Brechin,6126,4,14,10,12,51,51,0,52
Albion,6126,5,14,9,13,47,50,-3,51
Queen's Park,6126,6,13,9,14,42,50,-8,48
East Fife,6126,7,12,8,16,42,45,-3,44
Peterhead,6126,8,10,11,15,43,56,-13,41
Stranraer,6126,9,11,5,20,45,57,-12,38
Stenhousem'r,6126,10,10,8,18,52,79,-27,38
Livingston,6127,1,24,2,10,89,48,41,74
Alloa,6127,2,19,9,8,80,51,29,66
Albion,6127,3,18,6,12,63,47,16,60
Airdrieon,6127,4,15,9,12,70,53,17,54
East Fife,6127,5,14,10,12,62,51,11,52
Brechin,6127,6,14,8,14,45,55,-10,50
Stranraer,6127,7,11,8,17,52,63,-11,41
Queen's Park,6127,8,11,7,18,38,67,-29,40
Peterhead,6127,9,11,5,20,38,63,-25,38
Stenhousem'r,6127,10,8,6,22,49,88,-39,30
Livingston,6128,1,25,5,6,82,35,47,80
Alloa,6128,2,17,10,9,71,45,26,61
Queen's Park,6128,3,14,8,14,35,43,-8,50
Airdrieon,6128,4,14,7,15,58,68,-10,49
Albion,6128,5,13,9,14,46,46,0,48
Brechin,6128,6,13,9,14,41,44,-3,48
East Fife,6128,7,12,10,14,45,38,7,46
Stranraer,6128,8,12,6,18,52,65,-13,42
Peterhead,6128,9,11,8,17,45,58,-13,41
Stenhousem'r,6128,10,9,8,19,45,78,-33,35
Livingston,6129,1,23,5,8,77,45,32,74
Airdrieon,6129,2,17,7,12,78,64,14,58
Peterhead,6129,3,15,9,12,63,56,7,54
Stranraer,6129,4,15,9,12,47,47,0,54
Brechin,6129,5,16,5,15,54,50,4,53
Queen's Park,6129,6,15,6,15,46,52,-6,51
Alloa,6129,7,14,8,14,60,53,7,50
East Fife,6129,8,11,10,15,54,52,2,43
Albion,6129,9,11,10,15,41,54,-13,43
Stenhousem'r,6129,10,5,7,24,44,91,-47,22
Livingston,6130,1,23,4,9,79,42,37,73
Alloa,6130,2,18,7,11,73,45,28,61
Airdrieon,6130,3,18,5,13,57,57,0,59
Brechin,6130,4,17,8,11,48,49,-1,59
Queen's Park,6130,5,16,8,12,47,47,0,56
Peterhead,6130,6,12,9,15,49,56,-7,45
Albion,6130,7,9,12,15,41,52,-11,39
Stenhousem'r,6130,8,10,8,18,57,75,-18,38
Stranraer,6130,9,8,12,16,49,63,-14,36
East Fife,6130,10,7,11,18,48,62,-14,32
Livingston,6131,1,21,7,8,82,46,36,70
Alloa,6131,2,21,7,8,74,41,33,70
Brechin,6131,3,15,9,12,50,44,6,54
Peterhead,6131,4,15,7,14,59,52,7,52
Airdrieon,6131,5,14,8,14,62,65,-3,50
East Fife,6131,6,13,7,16,42,45,-3,46
Albion,6131,7,13,7,16,45,51,-6,46
Queen's Park,6131,8,12,7,17,34,51,-17,43
Stranraer,6131,9,12,6,18,46,69,-23,42
Stenhousem'r,6131,10,8,7,21,46,76,-30,31
Alloa,6132,1,18,7,11,71,48,23,61
Livingston,6132,2,18,5,13,64,47,17,59
Brechin,6132,3,17,7,12,58,50,8,58
Queen's Park,6132,4,15,9,12,46,44,2,54
Airdrieon,6132,5,15,7,14,51,61,-10,52
Peterhead,6132,6,13,11,12,56,55,1,50
Stranraer,6132,7,14,7,15,59,55,4,49
Albion,6132,8,13,10,13,53,50,3,49
East Fife,6132,9,11,9,16,41,52,-11,42
Stenhousem'r,6132,10,7,6,23,41,78,-37,27
Livingston,6133,1,20,7,9,91,58,33,67
Alloa,6133,2,20,7,9,77,45,32,67
Brechin,6133,3,17,9,10,46,39,7,60
Airdrieon,6133,4,18,5,13,60,61,-1,59
Peterhead,6133,5,15,6,15,47,52,-5,51
Albion,6133,6,13,9,14,53,50,3,48
Queen's Park,6133,7,13,8,15,43,49,-6,47
Stranraer,6133,8,11,6,19,53,70,-17,39
East Fife,6133,9,10,8,18,46,55,-9,38
Stenhousem'r,6133,10,6,9,21,49,86,-37,27
Brechin,6134,1,20,5,11,72,50,22,65
Livingston,6134,2,19,7,10,63,39,24,64
Alloa,6134,3,17,8,11,70,48,22,59
Airdrieon,6134,4,15,8,13,56,58,-2,53
Stranraer,6134,5,15,7,14,60,60,0,52
East Fife,6134,6,14,9,13,55,48,7,51
Peterhead,6134,7,12,11,13,42,53,-11,47
Albion,6134,8,10,10,16,47,64,-17,40
Queen's Park,6134,9,10,8,18,35,52,-17,38
Stenhousem'r,6134,10,7,9,20,49,77,-28,30
Livingston,6135,1,20,6,10,73,51,22,66
Albion,6135,2,17,9,10,58,42,16,60
Alloa,6135,3,15,11,10,51,39,12,56
Stranraer,6135,4,14,9,13,55,51,4,51
Airdrieon,6135,5,14,9,13,52,51,1,51
Peterhead,6135,6,14,8,14,54,52,2,50
Brechin,6135,7,14,6,16,49,55,-6,48
Queen's Park,6135,8,13,4,19,31,56,-25,43
East Fife,6135,9,10,11,15,44,45,-1,41
Stenhousem'r,6135,10,6,13,17,49,74,-25,31
Livingston,6136,1,23,3,10,81,47,34,72
Alloa,6136,2,19,10,7,63,39,24,67
Airdrieon,6136,3,19,6,11,55,55,0,63
Brechin,6136,4,18,5,13,50,46,4,59
Peterhead,6136,5,15,7,14,63,55,8,52
Albion,6136,6,12,13,11,55,54,1,49
Stranraer,6136,7,13,6,17,49,57,-8,45
Queen's Park,6136,8,10,10,16,35,53,-18,40
Stenhousem'r,6136,9,7,7,22,46,78,-32,28
East Fife,6136,10,5,11,20,37,50,-13,26
Livingston,6137,1,18,8,10,63,42,21,62
Alloa,6137,2,16,10,10,63,46,17,58
Airdrieon,6137,3,15,11,10,59,50,9,56
Stranraer,6137,4,16,8,12,56,51,5,56
Brechin,6137,5,15,8,13,55,51,4,53
Peterhead,6137,6,15,7,14,52,57,-5,52
East Fife,6137,7,10,12,14,48,51,-3,42
Queen's Park,6137,8,10,11,15,35,46,-11,41
Albion,6137,9,8,13,15,47,55,-8,37
Stenhousem'r,6137,10,10,6,20,50,79,-29,36
Livingston,6138,1,23,3,10,78,49,29,72
Airdrieon,6138,2,20,7,9,71,47,24,67
Alloa,6138,3,15,10,11,71,44,27,55
Brechin,6138,4,15,10,11,47,53,-6,55
Stranraer,6138,5,15,7,14,57,56,1,52
Albion,6138,6,14,8,14,52,53,-1,50
East Fife,6138,7,12,8,16,52,45,7,44
Peterhead,6138,8,11,9,16,52,65,-13,42
Queen's Park,6138,9,11,5,20,37,72,-35,38
Stenhousem'r,6138,10,7,7,22,43,76,-33,28
Alloa,6139,1,20,7,9,78,46,32,67
Livingston,6139,2,21,3,12,81,51,30,66
Airdrieon,6139,3,15,10,11,57,53,4,55
Peterhead,6139,4,15,8,13,47,44,3,53
Queen's Park,6139,5,16,4,16,47,52,-5,52
East Fife,6139,6,15,6,15,56,52,4,51
Albion,6139,7,14,9,13,55,62,-7,51
Brechin,6139,8,12,6,18,48,63,-15,42
Stranraer,6139,9,9,10,17,52,65,-13,37
Stenhousem'r,6139,10,5,13,18,51,84,-33,28
Airdrieon,6140,1,20,6,10,65,53,12,66
Alloa,6140,2,18,8,10,69,49,20,62
Livingston,6140,3,18,6,12,65,43,22,60
Brechin,6140,4,15,9,12,47,46,1,54
East Fife,6140,5,13,8,15,57,53,4,47
Stranraer,6140,6,13,7,16,47,52,-5,46
Peterhead,6140,7,13,6,17,47,53,-6,45
Queen's Park,6140,8,12,8,16,35,46,-11,44
Albion,6140,9,9,12,15,49,54,-5,39
Stenhousem'r,6140,10,10,8,18,50,82,-32,38
Alloa,6141,1,19,7,10,72,45,27,64
Livingston,6141,2,19,7,10,64,44,20,64
Airdrieon,6141,3,16,8,12,68,56,12,56
Brechin,6141,4,16,8,12,52,52,0,56
Queen's Park,6141,5,14,11,11,46,45,1,53
Albion,6141,6,13,11,12,50,45,5,50
Peterhead,6141,7,14,4,18,48,62,-14,46
Stranraer,6141,8,12,5,19,46,59,-13,41
East Fife,6141,9,8,12,16,50,58,-8,36
Stenhousem'r,6141,10,9,7,20,52,82,-30,34
Alloa,6142,1,22,6,8,85,46,39,72
Brechin,6142,2,18,9,9,46,41,5,63
Livingston,6142,3,18,4,14,72,58,14,58
Airdrieon,6142,4,17,5,14,57,49,8,56
Peterhead,6142,5,14,9,13,47,49,-2,51
Albion,6142,6,13,10,13,59,58,1,49
Stranraer,6142,7,12,9,15,53,66,-13,45
Queen's Park,6142,8,10,9,17,36,52,-16,39
East Fife,6142,9,10,7,19,43,50,-7,37
Stenhousem'r,6142,10,8,8,20,51,80,-29,32
Livingston,6143,1,25,4,7,79,42,37,79
Alloa,6143,2,19,7,10,71,47,24,64
Brechin,6143,3,19,5,12,61,48,13,62
Airdrieon,6143,4,17,6,13,54,51,3,57
Peterhead,6143,5,14,7,15,59,62,-3,49
East Fife,6143,6,11,9,16,50,52,-2,42
Albion,6143,7,12,6,18,48,61,-13,42
Queen's Park,6143,8,11,7,18,33,48,-15,40
Stranraer,6143,9,11,6,19,39,59,-20,39
Stenhousem'r,6143,10,9,7,20,51,75,-24,34
Livingston,6144,1,23,3,10,81,45,36,72
Alloa,6144,2,22,5,9,70,35,35,71
Airdrieon,6144,3,19,6,11,74,55,19,63
Brechin,6144,4,16,4,16,49,53,-4,52
Queen's Park,6144,5,14,6,16,45,49,-4,48
East Fife,6144,6,13,7,16,50,48,2,46
Peterhead,6144,7,12,10,14,50,60,-10,46
Albion,6144,8,11,8,17,45,58,-13,41
Stranraer,6144,9,13,2,21,52,69,-17,41
Stenhousem'r,6144,10,8,7,21,42,86,-44,31
Alloa,6145,1,21,7,8,70,40,30,70
Brechin,6145,2,18,8,10,52,37,15,62
Airdrieon,6145,3,19,5,12,62,54,8,62
Livingston,6145,4,18,4,14,69,60,9,58
East Fife,6145,5,15,5,16,46,39,7,50
Queen's Park,6145,6,13,6,17,49,63,-14,45
Stranraer,6145,7,13,4,19,47,57,-10,43
Stenhousem'r,6145,8,12,7,17,47,71,-24,43
Albion,6145,9,12,5,19,53,57,-4,41
Peterhead,6145,10,11,5,20,37,54,-17,38
Airdrieon,6146,1,20,6,10,73,54,19,66
Livingston,6146,2,18,5,13,74,53,21,59
Alloa,6146,3,17,7,12,70,50,20,58
Brechin,6146,4,17,7,12,51,49,2,58
Peterhead,6146,5,14,11,11,53,54,-1,53
Albion,6146,6,14,9,13,51,52,-1,51
Queen's Park,6146,7,13,9,14,49,46,3,48
Stranraer,6146,8,12,6,18,47,64,-17,42
East Fife,6146,9,7,15,14,41,46,-5,36
Stenhousem'r,6146,10,6,9,21,43,84,-41,27
Livingston,6147,1,18,7,11,65,45,20,61
Airdrieon,6147,2,18,7,11,56,44,12,61
Brechin,6147,3,17,7,12,42,34,8,58
Alloa,6147,4,17,5,14,58,45,13,56
Albion,6147,5,16,6,14,50,40,10,54
Peterhead,6147,6,14,10,12,52,46,6,52
Stranraer,6147,7,11,9,16,42,54,-12,42
East Fife,6147,8,10,11,15,40,50,-10,41
Queen's Park,6147,9,10,8,18,29,50,-21,38
Stenhousem'r,6147,10,10,8,18,42,68,-26,38
Alloa,6148,1,19,11,6,72,34,38,68
Livingston,6148,2,21,5,10,77,52,25,68
Brechin,6148,3,17,10,9,55,37,18,61
Airdrieon,6148,4,17,7,12,55,52,3,58
Peterhead,6148,5,12,9,15,52,61,-9,45
East Fife,6148,6,10,13,13,44,47,-3,43
Stranraer,6148,7,11,9,16,44,59,-15,42
Stenhousem'r,6148,8,10,9,17,43,64,-21,39
Queen's Park,6148,9,11,6,19,30,52,-22,39
Albion,6148,10,8,9,19,42,56,-14,33
Livingston,6149,1,21,4,11,82,51,31,67
Alloa,6149,2,17,8,11,64,52,12,59
Brechin,6149,3,17,7,12,47,51,-4,58
Airdrieon,6149,4,17,5,14,61,57,4,56
Peterhead,6149,5,16,7,13,48,44,4,55
Stranraer,6149,6,16,5,15,63,58,5,53
Albion,6149,7,15,7,14,54,54,0,52
East Fife,6149,8,14,8,14,59,48,11,50
Stenhousem'r,6149,9,6,11,19,39,74,-35,29
Queen's Park,6149,10,6,8,22,33,61,-28,26
Alloa,6150,1,19,9,8,71,46,25,66
Livingston,6150,2,20,4,12,65,45,20,64
Brechin,6150,3,18,5,13,47,38,9,59
Airdrieon,6150,4,17,4,15,52,49,3,55
Queen's Park,6150,5,16,7,13,44,44,0,55
Peterhead,6150,6,14,7,15,47,50,-3,49
Stenhousem'r,6150,7,12,8,16,53,70,-17,44
Albion,6150,8,10,10,16,51,58,-7,40
East Fife,6150,9,9,11,16,44,52,-8,38
Stranraer,6150,10,9,7,20,44,66,-22,34
Alloa,6151,1,19,8,9,77,44,33,65
Livingston,6151,2,18,6,12,74,52,22,60
Peterhead,6151,3,16,10,10,52,47,5,58
Brechin,6151,4,17,5,14,56,46,10,56
Airdrieon,6151,5,16,7,13,65,59,6,55
Queen's Park,6151,6,16,4,16,45,58,-13,52
Albion,6151,7,14,6,16,49,48,1,48
Stranraer,6151,8,14,6,16,56,63,-7,48
East Fife,6151,9,11,9,16,46,55,-9,42
Stenhousem'r,6151,10,4,9,23,34,82,-48,21
Livingston,6152,1,23,2,11,88,51,37,71
Alloa,6152,2,20,9,7,89,43,46,69
Airdrieon,6152,3,18,8,10,63,56,7,62
Brechin,6152,4,17,8,11,59,39,20,59
Albion,6152,5,15,7,14,54,60,-6,52
Peterhead,6152,6,13,7,16,50,59,-9,46
Stranraer,6152,7,13,6,17,42,57,-15,45
Queen's Park,6152,8,10,6,20,35,64,-29,36
East Fife,6152,9,9,8,19,36,52,-16,35
Stenhousem'r,6152,10,7,9,20,46,81,-35,30
Alloa,6153,1,20,9,7,73,38,35,69
Livingston,6153,2,20,6,10,75,47,28,66
Albion,6153,3,19,5,12,67,58,9,62
Brechin,6153,4,19,5,12,56,48,8,62
Airdrieon,6153,5,17,6,13,63,53,10,57
Peterhead,6153,6,14,8,14,42,52,-10,50
Queen's Park,6153,7,13,3,20,30,52,-22,42
Stranraer,6153,8,12,3,21,48,66,-18,39
East Fife,6153,9,10,6,20,46,52,-6,36
Stenhousem'r,6153,10,8,5,23,49,83,-34,29
Livingston,6154,1,24,3,9,77,44,33,75
Airdrieon,6154,2,17,7,12,65,61,4,58
Alloa,6154,3,16,4,16,62,53,9,52
Albion,6154,4,14,9,13,51,49,2,51
Brechin,6154,5,13,11,12,51,53,-2,50
Stranraer,6154,6,13,8,15,55,56,-1,47
East Fife,6154,7,12,10,14,54,44,10,46
Queen's Park,6154,8,11,9,16,38,60,-22,42
Peterhead,6154,9,10,11,15,51,61,-10,41
Stenhousem'r,6154,10,9,10,17,50,73,-23,37
Albion,6155,1,21,8,7,64,41,23,71
Alloa,6155,2,17,10,9,68,45,23,61
Livingston,6155,3,18,5,13,66,54,12,59
Brechin,6155,4,16,8,12,55,50,5,56
Airdrieon,6155,5,14,7,15,46,54,-8,49
Queen's Park,6155,6,13,9,14,42,47,-5,48
Peterhead,6155,7,11,10,15,51,61,-10,43
Stranraer,6155,8,11,9,16,47,46,1,42
East Fife,6155,9,9,10,17,41,51,-10,37
Stenhousem'r,6155,10,6,12,18,46,77,-31,30
Livingston,6156,1,22,6,8,74,45,29,72
Alloa,6156,2,20,7,9,75,45,30,67
Albion,6156,3,16,7,13,59,55,4,55
Airdrieon,6156,4,16,7,13,60,62,-2,55
Peterhead,6156,5,15,9,12,55,52,3,54
Brechin,6156,6,14,7,15,48,52,-4,49
Stranraer,6156,7,14,4,18,57,57,0,46
Queen's Park,6156,8,11,7,18,31,53,-22,40
East Fife,6156,9,10,7,19,50,58,-8,37
Stenhousem'r,6156,10,9,5,22,63,93,-30,32
Livingston,6157,1,22,4,10,75,38,37,70
Alloa,6157,2,16,11,9,67,48,19,59
Stranraer,6157,3,17,5,14,51,51,0,56
Brechin,6157,4,16,6,14,51,48,3,54
Airdrieon,6157,5,14,11,11,53,47,6,53
Peterhead,6157,6,11,13,12,46,52,-6,46
Albion,6157,7,10,14,12,48,46,2,44
Queen's Park,6157,8,12,8,16,40,54,-14,44
East Fife,6157,9,10,11,15,43,42,1,41
Stenhousem'r,6157,10,6,9,21,39,87,-48,27
Airdrieon,6158,1,19,6,11,58,46,12,63
Brechin,6158,2,17,9,10,61,44,17,60
Alloa,6158,3,17,8,11,70,52,18,59
Livingston,6158,4,17,8,11,67,51,16,59
Albion,6158,5,15,7,14,46,48,-2,52
Peterhead,6158,6,14,9,13,62,60,2,51
Stranraer,6158,7,15,5,16,55,60,-5,50
Queen's Park,6158,8,11,8,17,35,47,-12,41
East Fife,6158,9,8,11,17,51,62,-11,35
Stenhousem'r,6158,10,6,11,19,46,81,-35,29
Livingston,6159,1,21,7,8,73,42,31,70
Alloa,6159,2,20,7,9,79,43,36,67
Airdrieon,6159,3,16,8,12,60,55,5,56
Brechin,6159,4,16,6,14,52,49,3,54
East Fife,6159,5,13,14,9,61,44,17,53
Stranraer,6159,6,15,4,17,56,63,-7,49
Albion,6159,7,13,9,14,55,51,4,48
Peterhead,6159,8,13,6,17,49,57,-8,45
Queen's Park,6159,9,12,6,18,41,58,-17,42
Stenhousem'r,6159,10,4,7,25,40,104,-64,19
Alloa,6160,1,23,5,8,81,47,34,74
Livingston,6160,2,22,4,10,77,43,34,70
Airdrieon,6160,3,21,5,10,61,45,16,68
Stranraer,6160,4,15,6,15,51,52,-1,51
Peterhead,6160,5,14,7,15,55,59,-4,49
Brechin,6160,6,13,5,18,48,68,-20,44
Queen's Park,6160,7,11,8,17,39,52,-13,41
Albion,6160,8,10,8,18,51,65,-14,38
East Fife,6160,9,9,9,18,41,50,-9,36
Stenhousem'r,6160,10,9,9,18,49,72,-23,36
Livingston,6161,1,21,5,10,85,50,35,68
Airdrieon,6161,2,19,7,10,63,42,21,64
Alloa,6161,3,18,5,13,69,48,21,59
Peterhead,6161,4,15,10,11,56,56,0,55
Brechin,6161,5,15,9,12,43,46,-3,54
East Fife,6161,6,10,15,11,47,41,6,45
Albion,6161,7,11,11,14,53,62,-9,44
Stranraer,6161,8,12,7,17,53,58,-5,43
Queen's Park,6161,9,11,9,16,34,52,-18,42
Stenhousem'r,6161,10,5,8,23,44,92,-48,23
Livingston,6162,1,25,4,7,88,40,48,79
Alloa,6162,2,16,10,10,75,59,16,58
Airdrieon,6162,3,17,7,12,61,55,6,58
Queen's Park,6162,4,15,8,13,51,48,3,53
Brechin,6162,5,15,7,14,44,49,-5,52
Albion,6162,6,14,7,15,47,46,1,49
Peterhead,6162,7,14,7,15,56,59,-3,49
East Fife,6162,8,10,12,14,53,53,0,42
Stranraer,6162,9,9,6,21,42,68,-26,33
Stenhousem'r,6162,10,7,8,21,42,82,-40,29
Livingston,6163,1,22,6,8,81,48,33,72
Alloa,6163,2,18,9,9,81,50,31,63
Brechin,6163,3,17,8,11,54,48,6,59
Airdrieon,6163,4,17,6,13,56,61,-5,57
Albion,6163,5,15,5,16,51,47,4,50
Queen's Park,6163,6,12,9,15,35,50,-15,45
Stranraer,6163,7,12,7,17,54,59,-5,43
Peterhead,6163,8,13,4,19,50,63,-13,43
East Fife,6163,9,11,9,16,52,58,-6,42
Stenhousem'r,6163,10,8,7,21,45,75,-30,31
Alloa,6164,1,22,5,9,75,39,36,71
Livingston,6164,2,22,5,9,70,48,22,71
Brechin,6164,3,18,6,12,50,47,3,60
Airdrieon,6164,4,16,8,12,58,43,15,56
Peterhead,6164,5,16,8,12,48,47,1,56
Albion,6164,6,13,5,18,49,56,-7,44
Stranraer,6164,7,13,4,19,54,61,-7,43
East Fife,6164,8,10,10,16,58,61,-3,40
Stenhousem'r,6164,9,10,6,20,46,75,-29,36
Queen's Park,6164,10,9,5,22,26,57,-31,32
Alloa,6165,1,22,7,7,78,41,37,73
Airdrieon,6165,2,21,3,12,72,54,18,66
Livingston,6165,3,19,6,11,71,43,28,63
Stranraer,6165,4,15,7,14,57,53,4,52
Brechin,6165,5,15,7,14,47,48,-1,52
Albion,6165,6,15,7,14,48,52,-4,52
East Fife,6165,7,11,10,15,50,49,1,43
Peterhead,6165,8,10,10,16,44,65,-21,40
Queen's Park,6165,9,10,6,20,33,58,-25,36
Stenhousem'r,6165,10,6,9,21,49,86,-37,27
Livingston,6166,1,22,3,11,76,45,31,69
Alloa,6166,2,20,9,7,69,43,26,69
Airdrieon,6166,3,18,6,12,53,49,4,60
East Fife,6166,4,15,8,13,52,37,15,53
Brechin,6166,5,14,6,16,47,56,-9,48
Queen's Park,6166,6,12,8,16,36,44,-8,44
Stranraer,6166,7,13,4,19,61,65,-4,43
Albion,6166,8,11,9,16,42,52,-10,42
Peterhead,6166,9,11,9,16,40,53,-13,42
Stenhousem'r,6166,10,8,10,18,41,73,-32,34
Alloa,6167,1,21,7,8,69,38,31,70
Livingston,6167,2,19,7,10,77,50,27,64
Airdrieon,6167,3,18,8,10,54,41,13,62
Albion,6167,4,13,13,10,56,53,3,52
Brechin,6167,5,14,4,18,42,55,-13,46
Peterhead,6167,6,12,9,15,52,54,-2,45
Queen's Park,6167,7,12,8,16,42,54,-12,44
Stranraer,6167,8,11,10,15,45,54,-9,43
East Fife,6167,9,11,9,16,43,47,-4,42
Stenhousem'r,6167,10,7,9,20,37,71,-34,30
Alloa,6168,1,18,9,9,72,46,26,63
Livingston,6168,2,18,7,11,79,58,21,61
Brechin,6168,3,16,10,10,53,44,9,58
Airdrieon,6168,4,16,9,11,60,55,5,57
East Fife,6168,5,11,12,13,50,46,4,45
Albion,6168,6,10,15,11,49,47,2,45
Queen's Park,6168,7,12,9,15,35,49,-14,45
Stranraer,6168,8,10,13,13,51,57,-6,43
Peterhead,6168,9,8,12,16,41,60,-19,36
Stenhousem'r,6168,10,8,10,18,57,85,-28,34
Livingston,6169,1,24,4,8,95,48,47,76
Alloa,6169,2,19,8,9,71,40,31,65
Airdrieon,6169,3,17,5,14,53,56,-3,56
Peterhead,6169,4,14,10,12,52,53,-1,52
Brechin,6169,5,14,7,15,51,54,-3,49
Queen's Park,6169,6,14,6,16,44,55,-11,48
East Fife,6169,7,11,11,14,50,47,3,44
Albion,6169,8,11,9,16,50,59,-9,42
Stranraer,6169,9,11,5,20,46,71,-25,38
Stenhousem'r,6169,10,9,7,20,46,75,-29,34
Livingston,6170,1,24,5,7,85,41,44,77
Alloa,6170,2,18,11,7,76,45,31,65
Airdrieon,6170,3,18,8,10,61,49,12,62
Brechin,6170,4,15,6,15,53,53,0,51
Queen's Park,6170,5,14,9,13,38,44,-6,51
Albion,6170,6,13,9,14,54,49,5,48
Peterhead,6170,7,13,6,17,49,60,-11,45
East Fife,6170,8,12,8,16,47,54,-7,44
Stranraer,6170,9,9,6,21,48,71,-23,33
Stenhousem'r,6170,10,7,6,23,38,83,-45,27
Alloa,6171,1,20,8,8,75,41,34,68
Livingston,6171,2,21,3,12,71,49,22,66
Brechin,6171,3,16,6,14,54,53,1,54
Airdrieon,6171,4,15,7,14,55,53,2,52
Peterhead,6171,5,14,7,15,46,52,-6,49
Albion,6171,6,12,10,14,59,60,-1,46
Queen's Park,6171,7,12,10,14,34,46,-12,46
East Fife,6171,8,11,10,15,46,47,-1,43
Stranraer,6171,9,12,7,17,50,63,-13,43
Stenhousem'r,6171,10,9,8,19,42,68,-26,35
Livingston,6172,1,21,6,9,72,49,23,69
Alloa,6172,2,19,10,7,71,42,29,67
Airdrieon,6172,3,20,6,10,60,46,14,66
Stranraer,6172,4,17,6,13,67,63,4,57
Brechin,6172,5,15,6,15,48,44,4,51
Peterhead,6172,6,13,8,15,53,51,2,47
Albion,6172,7,12,7,17,50,59,-9,43
East Fife,6172,8,9,10,17,51,57,-6,37
Queen's Park,6172,9,10,5,21,35,68,-33,35
Stenhousem'r,6172,10,7,10,19,46,74,-28,31
Livingston,6173,1,23,5,8,83,46,37,74
Alloa,6173,2,19,8,9,69,39,30,65
Albion,6173,3,15,10,11,56,50,6,55
Brechin,6173,4,16,7,13,57,58,-1,55
Airdrieon,6173,5,14,8,14,55,62,-7,50
East Fife,6173,6,11,13,12,50,43,7,46
Stranraer,6173,7,13,5,18,49,58,-9,44
Queen's Park,6173,8,13,5,18,39,57,-18,44
Peterhead,6173,9,9,11,16,43,56,-13,38
Stenhousem'r,6173,10,6,10,20,42,74,-32,28
Alloa,6174,1,23,4,9,73,37,36,73
Livingston,6174,2,21,6,9,71,42,29,69
Airdrieon,6174,3,18,7,11,58,47,11,61
Albion,6174,4,15,7,14,57,45,12,52
Brechin,6174,5,13,5,18,41,52,-11,44
East Fife,6174,6,12,7,17,45,48,-3,43
Peterhead,6174,7,10,13,13,47,53,-6,43
Queen's Park,6174,8,11,9,16,37,53,-16,42
Stranraer,6174,9,12,6,18,40,61,-21,42
Stenhousem'r,6174,10,10,6,20,51,82,-31,36
Alloa,6175,1,22,8,6,77,39,38,74
Brechin,6175,2,21,1,14,54,52,2,64
Livingston,6175,3,18,6,12,70,53,17,60
Airdrieon,6175,4,18,5,13,65,57,8,59
Queen's Park,6175,5,15,8,13,50,51,-1,53
Albion,6175,6,14,10,12,60,53,7,52
Peterhead,6175,7,12,6,18,52,62,-10,42
East Fife,6175,8,10,10,16,44,46,-2,40
Stranraer,6175,9,12,4,20,57,64,-7,40
Stenhousem'r,6175,10,6,6,24,49,101,-52,24
Livingston,6176,1,22,4,10,76,48,28,70
Alloa,6176,2,18,9,9,69,42,27,63
Queen's Park,6176,3,15,7,14,47,50,-3,52
Airdrieon,6176,4,15,7,14,52,58,-6,52
Albion,6176,5,14,8,14,56,49,7,50
Brechin,6176,6,13,9,14,42,47,-5,48
Stranraer,6176,7,13,5,18,50,58,-8,44
Peterhead,6176,8,12,8,16,48,56,-8,44
Stenhousem'r,6176,9,12,5,19,47,70,-23,41
East Fife,6176,10,10,10,16,45,54,-9,40
Livingston,6177,1,20,7,9,66,46,20,67
Alloa,6177,2,20,5,11,68,43,25,65
Airdrieon,6177,3,17,8,11,68,53,15,59
Brechin,6177,4,16,6,14,52,53,-1,54
Peterhead,6177,5,14,9,13,56,58,-2,51
East Fife,6177,6,13,10,13,50,44,6,49
Queen's Park,6177,7,13,6,17,41,49,-8,45
Albion,6177,8,11,8,17,49,58,-9,41
Stranraer,6177,9,11,7,18,47,54,-7,40
Stenhousem'r,6177,10,9,6,21,47,86,-39,33
Livingston,6178,1,24,3,9,88,48,40,75
Airdrieon,6178,2,20,2,14,55,56,-1,62
Alloa,6178,3,18,7,11,74,45,29,61
Albion,6178,4,15,8,13,52,47,5,53
Queen's Park,6178,5,15,4,17,42,53,-11,49
East Fife,6178,6,13,8,15,41,38,3,47
Peterhead,6178,7,13,7,16,46,58,-12,46
Stranraer,6178,8,13,4,19,48,60,-12,43
Brechin,6178,9,11,8,17,41,49,-8,41
Stenhousem'r,6178,10,7,11,18,35,68,-33,32
Brechin,6179,1,20,6,10,68,54,14,66
Livingston,6179,2,21,2,13,79,56,23,65
Alloa,6179,3,18,8,10,69,43,26,62
Peterhead,6179,4,15,9,12,54,53,1,54
Airdrieon,6179,5,15,7,14,52,54,-2,52
Albion,6179,6,13,11,12,50,43,7,50
Queen's Park,6179,7,14,6,16,37,48,-11,48
East Fife,6179,8,11,7,18,47,51,-4,40
Stenhousem'r,6179,9,10,8,18,49,80,-31,38
Stranraer,6179,10,7,8,21,41,64,-23,29
Livingston,6180,1,22,4,10,71,42,29,70
Airdrieon,6180,2,19,8,9,64,43,21,65
Albion,6180,3,16,9,11,53,50,3,57
Alloa,6180,4,15,10,11,62,49,13,55
Brechin,6180,5,14,10,12,45,49,-4,52
Peterhead,6180,6,14,5,17,44,51,-7,47
Stranraer,6180,7,11,10,15,49,56,-7,43
East Fife,6180,8,9,12,15,42,47,-5,39
Queen's Park,6180,9,8,13,15,33,48,-15,37
Stenhousem'r,6180,10,5,13,18,41,69,-28,28
Alloa,6181,1,21,9,6,76,35,41,72
Airdrieon,6181,2,21,6,9,64,51,13,69
Livingston,6181,3,19,10,7,64,42,22,67
Brechin,6181,4,20,4,12,65,49,16,64
Albion,6181,5,13,8,15,56,60,-4,47
East Fife,6181,6,12,7,17,49,56,-7,43
Stranraer,6181,7,12,6,18,53,61,-8,42
Peterhead,6181,8,11,8,17,46,54,-8,41
Queen's Park,6181,9,7,9,20,31,61,-30,30
Stenhousem'r,6181,10,7,7,22,41,76,-35,28
Airdrieon,6182,1,19,7,10,58,44,14,64
Alloa,6182,2,17,8,11,67,44,23,59
Livingston,6182,3,18,4,14,66,53,13,58
Brechin,6182,4,18,4,14,54,48,6,58
Peterhead,6182,5,14,8,14,49,50,-1,50
Stranraer,6182,6,15,3,18,49,58,-9,48
Queen's Park,6182,7,14,4,18,37,47,-10,46
Albion,6182,8,10,13,13,49,57,-8,43
East Fife,6182,9,10,12,14,45,42,3,42
Stenhousem'r,6182,10,9,9,18,47,78,-31,36
Livingston,6183,1,22,6,8,77,42,35,72
Airdrieon,6183,2,18,8,10,67,53,14,62
Brechin,6183,3,20,2,14,59,50,9,62
Alloa,6183,4,17,8,11,64,43,21,59
Albion,6183,5,13,10,13,56,55,1,49
Stranraer,6183,6,13,8,15,53,58,-5,47
Queen's Park,6183,7,13,5,18,35,52,-17,44
Peterhead,6183,8,10,10,16,42,58,-16,40
East Fife,6183,9,9,10,17,56,62,-6,37
Stenhousem'r,6183,10,9,5,22,45,81,-36,32
Brechin,6184,1,23,4,9,61,46,15,73
Alloa,6184,2,22,5,9,80,49,31,71
Livingston,6184,3,18,8,10,70,44,26,62
Peterhead,6184,4,15,7,14,59,56,3,52
Airdrieon,6184,5,16,3,17,54,63,-9,51
Albion,6184,6,14,8,14,57,52,5,50
East Fife,6184,7,12,8,16,49,49,0,44
Queen's Park,6184,8,11,7,18,36,56,-20,40
Stranraer,6184,9,10,4,22,37,62,-25,34
Stenhousem'r,6184,10,9,6,21,46,72,-26,33
Alloa,6185,1,17,11,8,73,42,31,62
Livingston,6185,2,19,5,12,75,60,15,62
Brechin,6185,3,17,10,9,64,50,14,61
Airdrieon,6185,4,16,9,11,59,53,6,57
Albion,6185,5,15,8,13,58,55,3,53
Peterhead,6185,6,13,8,15,53,50,3,47
East Fife,6185,7,11,11,14,53,49,4,44
Stranraer,6185,8,10,11,15,49,60,-11,41
Queen's Park,6185,9,10,8,18,43,62,-19,38
Stenhousem'r,6185,10,8,7,21,40,86,-46,31
Alloa,6186,1,20,9,7,75,40,35,69
Livingston,6186,2,18,9,9,70,45,25,63
Airdrieon,6186,3,16,10,10,69,56,13,58
Brechin,6186,4,13,11,12,49,51,-2,50
Peterhead,6186,5,12,13,11,43,47,-4,49
Stranraer,6186,6,14,6,16,51,55,-4,48
Queen's Park,6186,7,12,10,14,37,46,-9,46
Albion,6186,8,11,10,15,46,55,-9,43
East Fife,6186,9,9,13,14,49,51,-2,40
Stenhousem'r,6186,10,6,7,23,40,83,-43,25
Alloa,6187,1,19,8,9,74,42,32,65
Albion,6187,2,18,7,11,64,53,11,61
Livingston,6187,3,17,8,11,76,55,21,59
Airdrieon,6187,4,15,9,12,57,53,4,54
East Fife,6187,5,13,10,13,55,45,10,49
Queen's Park,6187,6,14,6,16,38,52,-14,48
Peterhead,6187,7,11,12,13,45,55,-10,45
Stranraer,6187,8,12,7,17,45,63,-18,43
Brechin,6187,9,12,6,18,45,55,-10,42
Stenhousem'r,6187,10,6,13,17,39,65,-26,31
Brechin,6188,1,19,8,9,57,46,11,65
Alloa,6188,2,18,9,9,75,43,32,63
Airdrieon,6188,3,18,9,9,60,42,18,63
Livingston,6188,4,17,4,15,69,59,10,55
Stranraer,6188,5,13,7,16,57,58,-1,46
Albion,6188,6,12,10,14,46,55,-9,46
Peterhead,6188,7,12,7,17,37,54,-17,43
East Fife,6188,8,10,12,14,47,45,2,42
Queen's Park,6188,9,11,8,17,34,54,-20,41
Stenhousem'r,6188,10,9,8,19,44,70,-26,35
Alloa,6189,1,19,10,7,65,39,26,67
Livingston,6189,2,19,3,14,64,51,13,60
Airdrieon,6189,3,17,8,11,65,56,9,59
Brechin,6189,4,16,10,10,47,39,8,58
Peterhead,6189,5,13,8,15,45,51,-6,47
Albion,6189,6,11,11,14,51,51,0,44
Queen's Park,6189,7,11,10,15,41,54,-13,43
Stranraer,6189,8,12,6,18,45,56,-11,42
East Fife,6189,9,9,13,14,43,46,-3,40
Stenhousem'r,6189,10,8,11,17,52,75,-23,35
Livingston,6190,1,19,9,8,74,44,30,66
Alloa,6190,2,20,5,11,76,52,24,65
Airdrieon,6190,3,14,12,10,52,50,2,54
East Fife,6190,4,15,7,14,62,54,8,52
Brechin,6190,5,15,7,14,52,47,5,52
Queen's Park,6190,6,15,7,14,40,50,-10,52
Albion,6190,7,13,10,13,55,54,1,49
Peterhead,6190,8,12,7,17,47,65,-18,43
Stranraer,6190,9,10,8,18,48,59,-11,38
Stenhousem'r,6190,10,7,8,21,49,80,-31,29
Livingston,6191,1,22,5,9,71,44,27,71
Alloa,6191,2,21,7,8,79,44,35,70
Brechin,6191,3,17,5,14,63,55,8,56
Albion,6191,4,16,7,13,58,53,5,55
Airdrieon,6191,5,16,6,14,56,53,3,54
Queen's Park,6191,6,16,3,17,45,52,-7,51
Peterhead,6191,7,12,8,16,44,59,-15,44
Stranraer,6191,8,13,4,19,51,64,-13,43
East Fife,6191,9,10,7,19,45,52,-7,37
Stenhousem'r,6191,10,8,6,22,44,80,-36,30
Airdrieon,6192,1,20,7,9,66,44,22,67
Livingston,6192,2,20,3,13,76,54,22,63
Alloa,6192,3,17,11,8,64,44,20,62
Brechin,6192,4,16,9,11,52,45,7,57
Albion,6192,5,15,11,10,52,45,7,56
Stranraer,6192,6,14,5,17,55,62,-7,47
Peterhead,6192,7,11,12,13,41,52,-11,45
Queen's Park,6192,8,13,4,19,33,48,-15,43
East Fife,6192,9,7,9,20,46,63,-17,30
Stenhousem'r,6192,10,5,13,18,45,73,-28,28
Brechin,6193,1,18,7,11,65,47,18,61
Alloa,6193,2,17,8,11,59,43,16,59
Airdrieon,6193,3,16,11,9,55,45,10,59
Livingston,6193,4,17,5,14,72,52,20,56
Stranraer,6193,5,16,7,13,56,49,7,55
Albion,6193,6,14,8,14,55,65,-10,50
Queen's Park,6193,7,12,10,14,37,48,-11,46
Peterhead,6193,8,12,9,15,46,55,-9,45
East Fife,6193,9,8,14,14,48,48,0,38
Stenhousem'r,6193,10,7,7,22,40,81,-41,28
Alloa,6194,1,20,10,6,71,41,30,70
Livingston,6194,2,21,6,9,73,45,28,69
Brechin,6194,3,20,8,8,52,36,16,68
Albion,6194,4,16,7,13,58,48,10,55
Peterhead,6194,5,12,10,14,51,56,-5,46
Airdrieon,6194,6,10,11,15,52,62,-10,41
East Fife,6194,7,11,7,18,50,59,-9,40
Stranraer,6194,8,9,10,17,54,69,-15,37
Queen's Park,6194,9,10,7,19,37,52,-15,37
Stenhousem'r,6194,10,9,8,19,48,78,-30,35
Livingston,6195,1,19,5,12,78,54,24,62
Stranraer,6195,2,19,3,14,62,53,9,60
Peterhead,6195,3,16,9,11,63,45,18,57
Alloa,6195,4,16,9,11,67,51,16,57
Albion,6195,5,16,7,13,58,53,5,55
Airdrieon,6195,6,15,7,14,55,54,1,52
Brechin,6195,7,14,6,16,55,66,-11,48
Queen's Park,6195,8,12,10,14,38,55,-17,46
East Fife,6195,9,10,10,16,49,59,-10,40
Stenhousem'r,6195,10,6,8,22,55,90,-35,26
Livingston,6196,1,27,2,7,87,44,43,83
Brechin,6196,2,21,8,7,58,31,27,71
Alloa,6196,3,17,8,11,72,45,27,59
Peterhead,6196,4,17,5,14,59,60,-1,56
Stranraer,6196,5,16,6,14,57,52,5,54
Airdrieon,6196,6,13,7,16,56,61,-5,46
East Fife,6196,7,12,6,18,49,61,-12,42
Albion,6196,8,10,9,17,48,60,-12,39
Queen's Park,6196,9,9,4,23,40,75,-35,31
Stenhousem'r,6196,10,7,7,22,47,84,-37,28
Livingston,6197,1,22,6,8,76,40,36,72
Alloa,6197,2,19,8,9,64,41,23,65
Brechin,6197,3,19,5,12,56,45,11,62
Albion,6197,4,14,10,12,62,56,6,52
Airdrieon,6197,5,15,6,15,49,61,-12,51
Peterhead,6197,6,14,6,16,51,61,-10,48
Stranraer,6197,7,13,5,18,53,53,0,44
Queen's Park,6197,8,12,7,17,39,57,-18,43
East Fife,6197,9,10,10,16,47,50,-3,40
Stenhousem'r,6197,10,6,9,21,44,77,-33,27
Livingston,6198,1,20,9,7,77,43,34,69
Alloa,6198,2,19,7,10,67,45,22,64
Albion,6198,3,15,11,10,64,57,7,56
Brechin,6198,4,16,7,13,51,50,1,55
Airdrieon,6198,5,16,6,14,61,64,-3,54
East Fife,6198,6,14,10,12,58,48,10,52
Peterhead,6198,7,13,8,15,52,53,-1,47
Stranraer,6198,8,11,6,19,56,68,-12,39
Stenhousem'r,6198,9,9,7,20,49,83,-34,34
Queen's Park,6198,10,7,9,20,38,62,-24,30
Livingston,6199,1,23,1,12,78,52,26,70
Airdrieon,6199,2,20,6,10,72,55,17,66
Alloa,6199,3,18,10,8,68,48,20,64
Brechin,6199,4,19,6,11,61,48,13,63
East Fife,6199,5,14,7,15,47,40,7,49
Albion,6199,6,13,8,15,53,55,-2,47
Queen's Park,6199,7,11,7,18,34,59,-25,40
Stranraer,6199,8,12,3,21,50,64,-14,39
Peterhead,6199,9,11,6,19,43,58,-15,39
Stenhousem'r,6199,10,8,8,20,39,66,-27,32
Livingston,6200,1,21,9,6,85,49,36,72
Airdrieon,6200,2,20,7,9,62,44,18,67
Albion,6200,3,16,10,10,61,46,15,58
Alloa,6200,4,16,9,11,67,52,15,57
East Fife,6200,5,14,9,13,48,46,2,51
Brechin,6200,6,15,6,15,51,52,-1,51
Stranraer,6200,7,13,5,18,53,62,-9,44
Queen's Park,6200,8,11,9,16,38,54,-16,42
Peterhead,6200,9,9,9,18,39,61,-22,36
Stenhousem'r,6200,10,5,7,24,47,85,-38,22
Livingston,6201,1,22,3,11,75,44,31,69
Alloa,6201,2,19,7,10,71,44,27,64
Airdrieon,6201,3,18,6,12,58,44,14,60
Brechin,6201,4,17,4,15,51,42,9,55
Albion,6201,5,16,7,13,55,49,6,55
Peterhead,6201,6,15,7,14,51,46,5,52
East Fife,6201,7,11,11,14,51,51,0,44
Stranraer,6201,8,12,5,19,47,65,-18,41
Queen's Park,6201,9,10,9,17,29,49,-20,39
Stenhousem'r,6201,10,6,9,21,38,92,-54,27
Livingston,6202,1,21,4,11,86,57,29,67
Airdrieon,6202,2,19,6,11,65,48,17,63
Peterhead,6202,3,18,6,12,60,52,8,60
Brechin,6202,4,18,6,12,58,52,6,60
Alloa,6202,5,16,11,9,68,44,24,59
Albion,6202,6,14,8,14,54,51,3,50
Stranraer,6202,7,12,10,14,54,59,-5,46
Queen's Park,6202,8,11,8,17,35,56,-21,41
East Fife,6202,9,7,10,19,46,66,-20,31
Stenhousem'r,6202,10,6,7,23,46,87,-41,25
Livingston,6203,1,18,7,11,75,52,23,61
Brechin,6203,2,18,6,12,47,39,8,60
East Fife,6203,3,15,9,12,53,41,12,54
Albion,6203,4,15,9,12,53,50,3,54
Airdrieon,6203,5,16,5,15,53,57,-4,53
Peterhead,6203,6,15,7,14,47,45,2,52
Alloa,6203,7,14,8,14,54,44,10,50
Queen's Park,6203,8,13,8,15,35,42,-7,47
Stranraer,6203,9,12,3,21,39,59,-20,39
Stenhousem'r,6203,10,9,8,19,44,71,-27,35
Livingston,6204,1,19,6,11,74,50,24,63
Alloa,6204,2,18,8,10,59,36,23,62
Brechin,6204,3,19,5,12,46,45,1,62
Queen's Park,6204,4,15,7,14,43,42,1,52
Airdrieon,6204,5,14,8,14,62,60,2,50
East Fife,6204,6,13,9,14,60,54,6,48
Albion,6204,7,13,9,14,49,53,-4,48
Peterhead,6204,8,13,9,14,49,55,-6,48
Stranraer,6204,9,13,4,19,46,57,-11,43
Stenhousem'r,6204,10,8,5,23,47,83,-36,29
Livingston,6205,1,21,3,12,74,53,21,66
Alloa,6205,2,19,7,10,68,46,22,64
Brechin,6205,3,18,7,11,51,38,13,61
Stranraer,6205,4,16,6,14,51,47,4,54
Albion,6205,5,15,6,15,54,54,0,51
Airdrieon,6205,6,14,6,16,60,60,0,48
Queen's Park,6205,7,13,6,17,32,49,-17,45
East Fife,6205,8,12,6,18,55,57,-2,42
Peterhead,6205,9,12,5,19,46,64,-18,41
Stenhousem'r,6205,10,10,8,18,49,72,-23,38
Alloa,6206,1,20,8,8,79,45,34,68
Livingston,6206,2,20,7,9,73,49,24,67
Airdrieon,6206,3,17,7,12,59,52,7,58
Brechin,6206,4,16,6,14,53,54,-1,54
Queen's Park,6206,5,14,8,14,47,54,-7,50
Albion,6206,6,11,12,13,55,54,1,45
East Fife,6206,7,11,11,14,49,50,-1,44
Peterhead,6206,8,10,10,16,43,52,-9,40
Stenhousem'r,6206,9,10,7,19,41,74,-33,37
Stranraer,6206,10,9,8,19,48,63,-15,35
Livingston,6207,1,22,6,8,74,43,31,72
Alloa,6207,2,21,8,7,74,42,32,71
Queen's Park,6207,3,16,6,14,51,50,1,54
Brechin,6207,4,16,5,15,51,50,1,53
Airdrieon,6207,5,15,7,14,56,55,1,52
Stranraer,6207,6,16,4,16,65,66,-1,52
Peterhead,6207,7,15,7,14,54,55,-1,52
Albion,6207,8,11,6,19,44,59,-15,39
East Fife,6207,9,10,8,18,45,53,-8,38
Stenhousem'r,6207,10,5,9,22,49,90,-41,24
Livingston,6208,1,20,7,9,77,51,26,67
Alloa,6208,2,18,10,8,70,42,28,64
Airdrieon,6208,3,18,5,13,62,52,10,59
Albion,6208,4,14,10,12,55,55,0,52
East Fife,6208,5,12,12,12,48,51,-3,48
Brechin,6208,6,13,7,16,45,47,-2,46
Stranraer,6208,7,12,8,16,49,57,-8,44
Queen's Park,6208,8,12,6,18,40,51,-11,42
Peterhead,6208,9,12,6,18,39,57,-18,42
Stenhousem'r,6208,10,9,9,18,50,72,-22,36
Alloa,6209,1,20,6,10,73,43,30,66
Livingston,6209,2,19,8,9,76,48,28,65
Peterhead,6209,3,18,7,11,64,51,13,61
Brechin,6209,4,16,6,14,58,53,5,54
Airdrieon,6209,5,16,5,15,59,61,-2,53
East Fife,6209,6,15,6,15,49,48,1,51
Queen's Park,6209,7,13,10,13,44,46,-2,49
Albion,6209,8,13,9,14,55,54,1,48
Stranraer,6209,9,12,5,19,50,67,-17,41
Stenhousem'r,6209,10,3,8,25,32,89,-57,17
Alloa,6210,1,20,7,9,74,45,29,67
Livingston,6210,2,19,5,12,69,51,18,62
Albion,6210,3,16,9,11,51,41,10,57
Airdrieon,6210,4,15,7,14,60,58,2,52
Brechin,6210,5,16,4,16,50,49,1,52
East Fife,6210,6,14,7,15,51,51,0,49
Queen's Park,6210,7,14,7,15,40,50,-10,49
Peterhead,6210,8,11,11,14,41,47,-6,44
Stranraer,6210,9,12,6,18,45,57,-12,42
Stenhousem'r,6210,10,9,5,22,49,81,-32,32
Alloa,6211,1,23,6,7,80,40,40,75
Livingston,6211,2,19,7,10,67,44,23,64
Airdrieon,6211,3,17,7,12,58,47,11,58
Brechin,6211,4,16,9,11,50,46,4,57
Albion,6211,5,13,10,13,54,59,-5,49
Queen's Park,6211,6,15,2,19,41,53,-12,47
Peterhead,6211,7,13,6,17,45,54,-9,45
East Fife,6211,8,10,10,16,46,55,-9,40
Stenhousem'r,6211,9,9,8,19,48,74,-26,35
Stranraer,6211,10,9,7,20,47,64,-17,34
Livingston,6212,1,22,4,10,81,45,36,70
Alloa,6212,2,19,6,11,70,52,18,63
Peterhead,6212,3,16,7,13,59,56,3,55
Airdrieon,6212,4,16,6,14,62,64,-2,54
Brechin,6212,5,17,2,17,57,55,2,53
East Fife,6212,6,14,8,14,49,42,7,50
Queen's Park,6212,7,14,6,16,51,54,-3,48
Albion,6212,8,13,9,14,49,52,-3,48
Stranraer,6212,9,11,4,21,48,64,-16,37
Stenhousem'r,6212,10,8,8,20,57,99,-42,32
Alloa,6213,1,18,9,9,65,38,27,63
Brechin,6213,2,18,7,11,51,49,2,61
Airdrieon,6213,3,18,5,13,57,56,1,59
Peterhead,6213,4,17,6,13,57,48,9,57
Livingston,6213,5,16,6,14,75,61,14,54
Albion,6213,6,13,11,12,54,52,2,50
East Fife,6213,7,13,10,13,54,44,10,49
Queen's Park,6213,8,12,10,14,47,57,-10,46
Stranraer,6213,9,8,9,19,50,66,-16,33
Stenhousem'r,6213,10,7,7,22,47,86,-39,28
Alloa,6214,1,23,5,8,76,42,34,74
Brechin,6214,2,21,6,9,62,41,21,69
Airdrieon,6214,3,17,6,13,63,62,1,57
Livingston,6214,4,16,3,17,63,52,11,51
Peterhead,6214,5,14,7,15,49,50,-1,49
Albion,6214,6,14,5,17,52,57,-5,47
Stranraer,6214,7,14,3,19,50,61,-11,45
East Fife,6214,8,11,9,16,47,47,0,42
Queen's Park,6214,9,12,4,20,34,56,-22,40
Stenhousem'r,6214,10,10,8,18,44,72,-28,38
Livingston,6215,1,19,3,14,84,54,30,60
Airdrieon,6215,2,17,9,10,58,52,6,60
Alloa,6215,3,16,10,10,66,43,23,58
Brechin,6215,4,17,5,14,50,55,-5,56
Queen's Park,6215,5,16,6,14,53,50,3,54
Albion,6215,6,15,8,13,59,55,4,53
East Fife,6215,7,13,10,13,61,53,8,49
Stranraer,6215,8,11,10,15,46,54,-8,43
Peterhead,6215,9,12,7,17,44,55,-11,43
Stenhousem'r,6215,10,7,6,23,42,92,-50,27
Airdrieon,6216,1,21,6,9,62,46,16,69
Alloa,6216,2,18,10,8,65,37,28,64
Livingston,6216,3,19,4,13,80,49,31,61
Brechin,6216,4,16,8,12,50,45,5,56
Albion,6216,5,15,9,12,55,51,4,54
Stranraer,6216,6,13,7,16,53,61,-8,46
Peterhead,6216,7,11,12,13,48,48,0,45
East Fife,6216,8,10,13,13,47,47,0,43
Queen's Park,6216,9,9,9,18,30,60,-30,36
Stenhousem'r,6216,10,6,6,24,38,84,-46,24
Airdrieon,6217,1,20,6,10,65,46,19,66
Livingston,6217,2,17,6,13,68,51,17,57
Brechin,6217,3,16,8,12,51,45,6,56
Alloa,6217,4,16,7,13,65,53,12,55
East Fife,6217,5,13,10,13,52,48,4,49
Peterhead,6217,6,14,7,15,49,61,-12,49
Albion,6217,7,13,8,15,58,51,7,47
Stranraer,6217,8,13,7,16,57,56,1,46
Queen's Park,6217,9,13,7,16,40,54,-14,46
Stenhousem'r,6217,10,7,10,19,42,82,-40,31
Livingston,6218,1,21,7,8,73,47,26,70
Airdrieon,6218,2,19,7,10,64,46,18,64
Alloa,6218,3,16,11,9,73,44,29,59
Brechin,6218,4,16,8,12,52,42,10,56
East Fife,6218,5,12,12,12,53,51,2,48
Albion,6218,6,12,9,15,52,54,-2,45
Peterhead,6218,7,12,9,15,50,64,-14,45
Stenhousem'r,6218,8,9,10,17,53,74,-21,37
Queen's Park,6218,9,8,13,15,34,58,-24,37
Stranraer,6218,10,9,6,21,39,63,-24,33
Livingston,6219,1,24,5,7,80,41,39,77
Alloa,6219,2,18,9,9,64,39,25,63
Brechin,6219,3,18,6,12,54,51,3,60
Airdrieon,6219,4,16,6,14,53,54,-1,54
Stranraer,6219,5,13,9,14,48,52,-4,48
East Fife,6219,6,13,8,15,50,45,5,47
Albion,6219,7,13,8,15,55,55,0,47
Queen's Park,6219,8,10,8,18,38,62,-24,38
Peterhead,6219,9,9,9,18,35,49,-14,36
Stenhousem'r,6219,10,9,6,21,44,73,-29,33
Alloa,6220,1,23,7,6,68,35,33,76
Livingston,6220,2,21,8,7,71,39,32,71
Brechin,6220,3,15,10,11,49,41,8,55
Peterhead,6220,4,15,7,14,54,51,3,52
Airdrieon,6220,5,15,5,16,59,64,-5,50
Queen's Park,6220,6,15,4,17,38,48,-10,49
Stranraer,6220,7,13,7,16,51,55,-4,46
Albion,6220,8,11,9,16,49,55,-6,42
East Fife,6220,9,9,8,19,42,59,-17,35
Stenhousem'r,6220,10,7,7,22,33,67,-34,28
Livingston,6221,1,22,3,11,73,46,27,69
Brechin,6221,2,21,4,11,55,45,10,67
Alloa,6221,3,20,5,11,68,41,27,65
Airdrieon,6221,4,19,7,10,72,54,18,64
Peterhead,6221,5,14,6,16,56,65,-9,48
East Fife,6221,6,13,7,16,56,53,3,46
Stranraer,6221,7,14,4,18,51,64,-13,46
Albion,6221,8,11,5,20,47,59,-12,38
Queen's Park,6221,9,10,8,18,40,57,-17,38
Stenhousem'r,6221,10,9,5,22,55,89,-34,32
Livingston,6222,1,21,6,9,76,47,29,69
Alloa,6222,2,16,7,13,69,53,16,55
Airdrieon,6222,3,14,9,13,49,52,-3,51
Albion,6222,4,14,8,14,49,47,2,50
Brechin,6222,5,15,5,16,60,61,-1,50
Stranraer,6222,6,15,5,16,53,57,-4,50
Peterhead,6222,7,14,7,15,54,56,-2,49
Queen's Park,6222,8,12,9,15,36,47,-11,45
Stenhousem'r,6222,9,12,8,16,49,64,-15,44
East Fife,6222,10,10,10,16,46,57,-11,40
Livingston,6223,1,20,1,15,72,54,18,61
Peterhead,6223,2,17,8,11,54,47,7,59
Alloa,6223,3,18,4,14,68,48,20,58
Airdrieon,6223,4,16,7,13,48,45,3,55
Brechin,6223,5,15,10,11,51,49,2,55
Stranraer,6223,6,15,5,16,59,56,3,50
Albion,6223,7,14,7,15,52,53,-1,49
Queen's Park,6223,8,13,8,15,38,52,-14,47
East Fife,6223,9,12,9,15,45,45,0,45
Stenhousem'r,6223,10,7,7,22,36,74,-38,28
Livingston,6224,1,22,5,9,84,45,39,71
Brechin,6224,2,19,5,12,49,48,1,62
Alloa,6224,3,18,5,13,67,56,11,59
Airdrieon,6224,4,18,5,13,63,52,11,59
Albion,6224,5,17,7,12,58,46,12,58
Stranraer,6224,6,14,5,17,61,60,1,47
Peterhead,6224,7,12,5,19,49,55,-6,41
East Fife,6224,8,10,10,16,42,50,-8,40
Queen's Park,6224,9,10,9,17,35,61,-26,39
Stenhousem'r,6224,10,7,10,19,37,72,-35,31
Livingston,6225,1,21,6,9,78,55,23,69
Alloa,6225,2,20,7,9,77,49,28,67
Airdrieon,6225,3,19,6,11,59,49,10,63
Brechin,6225,4,16,7,13,55,57,-2,55
Peterhead,6225,5,15,6,15,52,44,8,51
East Fife,6225,6,14,7,15,55,56,-1,49
Albion,6225,7,11,10,15,57,63,-6,43
Stranraer,6225,8,11,6,19,51,62,-11,39
Stenhousem'r,6225,9,9,9,18,52,75,-23,36
Queen's Park,6225,10,8,8,20,32,58,-26,32
Livingston,6226,1,21,5,10,73,48,25,68
Airdrieon,6226,2,21,4,11,57,47,10,67
Alloa,6226,3,18,9,9,61,38,23,63
Stranraer,6226,4,17,4,15,54,48,6,55
Albion,6226,5,15,7,14,49,48,1,52
Peterhead,6226,6,15,5,16,50,49,1,50
Brechin,6226,7,15,5,16,46,48,-2,50
Queen's Park,6226,8,11,8,17,36,52,-16,41
East Fife,6226,9,9,7,20,40,49,-9,34
Stenhousem'r,6226,10,8,6,22,37,76,-39,30
Alloa,6227,1,19,6,11,73,44,29,63
Brechin,6227,2,18,9,9,54,43,11,63
Albion,6227,3,18,6,12,65,46,19,60
Livingston,6227,4,18,6,12,67,55,12,60
Airdrieon,6227,5,14,9,13,57,58,-1,51
Peterhead,6227,6,14,9,13,40,45,-5,51
Queen's Park,6227,7,13,5,18,36,52,-16,44
Stenhousem'r,6227,8,12,5,19,44,65,-21,41
East Fife,6227,9,10,7,19,51,63,-12,37
Stranraer,6227,10,11,4,21,47,63,-16,37
Livingston,6228,1,24,4,8,74,39,35,76
Airdrieon,6228,2,19,6,11,66,47,19,63
Alloa,6228,3,19,5,12,75,47,28,62
Albion,6228,4,14,11,11,53,46,7,53
Stranraer,6228,5,16,5,15,58,55,3,53
Brechin,6228,6,16,5,15,51,58,-7,53
Peterhead,6228,7,12,7,17,45,58,-13,43
Queen's Park,6228,8,12,7,17,35,53,-18,43
East Fife,6228,9,10,8,18,46,57,-11,38
Stenhousem'r,6228,10,6,6,24,41,84,-43,24
Livingston,6229,1,22,7,7,81,41,40,73
Alloa,6229,2,20,9,7,69,42,27,69
Airdrieon,6229,3,20,9,7,64,41,23,69
Brechin,6229,4,19,4,13,54,43,11,61
Peterhead,6229,5,16,6,14,50,51,-1,54
East Fife,6229,6,11,8,17,56,55,1,41
Stranraer,6229,7,12,5,19,41,53,-12,41
Queen's Park,6229,8,11,5,20,32,49,-17,38
Albion,6229,9,11,5,20,33,59,-26,38
Stenhousem'r,6229,10,7,4,25,45,91,-46,25
Alloa,6230,1,23,7,6,77,37,40,76
Livingston,6230,2,20,8,8,78,50,28,68
Airdrieon,6230,3,20,4,12,63,47,16,64
Brechin,6230,4,17,7,12,55,50,5,58
Stranraer,6230,5,13,5,18,51,59,-8,44
East Fife,6230,6,10,11,15,46,49,-3,41
Queen's Park,6230,7,11,8,17,44,60,-16,41
Albion,6230,8,9,12,15,43,56,-13,39
Peterhead,6230,9,11,4,21,42,63,-21,37
Stenhousem'r,6230,10,9,8,19,57,85,-28,35
Alloa,6231,1,21,8,7,77,40,37,71
Airdrieon,6231,2,19,7,10,71,52,19,64
Livingston,6231,3,19,5,12,75,57,18,62
Brechin,6231,4,16,8,12,54,45,9,56
East Fife,6231,5,12,11,13,50,47,3,47
Albion,6231,6,12,11,13,48,56,-8,47
Peterhead,6231,7,11,11,14,55,56,-1,44
Queen's Park,6231,8,12,7,17,38,57,-19,43
Stranraer,6231,9,10,5,21,43,63,-20,35
Stenhousem'r,6231,10,7,9,20,38,76,-38,30
Livingston,6232,1,25,4,7,78,36,42,79
Airdrieon,6232,2,19,8,9,60,42,18,65
Brechin,6232,3,16,8,12,46,39,7,56
Queen's Park,6232,4,15,7,14,41,48,-7,52
Alloa,6232,5,13,11,12,60,46,14,50
Peterhead,6232,6,12,9,15,49,57,-8,45
Albion,6232,7,12,7,17,45,50,-5,43
Stranraer,6232,8,12,6,18,46,61,-15,42
East Fife,6232,9,10,8,18,43,53,-10,38
Stenhousem'r,6232,10,9,6,21,39,75,-36,33
Livingston,6233,1,22,4,10,77,47,30,70
Alloa,6233,2,17,12,7,68,39,29,63
Albion,6233,3,17,6,13,55,53,2,57
Brechin,6233,4,16,7,13,53,51,2,55
Queen's Park,6233,5,16,5,15,47,49,-2,53
Peterhead,6233,6,14,10,12,49,53,-4,52
Airdrieon,6233,7,14,6,16,62,66,-4,48
Stenhousem'r,6233,8,9,9,18,61,85,-24,36
Stranraer,6233,9,10,5,21,44,63,-19,35
East Fife,6233,10,7,12,17,37,47,-10,33
Livingston,6234,1,22,5,9,65,41,24,71
Airdrieon,6234,2,19,8,9,63,46,17,65
Alloa,6234,3,16,8,12,72,48,24,56
Brechin,6234,4,17,4,15,42,46,-4,55
Peterhead,6234,5,14,8,14,51,48,3,50
Albion,6234,6,12,9,15,52,54,-2,45
East Fife,6234,7,11,10,15,44,42,2,43
Queen's Park,6234,8,11,9,16,33,48,-15,42
Stranraer,6234,9,10,8,18,45,69,-24,38
Stenhousem'r,6234,10,10,7,19,52,77,-25,37
Livingston,6235,1,28,1,7,87,45,42,85
Alloa,6235,2,20,7,9,74,53,21,67
Albion,6235,3,16,7,13,59,53,6,55
Brechin,6235,4,16,7,13,50,45,5,55
Airdrieon,6235,5,15,8,13,63,67,-4,53
Peterhead,6235,6,13,6,17,53,62,-9,45
East Fife,6235,7,10,10,16,54,60,-6,40
Queen's Park,6235,8,9,10,17,27,46,-19,37
Stranraer,6235,9,9,7,20,45,60,-15,34
Stenhousem'r,6235,10,8,9,19,55,76,-21,33
Livingston,6236,1,20,4,12,70,46,24,64
Alloa,6236,2,19,6,11,77,43,34,63
Peterhead,6236,3,17,9,10,53,47,6,60
Brechin,6236,4,16,8,12,46,45,1,56
Airdrieon,6236,5,15,9,12,61,56,5,54
Albion,6236,6,11,14,11,50,49,1,47
East Fife,6236,7,11,10,15,48,51,-3,43
Queen's Park,6236,8,11,8,17,37,61,-24,41
Stranraer,6236,9,10,8,18,49,57,-8,38
Stenhousem'r,6236,10,7,10,19,53,89,-36,31
Livingston,6237,1,20,6,10,64,35,29,66
Airdrieon,6237,2,21,3,12,62,51,11,66
Peterhead,6237,3,18,6,12,61,47,14,60
Albion,6237,4,16,9,11,55,42,13,57
Alloa,6237,5,16,8,12,66,54,12,56
Brechin,6237,6,16,6,14,47,44,3,54
Stranraer,6237,7,12,7,17,52,60,-8,43
Queen's Park,6237,8,12,6,18,31,54,-23,42
East Fife,6237,9,9,8,19,44,56,-12,35
Stenhousem'r,6237,10,7,7,22,41,80,-39,28
Livingston,6238,1,20,5,11,65,46,19,65
Alloa,6238,2,18,8,10,75,57,18,62
Airdrieon,6238,3,18,7,11,67,54,13,61
Brechin,6238,4,18,4,14,54,52,2,58
Albion,6238,5,15,9,12,50,51,-1,54
Queen's Park,6238,6,14,5,17,38,50,-12,47
Peterhead,6238,7,12,9,15,51,59,-8,45
Stranraer,6238,8,13,5,18,60,68,-8,44
East Fife,6238,9,10,6,20,54,54,0,36
Stenhousem'r,6238,10,9,8,19,52,75,-23,35
Livingston,6239,1,18,7,11,70,56,14,61
Alloa,6239,2,16,10,10,65,43,22,58
Airdrieon,6239,3,16,7,13,59,56,3,55
Brechin,6239,4,16,7,13,41,38,3,55
Albion,6239,5,15,8,13,55,51,4,53
East Fife,6239,6,13,11,12,50,45,5,50
Peterhead,6239,7,13,10,13,53,55,-2,49
Stranraer,6239,8,11,10,15,49,52,-3,43
Queen's Park,6239,9,11,9,16,36,53,-17,42
Stenhousem'r,6239,10,8,7,21,43,72,-29,31
Livingston,6240,1,24,3,9,87,50,37,75
Alloa,6240,2,15,9,12,62,51,11,54
Queen's Park,6240,3,14,11,11,39,39,0,53
Airdrieon,6240,4,14,10,12,64,53,11,52
Peterhead,6240,5,14,9,13,51,51,0,51
Albion,6240,6,12,12,12,49,51,-2,48
Brechin,6240,7,12,12,12,44,46,-2,48
Stranraer,6240,8,12,9,15,52,60,-8,45
East Fife,6240,9,9,11,16,52,59,-7,38
Stenhousem'r,6240,10,6,10,20,48,88,-40,28
Alloa,6241,1,22,7,7,76,44,32,73
Livingston,6241,2,20,5,11,72,49,23,65
Airdrieon,6241,3,19,3,14,57,49,8,60
Albion,6241,4,17,7,12,56,48,8,58
Brechin,6241,5,16,9,11,48,48,0,57
East Fife,6241,6,13,10,13,45,39,6,49
Stranraer,6241,7,13,3,20,54,64,-10,42
Peterhead,6241,8,10,9,17,45,54,-9,39
Queen's Park,6241,9,10,8,18,31,48,-17,38
Stenhousem'r,6241,10,5,9,22,46,87,-41,24
Brechin,6242,1,20,4,12,52,41,11,64
Alloa,6242,2,18,9,9,70,44,26,63
Livingston,6242,3,19,6,11,72,49,23,63
Airdrieon,6242,4,15,8,13,51,57,-6,53
Albion,6242,5,12,9,15,46,47,-1,45
Stranraer,6242,6,12,8,16,50,53,-3,44
Queen's Park,6242,7,12,7,17,35,49,-14,43
Stenhousem'r,6242,8,11,10,15,52,72,-20,43
Peterhead,6242,9,9,13,14,49,61,-12,40
East Fife,6242,10,8,14,14,47,51,-4,38
Livingston,6243,1,24,3,9,77,39,38,75
Alloa,6243,2,20,9,7,73,47,26,69
Brechin,6243,3,19,4,13,58,46,12,61
Stranraer,6243,4,16,3,17,62,64,-2,51
Airdrieon,6243,5,15,6,15,58,64,-6,51
Albion,6243,6,11,11,14,57,58,-1,44
East Fife,6243,7,11,11,14,45,49,-4,44
Peterhead,6243,8,11,9,16,46,51,-5,42
Queen's Park,6243,9,11,7,18,32,61,-29,40
Stenhousem'r,6243,10,8,5,23,47,76,-29,29
Livingston,6244,1,23,8,5,86,48,38,77
Alloa,6244,2,18,6,12,66,50,16,60
Peterhead,6244,3,16,8,12,57,48,9,56
Albion,6244,4,16,6,14,59,57,2,54
East Fife,6244,5,14,8,14,49,48,1,50
Brechin,6244,6,14,6,16,49,54,-5,48
Airdrieon,6244,7,13,8,15,48,55,-7,47
Queen's Park,6244,8,13,7,16,43,52,-9,46
Stranraer,6244,9,12,5,19,55,66,-11,41
Stenhousem'r,6244,10,6,8,22,41,75,-34,26
Livingston,6245,1,21,6,9,79,47,32,69
Brechin,6245,2,20,7,9,66,46,20,67
Alloa,6245,3,18,8,10,70,52,18,62
Stranraer,6245,4,16,2,18,50,61,-11,50
Albion,6245,5,13,10,13,49,48,1,49
Airdrieon,6245,6,14,4,18,62,68,-6,46
Queen's Park,6245,7,14,4,18,48,66,-18,46
East Fife,6245,8,10,12,14,49,44,5,42
Peterhead,6245,9,12,6,18,47,59,-12,42
Stenhousem'r,6245,10,8,9,19,42,71,-29,33
Alloa,6246,1,18,7,11,66,43,23,61
Livingston,6246,2,19,3,14,74,55,19,60
Albion,6246,3,17,6,13,52,44,8,57
Airdrieon,6246,4,16,8,12,61,54,7,56
Stranraer,6246,5,16,7,13,58,55,3,55
Brechin,6246,6,16,6,14,50,49,1,54
Peterhead,6246,7,13,8,15,47,53,-6,47
Queen's Park,6246,8,13,8,15,33,52,-19,47
East Fife,6246,9,11,8,17,45,52,-7,41
Stenhousem'r,6246,10,6,9,21,45,74,-29,27
Brechin,6247,1,20,6,10,61,45,16,66
Alloa,6247,2,19,6,11,70,44,26,63
Livingston,6247,3,19,5,12,80,53,27,62
Airdrieon,6247,4,18,6,12,62,50,12,60
Albion,6247,5,15,8,13,49,49,0,53
Peterhead,6247,6,14,7,15,47,53,-6,49
Stranraer,6247,7,13,7,16,53,59,-6,46
East Fife,6247,8,11,8,17,54,58,-4,41
Queen's Park,6247,9,8,9,19,36,68,-32,33
Stenhousem'r,6247,10,6,12,18,49,82,-33,30
Alloa,6248,1,21,7,8,77,42,35,70
Brechin,6248,2,21,6,9,62,37,25,69
Livingston,6248,3,21,5,10,83,52,31,68
Airdrieon,6248,4,18,8,10,66,57,9,62
Albion,6248,5,14,6,16,57,60,-3,48
Peterhead,6248,6,12,9,15,47,54,-7,45
Stranraer,6248,7,13,4,19,57,72,-15,43
Queen's Park,6248,8,11,6,19,39,55,-16,39
East Fife,6248,9,10,7,19,43,59,-16,37
Stenhousem'r,6248,10,6,8,22,43,86,-43,26
Livingston,6249,1,19,6,11,62,45,17,63
Albion,6249,2,19,6,11,61,46,15,63
Airdrieon,6249,3,16,11,9,62,52,10,59
Peterhead,6249,4,16,9,11,70,56,14,57
Brechin,6249,5,16,8,12,51,40,11,56
Alloa,6249,6,13,9,14,60,61,-1,48
Queen's Park,6249,7,14,6,16,43,53,-10,48
Stranraer,6249,8,11,6,19,46,65,-19,39
East Fife,6249,9,8,11,17,38,48,-10,35
Stenhousem'r,6249,10,8,8,20,44,71,-27,32
Alloa,6250,1,18,6,12,69,47,22,60
Brechin,6250,2,17,9,10,57,46,11,60
Livingston,6250,3,18,5,13,66,53,13,59
Airdrieon,6250,4,15,10,11,64,51,13,55
Albion,6250,5,16,7,13,58,58,0,55
East Fife,6250,6,14,9,13,51,49,2,51
Queen's Park,6250,7,14,6,16,42,43,-1,48
Stranraer,6250,8,14,6,16,49,56,-7,48
Peterhead,6250,9,12,8,16,50,55,-5,44
Stenhousem'r,6250,10,4,10,22,43,91,-48,22
Peterhead,6251,1,20,6,10,64,46,18,66
Alloa,6251,2,19,6,11,75,51,24,63
Airdrieon,6251,3,17,8,11,60,51,9,59
Livingston,6251,4,18,4,14,67,45,22,58
East Fife,6251,5,16,6,14,59,45,14,54
Brechin,6251,6,15,5,16,46,54,-8,50
Queen's Park,6251,7,15,4,17,41,52,-11,49
Stranraer,6251,8,14,2,20,58,61,-3,44
Albion,6251,9,12,8,16,51,60,-9,44
Stenhousem'r,6251,10,7,5,24,37,93,-56,26
Livingston,6252,1,20,3,13,77,44,33,63
Airdrieon,6252,2,17,9,10,75,57,18,60
Alloa,6252,3,16,9,11,77,51,26,57
Queen's Park,6252,4,18,3,15,46,49,-3,57
Albion,6252,5,15,8,13,54,53,1,53
East Fife,6252,6,15,7,14,57,53,4,52
Brechin,6252,7,15,4,17,51,63,-12,49
Stranraer,6252,8,13,5,18,51,68,-17,44
Peterhead,6252,9,12,6,18,53,60,-7,42
Stenhousem'r,6252,10,9,6,21,44,87,-43,33
Livingston,6253,1,21,5,10,84,49,35,68
Alloa,6253,2,18,12,6,70,38,32,66
Airdrieon,6253,3,17,7,12,63,61,2,58
Brechin,6253,4,16,7,13,50,50,0,55
East Fife,6253,5,13,10,13,57,49,8,49
Peterhead,6253,6,14,7,15,49,51,-2,49
Albion,6253,7,11,12,13,54,55,-1,45
Queen's Park,6253,8,12,7,17,38,60,-22,43
Stranraer,6253,9,12,6,18,48,64,-16,42
Stenhousem'r,6253,10,6,7,23,49,85,-36,25
Alloa,6254,1,22,8,6,75,38,37,74
Livingston,6254,2,23,1,12,83,53,30,70
Airdrieon,6254,3,16,6,14,65,65,0,54
Stranraer,6254,4,16,5,15,59,57,2,53
Peterhead,6254,5,14,7,15,57,58,-1,49
Albion,6254,6,13,8,15,60,54,6,47
East Fife,6254,7,11,11,14,48,48,0,44
Queen's Park,6254,8,13,4,19,29,48,-19,43
Brechin,6254,9,12,6,18,39,61,-22,42
Stenhousem'r,6254,10,9,6,21,43,76,-33,33
Alloa,6255,1,20,8,8,73,40,33,68
Livingston,6255,2,19,5,12,72,45,27,62
Airdrieon,6255,3,17,6,13,60,51,9,57
Stranraer,6255,4,16,5,15,51,48,3,53
Brechin,6255,5,14,8,14,49,50,-1,50
Albion,6255,6,14,8,14,51,54,-3,50
Peterhead,6255,7,12,11,13,39,46,-7,47
Queen's Park,6255,8,12,9,15,31,43,-12,45
Stenhousem'r,6255,9,10,7,19,52,85,-33,37
East Fife,6255,10,8,9,19,39,55,-16,33
Alloa,6256,1,20,10,6,73,39,34,70
Airdrieon,6256,2,20,6,10,61,53,8,66
Livingston,6256,3,18,8,10,74,43,31,62
Peterhead,6256,4,14,11,11,53,45,8,53
Brechin,6256,5,15,7,14,48,51,-3,52
Queen's Park,6256,6,15,4,17,43,61,-18,49
Albion,6256,7,12,10,14,58,59,-1,46
Stenhousem'r,6256,8,10,6,20,47,71,-24,36
Stranraer,6256,9,8,10,18,41,63,-22,34
East Fife,6256,10,7,10,19,47,60,-13,31
Alloa,6257,1,22,7,7,78,40,38,73
Livingston,6257,2,19,4,13,75,52,23,61
Albion,6257,3,16,8,12,52,46,6,56
Airdrieon,6257,4,14,7,15,56,55,1,49
Peterhead,6257,5,12,13,11,46,54,-8,49
Brechin,6257,6,14,6,16,46,52,-6,48
East Fife,6257,7,12,9,15,51,51,0,45
Queen's Park,6257,8,12,8,16,42,50,-8,44
Stranraer,6257,9,12,7,17,49,62,-13,43
Stenhousem'r,6257,10,8,9,19,44,77,-33,33
Livingston,6258,1,18,5,13,72,50,22,59
Alloa,6258,2,16,10,10,63,47,16,58
Queen's Park,6258,3,15,7,14,47,47,0,52
Brechin,6258,4,16,4,16,52,62,-10,52
Peterhead,6258,5,14,9,13,58,51,7,51
Airdrieon,6258,6,14,8,14,55,57,-2,50
Albion,6258,7,14,7,15,51,56,-5,49
East Fife,6258,8,13,9,14,47,42,5,48
Stranraer,6258,9,12,10,14,60,61,-1,46
Stenhousem'r,6258,10,11,5,20,51,83,-32,38
Livingston,6259,1,24,6,6,87,42,45,78
Alloa,6259,2,18,8,10,72,44,28,62
Airdrieon,6259,3,18,5,13,62,50,12,59
Peterhead,6259,4,16,9,11,58,61,-3,57
Brechin,6259,5,16,8,12,50,51,-1,56
Queen's Park,6259,6,12,8,16,42,51,-9,44
Albion,6259,7,10,12,14,50,58,-8,42
East Fife,6259,8,8,13,15,43,52,-9,37
Stranraer,6259,9,10,7,19,48,62,-14,37
Stenhousem'r,6259,10,6,8,22,44,85,-41,26
Livingston,6260,1,20,7,9,71,46,25,67
Airdrieon,6260,2,19,5,12,57,50,7,62
Peterhead,6260,3,18,5,13,50,45,5,59
Albion,6260,4,16,6,14,67,62,5,54
Alloa,6260,5,15,8,13,73,56,17,53
Queen's Park,6260,6,15,6,15,42,48,-6,51
East Fife,6260,7,13,10,13,54,46,8,49
Stranraer,6260,8,13,6,17,56,64,-8,45
Brechin,6260,9,13,5,18,45,63,-18,44
Stenhousem'r,6260,10,4,10,22,46,81,-35,22
Livingston,6261,1,21,2,13,77,51,26,65
Alloa,6261,2,18,9,9,67,49,18,63
Airdrieon,6261,3,19,5,12,64,58,6,62
East Fife,6261,4,15,7,14,54,46,8,52
Stranraer,6261,5,15,5,16,51,53,-2,50
Brechin,6261,6,13,9,14,50,50,0,48
Peterhead,6261,7,12,8,16,46,48,-2,44
Albion,6261,8,12,7,17,48,60,-12,43
Queen's Park,6261,9,12,7,17,33,45,-12,43
Stenhousem'r,6261,10,10,7,19,48,78,-30,37
Livingston,6262,1,21,7,8,73,44,29,70
Alloa,6262,2,20,9,7,72,38,34,69
Airdrieon,6262,3,17,7,12,54,55,-1,58
Albion,6262,4,14,11,11,54,44,10,53
East Fife,6262,5,14,10,12,65,50,15,52
Peterhead,6262,6,13,9,14,43,51,-8,48
Queen's Park,6262,7,12,10,14,37,43,-6,46
Brechin,6262,8,13,5,18,54,61,-7,44
Stranraer,6262,9,11,6,19,45,65,-20,39
Stenhousem'r,6262,10,5,6,25,34,80,-46,21
Alloa,6263,1,21,6,9,73,49,24,69
Airdrieon,6263,2,18,9,9,69,48,21,63
Stranraer,6263,3,16,7,13,54,50,4,55
Livingston,6263,4,15,9,12,60,54,6,54
Brechin,6263,5,13,11,12,50,51,-1,50
Queen's Park,6263,6,12,9,15,42,52,-10,45
Albion,6263,7,9,16,11,50,53,-3,43
Peterhead,6263,8,12,7,17,44,51,-7,43
East Fife,6263,9,10,12,14,50,48,2,42
Stenhousem'r,6263,10,5,12,19,42,78,-36,27
Livingston,6264,1,21,6,9,86,50,36,69
Alloa,6264,2,18,8,10,74,53,21,62
Brechin,6264,3,18,8,10,56,36,20,62
Peterhead,6264,4,15,7,14,55,59,-4,52
Albion,6264,5,14,8,14,54,58,-4,50
Airdrieon,6264,6,13,10,13,57,59,-2,49
East Fife,6264,7,12,9,15,51,55,-4,45
Queen's Park,6264,8,10,9,17,37,59,-22,39
Stranraer,6264,9,11,4,21,45,66,-21,37
Stenhousem'r,6264,10,9,9,18,58,78,-20,36
Alloa,6265,1,20,9,7,77,45,32,69
Livingston,6265,2,20,5,11,82,52,30,65
Airdrieon,6265,3,17,9,10,60,49,11,60
Albion,6265,4,16,7,13,64,48,16,55
Brechin,6265,5,14,6,16,48,61,-13,48
Stranraer,6265,6,12,9,15,46,51,-5,45
East Fife,6265,7,11,11,14,50,49,1,44
Queen's Park,6265,8,11,8,17,34,60,-26,41
Peterhead,6265,9,10,10,16,42,56,-14,40
Stenhousem'r,6265,10,8,8,20,44,76,-32,32
Livingston,6266,1,22,7,7,97,60,37,73
Airdrieon,6266,2,20,6,10,67,56,11,66
Alloa,6266,3,16,10,10,59,43,16,58
Brechin,6266,4,15,8,13,50,45,5,53
Peterhead,6266,5,14,7,15,49,48,1,49
Albion,6266,6,13,9,14,46,51,-5,48
East Fife,6266,7,13,8,15,53,49,4,47
Queen's Park,6266,8,13,7,16,36,49,-13,46
Stranraer,6266,9,10,9,17,47,59,-12,39
Stenhousem'r,6266,10,3,11,22,46,90,-44,20
Livingston,6267,1,24,7,5,89,47,42,79
Alloa,6267,2,20,7,9,73,44,29,67
Airdrieon,6267,3,18,6,12,64,50,14,60
Brechin,6267,4,18,4,14,47,48,-1,58
Peterhead,6267,5,14,8,14,53,63,-10,50
Albion,6267,6,13,10,13,51,51,0,49
East Fife,6267,7,12,8,16,57,55,2,44
Stenhousem'r,6267,8,9,8,19,46,75,-29,35
Queen's Park,6267,9,8,7,21,38,61,-23,31
Stranraer,6267,10,8,7,21,43,67,-24,31
Livingston,6268,1,19,6,11,73,44,29,63
Airdrieon,6268,2,17,8,11,58,51,7,59
Peterhead,6268,3,17,7,12,55,44,11,58
Brechin,6268,4,18,4,14,52,49,3,58
Alloa,6268,5,16,8,12,66,53,13,56
Stranraer,6268,6,14,7,15,55,50,5,49
Albion,6268,7,13,9,14,53,57,-4,48
Queen's Park,6268,8,14,6,16,39,52,-13,48
East Fife,6268,9,10,9,17,41,51,-10,39
Stenhousem'r,6268,10,7,6,23,40,81,-41,27
Airdrieon,6269,1,20,7,9,57,44,13,67
Alloa,6269,2,20,5,11,63,49,14,65
Livingston,6269,3,20,1,15,76,61,15,61
Peterhead,6269,4,18,6,12,61,57,4,60
Albion,6269,5,14,8,14,58,50,8,50
Stranraer,6269,6,15,5,16,53,54,-1,50
Brechin,6269,7,14,7,15,57,55,2,49
East Fife,6269,8,13,9,14,52,49,3,48
Stenhousem'r,6269,9,10,5,21,45,72,-27,35
Queen's Park,6269,10,7,5,24,32,63,-31,26
Livingston,6270,1,24,3,9,78,44,34,75
Alloa,6270,2,21,6,9,82,54,28,69
Airdrieon,6270,3,17,7,12,60,55,5,58
Albion,6270,4,15,8,13,47,48,-1,53
Brechin,6270,5,14,8,14,44,46,-2,50
Peterhead,6270,6,15,4,17,56,55,1,49
Queen's Park,6270,7,13,7,16,35,48,-13,46
Stranraer,6270,8,12,5,19,51,56,-5,41
East Fife,6270,9,8,12,16,44,52,-8,36
Stenhousem'r,6270,10,9,4,23,44,83,-39,31
Livingston,6271,1,21,5,10,77,44,33,68
Alloa,6271,2,19,7,10,65,44,21,64
Brechin,6271,3,18,6,12,49,45,4,60
Airdrieon,6271,4,16,6,14,68,59,9,54
Albion,6271,5,15,9,12,59,51,8,54
East Fife,6271,6,14,7,15,62,54,8,49
Peterhead,6271,7,14,5,17,46,57,-11,47
Queen's Park,6271,8,14,4,18,36,52,-16,46
Stranraer,6271,9,13,3,20,45,57,-12,42
Stenhousem'r,6271,10,7,6,23,49,93,-44,27
Airdrieon,6272,1,20,4,12,58,45,13,64
Brechin,6272,2,19,4,13,58,52,6,61
Alloa,6272,3,14,14,8,68,47,21,56
Livingston,6272,4,16,5,15,70,57,13,53
Stranraer,6272,5,15,5,16,56,59,-3,50
Queen's Park,6272,6,13,9,14,42,47,-5,48
Albion,6272,7,12,11,13,55,58,-3,47
Stenhousem'r,6272,8,14,5,17,63,82,-19,47
Peterhead,6272,9,10,9,17,44,58,-14,39
East Fife,6272,10,7,14,15,44,53,-9,35
Livingston,6273,1,24,4,8,77,40,37,76
Alloa,6273,2,19,8,9,62,39,23,65
Airdrieon,6273,3,14,11,11,49,46,3,53
Brechin,6273,4,16,5,15,48,47,1,53
Albion,6273,5,13,9,14,59,54,5,48
Stranraer,6273,6,12,7,17,44,59,-15,43
East Fife,6273,7,11,9,16,54,57,-3,42
Queen's Park,6273,8,12,6,18,31,47,-16,42
Peterhead,6273,9,10,11,15,45,53,-8,41
Stenhousem'r,6273,10,9,10,17,53,80,-27,37
Alloa,6274,1,17,9,10,74,52,22,60
Livingston,6274,2,18,6,12,69,56,13,60
East Fife,6274,3,15,9,12,63,42,21,54
Albion,6274,4,15,9,12,59,46,13,54
Airdrieon,6274,5,17,3,16,58,54,4,54
Peterhead,6274,6,16,5,15,57,60,-3,53
Brechin,6274,7,16,4,16,43,52,-9,52
Stranraer,6274,8,15,4,17,55,62,-7,49
Queen's Park,6274,9,11,8,17,35,54,-19,41
Stenhousem'r,6274,10,9,5,22,44,79,-35,32
Livingston,6275,1,19,4,13,77,56,21,61
Alloa,6275,2,17,8,11,71,48,23,59
Albion,6275,3,16,8,12,55,51,4,56
Airdrieon,6275,4,16,8,12,55,52,3,56
Brechin,6275,4,16,8,12,55,52,3,56
Stranraer,6275,6,14,7,15,59,57,2,49
Peterhead,6275,7,11,10,15,52,62,-10,43
East Fife,6275,8,11,9,16,55,63,-8,42
Stenhousem'r,6275,9,10,9,17,58,78,-20,39
Queen's Park,6275,10,9,11,16,44,62,-18,38
Livingston,6276,1,23,4,9,80,44,36,73
Alloa,6276,2,19,8,9,68,45,23,65
Brechin,6276,3,17,4,15,53,54,-1,55
East Fife,6276,4,13,9,14,51,44,7,48
Airdrieon,6276,5,13,9,14,49,62,-13,48
Albion,6276,6,13,8,15,54,56,-2,47
Stranraer,6276,7,14,5,17,55,61,-6,47
Queen's Park,6276,8,13,8,15,39,53,-14,47
Peterhead,6276,9,11,9,16,55,60,-5,42
Stenhousem'r,6276,10,8,8,20,53,78,-25,32
Livingston,6277,1,23,5,8,83,48,35,74
Alloa,6277,2,21,8,7,74,45,29,71
Stranraer,6277,3,15,8,13,50,52,-2,53
Albion,6277,4,14,9,13,56,50,6,51
Queen's Park,6277,5,16,3,17,44,50,-6,51
Brechin,6277,6,15,5,16,48,52,-4,50
Airdrieon,6277,7,14,7,15,59,61,-2,49
Peterhead,6277,8,13,9,14,45,47,-2,48
East Fife,6277,9,6,14,16,46,59,-13,32
Stenhousem'r,6277,10,6,6,24,41,82,-41,24
Livingston,6278,1,22,6,8,87,53,34,72
Airdrieon,6278,2,21,9,6,70,39,31,72
Alloa,6278,3,15,14,7,64,42,22,59
Brechin,6278,4,15,9,12,56,51,5,54
Albion,6278,5,15,8,13,53,48,5,53
Peterhead,6278,6,12,7,17,48,59,-11,43
Queen's Park,6278,7,11,10,15,33,49,-16,43
East Fife,6278,8,8,13,15,42,48,-6,37
Stranraer,6278,9,9,8,19,43,65,-22,35
Stenhousem'r,6278,10,6,8,22,42,84,-42,26
Alloa,6279,1,22,5,9,80,43,37,71
Brechin,6279,2,18,6,12,60,45,15,60
Albion,6279,3,15,8,13,58,50,8,53
Livingston,6279,4,14,9,13,70,58,12,51
Airdrieon,6279,5,12,12,12,47,53,-6,48
Stenhousem'r,6279,6,11,12,13,69,80,-11,45
Queen's Park,6279,7,12,8,16,28,45,-17,44
Peterhead,6279,8,12,8,16,44,66,-22,44
Stranraer,6279,9,12,7,17,52,64,-12,43
East Fife,6279,10,10,9,17,44,48,-4,39
Livingston,6280,1,20,6,10,80,49,31,66
Airdrieon,6280,2,19,9,8,63,43,20,66
Alloa,6280,3,18,7,11,73,46,27,61
Brechin,6280,4,16,9,11,47,47,0,57
Peterhead,6280,5,14,8,14,48,53,-5,50
Queen's Park,6280,6,13,8,15,39,57,-18,47
Albion,6280,7,11,11,14,49,51,-2,44
Stranraer,6280,8,11,8,17,52,56,-4,41
East Fife,6280,9,8,11,17,41,56,-15,35
Stenhousem'r,6280,10,8,7,21,47,81,-34,31
Alloa,6281,1,19,8,9,72,49,23,65
Albion,6281,2,18,7,11,57,42,15,61
Brechin,6281,3,18,6,12,56,52,4,60
Livingston,6281,4,17,7,12,72,52,20,58
East Fife,6281,5,14,8,14,54,55,-1,50
Peterhead,6281,6,12,11,13,55,57,-2,47
Airdrieon,6281,7,11,10,15,51,60,-9,43
Queen's Park,6281,8,11,7,18,35,47,-12,40
Stenhousem'r,6281,9,11,6,19,50,76,-26,39
Stranraer,6281,10,9,10,17,51,63,-12,37
Livingston,6282,1,22,6,8,73,38,35,72
Alloa,6282,2,20,8,8,74,40,34,68
Airdrieon,6282,3,16,6,14,64,55,9,54
Albion,6282,4,15,8,13,56,55,1,53
Brechin,6282,5,14,8,14,42,52,-10,50
East Fife,6282,6,12,10,14,52,46,6,46
Queen's Park,6282,7,12,9,15,39,48,-9,45
Peterhead,6282,8,10,12,14,45,58,-13,42
Stranraer,6282,9,10,9,17,45,58,-13,39
Stenhousem'r,6282,10,7,8,21,41,81,-40,29
Alloa,6283,1,22,5,9,68,35,33,71
Livingston,6283,2,18,7,11,70,55,15,61
Brechin,6283,3,17,5,14,51,51,0,56
Airdrieon,6283,4,16,7,13,55,58,-3,55
Stranraer,6283,5,14,10,12,44,40,4,52
Albion,6283,6,13,7,16,54,54,0,46
Queen's Park,6283,7,13,6,17,45,55,-10,45
East Fife,6283,8,9,14,13,45,47,-2,41
Peterhead,6283,9,11,6,19,41,52,-11,39
Stenhousem'r,6283,10,8,11,17,51,77,-26,35
Livingston,6284,1,20,5,11,74,43,31,65
Alloa,6284,2,17,8,11,74,49,25,59
Airdrieon,6284,3,15,8,13,52,58,-6,53
Brechin,6284,4,14,8,14,46,52,-6,50
Peterhead,6284,5,13,10,13,54,55,-1,49
East Fife,6284,6,12,12,12,54,51,3,48
Albion,6284,7,11,14,11,49,47,2,47
Queen's Park,6284,8,12,10,14,38,54,-16,46
Stranraer,6284,9,11,8,17,43,58,-15,41
Stenhousem'r,6284,10,9,9,18,66,83,-17,36
Alloa,6285,1,21,7,8,74,44,30,70
Livingston,6285,2,19,5,12,70,47,23,62
Airdrieon,6285,3,16,7,13,56,54,2,55
Brechin,6285,4,16,7,13,52,50,2,55
Queen's Park,6285,5,15,8,13,35,42,-7,53
Albion,6285,6,15,6,15,66,55,11,51
Stranraer,6285,7,15,6,15,60,62,-2,51
East Fife,6285,8,11,8,17,45,49,-4,41
Peterhead,6285,9,10,9,17,57,71,-14,39
Stenhousem'r,6285,10,7,7,22,45,86,-41,28
Livingston,6286,1,19,11,6,76,46,30,68
Alloa,6286,2,18,9,9,69,42,27,63
Albion,6286,3,17,9,10,58,52,6,60
Airdrieon,6286,4,16,5,15,58,61,-3,53
Stranraer,6286,5,14,5,17,60,60,0,47
East Fife,6286,6,12,8,16,54,52,2,44
Peterhead,6286,7,11,10,15,44,56,-12,43
Queen's Park,6286,8,12,7,17,45,59,-14,43
Brechin,6286,9,10,11,15,44,54,-10,41
Stenhousem'r,6286,10,10,7,19,55,81,-26,37
Airdrieon,6287,1,18,8,10,56,46,10,62
Livingston,6287,2,18,4,14,66,51,15,58
Alloa,6287,3,16,9,11,64,51,13,57
Brechin,6287,4,15,10,11,45,44,1,55
Albion,6287,5,15,6,15,50,55,-5,51
Peterhead,6287,6,14,7,15,53,52,1,49
Stranraer,6287,7,14,5,17,47,54,-7,47
Queen's Park,6287,8,14,5,17,41,52,-11,47
East Fife,6287,9,11,7,18,58,54,4,40
Stenhousem'r,6287,10,10,9,17,50,71,-21,39
Alloa,6288,1,21,8,7,72,35,37,71
Livingston,6288,2,20,7,9,77,46,31,67
Brechin,6288,3,18,8,10,55,41,14,62
Albion,6288,4,16,8,12,54,51,3,56
Airdrieon,6288,5,17,4,15,65,66,-1,55
Peterhead,6288,6,14,7,15,48,58,-10,49
East Fife,6288,7,11,10,15,50,45,5,43
Queen's Park,6288,8,11,5,20,40,58,-18,38
Stranraer,6288,9,8,9,19,45,70,-25,33
Stenhousem'r,6288,10,7,8,21,50,86,-36,29
Alloa,6289,1,19,9,8,67,37,30,66
Livingston,6289,2,17,7,12,69,54,15,58
Brechin,6289,3,17,7,12,55,50,5,58
Airdrieon,6289,4,16,9,11,58,53,5,57
Peterhead,6289,5,15,10,11,52,43,9,55
Albion,6289,6,13,8,15,53,61,-8,47
Stranraer,6289,7,12,10,14,48,53,-5,46
Queen's Park,6289,8,12,9,15,38,44,-6,45
East Fife,6289,9,10,13,13,47,48,-1,43
Stenhousem'r,6289,10,4,8,24,42,86,-44,20
Alloa,6290,1,22,6,8,74,44,30,72
Peterhead,6290,2,15,12,9,55,47,8,57
Livingston,6290,3,16,5,15,57,48,9,53
Airdrieon,6290,4,15,8,13,56,54,2,53
Brechin,6290,5,14,9,13,47,49,-2,51
East Fife,6290,6,13,11,12,52,41,11,50
Albion,6290,7,13,6,17,48,63,-15,45
Stranraer,6290,8,13,5,18,55,55,0,44
Queen's Park,6290,9,11,7,18,38,60,-22,40
Stenhousem'r,6290,10,9,9,18,53,74,-21,36
Alloa,6291,1,19,10,7,85,44,41,67
Livingston,6291,2,19,6,11,75,46,29,63
Brechin,6291,3,16,7,13,46,50,-4,55
Peterhead,6291,4,16,5,15,42,50,-8,53
Airdrieon,6291,5,15,7,14,57,57,0,52
Queen's Park,6291,6,14,5,17,48,56,-8,47
East Fife,6291,7,12,9,15,52,55,-3,45
Stranraer,6291,8,13,6,17,48,58,-10,45
Albion,6291,9,12,7,17,49,53,-4,43
Stenhousem'r,6291,10,10,6,20,42,75,-33,36
Livingston,6292,1,18,11,7,75,49,26,65
Alloa,6292,2,16,10,10,68,56,12,58
Airdrieon,6292,3,17,5,14,60,53,7,56
Brechin,6292,4,15,8,13,51,55,-4,53
Albion,6292,5,13,8,15,58,58,0,47
Peterhead,6292,6,12,10,14,46,52,-6,46
Stranraer,6292,7,13,7,16,56,64,-8,46
Stenhousem'r,6292,8,13,6,17,67,81,-14,45
East Fife,6292,9,11,9,16,51,51,0,42
Queen's Park,6292,10,11,8,17,36,49,-13,41
Livingston,6293,1,24,5,7,94,43,51,77
Alloa,6293,2,18,9,9,75,48,27,63
Airdrieon,6293,3,18,5,13,57,50,7,59
Brechin,6293,4,15,11,10,53,49,4,56
Queen's Park,6293,5,13,10,13,47,59,-12,49
East Fife,6293,6,13,9,14,54,52,2,48
Albion,6293,7,10,11,15,50,58,-8,41
Peterhead,6293,8,9,10,17,46,60,-14,37
Stranraer,6293,9,10,6,20,42,65,-23,36
Stenhousem'r,6293,10,7,10,19,47,81,-34,31
Livingston,6294,1,20,7,9,74,46,28,67
Albion,6294,2,19,7,10,69,55,14,64
Alloa,6294,3,18,9,9,68,43,25,63
Peterhead,6294,4,14,9,13,56,55,1,51
Airdrieon,6294,5,14,9,13,51,51,0,51
East Fife,6294,6,12,11,13,55,46,9,47
Queen's Park,6294,7,13,8,15,41,50,-9,47
Stranraer,6294,8,13,7,16,44,55,-11,46
Brechin,6294,9,13,6,17,43,44,-1,45
Stenhousem'r,6294,10,3,9,24,34,90,-56,18
Alloa,6295,1,23,6,7,70,36,34,75
Livingston,6295,2,20,4,12,79,54,25,64
Airdrieon,6295,3,18,7,11,61,53,8,61
Brechin,6295,4,15,8,13,48,50,-2,53
East Fife,6295,5,13,7,16,56,53,3,46
Albion,6295,6,12,9,15,47,51,-4,45
Stenhousem'r,6295,7,13,5,18,51,72,-21,44
Stranraer,6295,8,12,6,18,57,65,-8,42
Peterhead,6295,9,10,11,15,39,51,-12,41
Queen's Park,6295,10,9,7,20,28,51,-23,34
Livingston,6296,1,23,5,8,91,42,49,74
Airdrieon,6296,2,18,6,12,57,62,-5,60
Alloa,6296,3,16,11,9,66,49,17,59
Brechin,6296,4,17,8,11,59,48,11,59
Queen's Park,6296,5,14,7,15,52,60,-8,49
Peterhead,6296,6,14,6,16,53,63,-10,48
Albion,6296,7,13,7,16,51,50,1,46
East Fife,6296,8,12,8,16,52,53,-1,44
Stranraer,6296,9,11,4,21,46,65,-19,37
Stenhousem'r,6296,10,8,6,22,47,82,-35,30
Airdrieon,6297,1,20,7,9,72,47,25,67
Alloa,6297,2,19,7,10,77,44,33,64
Livingston,6297,3,19,6,11,75,42,33,63
Peterhead,6297,4,16,8,12,49,56,-7,56
Brechin,6297,5,13,11,12,50,49,1,50
Queen's Park,6297,6,15,5,16,44,51,-7,50
East Fife,6297,7,12,11,13,47,44,3,47
Albion,6297,8,11,10,15,57,69,-12,43
Stranraer,6297,9,9,6,21,43,70,-27,33
Stenhousem'r,6297,10,7,7,22,39,81,-42,28
Livingston,6298,1,19,8,9,67,39,28,65
Alloa,6298,2,18,6,12,66,49,17,60
Brechin,6298,3,18,6,12,46,38,8,60
Peterhead,6298,4,15,8,13,46,47,-1,53
Airdrieon,6298,5,15,6,15,57,58,-1,51
Stranraer,6298,6,15,5,16,56,54,2,50
Albion,6298,7,13,10,13,48,48,0,49
East Fife,6298,8,11,12,13,44,45,-1,45
Queen's Park,6298,9,11,8,17,36,55,-19,41
Stenhousem'r,6298,10,7,7,22,47,80,-33,28
Alloa,6299,1,18,9,9,72,51,21,63
Livingston,6299,2,19,5,12,66,44,22,62
Airdrieon,6299,3,18,8,10,68,54,14,62
Brechin,6299,4,17,6,13,50,45,5,57
East Fife,6299,5,12,12,12,56,52,4,48
Peterhead,6299,6,14,6,16,49,56,-7,48
Queen's Park,6299,7,13,7,16,35,45,-10,46
Albion,6299,8,12,9,15,54,54,0,45
Stranraer,6299,9,12,5,19,53,68,-15,41
Stenhousem'r,6299,10,7,9,20,51,85,-34,30
Livingston,6300,1,20,4,12,78,47,31,64
Alloa,6300,2,18,7,11,70,47,23,61
Peterhead,6300,3,17,7,12,55,45,10,58
Stranraer,6300,4,15,7,14,59,58,1,52
Airdrieon,6300,5,14,9,13,58,58,0,51
Brechin,6300,6,14,9,13,43,55,-12,51
East Fife,6300,7,13,11,12,53,40,13,50
Albion,6300,8,13,6,17,43,54,-11,45
Queen's Park,6300,9,11,9,16,37,51,-14,42
Stenhousem'r,6300,10,6,9,21,43,84,-41,27
Alloa,6301,1,21,6,9,78,46,32,69
Livingston,6301,2,20,5,11,64,46,18,65
Airdrieon,6301,3,19,8,9,60,42,18,65
Brechin,6301,4,19,6,11,59,40,19,63
Stranraer,6301,5,15,6,15,59,50,9,51
Albion,6301,6,13,10,13,48,51,-3,49
East Fife,6301,7,8,13,15,40,57,-17,37
Peterhead,6301,8,9,9,18,41,56,-15,36
Queen's Park,6301,9,10,4,22,33,58,-25,34
Stenhousem'r,6301,10,8,9,19,48,84,-36,33
Alloa,6302,1,19,8,9,73,46,27,65
Livingston,6302,2,19,8,9,77,52,25,65
Brechin,6302,3,14,10,12,47,46,1,52
Peterhead,6302,4,15,7,14,54,58,-4,52
Albion,6302,5,13,11,12,49,45,4,50
Airdrieon,6302,6,13,9,14,58,62,-4,48
East Fife,6302,7,13,7,16,48,45,3,46
Stranraer,6302,8,12,6,18,58,66,-8,42
Queen's Park,6302,9,10,12,14,33,47,-14,42
Stenhousem'r,6302,10,10,6,20,47,77,-30,36
Livingston,6303,1,22,5,9,80,46,34,71
Airdrieon,6303,2,19,6,11,68,54,14,63
Brechin,6303,3,18,7,11,54,48,6,61
Alloa,6303,4,15,10,11,57,43,14,55
Peterhead,6303,5,15,10,11,54,46,8,55
Queen's Park,6303,6,14,5,17,42,51,-9,47
Albion,6303,7,11,9,16,52,54,-2,42
Stranraer,6303,8,12,6,18,41,58,-17,42
East Fife,6303,9,8,10,18,38,55,-17,34
Stenhousem'r,6303,10,7,10,19,44,75,-31,31
Livingston,6304,1,20,8,8,78,49,29,68
Brechin,6304,2,20,5,11,60,40,20,65
Alloa,6304,3,16,10,10,61,42,19,58
Airdrieon,6304,4,16,8,12,57,60,-3,56
Albion,6304,5,14,12,10,61,49,12,54
Peterhead,6304,6,12,11,13,49,58,-9,47
Stranraer,6304,7,13,6,17,50,58,-8,45
East Fife,6304,8,10,9,17,46,53,-7,39
Queen's Park,6304,9,9,9,18,29,53,-24,36
Stenhousem'r,6304,10,6,10,20,46,75,-29,28
Livingston,6305,1,20,6,10,83,61,22,66
Alloa,6305,2,15,11,10,71,49,22,56
Airdrieon,6305,3,17,5,14,72,58,14,56
Albion,6305,4,14,13,9,53,46,7,55
Brechin,6305,5,16,5,15,44,49,-5,53
Peterhead,6305,6,14,9,13,45,47,-2,51
East Fife,6305,7,12,12,12,50,45,5,48
Queen's Park,6305,8,11,12,13,37,49,-12,45
Stranraer,6305,9,11,6,19,46,66,-20,39
Stenhousem'r,6305,10,8,5,23,50,81,-31,29
Alloa,6306,1,21,9,6,72,37,35,72
Airdrieon,6306,2,17,8,11,63,51,12,59
Livingston,6306,3,16,8,12,66,53,13,56
Albion,6306,4,17,4,15,60,47,13,55
Brechin,6306,5,15,10,11,49,46,3,55
Queen's Park,6306,6,14,6,16,41,50,-9,48
Peterhead,6306,7,13,6,17,55,66,-11,45
East Fife,6306,8,12,6,18,41,56,-15,42
Stranraer,6306,9,10,9,17,48,60,-12,39
Stenhousem'r,6306,10,6,12,18,42,71,-29,30
Alloa,6307,1,19,9,8,71,44,27,66
Livingston,6307,2,19,7,10,76,49,27,64
Airdrieon,6307,3,16,7,13,49,48,1,55
Brechin,6307,4,16,6,14,60,54,6,54
Peterhead,6307,5,15,8,13,55,52,3,53
Albion,6307,6,14,8,14,50,53,-3,50
Stranraer,6307,7,14,5,17,54,59,-5,47
East Fife,6307,8,12,7,17,44,50,-6,43
Queen's Park,6307,9,12,6,18,36,58,-22,42
Stenhousem'r,6307,10,6,11,19,45,73,-28,29
Livingston,6308,1,20,6,10,75,41,34,66
Brechin,6308,2,19,7,10,56,44,12,64
Peterhead,6308,3,18,5,13,55,40,15,59
Stranraer,6308,4,17,6,13,54,53,1,57
Alloa,6308,5,16,7,13,66,53,13,55
Airdrieon,6308,6,15,7,14,59,61,-2,52
East Fife,6308,7,11,10,15,47,49,-2,43
Albion,6308,8,11,8,17,46,54,-8,41
Queen's Park,6308,9,9,7,20,37,61,-24,34
Stenhousem'r,6308,10,8,9,19,42,81,-39,33
Alloa,6309,1,20,7,9,71,41,30,67
Livingston,6309,2,19,7,10,72,52,20,64
Brechin,6309,3,18,3,15,51,42,9,57
Peterhead,6309,4,15,6,15,47,50,-3,51
Stranraer,6309,5,14,8,14,56,57,-1,50
Queen's Park,6309,6,14,8,14,37,49,-12,50
East Fife,6309,7,14,7,15,50,50,0,49
Airdrieon,6309,8,14,7,15,53,54,-1,49
Albion,6309,9,10,9,17,44,53,-9,39
Stenhousem'r,6309,10,8,6,22,41,74,-33,30
Livingston,6310,1,21,4,11,78,53,25,67
Alloa,6310,2,19,7,10,70,45,25,64
Albion,6310,3,17,9,10,60,49,11,60
Brechin,6310,4,17,5,14,52,48,4,56
Peterhead,6310,5,16,7,13,46,45,1,55
Stranraer,6310,6,16,4,16,53,50,3,52
Airdrieon,6310,7,15,5,16,53,57,-4,50
East Fife,6310,8,11,8,17,49,56,-7,41
Queen's Park,6310,9,8,10,18,31,52,-21,34
Stenhousem'r,6310,10,7,7,22,40,77,-37,28
Livingston,6311,1,24,5,7,76,43,33,77
Alloa,6311,2,18,8,10,66,47,19,62
Brechin,6311,3,16,7,13,54,51,3,55
Airdrieon,6311,4,15,8,13,58,59,-1,53
Albion,6311,5,14,8,14,60,55,5,50
Peterhead,6311,6,13,8,15,45,54,-9,47
Queen's Park,6311,7,13,6,17,48,49,-1,45
East Fife,6311,8,11,10,15,49,56,-7,43
Stranraer,6311,9,10,10,16,60,69,-9,40
Stenhousem'r,6311,10,7,8,21,48,81,-33,29
Livingston,6312,1,21,4,11,78,48,30,67
Albion,6312,2,16,10,10,57,49,8,58
Alloa,6312,3,15,12,9,60,41,19,57
Brechin,6312,4,17,6,13,54,51,3,57
Peterhead,6312,5,14,12,10,44,40,4,54
Airdrieon,6312,6,15,7,14,56,60,-4,52
Stranraer,6312,7,12,9,15,57,56,1,45
Queen's Park,6312,8,12,7,17,32,47,-15,43
East Fife,6312,9,10,9,17,41,49,-8,39
Stenhousem'r,6312,10,6,8,22,37,75,-38,26
Livingston,6313,1,23,6,7,78,38,40,75
Alloa,6313,2,21,8,7,73,32,41,71
Airdrieon,6313,3,20,4,12,63,52,11,64
Brechin,6313,4,18,8,10,59,47,12,62
Queen's Park,6313,5,14,6,16,32,47,-15,48
East Fife,6313,6,12,9,15,51,50,1,45
Peterhead,6313,7,10,10,16,47,61,-14,40
Albion,6313,8,10,8,18,44,60,-16,38
Stranraer,6313,9,9,5,22,43,68,-25,32
Stenhousem'r,6313,10,8,6,22,44,79,-35,30
Livingston,6314,1,19,5,12,71,50,21,62
Alloa,6314,2,17,9,10,62,47,15,60
Airdrieon,6314,3,17,6,13,57,48,9,57
Albion,6314,4,16,7,13,57,47,10,55
Stranraer,6314,5,17,4,15,51,50,1,55
Brechin,6314,6,15,5,16,48,53,-5,50
Peterhead,6314,7,12,10,14,44,55,-11,46
Queen's Park,6314,8,11,9,16,39,50,-11,42
East Fife,6314,9,9,12,15,49,47,2,39
Stenhousem'r,6314,10,8,11,17,47,78,-31,35
Livingston,6315,1,23,6,7,89,49,40,75
Brechin,6315,2,20,5,11,64,49,15,65
Alloa,6315,3,18,8,10,75,53,22,62
Albion,6315,4,14,8,14,54,54,0,50
Airdrieon,6315,5,14,7,15,60,70,-10,49
Peterhead,6315,6,13,9,14,44,52,-8,48
East Fife,6315,7,12,10,14,59,49,10,46
Queen's Park,6315,8,12,6,18,39,57,-18,42
Stranraer,6315,9,12,5,19,58,69,-11,41
Stenhousem'r,6315,10,6,8,22,57,97,-40,26
Livingston,6316,1,22,4,10,78,43,35,70
Airdrieon,6316,2,18,8,10,68,47,21,62
Alloa,6316,3,18,6,12,60,45,15,60
Peterhead,6316,4,14,10,12,50,44,6,52
East Fife,6316,5,14,10,12,55,55,0,52
Albion,6316,6,14,10,12,47,53,-6,52
Brechin,6316,7,15,6,15,55,62,-7,51
Stranraer,6316,8,10,8,18,50,62,-12,38
Queen's Park,6316,9,8,12,16,34,50,-16,36
Stenhousem'r,6316,10,5,10,21,47,83,-36,25
Brechin,6317,1,21,4,11,60,37,23,67
Livingston,6317,2,20,7,9,72,50,22,67
Alloa,6317,3,16,8,12,60,40,20,56
Peterhead,6317,4,16,8,12,50,44,6,56
Airdrieon,6317,5,16,8,12,60,56,4,56
Stranraer,6317,6,14,6,16,46,56,-10,48
East Fife,6317,7,12,8,16,50,47,3,44
Albion,6317,8,13,5,18,43,55,-12,44
Queen's Park,6317,9,11,9,16,39,50,-11,42
Stenhousem'r,6317,10,5,9,22,31,76,-45,24
Alloa,6318,1,20,6,10,66,36,30,66
Livingston,6318,2,19,3,14,73,55,18,60
East Fife,6318,3,16,9,11,55,40,15,57
Brechin,6318,4,15,7,14,45,50,-5,52
Airdrieon,6318,5,14,7,15,61,63,-2,49
Peterhead,6318,6,14,7,15,50,53,-3,49
Stranraer,6318,7,15,3,18,53,61,-8,48
Queen's Park,6318,8,12,11,13,38,45,-7,47
Albion,6318,9,10,10,16,48,59,-11,40
Stenhousem'r,6318,10,10,7,19,49,76,-27,37
Livingston,6319,1,25,2,9,77,45,32,77
Brechin,6319,2,19,7,10,47,37,10,64
Alloa,6319,3,18,9,9,68,40,28,63
Airdrieon,6319,4,18,8,10,60,49,11,62
East Fife,6319,5,12,9,15,47,42,5,45
Albion,6319,6,12,9,15,54,53,1,45
Stenhousem'r,6319,7,10,10,16,50,74,-24,40
Peterhead,6319,8,10,9,17,43,60,-17,39
Queen's Park,6319,9,10,8,18,30,50,-20,38
Stranraer,6319,10,7,7,22,43,69,-26,28
Livingston,6320,1,22,3,11,76,44,32,69
Brechin,6320,2,20,6,10,62,46,16,66
Alloa,6320,3,19,8,9,72,42,30,65
Airdrieon,6320,4,19,5,12,59,51,8,62
Albion,6320,5,16,6,14,58,52,6,54
Queen's Park,6320,6,13,7,16,41,55,-14,46
Peterhead,6320,7,13,6,17,55,59,-4,45
Stranraer,6320,8,14,2,20,51,62,-11,44
East Fife,6320,9,9,10,17,47,64,-17,37
Stenhousem'r,6320,10,6,5,25,39,85,-46,23
Livingston,6321,1,24,4,8,86,46,40,76
Alloa,6321,2,20,8,8,75,46,29,68
Brechin,6321,3,17,5,14,56,48,8,56
Airdrieon,6321,4,16,6,14,56,56,0,54
Queen's Park,6321,5,15,6,15,43,48,-5,51
Peterhead,6321,6,14,6,16,52,59,-7,48
Albion,6321,7,13,5,18,57,64,-7,44
Stranraer,6321,8,12,6,18,51,69,-18,42
East Fife,6321,9,11,7,18,51,58,-7,40
Stenhousem'r,6321,10,8,7,21,40,73,-33,31
Livingston,6322,1,22,4,10,74,49,25,70
Airdrieon,6322,2,19,8,9,60,47,13,65
Alloa,6322,3,19,7,10,72,49,23,64
Brechin,6322,4,17,6,13,57,45,12,57
Stranraer,6322,5,15,6,15,58,56,2,51
Peterhead,6322,6,13,7,16,45,57,-12,46
Queen's Park,6322,7,14,3,19,41,54,-13,45
East Fife,6322,8,8,16,12,51,46,5,40
Albion,6322,9,10,10,16,46,56,-10,40
Stenhousem'r,6322,10,6,7,23,46,91,-45,25
Alloa,6323,1,22,6,8,70,38,32,72
Livingston,6323,2,18,6,12,70,56,14,60
Airdrieon,6323,3,16,6,14,53,49,4,54
Brechin,6323,4,14,11,11,54,46,8,53
Albion,6323,5,13,12,11,48,43,5,51
Peterhead,6323,6,13,9,14,50,53,-3,48
Queen's Park,6323,7,12,12,12,42,54,-12,48
Stranraer,6323,8,14,4,18,51,60,-9,46
East Fife,6323,9,9,8,19,41,51,-10,35
Stenhousem'r,6323,10,7,10,19,50,79,-29,31
Livingston,6324,1,20,5,11,70,47,23,65
Alloa,6324,2,19,6,11,71,51,20,63
Brechin,6324,3,17,6,13,48,40,8,57
Albion,6324,4,15,7,14,56,49,7,52
Airdrieon,6324,5,15,6,15,56,57,-1,51
Peterhead,6324,6,13,10,13,54,51,3,49
Queen's Park,6324,7,13,8,15,37,46,-9,47
Stranraer,6324,8,13,6,17,46,60,-14,45
East Fife,6324,9,9,11,16,47,58,-11,38
Stenhousem'r,6324,10,9,9,18,48,74,-26,36
Livingston,6325,1,22,5,9,81,45,36,71
Alloa,6325,2,21,7,8,80,37,43,70
Airdrieon,6325,3,18,9,9,58,53,5,63
Brechin,6325,4,16,6,14,55,49,6,54
Albion,6325,5,15,7,14,54,59,-5,52
Queen's Park,6325,6,13,9,14,41,51,-10,48
East Fife,6325,7,11,9,16,46,49,-3,42
Stranraer,6325,8,11,5,20,44,64,-20,38
Peterhead,6325,9,9,10,17,47,62,-15,37
Stenhousem'r,6325,10,6,9,21,42,79,-37,27
Livingston,6326,1,23,3,10,90,56,34,72
Alloa,6326,2,21,4,11,73,47,26,67
Peterhead,6326,3,16,6,14,58,55,3,54
Airdrieon,6326,4,16,4,16,52,56,-4,52
Brechin,6326,5,16,3,17,51,57,-6,51
Queen's Park,6326,6,15,6,15,41,51,-10,51
Stranraer,6326,7,13,7,16,52,57,-5,46
East Fife,6326,8,12,8,16,55,51,4,44
Albion,6326,9,11,9,16,50,58,-8,42
Stenhousem'r,6326,10,9,6,21,41,75,-34,33
Livingston,6327,1,23,5,8,79,50,29,74
Airdrieon,6327,2,20,9,7,68,47,21,69
Alloa,6327,3,19,8,9,68,41,27,65
East Fife,6327,4,14,7,15,57,46,11,49
Peterhead,6327,5,13,8,15,56,64,-8,47
Albion,6327,6,12,10,14,52,59,-7,46
Queen's Park,6327,7,13,5,18,43,52,-9,44
Brechin,6327,8,13,5,18,48,60,-12,44
Stranraer,6327,9,10,5,21,51,72,-21,35
Stenhousem'r,6327,10,9,6,21,42,73,-31,33
Livingston,6328,1,24,2,10,79,46,33,74
Brechin,6328,2,19,8,9,60,42,18,65
Alloa,6328,3,16,9,11,63,41,22,57
Airdrieon,6328,4,15,9,12,57,55,2,54
East Fife,6328,5,12,12,12,46,51,-5,48
Queen's Park,6328,6,12,11,13,40,53,-13,47
Peterhead,6328,7,12,9,15,45,51,-6,45
Stranraer,6328,8,12,4,20,54,68,-14,40
Albion,6328,9,9,10,17,46,52,-6,37
Stenhousem'r,6328,10,9,6,21,41,72,-31,33
Livingston,6329,1,22,4,10,89,54,35,70
Alloa,6329,2,20,8,8,71,40,31,68
Airdrieon,6329,3,17,9,10,56,52,4,60
Albion,6329,4,17,8,11,60,50,10,59
Brechin,6329,5,17,5,14,51,44,7,56
Stranraer,6329,6,12,7,17,52,62,-10,43
Peterhead,6329,7,12,6,18,43,55,-12,42
Queen's Park,6329,8,10,8,18,39,64,-25,38
East Fife,6329,9,8,12,16,49,56,-7,36
Stenhousem'r,6329,10,8,7,21,43,76,-33,31
Peterhead,6330,1,18,7,11,57,51,6,61
Alloa,6330,2,18,6,12,68,45,23,60
Livingston,6330,3,18,6,12,71,55,16,60
Brechin,6330,4,17,5,14,52,44,8,56
Airdrieon,6330,5,15,9,12,58,60,-2,54
East Fife,6330,6,15,8,13,48,40,8,53
Stranraer,6330,7,14,8,14,61,59,2,50
Albion,6330,8,12,10,14,55,55,0,46
Stenhousem'r,6330,9,8,8,20,45,74,-29,32
Queen's Park,6330,10,9,5,22,30,62,-32,32
Livingston,6331,1,24,3,9,84,39,45,75
Brechin,6331,2,20,5,11,52,41,11,65
Alloa,6331,3,16,8,12,70,46,24,56
Airdrieon,6331,4,15,6,15,51,50,1,51
Peterhead,6331,5,12,14,10,41,41,0,50
Albion,6331,6,14,8,14,60,61,-1,50
Queen's Park,6331,7,14,4,18,35,53,-18,46
East Fife,6331,8,10,11,15,41,48,-7,41
Stranraer,6331,9,11,5,20,45,65,-20,38
Stenhousem'r,6331,10,9,6,21,45,80,-35,33
Livingston,6332,1,24,3,9,79,52,27,75
Alloa,6332,2,20,8,8,72,43,29,68
Airdrieon,6332,3,16,8,12,59,54,5,56
Brechin,6332,4,15,5,16,47,52,-5,50
Albion,6332,5,13,9,14,54,53,1,48
Stranraer,6332,6,12,9,15,50,48,2,45
East Fife,6332,7,12,7,17,46,47,-1,43
Peterhead,6332,8,10,10,16,39,49,-10,40
Stenhousem'r,6332,9,10,9,17,51,73,-22,39
Queen's Park,6332,10,10,8,18,34,60,-26,38
Livingston,6333,1,22,7,7,74,40,34,73
Alloa,6333,2,18,11,7,72,45,27,65
Brechin,6333,3,18,5,13,56,52,4,59
Airdrieon,6333,4,14,11,11,51,50,1,53
Peterhead,6333,5,13,8,15,54,56,-2,47
East Fife,6333,6,11,12,13,51,50,1,45
Albion,6333,7,10,11,15,55,58,-3,41
Stranraer,6333,8,11,6,19,48,60,-12,39
Stenhousem'r,6333,9,10,9,17,46,69,-23,39
Queen's Park,6333,10,9,8,19,39,66,-27,35
Livingston,6334,1,20,5,11,76,55,21,65
Alloa,6334,2,18,9,9,64,42,22,63
Brechin,6334,3,15,12,9,51,39,12,57
Albion,6334,4,14,8,14,50,49,1,50
Peterhead,6334,5,13,9,14,54,56,-2,48
Stranraer,6334,6,14,6,16,50,55,-5,48
East Fife,6334,7,13,7,16,42,43,-1,46
Airdrieon,6334,8,14,4,18,45,64,-19,46
Queen's Park,6334,9,12,9,15,39,43,-4,45
Stenhousem'r,6334,10,8,9,19,49,74,-25,33
Alloa,6335,1,18,6,12,62,49,13,60
Livingston,6335,2,17,7,12,79,55,24,58
Brechin,6335,3,16,8,12,58,48,10,56
Queen's Park,6335,4,17,4,15,44,51,-7,55
Airdrieon,6335,5,15,7,14,61,53,8,52
Peterhead,6335,6,15,7,14,43,51,-8,52
Albion,6335,7,14,9,13,55,57,-2,51
Stranraer,6335,8,12,8,16,51,55,-4,44
East Fife,6335,9,11,9,16,50,57,-7,42
Stenhousem'r,6335,10,9,7,20,47,74,-27,34
Alloa,6336,1,17,10,9,73,45,28,61
Livingston,6336,2,17,6,13,64,50,14,57
Brechin,6336,3,17,6,13,45,45,0,57
Stranraer,6336,4,15,8,13,43,44,-1,53
Albion,6336,5,13,10,13,43,40,3,49
Airdrieon,6336,6,14,7,15,55,58,-3,49
Peterhead,6336,7,13,7,16,42,52,-10,46
East Fife,6336,8,12,8,16,51,46,5,44
Queen's Park,6336,9,12,7,17,41,51,-10,43
Stenhousem'r,6336,10,12,7,17,49,75,-26,43
Livingston,6337,1,23,2,11,77,50,27,71
Alloa,6337,2,21,7,8,93,44,49,70
Albion,6337,3,16,9,11,59,50,9,57
Peterhead,6337,4,15,6,15,52,52,0,51
Brechin,6337,5,14,7,15,48,55,-7,49
Airdrieon,6337,6,14,6,16,51,57,-6,48
Stranraer,6337,7,14,5,17,46,61,-15,47
Queen's Park,6337,8,11,7,18,39,62,-23,40
East Fife,6337,9,10,8,18,44,52,-8,38
Stenhousem'r,6337,10,7,13,16,50,76,-26,34
Livingston,6338,1,22,4,10,82,49,33,70
Airdrieon,6338,2,20,6,10,59,46,13,66
Brechin,6338,3,18,8,10,60,50,10,62
Alloa,6338,4,18,7,11,65,49,16,61
Albion,6338,5,14,9,13,48,55,-7,51
East Fife,6338,6,12,8,16,48,42,6,44
Peterhead,6338,7,12,7,17,43,51,-8,43
Stranraer,6338,8,11,9,16,40,50,-10,42
Queen's Park,6338,9,10,9,17,38,53,-15,39
Stenhousem'r,6338,10,5,9,22,45,83,-38,24
Alloa,6339,1,22,7,7,79,41,38,73
Brechin,6339,2,21,8,7,64,42,22,71
Livingston,6339,3,17,9,10,72,47,25,60
Airdrieon,6339,4,15,9,12,58,54,4,54
Albion,6339,5,14,9,13,57,53,4,51
Peterhead,6339,6,13,8,15,50,56,-6,47
East Fife,6339,7,8,13,15,54,70,-16,37
Queen's Park,6339,8,9,10,17,41,62,-21,37
Stranraer,6339,9,8,11,17,46,64,-18,35
Stenhousem'r,6339,10,7,8,21,50,82,-32,29
Livingston,6340,1,24,3,9,80,48,32,75
Brechin,6340,2,17,9,10,46,36,10,60
Alloa,6340,3,16,10,10,64,45,19,58
Albion,6340,4,16,8,12,53,43,10,56
Airdrieon,6340,5,17,3,16,49,53,-4,54
Peterhead,6340,6,13,9,14,45,48,-3,48
East Fife,6340,7,11,9,16,49,55,-6,42
Queen's Park,6340,8,10,9,17,29,48,-19,39
Stenhousem'r,6340,9,11,4,21,53,76,-23,37
Stranraer,6340,10,10,6,20,44,60,-16,36
Alloa,6341,1,19,11,6,70,43,27,68
Airdrieon,6341,2,20,4,12,68,63,5,64
Livingston,6341,3,15,8,13,66,49,17,53
Brechin,6341,4,15,7,14,47,50,-3,52
Albion,6341,5,13,10,13,59,51,8,49
Peterhead,6341,6,14,7,15,49,59,-10,49
Queen's Park,6341,7,12,9,15,44,52,-8,45
East Fife,6341,8,9,17,10,52,51,1,44
Stranraer,6341,9,12,8,16,52,53,-1,44
Stenhousem'r,6341,10,6,9,21,46,82,-36,27
Alloa,6342,1,18,10,8,76,46,30,64
Livingston,6342,2,18,4,14,67,47,20,58
Airdrieon,6342,3,16,10,10,57,50,7,58
Brechin,6342,4,17,5,14,48,45,3,56
Peterhead,6342,5,16,8,12,57,58,-1,56
Queen's Park,6342,6,13,8,15,31,44,-13,47
Albion,6342,7,13,7,16,59,57,2,46
East Fife,6342,8,12,7,17,46,48,-2,43
Stranraer,6342,9,12,5,19,44,57,-13,41
Stenhousem'r,6342,10,8,10,18,45,78,-33,34
Livingston,6343,1,21,7,8,76,47,29,70
Albion,6343,2,17,7,12,67,52,15,58
Alloa,6343,3,16,10,10,59,48,11,58
Airdrieon,6343,4,17,6,13,60,54,6,57
Brechin,6343,5,15,9,12,49,50,-1,54
East Fife,6343,6,11,13,12,49,43,6,46
Peterhead,6343,7,13,7,16,50,57,-7,46
Stranraer,6343,8,12,5,19,45,56,-11,41
Stenhousem'r,6343,9,9,9,18,48,71,-23,36
Queen's Park,6343,10,10,5,21,28,53,-25,35
Alloa,6344,1,23,6,7,77,40,37,75
Livingston,6344,2,20,6,10,85,48,37,66
Brechin,6344,3,16,8,12,52,42,10,56
Airdrieon,6344,4,14,9,13,56,58,-2,51
Albion,6344,5,14,8,14,55,56,-1,50
Queen's Park,6344,6,14,8,14,43,47,-4,50
Peterhead,6344,7,12,10,14,49,54,-5,46
Stranraer,6344,8,12,7,17,54,66,-12,43
East Fife,6344,9,10,11,15,40,52,-12,41
Stenhousem'r,6344,10,5,7,24,39,87,-48,22
Livingston,6345,1,21,7,8,80,48,32,70
Alloa,6345,2,19,9,8,72,41,31,66
Airdrieon,6345,3,19,7,10,69,51,18,64
Albion,6345,4,14,10,12,63,54,9,52
Brechin,6345,5,14,8,14,42,49,-7,50
Peterhead,6345,6,14,5,17,45,54,-9,47
East Fife,6345,7,12,7,17,47,56,-9,43
Stranraer,6345,8,11,6,19,44,60,-16,39
Stenhousem'r,6345,9,10,7,19,54,79,-25,37
Queen's Park,6345,10,10,6,20,33,57,-24,36
Livingston,6346,1,25,2,9,81,56,25,77
Alloa,6346,2,19,4,13,78,50,28,61
Airdrieon,6346,3,17,6,13,61,54,7,57
Brechin,6346,4,16,5,15,51,58,-7,53
Albion,6346,5,14,8,14,57,57,0,50
East Fife,6346,6,13,9,14,55,46,9,48
Peterhead,6346,7,13,7,16,52,56,-4,46
Queen's Park,6346,8,12,10,14,35,46,-11,46
Stranraer,6346,9,11,3,22,41,63,-22,36
Stenhousem'r,6346,10,10,6,20,50,75,-25,36
Alloa,6347,1,21,6,9,72,48,24,69
Airdrieon,6347,2,18,4,14,67,59,8,58
Queen's Park,6347,3,17,6,13,39,35,4,57
East Fife,6347,4,15,10,11,59,44,15,55
Livingston,6347,5,16,6,14,71,56,15,54
Brechin,6347,6,16,6,14,49,47,2,54
Albion,6347,7,14,8,14,60,55,5,50
Peterhead,6347,8,14,6,16,56,58,-2,48
Stranraer,6347,9,13,5,18,43,56,-13,44
Stenhousem'r,6347,10,5,5,26,39,97,-58,20
Livingston,6348,1,22,6,8,79,45,34,72
Brechin,6348,2,18,5,13,59,47,12,59
Alloa,6348,3,17,6,13,63,51,12,57
Queen's Park,6348,4,15,10,11,37,37,0,55
Peterhead,6348,5,14,10,12,50,48,2,52
Albion,6348,6,14,9,13,54,60,-6,51
Airdrieon,6348,7,13,11,12,59,62,-3,50
Stenhousem'r,6348,8,9,10,17,49,67,-18,37
East Fife,6348,9,6,14,16,48,56,-8,32
Stranraer,6348,10,8,7,21,48,73,-25,31
Airdrieon,6349,1,21,5,10,71,48,23,68
Livingston,6349,2,20,6,10,77,50,27,66
Alloa,6349,3,17,8,11,71,52,19,59
Albion,6349,4,17,8,11,64,46,18,59
Brechin,6349,5,16,4,16,49,57,-8,52
Peterhead,6349,6,14,7,15,53,56,-3,49
Stranraer,6349,7,13,7,16,54,58,-4,46
Queen's Park,6349,8,13,7,16,43,57,-14,46
East Fife,6349,9,11,6,19,44,59,-15,39
Stenhousem'r,6349,10,5,8,23,43,86,-43,23
Livingston,6350,1,24,2,10,75,44,31,74
Airdrieon,6350,2,20,6,10,73,49,24,66
Alloa,6350,3,19,7,10,63,40,23,64
Brechin,6350,4,17,6,13,57,48,9,57
Peterhead,6350,5,14,8,14,49,49,0,50
Albion,6350,6,12,8,16,54,57,-3,44
East Fife,6350,7,11,10,15,53,51,2,43
Queen's Park,6350,8,12,7,17,44,60,-16,43
Stranraer,6350,9,11,7,18,47,60,-13,40
Stenhousem'r,6350,10,6,7,23,47,104,-57,25
Alloa,6351,1,25,4,7,83,42,41,79
Livingston,6351,2,22,3,11,73,44,29,69
Airdrieon,6351,3,15,6,15,49,51,-2,51
Brechin,6351,4,15,6,15,45,50,-5,51
Albion,6351,5,13,11,12,61,55,6,50
East Fife,6351,6,13,9,14,52,45,7,48
Peterhead,6351,7,11,12,13,45,51,-6,45
Stranraer,6351,8,13,4,19,47,58,-11,43
Queen's Park,6351,9,10,7,19,34,59,-25,37
Stenhousem'r,6351,10,8,8,20,39,73,-34,32
Alloa,6352,1,20,6,10,70,44,26,66
Livingston,6352,2,20,5,11,76,56,20,65
Airdrieon,6352,3,17,8,11,60,47,13,59
Brechin,6352,4,17,4,15,50,51,-1,55
Stranraer,6352,5,17,3,16,53,55,-2,54
East Fife,6352,6,14,8,14,61,47,14,50
Peterhead,6352,7,12,9,15,48,55,-7,45
Queen's Park,6352,8,10,8,18,38,57,-19,38
Stenhousem'r,6352,9,9,10,17,42,67,-25,37
Albion,6352,10,9,9,18,41,60,-19,36
Livingston,6353,1,22,5,9,71,44,27,71
Airdrieon,6353,2,20,5,11,63,47,16,65
Albion,6353,3,18,6,12,54,40,14,60
Alloa,6353,4,15,9,12,76,52,24,54
Brechin,6353,5,15,6,15,53,60,-7,51
East Fife,6353,6,12,9,15,50,48,2,45
Queen's Park,6353,7,11,12,13,41,48,-7,45
Peterhead,6353,8,10,10,16,36,49,-13,40
Stranraer,6353,9,12,3,21,41,64,-23,39
Stenhousem'r,6353,10,9,7,20,53,86,-33,34
Livingston,6354,1,24,3,9,90,46,44,75
Alloa,6354,2,21,6,9,70,43,27,69
Brechin,6354,3,19,3,14,49,49,0,60
Airdrieon,6354,4,17,7,12,58,55,3,58
Peterhead,6354,5,13,10,13,55,55,0,49
Albion,6354,6,12,9,15,54,58,-4,45
Stranraer,6354,7,13,4,19,48,60,-12,43
Queen's Park,6354,8,11,6,19,33,51,-18,39
East Fife,6354,9,8,11,17,40,55,-15,35
Stenhousem'r,6354,10,10,5,21,54,79,-25,35
Livingston,6355,1,22,5,9,82,51,31,71
Albion,6355,2,18,8,10,67,46,21,62
Alloa,6355,3,18,7,11,69,48,21,61
Airdrieon,6355,4,17,8,11,60,53,7,59
Peterhead,6355,5,13,8,15,51,60,-9,47
Stranraer,6355,6,14,3,19,47,55,-8,45
Queen's Park,6355,7,13,6,17,39,54,-15,45
East Fife,6355,8,9,14,13,46,46,0,41
Brechin,6355,9,11,6,19,42,57,-15,39
Stenhousem'r,6355,10,9,7,20,44,77,-33,34
Alloa,6356,1,20,7,9,71,46,25,67
Queen's Park,6356,2,17,6,13,44,42,2,57
Airdrieon,6356,3,17,5,14,56,55,1,56
Brechin,6356,4,17,5,14,43,46,-3,56
Livingston,6356,5,17,4,15,60,50,10,55
Albion,6356,6,16,6,14,53,47,6,54
Peterhead,6356,7,14,9,13,52,46,6,51
Stranraer,6356,8,13,4,19,44,59,-15,43
East Fife,6356,9,10,9,17,44,43,1,39
Stenhousem'r,6356,10,8,7,21,47,80,-33,31
Livingston,6357,1,24,4,8,89,46,43,76
Alloa,6357,2,22,8,6,79,41,38,74
Airdrieon,6357,3,17,6,13,56,55,1,57
Brechin,6357,4,15,8,13,46,45,1,53
Peterhead,6357,5,15,7,14,56,57,-1,52
Stranraer,6357,6,14,6,16,55,55,0,48
East Fife,6357,7,12,8,16,45,48,-3,44
Albion,6357,8,10,8,18,45,65,-20,38
Queen's Park,6357,9,9,8,19,33,53,-20,35
Stenhousem'r,6357,10,6,9,21,38,77,-39,27
Livingston,6358,1,21,8,7,78,44,34,71
Alloa,6358,2,20,9,7,75,39,36,69
Brechin,6358,3,18,7,11,51,41,10,61
Airdrieon,6358,4,16,8,12,56,44,12,56
East Fife,6358,5,12,10,14,56,52,4,46
Stranraer,6358,6,13,7,16,49,59,-10,46
Albion,6358,7,11,12,13,59,57,2,45
Queen's Park,6358,8,10,7,19,27,57,-30,37
Peterhead,6358,9,9,9,18,46,68,-22,36
Stenhousem'r,6358,10,7,9,20,52,88,-36,30
Livingston,6359,1,21,6,9,78,40,38,69
Alloa,6359,2,21,6,9,67,42,25,69
Airdrieon,6359,3,16,10,10,51,46,5,58
Brechin,6359,4,15,12,9,49,47,2,57
Queen's Park,6359,5,13,8,15,44,51,-7,47
East Fife,6359,6,13,7,16,57,55,2,46
Albion,6359,7,12,9,15,45,51,-6,45
Peterhead,6359,8,10,10,16,40,54,-14,40
Stranraer,6359,9,10,7,19,43,60,-17,37
Stenhousem'r,6359,10,7,9,20,49,77,-28,30
Livingston,6360,1,20,6,10,75,42,33,66
Brechin,6360,2,17,5,14,51,48,3,56
Alloa,6360,3,15,10,11,68,49,19,55
Albion,6360,4,16,7,13,60,54,6,55
East Fife,6360,5,15,8,13,55,50,5,53
Airdrieon,6360,6,14,11,11,51,50,1,53
Peterhead,6360,7,16,4,16,54,56,-2,52
Queen's Park,6360,8,12,7,17,38,52,-14,43
Stranraer,6360,9,11,5,20,50,69,-19,38
Stenhousem'r,6360,10,9,7,20,50,82,-32,34
Livingston,6361,1,21,8,7,79,51,28,71
Alloa,6361,2,16,8,12,63,45,18,56
Airdrieon,6361,3,16,7,13,59,48,11,55
Brechin,6361,4,14,9,13,55,57,-2,51
Peterhead,6361,5,14,7,15,59,56,3,49
Queen's Park,6361,6,14,7,15,41,56,-15,49
Albion,6361,7,12,12,12,46,47,-1,48
East Fife,6361,8,10,14,12,52,51,1,44
Stranraer,6361,9,11,4,21,44,63,-19,37
Stenhousem'r,6361,10,9,10,17,41,65,-24,37
Airdrieon,6362,1,23,6,7,78,48,30,75
Livingston,6362,2,20,5,11,84,55,29,65
Alloa,6362,3,19,8,9,74,45,29,65
Albion,6362,4,14,10,12,51,56,-5,52
Peterhead,6362,5,15,6,15,58,56,2,51
Brechin,6362,6,13,11,12,47,51,-4,50
East Fife,6362,7,9,10,17,48,49,-1,37
Queen's Park,6362,8,8,12,16,35,57,-22,36
Stranraer,6362,9,7,12,17,44,69,-25,33
Stenhousem'r,6362,10,8,8,20,46,79,-33,32
Alloa,6363,1,21,8,7,79,44,35,71
Livingston,6363,2,21,5,10,74,45,29,68
Airdrieon,6363,3,20,4,12,64,48,16,64
Brechin,6363,4,15,10,11,53,46,7,55
Albion,6363,5,16,7,13,59,56,3,55
East Fife,6363,6,13,13,10,54,38,16,52
Stranraer,6363,7,10,9,17,49,63,-14,39
Peterhead,6363,8,9,11,16,46,58,-12,38
Queen's Park,6363,9,10,8,18,37,62,-25,38
Stenhousem'r,6363,10,5,5,26,44,99,-55,20
Livingston,6364,1,25,2,9,82,40,42,77
Alloa,6364,2,21,6,9,79,46,33,69
Peterhead,6364,3,16,6,14,68,62,6,54
Brechin,6364,4,15,8,13,58,59,-1,53
Airdrieon,6364,5,16,3,17,67,62,5,51
Albion,6364,6,14,7,15,45,56,-11,49
East Fife,6364,7,11,10,15,47,50,-3,43
Stenhousem'r,6364,8,12,6,18,57,81,-24,42
Queen's Park,6364,9,10,7,19,31,56,-25,37
Stranraer,6364,10,9,7,20,44,66,-22,34
Alloa,6365,1,20,9,7,72,37,35,69
Livingston,6365,2,19,5,12,68,45,23,62
East Fife,6365,3,15,10,11,57,40,17,55
Brechin,6365,4,15,9,12,56,57,-1,54
Queen's Park,6365,5,15,7,14,41,48,-7,52
Airdrieon,6365,6,16,3,17,54,56,-2,51
Peterhead,6365,7,12,7,17,54,60,-6,43
Albion,6365,8,12,7,17,48,59,-11,43
Stranraer,6365,9,13,4,19,49,63,-14,43
Stenhousem'r,6365,10,7,11,18,43,77,-34,32
Livingston,6366,1,19,6,11,70,48,22,63
Alloa,6366,2,19,5,12,71,43,28,62
Albion,6366,3,17,8,11,59,43,16,59
Stranraer,6366,4,17,6,13,55,51,4,57
Brechin,6366,5,15,7,14,42,50,-8,52
East Fife,6366,6,13,11,12,57,40,17,50
Peterhead,6366,7,13,7,16,44,56,-12,46
Airdrieon,6366,8,13,5,18,55,65,-10,44
Queen's Park,6366,9,10,7,19,34,53,-19,37
Stenhousem'r,6366,10,10,6,20,47,85,-38,36
Livingston,6367,1,19,8,9,79,51,28,65
Alloa,6367,2,19,6,11,76,45,31,63
East Fife,6367,3,15,8,13,48,42,6,53
Peterhead,6367,4,13,13,10,42,43,-1,52
Albion,6367,5,15,6,15,58,60,-2,51
Airdrieon,6367,6,13,9,14,52,59,-7,48
Brechin,6367,7,13,7,16,52,58,-6,46
Stranraer,6367,8,13,5,18,55,58,-3,44
Queen's Park,6367,9,10,9,17,38,58,-20,39
Stenhousem'r,6367,10,10,9,17,43,69,-26,39
Livingston,6368,1,21,7,8,72,42,30,70
Alloa,6368,2,19,9,8,62,40,22,66
Albion,6368,3,15,10,11,60,51,9,55
Airdrieon,6368,4,15,8,13,60,58,2,53
Stranraer,6368,5,15,5,16,60,58,2,50
Brechin,6368,6,14,8,14,41,44,-3,50
Peterhead,6368,7,12,10,14,48,55,-7,46
Queen's Park,6368,8,13,5,18,35,48,-13,44
East Fife,6368,9,10,8,18,44,51,-7,38
Stenhousem'r,6368,10,7,8,21,47,82,-35,29
Livingston,6369,1,20,7,9,84,60,24,67
Alloa,6369,2,17,8,11,61,47,14,59
Brechin,6369,3,16,10,10,56,51,5,58
Stranraer,6369,4,15,6,15,60,57,3,51
Peterhead,6369,5,15,4,17,54,58,-4,49
Queen's Park,6369,6,13,9,14,35,45,-10,48
Airdrieon,6369,7,13,8,15,52,58,-6,47
Albion,6369,8,12,10,14,53,54,-1,46
East Fife,6369,9,11,10,15,50,48,2,43
Stenhousem'r,6369,10,9,6,21,46,73,-27,33
Livingston,6370,1,22,6,8,90,51,39,72
Alloa,6370,2,21,6,9,70,39,31,69
Brechin,6370,3,17,3,16,58,49,9,54
Queen's Park,6370,4,16,5,15,47,52,-5,53
Peterhead,6370,5,14,8,14,47,51,-4,50
Albion,6370,6,12,10,14,51,56,-5,46
Airdrieon,6370,7,12,9,15,56,69,-13,45
East Fife,6370,8,10,9,17,42,54,-12,39
Stranraer,6370,9,11,6,19,47,64,-17,39
Stenhousem'r,6370,10,9,10,17,50,73,-23,37
Alloa,6371,1,20,7,9,69,46,23,67
Livingston,6371,2,19,6,11,71,46,25,63
East Fife,6371,3,16,8,12,56,46,10,56
Peterhead,6371,4,16,7,13,57,50,7,55
Airdrieon,6371,5,15,10,11,54,53,1,55
Brechin,6371,6,16,7,13,49,51,-2,55
Albion,6371,7,13,8,15,52,51,1,47
Stranraer,6371,8,12,6,18,53,65,-12,42
Queen's Park,6371,9,10,9,17,32,46,-14,39
Stenhousem'r,6371,10,5,8,23,41,80,-39,23
Livingston,6372,1,24,5,7,92,43,49,77
Alloa,6372,2,18,10,8,69,39,30,64
Brechin,6372,3,20,4,12,52,46,6,64
Airdrieon,6372,4,19,4,13,58,58,0,61
Queen's Park,6372,5,14,7,15,48,52,-4,49
Albion,6372,6,14,6,16,52,53,-1,48
Peterhead,6372,7,14,5,17,56,66,-10,47
East Fife,6372,8,12,8,16,53,59,-6,44
Stranraer,6372,9,11,5,20,50,55,-5,38
Stenhousem'r,6372,10,5,4,27,37,96,-59,19
Livingston,6373,1,23,3,10,72,49,23,72
Airdrieon,6373,2,18,7,11,59,49,10,61
Brechin,6373,3,16,10,10,51,50,1,58
Alloa,6373,4,15,9,12,65,51,14,54
Albion,6373,5,13,10,13,53,43,10,49
East Fife,6373,6,12,11,13,52,49,3,47
Stranraer,6373,7,14,4,18,53,60,-7,46
Peterhead,6373,8,11,12,13,44,50,-6,45
Queen's Park,6373,9,12,6,18,38,53,-15,42
Stenhousem'r,6373,10,6,8,22,38,71,-33,26
Alloa,6374,1,18,9,9,72,49,23,63
Livingston,6374,2,19,5,12,65,46,19,62
Brechin,6374,3,17,7,12,47,45,2,58
Airdrieon,6374,4,16,8,12,56,53,3,56
Queen's Park,6374,5,17,5,14,46,46,0,56
Stranraer,6374,6,13,6,17,60,67,-7,45
East Fife,6374,7,10,12,14,45,44,1,42
Albion,6374,8,11,9,16,45,51,-6,42
Peterhead,6374,9,11,9,16,39,46,-7,42
Stenhousem'r,6374,10,9,8,19,43,71,-28,35
Livingston,6375,1,23,5,8,75,46,29,74
Alloa,6375,2,19,6,11,74,50,24,63
Albion,6375,3,18,8,10,63,43,20,62
Airdrieon,6375,4,19,5,12,58,51,7,62
Stranraer,6375,5,16,4,16,56,49,7,52
Queen's Park,6375,6,14,5,17,35,48,-13,47
Peterhead,6375,7,13,6,17,52,60,-8,45
Brechin,6375,8,11,9,16,45,62,-17,42
East Fife,6375,9,10,5,21,48,60,-12,35
Stenhousem'r,6375,10,8,5,23,49,86,-37,29
Livingston,6376,1,21,6,9,74,43,31,69
Brechin,6376,2,20,6,10,56,34,22,66
Alloa,6376,3,18,7,11,63,43,20,61
Airdrieon,6376,4,17,9,10,56,52,4,60
Albion,6376,5,15,7,14,57,53,4,52
Peterhead,6376,6,12,7,17,49,57,-8,43
Queen's Park,6376,7,10,11,15,36,50,-14,41
Stranraer,6376,8,11,7,18,45,57,-12,40
East Fife,6376,9,9,9,18,45,56,-11,36
Stenhousem'r,6376,10,9,7,20,47,83,-36,34
Livingston,6377,1,20,7,9,77,46,31,67
Alloa,6377,2,19,9,8,73,39,34,66
Peterhead,6377,3,19,4,13,67,52,15,61
Airdrieon,6377,4,18,5,13,60,46,14,59
Brechin,6377,5,14,7,15,44,51,-7,49
Queen's Park,6377,6,14,6,16,46,55,-9,48
Albion,6377,7,12,10,14,51,55,-4,46
East Fife,6377,8,13,7,16,47,54,-7,46
Stranraer,6377,9,14,4,18,49,61,-12,46
Stenhousem'r,6377,10,6,3,27,42,97,-55,21
Brechin,6378,1,19,7,10,55,44,11,64
Livingston,6378,2,19,4,13,84,54,30,61
Queen's Park,6378,3,17,8,11,49,46,3,59
Airdrieon,6378,4,18,5,13,53,53,0,59
Alloa,6378,5,15,9,12,68,50,18,54
Peterhead,6378,6,14,7,15,51,54,-3,49
Albion,6378,7,12,8,16,44,54,-10,44
Stranraer,6378,8,10,9,17,49,65,-16,39
East Fife,6378,9,8,13,15,43,49,-6,37
Stenhousem'r,6378,10,10,6,20,52,79,-27,36
Livingston,6379,1,21,5,10,72,43,29,68
Airdrieon,6379,2,18,6,12,65,56,9,60
Albion,6379,3,16,11,9,58,42,16,59
Alloa,6379,4,16,10,10,61,44,17,58
Queen's Park,6379,5,13,10,13,41,48,-7,49
Brechin,6379,6,13,6,17,44,50,-6,45
Peterhead,6379,7,12,9,15,45,56,-11,45
East Fife,6379,8,11,9,16,47,49,-2,42
Stranraer,6379,9,12,6,18,46,60,-14,42
Stenhousem'r,6379,10,9,6,21,49,80,-31,33
Alloa,6380,1,19,8,9,67,44,23,65
Livingston,6380,2,20,4,12,72,52,20,64
Airdrieon,6380,3,18,6,12,73,62,11,60
East Fife,6380,4,13,13,10,58,40,18,52
Brechin,6380,5,13,9,14,51,49,2,48
Albion,6380,6,13,9,14,52,55,-3,48
Peterhead,6380,7,13,7,16,50,60,-10,46
Stranraer,6380,8,12,9,15,56,59,-3,45
Stenhousem'r,6380,9,10,7,19,44,75,-31,37
Queen's Park,6380,10,10,6,20,32,59,-27,36
Livingston,6381,1,21,6,9,77,40,37,69
Brechin,6381,2,21,5,10,61,44,17,68
Alloa,6381,3,17,11,8,70,45,25,62
Airdrieon,6381,4,16,7,13,55,50,5,55
East Fife,6381,5,14,9,13,48,41,7,51
Queen's Park,6381,6,13,7,16,44,53,-9,46
Albion,6381,7,11,11,14,55,61,-6,44
Stranraer,6381,8,10,8,18,42,54,-12,38
Peterhead,6381,9,10,5,21,35,63,-28,35
Stenhousem'r,6381,10,9,7,20,51,87,-36,34
Alloa,6382,1,19,9,8,75,46,29,66
Airdrieon,6382,2,18,11,7,61,45,16,65
Livingston,6382,3,16,10,10,72,50,22,58
Brechin,6382,4,13,13,10,53,44,9,52
Stranraer,6382,5,13,8,15,53,57,-4,47
Peterhead,6382,6,14,4,18,55,65,-10,46
Albion,6382,7,11,12,13,51,53,-2,45
Queen's Park,6382,8,9,14,13,35,51,-16,41
East Fife,6382,9,9,11,16,44,56,-12,38
Stenhousem'r,6382,10,7,10,19,42,74,-32,31
Livingston,6383,1,19,8,9,72,48,24,65
Alloa,6383,2,18,9,9,67,39,28,63
Brechin,6383,3,18,6,12,50,43,7,60
Airdrieon,6383,4,18,5,13,60,56,4,59
Stranraer,6383,5,13,8,15,58,60,-2,47
Queen's Park,6383,6,13,8,15,37,46,-9,47
Peterhead,6383,7,12,9,15,49,55,-6,45
Albion,6383,8,12,9,15,44,55,-11,45
East Fife,6383,9,12,8,16,49,48,1,44
Stenhousem'r,6383,10,8,4,24,38,74,-36,28
Livingston,6384,1,22,5,9,73,40,33,71
Alloa,6384,2,20,7,9,78,41,37,67
Airdrieon,6384,3,20,5,11,61,49,12,65
Albion,6384,4,17,9,10,58,49,9,60
Brechin,6384,5,16,6,14,49,46,3,54
East Fife,6384,6,13,8,15,57,48,9,47
Peterhead,6384,7,12,8,16,48,58,-10,44
Stranraer,6384,8,9,10,17,45,64,-19,37
Queen's Park,6384,9,9,7,20,33,54,-21,34
Stenhousem'r,6384,10,7,5,24,38,91,-53,26
Livingston,6385,1,22,7,7,85,47,38,73
Alloa,6385,2,15,14,7,68,45,23,59
Airdrieon,6385,3,17,6,13,62,56,6,57
Albion,6385,4,13,16,7,58,47,11,55
Brechin,6385,5,16,7,13,56,48,8,55
Queen's Park,6385,6,15,3,18,42,59,-17,48
Peterhead,6385,7,12,9,15,44,56,-12,45
East Fife,6385,8,10,7,19,41,46,-5,37
Stranraer,6385,9,9,8,19,47,63,-16,35
Stenhousem'r,6385,10,9,7,20,52,88,-36,34
Alloa,6386,1,20,6,10,73,42,31,66
Livingston,6386,2,19,6,11,74,48,26,63
Albion,6386,3,16,9,11,51,48,3,57
Airdrieon,6386,4,15,7,14,49,55,-6,52
Stranraer,6386,5,14,7,15,47,48,-1,49
Peterhead,6386,6,13,8,15,51,51,0,47
East Fife,6386,7,12,10,14,46,44,2,46
Queen's Park,6386,8,13,7,16,42,59,-17,46
Brechin,6386,9,12,9,15,53,57,-4,45
Stenhousem'r,6386,10,7,9,20,51,85,-34,30
Livingston,6387,1,24,2,10,80,48,32,74
Alloa,6387,2,17,8,11,66,46,20,59
Brechin,6387,3,16,7,13,54,49,5,55
East Fife,6387,4,15,7,14,52,52,0,52
Airdrieon,6387,5,14,10,12,53,57,-4,52
Peterhead,6387,6,13,8,15,55,54,1,47
Albion,6387,7,13,7,16,53,54,-1,46
Queen's Park,6387,8,13,7,16,42,50,-8,46
Stenhousem'r,6387,9,10,8,18,55,80,-25,38
Stranraer,6387,10,10,6,20,45,65,-20,36
Airdrieon,6388,1,20,8,8,65,45,20,68
Peterhead,6388,2,16,9,11,43,41,2,57
Albion,6388,3,15,7,14,50,42,8,52
Brechin,6388,4,15,7,14,53,46,7,52
Alloa,6388,5,13,12,11,58,47,11,51
Queen's Park,6388,6,14,9,13,44,49,-5,51
Livingston,6388,7,14,7,15,58,53,5,49
Stranraer,6388,8,13,6,17,51,55,-4,45
East Fife,6388,9,10,12,14,42,48,-6,42
Stenhousem'r,6388,10,8,7,21,38,76,-38,31
Livingston,6389,1,25,2,9,79,37,42,77
Alloa,6389,2,16,10,10,71,49,22,58
Brechin,6389,3,18,3,15,62,56,6,57
Airdrieon,6389,4,15,6,15,54,56,-2,51
Albion,6389,5,15,6,15,52,55,-3,51
Stranraer,6389,6,16,3,17,49,56,-7,51
Peterhead,6389,7,13,11,12,49,53,-4,50
Queen's Park,6389,8,14,6,16,37,48,-11,48
East Fife,6389,9,11,10,15,51,53,-2,43
Stenhousem'r,6389,10,5,7,24,42,83,-41,22
Livingston,6390,1,20,7,9,74,49,25,67
Airdrieon,6390,2,20,6,10,65,49,16,66
Alloa,6390,3,18,6,12,64,45,19,60
Brechin,6390,4,16,8,12,50,44,6,56
Queen's Park,6390,5,13,12,11,47,45,2,51
Stranraer,6390,6,13,6,17,55,64,-9,45
Albion,6390,7,12,8,16,47,54,-7,44
Peterhead,6390,8,12,7,17,52,60,-8,43
East Fife,6390,9,10,10,16,45,50,-5,40
Stenhousem'r,6390,10,7,8,21,41,80,-39,29
Livingston,6391,1,19,10,7,74,38,36,67
Albion,6391,2,19,7,10,74,56,18,64
Alloa,6391,3,18,7,11,70,49,21,61
Airdrieon,6391,4,14,10,12,51,50,1,52
East Fife,6391,5,14,8,14,52,54,-2,50
Brechin,6391,6,14,7,15,55,58,-3,49
Peterhead,6391,7,13,6,17,55,59,-4,45
Stranraer,6391,8,13,5,18,47,61,-14,44
Queen's Park,6391,9,10,6,20,34,57,-23,36
Stenhousem'r,6391,10,9,8,19,51,81,-30,35
Alloa,6392,1,18,9,9,69,46,23,63
Livingston,6392,2,19,5,12,74,46,28,62
Albion,6392,3,15,11,10,62,52,10,56
Stranraer,6392,4,17,4,15,65,61,4,55
Airdrieon,6392,5,16,6,14,53,64,-11,54
Brechin,6392,6,14,7,15,54,55,-1,49
Peterhead,6392,7,13,8,15,53,55,-2,47
Queen's Park,6392,8,14,5,17,48,59,-11,47
East Fife,6392,9,10,13,13,47,50,-3,43
Stenhousem'r,6392,10,5,10,21,36,73,-37,25
Livingston,6393,1,23,6,7,81,45,36,75
Peterhead,6393,2,18,8,10,59,47,12,62
Brechin,6393,3,17,8,11,66,53,13,59
Alloa,6393,4,14,10,12,57,49,8,52
Albion,6393,5,14,9,13,42,45,-3,51
Airdrieon,6393,6,15,6,15,56,60,-4,51
Stranraer,6393,7,15,5,16,60,64,-4,50
Queen's Park,6393,8,10,9,17,36,54,-18,39
East Fife,6393,9,9,10,17,46,56,-10,37
Stenhousem'r,6393,10,5,9,22,44,74,-30,24
Alloa,6394,1,21,7,8,81,40,41,70
Livingston,6394,2,18,7,11,60,42,18,61
Peterhead,6394,3,18,7,11,56,45,11,61
Brechin,6394,4,16,8,12,50,52,-2,56
Airdrieon,6394,5,17,5,14,53,58,-5,56
Albion,6394,6,14,8,14,52,49,3,50
Stranraer,6394,7,12,9,15,51,57,-6,45
Queen's Park,6394,8,13,5,18,39,56,-17,44
East Fife,6394,9,8,9,19,51,59,-8,33
Stenhousem'r,6394,10,7,7,22,46,81,-35,28
Alloa,6395,1,19,8,9,76,49,27,65
Livingston,6395,2,19,6,11,69,50,19,63
Queen's Park,6395,3,16,5,15,39,44,-5,53
Brechin,6395,4,14,10,12,47,51,-4,52
Albion,6395,5,15,6,15,57,62,-5,51
Airdrieon,6395,6,13,11,12,52,58,-6,50
Peterhead,6395,7,10,14,12,43,47,-4,44
Stenhousem'r,6395,8,11,8,17,43,65,-22,41
East Fife,6395,9,10,10,16,53,44,9,40
Stranraer,6395,10,11,6,19,60,69,-9,39
Livingston,6396,1,20,4,12,81,51,30,64
Airdrieon,6396,2,19,7,10,62,52,10,64
Alloa,6396,3,18,9,9,69,47,22,63
Albion,6396,4,19,5,12,61,51,10,62
East Fife,6396,5,14,7,15,53,51,2,49
Queen's Park,6396,6,14,7,15,39,49,-10,49
Stranraer,6396,7,13,8,15,53,58,-5,47
Brechin,6396,8,12,9,15,45,52,-7,45
Peterhead,6396,9,9,11,16,44,58,-14,38
Stenhousem'r,6396,10,5,7,24,35,73,-38,22
Livingston,6397,1,22,5,9,82,44,38,71
Brechin,6397,2,19,7,10,53,44,9,64
Alloa,6397,3,16,10,10,67,44,23,58
Airdrieon,6397,4,17,6,13,56,53,3,57
Albion,6397,5,13,10,13,54,56,-2,49
Peterhead,6397,6,13,8,15,49,57,-8,47
Queen's Park,6397,7,12,7,17,31,54,-23,43
Stranraer,6397,8,10,10,16,45,54,-9,40
East Fife,6397,9,10,9,17,46,48,-2,39
Stenhousem'r,6397,10,7,10,19,47,76,-29,31
Livingston,6398,1,23,4,9,75,48,27,73
Albion,6398,2,16,8,12,53,46,7,56
Stranraer,6398,3,16,6,14,63,62,1,54
Brechin,6398,4,17,2,17,48,43,5,53
Alloa,6398,5,14,9,13,63,51,12,51
Peterhead,6398,6,14,8,14,53,55,-2,50
Airdrieon,6398,7,13,7,16,60,67,-7,46
Queen's Park,6398,8,11,10,15,39,57,-18,43
East Fife,6398,9,11,7,18,48,54,-6,40
Stenhousem'r,6398,10,10,9,17,49,68,-19,39
Alloa,6399,1,21,8,7,78,45,33,71
Airdrieon,6399,2,19,8,9,75,50,25,65
Livingston,6399,3,17,5,14,74,62,12,56
Brechin,6399,4,16,8,12,48,48,0,56
Albion,6399,5,13,8,15,45,50,-5,47
Queen's Park,6399,6,12,8,16,42,56,-14,44
Stenhousem'r,6399,7,12,7,17,48,71,-23,43
East Fife,6399,8,11,9,16,48,53,-5,42
Peterhead,6399,9,9,12,15,42,54,-12,39
Stranraer,6399,10,11,5,20,47,58,-11,38
Livingston,6400,1,23,3,10,83,51,32,72
Alloa,6400,2,20,7,9,62,37,25,67
Albion,6400,3,18,8,10,66,44,22,62
Airdrieon,6400,4,17,7,12,58,55,3,58
Brechin,6400,5,17,5,14,49,50,-1,56
Stranraer,6400,6,15,7,14,59,59,0,52
Peterhead,6400,7,11,8,17,44,53,-9,41
East Fife,6400,8,9,9,18,40,50,-10,36
Queen's Park,6400,9,8,11,17,28,49,-21,35
Stenhousem'r,6400,10,6,7,23,42,83,-41,25
Livingston,6401,1,24,5,7,87,47,40,77
Airdrieon,6401,2,18,7,11,64,50,14,61
Alloa,6401,3,16,8,12,60,47,13,56
Brechin,6401,4,16,7,13,60,52,8,55
Albion,6401,5,15,9,12,70,54,16,54
East Fife,6401,6,15,5,16,48,54,-6,50
Queen's Park,6401,7,12,8,16,37,54,-17,44
Peterhead,6401,8,11,5,20,46,66,-20,38
Stranraer,6401,9,10,7,19,49,63,-14,37
Stenhousem'r,6401,10,9,7,20,44,78,-34,34
Airdrieon,6402,1,20,9,7,73,49,24,69
Livingston,6402,2,20,8,8,78,46,32,68
Brechin,6402,3,18,4,14,52,50,2,58
Alloa,6402,4,15,12,9,71,52,19,57
Peterhead,6402,5,16,7,13,55,58,-3,55
Albion,6402,6,15,7,14,51,48,3,52
Stranraer,6402,7,12,10,14,59,65,-6,46
East Fife,6402,8,10,9,17,50,56,-6,39
Queen's Park,6402,9,9,8,19,34,54,-20,35
Stenhousem'r,6402,10,6,4,26,39,84,-45,22
Livingston,6403,1,23,3,10,81,45,36,72
Alloa,6403,2,20,7,9,69,41,28,67
Airdrieon,6403,3,20,5,11,65,55,10,65
Brechin,6403,4,16,5,15,47,50,-3,53
Albion,6403,5,15,7,14,57,57,0,52
Peterhead,6403,6,15,4,17,52,58,-6,49
Queen's Park,6403,7,15,3,18,39,48,-9,48
East Fife,6403,8,10,12,14,49,44,5,42
Stranraer,6403,9,12,4,20,54,63,-9,40
Stenhousem'r,6403,10,5,8,23,36,88,-52,23
Alloa,6404,1,21,7,8,63,37,26,70
Brechin,6404,2,20,6,10,67,46,21,66
Airdrieon,6404,3,19,6,11,73,53,20,63
Livingston,6404,4,17,7,12,68,47,21,58
East Fife,6404,5,14,6,16,54,57,-3,48
Queen's Park,6404,6,14,3,19,32,44,-12,45
Stranraer,6404,7,14,2,20,45,62,-17,44
Albion,6404,8,11,9,16,44,56,-12,42
Peterhead,6404,9,10,9,17,41,54,-13,39
Stenhousem'r,6404,10,9,7,20,43,74,-31,34
Livingston,6405,1,19,6,11,79,48,31,63
Peterhead,6405,2,18,8,10,52,42,10,62
Queen's Park,6405,3,16,10,10,44,44,0,58
Alloa,6405,4,14,11,11,62,47,15,53
Brechin,6405,5,15,6,15,48,62,-14,51
Airdrieon,6405,6,15,5,16,63,69,-6,50
Albion,6405,7,9,14,13,52,53,-1,41
Stenhousem'r,6405,8,10,10,16,59,79,-20,40
Stranraer,6405,9,10,9,17,46,57,-11,39
East Fife,6405,10,8,13,15,41,45,-4,37
Alloa,6406,1,21,5,10,69,41,28,68
Airdrieon,6406,2,20,5,11,66,57,9,65
Livingston,6406,3,18,6,12,82,64,18,60
Albion,6406,4,15,6,15,52,54,-2,51
Stranraer,6406,5,14,8,14,56,53,3,50
Brechin,6406,6,13,9,14,51,53,-2,48
Peterhead,6406,7,12,11,13,53,57,-4,47
Queen's Park,6406,8,14,4,18,44,57,-13,46
East Fife,6406,9,9,10,17,47,51,-4,37
Stenhousem'r,6406,10,9,6,21,55,88,-33,33
Livingston,6407,1,19,6,11,79,52,27,63
Stranraer,6407,2,18,5,13,66,57,9,59
Brechin,6407,3,18,5,13,55,53,2,59
Alloa,6407,4,17,7,12,66,55,11,58
Airdrieon,6407,5,15,9,12,56,53,3,54
East Fife,6407,6,14,11,11,56,46,10,53
Queen's Park,6407,7,11,7,18,43,54,-11,40
Peterhead,6407,8,10,10,16,49,67,-18,40
Albion,6407,9,10,9,17,48,66,-18,39
Stenhousem'r,6407,10,8,11,17,48,63,-15,35
Livingston,6408,1,22,4,10,74,36,38,70
Alloa,6408,2,18,9,9,72,42,30,63
Airdrieon,6408,3,18,7,11,66,58,8,61
Brechin,6408,4,17,9,10,57,45,12,60
Albion,6408,5,17,7,12,59,53,6,58
Peterhead,6408,6,10,14,12,45,50,-5,44
Queen's Park,6408,7,12,7,17,45,65,-20,43
East Fife,6408,8,10,12,14,48,52,-4,42
Stenhousem'r,6408,9,7,8,21,45,85,-40,29
Stranraer,6408,10,7,7,22,39,64,-25,28
Airdrieon,6409,1,23,4,9,66,44,22,73
Alloa,6409,2,21,5,10,72,43,29,68
Livingston,6409,3,19,6,11,73,50,23,63
Brechin,6409,4,18,7,11,57,46,11,61
Albion,6409,5,14,8,14,52,53,-1,50
Queen's Park,6409,6,14,6,16,43,50,-7,48
East Fife,6409,7,13,8,15,52,50,2,47
Peterhead,6409,8,11,7,18,46,54,-8,40
Stranraer,6409,9,11,6,19,46,63,-17,39
Stenhousem'r,6409,10,4,7,25,38,92,-54,19
Livingston,6410,1,25,4,7,94,44,50,79
Brechin,6410,2,20,6,10,61,42,19,66
Airdrieon,6410,3,20,6,10,64,48,16,66
Alloa,6410,4,16,7,13,62,53,9,55
Peterhead,6410,5,14,5,17,48,59,-11,47
East Fife,6410,6,12,8,16,48,43,5,44
Albion,6410,7,12,6,18,48,63,-15,42
Stranraer,6410,8,11,7,18,48,64,-16,40
Stenhousem'r,6410,9,9,11,16,48,78,-30,38
Queen's Park,6410,10,8,6,22,24,51,-27,30
Alloa,6411,1,21,9,6,68,34,34,72
Livingston,6411,2,21,2,13,72,52,20,65
Airdrieon,6411,3,20,3,13,66,48,18,63
Brechin,6411,4,17,8,11,55,48,7,59
East Fife,6411,5,13,8,15,59,52,7,47
Peterhead,6411,6,13,8,15,47,52,-5,47
Albion,6411,7,11,12,13,51,54,-3,45
Queen's Park,6411,8,11,8,17,34,53,-19,41
Stranraer,6411,9,10,5,21,42,63,-21,35
Stenhousem'r,6411,10,8,7,21,37,75,-38,31
Alloa,6412,1,18,10,8,77,50,27,64
Livingston,6412,2,20,4,12,71,54,17,64
Brechin,6412,3,19,7,10,56,41,15,64
Airdrieon,6412,4,17,5,14,68,62,6,56
Peterhead,6412,5,15,10,11,54,49,5,55
East Fife,6412,6,11,12,13,55,55,0,45
Queen's Park,6412,7,12,9,15,40,51,-11,45
Albion,6412,8,11,9,16,49,58,-9,42
Stranraer,6412,9,9,9,18,49,67,-18,36
Stenhousem'r,6412,10,6,9,21,55,87,-32,27
Livingston,6413,1,18,7,11,70,52,18,61
Airdrieon,6413,2,15,11,10,63,56,7,56
Queen's Park,6413,3,15,10,11,44,43,1,55
Albion,6413,4,15,9,12,67,52,15,54
Peterhead,6413,5,14,12,10,52,45,7,54
Alloa,6413,6,13,14,9,70,47,23,53
Brechin,6413,7,15,8,13,46,52,-6,53
East Fife,6413,8,11,9,16,49,50,-1,42
Stranraer,6413,9,13,2,21,47,61,-14,41
Stenhousem'r,6413,10,6,8,22,46,96,-50,26
Livingston,6414,1,23,5,8,82,42,40,74
Alloa,6414,2,22,5,9,83,44,39,71
Brechin,6414,3,17,10,9,64,53,11,61
Peterhead,6414,4,13,9,14,49,65,-16,48
East Fife,6414,5,12,9,15,53,52,1,45
Airdrieon,6414,6,12,9,15,58,65,-7,45
Queen's Park,6414,7,12,8,16,36,49,-13,44
Stranraer,6414,8,12,6,18,55,72,-17,42
Albion,6414,9,9,10,17,49,61,-12,37
Stenhousem'r,6414,10,9,7,20,50,76,-26,34
Livingston,6415,1,22,4,10,84,42,42,70
Alloa,6415,2,19,6,11,78,45,33,63
Airdrieon,6415,3,19,6,11,64,54,10,63
Albion,6415,4,15,12,9,63,50,13,57
Brechin,6415,5,16,7,13,63,58,5,55
Queen's Park,6415,6,11,8,17,34,52,-18,41
Stranraer,6415,7,12,5,19,53,72,-19,41
Peterhead,6415,8,11,7,18,40,68,-28,40
Stenhousem'r,6415,9,10,8,18,51,73,-22,38
East Fife,6415,10,9,9,18,45,61,-16,36
Livingston,6416,1,20,8,8,78,43,35,68
Alloa,6416,2,18,7,11,66,45,21,61
Airdrieon,6416,3,17,8,11,60,51,9,59
Brechin,6416,4,17,6,13,58,48,10,57
East Fife,6416,5,14,8,14,54,48,6,50
Queen's Park,6416,6,14,7,15,41,55,-14,49
Peterhead,6416,7,13,8,15,42,52,-10,47
Albion,6416,8,11,8,17,46,56,-10,41
Stenhousem'r,6416,9,9,9,18,45,77,-32,36
Stranraer,6416,10,9,7,20,46,61,-15,34
Livingston,6417,1,23,5,8,80,40,40,74
Alloa,6417,2,20,10,6,79,44,35,70
Brechin,6417,3,17,9,10,51,41,10,60
Airdrieon,6417,4,16,7,13,54,48,6,55
Albion,6417,5,12,15,9,48,41,7,51
Peterhead,6417,6,14,8,14,46,52,-6,50
Queen's Park,6417,7,11,7,18,36,56,-20,40
East Fife,6417,8,10,7,19,51,57,-6,37
Stranraer,6417,9,8,8,20,37,66,-29,32
Stenhousem'r,6417,10,7,8,21,41,78,-37,29
Livingston,6418,1,24,3,9,87,47,40,75
Airdrieon,6418,2,20,5,11,65,49,16,65
Alloa,6418,3,16,10,10,58,50,8,58
Albion,6418,4,14,8,14,51,45,6,50
Brechin,6418,5,15,5,16,48,51,-3,50
East Fife,6418,6,13,10,13,55,44,11,49
Peterhead,6418,7,14,6,16,47,59,-12,48
Stranraer,6418,8,12,8,16,47,48,-1,44
Queen's Park,6418,9,13,3,20,35,55,-20,42
Stenhousem'r,6418,10,8,4,24,40,85,-45,28
Airdrieon,6419,1,20,7,9,65,51,14,67
Livingston,6419,2,19,3,14,69,47,22,60
Alloa,6419,3,18,5,13,69,51,18,59
Stranraer,6419,4,15,7,14,58,60,-2,52
Albion,6419,5,14,8,14,54,52,2,50
Brechin,6419,6,13,11,12,53,52,1,50
Peterhead,6419,7,12,9,15,43,47,-4,45
East Fife,6419,8,12,8,16,45,46,-1,44
Queen's Park,6419,9,12,5,19,31,51,-20,41
Stenhousem'r,6419,10,9,9,18,47,77,-30,36
Alloa,6420,1,20,7,9,77,43,34,67
Livingston,6420,2,18,5,13,73,51,22,59
Airdrieon,6420,3,16,9,11,57,49,8,57
Stranraer,6420,4,15,7,14,51,49,2,52
East Fife,6420,5,14,8,14,58,56,2,50
Queen's Park,6420,6,14,7,15,41,53,-12,49
Albion,6420,7,11,15,10,55,54,1,48
Brechin,6420,8,13,9,14,47,55,-8,48
Peterhead,6420,9,11,10,15,52,61,-9,43
Stenhousem'r,6420,10,4,11,21,48,88,-40,23
Brechin,6421,1,22,4,10,57,40,17,70
Livingston,6421,2,18,7,11,64,41,23,61
Alloa,6421,3,15,10,11,60,43,17,55
Airdrieon,6421,4,15,9,12,50,46,4,54
Albion,6421,5,16,6,14,50,48,2,54
Stranraer,6421,6,13,12,11,56,53,3,51
East Fife,6421,7,13,9,14,49,50,-1,48
Peterhead,6421,8,11,13,12,57,51,6,46
Queen's Park,6421,9,11,6,19,37,54,-17,39
Stenhousem'r,6421,10,4,8,24,39,93,-54,20
Alloa,6422,1,18,9,9,63,42,21,63
Airdrieon,6422,2,19,6,11,54,45,9,63
Livingston,6422,3,17,4,15,64,52,12,55
Albion,6422,4,16,7,13,57,52,5,55
Peterhead,6422,5,15,7,14,54,52,2,52
Brechin,6422,6,15,4,17,54,57,-3,49
Queen's Park,6422,7,13,7,16,34,46,-12,46
Stranraer,6422,8,13,6,17,45,55,-10,45
East Fife,6422,9,12,7,17,49,48,1,43
Stenhousem'r,6422,10,10,7,19,48,73,-25,37
Alloa,6423,1,24,5,7,87,36,51,77
Livingston,6423,2,20,6,10,81,60,21,66
Brechin,6423,3,17,8,11,53,46,7,59
Airdrieon,6423,4,14,9,13,63,62,1,51
Peterhead,6423,5,14,7,15,56,62,-6,49
Albion,6423,6,13,8,15,57,57,0,47
Stenhousem'r,6423,7,12,7,17,47,74,-27,43
Stranraer,6423,8,12,5,19,55,68,-13,41
Queen's Park,6423,9,10,7,19,35,59,-24,37
East Fife,6423,10,10,6,20,44,54,-10,36
Livingston,6424,1,21,6,9,76,44,32,69
Alloa,6424,2,19,10,7,81,44,37,67
Brechin,6424,3,16,7,13,49,41,8,55
Airdrieon,6424,4,14,10,12,49,58,-9,52
East Fife,6424,5,13,12,11,52,38,14,51
Peterhead,6424,6,13,8,15,42,51,-9,47
Albion,6424,7,12,9,15,54,56,-2,45
Stranraer,6424,8,12,5,19,59,72,-13,41
Stenhousem'r,6424,9,10,8,18,49,76,-27,38
Queen's Park,6424,10,10,5,21,32,63,-31,35
Livingston,6425,1,23,7,6,84,43,41,76
Alloa,6425,2,18,9,9,63,45,18,63
Airdrieon,6425,3,15,8,13,57,56,1,53
Albion,6425,4,14,7,15,59,48,11,49
Brechin,6425,5,14,7,15,55,64,-9,49
Peterhead,6425,6,12,8,16,50,52,-2,44
Queen's Park,6425,7,13,5,18,42,57,-15,44
Stranraer,6425,8,12,8,16,43,59,-16,44
East Fife,6425,9,11,10,15,43,43,0,43
Stenhousem'r,6425,10,9,9,18,51,80,-29,36
Alloa,6426,1,21,9,6,74,42,32,72
Livingston,6426,2,20,6,10,81,49,32,66
Airdrieon,6426,3,15,9,12,64,59,5,54
Brechin,6426,4,14,8,14,53,52,1,50
Stranraer,6426,5,12,11,13,55,56,-1,47
Queen's Park,6426,6,11,12,13,40,47,-7,45
Albion,6426,7,12,8,16,47,63,-16,44
Peterhead,6426,8,10,11,15,50,58,-8,41
Stenhousem'r,6426,9,10,9,17,47,74,-27,39
East Fife,6426,10,7,13,16,40,51,-11,34
Livingston,6427,1,22,3,11,82,46,36,69
Alloa,6427,2,22,3,11,73,52,21,69
Airdrieon,6427,3,18,6,12,64,52,12,60
Queen's Park,6427,4,17,6,13,52,51,1,57
Albion,6427,5,14,9,13,66,57,9,51
Peterhead,6427,6,15,6,15,48,49,-1,51
Brechin,6427,7,14,7,15,51,58,-7,49
East Fife,6427,8,10,11,15,45,51,-6,41
Stranraer,6427,9,8,10,18,51,66,-15,34
Stenhousem'r,6427,10,6,7,23,47,97,-50,25
Livingston,6428,1,21,5,10,74,51,23,68
Alloa,6428,2,20,7,9,71,44,27,67
Queen's Park,6428,3,17,6,13,45,45,0,57
Airdrieon,6428,4,16,7,13,66,59,7,55
Brechin,6428,5,16,5,15,44,46,-2,53
Peterhead,6428,6,14,8,14,58,59,-1,50
Albion,6428,7,14,7,15,56,55,1,49
East Fife,6428,8,10,9,17,46,54,-8,39
Stranraer,6428,9,11,5,20,55,72,-17,38
Stenhousem'r,6428,10,8,7,21,48,78,-30,31
Alloa,6429,1,19,10,7,72,45,27,67
Livingston,6429,2,19,3,14,71,49,22,60
Airdrieon,6429,3,17,8,11,72,58,14,59
Brechin,6429,4,18,4,14,63,57,6,58
Peterhead,6429,5,17,6,13,59,48,11,57
Albion,6429,6,14,8,14,52,55,-3,50
Queen's Park,6429,7,12,7,17,46,67,-21,43
East Fife,6429,8,11,7,18,53,55,-2,40
Stranraer,6429,9,11,7,18,48,65,-17,40
Stenhousem'r,6429,10,8,8,20,40,77,-37,32
Livingston,6430,1,22,5,9,77,45,32,71
Alloa,6430,2,20,6,10,79,43,36,66
Brechin,6430,3,20,6,10,54,36,18,66
Airdrieon,6430,4,19,8,9,58,45,13,65
Stranraer,6430,5,14,6,16,55,56,-1,48
Albion,6430,6,13,9,14,52,61,-9,48
Queen's Park,6430,7,13,3,20,38,51,-13,42
Peterhead,6430,8,11,7,18,42,63,-21,40
East Fife,6430,9,9,10,17,48,51,-3,37
Stenhousem'r,6430,10,5,8,23,45,97,-52,23
Brechin,6431,1,24,3,9,58,37,21,75
Livingston,6431,2,19,7,10,87,52,35,64
Peterhead,6431,3,15,11,10,59,55,4,56
Airdrieon,6431,4,15,7,14,58,66,-8,52
Albion,6431,5,13,10,13,47,43,4,49
Queen's Park,6431,6,12,11,13,45,58,-13,47
Alloa,6431,7,10,12,14,59,62,-3,42
East Fife,6431,8,10,11,15,50,54,-4,41
Stranraer,6431,9,11,7,18,61,67,-6,40
Stenhousem'r,6431,10,6,11,19,48,78,-30,29
Livingston,6432,1,22,3,11,79,40,39,69
Alloa,6432,2,19,6,11,74,53,21,63
Brechin,6432,3,17,7,12,55,49,6,58
Airdrieon,6432,4,16,7,13,58,58,0,55
Queen's Park,6432,5,15,7,14,43,48,-5,52
Stranraer,6432,6,16,3,17,55,57,-2,51
East Fife,6432,7,13,10,13,50,47,3,49
Peterhead,6432,8,12,10,14,45,51,-6,46
Albion,6432,9,10,8,18,51,68,-17,38
Stenhousem'r,6432,10,6,7,23,46,85,-39,25
Alloa,6433,1,21,7,8,83,45,38,70
Livingston,6433,2,20,7,9,79,50,29,67
Brechin,6433,3,19,9,8,63,47,16,66
Airdrieon,6433,4,15,11,10,62,56,6,56
Stranraer,6433,5,13,7,16,48,55,-7,46
Albion,6433,6,11,10,15,43,56,-13,43
Peterhead,6433,7,11,10,15,48,65,-17,43
Queen's Park,6433,8,10,10,16,42,59,-17,40
East Fife,6433,9,10,9,17,52,50,2,39
Stenhousem'r,6433,10,6,8,22,43,80,-37,26
Livingston,6434,1,22,4,10,72,44,28,70
Alloa,6434,2,19,10,7,72,44,28,67
Albion,6434,3,17,7,12,49,42,7,58
Peterhead,6434,4,14,12,10,50,47,3,54
Brechin,6434,5,14,10,12,43,41,2,52
Airdrieon,6434,6,14,9,13,53,49,4,51
Queen's Park,6434,7,12,7,17,33,50,-17,43
East Fife,6434,8,10,12,14,47,44,3,42
Stranraer,6434,9,12,5,19,52,58,-6,41
Stenhousem'r,6434,10,5,6,25,36,88,-52,21
Livingston,6435,1,20,7,9,68,39,29,67
Alloa,6435,2,15,12,9,59,40,19,57
Peterhead,6435,3,15,10,11,54,45,9,55
Stranraer,6435,4,16,6,14,55,54,1,54
Airdrieon,6435,5,14,10,12,61,64,-3,52
Brechin,6435,6,14,9,13,41,43,-2,51
Queen's Park,6435,7,11,10,15,37,46,-9,43
Albion,6435,8,11,10,15,47,59,-12,43
East Fife,6435,9,10,11,15,46,47,-1,41
Stenhousem'r,6435,10,8,7,21,49,80,-31,31
Alloa,6436,1,19,8,9,64,40,24,65
Livingston,6436,2,20,5,11,69,48,21,65
Brechin,6436,3,18,7,11,58,48,10,61
Airdrieon,6436,4,15,10,11,62,58,4,55
Albion,6436,5,16,6,14,56,49,7,54
Queen's Park,6436,6,13,6,17,47,54,-7,45
East Fife,6436,7,12,8,16,50,50,0,44
Peterhead,6436,8,11,7,18,48,63,-15,40
Stenhousem'r,6436,9,10,8,18,52,78,-26,38
Stranraer,6436,10,9,9,18,43,61,-18,36
Brechin,6437,1,20,8,8,70,46,24,68
Livingston,6437,2,21,2,13,76,49,27,65
Airdrieon,6437,3,19,6,11,60,53,7,63
Alloa,6437,4,18,6,12,69,43,26,60
Peterhead,6437,5,17,6,13,54,55,-1,57
Albion,6437,6,13,6,17,54,61,-7,45
Stranraer,6437,7,13,6,17,53,69,-16,45
Queen's Park,6437,8,11,8,17,39,54,-15,41
Stenhousem'r,6437,9,8,8,20,45,70,-25,32
East Fife,6437,10,7,10,19,48,68,-20,31
Brechin,6438,1,21,3,12,49,46,3,66
Airdrieon,6438,2,18,6,12,62,50,12,60
Livingston,6438,3,17,5,14,70,54,16,56
Alloa,6438,4,16,7,13,65,47,18,55
Peterhead,6438,5,15,9,12,55,51,4,54
East Fife,6438,6,13,10,13,57,52,5,49
Queen's Park,6438,7,14,7,15,43,53,-10,49
Albion,6438,8,13,6,17,48,57,-9,45
Stranraer,6438,9,12,6,18,56,59,-3,42
Stenhousem'r,6438,10,7,9,20,45,81,-36,30
Livingston,6439,1,21,7,8,81,48,33,70
Alloa,6439,2,18,9,9,69,45,24,63
Airdrieon,6439,3,17,5,14,57,55,2,56
Brechin,6439,4,16,4,16,51,55,-4,52
East Fife,6439,5,14,8,14,52,52,0,50
Queen's Park,6439,6,13,10,13,46,55,-9,49
Stranraer,6439,7,13,8,15,55,58,-3,47
Albion,6439,8,12,10,14,53,52,1,46
Peterhead,6439,9,12,9,15,54,56,-2,45
Stenhousem'r,6439,10,5,8,23,44,86,-42,23
Livingston,6440,1,21,4,11,82,51,31,67
Alloa,6440,2,17,8,11,66,46,20,59
Brechin,6440,3,18,5,13,56,52,4,59
Airdrieon,6440,4,18,5,13,56,57,-1,59
Stranraer,6440,5,17,3,16,53,59,-6,54
Albion,6440,6,15,7,14,52,49,3,52
Queen's Park,6440,7,14,5,17,33,46,-13,47
East Fife,6440,8,12,10,14,55,50,5,46
Peterhead,6440,9,12,6,18,52,60,-8,42
Stenhousem'r,6440,10,6,7,23,44,79,-35,25
Livingston,6441,1,21,6,9,74,45,29,69
Airdrieon,6441,2,19,5,12,60,56,4,62
Alloa,6441,3,16,8,12,62,40,22,56
Queen's Park,6441,4,18,2,16,49,48,1,56
Albion,6441,5,16,6,14,53,52,1,54
Brechin,6441,6,15,8,13,49,51,-2,53
Stranraer,6441,7,13,6,17,46,60,-14,45
Peterhead,6441,8,11,8,17,37,52,-15,41
East Fife,6441,9,10,9,17,48,45,3,39
Stenhousem'r,6441,10,9,6,21,42,71,-29,33
Livingston,6442,1,23,3,10,89,45,44,72
Alloa,6442,2,22,6,8,72,43,29,72
Peterhead,6442,3,18,4,14,57,47,10,58
East Fife,6442,4,15,8,13,56,44,12,53
Brechin,6442,5,16,4,16,47,52,-5,52
Airdrieon,6442,6,14,7,15,62,71,-9,49
Albion,6442,7,12,8,16,49,58,-9,44
Stranraer,6442,8,12,5,19,51,67,-16,41
Queen's Park,6442,9,11,6,19,32,57,-25,39
Stenhousem'r,6442,10,8,7,21,46,77,-31,31
Livingston,6443,1,21,6,9,83,44,39,69
Airdrieon,6443,2,20,6,10,65,52,13,66
Alloa,6443,3,16,12,8,62,41,21,60
Brechin,6443,4,17,6,13,50,42,8,57
Queen's Park,6443,5,15,8,13,37,47,-10,53
Peterhead,6443,6,13,7,16,45,55,-10,46
Albion,6443,7,11,11,14,55,55,0,44
East Fife,6443,8,12,6,18,48,52,-4,42
Stranraer,6443,9,10,9,17,52,66,-14,39
Stenhousem'r,6443,10,5,9,22,46,89,-43,24
Airdrieon,6444,1,19,7,10,61,46,15,64
Alloa,6444,2,18,8,10,68,45,23,62
Brechin,6444,3,19,4,13,53,48,5,61
Livingston,6444,4,17,6,13,58,48,10,57
Albion,6444,5,13,8,15,48,50,-2,47
East Fife,6444,6,12,10,14,57,49,8,46
Queen's Park,6444,7,12,9,15,43,54,-11,45
Stranraer,6444,8,13,5,18,52,57,-5,44
Peterhead,6444,9,10,10,16,40,55,-15,40
Stenhousem'r,6444,10,9,9,18,52,80,-28,36
Livingston,6445,1,23,2,11,80,45,35,71
Alloa,6445,2,18,8,10,70,43,27,62
Albion,6445,3,17,7,12,57,55,2,58
Airdrieon,6445,4,16,8,12,62,57,5,56
Peterhead,6445,5,15,5,16,53,54,-1,50
Queen's Park,6445,6,14,8,14,39,44,-5,50
Brechin,6445,7,14,8,14,51,61,-10,50
Stranraer,6445,8,13,8,15,55,58,-3,47
East Fife,6445,9,9,10,17,43,51,-8,37
Stenhousem'r,6445,10,5,8,23,42,84,-42,23
Alloa,6446,1,24,5,7,78,40,38,77
Livingston,6446,2,20,6,10,73,46,27,66
Albion,6446,3,18,5,13,58,55,3,59
Airdrieon,6446,4,15,7,14,60,64,-4,52
Brechin,6446,5,16,3,17,48,50,-2,51
East Fife,6446,6,14,6,16,60,57,3,48
Peterhead,6446,7,13,6,17,46,52,-6,45
Stenhousem'r,6446,8,11,6,19,47,71,-24,39
Stranraer,6446,9,11,5,20,50,61,-11,38
Queen's Park,6446,10,11,5,20,34,58,-24,38
Airdrieon,6447,1,17,9,10,55,46,9,60
Alloa,6447,2,17,7,12,72,49,23,58
Livingston,6447,3,17,6,13,68,43,25,57
Peterhead,6447,4,16,8,12,54,49,5,56
Brechin,6447,5,15,8,13,41,47,-6,53
Albion,6447,6,12,10,14,48,53,-5,46
Queen's Park,6447,7,14,4,18,34,52,-18,46
Stranraer,6447,8,12,9,15,50,58,-8,45
Stenhousem'r,6447,9,12,6,18,51,69,-18,42
East Fife,6447,10,8,13,15,42,49,-7,37
Alloa,6448,1,20,6,10,67,40,27,66
Livingston,6448,2,18,5,13,66,54,12,59
East Fife,6448,3,16,8,12,61,50,11,56
Brechin,6448,4,15,11,10,51,46,5,56
Airdrieon,6448,5,15,5,16,62,63,-1,50
Albion,6448,6,14,7,15,56,58,-2,49
Peterhead,6448,7,13,7,16,48,53,-5,46
Stranraer,6448,8,12,8,16,53,63,-10,44
Queen's Park,6448,9,12,5,19,38,50,-12,41
Stenhousem'r,6448,10,8,12,16,47,72,-25,36
Livingston,6449,1,18,6,12,59,44,15,60
Brechin,6449,2,19,3,14,55,50,5,60
Alloa,6449,3,16,9,11,59,41,18,57
Albion,6449,4,16,7,13,59,51,8,55
Airdrieon,6449,5,16,5,15,54,51,3,53
Peterhead,6449,6,15,7,14,54,53,1,52
East Fife,6449,7,13,11,12,46,41,5,50
Queen's Park,6449,8,13,6,17,37,52,-15,45
Stenhousem'r,6449,9,10,8,18,46,68,-22,38
Stranraer,6449,10,11,4,21,40,58,-18,37
Livingston,6450,1,20,4,12,77,42,35,64
Alloa,6450,2,19,6,11,72,40,32,63
Brechin,6450,3,18,6,12,53,52,1,60
Peterhead,6450,4,16,10,10,60,53,7,58
Airdrieon,6450,5,16,8,12,58,58,0,56
Albion,6450,6,12,9,15,46,50,-4,45
Stranraer,6450,7,13,6,17,48,59,-11,45
East Fife,6450,8,11,9,16,41,45,-4,42
Stenhousem'r,6450,9,10,9,17,52,76,-24,39
Queen's Park,6450,10,8,7,21,25,57,-32,31
Livingston,6451,1,23,2,11,85,46,39,71
Alloa,6451,2,20,9,7,68,40,28,69
Airdrieon,6451,3,17,8,11,57,51,6,59
Albion,6451,4,16,10,10,56,50,6,58
Brechin,6451,5,15,7,14,50,54,-4,52
Peterhead,6451,6,12,10,14,48,52,-4,46
Stranraer,6451,7,13,6,17,53,62,-9,45
Queen's Park,6451,8,12,8,16,40,47,-7,44
East Fife,6451,9,9,12,15,59,63,-4,39
Stenhousem'r,6451,10,3,8,25,32,83,-51,17
Alloa,6452,1,20,7,9,66,41,25,67
Livingston,6452,2,20,4,12,69,53,16,64
Airdrieon,6452,3,18,7,11,71,49,22,61
Brechin,6452,4,17,7,12,52,45,7,58
Queen's Park,6452,5,14,7,15,41,51,-10,49
Peterhead,6452,6,13,6,17,43,52,-9,45
Albion,6452,7,11,11,14,47,53,-6,44
East Fife,6452,8,10,13,13,45,41,4,43
Stranraer,6452,9,11,3,22,45,64,-19,36
Stenhousem'r,6452,10,9,9,18,45,75,-30,36
Alloa,6453,1,20,10,6,67,36,31,70
Livingston,6453,2,21,4,11,78,52,26,67
Brechin,6453,3,19,6,11,50,38,12,63
Airdrieon,6453,4,15,5,16,59,65,-6,50
Peterhead,6453,5,14,6,16,43,54,-11,48
Albion,6453,6,13,7,16,53,54,-1,46
Stranraer,6453,7,14,3,19,47,59,-12,45
East Fife,6453,8,11,9,16,46,45,1,42
Queen's Park,6453,9,12,6,18,33,43,-10,42
Stenhousem'r,6453,10,7,12,17,50,80,-30,33
Livingston,6454,1,23,4,9,82,48,34,73
Alloa,6454,2,19,8,9,72,42,30,65
Airdrieon,6454,3,15,8,13,55,56,-1,53
Brechin,6454,4,16,5,15,56,58,-2,53
Albion,6454,5,13,11,12,50,47,3,50
Queen's Park,6454,6,12,9,15,37,45,-8,45
Peterhead,6454,7,11,10,15,49,61,-12,43
East Fife,6454,8,10,12,14,45,45,0,42
Stranraer,6454,9,10,8,18,51,62,-11,38
Stenhousem'r,6454,10,9,9,18,45,78,-33,36
Livingston,6455,1,21,6,9,78,42,36,69
Alloa,6455,2,21,6,9,67,44,23,69
Airdrieon,6455,3,19,5,12,60,60,0,62
Brechin,6455,4,15,11,10,52,44,8,56
Albion,6455,5,13,9,14,50,47,3,48
East Fife,6455,6,11,12,13,55,51,4,45
Stranraer,6455,7,13,4,19,53,62,-9,43
Peterhead,6455,8,10,9,17,40,54,-14,39
Queen's Park,6455,9,10,8,18,38,59,-21,38
Stenhousem'r,6455,10,8,8,20,50,80,-30,32
Alloa,6456,1,21,8,7,81,39,42,71
Livingston,6456,2,21,8,7,71,42,29,71
Airdrieon,6456,3,17,7,12,59,53,6,58
Brechin,6456,4,14,9,13,47,54,-7,51
East Fife,6456,5,12,11,13,49,38,11,47
Albion,6456,6,13,8,15,54,51,3,47
Peterhead,6456,7,11,9,16,42,52,-10,42
Queen's Park,6456,8,11,8,17,35,48,-13,41
Stenhousem'r,6456,9,10,7,19,50,86,-36,37
Stranraer,6456,10,9,7,20,43,68,-25,34
Livingston,6457,1,25,1,10,78,42,36,76
Alloa,6457,2,17,9,10,70,52,18,60
Airdrieon,6457,3,17,6,13,54,51,3,57
Brechin,6457,4,16,8,12,51,45,6,56
Peterhead,6457,5,14,8,14,50,49,1,50
Queen's Park,6457,6,14,8,14,43,46,-3,50
East Fife,6457,7,13,9,14,44,43,1,48
Albion,6457,8,12,8,16,46,58,-12,44
Stranraer,6457,9,9,5,22,54,72,-18,32
Stenhousem'r,6457,10,8,8,20,43,75,-32,32
Alloa,6458,1,20,9,7,77,45,32,69
Livingston,6458,2,20,7,9,75,46,29,67
East Fife,6458,3,17,6,13,65,40,25,57
Airdrieon,6458,4,17,6,13,52,47,5,57
Peterhead,6458,5,16,7,13,53,51,2,55
Brechin,6458,6,16,6,14,45,55,-10,54
Stranraer,6458,7,13,4,19,52,60,-8,43
Albion,6458,8,10,7,19,53,66,-13,37
Queen's Park,6458,9,10,7,19,38,61,-23,37
Stenhousem'r,6458,10,8,7,21,47,86,-39,31
Alloa,6459,1,22,8,6,74,46,28,74
Livingston,6459,2,22,3,11,83,49,34,69
Brechin,6459,3,19,6,11,54,43,11,63
Airdrieon,6459,4,18,6,12,66,55,11,60
Albion,6459,5,13,9,14,53,50,3,48
Stranraer,6459,6,13,8,15,62,66,-4,47
Peterhead,6459,7,11,10,15,49,57,-8,43
Stenhousem'r,6459,8,10,9,17,51,74,-23,39
East Fife,6459,9,6,11,19,33,55,-22,29
Queen's Park,6459,10,7,8,21,36,66,-30,29
Stranraer,6460,1,20,3,13,64,42,22,63
Airdrieon,6460,2,18,8,10,61,49,12,62
Livingston,6460,3,17,9,10,69,46,23,60
Alloa,6460,4,15,8,13,66,54,12,53
Brechin,6460,5,16,5,15,42,50,-8,53
Queen's Park,6460,6,15,6,15,42,47,-5,51
Peterhead,6460,7,13,9,14,43,49,-6,48
Albion,6460,8,10,12,14,51,57,-6,42
East Fife,6460,9,8,11,17,40,51,-11,35
Stenhousem'r,6460,10,8,9,19,45,78,-33,33
Livingston,6461,1,20,8,8,79,49,30,68
Airdrieon,6461,2,19,8,9,70,54,16,65
Albion,6461,3,18,4,14,53,45,8,58
Peterhead,6461,4,16,7,13,53,57,-4,55
Alloa,6461,5,14,10,12,61,40,21,52
Queen's Park,6461,6,14,9,13,40,46,-6,51
Brechin,6461,7,14,7,15,43,51,-8,49
East Fife,6461,8,11,8,17,45,44,1,41
Stranraer,6461,9,10,5,21,44,63,-19,35
Stenhousem'r,6461,10,7,8,21,46,85,-39,29
Alloa,6462,1,22,8,6,77,34,43,74
Livingston,6462,2,21,6,9,82,49,33,69
Brechin,6462,3,19,2,15,55,52,3,59
Albion,6462,4,16,9,11,52,47,5,57
Airdrieon,6462,5,16,8,12,61,55,6,56
Stranraer,6462,6,13,5,18,49,61,-12,44
Peterhead,6462,7,11,10,15,50,60,-10,43
East Fife,6462,8,8,11,17,42,50,-8,35
Queen's Park,6462,9,8,9,19,34,65,-31,33
Stenhousem'r,6462,10,7,10,19,44,73,-29,31
Alloa,6463,1,19,7,10,60,42,18,64
Peterhead,6463,2,18,8,10,59,43,16,62
Brechin,6463,3,18,7,11,58,46,12,61
Airdrieon,6463,4,18,7,11,60,50,10,61
Livingston,6463,5,14,7,15,64,54,10,49
Albion,6463,6,12,12,12,50,53,-3,48
East Fife,6463,7,11,12,13,57,57,0,45
Stranraer,6463,8,11,6,19,54,59,-5,39
Stenhousem'r,6463,9,8,11,17,40,72,-32,35
Queen's Park,6463,10,8,9,19,33,59,-26,33
Livingston,6464,1,21,5,10,86,45,41,68
Alloa,6464,2,20,6,10,73,46,27,66
Brechin,6464,3,17,8,11,59,52,7,59
Airdrieon,6464,4,16,7,13,57,62,-5,55
Albion,6464,5,16,6,14,64,53,11,54
Peterhead,6464,6,13,10,13,52,59,-7,49
Stranraer,6464,7,14,5,17,53,61,-8,47
East Fife,6464,8,11,11,14,49,50,-1,44
Queen's Park,6464,9,12,6,18,35,55,-20,42
Stenhousem'r,6464,10,5,6,25,39,84,-45,21
Livingston,6465,1,23,4,9,77,47,30,73
Alloa,6465,2,17,10,9,66,49,17,61
Airdrieon,6465,3,16,8,12,53,49,4,56
East Fife,6465,4,14,12,10,62,51,11,54
Albion,6465,5,13,13,10,58,48,10,52
Peterhead,6465,6,14,8,14,51,54,-3,50
Stranraer,6465,7,12,8,16,50,55,-5,44
Queen's Park,6465,8,12,7,17,38,53,-15,43
Brechin,6465,9,12,6,18,42,54,-12,42
Stenhousem'r,6465,10,6,6,24,41,78,-37,24
Alloa,6466,1,20,10,6,64,37,27,70
Livingston,6466,2,22,3,11,78,50,28,69
Airdrieon,6466,3,17,9,10,57,51,6,60
Brechin,6466,4,18,5,13,59,54,5,59
Albion,6466,5,14,10,12,59,51,8,52
Queen's Park,6466,6,14,8,14,43,46,-3,50
Peterhead,6466,7,12,8,16,52,53,-1,44
Stranraer,6466,8,11,6,19,43,53,-10,39
East Fife,6466,9,9,11,16,50,56,-6,38
Stenhousem'r,6466,10,5,6,25,38,92,-54,21
Airdrieon,6467,1,19,9,8,65,47,18,66
Livingston,6467,2,19,7,10,73,50,23,64
Brechin,6467,3,18,6,12,48,44,4,60
Peterhead,6467,4,17,6,13,55,50,5,57
Albion,6467,5,14,8,14,52,55,-3,50
Alloa,6467,6,14,7,15,59,52,7,49
Queen's Park,6467,7,13,10,13,46,52,-6,49
East Fife,6467,8,12,9,15,52,47,5,45
Stranraer,6467,9,10,6,20,46,62,-16,36
Stenhousem'r,6467,10,6,8,22,43,80,-37,26
Alloa,6468,1,21,8,7,73,45,28,71
Airdrieon,6468,2,19,9,8,66,43,23,66
Peterhead,6468,3,17,8,11,55,49,6,59
Livingston,6468,4,17,7,12,76,58,18,58
Albion,6468,5,16,7,13,53,47,6,55
Brechin,6468,6,16,6,14,53,54,-1,54
Queen's Park,6468,7,10,8,18,41,59,-18,38
Stranraer,6468,8,9,8,19,43,60,-17,35
East Fife,6468,9,8,10,18,47,55,-8,34
Stenhousem'r,6468,10,8,7,21,44,81,-37,31
Alloa,6469,1,22,6,8,68,40,28,72
Livingston,6469,2,20,5,11,69,49,20,65
Airdrieon,6469,3,15,10,11,57,53,4,55
Peterhead,6469,4,14,9,13,46,46,0,51
East Fife,6469,5,13,10,13,56,52,4,49
Albion,6469,6,13,9,14,61,56,5,48
Brechin,6469,7,14,6,16,46,47,-1,48
Stranraer,6469,8,13,7,16,51,58,-7,46
Queen's Park,6469,9,10,9,17,33,48,-15,39
Stenhousem'r,6469,10,6,9,21,46,84,-38,27
Livingston,6470,1,19,6,11,73,59,14,63
Airdrieon,6470,2,17,8,11,60,50,10,59
Alloa,6470,3,15,11,10,66,48,18,56
East Fife,6470,4,15,9,12,52,37,15,54
Queen's Park,6470,5,15,9,12,44,45,-1,54
Albion,6470,6,14,10,12,59,52,7,52
Brechin,6470,7,14,6,16,43,50,-7,48
Peterhead,6470,8,14,5,17,51,63,-12,47
Stenhousem'r,6470,9,10,6,20,52,79,-27,36
Stranraer,6470,10,8,8,20,41,58,-17,32
Livingston,6471,1,21,5,10,77,44,33,68
Alloa,6471,2,18,6,12,71,55,16,60
Airdrieon,6471,3,17,7,12,60,50,10,58
Brechin,6471,4,16,7,13,54,50,4,55
Peterhead,6471,5,15,9,12,56,53,3,54
Albion,6471,6,12,11,13,51,54,-3,47
East Fife,6471,7,12,8,16,55,51,4,44
Stenhousem'r,6471,8,10,10,16,51,75,-24,40
Stranraer,6471,9,10,9,17,44,66,-22,39
Queen's Park,6471,10,9,8,19,30,51,-21,35
Livingston,6472,1,19,6,11,75,52,23,63
Alloa,6472,2,18,5,13,67,46,21,59
Airdrieon,6472,3,17,8,11,59,52,7,59
Albion,6472,4,15,8,13,60,54,6,53
Peterhead,6472,5,13,11,12,54,54,0,50
Brechin,6472,6,15,5,16,48,57,-9,50
Queen's Park,6472,7,13,9,14,42,52,-10,48
Stranraer,6472,8,12,7,17,49,62,-13,43
East Fife,6472,9,9,13,14,49,50,-1,40
Stenhousem'r,6472,10,8,10,18,58,82,-24,34
Livingston,6473,1,23,4,9,82,38,44,73
Brechin,6473,2,19,3,14,54,47,7,60
Airdrieon,6473,3,17,7,12,58,54,4,58
Alloa,6473,4,17,6,13,70,52,18,57
Albion,6473,5,16,6,14,52,49,3,54
Queen's Park,6473,6,15,5,16,40,49,-9,50
Peterhead,6473,7,14,5,17,46,62,-16,47
East Fife,6473,8,12,7,17,55,50,5,43
Stranraer,6473,9,11,5,20,39,58,-19,38
Stenhousem'r,6473,10,9,6,21,41,78,-37,33
Livingston,6474,1,22,7,7,97,51,46,73
Alloa,6474,2,22,6,8,69,36,33,72
Airdrieon,6474,3,16,7,13,59,54,5,55
Brechin,6474,4,14,9,13,52,60,-8,51
Queen's Park,6474,5,13,10,13,43,48,-5,49
Stranraer,6474,6,14,3,19,51,58,-7,45
Peterhead,6474,7,12,8,16,48,56,-8,44
East Fife,6474,8,12,7,17,49,57,-8,43
Stenhousem'r,6474,9,11,5,20,48,81,-33,38
Albion,6474,10,8,10,18,48,63,-15,34
Airdrieon,6475,1,19,9,8,57,38,19,66
Alloa,6475,2,18,10,8,65,45,20,64
Livingston,6475,3,19,6,11,70,41,29,63
Brechin,6475,4,16,7,13,57,50,7,55
Albion,6475,5,16,5,15,61,56,5,53
Stranraer,6475,6,14,3,19,52,62,-10,45
Queen's Park,6475,7,12,8,16,35,48,-13,44
East Fife,6475,8,10,12,14,50,52,-2,42
Peterhead,6475,9,10,10,16,42,61,-19,40
Stenhousem'r,6475,10,6,10,20,43,79,-36,28
Alloa,6476,1,23,7,6,87,42,45,76
Livingston,6476,2,17,5,14,77,61,16,56
Brechin,6476,3,16,6,14,49,50,-1,54
Stranraer,6476,4,16,5,15,58,66,-8,53
Queen's Park,6476,5,15,6,15,36,52,-16,51
Albion,6476,6,15,5,16,61,56,5,50
Airdrieon,6476,7,13,9,14,47,52,-5,48
East Fife,6476,8,11,8,17,55,52,3,41
Peterhead,6476,9,11,8,17,39,50,-11,41
Stenhousem'r,6476,10,11,5,20,46,74,-28,38
Alloa,6477,1,22,7,7,75,43,32,73
Airdrieon,6477,2,20,5,11,73,50,23,65
Livingston,6477,3,19,6,11,72,56,16,63
Brechin,6477,4,18,5,13,49,43,6,59
Albion,6477,5,13,9,14,55,53,2,48
East Fife,6477,6,11,11,14,52,50,2,44
Peterhead,6477,7,11,9,16,43,58,-15,42
Stranraer,6477,8,12,5,19,49,60,-11,41
Queen's Park,6477,9,11,5,20,33,54,-21,38
Stenhousem'r,6477,10,8,8,20,45,79,-34,32
Alloa,6478,1,22,7,7,75,45,30,73
Livingston,6478,2,17,8,11,64,46,18,59
Albion,6478,3,17,8,11,59,42,17,59
Brechin,6478,4,15,9,12,50,43,7,54
Airdrieon,6478,5,16,5,15,57,56,1,53
Peterhead,6478,6,15,7,14,51,52,-1,52
Stranraer,6478,7,15,4,17,49,57,-8,49
Queen's Park,6478,8,12,4,20,33,57,-24,40
East Fife,6478,9,9,9,18,48,58,-10,36
Stenhousem'r,6478,10,8,7,21,43,73,-30,31
Livingston,6479,1,22,6,8,80,47,33,72
Alloa,6479,2,19,7,10,65,43,22,64
Brechin,6479,3,17,5,14,52,46,6,56
Peterhead,6479,4,15,7,14,46,48,-2,52
Airdrieon,6479,5,15,6,15,55,54,1,51
Albion,6479,6,14,8,14,46,45,1,50
Queen's Park,6479,7,13,7,16,44,50,-6,46
East Fife,6479,8,13,6,17,46,45,1,45
Stranraer,6479,9,10,7,19,39,60,-21,37
Stenhousem'r,6479,10,9,7,20,46,81,-35,34
Alloa,6480,1,21,8,7,70,38,32,71
Livingston,6480,2,18,7,11,70,50,20,61
Airdrieon,6480,3,17,8,11,63,53,10,59
Brechin,6480,4,17,5,14,53,44,9,56
Albion,6480,5,15,6,15,65,57,8,51
Peterhead,6480,6,13,8,15,46,56,-10,47
Stranraer,6480,7,14,3,19,54,65,-11,45
East Fife,6480,8,13,5,18,49,52,-3,44
Stenhousem'r,6480,9,11,6,19,50,78,-28,39
Queen's Park,6480,10,9,8,19,34,61,-27,35
Alloa,6481,1,20,7,9,78,42,36,67
Airdrieon,6481,2,20,6,10,63,57,6,66
Livingston,6481,3,18,6,12,75,52,23,60
Peterhead,6481,4,16,4,16,51,58,-7,52
Brechin,6481,5,15,6,15,44,48,-4,51
Albion,6481,6,14,8,14,65,55,10,50
Stranraer,6481,7,12,7,17,47,57,-10,43
East Fife,6481,8,11,9,16,46,50,-4,42
Queen's Park,6481,9,11,8,17,47,60,-13,41
Stenhousem'r,6481,10,10,5,21,48,85,-37,35
Livingston,6482,1,27,2,7,86,40,46,83
Brechin,6482,2,20,5,11,57,50,7,65
Albion,6482,3,17,8,11,61,47,14,59
Alloa,6482,4,17,6,13,67,53,14,57
Peterhead,6482,5,13,6,17,50,58,-8,45
Queen's Park,6482,6,13,6,17,37,53,-16,45
East Fife,6482,7,11,9,16,47,52,-5,42
Stranraer,6482,8,12,4,20,49,57,-8,40
Airdrieon,6482,9,10,7,19,48,66,-18,37
Stenhousem'r,6482,10,10,7,19,56,82,-26,37
Livingston,6483,1,23,2,11,82,48,34,71
Alloa,6483,2,20,8,8,73,40,33,68
Brechin,6483,3,18,6,12,53,50,3,60
Airdrieon,6483,4,17,6,13,54,56,-2,57
Albion,6483,5,13,9,14,49,51,-2,48
Peterhead,6483,6,13,8,15,44,52,-8,47
Stranraer,6483,7,13,7,16,53,59,-6,46
East Fife,6483,8,11,9,16,55,51,4,42
Queen's Park,6483,9,11,8,17,38,54,-16,41
Stenhousem'r,6483,10,6,7,23,39,79,-40,25
Alloa,6484,1,21,7,8,76,46,30,70
Livingston,6484,2,20,4,12,81,52,29,64
Airdrieon,6484,3,18,7,11,58,53,5,61
East Fife,6484,4,15,10,11,58,43,15,55
Brechin,6484,5,16,7,13,54,56,-2,55
Albion,6484,6,13,13,10,53,49,4,52
Peterhead,6484,7,14,10,12,51,54,-3,52
Stranraer,6484,8,10,4,22,45,65,-20,34
Stenhousem'r,6484,9,9,5,22,48,75,-27,32
Queen's Park,6484,10,8,5,23,33,64,-31,29
Livingston,6485,1,24,4,8,79,48,31,76
Alloa,6485,2,20,4,12,65,42,23,64
Stranraer,6485,3,16,7,13,51,52,-1,55
Brechin,6485,4,17,3,16,61,56,5,54
Airdrieon,6485,5,14,6,16,58,55,3,48
Peterhead,6485,6,14,5,17,46,50,-4,47
East Fife,6485,7,11,10,15,49,48,1,43
Albion,6485,8,11,10,15,48,52,-4,43
Stenhousem'r,6485,9,11,8,17,51,75,-24,41
Queen's Park,6485,10,9,9,18,33,63,-30,36
Livingston,6486,1,21,5,10,75,47,28,68
Alloa,6486,2,18,9,9,69,51,18,63
Albion,6486,3,16,9,11,68,54,14,57
Airdrieon,6486,4,16,7,13,58,53,5,55
Brechin,6486,5,15,8,13,48,52,-4,53
East Fife,6486,6,13,9,14,57,50,7,48
Stranraer,6486,7,14,6,16,55,59,-4,48
Queen's Park,6486,8,13,5,18,44,57,-13,44
Peterhead,6486,9,10,6,20,47,64,-17,36
Stenhousem'r,6486,10,7,10,19,44,78,-34,31
Livingston,6487,1,21,7,8,78,44,34,70
Alloa,6487,2,21,6,9,82,50,32,69
Brechin,6487,3,19,3,14,53,49,4,60
Albion,6487,4,14,9,13,55,50,5,51
Airdrieon,6487,5,14,9,13,50,54,-4,51
Peterhead,6487,6,14,8,14,48,53,-5,50
Stranraer,6487,7,14,2,20,54,65,-11,44
Queen's Park,6487,8,12,8,16,39,52,-13,44
East Fife,6487,9,7,12,17,45,53,-8,33
Stenhousem'r,6487,10,8,8,20,47,81,-34,32
Alloa,6488,1,21,5,10,80,47,33,68
Brechin,6488,2,18,7,11,56,43,13,61
Airdrieon,6488,3,18,6,12,67,55,12,60
Livingston,6488,4,18,5,13,72,51,21,59
Stranraer,6488,5,17,4,15,50,53,-3,55
Peterhead,6488,6,15,3,18,44,50,-6,48
Albion,6488,7,12,11,13,54,54,0,47
East Fife,6488,8,11,9,16,50,53,-3,42
Queen's Park,6488,9,11,7,18,34,56,-22,40
Stenhousem'r,6488,10,6,9,21,38,83,-45,27
Airdrieon,6489,1,18,8,10,57,45,12,62
Albion,6489,2,17,10,9,70,51,19,61
Livingston,6489,3,16,8,12,73,65,8,56
Brechin,6489,4,17,5,14,53,48,5,56
Alloa,6489,5,14,13,9,64,48,16,55
Peterhead,6489,6,13,9,14,54,56,-2,48
East Fife,6489,7,12,9,15,48,53,-5,45
Queen's Park,6489,8,10,12,14,36,52,-16,42
Stranraer,6489,9,11,8,17,49,57,-8,41
Stenhousem'r,6489,10,5,12,19,41,70,-29,27
Alloa,6490,1,21,7,8,75,40,35,70
Livingston,6490,2,20,4,12,75,48,27,64
Brechin,6490,3,17,6,13,51,49,2,57
Airdrieon,6490,4,15,9,12,51,50,1,54
Peterhead,6490,5,13,9,14,50,50,0,48
Albion,6490,6,13,8,15,58,62,-4,47
Stranraer,6490,7,13,7,16,45,57,-12,46
East Fife,6490,8,12,6,18,52,59,-7,42
Queen's Park,6490,9,12,6,18,39,49,-10,42
Stenhousem'r,6490,10,9,8,19,42,74,-32,35
Alloa,6491,1,21,7,8,77,45,32,70
Livingston,6491,2,19,4,13,75,59,16,61
Brechin,6491,3,16,6,14,50,47,3,54
Airdrieon,6491,4,15,8,13,55,56,-1,53
Albion,6491,5,14,9,13,69,62,7,51
Peterhead,6491,6,14,7,15,53,55,-2,49
East Fife,6491,7,13,9,14,50,45,5,48
Stranraer,6491,8,14,6,16,53,61,-8,48
Queen's Park,6491,9,13,4,19,40,54,-14,43
Stenhousem'r,6491,10,7,8,21,50,88,-38,29
Livingston,6492,1,21,5,10,85,49,36,68
Airdrieon,6492,2,19,6,11,58,57,1,63
Peterhead,6492,3,16,10,10,58,44,14,58
Alloa,6492,4,15,12,9,67,53,14,57
Brechin,6492,5,14,8,14,52,47,5,50
East Fife,6492,6,14,8,14,48,45,3,50
Albion,6492,7,11,10,15,51,48,3,43
Queen's Park,6492,8,10,9,17,34,58,-24,39
Stranraer,6492,9,10,8,18,50,64,-14,38
Stenhousem'r,6492,10,8,8,20,48,86,-38,32
Alloa,6493,1,21,8,7,77,45,32,71
Airdrieon,6493,2,17,8,11,62,61,1,59
Livingston,6493,3,16,8,12,71,60,11,56
Brechin,6493,4,16,7,13,58,56,2,55
Peterhead,6493,5,15,8,13,54,50,4,53
East Fife,6493,6,12,13,11,52,42,10,49
Albion,6493,7,13,9,14,49,47,2,48
Stranraer,6493,8,12,6,18,53,67,-14,42
Queen's Park,6493,9,8,12,16,33,51,-18,36
Stenhousem'r,6493,10,6,9,21,56,86,-30,27
Alloa,6494,1,19,9,8,76,49,27,66
Livingston,6494,2,17,7,12,72,58,14,58
Peterhead,6494,3,16,9,11,50,49,1,57
Airdrieon,6494,4,16,7,13,60,52,8,55
Albion,6494,5,14,11,11,61,50,11,53
Queen's Park,6494,6,14,6,16,48,48,0,48
Brechin,6494,7,15,1,20,42,56,-14,46
East Fife,6494,8,11,10,15,52,50,2,43
Stranraer,6494,9,11,5,20,47,69,-22,38
Stenhousem'r,6494,10,9,11,16,49,76,-27,38
Livingston,6495,1,25,5,6,78,37,41,80
Alloa,6495,2,19,8,9,66,40,26,65
Brechin,6495,3,17,6,13,51,43,8,57
Airdrieon,6495,4,13,11,12,48,51,-3,50
Peterhead,6495,5,14,7,15,45,55,-10,49
Queen's Park,6495,6,12,10,14,38,43,-5,46
Albion,6495,7,9,14,13,46,53,-7,41
Stranraer,6495,8,11,8,17,42,51,-9,41
East Fife,6495,9,9,9,18,41,52,-11,36
Stenhousem'r,6495,10,8,8,20,49,79,-30,32
Alloa,6496,1,23,5,8,79,46,33,74
Brechin,6496,2,20,7,9,61,43,18,67
Livingston,6496,3,18,5,13,72,64,8,59
Airdrieon,6496,4,14,8,14,50,54,-4,50
Albion,6496,5,13,10,13,52,50,2,49
Peterhead,6496,6,12,9,15,53,54,-1,45
Stranraer,6496,7,13,5,18,50,57,-7,44
Queen's Park,6496,8,11,9,16,35,52,-17,42
Stenhousem'r,6496,9,10,9,17,52,70,-18,39
East Fife,6496,10,8,9,19,37,51,-14,33
Livingston,6497,1,20,5,11,68,53,15,65
Airdrieon,6497,2,20,4,12,75,52,23,64
Brechin,6497,3,17,7,12,64,54,10,58
Alloa,6497,4,15,11,10,65,43,22,56
Albion,6497,5,16,8,12,62,45,17,56
Stranraer,6497,6,14,5,17,55,64,-9,47
Queen's Park,6497,7,12,7,17,39,52,-13,43
East Fife,6497,8,11,8,17,45,53,-8,41
Peterhead,6497,9,11,8,17,47,65,-18,41
Stenhousem'r,6497,10,7,11,18,38,77,-39,32
Livingston,6498,1,24,2,10,92,58,34,74
Alloa,6498,2,17,10,9,71,46,25,61
East Fife,6498,3,15,9,12,55,42,13,54
Brechin,6498,4,14,9,13,63,57,6,51
Peterhead,6498,5,13,10,13,54,62,-8,49
Albion,6498,6,13,7,16,53,62,-9,46
Stranraer,6498,7,12,9,15,46,51,-5,45
Queen's Park,6498,8,12,9,15,37,52,-15,45
Airdrieon,6498,9,12,7,17,51,58,-7,43
Stenhousem'r,6498,10,8,8,20,48,82,-34,32
Airdrieon,6499,1,19,7,10,62,48,14,64
Livingston,6499,2,19,6,11,75,48,27,63
Brechin,6499,3,18,7,11,54,49,5,61
Alloa,6499,4,15,12,9,63,46,17,57
Albion,6499,5,15,7,14,53,54,-1,52
Peterhead,6499,6,13,9,14,49,52,-3,48
Queen's Park,6499,7,11,9,16,35,54,-19,42
Stenhousem'r,6499,8,10,8,18,47,73,-26,38
East Fife,6499,9,8,13,15,52,53,-1,37
Stranraer,6499,10,10,6,20,47,60,-13,36
Livingston,6500,1,21,3,12,86,67,19,66
Airdrieon,6500,2,18,7,11,66,48,18,61
Alloa,6500,3,16,12,8,69,42,27,60
Stranraer,6500,4,16,8,12,68,57,11,56
Peterhead,6500,5,15,8,13,58,59,-1,53
East Fife,6500,6,13,8,15,56,53,3,47
Albion,6500,7,14,4,18,50,58,-8,46
Brechin,6500,8,13,6,17,44,50,-6,45
Queen's Park,6500,9,11,7,18,34,57,-23,40
Stenhousem'r,6500,10,9,5,22,51,91,-40,32
Brechin,6501,1,20,7,9,57,48,9,67
Livingston,6501,2,20,6,10,72,48,24,66
Alloa,6501,3,17,9,10,73,45,28,60
Airdrieon,6501,4,17,8,11,61,59,2,59
Albion,6501,5,15,10,11,60,54,6,55
Peterhead,6501,6,12,7,17,46,56,-10,43
East Fife,6501,7,10,9,17,51,52,-1,39
Queen's Park,6501,8,9,11,16,47,63,-16,38
Stranraer,6501,9,10,8,18,41,60,-19,38
Stenhousem'r,6501,10,8,9,19,55,78,-23,33
Livingston,6502,1,20,3,13,71,52,19,63
Alloa,6502,2,17,11,8,66,37,29,62
Airdrieon,6502,3,17,9,10,57,52,5,60
Albion,6502,4,15,10,11,51,47,4,55
Stranraer,6502,5,14,8,14,50,48,2,50
Queen's Park,6502,6,13,9,14,37,43,-6,48
Brechin,6502,7,11,11,14,40,47,-7,44
Peterhead,6502,8,11,11,14,46,56,-10,44
East Fife,6502,9,9,10,17,48,49,-1,37
Stenhousem'r,6502,10,8,8,20,41,76,-35,32
Livingston,6503,1,22,4,10,72,42,30,70
Airdrieon,6503,2,20,8,8,58,40,18,68
Peterhead,6503,3,18,6,12,58,49,9,60
Alloa,6503,4,16,8,12,69,47,22,56
Queen's Park,6503,5,16,6,14,40,48,-8,54
Brechin,6503,6,13,8,15,43,50,-7,47
East Fife,6503,7,13,7,16,51,53,-2,46
Albion,6503,8,10,8,18,42,56,-14,38
Stranraer,6503,9,8,9,19,48,67,-19,33
Stenhousem'r,6503,10,9,6,21,46,75,-29,33
Alloa,6504,1,20,9,7,68,40,28,69
Airdrieon,6504,2,17,10,9,63,47,16,61
Brechin,6504,3,18,5,13,59,52,7,59
Livingston,6504,4,17,6,13,73,49,24,57
Albion,6504,5,14,10,12,54,53,1,52
Stranraer,6504,6,13,7,16,48,51,-3,46
East Fife,6504,7,12,8,16,44,48,-4,44
Peterhead,6504,8,11,10,15,47,64,-17,43
Stenhousem'r,6504,9,10,6,20,51,78,-27,36
Queen's Park,6504,10,10,5,21,32,57,-25,35
Livingston,6505,1,22,6,8,73,44,29,72
Alloa,6505,2,17,8,11,66,45,21,59
Brechin,6505,3,17,6,13,54,47,7,57
Airdrieon,6505,4,16,8,12,58,52,6,56
East Fife,6505,5,13,11,12,57,46,11,50
Stranraer,6505,6,14,4,18,59,68,-9,46
Queen's Park,6505,7,12,10,14,39,52,-13,46
Albion,6505,8,11,11,14,47,54,-7,44
Peterhead,6505,9,12,8,16,46,53,-7,44
Stenhousem'r,6505,10,5,10,21,38,76,-38,25
Airdrieon,6506,1,20,6,10,62,50,12,66
Alloa,6506,2,17,10,9,58,40,18,61
Livingston,6506,3,16,7,13,66,51,15,55
Brechin,6506,4,16,6,14,59,56,3,54
Stranraer,6506,5,15,7,14,55,52,3,52
Peterhead,6506,6,13,7,16,49,61,-12,46
Albion,6506,7,12,9,15,48,55,-7,45
East Fife,6506,8,11,10,15,49,46,3,43
Queen's Park,6506,9,10,13,13,42,51,-9,43
Stenhousem'r,6506,10,9,7,20,50,76,-26,34
Airdrieon,6507,1,20,4,12,74,54,20,64
Livingston,6507,2,18,8,10,74,53,21,62
Peterhead,6507,3,18,4,14,59,58,1,58
Alloa,6507,4,16,8,12,62,50,12,56
Stranraer,6507,5,18,2,16,57,60,-3,56
Albion,6507,6,15,7,14,58,53,5,52
Brechin,6507,7,14,7,15,53,54,-1,49
East Fife,6507,8,13,6,17,48,55,-7,45
Queen's Park,6507,9,7,12,17,35,53,-18,33
Stenhousem'r,6507,10,7,10,19,52,82,-30,31
Airdrieon,6508,1,20,6,10,68,54,14,66
Alloa,6508,2,19,8,9,70,43,27,65
Livingston,6508,3,20,5,11,76,50,26,65
Brechin,6508,4,17,4,15,54,53,1,55
Albion,6508,5,14,8,14,52,53,-1,50
Queen's Park,6508,6,12,10,14,40,54,-14,46
Stranraer,6508,7,13,5,18,55,61,-6,44
East Fife,6508,8,11,10,15,44,50,-6,43
Peterhead,6508,9,9,10,17,45,59,-14,37
Stenhousem'r,6508,10,8,8,20,50,77,-27,32
Livingston,6509,1,21,6,9,83,54,29,69
Alloa,6509,2,18,8,10,74,44,30,62
Airdrieon,6509,3,18,5,13,52,45,7,59
Peterhead,6509,4,15,5,16,50,53,-3,50
Brechin,6509,5,15,5,16,45,54,-9,50
Albion,6509,6,11,14,11,48,44,4,47
Stranraer,6509,7,14,5,17,48,55,-7,47
East Fife,6509,8,11,9,16,46,49,-3,42
Queen's Park,6509,9,10,10,16,34,47,-13,40
Stenhousem'r,6509,10,10,7,19,43,78,-35,37
Airdrieon,6510,1,22,7,7,74,43,31,73
Livingston,6510,2,22,4,10,83,56,27,70
Brechin,6510,3,17,11,8,56,42,14,62
Peterhead,6510,4,17,7,12,50,49,1,58
Alloa,6510,5,17,6,13,62,49,13,57
Albion,6510,6,16,8,12,57,52,5,56
Stranraer,6510,7,10,4,22,38,59,-21,34
East Fife,6510,8,8,9,19,46,55,-9,33
Queen's Park,6510,9,9,6,21,41,70,-29,33
Stenhousem'r,6510,10,8,6,22,48,80,-32,30
Livingston,6511,1,24,4,8,86,50,36,76
Alloa,6511,2,19,7,10,63,43,20,64
Airdrieon,6511,3,17,6,13,52,44,8,57
Brechin,6511,4,16,7,13,47,46,1,55
Queen's Park,6511,5,15,6,15,41,54,-13,51
Albion,6511,6,13,11,12,45,44,1,50
Peterhead,6511,7,12,7,17,57,61,-4,43
East Fife,6511,8,10,10,16,49,55,-6,40
Stranraer,6511,9,11,5,20,49,61,-12,38
Stenhousem'r,6511,10,7,9,20,49,80,-31,30
Alloa,6512,1,23,7,6,77,38,39,76
Airdrieon,6512,2,23,5,8,71,44,27,74
Livingston,6512,3,16,8,12,59,47,12,56
Peterhead,6512,4,14,10,12,59,52,7,52
Brechin,6512,5,15,4,17,47,50,-3,49
Albion,6512,6,13,7,16,52,59,-7,46
Queen's Park,6512,7,12,6,18,42,57,-15,42
East Fife,6512,8,10,9,17,51,54,-3,39
Stranraer,6512,9,10,6,20,39,72,-33,36
Stenhousem'r,6512,10,8,10,18,44,68,-24,34
Livingston,6513,1,19,7,10,66,44,22,64
Alloa,6513,2,19,6,11,76,44,32,63
Airdrieon,6513,3,17,9,10,66,61,5,60
Albion,6513,4,15,9,12,48,45,3,54
Brechin,6513,5,16,6,14,43,44,-1,54
Peterhead,6513,6,14,9,13,47,46,1,51
East Fife,6513,7,9,14,13,40,42,-2,41
Stranraer,6513,8,10,8,18,45,56,-11,38
Stenhousem'r,6513,9,9,9,18,41,71,-30,36
Queen's Park,6513,10,8,11,17,38,57,-19,35
Livingston,6514,1,23,6,7,85,42,43,75
Alloa,6514,2,18,8,10,76,53,23,62
Albion,6514,3,18,7,11,65,42,23,61
Brechin,6514,4,17,5,14,42,49,-7,56
Airdrieon,6514,5,15,6,15,49,57,-8,51
Peterhead,6514,6,14,8,14,47,49,-2,50
East Fife,6514,7,12,7,17,43,46,-3,43
Queen's Park,6514,8,11,7,18,33,54,-21,40
Stenhousem'r,6514,9,10,7,19,45,70,-25,37
Stranraer,6514,10,9,5,22,43,66,-23,32
Livingston,6515,1,21,7,8,68,43,25,70
Alloa,6515,2,18,10,8,72,41,31,64
Airdrieon,6515,3,17,6,13,59,51,8,57
Albion,6515,4,16,6,14,56,55,1,54
Peterhead,6515,5,14,9,13,52,48,4,51
Stranraer,6515,6,15,5,16,58,58,0,50
Brechin,6515,7,14,7,15,46,52,-6,49
East Fife,6515,8,12,9,15,55,50,5,45
Queen's Park,6515,9,10,9,17,29,49,-20,39
Stenhousem'r,6515,10,7,4,25,41,89,-48,25
Livingston,6516,1,22,2,12,83,56,27,68
Alloa,6516,2,19,7,10,74,51,23,64
Brechin,6516,3,19,6,11,61,51,10,63
Airdrieon,6516,4,18,5,13,58,49,9,59
Albion,6516,5,16,5,15,55,51,4,53
Stranraer,6516,6,15,5,16,66,67,-1,50
Queen's Park,6516,7,14,5,17,44,53,-9,47
Peterhead,6516,8,11,10,15,53,66,-13,43
East Fife,6516,9,8,9,19,44,60,-16,33
Stenhousem'r,6516,10,6,10,20,47,81,-34,28
Livingston,6517,1,24,2,10,80,47,33,74
Alloa,6517,2,19,7,10,71,45,26,64
Brechin,6517,3,18,5,13,53,45,8,59
Airdrieon,6517,4,15,8,13,61,54,7,53
Albion,6517,5,15,7,14,51,52,-1,52
East Fife,6517,6,14,8,14,47,43,4,50
Peterhead,6517,7,12,8,16,45,52,-7,44
Stranraer,6517,8,14,2,20,55,63,-8,44
Queen's Park,6517,9,10,7,19,30,52,-22,37
Stenhousem'r,6517,10,9,6,21,49,89,-40,33
Airdrieon,6518,1,20,5,11,74,55,19,65
Alloa,6518,2,19,7,10,76,48,28,64
Livingston,6518,3,20,3,13,75,58,17,63
Albion,6518,4,16,10,10,59,39,20,58
Brechin,6518,5,14,8,14,49,51,-2,50
Peterhead,6518,6,14,7,15,43,44,-1,49
Stranraer,6518,7,13,7,16,57,65,-8,46
Queen's Park,6518,8,10,10,16,35,55,-20,40
East Fife,6518,9,10,8,18,48,56,-8,38
Stenhousem'r,6518,10,8,7,21,54,99,-45,31
Livingston,6519,1,21,4,11,80,49,31,67
Alloa,6519,2,18,8,10,76,50,26,62
Airdrieon,6519,3,18,7,11,58,52,6,61
Queen's Park,6519,4,16,8,12,45,42,3,56
Brechin,6519,5,16,4,16,49,56,-7,52
East Fife,6519,6,15,6,15,55,48,7,51
Albion,6519,7,15,6,15,53,57,-4,51
Stenhousem'r,6519,8,11,6,19,54,72,-18,39
Peterhead,6519,9,8,13,15,40,64,-24,37
Stranraer,6519,10,9,4,23,45,65,-20,31
Brechin,6520,1,20,6,10,54,45,9,66
Livingston,6520,2,19,7,10,71,49,22,64
Alloa,6520,3,17,10,9,65,44,21,61
East Fife,6520,4,14,9,13,52,48,4,51
Peterhead,6520,5,14,9,13,47,50,-3,51
Airdrieon,6520,6,14,7,15,51,57,-6,49
Albion,6520,7,13,9,14,56,49,7,48
Queen's Park,6520,8,12,6,18,35,47,-12,42
Stranraer,6520,9,11,5,20,47,61,-14,38
Stenhousem'r,6520,10,6,12,18,39,67,-28,30
Livingston,6521,1,22,7,7,92,51,41,73
Alloa,6521,2,21,7,8,67,30,37,70
Stranraer,6521,3,14,7,15,50,52,-2,49
Brechin,6521,4,14,7,15,51,58,-7,49
Albion,6521,5,14,6,16,47,50,-3,48
Airdrieon,6521,6,14,6,16,50,63,-13,48
Queen's Park,6521,7,14,5,17,40,54,-14,47
East Fife,6521,8,12,9,15,49,51,-2,45
Peterhead,6521,9,13,6,17,50,58,-8,45
Stenhousem'r,6521,10,9,6,21,47,76,-29,33
Alloa,6522,1,21,7,8,77,43,34,70
Livingston,6522,2,21,3,12,82,52,30,66
Brechin,6522,3,18,9,9,51,39,12,63
Peterhead,6522,4,14,9,13,44,46,-2,51
Albion,6522,5,11,11,14,55,57,-2,44
East Fife,6522,6,12,8,16,45,48,-3,44
Stranraer,6522,7,13,4,19,48,59,-11,43
Airdrieon,6522,8,11,8,17,42,55,-13,41
Stenhousem'r,6522,9,10,10,16,47,67,-20,40
Queen's Park,6522,10,11,7,18,38,63,-25,40
Livingston,6523,1,23,5,8,80,43,37,74
Airdrieon,6523,2,20,7,9,65,49,16,67
Brechin,6523,3,16,9,11,44,39,5,57
Alloa,6523,4,15,6,15,64,58,6,51
East Fife,6523,5,12,12,12,46,45,1,48
Peterhead,6523,6,13,8,15,48,49,-1,47
Albion,6523,7,12,9,15,49,55,-6,45
Stranraer,6523,8,12,8,16,56,57,-1,44
Queen's Park,6523,9,9,11,16,31,54,-23,38
Stenhousem'r,6523,10,7,7,22,44,78,-34,28
Livingston,6524,1,21,5,10,73,51,22,68
Alloa,6524,2,19,7,10,72,49,23,64
East Fife,6524,3,16,7,13,59,49,10,55
Airdrieon,6524,4,15,10,11,57,56,1,55
Stranraer,6524,5,14,8,14,64,57,7,50
Queen's Park,6524,6,14,8,14,38,46,-8,50
Peterhead,6524,7,13,7,16,42,46,-4,46
Brechin,6524,8,13,5,18,46,51,-5,44
Albion,6524,9,12,6,18,49,61,-12,42
Stenhousem'r,6524,10,8,7,21,45,79,-34,31
Livingston,6525,1,21,4,11,75,47,28,67
Alloa,6525,2,17,10,9,68,45,23,61
Albion,6525,3,16,9,11,64,44,20,57
Brechin,6525,4,16,9,11,59,44,15,57
Airdrieon,6525,5,17,5,14,52,53,-1,56
Peterhead,6525,6,13,6,17,46,56,-10,45
East Fife,6525,7,10,14,12,47,43,4,44
Stranraer,6525,8,11,8,17,39,55,-16,41
Queen's Park,6525,9,10,9,17,33,60,-27,39
Stenhousem'r,6525,10,7,10,19,48,84,-36,31
Livingston,6526,1,22,2,12,72,44,28,68
Alloa,6526,2,20,7,9,73,44,29,67
Brechin,6526,3,19,4,13,64,55,9,61
Airdrieon,6526,4,16,7,13,55,51,4,55
East Fife,6526,5,14,9,13,58,51,7,51
Albion,6526,6,13,8,15,48,56,-8,47
Peterhead,6526,7,12,10,14,49,52,-3,46
Queen's Park,6526,8,13,6,17,37,53,-16,45
Stranraer,6526,9,11,3,22,50,69,-19,36
Stenhousem'r,6526,10,9,6,21,51,82,-31,33
Livingston,6527,1,22,5,9,73,37,36,71
Alloa,6527,2,21,5,10,69,47,22,68
Airdrieon,6527,3,18,4,14,64,57,7,58
Queen's Park,6527,4,16,4,16,45,47,-2,52
Brechin,6527,5,14,8,14,45,53,-8,50
Peterhead,6527,6,15,5,16,51,61,-10,50
Stranraer,6527,7,14,3,19,49,53,-4,45
East Fife,6527,8,11,8,17,44,49,-5,41
Stenhousem'r,6527,9,11,6,19,51,73,-22,39
Albion,6527,10,10,8,18,44,58,-14,38
Alloa,6528,1,21,9,6,81,40,41,72
Livingston,6528,2,20,8,8,73,45,28,68
Albion,6528,3,18,8,10,68,49,19,62
Brechin,6528,4,18,8,10,59,48,11,62
Airdrieon,6528,5,18,7,11,65,58,7,61
East Fife,6528,6,10,11,15,49,58,-9,41
Stranraer,6528,7,10,7,19,48,64,-16,37
Peterhead,6528,8,8,10,18,42,61,-19,34
Queen's Park,6528,9,7,10,19,28,53,-25,31
Stenhousem'r,6528,10,7,8,21,44,81,-37,29
Brechin,6529,1,21,3,12,60,47,13,66
Livingston,6529,2,20,5,11,72,51,21,65
Alloa,6529,3,17,10,9,74,50,24,61
Albion,6529,4,15,9,12,54,49,5,54
Airdrieon,6529,5,15,8,13,58,59,-1,53
Peterhead,6529,6,13,11,12,49,52,-3,50
Queen's Park,6529,7,14,6,16,45,48,-3,48
Stranraer,6529,8,12,9,15,50,54,-4,45
East Fife,6529,9,9,11,16,46,51,-5,38
Stenhousem'r,6529,10,4,8,24,37,84,-47,20
Livingston,6530,1,20,4,12,75,46,29,64
Alloa,6530,2,19,7,10,68,45,23,64
Brechin,6530,3,18,3,15,44,46,-2,57
Albion,6530,4,17,5,14,58,50,8,56
Peterhead,6530,5,16,7,13,59,57,2,55
Airdrieon,6530,6,15,7,14,56,50,6,52
Stranraer,6530,7,14,5,17,50,64,-14,47
Queen's Park,6530,8,11,10,15,45,57,-12,43
East Fife,6530,9,9,9,18,40,51,-11,36
Stenhousem'r,6530,10,9,7,20,47,76,-29,34
Livingston,6531,1,22,6,8,74,40,34,72
Alloa,6531,2,18,9,9,71,43,28,63
Airdrieon,6531,3,16,7,13,57,54,3,55
Brechin,6531,4,14,11,11,47,43,4,53
East Fife,6531,5,14,8,14,58,49,9,50
Albion,6531,6,12,11,13,56,62,-6,47
Stranraer,6531,7,10,10,16,47,58,-11,40
Stenhousem'r,6531,8,10,9,17,43,68,-25,39
Queen's Park,6531,9,8,13,15,35,55,-20,37
Peterhead,6531,10,8,12,16,37,53,-16,36
Livingston,6532,1,23,5,8,82,44,38,74
Alloa,6532,2,20,6,10,74,45,29,66
Airdrieon,6532,3,20,6,10,60,48,12,66
Peterhead,6532,4,15,9,12,49,44,5,54
Brechin,6532,5,17,2,17,47,59,-12,53
Stranraer,6532,6,15,2,19,57,63,-6,47
East Fife,6532,7,12,8,16,45,46,-1,44
Albion,6532,8,13,4,19,58,65,-7,43
Queen's Park,6532,9,10,8,18,35,57,-22,38
Stenhousem'r,6532,10,6,8,22,47,83,-36,26
Alloa,6533,1,19,10,7,83,49,34,67
Livingston,6533,2,20,4,12,77,50,27,64
Airdrieon,6533,3,19,6,11,69,54,15,63
Brechin,6533,4,17,5,14,47,42,5,56
East Fife,6533,5,13,9,14,56,49,7,48
Albion,6533,6,13,8,15,53,58,-5,47
Queen's Park,6533,7,14,5,17,42,56,-14,47
Stranraer,6533,8,11,10,15,49,59,-10,43
Peterhead,6533,9,11,9,16,43,55,-12,42
Stenhousem'r,6533,10,5,10,21,40,87,-47,25
Livingston,6534,1,21,2,13,70,42,28,65
Albion,6534,2,19,7,10,70,51,19,64
Alloa,6534,3,18,7,11,65,43,22,61
Airdrieon,6534,4,18,5,13,61,58,3,59
Peterhead,6534,5,14,9,13,52,47,5,51
Queen's Park,6534,6,14,9,13,48,47,1,51
Stranraer,6534,7,15,3,18,53,61,-8,48
Brechin,6534,8,13,5,18,51,67,-16,44
East Fife,6534,9,10,11,15,44,49,-5,41
Stenhousem'r,6534,10,7,4,25,38,87,-49,25
Livingston,6535,1,22,4,10,82,53,29,70
Airdrieon,6535,2,20,4,12,71,60,11,64
Alloa,6535,3,18,8,10,67,48,19,62
Brechin,6535,4,16,8,12,56,49,7,56
Stranraer,6535,5,15,6,15,58,53,5,51
Queen's Park,6535,6,13,8,15,39,53,-14,47
Albion,6535,7,13,7,16,60,57,3,46
East Fife,6535,8,10,8,18,51,53,-2,38
Peterhead,6535,9,10,7,19,42,63,-21,37
Stenhousem'r,6535,10,9,8,19,55,92,-37,35
Alloa,6536,1,23,6,7,88,39,49,75
Livingston,6536,2,23,2,11,74,43,31,71
Airdrieon,6536,3,18,4,14,51,48,3,58
Brechin,6536,4,16,6,14,43,51,-8,54
Peterhead,6536,5,13,10,13,42,51,-9,49
Stranraer,6536,6,12,6,18,51,59,-8,42
Albion,6536,7,10,10,16,39,44,-5,40
Queen's Park,6536,8,10,10,16,27,43,-16,40
Stenhousem'r,6536,9,11,7,18,51,78,-27,40
East Fife,6536,10,10,7,19,45,55,-10,37
Airdrieon,6537,1,18,6,12,62,47,15,60
Livingston,6537,2,18,4,14,68,50,18,58
Stranraer,6537,3,17,6,13,59,51,8,57
Alloa,6537,4,15,8,13,61,50,11,53
Brechin,6537,5,14,11,11,45,45,0,53
Albion,6537,6,13,11,12,57,53,4,50
East Fife,6537,7,13,9,14,52,48,4,48
Peterhead,6537,8,13,5,18,41,52,-11,44
Queen's Park,6537,9,10,9,17,35,55,-20,39
Stenhousem'r,6537,10,10,9,17,53,82,-29,39
Livingston,6538,1,22,5,9,76,44,32,71
Airdrieon,6538,2,19,9,8,70,46,24,66
Alloa,6538,3,18,10,8,66,37,29,64
Brechin,6538,4,13,10,13,49,49,0,49
Stranraer,6538,5,13,6,17,46,59,-13,45
Peterhead,6538,6,11,11,14,60,57,3,44
Albion,6538,7,11,8,17,51,60,-9,41
Queen's Park,6538,8,11,8,17,36,53,-17,41
Stenhousem'r,6538,9,11,6,19,43,82,-39,39
East Fife,6538,10,9,11,16,46,56,-10,38
Livingston,6539,1,20,6,10,76,52,24,66
Alloa,6539,2,16,9,11,65,50,15,57
Queen's Park,6539,3,15,12,9,42,42,0,57
Peterhead,6539,4,16,7,13,64,60,4,55
Brechin,6539,5,14,8,14,48,46,2,50
Airdrieon,6539,6,14,8,14,51,55,-4,50
Albion,6539,7,11,14,11,52,48,4,47
East Fife,6539,8,12,10,14,51,49,2,46
Stranraer,6539,9,11,5,20,48,58,-10,38
Stenhousem'r,6539,10,7,9,20,48,85,-37,30
Livingston,6540,1,21,2,13,76,50,26,65
Albion,6540,2,18,6,12,62,52,10,60
Alloa,6540,3,17,7,12,71,49,22,58
Airdrieon,6540,4,17,7,12,61,58,3,58
Brechin,6540,5,16,5,15,49,52,-3,53
Stranraer,6540,6,15,7,14,50,48,2,52
Queen's Park,6540,7,12,11,13,41,46,-5,47
Peterhead,6540,8,12,7,17,48,60,-12,43
East Fife,6540,9,11,9,16,45,50,-5,42
Stenhousem'r,6540,10,8,5,23,44,82,-38,29
Alloa,6541,1,22,7,7,75,37,38,73
Livingston,6541,2,23,3,10,86,51,35,72
Airdrieon,6541,3,19,6,11,62,47,15,63
Brechin,6541,4,14,7,15,54,57,-3,49
Albion,6541,5,14,6,16,48,54,-6,48
Queen's Park,6541,6,14,6,16,39,58,-19,48
Peterhead,6541,7,12,8,16,43,52,-9,44
Stranraer,6541,8,11,9,16,52,61,-9,42
East Fife,6541,9,10,9,17,42,47,-5,39
Stenhousem'r,6541,10,8,5,23,48,85,-37,29
Brechin,6542,1,22,3,11,59,39,20,69
Alloa,6542,2,19,9,8,70,39,31,66
Livingston,6542,3,18,4,14,64,49,15,58
Albion,6542,4,15,9,12,57,53,4,54
Airdrieon,6542,5,14,9,13,63,62,1,51
Queen's Park,6542,6,14,6,16,38,49,-11,48
East Fife,6542,7,11,9,16,54,53,1,42
Peterhead,6542,8,11,8,17,45,62,-17,41
Stranraer,6542,9,12,4,20,48,59,-11,40
Stenhousem'r,6542,10,9,9,18,46,79,-33,36
Airdrieon,6543,1,19,8,9,56,44,12,65
Livingston,6543,2,19,5,12,78,56,22,62
Alloa,6543,3,16,11,9,68,46,22,59
Albion,6543,4,16,8,12,51,49,2,56
Queen's Park,6543,5,15,6,15,52,51,1,51
East Fife,6543,6,12,10,14,42,45,-3,46
Brechin,6543,7,13,6,17,47,57,-10,45
Stranraer,6543,8,12,8,16,51,54,-3,44
Peterhead,6543,9,11,8,17,45,56,-11,41
Stenhousem'r,6543,10,5,14,17,50,82,-32,29
Alloa,6544,1,22,6,8,71,45,26,72
Livingston,6544,2,20,4,12,67,41,26,64
Brechin,6544,3,17,6,13,53,45,8,57
Stranraer,6544,4,16,5,15,54,53,1,53
Albion,6544,5,15,7,14,56,55,1,52
Airdrieon,6544,6,15,7,14,47,52,-5,52
Peterhead,6544,7,13,8,15,52,50,2,47
Queen's Park,6544,8,15,2,19,45,53,-8,47
East Fife,6544,9,9,11,16,38,51,-13,38
Stenhousem'r,6544,10,7,6,23,41,79,-38,27
Alloa,6545,1,19,10,7,71,45,26,67
Airdrieon,6545,2,18,5,13,70,62,8,59
Albion,6545,3,15,12,9,52,41,11,57
Brechin,6545,4,16,9,11,57,53,4,57
Livingston,6545,5,15,11,10,72,56,16,56
Queen's Park,6545,6,14,6,16,41,50,-9,48
East Fife,6545,7,10,10,16,42,44,-2,40
Peterhead,6545,8,10,10,16,51,59,-8,40
Stranraer,6545,9,10,7,19,52,65,-13,37
Stenhousem'r,6545,10,8,10,18,45,78,-33,34
Alloa,6546,1,24,7,5,80,43,37,79
Brechin,6546,2,18,7,11,63,51,12,61
Airdrieon,6546,3,18,4,14,65,59,6,58
Livingston,6546,4,15,8,13,70,51,19,53
Peterhead,6546,5,13,10,13,53,51,2,49
East Fife,6546,6,10,12,14,43,48,-5,42
Stranraer,6546,7,13,3,20,55,69,-14,42
Albion,6546,8,10,11,15,41,51,-10,41
Stenhousem'r,6546,9,9,11,16,51,74,-23,38
Queen's Park,6546,10,9,9,18,32,56,-24,36
Livingston,6547,1,20,6,10,79,46,33,66
Brechin,6547,2,18,6,12,56,50,6,60
Alloa,6547,3,17,8,11,67,49,18,59
East Fife,6547,4,16,11,9,50,32,18,59
Albion,6547,5,15,9,12,58,49,9,54
Airdrieon,6547,6,17,3,16,58,53,5,54
Queen's Park,6547,7,14,5,17,46,57,-11,47
Stranraer,6547,8,12,7,17,52,59,-7,43
Peterhead,6547,9,10,8,18,42,58,-16,38
Stenhousem'r,6547,10,6,7,23,41,96,-55,25
Livingston,6548,1,23,6,7,79,43,36,75
Alloa,6548,2,18,7,11,66,42,24,61
Airdrieon,6548,3,15,9,12,46,45,1,54
East Fife,6548,4,14,10,12,55,39,16,52
Queen's Park,6548,5,15,7,14,40,54,-14,52
Albion,6548,6,13,9,14,49,44,5,48
Brechin,6548,7,14,4,18,44,56,-12,46
Peterhead,6548,8,11,11,14,40,49,-9,44
Stranraer,6548,9,11,10,15,52,56,-4,43
Stenhousem'r,6548,10,6,7,23,43,86,-43,25
Alloa,6549,1,21,7,8,77,44,33,70
Livingston,6549,2,20,8,8,87,55,32,68
Airdrieon,6549,3,17,6,13,56,51,5,57
Brechin,6549,4,15,10,11,54,46,8,55
Albion,6549,5,13,10,13,62,62,0,49
Peterhead,6549,6,12,8,16,50,57,-7,44
East Fife,6549,7,11,10,15,47,46,1,43
Stranraer,6549,8,10,9,17,49,69,-20,39
Queen's Park,6549,9,11,5,20,37,56,-19,38
Stenhousem'r,6549,10,10,7,19,47,80,-33,37
Livingston,6550,1,22,6,8,75,50,25,72
Airdrieon,6550,2,19,6,11,62,42,20,63
Albion,6550,3,15,10,11,54,53,1,55
Alloa,6550,4,15,8,13,67,53,14,53
Stranraer,6550,5,14,7,15,53,50,3,49
Brechin,6550,6,13,8,15,43,48,-5,47
Queen's Park,6550,7,13,8,15,41,53,-12,47
East Fife,6550,8,10,13,13,51,48,3,43
Peterhead,6550,9,11,10,15,44,59,-15,43
Stenhousem'r,6550,10,6,8,22,45,79,-34,26
Livingston,6551,1,24,2,10,77,38,39,74
Brechin,6551,2,20,5,11,52,38,14,65
Alloa,6551,3,18,6,12,72,51,21,60
Airdrieon,6551,4,17,6,13,55,53,2,57
Stranraer,6551,5,15,7,14,57,58,-1,52
Albion,6551,6,13,9,14,54,52,2,48
East Fife,6551,7,12,10,14,53,49,4,46
Peterhead,6551,8,11,8,17,42,61,-19,41
Queen's Park,6551,9,10,8,18,33,53,-20,38
Stenhousem'r,6551,10,6,7,23,42,84,-42,25
Livingston,6552,1,19,6,11,72,48,24,63
Airdrieon,6552,2,19,4,13,67,54,13,61
Albion,6552,3,19,4,13,59,52,7,61
Alloa,6552,4,18,5,13,65,51,14,59
Brechin,6552,5,17,4,15,46,43,3,55
Stranraer,6552,6,15,7,14,52,52,0,52
Peterhead,6552,7,13,7,16,47,51,-4,46
Queen's Park,6552,8,13,7,16,39,47,-8,46
East Fife,6552,9,11,8,17,48,58,-10,41
Stenhousem'r,6552,10,7,6,23,44,83,-39,27
Livingston,6553,1,24,4,8,86,43,43,76
Alloa,6553,2,16,10,10,65,47,18,58
Stranraer,6553,3,18,4,14,69,63,6,58
Peterhead,6553,4,16,4,16,49,51,-2,52
Albion,6553,5,14,6,16,59,59,0,48
Airdrieon,6553,6,15,3,18,58,61,-3,48
Queen's Park,6553,7,12,10,14,36,49,-13,46
East Fife,6553,8,11,12,13,56,53,3,45
Brechin,6553,9,13,6,17,42,53,-11,45
Stenhousem'r,6553,10,9,5,22,45,86,-41,32
Livingston,6554,1,23,2,11,86,56,30,71
Airdrieon,6554,2,17,8,11,64,56,8,59
Alloa,6554,3,16,8,12,61,46,15,56
Brechin,6554,4,16,6,14,49,49,0,54
East Fife,6554,5,14,11,11,55,42,13,53
Peterhead,6554,6,14,9,13,50,55,-5,51
Albion,6554,7,14,6,16,60,55,5,48
Queen's Park,6554,8,12,8,16,40,56,-16,44
Stranraer,6554,9,10,9,17,48,61,-13,39
Stenhousem'r,6554,10,5,11,20,51,88,-37,26
Alloa,6555,1,20,8,8,71,42,29,68
Livingston,6555,2,19,5,12,70,61,9,62
Brechin,6555,3,17,7,12,57,45,12,58
Stranraer,6555,4,15,6,15,56,55,1,51
Airdrieon,6555,5,14,8,14,61,60,1,50
Peterhead,6555,6,13,10,13,54,60,-6,49
Queen's Park,6555,7,13,9,14,46,48,-2,48
East Fife,6555,8,11,10,15,47,51,-4,43
Albion,6555,9,10,11,15,48,55,-7,41
Stenhousem'r,6555,10,8,6,22,44,77,-33,30
Alloa,6556,1,22,7,7,75,46,29,73
Livingston,6556,2,20,3,13,77,50,27,63
Airdrieon,6556,3,16,11,9,63,52,11,59
Albion,6556,4,17,5,14,52,53,-1,56
Peterhead,6556,5,15,8,13,57,56,1,53
Brechin,6556,6,16,2,18,52,58,-6,50
Stranraer,6556,7,14,4,18,49,54,-5,46
Queen's Park,6556,8,12,6,18,34,44,-10,42
East Fife,6556,9,9,8,19,50,58,-8,35
Stenhousem'r,6556,10,9,6,21,46,84,-38,33
Livingston,6557,1,22,4,10,83,47,36,70
Alloa,6557,2,18,8,10,78,55,23,62
Airdrieon,6557,3,17,7,12,61,55,6,58
Brechin,6557,4,17,5,14,50,53,-3,56
Queen's Park,6557,5,14,10,12,50,50,0,52
Peterhead,6557,6,14,9,13,54,60,-6,51
Albion,6557,7,12,9,15,50,53,-3,45
Stranraer,6557,8,12,4,20,52,66,-14,40
East Fife,6557,9,10,7,19,51,59,-8,37
Stenhousem'r,6557,10,7,11,18,47,78,-31,32
Alloa,6558,1,22,7,7,83,45,38,73
Livingston,6558,2,21,4,11,84,53,31,67
Brechin,6558,3,17,4,15,54,53,1,55
Airdrieon,6558,4,14,7,15,57,61,-4,49
Albion,6558,5,13,9,14,53,50,3,48
East Fife,6558,6,11,13,12,49,45,4,46
Stranraer,6558,7,13,6,17,49,63,-14,45
Peterhead,6558,8,10,13,13,46,59,-13,43
Queen's Park,6558,9,11,7,18,37,50,-13,40
Stenhousem'r,6558,10,8,10,18,45,78,-33,34
Livingston,6559,1,23,4,9,78,46,32,73
Brechin,6559,2,17,11,8,51,41,10,62
Airdrieon,6559,3,17,6,13,58,55,3,57
Queen's Park,6559,4,15,7,14,38,40,-2,52
Alloa,6559,5,14,7,15,58,47,11,49
Albion,6559,6,13,8,15,51,55,-4,47
East Fife,6559,7,13,7,16,58,59,-1,46
Stranraer,6559,8,12,7,17,51,59,-8,43
Peterhead,6559,9,13,4,19,39,50,-11,43
Stenhousem'r,6559,10,9,7,20,40,70,-30,34
Alloa,6560,1,23,8,5,84,39,45,77
Livingston,6560,2,21,4,11,78,47,31,67
Airdrieon,6560,3,15,9,12,59,55,4,54
Peterhead,6560,4,14,10,12,50,52,-2,52
Queen's Park,6560,5,14,8,14,42,47,-5,50
Albion,6560,6,13,9,14,53,50,3,48
East Fife,6560,7,13,9,14,51,53,-2,48
Stranraer,6560,8,12,6,18,50,59,-9,42
Brechin,6560,9,11,6,19,47,61,-14,39
Stenhousem'r,6560,10,6,7,23,43,94,-51,25
Livingston,6561,1,23,1,12,78,48,30,70
Alloa,6561,2,16,11,9,66,47,19,59
Brechin,6561,3,16,9,11,56,47,9,57
Peterhead,6561,4,16,8,12,54,45,9,56
Queen's Park,6561,5,14,7,15,38,43,-5,49
Albion,6561,6,12,12,12,52,52,0,48
Airdrieon,6561,7,13,7,16,48,62,-14,46
East Fife,6561,8,11,11,14,49,46,3,44
Stranraer,6561,9,12,5,19,49,60,-11,41
Stenhousem'r,6561,10,7,9,20,45,85,-40,30
Livingston,6562,1,23,4,9,82,49,33,73
Airdrieon,6562,2,19,6,11,65,53,12,63
Alloa,6562,3,17,9,10,66,49,17,60
Peterhead,6562,4,14,9,13,61,58,3,51
Brechin,6562,5,15,6,15,50,49,1,51
Albion,6562,6,14,7,15,61,61,0,49
East Fife,6562,7,9,13,14,55,62,-7,40
Stenhousem'r,6562,8,11,7,18,55,79,-24,40
Queen's Park,6562,9,9,11,16,37,51,-14,38
Stranraer,6562,10,9,8,19,49,70,-21,35
Livingston,6563,1,21,5,10,72,51,21,68
Airdrieon,6563,2,17,7,12,62,51,11,58
Alloa,6563,3,16,9,11,68,44,24,57
Brechin,6563,4,17,6,13,50,48,2,57
Albion,6563,5,15,11,10,55,45,10,56
Stranraer,6563,6,17,4,15,60,55,5,55
East Fife,6563,7,12,9,15,50,52,-2,45
Peterhead,6563,8,12,8,16,52,57,-5,44
Queen's Park,6563,9,10,11,15,32,48,-16,41
Stenhousem'r,6563,10,4,8,24,39,89,-50,20
Livingston,6564,1,22,5,9,77,48,29,71
Brechin,6564,2,17,8,11,55,46,9,59
Alloa,6564,3,16,7,13,69,55,14,55
Albion,6564,4,15,9,12,59,52,7,54
East Fife,6564,5,14,11,11,52,44,8,53
Airdrieon,6564,6,14,9,13,61,62,-1,51
Peterhead,6564,7,12,6,18,47,58,-11,42
Stranraer,6564,8,12,6,18,46,64,-18,42
Queen's Park,6564,9,11,8,17,46,60,-14,41
Stenhousem'r,6564,10,8,9,19,50,73,-23,33
Albion,6565,1,19,9,8,57,37,20,66
Alloa,6565,2,18,8,10,67,49,18,62
Livingston,6565,3,19,4,13,71,47,24,61
Brechin,6565,4,17,7,12,62,42,20,58
Airdrieon,6565,5,17,7,12,59,53,6,58
Stranraer,6565,6,13,7,16,54,61,-7,46
East Fife,6565,7,11,10,15,55,59,-4,43
Peterhead,6565,8,11,9,16,47,60,-13,42
Queen's Park,6565,9,12,6,18,31,49,-18,42
Stenhousem'r,6565,10,6,7,23,45,91,-46,25
Livingston,6566,1,21,5,10,75,47,28,68
Brechin,6566,2,20,6,10,54,32,22,66
Alloa,6566,3,19,6,11,66,43,23,63
Airdrieon,6566,4,18,8,10,68,42,26,62
Albion,6566,5,14,8,14,51,62,-11,50
Peterhead,6566,6,13,7,16,49,58,-9,46
East Fife,6566,7,11,12,13,47,40,7,45
Stranraer,6566,8,13,5,18,52,63,-11,44
Queen's Park,6566,9,10,7,19,31,52,-21,37
Stenhousem'r,6566,10,6,6,24,33,87,-54,24
Livingston,6567,1,24,5,7,81,40,41,77
Alloa,6567,2,19,6,11,80,60,20,63
Albion,6567,3,18,7,11,60,55,5,61
Brechin,6567,4,17,4,15,55,51,4,55
Airdrieon,6567,5,15,9,12,72,64,8,54
Peterhead,6567,6,14,8,14,56,57,-1,50
Stranraer,6567,7,12,5,19,47,62,-15,41
Queen's Park,6567,8,10,7,19,35,59,-24,37
East Fife,6567,9,9,9,18,51,61,-10,36
Stenhousem'r,6567,10,7,10,19,53,81,-28,31
Alloa,6568,1,22,6,8,80,40,40,72
Livingston,6568,2,19,5,12,76,56,20,62
Albion,6568,3,17,5,14,57,54,3,56
Airdrieon,6568,4,16,6,14,62,59,3,54
Brechin,6568,5,15,8,13,51,52,-1,53
Peterhead,6568,6,14,7,15,53,56,-3,49
Queen's Park,6568,7,13,5,18,38,60,-22,44
East Fife,6568,8,11,10,15,45,45,0,43
Stranraer,6568,9,13,3,20,57,67,-10,42
Stenhousem'r,6568,10,8,9,19,48,78,-30,33
Livingston,6569,1,20,7,9,72,42,30,67
Alloa,6569,2,18,8,10,73,44,29,62
Airdrieon,6569,3,17,6,13,50,45,5,57
Brechin,6569,4,16,5,15,55,52,3,53
Stranraer,6569,5,13,11,12,49,47,2,50
East Fife,6569,6,12,11,13,52,53,-1,47
Albion,6569,7,13,7,16,52,58,-6,46
Queen's Park,6569,8,12,10,14,40,50,-10,46
Peterhead,6569,9,12,7,17,41,55,-14,43
Stenhousem'r,6569,10,7,8,21,47,85,-38,29
Livingston,6570,1,21,5,10,79,56,23,68
Alloa,6570,2,18,9,9,69,47,22,63
Brechin,6570,3,17,8,11,55,47,8,59
Airdrieon,6570,4,16,6,14,57,54,3,54
Albion,6570,5,14,9,13,51,45,6,51
Queen's Park,6570,6,12,9,15,35,44,-9,45
Peterhead,6570,7,11,11,14,45,57,-12,44
East Fife,6570,8,11,10,15,53,54,-1,43
Stranraer,6570,9,12,6,18,50,59,-9,42
Stenhousem'r,6570,10,7,9,20,38,69,-31,30
Livingston,6571,1,23,2,11,75,43,32,71
Albion,6571,2,20,9,7,63,42,21,69
Alloa,6571,3,20,7,9,61,43,18,67
Brechin,6571,4,17,5,14,49,40,9,56
Airdrieon,6571,5,15,9,12,56,52,4,54
Stranraer,6571,6,15,5,16,55,58,-3,50
Peterhead,6571,7,10,11,15,43,49,-6,41
Queen's Park,6571,8,9,9,18,36,59,-23,36
East Fife,6571,9,8,10,18,40,53,-13,34
Stenhousem'r,6571,10,6,7,23,41,80,-39,25
Livingston,6572,1,18,9,9,75,50,25,63
Alloa,6572,2,18,6,12,79,53,26,60
Airdrieon,6572,3,17,7,12,63,55,8,58
Albion,6572,4,15,10,11,51,45,6,55
Peterhead,6572,5,14,8,14,55,56,-1,50
Brechin,6572,6,14,7,15,49,53,-4,49
Queen's Park,6572,7,13,10,13,40,50,-10,49
Stranraer,6572,8,12,7,17,40,58,-18,43
East Fife,6572,9,10,12,14,49,43,6,42
Stenhousem'r,6572,10,6,10,20,38,76,-38,28
Livingston,6573,1,18,8,10,72,49,23,62
Alloa,6573,2,16,10,10,72,49,23,58
Airdrieon,6573,3,16,9,11,62,57,5,57
East Fife,6573,4,12,13,11,50,38,12,49
Albion,6573,5,12,13,11,49,50,-1,49
Brechin,6573,6,13,9,14,48,49,-1,48
Peterhead,6573,7,12,11,13,54,61,-7,47
Stranraer,6573,8,13,7,16,56,61,-5,46
Queen's Park,6573,9,9,11,16,35,50,-15,38
Stenhousem'r,6573,10,8,11,17,41,75,-34,35
Livingston,6574,1,20,10,6,76,41,35,70
Brechin,6574,2,20,4,12,60,49,11,64
Alloa,6574,3,16,10,10,71,46,25,58
Airdrieon,6574,4,12,10,14,58,64,-6,46
Queen's Park,6574,5,12,10,14,35,47,-12,46
Stranraer,6574,6,12,8,16,55,60,-5,44
East Fife,6574,7,11,11,14,46,51,-5,44
Peterhead,6574,8,8,16,12,39,51,-12,40
Albion,6574,9,8,14,14,47,59,-12,38
Stenhousem'r,6574,10,9,11,16,47,66,-19,38
Airdrieon,6575,1,21,4,11,66,48,18,67
Brechin,6575,2,18,9,9,52,40,12,63
Livingston,6575,3,18,6,12,76,54,22,60
Alloa,6575,4,16,9,11,71,50,21,57
Albion,6575,5,15,8,13,50,47,3,53
Peterhead,6575,6,13,7,16,43,45,-2,46
Queen's Park,6575,7,13,6,17,36,58,-22,45
Stranraer,6575,8,11,9,16,49,60,-11,42
East Fife,6575,9,10,9,17,49,59,-10,39
Stenhousem'r,6575,10,8,7,21,41,72,-31,31
Livingston,6576,1,22,5,9,83,48,35,71
Alloa,6576,2,17,10,9,70,46,24,61
Airdrieon,6576,3,15,11,10,55,49,6,56
Brechin,6576,4,17,5,14,52,50,2,56
Albion,6576,5,15,10,11,67,60,7,55
Peterhead,6576,6,13,11,12,47,42,5,50
Stranraer,6576,7,14,4,18,57,69,-12,46
East Fife,6576,8,11,11,14,45,46,-1,44
Queen's Park,6576,9,11,8,17,34,53,-19,41
Stenhousem'r,6576,10,4,7,25,40,87,-47,19
Livingston,6577,1,23,5,8,74,45,29,74
Alloa,6577,2,19,7,10,71,41,30,64
Brechin,6577,3,20,4,12,58,51,7,64
Albion,6577,4,14,9,13,56,56,0,51
Peterhead,6577,5,14,6,16,42,44,-2,48
Airdrieon,6577,6,12,9,15,51,57,-6,45
East Fife,6577,7,11,10,15,51,51,0,43
Stranraer,6577,8,12,7,17,40,54,-14,43
Queen's Park,6577,9,11,7,18,39,59,-20,40
Stenhousem'r,6577,10,8,8,20,47,71,-24,32
Airdrieon,6578,1,19,8,9,59,45,14,65
Alloa,6578,2,18,9,9,67,47,20,63
Livingston,6578,3,17,8,11,66,46,20,59
Stranraer,6578,4,15,6,15,51,49,2,51
Queen's Park,6578,5,14,7,15,40,41,-1,49
East Fife,6578,6,13,9,14,52,47,5,48
Brechin,6578,7,13,9,14,47,45,2,48
Peterhead,6578,8,12,9,15,49,61,-12,45
Albion,6578,9,12,7,17,49,57,-8,43
Stenhousem'r,6578,10,8,6,22,48,90,-42,30
Alloa,6579,1,21,6,9,74,40,34,69
Brechin,6579,2,20,5,11,57,40,17,65
Livingston,6579,3,20,3,13,75,58,17,63
Airdrieon,6579,4,17,3,16,56,60,-4,54
East Fife,6579,5,13,8,15,59,53,6,47
Stranraer,6579,6,12,8,16,53,54,-1,44
Queen's Park,6579,7,12,7,17,36,47,-11,43
Peterhead,6579,8,11,10,15,44,61,-17,43
Albion,6579,9,11,8,17,50,61,-11,41
Stenhousem'r,6579,10,10,8,18,52,82,-30,38
Livingston,6580,1,23,4,9,81,41,40,73
Albion,6580,2,18,5,13,55,48,7,59
Alloa,6580,3,17,5,14,69,50,19,56
Airdrieon,6580,4,15,10,11,57,49,8,55
Stranraer,6580,5,15,6,15,56,55,1,51
Brechin,6580,6,15,3,18,52,68,-16,48
Queen's Park,6580,7,14,6,16,42,58,-16,48
East Fife,6580,8,12,8,16,52,51,1,44
Stenhousem'r,6580,9,11,6,19,50,77,-27,39
Peterhead,6580,10,11,5,20,43,60,-17,38
Airdrieon,6581,1,22,3,11,64,53,11,69
Livingston,6581,2,21,5,10,80,42,38,68
Alloa,6581,3,20,5,11,72,46,26,65
Brechin,6581,4,15,6,15,52,55,-3,51
Albion,6581,5,13,11,12,64,56,8,50
Queen's Park,6581,6,15,4,17,38,43,-5,49
Peterhead,6581,7,13,9,14,40,52,-12,48
East Fife,6581,8,11,13,12,51,48,3,46
Stranraer,6581,9,12,5,19,50,67,-17,41
Stenhousem'r,6581,10,4,7,25,36,85,-49,19
Livingston,6582,1,25,1,10,85,45,40,76
Alloa,6582,2,17,11,8,73,46,27,62
Brechin,6582,3,17,7,12,52,59,-7,58
Airdrieon,6582,4,15,8,13,53,54,-1,53
Peterhead,6582,5,13,13,10,61,58,3,52
Albion,6582,6,13,10,13,52,51,1,49
Queen's Park,6582,7,13,7,16,41,47,-6,46
East Fife,6582,8,12,7,17,48,49,-1,43
Stranraer,6582,9,12,3,21,49,64,-15,39
Stenhousem'r,6582,10,6,7,23,47,88,-41,25
Alloa,6583,1,20,8,8,75,36,39,68
Peterhead,6583,2,20,3,13,56,45,11,63
Brechin,6583,3,19,4,13,58,55,3,61
Airdrieon,6583,4,17,8,11,68,59,9,59
Livingston,6583,5,18,4,14,72,57,15,58
Queen's Park,6583,6,14,5,17,38,53,-15,47
East Fife,6583,7,12,5,19,54,58,-4,41
Albion,6583,8,12,5,19,46,58,-12,41
Stenhousem'r,6583,9,11,6,19,46,74,-28,39
Stranraer,6583,10,9,8,19,40,58,-18,35
Livingston,6584,1,22,4,10,80,48,32,70
Airdrieon,6584,2,20,3,13,62,53,9,63
Alloa,6584,3,17,8,11,67,45,22,59
Albion,6584,4,17,6,13,71,61,10,57
Brechin,6584,5,16,5,15,49,60,-11,53
Stranraer,6584,6,14,6,16,60,57,3,48
Peterhead,6584,7,13,6,17,47,54,-7,45
Queen's Park,6584,8,12,7,17,41,47,-6,43
East Fife,6584,9,11,8,17,49,59,-10,41
Stenhousem'r,6584,10,8,7,21,49,91,-42,31
Livingston,6585,1,25,4,7,83,40,43,79
Airdrieon,6585,2,20,6,10,61,47,14,66
Alloa,6585,3,16,11,9,62,45,17,59
Brechin,6585,4,14,6,16,49,57,-8,48
Queen's Park,6585,5,13,8,15,40,50,-10,47
Peterhead,6585,6,13,8,15,46,59,-13,47
East Fife,6585,7,10,11,15,55,51,4,41
Stranraer,6585,8,11,8,17,59,65,-6,41
Albion,6585,9,8,13,15,51,63,-12,37
Stenhousem'r,6585,10,7,11,18,44,73,-29,32
Livingston,6586,1,26,2,8,87,44,43,80
Stranraer,6586,2,18,5,13,59,53,6,59
Alloa,6586,3,17,6,13,76,50,26,57
Brechin,6586,4,16,5,15,46,47,-1,53
Albion,6586,5,15,8,13,51,53,-2,53
Airdrieon,6586,6,14,7,15,58,56,2,49
Queen's Park,6586,7,12,5,19,39,58,-19,41
Stenhousem'r,6586,8,10,11,15,45,76,-31,41
East Fife,6586,9,10,9,17,40,51,-11,39
Peterhead,6586,10,8,10,18,45,58,-13,34
Alloa,6587,1,19,10,7,67,41,26,67
Livingston,6587,2,19,7,10,73,50,23,64
Brechin,6587,3,17,6,13,53,42,11,57
Airdrieon,6587,4,15,8,13,52,53,-1,53
Albion,6587,5,13,9,14,54,51,3,48
Queen's Park,6587,6,12,9,15,39,54,-15,45
Peterhead,6587,7,12,8,16,45,58,-13,44
Stenhousem'r,6587,8,11,10,15,59,71,-12,43
East Fife,6587,9,10,9,17,39,47,-8,39
Stranraer,6587,10,8,12,16,42,56,-14,36
Livingston,6588,1,21,7,8,74,43,31,70
Brechin,6588,2,19,9,8,50,34,16,66
Alloa,6588,3,15,13,8,75,45,30,58
Airdrieon,6588,4,16,6,14,57,60,-3,54
Queen's Park,6588,5,12,10,14,40,48,-8,46
Peterhead,6588,6,12,10,14,50,59,-9,46
Albion,6588,7,11,13,12,47,56,-9,46
East Fife,6588,8,11,11,14,56,49,7,44
Stranraer,6588,9,11,3,22,45,59,-14,36
Stenhousem'r,6588,10,8,6,22,49,90,-41,30
Livingston,6589,1,21,3,12,70,49,21,66
Airdrieon,6589,2,18,7,11,71,58,13,61
Alloa,6589,3,17,9,10,66,46,20,60
Brechin,6589,4,19,3,14,55,50,5,60
East Fife,6589,5,15,9,12,61,44,17,54
Peterhead,6589,6,15,9,12,52,54,-2,54
Stranraer,6589,7,15,4,17,54,62,-8,49
Albion,6589,8,11,9,16,50,56,-6,42
Queen's Park,6589,9,9,10,17,36,51,-15,37
Stenhousem'r,6589,10,5,7,24,42,87,-45,22
Livingston,6590,1,22,5,9,75,47,28,71
Brechin,6590,2,18,6,12,56,48,8,60
Alloa,6590,3,17,7,12,74,57,17,58
Albion,6590,4,14,11,11,64,52,12,53
Airdrieon,6590,5,15,8,13,54,57,-3,53
Stranraer,6590,6,16,4,16,60,57,3,52
Peterhead,6590,7,12,10,14,52,57,-5,46
Queen's Park,6590,8,13,7,16,42,53,-11,46
East Fife,6590,9,9,9,18,47,60,-13,36
Stenhousem'r,6590,10,7,7,22,41,77,-36,28
Livingston,6591,1,22,4,10,86,47,39,70
Alloa,6591,2,18,9,9,68,44,24,63
Peterhead,6591,3,17,5,14,59,52,7,56
Airdrieon,6591,4,15,10,11,64,57,7,55
Brechin,6591,5,16,2,18,56,60,-4,50
Stranraer,6591,6,14,5,17,52,62,-10,47
Albion,6591,7,12,10,14,48,57,-9,46
East Fife,6591,8,10,9,17,49,59,-10,39
Queen's Park,6591,9,11,6,19,37,60,-23,39
Stenhousem'r,6591,10,8,14,14,53,74,-21,38
Livingston,6592,1,23,4,9,78,44,34,73
Alloa,6592,2,16,11,9,73,49,24,59
Airdrieon,6592,3,16,8,12,54,50,4,56
Brechin,6592,4,15,7,14,45,43,2,52
Peterhead,6592,5,13,10,13,48,60,-12,49
Queen's Park,6592,6,11,15,10,30,37,-7,48
Albion,6592,7,11,9,16,49,53,-4,42
Stenhousem'r,6592,8,10,11,15,52,64,-12,41
East Fife,6592,9,9,10,17,44,49,-5,37
Stranraer,6592,10,9,9,18,46,70,-24,36
Livingston,6593,1,21,6,9,71,44,27,69
Alloa,6593,2,18,8,10,74,44,30,62
Brechin,6593,3,17,5,14,53,51,2,56
Albion,6593,4,15,10,11,57,48,9,55
Airdrieon,6593,5,16,7,13,64,56,8,55
Peterhead,6593,6,13,7,16,50,56,-6,46
Stranraer,6593,7,13,5,18,55,63,-8,44
East Fife,6593,8,10,10,16,47,51,-4,40
Queen's Park,6593,9,9,10,17,35,63,-28,37
Stenhousem'r,6593,10,9,10,17,49,79,-30,37
Airdrieon,6594,1,22,4,10,69,52,17,70
Alloa,6594,2,19,9,8,71,47,24,66
Livingston,6594,3,20,3,13,71,49,22,63
Queen's Park,6594,4,16,5,15,49,57,-8,53
Stranraer,6594,5,14,4,18,51,62,-11,46
Brechin,6594,6,12,9,15,41,48,-7,45
East Fife,6594,7,11,10,15,49,51,-2,43
Albion,6594,8,11,10,15,52,59,-7,43
Peterhead,6594,9,12,5,19,47,61,-14,41
Stenhousem'r,6594,10,9,9,18,58,72,-14,36
Alloa,6595,1,19,9,8,69,46,23,66
Brechin,6595,2,18,5,13,51,51,0,59
Queen's Park,6595,3,17,6,13,53,46,7,57
Airdrieon,6595,4,16,6,14,56,54,2,54
Peterhead,6595,5,14,10,12,54,53,1,52
Albion,6595,6,14,9,13,58,63,-5,51
Livingston,6595,7,15,5,16,67,56,11,50
Stranraer,6595,8,13,4,19,48,60,-12,43
East Fife,6595,9,11,9,16,53,54,-1,42
Stenhousem'r,6595,10,8,7,21,47,73,-26,31
Livingston,6596,1,20,4,12,78,47,31,64
Alloa,6596,2,18,9,9,74,50,24,63
Airdrieon,6596,3,19,4,13,68,59,9,61
Albion,6596,4,17,7,12,65,54,11,58
Brechin,6596,5,12,10,14,45,48,-3,46
Peterhead,6596,6,12,9,15,44,54,-10,45
Queen's Park,6596,7,11,11,14,40,53,-13,44
East Fife,6596,8,10,11,15,51,56,-5,41
Stranraer,6596,9,11,8,17,50,59,-9,41
Stenhousem'r,6596,10,10,7,19,55,90,-35,37
Livingston,6597,1,20,5,11,72,46,26,65
Peterhead,6597,2,19,7,10,54,47,7,64
Alloa,6597,3,18,9,9,82,53,29,63
Albion,6597,4,19,4,13,61,49,12,61
Airdrieon,6597,5,17,5,14,66,59,7,56
Brechin,6597,6,14,8,14,43,46,-3,50
East Fife,6597,7,12,6,18,51,52,-1,42
Queen's Park,6597,8,11,6,19,39,62,-23,39
Stenhousem'r,6597,9,11,4,21,48,76,-28,37
Stranraer,6597,10,9,6,21,45,71,-26,33
Livingston,6598,1,20,6,10,78,51,27,66
Alloa,6598,2,19,8,9,79,47,32,65
Airdrieon,6598,3,18,7,11,67,53,14,61
Brechin,6598,4,18,5,13,47,42,5,59
Stranraer,6598,5,14,9,13,55,55,0,51
Peterhead,6598,6,15,4,17,44,58,-14,49
Albion,6598,7,13,8,15,55,55,0,47
East Fife,6598,8,10,10,16,56,54,2,40
Stenhousem'r,6598,9,9,8,19,54,87,-33,35
Queen's Park,6598,10,8,7,21,36,69,-33,31
Alloa,6599,1,19,8,9,72,43,29,65
Brechin,6599,2,20,5,11,54,42,12,65
Livingston,6599,3,20,3,13,74,52,22,63
Airdrieon,6599,4,18,7,11,61,47,14,61
Peterhead,6599,5,15,6,15,59,53,6,51
Albion,6599,6,14,9,13,54,59,-5,51
Queen's Park,6599,7,12,9,15,38,54,-16,45
East Fife,6599,8,11,8,17,47,53,-6,41
Stranraer,6599,9,10,9,17,47,61,-14,39
Stenhousem'r,6599,10,5,8,23,43,85,-42,23
Alloa,6600,1,18,9,9,69,45,24,63
Livingston,6600,2,19,5,12,71,47,24,62
Airdrieon,6600,3,18,8,10,57,50,7,62
Brechin,6600,4,17,5,14,57,52,5,56
East Fife,6600,5,13,12,11,55,45,10,51
Peterhead,6600,6,14,8,14,51,53,-2,50
Stranraer,6600,7,14,4,18,52,57,-5,46
Albion,6600,8,12,8,16,44,54,-10,44
Queen's Park,6600,9,11,9,16,38,47,-9,42
Stenhousem'r,6600,10,6,8,22,36,80,-44,26
Livingston,6601,1,20,4,12,76,48,28,64
Alloa,6601,2,17,10,9,61,43,18,61
East Fife,6601,3,14,11,11,48,44,4,53
Brechin,6601,4,15,7,14,57,56,1,52
Airdrieon,6601,5,16,4,16,53,59,-6,52
Peterhead,6601,6,14,9,13,46,46,0,51
Queen's Park,6601,7,13,10,13,39,49,-10,49
Albion,6601,8,13,8,15,62,60,2,47
Stranraer,6601,9,12,8,16,51,53,-2,44
Stenhousem'r,6601,10,6,9,21,45,80,-35,27
Livingston,6602,1,24,5,7,70,33,37,77
Alloa,6602,2,22,3,11,79,51,28,69
Brechin,6602,3,19,8,9,59,38,21,65
Airdrieon,6602,4,17,6,13,63,48,15,57
Albion,6602,5,16,5,15,59,58,1,53
Peterhead,6602,6,11,14,11,46,53,-7,47
Queen's Park,6602,7,11,8,17,36,56,-20,41
Stenhousem'r,6602,8,10,7,19,46,79,-33,37
Stranraer,6602,9,9,5,22,48,66,-18,32
East Fife,6602,10,6,9,21,44,68,-24,27
Alloa,6603,1,23,6,7,83,46,37,75
Livingston,6603,2,20,7,9,70,49,21,67
Albion,6603,3,15,10,11,60,44,16,55
Brechin,6603,4,16,6,14,48,43,5,54
Airdrieon,6603,5,14,7,15,49,57,-8,49
Peterhead,6603,6,13,8,15,52,52,0,47
Queen's Park,6603,7,13,8,15,40,49,-9,47
East Fife,6603,8,12,6,18,51,67,-16,42
Stranraer,6603,9,10,8,18,44,59,-15,38
Stenhousem'r,6603,10,7,8,21,44,75,-31,29
Livingston,6604,1,23,5,8,82,50,32,74
Brechin,6604,2,19,7,10,61,43,18,64
Alloa,6604,3,19,6,11,65,47,18,63
Stranraer,6604,4,15,7,14,61,56,5,52
Airdrieon,6604,5,13,10,13,54,58,-4,49
Queen's Park,6604,6,13,7,16,48,54,-6,46
Albion,6604,7,12,9,15,50,59,-9,45
East Fife,6604,8,11,11,14,58,53,5,44
Peterhead,6604,9,11,8,17,48,68,-20,41
Stenhousem'r,6604,10,6,6,24,41,80,-39,24
Livingston,6605,1,21,6,9,75,48,27,69
Alloa,6605,2,19,7,10,72,53,19,64
Peterhead,6605,3,18,9,9,69,56,13,63
Brechin,6605,4,16,10,10,60,44,16,58
Airdrieon,6605,5,15,9,12,59,53,6,54
Albion,6605,6,13,11,12,56,51,5,50
East Fife,6605,7,12,10,14,60,57,3,46
Stranraer,6605,8,10,7,19,51,66,-15,37
Queen's Park,6605,9,7,11,18,33,64,-31,32
Stenhousem'r,6605,10,5,8,23,47,90,-43,23
Livingston,6606,1,20,2,14,66,51,15,62
Alloa,6606,2,18,7,11,70,51,19,61
Albion,6606,3,17,7,12,54,50,4,58
East Fife,6606,4,15,10,11,53,36,17,55
Brechin,6606,5,15,7,14,50,46,4,52
Airdrieon,6606,6,15,7,14,51,54,-3,52
Peterhead,6606,7,14,9,13,48,48,0,51
Stranraer,6606,8,13,3,20,52,67,-15,42
Queen's Park,6606,9,10,8,18,33,48,-15,38
Stenhousem'r,6606,10,8,10,18,51,77,-26,34
Brechin,6607,1,20,5,11,53,39,14,65
Airdrieon,6607,2,19,6,11,56,48,8,63
Livingston,6607,3,17,11,8,70,41,29,62
Albion,6607,4,17,7,12,53,46,7,58
Alloa,6607,5,15,11,10,67,44,23,56
Peterhead,6607,6,12,12,12,43,43,0,48
East Fife,6607,7,12,7,17,45,54,-9,43
Stranraer,6607,8,11,8,17,45,55,-10,41
Queen's Park,6607,9,9,8,19,31,52,-21,35
Stenhousem'r,6607,10,7,7,22,41,82,-41,28
Airdrieon,6608,1,21,8,7,59,42,17,71
Alloa,6608,2,21,7,8,79,39,40,70
Livingston,6608,3,21,5,10,69,39,30,68
Brechin,6608,4,13,9,14,43,45,-2,48
Albion,6608,5,14,5,17,40,46,-6,47
East Fife,6608,6,11,13,12,48,42,6,46
Peterhead,6608,7,12,10,14,42,50,-8,46
Stranraer,6608,8,12,8,16,50,63,-13,44
Queen's Park,6608,9,9,6,21,30,59,-29,33
Stenhousem'r,6608,10,7,7,22,40,75,-35,28
Livingston,6609,1,23,3,10,75,48,27,72
Alloa,6609,2,19,5,12,73,46,27,62
Airdrieon,6609,3,17,9,10,55,51,4,60
Peterhead,6609,4,16,8,12,55,47,8,56
Albion,6609,5,15,6,15,59,54,5,51
Brechin,6609,6,14,5,17,45,47,-2,47
Queen's Park,6609,7,13,6,17,35,58,-23,45
Stranraer,6609,8,12,8,16,56,61,-5,44
East Fife,6609,9,9,9,18,47,57,-10,36
Stenhousem'r,6609,10,10,5,21,50,81,-31,35
Livingston,6610,1,23,3,10,81,51,30,72
Alloa,6610,2,19,11,6,65,31,34,68
Peterhead,6610,3,18,7,11,56,54,2,61
Airdrieon,6610,4,15,4,17,56,56,0,49
Albion,6610,5,12,11,13,50,52,-2,47
Queen's Park,6610,6,12,10,14,39,40,-1,46
Brechin,6610,7,12,6,18,40,62,-22,42
East Fife,6610,8,10,10,16,42,46,-4,40
Stenhousem'r,6610,9,9,12,15,54,71,-17,39
Stranraer,6610,10,11,4,21,47,67,-20,37
Livingston,6611,1,20,9,7,80,45,35,69
Brechin,6611,2,19,5,12,54,42,12,62
Airdrieon,6611,3,17,11,8,54,44,10,62
Alloa,6611,4,17,7,12,74,51,23,58
East Fife,6611,5,13,10,13,50,45,5,49
Albion,6611,6,12,8,16,46,52,-6,44
Stranraer,6611,7,12,8,16,57,68,-11,44
Peterhead,6611,8,10,13,13,46,54,-8,43
Queen's Park,6611,9,10,7,19,36,62,-26,37
Stenhousem'r,6611,10,7,8,21,43,77,-34,29
Livingston,6612,1,19,6,11,65,50,15,63
Queen's Park,6612,2,18,5,13,51,45,6,59
Alloa,6612,3,17,6,13,77,55,22,57
Airdrieon,6612,4,15,8,13,61,55,6,53
Brechin,6612,5,15,6,15,51,54,-3,51
Peterhead,6612,6,14,8,14,46,59,-13,50
Albion,6612,7,14,7,15,56,55,1,49
Stranraer,6612,8,13,7,16,56,63,-7,46
East Fife,6612,9,12,7,17,50,50,0,43
Stenhousem'r,6612,10,6,14,16,40,67,-27,32
Alloa,6613,1,21,7,8,76,45,31,70
Livingston,6613,2,21,5,10,76,48,28,68
East Fife,6613,3,18,7,11,59,43,16,61
Airdrieon,6613,4,16,8,12,58,55,3,56
Brechin,6613,5,15,9,12,50,50,0,54
Albion,6613,6,14,6,16,53,50,3,48
Stranraer,6613,7,14,4,18,48,60,-12,46
Peterhead,6613,8,12,9,15,42,51,-9,45
Queen's Park,6613,9,7,10,19,37,62,-25,31
Stenhousem'r,6613,10,5,9,22,44,79,-35,24
Alloa,6614,1,19,9,8,72,39,33,66
Livingston,6614,2,19,7,10,71,43,28,64
Brechin,6614,3,17,6,13,51,41,10,57
Peterhead,6614,4,17,5,14,49,54,-5,56
Airdrieon,6614,5,16,7,13,63,62,1,55
Queen's Park,6614,6,12,7,17,42,46,-4,43
East Fife,6614,7,12,7,17,45,50,-5,43
Stranraer,6614,8,12,7,17,42,64,-22,43
Albion,6614,9,12,6,18,41,52,-11,42
Stenhousem'r,6614,10,10,7,19,51,76,-25,37
Airdrieon,6615,1,20,4,12,60,52,8,64
Livingston,6615,2,19,6,11,68,39,29,63
Albion,6615,3,18,9,9,64,44,20,63
Brechin,6615,4,19,5,12,55,44,11,62
Alloa,6615,5,15,8,13,72,49,23,53
Peterhead,6615,6,13,6,17,46,57,-11,45
Queen's Park,6615,7,13,6,17,36,62,-26,45
East Fife,6615,8,11,9,16,44,52,-8,42
Stranraer,6615,9,11,7,18,44,57,-13,40
Stenhousem'r,6615,10,8,6,22,37,70,-33,30
Livingston,6616,1,22,3,11,76,42,34,69
Queen's Park,6616,2,18,6,12,45,39,6,60
Alloa,6616,3,16,8,12,64,50,14,56
Brechin,6616,4,16,7,13,53,49,4,55
Stranraer,6616,5,16,4,16,57,65,-8,52
Airdrieon,6616,6,15,7,14,50,59,-9,52
Albion,6616,7,12,8,16,49,51,-2,44
East Fife,6616,8,11,9,16,45,45,0,42
Peterhead,6616,9,11,8,17,43,58,-15,41
Stenhousem'r,6616,10,8,10,18,52,76,-24,34
Livingston,6617,1,23,6,7,75,41,34,75
Albion,6617,2,16,7,13,52,46,6,55
Queen's Park,6617,3,16,6,14,43,43,0,54
Airdrieon,6617,4,15,8,13,56,54,2,53
Brechin,6617,5,16,4,16,50,49,1,52
Peterhead,6617,6,15,7,14,39,45,-6,52
Alloa,6617,7,14,6,16,55,49,6,48
Stranraer,6617,8,14,5,17,50,54,-4,47
East Fife,6617,9,11,11,14,52,48,4,44
Stenhousem'r,6617,10,8,4,24,46,89,-43,28
Livingston,6618,1,23,2,11,82,48,34,71
Albion,6618,2,18,7,11,64,54,10,61
Alloa,6618,3,17,7,12,65,49,16,58
Airdrieon,6618,4,17,6,13,65,62,3,57
Queen's Park,6618,5,16,6,14,45,45,0,54
Brechin,6618,6,15,7,14,44,46,-2,52
Stranraer,6618,7,14,6,16,55,54,1,48
Peterhead,6618,8,12,10,14,61,66,-5,46
East Fife,6618,9,10,10,16,49,51,-2,40
Stenhousem'r,6618,10,4,7,25,40,95,-55,19
Livingston,6619,1,23,6,7,81,42,39,75
Alloa,6619,2,19,9,8,69,43,26,66
Airdrieon,6619,3,17,7,12,62,57,5,58
Brechin,6619,4,16,5,15,51,48,3,53
Albion,6619,5,14,9,13,52,52,0,51
Stranraer,6619,6,14,6,16,54,61,-7,48
Peterhead,6619,7,12,8,16,49,59,-10,44
Queen's Park,6619,8,10,10,16,36,47,-11,40
East Fife,6619,9,9,10,17,42,51,-9,37
Stenhousem'r,6619,10,7,8,21,51,87,-36,29
Alloa,6620,1,20,10,6,78,40,38,70
Livingston,6620,2,19,7,10,77,54,23,64
Brechin,6620,3,19,6,11,51,41,10,63
Airdrieon,6620,4,15,8,13,58,59,-1,53
Stranraer,6620,5,14,8,14,50,57,-7,50
East Fife,6620,6,12,10,14,55,56,-1,46
Peterhead,6620,7,13,6,17,51,53,-2,45
Queen's Park,6620,8,10,11,15,37,50,-13,41
Albion,6620,9,9,9,18,45,59,-14,36
Stenhousem'r,6620,10,9,5,22,41,74,-33,32
Airdrieon,6621,1,19,7,10,62,45,17,64
Livingston,6621,2,19,6,11,79,58,21,63
Brechin,6621,3,16,10,10,56,46,10,58
Alloa,6621,4,16,9,11,70,51,19,57
Stranraer,6621,5,15,7,14,57,59,-2,52
Peterhead,6621,6,14,6,16,52,59,-7,48
Albion,6621,7,11,12,13,50,53,-3,45
Queen's Park,6621,8,12,8,16,37,48,-11,44
East Fife,6621,9,9,10,17,44,51,-7,37
Stenhousem'r,6621,10,4,15,17,43,80,-37,27
Alloa,6622,1,19,9,8,73,43,30,66
Livingston,6622,2,19,6,11,65,42,23,63
Brechin,6622,3,17,8,11,46,40,6,59
Airdrieon,6622,4,14,7,15,52,52,0,49
Albion,6622,5,13,10,13,55,60,-5,49
Peterhead,6622,6,11,13,12,39,41,-2,46
Queen's Park,6622,7,12,8,16,32,47,-15,44
East Fife,6622,8,10,13,13,47,51,-4,43
Stranraer,6622,9,13,3,20,44,60,-16,42
Stenhousem'r,6622,10,10,7,19,56,73,-17,37
Livingston,6623,1,20,6,10,88,55,33,66
Alloa,6623,2,17,7,12,68,46,22,58
Airdrieon,6623,3,17,7,12,55,54,1,58
Brechin,6623,4,16,7,13,47,50,-3,55
Albion,6623,5,14,11,11,56,50,6,53
Peterhead,6623,6,14,7,15,50,55,-5,49
Stranraer,6623,7,14,5,17,55,59,-4,47
Queen's Park,6623,8,13,7,16,38,53,-15,46
Stenhousem'r,6623,9,11,6,19,46,68,-22,39
East Fife,6623,10,7,11,18,45,58,-13,32
Livingston,6624,1,22,6,8,73,41,32,72
Alloa,6624,2,20,10,6,73,36,37,70
Airdrieon,6624,3,15,10,11,56,55,1,55
Queen's Park,6624,4,15,5,16,37,48,-11,50
Peterhead,6624,5,13,9,14,53,60,-7,48
East Fife,6624,6,12,10,14,55,51,4,46
Brechin,6624,7,12,6,18,36,46,-10,42
Albion,6624,8,9,14,13,50,51,-1,41
Stenhousem'r,6624,9,9,11,16,49,70,-21,38
Stranraer,6624,10,9,7,20,42,66,-24,34
Livingston,6625,1,21,6,9,72,43,29,69
Alloa,6625,2,18,11,7,66,44,22,65
Airdrieon,6625,3,17,6,13,63,53,10,57
Brechin,6625,4,15,9,12,39,39,0,54
Queen's Park,6625,5,14,9,13,38,39,-1,51
Albion,6625,6,12,12,12,52,45,7,48
Peterhead,6625,7,12,7,17,41,49,-8,43
Stranraer,6625,8,11,8,17,57,71,-14,41
East Fife,6625,9,9,11,16,39,49,-10,38
Stenhousem'r,6625,10,6,11,19,41,76,-35,29
Alloa,6626,1,20,8,8,74,44,30,68
Livingston,6626,2,21,5,10,68,43,25,68
Airdrieon,6626,3,20,7,9,57,42,15,67
Brechin,6626,4,20,4,12,52,36,16,64
Peterhead,6626,5,13,8,15,49,54,-5,47
Albion,6626,6,12,9,15,54,53,1,45
Stranraer,6626,7,13,6,17,51,60,-9,45
Queen's Park,6626,8,10,6,20,33,55,-22,36
East Fife,6626,9,8,10,18,43,55,-12,34
Stenhousem'r,6626,10,9,5,22,43,82,-39,32
Alloa,6627,1,22,6,8,75,48,27,72
Livingston,6627,2,19,7,10,71,41,30,64
Airdrieon,6627,3,20,4,12,59,48,11,64
Brechin,6627,4,16,8,12,52,44,8,56
Peterhead,6627,5,14,8,14,53,56,-3,50
Queen's Park,6627,6,13,5,18,40,55,-15,44
Stranraer,6627,7,12,7,17,49,57,-8,43
East Fife,6627,8,11,9,16,47,52,-5,42
Stenhousem'r,6627,9,10,6,20,52,85,-33,36
Albion,6627,10,9,8,19,51,63,-12,35
Livingston,6628,1,24,4,8,91,45,46,76
Airdrieon,6628,2,20,5,11,60,43,17,65
Alloa,6628,3,17,8,11,59,40,19,59
Stenhousem'r,6628,4,14,9,13,58,69,-11,51
Stranraer,6628,5,15,4,17,52,63,-11,49
Albion,6628,6,13,9,14,46,48,-2,48
Peterhead,6628,7,13,5,18,45,57,-12,44
Brechin,6628,8,10,9,17,35,49,-14,39
Queen's Park,6628,9,11,6,19,40,59,-19,39
East Fife,6628,10,10,7,19,46,59,-13,37
Livingston,6629,1,22,2,12,65,44,21,68
Alloa,6629,2,18,8,10,62,40,22,62
Brechin,6629,3,18,7,11,49,39,10,61
Albion,6629,4,15,6,15,53,51,2,51
Airdrieon,6629,5,14,8,14,50,54,-4,50
Stranraer,6629,6,13,7,16,54,49,5,46
Queen's Park,6629,7,13,7,16,32,51,-19,46
East Fife,6629,8,9,14,13,43,41,2,41
Peterhead,6629,9,10,10,16,39,49,-10,40
Stenhousem'r,6629,10,8,11,17,48,77,-29,35
Alloa,6630,1,22,4,10,74,39,35,70
Livingston,6630,2,19,9,8,75,46,29,66
Brechin,6630,3,20,4,12,52,46,6,64
Airdrieon,6630,4,15,11,10,53,46,7,56
Peterhead,6630,5,13,11,12,44,44,0,50
Albion,6630,6,14,5,17,46,49,-3,47
East Fife,6630,7,11,10,15,47,44,3,43
Queen's Park,6630,8,11,9,16,39,51,-12,42
Stranraer,6630,9,8,10,18,39,58,-19,34
Stenhousem'r,6630,10,8,5,23,44,90,-46,29
Alloa,6631,1,22,5,9,78,44,34,71
Livingston,6631,2,20,5,11,70,46,24,65
Brechin,6631,3,17,8,11,56,43,13,59
Airdrieon,6631,4,17,8,11,59,50,9,59
Peterhead,6631,5,16,7,13,49,46,3,55
Albion,6631,6,14,10,12,56,53,3,52
Queen's Park,6631,7,12,6,18,36,59,-23,42
Stranraer,6631,8,11,7,18,44,61,-17,40
Stenhousem'r,6631,9,9,8,19,47,75,-28,35
East Fife,6631,10,6,8,22,41,59,-18,26
Livingston,6632,1,21,6,9,78,47,31,69
Alloa,6632,2,20,5,11,61,42,19,65
Brechin,6632,3,17,6,13,53,47,6,57
Airdrieon,6632,4,17,3,16,69,69,0,54
Peterhead,6632,5,16,6,14,53,57,-4,54
Stranraer,6632,6,15,6,15,58,54,4,51
Albion,6632,7,14,7,15,60,56,4,49
Queen's Park,6632,8,12,9,15,38,48,-10,45
East Fife,6632,9,12,7,17,43,46,-3,43
Stenhousem'r,6632,10,5,7,24,45,92,-47,22
Livingston,6633,1,20,6,10,73,46,27,66
Airdrieon,6633,2,18,8,10,56,47,9,62
Alloa,6633,3,17,8,11,65,42,23,59
Albion,6633,4,17,8,11,58,44,14,59
Peterhead,6633,5,15,7,14,43,45,-2,52
Brechin,6633,6,13,11,12,44,43,1,50
Queen's Park,6633,7,12,7,17,36,55,-19,43
East Fife,6633,8,11,8,17,53,56,-3,41
Stranraer,6633,9,10,6,20,40,66,-26,36
Stenhousem'r,6633,10,7,11,18,44,68,-24,32
Livingston,6634,1,22,3,11,83,53,30,69
Airdrieon,6634,2,20,6,10,67,51,16,66
Alloa,6634,3,18,7,11,67,42,25,61
Brechin,6634,4,17,5,14,56,62,-6,56
Albion,6634,5,16,7,13,58,55,3,55
Peterhead,6634,6,13,10,13,56,48,8,49
East Fife,6634,7,12,13,11,46,42,4,49
Queen's Park,6634,8,9,10,17,40,56,-16,37
Stranraer,6634,9,11,3,22,53,74,-21,36
Stenhousem'r,6634,10,7,6,23,48,91,-43,27
Alloa,6635,1,20,8,8,76,39,37,68
Livingston,6635,2,19,6,11,69,48,21,63
Airdrieon,6635,3,16,12,8,64,50,14,60
Brechin,6635,4,17,6,13,56,44,12,57
East Fife,6635,5,14,10,12,55,42,13,52
Albion,6635,6,13,9,14,51,59,-8,48
Queen's Park,6635,7,12,7,17,38,59,-21,43
Peterhead,6635,8,10,10,16,47,62,-15,40
Stranraer,6635,9,10,8,18,43,64,-21,38
Stenhousem'r,6635,10,5,12,19,43,75,-32,27
Alloa,6636,1,17,12,7,64,39,25,63
Airdrieon,6636,2,19,6,11,68,55,13,63
Peterhead,6636,3,18,6,12,49,42,7,60
Brechin,6636,4,18,5,13,57,51,6,59
Livingston,6636,5,17,5,14,73,52,21,56
Albion,6636,6,14,7,15,59,55,4,49
Stranraer,6636,7,15,4,17,54,64,-10,49
Queen's Park,6636,8,13,5,18,41,61,-20,44
East Fife,6636,9,9,10,17,39,51,-12,37
Stenhousem'r,6636,10,7,6,23,50,84,-34,27
Alloa,6637,1,21,7,8,82,45,37,70
Livingston,6637,2,20,3,13,75,57,18,63
Airdrieon,6637,3,18,6,12,54,48,6,60
East Fife,6637,4,15,8,13,55,47,8,53
Brechin,6637,5,15,6,15,65,60,5,51
Albion,6637,6,14,9,13,53,57,-4,51
Stranraer,6637,7,13,6,17,55,66,-11,45
Peterhead,6637,8,12,8,16,52,54,-2,44
Queen's Park,6637,9,9,10,17,38,61,-23,37
Stenhousem'r,6637,10,7,9,20,45,79,-34,30
Livingston,6638,1,23,4,9,72,38,34,73
Brechin,6638,2,18,5,13,59,45,14,59
Alloa,6638,3,16,10,10,65,46,19,58
Albion,6638,4,16,10,10,58,49,9,58
Airdrieon,6638,5,15,9,12,59,60,-1,54
Queen's Park,6638,6,11,15,10,40,47,-7,48
Peterhead,6638,7,12,10,14,46,58,-12,46
East Fife,6638,8,10,11,15,59,55,4,41
Stranraer,6638,9,9,8,19,42,63,-21,35
Stenhousem'r,6638,10,5,8,23,38,77,-39,23
Livingston,6639,1,25,1,10,82,43,39,76
Alloa,6639,2,23,5,8,84,44,40,74
Peterhead,6639,3,16,9,11,54,45,9,57
Airdrieon,6639,4,16,4,16,50,62,-12,52
Brechin,6639,5,13,9,14,47,51,-4,48
Queen's Park,6639,6,13,6,17,39,53,-14,45
Albion,6639,7,13,5,18,54,58,-4,44
Stenhousem'r,6639,8,12,5,19,47,76,-29,41
Stranraer,6639,9,10,9,17,53,61,-8,39
East Fife,6639,10,8,9,19,41,58,-17,33
Livingston,6640,1,21,5,10,78,45,33,68
Alloa,6640,2,19,8,9,74,44,30,65
Airdrieon,6640,3,16,9,11,62,55,7,57
Brechin,6640,4,16,8,12,55,50,5,56
East Fife,6640,5,14,10,12,55,45,10,52
Peterhead,6640,6,12,12,12,41,39,2,48
Albion,6640,7,12,8,16,53,63,-10,44
Stranraer,6640,8,12,7,17,47,70,-23,43
Queen's Park,6640,9,10,6,20,37,63,-26,36
Stenhousem'r,6640,10,6,11,19,47,75,-28,29
Livingston,6641,1,21,5,10,84,53,31,68
Airdrieon,6641,2,20,6,10,67,52,15,66
Alloa,6641,3,19,8,9,72,41,31,65
Brechin,6641,4,16,8,12,50,53,-3,56
East Fife,6641,5,14,9,13,61,48,13,51
Peterhead,6641,6,13,7,16,53,67,-14,46
Albion,6641,7,12,9,15,55,55,0,45
Stranraer,6641,8,11,8,17,51,57,-6,41
Stenhousem'r,6641,9,9,7,20,47,82,-35,34
Queen's Park,6641,10,9,5,22,29,61,-32,32
Alloa,6642,1,21,8,7,83,42,41,71
Livingston,6642,2,20,5,11,75,49,26,65
Peterhead,6642,3,17,5,14,48,53,-5,56
Airdrieon,6642,4,15,7,14,62,64,-2,52
Albion,6642,5,14,9,13,55,53,2,51
Stranraer,6642,6,14,4,18,54,62,-8,46
Brechin,6642,7,12,8,16,48,57,-9,44
Queen's Park,6642,8,12,7,17,38,53,-15,43
East Fife,6642,9,10,11,15,40,47,-7,41
Stenhousem'r,6642,10,10,6,20,57,80,-23,36
Alloa,6643,1,21,6,9,71,43,28,69
Livingston,6643,2,21,5,10,78,53,25,68
Airdrieon,6643,3,17,6,13,58,50,8,57
Albion,6643,4,14,12,10,60,55,5,54
Peterhead,6643,5,16,6,14,48,44,4,54
Brechin,6643,6,15,7,14,53,52,1,52
East Fife,6643,7,10,11,15,58,58,0,41
Queen's Park,6643,8,10,10,16,35,48,-13,40
Stranraer,6643,9,11,6,19,44,62,-18,39
Stenhousem'r,6643,10,7,7,22,42,82,-40,28
Livingston,6644,1,20,8,8,82,45,37,68
Alloa,6644,2,19,10,7,77,41,36,67
Brechin,6644,3,16,7,13,51,45,6,55
Airdrieon,6644,4,14,11,11,53,49,4,53
Queen's Park,6644,5,14,7,15,37,50,-13,49
Peterhead,6644,6,14,5,17,56,69,-13,47
East Fife,6644,7,11,11,14,50,49,1,44
Stranraer,6644,8,11,9,16,54,62,-8,42
Albion,6644,9,11,8,17,51,71,-20,41
Stenhousem'r,6644,10,9,6,21,47,77,-30,33
Livingston,6645,1,24,4,8,76,43,33,76
Alloa,6645,2,20,6,10,65,40,25,66
Peterhead,6645,3,19,5,12,48,45,3,62
Albion,6645,4,14,7,15,50,54,-4,49
Stranraer,6645,5,15,4,17,54,60,-6,49
Brechin,6645,6,14,6,16,52,50,2,48
Airdrieon,6645,7,14,5,17,52,55,-3,47
East Fife,6645,8,11,10,15,53,55,-2,43
Queen's Park,6645,9,11,9,16,32,47,-15,42
Stenhousem'r,6645,10,7,6,23,42,75,-33,27
Livingston,6646,1,19,8,9,70,43,27,65
Alloa,6646,2,19,8,9,66,43,23,65
Airdrieon,6646,3,18,8,10,57,48,9,62
Stranraer,6646,4,15,9,12,52,47,5,54
Brechin,6646,5,15,8,13,54,51,3,53
Albion,6646,6,13,7,16,49,57,-8,46
Queen's Park,6646,7,11,8,17,35,56,-21,41
East Fife,6646,8,10,10,16,48,50,-2,40
Peterhead,6646,9,9,10,17,43,57,-14,37
Stenhousem'r,6646,10,9,8,19,50,72,-22,35
Livingston,6647,1,24,3,9,79,42,37,75
Brechin,6647,2,20,4,12,58,47,11,64
Airdrieon,6647,3,18,6,12,57,60,-3,60
Queen's Park,6647,4,17,3,16,37,44,-7,54
Peterhead,6647,5,14,8,14,47,44,3,50
Alloa,6647,6,13,10,13,59,49,10,49
Stranraer,6647,7,13,7,16,53,54,-1,46
Albion,6647,8,12,8,16,49,53,-4,44
East Fife,6647,9,10,9,17,46,52,-6,39
Stenhousem'r,6647,10,7,6,23,36,76,-40,27
Alloa,6648,1,21,5,10,73,42,31,68
Airdrieon,6648,2,20,6,10,57,40,17,66
Livingston,6648,3,20,5,11,77,45,32,65
Brechin,6648,4,19,7,10,54,42,12,64
Queen's Park,6648,5,18,6,12,51,48,3,60
East Fife,6648,6,11,11,14,55,51,4,44
Peterhead,6648,7,10,11,15,46,58,-12,41
Stranraer,6648,8,10,6,20,40,62,-22,36
Albion,6648,9,9,6,21,35,62,-27,33
Stenhousem'r,6648,10,7,7,22,44,82,-38,28
Livingston,6649,1,23,7,6,76,39,37,76
Brechin,6649,2,18,4,14,58,54,4,58
Alloa,6649,3,16,7,13,71,58,13,55
East Fife,6649,4,14,10,12,46,41,5,52
Airdrieon,6649,5,14,8,14,49,63,-14,50
Queen's Park,6649,6,14,7,15,51,53,-2,49
Albion,6649,7,12,8,16,62,61,1,44
Stenhousem'r,6649,8,12,8,16,58,66,-8,44
Peterhead,6649,9,10,11,15,48,61,-13,41
Stranraer,6649,10,10,4,22,45,68,-23,34
Livingston,6650,1,19,6,11,68,48,20,63
Alloa,6650,2,17,7,12,76,53,23,58
Albion,6650,3,16,9,11,62,47,15,57
Peterhead,6650,4,14,9,13,49,48,1,51
East Fife,6650,5,13,11,12,62,54,8,50
Airdrieon,6650,6,13,11,12,59,57,2,50
Stranraer,6650,7,14,5,17,47,66,-19,47
Brechin,6650,8,11,10,15,50,68,-18,43
Stenhousem'r,6650,9,10,10,16,64,80,-16,40
Queen's Park,6650,10,7,14,15,33,49,-16,35
Alloa,6651,1,20,7,9,69,42,27,67
Livingston,6651,2,20,5,11,77,50,27,65
Brechin,6651,3,17,5,14,50,54,-4,56
Albion,6651,4,16,7,13,53,46,7,55
Peterhead,6651,5,15,8,13,53,54,-1,53
Stranraer,6651,6,15,5,16,49,56,-7,50
Queen's Park,6651,7,14,6,16,38,53,-15,48
Airdrieon,6651,8,13,6,17,57,64,-7,45
Stenhousem'r,6651,9,8,10,18,48,69,-21,34
East Fife,6651,10,5,15,16,48,54,-6,30
Livingston,6652,1,24,3,9,82,45,37,75
Airdrieon,6652,2,20,7,9,73,47,26,67
Alloa,6652,3,19,8,9,62,41,21,65
Brechin,6652,4,17,7,12,55,50,5,58
Queen's Park,6652,5,14,7,15,44,53,-9,49
Peterhead,6652,6,12,8,16,48,53,-5,44
Albion,6652,7,11,7,18,53,65,-12,40
Stranraer,6652,8,11,7,18,46,62,-16,40
East Fife,6652,9,9,10,17,47,51,-4,37
Stenhousem'r,6652,10,6,10,20,45,88,-43,28
Livingston,6653,1,21,4,11,78,49,29,67
Alloa,6653,2,20,6,10,76,44,32,66
Brechin,6653,3,19,5,12,56,48,8,62
Airdrieon,6653,4,18,4,14,63,64,-1,58
Stranraer,6653,5,16,4,16,61,56,5,52
Peterhead,6653,6,13,10,13,56,57,-1,49
Albion,6653,7,12,10,14,50,55,-5,46
East Fife,6653,8,10,8,18,48,57,-9,38
Queen's Park,6653,9,9,9,18,42,65,-23,36
Stenhousem'r,6653,10,8,8,20,44,79,-35,32
Brechin,6654,1,21,6,9,67,39,28,69
Alloa,6654,2,18,6,12,64,45,19,60
Livingston,6654,3,17,6,13,65,45,20,57
Queen's Park,6654,4,16,8,12,47,47,0,56
Airdrieon,6654,5,15,7,14,55,53,2,52
East Fife,6654,6,14,8,14,48,44,4,50
Peterhead,6654,7,13,10,13,47,53,-6,49
Albion,6654,8,12,8,16,54,51,3,44
Stranraer,6654,9,13,4,19,41,64,-23,43
Stenhousem'r,6654,10,6,7,23,44,91,-47,25
Alloa,6655,1,20,8,8,74,45,29,68
Albion,6655,2,17,7,12,57,47,10,58
Livingston,6655,3,17,6,13,73,58,15,57
Airdrieon,6655,4,16,6,14,60,57,3,54
East Fife,6655,5,15,7,14,52,44,8,52
Brechin,6655,6,16,4,16,54,54,0,52
Queen's Park,6655,7,15,5,16,47,55,-8,50
Stranraer,6655,8,15,3,18,51,57,-6,48
Peterhead,6655,9,12,11,13,50,56,-6,47
Stenhousem'r,6655,10,4,9,23,44,89,-45,21
Livingston,6656,1,20,7,9,79,51,28,67
Alloa,6656,2,20,7,9,70,44,26,67
Peterhead,6656,3,15,9,12,56,47,9,54
Brechin,6656,4,14,8,14,47,46,1,50
Airdrieon,6656,5,14,6,16,54,61,-7,48
Queen's Park,6656,6,13,8,15,44,51,-7,47
Albion,6656,7,13,6,17,53,57,-4,45
East Fife,6656,8,11,10,15,50,49,1,43
Stranraer,6656,9,11,10,15,48,65,-17,43
Stenhousem'r,6656,10,10,7,19,54,84,-30,37
Alloa,6657,1,21,8,7,67,35,32,71
Airdrieon,6657,2,19,7,10,60,50,10,64
Livingston,6657,3,19,5,12,74,41,33,62
Queen's Park,6657,4,16,7,13,52,45,7,55
Stranraer,6657,5,16,3,17,49,56,-7,51
Peterhead,6657,6,13,9,14,43,52,-9,48
Albion,6657,7,12,9,15,62,59,3,45
Stenhousem'r,6657,8,10,8,18,48,73,-25,38
East Fife,6657,9,9,9,18,36,55,-19,36
Brechin,6657,10,10,5,21,42,67,-25,35
Livingston,6658,1,21,5,10,73,44,29,68
Alloa,6658,2,18,10,8,63,42,21,64
Peterhead,6658,3,15,9,12,53,50,3,54
Stranraer,6658,4,16,4,16,54,52,2,52
Queen's Park,6658,5,14,8,14,38,46,-8,50
Airdrieon,6658,6,14,8,14,56,65,-9,50
Albion,6658,7,14,6,16,44,48,-4,48
Brechin,6658,8,13,7,16,40,43,-3,46
East Fife,6658,9,10,12,14,50,49,1,42
Stenhousem'r,6658,10,6,9,21,44,76,-32,27
Livingston,6659,1,24,4,8,85,37,48,76
Alloa,6659,2,20,7,9,89,46,43,67
Airdrieon,6659,3,17,5,14,58,55,3,56
East Fife,6659,4,15,8,13,52,40,12,53
Albion,6659,5,15,4,17,54,57,-3,49
Brechin,6659,6,15,4,17,48,58,-10,49
Peterhead,6659,7,12,8,16,41,55,-14,44
Stranraer,6659,8,12,4,20,53,75,-22,40
Stenhousem'r,6659,9,10,9,17,48,73,-25,39
Queen's Park,6659,10,11,5,20,38,70,-32,38
Alloa,6660,1,20,6,10,70,49,21,66
Livingston,6660,2,17,9,10,69,46,23,60
Brechin,6660,3,18,6,12,58,46,12,60
Peterhead,6660,4,16,7,13,54,49,5,55
Stranraer,6660,5,16,4,16,53,48,5,52
Airdrieon,6660,6,14,6,16,56,63,-7,48
Queen's Park,6660,7,13,9,14,41,55,-14,48
Albion,6660,8,11,10,15,43,51,-8,43
East Fife,6660,9,10,11,15,48,56,-8,41
Stenhousem'r,6660,10,6,10,20,52,81,-29,28
Livingston,6661,1,22,4,10,86,55,31,70
Alloa,6661,2,17,10,9,68,44,24,61
East Fife,6661,3,16,9,11,59,47,12,57
Brechin,6661,4,15,7,14,46,45,1,52
Albion,6661,5,14,9,13,56,53,3,51
Queen's Park,6661,6,14,8,14,48,53,-5,50
Airdrieon,6661,7,15,4,17,51,55,-4,49
Stranraer,6661,8,13,4,19,45,60,-15,43
Peterhead,6661,9,12,6,18,35,50,-15,42
Stenhousem'r,6661,10,6,11,19,45,77,-32,29
Livingston,6662,1,22,3,11,75,47,28,69
Airdrieon,6662,2,19,4,13,64,52,12,61
Alloa,6662,3,16,9,11,66,43,23,57
Albion,6662,4,17,6,13,55,49,6,57
Peterhead,6662,5,17,5,14,54,52,2,56
East Fife,6662,6,16,7,13,58,47,11,55
Brechin,6662,7,17,3,16,53,52,1,54
Queen's Park,6662,8,11,9,16,35,52,-17,42
Stranraer,6662,9,12,4,20,49,59,-10,40
Stenhousem'r,6662,10,6,4,26,35,91,-56,22
Alloa,6663,1,23,7,6,77,35,42,76
Livingston,6663,2,20,5,11,82,55,27,65
Peterhead,6663,3,17,7,12,55,46,9,58
Airdrieon,6663,4,15,7,14,56,53,3,52
Brechin,6663,5,15,7,14,47,47,0,52
Albion,6663,6,15,6,15,47,49,-2,51
Stranraer,6663,7,15,3,18,52,64,-12,48
Queen's Park,6663,8,13,8,15,36,42,-6,47
East Fife,6663,9,9,11,16,42,46,-4,38
Stenhousem'r,6663,10,3,9,24,33,90,-57,18
Alloa,6664,1,21,7,8,73,45,28,70
Airdrieon,6664,2,18,8,10,73,57,16,62
Livingston,6664,3,19,5,12,68,52,16,62
Brechin,6664,4,15,10,11,44,42,2,55
Albion,6664,5,15,7,14,52,44,8,52
Peterhead,6664,6,13,8,15,56,59,-3,47
Stranraer,6664,7,12,6,18,51,57,-6,42
Stenhousem'r,6664,8,10,11,15,56,81,-25,41
Queen's Park,6664,9,10,9,17,45,61,-16,39
East Fife,6664,10,7,9,20,40,60,-20,30
Alloa,6665,1,22,6,8,76,42,34,72
Livingston,6665,2,21,7,8,88,51,37,70
Brechin,6665,3,17,7,12,57,52,5,58
Peterhead,6665,4,17,6,13,51,46,5,57
Airdrieon,6665,5,17,6,13,61,60,1,57
Albion,6665,6,13,11,12,48,42,6,50
Queen's Park,6665,7,11,11,14,34,47,-13,44
Stranraer,6665,8,12,4,20,45,56,-11,40
East Fife,6665,9,8,6,22,40,61,-21,30
Stenhousem'r,6665,10,7,6,23,47,90,-43,27
Livingston,6666,1,20,6,10,76,48,28,66
Alloa,6666,2,16,12,8,66,42,24,60
Airdrieon,6666,3,17,8,11,61,53,8,59
Peterhead,6666,4,16,7,13,53,55,-2,55
Albion,6666,5,16,6,14,55,48,7,54
Queen's Park,6666,6,16,5,15,44,52,-8,53
East Fife,6666,7,13,8,15,60,51,9,47
Brechin,6666,8,12,9,15,48,55,-7,45
Stranraer,6666,9,8,10,18,43,59,-16,34
Stenhousem'r,6666,10,6,9,21,46,89,-43,27
Airdrieon,6667,1,21,7,8,69,42,27,70
Livingston,6667,2,21,4,11,75,52,23,67
Brechin,6667,3,15,8,13,50,54,-4,53
Alloa,6667,4,15,7,14,66,52,14,52
East Fife,6667,5,13,11,12,57,45,12,50
Albion,6667,6,13,8,15,57,61,-4,47
Stranraer,6667,7,13,7,16,54,56,-2,46
Queen's Park,6667,8,12,8,16,36,52,-16,44
Peterhead,6667,9,12,7,17,48,64,-16,43
Stenhousem'r,6667,10,7,9,20,43,77,-34,30
Livingston,6668,1,20,4,12,78,47,31,64
Alloa,6668,2,19,6,11,75,45,30,63
Brechin,6668,3,19,4,13,51,48,3,61
Airdrieon,6668,4,18,6,12,60,54,6,60
Albion,6668,5,16,5,15,59,51,8,53
Queen's Park,6668,6,16,4,16,35,45,-10,52
Peterhead,6668,7,12,10,14,46,50,-4,46
East Fife,6668,8,13,6,17,54,51,3,45
Stranraer,6668,9,13,4,19,45,65,-20,43
Stenhousem'r,6668,10,6,7,23,39,86,-47,25
Livingston,6669,1,21,6,9,80,44,36,69
Alloa,6669,2,18,8,10,66,47,19,62
Queen's Park,6669,3,17,7,12,50,47,3,58
Airdrieon,6669,4,17,5,14,54,51,3,56
Brechin,6669,5,16,5,15,53,49,4,53
Albion,6669,6,14,7,15,51,58,-7,49
East Fife,6669,7,13,9,14,55,44,11,48
Peterhead,6669,8,9,13,14,45,52,-7,40
Stranraer,6669,9,10,6,20,41,70,-29,36
Stenhousem'r,6669,10,7,10,19,38,71,-33,31
Alloa,6670,1,20,10,6,77,42,35,70
Livingston,6670,2,20,4,12,84,56,28,64
Brechin,6670,3,19,6,11,63,54,9,63
East Fife,6670,4,14,12,10,55,45,10,54
Peterhead,6670,5,13,9,14,63,65,-2,48
Airdrieon,6670,6,12,12,12,58,61,-3,48
Queen's Park,6670,7,12,9,15,42,52,-10,45
Albion,6670,8,11,8,17,56,70,-14,41
Stranraer,6670,9,8,8,20,49,70,-21,32
Stenhousem'r,6670,10,7,10,19,51,83,-32,31
Livingston,6671,1,21,9,6,78,40,38,72
Alloa,6671,2,20,7,9,70,43,27,67
Airdrieon,6671,3,17,3,16,51,56,-5,54
Brechin,6671,4,16,4,16,42,40,2,52
Peterhead,6671,5,14,7,15,50,57,-7,49
Queen's Park,6671,6,13,8,15,34,45,-11,47
Stranraer,6671,7,13,7,16,50,56,-6,46
East Fife,6671,8,12,9,15,53,52,1,45
Albion,6671,9,11,7,18,48,57,-9,40
Stenhousem'r,6671,10,9,7,20,51,81,-30,34
Alloa,6672,1,20,7,9,73,42,31,67
Brechin,6672,2,20,4,12,56,36,20,64
Livingston,6672,3,18,2,16,81,60,21,56
Albion,6672,4,14,9,13,55,50,5,51
Airdrieon,6672,5,15,6,15,54,61,-7,51
Peterhead,6672,6,15,6,15,49,61,-12,51
Stranraer,6672,7,13,11,12,46,51,-5,50
East Fife,6672,8,13,10,13,59,44,15,49
Queen's Park,6672,9,9,9,18,36,60,-24,36
Stenhousem'r,6672,10,7,8,21,42,86,-44,29
Alloa,6673,1,23,8,5,86,45,41,77
Airdrieon,6673,2,21,8,7,64,43,21,71
Livingston,6673,3,18,8,10,76,44,32,62
Albion,6673,4,15,9,12,55,50,5,54
Brechin,6673,5,15,6,15,42,47,-5,51
East Fife,6673,6,13,9,14,52,46,6,48
Stranraer,6673,7,13,5,18,49,59,-10,44
Peterhead,6673,8,11,7,18,47,66,-19,40
Queen's Park,6673,9,11,7,18,32,52,-20,40
Stenhousem'r,6673,10,4,5,27,34,85,-51,17
Livingston,6674,1,20,7,9,79,54,25,67
Alloa,6674,2,20,6,10,76,52,24,66
Albion,6674,3,17,8,11,51,46,5,59
Airdrieon,6674,4,17,6,13,62,55,7,57
Peterhead,6674,5,15,6,15,49,52,-3,51
Brechin,6674,6,13,7,16,48,57,-9,46
Queen's Park,6674,7,13,5,18,41,59,-18,44
Stenhousem'r,6674,8,11,8,17,58,74,-16,41
Stranraer,6674,9,11,7,18,55,64,-9,40
East Fife,6674,10,10,6,20,47,53,-6,36
Livingston,6675,1,20,6,10,75,45,30,66
Airdrieon,6675,2,19,5,12,57,52,5,62
Brechin,6675,3,18,5,13,50,40,10,59
Alloa,6675,4,17,6,13,67,49,18,57
Queen's Park,6675,5,14,7,15,42,49,-7,49
Peterhead,6675,6,13,8,15,44,55,-11,47
East Fife,6675,7,13,7,16,51,44,7,46
Stranraer,6675,8,12,10,14,50,57,-7,46
Albion,6675,9,12,7,17,45,62,-17,43
Stenhousem'r,6675,10,8,7,21,49,77,-28,31
Alloa,6676,1,19,7,10,75,52,23,64
Brechin,6676,2,20,3,13,51,43,8,63
Livingston,6676,3,18,4,14,72,64,8,58
Airdrieon,6676,4,17,5,14,65,59,6,56
Peterhead,6676,5,17,5,14,52,55,-3,56
Queen's Park,6676,6,14,6,16,41,46,-5,48
Stranraer,6676,7,13,7,16,48,55,-7,46
Albion,6676,8,12,9,15,60,54,6,45
Stenhousem'r,6676,9,11,7,18,53,78,-25,40
East Fife,6676,10,9,7,20,39,50,-11,34
Alloa,6677,1,19,7,10,68,47,21,64
Airdrieon,6677,2,19,6,11,58,52,6,63
Peterhead,6677,3,17,8,11,56,42,14,59
Livingston,6677,4,18,4,14,69,52,17,58
Brechin,6677,5,17,6,13,55,51,4,57
Queen's Park,6677,6,14,8,14,40,44,-4,50
Albion,6677,7,12,10,14,50,54,-4,46
Stranraer,6677,8,13,5,18,43,49,-6,44
East Fife,6677,9,8,10,18,41,52,-11,34
Stenhousem'r,6677,10,7,8,21,43,80,-37,29
Airdrieon,6678,1,19,9,8,63,44,19,66
Livingston,6678,2,19,5,12,72,48,24,62
Brechin,6678,3,18,8,10,60,40,20,62
East Fife,6678,4,15,10,11,56,40,16,55
Alloa,6678,5,14,12,10,61,46,15,54
Peterhead,6678,6,14,8,14,45,52,-7,50
Albion,6678,7,12,10,14,50,55,-5,46
Stranraer,6678,8,13,5,18,54,65,-11,44
Queen's Park,6678,9,12,7,17,36,54,-18,43
Stenhousem'r,6678,10,3,8,25,41,94,-53,17
Livingston,6679,1,21,2,13,88,54,34,65
Airdrieon,6679,2,18,8,10,72,58,14,62
Brechin,6679,3,19,5,12,65,59,6,62
Albion,6679,4,17,7,12,62,63,-1,58
Alloa,6679,5,17,6,13,76,46,30,57
Queen's Park,6679,6,15,6,15,50,58,-8,51
Stranraer,6679,7,13,4,19,51,65,-14,43
East Fife,6679,8,11,7,18,44,61,-17,40
Peterhead,6679,9,10,9,17,50,63,-13,39
Stenhousem'r,6679,10,6,12,18,52,83,-31,30
Alloa,6680,1,21,7,8,78,48,30,70
Livingston,6680,2,20,7,9,76,46,30,67
Airdrieon,6680,3,18,6,12,63,52,11,60
Peterhead,6680,4,16,9,11,49,41,8,57
Brechin,6680,5,16,6,14,45,45,0,54
Albion,6680,6,14,7,15,49,53,-4,49
Queen's Park,6680,7,13,5,18,34,53,-19,44
Stranraer,6680,8,13,3,20,49,65,-16,42
East Fife,6680,9,8,11,17,52,57,-5,35
Stenhousem'r,6680,10,7,7,22,46,81,-35,28
Brechin,6681,1,24,3,9,58,38,20,75
Alloa,6681,2,18,8,10,76,50,26,62
Airdrieon,6681,3,19,4,13,58,50,8,61
Livingston,6681,4,17,7,12,69,54,15,58
East Fife,6681,5,15,7,14,55,44,11,52
Albion,6681,6,14,8,14,55,51,4,50
Peterhead,6681,7,11,8,17,39,52,-13,41
Queen's Park,6681,8,12,4,20,38,59,-21,40
Stranraer,6681,9,11,4,21,47,65,-18,37
Stenhousem'r,6681,10,9,7,20,42,74,-32,34
Livingston,6682,1,22,3,11,79,49,30,69
Alloa,6682,2,19,9,8,77,50,27,66
Brechin,6682,3,17,9,10,52,46,6,60
Airdrieon,6682,4,16,6,14,53,53,0,54
Peterhead,6682,5,14,8,14,53,52,1,50
Albion,6682,6,13,10,13,54,49,5,49
Stranraer,6682,7,13,8,15,56,62,-6,47
Queen's Park,6682,8,12,8,16,49,62,-13,44
East Fife,6682,9,10,12,14,50,50,0,42
Stenhousem'r,6682,10,3,9,24,43,93,-50,18
Livingston,6683,1,24,4,8,78,47,31,76
Airdrieon,6683,2,22,6,8,67,50,17,72
Alloa,6683,3,18,9,9,74,42,32,63
Brechin,6683,4,16,5,15,55,49,6,53
Peterhead,6683,5,13,10,13,48,51,-3,49
Albion,6683,6,11,10,15,49,50,-1,43
Stranraer,6683,7,12,7,17,50,65,-15,43
East Fife,6683,8,11,7,18,53,56,-3,40
Queen's Park,6683,9,9,10,17,37,62,-25,37
Stenhousem'r,6683,10,5,10,21,38,77,-39,25
Livingston,6684,1,20,9,7,81,38,43,69
Airdrieon,6684,2,20,7,9,64,53,11,67
Alloa,6684,3,19,8,9,74,50,24,65
Peterhead,6684,4,15,10,11,57,53,4,55
Albion,6684,5,14,8,14,52,57,-5,50
Brechin,6684,6,14,7,15,50,54,-4,49
Stranraer,6684,7,12,8,16,53,60,-7,44
East Fife,6684,8,9,11,16,46,58,-12,38
Queen's Park,6684,9,8,8,20,33,55,-22,32
Stenhousem'r,6684,10,7,8,21,50,82,-32,29
Alloa,6685,1,20,5,11,65,41,24,65
Livingston,6685,2,20,4,12,76,53,23,64
Stranraer,6685,3,16,7,13,58,54,4,55
Brechin,6685,4,15,9,12,49,44,5,54
Airdrieon,6685,5,15,8,13,58,54,4,53
Albion,6685,6,14,7,15,49,59,-10,49
Peterhead,6685,7,14,6,16,46,55,-9,48
Queen's Park,6685,8,13,6,17,40,51,-11,45
Stenhousem'r,6685,9,10,7,19,54,79,-25,37
East Fife,6685,10,8,11,17,50,55,-5,35
Livingston,6686,1,23,4,9,91,47,44,73
Alloa,6686,2,19,7,10,72,49,23,64
Brechin,6686,3,17,7,12,57,50,7,58
Peterhead,6686,4,15,11,10,59,51,8,56
Albion,6686,5,15,8,13,65,61,4,53
Airdrieon,6686,6,14,6,16,53,60,-7,48
East Fife,6686,7,13,6,17,53,52,1,45
Queen's Park,6686,8,13,5,18,39,58,-19,44
Stranraer,6686,9,13,4,19,53,60,-7,43
Stenhousem'r,6686,10,5,8,23,44,98,-54,23
Alloa,6687,1,20,9,7,81,43,38,69
Livingston,6687,2,17,11,8,75,48,27,62
Airdrieon,6687,3,17,5,14,61,61,0,56
Albion,6687,4,15,9,12,53,49,4,54
Peterhead,6687,5,16,6,14,52,54,-2,54
Brechin,6687,6,14,8,14,46,54,-8,50
East Fife,6687,7,10,12,14,57,50,7,42
Queen's Park,6687,8,10,8,18,34,57,-23,38
Stranraer,6687,9,10,7,19,50,67,-17,37
Stenhousem'r,6687,10,10,7,19,50,76,-26,37
Livingston,6688,1,21,5,10,77,42,35,68
Alloa,6688,2,18,7,11,66,45,21,61
Brechin,6688,3,17,5,14,51,57,-6,56
Airdrieon,6688,4,15,8,13,54,47,7,53
Peterhead,6688,5,14,10,12,52,53,-1,52
Albion,6688,6,14,9,13,54,47,7,51
Queen's Park,6688,7,12,8,16,37,56,-19,44
East Fife,6688,8,11,9,16,46,50,-4,42
Stranraer,6688,9,12,6,18,46,54,-8,42
Stenhousem'r,6688,10,9,7,20,42,74,-32,34
Alloa,6689,1,21,5,10,72,46,26,68
Livingston,6689,2,20,4,12,76,47,29,64
Brechin,6689,3,18,7,11,52,46,6,61
Airdrieon,6689,4,18,6,12,60,54,6,60
Queen's Park,6689,5,15,7,14,34,44,-10,52
Peterhead,6689,6,14,7,15,51,52,-1,49
Stranraer,6689,7,13,6,17,53,63,-10,45
East Fife,6689,8,10,9,17,47,48,-1,39
Albion,6689,9,10,8,18,44,58,-14,38
Stenhousem'r,6689,10,8,7,21,50,81,-31,31
Livingston,6690,1,23,2,11,86,48,38,71
Alloa,6690,2,19,6,11,68,40,28,63
Albion,6690,3,17,7,12,58,48,10,58
Brechin,6690,4,15,10,11,46,42,4,55
Airdrieon,6690,5,14,9,13,51,54,-3,51
Peterhead,6690,6,14,7,15,45,55,-10,49
East Fife,6690,7,11,8,17,42,51,-9,41
Stranraer,6690,8,11,7,18,47,59,-12,40
Stenhousem'r,6690,9,11,6,19,45,70,-25,39
Queen's Park,6690,10,10,8,18,27,48,-21,38
Airdrieon,6691,1,19,7,10,63,54,9,64
Livingston,6691,2,18,9,9,78,49,29,63
Alloa,6691,3,17,9,10,67,42,25,60
East Fife,6691,4,13,11,12,52,46,6,50
Brechin,6691,5,15,5,16,49,59,-10,50
Albion,6691,6,11,13,12,41,44,-3,46
Peterhead,6691,7,13,7,16,47,52,-5,46
Stranraer,6691,8,13,5,18,55,62,-7,44
Queen's Park,6691,9,12,4,20,32,58,-26,40
Stenhousem'r,6691,10,10,8,18,56,74,-18,38
Alloa,6692,1,21,8,7,75,37,38,71
Livingston,6692,2,22,3,11,74,45,29,69
Airdrieon,6692,3,18,8,10,59,47,12,62
Peterhead,6692,4,15,13,8,46,42,4,58
Brechin,6692,5,13,11,12,47,48,-1,50
East Fife,6692,6,11,11,14,50,55,-5,44
Queen's Park,6692,7,12,7,17,43,56,-13,43
Albion,6692,8,11,5,20,53,63,-10,38
Stranraer,6692,9,11,5,20,52,66,-14,38
Stenhousem'r,6692,10,5,11,20,43,83,-40,26
Livingston,6693,1,21,8,7,82,45,37,71
Alloa,6693,2,21,5,10,77,45,32,68
Brechin,6693,3,17,5,14,49,46,3,56
Albion,6693,4,15,7,14,48,45,3,52
Airdrieon,6693,5,14,9,13,49,59,-10,51
Stranraer,6693,6,15,5,16,55,52,3,50
Peterhead,6693,7,13,10,13,52,51,1,49
East Fife,6693,8,10,8,18,46,57,-11,38
Queen's Park,6693,9,11,3,22,31,55,-24,36
Stenhousem'r,6693,10,10,6,20,47,81,-34,36
Alloa,6694,1,20,9,7,65,36,29,69
Livingston,6694,2,20,4,12,69,47,22,64
Airdrieon,6694,3,15,9,12,57,48,9,54
Albion,6694,4,15,8,13,54,58,-4,53
Brechin,6694,5,14,7,15,42,47,-5,49
Peterhead,6694,6,11,12,13,52,55,-3,45
Stranraer,6694,7,13,5,18,46,55,-9,44
Queen's Park,6694,8,12,8,16,35,45,-10,44
Stenhousem'r,6694,9,12,7,17,51,70,-19,43
East Fife,6694,10,7,13,16,36,46,-10,34
Alloa,6695,1,20,8,8,75,45,30,68
Livingston,6695,2,19,7,10,74,51,23,64
Brechin,6695,3,18,7,11,59,45,14,61
Albion,6695,4,14,9,13,53,50,3,51
Peterhead,6695,5,13,11,12,47,50,-3,50
East Fife,6695,6,12,12,12,54,53,1,48
Airdrieon,6695,7,13,6,17,51,64,-13,45
Stranraer,6695,8,12,7,17,51,55,-4,43
Queen's Park,6695,9,10,7,19,36,56,-20,37
Stenhousem'r,6695,10,8,8,20,50,81,-31,32
Alloa,6696,1,21,8,7,78,46,32,71
Brechin,6696,2,19,6,11,58,49,9,63
Livingston,6696,3,17,6,13,79,56,23,57
Albion,6696,4,16,7,13,58,51,7,55
Airdrieon,6696,5,15,6,15,54,61,-7,51
Queen's Park,6696,6,14,8,14,45,49,-4,50
Stranraer,6696,7,13,10,13,53,54,-1,49
Peterhead,6696,8,12,10,14,51,53,-2,46
East Fife,6696,9,10,9,17,38,48,-10,39
Stenhousem'r,6696,10,4,8,24,52,99,-47,20
Alloa,6697,1,24,4,8,80,42,38,76
Airdrieon,6697,2,21,4,11,56,45,11,67
Livingston,6697,3,21,3,12,70,45,25,66
Queen's Park,6697,4,15,6,15,40,50,-10,51
Albion,6697,5,14,6,16,54,65,-11,48
East Fife,6697,6,12,11,13,49,47,2,47
Peterhead,6697,7,13,7,16,53,54,-1,46
Stranraer,6697,8,13,6,17,59,63,-4,45
Brechin,6697,9,13,3,20,53,63,-10,42
Stenhousem'r,6697,10,6,6,24,47,87,-40,24
Livingston,6698,1,23,4,9,92,56,36,73
Alloa,6698,2,18,8,10,68,48,20,62
Brechin,6698,3,18,5,13,60,51,9,59
Albion,6698,4,13,13,10,63,60,3,52
Queen's Park,6698,5,15,6,15,47,60,-13,51
East Fife,6698,6,13,8,15,60,53,7,47
Stranraer,6698,7,12,11,13,51,55,-4,47
Airdrieon,6698,8,13,8,15,46,55,-9,47
Peterhead,6698,9,9,8,19,44,61,-17,35
Stenhousem'r,6698,10,7,7,22,59,91,-32,28
Livingston,6699,1,24,5,7,83,44,39,77
Alloa,6699,2,18,9,9,77,53,24,63
Airdrieon,6699,3,17,8,11,62,50,12,59
Brechin,6699,4,16,7,13,45,45,0,55
East Fife,6699,5,14,10,12,61,53,8,52
Peterhead,6699,6,13,11,12,54,53,1,50
Albion,6699,7,12,8,16,55,67,-12,44
Queen's Park,6699,8,10,9,17,37,52,-15,39
Stranraer,6699,9,10,6,20,47,60,-13,36
Stenhousem'r,6699,10,5,9,22,44,88,-44,24
Alloa,6700,1,20,6,10,77,43,34,66
Livingston,6700,2,19,7,10,80,53,27,64
Brechin,6700,3,19,7,10,59,46,13,64
Airdrieon,6700,4,17,7,12,55,53,2,58
Albion,6700,5,13,12,11,53,52,1,51
East Fife,6700,6,11,11,14,57,54,3,44
Peterhead,6700,7,12,7,17,53,63,-10,43
Queen's Park,6700,8,11,9,16,39,47,-8,42
Stranraer,6700,9,11,8,17,49,67,-18,41
Stenhousem'r,6700,10,6,8,22,49,93,-44,26
Livingston,6701,1,23,3,10,82,47,35,72
Alloa,6701,2,18,8,10,68,44,24,62
Brechin,6701,3,16,6,14,58,48,10,54
Airdrieon,6701,4,15,8,13,58,55,3,53
Peterhead,6701,5,14,7,15,54,59,-5,49
Albion,6701,6,13,9,14,52,58,-6,48
Stranraer,6701,7,12,9,15,62,72,-10,45
Queen's Park,6701,8,12,8,16,52,66,-14,44
East Fife,6701,9,11,6,19,49,54,-5,39
Stenhousem'r,6701,10,10,8,18,49,81,-32,38
Alloa,6702,1,18,9,9,66,39,27,63
Livingston,6702,2,18,6,12,72,52,20,60
Albion,6702,3,15,13,8,62,45,17,58
Brechin,6702,4,16,6,14,51,48,3,54
Airdrieon,6702,5,15,8,13,52,54,-2,53
Stranraer,6702,6,15,5,16,56,64,-8,50
Peterhead,6702,7,13,7,16,49,53,-4,46
Queen's Park,6702,8,13,5,18,39,55,-16,44
Stenhousem'r,6702,9,9,11,16,46,74,-28,38
East Fife,6702,10,9,8,19,41,50,-9,35
Alloa,6703,1,19,10,7,67,41,26,67
Airdrieon,6703,2,20,4,12,63,53,10,64
Albion,6703,3,18,5,13,60,52,8,59
Livingston,6703,4,18,4,14,69,53,16,58
Brechin,6703,5,17,7,12,58,46,12,58
Peterhead,6703,6,17,6,13,57,49,8,57
Stranraer,6703,7,11,5,20,46,65,-19,38
East Fife,6703,8,8,12,16,43,55,-12,36
Queen's Park,6703,9,9,9,18,31,55,-24,36
Stenhousem'r,6703,10,7,10,19,55,80,-25,31
Alloa,6704,1,19,5,12,68,51,17,62
Brechin,6704,2,18,8,10,52,43,9,62
Peterhead,6704,3,17,7,12,57,53,4,58
Airdrieon,6704,4,17,6,13,62,52,10,57
Albion,6704,5,16,8,12,62,49,13,56
Livingston,6704,6,17,3,16,64,53,11,54
East Fife,6704,7,10,12,14,47,50,-3,42
Queen's Park,6704,8,11,9,16,37,51,-14,42
Stranraer,6704,9,10,7,19,46,59,-13,37
Stenhousem'r,6704,10,9,7,20,43,77,-34,34
Livingston,6705,1,26,4,6,89,33,56,82
Alloa,6705,2,20,8,8,66,43,23,68
Brechin,6705,3,17,9,10,46,34,12,60
Airdrieon,6705,4,17,8,11,58,53,5,59
Albion,6705,5,14,9,13,52,53,-1,51
Stranraer,6705,6,12,8,16,51,57,-6,44
Queen's Park,6705,7,12,7,17,33,44,-11,43
Peterhead,6705,8,8,10,18,38,54,-16,34
East Fife,6705,9,7,11,18,48,58,-10,32
Stenhousem'r,6705,10,6,8,22,33,85,-52,26
Alloa,6706,1,23,5,8,86,42,44,74
Brechin,6706,2,19,6,11,60,48,12,63
Airdrieon,6706,3,16,11,9,61,47,14,59
Livingston,6706,4,17,7,12,66,48,18,58
Peterhead,6706,5,15,7,14,59,54,5,52
Albion,6706,6,14,8,14,61,67,-6,50
Queen's Park,6706,7,13,3,20,36,59,-23,42
Stranraer,6706,8,11,7,18,48,58,-10,40
East Fife,6706,9,8,10,18,41,51,-10,34
Stenhousem'r,6706,10,9,6,21,42,86,-44,33
Alloa,6707,1,21,7,8,67,37,30,70
Livingston,6707,2,21,3,12,73,41,32,66
Brechin,6707,3,18,5,13,57,48,9,59
Airdrieon,6707,4,17,5,14,64,58,6,56
Albion,6707,5,16,6,14,51,52,-1,54
Peterhead,6707,6,14,10,12,52,47,5,52
East Fife,6707,7,13,9,14,53,56,-3,48
Stranraer,6707,8,11,5,20,47,63,-16,38
Queen's Park,6707,9,10,7,19,33,57,-24,37
Stenhousem'r,6707,10,6,9,21,35,73,-38,27
Livingston,6708,1,23,2,11,86,48,38,71
Alloa,6708,2,21,7,8,79,38,41,70
Brechin,6708,3,17,6,13,50,49,1,57
Albion,6708,4,15,6,15,52,59,-7,51
Queen's Park,6708,5,15,6,15,40,50,-10,51
Peterhead,6708,6,13,8,15,54,53,1,47
Airdrieon,6708,7,14,5,17,54,59,-5,47
Stranraer,6708,8,14,3,19,45,61,-16,45
East Fife,6708,9,11,9,16,53,51,2,42
Stenhousem'r,6708,10,8,6,22,39,84,-45,30
Alloa,6709,1,20,11,5,69,42,27,71
Livingston,6709,2,21,4,11,76,41,35,67
Airdrieon,6709,3,21,4,11,62,49,13,67
Queen's Park,6709,4,19,6,11,50,41,9,63
Brechin,6709,5,15,6,15,49,49,0,51
Stranraer,6709,6,15,1,20,56,63,-7,46
Peterhead,6709,7,12,8,16,46,58,-12,44
Albion,6709,8,11,9,16,49,53,-4,42
East Fife,6709,9,7,9,20,39,56,-17,30
Stenhousem'r,6709,10,7,6,23,43,87,-44,27
Livingston,6710,1,18,10,8,74,50,24,64
Alloa,6710,2,17,8,11,64,45,19,59
Brechin,6710,3,18,4,14,50,39,11,58
Stranraer,6710,4,18,3,15,55,47,8,57
Airdrieon,6710,5,16,9,11,51,47,4,57
Albion,6710,6,15,6,15,48,46,2,51
Peterhead,6710,7,11,11,14,43,47,-4,44
East Fife,6710,8,10,11,15,39,47,-8,41
Queen's Park,6710,9,10,8,18,34,57,-23,38
Stenhousem'r,6710,10,8,8,20,42,75,-33,32
Livingston,6711,1,23,6,7,78,43,35,75
Alloa,6711,2,20,10,6,70,33,37,70
Airdrieon,6711,3,15,8,13,64,61,3,53
Albion,6711,4,14,8,14,60,54,6,50
Brechin,6711,5,15,5,16,46,56,-10,50
Queen's Park,6711,6,13,9,14,38,48,-10,48
Peterhead,6711,7,13,8,15,51,54,-3,47
East Fife,6711,8,12,9,15,49,51,-2,45
Stranraer,6711,9,10,9,17,50,67,-17,39
Stenhousem'r,6711,10,4,10,22,46,85,-39,22
Livingston,6712,1,21,6,9,72,48,24,69
Alloa,6712,2,18,8,10,62,47,15,62
Brechin,6712,3,17,8,11,57,57,0,59
Peterhead,6712,4,15,7,14,51,48,3,52
Albion,6712,5,14,9,13,54,48,6,51
Airdrieon,6712,6,14,8,14,51,50,1,50
East Fife,6712,7,13,10,13,59,47,12,49
Queen's Park,6712,8,14,7,15,41,50,-9,49
Stranraer,6712,9,10,6,20,47,61,-14,36
Stenhousem'r,6712,10,6,7,23,38,76,-38,25
Alloa,6713,1,19,7,10,70,51,19,64
Livingston,6713,2,19,1,16,74,55,19,58
Airdrieon,6713,3,17,6,13,57,51,6,57
Brechin,6713,4,16,8,12,45,42,3,56
Queen's Park,6713,5,17,4,15,39,42,-3,55
Peterhead,6713,6,16,5,15,53,55,-2,53
Stranraer,6713,7,15,4,17,45,52,-7,49
Albion,6713,8,13,6,17,47,52,-5,45
East Fife,6713,9,11,9,16,45,46,-1,42
Stenhousem'r,6713,10,8,8,20,48,77,-29,32
Livingston,6714,1,22,4,10,85,48,37,70
Airdrieon,6714,2,20,8,8,60,44,16,68
Alloa,6714,3,17,10,9,74,44,30,61
Peterhead,6714,4,15,9,12,48,47,1,54
Albion,6714,5,15,6,15,56,59,-3,51
Brechin,6714,6,14,8,14,41,46,-5,50
Queen's Park,6714,7,15,4,17,39,53,-14,49
Stranraer,6714,8,11,7,18,48,56,-8,40
East Fife,6714,9,9,9,18,47,57,-10,36
Stenhousem'r,6714,10,4,11,21,39,83,-44,23
Alloa,6715,1,20,8,8,78,41,37,68
Livingston,6715,2,21,4,11,73,45,28,67
Airdrieon,6715,3,18,7,11,57,45,12,61
Brechin,6715,4,17,9,10,52,49,3,60
Stranraer,6715,5,16,4,16,55,61,-6,52
Peterhead,6715,6,15,6,15,49,51,-2,51
Albion,6715,7,11,8,17,47,53,-6,41
Queen's Park,6715,8,10,8,18,39,55,-16,38
East Fife,6715,9,9,10,17,38,56,-18,37
Stenhousem'r,6715,10,7,8,21,41,73,-32,29
Airdrieon,6716,1,17,8,11,57,55,2,59
Alloa,6716,2,17,7,12,68,43,25,58
Livingston,6716,3,16,10,10,67,45,22,58
Brechin,6716,4,17,5,14,55,46,9,56
Stranraer,6716,5,16,6,14,51,54,-3,54
Albion,6716,6,14,9,13,53,54,-1,51
Peterhead,6716,7,12,11,13,38,47,-9,47
Queen's Park,6716,8,12,6,18,38,55,-17,42
East Fife,6716,9,10,11,15,46,48,-2,41
Stenhousem'r,6716,10,7,11,18,48,74,-26,32
Livingston,6717,1,25,3,8,88,45,43,78
Airdrieon,6717,2,21,3,12,62,57,5,66
Alloa,6717,3,16,10,10,70,44,26,58
Queen's Park,6717,4,16,5,15,37,48,-11,53
Albion,6717,5,15,6,15,50,50,0,51
Brechin,6717,6,14,9,13,47,50,-3,51
Peterhead,6717,7,12,8,16,60,58,2,44
Stranraer,6717,8,13,3,20,48,59,-11,42
East Fife,6717,9,10,9,17,41,47,-6,39
Stenhousem'r,6717,10,6,8,22,47,92,-45,26
Alloa,6718,1,20,9,7,63,35,28,69
Livingston,6718,2,18,5,13,68,51,17,59
Airdrieon,6718,3,16,11,9,56,49,7,59
Queen's Park,6718,4,15,10,11,42,47,-5,55
Brechin,6718,5,15,8,13,49,48,1,53
Peterhead,6718,6,16,5,15,48,49,-1,53
Stranraer,6718,7,13,8,15,49,46,3,47
Albion,6718,8,12,6,18,50,57,-7,42
East Fife,6718,9,7,11,18,44,52,-8,32
Stenhousem'r,6718,10,7,9,20,41,76,-35,30
Livingston,6719,1,22,2,12,83,48,35,68
Alloa,6719,2,20,8,8,67,37,30,68
Airdrieon,6719,3,18,6,12,61,56,5,60
Brechin,6719,4,15,6,15,41,40,1,51
East Fife,6719,5,13,11,12,47,45,2,50
Albion,6719,6,11,12,13,53,56,-3,45
Stranraer,6719,7,12,8,16,45,52,-7,44
Queen's Park,6719,8,13,4,19,36,57,-21,43
Peterhead,6719,9,11,9,16,41,56,-15,42
Stenhousem'r,6719,10,8,8,20,47,74,-27,32
Alloa,6720,1,24,4,8,86,38,48,76
Livingston,6720,2,19,5,12,76,58,18,62
Airdrieon,6720,3,16,10,10,65,58,7,58
Brechin,6720,4,15,7,14,45,46,-1,52
Peterhead,6720,5,15,4,17,48,53,-5,49
East Fife,6720,6,13,9,14,43,40,3,48
Albion,6720,7,12,7,17,49,56,-7,43
Stenhousem'r,6720,8,12,7,17,54,71,-17,43
Stranraer,6720,9,12,5,19,47,68,-21,41
Queen's Park,6720,10,11,4,21,30,55,-25,37
Livingston,6721,1,20,4,12,78,45,33,64
Brechin,6721,2,19,6,11,68,54,14,63
Airdrieon,6721,3,17,8,11,63,57,6,59
Alloa,6721,4,16,9,11,67,45,22,57
Albion,6721,5,15,9,12,54,61,-7,54
Peterhead,6721,6,13,8,15,47,50,-3,47
East Fife,6721,7,11,12,13,54,51,3,45
Stranraer,6721,8,10,11,15,44,52,-8,41
Queen's Park,6721,9,10,7,19,33,60,-27,37
Stenhousem'r,6721,10,7,10,19,45,78,-33,31
Alloa,6722,1,22,8,6,69,34,35,74
Airdrieon,6722,2,19,8,9,63,48,15,65
Brechin,6722,3,18,6,12,48,39,9,60
Livingston,6722,4,17,7,12,67,51,16,58
Albion,6722,5,13,9,14,50,46,4,48
Peterhead,6722,6,11,11,14,52,56,-4,44
Queen's Park,6722,7,12,6,18,32,53,-21,42
Stranraer,6722,8,10,7,19,49,62,-13,37
East Fife,6722,9,8,13,15,44,57,-13,37
Stenhousem'r,6722,10,8,9,19,51,79,-28,33
Livingston,6723,1,22,6,8,75,44,31,72
Alloa,6723,2,17,10,9,60,42,18,61
Albion,6723,3,17,9,10,61,43,18,60
Airdrieon,6723,4,17,4,15,53,54,-1,55
Brechin,6723,5,14,6,16,40,49,-9,48
East Fife,6723,6,12,11,13,60,52,8,47
Stranraer,6723,7,13,6,17,52,54,-2,45
Peterhead,6723,8,13,6,17,40,54,-14,45
Queen's Park,6723,9,11,7,18,34,53,-19,40
Stenhousem'r,6723,10,9,5,22,49,79,-30,32
Airdrieon,6724,1,21,4,11,65,50,15,67
Alloa,6724,2,17,9,10,72,48,24,60
Livingston,6724,3,18,3,15,71,53,18,57
Brechin,6724,4,17,6,13,58,52,6,57
Peterhead,6724,5,15,8,13,55,56,-1,53
East Fife,6724,6,14,10,12,53,46,7,52
Stranraer,6724,7,12,8,16,56,61,-5,44
Queen's Park,6724,8,12,8,16,34,53,-19,44
Albion,6724,9,9,12,15,49,58,-9,39
Stenhousem'r,6724,10,7,8,21,46,82,-36,29
Livingston,6725,1,20,5,11,85,53,32,65
Alloa,6725,2,19,7,10,70,43,27,64
Brechin,6725,3,19,4,13,54,46,8,61
Airdrieon,6725,4,16,12,8,63,54,9,60
Albion,6725,5,16,8,12,57,55,2,56
Stranraer,6725,6,14,5,17,54,54,0,47
Queen's Park,6725,7,13,7,16,32,51,-19,46
East Fife,6725,8,12,7,17,56,55,1,43
Peterhead,6725,9,10,6,20,46,68,-22,36
Stenhousem'r,6725,10,7,7,22,47,85,-38,28
Livingston,6726,1,21,7,8,79,47,32,70
Alloa,6726,2,19,10,7,67,37,30,67
Airdrieon,6726,3,17,7,12,58,54,4,58
Brechin,6726,4,16,6,14,46,44,2,54
Albion,6726,5,13,8,15,54,54,0,47
Stranraer,6726,6,13,6,17,47,53,-6,45
East Fife,6726,7,11,10,15,48,49,-1,43
Peterhead,6726,8,11,8,17,45,59,-14,41
Queen's Park,6726,9,12,4,20,25,45,-20,40
Stenhousem'r,6726,10,10,8,18,44,71,-27,38
Livingston,6727,1,19,7,10,72,53,19,64
Peterhead,6727,2,17,6,13,49,42,7,57
Airdrieon,6727,3,17,4,15,54,56,-2,55
Queen's Park,6727,4,17,4,15,42,46,-4,55
Alloa,6727,5,16,5,15,78,56,22,53
Brechin,6727,6,15,8,13,50,44,6,53
Stranraer,6727,7,16,4,16,49,61,-12,52
East Fife,6727,8,12,9,15,53,46,7,45
Albion,6727,9,10,8,18,47,56,-9,38
Stenhousem'r,6727,10,9,9,18,47,81,-34,36
Alloa,6728,1,20,9,7,77,39,38,69
Airdrieon,6728,2,20,5,11,65,49,16,65
Livingston,6728,3,19,4,13,68,48,20,61
Brechin,6728,4,16,7,13,51,50,1,55
Peterhead,6728,5,13,8,15,47,53,-6,47
Queen's Park,6728,6,14,5,17,37,54,-17,47
East Fife,6728,7,11,11,14,53,47,6,44
Stranraer,6728,8,12,7,17,42,51,-9,43
Stenhousem'r,6728,9,10,10,16,42,72,-30,40
Albion,6728,10,8,8,20,41,60,-19,32
Livingston,6729,1,24,3,9,90,47,43,75
Albion,6729,2,18,8,10,57,44,13,62
Brechin,6729,3,18,7,11,51,43,8,61
Alloa,6729,4,17,7,12,69,48,21,58
Airdrieon,6729,5,15,9,12,57,54,3,54
East Fife,6729,6,12,9,15,54,55,-1,45
Queen's Park,6729,7,10,11,15,44,62,-18,41
Peterhead,6729,8,11,8,17,40,59,-19,41
Stranraer,6729,9,9,9,18,42,60,-18,36
Stenhousem'r,6729,10,7,7,22,40,72,-32,28
Alloa,6730,1,23,8,5,82,40,42,77
Livingston,6730,2,23,2,11,82,53,29,71
Brechin,6730,3,18,6,12,53,49,4,60
Albion,6730,4,13,10,13,54,54,0,49
Peterhead,6730,5,14,7,15,52,55,-3,49
Airdrieon,6730,6,11,14,11,47,44,3,47
Stranraer,6730,7,13,4,19,47,57,-10,43
Queen's Park,6730,8,11,9,16,38,52,-14,42
East Fife,6730,9,10,11,15,44,50,-6,41
Stenhousem'r,6730,10,5,7,24,43,88,-45,22
Livingston,6731,1,22,6,8,86,46,40,72
Alloa,6731,2,20,7,9,74,45,29,67
Brechin,6731,3,19,3,14,50,43,7,60
Airdrieon,6731,4,19,3,14,52,60,-8,60
Stranraer,6731,5,17,3,16,63,59,4,54
Peterhead,6731,6,14,8,14,51,50,1,50
Albion,6731,7,11,12,13,53,48,5,45
East Fife,6731,8,10,9,17,47,55,-8,39
Queen's Park,6731,9,9,7,20,25,53,-28,34
Stenhousem'r,6731,10,7,6,23,47,89,-42,27
Alloa,6732,1,23,7,6,88,42,46,76
Livingston,6732,2,19,5,12,69,45,24,62
Brechin,6732,3,19,5,12,53,47,6,62
Airdrieon,6732,4,17,7,12,61,50,11,58
East Fife,6732,5,13,11,12,52,46,6,50
Albion,6732,6,14,8,14,44,51,-7,50
Peterhead,6732,7,11,10,15,42,54,-12,43
Queen's Park,6732,8,11,5,20,37,60,-23,38
Stenhousem'r,6732,9,8,9,19,40,69,-29,33
Stranraer,6732,10,9,5,22,48,70,-22,32
Livingston,6733,1,22,3,11,81,46,35,69
Alloa,6733,2,21,4,11,69,47,22,67
Airdrieon,6733,3,16,8,12,62,57,5,56
Albion,6733,4,17,5,14,59,58,1,56
Brechin,6733,5,16,7,13,47,48,-1,55
Peterhead,6733,6,15,8,13,55,52,3,53
Queen's Park,6733,7,14,7,15,37,48,-11,49
East Fife,6733,8,10,9,17,50,54,-4,39
Stranraer,6733,9,10,4,22,52,71,-19,34
Stenhousem'r,6733,10,6,11,19,55,86,-31,29
Livingston,6734,1,23,4,9,74,41,33,73
Airdrieon,6734,2,18,9,9,64,51,13,63
Brechin,6734,3,18,5,13,52,48,4,59
Alloa,6734,4,15,8,13,67,51,16,53
Peterhead,6734,5,14,8,14,48,56,-8,50
Queen's Park,6734,6,13,9,14,37,49,-12,48
Albion,6734,7,12,9,15,54,53,1,45
East Fife,6734,8,11,10,15,47,50,-3,43
Stranraer,6734,9,9,9,18,50,57,-7,36
Stenhousem'r,6734,10,6,11,19,41,78,-37,29
Airdrieon,6735,1,21,4,11,62,49,13,67
Livingston,6735,2,18,6,12,60,43,17,60
Alloa,6735,3,16,10,10,63,45,18,58
Brechin,6735,4,15,7,14,52,52,0,52
Queen's Park,6735,5,15,5,16,42,53,-11,50
Peterhead,6735,6,14,7,15,59,52,7,49
Stranraer,6735,7,14,6,16,44,54,-10,48
Stenhousem'r,6735,8,12,8,16,51,67,-16,44
East Fife,6735,9,9,11,16,42,48,-6,38
Albion,6735,10,10,8,18,49,61,-12,38
Livingston,6736,1,21,4,11,76,49,27,67
Brechin,6736,2,20,3,13,56,51,5,63
Alloa,6736,3,18,6,12,72,54,18,60
Albion,6736,4,15,10,11,53,43,10,55
Airdrieon,6736,5,15,6,15,52,59,-7,51
Peterhead,6736,6,12,12,12,45,51,-6,48
Queen's Park,6736,7,14,4,18,39,54,-15,46
Stranraer,6736,8,14,2,20,54,53,1,44
East Fife,6736,9,12,7,17,52,51,1,43
Stenhousem'r,6736,10,8,8,20,47,81,-34,32
Livingston,6737,1,21,4,11,79,51,28,67
Alloa,6737,2,20,7,9,73,45,28,67
Airdrieon,6737,3,16,11,9,54,47,7,59
Brechin,6737,4,17,5,14,49,45,4,56
Albion,6737,5,14,10,12,58,53,5,52
Queen's Park,6737,6,15,7,14,46,47,-1,52
East Fife,6737,7,12,10,14,53,52,1,46
Peterhead,6737,8,9,10,17,47,64,-17,37
Stranraer,6737,9,10,6,20,43,62,-19,36
Stenhousem'r,6737,10,8,6,22,51,87,-36,30
Alloa,6738,1,22,6,8,69,41,28,72
Livingston,6738,2,22,4,10,78,47,31,70
Airdrieon,6738,3,18,5,13,61,54,7,59
Peterhead,6738,4,15,8,13,59,58,1,53
Brechin,6738,5,16,4,16,52,53,-1,52
Albion,6738,6,13,7,16,58,54,4,46
Queen's Park,6738,7,13,7,16,34,51,-17,46
Stranraer,6738,8,13,4,19,53,64,-11,43
East Fife,6738,9,9,12,15,47,52,-5,39
Stenhousem'r,6738,10,8,5,23,43,80,-37,29
Livingston,6739,1,21,5,10,77,48,29,68
Alloa,6739,2,18,8,10,69,48,21,62
Brechin,6739,3,19,3,14,54,48,6,60
East Fife,6739,4,16,9,11,56,39,17,57
Airdrieon,6739,5,15,6,15,67,65,2,51
Stranraer,6739,6,14,6,16,52,60,-8,48
Peterhead,6739,7,12,9,15,46,59,-13,45
Queen's Park,6739,8,13,5,18,36,55,-19,44
Albion,6739,9,12,7,17,55,60,-5,43
Stenhousem'r,6739,10,6,10,20,46,76,-30,28
Livingston,6740,1,21,3,12,71,47,24,66
Alloa,6740,2,18,10,8,76,44,32,64
Albion,6740,3,18,5,13,54,53,1,59
Airdrieon,6740,4,16,8,12,58,56,2,56
Stranraer,6740,5,16,7,13,57,56,1,55
East Fife,6740,6,14,9,13,57,42,15,51
Brechin,6740,7,15,4,17,47,52,-5,49
Peterhead,6740,8,13,7,16,52,60,-8,46
Queen's Park,6740,9,13,6,17,40,55,-15,45
Stenhousem'r,6740,10,3,7,26,38,85,-47,16
Alloa,6741,1,19,6,11,70,47,23,63
Livingston,6741,2,18,7,11,72,54,18,61
Airdrieon,6741,3,16,11,9,60,51,9,59
Queen's Park,6741,4,15,7,14,33,44,-11,52
Albion,6741,5,15,6,15,49,46,3,51
Stranraer,6741,6,15,6,15,63,61,2,51
East Fife,6741,7,14,7,15,56,47,9,49
Brechin,6741,8,14,7,15,48,48,0,49
Peterhead,6741,9,13,6,17,50,56,-6,45
Stenhousem'r,6741,10,6,7,23,43,90,-47,25
Alloa,6742,1,20,8,8,76,44,32,68
Livingston,6742,2,20,7,9,76,47,29,67
Stranraer,6742,3,14,11,11,54,51,3,53
Albion,6742,4,14,10,12,51,51,0,52
Brechin,6742,5,15,7,14,50,53,-3,52
Airdrieon,6742,6,14,8,14,55,52,3,50
Peterhead,6742,7,11,10,15,51,57,-6,43
Queen's Park,6742,8,11,8,17,35,47,-12,41
East Fife,6742,9,10,9,17,48,57,-9,39
Stenhousem'r,6742,10,6,12,18,40,77,-37,30
Alloa,6743,1,23,5,8,81,35,46,74
Airdrieon,6743,2,18,7,11,68,57,11,61
Brechin,6743,3,16,8,12,51,50,1,56
Livingston,6743,4,16,5,15,71,61,10,53
Albion,6743,5,15,6,15,57,51,6,51
Peterhead,6743,6,13,8,15,44,51,-7,47
Queen's Park,6743,7,12,11,13,45,56,-11,47
East Fife,6743,8,9,12,15,45,56,-11,39
Stranraer,6743,9,10,7,19,47,65,-18,37
Stenhousem'r,6743,10,8,11,17,50,77,-27,35
Alloa,6744,1,20,6,10,71,43,28,66
Livingston,6744,2,19,7,10,71,44,27,64
Brechin,6744,3,16,11,9,45,38,7,59
Albion,6744,4,16,10,10,56,46,10,58
Airdrieon,6744,5,16,7,13,58,51,7,55
Peterhead,6744,6,15,5,16,55,54,1,50
Queen's Park,6744,7,11,13,12,37,49,-12,46
Stranraer,6744,8,9,10,17,45,53,-8,37
East Fife,6744,9,8,10,18,45,61,-16,34
Stenhousem'r,6744,10,8,5,23,43,87,-44,29
Livingston,6745,1,23,5,8,86,35,51,74
Alloa,6745,2,17,8,11,69,50,19,59
Airdrieon,6745,3,17,8,11,57,50,7,59
Brechin,6745,4,18,5,13,54,53,1,59
Queen's Park,6745,5,15,8,13,35,47,-12,53
East Fife,6745,6,11,9,16,54,52,2,42
Peterhead,6745,7,11,8,17,45,60,-15,41
Stranraer,6745,8,12,4,20,50,71,-21,40
Albion,6745,9,9,11,16,47,58,-11,38
Stenhousem'r,6745,10,10,8,18,55,76,-21,38
Livingston,6746,1,22,3,11,80,51,29,69
Brechin,6746,2,21,5,10,66,39,27,68
Alloa,6746,3,19,7,10,68,50,18,64
Airdrieon,6746,4,18,2,16,72,57,15,56
Peterhead,6746,5,15,7,14,43,52,-9,52
Albion,6746,6,13,6,17,52,59,-7,45
East Fife,6746,7,12,8,16,54,52,2,44
Stranraer,6746,8,13,5,18,47,57,-10,44
Queen's Park,6746,9,11,7,18,32,51,-19,40
Stenhousem'r,6746,10,8,6,22,40,86,-46,30
Alloa,6747,1,21,6,9,71,39,32,69
Livingston,6747,2,18,7,11,74,50,24,61
Brechin,6747,3,15,10,11,50,42,8,55
Peterhead,6747,4,16,7,13,55,55,0,55
Albion,6747,5,13,14,9,57,47,10,53
Airdrieon,6747,6,15,5,16,58,66,-8,50
Queen's Park,6747,7,12,9,15,41,50,-9,45
East Fife,6747,8,10,10,16,45,54,-9,40
Stranraer,6747,9,10,8,18,40,61,-21,38
Stenhousem'r,6747,10,7,10,19,48,75,-27,31
Alloa,6748,1,19,7,10,76,49,27,64
Livingston,6748,2,19,6,11,65,45,20,63
Airdrieon,6748,3,17,5,14,58,55,3,56
Brechin,6748,4,17,5,14,52,50,2,56
Peterhead,6748,5,14,8,14,56,57,-1,50
East Fife,6748,6,14,7,15,53,49,4,49
Albion,6748,7,13,9,14,56,56,0,48
Stranraer,6748,8,13,6,17,53,62,-9,45
Queen's Park,6748,9,10,8,18,32,53,-21,38
Stenhousem'r,6748,10,9,9,18,52,77,-25,36
Livingston,6749,1,24,3,9,74,38,36,75
Alloa,6749,2,20,7,9,67,38,29,67
Albion,6749,3,17,7,12,59,47,12,58
Brechin,6749,4,16,9,11,52,47,5,57
Airdrieon,6749,5,16,6,14,46,46,0,54
Queen's Park,6749,6,14,5,17,40,51,-11,47
Peterhead,6749,7,10,8,18,47,65,-18,38
Stranraer,6749,8,11,5,20,42,60,-18,38
East Fife,6749,9,10,7,19,50,57,-7,37
Stenhousem'r,6749,10,10,7,19,48,76,-28,37
Livingston,6750,1,20,9,7,80,47,33,69
Airdrieon,6750,2,19,9,8,68,54,14,66
Alloa,6750,3,18,7,11,68,50,18,61
Peterhead,6750,4,17,6,13,56,49,7,57
Albion,6750,5,14,10,12,54,51,3,52
Stranraer,6750,6,12,10,14,58,59,-1,46
Brechin,6750,7,13,4,19,41,54,-13,43
East Fife,6750,8,11,9,16,56,57,-1,42
Queen's Park,6750,9,11,5,20,49,67,-18,38
Stenhousem'r,6750,10,8,5,23,54,96,-42,29
Alloa,6751,1,20,8,8,74,43,31,68
Airdrieon,6751,2,20,4,12,60,45,15,64
Livingston,6751,3,18,5,13,69,57,12,59
Brechin,6751,4,15,8,13,45,51,-6,53
Albion,6751,5,13,10,13,51,46,5,49
Queen's Park,6751,6,15,4,17,42,51,-9,49
East Fife,6751,7,13,7,16,56,56,0,46
Stranraer,6751,8,12,8,16,48,54,-6,44
Peterhead,6751,9,10,12,14,47,54,-7,42
Stenhousem'r,6751,10,6,10,20,38,73,-35,28
Alloa,6752,1,25,5,6,86,39,47,80
Livingston,6752,2,21,7,8,80,49,31,70
Albion,6752,3,15,8,13,55,53,2,53
Brechin,6752,4,15,7,14,50,48,2,52
East Fife,6752,5,13,10,13,62,57,5,49
Airdrieon,6752,6,14,7,15,50,58,-8,49
Peterhead,6752,7,13,9,14,55,59,-4,48
Queen's Park,6752,8,11,7,18,40,61,-21,40
Stranraer,6752,9,8,7,21,39,60,-21,31
Stenhousem'r,6752,10,6,11,19,40,73,-33,29
Alloa,6753,1,19,11,6,68,41,27,68
Livingston,6753,2,22,2,12,76,50,26,68
Airdrieon,6753,3,18,5,13,70,63,7,59
Brechin,6753,4,14,13,9,51,46,5,55
Peterhead,6753,5,15,8,13,54,53,1,53
Albion,6753,6,12,10,14,63,62,1,46
Stranraer,6753,7,13,4,19,50,62,-12,43
East Fife,6753,8,10,11,15,52,51,1,41
Queen's Park,6753,9,10,9,17,38,58,-20,39
Stenhousem'r,6753,10,6,9,21,48,84,-36,27
Airdrieon,6754,1,22,6,8,60,42,18,72
Livingston,6754,2,20,6,10,69,44,25,66
Alloa,6754,3,18,8,10,64,45,19,62
Brechin,6754,4,18,4,14,54,46,8,58
Peterhead,6754,5,14,7,15,57,56,1,49
East Fife,6754,6,13,7,16,52,51,1,46
Albion,6754,7,11,8,17,43,52,-9,41
Queen's Park,6754,8,12,5,19,37,48,-11,41
Stenhousem'r,6754,9,9,9,18,47,74,-27,36
Stranraer,6754,10,8,10,18,42,67,-25,34
Livingston,6755,1,21,3,12,72,53,19,66
Alloa,6755,2,17,7,12,63,46,17,58
Airdrieon,6755,3,15,10,11,59,49,10,55
Stranraer,6755,4,16,4,16,51,53,-2,52
East Fife,6755,5,13,12,11,53,46,7,51
Albion,6755,6,15,6,15,51,49,2,51
Brechin,6755,7,14,7,15,43,50,-7,49
Stenhousem'r,6755,8,12,7,17,53,75,-22,43
Queen's Park,6755,9,12,6,18,44,51,-7,42
Peterhead,6755,10,10,8,18,46,63,-17,38
Livingston,6756,1,20,3,13,78,51,27,63
Brechin,6756,2,19,6,11,56,47,9,63
Queen's Park,6756,3,18,6,12,46,46,0,60
Alloa,6756,4,17,7,12,68,48,20,58
Albion,6756,5,17,6,13,55,46,9,57
Airdrieon,6756,6,14,5,17,48,54,-6,47
Stranraer,6756,7,13,7,16,53,56,-3,46
East Fife,6756,8,12,8,16,46,53,-7,44
Peterhead,6756,9,10,11,15,36,55,-19,41
Stenhousem'r,6756,10,7,7,22,35,65,-30,28
Livingston,6757,1,19,5,12,71,52,19,62
Brechin,6757,2,17,10,9,56,41,15,61
Alloa,6757,3,16,10,10,58,44,14,58
Airdrieon,6757,4,16,5,15,64,60,4,53
Peterhead,6757,5,15,8,13,54,52,2,53
Stranraer,6757,6,14,7,15,47,60,-13,49
Queen's Park,6757,7,13,9,14,42,52,-10,48
East Fife,6757,8,12,10,14,54,42,12,46
Albion,6757,9,10,9,17,40,49,-9,39
Stenhousem'r,6757,10,8,7,21,45,79,-34,31
Livingston,6758,1,20,7,9,70,46,24,67
Airdrieon,6758,2,20,6,10,62,47,15,66
Alloa,6758,3,18,9,9,65,44,21,63
Brechin,6758,4,16,5,15,45,50,-5,53
Queen's Park,6758,5,14,9,13,49,47,2,51
East Fife,6758,6,13,9,14,54,49,5,48
Albion,6758,7,12,10,14,43,47,-4,46
Peterhead,6758,8,12,9,15,49,52,-3,45
Stranraer,6758,9,9,9,18,51,65,-14,36
Stenhousem'r,6758,10,6,7,23,44,85,-41,25
Livingston,6759,1,24,4,8,82,47,35,76
Alloa,6759,2,19,9,8,65,34,31,66
Airdrieon,6759,3,16,8,12,53,53,0,56
Peterhead,6759,4,15,10,11,53,49,4,55
Brechin,6759,5,15,8,13,47,50,-3,53
Albion,6759,6,11,12,13,59,62,-3,45
East Fife,6759,7,11,12,13,40,43,-3,45
Queen's Park,6759,8,12,8,16,48,57,-9,44
Stranraer,6759,9,8,6,22,37,59,-22,30
Stenhousem'r,6759,10,8,5,23,44,74,-30,29
Livingston,6760,1,25,3,8,93,42,51,78
Airdrieon,6760,2,19,7,10,71,51,20,64
Alloa,6760,3,19,7,10,67,48,19,64
Brechin,6760,4,18,3,15,53,57,-4,57
Peterhead,6760,5,14,9,13,47,53,-6,51
East Fife,6760,6,11,8,17,50,55,-5,41
Albion,6760,7,10,10,16,49,55,-6,40
Stranraer,6760,8,11,6,19,49,67,-18,39
Queen's Park,6760,9,9,10,17,28,47,-19,37
Stenhousem'r,6760,10,7,11,18,45,77,-32,32
Alloa,6761,1,22,6,8,84,49,35,72
Livingston,6761,2,23,3,10,71,43,28,72
Airdrieon,6761,3,16,8,12,52,61,-9,56
Brechin,6761,4,15,7,14,50,45,5,52
East Fife,6761,5,12,10,14,48,52,-4,46
Stranraer,6761,6,12,8,16,52,55,-3,44
Peterhead,6761,7,12,8,16,53,58,-5,44
Albion,6761,8,10,13,13,44,50,-6,43
Queen's Park,6761,9,10,9,17,41,54,-13,39
Stenhousem'r,6761,10,9,6,21,46,74,-28,33
Livingston,6762,1,22,6,8,71,44,27,72
Airdrieon,6762,2,20,10,6,71,39,32,70
Alloa,6762,3,19,7,10,66,45,21,64
Brechin,6762,4,14,10,12,49,47,2,52
Albion,6762,5,14,8,14,54,50,4,50
Peterhead,6762,6,12,7,17,39,49,-10,43
Queen's Park,6762,7,10,8,18,37,54,-17,38
Stranraer,6762,8,9,10,17,47,59,-12,37
Stenhousem'r,6762,9,9,10,17,50,86,-36,37
East Fife,6762,10,8,10,18,48,59,-11,34
Livingston,6763,1,20,6,10,75,53,22,66
Alloa,6763,2,17,8,11,63,43,20,59
East Fife,6763,3,17,8,11,52,36,16,59
Airdrieon,6763,4,16,10,10,59,49,10,58
Stranraer,6763,5,16,5,15,58,61,-3,53
Brechin,6763,6,15,7,14,49,48,1,52
Peterhead,6763,7,12,9,15,45,49,-4,45
Queen's Park,6763,8,11,7,18,34,57,-23,40
Albion,6763,9,9,12,15,49,51,-2,39
Stenhousem'r,6763,10,5,12,19,40,77,-37,27
Livingston,6764,1,18,8,10,68,46,22,62
Airdrieon,6764,2,18,5,13,58,45,13,59
Brechin,6764,3,18,3,15,56,49,7,57
Alloa,6764,4,17,5,14,70,52,18,56
Stranraer,6764,5,15,5,16,57,62,-5,50
East Fife,6764,6,13,9,14,61,50,11,48
Peterhead,6764,7,13,8,15,50,59,-9,47
Albion,6764,8,12,10,14,54,62,-8,46
Queen's Park,6764,9,12,7,17,37,55,-18,43
Stenhousem'r,6764,10,10,8,18,45,76,-31,38
Alloa,6765,1,26,5,5,84,34,50,83
Livingston,6765,2,22,5,9,78,49,29,71
Brechin,6765,3,16,5,15,52,60,-8,53
Stranraer,6765,4,15,4,17,56,57,-1,49
Airdrieon,6765,5,14,7,15,50,53,-3,49
Peterhead,6765,6,13,8,15,49,54,-5,47
Albion,6765,7,12,9,15,56,66,-10,45
Queen's Park,6765,8,13,4,19,40,55,-15,43
East Fife,6765,9,10,11,15,50,45,5,41
Stenhousem'r,6765,10,7,6,23,41,83,-42,27
Alloa,6766,1,20,5,11,72,56,16,65
Brechin,6766,2,18,4,14,56,50,6,58
Livingston,6766,3,17,6,13,71,57,14,57
Stranraer,6766,4,15,9,12,63,55,8,54
Airdrieon,6766,5,15,6,15,60,62,-2,51
Queen's Park,6766,6,15,6,15,42,45,-3,51
Albion,6766,7,11,15,10,53,47,6,48
East Fife,6766,8,9,12,15,50,58,-8,39
Peterhead,6766,9,8,14,14,43,55,-12,38
Stenhousem'r,6766,10,9,9,18,48,73,-25,36
Alloa,6767,1,20,10,6,71,36,35,70
Livingston,6767,2,20,4,12,75,55,20,64
Airdrieon,6767,3,17,8,11,59,52,7,59
Peterhead,6767,4,17,6,13,48,44,4,57
Brechin,6767,5,15,10,11,57,57,0,55
Stranraer,6767,6,13,8,15,54,58,-4,47
Albion,6767,7,13,7,16,57,63,-6,46
Queen's Park,6767,8,10,8,18,37,56,-19,38
East Fife,6767,9,8,9,19,51,61,-10,33
Stenhousem'r,6767,10,8,8,20,44,71,-27,32
Livingston,6768,1,21,6,9,72,44,28,69
Alloa,6768,2,19,9,8,69,47,22,66
Airdrieon,6768,3,18,6,12,60,50,10,60
Brechin,6768,4,17,8,11,50,46,4,59
Stranraer,6768,5,16,6,14,59,55,4,54
East Fife,6768,6,11,12,13,47,47,0,45
Peterhead,6768,7,11,11,14,47,45,2,44
Albion,6768,8,11,8,17,47,48,-1,41
Queen's Park,6768,9,11,7,18,37,55,-18,40
Stenhousem'r,6768,10,7,3,26,35,86,-51,24
Alloa,6769,1,25,5,6,80,36,44,80
Livingston,6769,2,17,8,11,67,51,16,59
Peterhead,6769,3,16,10,10,54,43,11,58
Airdrieon,6769,4,16,4,16,56,57,-1,52
Brechin,6769,5,13,8,15,47,57,-10,47
Albion,6769,6,11,12,13,46,54,-8,45
Stranraer,6769,7,12,7,17,57,65,-8,43
Queen's Park,6769,8,11,8,17,37,57,-20,41
Stenhousem'r,6769,9,11,6,19,57,74,-17,39
East Fife,6769,10,9,10,17,47,54,-7,37
Livingston,6770,1,22,4,10,76,42,34,70
Airdrieon,6770,2,21,6,9,57,39,18,69
Alloa,6770,3,17,9,10,69,52,17,60
Brechin,6770,4,15,9,12,51,50,1,54
East Fife,6770,5,12,12,12,60,51,9,48
Queen's Park,6770,6,14,5,17,34,49,-15,47
Peterhead,6770,7,13,5,18,46,54,-8,44
Stranraer,6770,8,13,3,20,55,66,-11,42
Albion,6770,9,11,8,17,49,57,-8,41
Stenhousem'r,6770,10,8,7,21,37,74,-37,31
Livingston,6771,1,19,6,11,86,64,22,63
Brechin,6771,2,18,8,10,59,43,16,62
Alloa,6771,3,15,11,10,65,44,21,56
Peterhead,6771,4,16,6,14,51,50,1,54
Airdrieon,6771,5,15,9,12,60,64,-4,54
Stranraer,6771,6,16,5,15,58,56,2,53
Albion,6771,7,11,11,14,59,63,-4,44
Queen's Park,6771,8,11,9,16,38,57,-19,42
East Fife,6771,9,6,17,13,45,49,-4,35
Stenhousem'r,6771,10,7,10,19,51,82,-31,31
Livingston,6772,1,23,5,8,80,37,43,74
Brechin,6772,2,18,6,12,47,44,3,60
Airdrieon,6772,3,17,7,12,59,56,3,58
Alloa,6772,4,16,7,13,68,52,16,55
Queen's Park,6772,5,17,4,15,44,53,-9,55
East Fife,6772,6,13,8,15,53,49,4,47
Peterhead,6772,7,12,6,18,44,53,-9,42
Stenhousem'r,6772,8,11,7,18,45,72,-27,40
Albion,6772,9,10,9,17,51,57,-6,39
Stranraer,6772,10,10,7,19,47,65,-18,37
Alloa,6773,1,23,8,5,88,39,49,77
Livingston,6773,2,22,3,11,81,49,32,69
Airdrieon,6773,3,18,10,8,57,47,10,64
East Fife,6773,4,13,11,12,54,50,4,50
Brechin,6773,5,13,9,14,46,51,-5,48
Peterhead,6773,6,11,9,16,42,52,-10,42
Albion,6773,7,11,6,19,53,67,-14,39
Queen's Park,6773,8,10,9,17,35,55,-20,39
Stenhousem'r,6773,9,10,8,18,53,73,-20,38
Stranraer,6773,10,11,3,22,46,72,-26,36
Alloa,6774,1,22,9,5,80,40,40,75
Brechin,6774,2,17,8,11,53,48,5,59
Livingston,6774,3,16,8,12,62,44,18,56
Peterhead,6774,4,16,8,12,55,47,8,56
Albion,6774,5,14,10,12,61,52,9,52
Airdrieon,6774,6,14,5,17,54,67,-13,47
Stranraer,6774,7,12,5,19,48,57,-9,41
Queen's Park,6774,8,10,10,16,30,49,-19,40
East Fife,6774,9,10,7,19,42,55,-13,37
Stenhousem'r,6774,10,9,10,17,50,76,-26,37
Livingston,6775,1,20,5,11,79,51,28,65
Alloa,6775,2,17,11,8,71,43,28,62
Airdrieon,6775,3,19,4,13,52,45,7,61
Peterhead,6775,4,15,11,10,60,52,8,56
Albion,6775,5,16,7,13,56,50,6,55
Brechin,6775,6,16,6,14,54,56,-2,54
Queen's Park,6775,7,13,8,15,31,44,-13,47
East Fife,6775,8,10,11,15,49,53,-4,41
Stranraer,6775,9,10,5,21,52,76,-24,35
Stenhousem'r,6775,10,6,8,22,43,77,-34,26
Alloa,6776,1,20,6,10,68,51,17,66
Brechin,6776,2,21,3,12,58,41,17,66
Albion,6776,3,17,10,9,63,42,21,61
Livingston,6776,4,19,3,14,72,52,20,60
Airdrieon,6776,5,15,11,10,62,57,5,56
East Fife,6776,6,11,12,13,46,42,4,45
Stranraer,6776,7,12,6,18,52,64,-12,42
Stenhousem'r,6776,8,11,6,19,41,75,-34,39
Peterhead,6776,9,8,10,18,43,59,-16,34
Queen's Park,6776,10,9,7,20,38,60,-22,34
Livingston,6777,1,25,2,9,79,42,37,77
Brechin,6777,2,19,6,11,52,37,15,63
Airdrieon,6777,3,17,6,13,56,59,-3,57
Alloa,6777,4,15,9,12,67,47,20,54
Albion,6777,5,15,9,12,57,47,10,54
Peterhead,6777,6,14,10,12,52,46,6,52
Stranraer,6777,7,14,4,18,48,61,-13,46
Queen's Park,6777,8,13,6,17,36,50,-14,45
East Fife,6777,9,9,9,18,44,62,-18,36
Stenhousem'r,6777,10,5,7,24,43,83,-40,22
Livingston,6778,1,21,5,10,85,53,32,68
Airdrieon,6778,2,18,9,9,66,53,13,63
Alloa,6778,3,17,9,10,73,49,24,60
Brechin,6778,4,18,3,15,55,50,5,57
Albion,6778,5,14,8,14,54,50,4,50
Peterhead,6778,6,12,10,14,47,56,-9,46
Queen's Park,6778,7,13,7,16,44,54,-10,46
East Fife,6778,8,10,11,15,52,51,1,41
Stenhousem'r,6778,9,9,10,17,48,87,-39,37
Stranraer,6778,10,10,4,22,48,69,-21,34
Livingston,6779,1,22,4,10,77,43,34,70
Alloa,6779,2,19,8,9,70,42,28,65
Peterhead,6779,3,16,9,11,54,45,9,57
Airdrieon,6779,4,17,6,13,61,60,1,57
Brechin,6779,5,15,9,12,50,47,3,54
Albion,6779,6,14,7,15,62,58,4,49
Stranraer,6779,7,11,11,14,46,58,-12,44
East Fife,6779,8,10,11,15,47,50,-3,41
Queen's Park,6779,9,9,9,18,33,56,-23,36
Stenhousem'r,6779,10,7,6,23,45,86,-41,27
Alloa,6780,1,22,6,8,67,35,32,72
Livingston,6780,2,22,3,11,81,40,41,69
Airdrieon,6780,3,18,9,9,72,59,13,63
Brechin,6780,4,16,7,13,55,54,1,55
East Fife,6780,5,13,9,14,54,51,3,48
Peterhead,6780,6,14,5,17,46,51,-5,47
Albion,6780,7,12,9,15,52,55,-3,45
Stranraer,6780,8,11,7,18,45,69,-24,40
Queen's Park,6780,9,10,9,17,34,53,-19,39
Stenhousem'r,6780,10,5,10,21,35,74,-39,25
Livingston,6781,1,20,5,11,74,47,27,65
Alloa,6781,2,18,10,8,70,42,28,64
Airdrieon,6781,3,19,5,12,57,48,9,62
Albion,6781,4,15,10,11,57,51,6,55
East Fife,6781,5,14,11,11,63,54,9,53
Brechin,6781,6,15,6,15,52,52,0,51
Peterhead,6781,7,11,10,15,50,57,-7,43
Queen's Park,6781,8,12,6,18,37,56,-19,42
Stranraer,6781,9,11,7,18,50,67,-17,40
Stenhousem'r,6781,10,6,8,22,52,88,-36,26
Livingston,6782,1,23,4,9,77,39,38,73
Alloa,6782,2,19,8,9,73,43,30,65
Airdrieon,6782,3,19,6,11,60,55,5,63
Brechin,6782,4,17,4,15,52,53,-1,55
Stranraer,6782,5,15,4,17,50,54,-4,49
Peterhead,6782,6,13,9,14,51,53,-2,48
East Fife,6782,7,13,8,15,48,51,-3,47
Queen's Park,6782,8,12,9,15,41,54,-13,45
Albion,6782,9,9,5,22,38,59,-21,32
Stenhousem'r,6782,10,8,7,21,41,70,-29,31
Brechin,6783,1,23,4,9,60,37,23,73
Livingston,6783,2,19,5,12,77,54,23,62
Albion,6783,3,15,11,10,58,49,9,56
Peterhead,6783,4,15,10,11,55,51,4,55
Stranraer,6783,5,15,6,15,52,53,-1,51
Airdrieon,6783,6,13,9,14,49,53,-4,48
Alloa,6783,7,11,12,13,59,50,9,45
East Fife,6783,8,12,7,17,46,45,1,43
Queen's Park,6783,9,11,7,18,44,64,-20,40
Stenhousem'r,6783,10,5,11,20,41,85,-44,26
Alloa,6784,1,22,7,7,72,35,37,73
Livingston,6784,2,22,5,9,82,43,39,71
Airdrieon,6784,3,18,4,14,57,53,4,58
Albion,6784,4,16,7,13,65,51,14,55
Peterhead,6784,5,15,7,14,46,50,-4,52
Queen's Park,6784,6,14,4,18,41,52,-11,46
Brechin,6784,7,14,3,19,45,58,-13,45
East Fife,6784,8,11,8,17,50,51,-1,41
Stranraer,6784,9,10,6,20,43,69,-26,36
Stenhousem'r,6784,10,7,11,18,47,86,-39,32
Alloa,6785,1,17,9,10,75,42,33,60
Peterhead,6785,2,15,12,9,52,44,8,57
Livingston,6785,3,17,4,15,65,50,15,55
Stranraer,6785,4,17,4,15,52,56,-4,55
Brechin,6785,5,15,7,14,54,54,0,52
Airdrieon,6785,6,13,9,14,55,53,2,48
Albion,6785,7,14,6,16,53,61,-8,48
East Fife,6785,8,13,8,15,52,47,5,47
Queen's Park,6785,9,12,9,15,43,59,-16,45
Stenhousem'r,6785,10,9,8,19,53,88,-35,35
Livingston,6786,1,22,6,8,80,52,28,72
Alloa,6786,2,19,7,10,68,43,25,64
Albion,6786,3,15,10,11,55,49,6,55
Peterhead,6786,4,14,10,12,52,50,2,52
Stranraer,6786,5,14,8,14,51,51,0,50
Queen's Park,6786,6,15,5,16,37,44,-7,50
Brechin,6786,7,14,7,15,44,43,1,49
Airdrieon,6786,8,13,6,17,55,65,-10,45
East Fife,6786,9,8,8,20,42,62,-20,32
Stenhousem'r,6786,10,7,11,18,42,67,-25,32
Livingston,6787,1,22,3,11,83,42,41,69
Alloa,6787,2,20,7,9,72,46,26,67
Stranraer,6787,3,17,4,15,54,53,1,55
Airdrieon,6787,4,15,8,13,55,56,-1,53
Albion,6787,5,15,7,14,52,48,4,52
Brechin,6787,6,15,6,15,44,49,-5,51
Peterhead,6787,7,14,8,14,53,63,-10,50
East Fife,6787,8,10,9,17,51,56,-5,39
Queen's Park,6787,9,9,10,17,29,51,-22,37
Stenhousem'r,6787,10,9,6,21,53,82,-29,33
Livingston,6788,1,22,2,12,72,54,18,68
Alloa,6788,2,17,9,10,72,50,22,60
Albion,6788,3,17,7,12,59,54,5,58
Peterhead,6788,4,15,9,12,54,52,2,54
Airdrieon,6788,5,15,8,13,59,59,0,53
Queen's Park,6788,6,16,4,16,43,44,-1,52
Brechin,6788,7,15,6,15,49,50,-1,51
Stranraer,6788,8,12,7,17,57,68,-11,43
East Fife,6788,9,10,11,15,50,50,0,41
Stenhousem'r,6788,10,6,7,23,36,70,-34,25
Livingston,6789,1,19,6,11,72,51,21,63
Alloa,6789,2,18,8,10,70,46,24,62
Albion,6789,3,16,8,12,57,51,6,56
Airdrieon,6789,4,16,6,14,60,57,3,54
Stranraer,6789,5,13,10,13,55,53,2,49
Queen's Park,6789,6,14,7,15,42,56,-14,49
East Fife,6789,7,13,9,14,48,43,5,48
Brechin,6789,8,14,6,16,49,50,-1,48
Peterhead,6789,9,9,10,17,36,51,-15,37
Stenhousem'r,6789,10,8,10,18,49,80,-31,34
Alloa,6790,1,21,7,8,77,42,35,70
Livingston,6790,2,19,6,11,69,45,24,63
Brechin,6790,3,18,4,14,56,55,1,58
Airdrieon,6790,4,16,9,11,58,49,9,57
Albion,6790,5,15,10,11,60,45,15,55
Peterhead,6790,6,16,7,13,58,56,2,55
East Fife,6790,7,11,8,17,53,63,-10,41
Queen's Park,6790,8,10,8,18,31,51,-20,38
Stranraer,6790,9,10,7,19,44,61,-17,37
Stenhousem'r,6790,10,7,8,21,43,82,-39,29
Livingston,6791,1,20,8,8,75,48,27,68
Alloa,6791,2,18,10,8,64,43,21,64
Peterhead,6791,3,14,10,12,55,50,5,52
Airdrieon,6791,4,16,4,16,62,62,0,52
Albion,6791,5,13,12,11,52,48,4,51
Brechin,6791,6,14,7,15,46,50,-4,49
East Fife,6791,7,12,10,14,52,50,2,46
Queen's Park,6791,8,12,9,15,39,52,-13,45
Stranraer,6791,9,12,6,18,57,60,-3,42
Stenhousem'r,6791,10,8,6,22,45,84,-39,30
Livingston,6792,1,20,5,11,69,52,17,65
Airdrieon,6792,2,18,8,10,71,53,18,62
Brechin,6792,3,15,10,11,54,49,5,55
Alloa,6792,4,13,14,9,66,50,16,53
Stranraer,6792,5,14,8,14,55,62,-7,50
Peterhead,6792,6,13,10,13,49,53,-4,49
East Fife,6792,7,12,12,12,47,44,3,48
Albion,6792,8,12,10,14,55,58,-3,46
Queen's Park,6792,9,10,7,19,37,54,-17,37
Stenhousem'r,6792,10,8,6,22,55,83,-28,30
Livingston,6793,1,23,3,10,81,44,37,72
Alloa,6793,2,22,6,8,70,41,29,72
Airdrieon,6793,3,18,6,12,63,55,8,60
Brechin,6793,4,16,6,14,56,51,5,54
Albion,6793,5,15,9,12,56,57,-1,54
Peterhead,6793,6,12,9,15,50,54,-4,45
Stranraer,6793,7,12,4,20,49,60,-11,40
Stenhousem'r,6793,8,10,9,17,53,76,-23,39
East Fife,6793,9,8,12,16,43,53,-10,36
Queen's Park,6793,10,8,8,20,29,59,-30,32
Livingston,6794,1,19,10,7,69,45,24,67
Peterhead,6794,2,17,7,12,53,47,6,58
Airdrieon,6794,3,16,6,14,56,55,1,54
Brechin,6794,4,14,10,12,48,44,4,52
Alloa,6794,5,13,12,11,62,50,12,51
Albion,6794,6,14,8,14,57,58,-1,50
Stranraer,6794,7,14,8,14,52,58,-6,50
East Fife,6794,8,14,6,16,51,48,3,48
Queen's Park,6794,9,9,10,17,36,54,-18,37
Stenhousem'r,6794,10,7,9,20,56,81,-25,30
Livingston,6795,1,21,8,7,76,38,38,71
Alloa,6795,2,17,9,10,69,46,23,60
Airdrieon,6795,3,17,9,10,56,53,3,60
Albion,6795,4,16,9,11,60,48,12,57
Brechin,6795,5,16,7,13,50,49,1,55
Stranraer,6795,6,17,3,16,52,51,1,54
Peterhead,6795,7,9,12,15,49,59,-10,39
Queen's Park,6795,8,10,9,17,34,60,-26,39
East Fife,6795,9,10,8,18,54,55,-1,38
Stenhousem'r,6795,10,7,6,23,46,87,-41,27
Airdrieon,6796,1,21,6,9,73,50,23,69
Brechin,6796,2,19,6,11,53,42,11,63
Alloa,6796,3,17,11,8,65,43,22,62
Livingston,6796,4,17,7,12,64,50,14,58
Queen's Park,6796,5,13,9,14,38,50,-12,48
Stranraer,6796,6,14,4,18,47,53,-6,46
Albion,6796,7,10,11,15,43,49,-6,41
East Fife,6796,8,10,10,16,49,51,-2,40
Stenhousem'r,6796,9,9,10,17,50,76,-26,37
Peterhead,6796,10,8,10,18,40,58,-18,34
Brechin,6797,1,19,9,8,56,39,17,66
Airdrieon,6797,2,19,8,9,63,55,8,65
Alloa,6797,3,19,6,11,69,39,30,63
Livingston,6797,4,17,9,10,65,45,20,60
Queen's Park,6797,5,16,6,14,49,46,3,54
Peterhead,6797,6,15,6,15,41,44,-3,51
East Fife,6797,7,10,11,15,50,47,3,41
Albion,6797,8,10,11,15,46,56,-10,41
Stranraer,6797,9,11,3,22,38,64,-26,36
Stenhousem'r,6797,10,5,9,22,42,84,-42,24
Alloa,6798,1,21,7,8,77,46,31,70
Livingston,6798,2,18,9,9,76,47,29,63
Airdrieon,6798,3,16,8,12,59,54,5,56
Albion,6798,4,15,9,12,56,50,6,54
Brechin,6798,5,15,6,15,45,47,-2,51
Queen's Park,6798,6,14,8,14,46,51,-5,50
Peterhead,6798,7,11,12,13,58,63,-5,45
Stranraer,6798,8,12,6,18,53,61,-8,42
Stenhousem'r,6798,9,8,13,15,49,80,-31,37
East Fife,6798,10,7,8,21,43,63,-20,29
Airdrieon,6799,1,19,8,9,74,54,20,65
Alloa,6799,2,19,6,11,73,40,33,63
Albion,6799,3,18,8,10,66,48,18,62
Livingston,6799,4,19,3,14,67,50,17,60
Brechin,6799,5,18,6,12,52,50,2,60
Peterhead,6799,6,14,8,14,49,52,-3,50
Queen's Park,6799,7,13,10,13,38,46,-8,49
East Fife,6799,8,10,10,16,48,52,-4,40
Stranraer,6799,9,12,4,20,49,68,-19,40
Stenhousem'r,6799,10,2,9,25,35,91,-56,15
Airdrieon,6800,1,22,2,12,60,50,10,68
Brechin,6800,2,20,6,10,61,43,18,66
Livingston,6800,3,21,2,13,67,50,17,65
Alloa,6800,4,19,7,10,76,48,28,64
Albion,6800,5,13,10,13,51,47,4,49
Stranraer,6800,6,15,2,19,62,65,-3,47
Peterhead,6800,7,13,8,15,50,56,-6,47
Queen's Park,6800,8,13,3,20,35,58,-23,42
Stenhousem'r,6800,9,10,8,18,54,80,-26,38
East Fife,6800,10,5,10,21,33,52,-19,25
Livingston,6801,1,22,2,12,77,55,22,68
Alloa,6801,2,16,11,9,59,44,15,59
Airdrieon,6801,3,14,12,10,56,50,6,54
East Fife,6801,4,13,12,11,49,41,8,51
Brechin,6801,5,14,9,13,52,52,0,51
Peterhead,6801,6,14,8,14,46,48,-2,50
Stranraer,6801,7,12,8,16,51,59,-8,44
Queen's Park,6801,8,12,8,16,33,42,-9,44
Albion,6801,9,10,10,16,42,46,-4,40
Stenhousem'r,6801,10,8,10,18,48,76,-28,34
Livingston,6802,1,19,7,10,77,49,28,64
Alloa,6802,2,19,6,11,73,47,26,63
Peterhead,6802,3,18,4,14,54,45,9,58
Airdrieon,6802,4,17,6,13,59,65,-6,57
Brechin,6802,5,16,7,13,54,51,3,55
East Fife,6802,6,16,5,15,54,51,3,53
Queen's Park,6802,7,16,4,16,38,48,-10,52
Albion,6802,8,13,9,14,57,47,10,48
Stranraer,6802,9,11,6,19,51,70,-19,39
Stenhousem'r,6802,10,5,6,25,46,90,-44,21
Livingston,6803,1,23,5,8,83,43,40,74
Alloa,6803,2,16,10,10,62,42,20,58
Airdrieon,6803,3,16,6,14,60,53,7,54
Brechin,6803,4,16,6,14,44,47,-3,54
Albion,6803,5,15,7,14,56,52,4,52
Queen's Park,6803,6,15,5,16,34,43,-9,50
Stranraer,6803,7,13,8,15,50,54,-4,47
Peterhead,6803,8,13,7,16,45,54,-9,46
East Fife,6803,9,10,13,13,47,51,-4,43
Stenhousem'r,6803,10,5,9,22,43,85,-42,24
Alloa,6804,1,21,8,7,73,35,38,71
Livingston,6804,2,20,6,10,80,45,35,66
Airdrieon,6804,3,19,3,14,61,58,3,60
East Fife,6804,4,16,8,12,63,50,13,56
Brechin,6804,5,13,8,15,40,53,-13,47
Peterhead,6804,6,12,10,14,46,49,-3,46
Stenhousem'r,6804,7,12,9,15,50,68,-18,45
Stranraer,6804,8,12,4,20,43,57,-14,40
Queen's Park,6804,9,9,10,17,32,55,-23,37
Albion,6804,10,10,6,20,48,66,-18,36
Livingston,6805,1,22,7,7,80,45,35,73
Alloa,6805,2,19,10,7,81,49,32,67
Brechin,6805,3,19,7,10,56,42,14,64
Airdrieon,6805,4,15,8,13,58,55,3,53
Albion,6805,5,13,12,11,57,51,6,51
Peterhead,6805,6,12,11,13,46,54,-8,47
East Fife,6805,7,12,10,14,50,46,4,46
Queen's Park,6805,8,12,5,19,38,52,-14,41
Stranraer,6805,9,11,3,22,43,69,-26,36
Stenhousem'r,6805,10,5,7,24,48,94,-46,22
Livingston,6806,1,23,2,11,76,42,34,71
Alloa,6806,2,19,11,6,59,37,22,68
Airdrieon,6806,3,17,9,10,56,50,6,60
Brechin,6806,4,15,11,10,45,43,2,56
Albion,6806,5,13,10,13,47,42,5,49
East Fife,6806,6,13,8,15,46,39,7,47
Queen's Park,6806,7,11,10,15,32,46,-14,43
Peterhead,6806,8,10,12,14,39,49,-10,42
Stranraer,6806,9,9,10,17,45,55,-10,37
Stenhousem'r,6806,10,3,11,22,39,81,-42,20
Livingston,6807,1,28,1,7,92,43,49,85
Albion,6807,2,17,7,12,57,48,9,58
East Fife,6807,3,15,9,12,60,42,18,54
Airdrieon,6807,4,16,5,15,58,57,1,53
Alloa,6807,5,15,7,14,55,54,1,52
Brechin,6807,6,15,5,16,54,52,2,50
Peterhead,6807,7,14,8,14,47,54,-7,50
Queen's Park,6807,8,15,5,16,36,50,-14,50
Stranraer,6807,9,10,6,20,41,58,-17,36
Stenhousem'r,6807,10,5,7,24,41,83,-42,22
Airdrieon,6808,1,18,9,9,75,57,18,63
Brechin,6808,2,19,6,11,48,43,5,63
Alloa,6808,3,17,8,11,68,47,21,59
Livingston,6808,4,17,7,12,65,52,13,58
Albion,6808,5,14,9,13,48,49,-1,51
Stranraer,6808,6,14,8,14,51,53,-2,50
Peterhead,6808,7,12,9,15,45,51,-6,45
East Fife,6808,8,11,9,16,45,52,-7,42
Queen's Park,6808,9,10,8,18,38,53,-15,38
Stenhousem'r,6808,10,8,7,21,47,73,-26,31
Livingston,6809,1,23,4,9,81,45,36,73
Airdrieon,6809,2,19,6,11,62,52,10,63
Brechin,6809,3,17,9,10,60,47,13,60
Alloa,6809,4,16,5,15,63,49,14,53
East Fife,6809,5,13,9,14,51,51,0,48
Albion,6809,6,12,9,15,48,57,-9,45
Peterhead,6809,7,13,6,17,53,63,-10,45
Stranraer,6809,8,13,5,18,48,61,-13,44
Queen's Park,6809,9,12,8,16,34,47,-13,44
Stenhousem'r,6809,10,7,9,20,52,80,-28,30
Alloa,6810,1,19,6,11,68,45,23,63
Livingston,6810,2,18,8,10,74,47,27,62
Brechin,6810,3,16,7,13,45,37,8,55
Airdrieon,6810,4,16,5,15,60,59,1,53
Queen's Park,6810,5,15,5,16,40,49,-9,50
Albion,6810,6,13,9,14,52,54,-2,48
Peterhead,6810,7,12,11,13,49,58,-9,47
East Fife,6810,8,13,7,16,47,49,-2,46
Stranraer,6810,9,12,7,17,47,52,-5,43
Stenhousem'r,6810,10,9,9,18,48,80,-32,36
Livingston,6811,1,21,9,6,77,44,33,72
Brechin,6811,2,20,6,10,59,41,18,66
Airdrieon,6811,3,20,6,10,71,61,10,66
Alloa,6811,4,18,8,10,67,47,20,62
Albion,6811,5,11,11,14,53,53,0,44
Peterhead,6811,6,11,10,15,57,61,-4,43
Queen's Park,6811,7,12,5,19,39,52,-13,41
Stranraer,6811,8,11,8,17,49,65,-16,41
Stenhousem'r,6811,9,10,5,21,47,74,-27,35
East Fife,6811,10,7,10,19,44,65,-21,31
Alloa,6812,1,22,8,6,68,29,39,74
Livingston,6812,2,20,4,12,63,44,19,64
Albion,6812,3,17,10,9,58,41,17,61
Queen's Park,6812,4,15,8,13,31,40,-9,53
Airdrieon,6812,5,13,7,16,53,59,-6,46
Stranraer,6812,6,13,5,18,46,57,-11,44
Brechin,6812,7,12,7,17,43,53,-10,43
Peterhead,6812,8,11,7,18,47,62,-15,40
Stenhousem'r,6812,9,11,7,18,49,68,-19,40
East Fife,6812,10,10,9,17,45,50,-5,39
Brechin,6813,1,19,6,11,59,46,13,63
Livingston,6813,2,18,7,11,69,53,16,61
Peterhead,6813,3,17,10,9,59,44,15,61
Alloa,6813,4,17,9,10,61,45,16,60
Airdrieon,6813,5,15,8,13,61,60,1,53
Stranraer,6813,6,15,6,15,51,50,1,51
East Fife,6813,7,13,6,17,50,53,-3,45
Queen's Park,6813,8,12,4,20,38,54,-16,40
Albion,6813,9,11,6,19,57,70,-13,39
Stenhousem'r,6813,10,8,8,20,53,83,-30,32
Livingston,6814,1,21,5,10,77,53,24,68
Airdrieon,6814,2,16,9,11,74,58,16,57
Brechin,6814,3,17,6,13,53,52,1,57
Alloa,6814,4,16,6,14,66,56,10,54
Queen's Park,6814,5,16,6,14,49,46,3,54
Stranraer,6814,6,16,6,14,63,61,2,54
Albion,6814,7,16,5,15,63,58,5,53
Peterhead,6814,8,14,9,13,51,53,-2,51
East Fife,6814,9,6,11,19,48,61,-13,29
Stenhousem'r,6814,10,8,5,23,46,92,-46,29
Livingston,6815,1,23,4,9,77,45,32,73
Alloa,6815,2,18,8,10,75,49,26,62
Airdrieon,6815,3,17,7,12,60,54,6,58
Peterhead,6815,4,14,12,10,56,51,5,54
Brechin,6815,5,14,7,15,51,50,1,49
Queen's Park,6815,6,14,7,15,45,53,-8,49
Stranraer,6815,7,12,7,17,49,57,-8,43
Stenhousem'r,6815,8,13,4,19,52,78,-26,43
Albion,6815,9,10,7,19,42,59,-17,37
East Fife,6815,10,7,13,16,44,55,-11,34
Alloa,6816,1,19,8,9,59,33,26,65
Airdrieon,6816,2,17,7,12,65,51,14,58
Livingston,6816,3,17,5,14,65,53,12,56
Peterhead,6816,4,16,8,12,47,41,6,56
Brechin,6816,5,17,4,15,48,43,5,55
Albion,6816,6,14,9,13,50,45,5,51
Queen's Park,6816,7,14,9,13,38,50,-12,51
Stenhousem'r,6816,8,12,8,16,46,69,-23,44
Stranraer,6816,9,10,6,20,43,62,-19,36
East Fife,6816,10,9,6,21,39,53,-14,33
Livingston,6817,1,20,4,12,74,52,22,64
Alloa,6817,2,17,11,8,64,39,25,62
Brechin,6817,3,19,5,12,60,53,7,62
Airdrieon,6817,4,16,7,13,58,53,5,55
Peterhead,6817,5,15,8,13,59,58,1,53
Albion,6817,6,13,11,12,53,48,5,50
Queen's Park,6817,7,13,10,13,36,41,-5,49
Stranraer,6817,8,13,6,17,45,58,-13,45
Stenhousem'r,6817,9,6,14,16,43,69,-26,32
East Fife,6817,10,6,8,22,46,67,-21,26
Alloa,6818,1,21,5,10,79,40,39,68
Livingston,6818,2,19,6,11,81,53,28,63
Brechin,6818,3,17,7,12,55,48,7,58
Airdrieon,6818,4,16,8,12,55,51,4,56
Peterhead,6818,5,15,7,14,58,50,8,52
East Fife,6818,6,13,9,14,50,48,2,48
Albion,6818,7,12,12,12,51,50,1,48
Queen's Park,6818,8,12,7,17,41,66,-25,43
Stranraer,6818,9,12,5,19,45,63,-18,41
Stenhousem'r,6818,10,6,8,22,39,85,-46,26
Livingston,6819,1,21,3,12,77,51,26,66
Stranraer,6819,2,18,4,14,62,56,6,58
Airdrieon,6819,3,15,9,12,67,53,14,54
Brechin,6819,4,17,3,16,51,60,-9,54
Alloa,6819,5,15,8,13,67,46,21,53
Peterhead,6819,6,15,8,13,53,57,-4,53
Albion,6819,7,14,7,15,52,58,-6,49
East Fife,6819,8,13,7,16,51,52,-1,46
Queen's Park,6819,9,12,6,18,38,55,-17,42
Stenhousem'r,6819,10,9,7,20,44,74,-30,34
Alloa,6820,1,24,6,6,89,38,51,78
Airdrieon,6820,2,18,5,13,70,56,14,59
Brechin,6820,3,17,6,13,53,47,6,57
Queen's Park,6820,4,17,6,13,45,59,-14,57
Livingston,6820,5,16,6,14,70,55,15,54
Peterhead,6820,6,11,10,15,51,59,-8,43
East Fife,6820,7,11,9,16,47,54,-7,42
Stranraer,6820,8,11,7,18,47,62,-15,40
Albion,6820,9,11,7,18,47,63,-16,40
Stenhousem'r,6820,10,11,4,21,49,75,-26,37
Brechin,6821,1,21,8,7,64,43,21,71
Livingston,6821,2,19,6,11,67,39,28,63
Airdrieon,6821,3,16,9,11,60,55,5,57
Alloa,6821,4,15,10,11,64,48,16,55
Peterhead,6821,5,14,9,13,50,46,4,51
East Fife,6821,6,14,8,14,55,50,5,50
Albion,6821,7,13,9,14,57,55,2,48
Stranraer,6821,8,10,9,17,52,62,-10,39
Queen's Park,6821,9,8,11,17,39,64,-25,35
Stenhousem'r,6821,10,5,11,20,44,90,-46,26
Livingston,6822,1,22,4,10,79,45,34,70
Airdrieon,6822,2,20,5,11,68,63,5,65
Alloa,6822,3,18,7,11,79,46,33,61
Brechin,6822,4,16,5,15,50,53,-3,53
Albion,6822,5,14,9,13,53,53,0,51
East Fife,6822,6,14,7,15,56,51,5,49
Peterhead,6822,7,12,7,17,45,52,-7,43
Queen's Park,6822,8,11,10,15,34,49,-15,43
Stranraer,6822,9,11,6,19,44,58,-14,39
Stenhousem'r,6822,10,8,8,20,41,79,-38,32
Livingston,6823,1,18,6,12,78,57,21,60
Alloa,6823,2,17,9,10,64,50,14,60
Airdrieon,6823,3,17,8,11,63,53,10,59
Brechin,6823,4,18,5,13,53,43,10,59
Stranraer,6823,5,17,4,15,54,57,-3,55
Peterhead,6823,6,14,10,12,49,48,1,52
Albion,6823,7,12,12,12,51,47,4,48
East Fife,6823,8,12,7,17,50,45,5,43
Queen's Park,6823,9,12,6,18,35,47,-12,42
Stenhousem'r,6823,10,5,9,22,41,91,-50,24
Livingston,6824,1,24,2,10,83,46,37,74
Alloa,6824,2,17,8,11,65,50,15,59
Albion,6824,3,15,11,10,60,46,14,56
Brechin,6824,4,16,5,15,48,57,-9,53
Airdrieon,6824,5,15,7,14,70,62,8,52
Peterhead,6824,6,14,10,12,58,57,1,52
Queen's Park,6824,7,15,5,16,45,55,-10,50
East Fife,6824,8,14,6,16,43,49,-6,48
Stranraer,6824,9,11,4,21,47,58,-11,37
Stenhousem'r,6824,10,5,10,21,43,82,-39,25
Livingston,6825,1,21,5,10,75,42,33,68
Brechin,6825,2,18,7,11,53,43,10,61
Peterhead,6825,3,17,8,11,55,46,9,59
Alloa,6825,4,16,9,11,64,45,19,57
Airdrieon,6825,5,14,9,13,57,58,-1,51
Albion,6825,6,13,10,13,55,57,-2,49
Queen's Park,6825,7,13,10,13,35,42,-7,49
Stranraer,6825,8,10,6,20,40,60,-20,36
Stenhousem'r,6825,9,9,8,19,51,76,-25,35
East Fife,6825,10,8,10,18,43,59,-16,34
Airdrieon,6826,1,20,6,10,75,49,26,66
Alloa,6826,2,19,7,10,65,42,23,64
Livingston,6826,3,18,7,11,79,56,23,61
Brechin,6826,4,16,7,13,53,50,3,55
Albion,6826,5,13,10,13,51,50,1,49
East Fife,6826,6,12,11,13,51,49,2,47
Peterhead,6826,7,11,10,15,48,57,-9,43
Queen's Park,6826,8,11,9,16,27,51,-24,42
Stranraer,6826,9,9,9,18,51,67,-16,36
Stenhousem'r,6826,10,10,6,20,45,74,-29,36
Alloa,6827,1,20,9,7,77,41,36,69
Livingston,6827,2,19,5,12,76,53,23,62
Brechin,6827,3,18,6,12,57,49,8,60
East Fife,6827,4,15,8,13,57,53,4,53
Airdrieon,6827,5,15,7,14,53,55,-2,52
Albion,6827,6,13,9,14,54,58,-4,48
Stranraer,6827,7,13,9,14,56,62,-6,48
Peterhead,6827,8,12,5,19,51,60,-9,41
Stenhousem'r,6827,9,11,6,19,54,78,-24,39
Queen's Park,6827,10,10,4,22,39,65,-26,34
Livingston,6828,1,23,4,9,80,43,37,73
Alloa,6828,2,19,8,9,74,44,30,65
Airdrieon,6828,3,15,10,11,62,57,5,55
Brechin,6828,4,17,4,15,49,50,-1,55
Peterhead,6828,5,15,8,13,53,54,-1,53
Queen's Park,6828,6,15,5,16,44,51,-7,50
Stranraer,6828,7,15,4,17,55,59,-4,49
Albion,6828,8,13,7,16,52,59,-7,46
East Fife,6828,9,10,8,18,48,56,-8,38
Stenhousem'r,6828,10,7,4,25,53,97,-44,25
Alloa,6829,1,19,8,9,79,40,39,65
Livingston,6829,2,18,6,12,76,54,22,60
Airdrieon,6829,3,17,5,14,62,64,-2,56
Brechin,6829,4,16,7,13,51,51,0,55
Albion,6829,5,15,7,14,57,54,3,52
East Fife,6829,6,13,11,12,57,47,10,50
Peterhead,6829,7,13,8,15,47,57,-10,47
Queen's Park,6829,8,12,8,16,44,53,-9,44
Stranraer,6829,9,11,7,18,45,70,-25,40
Stenhousem'r,6829,10,9,7,20,44,72,-28,34
Albion,6830,1,21,6,9,66,45,21,69
Livingston,6830,2,20,4,12,74,50,24,64
Alloa,6830,3,18,10,8,68,44,24,64
Airdrieon,6830,4,18,5,13,64,58,6,59
Brechin,6830,5,14,8,14,46,52,-6,50
Queen's Park,6830,6,14,8,14,45,53,-8,50
Peterhead,6830,7,13,6,17,55,60,-5,45
East Fife,6830,8,10,11,15,53,53,0,41
Stranraer,6830,9,9,6,21,46,67,-21,33
Stenhousem'r,6830,10,8,6,22,46,81,-35,30
Alloa,6831,1,23,6,7,71,39,32,75
Livingston,6831,2,17,5,14,75,68,7,56
Brechin,6831,3,16,8,12,52,46,6,56
Albion,6831,4,15,8,13,59,50,9,53
Peterhead,6831,5,14,10,12,55,53,2,52
Airdrieon,6831,6,15,6,15,54,59,-5,51
Queen's Park,6831,7,12,7,17,44,60,-16,43
Stranraer,6831,8,11,9,16,54,56,-2,42
East Fife,6831,9,10,11,15,54,54,0,41
Stenhousem'r,6831,10,8,8,20,43,76,-33,32
Livingston,6832,1,21,7,8,84,47,37,70
Alloa,6832,2,19,10,7,72,43,29,67
Queen's Park,6832,3,16,6,14,40,51,-11,54
East Fife,6832,4,14,9,13,60,50,10,51
Peterhead,6832,5,13,8,15,53,52,1,47
Brechin,6832,6,13,8,15,51,56,-5,47
Airdrieon,6832,7,13,7,16,56,66,-10,46
Stranraer,6832,8,12,7,17,55,66,-11,43
Albion,6832,9,10,11,15,52,62,-10,41
Stenhousem'r,6832,10,8,9,19,51,81,-30,33
Livingston,6833,1,22,5,9,81,43,38,71
Alloa,6833,2,20,8,8,65,46,19,68
Airdrieon,6833,3,18,7,11,63,51,12,61
Albion,6833,4,15,8,13,54,48,6,53
Brechin,6833,5,16,5,15,48,47,1,53
East Fife,6833,6,15,6,15,51,46,5,51
Peterhead,6833,7,13,6,17,47,55,-8,45
Stranraer,6833,8,11,7,18,42,55,-13,40
Queen's Park,6833,9,9,8,19,35,54,-19,35
Stenhousem'r,6833,10,6,10,20,37,78,-41,28
Alloa,6834,1,22,5,9,81,43,38,71
Airdrieon,6834,2,17,8,11,61,57,4,59
Brechin,6834,3,15,11,10,53,45,8,56
Livingston,6834,4,15,9,12,66,55,11,54
Peterhead,6834,5,15,7,14,50,56,-6,52
Albion,6834,6,14,7,15,56,52,4,49
Queen's Park,6834,7,14,6,16,47,57,-10,48
Stranraer,6834,8,12,6,18,53,57,-4,42
East Fife,6834,9,11,9,16,49,53,-4,42
Stenhousem'r,6834,10,7,8,21,42,83,-41,29
Livingston,6835,1,23,4,9,78,44,34,73
Alloa,6835,2,20,8,8,73,42,31,68
Brechin,6835,3,19,4,13,61,53,8,61
Airdrieon,6835,4,17,6,13,53,49,4,57
Queen's Park,6835,5,14,7,15,46,49,-3,49
Peterhead,6835,6,13,8,15,43,49,-6,47
Albion,6835,7,13,7,16,55,69,-14,46
Stranraer,6835,8,12,7,17,44,57,-13,43
East Fife,6835,9,11,8,17,48,48,0,41
Stenhousem'r,6835,10,4,9,23,41,82,-41,21
Livingston,6836,1,21,3,12,82,49,33,66
Airdrieon,6836,2,19,7,10,63,48,15,64
Alloa,6836,3,18,9,9,63,43,20,63
Albion,6836,4,15,9,12,54,49,5,54
Peterhead,6836,5,14,9,13,44,50,-6,51
Stranraer,6836,6,13,8,15,54,58,-4,47
Brechin,6836,7,13,7,16,49,57,-8,46
Queen's Park,6836,8,12,9,15,33,53,-20,45
East Fife,6836,9,10,10,16,47,45,2,40
Stenhousem'r,6836,10,5,9,22,33,70,-37,24
Alloa,6837,1,22,7,7,75,37,38,73
Livingston,6837,2,20,7,9,62,41,21,67
Airdrieon,6837,3,17,9,10,57,48,9,60
Brechin,6837,4,16,8,12,56,51,5,56
Peterhead,6837,5,14,9,13,49,52,-3,51
Albion,6837,6,11,10,15,44,47,-3,43
Stranraer,6837,7,12,5,19,45,60,-15,41
Queen's Park,6837,8,10,9,17,41,60,-19,39
East Fife,6837,9,9,10,17,43,49,-6,37
Stenhousem'r,6837,10,8,8,20,50,77,-27,32
Alloa,6838,1,22,8,6,91,46,45,74
Brechin,6838,2,22,4,10,60,46,14,70
Livingston,6838,3,20,0,16,74,60,14,60
Airdrieon,6838,4,17,5,14,65,59,6,56
Peterhead,6838,5,12,10,14,57,64,-7,46
Queen's Park,6838,6,12,9,15,47,62,-15,45
Albion,6838,7,11,10,15,44,50,-6,43
Stranraer,6838,8,11,6,19,50,58,-8,39
East Fife,6838,9,9,10,17,47,52,-5,37
Stenhousem'r,6838,10,10,6,20,53,91,-38,36
Alloa,6839,1,22,8,6,67,35,32,74
Livingston,6839,2,22,5,9,80,54,26,71
Albion,6839,3,16,9,11,59,45,14,57
Airdrieon,6839,4,16,7,13,59,53,6,55
Brechin,6839,5,14,10,12,41,44,-3,52
Stranraer,6839,6,13,8,15,53,55,-2,47
Peterhead,6839,7,12,6,18,45,58,-13,42
East Fife,6839,8,10,9,17,58,56,2,39
Queen's Park,6839,9,9,6,21,33,59,-26,33
Stenhousem'r,6839,10,8,8,20,43,79,-36,32
Livingston,6840,1,24,4,8,93,49,44,76
Alloa,6840,2,20,6,10,76,53,23,66
Airdrieon,6840,3,20,5,11,60,49,11,65
Brechin,6840,4,15,10,11,50,51,-1,55
Queen's Park,6840,5,14,8,14,49,51,-2,50
Peterhead,6840,6,13,7,16,48,57,-9,46
Albion,6840,7,12,9,15,51,51,0,45
East Fife,6840,8,10,12,14,45,50,-5,42
Stranraer,6840,9,12,5,19,50,59,-9,41
Stenhousem'r,6840,10,4,6,26,40,92,-52,18
Livingston,6841,1,22,4,10,81,52,29,70
Alloa,6841,2,18,8,10,73,47,26,62
Airdrieon,6841,3,19,4,13,63,48,15,61
Albion,6841,4,15,7,14,62,60,2,52
East Fife,6841,5,12,11,13,46,48,-2,47
Stranraer,6841,6,13,7,16,51,54,-3,46
Peterhead,6841,7,12,10,14,53,59,-6,46
Brechin,6841,8,12,10,14,44,52,-8,46
Queen's Park,6841,9,11,7,18,35,52,-17,40
Stenhousem'r,6841,10,8,8,20,50,86,-36,32
Livingston,6842,1,24,3,9,84,49,35,75
Airdrieon,6842,2,21,6,9,73,57,16,69
Alloa,6842,3,19,7,10,77,43,34,64
Queen's Park,6842,4,15,8,13,44,44,0,53
Brechin,6842,5,16,2,18,56,60,-4,50
Albion,6842,6,14,6,16,54,53,1,48
Peterhead,6842,7,13,7,16,47,62,-15,46
Stranraer,6842,8,11,7,18,45,62,-17,40
East Fife,6842,9,9,7,20,47,60,-13,34
Stenhousem'r,6842,10,6,11,19,42,79,-37,29
Livingston,6843,1,22,5,9,79,39,40,71
Brechin,6843,2,19,5,12,58,43,15,62
Alloa,6843,3,17,7,12,66,53,13,58
Queen's Park,6843,4,16,6,14,42,47,-5,54
Airdrieon,6843,5,15,7,14,59,55,4,52
Stranraer,6843,6,13,6,17,46,50,-4,45
Albion,6843,7,12,9,15,48,60,-12,45
Stenhousem'r,6843,8,11,10,15,56,72,-16,43
Peterhead,6843,9,11,7,18,47,70,-23,40
East Fife,6843,10,8,10,18,43,55,-12,34
Livingston,6844,1,19,9,8,70,43,27,66
Alloa,6844,2,16,9,11,68,53,15,57
Albion,6844,3,14,11,11,51,46,5,53
Stranraer,6844,4,15,7,14,60,57,3,52
Airdrieon,6844,5,14,8,14,56,49,7,50
Brechin,6844,6,13,10,13,52,48,4,49
Peterhead,6844,7,13,8,15,45,55,-10,47
Queen's Park,6844,8,12,10,14,41,48,-7,46
East Fife,6844,9,9,12,15,43,49,-6,39
Stenhousem'r,6844,10,9,8,19,46,84,-38,35
Livingston,6845,1,19,7,10,66,38,28,64
Alloa,6845,2,19,6,11,71,46,25,63
Airdrieon,6845,3,16,10,10,57,53,4,58
Stranraer,6845,4,15,8,13,61,52,9,53
Albion,6845,5,13,11,12,53,52,1,50
Peterhead,6845,6,14,8,14,51,52,-1,50
Brechin,6845,7,14,6,16,46,52,-6,48
East Fife,6845,8,8,13,15,51,63,-12,37
Queen's Park,6845,9,9,10,17,38,53,-15,37
Stenhousem'r,6845,10,9,9,18,55,88,-33,36
Alloa,6846,1,19,7,10,72,40,32,64
Brechin,6846,2,20,4,12,64,50,14,64
Livingston,6846,3,18,5,13,72,52,20,59
Airdrieon,6846,4,18,5,13,64,51,13,59
Queen's Park,6846,5,16,7,13,45,44,1,55
Albion,6846,6,15,8,13,57,58,-1,53
Peterhead,6846,7,12,8,16,47,63,-16,44
East Fife,6846,8,10,12,14,46,49,-3,42
Stranraer,6846,9,10,5,21,52,68,-16,35
Stenhousem'r,6846,10,7,9,20,43,87,-44,30
Alloa,6847,1,20,8,8,77,47,30,68
Livingston,6847,2,20,3,13,71,53,18,63
Airdrieon,6847,3,16,8,12,66,57,9,56
Peterhead,6847,4,17,5,14,61,56,5,56
Queen's Park,6847,5,14,7,15,45,48,-3,49
Albion,6847,6,12,11,13,54,53,1,47
Brechin,6847,7,12,10,14,49,56,-7,46
East Fife,6847,8,11,9,16,55,61,-6,42
Stranraer,6847,9,11,8,17,48,65,-17,41
Stenhousem'r,6847,10,9,7,20,59,89,-30,34
Livingston,6848,1,20,3,13,70,43,27,63
Alloa,6848,2,18,7,11,68,46,22,61
Brechin,6848,3,18,4,14,49,46,3,58
Airdrieon,6848,4,14,9,13,60,52,8,51
Peterhead,6848,5,15,6,15,57,59,-2,51
Albion,6848,6,14,8,14,62,59,3,50
Stranraer,6848,7,15,5,16,49,59,-10,50
Queen's Park,6848,8,13,4,19,41,60,-19,43
East Fife,6848,9,11,8,17,54,61,-7,41
Stenhousem'r,6848,10,10,10,16,45,70,-25,40
Livingston,6849,1,23,5,8,82,38,44,74
Airdrieon,6849,2,20,5,11,66,56,10,65
Alloa,6849,3,16,7,13,64,48,16,55
Brechin,6849,4,14,9,13,46,46,0,51
East Fife,6849,5,14,8,14,44,46,-2,50
Albion,6849,6,13,10,13,47,48,-1,49
Peterhead,6849,7,13,8,15,49,50,-1,47
Stranraer,6849,8,13,5,18,52,58,-6,44
Queen's Park,6849,9,10,10,16,30,52,-22,40
Stenhousem'r,6849,10,6,9,21,38,76,-38,27
Livingston,6850,1,20,6,10,73,44,29,66
Alloa,6850,2,18,8,10,72,50,22,62
East Fife,6850,3,16,7,13,53,45,8,55
Stranraer,6850,4,17,4,15,55,54,1,55
Airdrieon,6850,5,17,4,15,62,62,0,55
Peterhead,6850,6,15,6,15,47,52,-5,51
Queen's Park,6850,7,14,8,14,34,41,-7,50
Albion,6850,8,12,6,18,40,52,-12,42
Brechin,6850,9,11,7,18,43,53,-10,40
Stenhousem'r,6850,10,10,4,22,48,74,-26,34
Livingston,6851,1,21,7,8,79,45,34,70
Alloa,6851,2,21,7,8,73,43,30,70
Stranraer,6851,3,16,7,13,53,49,4,55
Brechin,6851,4,16,6,14,51,48,3,54
Albion,6851,5,14,10,12,61,50,11,52
Airdrieon,6851,6,14,9,13,54,56,-2,51
Queen's Park,6851,7,11,11,14,40,52,-12,44
Peterhead,6851,8,11,7,18,47,60,-13,40
East Fife,6851,9,9,8,19,37,56,-19,35
Stenhousem'r,6851,10,8,6,22,46,82,-36,30
Livingston,6852,1,22,4,10,85,44,41,70
Alloa,6852,2,20,8,8,66,35,31,68
Airdrieon,6852,3,18,7,11,58,53,5,61
Brechin,6852,4,17,9,10,53,39,14,60
East Fife,6852,5,12,11,13,47,47,0,47
Albion,6852,6,12,10,14,46,49,-3,46
Peterhead,6852,7,11,9,16,45,56,-11,42
Queen's Park,6852,8,11,5,20,37,64,-27,38
Stenhousem'r,6852,9,9,9,18,47,75,-28,36
Stranraer,6852,10,10,4,22,46,68,-22,34
Livingston,6853,1,22,4,10,73,42,31,70
Airdrieon,6853,2,19,6,11,57,46,11,63
Alloa,6853,3,17,11,8,75,50,25,62
Peterhead,6853,4,14,11,11,44,42,2,53
Brechin,6853,5,16,5,15,48,53,-5,53
Queen's Park,6853,6,14,5,17,34,47,-13,47
Albion,6853,7,12,7,17,43,51,-8,43
East Fife,6853,8,11,9,16,45,47,-2,42
Stranraer,6853,9,11,5,20,42,58,-16,38
Stenhousem'r,6853,10,7,11,18,51,76,-25,32
Livingston,6854,1,20,7,9,79,52,27,67
Alloa,6854,2,18,6,12,79,54,25,60
Brechin,6854,3,18,3,15,61,57,4,57
Queen's Park,6854,4,16,6,14,44,50,-6,54
Airdrieon,6854,5,13,13,10,56,54,2,52
Peterhead,6854,6,15,7,14,54,57,-3,52
Albion,6854,7,14,8,14,52,53,-1,50
Stranraer,6854,8,12,7,17,49,56,-7,43
East Fife,6854,9,9,9,18,45,52,-7,36
Stenhousem'r,6854,10,8,8,20,43,77,-34,32
Alloa,6855,1,22,7,7,72,34,38,73
Livingston,6855,2,20,5,11,78,54,24,65
Airdrieon,6855,3,20,3,13,64,53,11,63
Queen's Park,6855,4,15,8,13,36,42,-6,53
Brechin,6855,5,15,6,15,50,50,0,51
Albion,6855,6,13,8,15,48,49,-1,47
Peterhead,6855,7,10,12,14,49,57,-8,42
Stranraer,6855,8,11,6,19,47,66,-19,39
Stenhousem'r,6855,9,10,9,17,51,74,-23,39
East Fife,6855,10,6,12,18,35,51,-16,30
Livingston,6856,1,19,6,11,83,51,32,63
Brechin,6856,2,17,7,12,55,44,11,58
Airdrieon,6856,3,17,5,14,60,61,-1,56
Alloa,6856,4,15,9,12,60,46,14,54
East Fife,6856,5,14,12,10,55,45,10,54
Stranraer,6856,6,16,5,15,61,65,-4,53
Albion,6856,7,15,7,14,53,52,1,52
Queen's Park,6856,8,14,4,18,42,63,-21,46
Peterhead,6856,9,11,5,20,43,57,-14,38
Stenhousem'r,6856,10,9,6,21,53,81,-28,33
Alloa,6857,1,22,8,6,70,35,35,74
Livingston,6857,2,23,3,10,79,41,38,72
Albion,6857,3,15,9,12,51,50,1,54
Airdrieon,6857,4,16,5,15,55,62,-7,53
East Fife,6857,5,15,6,15,51,48,3,51
Stranraer,6857,6,15,3,18,49,63,-14,48
Peterhead,6857,7,13,7,16,50,53,-3,46
Brechin,6857,8,13,5,18,53,58,-5,44
Queen's Park,6857,9,11,8,17,36,50,-14,41
Stenhousem'r,6857,10,7,6,23,46,80,-34,27
Alloa,6858,1,26,6,4,83,36,47,84
Airdrieon,6858,2,18,8,10,57,46,11,62
Livingston,6858,3,18,6,12,84,58,26,60
Queen's Park,6858,4,15,6,15,38,45,-7,51
Brechin,6858,5,13,10,13,47,51,-4,49
East Fife,6858,6,12,10,14,52,45,7,46
Albion,6858,7,11,12,13,44,45,-1,45
Peterhead,6858,8,12,6,18,54,66,-12,42
Stranraer,6858,9,9,6,21,43,76,-33,33
Stenhousem'r,6858,10,5,12,19,46,80,-34,27
Brechin,6859,1,23,5,8,60,38,22,74
Alloa,6859,2,22,7,7,77,42,35,73
Livingston,6859,3,21,4,11,93,52,41,67
Airdrieon,6859,4,16,7,13,59,60,-1,55
Albion,6859,5,13,9,14,53,49,4,48
Peterhead,6859,6,10,11,15,42,56,-14,41
East Fife,6859,7,9,11,16,43,57,-14,38
Queen's Park,6859,8,10,8,18,36,57,-21,38
Stenhousem'r,6859,9,8,11,17,39,71,-32,35
Stranraer,6859,10,7,9,20,43,63,-20,30
Livingston,6860,1,18,7,11,73,57,16,61
Alloa,6860,2,17,9,10,66,44,22,60
Airdrieon,6860,3,18,6,12,58,52,6,60
Brechin,6860,4,16,10,10,48,40,8,58
Albion,6860,5,14,9,13,57,57,0,51
Stranraer,6860,6,14,7,15,56,51,5,49
Queen's Park,6860,7,13,7,16,34,41,-7,46
East Fife,6860,8,11,11,14,50,47,3,44
Peterhead,6860,9,10,13,13,44,55,-11,43
Stenhousem'r,6860,10,5,9,22,42,84,-42,24
Alloa,6861,1,22,6,8,81,42,39,72
Livingston,6861,2,22,2,12,75,48,27,68
Brechin,6861,3,16,7,13,46,49,-3,55
Albion,6861,4,16,6,14,61,50,11,54
Airdrieon,6861,5,16,6,14,58,53,5,54
Peterhead,6861,6,14,7,15,49,60,-11,49
East Fife,6861,7,13,9,14,55,52,3,48
Queen's Park,6861,8,11,6,19,34,57,-23,39
Stranraer,6861,9,9,8,19,45,59,-14,35
Stenhousem'r,6861,10,10,5,21,45,79,-34,35
Alloa,6862,1,21,7,8,70,43,27,70
Livingston,6862,2,21,5,10,76,45,31,68
Albion,6862,3,15,6,15,57,52,5,51
Brechin,6862,4,14,9,13,45,46,-1,51
Stranraer,6862,5,14,6,16,50,53,-3,48
Queen's Park,6862,6,14,6,16,38,46,-8,48
Peterhead,6862,7,13,9,14,45,54,-9,48
Airdrieon,6862,8,12,9,15,50,57,-7,45
East Fife,6862,9,12,6,18,45,46,-1,42
Stenhousem'r,6862,10,8,9,19,50,84,-34,33
Livingston,6863,1,22,6,8,79,46,33,72
Brechin,6863,2,16,9,11,59,48,11,57
Airdrieon,6863,3,15,9,12,58,59,-1,54
Alloa,6863,4,15,8,13,62,55,7,53
Peterhead,6863,5,15,5,16,52,56,-4,50
Albion,6863,6,12,12,12,52,51,1,48
Queen's Park,6863,7,14,6,16,41,48,-7,48
East Fife,6863,8,11,14,11,50,43,7,47
Stranraer,6863,9,14,3,19,48,59,-11,45
Stenhousem'r,6863,10,6,8,22,42,78,-36,26
Livingston,6864,1,24,5,7,80,39,41,77
Brechin,6864,2,19,3,14,60,45,15,60
Alloa,6864,3,17,8,11,64,49,15,59
Peterhead,6864,4,15,9,12,54,49,5,54
Airdrieon,6864,5,16,4,16,56,59,-3,52
Albion,6864,6,13,9,14,50,57,-7,48
Stranraer,6864,7,13,7,16,49,54,-5,46
Queen's Park,6864,8,12,6,18,37,57,-20,42
East Fife,6864,9,10,6,20,43,54,-11,36
Stenhousem'r,6864,10,8,9,19,49,79,-30,33
Livingston,6865,1,20,11,5,68,36,32,71
Airdrieon,6865,2,15,11,10,58,47,11,56
Stranraer,6865,3,17,5,14,52,55,-3,56
Alloa,6865,4,15,10,11,65,55,10,55
Peterhead,6865,5,13,13,10,49,44,5,52
East Fife,6865,6,14,9,13,52,45,7,51
Queen's Park,6865,7,13,6,17,42,52,-10,45
Albion,6865,8,11,9,16,41,43,-2,42
Brechin,6865,9,12,5,19,42,51,-9,41
Stenhousem'r,6865,10,6,9,21,41,82,-41,27
Livingston,6866,1,21,8,7,84,49,35,71
Alloa,6866,2,16,11,9,63,38,25,59
Albion,6866,3,16,10,10,51,46,5,58
Brechin,6866,4,16,8,12,54,50,4,56
Airdrieon,6866,5,13,13,10,46,45,1,52
Stranraer,6866,6,14,2,20,57,68,-11,44
Queen's Park,6866,7,11,10,15,35,51,-16,43
Peterhead,6866,8,11,7,18,44,54,-10,40
Stenhousem'r,6866,9,11,6,19,52,76,-24,39
East Fife,6866,10,8,11,17,44,53,-9,35
Airdrieon,6867,1,17,10,9,66,54,12,61
Livingston,6867,2,18,6,12,68,53,15,60
Peterhead,6867,3,17,9,10,52,47,5,60
Brechin,6867,4,16,10,10,57,43,14,58
Alloa,6867,5,15,10,11,61,42,19,55
Albion,6867,6,13,10,13,52,49,3,49
East Fife,6867,7,10,10,16,46,52,-6,40
Queen's Park,6867,8,9,13,14,31,49,-18,40
Stranraer,6867,9,11,5,20,44,61,-17,38
Stenhousem'r,6867,10,9,7,20,48,75,-27,34
Alloa,6868,1,21,7,8,75,49,26,70
Livingston,6868,2,20,2,14,83,57,26,62
Brechin,6868,3,16,9,11,52,40,12,57
Airdrieon,6868,4,17,5,14,54,61,-7,56
Albion,6868,5,14,10,12,59,54,5,52
Peterhead,6868,6,14,9,13,59,57,2,51
Stranraer,6868,7,14,5,17,50,60,-10,47
East Fife,6868,8,10,12,14,48,45,3,42
Queen's Park,6868,9,11,4,21,35,63,-28,37
Stenhousem'r,6868,10,8,7,21,48,77,-29,31
Livingston,6869,1,24,5,7,84,47,37,77
Alloa,6869,2,18,8,10,72,47,25,62
Brechin,6869,3,16,9,11,49,44,5,57
Stranraer,6869,4,15,6,15,63,59,4,51
Airdrieon,6869,5,13,7,16,50,63,-13,46
Peterhead,6869,6,12,9,15,54,59,-5,45
East Fife,6869,7,11,10,15,53,54,-1,43
Albion,6869,8,10,13,13,52,57,-5,43
Queen's Park,6869,9,10,9,17,30,50,-20,39
Stenhousem'r,6869,10,9,8,19,62,89,-27,35
Livingston,6870,1,24,3,9,91,47,44,75
Alloa,6870,2,19,7,10,69,43,26,64
Brechin,6870,3,18,6,12,51,45,6,60
Airdrieon,6870,4,16,6,14,59,71,-12,54
Albion,6870,5,14,10,12,60,57,3,52
Peterhead,6870,6,12,11,13,44,54,-10,47
Stranraer,6870,7,13,5,18,60,60,0,44
East Fife,6870,8,12,6,18,44,51,-7,42
Queen's Park,6870,9,10,10,16,38,49,-11,40
Stenhousem'r,6870,10,7,6,23,47,86,-39,27
Airdrieon,6871,1,19,6,11,53,41,12,63
Brechin,6871,2,19,4,13,51,40,11,61
Livingston,6871,3,19,2,15,68,54,14,59
Alloa,6871,4,16,10,10,60,42,18,58
Albion,6871,5,16,7,13,54,45,9,55
Queen's Park,6871,6,15,6,15,34,40,-6,51
East Fife,6871,7,12,9,15,51,53,-2,45
Peterhead,6871,8,10,12,14,42,49,-7,42
Stranraer,6871,9,10,6,20,46,66,-20,36
Stenhousem'r,6871,10,8,10,18,38,67,-29,34
Alloa,6872,1,25,5,6,80,36,44,80
Livingston,6872,2,20,3,13,75,51,24,63
Airdrieon,6872,3,18,8,10,64,47,17,62
Stranraer,6872,4,16,4,16,56,60,-4,52
Brechin,6872,5,15,6,15,47,51,-4,51
East Fife,6872,6,13,10,13,45,42,3,49
Albion,6872,7,14,6,16,49,53,-4,48
Peterhead,6872,8,12,8,16,53,60,-7,44
Queen's Park,6872,9,11,5,20,29,51,-22,38
Stenhousem'r,6872,10,5,7,24,37,84,-47,22
Livingston,6873,1,23,2,11,72,46,26,71
Alloa,6873,2,21,7,8,68,37,31,70
Albion,6873,3,15,10,11,45,39,6,55
Peterhead,6873,4,14,6,16,51,55,-4,48
Brechin,6873,5,14,5,17,43,56,-13,47
Queen's Park,6873,6,13,7,16,47,50,-3,46
East Fife,6873,7,12,9,15,53,49,4,45
Stranraer,6873,8,12,7,17,49,54,-5,43
Airdrieon,6873,9,13,4,19,49,61,-12,43
Stenhousem'r,6873,10,9,11,16,51,81,-30,38
Livingston,6874,1,26,3,7,82,43,39,81
Alloa,6874,2,22,7,7,79,40,39,73
Brechin,6874,3,19,6,11,55,42,13,63
Airdrieon,6874,4,15,6,15,52,63,-11,51
Peterhead,6874,5,13,9,14,54,50,4,48
Queen's Park,6874,6,13,6,17,37,52,-15,45
Stranraer,6874,7,12,7,17,57,68,-11,43
Albion,6874,8,12,5,19,46,55,-9,41
East Fife,6874,9,8,8,20,41,60,-19,32
Stenhousem'r,6874,10,7,9,20,43,73,-30,30
Livingston,6875,1,20,7,9,74,36,38,67
Alloa,6875,2,20,4,12,74,47,27,64
Airdrieon,6875,3,19,7,10,67,53,14,64
Peterhead,6875,4,13,12,11,58,60,-2,51
Albion,6875,5,15,6,15,47,55,-8,51
Stranraer,6875,6,13,11,12,54,54,0,50
Brechin,6875,7,14,8,14,48,49,-1,50
Queen's Park,6875,8,12,11,13,38,48,-10,47
East Fife,6875,9,5,13,18,34,50,-16,28
Stenhousem'r,6875,10,7,5,24,38,80,-42,26
Livingston,6876,1,20,6,10,87,59,28,66
Alloa,6876,2,19,6,11,64,45,19,63
Brechin,6876,3,18,6,12,63,58,5,60
Airdrieon,6876,4,16,7,13,58,60,-2,55
East Fife,6876,5,14,10,12,59,48,11,52
Peterhead,6876,6,15,5,16,50,49,1,50
Albion,6876,7,12,9,15,54,56,-2,45
Stranraer,6876,8,12,6,18,47,57,-10,42
Stenhousem'r,6876,9,10,8,18,51,76,-25,38
Queen's Park,6876,10,9,7,20,33,58,-25,34
Livingston,6877,1,19,7,10,77,54,23,64
Alloa,6877,2,19,7,10,66,47,19,64
Albion,6877,3,17,5,14,66,55,11,56
Brechin,6877,4,17,5,14,51,46,5,56
Airdrieon,6877,5,15,6,15,62,56,6,51
Stranraer,6877,6,15,4,17,60,64,-4,49
Queen's Park,6877,7,14,7,15,34,45,-11,49
Peterhead,6877,8,12,11,13,54,58,-4,47
East Fife,6877,9,12,8,16,50,51,-1,44
Stenhousem'r,6877,10,6,8,22,43,87,-44,26
Alloa,6878,1,23,7,6,76,39,37,76
Livingston,6878,2,22,5,9,72,40,32,71
Airdrieon,6878,3,18,7,11,58,47,11,61
Brechin,6878,4,16,9,11,58,47,11,57
Queen's Park,6878,5,16,5,15,45,53,-8,53
Peterhead,6878,6,13,6,17,51,59,-8,45
East Fife,6878,7,11,10,15,44,45,-1,43
Albion,6878,8,11,8,17,52,60,-8,41
Stranraer,6878,9,10,6,20,46,64,-18,36
Stenhousem'r,6878,10,5,7,24,39,87,-48,22
Livingston,6879,1,22,5,9,85,46,39,71
Airdrieon,6879,2,16,11,9,61,59,2,59
Alloa,6879,3,17,6,13,71,50,21,57
Peterhead,6879,4,15,11,10,51,44,7,56
Albion,6879,5,15,9,12,54,50,4,54
Stranraer,6879,6,16,5,15,62,62,0,53
Brechin,6879,7,12,9,15,52,55,-3,45
Queen's Park,6879,8,11,7,18,40,71,-31,40
East Fife,6879,9,9,9,18,46,55,-9,36
Stenhousem'r,6879,10,7,8,21,51,81,-30,29
Livingston,6880,1,22,3,11,83,52,31,69
Airdrieon,6880,2,19,4,13,68,57,11,61
Brechin,6880,3,17,5,14,50,51,-1,56
Alloa,6880,4,15,8,13,74,64,10,53
Albion,6880,5,13,8,15,53,54,-1,47
Peterhead,6880,6,13,8,15,58,64,-6,47
Queen's Park,6880,7,12,11,13,45,52,-7,47
East Fife,6880,8,12,9,15,52,55,-3,45
Stranraer,6880,9,13,4,19,57,73,-16,43
Stenhousem'r,6880,10,9,10,17,54,72,-18,37
Airdrieon,6881,1,20,7,9,68,54,14,67
Alloa,6881,2,18,9,9,66,40,26,63
Livingston,6881,3,17,9,10,83,50,33,60
Peterhead,6881,4,14,11,11,54,48,6,53
Brechin,6881,5,16,4,16,52,49,3,52
Albion,6881,6,14,9,13,47,47,0,51
Queen's Park,6881,7,12,10,14,38,54,-16,46
Stranraer,6881,8,13,6,17,45,53,-8,45
East Fife,6881,9,11,10,15,52,55,-3,43
Stenhousem'r,6881,10,3,9,24,45,100,-55,18
Brechin,6882,1,18,7,11,50,43,7,61
Livingston,6882,2,18,5,13,67,54,13,59
Alloa,6882,3,16,9,11,72,44,28,57
Peterhead,6882,4,15,12,9,53,43,10,57
Albion,6882,5,16,6,14,57,55,2,54
East Fife,6882,6,14,7,15,50,39,11,49
Airdrieon,6882,7,13,9,14,51,52,-1,48
Queen's Park,6882,8,12,9,15,30,48,-18,45
Stenhousem'r,6882,9,9,9,18,42,74,-32,36
Stranraer,6882,10,10,5,21,47,67,-20,35
Alloa,6883,1,20,6,10,66,43,23,66
Brechin,6883,2,19,3,14,55,47,8,60
Livingston,6883,3,18,4,14,73,59,14,58
Albion,6883,4,16,10,10,62,55,7,58
Airdrieon,6883,5,17,7,12,56,53,3,58
East Fife,6883,6,14,6,16,53,52,1,48
Peterhead,6883,7,13,8,15,47,48,-1,47
Queen's Park,6883,8,11,6,19,43,56,-13,39
Stranraer,6883,9,10,7,19,52,72,-20,37
Stenhousem'r,6883,10,9,9,18,52,74,-22,36
Alloa,6884,1,19,9,8,71,45,26,66
Airdrieon,6884,2,18,7,11,70,56,14,61
Livingston,6884,3,18,6,12,74,54,20,60
Albion,6884,4,15,8,13,51,49,2,53
Brechin,6884,5,16,5,15,46,45,1,53
East Fife,6884,6,15,6,15,46,42,4,51
Peterhead,6884,7,13,10,13,53,52,1,49
Stranraer,6884,8,14,3,19,55,64,-9,45
Queen's Park,6884,9,10,8,18,36,64,-28,38
Stenhousem'r,6884,10,8,6,22,45,76,-31,30
Livingston,6885,1,23,3,10,81,48,33,72
Alloa,6885,2,20,8,8,66,39,27,68
Airdrieon,6885,3,19,4,13,65,53,12,61
Albion,6885,4,14,8,14,59,57,2,50
Peterhead,6885,5,15,4,17,46,49,-3,49
Brechin,6885,6,14,4,18,48,62,-14,46
East Fife,6885,7,12,8,16,55,52,3,44
Stranraer,6885,8,12,7,17,51,63,-12,43
Queen's Park,6885,9,12,7,17,38,52,-14,43
Stenhousem'r,6885,10,10,5,21,49,83,-34,35
Livingston,6886,1,22,6,8,77,45,32,72
Airdrieon,6886,2,21,6,9,67,42,25,69
Alloa,6886,3,18,10,8,74,42,32,64
Brechin,6886,4,15,9,12,44,35,9,54
Albion,6886,5,13,9,14,53,50,3,48
Peterhead,6886,6,13,7,16,41,53,-12,46
East Fife,6886,7,11,10,15,46,50,-4,43
Queen's Park,6886,8,10,10,16,37,58,-21,40
Stranraer,6886,9,9,11,16,40,62,-22,38
Stenhousem'r,6886,10,4,10,22,37,79,-42,22
Alloa,6887,1,22,7,7,75,37,38,73
Livingston,6887,2,20,5,11,78,48,30,65
Airdrieon,6887,3,16,7,13,64,62,2,55
Albion,6887,4,15,7,14,56,58,-2,52
Brechin,6887,5,14,8,14,46,52,-6,50
East Fife,6887,6,12,9,15,56,50,6,45
Peterhead,6887,7,12,9,15,50,58,-8,45
Stenhousem'r,6887,8,11,10,15,58,70,-12,43
Queen's Park,6887,9,11,6,19,35,62,-27,39
Stranraer,6887,10,11,4,21,45,66,-21,37
Livingston,6888,1,23,5,8,78,46,32,74
Brechin,6888,2,18,6,12,59,52,7,60
Alloa,6888,3,15,14,7,64,47,17,59
Peterhead,6888,4,17,7,12,48,44,4,58
Airdrieon,6888,5,17,5,14,54,50,4,56
Albion,6888,6,13,9,14,55,60,-5,48
Queen's Park,6888,7,10,12,14,39,51,-12,42
East Fife,6888,8,10,9,17,54,48,6,39
Stranraer,6888,9,10,5,21,47,59,-12,35
Stenhousem'r,6888,10,7,8,21,49,90,-41,29
Airdrieon,6889,1,19,7,10,58,44,14,64
Livingston,6889,2,18,7,11,67,51,16,61
Alloa,6889,3,17,9,10,69,45,24,60
Brechin,6889,4,17,5,14,52,51,1,56
Albion,6889,5,17,4,15,52,52,0,55
East Fife,6889,6,14,9,13,58,44,14,51
Queen's Park,6889,7,14,4,18,41,56,-15,46
Stranraer,6889,8,13,4,19,48,62,-14,43
Peterhead,6889,9,12,5,19,52,56,-4,41
Stenhousem'r,6889,10,9,6,21,51,87,-36,33
Alloa,6890,1,18,9,9,65,44,21,63
Airdrieon,6890,2,18,5,13,64,59,5,59
Peterhead,6890,3,17,7,12,52,49,3,58
Livingston,6890,4,17,4,15,65,52,13,55
Queen's Park,6890,5,16,7,13,43,46,-3,55
Albion,6890,6,12,12,12,40,36,4,48
Brechin,6890,7,13,8,15,46,48,-2,47
Stranraer,6890,8,14,5,17,45,54,-9,47
East Fife,6890,9,10,9,17,44,47,-3,39
Stenhousem'r,6890,10,9,6,21,47,76,-29,33
Brechin,6891,1,24,3,9,68,44,24,75
Alloa,6891,2,20,7,9,73,44,29,67
Livingston,6891,3,17,7,12,69,52,17,58
Albion,6891,4,17,4,15,60,54,6,55
Peterhead,6891,5,14,10,12,58,56,2,52
Airdrieon,6891,6,15,4,17,57,64,-7,49
Stranraer,6891,7,13,8,15,57,55,2,47
East Fife,6891,8,12,8,16,45,52,-7,44
Queen's Park,6891,9,10,8,18,35,57,-22,38
Stenhousem'r,6891,10,5,7,24,44,88,-44,22
Livingston,6892,1,20,5,11,72,49,23,65
Brechin,6892,2,19,4,13,57,44,13,61
Airdrieon,6892,3,17,6,13,63,63,0,57
Alloa,6892,4,17,5,14,74,54,20,56
Albion,6892,5,14,11,11,55,50,5,53
Peterhead,6892,6,14,9,13,56,48,8,51
East Fife,6892,7,13,10,13,48,51,-3,49
Stranraer,6892,8,13,9,14,57,58,-1,48
Queen's Park,6892,9,9,8,19,34,61,-27,35
Stenhousem'r,6892,10,5,11,20,49,87,-38,26
Alloa,6893,1,22,7,7,72,38,34,73
Airdrieon,6893,2,19,6,11,72,53,19,63
Brechin,6893,3,19,6,11,57,50,7,63
Queen's Park,6893,4,18,6,12,50,44,6,60
Livingston,6893,5,15,8,13,66,58,8,53
Peterhead,6893,6,12,7,17,36,52,-16,43
Stranraer,6893,7,12,6,18,49,66,-17,42
Albion,6893,8,11,8,17,45,51,-6,41
East Fife,6893,9,10,8,18,52,56,-4,38
Stenhousem'r,6893,10,8,6,22,48,79,-31,30
Livingston,6894,1,19,8,9,81,51,30,65
Brechin,6894,2,17,7,12,58,52,6,58
Alloa,6894,3,16,9,11,66,51,15,57
Airdrieon,6894,4,17,6,13,63,57,6,57
Stranraer,6894,5,16,7,13,64,59,5,55
Peterhead,6894,6,16,7,13,47,48,-1,55
East Fife,6894,7,11,11,14,55,56,-1,44
Queen's Park,6894,8,11,10,15,39,50,-11,43
Albion,6894,9,10,12,14,48,50,-2,42
Stenhousem'r,6894,10,6,5,25,45,92,-47,23
Livingston,6895,1,24,2,10,86,44,42,74
Alloa,6895,2,20,7,9,73,43,30,67
Albion,6895,3,17,6,13,62,56,6,57
Brechin,6895,4,16,7,13,58,58,0,55
Airdrieon,6895,5,15,8,13,54,52,2,53
Queen's Park,6895,6,13,8,15,40,43,-3,47
Stranraer,6895,7,14,4,18,53,64,-11,46
Peterhead,6895,8,13,6,17,41,57,-16,45
East Fife,6895,9,10,7,19,44,50,-6,37
Stenhousem'r,6895,10,7,7,22,43,87,-44,28
Livingston,6896,1,22,4,10,78,39,39,70
Alloa,6896,2,20,5,11,71,51,20,65
Albion,6896,3,15,7,14,53,47,6,52
Airdrieon,6896,4,13,11,12,53,50,3,50
Peterhead,6896,5,13,10,13,51,59,-8,49
Queen's Park,6896,6,12,12,12,49,52,-3,48
Brechin,6896,7,12,9,15,48,59,-11,45
East Fife,6896,8,10,12,14,48,50,-2,42
Stranraer,6896,9,11,5,20,44,61,-17,38
Stenhousem'r,6896,10,8,13,15,50,77,-27,37
Alloa,6897,1,20,10,6,74,45,29,70
Airdrieon,6897,2,20,7,9,63,43,20,67
Livingston,6897,3,17,5,14,65,53,12,56
Peterhead,6897,4,15,7,14,58,55,3,52
Queen's Park,6897,5,13,11,12,38,38,0,50
Brechin,6897,6,15,5,16,57,59,-2,50
East Fife,6897,7,12,9,15,51,56,-5,45
Stranraer,6897,8,13,5,18,52,61,-9,44
Albion,6897,9,12,7,17,47,58,-11,43
Stenhousem'r,6897,10,6,8,22,49,86,-37,26
Alloa,6898,1,20,7,9,75,47,28,67
East Fife,6898,2,19,6,11,56,42,14,63
Airdrieon,6898,3,19,6,11,60,55,5,63
Livingston,6898,4,19,4,13,83,60,23,61
Brechin,6898,5,15,5,16,53,52,1,50
Queen's Park,6898,6,15,4,17,42,51,-9,49
Peterhead,6898,7,13,8,15,53,54,-1,47
Albion,6898,8,14,5,17,51,57,-6,47
Stranraer,6898,9,11,4,21,47,63,-16,37
Stenhousem'r,6898,10,7,7,22,45,84,-39,28
Livingston,6899,1,24,3,9,67,36,31,75
Airdrieon,6899,2,18,5,13,56,56,0,59
Brechin,6899,3,17,7,12,54,45,9,58
Alloa,6899,4,16,8,12,68,51,17,56
Peterhead,6899,5,15,7,14,62,56,6,52
Queen's Park,6899,6,15,5,16,36,47,-11,50
Albion,6899,7,13,10,13,52,52,0,49
Stenhousem'r,6899,8,12,5,19,50,77,-27,41
Stranraer,6899,9,11,3,22,43,60,-17,36
East Fife,6899,10,8,9,19,49,57,-8,33
Alloa,6900,1,20,7,9,68,37,31,67
Livingston,6900,2,18,8,10,69,47,22,62
Airdrieon,6900,3,15,8,13,50,53,-3,53
Stranraer,6900,4,15,6,15,60,61,-1,51
Peterhead,6900,5,14,9,13,42,49,-7,51
Albion,6900,6,14,7,15,57,56,1,49
Queen's Park,6900,7,14,5,17,35,51,-16,47
Brechin,6900,8,14,4,18,51,55,-4,46
East Fife,6900,9,12,9,15,56,48,8,45
Stenhousem'r,6900,10,7,11,18,46,77,-31,32
Alloa,6901,1,24,4,8,76,40,36,76
Airdrieon,6901,2,18,9,9,60,51,9,63
Brechin,6901,3,18,4,14,51,46,5,58
Livingston,6901,4,18,3,15,69,52,17,57
East Fife,6901,5,15,11,10,57,42,15,56
Peterhead,6901,6,13,7,16,45,48,-3,46
Queen's Park,6901,7,13,3,20,43,50,-7,42
Stranraer,6901,8,12,4,20,40,66,-26,40
Albion,6901,9,11,5,20,48,66,-18,38
Stenhousem'r,6901,10,9,8,19,45,73,-28,35
Livingston,6902,1,23,2,11,78,42,36,71
Airdrieon,6902,2,20,4,12,57,51,6,64
Alloa,6902,3,18,7,11,62,43,19,61
Brechin,6902,4,15,9,12,45,43,2,54
Albion,6902,5,14,5,17,52,54,-2,47
Queen's Park,6902,6,13,7,16,34,44,-10,46
Stenhousem'r,6902,7,12,8,16,49,65,-16,44
East Fife,6902,8,10,11,15,42,46,-4,41
Peterhead,6902,9,11,8,17,41,53,-12,41
Stranraer,6902,10,10,7,19,44,63,-19,37
Alloa,6903,1,19,9,8,65,44,21,66
Livingston,6903,2,19,7,10,73,53,20,64
Airdrieon,6903,3,17,4,15,61,56,5,55
Albion,6903,4,16,6,14,55,47,8,54
Stranraer,6903,5,16,6,14,62,55,7,54
Brechin,6903,6,15,8,13,45,44,1,53
Peterhead,6903,7,13,7,16,40,56,-16,46
East Fife,6903,8,13,6,17,52,54,-2,45
Queen's Park,6903,9,11,6,19,33,53,-20,39
Stenhousem'r,6903,10,7,9,20,54,78,-24,30
Livingston,6904,1,20,6,10,83,43,40,66
Airdrieon,6904,2,19,8,9,59,45,14,65
Alloa,6904,3,18,6,12,59,52,7,60
Stranraer,6904,4,15,8,13,60,57,3,53
East Fife,6904,5,14,7,15,48,44,4,49
Brechin,6904,6,14,5,17,44,46,-2,47
Peterhead,6904,7,13,8,15,40,43,-3,47
Queen's Park,6904,8,13,7,16,38,54,-16,46
Albion,6904,9,11,9,16,42,54,-12,42
Stenhousem'r,6904,10,5,12,19,47,82,-35,27
Livingston,6905,1,23,4,9,80,51,29,73
Alloa,6905,2,19,10,7,66,39,27,67
Brechin,6905,3,16,10,10,45,41,4,58
Airdrieon,6905,4,16,7,13,59,55,4,55
Albion,6905,5,13,10,13,55,52,3,49
Peterhead,6905,5,14,7,15,55,52,3,49
Queen's Park,6905,7,11,9,16,34,44,-10,42
East Fife,6905,8,11,8,17,46,52,-6,41
Stranraer,6905,9,9,10,17,44,60,-16,37
Stenhousem'r,6905,10,8,5,23,48,86,-38,29
Alloa,6906,1,20,7,9,69,38,31,67
Livingston,6906,2,20,6,10,78,48,30,66
Brechin,6906,3,18,5,13,59,50,9,59
Peterhead,6906,4,15,10,11,59,53,6,55
Airdrieon,6906,5,16,6,14,60,61,-1,54
Albion,6906,6,12,12,12,50,54,-4,48
Queen's Park,6906,7,13,8,15,38,47,-9,47
East Fife,6906,8,11,9,16,58,61,-3,42
Stranraer,6906,9,11,5,20,45,63,-18,38
Stenhousem'r,6906,10,7,6,23,46,87,-41,27
Livingston,6907,1,23,4,9,76,42,34,73
Alloa,6907,2,22,6,8,74,45,29,72
Brechin,6907,3,16,7,13,56,50,6,55
Albion,6907,4,15,9,12,55,50,5,54
Peterhead,6907,5,14,8,14,48,51,-3,50
Airdrieon,6907,6,13,6,17,48,57,-9,45
Queen's Park,6907,7,13,6,17,38,52,-14,45
East Fife,6907,8,10,12,14,44,47,-3,42
Stranraer,6907,9,10,10,16,45,56,-11,40
Stenhousem'r,6907,10,5,10,21,40,74,-34,25
Alloa,6908,1,19,8,9,65,47,18,65
Brechin,6908,2,19,6,11,53,48,5,63
Airdrieon,6908,3,17,9,10,63,54,9,60
Livingston,6908,4,17,6,13,77,57,20,57
Albion,6908,5,17,6,13,58,44,14,57
Stranraer,6908,6,16,4,16,60,57,3,52
East Fife,6908,7,13,7,16,49,49,0,46
Peterhead,6908,8,12,7,17,42,58,-16,43
Queen's Park,6908,9,9,5,22,29,52,-23,32
Stenhousem'r,6908,10,8,8,20,41,71,-30,32
Livingston,6909,1,22,6,8,80,45,35,72
Alloa,6909,2,19,11,6,68,38,30,68
Airdrieon,6909,3,18,6,12,62,50,12,60
Brechin,6909,4,16,7,13,42,49,-7,55
Queen's Park,6909,5,14,10,12,41,41,0,52
Albion,6909,6,12,12,12,45,43,2,48
Peterhead,6909,7,12,9,15,37,46,-9,45
East Fife,6909,8,10,9,17,40,45,-5,39
Stranraer,6909,9,10,9,17,45,56,-11,39
Stenhousem'r,6909,10,5,5,26,39,86,-47,20
Livingston,6910,1,21,6,9,77,49,28,69
Alloa,6910,2,19,8,9,68,40,28,65
Airdrieon,6910,3,16,10,10,59,48,11,58
Albion,6910,4,15,9,12,46,48,-2,54
Brechin,6910,5,14,9,13,51,47,4,51
East Fife,6910,6,12,10,14,54,51,3,46
Peterhead,6910,7,12,10,14,41,52,-11,46
Queen's Park,6910,8,12,9,15,41,54,-13,45
Stranraer,6910,9,10,7,19,45,63,-18,37
Stenhousem'r,6910,10,6,8,22,52,82,-30,26
Livingston,6911,1,20,5,11,72,48,24,65
Brechin,6911,2,18,10,8,60,43,17,64
Airdrieon,6911,3,17,5,14,61,58,3,56
Alloa,6911,4,14,10,12,63,50,13,52
Peterhead,6911,5,14,8,14,49,55,-6,50
Albion,6911,6,14,7,15,56,57,-1,49
Stranraer,6911,7,15,4,17,56,58,-2,49
East Fife,6911,8,11,10,15,49,49,0,43
Stenhousem'r,6911,9,11,8,17,55,78,-23,41
Queen's Park,6911,10,9,7,20,30,55,-25,34
Livingston,6912,1,22,5,9,80,47,33,71
Alloa,6912,2,20,5,11,64,39,25,65
Brechin,6912,3,17,7,12,59,51,8,58
Airdrieon,6912,4,17,5,14,59,57,2,56
Albion,6912,5,14,6,16,52,48,4,48
Queen's Park,6912,6,14,6,16,42,54,-12,48
East Fife,6912,7,12,9,15,47,52,-5,45
Peterhead,6912,8,11,8,17,43,61,-18,41
Stenhousem'r,6912,9,11,7,18,46,70,-24,40
Stranraer,6912,10,10,6,20,55,68,-13,36
Alloa,6913,1,21,8,7,85,43,42,71
Livingston,6913,2,20,9,7,77,49,28,69
Airdrieon,6913,3,18,9,9,65,52,13,63
Brechin,6913,4,16,9,11,51,52,-1,57
Albion,6913,5,13,11,12,65,59,6,50
Queen's Park,6913,6,11,12,13,43,51,-8,45
Peterhead,6913,7,12,7,17,45,55,-10,43
East Fife,6913,8,8,14,14,48,56,-8,38
Stenhousem'r,6913,9,6,11,19,41,76,-35,29
Stranraer,6913,10,7,6,23,45,72,-27,27
Alloa,6914,1,19,12,5,72,38,34,69
Livingston,6914,2,20,3,13,70,49,21,63
Brechin,6914,3,19,4,13,49,53,-4,61
Albion,6914,4,17,8,11,59,46,13,59
Airdrieon,6914,5,16,10,10,49,49,0,58
Peterhead,6914,6,14,8,14,51,48,3,50
Stranraer,6914,7,11,7,18,49,55,-6,40
East Fife,6914,8,8,12,16,44,52,-8,36
Queen's Park,6914,9,7,10,19,26,48,-22,31
Stenhousem'r,6914,10,7,10,19,51,82,-31,31
Livingston,6915,1,24,3,9,77,43,34,75
Brechin,6915,2,19,6,11,58,50,8,63
Airdrieon,6915,3,20,3,13,64,62,2,63
Alloa,6915,4,17,8,11,71,48,23,59
East Fife,6915,5,12,11,13,49,48,1,47
Stranraer,6915,6,14,4,18,53,60,-7,46
Queen's Park,6915,7,13,6,17,37,55,-18,45
Albion,6915,8,11,10,15,55,58,-3,43
Peterhead,6915,9,10,7,19,43,55,-12,37
Stenhousem'r,6915,10,8,6,22,56,84,-28,30
Alloa,6916,1,21,7,8,73,41,32,70
Livingston,6916,2,21,5,10,79,46,33,68
Peterhead,6916,3,17,6,13,55,57,-2,57
Albion,6916,4,14,10,12,58,52,6,52
East Fife,6916,5,14,7,15,54,50,4,49
Brechin,6916,6,13,9,14,52,60,-8,48
Stranraer,6916,7,14,4,18,47,53,-6,46
Airdrieon,6916,8,13,6,17,53,64,-11,45
Queen's Park,6916,9,10,8,18,50,65,-15,38
Stenhousem'r,6916,10,9,6,21,49,82,-33,33
Livingston,6917,1,25,2,9,90,45,45,77
Alloa,6917,2,22,5,9,66,43,23,71
Airdrieon,6917,3,16,8,12,60,58,2,56
Brechin,6917,4,18,2,16,44,48,-4,56
Albion,6917,5,14,8,14,56,57,-1,50
East Fife,6917,6,12,8,16,60,56,4,44
Queen's Park,6917,7,11,9,16,37,51,-14,42
Peterhead,6917,8,10,11,15,46,53,-7,41
Stranraer,6917,9,10,8,18,48,64,-16,38
Stenhousem'r,6917,10,7,9,20,46,78,-32,30
Alloa,6918,1,17,12,7,65,42,23,63
Livingston,6918,2,18,5,13,72,52,20,59
Airdrieon,6918,3,17,7,12,59,55,4,58
Albion,6918,4,16,8,12,70,55,15,56
Queen's Park,6918,5,15,6,15,43,50,-7,51
Brechin,6918,6,14,7,15,50,50,0,49
Stranraer,6918,7,14,7,15,49,52,-3,49
East Fife,6918,8,9,11,16,53,62,-9,38
Stenhousem'r,6918,9,10,8,18,47,76,-29,38
Peterhead,6918,10,8,13,15,40,54,-14,37
Alloa,6919,1,19,7,10,71,46,25,64
Brechin,6919,2,16,8,12,53,47,6,56
Airdrieon,6919,3,16,8,12,53,52,1,56
Livingston,6919,4,14,11,11,69,57,12,53
Stranraer,6919,5,16,4,16,53,50,3,52
Queen's Park,6919,6,13,11,12,36,46,-10,50
Albion,6919,7,13,10,13,51,46,5,49
East Fife,6919,8,13,6,17,50,52,-2,45
Peterhead,6919,9,12,8,16,47,54,-7,44
Stenhousem'r,6919,10,6,11,19,49,82,-33,29
Livingston,6920,1,21,4,11,74,50,24,67
Alloa,6920,2,18,9,9,73,45,28,63
Queen's Park,6920,3,15,8,13,46,46,0,53
Brechin,6920,4,15,8,13,50,51,-1,53
Stranraer,6920,5,14,7,15,47,51,-4,49
East Fife,6920,6,13,9,14,56,53,3,48
Airdrieon,6920,7,12,11,13,55,58,-3,47
Albion,6920,8,11,10,15,53,58,-5,43
Peterhead,6920,9,11,10,15,51,59,-8,43
Stenhousem'r,6920,10,7,10,19,46,80,-34,31
Livingston,6921,1,24,4,8,80,46,34,76
Alloa,6921,2,19,7,10,87,50,37,64
Brechin,6921,3,18,5,13,54,52,2,59
Peterhead,6921,4,17,5,14,56,53,3,56
Airdrieon,6921,5,14,9,13,51,60,-9,51
Albion,6921,6,14,6,16,62,53,9,48
Queen's Park,6921,7,12,9,15,40,58,-18,45
East Fife,6921,8,12,7,17,53,56,-3,43
Stranraer,6921,9,10,8,18,48,67,-19,38
Stenhousem'r,6921,10,7,6,23,51,87,-36,27
Livingston,6922,1,22,3,11,74,46,28,69
Alloa,6922,2,19,6,11,71,44,27,63
Peterhead,6922,3,17,6,13,49,54,-5,57
East Fife,6922,4,14,9,13,55,47,8,51
Albion,6922,5,15,6,15,60,53,7,51
Airdrieon,6922,6,14,9,13,53,60,-7,51
Brechin,6922,7,14,8,14,45,48,-3,50
Queen's Park,6922,8,12,9,15,38,51,-13,45
Stranraer,6922,9,12,4,20,51,65,-14,40
Stenhousem'r,6922,10,8,6,22,51,79,-28,30
Alloa,6923,1,19,7,10,76,46,30,64
Livingston,6923,2,18,4,14,74,57,17,58
Airdrieon,6923,3,17,7,12,70,59,11,58
Brechin,6923,4,18,4,14,55,52,3,58
Peterhead,6923,5,14,8,14,53,54,-1,50
Albion,6923,6,14,6,16,55,57,-2,48
Queen's Park,6923,7,13,7,16,41,63,-22,46
Stenhousem'r,6923,8,12,7,17,55,79,-24,43
Stranraer,6923,9,12,6,18,56,66,-10,42
East Fife,6923,10,11,8,17,52,54,-2,41
Livingston,6924,1,21,3,12,77,49,28,66
Alloa,6924,2,20,6,10,84,58,26,66
Airdrieon,6924,3,17,8,11,58,54,4,59
Brechin,6924,4,16,7,13,53,50,3,55
Albion,6924,5,14,12,10,53,44,9,54
East Fife,6924,6,13,8,15,51,48,3,47
Stranraer,6924,7,13,8,15,62,63,-1,47
Peterhead,6924,8,13,8,15,47,57,-10,47
Queen's Park,6924,9,10,7,19,33,58,-25,37
Stenhousem'r,6924,10,5,9,22,46,83,-37,24
Alloa,6925,1,22,6,8,81,42,39,72
Livingston,6925,2,20,3,13,76,52,24,63
Airdrieon,6925,3,19,6,11,61,48,13,63
Brechin,6925,4,19,6,11,54,50,4,63
East Fife,6925,5,14,7,15,47,45,2,49
Peterhead,6925,6,12,7,17,49,53,-4,43
Albion,6925,7,13,4,19,52,60,-8,43
Stranraer,6925,8,11,10,15,48,58,-10,43
Queen's Park,6925,9,10,7,19,29,54,-25,37
Stenhousem'r,6925,10,9,6,21,52,87,-35,33
Alloa,6926,1,20,7,9,76,45,31,67
Airdrieon,6926,2,20,7,9,67,54,13,67
Livingston,6926,3,19,4,13,69,49,20,61
Brechin,6926,4,15,7,14,48,46,2,52
Peterhead,6926,5,14,7,15,49,50,-1,49
Albion,6926,6,13,9,14,48,48,0,48
Stranraer,6926,7,14,5,17,47,60,-13,47
Queen's Park,6926,8,13,5,18,37,52,-15,44
East Fife,6926,9,9,12,15,46,54,-8,39
Stenhousem'r,6926,10,7,9,20,49,78,-29,30
Livingston,6927,1,21,6,9,71,45,26,69
Alloa,6927,2,17,8,11,73,49,24,59
Peterhead,6927,3,17,8,11,49,41,8,59
Airdrieon,6927,4,15,8,13,52,54,-2,53
Albion,6927,5,14,6,16,57,58,-1,48
East Fife,6927,6,12,10,14,46,45,1,46
Stranraer,6927,7,13,5,18,45,53,-8,44
Brechin,6927,8,12,8,16,48,61,-13,44
Queen's Park,6927,9,11,9,16,41,53,-12,42
Stenhousem'r,6927,10,11,6,19,44,67,-23,39
Livingston,6928,1,25,4,7,88,45,43,79
Alloa,6928,2,17,11,8,71,40,31,62
Peterhead,6928,3,14,12,10,53,48,5,54
Brechin,6928,4,16,5,15,54,53,1,53
Albion,6928,5,15,8,13,55,61,-6,53
Airdrieon,6928,6,13,8,15,58,64,-6,47
Queen's Park,6928,7,10,14,12,45,53,-8,44
Stranraer,6928,8,11,8,17,54,67,-13,41
East Fife,6928,9,7,11,18,44,54,-10,32
Stenhousem'r,6928,10,7,9,20,50,87,-37,30
Livingston,6929,1,22,3,11,76,49,27,69
Brechin,6929,2,19,4,13,56,50,6,61
Alloa,6929,3,17,8,11,66,45,21,59
Airdrieon,6929,4,17,7,12,66,62,4,58
Albion,6929,5,15,8,13,48,47,1,53
Queen's Park,6929,6,14,5,17,43,50,-7,47
East Fife,6929,7,12,9,15,52,48,4,45
Peterhead,6929,8,11,10,15,50,53,-3,43
Stranraer,6929,9,11,9,16,46,55,-9,42
Stenhousem'r,6929,10,8,5,23,48,92,-44,29
Alloa,6930,1,20,6,10,70,41,29,66
Livingston,6930,2,17,7,12,59,45,14,58
Brechin,6930,3,17,7,12,53,48,5,58
Airdrieon,6930,4,16,8,12,59,56,3,56
Peterhead,6930,5,14,9,13,46,56,-10,51
East Fife,6930,6,13,9,14,47,37,10,48
Stranraer,6930,7,12,8,16,47,53,-6,44
Queen's Park,6930,8,13,5,18,38,47,-9,44
Albion,6930,9,11,7,18,42,52,-10,40
Stenhousem'r,6930,10,8,12,16,47,73,-26,36
Airdrieon,6931,1,22,6,8,68,47,21,72
Alloa,6931,2,21,8,7,81,48,33,71
Livingston,6931,3,21,3,12,74,54,20,66
Brechin,6931,4,16,4,16,54,48,6,52
East Fife,6931,5,14,7,15,49,48,1,49
Albion,6931,6,14,5,17,62,57,5,47
Queen's Park,6931,7,13,8,15,37,54,-17,47
Peterhead,6931,8,12,10,14,43,50,-7,46
Stranraer,6931,9,10,7,19,48,67,-19,37
Stenhousem'r,6931,10,5,6,25,36,79,-43,21
Alloa,6932,1,19,7,10,72,43,29,64
Airdrieon,6932,2,19,7,10,69,52,17,64
Brechin,6932,3,19,6,11,57,50,7,63
Livingston,6932,4,18,5,13,78,57,21,59
East Fife,6932,5,13,9,14,54,53,1,48
Peterhead,6932,6,13,9,14,45,52,-7,48
Stranraer,6932,7,14,3,19,46,60,-14,45
Queen's Park,6932,8,11,9,16,36,50,-14,42
Albion,6932,9,10,10,16,43,55,-12,40
Stenhousem'r,6932,10,7,9,20,44,72,-28,30
Livingston,6933,1,17,8,11,71,54,17,59
Brechin,6933,2,17,8,11,58,45,13,59
Alloa,6933,3,16,10,10,61,45,16,58
Airdrieon,6933,4,15,10,11,64,50,14,55
Peterhead,6933,5,13,10,13,48,49,-1,49
Stranraer,6933,6,15,4,17,47,57,-10,49
Albion,6933,7,11,11,14,56,58,-2,44
Queen's Park,6933,8,11,10,15,44,56,-12,43
East Fife,6933,9,11,9,16,45,51,-6,42
Stenhousem'r,6933,10,10,8,18,51,80,-29,38
Alloa,6934,1,18,10,8,67,43,24,64
Livingston,6934,2,16,10,10,63,47,16,58
Peterhead,6934,3,17,6,13,54,49,5,57
Brechin,6934,4,16,8,12,52,50,2,56
Airdrieon,6934,5,16,6,14,60,56,4,54
Albion,6934,6,14,8,14,56,56,0,50
East Fife,6934,7,12,11,13,56,48,8,47
Stranraer,6934,8,10,9,17,41,56,-15,39
Queen's Park,6934,9,9,12,15,28,47,-19,39
Stenhousem'r,6934,10,7,10,19,45,70,-25,31
Albion,6935,1,19,7,10,61,43,18,64
Livingston,6935,2,19,5,12,75,48,27,62
Airdrieon,6935,3,17,7,12,59,59,0,58
Peterhead,6935,4,16,6,14,49,51,-2,54
Brechin,6935,5,16,4,16,48,51,-3,52
Queen's Park,6935,6,14,7,15,46,52,-6,49
Alloa,6935,7,13,9,14,59,47,12,48
Stranraer,6935,8,14,6,16,49,55,-6,48
East Fife,6935,9,9,10,17,54,53,1,37
Stenhousem'r,6935,10,9,7,20,46,87,-41,34
Alloa,6936,1,18,11,7,73,46,27,65
Livingston,6936,2,18,2,16,67,52,15,56
Airdrieon,6936,3,16,8,12,62,58,4,56
Brechin,6936,4,15,10,11,49,41,8,55
Stranraer,6936,5,15,8,13,49,49,0,53
Albion,6936,6,13,9,14,52,51,1,48
Peterhead,6936,7,13,8,15,44,51,-7,47
Queen's Park,6936,8,12,7,17,31,48,-17,43
East Fife,6936,9,8,14,14,40,44,-4,38
Stenhousem'r,6936,10,8,11,17,43,70,-27,35
Alloa,6937,1,20,8,8,71,44,27,68
Livingston,6937,2,18,3,15,66,52,14,57
Queen's Park,6937,3,16,9,11,45,41,4,57
Peterhead,6937,4,16,7,13,53,51,2,55
Albion,6937,5,16,5,15,56,50,6,53
Airdrieon,6937,6,15,7,14,64,64,0,52
Brechin,6937,7,15,5,16,52,56,-4,50
Stranraer,6937,8,12,8,16,49,64,-15,44
East Fife,6937,9,11,9,16,53,55,-2,42
Stenhousem'r,6937,10,6,9,21,40,72,-32,27
Livingston,6938,1,23,3,10,80,47,33,72
Alloa,6938,2,20,7,9,76,48,28,67
Brechin,6938,3,21,4,11,67,53,14,67
Airdrieon,6938,4,17,8,11,61,51,10,59
Albion,6938,5,15,8,13,65,54,11,53
Stranraer,6938,6,14,6,16,50,54,-4,48
Peterhead,6938,7,13,4,19,46,61,-15,43
East Fife,6938,8,8,10,18,48,55,-7,34
Queen's Park,6938,9,8,9,19,30,59,-29,33
Stenhousem'r,6938,10,9,5,22,43,84,-41,32
Livingston,6939,1,22,4,10,82,50,32,70
Alloa,6939,2,17,9,10,71,44,27,60
Albion,6939,3,16,9,11,61,44,17,57
Airdrieon,6939,4,16,8,12,58,51,7,56
Stranraer,6939,5,16,5,15,60,54,6,53
East Fife,6939,6,14,8,14,48,49,-1,50
Brechin,6939,7,15,4,17,47,59,-12,49
Peterhead,6939,8,14,6,16,45,55,-10,48
Queen's Park,6939,9,9,8,19,34,62,-28,35
Stenhousem'r,6939,10,5,11,20,49,87,-38,26
Livingston,6940,1,23,2,11,79,47,32,71
Airdrieon,6940,2,22,5,9,67,47,20,71
Alloa,6940,3,18,9,9,77,41,36,63
Brechin,6940,4,16,8,12,44,45,-1,56
Albion,6940,5,13,10,13,55,50,5,49
East Fife,6940,6,12,11,13,49,44,5,47
Peterhead,6940,7,11,8,17,39,50,-11,41
Queen's Park,6940,8,11,7,18,29,53,-24,40
Stranraer,6940,9,10,6,20,42,64,-22,36
Stenhousem'r,6940,10,7,8,21,41,81,-40,29
Albion,6941,1,17,9,10,54,43,11,60
Livingston,6941,2,18,5,13,75,57,18,59
Brechin,6941,3,18,3,15,53,50,3,57
Alloa,6941,4,16,7,13,63,51,12,55
Queen's Park,6941,5,15,7,14,38,39,-1,52
Airdrieon,6941,6,15,5,16,53,55,-2,50
Peterhead,6941,7,14,8,14,51,56,-5,50
Stranraer,6941,8,15,5,16,52,58,-6,50
East Fife,6941,9,11,10,15,50,49,1,43
Stenhousem'r,6941,10,8,7,21,52,83,-31,31
Alloa,6942,1,22,5,9,74,38,36,71
Livingston,6942,2,21,5,10,72,46,26,68
Brechin,6942,3,18,6,12,51,40,11,60
Airdrieon,6942,4,16,4,16,57,59,-2,52
Peterhead,6942,5,14,9,13,45,48,-3,51
East Fife,6942,6,11,11,14,45,45,0,44
Albion,6942,7,11,9,16,36,46,-10,42
Queen's Park,6942,8,12,6,18,38,51,-13,42
Stranraer,6942,9,11,7,18,43,56,-13,40
Stenhousem'r,6942,10,9,8,19,46,78,-32,35
Livingston,6943,1,22,6,8,82,47,35,72
Alloa,6943,2,18,6,12,63,51,12,60
Brechin,6943,3,17,9,10,56,45,11,60
Albion,6943,4,16,10,10,59,48,11,58
Airdrieon,6943,5,16,7,13,61,62,-1,55
East Fife,6943,6,14,7,15,52,51,1,49
Peterhead,6943,7,13,8,15,50,52,-2,47
Queen's Park,6943,8,12,4,20,35,55,-20,40
Stranraer,6943,9,11,6,19,54,66,-12,39
Stenhousem'r,6943,10,7,5,24,52,87,-35,26
Livingston,6944,1,23,4,9,74,43,31,73
Brechin,6944,2,20,4,12,57,42,15,64
Alloa,6944,3,16,12,8,73,46,27,60
Airdrieon,6944,4,16,7,13,54,48,6,55
Albion,6944,5,14,11,11,58,49,9,53
Peterhead,6944,6,12,10,14,50,52,-2,46
East Fife,6944,7,10,12,14,46,49,-3,42
Stranraer,6944,8,11,6,19,36,60,-24,39
Queen's Park,6944,9,9,10,17,31,53,-22,37
Stenhousem'r,6944,10,5,12,19,40,77,-37,27
Livingston,6945,1,24,2,10,72,43,29,74
Airdrieon,6945,2,18,6,12,62,53,9,60
Alloa,6945,3,16,10,10,72,47,25,58
Albion,6945,4,18,4,14,57,54,3,58
Brechin,6945,5,15,6,15,43,44,-1,51
Stranraer,6945,6,14,8,14,60,63,-3,50
East Fife,6945,7,12,9,15,54,52,2,45
Peterhead,6945,8,13,5,18,49,61,-12,44
Queen's Park,6945,9,11,8,17,35,51,-16,41
Stenhousem'r,6945,10,7,6,23,51,87,-36,27
Brechin,6946,1,22,4,10,58,36,22,70
Alloa,6946,2,19,8,9,70,40,30,65
Livingston,6946,3,19,5,12,69,45,24,62
Airdrieon,6946,4,15,6,15,58,63,-5,51
Stranraer,6946,5,15,6,15,50,56,-6,51
Albion,6946,6,12,11,13,53,52,1,47
Queen's Park,6946,7,13,8,15,38,46,-8,47
East Fife,6946,8,12,9,15,54,52,2,45
Peterhead,6946,9,9,8,19,48,61,-13,35
Stenhousem'r,6946,10,7,9,20,45,92,-47,30
Livingston,6947,1,21,6,9,70,43,27,69
Alloa,6947,2,19,5,12,75,50,25,62
Peterhead,6947,3,17,8,11,60,56,4,59
Airdrieon,6947,4,17,7,12,63,51,12,58
Albion,6947,5,16,7,13,53,46,7,55
Brechin,6947,6,16,6,14,46,49,-3,54
East Fife,6947,7,13,11,12,55,44,11,50
Queen's Park,6947,8,10,8,18,35,61,-26,38
Stranraer,6947,9,8,9,19,46,70,-24,33
Stenhousem'r,6947,10,5,9,22,43,76,-33,24
Livingston,6948,1,23,5,8,78,41,37,74
Alloa,6948,2,18,7,11,64,44,20,61
Peterhead,6948,3,15,9,12,56,49,7,54
Airdrieon,6948,4,15,8,13,58,58,0,53
Albion,6948,5,13,12,11,56,52,4,51
Brechin,6948,6,13,8,15,49,55,-6,47
East Fife,6948,7,12,9,15,46,49,-3,45
Stranraer,6948,8,11,12,13,42,49,-7,45
Queen's Park,6948,9,11,8,17,37,58,-21,41
Stenhousem'r,6948,10,6,8,22,47,78,-31,26
Livingston,6949,1,25,2,9,75,37,38,77
Brechin,6949,2,18,7,11,57,46,11,61
Alloa,6949,3,18,6,12,66,49,17,60
Albion,6949,4,16,8,12,52,44,8,56
Airdrieon,6949,5,14,6,16,52,54,-2,48
Stranraer,6949,6,14,5,17,43,55,-12,47
Queen's Park,6949,7,12,8,16,38,50,-12,44
East Fife,6949,8,10,10,16,50,54,-4,40
Peterhead,6949,9,11,7,18,45,62,-17,40
Stenhousem'r,6949,10,10,5,21,48,75,-27,35
Livingston,6950,1,22,5,9,75,47,28,71
Alloa,6950,2,20,9,7,70,39,31,69
Queen's Park,6950,3,15,7,14,41,44,-3,52
Airdrieon,6950,4,14,9,13,51,49,2,51
Brechin,6950,5,14,9,13,43,47,-4,51
Peterhead,6950,6,12,9,15,46,51,-5,45
Stenhousem'r,6950,7,12,8,16,51,69,-18,44
East Fife,6950,8,10,13,13,46,43,3,43
Albion,6950,9,10,9,17,44,56,-12,39
Stranraer,6950,10,10,4,22,43,65,-22,34
Livingston,6951,1,24,3,9,81,48,33,75
Alloa,6951,2,20,7,9,87,47,40,67
Brechin,6951,3,19,4,13,52,50,2,61
Queen's Park,6951,4,17,6,13,50,48,2,57
Airdrieon,6951,5,15,7,14,64,60,4,52
East Fife,6951,6,13,8,15,52,46,6,47
Peterhead,6951,7,12,8,16,51,68,-17,44
Albion,6951,8,9,11,16,41,54,-13,38
Stranraer,6951,9,11,5,20,47,63,-16,38
Stenhousem'r,6951,10,6,9,21,46,87,-41,27
Livingston,6952,1,24,4,8,84,50,34,76
Alloa,6952,2,19,10,7,73,40,33,67
Peterhead,6952,3,18,8,10,60,46,14,62
Brechin,6952,4,18,8,10,54,46,8,62
Airdrieon,6952,5,16,8,12,53,47,6,56
Queen's Park,6952,6,13,7,16,41,49,-8,46
East Fife,6952,7,11,10,15,51,54,-3,43
Albion,6952,8,9,11,16,45,59,-14,38
Stranraer,6952,9,10,3,23,43,67,-24,33
Stenhousem'r,6952,10,5,5,26,38,84,-46,20
Alloa,6953,1,24,6,6,81,38,43,78
Airdrieon,6953,2,20,7,9,64,42,22,67
Livingston,6953,3,20,4,12,67,46,21,64
Brechin,6953,4,15,8,13,46,42,4,53
Albion,6953,5,13,9,14,53,50,3,48
Peterhead,6953,6,13,9,14,45,51,-6,48
East Fife,6953,7,11,7,18,45,54,-9,40
Stranraer,6953,8,10,9,17,46,61,-15,39
Queen's Park,6953,9,12,3,21,41,62,-21,39
Stenhousem'r,6953,10,7,8,21,43,85,-42,29
Alloa,6954,1,19,8,9,71,38,33,65
Livingston,6954,2,17,8,11,84,60,24,59
Brechin,6954,3,18,5,13,46,42,4,59
Airdrieon,6954,4,17,4,15,50,59,-9,55
Peterhead,6954,5,14,8,14,44,47,-3,50
East Fife,6954,6,13,10,13,51,45,6,49
Albion,6954,7,14,7,15,49,55,-6,49
Stranraer,6954,8,14,6,16,51,50,1,48
Queen's Park,6954,9,11,9,16,37,50,-13,42
Stenhousem'r,6954,10,9,3,24,55,92,-37,30
Alloa,6955,1,19,6,11,76,52,24,63
Albion,6955,2,17,12,7,60,44,16,63
Livingston,6955,3,19,5,12,74,49,25,62
Brechin,6955,4,19,1,16,54,54,0,58
Airdrieon,6955,5,15,8,13,54,53,1,53
Queen's Park,6955,6,14,7,15,44,52,-8,49
Peterhead,6955,7,13,6,17,42,53,-11,45
Stranraer,6955,8,11,8,17,48,62,-14,41
Stenhousem'r,6955,9,10,10,16,51,70,-19,40
East Fife,6955,10,6,11,19,46,60,-14,29
Livingston,6956,1,21,5,10,76,43,33,68
Alloa,6956,2,20,6,10,66,35,31,66
Albion,6956,3,19,6,11,61,43,18,63
Airdrieon,6956,4,16,5,15,55,51,4,53
Peterhead,6956,5,14,6,16,40,50,-10,48
Brechin,6956,6,12,10,14,45,47,-2,46
East Fife,6956,7,12,10,14,40,46,-6,46
Stranraer,6956,8,10,9,17,40,57,-17,39
Stenhousem'r,6956,9,9,10,17,40,73,-33,37
Queen's Park,6956,10,8,11,17,31,49,-18,35
Alloa,6957,1,20,6,10,64,46,18,66
Airdrieon,6957,2,20,3,13,67,58,9,63
Livingston,6957,3,19,3,14,68,42,26,60
East Fife,6957,4,15,8,13,58,49,9,53
Brechin,6957,5,16,5,15,43,45,-2,53
Stranraer,6957,6,14,6,16,50,54,-4,48
Albion,6957,7,12,10,14,51,60,-9,46
Peterhead,6957,8,12,10,14,44,54,-10,46
Queen's Park,6957,9,11,4,21,36,54,-18,37
Stenhousem'r,6957,10,10,7,19,47,66,-19,37
Livingston,6958,1,23,5,8,71,33,38,74
Alloa,6958,2,17,8,11,65,52,13,59
Brechin,6958,3,16,8,12,52,45,7,56
Airdrieon,6958,4,15,9,12,51,46,5,54
East Fife,6958,5,14,8,14,50,48,2,50
Albion,6958,6,13,8,15,45,44,1,47
Stranraer,6958,7,14,4,18,52,62,-10,46
Peterhead,6958,8,12,8,16,41,53,-12,44
Stenhousem'r,6958,9,10,8,18,46,68,-22,38
Queen's Park,6958,10,10,6,20,27,49,-22,36
Livingston,6959,1,19,9,8,78,46,32,66
Alloa,6959,2,19,7,10,64,43,21,64
Brechin,6959,3,19,5,12,55,44,11,62
Queen's Park,6959,4,14,8,14,46,48,-2,50
East Fife,6959,5,11,13,12,55,53,2,46
Airdrieon,6959,6,12,8,16,51,57,-6,44
Stenhousem'r,6959,7,12,7,17,54,74,-20,43
Albion,6959,8,10,12,14,44,54,-10,42
Peterhead,6959,9,10,11,15,45,55,-10,41
Stranraer,6959,10,10,8,18,48,66,-18,38
Alloa,6960,1,21,7,8,71,39,32,70
Livingston,6960,2,19,9,8,83,49,34,66
Brechin,6960,3,17,5,14,39,46,-7,56
Airdrieon,6960,4,15,10,11,61,57,4,55
Peterhead,6960,5,13,10,13,49,52,-3,49
Albion,6960,6,14,7,15,54,59,-5,49
Queen's Park,6960,7,12,11,13,43,49,-6,47
Stenhousem'r,6960,8,11,9,16,61,78,-17,42
Stranraer,6960,9,10,4,22,48,61,-13,34
East Fife,6960,10,8,8,20,42,61,-19,32
Alloa,6961,1,23,6,7,79,43,36,75
Livingston,6961,2,19,7,10,76,48,28,64
Airdrieon,6961,3,17,7,12,61,53,8,58
Brechin,6961,4,16,6,14,60,54,6,54
Peterhead,6961,5,16,5,15,52,60,-8,53
Albion,6961,6,15,7,14,49,54,-5,52
Queen's Park,6961,7,10,11,15,35,52,-17,41
Stenhousem'r,6961,8,10,8,18,50,74,-24,38
East Fife,6961,9,8,10,18,53,58,-5,34
Stranraer,6961,10,7,11,18,45,64,-19,32
Livingston,6962,1,21,3,12,85,55,30,66
Alloa,6962,2,17,10,9,63,38,25,61
Brechin,6962,3,16,7,13,52,47,5,55
Airdrieon,6962,4,16,6,14,51,46,5,54
East Fife,6962,5,15,6,15,54,49,5,51
Albion,6962,6,13,9,14,53,59,-6,48
Stranraer,6962,7,13,6,17,49,64,-15,45
Peterhead,6962,8,12,7,17,46,53,-7,43
Stenhousem'r,6962,9,12,6,18,49,69,-20,42
Queen's Park,6962,10,11,8,17,34,56,-22,41
Livingston,6963,1,23,3,10,74,45,29,72
Airdrieon,6963,2,18,8,10,59,53,6,62
Alloa,6963,3,18,7,11,76,54,22,61
Queen's Park,6963,4,16,8,12,55,53,2,56
East Fife,6963,5,15,7,14,66,63,3,52
Brechin,6963,6,15,7,14,47,52,-5,52
Peterhead,6963,7,12,9,15,47,46,1,45
Albion,6963,8,11,8,17,47,59,-12,41
Stranraer,6963,9,10,5,21,52,66,-14,35
Stenhousem'r,6963,10,7,8,21,48,80,-32,29
Livingston,6964,1,21,5,10,83,47,36,68
Alloa,6964,2,18,8,10,74,54,20,62
Airdrieon,6964,3,18,8,10,58,44,14,62
Brechin,6964,4,16,7,13,54,47,7,55
Albion,6964,5,14,9,13,61,57,4,51
Queen's Park,6964,6,15,5,16,32,49,-17,50
Peterhead,6964,7,14,7,15,43,48,-5,49
East Fife,6964,8,11,8,17,45,51,-6,41
Stranraer,6964,9,11,7,18,48,62,-14,40
Stenhousem'r,6964,10,8,4,24,45,84,-39,28
Alloa,6965,1,22,7,7,81,45,36,73
Livingston,6965,2,21,4,11,79,49,30,67
Albion,6965,3,19,6,11,65,47,18,63
Brechin,6965,4,17,5,14,52,51,1,56
Airdrieon,6965,5,14,11,11,59,49,10,53
East Fife,6965,6,14,7,15,56,51,5,49
Peterhead,6965,7,12,10,14,42,53,-11,46
Stranraer,6965,8,11,8,17,51,69,-18,41
Queen's Park,6965,9,10,7,19,40,64,-24,37
Stenhousem'r,6965,10,4,7,25,44,91,-47,19
Livingston,6966,1,22,2,12,80,54,26,68
Alloa,6966,2,19,8,9,72,49,23,65
Brechin,6966,3,18,6,12,54,46,8,60
Peterhead,6966,4,15,8,13,53,51,2,53
East Fife,6966,5,12,11,13,45,44,1,47
Albion,6966,6,12,10,14,54,50,4,46
Airdrieon,6966,7,13,6,17,50,61,-11,45
Stranraer,6966,8,12,8,16,44,51,-7,44
Queen's Park,6966,9,10,9,17,40,62,-22,39
Stenhousem'r,6966,10,8,10,18,55,79,-24,34
Alloa,6967,1,19,10,7,77,44,33,67
Livingston,6967,2,18,6,12,78,54,24,60
Albion,6967,3,16,9,11,61,50,11,57
Airdrieon,6967,4,15,9,12,53,49,4,54
East Fife,6967,5,12,9,15,51,47,4,45
Brechin,6967,6,13,6,17,48,55,-7,45
Stranraer,6967,7,13,6,17,44,58,-14,45
Peterhead,6967,8,12,9,15,41,56,-15,45
Queen's Park,6967,9,12,8,16,35,49,-14,44
Stenhousem'r,6967,10,10,8,18,47,73,-26,38
Alloa,6968,1,21,7,8,81,47,34,70
Livingston,6968,2,21,3,12,73,44,29,66
Airdrieon,6968,3,19,7,10,65,54,11,64
Albion,6968,4,17,8,11,58,50,8,59
Peterhead,6968,5,13,8,15,50,52,-2,47
Brechin,6968,6,13,8,15,44,50,-6,47
East Fife,6968,7,10,12,14,44,48,-4,42
Stranraer,6968,8,11,7,18,47,56,-9,40
Queen's Park,6968,9,10,7,19,32,53,-21,37
Stenhousem'r,6968,10,9,5,22,47,87,-40,32
Alloa,6969,1,21,7,8,70,49,21,70
Livingston,6969,2,19,7,10,74,50,24,64
Airdrieon,6969,3,17,8,11,67,51,16,59
Brechin,6969,4,16,6,14,45,45,0,54
East Fife,6969,5,14,8,14,55,44,11,50
Stranraer,6969,6,14,7,15,48,51,-3,49
Albion,6969,7,13,8,15,49,53,-4,47
Peterhead,6969,8,12,8,16,48,55,-7,44
Queen's Park,6969,9,11,8,17,39,49,-10,41
Stenhousem'r,6969,10,6,7,23,37,85,-48,25
Livingston,6970,1,20,5,11,67,40,27,65
Brechin,6970,2,19,6,11,53,41,12,63
Alloa,6970,3,17,10,9,73,45,28,61
Albion,6970,4,16,8,12,52,39,13,56
Airdrieon,6970,5,16,7,13,58,60,-2,55
Peterhead,6970,6,12,11,13,53,54,-1,47
Queen's Park,6970,7,13,7,16,34,58,-24,46
Stranraer,6970,8,11,9,16,50,59,-9,42
East Fife,6970,9,8,11,17,42,45,-3,35
Stenhousem'r,6970,10,6,10,20,40,81,-41,28
Livingston,6971,1,26,3,7,82,41,41,81
Alloa,6971,2,17,9,10,82,55,27,60
Albion,6971,3,17,7,12,59,46,13,58
Airdrieon,6971,4,17,6,13,57,57,0,57
East Fife,6971,5,15,6,15,61,46,15,51
Brechin,6971,6,14,9,13,46,47,-1,51
Peterhead,6971,7,12,7,17,50,62,-12,43
Queen's Park,6971,8,11,9,16,38,56,-18,42
Stranraer,6971,9,9,6,21,46,70,-24,33
Stenhousem'r,6971,10,8,6,22,42,83,-41,30
Livingston,6972,1,20,3,13,79,56,23,63
Alloa,6972,2,18,8,10,70,51,19,62
Airdrieon,6972,3,19,4,13,64,54,10,61
Peterhead,6972,4,17,9,10,60,50,10,60
Albion,6972,5,16,7,13,56,53,3,55
Brechin,6972,6,14,7,15,50,55,-5,49
East Fife,6972,7,11,8,17,58,58,0,41
Stranraer,6972,8,10,10,16,52,67,-15,40
Stenhousem'r,6972,9,10,7,19,48,73,-25,37
Queen's Park,6972,10,9,9,18,39,59,-20,36
Alloa,6973,1,19,8,9,76,44,32,65
Airdrieon,6973,2,19,5,12,72,51,21,62
Livingston,6973,3,18,6,12,71,53,18,60
Peterhead,6973,4,16,10,10,55,52,3,58
Albion,6973,5,14,8,14,52,52,0,50
Stranraer,6973,6,13,6,17,57,61,-4,45
East Fife,6973,7,11,11,14,44,52,-8,44
Brechin,6973,8,13,5,18,43,59,-16,44
Queen's Park,6973,9,11,5,20,37,56,-19,38
Stenhousem'r,6973,10,9,10,17,49,76,-27,37
Airdrieon,6974,1,20,6,10,56,43,13,66
Brechin,6974,2,16,13,7,51,34,17,61
Livingston,6974,3,19,4,13,61,45,16,61
Albion,6974,4,15,12,9,57,49,8,57
Alloa,6974,5,14,11,11,57,46,11,53
Peterhead,6974,6,15,7,14,57,62,-5,52
East Fife,6974,7,10,13,13,46,47,-1,43
Queen's Park,6974,8,10,7,19,38,56,-18,37
Stranraer,6974,9,9,7,20,41,58,-17,34
Stenhousem'r,6974,10,8,8,20,51,75,-24,32
Livingston,6975,1,28,1,7,84,39,45,85
Alloa,6975,2,19,7,10,65,43,22,64
Brechin,6975,3,17,6,13,47,43,4,57
Peterhead,6975,4,14,11,11,51,48,3,53
Airdrieon,6975,5,14,10,12,56,58,-2,52
East Fife,6975,6,13,10,13,49,41,8,49
Stranraer,6975,7,12,7,17,48,59,-11,43
Queen's Park,6975,8,12,7,17,41,55,-14,43
Albion,6975,9,9,9,18,43,56,-13,36
Stenhousem'r,6975,10,4,8,24,39,81,-42,20
Livingston,6976,1,21,3,12,74,49,25,66
Albion,6976,2,19,5,12,64,48,16,62
Brechin,6976,3,17,6,13,54,50,4,57
Alloa,6976,4,16,6,14,54,46,8,54
Airdrieon,6976,5,15,8,13,63,62,1,53
Peterhead,6976,6,15,5,16,57,61,-4,50
Stenhousem'r,6976,7,12,10,14,53,66,-13,46
Stranraer,6976,8,9,13,14,44,52,-8,40
Queen's Park,6976,9,11,7,18,40,57,-17,40
East Fife,6976,10,8,11,17,39,51,-12,35
Livingston,6977,1,23,4,9,75,49,26,73
Alloa,6977,2,17,7,12,72,53,19,58
Stranraer,6977,3,18,2,16,52,59,-7,56
Peterhead,6977,4,16,6,14,51,50,1,54
Airdrieon,6977,5,15,7,14,63,54,9,52
East Fife,6977,6,13,10,13,49,47,2,49
Queen's Park,6977,7,14,6,16,39,48,-9,48
Albion,6977,8,13,8,15,55,49,6,47
Brechin,6977,9,13,5,18,42,48,-6,44
Stenhousem'r,6977,10,7,7,22,40,81,-41,28
Alloa,6978,1,21,6,9,70,41,29,69
Livingston,6978,2,20,3,13,81,56,25,63
Brechin,6978,3,19,2,15,52,48,4,59
Airdrieon,6978,4,15,9,12,59,54,5,54
East Fife,6978,5,14,9,13,53,41,12,51
Albion,6978,6,12,11,13,49,50,-1,47
Peterhead,6978,7,12,9,15,47,51,-4,45
Queen's Park,6978,8,12,9,15,35,49,-14,45
Stranraer,6978,9,12,7,17,45,64,-19,43
Stenhousem'r,6978,10,8,5,23,41,78,-37,29
Livingston,6979,1,22,6,8,81,43,38,72
Alloa,6979,2,17,8,11,61,49,12,59
Airdrieon,6979,3,17,7,12,60,56,4,58
Brechin,6979,4,17,6,13,53,53,0,57
East Fife,6979,5,15,7,14,65,55,10,52
Albion,6979,6,13,10,13,54,51,3,49
Peterhead,6979,7,11,8,17,54,60,-6,41
Stranraer,6979,8,11,6,19,48,62,-14,39
Stenhousem'r,6979,9,10,9,17,48,74,-26,39
Queen's Park,6979,10,9,9,18,35,56,-21,36
Alloa,6980,1,21,9,6,77,37,40,72
Livingston,6980,2,19,6,11,75,50,25,63
Albion,6980,3,17,9,10,68,50,18,60
Airdrieon,6980,4,16,10,10,55,47,8,58
Peterhead,6980,5,13,10,13,48,54,-6,49
Brechin,6980,6,13,9,14,51,60,-9,48
Queen's Park,6980,7,10,11,15,42,53,-11,41
Stranraer,6980,8,10,11,15,46,59,-13,41
Stenhousem'r,6980,9,8,8,20,54,81,-27,32
East Fife,6980,10,8,7,21,42,67,-25,31
Livingston,6981,1,22,5,9,85,54,31,71
Alloa,6981,2,20,10,6,74,45,29,70
Brechin,6981,3,17,8,11,62,49,13,59
Airdrieon,6981,4,15,10,11,54,49,5,55
East Fife,6981,5,14,11,11,59,48,11,53
Peterhead,6981,6,11,7,18,58,68,-10,40
Queen's Park,6981,7,11,6,19,38,64,-26,39
Albion,6981,8,9,11,16,46,55,-9,38
Stranraer,6981,9,10,8,18,46,65,-19,38
Stenhousem'r,6981,10,9,8,19,49,74,-25,35
Alloa,6982,1,21,8,7,85,45,40,71
Livingston,6982,2,22,3,11,68,46,22,69
Brechin,6982,3,19,5,12,52,49,3,62
Albion,6982,4,19,4,13,58,51,7,61
Airdrieon,6982,5,15,9,12,54,50,4,54
East Fife,6982,6,12,10,14,50,44,6,46
Peterhead,6982,7,13,5,18,50,60,-10,44
Queen's Park,6982,8,11,7,18,40,60,-20,40
Stranraer,6982,9,9,8,19,52,69,-17,35
Stenhousem'r,6982,10,6,7,23,51,86,-35,25
Alloa,6983,1,19,7,10,72,48,24,64
Airdrieon,6983,2,18,9,9,61,47,14,63
Livingston,6983,3,16,10,10,72,54,18,58
Albion,6983,4,17,6,13,59,51,8,57
Brechin,6983,5,16,9,11,48,41,7,57
Stranraer,6983,6,17,3,16,61,56,5,54
Peterhead,6983,7,13,8,15,50,56,-6,47
Queen's Park,6983,8,13,8,15,43,50,-7,47
Stenhousem'r,6983,9,7,7,22,46,89,-43,28
East Fife,6983,10,5,11,20,38,58,-20,26
Alloa,6984,1,19,8,9,67,41,26,65
Livingston,6984,2,17,10,9,64,41,23,61
Brechin,6984,3,18,7,11,60,52,8,61
Albion,6984,4,16,9,11,55,50,5,57
Stranraer,6984,5,17,3,16,54,60,-6,54
Airdrieon,6984,6,12,11,13,54,51,3,47
Queen's Park,6984,7,12,6,18,37,54,-17,42
Peterhead,6984,8,10,10,16,41,51,-10,40
East Fife,6984,9,8,12,16,55,59,-4,36
Stenhousem'r,6984,10,10,6,20,42,70,-28,36
Livingston,6985,1,24,5,7,78,40,38,77
Alloa,6985,2,20,9,7,68,41,27,69
Albion,6985,3,15,8,13,58,59,-1,53
Brechin,6985,4,16,5,15,45,47,-2,53
Stranraer,6985,5,15,3,18,50,56,-6,48
Queen's Park,6985,6,14,5,17,35,47,-12,47
East Fife,6985,7,13,6,17,48,45,3,45
Airdrieon,6985,8,12,9,15,51,53,-2,45
Peterhead,6985,9,12,8,16,49,53,-4,44
Stenhousem'r,6985,10,8,4,24,40,81,-41,28
Livingston,6986,1,25,1,10,79,44,35,76
Albion,6986,2,18,6,12,57,44,13,60
Alloa,6986,3,17,8,11,65,49,16,59
Airdrieon,6986,4,17,6,13,48,52,-4,57
Brechin,6986,5,17,4,15,60,51,9,55
Queen's Park,6986,6,14,8,14,32,38,-6,50
Peterhead,6986,7,14,6,16,45,50,-5,48
East Fife,6986,8,10,11,15,41,47,-6,41
Stranraer,6986,9,12,4,20,52,64,-12,40
Stenhousem'r,6986,10,7,4,25,41,81,-40,25
Livingston,6987,1,25,2,9,79,37,42,77
Alloa,6987,2,19,7,10,74,50,24,64
Brechin,6987,3,17,8,11,51,38,13,59
Airdrieon,6987,4,16,8,12,66,63,3,56
Peterhead,6987,5,15,9,12,48,48,0,54
Albion,6987,6,11,9,16,47,58,-11,42
East Fife,6987,7,10,10,16,48,51,-3,40
Queen's Park,6987,8,12,4,20,37,55,-18,40
Stenhousem'r,6987,9,8,11,17,43,73,-30,35
Stranraer,6987,10,8,10,18,45,65,-20,34
Brechin,6988,1,18,8,10,45,36,9,62
Livingston,6988,2,18,6,12,66,47,19,60
Airdrieon,6988,3,18,6,12,53,47,6,60
Alloa,6988,4,18,5,13,67,44,23,59
Albion,6988,5,15,8,13,57,56,1,53
Peterhead,6988,6,14,7,15,42,45,-3,49
East Fife,6988,7,12,10,14,56,52,4,46
Queen's Park,6988,8,12,9,15,37,48,-11,45
Stranraer,6988,9,11,6,19,45,63,-18,39
Stenhousem'r,6988,10,8,7,21,44,74,-30,31
Livingston,6989,1,22,3,11,77,43,34,69
Airdrieon,6989,2,21,4,11,63,50,13,67
Alloa,6989,3,19,6,11,75,49,26,63
Brechin,6989,4,18,5,13,46,35,11,59
Albion,6989,5,16,8,12,59,48,11,56
Peterhead,6989,6,12,9,15,47,55,-8,45
Stranraer,6989,7,13,4,19,45,58,-13,43
Queen's Park,6989,8,9,10,17,32,57,-25,37
Stenhousem'r,6989,9,9,9,18,49,89,-40,36
East Fife,6989,10,6,12,18,40,49,-9,30
Livingston,6990,1,22,6,8,89,49,40,72
Alloa,6990,2,16,10,10,67,40,27,58
Brechin,6990,3,16,10,10,54,51,3,58
Airdrieon,6990,4,15,7,14,57,64,-7,52
Albion,6990,5,12,12,12,58,62,-4,48
Peterhead,6990,6,12,9,15,47,49,-2,45
East Fife,6990,7,10,14,12,52,51,1,44
Stranraer,6990,8,11,9,16,52,58,-6,42
Queen's Park,6990,9,10,9,17,40,60,-20,39
Stenhousem'r,6990,10,7,12,17,48,80,-32,33
Livingston,6991,1,18,7,11,67,47,20,61
Alloa,6991,2,17,9,10,76,51,25,60
Airdrieon,6991,3,18,6,12,59,50,9,60
Peterhead,6991,4,17,7,12,60,55,5,58
East Fife,6991,5,16,8,12,55,40,15,56
Albion,6991,6,16,7,13,58,53,5,55
Brechin,6991,7,13,5,18,39,52,-13,44
Stranraer,6991,8,12,6,18,47,61,-14,42
Queen's Park,6991,9,10,10,16,33,53,-20,40
Stenhousem'r,6991,10,6,9,21,41,73,-32,27
Livingston,6992,1,22,6,8,72,49,23,72
Alloa,6992,2,19,6,11,61,38,23,63
Brechin,6992,3,16,8,12,56,40,16,56
Airdrieon,6992,4,16,7,13,62,60,2,55
Peterhead,6992,5,15,8,13,55,53,2,53
Albion,6992,6,14,10,12,51,47,4,52
Queen's Park,6992,7,11,11,14,35,46,-11,44
Stranraer,6992,8,12,6,18,48,58,-10,42
East Fife,6992,9,8,12,16,43,52,-9,36
Stenhousem'r,6992,10,4,12,20,43,83,-40,24
Livingston,6993,1,19,7,10,77,55,22,64
Airdrieon,6993,2,17,8,11,62,49,13,59
Alloa,6993,3,16,9,11,71,54,17,57
Albion,6993,4,16,5,15,57,49,8,53
Peterhead,6993,5,15,7,14,50,55,-5,52
Queen's Park,6993,6,14,9,13,39,40,-1,51
Brechin,6993,7,15,6,15,46,49,-3,51
Stranraer,6993,8,15,5,16,57,53,4,50
East Fife,6993,9,9,11,16,40,46,-6,38
Stenhousem'r,6993,10,7,7,22,43,92,-49,28
Livingston,6994,1,21,4,11,78,54,24,67
Alloa,6994,2,18,8,10,59,41,18,62
Airdrieon,6994,3,18,8,10,60,50,10,62
Stranraer,6994,4,15,9,12,58,55,3,54
Peterhead,6994,5,14,11,11,53,49,4,53
Brechin,6994,6,14,4,18,43,53,-10,46
Albion,6994,7,12,9,15,42,52,-10,45
East Fife,6994,8,9,10,17,46,51,-5,37
Queen's Park,6994,9,9,10,17,44,58,-14,37
Stenhousem'r,6994,10,8,11,17,47,67,-20,35
Alloa,6995,1,20,8,8,72,46,26,68
Livingston,6995,2,21,3,12,78,53,25,66
Airdrieon,6995,3,20,5,11,67,52,15,65
Peterhead,6995,4,15,7,14,53,57,-4,52
Brechin,6995,5,15,5,16,49,47,2,50
East Fife,6995,6,12,13,11,48,44,4,49
Albion,6995,7,14,7,15,52,50,2,49
Stranraer,6995,8,13,4,19,45,56,-11,43
Queen's Park,6995,9,10,7,19,29,54,-25,37
Stenhousem'r,6995,10,8,5,23,43,77,-34,29
Livingston,6996,1,24,0,12,87,58,29,72
Alloa,6996,2,17,9,10,61,41,20,60
Albion,6996,3,16,7,13,60,52,8,55
Brechin,6996,4,15,9,12,53,50,3,54
Airdrieon,6996,5,16,5,15,60,63,-3,53
East Fife,6996,6,14,10,12,57,47,10,52
Peterhead,6996,7,15,7,14,46,46,0,52
Queen's Park,6996,8,12,10,14,40,48,-8,46
Stranraer,6996,9,10,7,19,48,67,-19,37
Stenhousem'r,6996,10,6,6,24,39,79,-40,24
Alloa,6997,1,21,8,7,83,40,43,71
Livingston,6997,2,20,5,11,80,50,30,65
Airdrieon,6997,3,18,6,12,66,47,19,60
Queen's Park,6997,4,17,6,13,47,50,-3,57
Brechin,6997,5,15,6,15,53,56,-3,51
Peterhead,6997,6,12,12,12,46,54,-8,48
Albion,6997,7,12,8,16,56,67,-11,44
East Fife,6997,8,11,10,15,50,57,-7,43
Stranraer,6997,9,11,3,22,42,71,-29,36
Stenhousem'r,6997,10,8,6,22,53,84,-31,30
Alloa,6998,1,22,8,6,72,36,36,74
Livingston,6998,2,19,5,12,75,59,16,62
Airdrieon,6998,3,18,5,13,57,53,4,59
Albion,6998,4,16,5,15,56,48,8,53
Stranraer,6998,5,16,5,15,60,56,4,53
Brechin,6998,6,15,7,14,51,53,-2,52
East Fife,6998,7,10,12,14,50,54,-4,42
Peterhead,6998,8,11,9,16,43,57,-14,42
Queen's Park,6998,9,11,5,20,35,54,-19,38
Stenhousem'r,6998,10,5,13,18,48,77,-29,28
Airdrieon,6999,1,20,7,9,66,62,4,67
Alloa,6999,2,17,9,10,66,48,18,60
Brechin,6999,3,18,6,12,57,46,11,60
Stranraer,6999,4,17,4,15,56,52,4,55
Livingston,6999,5,17,3,16,65,46,19,54
Peterhead,6999,6,13,10,13,63,59,4,49
Albion,6999,7,12,9,15,48,57,-9,45
East Fife,6999,8,11,9,16,58,55,3,42
Queen's Park,6999,9,10,9,17,36,55,-19,39
Stenhousem'r,6999,10,7,10,19,42,77,-35,31
Airdrieon,7000,1,20,6,10,61,47,14,66
Livingston,7000,2,18,4,14,68,59,9,58
Alloa,7000,3,14,13,9,55,42,13,55
Peterhead,7000,4,15,10,11,59,53,6,55
Stranraer,7000,5,14,6,16,57,57,0,48
Brechin,7000,6,13,9,14,47,48,-1,48
Albion,7000,7,14,5,17,57,58,-1,47
Queen's Park,7000,8,13,7,16,38,52,-14,46
East Fife,7000,9,10,11,15,47,52,-5,41
Stenhousem'r,7000,10,8,11,17,44,65,-21,35
Livingston,7001,1,20,2,14,69,49,20,62
Airdrieon,7001,2,19,4,13,62,56,6,61
Alloa,7001,3,16,10,10,63,40,23,58
Brechin,7001,4,17,6,13,55,52,3,57
Albion,7001,5,15,8,13,52,51,1,53
Queen's Park,7001,6,16,5,15,38,44,-6,53
East Fife,7001,7,14,9,13,49,42,7,51
Stranraer,7001,8,15,4,17,54,55,-1,49
Peterhead,7001,9,12,8,16,49,57,-8,44
Stenhousem'r,7001,10,5,6,25,44,89,-45,21
Livingston,7002,1,23,2,11,86,50,36,71
Alloa,7002,2,18,6,12,68,44,24,60
Brechin,7002,3,18,6,12,51,47,4,60
Peterhead,7002,4,17,6,13,55,45,10,57
East Fife,7002,5,13,10,13,50,39,11,49
Stranraer,7002,6,14,7,15,50,59,-9,49
Airdrieon,7002,7,14,6,16,58,64,-6,48
Albion,7002,8,12,9,15,47,57,-10,45
Queen's Park,7002,9,11,5,20,34,55,-21,38
Stenhousem'r,7002,10,8,7,21,38,77,-39,31
Alloa,7003,1,20,9,7,72,41,31,69
Airdrieon,7003,2,19,9,8,62,44,18,66
Livingston,7003,3,18,7,11,63,48,15,61
Brechin,7003,4,17,7,12,63,52,11,58
Albion,7003,5,12,9,15,48,50,-2,45
Peterhead,7003,6,13,6,17,48,51,-3,45
Queen's Park,7003,7,12,8,16,36,53,-17,44
East Fife,7003,8,9,13,14,48,50,-2,40
Stranraer,7003,9,11,6,19,47,66,-19,39
Stenhousem'r,7003,10,7,10,19,44,76,-32,31
Livingston,7004,1,21,6,9,75,50,25,69
Airdrieon,7004,2,18,6,12,59,51,8,60
Alloa,7004,3,17,8,11,66,47,19,59
Albion,7004,4,16,8,12,62,51,11,56
Peterhead,7004,5,15,5,16,54,55,-1,50
Brechin,7004,6,13,8,15,46,53,-7,47
Stranraer,7004,7,11,11,14,49,56,-7,44
Queen's Park,7004,8,12,6,18,37,55,-18,42
East Fife,7004,9,11,8,17,48,55,-7,41
Stenhousem'r,7004,10,11,4,21,54,77,-23,37
Livingston,7005,1,24,4,8,86,39,47,76
Alloa,7005,2,21,5,10,72,45,27,68
Brechin,7005,3,19,8,9,60,43,17,65
Albion,7005,4,15,10,11,66,53,13,55
Airdrieon,7005,5,15,7,14,62,66,-4,52
Peterhead,7005,6,13,11,12,51,50,1,50
Stranraer,7005,7,12,7,17,42,58,-16,43
East Fife,7005,8,10,7,19,46,60,-14,37
Queen's Park,7005,9,10,7,19,41,58,-17,37
Stenhousem'r,7005,10,3,10,23,42,96,-54,19
Alloa,7006,1,22,5,9,82,46,36,71
Livingston,7006,2,20,7,9,65,43,22,67
Brechin,7006,3,16,11,9,53,47,6,59
Airdrieon,7006,4,17,7,12,60,51,9,58
Queen's Park,7006,5,16,4,16,44,49,-5,52
Peterhead,7006,6,13,9,14,44,53,-9,48
Albion,7006,7,11,9,16,41,47,-6,42
East Fife,7006,8,10,12,14,45,52,-7,42
Stranraer,7006,9,11,5,20,49,64,-15,38
Stenhousem'r,7006,10,6,7,23,45,76,-31,25
Alloa,7007,1,22,7,7,75,43,32,73
Livingston,7007,2,20,7,9,79,50,29,67
Brechin,7007,3,16,8,12,54,47,7,56
Albion,7007,4,13,12,11,63,52,11,51
Airdrieon,7007,5,13,10,13,49,54,-5,49
Peterhead,7007,6,13,9,14,46,48,-2,48
Stenhousem'r,7007,7,12,7,17,56,74,-18,43
Queen's Park,7007,8,11,8,17,37,59,-22,41
East Fife,7007,9,10,9,17,46,53,-7,39
Stranraer,7007,10,8,7,21,44,69,-25,31
Alloa,7008,1,23,5,8,74,42,32,74
Airdrieon,7008,2,20,4,12,73,59,14,64
Livingston,7008,3,18,6,12,77,63,14,60
Brechin,7008,4,16,8,12,58,51,7,56
Queen's Park,7008,5,13,6,17,38,49,-11,45
East Fife,7008,6,12,7,17,51,55,-4,43
Albion,7008,7,10,12,14,50,57,-7,42
Stranraer,7008,8,11,9,16,48,61,-13,42
Peterhead,7008,9,11,7,18,45,56,-11,40
Stenhousem'r,7008,10,9,10,17,47,68,-21,37
Airdrieon,7009,1,21,3,12,63,49,14,66
Livingston,7009,2,20,5,11,75,52,23,65
Alloa,7009,3,16,9,11,69,48,21,57
Brechin,7009,4,17,5,14,59,53,6,56
Albion,7009,5,14,7,15,59,60,-1,49
Stranraer,7009,6,14,4,18,56,62,-6,46
East Fife,7009,7,12,8,16,50,50,0,44
Peterhead,7009,8,12,8,16,52,65,-13,44
Stenhousem'r,7009,9,11,9,16,52,74,-22,42
Queen's Park,7009,10,11,6,19,40,62,-22,39
Alloa,7010,1,21,8,7,64,37,27,71
Livingston,7010,2,21,3,12,73,51,22,66
Airdrieon,7010,3,17,7,12,54,51,3,58
Albion,7010,4,16,7,13,50,44,6,55
Brechin,7010,5,14,9,13,52,49,3,51
East Fife,7010,6,13,9,14,52,49,3,48
Peterhead,7010,7,12,9,15,45,56,-11,45
Queen's Park,7010,8,11,7,18,37,57,-20,40
Stranraer,7010,9,11,6,19,46,56,-10,39
Stenhousem'r,7010,10,7,9,20,46,69,-23,30
Livingston,7011,1,25,1,10,79,40,39,76
Alloa,7011,2,19,9,8,79,45,34,66
Brechin,7011,3,16,8,12,55,48,7,56
Airdrieon,7011,4,17,5,14,61,57,4,56
Peterhead,7011,5,12,10,14,64,67,-3,46
Stranraer,7011,6,13,5,18,41,56,-15,44
Stenhousem'r,7011,7,12,7,17,54,78,-24,43
Albion,7011,8,11,9,16,48,54,-6,42
East Fife,7011,9,10,10,16,39,50,-11,40
Queen's Park,7011,10,9,8,19,27,52,-25,35
Alloa,7012,1,23,7,6,94,49,45,76
Brechin,7012,2,17,7,12,57,45,12,58
Queen's Park,7012,3,17,6,13,43,47,-4,57
Airdrieon,7012,4,15,7,14,55,60,-5,52
Livingston,7012,5,15,6,15,68,54,14,51
Peterhead,7012,6,13,10,13,48,49,-1,49
East Fife,7012,7,12,9,15,49,52,-3,45
Albion,7012,8,11,12,13,49,55,-6,45
Stranraer,7012,9,10,8,18,47,66,-19,38
Stenhousem'r,7012,10,6,10,20,43,76,-33,28
Livingston,7013,1,23,4,9,72,41,31,73
Brechin,7013,2,17,8,11,52,44,8,59
Airdrieon,7013,3,16,9,11,59,51,8,57
Alloa,7013,4,16,8,12,68,49,19,56
Peterhead,7013,5,14,7,15,40,48,-8,49
Albion,7013,6,12,9,15,57,57,0,45
East Fife,7013,7,12,9,15,47,48,-1,45
Stenhousem'r,7013,8,12,7,17,60,76,-16,43
Queen's Park,7013,9,9,10,17,35,53,-18,37
Stranraer,7013,10,10,7,19,46,69,-23,37
Livingston,7014,1,20,4,12,75,47,28,64
Airdrieon,7014,2,17,9,10,67,52,15,60
Brechin,7014,3,18,6,12,50,50,0,60
Alloa,7014,4,16,10,10,67,49,18,58
Albion,7014,5,16,8,12,51,42,9,56
Peterhead,7014,6,13,10,13,57,58,-1,49
Queen's Park,7014,7,14,5,17,34,49,-15,47
East Fife,7014,8,10,13,13,63,52,11,43
Stranraer,7014,9,12,5,19,44,61,-17,41
Stenhousem'r,7014,10,5,8,23,40,88,-48,23
Livingston,7015,1,23,3,10,83,51,32,72
Alloa,7015,2,20,7,9,77,48,29,67
Brechin,7015,3,17,5,14,56,46,10,56
Stranraer,7015,4,16,5,15,58,55,3,53
Airdrieon,7015,5,15,7,14,48,56,-8,52
Albion,7015,6,13,11,12,53,55,-2,50
Peterhead,7015,7,13,9,14,42,50,-8,48
East Fife,7015,8,10,7,19,48,49,-1,37
Stenhousem'r,7015,9,9,10,17,48,75,-27,37
Queen's Park,7015,10,9,6,21,28,56,-28,33
Alloa,7016,1,18,11,7,73,46,27,65
Livingston,7016,2,18,6,12,75,51,24,60
Airdrieon,7016,3,15,7,14,61,56,5,52
Brechin,7016,4,14,10,12,47,47,0,52
Albion,7016,5,13,10,13,62,56,6,49
East Fife,7016,6,14,7,15,48,48,0,49
Peterhead,7016,7,12,10,14,45,54,-9,46
Queen's Park,7016,8,12,10,14,43,54,-11,46
Stranraer,7016,9,12,9,15,41,50,-9,45
Stenhousem'r,7016,10,9,6,21,47,80,-33,33
Livingston,7017,1,22,2,12,87,57,30,68
Airdrieon,7017,2,19,6,11,77,58,19,63
East Fife,7017,3,18,8,10,58,35,23,62
Alloa,7017,4,18,5,13,67,54,13,59
Brechin,7017,5,16,4,16,45,53,-8,52
Queen's Park,7017,6,16,3,17,43,49,-6,51
Peterhead,7017,7,14,6,16,51,49,2,48
Albion,7017,8,13,6,17,55,61,-6,45
Stranraer,7017,9,11,6,19,49,65,-16,39
Stenhousem'r,7017,10,6,8,22,42,93,-51,26
Alloa,7018,1,20,8,8,68,40,28,68
Livingston,7018,2,18,4,14,71,55,16,58
Brechin,7018,3,17,6,13,52,44,8,57
Queen's Park,7018,4,16,8,12,38,43,-5,56
Peterhead,7018,5,16,6,14,48,46,2,54
Albion,7018,6,15,7,14,54,42,12,52
Airdrieon,7018,7,14,10,12,57,56,1,52
Stranraer,7018,8,13,4,19,44,60,-16,43
East Fife,7018,9,7,11,18,40,58,-18,32
Stenhousem'r,7018,10,6,12,18,43,71,-28,30
Livingston,7019,1,23,4,9,77,37,40,73
Alloa,7019,2,21,7,8,70,40,30,70
Brechin,7019,3,21,3,12,60,55,5,66
Airdrieon,7019,4,16,7,13,51,52,-1,55
Queen's Park,7019,5,14,7,15,41,51,-10,49
Stranraer,7019,6,14,3,19,50,58,-8,45
Peterhead,7019,7,11,8,17,42,54,-12,41
Albion,7019,8,10,10,16,57,67,-10,40
East Fife,7019,9,10,8,18,50,53,-3,38
Stenhousem'r,7019,10,8,7,21,52,83,-31,31
Livingston,7020,1,23,1,12,76,49,27,70
Alloa,7020,2,18,9,9,76,49,27,63
Airdrieon,7020,3,17,6,13,63,64,-1,57
Peterhead,7020,4,16,8,12,51,51,0,56
Albion,7020,5,16,6,14,55,48,7,54
Brechin,7020,6,15,6,15,58,59,-1,51
East Fife,7020,7,13,8,15,58,55,3,47
Stranraer,7020,8,13,2,21,53,67,-14,41
Queen's Park,7020,9,9,11,16,38,55,-17,38
Stenhousem'r,7020,10,6,11,19,51,82,-31,29
Alloa,7021,1,22,7,7,77,45,32,73
Brechin,7021,2,19,5,12,64,50,14,62
Livingston,7021,3,18,5,13,71,55,16,59
Airdrieon,7021,4,16,8,12,65,60,5,56
Peterhead,7021,5,15,10,11,53,49,4,55
Albion,7021,6,14,8,14,55,54,1,50
Stranraer,7021,7,13,5,18,47,64,-17,44
East Fife,7021,8,10,10,16,46,47,-1,40
Queen's Park,7021,9,9,9,18,46,64,-18,36
Stenhousem'r,7021,10,4,13,19,41,77,-36,25
Alloa,7022,1,18,11,7,72,50,22,65
Livingston,7022,2,20,4,12,73,50,23,64
Brechin,7022,3,18,7,11,49,42,7,61
Peterhead,7022,4,15,8,13,47,46,1,53
Airdrieon,7022,5,13,10,13,52,59,-7,49
Albion,7022,6,14,5,17,47,52,-5,47
East Fife,7022,7,10,12,14,51,43,8,42
Stranraer,7022,8,11,8,17,55,62,-7,41
Queen's Park,7022,9,11,7,18,34,55,-21,40
Stenhousem'r,7022,10,8,12,16,51,72,-21,36
Alloa,7023,1,21,7,8,70,36,34,70
Livingston,7023,2,20,3,13,69,47,22,63
Airdrieon,7023,3,18,8,10,58,45,13,62
Albion,7023,4,19,5,12,62,51,11,62
Stranraer,7023,5,15,5,16,55,60,-5,50
Brechin,7023,6,14,7,15,52,52,0,49
Peterhead,7023,7,13,7,16,39,49,-10,46
Queen's Park,7023,8,12,7,17,39,50,-11,43
East Fife,7023,9,9,7,20,41,58,-17,34
Stenhousem'r,7023,10,8,6,22,45,82,-37,30
Brechin,7024,1,20,6,10,55,36,19,66
Alloa,7024,2,18,7,11,61,45,16,61
Airdrieon,7024,3,17,8,11,60,51,9,59
Livingston,7024,4,17,4,15,60,55,5,55
Stranraer,7024,5,14,7,15,60,58,2,49
Peterhead,7024,6,14,7,15,48,52,-4,49
Queen's Park,7024,7,14,5,17,44,53,-9,47
Stenhousem'r,7024,8,12,6,18,61,83,-22,42
Albion,7024,9,10,10,16,44,52,-8,40
East Fife,7024,10,10,8,18,47,55,-8,38
Airdrieon,7025,1,20,7,9,62,40,22,67
Alloa,7025,2,20,7,9,63,43,20,67
Livingston,7025,3,20,2,14,73,44,29,62
Brechin,7025,4,17,4,15,54,51,3,55
Peterhead,7025,5,15,6,15,50,55,-5,51
Albion,7025,6,14,6,16,48,59,-11,48
Queen's Park,7025,7,13,6,17,36,47,-11,45
Stranraer,7025,8,13,4,19,49,58,-9,43
East Fife,7025,9,10,10,16,44,46,-2,40
Stenhousem'r,7025,10,9,6,21,49,85,-36,33
Alloa,7026,1,24,6,6,76,38,38,78
Airdrieon,7026,2,20,6,10,63,50,13,66
Livingston,7026,3,19,8,9,79,49,30,65
Albion,7026,4,13,11,12,53,56,-3,50
Stranraer,7026,5,15,4,17,58,61,-3,49
Brechin,7026,6,13,7,16,44,52,-8,46
Stenhousem'r,7026,7,11,7,18,49,68,-19,40
Peterhead,7026,8,10,8,18,49,63,-14,38
East Fife,7026,9,9,9,18,39,52,-13,36
Queen's Park,7026,10,9,8,19,34,55,-21,35
Airdrieon,7027,1,21,7,8,69,44,25,70
Livingston,7027,2,22,3,11,75,46,29,69
Alloa,7027,3,18,8,10,61,43,18,62
Albion,7027,4,16,6,14,63,45,18,54
Brechin,7027,5,15,7,14,42,43,-1,52
Peterhead,7027,6,12,7,17,46,61,-15,43
Stranraer,7027,7,11,8,17,41,55,-14,41
East Fife,7027,8,10,10,16,52,55,-3,40
Queen's Park,7027,9,10,8,18,35,57,-22,38
Stenhousem'r,7027,10,9,8,19,47,82,-35,35
Livingston,7028,1,24,7,5,73,38,35,79
Alloa,7028,2,20,8,8,76,43,33,68
Airdrieon,7028,3,16,7,13,72,61,11,55
Brechin,7028,4,16,6,14,46,50,-4,54
Queen's Park,7028,5,15,8,13,44,48,-4,53
Peterhead,7028,6,11,12,13,48,54,-6,45
Albion,7028,7,12,7,17,58,66,-8,43
Stranraer,7028,8,13,3,20,47,64,-17,42
East Fife,7028,9,8,12,16,46,55,-9,36
Stenhousem'r,7028,10,8,4,24,57,88,-31,28
Livingston,7029,1,22,4,10,80,48,32,70
Albion,7029,2,18,6,12,55,45,10,60
Alloa,7029,3,16,8,12,65,47,18,56
Airdrieon,7029,4,16,7,13,50,54,-4,55
Peterhead,7029,5,14,7,15,57,64,-7,49
Stranraer,7029,6,14,6,16,50,59,-9,48
East Fife,7029,7,13,7,16,58,56,2,46
Brechin,7029,8,13,6,17,41,44,-3,45
Queen's Park,7029,9,12,8,16,40,48,-8,44
Stenhousem'r,7029,10,8,9,19,50,81,-31,33
Livingston,7030,1,23,4,9,77,45,32,73
Alloa,7030,2,19,6,11,72,49,23,63
Airdrieon,7030,3,15,11,10,59,50,9,56
Brechin,7030,4,16,7,13,45,47,-2,55
Peterhead,7030,5,15,7,14,49,58,-9,52
Albion,7030,6,13,10,13,44,52,-8,49
East Fife,7030,7,12,11,13,58,49,9,47
Stranraer,7030,8,12,8,16,45,52,-7,44
Queen's Park,7030,9,12,5,19,27,42,-15,41
Stenhousem'r,7030,10,6,5,25,41,73,-32,23
Livingston,7031,1,23,4,9,79,42,37,73
Brechin,7031,2,19,5,12,61,44,17,62
Airdrieon,7031,3,18,7,11,58,46,12,61
Alloa,7031,4,15,7,14,58,47,11,52
Albion,7031,5,14,8,14,52,62,-10,50
Peterhead,7031,6,12,10,14,46,52,-6,46
Queen's Park,7031,7,12,9,15,40,50,-10,45
East Fife,7031,8,12,7,17,50,60,-10,43
Stranraer,7031,9,12,4,20,47,58,-11,40
Stenhousem'r,7031,10,8,9,19,47,77,-30,33
Alloa,7032,1,21,7,8,73,44,29,70
Livingston,7032,2,20,5,11,68,54,14,65
Airdrieon,7032,3,17,6,13,53,52,1,57
Queen's Park,7032,4,16,7,13,43,47,-4,55
Albion,7032,5,15,9,12,65,51,14,54
Brechin,7032,6,17,2,17,49,48,1,53
Peterhead,7032,7,12,10,14,52,54,-2,46
Stranraer,7032,8,11,8,17,50,64,-14,41
East Fife,7032,9,10,8,18,49,49,0,38
Stenhousem'r,7032,10,6,8,22,41,80,-39,26
Alloa,7033,1,22,6,8,75,43,32,72
Livingston,7033,2,19,4,13,67,51,16,61
Albion,7033,3,16,6,14,59,53,6,54
Airdrieon,7033,4,15,8,13,53,52,1,53
East Fife,7033,5,15,7,14,50,45,5,52
Stranraer,7033,6,14,8,14,56,51,5,50
Brechin,7033,7,13,7,16,48,58,-10,46
Queen's Park,7033,8,13,6,17,43,51,-8,45
Peterhead,7033,9,12,5,19,46,64,-18,41
Stenhousem'r,7033,10,9,7,20,41,70,-29,34
Livingston,7034,1,21,4,11,68,48,20,67
Alloa,7034,2,18,8,10,75,48,27,62
Peterhead,7034,3,17,8,11,51,43,8,59
Airdrieon,7034,4,16,9,11,54,49,5,57
Albion,7034,5,15,9,12,62,55,7,54
Queen's Park,7034,6,13,8,15,42,46,-4,47
Brechin,7034,7,13,5,18,48,60,-12,44
Stranraer,7034,8,13,5,18,47,59,-12,44
East Fife,7034,9,11,9,16,49,45,4,42
Stenhousem'r,7034,10,6,9,21,45,88,-43,27
Alloa,7035,1,18,8,10,66,43,23,62
Livingston,7035,2,19,5,12,72,54,18,62
Airdrieon,7035,3,18,8,10,54,46,8,62
Brechin,7035,4,17,7,12,50,41,9,58
Queen's Park,7035,5,13,9,14,42,47,-5,48
East Fife,7035,6,13,8,15,45,41,4,47
Peterhead,7035,7,13,7,16,44,53,-9,46
Stranraer,7035,8,11,11,14,47,49,-2,44
Albion,7035,9,11,8,17,40,54,-14,41
Stenhousem'r,7035,10,8,7,21,40,72,-32,31
Livingston,7036,1,21,7,8,77,43,34,70
Peterhead,7036,2,17,9,10,61,44,17,60
Airdrieon,7036,3,16,8,12,54,54,0,56
East Fife,7036,4,16,6,14,60,54,6,54
Alloa,7036,5,13,10,13,61,56,5,49
Albion,7036,6,13,8,15,50,56,-6,47
Brechin,7036,7,13,7,16,46,51,-5,46
Queen's Park,7036,8,11,9,16,38,52,-14,42
Stranraer,7036,9,12,5,19,46,58,-12,41
Stenhousem'r,7036,10,10,7,19,50,75,-25,37
Livingston,7037,1,24,2,10,78,50,28,74
Alloa,7037,2,21,6,9,76,41,35,69
Peterhead,7037,3,17,6,13,58,52,6,57
Airdrieon,7037,4,17,6,13,54,48,6,57
Albion,7037,5,14,7,15,52,58,-6,49
Brechin,7037,6,14,5,17,52,56,-4,47
East Fife,7037,7,12,8,16,48,50,-2,44
Stranraer,7037,8,13,3,20,51,67,-16,42
Queen's Park,7037,9,10,9,17,33,50,-17,39
Stenhousem'r,7037,10,9,6,21,57,87,-30,33
Livingston,7038,1,22,6,8,79,45,34,72
Airdrieon,7038,2,18,8,10,72,57,15,62
Alloa,7038,3,18,6,12,72,51,21,60
Brechin,7038,4,15,10,11,50,43,7,55
Queen's Park,7038,5,15,6,15,46,56,-10,51
Peterhead,7038,6,13,11,12,55,57,-2,50
Albion,7038,7,14,7,15,56,55,1,49
East Fife,7038,8,9,11,16,47,57,-10,38
Stranraer,7038,9,10,6,20,50,66,-16,36
Stenhousem'r,7038,10,6,9,21,45,85,-40,27
Livingston,7039,1,20,5,11,72,47,25,65
Alloa,7039,2,19,5,12,68,42,26,62
Peterhead,7039,3,16,9,11,49,48,1,57
Airdrieon,7039,4,14,9,13,58,60,-2,51
Albion,7039,5,14,9,13,53,55,-2,51
Queen's Park,7039,6,15,6,15,43,49,-6,51
Stranraer,7039,7,15,5,16,56,56,0,50
Brechin,7039,8,15,4,17,45,49,-4,49
East Fife,7039,9,11,7,18,39,48,-9,40
Stenhousem'r,7039,10,8,7,21,56,85,-29,31
Livingston,7040,1,22,3,11,82,46,36,69
Alloa,7040,2,20,8,8,70,42,28,68
Airdrieon,7040,3,19,7,10,74,52,22,64
Albion,7040,4,14,9,13,51,51,0,51
Brechin,7040,5,15,6,15,41,46,-5,51
East Fife,7040,6,13,8,15,49,47,2,47
Stranraer,7040,7,13,6,17,51,63,-12,45
Queen's Park,7040,8,11,8,17,33,56,-23,41
Peterhead,7040,9,9,11,16,39,56,-17,38
Stenhousem'r,7040,10,6,10,20,50,81,-31,28
Alloa,7041,1,21,6,9,71,39,32,69
Brechin,7041,2,17,10,9,52,38,14,61
Livingston,7041,3,17,5,14,67,45,22,56
Peterhead,7041,4,15,9,12,46,43,3,54
Airdrieon,7041,5,16,6,14,61,61,0,54
Albion,7041,6,15,9,12,56,57,-1,54
Stranraer,7041,7,16,3,17,58,65,-7,51
East Fife,7041,8,12,12,12,53,46,7,48
Stenhousem'r,7041,9,7,9,20,45,82,-37,30
Queen's Park,7041,10,5,9,22,28,61,-33,24
Livingston,7042,1,22,4,10,84,43,41,70
Alloa,7042,2,21,6,9,66,38,28,69
Airdrieon,7042,3,19,8,9,66,51,15,65
Brechin,7042,4,18,5,13,53,52,1,59
Queen's Park,7042,5,14,5,17,42,45,-3,47
Peterhead,7042,6,13,8,15,46,57,-11,47
Albion,7042,7,13,7,16,52,58,-6,46
Stranraer,7042,8,12,3,21,45,62,-17,39
East Fife,7042,9,10,7,19,47,61,-14,37
Stenhousem'r,7042,10,8,7,21,51,85,-34,31
Alloa,7043,1,22,7,7,78,44,34,73
Livingston,7043,2,22,6,8,88,46,42,72
Brechin,7043,3,17,4,15,53,45,8,55
Albion,7043,4,16,7,13,57,54,3,55
Airdrieon,7043,5,16,7,13,55,57,-2,55
Stranraer,7043,6,12,9,15,57,62,-5,45
Queen's Park,7043,7,12,8,16,40,59,-19,44
Peterhead,7043,8,11,9,16,45,62,-17,42
East Fife,7043,9,9,8,19,50,57,-7,35
Stenhousem'r,7043,10,7,7,22,40,77,-37,28
Brechin,7044,1,19,8,9,51,34,17,65
Airdrieon,7044,2,17,10,9,69,48,21,61
Livingston,7044,3,17,5,14,61,50,11,56
Queen's Park,7044,4,14,10,12,41,40,1,52
Alloa,7044,5,13,12,11,60,45,15,51
Albion,7044,6,13,10,13,57,50,7,49
Peterhead,7044,7,14,5,17,52,66,-14,47
Stranraer,7044,8,12,7,17,50,64,-14,43
East Fife,7044,9,12,6,18,46,56,-10,42
Stenhousem'r,7044,10,10,5,21,43,77,-34,35
Livingston,7045,1,25,3,8,81,41,40,78
Alloa,7045,2,18,7,11,72,53,19,61
Albion,7045,3,17,6,13,57,42,15,57
Airdrieon,7045,4,15,8,13,58,54,4,53
Brechin,7045,5,16,4,16,46,45,1,52
Queen's Park,7045,6,15,7,14,44,52,-8,52
Peterhead,7045,7,14,5,17,46,68,-22,47
East Fife,7045,8,12,9,15,50,51,-1,45
Stranraer,7045,9,12,2,22,51,63,-12,38
Stenhousem'r,7045,10,7,7,22,44,80,-36,28
Livingston,7046,1,21,5,10,81,55,26,68
Alloa,7046,2,17,8,11,71,45,26,59
Albion,7046,3,14,9,13,55,52,3,51
Queen's Park,7046,4,14,9,13,43,50,-7,51
Brechin,7046,5,14,8,14,45,47,-2,50
East Fife,7046,6,13,10,13,55,45,10,49
Stranraer,7046,7,12,11,13,55,58,-3,47
Peterhead,7046,8,13,7,16,43,55,-12,46
Airdrieon,7046,9,13,6,17,56,68,-12,45
Stenhousem'r,7046,10,8,9,19,47,76,-29,33
Livingston,7047,1,24,3,9,79,42,37,75
Brechin,7047,2,19,8,9,64,41,23,65
Alloa,7047,3,18,7,11,64,43,21,61
Peterhead,7047,4,15,7,14,52,57,-5,52
Albion,7047,5,14,9,13,48,47,1,51
East Fife,7047,6,13,9,14,59,53,6,48
Airdrieon,7047,7,14,5,17,45,52,-7,47
Queen's Park,7047,8,13,5,18,38,57,-19,44
Stranraer,7047,9,9,6,21,37,61,-24,33
Stenhousem'r,7047,10,9,5,22,47,80,-33,32
Livingston,7048,1,21,5,10,70,39,31,68
Brechin,7048,2,18,5,13,51,51,0,59
Alloa,7048,3,17,7,12,69,52,17,58
Albion,7048,4,17,7,12,64,50,14,58
Stranraer,7048,5,15,6,15,56,56,0,51
Airdrieon,7048,6,15,5,16,49,56,-7,50
Queen's Park,7048,7,14,6,16,40,45,-5,48
Peterhead,7048,8,13,6,17,54,59,-5,45
Stenhousem'r,7048,9,10,7,19,43,71,-28,37
East Fife,7048,10,9,8,19,39,56,-17,35
Alloa,7049,1,19,8,9,77,51,26,65
Livingston,7049,2,19,5,12,73,52,21,62
Airdrieon,7049,3,17,8,11,62,54,8,59
Brechin,7049,4,18,3,15,60,56,4,57
Albion,7049,5,16,8,12,59,50,9,56
Queen's Park,7049,6,16,7,13,43,46,-3,55
Peterhead,7049,7,13,5,18,43,59,-16,44
Stranraer,7049,8,12,5,19,51,60,-9,41
East Fife,7049,9,8,13,15,45,53,-8,37
Stenhousem'r,7049,10,6,10,20,47,79,-32,28
Alloa,7050,1,18,9,9,57,39,18,63
Airdrieon,7050,2,18,9,9,61,49,12,63
Livingston,7050,3,19,4,13,66,43,23,61
Brechin,7050,4,15,9,12,56,48,8,54
Peterhead,7050,5,15,9,12,49,47,2,54
East Fife,7050,6,12,9,15,47,49,-2,45
Queen's Park,7050,7,12,7,17,30,47,-17,43
Albion,7050,8,9,13,14,43,51,-8,40
Stranraer,7050,9,10,9,17,44,54,-10,39
Stenhousem'r,7050,10,8,10,18,48,74,-26,34
Airdrieon,7051,1,18,6,12,55,44,11,60
Livingston,7051,2,18,5,13,76,57,19,59
Albion,7051,3,18,5,13,69,54,15,59
Alloa,7051,4,15,11,10,62,45,17,56
Brechin,7051,5,16,6,14,53,42,11,54
Peterhead,7051,6,14,10,12,50,52,-2,52
Queen's Park,7051,7,15,6,15,41,54,-13,51
Stranraer,7051,8,12,10,14,41,48,-7,46
East Fife,7051,9,9,10,17,40,49,-9,37
Stenhousem'r,7051,10,8,5,23,43,85,-42,29
Alloa,7052,1,20,7,9,82,47,35,67
Airdrieon,7052,2,20,6,10,64,50,14,66
Livingston,7052,3,19,6,11,72,57,15,63
Brechin,7052,4,16,6,14,48,45,3,54
Albion,7052,5,13,9,14,51,57,-6,48
Peterhead,7052,6,14,4,18,43,57,-14,46
East Fife,7052,7,11,11,14,52,50,2,44
Stranraer,7052,8,13,5,18,52,59,-7,44
Stenhousem'r,7052,9,10,7,19,57,78,-21,37
Queen's Park,7052,10,10,7,19,40,61,-21,37
Alloa,7053,1,20,8,8,79,48,31,68
Livingston,7053,2,18,7,11,70,50,20,61
Airdrieon,7053,3,18,5,13,64,56,8,59
Peterhead,7053,4,16,8,12,47,49,-2,56
Brechin,7053,5,16,6,14,54,53,1,54
Albion,7053,6,13,9,14,55,52,3,48
Stranraer,7053,7,13,6,17,59,58,1,45
East Fife,7053,8,11,10,15,51,53,-2,43
Queen's Park,7053,9,9,8,19,30,54,-24,35
Stenhousem'r,7053,10,9,7,20,43,79,-36,34
Airdrieon,7054,1,16,14,6,53,36,17,62
Brechin,7054,2,18,4,14,50,47,3,58
Livingston,7054,3,17,6,13,74,49,25,57
Alloa,7054,4,16,7,13,58,40,18,55
Stranraer,7054,5,16,6,14,58,62,-4,54
Albion,7054,6,14,7,15,53,51,2,49
Queen's Park,7054,7,14,7,15,37,51,-14,49
Peterhead,7054,8,13,9,14,41,57,-16,48
East Fife,7054,9,11,13,12,55,50,5,46
Stenhousem'r,7054,10,4,9,23,44,80,-36,21
Livingston,7055,1,25,2,9,87,45,42,77
Alloa,7055,2,17,6,13,66,48,18,57
Airdrieon,7055,3,16,9,11,56,49,7,57
Brechin,7055,4,15,8,13,49,50,-1,53
Albion,7055,5,15,5,16,53,55,-2,50
Peterhead,7055,6,14,7,15,49,59,-10,49
Stranraer,7055,7,13,8,15,53,56,-3,47
Queen's Park,7055,8,13,5,18,41,56,-15,44
East Fife,7055,9,10,10,16,43,49,-6,40
Stenhousem'r,7055,10,9,6,21,48,78,-30,33
Alloa,7056,1,20,7,9,74,45,29,67
Livingston,7056,2,20,2,14,72,61,11,62
Stranraer,7056,3,18,3,15,60,58,2,57
Airdrieon,7056,4,18,3,15,60,60,0,57
Brechin,7056,5,16,6,14,54,45,9,54
Albion,7056,6,13,10,13,53,51,2,49
Peterhead,7056,7,14,7,15,45,47,-2,49
East Fife,7056,8,12,9,15,48,46,2,45
Queen's Park,7056,9,12,6,18,39,55,-16,42
Stenhousem'r,7056,10,7,7,22,46,83,-37,28
Livingston,7057,1,25,3,8,86,36,50,78
Airdrieon,7057,2,17,8,11,63,51,12,59
Alloa,7057,3,15,12,9,69,55,14,57
Queen's Park,7057,4,17,6,13,41,48,-7,57
Brechin,7057,5,14,11,11,49,45,4,53
Albion,7057,6,13,8,15,54,53,1,47
Peterhead,7057,7,11,8,17,50,62,-12,41
East Fife,7057,8,10,10,16,53,58,-5,40
Stranraer,7057,9,9,11,16,47,64,-17,38
Stenhousem'r,7057,10,7,7,22,39,79,-40,28
Alloa,7058,1,20,8,8,73,43,30,68
Livingston,7058,2,19,7,10,70,47,23,64
Peterhead,7058,3,16,9,11,58,46,12,57
Airdrieon,7058,4,17,6,13,49,53,-4,57
Brechin,7058,5,16,7,13,50,44,6,55
Albion,7058,6,12,8,16,55,53,2,44
Stenhousem'r,7058,7,11,8,17,47,75,-28,41
Queen's Park,7058,8,10,10,16,35,51,-16,40
Stranraer,7058,9,11,6,19,49,57,-8,39
East Fife,7058,10,9,9,18,40,57,-17,36
Livingston,7059,1,24,3,9,73,41,32,75
Airdrieon,7059,2,19,4,13,64,50,14,61
Peterhead,7059,3,17,8,11,57,47,10,59
Alloa,7059,4,15,11,10,57,50,7,56
Brechin,7059,5,15,6,15,47,51,-4,51
Queen's Park,7059,6,12,11,13,36,45,-9,47
Albion,7059,7,12,10,14,54,52,2,46
East Fife,7059,8,11,7,18,47,51,-4,40
Stranraer,7059,9,11,4,21,46,68,-22,37
Stenhousem'r,7059,10,8,8,20,45,71,-26,32
Livingston,7060,1,19,8,9,79,53,26,65
Brechin,7060,2,19,8,9,59,41,18,65
Alloa,7060,3,19,6,11,69,38,31,63
Airdrieon,7060,4,17,3,16,63,59,4,54
Stranraer,7060,5,13,7,16,48,57,-9,46
East Fife,7060,6,12,8,16,59,57,2,44
Albion,7060,7,10,12,14,44,49,-5,42
Queen's Park,7060,8,11,9,16,37,51,-14,42
Peterhead,7060,9,12,5,19,49,74,-25,41
Stenhousem'r,7060,10,10,10,16,45,73,-28,40
Alloa,7061,1,20,7,9,68,40,28,67
Livingston,7061,2,20,7,9,77,53,24,67
Brechin,7061,3,21,4,11,70,46,24,67
Airdrieon,7061,4,13,8,15,57,60,-3,47
Albion,7061,5,12,10,14,49,52,-3,46
East Fife,7061,6,11,12,13,51,53,-2,45
Peterhead,7061,7,13,6,17,46,57,-11,45
Queen's Park,7061,8,12,6,18,44,60,-16,42
Stranraer,7061,9,11,6,19,47,62,-15,39
Stenhousem'r,7061,10,9,10,17,50,76,-26,37
Alloa,7062,1,20,8,8,65,38,27,68
Livingston,7062,2,20,6,10,69,47,22,66
Brechin,7062,3,17,10,9,48,36,12,61
Airdrieon,7062,4,17,6,13,67,55,12,57
Albion,7062,5,16,8,12,53,49,4,56
Peterhead,7062,6,12,7,17,46,60,-14,43
Stranraer,7062,7,11,6,19,42,57,-15,39
Queen's Park,7062,8,10,8,18,34,53,-19,38
Stenhousem'r,7062,9,9,11,16,47,69,-22,38
East Fife,7062,10,5,16,15,43,50,-7,31
Livingston,7063,1,22,5,9,69,46,23,71
Brechin,7063,2,17,7,12,52,47,5,58
Alloa,7063,3,16,7,13,66,45,21,55
Airdrieon,7063,4,15,7,14,55,52,3,52
Stranraer,7063,5,14,8,14,55,50,5,50
Queen's Park,7063,6,14,8,14,43,49,-6,50
East Fife,7063,7,11,10,15,46,42,4,43
Albion,7063,8,10,11,15,49,54,-5,41
Peterhead,7063,9,10,11,15,48,64,-16,41
Stenhousem'r,7063,10,9,10,17,52,86,-34,37
Livingston,7064,1,23,6,7,81,38,43,75
Airdrieon,7064,2,19,7,10,63,50,13,64
Brechin,7064,3,17,7,12,59,47,12,58
Alloa,7064,4,15,10,11,59,48,11,55
Albion,7064,5,14,9,13,61,69,-8,51
East Fife,7064,6,11,12,13,49,49,0,45
Peterhead,7064,7,13,6,17,54,59,-5,45
Queen's Park,7064,8,10,9,17,33,53,-20,39
Stranraer,7064,9,9,9,18,48,62,-14,36
Stenhousem'r,7064,10,8,7,21,42,74,-32,31
Alloa,7065,1,21,6,9,75,42,33,69
Livingston,7065,2,20,4,12,76,50,26,64
Albion,7065,3,15,9,12,52,45,7,54
Peterhead,7065,4,16,6,14,46,49,-3,54
Brechin,7065,5,15,7,14,44,45,-1,52
Queen's Park,7065,6,13,11,12,36,43,-7,50
Airdrieon,7065,7,14,6,16,51,56,-5,48
East Fife,7065,8,11,10,15,53,56,-3,43
Stranraer,7065,9,11,7,18,40,49,-9,40
Stenhousem'r,7065,10,6,10,20,47,85,-38,28
Alloa,7066,1,18,9,9,76,38,38,63
Albion,7066,2,18,9,9,55,50,5,63
Livingston,7066,3,18,4,14,63,54,9,58
Airdrieon,7066,4,18,4,14,55,48,7,58
Brechin,7066,5,16,8,12,50,47,3,56
Stranraer,7066,6,15,4,17,51,52,-1,49
Queen's Park,7066,7,12,7,17,33,48,-15,43
Peterhead,7066,8,12,6,18,49,57,-8,42
East Fife,7066,9,11,7,18,45,51,-6,40
Stenhousem'r,7066,10,8,10,18,38,70,-32,34
Livingston,7067,1,24,4,8,81,38,43,76
Stranraer,7067,2,19,7,10,58,46,12,64
Airdrieon,7067,3,18,6,12,54,47,7,60
Alloa,7067,4,17,8,11,78,56,22,59
Brechin,7067,5,16,4,16,46,57,-11,52
Peterhead,7067,6,13,8,15,46,60,-14,47
Albion,7067,7,13,7,16,54,53,1,46
Queen's Park,7067,8,12,5,19,38,59,-21,41
East Fife,7067,9,10,8,18,57,49,8,38
Stenhousem'r,7067,10,5,9,22,35,82,-47,24
Livingston,7068,1,24,4,8,85,50,35,76
Albion,7068,2,16,7,13,52,47,5,55
Brechin,7068,3,16,7,13,49,44,5,55
Alloa,7068,4,15,8,13,59,50,9,53
East Fife,7068,5,13,11,12,50,47,3,50
Airdrieon,7068,6,14,7,15,51,56,-5,49
Peterhead,7068,7,12,9,15,52,54,-2,45
Stranraer,7068,8,11,8,17,51,58,-7,41
Queen's Park,7068,9,10,11,15,35,53,-18,41
Stenhousem'r,7068,10,9,8,19,57,82,-25,35
Livingston,7069,1,21,5,10,73,46,27,68
Alloa,7069,2,16,12,8,61,41,20,60
Brechin,7069,3,14,13,9,50,43,7,55
Peterhead,7069,4,15,9,12,51,50,1,54
Albion,7069,5,14,11,11,55,48,7,53
Airdrieon,7069,6,12,10,14,56,59,-3,46
East Fife,7069,7,11,11,14,59,57,2,44
Stranraer,7069,8,11,11,14,49,51,-2,44
Queen's Park,7069,9,10,8,18,35,59,-24,38
Stenhousem'r,7069,10,7,8,21,52,87,-35,29
Livingston,7070,1,23,3,10,78,40,38,72
Alloa,7070,2,21,7,8,70,35,35,70
Airdrieon,7070,3,17,5,14,52,50,2,56
Albion,7070,4,16,7,13,58,48,10,55
Brechin,7070,5,16,6,14,47,51,-4,54
Peterhead,7070,6,13,8,15,49,50,-1,47
East Fife,7070,7,11,11,14,44,45,-1,44
Stranraer,7070,8,11,7,18,42,59,-17,40
Queen's Park,7070,9,11,7,18,36,56,-20,40
Stenhousem'r,7070,10,6,9,21,43,85,-42,27
Brechin,7071,1,20,7,9,59,41,18,67
Livingston,7071,2,20,6,10,71,47,24,66
Alloa,7071,3,18,6,12,74,47,27,60
Airdrieon,7071,4,17,6,13,59,62,-3,57
East Fife,7071,5,15,9,12,53,44,9,54
Albion,7071,6,13,8,15,48,52,-4,47
Queen's Park,7071,7,13,5,18,38,52,-14,44
Peterhead,7071,8,9,12,15,46,57,-11,39
Stranraer,7071,9,11,5,20,44,62,-18,38
Stenhousem'r,7071,10,8,8,20,51,79,-28,32
Livingston,7072,1,24,4,8,86,48,38,76
Alloa,7072,2,19,9,8,79,47,32,66
Brechin,7072,3,20,5,11,60,48,12,65
Airdrieon,7072,4,16,7,13,59,59,0,55
Albion,7072,5,15,7,14,59,55,4,52
Peterhead,7072,6,13,9,14,57,58,-1,48
East Fife,7072,7,13,8,15,48,47,1,47
Stranraer,7072,8,11,8,17,57,66,-9,41
Queen's Park,7072,9,11,6,19,36,60,-24,39
Stenhousem'r,7072,10,3,7,26,35,88,-53,16
Alloa,7073,1,21,8,7,69,39,30,71
Livingston,7073,2,20,9,7,82,48,34,69
Airdrieon,7073,3,17,7,12,65,47,18,58
Brechin,7073,4,16,8,12,47,48,-1,56
Peterhead,7073,5,12,11,13,49,50,-1,47
Albion,7073,6,10,12,14,45,56,-11,42
Queen's Park,7073,7,11,9,16,37,57,-20,42
East Fife,7073,8,11,7,18,42,53,-11,40
Stranraer,7073,9,12,4,20,50,62,-12,40
Stenhousem'r,7073,10,9,7,20,45,71,-26,34
Livingston,7074,1,20,5,11,76,51,25,65
Alloa,7074,2,19,8,9,66,45,21,65
Brechin,7074,3,19,5,12,59,48,11,62
Peterhead,7074,4,18,6,12,54,48,6,60
Stranraer,7074,5,17,6,13,62,54,8,57
Airdrieon,7074,6,16,7,13,60,54,6,55
Albion,7074,7,14,6,16,58,63,-5,48
Queen's Park,7074,8,9,9,18,34,56,-22,36
East Fife,7074,9,8,8,20,42,59,-17,32
Stenhousem'r,7074,10,7,6,23,51,84,-33,27
Livingston,7075,1,20,5,11,72,47,25,65
Airdrieon,7075,2,19,5,12,70,52,18,62
Albion,7075,3,16,9,11,64,47,17,57
Brechin,7075,4,15,8,13,50,53,-3,53
Peterhead,7075,5,16,4,16,61,61,0,52
Queen's Park,7075,6,15,6,15,47,56,-9,51
Alloa,7075,7,13,9,14,70,61,9,48
East Fife,7075,8,14,6,16,51,48,3,48
Stranraer,7075,9,14,4,18,48,57,-9,46
Stenhousem'r,7075,10,7,6,23,43,94,-51,27
Alloa,7076,1,21,9,6,80,35,45,72
Livingston,7076,2,19,5,12,70,51,19,62
Airdrieon,7076,3,17,9,10,63,48,15,60
Brechin,7076,4,16,4,16,50,59,-9,52
Peterhead,7076,5,13,9,14,49,51,-2,48
Albion,7076,6,13,9,14,59,64,-5,48
East Fife,7076,7,13,8,15,58,53,5,47
Queen's Park,7076,8,11,9,16,42,58,-16,42
Stranraer,7076,9,10,6,20,44,65,-21,36
Stenhousem'r,7076,10,10,6,20,52,83,-31,36
Livingston,7077,1,21,4,11,76,51,25,67
Alloa,7077,2,20,6,10,72,43,29,66
Airdrieon,7077,3,15,12,9,67,51,16,57
Brechin,7077,4,16,9,11,49,51,-2,57
Albion,7077,5,15,6,15,54,52,2,51
Peterhead,7077,6,13,9,14,53,54,-1,48
Queen's Park,7077,7,12,11,13,35,43,-8,47
East Fife,7077,8,10,12,14,55,53,2,42
Stranraer,7077,9,11,9,16,53,67,-14,42
Stenhousem'r,7077,10,4,8,24,43,92,-49,20
Livingston,7078,1,20,6,10,73,44,29,66
Alloa,7078,2,19,7,10,65,47,18,64
Airdrieon,7078,3,18,5,13,52,40,12,59
Albion,7078,4,14,10,12,48,49,-1,52
Stranraer,7078,5,14,7,15,49,52,-3,49
East Fife,7078,6,12,12,12,53,47,6,48
Peterhead,7078,7,13,8,15,42,44,-2,47
Queen's Park,7078,8,13,7,16,39,45,-6,46
Brechin,7078,9,13,5,18,44,49,-5,44
Stenhousem'r,7078,10,6,9,21,37,85,-48,27
Alloa,7079,1,23,5,8,73,41,32,74
Livingston,7079,2,22,3,11,78,52,26,69
Brechin,7079,3,17,7,12,47,45,2,58
Airdrieon,7079,4,15,4,17,56,59,-3,49
Queen's Park,7079,5,14,7,15,34,45,-11,49
East Fife,7079,6,13,8,15,60,56,4,47
Peterhead,7079,7,13,7,16,56,58,-2,46
Albion,7079,8,13,6,17,54,52,2,45
Stranraer,7079,9,11,8,17,34,48,-14,41
Stenhousem'r,7079,10,8,7,21,45,81,-36,31
Alloa,7080,1,22,5,9,81,47,34,71
Livingston,7080,2,21,3,12,74,50,24,66
Albion,7080,3,17,8,11,55,41,14,59
Airdrieon,7080,4,16,5,15,54,60,-6,53
Brechin,7080,5,16,4,16,52,51,1,52
Stranraer,7080,6,15,7,14,55,57,-2,52
Peterhead,7080,7,13,6,17,46,53,-7,45
Queen's Park,7080,8,13,5,18,36,53,-17,44
East Fife,7080,9,9,9,18,47,54,-7,36
Stenhousem'r,7080,10,8,8,20,37,71,-34,32
Alloa,7081,1,21,6,9,72,40,32,69
Livingston,7081,2,21,5,10,75,44,31,68
Airdrieon,7081,3,19,7,10,61,52,9,64
Albion,7081,4,12,14,10,51,45,6,50
East Fife,7081,5,13,11,12,53,48,5,50
Brechin,7081,6,13,10,13,52,56,-4,49
Queen's Park,7081,7,12,6,18,36,50,-14,42
Peterhead,7081,8,10,9,17,40,55,-15,39
Stranraer,7081,9,11,5,20,52,62,-10,38
Stenhousem'r,7081,10,8,7,21,44,84,-40,31
Livingston,7082,1,21,7,8,76,48,28,70
Alloa,7082,2,17,7,12,54,40,14,58
Airdrieon,7082,3,17,5,14,64,55,9,56
Stranraer,7082,4,17,5,14,57,55,2,56
Queen's Park,7082,5,16,7,13,49,46,3,55
East Fife,7082,6,13,11,12,65,47,18,50
Brechin,7082,7,13,7,16,46,56,-10,46
Albion,7082,8,12,7,17,52,59,-7,43
Peterhead,7082,9,12,7,17,39,57,-18,43
Stenhousem'r,7082,10,6,9,21,41,80,-39,27
Brechin,7083,1,22,5,9,53,40,13,71
Airdrieon,7083,2,22,4,10,68,44,24,70
Livingston,7083,3,21,6,9,76,42,34,69
Alloa,7083,4,21,6,9,71,38,33,69
Albion,7083,5,14,6,16,49,55,-6,48
East Fife,7083,6,12,9,15,49,45,4,45
Stranraer,7083,7,12,5,19,45,61,-16,41
Peterhead,7083,8,10,6,20,42,63,-21,36
Queen's Park,7083,9,8,10,18,27,54,-27,34
Stenhousem'r,7083,10,7,5,24,44,82,-38,26
Livingston,7084,1,22,4,10,87,59,28,70
Brechin,7084,2,19,8,9,63,43,20,65
Alloa,7084,3,17,7,12,65,52,13,58
Airdrieon,7084,4,15,8,13,66,62,4,53
Albion,7084,5,13,12,11,54,45,9,51
Peterhead,7084,6,14,8,14,46,56,-10,50
Stranraer,7084,7,13,6,17,49,55,-6,45
East Fife,7084,8,11,8,17,48,49,-1,41
Queen's Park,7084,9,11,8,17,38,53,-15,41
Stenhousem'r,7084,10,7,7,22,39,81,-42,28
Alloa,7085,1,19,12,5,71,44,27,69
Livingston,7085,2,19,5,12,74,51,23,62
Albion,7085,3,17,6,13,61,61,0,57
Peterhead,7085,4,16,6,14,59,57,2,54
Brechin,7085,5,16,4,16,54,58,-4,52
Stranraer,7085,6,12,10,14,58,58,0,46
East Fife,7085,7,13,6,17,49,51,-2,45
Airdrieon,7085,8,13,6,17,52,59,-7,45
Queen's Park,7085,9,12,6,18,39,47,-8,42
Stenhousem'r,7085,10,7,11,18,49,80,-31,32
Livingston,7086,1,19,3,14,74,53,21,60
Peterhead,7086,2,17,9,10,56,44,12,60
Alloa,7086,3,16,8,12,63,52,11,56
Stranraer,7086,4,17,5,14,64,60,4,56
Brechin,7086,5,17,5,14,53,56,-3,56
Albion,7086,6,12,10,14,55,55,0,46
Airdrieon,7086,7,13,5,18,59,65,-6,44
Stenhousem'r,7086,8,11,10,15,53,71,-18,43
East Fife,7086,9,11,9,16,51,52,-1,42
Queen's Park,7086,10,10,10,16,37,57,-20,40
Brechin,7087,1,22,5,9,67,46,21,71
Alloa,7087,2,18,5,13,70,59,11,59
Livingston,7087,3,19,1,16,66,51,15,58
Queen's Park,7087,4,16,5,15,48,52,-4,53
Albion,7087,5,15,7,14,55,48,7,52
Airdrieon,7087,6,16,4,16,53,53,0,52
Peterhead,7087,7,14,8,14,47,53,-6,50
East Fife,7087,8,12,7,17,49,50,-1,43
Stranraer,7087,9,12,5,19,47,58,-11,41
Stenhousem'r,7087,10,9,7,20,51,83,-32,34
Alloa,7088,1,20,11,5,84,47,37,71
Brechin,7088,2,19,7,10,52,43,9,64
Livingston,7088,3,19,4,13,78,57,21,61
Airdrieon,7088,4,16,11,9,68,55,13,59
Peterhead,7088,5,13,13,10,59,54,5,52
East Fife,7088,6,13,9,14,45,44,1,48
Queen's Park,7088,7,14,6,16,47,55,-8,48
Albion,7088,8,10,8,18,46,56,-10,38
Stranraer,7088,9,9,4,23,47,80,-33,31
Stenhousem'r,7088,10,6,9,21,54,89,-35,27
Livingston,7089,1,19,4,13,74,57,17,61
Alloa,7089,2,17,9,10,62,43,19,60
Albion,7089,3,16,10,10,64,49,15,58
Brechin,7089,4,16,7,13,55,43,12,55
Airdrieon,7089,5,17,4,15,53,51,2,55
Stranraer,7089,6,14,7,15,58,62,-4,49
East Fife,7089,7,13,9,14,54,52,2,48
Queen's Park,7089,8,13,7,16,35,48,-13,46
Peterhead,7089,9,11,9,16,45,57,-12,42
Stenhousem'r,7089,10,7,8,21,48,86,-38,29
Alloa,7090,1,21,7,8,74,48,26,70
Airdrieon,7090,2,18,6,12,61,51,10,60
Livingston,7090,3,17,8,11,71,53,18,59
Albion,7090,4,17,6,13,61,49,12,57
Peterhead,7090,5,15,9,12,47,44,3,54
Brechin,7090,6,14,8,14,43,53,-10,50
East Fife,7090,7,12,12,12,62,59,3,48
Queen's Park,7090,8,12,7,17,41,49,-8,43
Stranraer,7090,9,10,6,20,47,63,-16,36
Stenhousem'r,7090,10,6,7,23,41,79,-38,25
Livingston,7091,1,19,7,10,79,55,24,64
Airdrieon,7091,2,20,4,12,72,52,20,64
Alloa,7091,3,15,11,10,65,46,19,56
Albion,7091,4,17,5,14,57,59,-2,56
Brechin,7091,5,16,7,13,52,52,0,55
Queen's Park,7091,6,12,9,15,40,47,-7,45
Peterhead,7091,7,12,8,16,47,55,-8,44
East Fife,7091,8,12,7,17,43,59,-16,43
Stranraer,7091,9,11,6,19,42,56,-14,39
Stenhousem'r,7091,10,9,10,17,48,64,-16,37
Livingston,7092,1,20,5,11,79,51,28,65
Alloa,7092,2,18,6,12,68,42,26,60
Airdrieon,7092,3,16,7,13,51,51,0,55
East Fife,7092,4,14,10,12,57,44,13,52
Brechin,7092,5,15,7,14,55,52,3,52
Peterhead,7092,6,13,11,12,51,47,4,50
Stranraer,7092,7,15,4,17,57,63,-6,49
Albion,7092,8,13,6,17,42,51,-9,45
Queen's Park,7092,9,13,5,18,35,55,-20,44
Stenhousem'r,7092,10,9,7,20,43,82,-39,34
Livingston,7093,1,20,8,8,75,45,30,68
Airdrieon,7093,2,16,8,12,56,53,3,56
Peterhead,7093,3,16,7,13,53,55,-2,55
Alloa,7093,4,16,5,15,63,56,7,53
Albion,7093,5,12,12,12,53,50,3,48
Brechin,7093,6,13,8,15,49,55,-6,47
Queen's Park,7093,7,12,8,16,43,54,-11,44
Stenhousem'r,7093,8,12,8,16,57,74,-17,44
Stranraer,7093,9,12,7,17,53,54,-1,43
East Fife,7093,10,10,11,15,41,47,-6,41
Livingston,7094,1,24,5,7,81,44,37,77
Alloa,7094,2,18,8,10,74,49,25,62
Brechin,7094,3,16,7,13,54,52,2,55
Airdrieon,7094,4,14,11,11,52,50,2,53
Queen's Park,7094,5,15,7,14,42,48,-6,52
East Fife,7094,6,12,12,12,54,45,9,48
Stranraer,7094,7,14,5,17,54,65,-11,47
Peterhead,7094,8,10,13,13,41,50,-9,43
Albion,7094,9,11,8,17,56,58,-2,41
Stenhousem'r,7094,10,4,8,24,41,88,-47,20
Alloa,7095,1,21,5,10,78,42,36,68
Livingston,7095,2,19,7,10,75,51,24,64
Albion,7095,3,18,7,11,56,42,14,61
Airdrieon,7095,4,16,7,13,54,55,-1,55
Peterhead,7095,5,16,6,14,55,52,3,54
Brechin,7095,6,14,7,15,48,53,-5,49
East Fife,7095,7,12,10,14,49,49,0,46
Stranraer,7095,8,11,6,19,47,65,-18,39
Stenhousem'r,7095,9,10,7,19,49,73,-24,37
Queen's Park,7095,10,10,4,22,36,65,-29,34
Livingston,7096,1,22,2,12,67,45,22,68
Brechin,7096,2,17,9,10,55,51,4,60
Alloa,7096,3,16,9,11,67,50,17,57
Queen's Park,7096,4,17,6,13,41,42,-1,57
Airdrieon,7096,5,14,9,13,56,55,1,51
Stranraer,7096,6,12,10,14,55,56,-1,46
East Fife,7096,7,12,8,16,48,45,3,44
Albion,7096,8,11,11,14,50,56,-6,44
Peterhead,7096,9,11,10,15,56,62,-6,43
Stenhousem'r,7096,10,7,8,21,50,83,-33,29
Alloa,7097,1,22,4,10,72,41,31,70
Livingston,7097,2,20,5,11,74,45,29,65
Airdrieon,7097,3,19,8,9,59,47,12,65
Queen's Park,7097,4,17,6,13,38,39,-1,57
Stranraer,7097,5,14,6,16,54,65,-11,48
Albion,7097,6,13,5,18,49,64,-15,44
East Fife,7097,7,11,10,15,49,55,-6,43
Peterhead,7097,8,10,10,16,40,47,-7,40
Brechin,7097,9,11,5,20,41,50,-9,38
Stenhousem'r,7097,10,9,9,18,47,70,-23,36
Alloa,7098,1,20,10,6,70,39,31,70
Livingston,7098,2,18,9,9,77,48,29,63
Airdrieon,7098,3,18,9,9,67,50,17,63
Albion,7098,4,15,8,13,46,50,-4,53
Brechin,7098,5,14,10,12,44,37,7,52
Peterhead,7098,6,13,9,14,49,50,-1,48
Stranraer,7098,7,12,8,16,48,60,-12,44
Queen's Park,7098,8,10,10,16,34,51,-17,40
East Fife,7098,9,8,13,15,46,52,-6,37
Stenhousem'r,7098,10,5,8,23,36,80,-44,23
Airdrieon,7099,1,19,7,10,64,50,14,64
Brechin,7099,2,19,6,11,57,43,14,63
Livingston,7099,3,17,7,12,66,47,19,58
Alloa,7099,4,16,8,12,66,50,16,56
Peterhead,7099,5,14,7,15,45,47,-2,49
Stranraer,7099,6,14,6,16,50,56,-6,48
East Fife,7099,7,10,13,13,48,49,-1,43
Queen's Park,7099,8,11,10,15,34,52,-18,43
Albion,7099,9,11,7,18,54,63,-9,40
Stenhousem'r,7099,10,8,11,17,52,79,-27,35
Alloa,7100,1,21,7,8,69,40,29,70
Livingston,7100,2,21,5,10,78,47,31,68
Airdrieon,7100,3,18,6,12,66,66,0,60
Brechin,7100,4,16,8,12,60,47,13,56
Queen's Park,7100,5,16,3,17,51,58,-7,51
Albion,7100,6,14,8,14,51,47,4,50
Stranraer,7100,7,13,7,16,48,58,-10,46
Peterhead,7100,8,13,7,16,41,55,-14,46
East Fife,7100,9,9,9,18,48,51,-3,36
Stenhousem'r,7100,10,5,8,23,38,81,-43,23
Livingston,7101,1,22,6,8,74,45,29,72
Alloa,7101,2,19,8,9,65,45,20,65
Airdrieon,7101,3,17,10,9,61,53,8,61
Peterhead,7101,4,13,10,13,62,61,1,49
Brechin,7101,5,14,6,16,58,56,2,48
Albion,7101,6,13,7,16,56,62,-6,46
Queen's Park,7101,7,13,6,17,38,49,-11,45
Stranraer,7101,8,12,8,16,50,55,-5,44
Stenhousem'r,7101,9,12,6,18,51,73,-22,42
East Fife,7101,10,7,9,20,40,56,-16,30
Livingston,7102,1,23,4,9,76,40,36,73
Alloa,7102,2,17,10,9,69,45,24,61
Albion,7102,3,17,6,13,60,53,7,57
Airdrieon,7102,4,14,8,14,53,51,2,50
Stranraer,7102,5,14,7,15,51,55,-4,49
East Fife,7102,6,14,6,16,51,49,2,48
Queen's Park,7102,7,14,5,17,37,54,-17,47
Peterhead,7102,8,12,9,15,44,50,-6,45
Brechin,7102,9,12,5,19,39,50,-11,41
Stenhousem'r,7102,10,11,4,21,50,83,-33,37
Livingston,7103,1,24,5,7,76,41,35,77
Alloa,7103,2,18,8,10,71,44,27,62
Airdrieon,7103,3,17,7,12,60,51,9,58
Peterhead,7103,4,17,6,13,54,48,6,57
Brechin,7103,5,16,5,15,53,60,-7,53
Albion,7103,6,15,6,15,57,56,1,51
East Fife,7103,7,11,9,16,45,43,2,42
Queen's Park,7103,8,11,8,17,40,55,-15,41
Stenhousem'r,7103,9,10,4,22,48,84,-36,34
Stranraer,7103,10,8,8,20,42,64,-22,32
Alloa,7104,1,19,9,8,63,34,29,66
Livingston,7104,2,20,6,10,68,48,20,66
Airdrieon,7104,3,19,8,9,62,44,18,65
Stranraer,7104,4,16,5,15,51,51,0,53
Brechin,7104,5,14,9,13,44,52,-8,51
Albion,7104,6,12,13,11,53,46,7,49
Queen's Park,7104,7,13,8,15,42,52,-10,47
Peterhead,7104,8,10,9,17,46,52,-6,39
East Fife,7104,9,10,9,17,39,51,-12,39
Stenhousem'r,7104,10,4,10,22,37,75,-38,22
Livingston,7105,1,22,5,9,75,39,36,71
Alloa,7105,2,19,6,11,65,46,19,63
Brechin,7105,3,16,7,13,54,49,5,55
Airdrieon,7105,4,15,7,14,51,56,-5,52
Stranraer,7105,5,15,5,16,59,61,-2,50
Albion,7105,6,13,9,14,50,52,-2,48
East Fife,7105,7,10,14,12,48,47,1,44
Peterhead,7105,8,12,8,16,41,52,-11,44
Queen's Park,7105,9,11,9,16,44,54,-10,42
Stenhousem'r,7105,10,8,8,20,46,77,-31,32
Alloa,7106,1,23,5,8,78,44,34,74
Airdrieon,7106,2,17,8,11,58,54,4,59
Livingston,7106,3,15,9,12,68,57,11,54
East Fife,7106,4,15,7,14,57,50,7,52
Albion,7106,5,13,10,13,54,54,0,49
Brechin,7106,6,13,6,17,54,52,2,45
Peterhead,7106,7,12,9,15,50,52,-2,45
Queen's Park,7106,8,9,14,13,37,51,-14,41
Stranraer,7106,9,11,7,18,47,63,-16,40
Stenhousem'r,7106,10,10,9,17,51,77,-26,39
Livingston,7107,1,24,4,8,85,45,40,76
Alloa,7107,2,19,10,7,67,31,36,67
Peterhead,7107,3,14,11,11,52,46,6,53
Airdrieon,7107,4,14,9,13,60,64,-4,51
Brechin,7107,5,15,5,16,45,47,-2,50
Albion,7107,6,12,12,12,44,49,-5,48
Queen's Park,7107,7,12,9,15,36,47,-11,45
East Fife,7107,8,10,9,17,48,59,-11,39
Stranraer,7107,9,11,6,19,56,71,-15,39
Stenhousem'r,7107,10,7,9,20,52,86,-34,30
Livingston,7108,1,20,5,11,70,42,28,65
Alloa,7108,2,18,8,10,73,44,29,62
Airdrieon,7108,3,18,6,12,58,52,6,60
Brechin,7108,4,17,7,12,51,40,11,58
Peterhead,7108,5,17,7,12,59,55,4,58
East Fife,7108,6,13,9,14,55,46,9,48
Queen's Park,7108,7,14,6,16,32,53,-21,48
Albion,7108,8,10,11,15,49,49,0,41
Stranraer,7108,9,11,4,21,39,63,-24,37
Stenhousem'r,7108,10,7,7,22,37,79,-42,28
Livingston,7109,1,22,3,11,76,49,27,69
Alloa,7109,2,17,9,10,63,41,22,60
East Fife,7109,3,15,8,13,60,47,13,53
Airdrieon,7109,4,13,13,10,46,46,0,52
Brechin,7109,5,15,7,14,45,46,-1,52
Peterhead,7109,6,14,9,13,47,48,-1,51
Stranraer,7109,7,15,6,15,52,55,-3,51
Albion,7109,8,14,6,16,51,48,3,48
Queen's Park,7109,9,13,3,20,39,56,-17,42
Stenhousem'r,7109,10,5,10,21,35,78,-43,25
Livingston,7110,1,23,7,6,79,39,40,76
Alloa,7110,2,20,10,6,83,40,43,70
Airdrieon,7110,3,18,8,10,65,57,8,62
Brechin,7110,4,17,6,13,58,51,7,57
Queen's Park,7110,5,14,10,12,37,43,-6,52
East Fife,7110,6,14,7,15,50,43,7,49
Peterhead,7110,7,14,4,18,46,58,-12,46
Stranraer,7110,8,9,8,19,51,68,-17,35
Albion,7110,9,8,7,21,44,66,-22,31
Stenhousem'r,7110,10,7,5,24,42,90,-48,26
Alloa,7111,1,22,7,7,79,40,39,73
Livingston,7111,2,21,4,11,75,52,23,67
Brechin,7111,3,20,6,10,59,39,20,66
Airdrieon,7111,4,14,10,12,48,53,-5,52
Peterhead,7111,5,14,6,16,47,47,0,48
Albion,7111,6,14,5,17,50,54,-4,47
East Fife,7111,7,12,7,17,47,52,-5,43
Stranraer,7111,8,12,6,18,41,53,-12,42
Queen's Park,7111,9,10,10,16,34,49,-15,40
Stenhousem'r,7111,10,6,9,21,40,81,-41,27
Alloa,7112,1,21,8,7,66,34,32,71
Airdrieon,7112,2,22,4,10,74,45,29,70
Livingston,7112,3,21,4,11,72,42,30,67
Albion,7112,4,16,8,12,57,45,12,56
Brechin,7112,5,16,5,15,56,55,1,53
Peterhead,7112,6,12,8,16,49,58,-9,44
East Fife,7112,7,10,10,16,41,52,-11,40
Queen's Park,7112,8,11,6,19,29,55,-26,39
Stranraer,7112,9,8,11,17,36,57,-21,35
Stenhousem'r,7112,10,6,10,20,43,80,-37,28
Livingston,7113,1,21,5,10,71,48,23,68
Airdrieon,7113,2,17,13,6,60,42,18,64
Brechin,7113,3,19,7,10,53,41,12,64
Alloa,7113,4,13,14,9,66,48,18,53
Peterhead,7113,5,14,10,12,57,57,0,52
East Fife,7113,6,13,10,13,56,44,12,49
Albion,7113,7,13,9,14,55,55,0,48
Stranraer,7113,8,10,5,21,51,72,-21,35
Stenhousem'r,7113,9,8,9,19,53,81,-28,33
Queen's Park,7113,10,6,10,20,29,63,-34,28
Alloa,7114,1,19,8,9,66,46,20,65
Livingston,7114,2,19,6,11,74,51,23,63
Peterhead,7114,3,19,4,13,51,50,1,61
Airdrieon,7114,4,15,9,12,58,50,8,54
Brechin,7114,5,15,5,16,47,55,-8,50
Queen's Park,7114,6,14,6,16,44,47,-3,48
Stranraer,7114,7,13,7,16,54,55,-1,46
Albion,7114,8,12,10,14,53,59,-6,46
East Fife,7114,9,12,8,16,57,54,3,44
Stenhousem'r,7114,10,5,11,20,43,80,-37,26
Alloa,7115,1,18,11,7,66,39,27,65
Livingston,7115,2,19,5,12,71,53,18,62
Brechin,7115,3,15,9,12,46,39,7,54
Stranraer,7115,4,14,8,14,51,49,2,50
Airdrieon,7115,5,14,7,15,50,57,-7,49
Albion,7115,6,12,10,14,47,51,-4,46
Peterhead,7115,7,11,11,14,47,48,-1,44
East Fife,7115,8,11,11,14,47,50,-3,44
Queen's Park,7115,9,12,8,16,29,47,-18,44
Stenhousem'r,7115,10,10,8,18,48,69,-21,38
Livingston,7116,1,22,3,11,73,43,30,69
Airdrieon,7116,2,22,3,11,70,56,14,69
Alloa,7116,3,19,8,9,75,49,26,65
Brechin,7116,4,17,7,12,57,44,13,58
Albion,7116,5,12,11,13,55,54,1,47
Stranraer,7116,6,13,6,17,49,56,-7,45
Peterhead,7116,7,11,11,14,51,59,-8,44
East Fife,7116,8,10,11,15,41,44,-3,41
Queen's Park,7116,9,8,11,17,31,52,-21,35
Stenhousem'r,7116,10,6,9,21,37,82,-45,27
Livingston,7117,1,22,6,8,77,44,33,72
Alloa,7117,2,19,10,7,61,38,23,67
Albion,7117,3,17,10,9,71,54,17,61
Airdrieon,7117,4,14,8,14,60,68,-8,50
Brechin,7117,5,13,9,14,46,50,-4,48
Peterhead,7117,6,11,11,14,47,52,-5,44
East Fife,7117,7,11,10,15,48,60,-12,43
Queen's Park,7117,8,11,7,18,43,56,-13,40
Stranraer,7117,9,10,8,18,48,52,-4,38
Stenhousem'r,7117,10,9,7,20,55,82,-27,34
Alloa,7118,1,20,6,10,72,44,28,66
Livingston,7118,2,19,5,12,76,54,22,62
Brechin,7118,3,18,5,13,49,44,5,59
Albion,7118,4,14,13,9,54,44,10,55
Peterhead,7118,5,14,8,14,47,50,-3,50
Airdrieon,7118,6,14,7,15,54,58,-4,49
Stranraer,7118,7,13,8,15,58,60,-2,47
Queen's Park,7118,8,11,8,17,34,59,-25,41
East Fife,7118,9,9,12,15,42,50,-8,39
Stenhousem'r,7118,10,8,8,20,53,76,-23,32
Alloa,7119,1,20,8,8,67,36,31,68
Livingston,7119,2,19,5,12,78,52,26,62
Brechin,7119,3,16,8,12,48,40,8,56
Albion,7119,4,15,9,12,61,50,11,54
Airdrieon,7119,5,15,9,12,59,54,5,54
Stranraer,7119,6,15,6,15,45,52,-7,51
Peterhead,7119,7,13,7,16,46,52,-6,46
Queen's Park,7119,8,13,5,18,30,54,-24,44
East Fife,7119,9,8,11,17,42,51,-9,35
Stenhousem'r,7119,10,8,8,20,45,80,-35,32
Alloa,7120,1,23,5,8,65,34,31,74
Livingston,7120,2,21,4,11,69,46,23,67
Peterhead,7120,3,17,11,8,64,48,16,62
Airdrieon,7120,4,16,6,14,58,61,-3,54
Brechin,7120,5,15,4,17,48,55,-7,49
Stranraer,7120,6,15,3,18,52,52,0,48
Albion,7120,7,12,6,18,45,63,-18,42
East Fife,7120,8,10,9,17,47,45,2,39
Queen's Park,7120,9,11,6,19,39,50,-11,39
Stenhousem'r,7120,10,10,6,20,54,87,-33,36
Livingston,7121,1,19,7,10,79,53,26,64
Alloa,7121,2,18,9,9,64,44,20,63
Airdrieon,7121,3,17,8,11,61,60,1,59
Albion,7121,4,15,6,15,51,47,4,51
Brechin,7121,5,13,11,12,46,48,-2,50
Queen's Park,7121,6,15,4,17,36,49,-13,49
Stranraer,7121,7,12,7,17,57,62,-5,43
Peterhead,7121,8,11,10,15,53,61,-8,43
East Fife,7121,9,10,12,14,46,47,-1,42
Stenhousem'r,7121,10,7,12,17,49,71,-22,33
Alloa,7122,1,21,8,7,73,40,33,71
Livingston,7122,2,17,8,11,76,57,19,59
Airdrieon,7122,3,18,5,13,56,51,5,59
Brechin,7122,4,17,5,14,52,52,0,56
Peterhead,7122,5,13,8,15,55,61,-6,47
East Fife,7122,6,12,10,14,56,51,5,46
Queen's Park,7122,7,12,8,16,43,53,-10,44
Stranraer,7122,8,12,6,18,54,66,-12,42
Albion,7122,9,11,8,17,44,52,-8,41
Stenhousem'r,7122,10,9,10,17,48,74,-26,37
Livingston,7123,1,23,3,10,79,45,34,72
Alloa,7123,2,18,8,10,75,49,26,62
Brechin,7123,3,19,3,14,61,54,7,60
East Fife,7123,4,17,7,12,56,42,14,58
Queen's Park,7123,5,15,7,14,42,50,-8,52
Airdrieon,7123,6,14,7,15,49,53,-4,49
Stranraer,7123,7,14,6,16,58,61,-3,48
Peterhead,7123,8,11,10,15,49,57,-8,43
Albion,7123,9,9,9,18,46,62,-16,36
Stenhousem'r,7123,10,8,4,24,47,89,-42,28
Airdrieon,7124,1,20,4,12,62,55,7,64
Alloa,7124,2,19,6,11,65,40,25,63
Livingston,7124,3,20,3,13,74,52,22,63
Brechin,7124,4,18,6,12,58,48,10,60
Albion,7124,5,13,12,11,54,43,11,51
Peterhead,7124,6,14,7,15,51,60,-9,49
East Fife,7124,7,13,8,15,50,46,4,47
Stranraer,7124,8,14,3,19,49,60,-11,45
Queen's Park,7124,9,12,5,19,36,58,-22,41
Stenhousem'r,7124,10,6,8,22,36,73,-37,26
Livingston,7125,1,23,4,9,80,41,39,73
Alloa,7125,2,20,7,9,69,40,29,67
Airdrieon,7125,3,16,8,12,56,52,4,56
Albion,7125,4,15,6,15,56,49,7,51
Brechin,7125,5,14,9,13,48,50,-2,51
Peterhead,7125,6,14,5,17,52,59,-7,47
East Fife,7125,7,11,10,15,48,53,-5,43
Stranraer,7125,8,13,4,19,45,62,-17,43
Queen's Park,7125,9,10,8,18,37,53,-16,38
Stenhousem'r,7125,10,9,9,18,43,75,-32,36
Livingston,7126,1,23,4,9,84,48,36,73
Airdrieon,7126,2,17,9,10,62,51,11,60
Alloa,7126,3,18,5,13,73,47,26,59
Peterhead,7126,4,17,6,13,52,46,6,57
Brechin,7126,5,16,5,15,45,51,-6,53
Albion,7126,6,14,9,13,53,45,8,51
Stranraer,7126,7,13,7,16,54,58,-4,46
East Fife,7126,8,11,9,16,49,56,-7,42
Queen's Park,7126,9,9,8,19,31,58,-27,35
Stenhousem'r,7126,10,7,8,21,44,87,-43,29
Alloa,7127,1,19,8,9,68,42,26,65
Livingston,7127,2,20,5,11,73,48,25,65
Brechin,7127,3,19,8,9,56,37,19,65
Airdrieon,7127,4,19,7,10,65,42,23,64
Stranraer,7127,5,14,6,16,55,61,-6,48
Albion,7127,6,13,8,15,55,59,-4,47
Peterhead,7127,7,13,6,17,46,55,-9,45
Queen's Park,7127,8,11,5,20,36,64,-28,38
Stenhousem'r,7127,9,8,10,18,45,77,-32,34
East Fife,7127,10,7,11,18,38,52,-14,32
Alloa,7128,1,21,7,8,67,42,25,70
Livingston,7128,2,19,6,11,74,50,24,63
Albion,7128,3,17,6,13,56,46,10,57
Peterhead,7128,4,14,12,10,52,52,0,54
Brechin,7128,5,16,5,15,51,49,2,53
Airdrieon,7128,6,14,8,14,58,58,0,50
East Fife,7128,7,13,10,13,50,48,2,49
Queen's Park,7128,8,12,9,15,45,55,-10,45
Stranraer,7128,9,12,5,19,56,65,-9,41
Stenhousem'r,7128,10,5,6,25,48,92,-44,21
Brechin,7129,1,17,9,10,53,48,5,60
Alloa,7129,2,17,8,11,78,52,26,59
Peterhead,7129,3,18,5,13,52,48,4,59
Livingston,7129,4,18,3,15,71,55,16,57
Airdrieon,7129,5,17,6,13,67,54,13,57
East Fife,7129,6,16,7,13,60,50,10,55
Albion,7129,7,15,7,14,60,52,8,52
Queen's Park,7129,8,11,9,16,38,60,-22,42
Stranraer,7129,9,11,7,18,45,57,-12,40
Stenhousem'r,7129,10,6,7,23,37,85,-48,25
Livingston,7130,1,20,5,11,70,48,22,65
Alloa,7130,2,17,11,8,68,45,23,62
Albion,7130,3,18,8,10,64,47,17,62
Brechin,7130,4,17,10,9,57,44,13,61
Peterhead,7130,5,17,7,12,52,50,2,58
Airdrieon,7130,6,18,3,15,56,62,-6,57
Stranraer,7130,7,14,3,19,55,58,-3,45
East Fife,7130,8,11,6,19,47,48,-1,39
Queen's Park,7130,9,9,4,23,28,57,-29,31
Stenhousem'r,7130,10,8,5,23,40,78,-38,29
Alloa,7131,1,21,7,8,74,43,31,70
Livingston,7131,2,21,3,12,67,47,20,66
Brechin,7131,3,20,3,13,51,42,9,63
Airdrieon,7131,4,17,8,11,58,49,9,59
Albion,7131,5,15,7,14,55,56,-1,52
Stranraer,7131,6,14,7,15,58,52,6,49
Peterhead,7131,7,13,5,18,44,55,-11,44
Queen's Park,7131,8,11,5,20,38,61,-23,38
East Fife,7131,9,9,8,19,40,51,-11,35
Stenhousem'r,7131,10,10,5,21,43,72,-29,35
Alloa,7132,1,20,9,7,68,41,27,69
Livingston,7132,2,18,8,10,65,46,19,62
Brechin,7132,3,17,9,10,60,44,16,60
Airdrieon,7132,4,16,8,12,52,50,2,56
Stranraer,7132,5,15,6,15,52,51,1,51
Albion,7132,6,13,6,17,48,52,-4,45
Peterhead,7132,7,12,9,15,45,51,-6,45
Queen's Park,7132,8,13,6,17,38,55,-17,45
East Fife,7132,9,9,10,17,47,57,-10,37
Stenhousem'r,7132,10,6,11,19,47,75,-28,29
Airdrieon,7133,1,22,7,7,66,41,25,73
Livingston,7133,2,22,5,9,73,44,29,71
Alloa,7133,3,18,9,9,72,48,24,63
Albion,7133,4,14,10,12,63,53,10,52
Peterhead,7133,5,12,9,15,48,60,-12,45
Brechin,7133,6,12,8,16,48,57,-9,44
East Fife,7133,7,11,9,16,56,52,4,42
Queen's Park,7133,8,10,10,16,42,59,-17,40
Stranraer,7133,9,11,4,21,46,67,-21,37
Stenhousem'r,7133,10,9,7,20,46,79,-33,34
Livingston,7134,1,24,2,10,81,48,33,74
Brechin,7134,2,16,9,11,60,53,7,57
Airdrieon,7134,3,16,7,13,64,55,9,55
Alloa,7134,4,14,11,11,70,51,19,53
Peterhead,7134,5,16,5,15,52,54,-2,53
East Fife,7134,6,13,9,14,49,56,-7,48
Albion,7134,7,14,5,17,58,65,-7,47
Queen's Park,7134,8,12,9,15,38,53,-15,45
Stranraer,7134,9,9,11,16,48,57,-9,38
Stenhousem'r,7134,10,9,6,21,52,80,-28,33
Livingston,7135,1,21,4,11,75,53,22,67
Airdrieon,7135,2,19,6,11,59,52,7,63
Brechin,7135,3,17,5,14,46,44,2,56
Alloa,7135,4,16,7,13,66,44,22,55
Albion,7135,5,13,9,14,55,49,6,48
East Fife,7135,6,12,11,13,52,48,4,47
Queen's Park,7135,7,13,8,15,38,48,-10,47
Peterhead,7135,8,11,11,14,49,56,-7,44
Stranraer,7135,9,10,11,15,49,62,-13,41
Stenhousem'r,7135,10,9,6,21,51,84,-33,33
Alloa,7136,1,23,8,5,69,37,32,77
Livingston,7136,2,23,0,13,75,47,28,69
Brechin,7136,3,19,7,10,64,54,10,64
Airdrieon,7136,4,15,10,11,60,59,1,55
Queen's Park,7136,5,15,9,12,48,46,2,54
Albion,7136,6,13,7,16,51,53,-2,46
East Fife,7136,7,10,7,19,46,52,-6,37
Stenhousem'r,7136,8,10,6,20,46,72,-26,36
Stranraer,7136,9,10,5,21,50,64,-14,35
Peterhead,7136,10,8,9,19,45,70,-25,33
Livingston,7137,1,22,4,10,79,47,32,70
Airdrieon,7137,2,19,7,10,70,51,19,64
Alloa,7137,3,18,9,9,73,54,19,63
Queen's Park,7137,4,16,8,12,40,41,-1,56
East Fife,7137,5,13,10,13,50,40,10,49
Albion,7137,6,12,8,16,58,58,0,44
Brechin,7137,7,12,8,16,46,50,-4,44
Peterhead,7137,8,11,10,15,45,56,-11,43
Stenhousem'r,7137,9,7,12,17,44,80,-36,33
Stranraer,7137,10,8,8,20,42,70,-28,32
Brechin,7138,1,20,6,10,57,36,21,66
Alloa,7138,2,18,7,11,67,47,20,61
Albion,7138,3,17,8,11,52,48,4,59
Livingston,7138,4,18,4,14,64,51,13,58
East Fife,7138,5,16,6,14,65,47,18,54
Airdrieon,7138,6,13,10,13,50,52,-2,49
Peterhead,7138,7,13,10,13,49,59,-10,49
Queen's Park,7138,8,11,9,16,36,55,-19,42
Stranraer,7138,9,10,4,22,39,58,-19,34
Stenhousem'r,7138,10,10,4,22,53,79,-26,34
Livingston,7139,1,20,5,11,77,61,16,65
Airdrieon,7139,2,18,10,8,64,41,23,64
Brechin,7139,3,17,7,12,55,48,7,58
Alloa,7139,4,14,10,12,65,48,17,52
Albion,7139,5,13,12,11,56,54,2,51
East Fife,7139,6,12,11,13,49,46,3,47
Queen's Park,7139,7,13,8,15,50,57,-7,47
Stranraer,7139,8,12,8,16,57,62,-5,44
Peterhead,7139,9,11,10,15,45,56,-11,43
Stenhousem'r,7139,10,6,7,23,47,92,-45,25
Livingston,7140,1,22,3,11,86,51,35,69
Alloa,7140,2,19,8,9,73,39,34,65
East Fife,7140,3,15,7,14,60,52,8,52
Stranraer,7140,4,15,7,14,53,53,0,52
Albion,7140,5,15,6,15,55,60,-5,51
Airdrieon,7140,6,14,7,15,48,66,-18,49
Brechin,7140,7,14,6,16,52,56,-4,48
Queen's Park,7140,8,13,7,16,42,48,-6,46
Peterhead,7140,9,11,11,14,48,57,-9,44
Stenhousem'r,7140,10,8,6,22,48,83,-35,30
Livingston,7141,1,20,5,11,73,49,24,65
Airdrieon,7141,2,18,7,11,52,49,3,61
Alloa,7141,3,18,6,12,74,50,24,60
Brechin,7141,4,16,7,13,50,49,1,55
Albion,7141,5,14,7,15,48,56,-8,49
East Fife,7141,6,13,9,14,60,50,10,48
Stranraer,7141,7,13,7,16,56,58,-2,46
Peterhead,7141,8,12,8,16,50,58,-8,44
Stenhousem'r,7141,9,10,8,18,47,71,-24,38
Queen's Park,7141,10,9,10,17,40,60,-20,37
Livingston,7142,1,26,2,8,88,46,42,80
Alloa,7142,2,21,5,10,71,50,21,68
Airdrieon,7142,3,17,9,10,62,50,12,60
Brechin,7142,4,15,8,13,53,45,8,53
Albion,7142,5,15,6,15,60,55,5,51
East Fife,7142,6,14,8,14,51,48,3,50
Peterhead,7142,7,13,7,16,51,62,-11,46
Queen's Park,7142,8,9,10,17,32,48,-16,37
Stranraer,7142,9,11,4,21,50,67,-17,37
Stenhousem'r,7142,10,5,9,22,41,88,-47,24
Brechin,7143,1,21,6,9,64,41,23,69
Alloa,7143,2,19,7,10,65,45,20,64
Livingston,7143,3,19,4,13,78,52,26,61
Albion,7143,4,18,6,12,61,52,9,60
Airdrieon,7143,5,17,6,13,59,57,2,57
Peterhead,7143,6,11,11,14,56,55,1,44
Queen's Park,7143,7,12,6,18,32,50,-18,42
East Fife,7143,8,11,8,17,51,58,-7,41
Stranraer,7143,9,11,5,20,44,66,-22,38
Stenhousem'r,7143,10,6,11,19,42,76,-34,29
Livingston,7144,1,21,7,8,82,49,33,70
Brechin,7144,2,21,5,10,56,46,10,68
Stranraer,7144,3,16,8,12,64,54,10,56
Alloa,7144,4,15,8,13,65,49,16,53
Airdrieon,7144,5,15,8,13,50,53,-3,53
Queen's Park,7144,6,11,11,14,41,52,-11,44
Peterhead,7144,7,11,9,16,38,57,-19,42
Albion,7144,8,10,10,16,55,58,-3,40
East Fife,7144,9,10,10,16,42,47,-5,40
Stenhousem'r,7144,10,9,6,21,49,77,-28,33
Alloa,7145,1,19,8,9,69,42,27,65
Livingston,7145,2,18,7,11,66,48,18,61
Airdrieon,7145,3,16,11,9,64,51,13,59
Stranraer,7145,4,16,7,13,53,49,4,55
Albion,7145,5,14,11,11,50,49,1,53
Brechin,7145,6,13,8,15,42,51,-9,47
East Fife,7145,7,12,10,14,52,47,5,46
Peterhead,7145,8,11,8,17,40,50,-10,41
Queen's Park,7145,9,10,8,18,37,57,-20,38
Stenhousem'r,7145,10,9,6,21,54,83,-29,33
Alloa,7146,1,23,5,8,77,42,35,74
Airdrieon,7146,2,21,7,8,67,45,22,70
Livingston,7146,3,17,5,14,65,55,10,56
Albion,7146,4,13,9,14,49,51,-2,48
Peterhead,7146,5,13,8,15,40,49,-9,47
Stranraer,7146,6,13,7,16,50,59,-9,46
East Fife,7146,7,11,10,15,49,56,-7,43
Queen's Park,7146,8,11,8,17,34,48,-14,41
Brechin,7146,9,11,7,18,42,49,-7,40
Stenhousem'r,7146,10,10,8,18,45,64,-19,38
Livingston,7147,1,24,5,7,80,37,43,77
Alloa,7147,2,17,9,10,67,49,18,60
Queen's Park,7147,3,15,7,14,51,54,-3,52
Brechin,7147,4,15,6,15,59,59,0,51
Airdrieon,7147,5,14,6,16,59,59,0,48
Albion,7147,6,12,11,13,54,50,4,47
Peterhead,7147,7,11,13,12,51,53,-2,46
Stranraer,7147,8,11,11,14,44,54,-10,44
East Fife,7147,9,10,11,15,47,59,-12,41
Stenhousem'r,7147,10,9,5,22,44,82,-38,32
Alloa,7148,1,19,7,10,66,44,22,64
Brechin,7148,2,17,8,11,60,49,11,59
Livingston,7148,3,18,3,15,77,58,19,57
Peterhead,7148,4,15,11,10,61,48,13,56
Airdrieon,7148,5,14,8,14,52,58,-6,50
Albion,7148,6,14,7,15,54,55,-1,49
Queen's Park,7148,7,12,8,16,45,55,-10,44
Stranraer,7148,8,12,7,17,51,61,-10,43
East Fife,7148,9,11,9,16,51,59,-8,42
Stenhousem'r,7148,10,11,6,19,52,82,-30,39
Alloa,7149,1,17,8,11,73,50,23,59
Livingston,7149,2,18,5,13,72,54,18,59
Brechin,7149,3,16,8,12,59,50,9,56
Albion,7149,4,15,8,13,60,57,3,53
Airdrieon,7149,5,15,7,14,52,53,-1,52
Queen's Park,7149,6,14,8,14,47,49,-2,50
Stranraer,7149,7,14,7,15,57,63,-6,49
Peterhead,7149,8,13,7,16,52,61,-9,46
East Fife,7149,9,11,9,16,43,51,-8,42
Stenhousem'r,7149,10,10,7,19,58,85,-27,37
Alloa,7150,1,20,9,7,70,44,26,69
Livingston,7150,2,21,4,11,81,42,39,67
Peterhead,7150,3,16,6,14,50,53,-3,54
Airdrieon,7150,4,14,9,13,55,58,-3,51
Stranraer,7150,5,14,7,15,50,54,-4,49
Albion,7150,6,12,10,14,49,52,-3,46
East Fife,7150,7,12,9,15,52,48,4,45
Brechin,7150,8,11,9,16,40,51,-11,42
Queen's Park,7150,9,11,8,17,38,57,-19,41
Stenhousem'r,7150,10,9,9,18,44,70,-26,36
Alloa,7151,1,22,5,9,70,34,36,71
Livingston,7151,2,22,1,13,74,55,19,67
Brechin,7151,3,20,5,11,55,46,9,65
Airdrieon,7151,4,18,3,15,67,59,8,57
Albion,7151,5,16,6,14,60,54,6,54
Peterhead,7151,6,15,7,14,53,58,-5,52
Queen's Park,7151,7,14,8,14,42,45,-3,50
Stranraer,7151,8,10,8,18,48,67,-19,38
Stenhousem'r,7151,9,8,7,21,50,85,-35,31
East Fife,7151,10,7,6,23,42,58,-16,27
Livingston,7152,1,20,5,11,77,50,27,65
Alloa,7152,2,19,6,11,73,49,24,63
Brechin,7152,3,19,2,15,46,45,1,59
Stranraer,7152,4,15,9,12,52,47,5,54
Peterhead,7152,5,15,7,14,53,55,-2,52
Albion,7152,6,12,13,11,50,51,-1,49
Airdrieon,7152,7,13,7,16,59,64,-5,46
Queen's Park,7152,8,12,5,19,38,50,-12,41
Stenhousem'r,7152,9,12,4,20,50,73,-23,40
East Fife,7152,10,10,8,18,39,53,-14,38
Alloa,7153,1,22,6,8,78,40,38,72
Livingston,7153,2,17,7,12,70,49,21,58
Queen's Park,7153,3,16,8,12,45,46,-1,56
Airdrieon,7153,4,14,9,13,58,54,4,51
Stranraer,7153,5,15,5,16,57,64,-7,50
Albion,7153,6,14,6,16,52,51,1,48
Brechin,7153,7,13,9,14,49,58,-9,48
East Fife,7153,8,11,12,13,53,50,3,45
Peterhead,7153,9,11,12,13,50,60,-10,45
Stenhousem'r,7153,10,6,8,22,42,82,-40,26
Livingston,7154,1,20,6,10,78,47,31,66
Airdrieon,7154,2,18,7,11,62,56,6,61
Alloa,7154,3,17,6,13,72,52,20,57
Brechin,7154,4,17,6,13,48,44,4,57
East Fife,7154,5,17,5,14,50,46,4,56
Queen's Park,7154,6,16,7,13,41,49,-8,55
Stranraer,7154,7,14,6,16,58,55,3,48
Peterhead,7154,8,13,6,17,45,56,-11,45
Albion,7154,9,12,4,20,44,52,-8,40
Stenhousem'r,7154,10,5,9,22,49,90,-41,24
Livingston,7155,1,21,6,9,85,46,39,69
Brechin,7155,2,21,6,9,59,47,12,69
Alloa,7155,3,18,8,10,69,46,23,62
Albion,7155,4,13,9,14,53,49,4,48
Airdrieon,7155,5,13,9,14,60,57,3,48
Queen's Park,7155,6,13,8,15,42,48,-6,47
Peterhead,7155,7,13,8,15,46,54,-8,47
Stranraer,7155,8,12,6,18,49,63,-14,42
East Fife,7155,9,11,8,17,53,61,-8,41
Stenhousem'r,7155,10,7,8,21,47,92,-45,29
Alloa,7156,1,20,3,13,69,44,25,63
Livingston,7156,2,19,5,12,65,50,15,62
East Fife,7156,3,16,10,10,49,38,11,58
Airdrieon,7156,4,17,7,12,59,52,7,58
Albion,7156,5,15,10,11,55,50,5,55
Peterhead,7156,6,16,6,14,40,46,-6,54
Queen's Park,7156,7,12,9,15,43,53,-10,45
Stranraer,7156,8,12,6,18,52,62,-10,42
Brechin,7156,9,11,6,19,45,56,-11,39
Stenhousem'r,7156,10,7,8,21,49,75,-26,29
Alloa,7157,1,22,5,9,75,36,39,71
Livingston,7157,2,19,5,12,81,56,25,62
Brechin,7157,3,17,7,12,53,53,0,58
Airdrieon,7157,4,17,6,13,57,60,-3,57
Albion,7157,5,15,9,12,47,46,1,54
Stranraer,7157,6,15,6,15,54,53,1,51
East Fife,7157,7,13,7,16,63,59,4,46
Peterhead,7157,8,12,5,19,46,58,-12,41
Queen's Park,7157,9,11,6,19,41,63,-22,39
Stenhousem'r,7157,10,9,4,23,53,86,-33,31
Livingston,7158,1,21,6,9,76,39,37,69
Airdrieon,7158,2,17,8,11,65,54,11,59
Alloa,7158,3,17,7,12,68,51,17,58
East Fife,7158,4,16,7,13,54,43,11,55
Brechin,7158,5,15,6,15,51,48,3,51
Albion,7158,6,15,5,16,51,57,-6,50
Stranraer,7158,7,14,6,16,52,63,-11,48
Peterhead,7158,8,11,12,13,48,55,-7,45
Queen's Park,7158,9,12,7,17,33,46,-13,43
Stenhousem'r,7158,10,7,6,23,41,83,-42,27
Airdrieon,7159,1,22,5,9,71,58,13,71
Livingston,7159,2,20,4,12,74,48,26,64
Alloa,7159,3,18,7,11,71,49,22,61
Stranraer,7159,4,15,6,15,61,61,0,51
Brechin,7159,5,15,6,15,47,54,-7,51
Albion,7159,6,13,5,18,48,52,-4,44
Queen's Park,7159,7,12,8,16,41,51,-10,44
East Fife,7159,8,11,10,15,54,57,-3,43
Peterhead,7159,9,12,7,17,47,59,-12,43
Stenhousem'r,7159,10,8,10,18,39,64,-25,34
Alloa,7160,1,21,11,4,82,38,44,74
Livingston,7160,2,19,8,9,74,52,22,65
Airdrieon,7160,3,18,7,11,66,57,9,61
Brechin,7160,4,15,8,13,54,51,3,53
Stranraer,7160,5,16,3,17,56,64,-8,51
Queen's Park,7160,6,10,13,13,48,56,-8,43
Peterhead,7160,7,10,11,15,45,56,-11,41
East Fife,7160,8,10,10,16,52,52,0,40
Albion,7160,9,11,7,18,47,57,-10,40
Stenhousem'r,7160,10,8,6,22,41,82,-41,30
Livingston,7161,1,22,3,11,74,47,27,69
Airdrieon,7161,2,16,10,10,60,51,9,58
Alloa,7161,3,17,7,12,55,46,9,58
Brechin,7161,4,16,7,13,57,50,7,55
Albion,7161,5,13,10,13,55,54,1,49
East Fife,7161,6,12,9,15,52,46,6,45
Queen's Park,7161,7,11,11,14,34,44,-10,44
Stenhousem'r,7161,8,12,7,17,51,69,-18,43
Stranraer,7161,9,10,10,16,48,62,-14,40
Peterhead,7161,10,10,8,18,38,55,-17,38
Livingston,7162,1,23,3,10,84,49,35,72
Alloa,7162,2,18,8,10,74,49,25,62
East Fife,7162,3,15,9,12,49,43,6,54
Brechin,7162,4,17,3,16,54,55,-1,54
Queen's Park,7162,5,15,8,13,40,42,-2,53
Airdrieon,7162,6,15,6,15,57,63,-6,51
Stranraer,7162,7,13,6,17,54,58,-4,45
Albion,7162,8,12,9,15,50,57,-7,45
Peterhead,7162,9,12,8,16,52,65,-13,44
Stenhousem'r,7162,10,5,10,21,44,77,-33,25
Livingston,7163,1,19,8,9,78,46,32,65
Alloa,7163,2,18,10,8,69,43,26,64
Airdrieon,7163,3,17,9,10,58,50,8,60
East Fife,7163,4,13,11,12,60,46,14,50
Stranraer,7163,5,14,8,14,54,57,-3,50
Brechin,7163,6,13,10,13,43,45,-2,49
Albion,7163,7,13,10,13,45,49,-4,49
Peterhead,7163,8,12,7,17,46,59,-13,43
Queen's Park,7163,9,9,11,16,33,55,-22,38
Stenhousem'r,7163,10,6,8,22,45,81,-36,26
Alloa,7164,1,20,8,8,78,50,28,68
Airdrieon,7164,2,20,4,12,57,49,8,64
Peterhead,7164,3,19,6,11,75,49,26,63
Livingston,7164,4,16,9,11,70,53,17,57
Albion,7164,5,15,6,15,54,59,-5,51
Brechin,7164,6,14,8,14,52,50,2,50
Stranraer,7164,7,13,6,17,54,58,-4,45
Queen's Park,7164,8,12,3,21,40,64,-24,39
Stenhousem'r,7164,9,9,8,19,47,82,-35,35
East Fife,7164,10,8,10,18,39,52,-13,34
Livingston,7165,1,22,4,10,70,46,24,70
Alloa,7165,2,19,6,11,69,49,20,63
Brechin,7165,3,17,8,11,56,46,10,59
Airdrieon,7165,4,16,6,14,57,62,-5,54
Albion,7165,5,15,7,14,55,51,4,52
East Fife,7165,6,14,9,13,52,47,5,51
Peterhead,7165,7,15,5,16,60,58,2,50
Stranraer,7165,8,11,7,18,50,57,-7,40
Queen's Park,7165,9,11,6,19,45,65,-20,39
Stenhousem'r,7165,10,7,8,21,46,79,-33,29
Alloa,7166,1,20,8,8,72,43,29,68
Livingston,7166,2,21,3,12,76,53,23,66
Airdrieon,7166,3,18,5,13,56,53,3,59
Peterhead,7166,4,15,9,12,52,47,5,54
Albion,7166,5,14,7,15,49,52,-3,49
Brechin,7166,6,14,5,17,43,54,-11,47
Stranraer,7166,7,13,7,16,52,62,-10,46
Queen's Park,7166,8,12,7,17,41,53,-12,43
East Fife,7166,9,11,7,18,56,57,-1,40
Stenhousem'r,7166,10,8,10,18,49,72,-23,34
Alloa,7167,1,22,7,7,67,37,30,73
Livingston,7167,2,20,4,12,83,49,34,64
Brechin,7167,3,18,6,12,66,57,9,60
Airdrieon,7167,4,17,5,14,56,49,7,56
Peterhead,7167,5,14,9,13,46,47,-1,51
Albion,7167,6,13,11,12,55,58,-3,50
Stranraer,7167,7,14,6,16,52,56,-4,48
East Fife,7167,8,12,7,17,50,49,1,43
Queen's Park,7167,9,10,4,22,29,59,-30,34
Stenhousem'r,7167,10,7,7,22,40,83,-43,28
Airdrieon,7168,1,21,5,10,70,46,24,68
Livingston,7168,2,20,5,11,77,62,15,65
Alloa,7168,3,17,7,12,81,47,34,58
Queen's Park,7168,4,16,7,13,50,51,-1,55
Brechin,7168,5,15,9,12,53,46,7,54
Albion,7168,6,13,9,14,57,58,-1,48
Stranraer,7168,7,12,7,17,51,60,-9,43
East Fife,7168,8,11,10,15,49,59,-10,43
Peterhead,7168,9,11,9,16,44,50,-6,42
Stenhousem'r,7168,10,6,8,22,42,95,-53,26
Airdrieon,7169,1,22,4,10,63,46,17,70
Alloa,7169,2,20,8,8,72,44,28,68
Livingston,7169,3,19,7,10,73,42,31,64
Brechin,7169,4,16,8,12,52,48,4,56
Albion,7169,5,13,8,15,45,46,-1,47
East Fife,7169,6,11,13,12,48,49,-1,46
Queen's Park,7169,7,13,7,16,36,45,-9,46
Stranraer,7169,8,12,5,19,48,62,-14,41
Peterhead,7169,9,7,10,19,37,61,-24,31
Stenhousem'r,7169,10,7,10,19,42,73,-31,31
Alloa,7170,1,23,8,5,82,46,36,77
Livingston,7170,2,18,7,11,70,43,27,61
Airdrieon,7170,3,18,7,11,62,55,7,61
Peterhead,7170,4,14,9,13,51,48,3,51
Brechin,7170,5,15,6,15,50,53,-3,51
Queen's Park,7170,6,13,6,17,41,53,-12,45
Albion,7170,7,11,8,17,46,54,-8,41
Stranraer,7170,8,11,7,18,51,67,-16,40
East Fife,7170,9,10,9,17,51,62,-11,39
Stenhousem'r,7170,10,8,11,17,52,75,-23,35
Livingston,7171,1,21,6,9,71,41,30,69
Airdrieon,7171,2,18,8,10,66,59,7,62
Alloa,7171,3,17,10,9,76,49,27,61
Brechin,7171,4,17,6,13,50,45,5,57
Stranraer,7171,5,15,7,14,59,57,2,52
Peterhead,7171,6,13,9,14,53,59,-6,48
Queen's Park,7171,7,13,5,18,44,61,-17,44
Albion,7171,8,11,7,18,49,63,-14,40
East Fife,7171,9,10,8,18,49,52,-3,38
Stenhousem'r,7171,10,8,8,20,47,78,-31,32
Livingston,7172,1,22,5,9,76,47,29,71
Alloa,7172,2,17,10,9,66,45,21,61
Albion,7172,3,15,9,12,51,51,0,54
Airdrieon,7172,4,16,6,14,56,60,-4,54
Brechin,7172,5,15,8,13,55,45,10,53
Peterhead,7172,6,13,6,17,49,53,-4,45
Stranraer,7172,7,12,8,16,50,52,-2,44
East Fife,7172,8,11,11,14,49,52,-3,44
Queen's Park,7172,9,10,8,18,32,54,-22,38
Stenhousem'r,7172,10,7,13,16,50,75,-25,34
Alloa,7173,1,22,5,9,79,40,39,71
Brechin,7173,2,19,5,12,53,47,6,62
Peterhead,7173,3,18,7,11,59,49,10,61
Livingston,7173,4,18,4,14,73,54,19,58
East Fife,7173,5,14,7,15,47,44,3,49
Airdrieon,7173,6,13,9,14,56,59,-3,48
Queen's Park,7173,7,13,7,16,40,58,-18,46
Albion,7173,8,12,8,16,45,52,-7,44
Stranraer,7173,9,12,5,19,47,59,-12,41
Stenhousem'r,7173,10,6,9,21,37,74,-37,27
Livingston,7174,1,22,5,9,80,45,35,71
Brechin,7174,2,18,5,13,47,41,6,59
Alloa,7174,3,16,9,11,61,46,15,57
Airdrieon,7174,4,17,5,14,56,52,4,56
East Fife,7174,5,15,8,13,56,42,14,53
Peterhead,7174,6,13,10,13,52,55,-3,49
Albion,7174,7,13,7,16,44,51,-7,46
Queen's Park,7174,8,13,7,16,38,51,-13,46
Stranraer,7174,9,11,4,21,43,63,-20,37
Stenhousem'r,7174,10,10,4,22,43,74,-31,34
Alloa,7175,1,19,9,8,65,43,22,66
Airdrieon,7175,2,18,6,12,58,51,7,60
Livingston,7175,3,17,8,11,70,49,21,59
Peterhead,7175,4,17,6,13,52,46,6,57
Queen's Park,7175,5,15,7,14,43,50,-7,52
Albion,7175,6,11,14,11,57,50,7,47
Brechin,7175,7,13,6,17,47,52,-5,45
Stranraer,7175,8,13,3,20,50,63,-13,42
East Fife,7175,9,9,14,13,44,48,-4,41
Stenhousem'r,7175,10,7,9,20,42,76,-34,30
Livingston,7176,1,27,0,9,81,46,35,81
Alloa,7176,2,17,10,9,78,46,32,61
Airdrieon,7176,3,16,10,10,62,51,11,58
Queen's Park,7176,4,16,4,16,44,54,-10,52
Brechin,7176,5,16,4,16,47,59,-12,52
Peterhead,7176,6,14,7,15,45,50,-5,49
Albion,7176,7,14,6,16,58,59,-1,48
Stranraer,7176,8,14,5,17,57,62,-5,47
East Fife,7176,9,12,8,16,66,57,9,44
Stenhousem'r,7176,10,4,6,26,32,86,-54,18
Livingston,7177,1,22,7,7,80,41,39,73
Alloa,7177,2,21,5,10,72,45,27,68
Airdrieon,7177,3,15,8,13,62,55,7,53
Brechin,7177,4,15,5,16,51,58,-7,50
Peterhead,7177,5,12,12,12,46,53,-7,48
Queen's Park,7177,6,14,6,16,37,49,-12,48
Stranraer,7177,7,14,5,17,43,52,-9,47
Albion,7177,8,11,10,15,52,51,1,43
East Fife,7177,9,11,7,18,46,55,-9,40
Stenhousem'r,7177,10,9,7,20,49,79,-30,34
Alloa,7178,1,21,6,9,68,42,26,69
Airdrieon,7178,2,21,5,10,69,51,18,68
Livingston,7178,3,17,7,12,71,56,15,58
Brechin,7178,4,18,3,15,40,43,-3,57
Albion,7178,5,15,8,13,60,53,7,53
Stranraer,7178,6,14,4,18,49,59,-10,46
East Fife,7178,7,12,8,16,54,51,3,44
Peterhead,7178,8,11,7,18,58,65,-7,40
Queen's Park,7178,9,12,4,20,35,57,-22,40
Stenhousem'r,7178,10,8,10,18,47,74,-27,34
Livingston,7179,1,17,9,10,68,48,20,60
Queen's Park,7179,2,18,6,12,50,44,6,60
Brechin,7179,3,16,8,12,49,45,4,56
Peterhead,7179,4,15,9,12,57,54,3,54
Alloa,7179,5,14,10,12,72,55,17,52
Airdrieon,7179,6,14,8,14,51,54,-3,50
Albion,7179,7,13,8,15,48,55,-7,47
Stranraer,7179,8,12,8,16,49,55,-6,44
East Fife,7179,9,9,12,15,45,50,-5,39
Stenhousem'r,7179,10,10,6,20,44,73,-29,36
Alloa,7180,1,22,9,5,79,38,41,75
Livingston,7180,2,21,5,10,77,47,30,68
Airdrieon,7180,3,16,6,14,67,61,6,54
Peterhead,7180,4,15,7,14,52,56,-4,52
Brechin,7180,5,15,5,16,51,55,-4,50
Albion,7180,6,13,7,16,51,58,-7,46
Stranraer,7180,7,13,6,17,49,61,-12,45
Stenhousem'r,7180,8,10,10,16,58,75,-17,40
East Fife,7180,9,10,8,18,47,54,-7,38
Queen's Park,7180,10,8,11,17,34,60,-26,35
Livingston,7181,1,24,3,9,81,45,36,75
Alloa,7181,2,17,9,10,68,41,27,60
Brechin,7181,3,17,4,15,47,50,-3,55
Stranraer,7181,4,15,9,12,47,40,7,54
Airdrieon,7181,5,15,6,15,54,62,-8,51
Queen's Park,7181,6,12,12,12,42,43,-1,48
Albion,7181,7,12,8,16,46,57,-11,44
Stenhousem'r,7181,8,11,8,17,53,72,-19,41
Peterhead,7181,9,10,8,18,47,67,-20,38
East Fife,7181,10,9,9,18,44,52,-8,36
Alloa,7182,1,22,7,7,76,45,31,73
Livingston,7182,2,22,5,9,81,51,30,71
Brechin,7182,3,17,4,15,53,45,8,55
Airdrieon,7182,4,14,8,14,49,54,-5,50
Peterhead,7182,5,12,13,11,46,48,-2,49
Queen's Park,7182,6,14,7,15,43,49,-6,49
East Fife,7182,7,12,8,16,47,46,1,44
Albion,7182,8,11,7,18,45,53,-8,40
Stranraer,7182,9,10,7,19,50,69,-19,37
Stenhousem'r,7182,10,8,10,18,43,73,-30,34
Brechin,7183,1,20,7,9,60,42,18,67
Alloa,7183,2,20,6,10,73,36,37,66
Airdrieon,7183,3,19,7,10,66,50,16,64
Livingston,7183,4,16,6,14,72,57,15,54
Albion,7183,5,14,6,16,48,53,-5,48
East Fife,7183,6,11,13,12,48,48,0,46
Queen's Park,7183,7,13,6,17,35,49,-14,45
Peterhead,7183,8,12,7,17,45,63,-18,43
Stranraer,7183,9,12,4,20,49,67,-18,40
Stenhousem'r,7183,10,8,8,20,45,76,-31,32
Alloa,7184,1,18,10,8,72,43,29,64
Livingston,7184,2,19,5,12,68,51,17,62
Airdrieon,7184,3,15,8,13,53,64,-11,53
Stranraer,7184,4,15,6,15,59,60,-1,51
Brechin,7184,5,14,8,14,50,52,-2,50
Albion,7184,6,14,6,16,61,62,-1,48
Peterhead,7184,7,14,6,16,42,44,-2,48
East Fife,7184,8,11,12,13,49,40,9,45
Queen's Park,7184,9,10,12,14,34,47,-13,42
Stenhousem'r,7184,10,9,9,18,44,69,-25,36
Livingston,7185,1,20,7,9,72,43,29,67
Alloa,7185,2,16,12,8,68,49,19,60
Airdrieon,7185,3,16,11,9,54,47,7,59
Brechin,7185,4,15,7,14,53,50,3,52
Peterhead,7185,5,13,11,12,54,53,1,50
Stranraer,7185,6,14,7,15,53,58,-5,49
Queen's Park,7185,7,13,8,15,38,49,-11,47
East Fife,7185,8,11,11,14,52,50,2,44
Albion,7185,9,10,12,14,50,57,-7,42
Stenhousem'r,7185,10,4,10,22,40,78,-38,22
Livingston,7186,1,21,4,11,84,59,25,67
Airdrieon,7186,2,19,9,8,71,56,15,66
Alloa,7186,3,18,8,10,65,44,21,62
Queen's Park,7186,4,19,4,13,49,50,-1,61
Albion,7186,5,16,5,15,65,53,12,53
Brechin,7186,6,15,8,13,50,44,6,53
Stranraer,7186,7,15,4,17,53,56,-3,49
Peterhead,7186,8,12,7,17,52,68,-16,43
East Fife,7186,9,10,10,16,47,51,-4,40
Stenhousem'r,7186,10,3,5,28,28,83,-55,14
Airdrieon,7187,1,21,8,7,64,36,28,71
Alloa,7187,2,20,7,9,80,43,37,67
Livingston,7187,3,18,10,8,72,47,25,64
Peterhead,7187,4,17,7,12,50,44,6,58
Albion,7187,5,13,10,13,51,51,0,49
Brechin,7187,6,14,7,15,46,47,-1,49
Stranraer,7187,7,12,9,15,45,58,-13,45
Queen's Park,7187,8,11,8,17,32,58,-26,41
East Fife,7187,9,8,9,19,48,59,-11,33
Stenhousem'r,7187,10,6,5,25,42,87,-45,23
Livingston,7188,1,20,7,9,76,45,31,67
Peterhead,7188,2,17,8,11,53,46,7,59
Airdrieon,7188,3,17,7,12,60,47,13,58
Alloa,7188,4,16,8,12,60,38,22,56
Brechin,7188,5,16,6,14,48,52,-4,54
Albion,7188,6,15,8,13,56,50,6,53
Queen's Park,7188,7,13,10,13,36,46,-10,49
East Fife,7188,8,14,5,17,48,51,-3,47
Stranraer,7188,9,11,7,18,51,64,-13,40
Stenhousem'r,7188,10,4,8,24,36,85,-49,20
Alloa,7189,1,22,8,6,73,34,39,74
Livingston,7189,2,23,3,10,78,44,34,72
Airdrieon,7189,3,20,3,13,64,51,13,63
Brechin,7189,4,17,6,13,52,45,7,57
Albion,7189,5,16,8,12,60,44,16,56
Peterhead,7189,6,14,6,16,40,50,-10,48
East Fife,7189,7,13,7,16,39,45,-6,46
Stranraer,7189,8,10,5,21,36,60,-24,35
Queen's Park,7189,9,9,7,20,31,58,-27,34
Stenhousem'r,7189,10,7,5,24,42,84,-42,26
Airdrieon,7190,1,23,4,9,74,53,21,73
Alloa,7190,2,19,8,9,71,46,25,65
Livingston,7190,3,19,8,9,70,54,16,65
Brechin,7190,4,16,5,15,55,51,4,53
Peterhead,7190,5,14,6,16,45,55,-10,48
East Fife,7190,6,11,11,14,51,46,5,44
Albion,7190,7,11,9,16,48,51,-3,42
Stranraer,7190,8,13,3,20,50,61,-11,42
Queen's Park,7190,9,10,8,18,33,50,-17,38
Stenhousem'r,7190,10,10,6,20,43,73,-30,36
Livingston,7191,1,20,5,11,66,42,24,65
Airdrieon,7191,2,19,8,9,62,49,13,65
Alloa,7191,3,18,7,11,71,49,22,61
Brechin,7191,4,16,7,13,57,56,1,55
Stranraer,7191,5,12,10,14,55,56,-1,46
Peterhead,7191,6,11,11,14,46,56,-10,44
Queen's Park,7191,7,11,9,16,37,53,-16,42
East Fife,7191,8,9,12,15,49,46,3,39
Albion,7191,9,9,12,15,42,53,-11,39
Stenhousem'r,7191,10,10,9,17,45,70,-25,39
Alloa,7192,1,22,7,7,84,48,36,73
Livingston,7192,2,20,8,8,80,47,33,68
Airdrieon,7192,3,17,10,9,65,56,9,61
Albion,7192,4,15,8,13,59,59,0,53
Peterhead,7192,5,14,7,15,53,57,-4,49
Brechin,7192,6,13,7,16,57,56,1,46
Stranraer,7192,7,11,9,16,53,58,-5,42
East Fife,7192,8,11,8,17,52,61,-9,41
Queen's Park,7192,9,12,5,19,36,60,-24,41
Stenhousem'r,7192,10,6,9,21,52,89,-37,27
Livingston,7193,1,22,7,7,79,48,31,73
Alloa,7193,2,21,7,8,70,38,32,70
Brechin,7193,3,15,8,13,48,48,0,53
Peterhead,7193,4,15,7,14,53,53,0,52
Stranraer,7193,5,15,5,16,50,56,-6,50
Airdrieon,7193,6,14,7,15,56,62,-6,49
Albion,7193,7,12,12,12,51,50,1,48
East Fife,7193,8,10,11,15,54,56,-2,41
Queen's Park,7193,9,8,9,19,32,51,-19,33
Stenhousem'r,7193,10,9,5,22,47,78,-31,32
Alloa,7194,1,19,6,11,71,47,24,63
Albion,7194,2,19,5,12,65,47,18,62
Livingston,7194,3,18,5,13,67,56,11,59
Airdrieon,7194,4,17,7,12,57,53,4,58
Queen's Park,7194,5,17,5,14,53,49,4,56
Stranraer,7194,6,16,5,15,51,51,0,53
Brechin,7194,7,15,6,15,52,56,-4,51
Peterhead,7194,8,11,10,15,44,51,-7,43
Stenhousem'r,7194,9,8,11,17,49,78,-29,35
East Fife,7194,10,5,10,21,38,59,-21,25
Alloa,7195,1,19,12,5,67,40,27,69
Livingston,7195,2,18,9,9,74,52,22,63
Brechin,7195,3,17,5,14,44,40,4,56
Albion,7195,4,14,9,13,51,49,2,51
Airdrieon,7195,5,14,7,15,58,54,4,49
Peterhead,7195,6,14,7,15,43,49,-6,49
East Fife,7195,7,12,9,15,49,43,6,45
Queen's Park,7195,8,11,10,15,35,52,-17,43
Stranraer,7195,9,10,8,18,45,61,-16,38
Stenhousem'r,7195,10,9,8,19,48,74,-26,35
Livingston,7196,1,22,6,8,77,42,35,72
Alloa,7196,2,18,9,9,71,43,28,63
Airdrieon,7196,3,15,9,12,46,47,-1,54
Albion,7196,4,15,8,13,56,50,6,53
Brechin,7196,5,14,8,14,45,42,3,50
East Fife,7196,6,12,13,11,45,32,13,49
Peterhead,7196,7,13,10,13,48,47,1,49
Queen's Park,7196,8,13,8,15,33,45,-12,47
Stranraer,7196,9,12,3,21,49,70,-21,39
Stenhousem'r,7196,10,4,10,22,39,91,-52,22
Livingston,7197,1,25,1,10,86,50,36,76
Alloa,7197,2,19,8,9,62,44,18,65
Airdrieon,7197,3,20,4,12,65,51,14,64
Brechin,7197,4,19,2,15,69,61,8,59
Queen's Park,7197,5,17,3,16,42,54,-12,54
Stranraer,7197,6,14,3,19,54,60,-6,45
Peterhead,7197,7,13,6,17,49,57,-8,45
East Fife,7197,8,11,8,17,54,56,-2,41
Albion,7197,9,10,11,15,46,55,-9,41
Stenhousem'r,7197,10,6,6,24,45,84,-39,24
Livingston,7198,1,22,7,7,86,46,40,73
Alloa,7198,2,22,7,7,70,40,30,73
Airdrieon,7198,3,19,6,11,60,56,4,63
Albion,7198,4,14,7,15,57,54,3,49
Peterhead,7198,5,14,6,16,46,52,-6,48
Queen's Park,7198,6,12,9,15,37,47,-10,45
East Fife,7198,7,12,6,18,51,53,-2,42
Stranraer,7198,8,12,5,19,52,66,-14,41
Brechin,7198,9,11,8,17,39,56,-17,41
Stenhousem'r,7198,10,8,7,21,43,71,-28,31
Alloa,7199,1,18,9,9,68,40,28,63
Albion,7199,2,17,10,9,55,41,14,61
Livingston,7199,3,17,9,10,68,54,14,60
Stranraer,7199,4,14,7,15,51,53,-2,49
Airdrieon,7199,5,13,9,14,58,54,4,48
Brechin,7199,6,14,6,16,51,56,-5,48
Queen's Park,7199,7,14,5,17,35,48,-13,47
Peterhead,7199,8,13,6,17,41,55,-14,45
East Fife,7199,9,10,10,16,49,54,-5,40
Stenhousem'r,7199,10,9,11,16,51,72,-21,38
Livingston,7200,1,22,6,8,78,45,33,72
Alloa,7200,2,18,6,12,66,42,24,60
Brechin,7200,3,16,7,13,48,45,3,55
Albion,7200,4,15,7,14,63,60,3,52
Airdrieon,7200,5,14,10,12,59,63,-4,52
East Fife,7200,6,14,6,16,61,48,13,48
Stranraer,7200,7,12,11,13,41,45,-4,47
Peterhead,7200,8,13,7,16,48,62,-14,46
Queen's Park,7200,9,9,12,15,34,49,-15,39
Stenhousem'r,7200,10,8,6,22,42,81,-39,30
Livingston,7201,1,21,9,6,75,38,37,72
Alloa,7201,2,18,9,9,69,42,27,63
Brechin,7201,3,17,7,12,52,46,6,58
Airdrieon,7201,4,16,7,13,56,57,-1,55
Peterhead,7201,5,15,6,15,50,52,-2,51
Albion,7201,6,13,9,14,58,62,-4,48
Queen's Park,7201,7,13,8,15,33,41,-8,47
East Fife,7201,8,10,11,15,48,48,0,41
Stranraer,7201,9,11,5,20,49,63,-14,38
Stenhousem'r,7201,10,7,7,22,46,87,-41,28
Alloa,7202,1,19,8,9,63,41,22,65
Livingston,7202,2,17,11,8,69,45,24,62
Albion,7202,3,15,8,13,59,54,5,53
East Fife,7202,4,14,10,12,47,40,7,52
Peterhead,7202,5,14,9,13,49,49,0,51
Queen's Park,7202,6,14,9,13,41,49,-8,51
Airdrieon,7202,7,13,11,12,56,57,-1,50
Brechin,7202,8,12,8,16,38,47,-9,44
Stranraer,7202,9,9,11,16,50,61,-11,38
Stenhousem'r,7202,10,5,11,20,49,78,-29,26
Livingston,7203,1,22,2,12,77,58,19,68
Airdrieon,7203,2,20,6,10,64,42,22,66
Alloa,7203,3,17,6,13,70,51,19,57
Brechin,7203,4,17,6,13,49,49,0,57
Peterhead,7203,5,15,6,15,51,50,1,51
Albion,7203,6,14,8,14,56,55,1,50
Queen's Park,7203,7,11,10,15,40,49,-9,43
East Fife,7203,8,11,8,17,53,54,-1,41
Stenhousem'r,7203,9,10,7,19,42,73,-31,37
Stranraer,7203,10,9,9,18,42,63,-21,36
Livingston,7204,1,23,4,9,90,48,42,73
Alloa,7204,2,21,7,8,71,41,30,70
Brechin,7204,3,17,6,13,64,46,18,57
Albion,7204,4,15,9,12,58,57,1,54
Airdrieon,7204,5,14,10,12,54,53,1,52
East Fife,7204,6,12,11,13,62,53,9,47
Peterhead,7204,7,13,8,15,48,56,-8,47
Queen's Park,7204,8,12,10,14,36,49,-13,46
Stranraer,7204,9,9,8,19,42,63,-21,35
Stenhousem'r,7204,10,4,7,25,30,89,-59,19
Livingston,7205,1,22,3,11,75,53,22,69
Airdrieon,7205,2,19,4,13,61,53,8,61
Peterhead,7205,3,17,8,11,59,44,15,59
Alloa,7205,4,16,10,10,69,48,21,58
Albion,7205,5,16,10,10,62,53,9,58
Brechin,7205,6,15,7,14,54,57,-3,52
East Fife,7205,7,10,11,15,52,50,2,41
Stranraer,7205,8,12,5,19,50,68,-18,41
Queen's Park,7205,9,9,7,20,37,67,-30,34
Stenhousem'r,7205,10,9,5,22,57,83,-26,32
Alloa,7206,1,20,6,10,74,48,26,66
Brechin,7206,2,20,5,11,52,44,8,65
Livingston,7206,3,17,5,14,66,53,13,56
Peterhead,7206,4,16,6,14,53,52,1,54
Stranraer,7206,5,14,8,14,61,57,4,50
Airdrieon,7206,6,15,5,16,56,58,-2,50
East Fife,7206,7,13,8,15,49,52,-3,47
Albion,7206,8,11,12,13,53,52,1,45
Queen's Park,7206,9,11,8,17,33,44,-11,41
Stenhousem'r,7206,10,9,5,22,45,82,-37,32
Livingston,7207,1,23,5,8,80,44,36,74
Alloa,7207,2,19,10,7,65,37,28,67
Albion,7207,3,14,12,10,55,50,5,54
Brechin,7207,4,15,9,12,54,55,-1,54
Peterhead,7207,5,12,8,16,54,62,-8,44
East Fife,7207,6,9,16,11,47,45,2,43
Airdrieon,7207,7,12,7,17,54,68,-14,43
Queen's Park,7207,8,11,7,18,47,56,-9,40
Stenhousem'r,7207,9,10,10,16,52,75,-23,40
Stranraer,7207,10,8,10,18,52,68,-16,34
Brechin,7208,1,22,6,8,62,34,28,72
Livingston,7208,2,20,3,13,70,45,25,63
Albion,7208,3,15,10,11,53,44,9,55
Alloa,7208,4,13,13,10,58,49,9,52
Airdrieon,7208,5,15,7,14,57,53,4,52
Peterhead,7208,6,14,8,14,52,57,-5,50
Queen's Park,7208,7,12,7,17,37,58,-21,43
East Fife,7208,8,11,9,16,48,51,-3,42
Stranraer,7208,9,11,8,17,47,56,-9,41
Stenhousem'r,7208,10,7,9,20,48,85,-37,30
Livingston,7209,1,21,5,10,77,43,34,68
Airdrieon,7209,2,16,7,13,57,62,-5,55
Alloa,7209,3,16,6,14,71,54,17,54
Queen's Park,7209,4,16,6,14,41,47,-6,54
Peterhead,7209,5,15,7,14,47,45,2,52
Brechin,7209,6,14,8,14,47,47,0,50
Stranraer,7209,7,15,5,16,53,60,-7,50
Albion,7209,8,11,11,14,56,60,-4,44
East Fife,7209,9,12,7,17,48,53,-5,43
Stenhousem'r,7209,10,9,8,19,52,78,-26,35
Airdrieon,7210,1,22,5,9,71,44,27,71
Alloa,7210,2,20,7,9,70,42,28,67
Livingston,7210,3,20,5,11,74,44,30,65
Brechin,7210,4,17,6,13,49,49,0,57
Peterhead,7210,5,13,9,14,52,58,-6,48
Stranraer,7210,6,14,5,17,54,60,-6,47
Albion,7210,7,11,8,17,54,59,-5,41
East Fife,7210,8,10,7,19,49,56,-7,37
Queen's Park,7210,9,8,12,16,36,60,-24,36
Stenhousem'r,7210,10,10,6,20,41,78,-37,36
Livingston,7211,1,20,4,12,73,54,19,64
Airdrieon,7211,2,19,6,11,69,50,19,63
Albion,7211,3,13,13,10,54,48,6,52
Peterhead,7211,4,16,3,17,50,56,-6,51
Stranraer,7211,5,14,7,15,54,60,-6,49
Alloa,7211,6,14,6,16,58,54,4,48
Brechin,7211,7,13,9,14,46,47,-1,48
East Fife,7211,8,12,9,15,49,51,-2,45
Queen's Park,7211,9,12,9,15,36,47,-11,45
Stenhousem'r,7211,10,11,6,19,61,83,-22,39
Livingston,7212,1,21,2,13,81,60,21,65
Alloa,7212,2,19,7,10,69,50,19,64
Airdrieon,7212,3,17,6,13,64,62,2,57
Brechin,7212,4,16,8,12,51,47,4,56
East Fife,7212,5,14,10,12,61,47,14,52
Stranraer,7212,6,14,4,18,50,57,-7,46
Peterhead,7212,7,11,10,15,48,55,-7,43
Albion,7212,8,10,12,14,51,55,-4,42
Queen's Park,7212,9,10,10,16,39,58,-19,40
Stenhousem'r,7212,10,11,5,20,47,70,-23,38
Livingston,7213,1,20,5,11,65,38,27,65
Brechin,7213,2,19,4,13,61,54,7,61
Alloa,7213,3,16,9,11,68,52,16,57
Peterhead,7213,4,16,8,12,52,52,0,56
Stranraer,7213,5,15,9,12,56,53,3,54
East Fife,7213,6,14,9,13,58,49,9,51
Airdrieon,7213,7,14,8,14,57,58,-1,50
Albion,7213,8,13,5,18,48,53,-5,44
Queen's Park,7213,9,11,4,21,36,56,-20,37
Stenhousem'r,7213,10,9,5,22,43,79,-36,32
Livingston,7214,1,22,1,13,73,50,23,67
Airdrieon,7214,2,20,5,11,62,52,10,65
Alloa,7214,3,17,10,9,67,47,20,61
Peterhead,7214,4,16,6,14,50,46,4,54
Stranraer,7214,5,15,5,16,56,59,-3,50
Albion,7214,6,12,13,11,60,49,11,49
Brechin,7214,7,14,6,16,51,60,-9,48
East Fife,7214,8,9,13,14,56,52,4,40
Stenhousem'r,7214,9,11,7,18,48,77,-29,40
Queen's Park,7214,10,7,8,21,30,61,-31,29
Alloa,7215,1,23,6,7,78,36,42,75
Livingston,7215,2,18,5,13,75,54,21,59
Airdrieon,7215,3,16,7,13,55,49,6,55
Brechin,7215,4,15,6,15,51,58,-7,51
East Fife,7215,5,13,10,13,48,42,6,49
Queen's Park,7215,6,14,7,15,37,46,-9,49
Peterhead,7215,7,13,9,14,53,54,-1,48
Albion,7215,8,12,9,15,49,56,-7,45
Stranraer,7215,9,12,5,19,38,60,-22,41
Stenhousem'r,7215,10,9,6,21,46,75,-29,33
Livingston,7216,1,22,4,10,78,49,29,70
Airdrieon,7216,2,20,5,11,65,45,20,65
Alloa,7216,3,16,8,12,63,50,13,56
Brechin,7216,4,16,7,13,57,49,8,55
East Fife,7216,5,14,7,15,51,53,-2,49
Peterhead,7216,6,13,9,14,49,52,-3,48
Stranraer,7216,7,15,3,18,47,62,-15,48
Albion,7216,8,12,9,15,62,61,1,45
Queen's Park,7216,9,9,9,18,35,59,-24,36
Stenhousem'r,7216,10,9,7,20,47,74,-27,34
Alloa,7217,1,20,7,9,73,43,30,67
Livingston,7217,2,18,7,11,67,49,18,61
Airdrieon,7217,3,17,7,12,57,50,7,58
Albion,7217,4,15,7,14,59,51,8,52
Brechin,7217,5,15,6,15,39,47,-8,51
Queen's Park,7217,6,15,5,16,40,50,-10,50
Peterhead,7217,7,14,7,15,39,42,-3,49
East Fife,7217,8,12,9,15,51,52,-1,45
Stranraer,7217,9,13,5,18,52,58,-6,44
Stenhousem'r,7217,10,7,8,21,33,68,-35,29
Livingston,7218,1,21,2,13,69,44,25,65
Airdrieon,7218,2,19,6,11,61,44,17,63
Alloa,7218,3,18,7,11,62,47,15,61
Brechin,7218,4,18,5,13,61,48,13,59
Albion,7218,5,17,5,14,66,60,6,56
Stranraer,7218,6,14,7,15,45,53,-8,49
East Fife,7218,7,10,10,16,48,49,-1,40
Stenhousem'r,7218,8,10,8,18,53,71,-18,38
Queen's Park,7218,9,10,8,18,34,56,-22,38
Peterhead,7218,10,10,8,18,40,67,-27,38
Alloa,7219,1,21,6,9,80,41,39,69
Livingston,7219,2,21,2,13,68,42,26,65
Airdrieon,7219,3,19,7,10,54,42,12,64
Brechin,7219,4,18,6,12,51,44,7,60
Queen's Park,7219,5,13,10,13,37,47,-10,49
Stranraer,7219,6,13,7,16,43,48,-5,46
Peterhead,7219,7,12,9,15,48,53,-5,45
East Fife,7219,8,10,8,18,46,57,-11,38
Albion,7219,9,9,11,16,52,73,-21,38
Stenhousem'r,7219,10,7,8,21,41,73,-32,29
Livingston,7220,1,19,7,10,71,52,19,64
Alloa,7220,2,18,7,11,72,48,24,61
Airdrieon,7220,3,17,10,9,62,46,16,61
Albion,7220,4,17,7,12,58,48,10,58
Brechin,7220,5,18,4,14,47,45,2,58
Queen's Park,7220,6,15,7,14,39,43,-4,52
Peterhead,7220,7,14,8,14,52,51,1,50
East Fife,7220,8,10,10,16,52,54,-2,40
Stranraer,7220,9,10,5,21,43,65,-22,35
Stenhousem'r,7220,10,5,9,22,35,79,-44,24
Livingston,7221,1,27,2,7,84,43,41,83
Airdrieon,7221,2,18,9,9,64,49,15,63
Alloa,7221,3,16,11,9,79,48,31,59
Brechin,7221,4,15,8,13,46,41,5,53
Queen's Park,7221,5,12,9,15,38,59,-21,45
East Fife,7221,6,9,17,10,48,44,4,44
Peterhead,7221,7,12,8,16,47,56,-9,44
Albion,7221,8,10,9,17,46,57,-11,39
Stranraer,7221,9,9,9,18,45,64,-19,36
Stenhousem'r,7221,10,7,8,21,49,85,-36,29
Alloa,7222,1,20,8,8,71,40,31,68
Airdrieon,7222,2,19,5,12,74,53,21,62
Livingston,7222,3,17,5,14,67,52,15,56
Queen's Park,7222,4,16,5,15,44,49,-5,53
Brechin,7222,5,15,7,14,45,42,3,52
Albion,7222,6,14,6,16,45,60,-15,48
Peterhead,7222,7,13,8,15,46,53,-7,47
Stranraer,7222,8,12,7,17,49,59,-10,43
East Fife,7222,9,11,8,17,42,54,-12,41
Stenhousem'r,7222,10,10,7,19,44,65,-21,37
Alloa,7223,1,20,7,9,66,37,29,67
Livingston,7223,2,20,3,13,74,51,23,63
Brechin,7223,3,17,8,11,59,49,10,59
Peterhead,7223,4,16,8,12,58,50,8,56
Albion,7223,5,16,8,12,48,43,5,56
Airdrieon,7223,6,15,6,15,55,68,-13,51
Stranraer,7223,7,14,4,18,56,55,1,46
Queen's Park,7223,8,10,11,15,44,62,-18,41
East Fife,7223,9,9,12,15,51,51,0,39
Stenhousem'r,7223,10,6,7,23,44,89,-45,25
Livingston,7224,1,21,5,10,82,50,32,68
Alloa,7224,2,18,10,8,70,43,27,64
Stranraer,7224,3,17,8,11,54,46,8,59
Airdrieon,7224,4,15,11,10,57,50,7,56
Peterhead,7224,5,16,7,13,51,51,0,55
Brechin,7224,6,16,3,17,48,49,-1,51
East Fife,7224,7,11,10,15,48,53,-5,43
Albion,7224,8,10,10,16,48,55,-7,40
Queen's Park,7224,9,10,8,18,36,62,-26,38
Stenhousem'r,7224,10,5,10,21,39,74,-35,25
Alloa,7225,1,21,6,9,79,42,37,69
Livingston,7225,2,19,6,11,73,49,24,63
Airdrieon,7225,3,16,8,12,63,57,6,56
East Fife,7225,4,15,8,13,51,44,7,53
Brechin,7225,5,16,5,15,48,44,4,53
Queen's Park,7225,6,17,2,17,37,53,-16,53
Peterhead,7225,7,12,9,15,46,57,-11,45
Albion,7225,8,12,8,16,50,54,-4,44
Stranraer,7225,9,12,5,19,45,56,-11,41
Stenhousem'r,7225,10,7,9,20,49,85,-36,30
Livingston,7226,1,22,2,12,80,52,28,68
Alloa,7226,2,18,9,9,74,44,30,63
Brechin,7226,3,18,4,14,54,53,1,58
Airdrieon,7226,4,17,6,13,53,54,-1,57
Peterhead,7226,5,15,9,12,51,52,-1,54
Albion,7226,6,15,7,14,55,56,-1,52
Queen's Park,7226,7,14,5,17,39,49,-10,47
East Fife,7226,8,11,7,18,44,45,-1,40
Stranraer,7226,9,9,8,19,41,56,-15,35
Stenhousem'r,7226,10,9,7,20,51,81,-30,34
Livingston,7227,1,26,1,9,86,46,40,79
Alloa,7227,2,19,6,11,76,47,29,63
Peterhead,7227,3,15,7,14,55,55,0,52
Brechin,7227,4,16,4,16,46,52,-6,52
Airdrieon,7227,5,14,9,13,56,61,-5,51
Stranraer,7227,6,14,8,14,60,61,-1,50
Queen's Park,7227,7,14,5,17,40,56,-16,47
East Fife,7227,8,9,12,15,51,52,-1,39
Albion,7227,9,10,9,17,47,56,-9,39
Stenhousem'r,7227,10,10,5,21,54,85,-31,35
Livingston,7228,1,22,5,9,78,50,28,71
Peterhead,7228,2,19,6,11,52,38,14,63
Airdrieon,7228,3,19,5,12,63,53,10,62
Alloa,7228,4,15,11,10,64,48,16,56
Brechin,7228,5,15,6,15,45,51,-6,51
East Fife,7228,6,12,10,14,51,49,2,46
Stenhousem'r,7228,7,11,10,15,53,67,-14,43
Queen's Park,7228,8,11,7,18,37,52,-15,40
Albion,7228,9,8,11,17,42,57,-15,35
Stranraer,7228,10,9,7,20,48,68,-20,34
Livingston,7229,1,21,7,8,82,43,39,70
Alloa,7229,2,18,6,12,76,57,19,60
Peterhead,7229,3,17,8,11,59,50,9,59
Brechin,7229,4,17,7,12,56,47,9,58
Airdrieon,7229,5,15,8,13,64,59,5,53
Albion,7229,6,12,7,17,47,55,-8,43
Queen's Park,7229,7,11,10,15,39,57,-18,43
Stenhousem'r,7229,8,12,6,18,48,76,-28,42
Stranraer,7229,9,11,6,19,44,61,-17,39
East Fife,7229,10,9,9,18,45,55,-10,36
Livingston,7230,1,19,5,12,76,51,25,62
Brechin,7230,2,17,8,11,58,49,9,59
Alloa,7230,3,17,6,13,64,47,17,57
East Fife,7230,4,15,11,10,54,34,20,56
Airdrieon,7230,5,15,9,12,59,58,1,54
Albion,7230,6,15,8,13,61,63,-2,53
Queen's Park,7230,7,14,10,12,46,50,-4,52
Stranraer,7230,8,12,6,18,51,68,-17,42
Peterhead,7230,9,8,9,19,50,68,-18,33
Stenhousem'r,7230,10,7,10,19,46,77,-31,31
Livingston,7231,1,23,4,9,81,43,38,73
Alloa,7231,2,18,5,13,67,48,19,59
Brechin,7231,3,16,10,10,46,43,3,58
Airdrieon,7231,4,14,11,11,66,57,9,53
Stranraer,7231,5,13,10,13,50,56,-6,49
Albion,7231,6,11,14,11,55,54,1,47
Queen's Park,7231,7,12,7,17,37,52,-15,43
Peterhead,7231,8,11,9,16,50,58,-8,42
East Fife,7231,9,8,13,15,43,50,-7,37
Stenhousem'r,7231,10,7,11,18,40,74,-34,32
Alloa,7232,1,19,7,10,75,48,27,64
Livingston,7232,2,18,9,9,71,46,25,63
Airdrieon,7232,3,18,8,10,69,58,11,62
Brechin,7232,4,17,8,11,59,50,9,59
Peterhead,7232,5,14,9,13,58,55,3,51
Albion,7232,6,14,7,15,51,57,-6,49
Stranraer,7232,7,13,7,16,47,51,-4,46
Queen's Park,7232,8,12,8,16,41,53,-12,44
East Fife,7232,9,11,5,20,46,60,-14,38
Stenhousem'r,7232,10,6,8,22,44,83,-39,26
Livingston,7233,1,22,5,9,77,43,34,71
Airdrieon,7233,2,19,9,8,65,46,19,66
Brechin,7233,3,18,7,11,55,47,8,61
Alloa,7233,4,14,9,13,61,52,9,51
Albion,7233,5,14,9,13,57,51,6,51
Peterhead,7233,6,13,9,14,45,52,-7,48
East Fife,7233,7,12,10,14,56,51,5,46
Stranraer,7233,8,11,10,15,50,59,-9,43
Stenhousem'r,7233,9,7,11,18,42,73,-31,32
Queen's Park,7233,10,7,7,22,24,58,-34,28
Brechin,7234,1,21,3,12,57,50,7,66
Airdrieon,7234,2,20,5,11,68,44,24,65
Livingston,7234,3,19,5,12,75,54,21,62
Alloa,7234,4,18,8,10,67,48,19,62
East Fife,7234,5,15,9,12,56,43,13,54
Stranraer,7234,6,13,5,18,56,69,-13,44
Albion,7234,7,12,8,16,50,66,-16,44
Queen's Park,7234,8,12,6,18,42,53,-11,42
Peterhead,7234,9,12,6,18,41,53,-12,42
Stenhousem'r,7234,10,8,5,23,45,77,-32,29
Livingston,7235,1,22,6,8,73,42,31,72
Alloa,7235,2,20,3,13,61,45,16,63
Airdrieon,7235,3,16,9,11,53,48,5,57
Albion,7235,4,15,9,12,60,52,8,54
Peterhead,7235,5,15,8,13,50,49,1,53
Stranraer,7235,6,14,8,14,53,52,1,50
Queen's Park,7235,7,15,3,18,38,54,-16,48
Brechin,7235,8,13,4,19,42,52,-10,43
East Fife,7235,9,12,6,18,56,59,-3,42
Stenhousem'r,7235,10,5,10,21,44,77,-33,25
Livingston,7236,1,19,5,12,68,50,18,62
Brechin,7236,2,18,7,11,54,42,12,61
Alloa,7236,3,16,7,13,60,45,15,55
Peterhead,7236,4,15,8,13,47,48,-1,53
Queen's Park,7236,5,15,5,16,34,43,-9,50
Airdrieon,7236,6,14,7,15,52,55,-3,49
East Fife,7236,7,12,11,13,50,45,5,47
Albion,7236,8,12,11,13,58,56,2,47
Stranraer,7236,9,13,6,17,44,55,-11,45
Stenhousem'r,7236,10,8,9,19,43,71,-28,33
Livingston,7237,1,23,4,9,80,44,36,73
Alloa,7237,2,19,8,9,78,49,29,65
Airdrieon,7237,3,19,4,13,67,63,4,61
Brechin,7237,4,17,6,13,57,52,5,57
Albion,7237,5,16,8,12,65,49,16,56
Queen's Park,7237,6,16,6,14,43,46,-3,54
East Fife,7237,7,10,10,16,49,52,-3,40
Stranraer,7237,8,10,8,18,43,61,-18,38
Peterhead,7237,9,11,5,20,47,68,-21,38
Stenhousem'r,7237,10,5,9,22,48,93,-45,24
Livingston,7238,1,22,3,11,80,46,34,69
Alloa,7238,2,19,8,9,72,41,31,65
Albion,7238,3,15,11,10,50,45,5,56
Airdrieon,7238,4,17,5,14,55,54,1,56
Brechin,7238,5,16,6,14,47,53,-6,54
East Fife,7238,6,14,8,14,51,43,8,50
Stranraer,7238,7,14,5,17,45,49,-4,47
Queen's Park,7238,8,10,8,18,36,54,-18,38
Peterhead,7238,9,10,8,18,41,64,-23,38
Stenhousem'r,7238,10,7,10,19,42,70,-28,31
Alloa,7239,1,16,12,8,65,42,23,60
Airdrieon,7239,2,18,6,12,57,47,10,60
Livingston,7239,3,18,5,13,68,54,14,59
Albion,7239,4,16,10,10,50,43,7,58
Peterhead,7239,5,14,10,12,58,52,6,52
East Fife,7239,6,12,11,13,51,49,2,47
Queen's Park,7239,7,11,10,15,40,51,-11,43
Stranraer,7239,8,12,7,17,47,61,-14,43
Brechin,7239,9,10,10,16,36,46,-10,40
Stenhousem'r,7239,10,9,7,20,46,73,-27,34
Airdrieon,7240,1,18,10,8,57,47,10,64
Alloa,7240,2,18,8,10,79,49,30,62
Livingston,7240,3,16,6,14,60,53,7,54
Albion,7240,4,15,5,16,57,55,2,50
Brechin,7240,5,13,10,13,50,55,-5,49
Peterhead,7240,6,13,8,15,50,52,-2,47
Queen's Park,7240,7,13,7,16,39,47,-8,46
Stranraer,7240,8,12,8,16,50,60,-10,44
Stenhousem'r,7240,9,12,8,16,50,68,-18,44
East Fife,7240,10,10,10,16,41,47,-6,40
Livingston,7241,1,21,5,10,90,47,43,68
Airdrieon,7241,2,19,5,12,57,52,5,62
Brechin,7241,3,19,4,13,64,55,9,61
Alloa,7241,4,17,7,12,66,49,17,58
Peterhead,7241,5,14,7,15,55,58,-3,49
Stranraer,7241,6,13,7,16,53,64,-11,46
Albion,7241,7,11,11,14,51,49,2,44
East Fife,7241,8,12,7,17,44,51,-7,43
Queen's Park,7241,9,13,4,19,34,54,-20,43
Stenhousem'r,7241,10,9,7,20,49,84,-35,34
Alloa,7242,1,21,8,7,72,41,31,71
Livingston,7242,2,21,5,10,75,43,32,68
Brechin,7242,3,17,8,11,64,52,12,59
Albion,7242,4,17,6,13,61,55,6,57
Airdrieon,7242,5,13,13,10,61,58,3,52
East Fife,7242,6,12,10,14,51,47,4,46
Queen's Park,7242,7,13,6,17,43,62,-19,45
Peterhead,7242,8,10,9,17,49,59,-10,39
Stranraer,7242,9,10,7,19,45,62,-17,37
Stenhousem'r,7242,10,4,12,20,43,85,-42,24
Albion,7243,1,20,6,10,61,47,14,66
Alloa,7243,2,18,8,10,63,41,22,62
Brechin,7243,3,16,8,12,52,53,-1,56
Livingston,7243,4,17,3,16,65,52,13,54
Airdrieon,7243,5,15,9,12,56,52,4,54
East Fife,7243,6,12,9,15,43,45,-2,45
Stenhousem'r,7243,7,13,6,17,52,58,-6,45
Queen's Park,7243,8,12,8,16,39,54,-15,44
Stranraer,7243,9,12,5,19,53,67,-14,41
Peterhead,7243,10,10,8,18,38,53,-15,38
Livingston,7244,1,23,4,9,89,41,48,73
Alloa,7244,2,21,6,9,74,43,31,69
Peterhead,7244,3,16,8,12,57,51,6,56
Airdrieon,7244,4,16,7,13,61,67,-6,55
Brechin,7244,5,15,7,14,45,48,-3,52
Albion,7244,6,14,7,15,52,56,-4,49
Stranraer,7244,7,13,7,16,47,52,-5,46
East Fife,7244,8,10,10,16,47,51,-4,40
Queen's Park,7244,9,10,9,17,48,60,-12,39
Stenhousem'r,7244,10,6,7,23,46,97,-51,25
Alloa,7245,1,19,7,10,71,44,27,64
Livingston,7245,2,18,7,11,72,56,16,61
Brechin,7245,3,16,8,12,56,46,10,56
Airdrieon,7245,4,15,10,11,63,52,11,55
Albion,7245,5,14,8,14,59,64,-5,50
Stranraer,7245,6,14,4,18,63,66,-3,46
East Fife,7245,7,13,7,16,53,56,-3,46
Queen's Park,7245,8,12,8,16,41,53,-12,44
Peterhead,7245,9,12,8,16,46,62,-16,44
Stenhousem'r,7245,10,9,9,18,52,77,-25,36
Airdrieon,7246,1,20,5,11,65,57,8,65
Alloa,7246,2,18,10,8,69,39,30,64
Livingston,7246,3,18,7,11,71,59,12,61
Brechin,7246,4,16,10,10,50,43,7,58
Peterhead,7246,5,14,8,14,49,55,-6,50
Stranraer,7246,6,13,8,15,53,53,0,47
Queen's Park,7246,7,13,7,16,46,55,-9,46
Albion,7246,8,12,8,16,48,56,-8,44
East Fife,7246,9,10,9,17,54,51,3,39
Stenhousem'r,7246,10,6,8,22,46,83,-37,26
Alloa,7247,1,18,11,7,68,37,31,65
Brechin,7247,2,15,14,7,48,34,14,59
Airdrieon,7247,3,17,7,12,56,55,1,58
Livingston,7247,4,16,9,11,68,53,15,57
Albion,7247,5,14,10,12,61,54,7,52
Peterhead,7247,6,12,12,12,56,57,-1,48
Stranraer,7247,7,14,6,16,50,54,-4,48
Queen's Park,7247,8,9,13,14,38,49,-11,40
Stenhousem'r,7247,9,9,8,19,44,71,-27,35
East Fife,7247,10,6,10,20,41,66,-25,28
Livingston,7248,1,23,5,8,88,43,45,74
Alloa,7248,2,19,5,12,65,51,14,62
Brechin,7248,3,19,5,12,61,48,13,62
Airdrieon,7248,4,18,7,11,56,44,12,61
Queen's Park,7248,5,15,4,17,49,59,-10,49
Albion,7248,6,13,9,14,49,54,-5,48
East Fife,7248,7,14,5,17,49,55,-6,47
Peterhead,7248,8,9,12,15,46,56,-10,39
Stranraer,7248,9,11,4,21,45,62,-17,37
Stenhousem'r,7248,10,7,8,21,46,82,-36,29
Livingston,7249,1,26,4,6,84,38,46,82
Alloa,7249,2,19,5,12,68,49,19,62
Brechin,7249,3,17,5,14,57,53,4,56
Queen's Park,7249,4,15,4,17,43,53,-10,49
East Fife,7249,5,13,9,14,52,44,8,48
Airdrieon,7249,6,14,5,17,54,61,-7,47
Peterhead,7249,7,13,7,16,50,52,-2,46
Stranraer,7249,8,14,3,19,46,61,-15,45
Albion,7249,9,11,8,17,49,64,-15,41
Stenhousem'r,7249,10,9,8,19,48,76,-28,35
Alloa,7250,1,26,6,4,92,41,51,84
Livingston,7250,2,21,1,14,76,60,16,64
Airdrieon,7250,3,18,8,10,57,54,3,62
Albion,7250,4,14,11,11,59,57,2,53
Brechin,7250,5,14,5,17,43,48,-5,47
East Fife,7250,6,10,13,13,41,39,2,43
Queen's Park,7250,7,11,10,15,38,49,-11,43
Peterhead,7250,8,10,7,19,45,62,-17,37
Stenhousem'r,7250,9,10,6,20,51,74,-23,36
Stranraer,7250,10,9,7,20,48,66,-18,34
Livingston,7251,1,23,7,6,90,48,42,76
Brechin,7251,2,19,4,13,63,52,11,61
Alloa,7251,3,16,9,11,70,57,13,57
Airdrieon,7251,4,16,6,14,61,62,-1,54
Stranraer,7251,5,14,4,18,54,65,-11,46
Albion,7251,6,12,9,15,59,59,0,45
Peterhead,7251,7,12,9,15,50,59,-9,45
Queen's Park,7251,8,12,8,16,39,55,-16,44
East Fife,7251,9,10,8,18,43,55,-12,38
Stenhousem'r,7251,10,10,8,18,61,78,-17,38
Alloa,7252,1,21,7,8,81,36,45,70
Livingston,7252,2,21,3,12,79,57,22,66
Airdrieon,7252,3,16,7,13,54,50,4,55
Albion,7252,4,14,11,11,62,49,13,53
Brechin,7252,5,15,8,13,53,56,-3,53
Peterhead,7252,6,15,6,15,44,51,-7,51
East Fife,7252,7,13,8,15,50,50,0,47
Queen's Park,7252,8,9,11,16,33,53,-20,38
Stranraer,7252,9,10,6,20,41,61,-20,36
Stenhousem'r,7252,10,6,13,17,43,77,-34,31
Alloa,7253,1,22,5,9,68,32,36,71
Livingston,7253,2,21,6,9,83,43,40,69
Brechin,7253,3,18,5,13,50,53,-3,59
East Fife,7253,4,16,9,11,61,43,18,57
Airdrieon,7253,5,13,9,14,47,54,-7,48
Queen's Park,7253,6,13,9,14,40,51,-11,48
Albion,7253,7,13,5,18,54,63,-9,44
Peterhead,7253,8,12,6,18,43,58,-15,42
Stranraer,7253,9,10,5,21,42,60,-18,35
Stenhousem'r,7253,10,9,7,20,44,75,-31,34
Alloa,7254,1,24,5,7,83,42,41,77
Airdrieon,7254,2,22,6,8,66,54,12,72
Livingston,7254,3,22,1,13,86,51,35,67
Brechin,7254,4,19,2,15,61,54,7,59
Albion,7254,5,16,6,14,57,56,1,54
Queen's Park,7254,6,13,5,18,35,51,-16,44
Peterhead,7254,7,10,8,18,50,71,-21,38
Stranraer,7254,8,11,3,22,49,64,-15,36
Stenhousem'r,7254,9,9,8,19,44,77,-33,35
East Fife,7254,10,8,8,20,53,64,-11,32
Livingston,7255,1,21,6,9,86,53,33,69
Alloa,7255,2,18,7,11,66,48,18,61
Airdrieon,7255,3,18,6,12,67,56,11,60
Queen's Park,7255,4,16,7,13,44,44,0,55
East Fife,7255,5,13,11,12,54,44,10,50
Brechin,7255,6,14,7,15,46,54,-8,49
Peterhead,7255,7,12,11,13,56,55,1,47
Stranraer,7255,8,11,6,19,47,62,-15,39
Albion,7255,9,9,10,17,47,59,-12,37
Stenhousem'r,7255,10,7,11,18,48,86,-38,32
Albion,7256,1,19,6,11,68,49,19,63
Airdrieon,7256,2,18,6,12,63,53,10,60
Livingston,7256,3,17,8,11,69,52,17,59
Alloa,7256,4,16,9,11,71,53,18,57
Brechin,7256,5,17,4,15,54,53,1,55
East Fife,7256,6,14,12,10,51,46,5,54
Peterhead,7256,7,14,10,12,59,61,-2,52
Queen's Park,7256,8,12,9,15,45,54,-9,45
Stranraer,7256,9,12,4,20,50,60,-10,40
Stenhousem'r,7256,10,3,8,25,41,90,-49,17
Alloa,7257,1,20,8,8,72,41,31,68
Airdrieon,7257,2,19,7,10,54,45,9,64
Livingston,7257,3,18,6,12,73,52,21,60
East Fife,7257,4,16,8,12,54,42,12,56
Peterhead,7257,5,16,7,13,49,48,1,55
Brechin,7257,6,15,9,12,50,42,8,54
Albion,7257,7,12,8,16,43,49,-6,44
Stranraer,7257,8,12,7,17,45,56,-11,43
Queen's Park,7257,9,10,9,17,36,55,-19,39
Stenhousem'r,7257,10,5,5,26,39,85,-46,20
Alloa,7258,1,21,7,8,74,49,25,70
Airdrieon,7258,2,17,8,11,56,45,11,59
Livingston,7258,3,16,10,10,61,44,17,58
Peterhead,7258,4,16,8,12,55,42,13,56
Brechin,7258,5,15,7,14,51,53,-2,52
East Fife,7258,6,13,11,12,54,49,5,50
Stranraer,7258,7,12,7,17,54,59,-5,43
Albion,7258,8,12,7,17,47,54,-7,43
Queen's Park,7258,9,10,7,19,29,52,-23,37
Stenhousem'r,7258,10,8,8,20,43,77,-34,32
Livingston,7259,1,24,2,10,87,49,38,74
Alloa,7259,2,17,8,11,68,55,13,59
Airdrieon,7259,3,16,6,14,56,57,-1,54
Peterhead,7259,4,15,7,14,59,60,-1,52
Albion,7259,5,14,9,13,57,53,4,51
Brechin,7259,6,15,4,17,51,59,-8,49
Stenhousem'r,7259,7,12,7,17,52,66,-14,43
Queen's Park,7259,8,12,7,17,39,57,-18,43
East Fife,7259,9,11,9,16,48,48,0,42
Stranraer,7259,10,11,7,18,53,66,-13,40
Livingston,7260,1,24,4,8,88,46,42,76
Albion,7260,2,18,9,9,61,44,17,63
Alloa,7260,3,16,9,11,71,50,21,57
Airdrieon,7260,4,16,5,15,58,65,-7,53
Peterhead,7260,5,13,9,14,47,52,-5,48
Queen's Park,7260,6,12,10,14,39,49,-10,46
Brechin,7260,7,13,5,18,41,56,-15,44
East Fife,7260,8,11,7,18,48,55,-7,40
Stenhousem'r,7260,9,10,9,17,60,75,-15,39
Stranraer,7260,10,10,7,19,44,65,-21,37
Livingston,7261,1,23,8,5,83,42,41,77
Alloa,7261,2,19,10,7,80,43,37,67
Airdrieon,7261,3,15,7,14,62,60,2,52
Peterhead,7261,4,15,6,15,56,54,2,51
Brechin,7261,5,12,12,12,41,47,-6,48
Albion,7261,6,11,14,11,56,54,2,47
Stenhousem'r,7261,7,12,6,18,53,83,-30,42
Queen's Park,7261,8,10,9,17,39,60,-21,39
East Fife,7261,9,9,10,17,40,51,-11,37
Stranraer,7261,10,10,6,20,47,63,-16,36
Livingston,7262,1,24,3,9,69,39,30,75
Alloa,7262,2,17,10,9,63,46,17,61
Brechin,7262,3,17,7,12,50,43,7,58
Airdrieon,7262,4,16,8,12,63,53,10,56
Stranraer,7262,5,15,9,12,62,50,12,54
Albion,7262,6,15,8,13,61,52,9,53
East Fife,7262,7,11,8,17,55,63,-8,41
Peterhead,7262,8,9,10,17,46,67,-21,37
Queen's Park,7262,9,9,8,19,26,49,-23,35
Stenhousem'r,7262,10,8,7,21,49,82,-33,31
Brechin,7263,1,19,8,9,63,46,17,65
Livingston,7263,2,20,4,12,80,52,28,64
Airdrieon,7263,3,18,4,14,61,55,6,58
Alloa,7263,4,14,13,9,61,45,16,55
Stranraer,7263,5,13,7,16,49,53,-4,46
Albion,7263,6,12,9,15,45,57,-12,45
Peterhead,7263,7,13,6,17,47,60,-13,45
East Fife,7263,8,12,7,17,53,58,-5,43
Queen's Park,7263,9,13,4,19,33,49,-16,43
Stenhousem'r,7263,10,11,8,17,58,75,-17,41
Brechin,7264,1,18,10,8,55,39,16,64
Alloa,7264,2,17,11,8,79,48,31,62
Livingston,7264,3,19,5,12,73,53,20,62
Albion,7264,4,15,9,12,63,46,17,54
Peterhead,7264,5,15,9,12,56,53,3,54
Airdrieon,7264,6,15,6,15,48,52,-4,51
Queen's Park,7264,7,12,9,15,38,54,-16,45
East Fife,7264,8,9,8,19,45,56,-11,35
Stranraer,7264,9,9,8,19,42,69,-27,35
Stenhousem'r,7264,10,8,11,17,51,80,-29,35
Livingston,7265,1,22,6,8,78,46,32,72
Alloa,7265,2,21,5,10,69,45,24,68
Airdrieon,7265,3,17,8,11,61,53,8,59
Albion,7265,4,16,7,13,57,47,10,55
Peterhead,7265,5,15,8,13,51,50,1,53
Brechin,7265,6,13,8,15,55,58,-3,47
East Fife,7265,7,11,10,15,52,54,-2,43
Queen's Park,7265,8,11,9,16,33,47,-14,42
Stranraer,7265,9,11,7,18,53,62,-9,40
Stenhousem'r,7265,10,5,8,23,37,84,-47,23
Livingston,7266,1,22,1,13,78,49,29,67
Airdrieon,7266,2,20,7,9,64,49,15,67
Alloa,7266,3,16,8,12,72,53,19,56
Albion,7266,4,15,10,11,56,51,5,55
Brechin,7266,5,16,7,13,58,56,2,55
Queen's Park,7266,6,15,6,15,37,44,-7,51
Peterhead,7266,7,11,8,17,44,56,-12,41
Stranraer,7266,8,10,10,16,54,61,-7,40
East Fife,7266,9,9,10,17,45,60,-15,37
Stenhousem'r,7266,10,9,7,20,46,75,-29,34
Alloa,7267,1,20,4,12,68,49,19,64
Airdrieon,7267,2,20,4,12,55,46,9,64
Livingston,7267,3,19,2,15,70,55,15,59
Brechin,7267,4,17,5,14,55,50,5,56
East Fife,7267,5,15,8,13,51,42,9,53
Albion,7267,6,14,9,13,57,49,8,51
Peterhead,7267,7,13,8,15,49,58,-9,47
Queen's Park,7267,8,12,8,16,49,56,-7,44
Stranraer,7267,9,13,5,18,49,58,-9,44
Stenhousem'r,7267,10,8,5,23,44,84,-40,29
Alloa,7268,1,20,7,9,70,43,27,67
Livingston,7268,2,20,3,13,66,49,17,63
Brechin,7268,3,18,7,11,55,51,4,61
Albion,7268,4,16,7,13,55,50,5,55
Peterhead,7268,5,15,9,12,51,47,4,54
Airdrieon,7268,6,14,7,15,45,48,-3,49
East Fife,7268,7,11,11,14,40,40,0,44
Queen's Park,7268,8,12,8,16,36,49,-13,44
Stranraer,7268,9,10,7,19,45,60,-15,37
Stenhousem'r,7268,10,7,8,21,46,72,-26,29
Alloa,7269,1,24,4,8,85,46,39,76
Brechin,7269,2,19,6,11,57,40,17,63
Livingston,7269,3,18,5,13,66,50,16,59
Peterhead,7269,4,16,6,14,57,58,-1,54
Albion,7269,5,16,5,15,58,58,0,53
Airdrieon,7269,6,13,8,15,52,55,-3,47
East Fife,7269,7,12,8,16,50,49,1,44
Queen's Park,7269,8,13,4,19,43,60,-17,43
Stranraer,7269,9,11,7,18,44,59,-15,40
Stenhousem'r,7269,10,8,7,21,43,80,-37,31
Livingston,7270,1,23,5,8,85,44,41,74
Alloa,7270,2,20,6,10,73,50,23,66
Albion,7270,3,16,7,13,58,51,7,55
Brechin,7270,4,14,10,12,55,54,1,52
Peterhead,7270,5,15,6,15,58,53,5,51
Airdrieon,7270,6,14,7,15,58,59,-1,49
Queen's Park,7270,7,14,6,16,38,49,-11,48
East Fife,7270,8,12,8,16,44,44,0,44
Stranraer,7270,9,12,4,20,49,67,-18,40
Stenhousem'r,7270,10,8,5,23,40,87,-47,29
Brechin,7271,1,21,6,9,56,41,15,69
Alloa,7271,2,19,8,9,67,44,23,65
Airdrieon,7271,3,18,11,7,61,46,15,65
Livingston,7271,4,19,7,10,68,46,22,64
Albion,7271,5,14,10,12,57,53,4,52
Stranraer,7271,6,13,7,16,58,57,1,46
Peterhead,7271,7,13,7,16,50,57,-7,46
Queen's Park,7271,8,10,7,19,33,51,-18,37
East Fife,7271,9,9,9,18,42,54,-12,36
Stenhousem'r,7271,10,5,6,25,40,83,-43,21
Livingston,7272,1,20,5,11,72,45,27,65
Airdrieon,7272,2,18,7,11,56,47,9,61
Alloa,7272,3,17,7,12,62,42,20,58
Albion,7272,4,16,5,15,58,59,-1,53
Stranraer,7272,5,15,6,15,51,51,0,51
Queen's Park,7272,6,13,8,15,36,47,-11,47
Brechin,7272,7,13,7,16,50,52,-2,46
East Fife,7272,8,12,9,15,45,47,-2,45
Peterhead,7272,9,12,6,18,46,54,-8,42
Stenhousem'r,7272,10,11,6,19,52,84,-32,39
Livingston,7273,1,21,4,11,91,49,42,67
Airdrieon,7273,2,18,10,8,58,45,13,64
Alloa,7273,3,15,11,10,70,48,22,56
Brechin,7273,4,15,10,11,47,41,6,55
Albion,7273,5,15,8,13,53,55,-2,53
Peterhead,7273,6,13,11,12,47,51,-4,50
Stranraer,7273,7,13,6,17,46,58,-12,45
Queen's Park,7273,8,11,8,17,36,53,-17,41
East Fife,7273,9,10,9,17,49,56,-7,39
Stenhousem'r,7273,10,6,9,21,44,85,-41,27
Livingston,7274,1,23,6,7,80,47,33,75
Alloa,7274,2,19,8,9,67,43,24,65
Brechin,7274,3,19,7,10,56,42,14,64
Peterhead,7274,4,17,7,12,52,51,1,58
Airdrieon,7274,5,13,7,16,57,65,-8,46
Albion,7274,6,12,9,15,44,44,0,45
Stranraer,7274,7,13,5,18,45,58,-13,44
Queen's Park,7274,8,10,10,16,37,51,-14,40
Stenhousem'r,7274,9,7,12,17,51,70,-19,33
East Fife,7274,10,7,9,20,46,64,-18,30
Alloa,7275,1,20,8,8,68,44,24,68
Airdrieon,7275,2,20,7,9,59,44,15,67
Livingston,7275,3,20,4,12,73,47,26,64
Albion,7275,4,16,8,12,52,42,10,56
East Fife,7275,5,12,12,12,52,46,6,48
Brechin,7275,6,14,1,21,48,55,-7,43
Peterhead,7275,7,12,7,17,49,59,-10,43
Stranraer,7275,8,12,7,17,60,72,-12,43
Queen's Park,7275,9,12,6,18,40,62,-22,42
Stenhousem'r,7275,10,8,8,20,45,75,-30,32
Livingston,7276,1,22,4,10,82,49,33,70
Airdrieon,7276,2,20,6,10,64,50,14,66
Brechin,7276,3,20,2,14,51,44,7,62
Peterhead,7276,4,16,9,11,52,47,5,57
Alloa,7276,5,14,9,13,65,59,6,51
Albion,7276,6,13,10,13,55,53,2,49
Queen's Park,7276,7,14,5,17,43,51,-8,47
Stranraer,7276,8,12,7,17,49,55,-6,43
East Fife,7276,9,10,10,16,46,49,-3,40
Stenhousem'r,7276,10,6,4,26,43,93,-50,22
Livingston,7277,1,25,5,6,78,46,32,80
Alloa,7277,2,20,6,10,76,47,29,66
Airdrieon,7277,3,18,6,12,55,47,8,60
Brechin,7277,4,18,2,16,53,51,2,56
Stranraer,7277,5,14,8,14,57,53,4,50
Albion,7277,6,13,8,15,50,50,0,47
Queen's Park,7277,7,13,6,17,38,48,-10,45
Peterhead,7277,8,11,7,18,47,64,-17,40
East Fife,7277,9,10,8,18,49,52,-3,38
Stenhousem'r,7277,10,7,6,23,42,87,-45,27
Brechin,7278,1,20,7,9,58,44,14,67
Alloa,7278,2,17,10,9,67,44,23,61
Livingston,7278,3,16,9,11,77,53,24,57
East Fife,7278,4,13,11,12,55,49,6,50
Peterhead,7278,5,14,8,14,50,46,4,50
Stranraer,7278,6,14,7,15,52,61,-9,49
Queen's Park,7278,7,12,10,14,43,53,-10,46
Airdrieon,7278,8,11,11,14,48,59,-11,44
Albion,7278,9,10,10,16,48,58,-10,40
Stenhousem'r,7278,10,7,9,20,44,75,-31,30
Alloa,7279,1,19,9,8,74,47,27,66
Peterhead,7279,2,18,5,13,59,49,10,59
Brechin,7279,3,17,5,14,50,53,-3,56
Livingston,7279,4,16,7,13,71,52,19,55
Stranraer,7279,5,17,4,15,61,56,5,55
Airdrieon,7279,6,14,8,14,57,64,-7,50
Albion,7279,7,14,7,15,59,55,4,49
East Fife,7279,8,10,12,14,45,53,-8,42
Stenhousem'r,7279,9,11,6,19,48,67,-19,39
Queen's Park,7279,10,9,7,20,33,61,-28,34
Alloa,7280,1,20,8,8,74,50,24,68
Airdrieon,7280,2,19,6,11,61,53,8,63
Livingston,7280,3,19,4,13,70,49,21,61
Albion,7280,4,15,5,16,50,55,-5,50
Brechin,7280,5,14,7,15,49,52,-3,49
Peterhead,7280,6,12,11,13,56,57,-1,47
Queen's Park,7280,7,12,10,14,42,55,-13,46
Stranraer,7280,8,13,5,18,50,55,-5,44
Stenhousem'r,7280,9,11,7,18,52,69,-17,40
East Fife,7280,10,8,11,17,40,49,-9,35
Albion,7281,1,20,7,9,58,40,18,67
Livingston,7281,2,21,3,12,78,52,26,66
Alloa,7281,3,19,6,11,71,47,24,63
Brechin,7281,4,17,6,13,54,53,1,57
Airdrieon,7281,5,15,9,12,66,59,7,54
Peterhead,7281,6,13,9,14,57,61,-4,48
East Fife,7281,7,12,10,14,44,41,3,46
Queen's Park,7281,8,12,9,15,43,58,-15,45
Stranraer,7281,9,8,7,21,46,67,-21,31
Stenhousem'r,7281,10,7,6,23,42,81,-39,27
Alloa,7282,1,20,8,8,79,45,34,68
Airdrieon,7282,2,19,4,13,58,53,5,61
Livingston,7282,3,18,6,12,74,52,22,60
Peterhead,7282,4,14,9,13,47,49,-2,51
Brechin,7282,5,15,4,17,54,67,-13,49
Albion,7282,6,13,9,14,51,49,2,48
Queen's Park,7282,7,14,5,17,41,55,-14,47
Stranraer,7282,8,13,6,17,56,55,1,45
East Fife,7282,9,10,12,14,45,49,-4,42
Stenhousem'r,7282,10,9,7,20,40,71,-31,34
Airdrieon,7283,1,20,5,11,63,52,11,65
Alloa,7283,2,18,9,9,71,47,24,63
Albion,7283,3,16,12,8,55,43,12,60
Livingston,7283,4,17,6,13,66,46,20,57
Brechin,7283,5,15,9,12,54,47,7,54
East Fife,7283,6,13,9,14,55,48,7,48
Peterhead,7283,7,13,7,16,49,57,-8,46
Queen's Park,7283,8,10,8,18,35,60,-25,38
Stranraer,7283,9,9,8,19,42,56,-14,35
Stenhousem'r,7283,10,9,7,20,49,83,-34,34
Livingston,7284,1,21,4,11,70,41,29,67
Brechin,7284,2,18,7,11,47,42,5,61
Airdrieon,7284,3,17,9,10,60,47,13,60
Albion,7284,4,15,7,14,58,50,8,52
Peterhead,7284,5,15,7,14,50,57,-7,52
Alloa,7284,6,14,9,13,61,48,13,51
Stranraer,7284,7,13,7,16,45,56,-11,46
Queen's Park,7284,8,11,9,16,39,50,-11,42
East Fife,7284,9,9,10,17,46,53,-7,37
Stenhousem'r,7284,10,7,11,18,52,84,-32,32
Airdrieon,7285,1,22,6,8,69,52,17,72
Brechin,7285,2,16,7,13,52,56,-4,55
Livingston,7285,3,15,9,12,70,50,20,54
Peterhead,7285,4,14,10,12,61,54,7,52
Alloa,7285,5,14,9,13,66,56,10,51
Albion,7285,6,12,14,10,51,47,4,50
Queen's Park,7285,7,12,10,14,41,50,-9,46
East Fife,7285,8,12,8,16,53,49,4,44
Stranraer,7285,9,9,9,18,48,69,-21,36
Stenhousem'r,7285,10,8,10,18,47,75,-28,34
Livingston,7286,1,19,8,9,75,48,27,65
Airdrieon,7286,2,18,7,11,53,54,-1,61
Alloa,7286,3,16,10,10,64,46,18,58
East Fife,7286,4,16,8,12,59,43,16,56
Peterhead,7286,5,15,9,12,44,45,-1,54
Brechin,7286,6,16,4,16,47,55,-8,52
Albion,7286,7,13,8,15,52,43,9,47
Queen's Park,7286,8,13,7,16,40,47,-7,46
Stranraer,7286,9,10,8,18,40,53,-13,38
Stenhousem'r,7286,10,6,7,23,35,75,-40,25
Livingston,7287,1,23,2,11,80,42,38,71
Alloa,7287,2,19,8,9,59,39,20,65
Brechin,7287,3,17,9,10,54,49,5,60
Albion,7287,4,16,9,11,60,46,14,57
Airdrieon,7287,5,16,5,15,55,59,-4,53
Peterhead,7287,6,13,8,15,40,44,-4,47
Stranraer,7287,7,12,8,16,49,62,-13,44
East Fife,7287,8,11,7,18,51,56,-5,40
Queen's Park,7287,9,10,9,17,38,53,-15,39
Stenhousem'r,7287,10,6,9,21,42,78,-36,27
Brechin,7288,1,21,3,12,52,45,7,66
Alloa,7288,2,18,10,8,69,42,27,64
Livingston,7288,3,17,4,15,68,61,7,55
Peterhead,7288,4,15,10,11,52,49,3,55
Albion,7288,5,15,9,12,58,49,9,54
East Fife,7288,6,14,8,14,56,44,12,50
Airdrieon,7288,7,14,8,14,49,55,-6,50
Stranraer,7288,8,11,9,16,47,55,-8,42
Queen's Park,7288,9,9,8,19,39,60,-21,35
Stenhousem'r,7288,10,7,9,20,48,78,-30,30
Alloa,7289,1,20,7,9,68,39,29,67
Livingston,7289,2,20,5,11,75,49,26,65
Brechin,7289,3,18,5,13,51,43,8,59
Queen's Park,7289,4,14,8,14,41,46,-5,50
Airdrieon,7289,5,13,9,14,54,58,-4,48
East Fife,7289,6,12,11,13,56,52,4,47
Stranraer,7289,7,14,5,17,54,63,-9,47
Peterhead,7289,8,13,7,16,48,52,-4,46
Albion,7289,9,10,12,14,50,57,-7,42
Stenhousem'r,7289,10,8,7,21,44,82,-38,31
Livingston,7290,1,23,4,9,79,50,29,73
Alloa,7290,2,19,6,11,73,48,25,63
Brechin,7290,3,18,8,10,54,47,7,62
Peterhead,7290,4,15,9,12,53,47,6,54
Albion,7290,5,14,7,15,51,65,-14,49
Queen's Park,7290,6,13,6,17,38,53,-15,45
Stranraer,7290,7,12,7,17,47,55,-8,43
East Fife,7290,8,11,9,16,47,48,-1,42
Airdrieon,7290,9,10,9,17,47,57,-10,39
Stenhousem'r,7290,10,10,5,21,51,70,-19,35
Livingston,7291,1,23,4,9,80,46,34,73
Queen's Park,7291,2,16,8,12,47,46,1,56
Peterhead,7291,3,14,9,13,49,46,3,51
Alloa,7291,4,13,11,12,66,53,13,50
Airdrieon,7291,5,14,8,14,57,63,-6,50
Brechin,7291,6,14,7,15,49,57,-8,49
Albion,7291,7,11,11,14,47,50,-3,44
Stranraer,7291,8,11,9,16,52,57,-5,42
East Fife,7291,9,10,10,16,47,49,-2,40
Stenhousem'r,7291,10,9,13,14,47,74,-27,40
Livingston,7292,1,20,7,9,80,53,27,67
Peterhead,7292,2,17,6,13,66,51,15,57
Alloa,7292,3,15,10,11,68,51,17,55
Airdrieon,7292,4,14,11,11,57,66,-9,53
Brechin,7292,5,14,10,12,52,48,4,52
Albion,7292,6,14,10,12,52,50,2,52
East Fife,7292,7,13,10,13,53,53,0,49
Stranraer,7292,8,13,8,15,55,55,0,47
Queen's Park,7292,9,8,8,20,42,68,-26,32
Stenhousem'r,7292,10,7,10,19,49,79,-30,31
Livingston,7293,1,21,4,11,76,43,33,67
Alloa,7293,2,18,9,9,68,48,20,63
Airdrieon,7293,3,19,6,11,63,48,15,63
Brechin,7293,4,18,6,12,65,51,14,60
Albion,7293,5,14,10,12,51,50,1,52
Queen's Park,7293,6,15,5,16,46,52,-6,50
East Fife,7293,7,12,10,14,45,47,-2,46
Peterhead,7293,8,9,9,18,44,57,-13,36
Stranraer,7293,9,8,9,19,36,54,-18,33
Stenhousem'r,7293,10,9,6,21,40,84,-44,33
Airdrieon,7294,1,22,5,9,67,54,13,71
Alloa,7294,2,21,5,10,69,41,28,68
Livingston,7294,3,19,4,13,72,46,26,61
Brechin,7294,4,16,9,11,51,46,5,57
Albion,7294,5,16,5,15,49,50,-1,53
Stranraer,7294,6,16,3,17,58,62,-4,51
Peterhead,7294,7,12,7,17,53,60,-7,43
Queen's Park,7294,8,10,7,19,33,56,-23,37
East Fife,7294,9,8,10,18,44,57,-13,34
Stenhousem'r,7294,10,9,7,20,51,75,-24,34
Livingston,7295,1,22,4,10,68,44,24,70
Alloa,7295,2,20,9,7,66,42,24,69
Peterhead,7295,3,18,6,12,53,47,6,60
Brechin,7295,4,18,5,13,54,42,12,59
Airdrieon,7295,5,17,6,13,65,55,10,57
Albion,7295,6,13,9,14,51,44,7,48
East Fife,7295,7,13,7,16,47,43,4,46
Queen's Park,7295,8,11,5,20,32,50,-18,38
Stranraer,7295,9,11,2,23,41,73,-32,35
Stenhousem'r,7295,10,7,7,22,44,81,-37,28
Alloa,7296,1,19,6,11,60,41,19,63
Livingston,7296,2,17,7,12,66,48,18,58
Brechin,7296,3,17,7,12,49,50,-1,58
Albion,7296,4,16,6,14,46,46,0,54
Peterhead,7296,5,15,6,15,48,48,0,51
East Fife,7296,6,12,11,13,47,48,-1,47
Airdrieon,7296,7,14,5,17,53,63,-10,47
Stenhousem'r,7296,8,13,6,17,58,66,-8,45
Stranraer,7296,9,12,5,19,49,56,-7,41
Queen's Park,7296,10,10,11,15,33,43,-10,41
Alloa,7297,1,18,11,7,68,43,25,65
Livingston,7297,2,20,5,11,70,46,24,65
Airdrieon,7297,3,17,9,10,61,48,13,60
Brechin,7297,4,18,6,12,55,48,7,60
Albion,7297,5,14,8,14,59,57,2,50
Stranraer,7297,6,14,8,14,55,55,0,50
Queen's Park,7297,7,14,4,18,42,54,-12,46
East Fife,7297,8,8,13,15,43,50,-7,37
Peterhead,7297,9,8,13,15,40,57,-17,37
Stenhousem'r,7297,10,5,11,20,43,78,-35,26
Alloa,7298,1,20,6,10,79,49,30,66
Brechin,7298,2,20,5,11,52,44,8,65
Livingston,7298,3,20,2,14,63,55,8,62
Peterhead,7298,4,14,11,11,60,49,11,53
Airdrieon,7298,5,14,11,11,55,51,4,53
Albion,7298,6,12,11,13,45,45,0,47
Stranraer,7298,7,14,5,17,49,54,-5,47
East Fife,7298,8,10,10,16,48,49,-1,40
Queen's Park,7298,9,11,7,18,36,51,-15,40
Stenhousem'r,7298,10,6,10,20,42,82,-40,28
Livingston,7299,1,23,5,8,86,47,39,74
Alloa,7299,2,21,7,8,69,42,27,70
Airdrieon,7299,3,21,6,9,62,46,16,69
Brechin,7299,4,15,6,15,49,47,2,51
Albion,7299,5,12,11,13,54,55,-1,47
Peterhead,7299,6,13,8,15,49,56,-7,47
Queen's Park,7299,7,13,5,18,42,54,-12,44
East Fife,7299,8,11,8,17,43,51,-8,41
Stranraer,7299,9,9,5,22,42,68,-26,32
Stenhousem'r,7299,10,6,11,19,48,78,-30,29
Livingston,7300,1,19,6,11,70,51,19,63
Brechin,7300,2,19,5,12,58,42,16,62
Airdrieon,7300,3,18,7,11,56,54,2,61
Alloa,7300,4,16,9,11,58,47,11,57
Peterhead,7300,5,13,11,12,47,47,0,50
Albion,7300,6,13,9,14,58,59,-1,48
Queen's Park,7300,7,14,4,18,45,54,-9,46
East Fife,7300,8,12,8,16,50,55,-5,44
Stranraer,7300,9,12,6,18,60,67,-7,42
Stenhousem'r,7300,10,6,11,19,44,70,-26,29
Livingston,7301,1,23,3,10,80,50,30,72
Alloa,7301,2,17,10,9,63,38,25,61
Brechin,7301,3,18,4,14,50,45,5,58
Airdrieon,7301,4,14,9,13,54,60,-6,51
Stranraer,7301,5,14,6,16,52,57,-5,48
Peterhead,7301,6,14,5,17,48,54,-6,47
Albion,7301,7,13,6,17,52,58,-6,45
East Fife,7301,8,12,8,16,45,50,-5,44
Queen's Park,7301,9,13,5,18,43,51,-8,44
Stenhousem'r,7301,10,10,8,18,57,81,-24,38
Alloa,7302,1,20,8,8,67,35,32,68
Livingston,7302,2,20,6,10,76,52,24,66
Airdrieon,7302,3,18,7,11,57,49,8,61
Albion,7302,4,16,7,13,57,53,4,55
Peterhead,7302,5,14,9,13,51,51,0,51
Brechin,7302,6,15,6,15,46,48,-2,51
Queen's Park,7302,7,13,8,15,43,53,-10,47
Stranraer,7302,8,13,7,16,55,62,-7,46
East Fife,7302,9,8,7,21,36,43,-7,31
Stenhousem'r,7302,10,7,7,22,42,84,-42,28
Alloa,7303,1,22,7,7,79,42,37,73
Livingston,7303,2,22,6,8,89,49,40,72
Airdrieon,7303,3,19,9,8,66,46,20,66
Peterhead,7303,4,14,7,15,52,65,-13,49
Brechin,7303,5,12,8,16,43,58,-15,44
Stranraer,7303,6,11,10,15,51,60,-9,43
East Fife,7303,7,11,8,17,50,50,0,41
Albion,7303,8,12,5,19,50,59,-9,41
Queen's Park,7303,9,10,10,16,40,59,-19,40
Stenhousem'r,7303,10,6,12,18,44,76,-32,30
Livingston,7304,1,23,4,9,79,47,32,73
Alloa,7304,2,19,12,5,83,46,37,69
Airdrieon,7304,3,15,10,11,55,53,2,55
Peterhead,7304,4,14,9,13,54,51,3,51
East Fife,7304,5,14,7,15,58,46,12,49
Brechin,7304,6,13,9,14,50,58,-8,48
Albion,7304,7,12,11,13,52,56,-4,47
Stranraer,7304,8,12,9,15,54,64,-10,45
Queen's Park,7304,9,10,7,19,41,62,-21,37
Stenhousem'r,7304,10,6,6,24,41,84,-43,24
Livingston,7305,1,22,6,8,86,53,33,72
Alloa,7305,2,18,10,8,72,44,28,64
Airdrieon,7305,3,17,6,13,67,54,13,57
Stranraer,7305,4,15,7,14,60,61,-1,52
Peterhead,7305,5,13,10,13,49,53,-4,49
East Fife,7305,6,13,9,14,46,39,7,48
Albion,7305,7,13,9,14,46,48,-2,48
Brechin,7305,8,14,6,16,42,49,-7,48
Queen's Park,7305,9,9,7,20,31,58,-27,34
Stenhousem'r,7305,10,7,8,21,48,88,-40,29
Livingston,7306,1,24,2,10,81,50,31,74
Alloa,7306,2,21,8,7,71,43,28,71
Peterhead,7306,3,17,4,15,58,53,5,55
Albion,7306,4,14,8,14,55,54,1,50
Airdrieon,7306,5,15,4,17,53,52,1,49
Brechin,7306,6,14,7,15,45,59,-14,49
Queen's Park,7306,7,12,11,13,42,52,-10,47
Stranraer,7306,8,14,4,18,54,58,-4,46
East Fife,7306,9,9,11,16,48,50,-2,38
Stenhousem'r,7306,10,7,7,22,46,82,-36,28
Airdrieon,7307,1,20,6,10,62,49,13,66
Alloa,7307,2,17,12,7,74,45,29,63
Livingston,7307,3,18,6,12,60,41,19,60
Peterhead,7307,4,15,9,12,43,50,-7,54
Brechin,7307,5,15,8,13,47,41,6,53
Albion,7307,6,13,8,15,51,52,-1,47
East Fife,7307,7,11,9,16,50,48,2,42
Queen's Park,7307,8,10,12,14,39,48,-9,42
Stranraer,7307,9,11,9,16,42,57,-15,42
Stenhousem'r,7307,10,6,9,21,40,77,-37,27
Alloa,7308,1,20,9,7,87,42,45,69
Livingston,7308,2,19,7,10,68,48,20,64
Brechin,7308,3,19,5,12,59,43,16,62
Albion,7308,4,16,9,11,64,52,12,57
Airdrieon,7308,5,17,4,15,57,57,0,55
Stranraer,7308,6,13,7,16,53,53,0,46
Peterhead,7308,7,13,6,17,46,61,-15,45
East Fife,7308,8,11,11,14,53,52,1,44
Queen's Park,7308,9,9,7,20,30,71,-41,34
Stenhousem'r,7308,10,8,5,23,48,86,-38,29
Livingston,7309,1,20,5,11,73,51,22,65
Airdrieon,7309,2,19,7,10,62,51,11,64
Brechin,7309,3,19,7,10,52,42,10,64
Alloa,7309,4,17,8,11,70,50,20,59
Albion,7309,5,14,8,14,61,52,9,50
Stranraer,7309,6,14,4,18,59,67,-8,46
Queen's Park,7309,7,11,8,17,38,56,-18,41
Peterhead,7309,8,8,15,13,41,55,-14,39
Stenhousem'r,7309,9,10,8,18,42,65,-23,38
East Fife,7309,10,10,6,20,46,55,-9,36
Alloa,7310,1,23,5,8,69,41,28,74
Livingston,7310,2,23,2,11,91,56,35,71
Airdrieon,7310,3,20,7,9,69,53,16,67
Queen's Park,7310,4,17,6,13,44,44,0,57
Albion,7310,5,14,8,14,60,56,4,50
Stranraer,7310,6,13,8,15,45,53,-8,47
Brechin,7310,7,13,3,20,43,55,-12,42
Peterhead,7310,8,12,6,18,37,54,-17,42
East Fife,7310,9,7,9,20,40,58,-18,30
Stenhousem'r,7310,10,6,10,20,52,80,-28,28
Alloa,7311,1,22,8,6,77,39,38,74
Livingston,7311,2,21,4,11,76,41,35,67
Brechin,7311,3,17,5,14,60,52,8,56
Albion,7311,4,15,7,14,60,59,1,52
Queen's Park,7311,5,14,6,16,42,50,-8,48
East Fife,7311,6,13,8,15,50,52,-2,47
Peterhead,7311,7,13,7,16,47,59,-12,46
Airdrieon,7311,8,13,6,17,49,61,-12,45
Stranraer,7311,9,10,7,19,44,59,-15,37
Stenhousem'r,7311,10,11,4,21,49,82,-33,37
Livingston,7312,1,22,2,12,74,51,23,68
Airdrieon,7312,2,20,6,10,62,48,14,66
Alloa,7312,3,19,7,10,73,46,27,64
Albion,7312,4,15,6,15,58,54,4,51
Stranraer,7312,5,15,3,18,51,56,-5,48
East Fife,7312,6,13,8,15,58,53,5,47
Queen's Park,7312,7,13,6,17,36,52,-16,45
Peterhead,7312,8,11,11,14,39,46,-7,44
Brechin,7312,9,11,9,16,44,57,-13,42
Stenhousem'r,7312,10,8,8,20,41,73,-32,32
Livingston,7313,1,24,4,8,83,44,39,76
Alloa,7313,2,22,5,9,75,38,37,71
Brechin,7313,3,19,3,14,52,45,7,60
Airdrieon,7313,4,18,6,12,66,61,5,60
Albion,7313,5,14,7,15,65,55,10,49
Peterhead,7313,6,14,6,16,53,67,-14,48
East Fife,7313,7,13,6,17,57,54,3,45
Stranraer,7313,8,11,4,21,50,80,-30,37
Queen's Park,7313,9,10,6,20,40,62,-22,36
Stenhousem'r,7313,10,8,7,21,52,87,-35,31
Livingston,7314,1,23,4,9,76,40,36,73
Alloa,7314,2,17,6,13,67,55,12,57
Brechin,7314,3,18,2,16,53,46,7,56
Airdrieon,7314,4,15,8,13,54,48,6,53
Queen's Park,7314,5,15,8,13,46,47,-1,53
Albion,7314,6,14,6,16,47,51,-4,48
Stranraer,7314,7,14,6,16,49,57,-8,48
Peterhead,7314,8,14,6,16,52,61,-9,48
East Fife,7314,9,12,10,14,47,43,4,46
Stenhousem'r,7314,10,5,10,21,39,82,-43,25
Alloa,7315,1,20,8,8,74,45,29,68
Livingston,7315,2,21,3,12,69,47,22,66
Brechin,7315,3,16,9,11,57,48,9,57
Airdrieon,7315,4,16,5,15,51,53,-2,53
Albion,7315,5,15,7,14,57,52,5,52
Peterhead,7315,6,14,7,15,52,54,-2,49
Queen's Park,7315,7,13,8,15,42,49,-7,47
Stranraer,7315,8,12,6,18,51,62,-11,42
East Fife,7315,9,10,10,16,51,52,-1,40
Stenhousem'r,7315,10,9,5,22,52,94,-42,32
Alloa,7316,1,23,4,9,73,35,38,73
Livingston,7316,2,21,4,11,81,55,26,67
Airdrieon,7316,3,16,8,12,59,55,4,56
Albion,7316,4,16,4,16,59,55,4,52
Queen's Park,7316,5,15,4,17,46,60,-14,49
East Fife,7316,6,13,6,17,54,57,-3,45
Brechin,7316,7,13,6,17,39,51,-12,45
Stenhousem'r,7316,8,12,7,17,47,69,-22,43
Stranraer,7316,9,12,5,19,53,67,-14,41
Peterhead,7316,10,10,10,16,42,49,-7,40
Alloa,7317,1,20,8,8,64,40,24,68
Brechin,7317,2,18,8,10,59,39,20,62
Livingston,7317,3,18,7,11,81,52,29,61
Airdrieon,7317,4,17,5,14,56,59,-3,56
Albion,7317,5,15,7,14,55,53,2,52
Peterhead,7317,6,13,9,14,51,50,1,48
Queen's Park,7317,7,11,8,17,37,60,-23,41
Stranraer,7317,8,11,6,19,46,59,-13,39
Stenhousem'r,7317,9,10,8,18,50,77,-27,38
East Fife,7317,10,8,12,16,43,53,-10,36
Livingston,7318,1,23,3,10,82,48,34,72
Albion,7318,2,16,10,10,64,53,11,58
Airdrieon,7318,3,15,11,10,63,53,10,56
Alloa,7318,4,13,14,9,66,52,14,53
Peterhead,7318,5,14,8,14,46,47,-1,50
Queen's Park,7318,6,12,12,12,38,48,-10,48
Brechin,7318,7,13,8,15,44,48,-4,47
Stranraer,7318,8,12,8,16,48,54,-6,44
East Fife,7318,9,9,11,16,45,51,-6,38
Stenhousem'r,7318,10,7,7,22,43,85,-42,28
Livingston,7319,1,18,9,9,70,50,20,63
Alloa,7319,2,16,11,9,63,39,24,59
Airdrieon,7319,3,15,8,13,59,54,5,53
East Fife,7319,4,15,7,14,57,51,6,52
Albion,7319,5,14,9,13,52,44,8,51
Stranraer,7319,6,15,6,15,54,51,3,51
Brechin,7319,7,14,8,14,43,44,-1,50
Peterhead,7319,8,12,9,15,42,60,-18,45
Queen's Park,7319,9,13,6,17,37,59,-22,45
Stenhousem'r,7319,10,10,3,23,51,76,-25,33
Alloa,7320,1,19,7,10,83,52,31,64
Livingston,7320,2,18,6,12,70,53,17,60
Airdrieon,7320,3,17,9,10,60,47,13,60
Albion,7320,4,15,10,11,56,51,5,55
Brechin,7320,5,16,7,13,52,47,5,55
Stranraer,7320,6,14,7,15,56,57,-1,49
Queen's Park,7320,7,13,7,16,45,57,-12,46
Peterhead,7320,8,9,11,16,50,62,-12,38
East Fife,7320,9,9,10,17,48,51,-3,37
Stenhousem'r,7320,10,8,10,18,41,84,-43,34
Livingston,7321,1,22,5,9,75,43,32,71
Alloa,7321,2,19,7,10,74,49,25,64
Airdrieon,7321,3,18,6,12,64,54,10,60
Peterhead,7321,4,15,7,14,50,51,-1,52
Brechin,7321,5,15,6,15,50,53,-3,51
East Fife,7321,6,14,7,15,45,46,-1,49
Queen's Park,7321,7,14,7,15,36,42,-6,49
Albion,7321,8,13,6,17,55,61,-6,45
Stranraer,7321,9,12,7,17,49,61,-12,43
Stenhousem'r,7321,10,4,10,22,43,81,-38,22
Airdrieon,7322,1,21,7,8,65,46,19,70
Livingston,7322,2,21,5,10,83,46,37,68
Alloa,7322,3,18,6,12,67,44,23,60
Queen's Park,7322,4,16,9,11,48,44,4,57
Albion,7322,5,14,7,15,57,55,2,49
Stranraer,7322,6,14,4,18,49,65,-16,46
Brechin,7322,7,11,9,16,45,55,-10,42
East Fife,7322,8,10,11,15,47,49,-2,41
Peterhead,7322,9,9,10,17,40,62,-22,37
Stenhousem'r,7322,10,8,8,20,47,82,-35,32
Livingston,7323,1,23,3,10,74,45,29,72
Airdrieon,7323,2,20,7,9,64,44,20,67
Alloa,7323,3,19,6,11,69,46,23,63
Peterhead,7323,4,16,6,14,47,51,-4,54
Brechin,7323,5,16,4,16,50,54,-4,52
Albion,7323,6,13,9,14,49,47,2,48
Stranraer,7323,7,13,8,15,50,58,-8,47
Queen's Park,7323,8,12,7,17,39,51,-12,43
East Fife,7323,9,10,8,18,49,53,-4,38
Stenhousem'r,7323,10,7,4,25,38,80,-42,25
Livingston,7324,1,20,8,8,74,40,34,68
Alloa,7324,2,17,8,11,63,47,16,59
Airdrieon,7324,3,14,11,11,54,47,7,53
Brechin,7324,4,15,7,14,45,52,-7,52
Stranraer,7324,5,14,7,15,47,51,-4,49
Peterhead,7324,6,14,6,16,44,55,-11,48
Albion,7324,7,13,8,15,53,52,1,47
Queen's Park,7324,8,13,8,15,40,48,-8,47
East Fife,7324,9,12,10,14,53,48,5,46
Stenhousem'r,7324,10,7,9,20,44,77,-33,30
Alloa,7325,1,17,9,10,61,47,14,60
Brechin,7325,2,19,3,14,51,45,6,60
Airdrieon,7325,3,16,9,11,56,49,7,57
Queen's Park,7325,4,17,3,16,44,54,-10,54
Stranraer,7325,5,15,7,14,54,45,9,52
Livingston,7325,6,16,4,16,61,56,5,52
Albion,7325,7,13,9,14,64,57,7,48
Stenhousem'r,7325,8,9,14,13,46,66,-20,41
East Fife,7325,9,10,10,16,44,43,1,40
Peterhead,7325,10,10,8,18,43,62,-19,38
Alloa,7326,1,17,11,8,68,48,20,62
Brechin,7326,2,17,8,11,46,37,9,59
Airdrieon,7326,3,16,9,11,56,52,4,57
Livingston,7326,4,16,5,15,68,55,13,53
Stranraer,7326,5,17,2,17,51,53,-2,53
Peterhead,7326,6,13,8,15,51,52,-1,47
Albion,7326,7,12,10,14,49,61,-12,46
Queen's Park,7326,8,12,7,17,43,53,-10,43
East Fife,7326,9,11,9,16,52,51,1,42
Stenhousem'r,7326,10,11,7,18,45,67,-22,40
Brechin,7327,1,21,7,8,59,41,18,70
Livingston,7327,2,17,9,10,76,55,21,60
Alloa,7327,3,16,9,11,67,49,18,57
Airdrieon,7327,4,15,8,13,66,60,6,53
Stranraer,7327,5,13,10,13,50,54,-4,49
Queen's Park,7327,6,13,10,13,35,39,-4,49
Albion,7327,7,12,10,14,50,54,-4,46
Peterhead,7327,8,11,9,16,49,62,-13,42
East Fife,7327,9,9,14,13,45,52,-7,41
Stenhousem'r,7327,10,5,10,21,45,76,-31,25
Livingston,7328,1,23,2,11,75,50,25,71
Queen's Park,7328,2,19,5,12,49,48,1,62
Alloa,7328,3,17,7,12,66,44,22,58
Brechin,7328,4,17,6,13,51,53,-2,57
Stranraer,7328,5,17,4,15,55,50,5,55
East Fife,7328,6,13,10,13,56,42,14,49
Airdrieon,7328,7,14,5,17,46,57,-11,47
Albion,7328,8,9,10,17,47,63,-16,37
Peterhead,7328,9,9,10,17,45,63,-18,37
Stenhousem'r,7328,10,8,9,19,49,69,-20,33
Livingston,7329,1,24,3,9,79,41,38,75
Alloa,7329,2,20,8,8,79,46,33,68
Albion,7329,3,15,7,14,66,65,1,52
Brechin,7329,4,15,7,14,48,49,-1,52
Airdrieon,7329,5,14,9,13,53,59,-6,51
Peterhead,7329,6,14,8,14,51,51,0,50
East Fife,7329,7,13,9,14,51,48,3,48
Stranraer,7329,8,12,5,19,46,59,-13,41
Queen's Park,7329,9,10,9,17,33,50,-17,39
Stenhousem'r,7329,10,6,9,21,45,83,-38,27
Airdrieon,7330,1,20,7,9,68,49,19,67
Alloa,7330,2,18,8,10,66,46,20,62
Brechin,7330,3,18,7,11,53,45,8,61
Livingston,7330,4,18,6,12,65,46,19,60
Albion,7330,5,13,10,13,59,56,3,49
East Fife,7330,6,12,9,15,47,49,-2,45
Queen's Park,7330,7,12,8,16,40,51,-11,44
Peterhead,7330,8,10,9,17,35,50,-15,39
Stranraer,7330,9,11,6,19,44,60,-16,39
Stenhousem'r,7330,10,10,6,20,44,69,-25,36
Livingston,7331,1,22,5,9,83,48,35,71
Airdrieon,7331,2,19,6,11,69,51,18,63
Alloa,7331,3,17,9,10,70,43,27,60
Brechin,7331,4,16,9,11,57,51,6,57
Albion,7331,5,15,8,13,58,57,1,53
Peterhead,7331,6,13,8,15,49,58,-9,47
Stranraer,7331,7,14,5,17,50,60,-10,47
Queen's Park,7331,8,12,6,18,43,60,-17,42
Stenhousem'r,7331,9,9,6,21,46,81,-35,33
East Fife,7331,10,5,14,17,36,52,-16,29
Peterhead,7332,1,19,4,13,58,49,9,61
Airdrieon,7332,2,18,6,12,64,56,8,60
Brechin,7332,3,17,8,11,53,46,7,59
Albion,7332,4,16,9,11,47,40,7,57
Livingston,7332,5,18,3,15,65,59,6,57
Alloa,7332,6,16,8,12,68,44,24,56
Queen's Park,7332,7,11,9,16,32,50,-18,42
East Fife,7332,8,9,14,13,45,47,-2,41
Stranraer,7332,9,12,5,19,50,57,-7,41
Stenhousem'r,7332,10,6,10,20,41,75,-34,28
Alloa,7333,1,20,8,8,72,35,37,68
Livingston,7333,2,21,3,12,83,56,27,66
Brechin,7333,3,20,5,11,62,48,14,65
Stranraer,7333,4,15,6,15,53,59,-6,51
Airdrieon,7333,5,15,5,16,54,60,-6,50
East Fife,7333,6,12,10,14,47,43,4,46
Albion,7333,7,13,7,16,47,52,-5,46
Queen's Park,7333,8,12,8,16,39,51,-12,44
Peterhead,7333,9,12,7,17,47,53,-6,43
Stenhousem'r,7333,10,8,5,23,39,86,-47,29
Alloa,7334,1,23,6,7,80,39,41,75
Brechin,7334,2,20,3,13,64,52,12,63
Livingston,7334,3,17,6,13,74,56,18,57
East Fife,7334,4,15,10,11,56,40,16,55
Airdrieon,7334,5,15,9,12,58,54,4,54
Peterhead,7334,6,14,8,14,55,55,0,50
Albion,7334,7,14,5,17,56,57,-1,47
Queen's Park,7334,8,8,11,17,33,57,-24,35
Stenhousem'r,7334,9,10,5,21,44,86,-42,35
Stranraer,7334,10,9,7,20,50,74,-24,34
Alloa,7335,1,19,9,8,68,37,31,66
Brechin,7335,2,19,7,10,51,40,11,64
Airdrieon,7335,3,19,6,11,63,58,5,63
Livingston,7335,4,19,3,14,71,50,21,60
Peterhead,7335,5,14,11,11,55,50,5,53
Albion,7335,6,15,8,13,48,44,4,53
Stranraer,7335,7,12,7,17,46,50,-4,43
Queen's Park,7335,8,9,10,17,37,58,-21,37
Stenhousem'r,7335,9,11,3,22,48,80,-32,36
East Fife,7335,10,6,10,20,38,58,-20,28
Livingston,7336,1,20,5,11,75,57,18,65
Alloa,7336,2,18,6,12,70,47,23,60
Brechin,7336,3,16,9,11,52,42,10,57
Airdrieon,7336,4,15,9,12,56,55,1,54
Albion,7336,5,14,9,13,51,48,3,51
Peterhead,7336,6,14,7,15,52,57,-5,49
East Fife,7336,7,12,11,13,47,43,4,47
Queen's Park,7336,8,12,11,13,40,46,-6,47
Stranraer,7336,9,12,5,19,44,60,-16,41
Stenhousem'r,7336,10,8,6,22,54,86,-32,30
Livingston,7337,1,25,3,8,79,46,33,78
Airdrieon,7337,2,19,8,9,62,48,14,65
Alloa,7337,3,17,10,9,67,45,22,61
Brechin,7337,4,14,8,14,49,46,3,50
Queen's Park,7337,5,12,10,14,37,55,-18,46
East Fife,7337,6,10,14,12,47,45,2,44
Albion,7337,7,11,9,16,48,56,-8,42
Peterhead,7337,8,11,9,16,39,49,-10,42
Stranraer,7337,9,12,5,19,52,62,-10,41
Stenhousem'r,7337,10,7,8,21,48,76,-28,29
Alloa,7338,1,23,5,8,84,43,41,74
Livingston,7338,2,21,5,10,80,45,35,68
Airdrieon,7338,3,20,4,12,67,57,10,64
East Fife,7338,4,14,9,13,52,42,10,51
Brechin,7338,5,13,9,14,49,47,2,48
Queen's Park,7338,6,13,7,16,41,55,-14,46
Peterhead,7338,7,12,7,17,43,58,-15,43
Albion,7338,8,10,11,15,49,55,-6,41
Stenhousem'r,7338,9,11,8,17,46,76,-30,41
Stranraer,7338,10,9,3,24,40,73,-33,30
Livingston,7339,1,22,7,7,77,43,34,73
Brechin,7339,2,21,3,12,62,46,16,66
Alloa,7339,3,16,9,11,72,50,22,57
Albion,7339,4,14,10,12,61,61,0,52
Airdrieon,7339,5,14,7,15,51,52,-1,49
Queen's Park,7339,6,15,4,17,39,52,-13,49
Stranraer,7339,7,12,7,17,55,64,-9,43
East Fife,7339,8,11,9,16,44,44,0,42
Peterhead,7339,9,12,6,18,41,52,-11,42
Stenhousem'r,7339,10,8,8,20,50,88,-38,32
Livingston,7340,1,24,5,7,82,38,44,77
Alloa,7340,2,20,9,7,68,32,36,69
Brechin,7340,3,18,5,13,55,51,4,59
Airdrieon,7340,4,16,5,15,47,56,-9,53
Albion,7340,5,13,11,12,53,52,1,50
Peterhead,7340,6,15,5,16,56,58,-2,50
Queen's Park,7340,7,10,10,16,34,49,-15,40
East Fife,7340,8,10,9,17,49,54,-5,39
Stenhousem'r,7340,9,10,6,20,52,83,-31,36
Stranraer,7340,10,7,9,20,35,58,-23,30
Livingston,7341,1,19,9,8,74,46,28,66
Peterhead,7341,2,20,5,11,64,53,11,65
Alloa,7341,3,18,8,10,68,41,27,62
Airdrieon,7341,4,16,9,11,62,53,9,57
Albion,7341,5,16,7,13,59,55,4,55
Brechin,7341,6,13,9,14,48,55,-7,48
East Fife,7341,7,12,10,14,55,49,6,46
Queen's Park,7341,8,11,9,16,41,58,-17,42
Stranraer,7341,9,9,5,22,44,65,-21,32
Stenhousem'r,7341,10,6,9,21,45,85,-40,27
Livingston,7342,1,24,4,8,88,45,43,76
Alloa,7342,2,18,8,10,68,48,20,62
Peterhead,7342,3,19,5,12,62,51,11,62
Airdrieon,7342,4,18,7,11,66,56,10,61
Brechin,7342,5,14,6,16,51,47,4,48
Albion,7342,6,12,10,14,56,62,-6,46
East Fife,7342,7,10,12,14,48,52,-4,42
Stranraer,7342,8,11,6,19,54,70,-16,39
Queen's Park,7342,9,9,8,19,35,54,-19,35
Stenhousem'r,7342,10,9,6,21,42,85,-43,33
Airdrieon,7343,1,21,5,10,69,41,28,68
Alloa,7343,2,21,4,11,73,51,22,67
Livingston,7343,3,19,5,12,80,55,25,62
Brechin,7343,4,16,7,13,53,49,4,55
Queen's Park,7343,5,13,7,16,47,51,-4,46
Stranraer,7343,6,14,4,18,55,61,-6,46
East Fife,7343,7,12,9,15,50,60,-10,45
Stenhousem'r,7343,8,13,4,19,54,84,-30,43
Albion,7343,9,11,8,17,50,57,-7,41
Peterhead,7343,10,10,7,19,46,68,-22,37
Alloa,7344,1,18,10,8,71,49,22,64
Airdrieon,7344,2,19,7,10,66,45,21,64
Brechin,7344,3,19,7,10,61,45,16,64
Livingston,7344,4,18,5,13,69,48,21,59
East Fife,7344,5,14,9,13,53,45,8,51
Stranraer,7344,6,14,5,17,55,58,-3,47
Peterhead,7344,7,12,8,16,45,52,-7,44
Albion,7344,8,12,5,19,44,61,-17,41
Queen's Park,7344,9,10,10,16,38,56,-18,40
Stenhousem'r,7344,10,9,4,23,35,78,-43,31
Brechin,7345,1,21,8,7,57,36,21,71
Livingston,7345,2,21,6,9,84,51,33,69
Alloa,7345,3,19,7,10,69,43,26,64
Airdrieon,7345,4,15,9,12,56,58,-2,54
Peterhead,7345,5,14,8,14,49,49,0,50
Albion,7345,6,11,12,13,54,49,5,45
Stranraer,7345,7,14,3,19,55,68,-13,45
East Fife,7345,8,11,9,16,49,58,-9,42
Queen's Park,7345,9,9,8,19,29,53,-24,35
Stenhousem'r,7345,10,7,6,23,47,84,-37,27
Airdrieon,7346,1,19,8,9,71,47,24,65
Livingston,7346,2,20,5,11,73,54,19,65
Brechin,7346,3,20,4,12,60,49,11,64
Alloa,7346,4,18,9,9,67,45,22,63
Peterhead,7346,5,15,8,13,55,57,-2,53
Stranraer,7346,6,13,9,14,54,52,2,48
Albion,7346,7,12,10,14,53,57,-4,46
East Fife,7346,8,11,9,16,52,56,-4,42
Queen's Park,7346,9,8,7,21,29,57,-28,31
Stenhousem'r,7346,10,6,7,23,47,87,-40,25
Livingston,7347,1,19,5,12,75,51,24,62
Airdrieon,7347,2,18,5,13,54,54,0,59
Albion,7347,3,17,7,12,60,46,14,58
Queen's Park,7347,4,16,6,14,43,48,-5,54
Alloa,7347,5,14,10,12,54,42,12,52
East Fife,7347,6,14,7,15,54,52,2,49
Brechin,7347,7,13,8,15,45,48,-3,47
Peterhead,7347,8,11,10,15,45,57,-12,43
Stranraer,7347,9,11,8,17,47,52,-5,41
Stenhousem'r,7347,10,11,6,19,48,75,-27,39
Livingston,7348,1,20,6,10,84,53,31,66
Airdrieon,7348,2,20,5,11,62,55,7,65
Alloa,7348,3,19,7,10,71,41,30,64
East Fife,7348,4,17,8,11,62,42,20,59
Brechin,7348,5,17,7,12,58,48,10,58
Peterhead,7348,6,14,10,12,55,49,6,52
Albion,7348,7,11,7,18,45,61,-16,40
Stranraer,7348,8,10,6,20,44,70,-26,36
Stenhousem'r,7348,9,9,6,21,50,84,-34,33
Queen's Park,7348,10,8,8,20,32,60,-28,32
Livingston,7349,1,21,3,12,72,44,28,66
Airdrieon,7349,2,18,9,9,64,52,12,63
Alloa,7349,3,18,8,10,67,43,24,62
Brechin,7349,4,18,7,11,49,40,9,61
Stranraer,7349,5,16,5,15,55,55,0,53
East Fife,7349,6,13,10,13,56,49,7,49
Peterhead,7349,7,11,11,14,42,49,-7,44
Albion,7349,8,12,7,17,46,55,-9,43
Queen's Park,7349,9,10,7,19,34,57,-23,37
Stenhousem'r,7349,10,5,9,22,34,75,-41,24
Alloa,7350,1,22,5,9,80,43,37,71
Albion,7350,2,18,8,10,64,46,18,62
Livingston,7350,3,17,5,14,68,52,16,56
Brechin,7350,4,17,5,14,50,48,2,56
Peterhead,7350,5,15,8,13,54,58,-4,53
Airdrieon,7350,6,15,7,14,55,61,-6,52
Queen's Park,7350,7,14,7,15,42,50,-8,49
Stranraer,7350,8,13,5,18,49,60,-11,44
East Fife,7350,9,10,7,19,50,60,-10,37
Stenhousem'r,7350,10,7,7,22,42,76,-34,28
Alloa,7351,1,18,10,8,76,39,37,64
Livingston,7351,2,17,6,13,66,53,13,57
Stranraer,7351,3,16,6,14,55,54,1,54
Airdrieon,7351,4,16,5,15,55,54,1,53
Brechin,7351,5,14,10,12,44,47,-3,52
Queen's Park,7351,6,15,3,18,48,56,-8,48
Peterhead,7351,7,13,8,15,53,60,-7,47
Albion,7351,8,12,9,15,48,54,-6,45
East Fife,7351,9,11,11,14,50,50,0,44
Stenhousem'r,7351,10,10,8,18,48,76,-28,38
Livingston,7352,1,24,3,9,94,53,41,75
Alloa,7352,2,20,7,9,78,43,35,67
Airdrieon,7352,3,18,7,11,51,45,6,61
Brechin,7352,4,16,9,11,50,52,-2,57
East Fife,7352,5,13,9,14,57,48,9,48
Albion,7352,6,13,6,17,57,63,-6,45
Queen's Park,7352,7,13,6,17,38,54,-16,45
Peterhead,7352,8,11,8,17,42,56,-14,41
Stranraer,7352,9,11,2,23,42,63,-21,35
Stenhousem'r,7352,10,10,5,21,50,82,-32,35
Livingston,7353,1,23,3,10,83,46,37,72
Airdrieon,7353,2,21,6,9,74,49,25,69
Alloa,7353,3,18,9,9,75,39,36,63
Brechin,7353,4,17,9,10,47,40,7,60
Albion,7353,5,14,10,12,56,56,0,52
East Fife,7353,6,12,12,12,50,48,2,48
Peterhead,7353,7,13,6,17,49,55,-6,45
Queen's Park,7353,8,11,5,20,32,61,-29,38
Stranraer,7353,9,8,6,22,41,61,-20,30
Stenhousem'r,7353,10,6,8,22,49,101,-52,26
Alloa,7354,1,20,9,7,85,47,38,69
Livingston,7354,2,21,4,11,77,42,35,67
Albion,7354,3,15,10,11,53,43,10,55
Peterhead,7354,4,15,9,12,51,57,-6,54
East Fife,7354,5,15,5,16,52,48,4,50
Queen's Park,7354,6,13,11,12,42,45,-3,50
Airdrieon,7354,7,13,8,15,53,59,-6,47
Stranraer,7354,8,13,4,19,53,68,-15,43
Brechin,7354,9,11,7,18,48,61,-13,40
Stenhousem'r,7354,10,6,9,21,42,86,-44,27
Livingston,7355,1,20,7,9,78,43,35,67
Alloa,7355,2,19,8,9,64,34,30,65
Airdrieon,7355,3,16,12,8,58,47,11,60
Albion,7355,4,14,10,12,54,50,4,52
Queen's Park,7355,5,12,10,14,38,45,-7,46
East Fife,7355,6,12,8,16,46,59,-13,44
Peterhead,7355,7,12,7,17,46,55,-9,43
Brechin,7355,8,12,7,17,44,56,-12,43
Stranraer,7355,9,12,6,18,41,57,-16,42
Stenhousem'r,7355,10,8,11,17,47,70,-23,35
Livingston,7356,1,22,3,11,80,50,30,69
Airdrieon,7356,2,19,7,10,73,66,7,64
Alloa,7356,3,18,9,9,70,41,29,63
Peterhead,7356,4,18,6,12,57,49,8,60
Queen's Park,7356,5,15,9,12,42,46,-4,54
Brechin,7356,6,15,6,15,51,43,8,51
East Fife,7356,7,12,9,15,48,47,1,45
Stranraer,7356,8,12,5,19,48,62,-14,41
Albion,7356,9,11,3,22,43,58,-15,36
Stenhousem'r,7356,10,6,7,23,39,89,-50,25
Alloa,7357,1,21,8,7,75,39,36,71
Livingston,7357,2,22,4,10,92,40,52,70
Brechin,7357,3,18,4,14,59,55,4,58
Airdrieon,7357,4,16,6,14,61,65,-4,54
East Fife,7357,5,14,11,11,60,51,9,53
Albion,7357,6,14,6,16,49,52,-3,48
Stranraer,7357,7,12,8,16,52,70,-18,44
Peterhead,7357,8,10,10,16,35,55,-20,40
Stenhousem'r,7357,9,9,8,19,45,74,-29,35
Queen's Park,7357,10,8,7,21,39,66,-27,31
Livingston,7358,1,26,1,9,84,39,45,79
Airdrieon,7358,2,18,6,12,60,48,12,60
Alloa,7358,3,17,8,11,70,50,20,59
Brechin,7358,4,16,8,12,49,49,0,56
Peterhead,7358,5,14,9,13,44,49,-5,51
Queen's Park,7358,6,14,8,14,40,47,-7,50
Albion,7358,7,11,9,16,50,53,-3,42
Stranraer,7358,8,12,6,18,51,62,-11,42
East Fife,7358,9,7,11,18,42,59,-17,32
Stenhousem'r,7358,10,8,8,20,42,76,-34,32
Alloa,7359,1,18,10,8,74,50,24,64
Livingston,7359,2,19,4,13,74,54,20,61
Airdrieon,7359,3,16,8,12,56,47,9,56
Peterhead,7359,4,15,11,10,55,50,5,56
Stranraer,7359,5,14,8,14,55,57,-2,50
Brechin,7359,6,14,6,16,47,51,-4,48
Queen's Park,7359,7,13,8,15,41,46,-5,47
East Fife,7359,8,12,9,15,50,51,-1,45
Albion,7359,9,12,9,15,55,58,-3,45
Stenhousem'r,7359,10,8,5,23,45,88,-43,29
Livingston,7360,1,22,4,10,72,44,28,70
Airdrieon,7360,2,20,5,11,68,51,17,65
Alloa,7360,3,19,6,11,69,37,32,63
Brechin,7360,4,18,7,11,48,44,4,61
Peterhead,7360,5,15,6,15,46,50,-4,51
Queen's Park,7360,6,14,6,16,34,44,-10,48
East Fife,7360,7,12,7,17,53,53,0,43
Albion,7360,8,11,8,17,43,56,-13,41
Stranraer,7360,9,10,6,20,45,67,-22,36
Stenhousem'r,7360,10,7,9,20,43,75,-32,30
Livingston,7361,1,21,4,11,77,48,29,67
Alloa,7361,2,19,8,9,68,49,19,65
Brechin,7361,3,18,5,13,59,52,7,59
Airdrieon,7361,4,17,4,15,65,61,4,55
Queen's Park,7361,5,14,8,14,47,48,-1,50
East Fife,7361,6,12,11,13,58,50,8,47
Peterhead,7361,7,12,10,14,51,56,-5,46
Albion,7361,8,10,11,15,43,53,-10,41
Stranraer,7361,9,11,6,19,47,61,-14,39
Stenhousem'r,7361,10,10,5,21,49,86,-37,35
Livingston,7362,1,22,3,11,74,47,27,69
Airdrieon,7362,2,19,8,9,58,44,14,65
Alloa,7362,3,16,11,9,62,46,16,59
Peterhead,7362,4,15,7,14,61,58,3,52
Brechin,7362,5,14,10,12,59,58,1,52
Albion,7362,6,13,8,15,56,56,0,47
East Fife,7362,7,12,10,14,51,47,4,46
Queen's Park,7362,8,11,10,15,42,55,-13,43
Stranraer,7362,9,10,8,18,53,62,-9,38
Stenhousem'r,7362,10,6,9,21,42,85,-43,27
Alloa,7363,1,22,6,8,77,43,34,72
Livingston,7363,2,20,6,10,74,45,29,66
Airdrieon,7363,3,17,8,11,60,45,15,59
Brechin,7363,4,18,4,14,54,47,7,58
Stranraer,7363,5,16,3,17,51,53,-2,51
Albion,7363,6,13,9,14,53,53,0,48
East Fife,7363,7,10,10,16,49,49,0,40
Queen's Park,7363,8,10,9,17,30,52,-22,39
Peterhead,7363,9,10,8,18,38,57,-19,38
Stenhousem'r,7363,10,8,9,19,41,83,-42,33
Alloa,7364,1,19,11,6,75,44,31,68
Livingston,7364,2,20,7,9,79,45,34,67
Peterhead,7364,3,17,9,10,61,49,12,60
Airdrieon,7364,4,17,4,15,57,58,-1,55
Albion,7364,5,14,8,14,49,49,0,50
Brechin,7364,6,13,5,18,48,55,-7,44
Stranraer,7364,7,13,5,18,49,63,-14,44
Queen's Park,7364,8,13,5,18,35,56,-21,44
East Fife,7364,9,9,10,17,39,49,-10,37
Stenhousem'r,7364,10,7,12,17,48,72,-24,33
Livingston,7365,1,25,4,7,82,42,40,79
Brechin,7365,2,18,7,11,54,47,7,61
Alloa,7365,3,17,7,12,62,48,14,58
Airdrieon,7365,4,15,9,12,59,60,-1,54
Albion,7365,5,13,10,13,51,44,7,49
Queen's Park,7365,6,13,6,17,42,56,-14,45
Peterhead,7365,7,11,10,15,47,44,3,43
East Fife,7365,8,11,10,15,46,48,-2,43
Stranraer,7365,9,10,7,19,42,61,-19,37
Stenhousem'r,7365,10,9,6,21,44,79,-35,33
Livingston,7366,1,23,4,9,78,47,31,73
Alloa,7366,2,20,9,7,75,44,31,69
Brechin,7366,3,18,5,13,53,42,11,59
Airdrieon,7366,4,18,4,14,61,52,9,58
Albion,7366,5,15,7,14,57,56,1,52
Peterhead,7366,6,15,6,15,50,54,-4,51
East Fife,7366,7,12,10,14,51,51,0,46
Queen's Park,7366,8,12,7,17,39,50,-11,43
Stranraer,7366,9,9,6,21,44,63,-19,33
Stenhousem'r,7366,10,6,6,24,45,94,-49,24
Livingston,7367,1,19,5,12,72,56,16,62
Airdrieon,7367,2,18,6,12,52,49,3,60
Alloa,7367,3,17,8,11,72,50,22,59
Brechin,7367,4,15,9,12,49,43,6,54
Peterhead,7367,5,14,8,14,46,45,1,50
Stranraer,7367,6,14,7,15,54,57,-3,49
Albion,7367,7,13,8,15,51,51,0,47
East Fife,7367,8,12,8,16,57,55,2,44
Queen's Park,7367,9,12,4,20,32,53,-21,40
Stenhousem'r,7367,10,11,7,18,50,76,-26,40
Livingston,7368,1,23,6,7,83,43,40,75
Alloa,7368,2,20,6,10,71,44,27,66
Airdrieon,7368,3,16,8,12,55,54,1,56
Albion,7368,4,13,11,12,53,49,4,50
Queen's Park,7368,5,12,14,10,46,50,-4,50
Peterhead,7368,6,13,9,14,47,52,-5,48
Brechin,7368,7,11,8,17,41,56,-15,41
Stranraer,7368,8,12,4,20,48,57,-9,40
East Fife,7368,9,9,10,17,52,56,-4,37
Stenhousem'r,7368,10,9,8,19,45,80,-35,35
Livingston,7369,1,19,6,11,70,51,19,63
Alloa,7369,2,17,8,11,64,43,21,59
Airdrieon,7369,3,18,4,14,52,50,2,58
East Fife,7369,4,16,9,11,60,44,16,57
Brechin,7369,5,17,6,13,56,47,9,57
Peterhead,7369,6,14,10,12,52,48,4,52
Queen's Park,7369,7,12,7,17,40,55,-15,43
Albion,7369,8,11,8,17,41,57,-16,41
Stranraer,7369,9,11,7,18,52,65,-13,40
Stenhousem'r,7369,10,8,9,19,54,81,-27,33
Alloa,7370,1,21,9,6,80,36,44,72
Livingston,7370,2,22,5,9,82,47,35,71
Airdrieon,7370,3,19,8,9,60,50,10,65
East Fife,7370,4,15,7,14,56,47,9,52
Brechin,7370,5,14,7,15,41,50,-9,49
Queen's Park,7370,6,14,5,17,33,52,-19,47
Albion,7370,7,13,7,16,46,50,-4,46
Stranraer,7370,8,10,9,17,48,63,-15,39
Peterhead,7370,9,11,3,22,42,58,-16,36
Stenhousem'r,7370,10,6,10,20,40,75,-35,28
Livingston,7371,1,23,2,11,84,47,37,71
Alloa,7371,2,20,8,8,69,42,27,68
Airdrieon,7371,3,19,4,13,59,50,9,61
Brechin,7371,4,15,11,10,50,43,7,56
East Fife,7371,5,14,9,13,43,44,-1,51
Peterhead,7371,6,15,6,15,51,53,-2,51
Queen's Park,7371,7,13,7,16,38,47,-9,46
Stranraer,7371,8,12,5,19,46,65,-19,41
Albion,7371,9,10,8,18,45,55,-10,38
Stenhousem'r,7371,10,5,8,23,39,78,-39,23
Livingston,7372,1,20,5,11,81,51,30,65
Alloa,7372,2,18,10,8,71,41,30,64
Brechin,7372,3,17,9,10,49,47,2,60
Peterhead,7372,4,16,7,13,54,47,7,55
Albion,7372,5,14,10,12,51,45,6,52
Airdrieon,7372,6,13,9,14,45,50,-5,48
East Fife,7372,7,12,9,15,50,52,-2,45
Stranraer,7372,8,12,7,17,47,54,-7,43
Queen's Park,7372,9,10,7,19,35,55,-20,37
Stenhousem'r,7372,10,8,7,21,41,82,-41,31
Livingston,7373,1,25,2,9,85,45,40,77
Alloa,7373,2,20,6,10,61,37,24,66
Airdrieon,7373,3,20,3,13,65,59,6,63
Albion,7373,4,16,7,13,53,48,5,55
Peterhead,7373,5,16,7,13,46,47,-1,55
Brechin,7373,6,14,4,18,44,55,-11,46
Stranraer,7373,7,12,4,20,50,64,-14,40
Queen's Park,7373,8,11,7,18,31,47,-16,40
East Fife,7373,9,11,6,19,44,51,-7,39
Stenhousem'r,7373,10,9,6,21,44,70,-26,33
Alloa,7374,1,18,7,11,66,51,15,61
Airdrieon,7374,2,17,9,10,53,39,14,60
Livingston,7374,3,16,8,12,66,51,15,56
Brechin,7374,4,18,2,16,52,54,-2,56
Albion,7374,5,14,8,14,57,47,10,50
Stranraer,7374,6,13,11,12,47,52,-5,50
East Fife,7374,7,14,7,15,49,43,6,49
Queen's Park,7374,8,13,8,15,50,53,-3,47
Peterhead,7374,9,10,9,17,40,51,-11,39
Stenhousem'r,7374,10,10,5,21,49,88,-39,35
Livingston,7375,1,20,3,13,75,57,18,63
Alloa,7375,2,17,11,8,78,53,25,62
Brechin,7375,3,17,6,13,53,50,3,57
Albion,7375,4,16,7,13,58,50,8,55
Peterhead,7375,5,15,10,11,55,47,8,55
Airdrieon,7375,6,14,7,15,52,61,-9,49
Queen's Park,7375,7,13,8,15,32,50,-18,47
East Fife,7375,8,12,9,15,52,47,5,45
Stranraer,7375,9,11,6,19,50,58,-8,39
Stenhousem'r,7375,10,7,9,20,42,74,-32,30
Alloa,7376,1,20,10,6,70,32,38,70
Airdrieon,7376,2,18,4,14,61,54,7,58
Queen's Park,7376,3,17,6,13,44,45,-1,57
Brechin,7376,4,16,4,16,50,47,3,52
Peterhead,7376,5,15,7,14,51,54,-3,52
Livingston,7376,6,15,6,15,58,48,10,51
East Fife,7376,7,14,9,13,50,43,7,51
Albion,7376,8,14,5,17,53,57,-4,47
Stranraer,7376,9,10,9,17,34,53,-19,39
Stenhousem'r,7376,10,7,8,21,42,80,-38,29
Peterhead,7377,1,18,9,9,62,38,24,63
Livingston,7377,2,19,6,11,67,48,19,63
Airdrieon,7377,3,18,7,11,63,51,12,61
Albion,7377,4,15,12,9,60,53,7,57
Brechin,7377,5,17,6,13,51,46,5,57
Alloa,7377,6,16,8,12,54,41,13,56
Stranraer,7377,7,13,5,18,50,55,-5,44
East Fife,7377,8,9,9,18,49,62,-13,36
Queen's Park,7377,9,9,8,19,30,55,-25,35
Stenhousem'r,7377,10,8,6,22,43,80,-37,30
Livingston,7378,1,23,4,9,74,43,31,73
Alloa,7378,2,19,4,13,61,42,19,61
Peterhead,7378,3,17,6,13,49,45,4,57
Albion,7378,4,16,5,15,54,53,1,53
Brechin,7378,5,16,4,16,52,53,-1,52
Stranraer,7378,6,15,6,15,59,56,3,51
Airdrieon,7378,7,13,7,16,46,52,-6,46
Queen's Park,7378,8,13,5,18,33,54,-21,44
East Fife,7378,9,11,10,15,58,57,1,43
Stenhousem'r,7378,10,7,9,20,43,74,-31,30
Livingston,7379,1,24,3,9,87,48,39,75
Brechin,7379,2,21,6,9,64,41,23,69
Alloa,7379,3,17,11,8,70,42,28,62
Airdrieon,7379,4,16,9,11,66,57,9,57
Queen's Park,7379,5,14,9,13,40,47,-7,51
Peterhead,7379,6,12,9,15,48,51,-3,45
Albion,7379,7,13,6,17,49,62,-13,45
East Fife,7379,8,8,12,16,49,62,-13,36
Stranraer,7379,9,8,7,21,47,71,-24,31
Stenhousem'r,7379,10,8,6,22,41,80,-39,30
Alloa,7380,1,22,5,9,72,38,34,71
Livingston,7380,2,20,6,10,66,42,24,66
Airdrieon,7380,3,15,10,11,53,47,6,55
Albion,7380,4,15,6,15,49,48,1,51
Brechin,7380,5,15,6,15,44,50,-6,51
Peterhead,7380,6,14,7,15,52,54,-2,49
East Fife,7380,7,14,6,16,46,47,-1,48
Stranraer,7380,8,13,8,15,55,55,0,47
Queen's Park,7380,9,13,8,15,33,43,-10,47
Stenhousem'r,7380,10,6,4,26,42,88,-46,22
Livingston,7381,1,20,6,10,87,57,30,66
Alloa,7381,2,18,8,10,60,43,17,62
Airdrieon,7381,3,18,6,12,59,54,5,60
Peterhead,7381,4,17,7,12,60,51,9,58
Brechin,7381,5,17,5,14,52,49,3,56
Albion,7381,6,14,10,12,56,54,2,52
Queen's Park,7381,7,14,7,15,42,50,-8,49
East Fife,7381,8,11,7,18,43,49,-6,40
Stranraer,7381,9,10,6,20,40,56,-16,36
Stenhousem'r,7381,10,6,8,22,54,90,-36,26
Alloa,7382,1,21,8,7,73,44,29,71
Livingston,7382,2,21,5,10,84,52,32,68
Brechin,7382,3,21,2,13,48,49,-1,65
Albion,7382,4,18,5,13,51,44,7,59
Airdrieon,7382,5,16,6,14,60,57,3,54
Peterhead,7382,6,13,9,14,53,48,5,48
East Fife,7382,7,11,8,17,46,47,-1,41
Queen's Park,7382,8,12,4,20,41,63,-22,40
Stranraer,7382,9,11,6,19,44,63,-19,39
Stenhousem'r,7382,10,7,5,24,44,77,-33,26
Livingston,7383,1,21,4,11,74,52,22,67
Alloa,7383,2,19,8,9,69,42,27,65
Brechin,7383,3,17,5,14,53,53,0,56
Airdrieon,7383,4,15,7,14,60,63,-3,52
Peterhead,7383,5,13,10,13,53,50,3,49
Queen's Park,7383,6,14,5,17,46,55,-9,47
East Fife,7383,7,11,12,13,47,47,0,45
Stranraer,7383,8,13,5,18,46,58,-12,44
Albion,7383,9,11,8,17,49,55,-6,41
Stenhousem'r,7383,10,10,8,18,50,72,-22,38
Livingston,7384,1,20,6,10,77,51,26,66
Alloa,7384,2,17,12,7,71,44,27,63
Airdrieon,7384,3,17,6,13,52,54,-2,57
East Fife,7384,4,12,15,9,49,41,8,51
Stranraer,7384,5,14,7,15,49,57,-8,49
Brechin,7384,6,12,10,14,46,50,-4,46
Peterhead,7384,7,12,9,15,55,54,1,45
Albion,7384,8,11,10,15,46,50,-4,43
Stenhousem'r,7384,9,11,9,16,52,69,-17,42
Queen's Park,7384,10,9,6,21,29,56,-27,33
Livingston,7385,1,19,3,14,62,43,19,60
Albion,7385,2,17,8,11,59,52,7,59
Airdrieon,7385,3,17,7,12,60,48,12,58
Alloa,7385,4,16,8,12,63,44,19,56
Peterhead,7385,5,15,10,11,52,52,0,55
Stranraer,7385,6,16,5,15,48,52,-4,53
Brechin,7385,7,13,11,12,43,47,-4,50
Queen's Park,7385,8,13,6,17,39,51,-12,45
East Fife,7385,9,11,9,16,42,42,0,42
Stenhousem'r,7385,10,5,9,22,40,77,-37,24
Livingston,7386,1,19,6,11,74,47,27,63
East Fife,7386,2,16,11,9,58,41,17,59
Airdrieon,7386,3,17,8,11,56,47,9,59
Alloa,7386,4,16,7,13,70,51,19,55
Brechin,7386,5,17,3,16,52,55,-3,54
Peterhead,7386,6,16,5,15,50,50,0,53
Stranraer,7386,7,12,8,16,47,57,-10,44
Queen's Park,7386,8,13,4,19,35,56,-21,43
Albion,7386,9,10,11,15,44,55,-11,41
Stenhousem'r,7386,10,8,9,19,41,68,-27,33
Alloa,7387,1,20,6,10,70,44,26,66
Livingston,7387,2,19,6,11,73,48,25,63
Airdrieon,7387,3,18,6,12,64,47,17,60
Queen's Park,7387,4,17,5,14,46,45,1,56
Brechin,7387,5,16,6,14,52,57,-5,54
Albion,7387,6,14,7,15,62,55,7,49
Stranraer,7387,7,14,5,17,55,68,-13,47
Peterhead,7387,8,10,9,17,48,69,-21,39
East Fife,7387,9,9,9,18,48,58,-10,36
Stenhousem'r,7387,10,9,9,18,44,71,-27,36
Livingston,7388,1,20,6,10,77,50,27,66
Airdrieon,7388,2,17,7,12,61,47,14,58
Brechin,7388,3,16,8,12,51,49,2,56
Alloa,7388,4,16,7,13,69,53,16,55
East Fife,7388,5,14,10,12,54,46,8,52
Peterhead,7388,6,14,10,12,49,54,-5,52
Queen's Park,7388,7,12,9,15,35,44,-9,45
Albion,7388,8,12,8,16,56,54,2,44
Stranraer,7388,9,11,9,16,51,58,-7,42
Stenhousem'r,7388,10,7,8,21,38,86,-48,29
Livingston,7389,1,22,3,11,80,46,34,69
Alloa,7389,2,20,9,7,77,43,34,69
Stranraer,7389,3,16,9,11,57,49,8,57
Brechin,7389,4,16,8,12,54,55,-1,56
Peterhead,7389,5,13,9,14,52,55,-3,48
Airdrieon,7389,6,13,7,16,53,65,-12,46
Albion,7389,7,11,11,14,47,47,0,44
East Fife,7389,8,9,11,16,48,56,-8,38
Queen's Park,7389,9,9,11,16,39,58,-19,38
Stenhousem'r,7389,10,7,10,19,43,76,-33,31
Alloa,7390,1,21,6,9,72,40,32,69
Livingston,7390,2,20,7,9,75,48,27,67
Brechin,7390,3,15,7,14,49,55,-6,52
Albion,7390,4,15,6,15,52,46,6,51
Peterhead,7390,5,15,6,15,52,54,-2,51
Airdrieon,7390,6,13,9,14,58,55,3,48
East Fife,7390,7,12,9,15,48,50,-2,45
Stranraer,7390,8,12,7,17,50,58,-8,43
Queen's Park,7390,9,11,8,17,36,55,-19,41
Stenhousem'r,7390,10,9,9,18,46,77,-31,36
Livingston,7391,1,21,3,12,73,49,24,66
Alloa,7391,2,17,11,8,63,41,22,62
Brechin,7391,3,18,6,12,58,49,9,60
Queen's Park,7391,4,17,7,12,43,41,2,58
Airdrieon,7391,5,14,6,16,56,60,-4,48
Albion,7391,6,12,9,15,50,54,-4,45
East Fife,7391,7,12,7,17,51,54,-3,43
Stranraer,7391,8,11,10,15,45,48,-3,43
Peterhead,7391,9,10,11,15,48,58,-10,41
Stenhousem'r,7391,10,10,6,20,43,76,-33,36
Livingston,7392,1,23,6,7,75,41,34,75
Airdrieon,7392,2,19,6,11,62,50,12,63
Alloa,7392,3,18,8,10,68,47,21,62
Peterhead,7392,4,15,7,14,51,43,8,52
Brechin,7392,5,15,7,14,50,56,-6,52
Albion,7392,6,13,8,15,48,51,-3,47
Queen's Park,7392,7,13,7,16,42,56,-14,46
East Fife,7392,8,11,10,15,44,50,-6,43
Stranraer,7392,9,10,6,20,50,61,-11,36
Stenhousem'r,7392,10,5,11,20,43,78,-35,26
Livingston,7393,1,20,3,13,84,52,32,63
Brechin,7393,2,18,9,9,51,42,9,63
Airdrieon,7393,3,18,6,12,53,49,4,60
Alloa,7393,4,17,7,12,63,48,15,58
Albion,7393,5,15,9,12,59,54,5,54
Peterhead,7393,6,13,12,11,55,46,9,51
Queen's Park,7393,7,15,6,15,37,44,-7,51
Stenhousem'r,7393,8,10,7,19,47,81,-34,37
Stranraer,7393,9,10,6,20,42,60,-18,36
East Fife,7393,10,8,7,21,43,58,-15,31
Airdrieon,7394,1,20,7,9,62,44,18,67
Alloa,7394,2,20,6,10,67,49,18,66
Livingston,7394,3,20,5,11,66,46,20,65
Brechin,7394,4,18,6,12,56,44,12,60
Albion,7394,5,12,9,15,51,60,-9,45
East Fife,7394,6,11,10,15,45,42,3,43
Queen's Park,7394,7,11,10,15,31,49,-18,43
Peterhead,7394,8,10,8,18,48,55,-7,38
Stranraer,7394,9,9,10,17,45,60,-15,37
Stenhousem'r,7394,10,8,11,17,53,75,-22,35
Airdrieon,7395,1,17,9,10,60,51,9,60
Albion,7395,2,17,6,13,66,54,12,57
Livingston,7395,3,17,5,14,67,51,16,56
East Fife,7395,4,15,10,11,52,41,11,55
Queen's Park,7395,5,15,10,11,39,43,-4,55
Brechin,7395,6,14,10,12,45,49,-4,52
Alloa,7395,7,14,8,14,66,50,16,50
Peterhead,7395,8,12,12,12,48,50,-2,48
Stranraer,7395,9,12,8,16,51,53,-2,44
Stenhousem'r,7395,10,4,8,24,41,93,-52,20
Livingston,7396,1,20,7,9,74,43,31,67
Alloa,7396,2,17,10,9,73,47,26,61
Albion,7396,3,17,8,11,56,49,7,59
Peterhead,7396,4,17,7,12,54,45,9,58
Airdrieon,7396,5,17,5,14,63,60,3,56
Brechin,7396,6,14,7,15,47,53,-6,49
Queen's Park,7396,7,12,6,18,42,61,-19,42
Stranraer,7396,8,12,5,19,61,75,-14,41
Stenhousem'r,7396,9,11,6,19,48,72,-24,39
East Fife,7396,10,7,11,18,40,53,-13,32
Alloa,7397,1,21,6,9,73,44,29,69
Livingston,7397,2,21,5,10,85,57,28,68
Brechin,7397,3,18,5,13,54,44,10,59
Peterhead,7397,4,16,4,16,55,59,-4,52
Albion,7397,5,14,7,15,55,57,-2,49
Stranraer,7397,6,14,5,17,50,53,-3,47
Airdrieon,7397,7,13,8,15,54,62,-8,47
East Fife,7397,8,13,7,16,53,54,-1,46
Queen's Park,7397,9,12,5,19,31,52,-21,41
Stenhousem'r,7397,10,9,6,21,42,70,-28,33
Livingston,7398,1,23,6,7,81,40,41,75
Alloa,7398,2,21,5,10,75,45,30,68
Airdrieon,7398,3,19,7,10,65,52,13,64
Albion,7398,4,16,8,12,56,53,3,56
Brechin,7398,5,16,7,13,54,44,10,55
Stranraer,7398,6,13,6,17,48,53,-5,45
Queen's Park,7398,7,12,9,15,45,57,-12,45
Peterhead,7398,8,11,6,19,43,57,-14,39
East Fife,7398,9,8,8,20,42,53,-11,32
Stenhousem'r,7398,10,7,6,23,38,93,-55,27
Livingston,7399,1,27,1,8,88,36,52,82
Alloa,7399,2,18,10,8,67,42,25,64
Airdrieon,7399,3,19,5,12,60,56,4,62
East Fife,7399,4,15,9,12,61,50,11,54
Brechin,7399,5,14,9,13,48,49,-1,51
Albion,7399,6,13,9,14,58,59,-1,48
Stenhousem'r,7399,7,9,11,16,53,83,-30,38
Stranraer,7399,8,9,9,18,40,55,-15,36
Queen's Park,7399,9,10,6,20,36,51,-15,36
Peterhead,7399,10,7,9,20,41,71,-30,30
Livingston,7400,1,21,4,11,76,45,31,67
Alloa,7400,2,19,6,11,69,54,15,63
Brechin,7400,3,16,9,11,50,44,6,57
Peterhead,7400,4,16,8,12,57,48,9,56
Albion,7400,5,15,7,14,56,53,3,52
Airdrieon,7400,6,15,7,14,55,61,-6,52
East Fife,7400,7,14,9,13,52,44,8,51
Queen's Park,7400,8,12,8,16,33,46,-13,44
Stranraer,7400,9,7,11,18,41,57,-16,32
Stenhousem'r,7400,10,6,9,21,43,80,-37,27
Alloa,7401,1,19,8,9,67,44,23,65
Airdrieon,7401,2,19,7,10,62,54,8,64
Livingston,7401,3,19,6,11,83,59,24,63
Brechin,7401,4,17,7,12,55,44,11,58
Peterhead,7401,5,14,10,12,59,50,9,52
East Fife,7401,6,12,9,15,49,47,2,45
Albion,7401,7,11,9,16,47,58,-11,42
Stranraer,7401,8,11,7,18,44,60,-16,40
Stenhousem'r,7401,9,12,4,20,57,78,-21,40
Queen's Park,7401,10,9,7,20,38,67,-29,34
Livingston,7402,1,23,3,10,77,43,34,72
Alloa,7402,2,22,4,10,71,44,27,70
Brechin,7402,3,19,4,13,50,47,3,61
Airdrieon,7402,4,16,8,12,52,54,-2,56
Albion,7402,5,16,5,15,58,54,4,53
Stranraer,7402,6,16,5,15,50,52,-2,53
Peterhead,7402,7,16,3,17,54,50,4,51
Queen's Park,7402,8,13,6,17,41,53,-12,45
East Fife,7402,9,8,10,18,45,52,-7,34
Stenhousem'r,7402,10,4,6,26,40,89,-49,18
Alloa,7403,1,24,5,7,74,39,35,77
Livingston,7403,2,21,7,8,75,39,36,70
Brechin,7403,3,17,4,15,48,42,6,55
East Fife,7403,4,15,8,13,53,43,10,53
Airdrieon,7403,5,15,6,15,52,57,-5,51
Albion,7403,6,12,9,15,46,53,-7,45
Peterhead,7403,7,13,6,17,47,60,-13,45
Queen's Park,7403,8,12,5,19,36,52,-16,41
Stranraer,7403,9,11,4,21,46,66,-20,37
Stenhousem'r,7403,10,9,8,19,44,70,-26,35
Livingston,7404,1,21,1,14,73,49,24,64
Albion,7404,2,17,9,10,61,49,12,60
Airdrieon,7404,3,15,14,7,61,51,10,59
Alloa,7404,4,17,6,13,63,46,17,57
Brechin,7404,5,15,6,15,49,50,-1,51
Stranraer,7404,6,15,6,15,52,54,-2,51
East Fife,7404,7,12,9,15,56,51,5,45
Queen's Park,7404,8,13,6,17,46,62,-16,45
Peterhead,7404,9,10,11,15,49,55,-6,41
Stenhousem'r,7404,10,6,10,20,49,92,-43,28
Livingston,7405,1,23,5,8,76,44,32,74
Brechin,7405,2,20,5,11,56,36,20,65
Alloa,7405,3,18,5,13,72,54,18,59
East Fife,7405,4,12,11,13,55,45,10,47
Peterhead,7405,5,13,8,15,53,56,-3,47
Airdrieon,7405,6,13,8,15,56,64,-8,47
Queen's Park,7405,7,13,6,17,39,49,-10,45
Stenhousem'r,7405,8,12,7,17,42,75,-33,43
Albion,7405,9,11,7,18,49,58,-9,40
Stranraer,7405,10,11,6,19,49,66,-17,39
Livingston,7406,1,22,5,9,83,44,39,71
Alloa,7406,2,18,8,10,65,49,16,62
Peterhead,7406,3,18,6,12,58,44,14,60
Albion,7406,4,17,5,14,53,50,3,56
Airdrieon,7406,5,15,9,12,63,65,-2,54
Brechin,7406,6,15,6,15,50,56,-6,51
East Fife,7406,7,13,9,14,57,53,4,48
Queen's Park,7406,8,12,4,20,33,51,-18,40
Stranraer,7406,9,11,6,19,47,62,-15,39
Stenhousem'r,7406,10,7,6,23,52,87,-35,27
Alloa,7407,1,22,6,8,73,41,32,72
Livingston,7407,2,19,6,11,74,43,31,63
Brechin,7407,3,19,4,13,54,45,9,61
Airdrieon,7407,4,17,6,13,59,55,4,57
Albion,7407,5,13,9,14,47,53,-6,48
Queen's Park,7407,6,14,6,16,36,46,-10,48
East Fife,7407,7,11,12,13,41,41,0,45
Stranraer,7407,8,10,9,17,46,56,-10,39
Peterhead,7407,9,10,9,17,40,56,-16,39
Stenhousem'r,7407,10,6,11,19,39,73,-34,29
Livingston,7408,1,24,5,7,80,50,30,77
Brechin,7408,2,18,8,10,55,36,19,62
Alloa,7408,3,19,5,12,66,48,18,62
Airdrieon,7408,4,15,9,12,58,54,4,54
East Fife,7408,5,14,8,14,57,48,9,50
Albion,7408,6,13,6,17,54,58,-4,45
Peterhead,7408,7,12,9,15,41,51,-10,45
Queen's Park,7408,8,13,4,19,39,59,-20,43
Stranraer,7408,9,11,6,19,47,57,-10,39
Stenhousem'r,7408,10,7,8,21,45,81,-36,29
Alloa,7409,1,20,10,6,82,41,41,70
Livingston,7409,2,22,4,10,79,47,32,70
Airdrieon,7409,3,17,7,12,60,59,1,58
Stranraer,7409,4,17,5,14,51,54,-3,56
Brechin,7409,5,15,8,13,55,55,0,53
Albion,7409,6,12,11,13,46,45,1,47
Peterhead,7409,7,12,8,16,39,52,-13,44
Queen's Park,7409,8,10,11,15,37,51,-14,41
East Fife,7409,9,7,11,18,45,55,-10,32
Stenhousem'r,7409,10,7,7,22,46,81,-35,28
Livingston,7410,1,22,5,9,87,51,36,71
Alloa,7410,2,21,8,7,80,47,33,71
Airdrieon,7410,3,14,11,11,56,50,6,53
Peterhead,7410,4,14,11,11,58,54,4,53
Albion,7410,5,13,9,14,51,55,-4,48
Queen's Park,7410,6,12,11,13,41,53,-12,47
Brechin,7410,7,14,3,19,53,66,-13,45
East Fife,7410,8,12,7,17,48,59,-11,43
Stranraer,7410,9,11,5,20,48,63,-15,38
Stenhousem'r,7410,10,8,8,20,38,62,-24,32
Alloa,7411,1,18,12,6,74,47,27,66
Brechin,7411,2,19,5,12,62,50,12,62
Livingston,7411,3,17,9,10,66,47,19,60
Airdrieon,7411,4,16,10,10,59,43,16,58
Peterhead,7411,5,15,10,11,49,49,0,55
East Fife,7411,6,14,7,15,58,54,4,49
Albion,7411,7,11,8,17,49,61,-12,41
Stranraer,7411,8,10,7,19,44,61,-17,37
Queen's Park,7411,9,9,9,18,42,58,-16,36
Stenhousem'r,7411,10,8,9,19,49,82,-33,33
Alloa,7412,1,19,7,10,71,44,27,64
Albion,7412,2,18,6,12,60,49,11,60
Airdrieon,7412,3,18,5,13,57,58,-1,59
Livingston,7412,4,18,4,14,72,59,13,58
East Fife,7412,5,15,7,14,59,47,12,52
Brechin,7412,6,14,7,15,56,57,-1,49
Stranraer,7412,7,13,8,15,50,55,-5,47
Peterhead,7412,8,13,6,17,45,58,-13,45
Queen's Park,7412,9,10,11,15,32,45,-13,41
Stenhousem'r,7412,10,6,11,19,45,75,-30,29
Airdrieon,7413,1,21,4,11,77,58,19,67
Alloa,7413,2,20,4,12,74,45,29,64
Brechin,7413,3,18,8,10,51,43,8,62
Livingston,7413,4,20,1,15,78,61,17,61
Stranraer,7413,5,16,6,14,57,57,0,54
Albion,7413,6,12,10,14,57,59,-2,46
Queen's Park,7413,7,13,5,18,38,55,-17,44
East Fife,7413,8,12,6,18,46,57,-11,42
Peterhead,7413,9,11,7,18,46,63,-17,40
Stenhousem'r,7413,10,8,7,21,50,76,-26,31
Livingston,7414,1,22,5,9,80,45,35,71
Alloa,7414,2,19,7,10,66,48,18,64
Airdrieon,7414,3,18,8,10,56,43,13,62
Brechin,7414,4,16,7,13,58,52,6,55
Albion,7414,5,16,6,14,54,47,7,54
Peterhead,7414,6,13,8,15,43,54,-11,47
East Fife,7414,7,11,9,16,49,54,-5,42
Stranraer,7414,8,11,9,16,43,53,-10,42
Queen's Park,7414,9,10,8,18,36,52,-16,38
Stenhousem'r,7414,10,7,7,22,42,79,-37,28
Alloa,7415,1,23,5,8,84,36,48,74
Livingston,7415,2,20,5,11,80,47,33,65
Airdrieon,7415,3,19,8,9,66,61,5,65
Brechin,7415,4,15,7,14,54,54,0,52
Peterhead,7415,5,12,8,16,50,54,-4,44
Queen's Park,7415,6,12,8,16,35,46,-11,44
East Fife,7415,7,11,9,16,44,55,-11,42
Stranraer,7415,8,11,7,18,48,65,-17,40
Albion,7415,9,11,7,18,48,66,-18,40
Stenhousem'r,7415,10,10,8,18,56,81,-25,38
Livingston,7416,1,22,2,12,81,49,32,68
Alloa,7416,2,20,7,9,75,44,31,67
Brechin,7416,3,19,5,12,56,47,9,62
Airdrieon,7416,4,17,8,11,56,52,4,59
Albion,7416,5,15,8,13,52,47,5,53
Peterhead,7416,6,15,6,15,50,55,-5,51
Stranraer,7416,7,13,6,17,47,54,-7,45
Queen's Park,7416,8,10,7,19,27,46,-19,37
East Fife,7416,9,8,9,19,42,58,-16,33
Stenhousem'r,7416,10,9,6,21,44,78,-34,33
Alloa,7417,1,22,3,11,71,44,27,69
Livingston,7417,2,19,5,12,70,52,18,62
Peterhead,7417,3,17,7,12,47,48,-1,58
Brechin,7417,4,18,3,15,58,51,7,57
Airdrieon,7417,5,18,3,15,58,57,1,57
Queen's Park,7417,6,14,7,15,42,45,-3,49
Albion,7417,7,12,11,13,49,47,2,47
East Fife,7417,8,11,9,16,48,48,0,42
Stranraer,7417,9,12,5,19,43,55,-12,41
Stenhousem'r,7417,10,6,9,21,40,79,-39,27
Livingston,7418,1,25,3,8,82,33,49,78
Alloa,7418,2,19,9,8,71,41,30,66
Albion,7418,3,17,7,12,61,46,15,58
Brechin,7418,4,17,6,13,47,41,6,57
Airdrieon,7418,5,16,7,13,57,60,-3,55
Stranraer,7418,6,15,6,15,64,59,5,51
Peterhead,7418,7,12,9,15,44,51,-7,45
East Fife,7418,8,12,7,17,50,64,-14,43
Queen's Park,7418,9,8,10,18,33,55,-22,34
Stenhousem'r,7418,10,3,8,25,29,88,-59,17
Livingston,7419,1,21,7,8,77,44,33,70
Alloa,7419,2,20,7,9,78,45,33,67
Airdrieon,7419,3,16,7,13,61,56,5,55
Brechin,7419,4,16,7,13,50,48,2,55
Peterhead,7419,5,16,6,14,51,53,-2,54
Albion,7419,6,12,10,14,53,58,-5,46
Stranraer,7419,7,11,10,15,50,62,-12,43
East Fife,7419,8,10,11,15,47,51,-4,41
Queen's Park,7419,9,11,7,18,39,60,-21,40
Stenhousem'r,7419,10,7,8,21,48,77,-29,29
Alloa,7420,1,21,5,10,74,44,30,68
Livingston,7420,2,17,7,12,73,57,16,58
Brechin,7420,3,14,13,9,53,42,11,55
Stranraer,7420,4,16,4,16,58,59,-1,52
Queen's Park,7420,5,15,7,14,44,50,-6,52
Albion,7420,6,12,13,11,56,52,4,49
Peterhead,7420,7,13,9,14,49,54,-5,48
East Fife,7420,8,11,11,14,50,45,5,44
Airdrieon,7420,9,12,5,19,51,66,-15,41
Stenhousem'r,7420,10,8,8,20,45,84,-39,32
Alloa,7421,1,20,10,6,77,41,36,70
Livingston,7421,2,18,6,12,76,52,24,60
Airdrieon,7421,3,17,7,12,61,55,6,58
Brechin,7421,4,16,8,12,50,41,9,56
East Fife,7421,5,13,10,13,55,53,2,49
Albion,7421,6,13,10,13,48,58,-10,49
Stranraer,7421,7,14,5,17,59,69,-10,47
Queen's Park,7421,8,12,5,19,34,45,-11,41
Stenhousem'r,7421,9,10,7,19,55,81,-26,37
Peterhead,7421,10,9,8,19,38,58,-20,35
Livingston,7422,1,21,5,10,78,51,27,68
Airdrieon,7422,2,19,7,10,64,49,15,64
Peterhead,7422,3,16,9,11,56,52,4,57
Alloa,7422,4,14,12,10,58,53,5,54
East Fife,7422,5,13,10,13,45,45,0,49
Brechin,7422,6,12,10,14,44,49,-5,46
Stenhousem'r,7422,7,12,6,18,52,73,-21,42
Stranraer,7422,8,12,5,19,60,70,-10,41
Albion,7422,9,11,7,18,52,56,-4,40
Queen's Park,7422,10,11,7,18,37,48,-11,40
Livingston,7423,1,20,5,11,77,53,24,65
Brechin,7423,2,16,9,11,53,44,9,57
Airdrieon,7423,3,15,12,9,55,53,2,57
Alloa,7423,4,14,11,11,63,47,16,53
Albion,7423,5,13,12,11,44,44,0,51
Peterhead,7423,6,14,8,14,54,52,2,50
Stranraer,7423,7,14,6,16,48,54,-6,48
Queen's Park,7423,8,11,11,14,37,47,-10,44
East Fife,7423,9,12,7,17,50,52,-2,43
Stenhousem'r,7423,10,6,9,21,40,75,-35,27
Alloa,7424,1,20,7,9,79,44,35,67
Livingston,7424,2,17,6,13,63,47,16,57
Brechin,7424,3,16,8,12,52,44,8,56
Airdrieon,7424,4,16,8,12,52,54,-2,56
Queen's Park,7424,5,16,6,14,39,53,-14,54
Albion,7424,6,15,7,14,60,55,5,52
Peterhead,7424,7,14,9,13,46,46,0,51
Stranraer,7424,8,12,6,18,47,53,-6,42
East Fife,7424,9,10,10,16,42,47,-5,40
Stenhousem'r,7424,10,5,11,20,46,83,-37,26
Livingston,7425,1,19,5,12,76,50,26,62
Alloa,7425,2,17,8,11,69,51,18,59
Airdrieon,7425,3,16,8,12,60,52,8,56
Albion,7425,4,16,8,12,57,58,-1,56
Brechin,7425,5,14,7,15,56,56,0,49
Queen's Park,7425,6,13,8,15,37,41,-4,47
Peterhead,7425,7,13,8,15,61,68,-7,47
East Fife,7425,8,11,10,15,49,56,-7,43
Stenhousem'r,7425,9,11,9,16,51,69,-18,42
Stranraer,7425,10,11,7,18,44,59,-15,40
Livingston,7426,1,22,4,10,84,53,31,70
Alloa,7426,2,19,11,6,69,38,31,68
Airdrieon,7426,3,16,7,13,56,53,3,55
Albion,7426,4,15,10,11,53,52,1,55
Brechin,7426,5,16,5,15,45,45,0,53
Peterhead,7426,6,13,8,15,45,51,-6,47
Stranraer,7426,7,13,4,19,45,58,-13,43
Queen's Park,7426,8,11,8,17,40,50,-10,41
East Fife,7426,9,10,10,16,51,55,-4,40
Stenhousem'r,7426,10,9,5,22,49,82,-33,32
Alloa,7427,1,18,9,9,72,42,30,63
Livingston,7427,2,17,7,12,72,52,20,58
Albion,7427,3,17,6,13,63,50,13,57
Airdrieon,7427,4,17,6,13,50,52,-2,57
Stranraer,7427,5,15,6,15,54,56,-2,51
East Fife,7427,6,13,10,13,52,52,0,49
Brechin,7427,7,14,4,18,42,56,-14,46
Queen's Park,7427,8,13,6,17,33,52,-19,45
Peterhead,7427,9,10,11,15,37,47,-10,41
Stenhousem'r,7427,10,11,5,20,53,69,-16,38
Alloa,7428,1,21,8,7,68,38,30,71
Livingston,7428,2,21,4,11,73,47,26,67
Brechin,7428,3,17,8,11,66,51,15,59
Queen's Park,7428,4,14,8,14,39,52,-13,50
Albion,7428,5,15,4,17,60,61,-1,49
Airdrieon,7428,6,14,7,15,63,67,-4,49
East Fife,7428,7,13,8,15,54,57,-3,47
Peterhead,7428,8,13,7,16,50,57,-7,46
Stranraer,7428,9,9,8,19,43,57,-14,35
Stenhousem'r,7428,10,9,6,21,62,91,-29,33
Livingston,7429,1,19,8,9,87,50,37,65
Alloa,7429,2,18,9,9,71,49,22,63
Brechin,7429,3,17,6,13,55,43,12,57
Albion,7429,4,14,11,11,57,58,-1,53
Peterhead,7429,5,14,9,13,55,53,2,51
Airdrieon,7429,6,14,9,13,56,56,0,51
East Fife,7429,7,14,7,15,45,49,-4,49
Queen's Park,7429,8,14,4,18,46,61,-15,46
Stranraer,7429,9,8,9,19,46,74,-28,33
Stenhousem'r,7429,10,7,10,19,49,74,-25,31
Livingston,7430,1,23,4,9,88,48,40,73
Alloa,7430,2,22,5,9,79,40,39,71
Airdrieon,7430,3,16,4,16,58,66,-8,52
Brechin,7430,4,15,7,14,53,62,-9,52
East Fife,7430,5,14,8,14,60,52,8,50
Albion,7430,6,12,11,13,54,54,0,47
Stranraer,7430,7,13,6,17,52,61,-9,45
Queen's Park,7430,8,12,9,15,37,48,-11,45
Peterhead,7430,9,10,12,14,45,46,-1,42
Stenhousem'r,7430,10,7,6,23,49,98,-49,27
Alloa,7431,1,19,9,8,75,47,28,66
Albion,7431,2,18,8,10,66,59,7,62
Livingston,7431,3,17,9,10,74,58,16,60
Airdrieon,7431,4,17,7,12,64,54,10,58
Brechin,7431,5,17,6,13,52,47,5,57
Peterhead,7431,6,16,5,15,53,51,2,53
East Fife,7431,7,11,11,14,44,41,3,44
Queen's Park,7431,8,13,2,21,43,54,-11,41
Stranraer,7431,9,10,5,21,45,68,-23,35
Stenhousem'r,7431,10,6,10,20,41,78,-37,28
Livingston,7432,1,21,4,11,62,44,18,67
Alloa,7432,2,19,9,8,71,42,29,66
Airdrieon,7432,3,18,5,13,68,64,4,59
Albion,7432,4,15,7,14,56,50,6,52
Brechin,7432,5,16,3,17,55,47,8,51
Queen's Park,7432,6,13,9,14,43,48,-5,48
Peterhead,7432,7,13,7,16,51,58,-7,46
East Fife,7432,8,12,10,14,45,53,-8,46
Stenhousem'r,7432,9,12,7,17,55,74,-19,43
Stranraer,7432,10,8,5,23,43,69,-26,29
Brechin,7433,1,19,8,9,60,53,7,65
Livingston,7433,2,19,6,11,75,46,29,63
Alloa,7433,3,18,7,11,83,50,33,61
Airdrieon,7433,4,16,6,14,61,60,1,54
Peterhead,7433,5,13,9,14,50,50,0,48
Queen's Park,7433,6,12,11,13,38,52,-14,47
Stranraer,7433,7,13,6,17,49,61,-12,45
Albion,7433,8,12,8,16,46,53,-7,44
East Fife,7433,9,8,15,13,38,45,-7,39
Stenhousem'r,7433,10,6,12,18,45,75,-30,30
Livingston,7434,1,23,6,7,78,41,37,75
Alloa,7434,2,19,9,8,71,35,36,66
Albion,7434,3,16,7,13,53,49,4,55
Airdrieon,7434,4,15,7,14,53,55,-2,52
East Fife,7434,5,13,9,14,56,47,9,48
Peterhead,7434,6,12,11,13,47,55,-8,47
Brechin,7434,7,13,7,16,50,63,-13,46
Stranraer,7434,8,12,7,17,56,64,-8,43
Queen's Park,7434,9,9,10,17,33,50,-17,37
Stenhousem'r,7434,10,8,7,21,45,83,-38,31
Livingston,7435,1,22,4,10,73,41,32,70
Alloa,7435,2,20,7,9,64,39,25,67
Airdrieon,7435,3,17,7,12,51,51,0,58
Brechin,7435,4,16,9,11,56,50,6,57
Albion,7435,5,15,5,16,44,53,-9,50
Peterhead,7435,6,13,10,13,51,50,1,49
Queen's Park,7435,7,13,6,17,35,46,-11,45
Stranraer,7435,8,12,7,17,46,54,-8,43
East Fife,7435,9,9,9,18,42,49,-7,36
Stenhousem'r,7435,10,6,10,20,46,75,-29,28
Alloa,7436,1,19,9,8,67,44,23,66
Livingston,7436,2,18,7,11,65,51,14,61
Brechin,7436,3,16,8,12,50,50,0,56
Albion,7436,4,14,11,11,58,51,7,53
Queen's Park,7436,5,14,9,13,38,41,-3,51
Peterhead,7436,6,15,5,16,68,67,1,50
Airdrieon,7436,7,14,5,17,53,58,-5,47
Stranraer,7436,8,12,6,18,49,60,-11,42
East Fife,7436,9,9,13,14,46,49,-3,40
Stenhousem'r,7436,10,8,9,19,53,76,-23,33
Livingston,7437,1,21,4,11,69,41,28,67
Alloa,7437,2,19,6,11,71,48,23,63
Airdrieon,7437,3,18,6,12,63,51,12,60
East Fife,7437,4,15,8,13,47,46,1,53
Peterhead,7437,5,15,7,14,49,49,0,52
Stranraer,7437,6,15,5,16,46,48,-2,50
Brechin,7437,7,14,7,15,52,56,-4,49
Albion,7437,8,10,8,18,37,48,-11,38
Queen's Park,7437,9,10,7,19,45,68,-23,37
Stenhousem'r,7437,10,8,12,16,45,69,-24,36
Alloa,7438,1,18,7,11,58,43,15,61
Livingston,7438,2,18,3,15,69,52,17,57
Brechin,7438,3,15,9,12,53,47,6,54
Albion,7438,4,15,9,12,53,52,1,54
Stranraer,7438,5,15,7,14,52,50,2,52
Queen's Park,7438,6,14,9,13,42,48,-6,51
Peterhead,7438,7,14,8,14,43,46,-3,50
Airdrieon,7438,8,14,8,14,42,51,-9,50
East Fife,7438,9,10,7,19,46,50,-4,37
Stenhousem'r,7438,10,10,7,19,54,73,-19,37
Livingston,7439,1,23,5,8,77,35,42,74
Alloa,7439,2,20,9,7,79,40,39,69
Albion,7439,3,16,9,11,55,43,12,57
Airdrieon,7439,4,15,8,13,56,52,4,53
East Fife,7439,5,14,10,12,60,44,16,52
Brechin,7439,6,13,11,12,46,52,-6,50
Queen's Park,7439,7,11,8,17,33,55,-22,41
Stranraer,7439,8,10,9,17,40,59,-19,39
Peterhead,7439,9,8,10,18,43,64,-21,34
Stenhousem'r,7439,10,7,7,22,41,86,-45,28
Livingston,7440,1,23,5,8,69,37,32,74
Alloa,7440,2,21,6,9,75,44,31,69
Brechin,7440,3,18,7,11,48,38,10,61
Airdrieon,7440,4,16,8,12,53,50,3,56
Albion,7440,5,14,10,12,51,42,9,52
Queen's Park,7440,6,13,7,16,40,59,-19,46
Stranraer,7440,7,12,9,15,54,58,-4,45
Peterhead,7440,8,11,4,21,44,65,-21,37
East Fife,7440,9,9,9,18,52,52,0,36
Stenhousem'r,7440,10,8,5,23,46,87,-41,29
Alloa,7441,1,20,7,9,75,42,33,67
Airdrieon,7441,2,20,7,9,72,50,22,67
East Fife,7441,3,17,10,9,50,33,17,61
Livingston,7441,4,17,5,14,71,58,13,56
Queen's Park,7441,5,15,6,15,43,50,-7,51
Albion,7441,6,13,9,14,49,57,-8,48
Brechin,7441,7,14,6,16,45,54,-9,48
Peterhead,7441,8,11,12,13,49,56,-7,45
Stranraer,7441,9,10,3,23,43,66,-23,33
Stenhousem'r,7441,10,6,9,21,48,79,-31,27
Alloa,7442,1,19,7,10,64,38,26,64
Livingston,7442,2,18,8,10,76,54,22,62
Airdrieon,7442,3,18,7,11,60,53,7,61
Peterhead,7442,4,17,8,11,57,43,14,59
Albion,7442,5,15,10,11,55,55,0,55
Brechin,7442,6,14,8,14,47,46,1,50
Stranraer,7442,7,14,6,16,51,58,-7,48
Queen's Park,7442,8,12,6,18,36,53,-17,42
East Fife,7442,9,9,9,18,49,57,-8,36
Stenhousem'r,7442,10,7,5,24,47,85,-38,26
Alloa,7443,1,18,11,7,75,42,33,65
Airdrieon,7443,2,19,6,11,60,47,13,63
Livingston,7443,3,17,8,11,70,52,18,59
Brechin,7443,4,15,9,12,53,51,2,54
Peterhead,7443,5,16,5,15,47,53,-6,53
East Fife,7443,6,13,9,14,53,45,8,48
Albion,7443,7,11,11,14,47,51,-4,44
Queen's Park,7443,8,10,11,15,36,56,-20,41
Stenhousem'r,7443,9,9,9,18,53,77,-24,36
Stranraer,7443,10,9,7,20,45,65,-20,34
Livingston,7444,1,23,5,8,77,40,37,74
Brechin,7444,2,21,5,10,62,45,17,68
Alloa,7444,3,18,10,8,68,51,17,64
Airdrieon,7444,4,16,9,11,61,52,9,57
Albion,7444,5,11,12,13,53,51,2,45
Queen's Park,7444,6,11,9,16,37,51,-14,42
East Fife,7444,7,11,7,18,51,59,-8,40
Stenhousem'r,7444,8,9,11,16,60,81,-21,38
Peterhead,7444,9,10,6,20,55,69,-14,36
Stranraer,7444,10,8,10,18,47,72,-25,34
Livingston,7445,1,23,3,10,68,38,30,72
Alloa,7445,2,18,7,11,69,49,20,61
Airdrieon,7445,3,16,8,12,58,49,9,56
Brechin,7445,4,16,8,12,43,44,-1,56
Albion,7445,5,14,8,14,53,45,8,50
Queen's Park,7445,6,15,5,16,39,52,-13,50
East Fife,7445,7,12,12,12,50,45,5,48
Peterhead,7445,8,13,7,16,44,54,-10,46
Stenhousem'r,7445,9,9,7,20,44,70,-26,34
Stranraer,7445,10,9,5,22,43,65,-22,32
Alloa,7446,1,23,5,8,81,41,40,74
Airdrieon,7446,2,18,6,12,65,57,8,60
Livingston,7446,3,17,5,14,73,55,18,56
Peterhead,7446,4,16,7,13,51,54,-3,55
Albion,7446,5,15,7,14,57,50,7,52
Stranraer,7446,6,16,2,18,58,64,-6,50
East Fife,7446,7,12,13,11,55,45,10,49
Brechin,7446,8,14,6,16,52,56,-4,48
Queen's Park,7446,9,9,6,21,33,63,-30,33
Stenhousem'r,7446,10,9,5,22,41,81,-40,32
Alloa,7447,1,22,6,8,67,40,27,72
Livingston,7447,2,21,6,9,85,46,39,69
Brechin,7447,3,19,8,9,62,46,16,65
Airdrieon,7447,4,17,6,13,52,45,7,57
Stranraer,7447,5,15,3,18,47,58,-11,48
Peterhead,7447,6,11,12,13,38,46,-8,45
East Fife,7447,7,12,8,16,48,49,-1,44
Albion,7447,8,10,10,16,49,68,-19,40
Queen's Park,7447,9,11,7,18,38,57,-19,40
Stenhousem'r,7447,10,7,4,25,52,83,-31,25
Livingston,7448,1,22,5,9,80,49,31,71
Alloa,7448,2,21,6,9,74,40,34,69
Airdrieon,7448,3,17,5,14,58,51,7,56
Brechin,7448,4,16,7,13,53,52,1,55
Albion,7448,5,15,8,13,56,50,6,53
Peterhead,7448,6,13,7,16,46,53,-7,46
Stranraer,7448,7,9,14,13,56,67,-11,41
Queen's Park,7448,8,10,11,15,38,55,-17,41
East Fife,7448,9,10,10,16,47,50,-3,40
Stenhousem'r,7448,10,6,9,21,42,83,-41,27
Alloa,7449,1,19,8,9,75,46,29,65
Livingston,7449,2,19,5,12,81,53,28,62
Queen's Park,7449,3,15,10,11,47,43,4,55
Peterhead,7449,4,16,7,13,49,52,-3,55
Brechin,7449,5,15,8,13,60,59,1,53
Albion,7449,6,14,10,12,58,50,8,52
Airdrieon,7449,7,14,6,16,52,60,-8,48
Stranraer,7449,8,12,9,15,68,70,-2,45
East Fife,7449,9,10,10,16,47,53,-6,40
Stenhousem'r,7449,10,7,5,24,44,95,-51,26
Livingston,7450,1,18,8,10,65,47,18,62
Alloa,7450,2,17,10,9,67,45,22,61
Airdrieon,7450,3,17,9,10,61,46,15,60
Albion,7450,4,16,6,14,64,54,10,54
Stranraer,7450,5,15,6,15,49,50,-1,51
Queen's Park,7450,6,13,9,14,42,47,-5,48
Brechin,7450,7,13,9,14,46,52,-6,48
Peterhead,7450,8,11,11,14,45,49,-4,44
East Fife,7450,9,8,11,17,42,54,-12,35
Stenhousem'r,7450,10,9,7,20,45,82,-37,34
Livingston,7451,1,22,6,8,77,54,23,72
Alloa,7451,2,19,9,8,69,40,29,66
Airdrieon,7451,3,17,11,8,65,51,14,62
Brechin,7451,4,17,4,15,58,51,7,55
Peterhead,7451,5,12,10,14,47,52,-5,46
Stranraer,7451,6,13,5,18,54,63,-9,44
Albion,7451,7,11,9,16,47,50,-3,42
East Fife,7451,8,11,9,16,49,55,-6,42
Queen's Park,7451,9,10,9,17,38,57,-19,39
Stenhousem'r,7451,10,7,10,19,53,84,-31,31
Livingston,7452,1,23,2,11,74,47,27,71
Alloa,7452,2,21,5,10,72,46,26,68
Brechin,7452,3,18,7,11,53,38,15,61
Queen's Park,7452,4,14,6,16,39,43,-4,48
Airdrieon,7452,5,14,6,16,49,59,-10,48
Stranraer,7452,6,13,6,17,48,54,-6,45
Peterhead,7452,7,12,8,16,48,59,-11,44
Albion,7452,8,12,7,17,48,59,-11,43
East Fife,7452,9,11,8,17,44,46,-2,41
Stenhousem'r,7452,10,10,9,17,55,79,-24,39
Livingston,7453,1,27,1,8,88,47,41,82
Airdrieon,7453,2,18,6,12,63,52,11,60
Brechin,7453,3,18,4,14,66,66,0,58
Alloa,7453,4,14,11,11,69,51,18,53
Peterhead,7453,5,14,7,15,52,55,-3,49
East Fife,7453,6,13,7,16,43,46,-3,46
Queen's Park,7453,7,12,10,14,40,50,-10,46
Stranraer,7453,8,13,6,17,60,66,-6,45
Albion,7453,9,11,8,17,53,67,-14,41
Stenhousem'r,7453,10,7,6,23,49,83,-34,27
Livingston,7454,1,20,6,10,70,47,23,66
Brechin,7454,2,20,4,12,62,45,17,64
Albion,7454,3,15,8,13,62,52,10,53
Airdrieon,7454,4,15,8,13,60,58,2,53
Alloa,7454,5,13,13,10,62,49,13,52
Peterhead,7454,6,15,7,14,49,48,1,52
Queen's Park,7454,7,14,10,12,43,47,-4,52
East Fife,7454,8,10,9,17,52,58,-6,39
Stranraer,7454,9,11,6,19,53,68,-15,39
Stenhousem'r,7454,10,7,9,20,44,85,-41,30
Brechin,7455,1,21,7,8,62,48,14,70
Livingston,7455,2,20,7,9,79,53,26,67
Alloa,7455,3,20,6,10,73,44,29,66
Airdrieon,7455,4,18,7,11,63,52,11,61
Albion,7455,5,15,7,14,51,51,0,52
East Fife,7455,6,13,6,17,44,51,-7,45
Stranraer,7455,7,12,7,17,51,62,-11,43
Peterhead,7455,8,12,5,19,45,54,-9,41
Queen's Park,7455,9,9,7,20,37,56,-19,34
Stenhousem'r,7455,10,8,5,23,41,75,-34,29
Livingston,7456,1,19,5,12,76,48,28,62
Albion,7456,2,15,11,10,68,48,20,56
Brechin,7456,3,17,5,14,55,51,4,56
Alloa,7456,4,13,14,9,60,49,11,53
Peterhead,7456,5,15,8,13,47,54,-7,53
Stranraer,7456,6,15,6,15,56,53,3,51
Airdrieon,7456,7,13,10,13,52,57,-5,49
Queen's Park,7456,8,14,6,16,43,51,-8,48
East Fife,7456,9,12,9,15,48,53,-5,45
Stenhousem'r,7456,10,4,12,20,37,78,-41,24
Livingston,7457,1,22,6,8,84,41,43,72
Alloa,7457,2,20,6,10,68,43,25,66
Brechin,7457,3,20,3,13,56,50,6,63
Airdrieon,7457,4,16,4,16,53,54,-1,52
Peterhead,7457,5,15,6,15,48,51,-3,51
East Fife,7457,6,13,10,13,54,49,5,49
Stenhousem'r,7457,7,12,5,19,52,75,-23,41
Stranraer,7457,8,11,7,18,51,60,-9,40
Queen's Park,7457,9,11,6,19,30,50,-20,39
Albion,7457,10,11,5,20,49,72,-23,38
Alloa,7458,1,22,8,6,87,42,45,74
Livingston,7458,2,21,5,10,79,49,30,68
Airdrieon,7458,3,19,4,13,58,53,5,61
Brechin,7458,4,16,12,8,51,42,9,60
Peterhead,7458,5,14,7,15,43,50,-7,49
Queen's Park,7458,6,14,5,17,45,53,-8,47
East Fife,7458,7,10,10,16,52,56,-4,40
Stranraer,7458,8,11,5,20,46,61,-15,38
Albion,7458,9,7,12,17,46,61,-15,33
Stenhousem'r,7458,10,8,8,20,39,79,-40,32
Livingston,7459,1,23,7,6,82,35,47,76
Alloa,7459,2,21,9,6,74,38,36,72
Brechin,7459,3,18,5,13,55,53,2,59
Airdrieon,7459,4,15,8,13,55,57,-2,53
Albion,7459,5,13,6,17,43,46,-3,45
Peterhead,7459,6,11,12,13,51,57,-6,45
Stranraer,7459,7,10,11,15,46,55,-9,41
Queen's Park,7459,8,10,10,16,40,60,-20,40
East Fife,7459,9,8,12,16,46,50,-4,36
Stenhousem'r,7459,10,7,8,21,38,79,-41,29
Alloa,7460,1,20,7,9,81,41,40,67
Livingston,7460,2,19,9,8,74,54,20,66
Airdrieon,7460,3,17,11,8,60,50,10,62
Peterhead,7460,4,13,10,13,48,55,-7,49
Stranraer,7460,5,14,6,16,51,58,-7,48
East Fife,7460,6,12,11,13,59,52,7,47
Albion,7460,7,13,7,16,51,48,3,46
Brechin,7460,8,12,8,16,48,58,-10,44
Queen's Park,7460,9,10,10,16,34,53,-19,40
Stenhousem'r,7460,10,5,11,20,41,78,-37,26
Livingston,7461,1,22,5,9,75,48,27,71
Alloa,7461,2,17,7,12,66,44,22,58
Airdrieon,7461,3,18,4,14,56,50,6,58
Albion,7461,4,15,10,11,63,54,9,55
East Fife,7461,5,13,11,12,51,42,9,50
Queen's Park,7461,6,13,9,14,45,50,-5,48
Stranraer,7461,7,14,6,16,47,55,-8,48
Brechin,7461,8,12,10,14,40,42,-2,46
Peterhead,7461,9,11,9,16,41,53,-12,42
Stenhousem'r,7461,10,5,9,22,47,93,-46,24
Alloa,7462,1,20,10,6,82,37,45,70
Livingston,7462,2,21,4,11,73,42,31,67
Airdrieon,7462,3,15,8,13,60,55,5,53
Albion,7462,4,14,7,15,52,58,-6,49
Brechin,7462,5,13,8,15,42,46,-4,47
Peterhead,7462,6,13,8,15,45,64,-19,47
East Fife,7462,7,11,10,15,42,47,-5,43
Queen's Park,7462,8,11,10,15,38,50,-12,43
Stranraer,7462,9,12,6,18,49,64,-15,42
Stenhousem'r,7462,10,11,7,18,45,65,-20,40
Alloa,7463,1,18,11,7,62,36,26,65
Albion,7463,2,19,7,10,69,46,23,64
Livingston,7463,3,18,7,11,70,51,19,61
Brechin,7463,4,19,4,13,46,37,9,61
Airdrieon,7463,5,15,8,13,55,53,2,53
Stranraer,7463,6,12,8,16,48,54,-6,44
East Fife,7463,7,10,10,16,52,59,-7,40
Peterhead,7463,8,10,9,17,40,54,-14,39
Queen's Park,7463,9,10,7,19,32,56,-24,37
Stenhousem'r,7463,10,9,9,18,51,79,-28,36
Livingston,7464,1,22,8,6,81,44,37,74
Alloa,7464,2,20,5,11,71,45,26,65
Brechin,7464,3,17,8,11,54,41,13,59
Airdrieon,7464,4,16,7,13,54,53,1,55
Albion,7464,5,14,11,11,55,51,4,53
East Fife,7464,6,9,15,12,47,47,0,42
Peterhead,7464,7,10,12,14,47,55,-8,42
Stranraer,7464,8,11,7,18,48,60,-12,40
Queen's Park,7464,9,8,12,16,32,53,-21,36
Stenhousem'r,7464,10,6,9,21,48,88,-40,27
Alloa,7465,1,23,6,7,81,39,42,75
Livingston,7465,2,23,3,10,73,41,32,72
Albion,7465,3,16,8,12,60,47,13,56
Airdrieon,7465,4,14,8,14,61,62,-1,50
Stranraer,7465,5,15,4,17,62,67,-5,49
Peterhead,7465,6,12,10,14,51,61,-10,46
Brechin,7465,7,13,6,17,41,49,-8,45
East Fife,7465,8,10,10,16,51,54,-3,40
Queen's Park,7465,9,10,8,18,26,52,-26,38
Stenhousem'r,7465,10,7,11,18,56,90,-34,32
Livingston,7466,1,24,3,9,83,51,32,75
Peterhead,7466,2,16,9,11,59,53,6,57
Alloa,7466,3,16,6,14,65,49,16,54
Brechin,7466,4,16,6,14,62,59,3,54
Queen's Park,7466,5,15,7,14,46,48,-2,52
Albion,7466,6,14,8,14,55,53,2,50
Airdrieon,7466,7,14,8,14,58,58,0,50
East Fife,7466,8,13,10,13,60,56,4,49
Stranraer,7466,9,8,9,19,43,64,-21,33
Stenhousem'r,7466,10,7,8,21,50,90,-40,29
Alloa,7467,1,20,8,8,73,36,37,68
Brechin,7467,2,20,5,11,58,45,13,65
Airdrieon,7467,3,17,6,13,56,53,3,57
Livingston,7467,4,18,2,16,66,48,18,56
Albion,7467,5,13,10,13,44,42,2,49
Peterhead,7467,6,13,10,13,51,51,0,49
Queen's Park,7467,7,14,4,18,29,54,-25,46
Stenhousem'r,7467,8,12,9,15,48,66,-18,45
Stranraer,7467,9,11,8,17,44,54,-10,41
East Fife,7467,10,6,10,20,36,56,-20,28
Alloa,7468,1,20,7,9,67,44,23,67
Livingston,7468,2,20,6,10,70,43,27,66
Peterhead,7468,3,18,6,12,57,48,9,60
Queen's Park,7468,4,16,7,13,42,38,4,55
Brechin,7468,5,16,6,14,53,49,4,54
Airdrieon,7468,6,15,9,12,53,53,0,54
Albion,7468,7,14,7,15,52,52,0,49
East Fife,7468,8,12,7,17,51,56,-5,43
Stenhousem'r,7468,9,8,9,19,49,81,-32,33
Stranraer,7468,10,5,8,23,36,66,-30,23
Livingston,7469,1,22,4,10,79,45,34,70
Peterhead,7469,2,16,10,10,53,39,14,58
Brechin,7469,3,17,6,13,46,52,-6,57
Alloa,7469,4,14,10,12,58,42,16,52
Albion,7469,5,13,11,12,50,47,3,50
East Fife,7469,6,11,12,13,42,40,2,45
Stranraer,7469,7,14,3,19,43,56,-13,45
Airdrieon,7469,8,12,8,16,49,57,-8,44
Stenhousem'r,7469,9,11,7,18,49,70,-21,40
Queen's Park,7469,10,11,7,18,36,57,-21,40
Livingston,7470,1,23,2,11,91,49,42,71
Airdrieon,7470,2,17,7,12,54,53,1,58
Alloa,7470,3,17,6,13,70,56,14,57
Peterhead,7470,4,16,9,11,57,54,3,57
Brechin,7470,5,17,5,14,55,45,10,56
Albion,7470,6,15,9,12,55,57,-2,54
East Fife,7470,7,10,13,13,55,56,-1,43
Stranraer,7470,8,10,10,16,48,57,-9,40
Queen's Park,7470,9,7,11,18,35,62,-27,32
Stenhousem'r,7470,10,8,8,20,49,80,-31,32
Livingston,7471,1,26,3,7,95,51,44,81
Alloa,7471,2,18,6,12,68,43,25,60
Airdrieon,7471,3,17,7,12,64,51,13,58
Peterhead,7471,4,16,9,11,47,41,6,57
Albion,7471,5,13,8,15,49,49,0,47
East Fife,7471,6,12,10,14,49,46,3,46
Brechin,7471,7,14,4,18,49,66,-17,46
Queen's Park,7471,8,12,6,18,36,63,-27,42
Stranraer,7471,9,11,8,17,49,55,-6,41
Stenhousem'r,7471,10,7,7,22,46,87,-41,28
Alloa,7472,1,24,6,6,80,36,44,78
Livingston,7472,2,19,3,14,72,57,15,60
Brechin,7472,3,17,5,14,51,43,8,56
Albion,7472,4,16,5,15,55,53,2,53
East Fife,7472,5,13,11,12,50,45,5,50
Queen's Park,7472,6,14,7,15,36,48,-12,49
Airdrieon,7472,7,13,9,14,55,60,-5,48
Peterhead,7472,8,13,9,14,43,50,-7,48
Stranraer,7472,9,10,6,20,44,65,-21,36
Stenhousem'r,7472,10,7,7,22,42,71,-29,28
Peterhead,7473,1,18,7,11,55,46,9,61
Alloa,7473,2,18,6,12,70,47,23,60
Airdrieon,7473,3,17,8,11,58,59,-1,59
Livingston,7473,4,18,4,14,76,53,23,58
Brechin,7473,5,17,4,15,53,46,7,55
East Fife,7473,6,15,8,13,53,45,8,53
Albion,7473,7,15,6,15,52,63,-11,51
Stranraer,7473,8,13,9,14,54,52,2,48
Queen's Park,7473,9,13,3,20,39,53,-14,42
Stenhousem'r,7473,10,6,5,25,44,90,-46,23
Alloa,7474,1,20,7,9,78,50,28,67
Livingston,7474,2,21,4,11,73,47,26,67
Airdrieon,7474,3,20,7,9,74,51,23,67
Brechin,7474,4,16,7,13,50,53,-3,55
Albion,7474,5,14,8,14,51,51,0,50
Queen's Park,7474,6,14,4,18,40,49,-9,46
Stranraer,7474,7,11,11,14,60,61,-1,44
Peterhead,7474,8,11,9,16,45,55,-10,42
East Fife,7474,9,11,6,19,46,59,-13,39
Stenhousem'r,7474,10,7,7,22,43,84,-41,28
Alloa,7475,1,19,9,8,69,53,16,66
Albion,7475,2,19,5,12,59,50,9,62
Airdrieon,7475,3,18,4,14,57,54,3,58
Brechin,7475,4,15,10,11,49,41,8,55
Livingston,7475,5,15,9,12,64,45,19,54
East Fife,7475,6,12,11,13,48,43,5,47
Queen's Park,7475,7,13,8,15,41,48,-7,47
Stranraer,7475,8,12,8,16,54,55,-1,44
Peterhead,7475,9,12,7,17,48,58,-10,43
Stenhousem'r,7475,10,7,5,24,40,82,-42,26
Alloa,7476,1,19,8,9,76,42,34,65
Livingston,7476,2,20,4,12,79,48,31,64
East Fife,7476,3,17,9,10,57,44,13,60
Albion,7476,4,17,7,12,57,47,10,58
Airdrieon,7476,5,16,6,14,57,61,-4,54
Queen's Park,7476,6,15,7,14,40,49,-9,52
Brechin,7476,7,15,6,15,54,56,-2,51
Stranraer,7476,8,14,5,17,59,61,-2,47
Peterhead,7476,9,9,5,22,47,76,-29,32
Stenhousem'r,7476,10,7,5,24,45,87,-42,26
Alloa,7477,1,21,8,7,79,39,40,71
Livingston,7477,2,20,6,10,76,52,24,66
Airdrieon,7477,3,18,7,11,58,49,9,61
Brechin,7477,4,17,8,11,49,47,2,59
Peterhead,7477,5,14,8,14,55,56,-1,50
Stranraer,7477,6,14,7,15,51,54,-3,49
Albion,7477,7,14,6,16,52,46,6,48
Stenhousem'r,7477,8,8,11,17,49,74,-25,35
East Fife,7477,9,8,8,20,46,62,-16,32
Queen's Park,7477,10,7,9,20,28,64,-36,30
Livingston,7478,1,20,5,11,74,46,28,65
Alloa,7478,2,17,11,8,60,40,20,62
Airdrieon,7478,3,16,9,11,53,51,2,57
Albion,7478,4,15,11,10,53,45,8,56
Brechin,7478,5,14,9,13,47,46,1,51
Stranraer,7478,6,14,4,18,52,61,-9,46
Peterhead,7478,7,11,11,14,52,57,-5,44
Queen's Park,7478,8,12,8,16,36,50,-14,44
East Fife,7478,9,10,13,13,49,44,5,43
Stenhousem'r,7478,10,8,5,23,49,85,-36,29
Alloa,7479,1,23,4,9,78,43,35,73
Livingston,7479,2,21,3,12,83,55,28,66
Albion,7479,3,17,6,13,56,49,7,57
Brechin,7479,4,16,8,12,59,50,9,56
Airdrieon,7479,5,15,9,12,51,52,-1,54
Peterhead,7479,6,15,5,16,50,53,-3,50
Stranraer,7479,7,14,5,17,55,63,-8,47
Queen's Park,7479,8,12,9,15,49,65,-16,45
Stenhousem'r,7479,9,7,10,19,45,73,-28,31
East Fife,7479,10,6,9,21,34,57,-23,27
Livingston,7480,1,18,7,11,63,49,14,61
Alloa,7480,2,17,8,11,70,51,19,59
Airdrieon,7480,3,17,6,13,69,54,15,57
Brechin,7480,4,16,7,13,50,52,-2,55
Albion,7480,5,15,6,15,56,60,-4,51
Queen's Park,7480,6,15,5,16,41,51,-10,50
Peterhead,7480,7,13,10,13,53,53,0,49
East Fife,7480,8,13,6,17,53,46,7,45
Stranraer,7480,9,13,4,19,57,73,-16,43
Stenhousem'r,7480,10,10,7,19,51,74,-23,37
Livingston,7481,1,23,6,7,84,47,37,75
Alloa,7481,2,19,7,10,72,52,20,64
Brechin,7481,3,17,7,12,53,49,4,58
Airdrieon,7481,4,17,5,14,64,56,8,56
Albion,7481,5,14,7,15,59,54,5,49
Peterhead,7481,6,15,4,17,56,60,-4,49
Queen's Park,7481,7,14,6,16,46,58,-12,48
Stranraer,7481,8,13,4,19,49,62,-13,43
East Fife,7481,9,10,7,19,46,57,-11,37
Stenhousem'r,7481,10,9,5,22,48,82,-34,32
Alloa,7482,1,22,7,7,85,39,46,73
Livingston,7482,2,19,7,10,70,53,17,64
Airdrieon,7482,3,17,9,10,62,50,12,60
Brechin,7482,4,15,7,14,54,54,0,52
Peterhead,7482,5,15,6,15,52,49,3,51
East Fife,7482,6,13,8,15,47,47,0,47
Albion,7482,7,12,7,17,51,56,-5,43
Stranraer,7482,8,12,7,17,44,66,-22,43
Queen's Park,7482,9,10,7,19,32,52,-20,37
Stenhousem'r,7482,10,10,5,21,49,80,-31,35
Livingston,7483,1,19,6,11,71,46,25,63
Airdrieon,7483,2,16,10,10,61,48,13,58
Brechin,7483,3,18,4,14,46,48,-2,58
Alloa,7483,4,16,9,11,62,50,12,57
Albion,7483,5,16,8,12,59,49,10,56
Peterhead,7483,6,16,7,13,53,54,-1,55
Queen's Park,7483,7,12,9,15,42,51,-9,45
East Fife,7483,8,11,10,15,48,51,-3,43
Stranraer,7483,9,9,9,18,50,63,-13,36
Stenhousem'r,7483,10,9,4,23,40,72,-32,31
Livingston,7484,1,22,7,7,79,39,40,73
Alloa,7484,2,18,8,10,67,41,26,62
Peterhead,7484,3,16,7,13,57,48,9,55
Queen's Park,7484,4,15,6,15,41,50,-9,51
Airdrieon,7484,5,15,6,15,52,63,-11,51
Brechin,7484,6,14,5,17,48,58,-10,47
East Fife,7484,7,12,10,14,49,48,1,46
Stranraer,7484,8,13,6,17,60,63,-3,45
Albion,7484,9,12,5,19,45,61,-16,41
Stenhousem'r,7484,10,9,8,19,50,77,-27,35
Livingston,7485,1,20,4,12,81,54,27,64
Brechin,7485,2,18,7,11,52,45,7,61
Alloa,7485,3,16,9,11,69,50,19,57
Albion,7485,4,16,8,12,55,50,5,56
Airdrieon,7485,5,16,7,13,57,54,3,55
Queen's Park,7485,6,15,9,12,49,55,-6,54
East Fife,7485,7,11,11,14,46,47,-1,44
Peterhead,7485,8,10,11,15,53,62,-9,41
Stranraer,7485,9,10,8,18,46,61,-15,38
Stenhousem'r,7485,10,6,10,20,47,77,-30,28
Brechin,7486,1,22,3,11,54,43,11,69
Alloa,7486,2,18,8,10,70,44,26,62
Albion,7486,3,18,8,10,59,43,16,62
Peterhead,7486,4,18,5,13,51,49,2,59
Livingston,7486,5,16,7,13,65,53,12,55
Airdrieon,7486,6,15,5,16,60,58,2,50
Queen's Park,7486,7,13,7,16,38,50,-12,46
Stranraer,7486,8,13,3,20,53,65,-12,42
Stenhousem'r,7486,9,10,6,20,44,65,-21,36
East Fife,7486,10,8,6,22,34,58,-24,30
Livingston,7487,1,23,5,8,76,46,30,74
Alloa,7487,2,17,9,10,68,51,17,60
Brechin,7487,3,16,11,9,52,37,15,59
Airdrieon,7487,4,16,8,12,65,57,8,56
Queen's Park,7487,5,13,10,13,37,46,-9,49
Peterhead,7487,6,14,6,16,48,61,-13,48
Albion,7487,7,13,6,17,54,61,-7,45
East Fife,7487,8,10,13,13,57,52,5,43
Stranraer,7487,9,12,7,17,62,63,-1,43
Stenhousem'r,7487,10,5,7,24,37,82,-45,22
Livingston,7488,1,21,6,9,69,43,26,69
Alloa,7488,2,20,6,10,65,42,23,66
Airdrieon,7488,3,18,7,11,67,59,8,61
Brechin,7488,4,19,2,15,48,40,8,59
Albion,7488,5,14,9,13,48,44,4,51
Queen's Park,7488,6,14,4,18,39,57,-18,46
Stranraer,7488,7,12,8,16,41,58,-17,44
Peterhead,7488,8,12,6,18,50,52,-2,42
East Fife,7488,9,10,7,19,52,57,-5,37
Stenhousem'r,7488,10,10,5,21,50,77,-27,35
Alloa,7489,1,22,5,9,73,41,32,71
Livingston,7489,2,21,7,8,66,37,29,70
Airdrieon,7489,3,16,10,10,52,44,8,58
Queen's Park,7489,4,15,6,15,46,49,-3,51
Peterhead,7489,5,15,5,16,46,48,-2,50
Brechin,7489,6,14,8,14,46,54,-8,50
Albion,7489,7,12,9,15,50,53,-3,45
East Fife,7489,8,10,11,15,45,47,-2,41
Stranraer,7489,9,8,10,18,43,61,-18,34
Stenhousem'r,7489,10,8,7,21,45,78,-33,31
Alloa,7490,1,24,8,4,89,35,54,80
Livingston,7490,2,18,6,12,78,55,23,60
Airdrieon,7490,3,16,7,13,55,55,0,55
Albion,7490,4,15,8,13,59,51,8,53
Peterhead,7490,5,15,6,15,56,55,1,51
Brechin,7490,6,15,5,16,42,54,-12,50
East Fife,7490,7,12,9,15,46,44,2,45
Stenhousem'r,7490,8,11,7,18,49,76,-27,40
Queen's Park,7490,9,10,9,17,41,63,-22,39
Stranraer,7490,10,8,7,21,44,71,-27,31
Livingston,7491,1,21,7,8,72,40,32,70
Alloa,7491,2,17,7,12,56,42,14,58
Queen's Park,7491,3,16,9,11,44,39,5,57
Airdrieon,7491,4,17,5,14,51,51,0,56
Brechin,7491,5,16,8,12,48,48,0,56
Stranraer,7491,6,15,8,13,51,49,2,53
Peterhead,7491,7,14,7,15,52,53,-1,49
Albion,7491,8,10,8,18,41,50,-9,38
East Fife,7491,9,8,12,16,40,47,-7,36
Stenhousem'r,7491,10,7,7,22,36,72,-36,28
Alloa,7492,1,23,7,6,81,35,46,76
Livingston,7492,2,20,5,11,74,51,23,65
Queen's Park,7492,3,16,7,13,32,38,-6,55
Airdrieon,7492,4,16,5,15,48,58,-10,53
Albion,7492,5,15,6,15,53,50,3,51
Peterhead,7492,6,12,10,14,47,50,-3,46
Brechin,7492,7,13,7,16,41,51,-10,46
Stenhousem'r,7492,8,13,3,20,58,77,-19,42
East Fife,7492,9,10,7,19,42,52,-10,37
Stranraer,7492,10,10,7,19,44,58,-14,37
Livingston,7493,1,22,7,7,74,39,35,73
Alloa,7493,2,21,6,9,76,43,33,69
Peterhead,7493,3,17,6,13,55,46,9,57
Brechin,7493,4,17,4,15,43,45,-2,55
East Fife,7493,5,14,8,14,51,46,5,50
Albion,7493,6,13,8,15,56,58,-2,47
Airdrieon,7493,7,11,12,13,51,57,-6,45
Queen's Park,7493,8,10,9,17,36,55,-19,39
Stranraer,7493,9,10,5,21,45,65,-20,35
Stenhousem'r,7493,10,8,9,19,43,76,-33,33
Alloa,7494,1,22,5,9,75,43,32,71
Livingston,7494,2,18,6,12,68,53,15,60
Airdrieon,7494,3,15,11,10,59,53,6,56
Brechin,7494,4,14,10,12,51,47,4,52
East Fife,7494,5,13,9,14,54,49,5,48
Stranraer,7494,6,12,10,14,53,55,-2,46
Queen's Park,7494,7,12,10,14,41,48,-7,46
Albion,7494,8,11,12,13,48,47,1,45
Peterhead,7494,9,13,5,18,38,63,-25,44
Stenhousem'r,7494,10,6,10,20,40,69,-29,28
Livingston,7495,1,22,3,11,77,47,30,69
Alloa,7495,2,20,5,11,76,42,34,65
Queen's Park,7495,3,18,6,12,52,51,1,60
Peterhead,7495,4,16,9,11,57,52,5,57
Airdrieon,7495,5,16,4,16,54,59,-5,52
Stranraer,7495,6,15,5,16,56,70,-14,50
Brechin,7495,7,13,6,17,47,48,-1,45
Albion,7495,8,12,8,16,55,60,-5,44
East Fife,7495,9,11,9,16,46,54,-8,42
Stenhousem'r,7495,10,6,7,23,39,76,-37,25
Brechin,7496,1,20,6,10,45,37,8,66
Airdrieon,7496,2,19,7,10,61,51,10,64
Livingston,7496,3,19,5,12,81,47,34,62
Alloa,7496,4,18,7,11,75,48,27,61
Albion,7496,5,17,6,13,58,51,7,57
East Fife,7496,6,13,8,15,58,55,3,47
Queen's Park,7496,7,13,6,17,37,51,-14,45
Stranraer,7496,8,12,5,19,43,59,-16,41
Peterhead,7496,9,10,7,19,39,61,-22,37
Stenhousem'r,7496,10,7,7,22,48,85,-37,28
Alloa,7497,1,20,6,10,65,46,19,66
Airdrieon,7497,2,18,8,10,69,49,20,62
Livingston,7497,3,18,7,11,69,47,22,61
Brechin,7497,4,16,5,15,56,56,0,53
Albion,7497,5,13,10,13,49,52,-3,49
Queen's Park,7497,6,13,7,16,37,47,-10,46
Stranraer,7497,7,11,11,14,47,54,-7,44
East Fife,7497,8,11,9,16,47,49,-2,42
Peterhead,7497,9,11,9,16,54,62,-8,42
Stenhousem'r,7497,10,7,12,17,50,81,-31,33
Livingston,7498,1,25,4,7,93,44,49,79
Alloa,7498,2,20,6,10,78,41,37,66
Airdrieon,7498,3,17,12,7,65,48,17,63
Brechin,7498,4,18,7,11,55,50,5,61
Peterhead,7498,5,14,8,14,53,53,0,50
Queen's Park,7498,6,11,10,15,36,54,-18,43
Stenhousem'r,7498,7,11,7,18,47,77,-30,40
Albion,7498,8,9,9,18,46,55,-9,36
Stranraer,7498,9,10,6,20,48,77,-29,36
East Fife,7498,10,7,7,22,33,55,-22,28
Livingston,7499,1,20,6,10,69,40,29,66
Brechin,7499,2,17,10,9,49,34,15,61
Alloa,7499,3,18,6,12,63,43,20,60
Albion,7499,4,17,6,13,50,42,8,57
Airdrieon,7499,5,18,3,15,56,60,-4,57
Stranraer,7499,6,14,4,18,52,62,-10,46
Peterhead,7499,7,13,6,17,47,55,-8,45
Queen's Park,7499,8,12,9,15,37,50,-13,45
East Fife,7499,9,12,7,17,41,53,-12,43
Stenhousem'r,7499,10,8,5,23,50,75,-25,29
Alloa,7500,1,21,7,8,80,41,39,70
Brechin,7500,2,18,8,10,60,45,15,62
Albion,7500,3,16,8,12,58,47,11,56
Livingston,7500,4,15,7,14,68,57,11,52
Airdrieon,7500,5,15,7,14,59,63,-4,52
Peterhead,7500,6,13,11,12,49,53,-4,50
Stranraer,7500,7,15,2,19,56,67,-11,47
East Fife,7500,8,12,8,16,47,48,-1,44
Queen's Park,7500,9,10,8,18,31,50,-19,38
Stenhousem'r,7500,10,7,10,19,52,89,-37,31
Livingston,7501,1,22,4,10,78,49,29,70
Alloa,7501,2,17,11,8,73,48,25,62
Queen's Park,7501,3,17,6,13,51,51,0,57
Brechin,7501,4,17,5,14,51,50,1,56
Airdrieon,7501,5,16,7,13,70,60,10,55
East Fife,7501,6,15,8,13,56,48,8,53
Peterhead,7501,7,11,9,16,51,59,-8,42
Stranraer,7501,8,12,6,18,51,60,-9,42
Albion,7501,9,10,7,19,48,67,-19,37
Stenhousem'r,7501,10,7,9,20,49,86,-37,30
Livingston,7502,1,19,8,9,84,55,29,65
Airdrieon,7502,2,18,8,10,62,48,14,62
Peterhead,7502,3,17,7,12,59,51,8,58
Alloa,7502,4,16,8,12,67,55,12,56
Brechin,7502,5,15,5,16,47,50,-3,50
Albion,7502,6,13,9,14,50,57,-7,48
East Fife,7502,7,12,10,14,46,49,-3,46
Stranraer,7502,8,12,8,16,50,60,-10,44
Queen's Park,7502,9,12,7,17,40,48,-8,43
Stenhousem'r,7502,10,7,8,21,44,76,-32,29
Livingston,7503,1,20,7,9,85,50,35,67
Peterhead,7503,2,18,8,10,59,42,17,62
Airdrieon,7503,3,18,8,10,61,51,10,62
Brechin,7503,4,17,10,9,55,42,13,61
Alloa,7503,5,13,11,12,56,50,6,50
Albion,7503,6,12,12,12,48,52,-4,48
Stranraer,7503,7,11,12,13,55,66,-11,45
Queen's Park,7503,8,11,7,18,40,59,-19,40
Stenhousem'r,7503,9,10,6,20,55,82,-27,36
East Fife,7503,10,5,9,22,43,63,-20,24
Livingston,7504,1,24,4,8,85,38,47,76
Alloa,7504,2,19,8,9,70,40,30,65
Airdrieon,7504,3,18,10,8,62,52,10,64
Albion,7504,4,16,9,11,56,53,3,57
Brechin,7504,5,16,5,15,44,47,-3,53
Stranraer,7504,6,14,5,17,54,59,-5,47
Peterhead,7504,7,12,8,16,43,50,-7,44
Queen's Park,7504,8,12,4,20,31,54,-23,40
East Fife,7504,9,5,14,17,44,59,-15,29
Stenhousem'r,7504,10,7,7,22,34,71,-37,28
Livingston,7505,1,20,6,10,77,48,29,66
Peterhead,7505,2,19,8,9,52,36,16,65
Alloa,7505,3,17,8,11,70,50,20,59
Brechin,7505,4,18,4,14,59,52,7,58
Airdrieon,7505,5,15,11,10,59,49,10,56
Albion,7505,6,15,10,11,51,46,5,55
Queen's Park,7505,7,11,7,18,38,56,-18,40
East Fife,7505,8,10,7,19,39,52,-13,37
Stenhousem'r,7505,9,10,5,21,51,85,-34,35
Stranraer,7505,10,8,8,20,40,62,-22,32
Livingston,7506,1,17,8,11,65,52,13,59
Alloa,7506,2,17,6,13,69,46,23,57
Brechin,7506,3,16,8,12,53,47,6,56
Peterhead,7506,4,16,7,13,43,38,5,55
Airdrieon,7506,5,14,10,12,67,69,-2,52
Albion,7506,6,14,9,13,56,52,4,51
Stranraer,7506,7,13,10,13,56,58,-2,49
Queen's Park,7506,8,13,7,16,36,44,-8,46
East Fife,7506,9,10,7,19,44,54,-10,37
Stenhousem'r,7506,10,9,10,17,49,78,-29,37
Livingston,7507,1,24,4,8,81,43,38,76
Alloa,7507,2,18,8,10,68,35,33,62
Brechin,7507,3,18,6,12,53,46,7,60
Airdrieon,7507,4,16,7,13,57,56,1,55
Queen's Park,7507,5,12,9,15,32,49,-17,45
Stranraer,7507,6,12,8,16,42,56,-14,44
East Fife,7507,7,11,10,15,51,44,7,43
Peterhead,7507,8,12,6,18,51,64,-13,42
Albion,7507,9,10,10,16,49,56,-7,40
Stenhousem'r,7507,10,9,8,19,40,75,-35,35
Airdrieon,7508,1,22,5,9,67,48,19,71
Alloa,7508,2,20,9,7,72,43,29,69
Livingston,7508,3,22,2,12,80,55,25,68
Peterhead,7508,4,16,9,11,43,39,4,57
Albion,7508,5,13,10,13,60,56,4,49
Brechin,7508,6,14,5,17,50,60,-10,47
Stranraer,7508,7,11,9,16,48,57,-9,42
East Fife,7508,8,7,14,15,42,51,-9,35
Stenhousem'r,7508,9,9,7,20,53,79,-26,34
Queen's Park,7508,10,7,8,21,33,60,-27,29
Alloa,7509,1,20,7,9,74,41,33,67
Livingston,7509,2,20,4,12,74,52,22,64
Peterhead,7509,3,16,6,14,51,56,-5,54
Airdrieon,7509,4,15,7,14,51,58,-7,52
Albion,7509,5,14,9,13,59,56,3,51
Brechin,7509,6,13,10,13,45,45,0,49
East Fife,7509,7,12,10,14,48,45,3,46
Stranraer,7509,8,12,9,15,43,50,-7,45
Queen's Park,7509,9,12,8,16,41,47,-6,44
Stenhousem'r,7509,10,7,8,21,46,82,-36,29
Livingston,7510,1,22,2,12,84,49,35,68
Alloa,7510,2,17,8,11,69,48,21,59
Airdrieon,7510,3,16,10,10,57,51,6,58
East Fife,7510,4,14,11,11,55,44,11,53
Peterhead,7510,5,15,7,14,51,56,-5,52
Brechin,7510,6,14,8,14,45,50,-5,50
Albion,7510,7,12,8,16,57,56,1,44
Stranraer,7510,8,12,8,16,45,58,-13,44
Queen's Park,7510,9,10,10,16,34,52,-18,40
Stenhousem'r,7510,10,8,8,20,46,79,-33,32
Alloa,7511,1,23,6,7,75,36,39,75
Livingston,7511,2,20,6,10,75,40,35,66
Brechin,7511,3,17,6,13,49,47,2,57
Airdrieon,7511,4,14,9,13,51,53,-2,51
Albion,7511,5,14,8,14,50,45,5,50
Peterhead,7511,6,13,7,16,43,52,-9,46
Queen's Park,7511,7,12,8,16,37,51,-14,44
Stenhousem'r,7511,8,11,7,18,48,82,-34,40
East Fife,7511,9,9,11,16,47,51,-4,38
Stranraer,7511,10,10,6,20,44,62,-18,36
Livingston,7512,1,21,4,11,87,57,30,67
Alloa,7512,2,19,8,9,74,48,26,65
Airdrieon,7512,3,19,6,11,57,45,12,63
Brechin,7512,4,17,5,14,54,47,7,56
Albion,7512,5,16,7,13,57,53,4,55
East Fife,7512,6,14,9,13,53,41,12,51
Peterhead,7512,7,12,9,15,53,63,-10,45
Queen's Park,7512,8,10,10,16,43,63,-20,40
Stenhousem'r,7512,9,9,8,19,45,80,-35,35
Stranraer,7512,10,8,4,24,46,72,-26,28
Livingston,7513,1,21,2,13,76,56,20,65
Alloa,7513,2,20,4,12,76,54,22,64
Brechin,7513,3,17,4,15,53,53,0,55
Airdrieon,7513,4,15,8,13,58,54,4,53
Peterhead,7513,5,15,7,14,57,54,3,52
Stranraer,7513,6,15,4,17,52,57,-5,49
Queen's Park,7513,7,15,4,17,33,48,-15,49
East Fife,7513,8,13,8,15,55,49,6,47
Albion,7513,9,14,5,17,60,60,0,47
Stenhousem'r,7513,10,8,8,20,47,82,-35,32
Livingston,7514,1,23,6,7,84,42,42,75
Brechin,7514,2,19,6,11,50,42,8,63
Alloa,7514,3,17,10,9,63,41,22,61
Albion,7514,4,15,8,13,62,53,9,53
Queen's Park,7514,5,15,7,14,37,50,-13,52
Airdrieon,7514,6,13,6,17,51,60,-9,45
Peterhead,7514,7,11,11,14,41,54,-13,44
Stranraer,7514,8,9,9,18,44,55,-11,36
East Fife,7514,9,7,13,16,42,51,-9,34
Stenhousem'r,7514,10,8,10,18,52,78,-26,34
Livingston,7515,1,24,6,6,87,47,40,78
Alloa,7515,2,19,7,10,72,53,19,64
Airdrieon,7515,3,19,5,12,70,54,16,62
Peterhead,7515,4,14,10,12,54,54,0,52
Albion,7515,5,15,6,15,61,48,13,51
Brechin,7515,6,14,8,14,56,68,-12,50
Stranraer,7515,7,13,4,19,48,65,-17,43
East Fife,7515,8,11,9,16,54,56,-2,42
Queen's Park,7515,9,9,8,19,37,60,-23,35
Stenhousem'r,7515,10,8,5,23,49,83,-34,29
Alloa,7516,1,20,6,10,70,42,28,66
Livingston,7516,2,19,5,12,62,50,12,62
Airdrieon,7516,3,19,3,14,68,55,13,60
Peterhead,7516,4,16,9,11,59,49,10,57
Queen's Park,7516,5,14,9,13,39,46,-7,51
Brechin,7516,6,15,4,17,45,52,-7,49
Albion,7516,7,11,8,17,54,60,-6,41
Stranraer,7516,8,11,8,17,49,65,-16,41
East Fife,7516,9,9,12,15,50,58,-8,39
Stenhousem'r,7516,10,8,12,16,52,71,-19,36
Livingston,7517,1,23,4,9,76,43,33,73
Brechin,7517,2,21,4,11,55,46,9,67
Alloa,7517,3,18,6,12,66,39,27,60
Airdrieon,7517,4,18,4,14,54,53,1,58
East Fife,7517,5,13,10,13,49,45,4,49
Peterhead,7517,6,13,8,15,46,55,-9,47
Albion,7517,7,12,10,14,48,50,-2,46
Queen's Park,7517,8,13,6,17,37,47,-10,45
Stranraer,7517,9,9,9,18,46,63,-17,36
Stenhousem'r,7517,10,6,7,23,38,74,-36,25
Livingston,7518,1,25,3,8,83,46,37,78
Alloa,7518,2,18,7,11,73,53,20,61
Airdrieon,7518,3,16,9,11,64,55,9,57
Brechin,7518,4,17,6,13,53,47,6,57
Stranraer,7518,5,16,5,15,59,57,2,53
Albion,7518,6,11,12,13,49,52,-3,45
Peterhead,7518,7,11,11,14,54,57,-3,44
East Fife,7518,8,11,11,14,48,52,-4,44
Queen's Park,7518,9,12,7,17,33,48,-15,43
Stenhousem'r,7518,10,4,7,25,35,84,-49,19
Livingston,7519,1,20,6,10,78,45,33,66
Alloa,7519,2,19,6,11,78,54,24,63
Peterhead,7519,3,17,8,11,62,52,10,59
Brechin,7519,4,17,7,12,50,48,2,58
Airdrieon,7519,5,16,7,13,66,66,0,55
Stranraer,7519,6,15,6,15,52,56,-4,51
Albion,7519,7,10,12,14,51,56,-5,42
East Fife,7519,8,10,8,18,46,57,-11,38
Queen's Park,7519,9,8,12,16,35,53,-18,36
Stenhousem'r,7519,10,6,12,18,44,75,-31,30
Livingston,7520,1,20,4,12,75,49,26,64
Alloa,7520,2,19,6,11,73,44,29,63
Albion,7520,3,18,7,11,60,41,19,61
Airdrieon,7520,4,19,4,13,66,60,6,61
Brechin,7520,5,14,8,14,51,62,-11,50
East Fife,7520,6,11,11,14,53,53,0,44
Peterhead,7520,7,12,8,16,44,52,-8,44
Queen's Park,7520,8,13,4,19,41,54,-13,43
Stranraer,7520,9,12,6,18,46,62,-16,42
Stenhousem'r,7520,10,8,10,18,47,79,-32,34
Livingston,7521,1,23,4,9,78,47,31,73
Alloa,7521,2,18,7,11,75,49,26,61
Albion,7521,3,16,8,12,64,47,17,56
Brechin,7521,4,15,7,14,50,48,2,52
Stranraer,7521,5,14,8,14,48,50,-2,50
East Fife,7521,6,14,7,15,42,40,2,49
Airdrieon,7521,7,14,7,15,52,59,-7,49
Queen's Park,7521,8,12,9,15,39,55,-16,45
Peterhead,7521,9,12,8,16,42,55,-13,44
Stenhousem'r,7521,10,7,5,24,44,84,-40,26
Alloa,7522,1,22,6,8,78,42,36,72
Livingston,7522,2,21,5,10,76,46,30,68
Airdrieon,7522,3,16,7,13,51,44,7,55
Brechin,7522,4,16,5,15,48,54,-6,53
Peterhead,7522,5,14,8,14,48,58,-10,50
Albion,7522,6,13,9,14,50,51,-1,48
Stenhousem'r,7522,7,11,10,15,51,69,-18,43
East Fife,7522,8,10,10,16,46,52,-6,40
Stranraer,7522,9,10,7,19,49,56,-7,37
Queen's Park,7522,10,9,9,18,29,54,-25,36
Livingston,7523,1,22,5,9,74,40,34,71
Alloa,7523,2,21,5,10,74,50,24,68
Brechin,7523,3,16,7,13,48,46,2,55
Airdrieon,7523,4,17,4,15,62,61,1,55
Albion,7523,5,15,5,16,57,52,5,50
Peterhead,7523,6,13,8,15,47,57,-10,47
East Fife,7523,7,11,12,13,45,39,6,45
Queen's Park,7523,8,12,5,19,35,47,-12,41
Stranraer,7523,9,11,6,19,52,64,-12,39
Stenhousem'r,7523,10,11,5,20,44,82,-38,38
Livingston,7524,1,24,5,7,91,49,42,77
Brechin,7524,2,19,5,12,46,43,3,62
Airdrieon,7524,3,18,4,14,65,54,11,58
Alloa,7524,4,16,7,13,72,51,21,55
Peterhead,7524,5,15,7,14,53,55,-2,52
Albion,7524,6,12,11,13,50,54,-4,47
Queen's Park,7524,7,11,10,15,41,55,-14,43
Stranraer,7524,8,11,9,16,60,64,-4,42
East Fife,7524,9,10,11,15,46,55,-9,41
Stenhousem'r,7524,10,6,7,23,44,88,-44,25
Alloa,7525,1,19,7,10,71,45,26,64
Livingston,7525,2,19,6,11,72,42,30,63
Airdrieon,7525,3,19,4,13,62,51,11,61
Peterhead,7525,4,17,8,11,56,49,7,59
Brechin,7525,5,18,4,14,63,56,7,58
Albion,7525,6,12,8,16,49,55,-6,44
East Fife,7525,7,11,10,15,47,56,-9,43
Stranraer,7525,8,12,6,18,47,62,-15,42
Queen's Park,7525,9,12,6,18,31,49,-18,42
Stenhousem'r,7525,10,8,7,21,44,77,-33,31
Livingston,7526,1,23,2,11,80,46,34,71
Airdrieon,7526,2,21,4,11,66,52,14,67
Alloa,7526,3,19,7,10,77,52,25,64
Albion,7526,4,15,9,12,62,56,6,54
Peterhead,7526,5,15,7,14,53,56,-3,52
East Fife,7526,6,13,9,14,51,51,0,48
Queen's Park,7526,7,13,7,16,42,52,-10,46
Brechin,7526,8,12,9,15,45,48,-3,45
Stranraer,7526,9,10,10,16,52,62,-10,40
Stenhousem'r,7526,10,4,6,26,39,92,-53,18
Alloa,7527,1,20,7,9,69,43,26,67
Airdrieon,7527,2,19,4,13,57,52,5,61
Livingston,7527,3,17,4,15,73,59,14,55
East Fife,7527,4,16,5,15,53,54,-1,53
Queen's Park,7527,5,15,6,15,44,49,-5,51
Peterhead,7527,6,14,8,14,55,60,-5,50
Stranraer,7527,7,14,7,15,57,52,5,49
Brechin,7527,8,14,5,17,47,50,-3,47
Albion,7527,9,11,11,14,52,49,3,44
Stenhousem'r,7527,10,8,7,21,38,77,-39,31
Alloa,7528,1,24,6,6,85,41,44,78
Livingston,7528,2,20,4,12,82,52,30,64
Airdrieon,7528,3,20,4,12,68,57,11,64
Brechin,7528,4,16,11,9,50,40,10,59
Queen's Park,7528,5,13,7,16,36,56,-20,46
Peterhead,7528,6,13,5,18,53,56,-3,44
East Fife,7528,7,11,10,15,48,52,-4,43
Albion,7528,8,11,7,18,57,66,-9,40
Stranraer,7528,9,12,4,20,47,61,-14,40
Stenhousem'r,7528,10,8,6,22,40,85,-45,30
Livingston,7529,1,20,7,9,81,53,28,67
Alloa,7529,2,18,9,9,75,44,31,63
Brechin,7529,3,16,8,12,52,48,4,56
Albion,7529,4,15,9,12,64,50,14,54
Airdrieon,7529,5,13,10,13,57,58,-1,49
Stranraer,7529,6,13,7,16,48,60,-12,46
East Fife,7529,7,12,8,16,47,47,0,44
Peterhead,7529,8,10,14,12,48,58,-10,44
Queen's Park,7529,9,9,10,17,40,61,-21,37
Stenhousem'r,7529,10,7,12,17,44,77,-33,33
Airdrieon,7530,1,20,4,12,58,53,5,64
Livingston,7530,2,18,7,11,72,51,21,61
Alloa,7530,3,16,10,10,62,43,19,58
Brechin,7530,4,17,7,12,54,42,12,58
Albion,7530,5,13,11,12,56,56,0,50
Queen's Park,7530,6,14,5,17,40,48,-8,47
Peterhead,7530,7,13,7,16,53,60,-7,46
East Fife,7530,8,12,9,15,47,41,6,45
Stranraer,7530,9,13,4,19,55,69,-14,43
Stenhousem'r,7530,10,8,8,20,41,75,-34,32
Livingston,7531,1,19,8,9,69,46,23,65
Alloa,7531,2,19,8,9,65,46,19,65
Airdrieon,7531,3,17,8,11,55,52,3,59
Brechin,7531,4,14,8,14,52,49,3,50
East Fife,7531,5,12,12,12,48,33,15,48
Stranraer,7531,6,13,7,16,50,48,2,46
Peterhead,7531,7,12,10,14,45,53,-8,46
Albion,7531,8,11,9,16,52,61,-9,42
Stenhousem'r,7531,9,10,8,18,51,71,-20,38
Queen's Park,7531,10,9,10,17,31,59,-28,37
Livingston,7532,1,21,6,9,81,53,28,69
Airdrieon,7532,2,19,8,9,61,48,13,65
Alloa,7532,3,17,12,7,70,40,30,63
Brechin,7532,4,17,8,11,56,47,9,59
Queen's Park,7532,5,14,11,11,42,48,-6,53
East Fife,7532,6,12,9,15,47,51,-4,45
Peterhead,7532,7,11,8,17,48,56,-8,41
Stranraer,7532,8,11,6,19,45,57,-12,39
Albion,7532,9,8,11,17,50,68,-18,35
Stenhousem'r,7532,10,6,9,21,44,76,-32,27
Livingston,7533,1,22,4,10,76,45,31,70
Albion,7533,2,18,5,13,67,53,14,59
Peterhead,7533,3,17,6,13,47,42,5,57
Brechin,7533,4,17,6,13,48,52,-4,57
Alloa,7533,5,16,8,12,66,51,15,56
Airdrieon,7533,6,15,7,14,60,57,3,52
Queen's Park,7533,7,13,6,17,46,55,-9,45
East Fife,7533,8,11,10,15,47,48,-1,43
Stranraer,7533,9,12,5,19,53,63,-10,41
Stenhousem'r,7533,10,7,7,22,37,81,-44,28
Livingston,7534,1,22,4,10,84,51,33,70
Brechin,7534,2,18,5,13,46,41,5,59
Alloa,7534,3,14,11,11,66,45,21,53
Airdrieon,7534,4,15,7,14,54,55,-1,52
East Fife,7534,5,14,7,15,52,52,0,49
Stranraer,7534,6,14,7,15,55,56,-1,49
Peterhead,7534,7,13,7,16,54,56,-2,46
Queen's Park,7534,8,13,6,17,34,57,-23,45
Albion,7534,9,11,11,14,45,50,-5,44
Stenhousem'r,7534,10,9,9,18,46,73,-27,36
Livingston,7535,1,22,6,8,83,48,35,72
Alloa,7535,2,20,8,8,69,39,30,68
Airdrieon,7535,3,17,8,11,66,52,14,59
Brechin,7535,4,15,7,14,49,46,3,52
East Fife,7535,5,13,11,12,52,46,6,50
Queen's Park,7535,6,13,7,16,38,50,-12,46
Albion,7535,7,11,10,15,52,60,-8,43
Stranraer,7535,8,11,9,16,53,55,-2,42
Peterhead,7535,9,10,10,16,46,63,-17,40
Stenhousem'r,7535,10,7,6,23,40,89,-49,27
Livingston,7536,1,21,8,7,77,44,33,71
Alloa,7536,2,21,8,7,74,43,31,71
Brechin,7536,3,17,8,11,50,41,9,59
Airdrieon,7536,4,16,8,12,62,53,9,56
Queen's Park,7536,5,12,12,12,42,52,-10,48
Albion,7536,6,11,12,13,49,52,-3,45
Peterhead,7536,7,11,9,16,49,57,-8,42
Stranraer,7536,8,11,6,19,50,62,-12,39
East Fife,7536,9,8,11,17,43,56,-13,35
Stenhousem'r,7536,10,7,8,21,48,84,-36,29
Alloa,7537,1,22,4,10,68,48,20,70
Airdrieon,7537,2,17,11,8,60,44,16,62
Livingston,7537,3,18,7,11,70,51,19,61
Albion,7537,4,16,11,9,63,45,18,59
Brechin,7537,5,13,9,14,43,43,0,48
Peterhead,7537,6,12,9,15,44,57,-13,45
East Fife,7537,7,11,10,15,63,56,7,43
Stranraer,7537,8,9,13,14,44,56,-12,40
Queen's Park,7537,9,8,9,19,32,51,-19,33
Stenhousem'r,7537,10,5,15,16,46,82,-36,30
Alloa,7538,1,18,10,8,69,41,28,64
Livingston,7538,2,19,5,12,69,52,17,62
Albion,7538,3,17,10,9,68,48,20,61
Brechin,7538,4,17,7,12,55,43,12,58
Airdrieon,7538,5,16,6,14,52,52,0,54
East Fife,7538,6,13,10,13,51,51,0,49
Peterhead,7538,7,12,9,15,46,47,-1,45
Stranraer,7538,8,12,6,18,48,58,-10,42
Queen's Park,7538,9,10,5,21,35,59,-24,35
Stenhousem'r,7538,10,9,6,21,43,85,-42,33
Alloa,7539,1,21,7,8,79,43,36,70
Livingston,7539,2,21,5,10,79,47,32,68
Airdrieon,7539,3,16,6,14,61,60,1,54
Brechin,7539,4,15,8,13,53,47,6,53
Peterhead,7539,5,14,8,14,52,57,-5,50
East Fife,7539,6,13,8,15,54,49,5,47
Stranraer,7539,7,13,8,15,45,50,-5,47
Queen's Park,7539,8,12,7,17,38,55,-17,43
Albion,7539,9,11,8,17,50,57,-7,41
Stenhousem'r,7539,10,7,9,20,42,88,-46,30
Livingston,7540,1,20,5,11,73,53,20,65
Alloa,7540,2,18,7,11,71,44,27,61
Peterhead,7540,3,16,6,14,53,48,5,54
Airdrieon,7540,4,16,6,14,47,51,-4,54
Brechin,7540,5,16,5,15,52,58,-6,53
Stranraer,7540,6,16,4,16,51,51,0,52
Albion,7540,7,14,7,15,61,64,-3,49
Queen's Park,7540,8,14,7,15,50,56,-6,49
East Fife,7540,9,13,9,14,41,38,3,48
Stenhousem'r,7540,10,5,8,23,36,72,-36,23
Livingston,7541,1,20,7,9,79,55,24,67
Airdrieon,7541,2,18,9,9,68,55,13,63
Brechin,7541,3,17,8,11,59,50,9,59
Albion,7541,4,14,11,11,61,53,8,53
Queen's Park,7541,5,15,6,15,51,60,-9,51
Alloa,7541,6,14,8,14,60,51,9,50
Peterhead,7541,7,12,9,15,54,62,-8,45
East Fife,7541,8,11,11,14,55,52,3,44
Stranraer,7541,9,11,10,15,48,50,-2,43
Stenhousem'r,7541,10,5,7,24,43,90,-47,22
Livingston,7542,1,23,7,6,83,39,44,76
Airdrieon,7542,2,19,6,11,61,52,9,63
Brechin,7542,3,18,7,11,47,39,8,61
Albion,7542,4,16,10,10,47,44,3,58
Alloa,7542,5,16,9,11,64,46,18,57
Peterhead,7542,6,12,9,15,47,50,-3,45
Queen's Park,7542,7,11,6,19,35,57,-22,39
East Fife,7542,8,9,9,18,43,53,-10,36
Stranraer,7542,9,10,6,20,48,59,-11,36
Stenhousem'r,7542,10,7,9,20,44,80,-36,30
Alloa,7543,1,21,6,9,76,42,34,69
Livingston,7543,2,21,3,12,79,45,34,66
Airdrieon,7543,3,17,5,14,57,52,5,56
Albion,7543,4,16,7,13,61,53,8,55
Queen's Park,7543,5,15,4,17,41,55,-14,49
Brechin,7543,6,14,6,16,47,50,-3,48
Stranraer,7543,7,15,3,18,59,72,-13,48
Peterhead,7543,8,12,7,17,40,55,-15,43
East Fife,7543,9,10,12,14,47,51,-4,42
Stenhousem'r,7543,10,9,7,20,47,79,-32,34
Livingston,7544,1,27,3,6,85,38,47,84
Airdrieon,7544,2,16,8,12,59,51,8,56
Brechin,7544,3,18,2,16,53,57,-4,56
Alloa,7544,4,16,7,13,63,50,13,55
Queen's Park,7544,5,15,8,13,40,43,-3,53
East Fife,7544,6,14,8,14,52,44,8,50
Peterhead,7544,7,14,7,15,50,55,-5,49
Albion,7544,8,11,11,14,49,59,-10,44
Stranraer,7544,9,9,6,21,48,66,-18,33
Stenhousem'r,7544,10,8,4,24,46,82,-36,28
Livingston,7545,1,19,7,10,73,54,19,64
Alloa,7545,2,18,9,9,64,45,19,63
Airdrieon,7545,3,17,7,12,61,56,5,58
Peterhead,7545,4,16,7,13,53,43,10,55
Brechin,7545,5,14,8,14,45,48,-3,50
Albion,7545,6,12,11,13,56,54,2,47
East Fife,7545,7,11,12,13,46,46,0,45
Queen's Park,7545,8,13,3,20,42,57,-15,42
Stranraer,7545,9,12,5,19,46,59,-13,41
Stenhousem'r,7545,10,9,9,18,58,82,-24,36
Alloa,7546,1,23,6,7,74,38,36,75
Airdrieon,7546,2,21,6,9,59,49,10,69
Livingston,7546,3,19,5,12,70,49,21,62
Brechin,7546,4,19,5,12,55,46,9,62
Stranraer,7546,5,15,3,18,47,54,-7,48
East Fife,7546,6,13,7,16,53,53,0,46
Albion,7546,7,12,8,16,53,61,-8,44
Peterhead,7546,8,11,8,17,50,58,-8,41
Queen's Park,7546,9,10,8,18,36,55,-19,38
Stenhousem'r,7546,10,5,8,23,44,78,-34,23
Alloa,7547,1,21,6,9,71,42,29,69
Livingston,7547,2,22,2,12,74,44,30,68
Brechin,7547,3,19,5,12,55,41,14,62
Airdrieon,7547,4,18,5,13,62,61,1,59
Peterhead,7547,5,15,10,11,49,48,1,55
Stranraer,7547,6,13,6,17,55,58,-3,45
Queen's Park,7547,7,12,6,18,36,55,-19,42
East Fife,7547,8,10,9,17,41,47,-6,39
Albion,7547,9,10,8,18,46,62,-16,38
Stenhousem'r,7547,10,9,5,22,47,78,-31,32
Alloa,7548,1,19,9,8,73,43,30,66
Livingston,7548,2,20,4,12,68,47,21,64
Airdrieon,7548,3,20,4,12,66,62,4,64
Brechin,7548,4,18,5,13,53,48,5,59
Queen's Park,7548,5,15,6,15,38,50,-12,51
Stranraer,7548,6,12,12,12,54,45,9,48
Albion,7548,7,12,8,16,58,62,-4,44
Peterhead,7548,8,12,7,17,50,63,-13,43
East Fife,7548,9,12,6,18,46,49,-3,42
Stenhousem'r,7548,10,6,7,23,44,81,-37,25
Alloa,7549,1,19,9,8,76,43,33,66
Albion,7549,2,18,6,12,70,56,14,60
Peterhead,7549,3,18,6,12,56,52,4,60
Airdrieon,7549,4,18,5,13,58,58,0,59
Livingston,7549,5,17,7,12,75,53,22,58
Brechin,7549,6,16,9,11,47,46,1,57
East Fife,7549,7,16,7,13,65,49,16,55
Stranraer,7549,8,13,3,20,56,66,-10,42
Queen's Park,7549,9,9,6,21,37,63,-26,33
Stenhousem'r,7549,10,3,8,25,38,92,-54,17
Livingston,7550,1,23,3,10,84,44,40,72
Alloa,7550,2,19,8,9,65,42,23,65
Albion,7550,3,17,8,11,59,51,8,59
Airdrieon,7550,4,17,6,13,58,56,2,57
Brechin,7550,5,16,8,12,45,42,3,56
Peterhead,7550,6,15,8,13,58,49,9,53
Stranraer,7550,7,13,7,16,50,55,-5,46
Queen's Park,7550,8,10,10,16,40,62,-22,40
East Fife,7550,9,8,10,18,41,49,-8,34
Stenhousem'r,7550,10,4,8,24,38,88,-50,20
Livingston,7551,1,20,5,11,78,51,27,65
Alloa,7551,2,19,7,10,76,43,33,64
Airdrieon,7551,3,19,5,12,64,53,11,62
Brechin,7551,4,17,5,14,48,49,-1,56
Stranraer,7551,5,16,5,15,58,51,7,53
Peterhead,7551,6,14,7,15,53,59,-6,49
Albion,7551,7,13,9,14,46,54,-8,48
Queen's Park,7551,8,12,7,17,36,51,-15,43
East Fife,7551,9,10,8,18,46,51,-5,38
Stenhousem'r,7551,10,6,10,20,45,88,-43,28
Livingston,7552,1,23,3,10,74,44,30,72
Alloa,7552,2,21,7,8,70,46,24,70
Airdrieon,7552,3,18,5,13,64,48,16,59
Albion,7552,4,15,6,15,50,53,-3,51
East Fife,7552,5,13,10,13,52,49,3,49
Peterhead,7552,6,13,9,14,49,48,1,48
Queen's Park,7552,7,14,5,17,42,52,-10,47
Brechin,7552,8,13,5,18,48,58,-10,44
Stranraer,7552,9,12,4,20,45,58,-13,40
Stenhousem'r,7552,10,6,10,20,38,76,-38,28
Airdrieon,7553,1,21,7,8,64,48,16,70
Brechin,7553,2,17,7,12,49,41,8,58
Livingston,7553,3,18,3,15,75,53,22,57
Alloa,7553,4,15,10,11,64,53,11,55
East Fife,7553,5,14,9,13,51,43,8,51
Stranraer,7553,6,15,5,16,52,54,-2,50
Queen's Park,7553,7,12,11,13,36,48,-12,47
Peterhead,7553,8,11,10,15,44,54,-10,43
Albion,7553,9,11,8,17,50,59,-9,41
Stenhousem'r,7553,10,5,12,19,41,73,-32,27
Livingston,7554,1,19,3,14,71,53,18,60
Airdrieon,7554,2,16,10,10,59,47,12,58
Alloa,7554,3,15,11,10,59,44,15,56
Albion,7554,4,15,10,11,56,44,12,55
Brechin,7554,5,16,6,14,43,50,-7,54
Peterhead,7554,6,12,10,14,43,50,-7,46
Stranraer,7554,7,13,6,17,43,50,-7,45
Queen's Park,7554,8,12,7,17,37,49,-12,43
Stenhousem'r,7554,9,11,9,16,49,68,-19,42
East Fife,7554,10,10,10,16,45,50,-5,40
Livingston,7555,1,21,6,9,72,45,27,69
Alloa,7555,2,19,4,13,65,57,8,61
Albion,7555,3,17,9,10,59,38,21,60
Brechin,7555,4,18,5,13,56,48,8,59
Airdrieon,7555,5,17,7,12,65,56,9,58
Stranraer,7555,6,14,6,16,57,63,-6,48
Peterhead,7555,7,12,11,13,46,50,-4,47
East Fife,7555,8,8,11,17,43,51,-8,35
Queen's Park,7555,9,8,10,18,33,62,-29,34
Stenhousem'r,7555,10,8,7,21,52,78,-26,31
Livingston,7556,1,21,7,8,78,49,29,70
Alloa,7556,2,18,9,9,75,45,30,63
Airdrieon,7556,3,16,8,12,58,54,4,56
East Fife,7556,4,12,13,11,54,49,5,49
Peterhead,7556,5,13,10,13,49,49,0,49
Albion,7556,6,13,8,15,54,57,-3,47
Brechin,7556,7,13,7,16,52,51,1,46
Stranraer,7556,8,12,8,16,45,55,-10,44
Queen's Park,7556,9,12,7,17,31,53,-22,43
Stenhousem'r,7556,10,7,9,20,40,74,-34,30
Livingston,7557,1,20,6,10,72,48,24,66
Alloa,7557,2,19,8,9,65,41,24,65
Airdrieon,7557,3,17,8,11,65,58,7,59
East Fife,7557,4,13,9,14,54,48,6,48
Brechin,7557,5,14,5,17,45,51,-6,47
Stranraer,7557,6,12,10,14,51,54,-3,46
Peterhead,7557,7,11,13,12,40,46,-6,46
Albion,7557,8,11,10,15,51,56,-5,43
Queen's Park,7557,9,11,9,16,47,58,-11,42
Stenhousem'r,7557,10,10,6,20,46,76,-30,36
Livingston,7558,1,23,5,8,82,46,36,74
Alloa,7558,2,21,8,7,68,38,30,71
Brechin,7558,3,19,4,13,56,47,9,61
Airdrieon,7558,4,18,6,12,69,54,15,60
East Fife,7558,5,13,9,14,53,45,8,48
Albion,7558,6,13,7,16,47,54,-7,46
Stranraer,7558,7,12,6,18,50,67,-17,42
Peterhead,7558,8,11,6,19,41,61,-20,39
Queen's Park,7558,9,9,8,19,34,57,-23,35
Stenhousem'r,7558,10,7,9,20,43,74,-31,30
Livingston,7559,1,22,3,11,77,49,28,69
Alloa,7559,2,18,7,11,67,54,13,61
Brechin,7559,3,18,6,12,58,50,8,60
Airdrieon,7559,4,17,6,13,65,59,6,57
Stranraer,7559,5,15,6,15,58,57,1,51
Albion,7559,6,13,8,15,53,51,2,47
Peterhead,7559,7,13,7,16,49,52,-3,46
East Fife,7559,8,10,10,16,46,49,-3,40
Queen's Park,7559,9,10,8,18,29,55,-26,38
Stenhousem'r,7559,10,9,9,18,48,74,-26,36
Livingston,7560,1,21,7,8,68,43,25,70
Alloa,7560,2,17,10,9,60,40,20,61
Brechin,7560,3,16,10,10,57,53,4,58
Airdrieon,7560,4,17,7,12,61,63,-2,58
Queen's Park,7560,5,14,8,14,49,47,2,50
Peterhead,7560,6,14,7,15,46,49,-3,49
East Fife,7560,7,11,10,15,55,50,5,43
Albion,7560,8,11,9,16,52,56,-4,42
Stranraer,7560,9,11,6,19,57,67,-10,39
Stenhousem'r,7560,10,7,8,21,45,82,-37,29
Alloa,7561,1,20,7,9,74,41,33,67
Airdrieon,7561,2,19,6,11,65,51,14,63
Peterhead,7561,3,16,7,13,52,51,1,55
Brechin,7561,4,15,8,13,48,49,-1,53
Livingston,7561,5,15,6,15,73,61,12,51
Albion,7561,6,13,9,14,51,56,-5,48
East Fife,7561,7,12,9,15,58,51,7,45
Stranraer,7561,8,13,6,17,50,62,-12,45
Queen's Park,7561,9,13,5,18,35,50,-15,44
Stenhousem'r,7561,10,7,11,18,41,75,-34,32
Alloa,7562,1,20,8,8,70,39,31,68
Livingston,7562,2,20,4,12,68,41,27,64
Airdrieon,7562,3,17,7,12,57,49,8,58
East Fife,7562,4,16,7,13,51,39,12,55
Queen's Park,7562,5,16,6,14,44,44,0,54
Albion,7562,6,13,8,15,46,51,-5,47
Peterhead,7562,7,12,7,17,54,55,-1,43
Brechin,7562,8,11,9,16,32,48,-16,42
Stranraer,7562,9,13,1,22,47,72,-25,40
Stenhousem'r,7562,10,10,7,19,44,75,-31,37
Livingston,7563,1,21,5,10,81,44,37,68
Alloa,7563,2,20,7,9,70,48,22,67
Airdrieon,7563,3,18,9,9,66,49,17,63
Queen's Park,7563,4,15,7,14,37,53,-16,52
East Fife,7563,5,15,6,15,58,46,12,51
Brechin,7563,6,15,4,17,50,54,-4,49
Stranraer,7563,7,13,7,16,59,59,0,46
Albion,7563,8,11,9,16,49,54,-5,42
Peterhead,7563,9,12,6,18,42,57,-15,42
Stenhousem'r,7563,10,6,8,22,37,85,-48,26
Alloa,7564,1,21,6,9,74,42,32,69
Livingston,7564,2,21,3,12,78,47,31,66
Brechin,7564,3,18,6,12,57,47,10,60
Stranraer,7564,4,15,7,14,50,45,5,52
Albion,7564,5,15,6,15,52,50,2,51
Queen's Park,7564,6,14,6,16,38,51,-13,48
Peterhead,7564,7,13,7,16,52,55,-3,46
Airdrieon,7564,8,12,6,18,46,66,-20,42
Stenhousem'r,7564,9,12,6,18,45,76,-31,42
East Fife,7564,10,7,11,18,45,58,-13,32
Airdrieon,7565,1,19,7,10,61,53,8,64
Livingston,7565,2,19,6,11,77,49,28,63
Brechin,7565,3,18,4,14,50,52,-2,58
Alloa,7565,4,15,8,13,73,52,21,53
Peterhead,7565,5,15,8,13,48,50,-2,53
Stranraer,7565,6,16,3,17,58,53,5,51
East Fife,7565,7,11,10,15,50,48,2,43
Albion,7565,8,11,10,15,56,64,-8,43
Queen's Park,7565,9,12,6,18,41,64,-23,42
Stenhousem'r,7565,10,9,8,19,53,82,-29,35
Alloa,7566,1,17,11,8,66,41,25,62
Livingston,7566,2,19,5,12,77,53,24,62
Brechin,7566,3,18,6,12,54,43,11,60
Airdrieon,7566,4,16,8,12,65,63,2,56
East Fife,7566,5,14,9,13,54,44,10,51
Peterhead,7566,6,15,6,15,56,60,-4,51
Queen's Park,7566,7,13,7,16,37,48,-11,46
Albion,7566,8,12,9,15,53,59,-6,45
Stranraer,7566,9,13,6,17,52,58,-6,45
Stenhousem'r,7566,10,7,5,24,47,92,-45,26
Livingston,7567,1,21,6,9,80,45,35,69
Alloa,7567,2,19,5,12,67,45,22,62
Airdrieon,7567,3,17,4,15,56,62,-6,55
Queen's Park,7567,4,15,7,14,38,42,-4,52
Brechin,7567,5,14,8,14,46,48,-2,50
Peterhead,7567,6,13,10,13,46,45,1,49
Albion,7567,7,13,9,14,54,55,-1,48
Stranraer,7567,8,12,7,17,44,54,-10,43
Stenhousem'r,7567,9,10,9,17,45,77,-32,39
East Fife,7567,10,9,9,18,44,47,-3,36
Livingston,7568,1,21,4,11,73,55,18,67
Alloa,7568,2,19,7,10,66,44,22,64
Albion,7568,3,19,6,11,50,41,9,63
Airdrieon,7568,4,18,8,10,63,45,18,62
Brechin,7568,5,14,7,15,55,55,0,49
Stranraer,7568,6,14,6,16,52,54,-2,48
Peterhead,7568,7,13,8,15,46,48,-2,47
East Fife,7568,8,12,8,16,41,45,-4,44
Queen's Park,7568,9,8,8,20,28,53,-25,32
Stenhousem'r,7568,10,6,10,20,47,81,-34,28
Livingston,7569,1,24,5,7,80,36,44,77
Alloa,7569,2,18,11,7,71,42,29,65
East Fife,7569,3,15,7,14,51,46,5,52
Brechin,7569,4,15,6,15,54,54,0,51
Peterhead,7569,5,15,6,15,51,53,-2,51
Stranraer,7569,6,14,4,18,47,49,-2,46
Queen's Park,7569,7,12,9,15,44,54,-10,45
Airdrieon,7569,8,13,6,17,50,65,-15,45
Albion,7569,9,11,9,16,54,58,-4,42
Stenhousem'r,7569,10,8,7,21,44,89,-45,31
Airdrieon,7570,1,20,7,9,66,48,18,67
Alloa,7570,2,18,9,9,67,40,27,63
Albion,7570,3,16,9,11,64,51,13,57
Livingston,7570,4,16,8,12,70,51,19,56
Peterhead,7570,5,15,9,12,57,54,3,54
Brechin,7570,6,12,12,12,47,50,-3,48
Queen's Park,7570,7,13,9,14,42,53,-11,48
Stranraer,7570,8,12,5,19,46,68,-22,41
East Fife,7570,9,9,11,16,48,50,-2,38
Stenhousem'r,7570,10,4,11,21,40,82,-42,23
Alloa,7571,1,21,10,5,74,33,41,73
Livingston,7571,2,21,4,11,79,53,26,67
Brechin,7571,3,18,4,14,50,50,0,58
Airdrieon,7571,4,16,6,14,63,57,6,54
East Fife,7571,5,13,10,13,52,47,5,49
Albion,7571,6,13,8,15,45,50,-5,47
Queen's Park,7571,7,11,9,16,33,49,-16,42
Peterhead,7571,8,11,8,17,52,67,-15,41
Stranraer,7571,9,11,7,18,42,51,-9,40
Stenhousem'r,7571,10,8,8,20,48,81,-33,32
Livingston,7572,1,24,4,8,76,42,34,76
Alloa,7572,2,19,7,10,63,39,24,64
Albion,7572,3,17,7,12,62,50,12,58
Airdrieon,7572,4,18,4,14,57,62,-5,58
Brechin,7572,5,14,8,14,52,56,-4,50
Peterhead,7572,6,12,9,15,46,54,-8,45
Stranraer,7572,7,11,6,19,41,58,-17,39
Stenhousem'r,7572,8,10,9,17,49,70,-21,39
East Fife,7572,9,8,14,14,46,52,-6,38
Queen's Park,7572,10,8,10,18,39,48,-9,34
Alloa,7573,1,20,9,7,74,39,35,69
Livingston,7573,2,21,1,14,77,51,26,64
Brechin,7573,3,18,7,11,61,53,8,61
Airdrieon,7573,4,17,9,10,54,51,3,60
Stranraer,7573,5,16,6,14,56,61,-5,54
East Fife,7573,6,14,6,16,60,50,10,48
Peterhead,7573,7,13,7,16,50,57,-7,46
Queen's Park,7573,8,13,7,16,37,51,-14,46
Albion,7573,9,11,7,18,60,64,-4,40
Stenhousem'r,7573,10,4,7,25,44,96,-52,19
Livingston,7574,1,21,4,11,87,52,35,67
Alloa,7574,2,19,7,10,68,46,22,64
Airdrieon,7574,3,18,7,11,68,48,20,61
East Fife,7574,4,18,6,12,56,44,12,60
Brechin,7574,5,16,9,11,59,45,14,57
Albion,7574,6,14,9,13,57,55,2,51
Stranraer,7574,7,13,4,19,50,71,-21,43
Queen's Park,7574,8,10,10,16,33,46,-13,40
Peterhead,7574,9,9,11,16,51,62,-11,38
Stenhousem'r,7574,10,7,3,26,39,99,-60,24
Livingston,7575,1,24,2,10,78,50,28,74
Alloa,7575,2,18,8,10,71,42,29,62
Albion,7575,3,18,6,12,56,45,11,60
Brechin,7575,4,17,5,14,61,50,11,56
Stranraer,7575,5,15,4,17,48,56,-8,49
Peterhead,7575,6,13,7,16,48,62,-14,46
Queen's Park,7575,7,13,6,17,41,51,-10,45
Airdrieon,7575,8,13,6,17,48,62,-14,45
East Fife,7575,9,10,8,18,44,52,-8,38
Stenhousem'r,7575,10,10,6,20,56,81,-25,36
Alloa,7576,1,20,6,10,70,39,31,66
Livingston,7576,2,19,7,10,69,39,30,64
Peterhead,7576,3,17,9,10,56,44,12,60
Airdrieon,7576,4,16,10,10,60,48,12,58
Queen's Park,7576,5,14,6,16,45,51,-6,48
Albion,7576,6,13,9,14,46,56,-10,48
Brechin,7576,7,14,5,17,39,47,-8,47
East Fife,7576,8,11,9,16,43,47,-4,42
Stranraer,7576,9,11,6,19,49,65,-16,39
Stenhousem'r,7576,10,8,7,21,44,85,-41,31
Alloa,7577,1,21,7,8,72,40,32,70
Airdrieon,7577,2,21,5,10,62,50,12,68
Livingston,7577,3,19,3,14,72,46,26,60
Peterhead,7577,4,17,6,13,60,42,18,57
East Fife,7577,5,14,7,15,57,50,7,49
Brechin,7577,6,13,7,16,36,47,-11,46
Albion,7577,7,12,9,15,58,61,-3,45
Stranraer,7577,8,12,6,18,50,67,-17,42
Queen's Park,7577,9,12,6,18,33,55,-22,42
Stenhousem'r,7577,10,8,6,22,45,87,-42,30
Livingston,7578,1,21,9,6,75,39,36,72
Alloa,7578,2,20,6,10,77,47,30,66
Brechin,7578,3,18,7,11,55,42,13,61
Airdrieon,7578,4,15,10,11,54,52,2,55
Albion,7578,5,14,10,12,51,45,6,52
Peterhead,7578,6,13,9,14,48,55,-7,48
Queen's Park,7578,7,13,8,15,32,50,-18,47
Stranraer,7578,8,9,6,21,48,66,-18,33
East Fife,7578,9,7,11,18,45,59,-14,32
Stenhousem'r,7578,10,8,8,20,48,78,-30,32
Alloa,7579,1,20,8,8,67,44,23,68
Airdrieon,7579,2,20,6,10,66,56,10,66
Livingston,7579,3,19,8,9,74,49,25,65
Peterhead,7579,4,13,10,13,52,49,3,49
Albion,7579,5,12,11,13,52,54,-2,47
Brechin,7579,6,13,8,15,47,51,-4,47
Queen's Park,7579,7,13,7,16,47,53,-6,46
Stranraer,7579,8,13,3,20,50,62,-12,42
East Fife,7579,9,9,10,17,45,57,-12,37
Stenhousem'r,7579,10,8,9,19,56,81,-25,33
Alloa,7580,1,19,9,8,73,46,27,66
Airdrieon,7580,2,19,6,11,58,46,12,63
Livingston,7580,3,19,4,13,68,48,20,61
Brechin,7580,4,16,10,10,62,51,11,58
Stranraer,7580,5,15,6,15,60,62,-2,51
East Fife,7580,6,14,8,14,55,55,0,50
Peterhead,7580,7,15,5,16,45,55,-10,50
Queen's Park,7580,8,12,5,19,41,60,-19,41
Albion,7580,9,9,9,18,47,55,-8,36
Stenhousem'r,7580,10,7,8,21,41,72,-31,29
Livingston,7581,1,24,2,10,80,45,35,74
Alloa,7581,2,18,9,9,75,47,28,63
Airdrieon,7581,3,15,10,11,57,58,-1,55
Albion,7581,4,14,11,11,56,51,5,53
Queen's Park,7581,5,14,7,15,40,55,-15,49
Brechin,7581,6,15,3,18,48,50,-2,48
Stranraer,7581,7,11,9,16,44,56,-12,42
East Fife,7581,8,11,7,18,47,53,-6,40
Peterhead,7581,9,10,10,16,46,56,-10,40
Stenhousem'r,7581,10,9,10,17,54,76,-22,37
Alloa,7582,1,23,5,8,72,42,30,74
Livingston,7582,2,21,6,9,76,50,26,69
Airdrieon,7582,3,15,6,15,59,55,4,51
Albion,7582,4,13,10,13,56,52,4,49
Brechin,7582,5,14,7,15,44,49,-5,49
Queen's Park,7582,6,14,5,17,42,50,-8,47
Peterhead,7582,7,12,11,13,45,54,-9,47
Stenhousem'r,7582,8,11,9,16,44,65,-21,42
Stranraer,7582,9,12,3,21,43,57,-14,39
East Fife,7582,10,8,12,16,40,47,-7,36
Alloa,7583,1,22,7,7,68,35,33,73
Livingston,7583,2,20,8,8,77,47,30,68
Peterhead,7583,3,15,9,12,59,50,9,54
Brechin,7583,4,15,6,15,46,51,-5,51
Albion,7583,5,13,9,14,58,53,5,48
East Fife,7583,6,13,6,17,60,57,3,45
Airdrieon,7583,7,13,6,17,51,63,-12,45
Stranraer,7583,8,12,6,18,52,62,-10,42
Queen's Park,7583,9,11,8,17,36,60,-24,41
Stenhousem'r,7583,10,9,9,18,44,73,-29,36
Livingston,7584,1,23,1,12,84,53,31,70
Alloa,7584,2,20,9,7,68,31,37,69
Airdrieon,7584,3,17,8,11,58,52,6,59
Brechin,7584,4,15,6,15,46,52,-6,51
Queen's Park,7584,5,14,7,15,40,48,-8,49
Albion,7584,6,14,6,16,54,60,-6,48
Peterhead,7584,7,13,7,16,45,44,1,46
East Fife,7584,8,11,11,14,46,49,-3,44
Stranraer,7584,9,10,9,17,48,61,-13,39
Stenhousem'r,7584,10,8,6,22,40,79,-39,30
Livingston,7585,1,19,8,9,67,41,26,65
Alloa,7585,2,16,14,6,70,41,29,62
Airdrieon,7585,3,16,12,8,62,48,14,60
Albion,7585,4,13,14,9,56,48,8,53
Queen's Park,7585,5,12,11,13,42,53,-11,47
East Fife,7585,6,12,10,14,53,50,3,46
Brechin,7585,7,11,12,13,43,50,-7,45
Stranraer,7585,8,10,10,16,47,60,-13,40
Peterhead,7585,9,10,9,17,43,58,-15,39
Stenhousem'r,7585,10,6,10,20,50,84,-34,28
Livingston,7586,1,20,4,12,68,50,18,64
Alloa,7586,2,17,11,8,66,41,25,62
Airdrieon,7586,3,17,9,10,60,45,15,60
Brechin,7586,4,17,7,12,49,49,0,58
Albion,7586,5,13,9,14,48,48,0,48
Stranraer,7586,6,12,11,13,54,52,2,47
Queen's Park,7586,7,10,15,11,33,40,-7,45
East Fife,7586,8,11,8,17,41,52,-11,41
Peterhead,7586,9,10,8,18,41,55,-14,38
Stenhousem'r,7586,10,7,10,19,43,71,-28,31
Brechin,7587,1,19,9,8,62,40,22,66
Livingston,7587,2,20,5,11,76,47,29,65
Airdrieon,7587,3,18,7,11,60,44,16,61
Alloa,7587,4,17,9,10,60,48,12,60
Albion,7587,5,13,13,10,64,51,13,52
East Fife,7587,6,12,9,15,45,49,-4,45
Stranraer,7587,7,12,4,20,57,68,-11,40
Stenhousem'r,7587,8,12,4,20,44,73,-29,40
Peterhead,7587,9,10,7,19,36,54,-18,37
Queen's Park,7587,10,9,9,18,27,57,-30,36
Livingston,7588,1,21,6,9,81,45,36,69
Queen's Park,7588,2,18,6,12,47,47,0,60
Brechin,7588,3,17,4,15,61,57,4,55
Peterhead,7588,4,15,10,11,56,52,4,55
Albion,7588,5,15,8,13,61,56,5,53
Alloa,7588,6,12,12,12,54,49,5,48
Airdrieon,7588,7,13,7,16,55,60,-5,46
East Fife,7588,8,11,9,16,55,54,1,42
Stranraer,7588,9,12,4,20,51,66,-15,40
Stenhousem'r,7588,10,7,12,17,46,81,-35,33
Brechin,7589,1,20,5,11,62,54,8,65
Alloa,7589,2,18,10,8,82,44,38,64
Airdrieon,7589,3,17,8,11,60,51,9,59
Livingston,7589,4,18,4,14,78,51,27,58
Albion,7589,5,14,7,15,47,50,-3,49
East Fife,7589,6,14,6,16,62,65,-3,48
Peterhead,7589,7,10,14,12,52,54,-2,44
Queen's Park,7589,8,10,9,17,36,51,-15,39
Stranraer,7589,9,10,9,17,43,66,-23,39
Stenhousem'r,7589,10,9,8,19,42,78,-36,35
Alloa,7590,1,20,8,8,77,41,36,68
Airdrieon,7590,2,20,6,10,66,46,20,66
Albion,7590,3,19,7,10,69,46,23,64
Brechin,7590,4,16,5,15,50,49,1,53
Livingston,7590,5,14,7,15,64,55,9,49
Peterhead,7590,6,13,6,17,44,56,-12,45
Queen's Park,7590,7,12,8,16,35,56,-21,44
East Fife,7590,8,10,11,15,54,57,-3,41
Stranraer,7590,9,12,4,20,50,64,-14,40
Stenhousem'r,7590,10,10,6,20,47,86,-39,36
Livingston,7591,1,22,3,11,88,54,34,69
Airdrieon,7591,2,16,9,11,58,56,2,57
Alloa,7591,3,15,8,13,70,53,17,53
Stranraer,7591,4,15,8,13,56,52,4,53
Albion,7591,5,15,7,14,64,58,6,52
Peterhead,7591,6,13,9,14,54,55,-1,48
Brechin,7591,7,13,9,14,45,58,-13,48
East Fife,7591,8,12,9,15,60,55,5,45
Queen's Park,7591,9,12,7,17,44,65,-21,43
Stenhousem'r,7591,10,9,7,20,46,79,-33,34
Livingston,7592,1,19,7,10,73,47,26,64
Albion,7592,2,17,9,10,57,46,11,60
Alloa,7592,3,15,9,12,59,47,12,54
Brechin,7592,4,14,10,12,46,41,5,52
Queen's Park,7592,5,14,10,12,44,44,0,52
Stranraer,7592,6,15,5,16,54,56,-2,50
Airdrieon,7592,7,13,10,13,54,59,-5,49
East Fife,7592,8,11,11,14,45,50,-5,44
Peterhead,7592,9,12,7,17,40,49,-9,43
Stenhousem'r,7592,10,7,8,21,53,86,-33,29
Livingston,7593,1,22,5,9,73,41,32,71
Alloa,7593,2,19,5,12,69,45,24,62
Peterhead,7593,3,15,9,12,60,50,10,54
Airdrieon,7593,4,15,7,14,53,54,-1,52
Brechin,7593,5,16,3,17,49,47,2,51
Queen's Park,7593,6,14,7,15,37,46,-9,49
East Fife,7593,7,13,9,14,47,48,-1,48
Albion,7593,8,13,7,16,49,55,-6,46
Stranraer,7593,9,12,4,20,38,57,-19,40
Stenhousem'r,7593,10,9,8,19,52,84,-32,35
Alloa,7594,1,25,6,5,86,38,48,81
Livingston,7594,2,16,6,14,64,57,7,54
Airdrieon,7594,3,16,6,14,56,59,-3,54
East Fife,7594,4,15,8,13,56,46,10,53
Peterhead,7594,5,14,11,11,53,47,6,53
Albion,7594,6,11,12,13,56,58,-2,45
Brechin,7594,7,13,6,17,39,53,-14,45
Queen's Park,7594,8,12,8,16,34,45,-11,44
Stranraer,7594,9,11,8,17,41,52,-11,41
Stenhousem'r,7594,10,7,9,20,43,73,-30,30
Livingston,7595,1,23,6,7,82,38,44,75
Alloa,7595,2,21,8,7,71,41,30,71
Airdrieon,7595,3,19,5,12,67,67,0,62
Peterhead,7595,4,15,8,13,46,46,0,53
Brechin,7595,5,16,3,17,47,45,2,51
Albion,7595,6,11,14,11,45,47,-2,47
Queen's Park,7595,7,13,4,19,33,51,-18,43
East Fife,7595,8,11,8,17,57,61,-4,41
Stranraer,7595,9,10,4,22,44,67,-23,34
Stenhousem'r,7595,10,7,8,21,52,81,-29,29
Airdrieon,7596,1,21,6,9,67,46,21,69
Livingston,7596,2,19,7,10,64,40,24,64
Peterhead,7596,3,19,5,12,49,45,4,62
Alloa,7596,4,17,7,12,65,52,13,58
Brechin,7596,5,15,8,13,56,48,8,53
Albion,7596,6,15,7,14,56,54,2,52
Stranraer,7596,7,14,5,17,57,58,-1,47
East Fife,7596,8,11,7,18,53,59,-6,40
Queen's Park,7596,9,9,9,18,37,58,-21,36
Stenhousem'r,7596,10,6,7,23,41,85,-44,25
Alloa,7597,1,21,7,8,78,45,33,70
Livingston,7597,2,21,5,10,73,42,31,68
Airdrieon,7597,3,18,6,12,60,51,9,60
Brechin,7597,4,16,8,12,49,47,2,56
Queen's Park,7597,5,16,5,15,46,50,-4,53
Stranraer,7597,6,12,6,18,49,58,-9,42
East Fife,7597,7,10,10,16,42,47,-5,40
Peterhead,7597,8,10,10,16,46,63,-17,40
Albion,7597,9,9,11,16,42,54,-12,38
Stenhousem'r,7597,10,8,10,18,47,75,-28,34
Livingston,7598,1,20,7,9,73,49,24,67
Peterhead,7598,2,15,10,11,61,50,11,55
East Fife,7598,3,15,9,12,58,42,16,54
Airdrieon,7598,4,14,9,13,59,60,-1,51
Stranraer,7598,5,14,8,14,52,52,0,50
Brechin,7598,6,13,9,14,46,53,-7,48
Alloa,7598,7,11,14,11,55,49,6,47
Albion,7598,8,13,7,16,58,60,-2,46
Queen's Park,7598,9,11,11,14,36,50,-14,44
Stenhousem'r,7598,10,7,10,19,45,78,-33,31
Alloa,7599,1,20,5,11,74,43,31,65
Livingston,7599,2,19,5,12,67,50,17,62
Brechin,7599,3,15,11,10,52,45,7,56
Airdrieon,7599,4,15,10,11,66,58,8,55
Stranraer,7599,5,17,4,15,60,62,-2,55
Peterhead,7599,6,13,8,15,52,56,-4,47
Queen's Park,7599,7,13,8,15,44,50,-6,47
Albion,7599,8,12,10,14,56,61,-5,46
East Fife,7599,9,8,12,16,44,52,-8,36
Stenhousem'r,7599,10,7,9,20,48,86,-38,30
Livingston,7600,1,21,5,10,75,53,22,68
Brechin,7600,2,18,7,11,55,44,11,61
Alloa,7600,3,18,6,12,68,46,22,60
Airdrieon,7600,4,18,6,12,63,58,5,60
Albion,7600,5,15,9,12,61,56,5,54
Peterhead,7600,6,14,8,14,54,49,5,50
Queen's Park,7600,7,13,6,17,36,51,-15,45
East Fife,7600,8,11,8,17,45,50,-5,41
Stranraer,7600,9,10,8,18,45,57,-12,38
Stenhousem'r,7600,10,8,5,23,50,88,-38,29
Livingston,7601,1,20,5,11,76,49,27,65
Alloa,7601,2,17,9,10,71,52,19,60
Peterhead,7601,3,17,8,11,52,44,8,59
Airdrieon,7601,4,18,3,15,60,61,-1,57
Brechin,7601,5,16,7,13,47,40,7,55
Queen's Park,7601,6,15,5,16,46,50,-4,50
Albion,7601,7,14,7,15,54,61,-7,49
Stranraer,7601,8,14,4,18,48,56,-8,46
East Fife,7601,9,11,7,18,53,54,-1,40
Stenhousem'r,7601,10,7,7,22,42,82,-40,28
Livingston,7602,1,23,4,9,93,55,38,73
Alloa,7602,2,22,7,7,74,38,36,73
Brechin,7602,3,17,6,13,53,50,3,57
Airdrieon,7602,4,16,8,12,62,58,4,56
Peterhead,7602,5,15,9,12,53,52,1,54
Albion,7602,6,14,5,17,54,59,-5,47
Queen's Park,7602,7,11,10,15,42,53,-11,43
East Fife,7602,8,10,11,15,52,60,-8,41
Stranraer,7602,9,10,3,23,52,71,-19,33
Stenhousem'r,7602,10,7,7,22,44,83,-39,28
Brechin,7603,1,18,8,10,57,41,16,62
Livingston,7603,2,17,9,10,71,50,21,60
Alloa,7603,3,17,7,12,62,47,15,58
Peterhead,7603,4,16,9,11,44,39,5,57
Airdrieon,7603,5,13,10,13,48,51,-3,49
Stranraer,7603,6,13,9,14,49,49,0,48
Albion,7603,7,12,12,12,48,49,-1,48
Queen's Park,7603,8,12,11,13,38,40,-2,47
East Fife,7603,9,8,11,17,43,58,-15,35
Stenhousem'r,7603,10,9,4,23,50,86,-36,31
Livingston,7604,1,24,2,10,90,52,38,74
Airdrieon,7604,2,20,6,10,57,47,10,66
Peterhead,7604,3,17,10,9,59,43,16,61
Brechin,7604,4,18,5,13,50,40,10,59
Alloa,7604,5,15,11,10,67,50,17,56
Albion,7604,6,12,9,15,54,55,-1,45
Queen's Park,7604,7,13,5,18,35,50,-15,44
East Fife,7604,8,11,8,17,58,65,-7,41
Stranraer,7604,9,12,5,19,49,61,-12,41
Stenhousem'r,7604,10,4,7,25,35,91,-56,19
Livingston,7605,1,20,6,10,72,44,28,66
Alloa,7605,2,19,9,8,66,38,28,66
Brechin,7605,3,19,5,12,55,46,9,62
Airdrieon,7605,4,17,7,12,56,52,4,58
Stranraer,7605,5,15,6,15,52,53,-1,51
Peterhead,7605,6,13,8,15,48,55,-7,47
Queen's Park,7605,7,14,3,19,42,59,-17,45
East Fife,7605,8,11,8,17,49,52,-3,41
Albion,7605,9,11,8,17,50,55,-5,41
Stenhousem'r,7605,10,8,6,22,47,83,-36,30
Livingston,7606,1,22,3,11,71,43,28,69
Brechin,7606,2,20,4,12,55,42,13,64
Airdrieon,7606,3,19,6,11,60,53,7,63
Alloa,7606,4,17,8,11,70,48,22,59
East Fife,7606,5,13,11,12,52,44,8,50
Queen's Park,7606,6,14,7,15,36,43,-7,49
Albion,7606,7,12,9,15,54,55,-1,45
Peterhead,7606,8,12,6,18,44,56,-12,42
Stranraer,7606,9,9,8,19,43,62,-19,35
Stenhousem'r,7606,10,8,6,22,40,79,-39,30
Livingston,7607,1,21,6,9,77,39,38,69
Alloa,7607,2,21,6,9,71,38,33,69
Brechin,7607,3,18,8,10,56,47,9,62
Airdrieon,7607,4,16,7,13,59,50,9,55
Albion,7607,5,15,8,13,51,46,5,53
East Fife,7607,6,13,11,12,51,44,7,50
Peterhead,7607,7,13,9,14,47,54,-7,48
Queen's Park,7607,8,12,7,17,28,47,-19,43
Stranraer,7607,9,8,5,23,38,60,-22,29
Stenhousem'r,7607,10,7,5,24,46,99,-53,26
Livingston,7608,1,23,6,7,84,49,35,75
Brechin,7608,2,22,5,9,66,36,30,71
Alloa,7608,3,20,8,8,68,42,26,68
Airdrieon,7608,4,17,7,12,52,47,5,58
Albion,7608,5,17,6,13,58,50,8,57
Peterhead,7608,6,14,9,13,50,53,-3,51
Queen's Park,7608,7,10,10,16,31,47,-16,40
East Fife,7608,8,7,9,20,42,50,-8,30
Stranraer,7608,9,9,3,24,46,77,-31,30
Stenhousem'r,7608,10,7,5,24,41,87,-46,26
Livingston,7609,1,23,4,9,88,48,40,73
Alloa,7609,2,19,8,9,75,45,30,65
Airdrieon,7609,3,18,7,11,65,50,15,61
Peterhead,7609,4,14,10,12,50,48,2,52
Albion,7609,5,13,10,13,56,51,5,49
East Fife,7609,6,13,7,16,48,46,2,46
Brechin,7609,7,12,9,15,41,48,-7,45
Stranraer,7609,8,11,9,16,46,62,-16,42
Queen's Park,7609,9,9,9,18,27,52,-25,36
Stenhousem'r,7609,10,8,7,21,42,88,-46,31
Livingston,7610,1,20,3,13,72,51,21,63
Alloa,7610,2,17,11,8,66,41,25,62
Brechin,7610,3,16,7,13,46,43,3,55
Airdrieon,7610,4,15,7,14,64,58,6,52
Peterhead,7610,5,15,6,15,50,44,6,51
Albion,7610,6,15,6,15,51,50,1,51
East Fife,7610,7,14,6,16,46,46,0,48
Stranraer,7610,8,15,3,18,48,58,-10,48
Queen's Park,7610,9,11,9,16,31,53,-22,42
Stenhousem'r,7610,10,11,4,21,46,76,-30,37
Airdrieon,7611,1,21,5,10,65,51,14,68
Alloa,7611,2,20,6,10,71,42,29,66
Livingston,7611,3,19,3,14,75,57,18,60
Brechin,7611,4,16,7,13,51,55,-4,55
Albion,7611,5,15,7,14,55,43,12,52
East Fife,7611,6,15,5,16,56,49,7,50
Peterhead,7611,7,14,7,15,58,61,-3,49
Stranraer,7611,8,13,6,17,60,65,-5,45
Queen's Park,7611,9,10,8,18,37,61,-24,38
Stenhousem'r,7611,10,6,8,22,43,87,-44,26
Livingston,7612,1,20,9,7,71,38,33,69
Alloa,7612,2,17,13,6,62,43,19,64
Brechin,7612,3,18,4,14,46,43,3,58
Airdrieon,7612,4,16,6,14,51,53,-2,54
Albion,7612,5,13,10,13,62,50,12,49
Queen's Park,7612,6,14,6,16,36,51,-15,48
East Fife,7612,7,10,12,14,45,48,-3,42
Peterhead,7612,8,10,11,15,45,51,-6,41
Stranraer,7612,9,9,10,17,50,60,-10,37
Stenhousem'r,7612,10,7,11,18,46,77,-31,32
Livingston,7613,1,20,6,10,82,45,37,66
Alloa,7613,2,19,7,10,61,34,27,64
Brechin,7613,3,18,7,11,48,43,5,61
Peterhead,7613,4,18,6,12,53,40,13,60
Airdrieon,7613,5,14,9,13,56,61,-5,51
Albion,7613,6,14,8,14,51,51,0,50
Stranraer,7613,7,14,7,15,50,49,1,49
Queen's Park,7613,8,11,7,18,36,61,-25,40
Stenhousem'r,7613,9,9,5,22,41,80,-39,32
East Fife,7613,10,7,10,19,40,54,-14,31
Livingston,7614,1,20,6,10,74,55,19,66
Alloa,7614,2,20,5,11,62,42,20,65
Airdrieon,7614,3,19,7,10,66,51,15,64
Brechin,7614,4,14,11,11,47,44,3,53
Stranraer,7614,5,14,7,15,56,61,-5,49
Peterhead,7614,6,14,5,17,56,55,1,47
Albion,7614,7,11,11,14,47,50,-3,44
East Fife,7614,8,10,10,16,49,51,-2,40
Stenhousem'r,7614,9,11,7,18,46,70,-24,40
Queen's Park,7614,10,10,5,21,32,56,-24,35
Alloa,7615,1,22,6,8,71,42,29,72
Brechin,7615,2,19,5,12,48,49,-1,62
Peterhead,7615,3,18,5,13,64,49,15,59
Livingston,7615,4,18,4,14,70,53,17,58
Albion,7615,5,15,7,14,51,51,0,52
Airdrieon,7615,6,15,6,15,58,61,-3,51
Stranraer,7615,7,13,5,18,45,50,-5,44
East Fife,7615,8,12,6,18,51,52,-1,42
Queen's Park,7615,9,10,8,18,35,50,-15,38
Stenhousem'r,7615,10,10,4,22,38,74,-36,34
Livingston,7616,1,22,6,8,70,43,27,72
Alloa,7616,2,19,8,9,76,48,28,65
Airdrieon,7616,3,17,8,11,70,56,14,59
Brechin,7616,4,15,9,12,50,48,2,54
Queen's Park,7616,5,15,6,15,43,54,-11,51
East Fife,7616,6,13,7,16,47,48,-1,46
Stranraer,7616,7,12,8,16,47,48,-1,44
Peterhead,7616,8,12,8,16,44,53,-9,44
Albion,7616,9,10,12,14,47,53,-6,42
Stenhousem'r,7616,10,5,8,23,44,87,-43,23
Livingston,7617,1,25,4,7,79,37,42,79
Alloa,7617,2,17,10,9,79,50,29,61
Brechin,7617,3,17,6,13,57,62,-5,57
Stranraer,7617,4,15,5,16,53,63,-10,50
Airdrieon,7617,5,14,7,15,55,58,-3,49
Peterhead,7617,6,14,6,16,71,62,9,48
East Fife,7617,7,12,10,14,45,40,5,46
Albion,7617,8,11,12,13,55,58,-3,45
Queen's Park,7617,9,11,8,17,40,58,-18,41
Stenhousem'r,7617,10,8,4,24,44,90,-46,28
Alloa,7618,1,21,9,6,80,44,36,72
Airdrieon,7618,2,20,8,8,69,47,22,68
Brechin,7618,3,20,8,8,57,42,15,68
Livingston,7618,4,19,6,11,74,51,23,63
Peterhead,7618,5,15,9,12,51,50,1,54
East Fife,7618,6,10,11,15,47,47,0,41
Albion,7618,7,10,11,15,45,53,-8,41
Stranraer,7618,8,11,6,19,49,68,-19,39
Queen's Park,7618,9,9,7,20,31,61,-30,34
Stenhousem'r,7618,10,4,7,25,41,81,-40,19
Livingston,7619,1,21,6,9,67,39,28,69
Alloa,7619,2,19,7,10,70,43,27,64
Airdrieon,7619,3,17,7,12,66,53,13,58
Queen's Park,7619,4,14,9,13,44,43,1,51
East Fife,7619,5,13,11,12,54,49,5,50
Brechin,7619,6,12,10,14,39,47,-8,46
Peterhead,7619,7,12,9,15,42,48,-6,45
Albion,7619,8,12,8,16,49,52,-3,44
Stranraer,7619,9,11,7,18,45,60,-15,40
Stenhousem'r,7619,10,9,6,21,41,83,-42,33
Alloa,7620,1,22,6,8,75,41,34,72
Livingston,7620,2,21,6,9,83,55,28,69
Airdrieon,7620,3,19,7,10,66,55,11,64
Brechin,7620,4,16,6,14,51,46,5,54
Stranraer,7620,5,15,3,18,52,56,-4,48
Albion,7620,6,13,7,16,53,56,-3,46
Peterhead,7620,7,12,8,16,48,57,-9,44
East Fife,7620,8,9,13,14,40,43,-3,40
Queen's Park,7620,9,9,7,20,31,55,-24,34
Stenhousem'r,7620,10,8,9,19,46,81,-35,33
Livingston,7621,1,18,4,14,77,59,18,58
Albion,7621,2,14,13,9,58,40,18,55
Brechin,7621,3,16,6,14,50,54,-4,54
Alloa,7621,4,15,8,13,71,50,21,53
Airdrieon,7621,5,15,8,13,70,66,4,53
Peterhead,7621,6,14,9,13,56,53,3,51
Queen's Park,7621,7,14,7,15,44,49,-5,49
Stranraer,7621,8,13,8,15,50,61,-11,47
East Fife,7621,9,12,7,17,50,54,-4,43
Stenhousem'r,7621,10,10,8,18,42,82,-40,38
Livingston,7622,1,21,3,12,77,55,22,66
Alloa,7622,2,19,7,10,65,42,23,64
Airdrieon,7622,3,20,3,13,64,53,11,63
Peterhead,7622,4,15,8,13,47,47,0,53
Albion,7622,5,15,7,14,56,55,1,52
Brechin,7622,6,14,10,12,43,42,1,52
East Fife,7622,7,12,9,15,51,51,0,45
Stranraer,7622,8,11,6,19,50,64,-14,39
Queen's Park,7622,9,10,8,18,32,50,-18,38
Stenhousem'r,7622,10,8,9,19,40,66,-26,33
Alloa,7623,1,19,8,9,69,50,19,65
Livingston,7623,2,20,2,14,73,49,24,62
Airdrieon,7623,3,18,7,11,60,50,10,61
Peterhead,7623,4,18,7,11,57,47,10,61
Brechin,7623,5,16,6,14,49,45,4,54
Albion,7623,6,14,8,14,47,47,0,50
Queen's Park,7623,7,12,11,13,41,55,-14,47
East Fife,7623,8,11,9,16,53,51,2,42
Stranraer,7623,9,11,4,21,48,64,-16,37
Stenhousem'r,7623,10,7,6,23,45,84,-39,27
Alloa,7624,1,19,8,9,74,46,28,65
Albion,7624,2,17,8,11,54,47,7,59
Livingston,7624,3,17,7,12,66,53,13,58
Airdrieon,7624,4,16,7,13,56,51,5,55
Brechin,7624,5,17,4,15,55,52,3,55
Peterhead,7624,6,13,9,14,47,46,1,48
Queen's Park,7624,7,14,5,17,32,50,-18,47
Stranraer,7624,8,14,3,19,53,67,-14,45
East Fife,7624,9,12,8,16,54,51,3,44
Stenhousem'r,7624,10,7,9,20,43,71,-28,30
Livingston,7625,1,20,7,9,76,51,25,67
Alloa,7625,2,19,9,8,72,40,32,66
Airdrieon,7625,3,19,6,11,68,55,13,63
Brechin,7625,4,18,4,14,55,54,1,58
East Fife,7625,5,16,8,12,58,47,11,56
Albion,7625,6,16,6,14,52,53,-1,54
Queen's Park,7625,7,13,4,19,41,60,-19,43
Peterhead,7625,8,11,7,18,53,61,-8,40
Stranraer,7625,9,10,7,19,52,59,-7,37
Stenhousem'r,7625,10,5,8,23,46,93,-47,23
Airdrieon,7626,1,19,6,11,64,56,8,63
Alloa,7626,2,18,8,10,71,45,26,62
Livingston,7626,3,18,6,12,70,49,21,60
Stranraer,7626,4,17,6,13,52,47,5,57
Albion,7626,5,16,8,12,65,55,10,56
East Fife,7626,6,13,8,15,54,50,4,47
Peterhead,7626,7,12,10,14,48,50,-2,46
Queen's Park,7626,8,13,4,19,38,58,-20,43
Brechin,7626,9,12,4,20,46,65,-19,40
Stenhousem'r,7626,10,9,6,21,43,76,-33,33
Livingston,7627,1,22,4,10,81,52,29,70
Queen's Park,7627,2,17,8,11,44,37,7,59
Brechin,7627,3,18,5,13,49,47,2,59
Alloa,7627,4,17,6,13,70,49,21,57
Peterhead,7627,5,14,7,15,61,66,-5,49
Albion,7627,6,12,12,12,56,52,4,48
Airdrieon,7627,7,14,6,16,52,56,-4,48
Stranraer,7627,8,11,9,16,48,62,-14,42
East Fife,7627,9,8,12,16,45,52,-7,36
Stenhousem'r,7627,10,9,7,20,47,80,-33,34
Livingston,7628,1,21,6,9,73,41,32,69
Alloa,7628,2,19,8,9,72,41,31,65
Brechin,7628,3,18,4,14,48,46,2,58
Airdrieon,7628,4,16,7,13,56,54,2,55
Peterhead,7628,5,15,5,16,51,64,-13,50
Stranraer,7628,6,15,4,17,52,58,-6,49
Queen's Park,7628,7,13,7,16,44,52,-8,46
Albion,7628,8,11,10,15,48,50,-2,43
East Fife,7628,9,9,11,16,48,56,-8,38
Stenhousem'r,7628,10,7,10,19,44,74,-30,31
Airdrieon,7629,1,20,6,10,59,51,8,66
Livingston,7629,2,18,9,9,77,50,27,63
Alloa,7629,3,16,11,9,61,41,20,59
Queen's Park,7629,4,14,10,12,50,47,3,52
Peterhead,7629,5,14,6,16,51,56,-5,48
East Fife,7629,6,12,10,14,54,49,5,46
Brechin,7629,7,12,10,14,48,48,0,46
Albion,7629,8,13,7,16,53,59,-6,46
Stranraer,7629,9,12,6,18,50,62,-12,42
Stenhousem'r,7629,10,6,11,19,42,82,-40,29
Livingston,7630,1,23,1,12,81,46,35,70
Alloa,7630,2,20,5,11,76,47,29,65
Airdrieon,7630,3,18,7,11,57,50,7,61
Brechin,7630,4,16,7,13,56,51,5,55
East Fife,7630,5,13,11,12,56,50,6,50
Albion,7630,6,14,8,14,60,60,0,50
Peterhead,7630,7,12,10,14,57,61,-4,46
Stranraer,7630,8,10,8,18,47,64,-17,38
Queen's Park,7630,9,9,8,19,35,65,-30,35
Stenhousem'r,7630,10,7,11,18,51,82,-31,32
Airdrieon,7631,1,22,5,9,66,44,22,71
Livingston,7631,2,18,5,13,67,54,13,59
Albion,7631,3,18,5,13,66,58,8,59
Alloa,7631,4,15,10,11,57,45,12,55
Brechin,7631,5,16,7,13,54,48,6,55
East Fife,7631,6,16,6,14,54,43,11,54
Stranraer,7631,7,14,6,16,47,56,-9,48
Stenhousem'r,7631,8,11,5,20,45,66,-21,38
Queen's Park,7631,9,9,8,19,34,53,-19,35
Peterhead,7631,10,7,11,18,39,62,-23,32
Livingston,7632,1,21,5,10,78,48,30,68
Alloa,7632,2,19,9,8,70,43,27,66
Brechin,7632,3,18,6,12,52,43,9,60
Peterhead,7632,4,15,7,14,50,46,4,52
Airdrieon,7632,5,14,10,12,55,54,1,52
Albion,7632,6,13,7,16,44,52,-8,46
Queen's Park,7632,7,11,10,15,41,56,-15,43
East Fife,7632,8,10,11,15,43,43,0,41
Stranraer,7632,9,10,8,18,50,67,-17,38
Stenhousem'r,7632,10,9,7,20,46,77,-31,34
Airdrieon,7633,1,17,8,11,60,56,4,59
Alloa,7633,2,16,9,11,65,42,23,57
Livingston,7633,3,17,4,15,67,53,14,55
Albion,7633,4,15,10,11,61,49,12,55
Queen's Park,7633,5,15,7,14,42,45,-3,52
Brechin,7633,6,15,6,15,46,53,-7,51
Stranraer,7633,7,14,7,15,53,56,-3,49
East Fife,7633,8,12,8,16,41,45,-4,44
Stenhousem'r,7633,9,12,6,18,56,75,-19,42
Peterhead,7633,10,11,7,18,40,57,-17,40
Alloa,7634,1,19,8,9,69,42,27,65
Livingston,7634,2,21,1,14,66,47,19,64
Brechin,7634,3,19,6,11,46,33,13,63
Airdrieon,7634,4,19,4,13,68,56,12,61
Albion,7634,5,14,11,11,57,43,14,53
Queen's Park,7634,6,13,6,17,28,45,-17,45
Stranraer,7634,7,12,7,17,51,64,-13,43
East Fife,7634,8,10,12,14,46,46,0,42
Peterhead,7634,9,10,9,17,44,60,-16,39
Stenhousem'r,7634,10,7,8,21,46,85,-39,29
Livingston,7635,1,24,4,8,78,38,40,76
Airdrieon,7635,2,20,7,9,64,43,21,67
Alloa,7635,3,17,9,10,68,46,22,60
Brechin,7635,4,18,3,15,55,51,4,57
Queen's Park,7635,5,14,8,14,41,52,-11,50
Peterhead,7635,6,14,6,16,50,53,-3,48
East Fife,7635,7,11,8,17,39,50,-11,41
Albion,7635,8,10,10,16,49,58,-9,40
Stranraer,7635,9,11,7,18,43,58,-15,40
Stenhousem'r,7635,10,6,8,22,39,77,-38,26
Alloa,7636,1,20,10,6,71,39,32,70
Airdrieon,7636,2,22,4,10,78,57,21,70
Livingston,7636,3,20,6,10,75,48,27,66
Brechin,7636,4,17,4,15,45,47,-2,55
Albion,7636,5,12,13,11,52,53,-1,49
Stranraer,7636,6,14,6,16,48,51,-3,48
Peterhead,7636,7,12,10,14,39,45,-6,46
Queen's Park,7636,8,13,5,18,38,52,-14,44
East Fife,7636,9,8,9,19,36,48,-12,33
Stenhousem'r,7636,10,6,5,25,38,80,-42,23
Airdrieon,7637,1,20,6,10,63,49,14,66
Alloa,7637,2,20,5,11,61,38,23,65
Livingston,7637,3,18,8,10,74,48,26,62
Albion,7637,4,16,10,10,55,46,9,58
Peterhead,7637,5,14,7,15,48,46,2,49
Queen's Park,7637,6,13,9,14,33,41,-8,48
Brechin,7637,7,14,6,16,44,61,-17,48
East Fife,7637,8,10,11,15,41,42,-1,41
Stranraer,7637,9,10,5,21,46,66,-20,35
Stenhousem'r,7637,10,6,11,19,44,72,-28,29
Livingston,7638,1,20,4,12,78,53,25,64
Brechin,7638,2,19,2,15,46,57,-11,59
Alloa,7638,3,16,10,10,77,51,26,58
Albion,7638,4,16,6,14,67,62,5,54
Peterhead,7638,5,16,6,14,55,52,3,54
Airdrieon,7638,6,15,4,17,72,62,10,49
East Fife,7638,7,12,12,12,59,49,10,48
Queen's Park,7638,8,11,10,15,36,49,-13,43
Stenhousem'r,7638,9,10,9,17,47,83,-36,39
Stranraer,7638,10,11,5,20,45,64,-19,38
Albion,7639,1,18,8,10,64,43,21,62
Alloa,7639,2,18,7,11,67,45,22,61
Brechin,7639,3,18,7,11,57,40,17,61
Livingston,7639,4,18,6,12,68,55,13,60
Peterhead,7639,5,16,9,11,56,45,11,57
Airdrieon,7639,6,16,6,14,61,69,-8,54
Queen's Park,7639,7,13,5,18,40,53,-13,44
Stranraer,7639,8,12,6,18,48,57,-9,42
East Fife,7639,9,11,8,17,44,53,-9,41
Stenhousem'r,7639,10,6,6,24,41,86,-45,24
Brechin,7640,1,22,7,7,58,36,22,73
Alloa,7640,2,19,6,11,82,50,32,63
Livingston,7640,3,19,6,11,77,48,29,63
Peterhead,7640,4,16,7,13,61,58,3,55
Airdrieon,7640,5,14,6,16,50,62,-12,48
Albion,7640,6,11,13,12,51,52,-1,46
Queen's Park,7640,7,13,7,16,40,56,-16,46
Stranraer,7640,8,11,9,16,52,66,-14,42
East Fife,7640,9,9,10,17,48,55,-7,37
Stenhousem'r,7640,10,5,11,20,46,82,-36,26
Airdrieon,7641,1,18,6,12,64,56,8,60
Livingston,7641,2,17,8,11,78,60,18,59
Alloa,7641,3,16,9,11,63,43,20,57
Albion,7641,4,14,9,13,53,55,-2,51
Brechin,7641,5,15,6,15,51,53,-2,51
Queen's Park,7641,6,13,10,13,47,49,-2,49
Peterhead,7641,7,13,9,14,56,62,-6,48
Stranraer,7641,8,14,6,16,53,59,-6,48
East Fife,7641,9,11,10,15,50,50,0,43
Stenhousem'r,7641,10,7,11,18,49,77,-28,32
Brechin,7642,1,21,4,11,55,46,9,67
Alloa,7642,2,17,7,12,71,48,23,58
Queen's Park,7642,3,16,9,11,49,47,2,57
Livingston,7642,4,16,7,13,63,48,15,55
Albion,7642,5,12,11,13,48,47,1,47
Stranraer,7642,6,13,7,16,55,67,-12,46
Airdrieon,7642,7,13,6,17,54,62,-8,45
East Fife,7642,8,10,14,12,55,46,9,44
Peterhead,7642,9,12,8,16,42,59,-17,44
Stenhousem'r,7642,10,9,9,18,49,71,-22,36
Livingston,7643,1,22,4,10,79,53,26,70
Alloa,7643,2,18,10,8,64,42,22,64
Airdrieon,7643,3,19,4,13,61,54,7,61
Brechin,7643,4,18,4,14,50,46,4,58
Queen's Park,7643,5,13,8,15,39,48,-9,47
East Fife,7643,6,12,9,15,46,47,-1,45
Albion,7643,7,11,11,14,53,53,0,44
Stenhousem'r,7643,8,12,7,17,56,69,-13,43
Peterhead,7643,9,10,7,19,44,61,-17,37
Stranraer,7643,10,10,6,20,42,61,-19,36
Alloa,7644,1,19,8,9,74,47,27,65
Brechin,7644,2,18,6,12,55,38,17,60
Airdrieon,7644,3,15,10,11,55,53,2,55
Livingston,7644,4,16,6,14,66,53,13,54
Queen's Park,7644,5,14,11,11,46,52,-6,53
Stranraer,7644,6,15,6,15,56,56,0,51
Peterhead,7644,7,13,9,14,49,52,-3,48
Albion,7644,8,11,12,13,50,51,-1,45
East Fife,7644,9,6,17,13,41,48,-7,35
Stenhousem'r,7644,10,5,11,20,37,79,-42,26
Livingston,7645,1,20,7,9,82,53,29,67
Alloa,7645,2,16,11,9,73,48,25,59
Brechin,7645,3,16,7,13,51,50,1,55
Airdrieon,7645,4,15,9,12,62,57,5,54
Peterhead,7645,5,14,9,13,56,55,1,51
Albion,7645,6,13,11,12,58,57,1,50
East Fife,7645,7,13,10,13,55,41,14,49
Queen's Park,7645,8,12,11,13,36,47,-11,47
Stranraer,7645,9,10,7,19,44,63,-19,37
Stenhousem'r,7645,10,5,10,21,41,87,-46,25
Livingston,7646,1,23,4,9,77,51,26,73
Alloa,7646,2,19,8,9,77,51,26,65
Airdrieon,7646,3,15,11,10,67,51,16,56
Albion,7646,4,16,7,13,55,47,8,55
Brechin,7646,5,13,9,14,44,52,-8,48
East Fife,7646,6,12,9,15,46,47,-1,45
Peterhead,7646,7,11,10,15,40,52,-12,43
Queen's Park,7646,8,11,9,16,37,51,-14,42
Stranraer,7646,9,10,8,18,50,63,-13,38
Stenhousem'r,7646,10,8,9,19,45,73,-28,33
Livingston,7647,1,23,4,9,83,50,33,73
Alloa,7647,2,21,7,8,76,45,31,70
Brechin,7647,3,16,7,13,50,49,1,55
Peterhead,7647,4,15,7,14,49,50,-1,52
Albion,7647,5,14,8,14,58,56,2,50
Stranraer,7647,6,16,2,18,51,58,-7,50
Airdrieon,7647,7,13,7,16,54,61,-7,46
Queen's Park,7647,8,13,6,17,35,50,-15,45
East Fife,7647,9,8,9,19,45,55,-10,33
Stenhousem'r,7647,10,8,9,19,52,79,-27,33
Livingston,7648,1,20,7,9,73,46,27,67
Alloa,7648,2,19,5,12,75,48,27,62
Airdrieon,7648,3,18,4,14,61,53,8,58
Queen's Park,7648,4,17,6,13,50,42,8,57
Brechin,7648,5,16,6,14,58,59,-1,54
Peterhead,7648,6,15,7,14,56,54,2,52
Albion,7648,7,13,8,15,52,56,-4,47
East Fife,7648,8,12,9,15,49,58,-9,45
Stranraer,7648,9,12,2,22,43,65,-22,38
Stenhousem'r,7648,10,8,6,22,50,86,-36,30
Alloa,7649,1,21,9,6,76,39,37,72
Airdrieon,7649,2,18,7,11,52,43,9,61
Livingston,7649,3,17,6,13,67,50,17,57
Brechin,7649,4,14,8,14,55,54,1,50
Peterhead,7649,5,13,10,13,51,50,1,49
Albion,7649,6,14,5,17,55,51,4,47
East Fife,7649,7,13,8,15,53,50,3,47
Stranraer,7649,8,15,1,20,55,65,-10,46
Queen's Park,7649,9,12,8,16,35,56,-21,44
Stenhousem'r,7649,10,8,8,20,42,83,-41,32
Airdrieon,7650,1,21,5,10,73,50,23,68
Livingston,7650,2,18,8,10,81,58,23,62
Alloa,7650,3,18,5,13,75,57,18,59
Queen's Park,7650,4,16,7,13,49,47,2,55
Brechin,7650,5,15,8,13,49,54,-5,53
Peterhead,7650,6,14,7,15,54,60,-6,49
Stranraer,7650,7,13,8,15,56,57,-1,47
East Fife,7650,8,12,9,15,54,47,7,45
Albion,7650,9,11,9,16,49,62,-13,42
Stenhousem'r,7650,10,5,8,23,45,93,-48,23
Livingston,7651,1,23,3,10,78,46,32,72
Alloa,7651,2,16,10,10,69,46,23,58
Airdrieon,7651,3,16,10,10,61,47,14,58
Brechin,7651,4,15,8,13,47,43,4,53
Albion,7651,5,12,11,13,48,51,-3,47
East Fife,7651,6,12,10,14,51,50,1,46
Peterhead,7651,7,13,7,16,50,59,-9,46
Stranraer,7651,8,14,3,19,48,61,-13,45
Queen's Park,7651,9,12,7,17,41,54,-13,43
Stenhousem'r,7651,10,9,7,20,40,76,-36,34
Livingston,7652,1,23,4,9,87,45,42,73
Brechin,7652,2,19,5,12,51,48,3,62
Alloa,7652,3,17,9,10,70,45,25,60
Albion,7652,4,16,10,10,56,43,13,58
Peterhead,7652,5,12,12,12,48,55,-7,48
Queen's Park,7652,6,13,8,15,37,45,-8,47
Stranraer,7652,7,14,3,19,55,61,-6,45
Airdrieon,7652,8,9,14,13,47,56,-9,41
East Fife,7652,9,9,9,18,38,50,-12,36
Stenhousem'r,7652,10,4,14,18,43,84,-41,26
Livingston,7653,1,23,7,6,87,46,41,76
Alloa,7653,2,20,8,8,68,41,27,68
Airdrieon,7653,3,16,9,11,57,52,5,57
Brechin,7653,4,12,11,13,51,50,1,47
East Fife,7653,5,12,10,14,57,49,8,46
Albion,7653,6,13,7,16,53,74,-21,46
Stenhousem'r,7653,7,13,5,18,56,70,-14,44
Peterhead,7653,8,10,9,17,47,52,-5,39
Stranraer,7653,9,10,8,18,47,64,-17,38
Queen's Park,7653,10,7,14,15,27,52,-25,35
Livingston,7654,1,21,4,11,90,55,35,67
Alloa,7654,2,19,10,7,71,42,29,67
Albion,7654,3,19,9,8,66,44,22,66
Airdrieon,7654,4,17,10,9,61,48,13,61
Brechin,7654,5,18,6,12,59,52,7,60
Queen's Park,7654,6,13,9,14,38,48,-10,48
Peterhead,7654,7,14,6,16,48,60,-12,48
East Fife,7654,8,10,9,17,53,61,-8,39
Stranraer,7654,9,10,2,24,46,71,-25,32
Stenhousem'r,7654,10,3,7,26,38,89,-51,16
Livingston,7655,1,19,5,12,76,50,26,62
Alloa,7655,2,18,5,13,81,52,29,59
Brechin,7655,3,17,6,13,53,43,10,57
Airdrieon,7655,4,17,6,13,51,61,-10,57
Stranraer,7655,5,15,10,11,55,53,2,55
Albion,7655,6,14,9,13,58,51,7,51
East Fife,7655,7,14,8,14,54,57,-3,50
Peterhead,7655,8,14,7,15,59,59,0,49
Queen's Park,7655,9,11,7,18,43,55,-12,40
Stenhousem'r,7655,10,5,9,22,37,86,-49,24
Airdrieon,7656,1,22,6,8,67,43,24,72
Alloa,7656,2,20,9,7,67,41,26,69
Livingston,7656,3,21,5,10,68,44,24,68
Brechin,7656,4,18,8,10,52,39,13,62
Albion,7656,5,16,8,12,52,44,8,56
Peterhead,7656,6,11,9,16,44,53,-9,42
East Fife,7656,7,11,8,17,43,49,-6,41
Stranraer,7656,8,12,5,19,46,55,-9,41
Queen's Park,7656,9,9,5,22,25,57,-32,32
Stenhousem'r,7656,10,6,5,25,44,83,-39,23
Livingston,7657,1,22,4,10,65,38,27,70
Alloa,7657,2,19,6,11,66,38,28,63
Brechin,7657,3,18,6,12,48,46,2,60
Albion,7657,4,14,10,12,56,45,11,52
Airdrieon,7657,5,12,14,10,49,47,2,50
Queen's Park,7657,6,13,8,15,42,51,-9,47
Peterhead,7657,7,13,6,17,41,56,-15,45
Stranraer,7657,8,12,5,19,52,61,-9,41
East Fife,7657,9,8,12,16,40,49,-9,36
Stenhousem'r,7657,10,8,11,17,45,73,-28,35
Alloa,7658,1,20,8,8,74,42,32,68
Airdrieon,7658,2,18,6,12,60,51,9,60
Livingston,7658,3,18,4,14,73,56,17,58
Brechin,7658,4,17,5,14,53,41,12,56
Stranraer,7658,5,17,3,16,47,57,-10,54
East Fife,7658,6,15,7,14,47,42,5,52
Queen's Park,7658,7,15,4,17,44,55,-11,49
Peterhead,7658,8,12,7,17,51,50,1,43
Albion,7658,9,10,7,19,55,72,-17,37
Stenhousem'r,7658,10,9,7,20,39,77,-38,34
Alloa,7659,1,20,7,9,70,41,29,67
Livingston,7659,2,19,6,11,74,51,23,63
Airdrieon,7659,3,17,8,11,60,53,7,59
Brechin,7659,4,17,5,14,47,52,-5,56
Peterhead,7659,5,14,11,11,49,47,2,53
Albion,7659,6,14,10,12,59,50,9,52
Queen's Park,7659,7,12,10,14,37,51,-14,46
Stenhousem'r,7659,8,9,10,17,54,72,-18,37
Stranraer,7659,9,9,8,19,46,64,-18,35
East Fife,7659,10,7,9,20,41,56,-15,30
Airdrieon,7660,1,20,8,8,67,49,18,68
Livingston,7660,2,20,5,11,79,45,34,65
Alloa,7660,3,17,11,8,73,37,36,62
Brechin,7660,4,14,11,11,50,46,4,53
Peterhead,7660,5,15,8,13,45,46,-1,53
Stranraer,7660,6,14,6,16,55,65,-10,48
Queen's Park,7660,7,13,9,14,40,51,-11,48
Albion,7660,8,10,9,17,44,56,-12,39
Stenhousem'r,7660,9,8,8,20,44,81,-37,32
East Fife,7660,10,7,9,20,37,58,-21,30
Airdrieon,7661,1,22,5,9,58,40,18,71
Livingston,7661,2,19,4,13,59,45,14,61
Alloa,7661,3,18,5,13,57,45,12,59
Brechin,7661,4,15,9,12,50,47,3,54
Stranraer,7661,5,15,7,14,50,48,2,52
Peterhead,7661,6,15,7,14,47,48,-1,52
East Fife,7661,7,13,9,14,51,47,4,48
Albion,7661,8,13,7,16,51,55,-4,46
Queen's Park,7661,9,10,5,21,33,52,-19,35
Stenhousem'r,7661,10,6,10,20,47,76,-29,28
Livingston,7662,1,24,3,9,83,45,38,75
Albion,7662,2,18,6,12,71,56,15,60
Peterhead,7662,3,19,3,14,58,49,9,60
Airdrieon,7662,4,17,5,14,62,59,3,56
Brechin,7662,5,16,6,14,53,57,-4,54
Alloa,7662,6,13,8,15,62,53,9,47
Queen's Park,7662,7,13,7,16,29,48,-19,46
East Fife,7662,8,13,5,18,53,62,-9,44
Stranraer,7662,9,12,4,20,48,58,-10,40
Stenhousem'r,7662,10,8,7,21,40,72,-32,31
Livingston,7663,1,25,2,9,90,41,49,77
Brechin,7663,2,19,5,12,51,44,7,62
Airdrieon,7663,3,18,5,13,52,54,-2,59
Alloa,7663,4,16,7,13,64,50,14,55
Albion,7663,5,16,6,14,55,57,-2,54
East Fife,7663,6,14,8,14,55,49,6,50
Stranraer,7663,7,13,5,18,52,58,-6,44
Queen's Park,7663,8,12,6,18,38,54,-16,42
Peterhead,7663,9,10,7,19,44,59,-15,37
Stenhousem'r,7663,10,9,5,22,45,80,-35,32
Alloa,7664,1,22,6,8,76,41,35,72
Livingston,7664,2,21,4,11,75,50,25,67
Brechin,7664,3,20,2,14,61,50,11,62
Airdrieon,7664,4,14,9,13,59,57,2,51
Albion,7664,5,12,13,11,54,51,3,49
Queen's Park,7664,6,12,10,14,44,61,-17,46
Peterhead,7664,7,12,8,16,51,59,-8,44
East Fife,7664,8,10,10,16,51,54,-3,40
Stenhousem'r,7664,9,11,4,21,49,76,-27,37
Stranraer,7664,10,8,10,18,38,59,-21,34
Alloa,7665,1,25,6,5,84,43,41,81
Livingston,7665,2,21,5,10,77,45,32,68
Brechin,7665,3,16,9,11,51,50,1,57
Airdrieon,7665,4,14,11,11,61,53,8,53
Albion,7665,5,13,11,12,52,45,7,50
Peterhead,7665,6,14,7,15,53,58,-5,49
Queen's Park,7665,7,12,9,15,40,54,-14,45
East Fife,7665,8,7,14,15,48,54,-6,35
Stranraer,7665,9,9,5,22,44,72,-28,32
Stenhousem'r,7665,10,8,5,23,39,75,-36,29
Alloa,7666,1,23,6,7,75,40,35,75
Livingston,7666,2,21,7,8,77,47,30,70
Brechin,7666,3,19,5,12,58,50,8,62
Albion,7666,4,16,8,12,57,50,7,56
Airdrieon,7666,5,13,10,13,50,50,0,49
Peterhead,7666,6,13,8,15,56,60,-4,47
Stranraer,7666,7,12,6,18,49,62,-13,42
East Fife,7666,8,11,7,18,50,56,-6,40
Queen's Park,7666,9,10,10,16,36,52,-16,40
Stenhousem'r,7666,10,5,7,24,44,85,-41,22
Brechin,7667,1,23,4,9,59,38,21,73
Alloa,7667,2,21,6,9,68,35,33,69
Livingston,7667,3,16,12,8,70,49,21,60
Airdrieon,7667,4,17,8,11,51,45,6,59
Peterhead,7667,5,14,4,18,46,54,-8,46
Albion,7667,6,11,9,16,50,53,-3,42
Stranraer,7667,7,12,6,18,39,50,-11,42
East Fife,7667,8,10,11,15,45,50,-5,41
Queen's Park,7667,9,9,9,18,30,57,-27,36
Stenhousem'r,7667,10,9,7,20,46,73,-27,34
Alloa,7668,1,17,11,8,67,42,25,62
Livingston,7668,2,20,2,14,66,51,15,62
Brechin,7668,3,18,6,12,47,42,5,60
Airdrieon,7668,4,15,6,15,50,54,-4,51
East Fife,7668,5,13,9,14,52,38,14,48
Peterhead,7668,6,12,12,12,53,50,3,48
Albion,7668,7,14,6,16,51,53,-2,48
Queen's Park,7668,8,13,9,14,42,54,-12,48
Stranraer,7668,9,13,3,20,49,63,-14,42
Stenhousem'r,7668,10,9,8,19,47,77,-30,35
Livingston,7669,1,23,5,8,78,44,34,74
Alloa,7669,2,19,8,9,68,44,24,65
Airdrieon,7669,3,17,7,12,65,50,15,58
Peterhead,7669,4,15,5,16,56,65,-9,50
Albion,7669,5,13,9,14,52,58,-6,48
Stenhousem'r,7669,6,13,7,16,57,65,-8,46
Queen's Park,7669,7,11,10,15,36,51,-15,43
East Fife,7669,8,11,8,17,57,60,-3,41
Brechin,7669,9,12,5,19,43,55,-12,41
Stranraer,7669,10,12,4,20,44,64,-20,40
Airdrieon,7670,1,20,4,12,61,51,10,64
Alloa,7670,2,18,8,10,68,42,26,62
Livingston,7670,3,20,2,14,73,51,22,62
Brechin,7670,4,18,7,11,53,49,4,61
Peterhead,7670,5,15,7,14,45,51,-6,52
Albion,7670,6,15,6,15,52,44,8,51
Stranraer,7670,7,16,3,17,51,57,-6,51
East Fife,7670,8,12,10,14,48,46,2,46
Queen's Park,7670,9,8,8,20,27,55,-28,32
Stenhousem'r,7670,10,7,7,22,37,69,-32,28
Airdrieon,7671,1,22,4,10,56,39,17,70
Alloa,7671,2,20,8,8,69,37,32,68
Brechin,7671,3,16,8,12,42,37,5,56
Queen's Park,7671,4,15,8,13,45,40,5,53
Livingston,7671,5,14,9,13,69,50,19,51
East Fife,7671,6,13,12,11,55,46,9,51
Stranraer,7671,7,14,4,18,50,61,-11,46
Albion,7671,8,12,10,14,51,68,-17,46
Peterhead,7671,9,9,12,15,39,54,-15,39
Stenhousem'r,7671,10,3,9,24,35,79,-44,18
Livingston,7672,1,22,3,11,77,55,22,69
Alloa,7672,2,19,8,9,69,41,28,65
Brechin,7672,3,18,4,14,54,51,3,58
Peterhead,7672,4,15,10,11,50,46,4,55
Airdrieon,7672,5,16,7,13,67,64,3,55
Stranraer,7672,6,14,7,15,56,54,2,49
Albion,7672,7,11,11,14,53,52,1,44
Queen's Park,7672,8,11,8,17,39,53,-14,41
East Fife,7672,9,10,10,16,50,56,-6,40
Stenhousem'r,7672,10,4,12,20,45,88,-43,24
Livingston,7673,1,22,6,8,78,39,39,72
Airdrieon,7673,2,20,6,10,58,44,14,66
Alloa,7673,3,15,10,11,65,51,14,55
Peterhead,7673,4,15,8,13,51,48,3,53
Brechin,7673,5,16,5,15,43,51,-8,53
East Fife,7673,6,14,9,13,50,39,11,51
Albion,7673,7,13,8,15,53,59,-6,47
Queen's Park,7673,8,13,7,16,40,57,-17,46
Stranraer,7673,9,10,4,22,48,62,-14,34
Stenhousem'r,7673,10,6,9,21,38,74,-36,27
Livingston,7674,1,21,4,11,76,60,16,67
Airdrieon,7674,2,18,9,9,73,57,16,63
Alloa,7674,3,17,8,11,63,41,22,59
Albion,7674,4,16,6,14,57,48,9,54
Brechin,7674,5,16,4,16,44,47,-3,52
Stranraer,7674,6,15,6,15,52,53,-1,51
Peterhead,7674,7,13,7,16,53,57,-4,46
East Fife,7674,8,11,9,16,48,51,-3,42
Queen's Park,7674,9,9,10,17,34,58,-24,37
Stenhousem'r,7674,10,7,11,18,43,71,-28,32
Livingston,7675,1,18,8,10,67,40,27,62
Albion,7675,2,15,12,9,51,43,8,57
Airdrieon,7675,3,15,9,12,54,50,4,54
Alloa,7675,4,15,8,13,68,47,21,53
Queen's Park,7675,5,15,6,15,47,57,-10,51
Brechin,7675,6,14,8,14,40,45,-5,50
Peterhead,7675,7,13,10,13,41,44,-3,49
East Fife,7675,8,13,7,16,49,47,2,46
Stranraer,7675,9,12,6,18,49,62,-13,42
Stenhousem'r,7675,10,9,8,19,48,79,-31,35
Alloa,7676,1,17,8,11,78,43,35,59
Livingston,7676,2,19,2,15,70,66,4,59
Brechin,7676,3,17,5,14,47,45,2,56
Albion,7676,4,16,7,13,59,50,9,55
Airdrieon,7676,5,16,7,13,51,52,-1,55
East Fife,7676,6,15,9,12,46,40,6,54
Queen's Park,7676,7,16,6,14,42,47,-5,54
Peterhead,7676,8,12,9,15,48,52,-4,45
Stranraer,7676,9,10,6,20,43,64,-21,36
Stenhousem'r,7676,10,7,11,18,51,76,-25,32
Alloa,7677,1,20,5,11,86,52,34,65
Livingston,7677,2,19,3,14,77,51,26,60
Airdrieon,7677,3,17,8,11,61,49,12,59
Brechin,7677,4,18,4,14,55,48,7,58
East Fife,7677,5,15,10,11,56,47,9,55
Albion,7677,6,15,8,13,51,46,5,53
Peterhead,7677,7,14,9,13,57,53,4,51
Stranraer,7677,8,11,4,21,45,72,-27,37
Queen's Park,7677,9,9,10,17,40,69,-29,37
Stenhousem'r,7677,10,7,9,20,46,87,-41,30
Alloa,7678,1,20,6,10,74,40,34,66
Livingston,7678,2,20,3,13,68,53,15,63
Airdrieon,7678,3,14,12,10,61,57,4,54
Peterhead,7678,4,16,5,15,52,52,0,53
Albion,7678,5,16,4,16,63,57,6,52
Brechin,7678,6,16,4,16,47,51,-4,52
East Fife,7678,7,12,10,14,48,45,3,46
Stranraer,7678,8,12,10,14,53,59,-6,46
Queen's Park,7678,9,11,5,20,33,57,-24,38
Stenhousem'r,7678,10,9,9,18,50,78,-28,36
Livingston,7679,1,20,7,9,69,42,27,67
Alloa,7679,2,19,8,9,62,38,24,65
Airdrieon,7679,3,20,4,12,62,49,13,64
Brechin,7679,4,17,5,14,54,51,3,56
Stranraer,7679,5,17,2,17,59,57,2,53
Queen's Park,7679,6,12,11,13,38,54,-16,47
East Fife,7679,7,10,11,15,49,48,1,41
Albion,7679,8,11,8,17,48,57,-9,41
Peterhead,7679,9,9,9,18,41,57,-16,36
Stenhousem'r,7679,10,9,7,20,44,73,-29,34
Livingston,7680,1,20,7,9,77,46,31,67
Alloa,7680,2,17,7,12,61,47,14,58
Albion,7680,3,16,7,13,53,45,8,55
Airdrieon,7680,4,15,9,12,57,56,1,54
Brechin,7680,5,16,5,15,49,50,-1,53
Peterhead,7680,6,15,8,13,53,57,-4,53
Queen's Park,7680,7,14,7,15,39,46,-7,49
East Fife,7680,8,11,10,15,55,53,2,43
Stenhousem'r,7680,9,9,10,17,46,70,-24,37
Stranraer,7680,10,8,8,20,49,69,-20,32
Livingston,7681,1,20,6,10,80,53,27,66
Brechin,7681,2,21,3,12,54,46,8,66
Alloa,7681,3,19,8,9,73,41,32,65
Airdrieon,7681,4,18,6,12,62,54,8,60
Albion,7681,5,14,9,13,54,54,0,51
East Fife,7681,6,14,7,15,52,51,1,49
Stranraer,7681,7,13,6,17,53,54,-1,45
Peterhead,7681,8,11,9,16,44,56,-12,42
Queen's Park,7681,9,10,7,19,35,55,-20,37
Stenhousem'r,7681,10,6,7,23,36,79,-43,25
Livingston,7682,1,28,3,5,89,38,51,87
Alloa,7682,2,20,7,9,65,39,26,67
Brechin,7682,3,19,5,12,59,50,9,62
Airdrieon,7682,4,15,7,14,49,53,-4,52
Queen's Park,7682,5,14,8,14,47,49,-2,50
East Fife,7682,6,13,10,13,49,46,3,49
Stranraer,7682,7,11,7,18,42,57,-15,40
Albion,7682,8,9,10,17,43,55,-12,37
Peterhead,7682,9,10,5,21,43,61,-18,35
Stenhousem'r,7682,10,5,10,21,34,72,-38,25
Alloa,7683,1,22,6,8,71,37,34,72
Livingston,7683,2,21,4,11,74,52,22,67
Airdrieon,7683,3,19,5,12,66,57,9,62
Peterhead,7683,4,17,8,11,62,49,13,59
Albion,7683,5,16,6,14,60,58,2,54
Stranraer,7683,6,15,3,18,54,60,-6,48
East Fife,7683,7,11,12,13,58,52,6,45
Queen's Park,7683,8,11,8,17,39,59,-20,41
Brechin,7683,9,11,7,18,42,52,-10,40
Stenhousem'r,7683,10,5,5,26,40,90,-50,20
Livingston,7684,1,18,9,9,77,52,25,63
Alloa,7684,2,17,11,8,54,41,13,62
Brechin,7684,3,15,9,12,49,42,7,54
Albion,7684,4,14,10,12,58,52,6,52
Queen's Park,7684,5,15,7,14,37,43,-6,52
Stranraer,7684,6,15,5,16,53,51,2,50
Airdrieon,7684,7,13,11,12,47,46,1,50
East Fife,7684,8,11,10,15,46,46,0,43
Peterhead,7684,9,9,11,16,44,59,-15,38
Stenhousem'r,7684,10,6,11,19,49,82,-33,29
Brechin,7685,1,20,5,11,54,42,12,65
Livingston,7685,2,19,7,10,77,48,29,64
Alloa,7685,3,18,8,10,67,47,20,62
Airdrieon,7685,4,18,8,10,62,56,6,62
East Fife,7685,5,16,10,10,62,47,15,58
Peterhead,7685,6,14,7,15,50,48,2,49
Stranraer,7685,7,11,7,18,42,53,-11,40
Albion,7685,8,10,10,16,39,54,-15,40
Queen's Park,7685,9,9,8,19,35,58,-23,35
Stenhousem'r,7685,10,5,10,21,43,78,-35,25
Livingston,7686,1,24,3,9,87,52,35,75
Alloa,7686,2,20,7,9,76,45,31,67
Brechin,7686,3,16,8,12,53,51,2,56
Airdrieon,7686,4,16,4,16,56,55,1,52
Peterhead,7686,5,15,7,14,46,45,1,52
East Fife,7686,6,14,6,16,47,46,1,48
Albion,7686,7,13,7,16,47,54,-7,46
Queen's Park,7686,8,12,7,17,48,57,-9,43
Stranraer,7686,9,13,4,19,57,75,-18,43
Stenhousem'r,7686,10,7,7,22,51,88,-37,28
Livingston,7687,1,20,6,10,80,47,33,66
Alloa,7687,2,19,7,10,63,51,12,64
Brechin,7687,3,17,7,12,54,47,7,58
Airdrieon,7687,4,16,10,10,58,54,4,58
Peterhead,7687,5,16,7,13,63,53,10,55
Stranraer,7687,6,13,7,16,50,54,-4,46
Albion,7687,7,11,10,15,48,55,-7,43
Queen's Park,7687,8,13,4,19,40,57,-17,43
East Fife,7687,9,10,8,18,54,54,0,38
Stenhousem'r,7687,10,9,6,21,45,83,-38,33
Airdrieon,7688,1,22,6,8,73,47,26,72
Brechin,7688,2,19,6,11,59,47,12,63
Livingston,7688,3,19,5,12,73,50,23,62
Alloa,7688,4,13,15,8,56,44,12,54
East Fife,7688,5,14,10,12,58,43,15,52
Albion,7688,6,13,9,14,55,64,-9,48
Peterhead,7688,7,11,9,16,47,55,-8,42
Queen's Park,7688,8,10,11,15,37,51,-14,41
Stranraer,7688,9,10,6,20,42,59,-17,36
Stenhousem'r,7688,10,7,7,22,37,77,-40,28
Livingston,7689,1,22,3,11,75,47,28,69
Alloa,7689,2,20,7,9,64,41,23,67
Airdrieon,7689,3,19,8,9,61,48,13,65
Queen's Park,7689,4,16,6,14,43,50,-7,54
Peterhead,7689,5,15,7,14,56,51,5,52
Brechin,7689,6,16,4,16,50,51,-1,52
Stranraer,7689,7,14,6,16,57,58,-1,48
East Fife,7689,8,12,6,18,46,56,-10,42
Albion,7689,9,11,7,18,49,54,-5,40
Stenhousem'r,7689,10,6,4,26,42,87,-45,22
Alloa,7690,1,22,8,6,79,41,38,74
Livingston,7690,2,20,5,11,75,53,22,65
Airdrieon,7690,3,20,5,11,72,56,16,65
Brechin,7690,4,18,5,13,58,55,3,59
Peterhead,7690,5,13,6,17,50,56,-6,45
Stranraer,7690,6,13,6,17,53,62,-9,45
Albion,7690,7,12,8,16,48,53,-5,44
East Fife,7690,8,11,8,17,48,48,0,41
Queen's Park,7690,9,11,7,18,45,67,-22,40
Stenhousem'r,7690,10,6,10,20,44,81,-37,28
Alloa,7691,1,16,10,10,66,44,22,58
Brechin,7691,2,16,8,12,45,46,-1,56
Livingston,7691,3,16,7,13,71,53,18,55
Queen's Park,7691,4,16,6,14,40,47,-7,54
Airdrieon,7691,5,15,7,14,54,53,1,52
Albion,7691,6,13,12,11,58,51,7,51
East Fife,7691,7,12,12,12,51,46,5,48
Peterhead,7691,8,11,11,14,40,47,-7,44
Stranraer,7691,9,9,11,16,49,63,-14,38
Stenhousem'r,7691,10,10,8,18,52,76,-24,38
Livingston,7692,1,24,6,6,83,45,38,78
Peterhead,7692,2,20,7,9,63,47,16,67
Airdrieon,7692,3,16,11,9,65,48,17,59
Brechin,7692,4,16,9,11,53,46,7,57
Queen's Park,7692,5,13,7,16,34,44,-10,46
Alloa,7692,6,11,12,13,55,59,-4,45
Albion,7692,7,11,11,14,56,56,0,44
Stranraer,7692,8,11,7,18,46,61,-15,40
Stenhousem'r,7692,9,9,7,20,51,88,-37,34
East Fife,7692,10,6,9,21,47,59,-12,27
Livingston,7693,1,25,3,8,90,45,45,78
Alloa,7693,2,22,6,8,74,42,32,72
Brechin,7693,3,18,6,12,56,48,8,60
Airdrieon,7693,4,17,8,11,62,59,3,59
Peterhead,7693,5,12,12,12,54,51,3,48
Queen's Park,7693,6,12,8,16,38,56,-18,44
Albion,7693,7,9,10,17,48,57,-9,37
East Fife,7693,8,9,10,17,41,50,-9,37
Stranraer,7693,9,10,6,20,48,62,-14,36
Stenhousem'r,7693,10,7,9,20,40,81,-41,30
Livingston,7694,1,22,6,8,76,42,34,72
Alloa,7694,2,17,12,7,62,35,27,63
Brechin,7694,3,19,4,13,45,47,-2,61
Airdrieon,7694,4,16,8,12,61,55,6,56
Albion,7694,5,13,9,14,53,51,2,48
Queen's Park,7694,6,13,7,16,47,51,-4,46
East Fife,7694,7,10,10,16,43,49,-6,40
Stranraer,7694,8,11,6,19,46,57,-11,39
Stenhousem'r,7694,9,10,8,18,48,77,-29,38
Peterhead,7694,10,9,10,17,44,61,-17,37
Alloa,7695,1,23,7,6,81,39,42,76
Livingston,7695,2,21,6,9,74,47,27,69
Airdrieon,7695,3,17,8,11,53,40,13,59
Brechin,7695,4,16,7,13,50,51,-1,55
East Fife,7695,5,13,11,12,58,47,11,50
Albion,7695,6,13,11,12,52,48,4,50
Queen's Park,7695,7,14,6,16,43,55,-12,48
Stranraer,7695,8,10,5,21,48,69,-21,35
Stenhousem'r,7695,9,8,8,20,49,81,-32,32
Peterhead,7695,10,8,5,23,40,71,-31,29
Alloa,7696,1,18,10,8,67,39,28,64
Brechin,7696,2,19,6,11,60,47,13,63
Livingston,7696,3,20,1,15,68,58,10,61
Airdrieon,7696,4,17,4,15,56,61,-5,55
Albion,7696,5,15,7,14,57,50,7,52
Stranraer,7696,6,13,7,16,53,62,-9,46
Peterhead,7696,7,12,7,17,45,54,-9,43
Queen's Park,7696,8,11,9,16,43,52,-9,42
Stenhousem'r,7696,9,11,8,17,47,69,-22,41
East Fife,7696,10,11,7,18,52,56,-4,40
Livingston,7697,1,18,10,8,82,61,21,64
Alloa,7697,2,17,9,10,68,45,23,60
Albion,7697,3,14,10,12,61,58,3,52
Airdrieon,7697,4,16,4,16,57,65,-8,52
Brechin,7697,5,14,6,16,40,44,-4,48
Queen's Park,7697,6,14,6,16,38,51,-13,48
Stranraer,7697,7,13,8,15,54,59,-5,47
Peterhead,7697,8,12,10,14,50,53,-3,46
East Fife,7697,9,11,10,15,54,46,8,43
Stenhousem'r,7697,10,9,11,16,52,74,-22,38
Alloa,7698,1,20,6,10,76,46,30,66
Livingston,7698,2,20,6,10,69,45,24,66
Brechin,7698,3,15,11,10,50,45,5,56
Peterhead,7698,4,13,13,10,47,43,4,52
Airdrieon,7698,5,13,9,14,55,55,0,48
East Fife,7698,6,11,11,14,45,47,-2,44
Stranraer,7698,7,11,10,15,64,66,-2,43
Albion,7698,8,11,10,15,54,58,-4,43
Queen's Park,7698,9,10,9,17,31,50,-19,39
Stenhousem'r,7698,10,8,11,17,41,77,-36,35
Livingston,7699,1,21,5,10,81,44,37,68
Airdrieon,7699,2,21,5,10,64,50,14,68
Brechin,7699,3,19,5,12,56,46,10,62
Alloa,7699,4,18,5,13,66,51,15,59
Albion,7699,5,15,10,11,52,41,11,55
Stranraer,7699,6,15,7,14,51,48,3,52
Peterhead,7699,7,12,7,17,49,56,-7,43
Queen's Park,7699,8,10,5,21,32,57,-25,35
East Fife,7699,9,9,7,20,37,54,-17,34
Stenhousem'r,7699,10,9,6,21,37,78,-41,33
Livingston,7700,1,22,6,8,77,43,34,72
Alloa,7700,2,22,5,9,74,39,35,71
Peterhead,7700,3,16,8,12,51,45,6,56
Albion,7700,4,16,8,12,61,56,5,56
Airdrieon,7700,5,15,6,15,55,52,3,51
Brechin,7700,6,14,5,17,56,65,-9,47
Stranraer,7700,7,13,4,19,47,59,-12,43
Queen's Park,7700,8,10,8,18,35,56,-21,38
Stenhousem'r,7700,9,10,7,19,55,84,-29,37
East Fife,7700,10,8,11,17,38,50,-12,35
Alloa,7701,1,21,7,8,67,37,30,70
Livingston,7701,2,20,6,10,72,46,26,66
Airdrieon,7701,3,18,7,11,56,48,8,61
Brechin,7701,4,18,5,13,57,48,9,59
Queen's Park,7701,5,16,6,14,46,49,-3,54
Albion,7701,6,13,11,12,52,50,2,50
Peterhead,7701,7,10,8,18,48,62,-14,38
Stranraer,7701,8,9,9,18,50,66,-16,36
Stenhousem'r,7701,9,9,7,20,46,78,-32,34
East Fife,7701,10,6,14,16,48,58,-10,32
Brechin,7702,1,22,5,9,60,44,16,71
Livingston,7702,2,21,2,13,72,54,18,65
Alloa,7702,3,18,6,12,71,47,24,60
Airdrieon,7702,4,18,5,13,62,62,0,59
Queen's Park,7702,5,17,5,14,52,49,3,56
Albion,7702,6,15,6,15,53,51,2,51
Stranraer,7702,7,15,4,17,57,56,1,49
East Fife,7702,8,12,10,14,48,47,1,46
Peterhead,7702,9,11,6,19,50,60,-10,39
Stenhousem'r,7702,10,3,7,26,37,92,-55,16
Alloa,7703,1,19,8,9,71,42,29,65
Brechin,7703,2,19,7,10,59,47,12,64
Livingston,7703,3,19,5,12,67,48,19,62
Airdrieon,7703,4,17,7,12,56,51,5,58
Albion,7703,5,15,5,16,63,55,8,50
East Fife,7703,6,13,9,14,64,49,15,48
Stranraer,7703,7,14,6,16,58,61,-3,48
Queen's Park,7703,8,12,7,17,36,54,-18,43
Peterhead,7703,9,12,5,19,41,70,-29,41
Stenhousem'r,7703,10,6,9,21,44,82,-38,27
Alloa,7704,1,21,6,9,71,39,32,69
Livingston,7704,2,21,5,10,78,48,30,68
Brechin,7704,3,18,5,13,52,53,-1,59
Airdrieon,7704,4,15,10,11,58,53,5,55
Albion,7704,5,15,6,15,54,51,3,51
Stranraer,7704,6,14,9,13,51,51,0,51
Peterhead,7704,7,13,10,13,50,55,-5,49
East Fife,7704,8,9,11,16,41,45,-4,38
Queen's Park,7704,9,10,7,19,35,57,-22,37
Stenhousem'r,7704,10,6,7,23,43,81,-38,25
Airdrieon,7705,1,18,8,10,68,49,19,62
Stranraer,7705,2,19,2,15,58,54,4,59
Alloa,7705,3,16,10,10,51,32,19,58
Livingston,7705,4,18,4,14,65,52,13,58
Peterhead,7705,5,17,7,12,49,41,8,58
Albion,7705,6,16,6,14,57,53,4,54
Brechin,7705,7,16,6,14,51,51,0,54
Queen's Park,7705,8,11,7,18,36,53,-17,40
Stenhousem'r,7705,9,9,7,20,55,83,-28,34
East Fife,7705,10,8,7,21,40,62,-22,31
Livingston,7706,1,22,5,9,74,44,30,71
Alloa,7706,2,21,7,8,78,42,36,70
Airdrieon,7706,3,18,10,8,64,44,20,64
Brechin,7706,4,17,5,14,52,47,5,56
Stranraer,7706,5,15,5,16,50,54,-4,50
Queen's Park,7706,6,13,8,15,36,46,-10,47
Peterhead,7706,7,13,5,18,48,55,-7,44
Albion,7706,8,12,6,18,44,59,-15,42
East Fife,7706,9,11,7,18,44,55,-11,40
Stenhousem'r,7706,10,5,8,23,43,87,-44,23
Alloa,7707,1,21,10,5,85,47,38,73
Livingston,7707,2,22,3,11,77,47,30,69
Airdrieon,7707,3,21,5,10,65,48,17,68
Brechin,7707,4,15,10,11,47,42,5,55
Stranraer,7707,5,15,3,18,50,57,-7,48
Stenhousem'r,7707,6,12,8,16,49,73,-24,44
East Fife,7707,7,11,10,15,51,50,1,43
Queen's Park,7707,8,12,5,19,37,53,-16,41
Albion,7707,9,7,11,18,35,59,-24,32
Peterhead,7707,10,6,11,19,36,56,-20,29
Airdrieon,7708,1,21,3,12,59,46,13,66
Livingston,7708,2,19,4,13,69,53,16,61
Brechin,7708,3,19,4,13,53,44,9,61
Stranraer,7708,4,16,6,14,65,55,10,54
Alloa,7708,5,15,7,14,62,50,12,52
Albion,7708,6,14,9,13,57,52,5,51
Peterhead,7708,7,13,7,16,54,52,2,46
Queen's Park,7708,8,12,8,16,38,53,-15,44
East Fife,7708,9,12,7,17,46,59,-13,43
Stenhousem'r,7708,10,9,5,22,45,84,-39,32
Livingston,7709,1,21,7,8,73,43,30,70
Alloa,7709,2,19,7,10,70,50,20,64
Airdrieon,7709,3,18,8,10,60,46,14,62
Stranraer,7709,4,16,6,14,56,51,5,54
East Fife,7709,5,14,9,13,56,46,10,51
Brechin,7709,6,12,10,14,41,60,-19,46
Queen's Park,7709,7,12,7,17,42,60,-18,43
Albion,7709,8,11,8,17,57,63,-6,41
Peterhead,7709,9,11,8,17,44,55,-11,41
Stenhousem'r,7709,10,8,6,22,46,71,-25,30
Alloa,7710,1,19,7,10,74,44,30,64
Livingston,7710,2,19,6,11,72,46,26,63
Airdrieon,7710,3,16,8,12,58,55,3,56
Brechin,7710,4,17,4,15,60,58,2,55
Peterhead,7710,5,16,7,13,55,54,1,55
Stranraer,7710,6,13,8,15,53,55,-2,47
East Fife,7710,7,11,9,16,49,54,-5,42
Albion,7710,8,10,11,15,49,60,-11,41
Queen's Park,7710,9,11,8,17,43,58,-15,41
Stenhousem'r,7710,10,10,8,18,48,77,-29,38
Livingston,7711,1,22,5,9,83,51,32,71
Alloa,7711,2,19,7,10,68,44,24,64
Airdrieon,7711,3,18,8,10,67,55,12,62
Brechin,7711,4,18,6,12,49,38,11,60
Albion,7711,5,15,9,12,54,50,4,54
Stranraer,7711,6,14,6,16,56,58,-2,48
Queen's Park,7711,7,13,6,17,47,54,-7,45
Peterhead,7711,8,11,4,21,46,63,-17,37
East Fife,7711,9,8,9,19,41,56,-15,33
Stenhousem'r,7711,10,9,6,21,42,84,-42,33
Alloa,7712,1,22,6,8,78,41,37,72
Livingston,7712,2,21,4,11,79,50,29,67
East Fife,7712,3,16,6,14,52,49,3,54
Albion,7712,4,16,4,16,60,52,8,52
Airdrieon,7712,5,14,9,13,55,53,2,51
Queen's Park,7712,6,14,7,15,41,48,-7,49
Stranraer,7712,7,14,4,18,49,57,-8,46
Peterhead,7712,8,12,8,16,48,55,-7,44
Brechin,7712,9,13,5,18,39,58,-19,44
Stenhousem'r,7712,10,7,9,20,49,87,-38,30
Livingston,7713,1,24,3,9,95,43,52,75
Alloa,7713,2,17,13,6,73,48,25,64
Airdrieon,7713,3,17,8,11,74,63,11,59
Peterhead,7713,4,15,7,14,56,55,1,52
Brechin,7713,5,14,8,14,40,45,-5,50
Albion,7713,6,9,14,13,55,60,-5,41
Stenhousem'r,7713,7,12,5,19,52,81,-29,41
Stranraer,7713,8,12,4,20,43,67,-24,40
East Fife,7713,9,9,12,15,49,51,-2,39
Queen's Park,7713,10,9,10,17,39,63,-24,37
Livingston,7714,1,23,5,8,85,48,37,74
Alloa,7714,2,22,8,6,73,40,33,74
Brechin,7714,3,14,7,15,40,43,-3,49
Queen's Park,7714,4,13,10,13,45,49,-4,49
Peterhead,7714,5,14,7,15,47,58,-11,49
Airdrieon,7714,6,13,9,14,58,64,-6,48
Albion,7714,7,13,7,16,51,50,1,46
Stranraer,7714,8,13,5,18,57,60,-3,44
East Fife,7714,9,9,9,18,35,48,-13,36
Stenhousem'r,7714,10,10,5,21,42,73,-31,35
Livingston,7715,1,22,5,9,79,43,36,71
Alloa,7715,2,20,8,8,76,50,26,68
East Fife,7715,3,15,9,12,53,44,9,54
Brechin,7715,4,15,8,13,49,50,-1,53
Queen's Park,7715,5,13,11,12,43,45,-2,50
Albion,7715,6,13,9,14,55,57,-2,48
Peterhead,7715,7,14,6,16,50,62,-12,48
Airdrieon,7715,8,13,6,17,55,65,-10,45
Stranraer,7715,9,10,7,19,54,65,-11,37
Stenhousem'r,7715,10,5,11,20,47,80,-33,26
Livingston,7716,1,22,2,12,75,43,32,68
Alloa,7716,2,19,8,9,62,40,22,65
Airdrieon,7716,3,18,7,11,60,52,8,61
Brechin,7716,4,18,4,14,57,52,5,58
Peterhead,7716,5,15,5,16,47,55,-8,50
Queen's Park,7716,6,13,10,13,41,51,-10,49
Albion,7716,7,13,9,14,53,54,-1,48
East Fife,7716,8,9,11,16,45,50,-5,38
Stenhousem'r,7716,9,8,10,18,49,75,-26,34
Stranraer,7716,10,8,8,20,47,64,-17,32
Livingston,7717,1,21,3,12,75,54,21,66
Stranraer,7717,2,19,5,12,60,47,13,62
Alloa,7717,3,19,4,13,77,47,30,61
Peterhead,7717,4,18,7,11,59,46,13,61
Albion,7717,5,15,8,13,53,50,3,53
Brechin,7717,6,13,10,13,47,51,-4,49
Airdrieon,7717,7,14,6,16,58,60,-2,48
Queen's Park,7717,8,14,6,16,43,53,-10,48
East Fife,7717,9,9,8,19,45,58,-13,35
Stenhousem'r,7717,10,7,5,24,35,86,-51,26
Livingston,7718,1,22,3,11,80,52,28,69
Alloa,7718,2,19,10,7,74,38,36,67
Brechin,7718,3,19,4,13,51,42,9,61
Queen's Park,7718,4,13,10,13,35,45,-10,49
Airdrieon,7718,5,14,5,17,59,69,-10,47
Peterhead,7718,6,12,10,14,44,51,-7,46
Stranraer,7718,7,13,7,16,53,64,-11,46
East Fife,7718,8,11,12,13,49,45,4,45
Albion,7718,9,11,10,15,49,53,-4,43
Stenhousem'r,7718,10,5,11,20,34,69,-35,26
Alloa,7719,1,21,8,7,68,37,31,71
Livingston,7719,2,18,6,12,66,47,19,60
Airdrieon,7719,3,16,7,13,52,57,-5,55
Brechin,7719,4,15,7,14,46,51,-5,52
Peterhead,7719,5,15,6,15,53,54,-1,51
Albion,7719,6,14,8,14,63,57,6,50
Stranraer,7719,7,13,6,17,49,51,-2,45
East Fife,7719,8,11,9,16,41,46,-5,42
Queen's Park,7719,9,12,6,18,38,51,-13,42
Stenhousem'r,7719,10,9,9,18,47,72,-25,36
Airdrieon,7720,1,20,6,10,67,47,20,66
Brechin,7720,2,19,5,12,48,36,12,62
Livingston,7720,3,19,3,14,71,53,18,60
Alloa,7720,4,17,8,11,65,44,21,59
Peterhead,7720,5,17,7,12,55,50,5,58
Albion,7720,6,15,8,13,54,43,11,53
East Fife,7720,7,13,10,13,43,40,3,49
Queen's Park,7720,8,11,8,17,35,53,-18,41
Stranraer,7720,9,10,5,21,38,67,-29,35
Stenhousem'r,7720,10,5,8,23,45,88,-43,23
Livingston,7721,1,20,8,8,70,42,28,68
Brechin,7721,2,18,7,11,55,46,9,61
Alloa,7721,3,17,9,10,73,52,21,60
Airdrieon,7721,4,16,6,14,57,57,0,54
Albion,7721,5,15,7,14,58,52,6,52
Peterhead,7721,6,13,11,12,57,57,0,50
Queen's Park,7721,7,13,5,18,47,62,-15,44
Stranraer,7721,8,11,9,16,57,68,-11,42
East Fife,7721,9,9,11,16,48,56,-8,38
Stenhousem'r,7721,10,6,11,19,60,90,-30,29
Alloa,7722,1,20,8,8,71,45,26,68
Brechin,7722,2,21,5,10,65,47,18,68
Airdrieon,7722,3,21,5,10,60,47,13,68
Livingston,7722,4,20,3,13,65,50,15,63
Albion,7722,5,12,9,15,54,50,4,45
Peterhead,7722,6,11,12,13,36,47,-11,45
Stranraer,7722,7,13,5,18,48,55,-7,44
East Fife,7722,8,9,12,15,47,53,-6,39
Queen's Park,7722,9,11,5,20,35,53,-18,38
Stenhousem'r,7722,10,7,6,23,47,81,-34,27
Livingston,7723,1,23,4,9,77,44,33,73
Alloa,7723,2,19,5,12,77,49,28,62
Airdrieon,7723,3,19,4,13,61,51,10,61
Brechin,7723,4,18,5,13,52,48,4,59
Peterhead,7723,5,12,12,12,50,53,-3,48
Albion,7723,6,11,12,13,50,51,-1,45
East Fife,7723,7,11,10,15,46,50,-4,43
Queen's Park,7723,8,12,6,18,39,50,-11,42
Stranraer,7723,9,11,6,19,43,64,-21,39
Stenhousem'r,7723,10,9,6,21,50,85,-35,33
Brechin,7724,1,20,5,11,55,41,14,65
Livingston,7724,2,19,6,11,80,52,28,63
Alloa,7724,3,17,9,10,77,50,27,60
Airdrieon,7724,4,16,7,13,56,63,-7,55
Albion,7724,5,14,11,11,52,46,6,53
Stranraer,7724,6,15,6,15,55,56,-1,51
Peterhead,7724,7,15,5,16,59,61,-2,50
Queen's Park,7724,8,11,9,16,37,53,-16,42
East Fife,7724,9,10,8,18,47,55,-8,38
Stenhousem'r,7724,10,7,6,23,45,86,-41,27
Livingston,7725,1,21,4,11,67,47,20,67
Brechin,7725,2,19,7,10,54,42,12,64
Airdrieon,7725,3,17,10,9,51,42,9,61
Albion,7725,4,16,10,10,53,43,10,58
Alloa,7725,5,16,9,11,72,49,23,57
Peterhead,7725,6,12,13,11,51,51,0,49
Queen's Park,7725,7,11,8,17,27,45,-18,41
Stranraer,7725,8,10,8,18,41,55,-14,38
East Fife,7725,9,8,8,20,36,55,-19,32
Stenhousem'r,7725,10,7,9,20,43,66,-23,30
Brechin,7726,1,21,4,11,52,32,20,67
Alloa,7726,2,20,5,11,77,44,33,65
Livingston,7726,3,20,1,15,71,54,17,61
Albion,7726,4,17,8,11,66,54,12,59
Airdrieon,7726,5,18,5,13,63,54,9,59
Peterhead,7726,6,17,7,12,47,44,3,58
East Fife,7726,7,15,6,15,54,54,0,51
Stenhousem'r,7726,8,10,4,22,47,82,-35,34
Stranraer,7726,9,9,5,22,45,67,-22,32
Queen's Park,7726,10,6,9,21,28,65,-37,27
Alloa,7727,1,18,9,9,65,41,24,63
Brechin,7727,2,16,8,12,46,37,9,56
Queen's Park,7727,3,15,11,10,49,45,4,56
Airdrieon,7727,4,16,8,12,55,56,-1,56
Livingston,7727,5,16,5,15,60,47,13,53
East Fife,7727,6,12,12,12,56,47,9,48
Peterhead,7727,7,12,10,14,44,52,-8,46
Albion,7727,8,12,9,15,54,59,-5,45
Stenhousem'r,7727,9,12,5,19,49,76,-27,41
Stranraer,7727,10,9,7,20,45,63,-18,34
Alloa,7728,1,23,7,6,73,40,33,76
Brechin,7728,2,20,4,12,58,48,10,64
Livingston,7728,3,19,6,11,71,48,23,63
Airdrieon,7728,4,17,8,11,60,51,9,59
Peterhead,7728,5,15,8,13,52,52,0,53
Albion,7728,6,14,6,16,51,54,-3,48
Stranraer,7728,7,12,5,19,43,51,-8,41
East Fife,7728,8,9,8,19,49,59,-10,35
Queen's Park,7728,9,7,12,17,33,56,-23,33
Stenhousem'r,7728,10,8,8,20,41,72,-31,32
Alloa,7729,1,23,3,10,70,47,23,72
Livingston,7729,2,20,6,10,84,55,29,66
Airdrieon,7729,3,16,6,14,59,53,6,54
Albion,7729,4,14,10,12,50,53,-3,52
Brechin,7729,5,15,6,15,52,55,-3,51
Queen's Park,7729,6,14,8,14,48,54,-6,50
Stranraer,7729,7,13,9,14,51,48,3,48
East Fife,7729,8,10,9,17,44,49,-5,39
Peterhead,7729,9,10,9,17,45,55,-10,39
Stenhousem'r,7729,10,8,8,20,54,88,-34,32
Livingston,7730,1,19,5,12,69,53,16,62
Albion,7730,2,18,7,11,54,44,10,61
Alloa,7730,3,17,8,11,65,47,18,59
Peterhead,7730,4,16,6,14,48,47,1,54
Airdrieon,7730,5,14,8,14,56,48,8,50
Brechin,7730,6,14,7,15,42,48,-6,49
Queen's Park,7730,7,13,8,15,44,48,-4,47
Stenhousem'r,7730,8,12,6,18,44,70,-26,42
East Fife,7730,9,11,8,17,44,48,-4,41
Stranraer,7730,10,9,11,16,42,55,-13,38
Brechin,7731,1,22,4,10,59,32,27,70
Alloa,7731,2,18,8,10,74,52,22,62
Livingston,7731,3,17,6,13,70,53,17,57
Queen's Park,7731,4,16,6,14,38,49,-11,54
Albion,7731,5,14,11,11,51,48,3,53
Peterhead,7731,6,13,9,14,50,49,1,48
Stranraer,7731,7,13,5,18,47,54,-7,44
Airdrieon,7731,8,12,8,16,48,59,-11,44
East Fife,7731,9,9,8,19,42,55,-13,35
Stenhousem'r,7731,10,8,11,17,45,73,-28,35
Livingston,7732,1,20,4,12,78,47,31,64
Brechin,7732,2,19,3,14,57,56,1,60
Albion,7732,3,16,9,11,53,47,6,57
East Fife,7732,4,15,10,11,53,43,10,55
Alloa,7732,5,16,6,14,64,50,14,54
Peterhead,7732,6,16,4,16,48,50,-2,52
Airdrieon,7732,7,15,5,16,54,55,-1,50
Stranraer,7732,8,12,6,18,50,65,-15,42
Queen's Park,7732,9,11,9,16,38,55,-17,42
Stenhousem'r,7732,10,8,8,20,41,68,-27,32
Alloa,7733,1,18,12,6,77,43,34,66
Brechin,7733,2,19,7,10,58,40,18,64
Livingston,7733,3,18,5,13,72,50,22,59
Airdrieon,7733,4,17,7,12,57,46,11,58
East Fife,7733,5,13,10,13,56,54,2,49
Peterhead,7733,6,13,9,14,49,53,-4,48
Albion,7733,7,13,8,15,45,52,-7,47
Queen's Park,7733,8,12,8,16,44,58,-14,44
Stranraer,7733,9,9,8,19,39,58,-19,35
Stenhousem'r,7733,10,6,10,20,44,87,-43,28
Alloa,7734,1,22,5,9,77,39,38,71
Livingston,7734,2,22,4,10,79,51,28,70
Brechin,7734,3,19,6,11,54,44,10,63
East Fife,7734,4,15,8,13,53,47,6,53
Airdrieon,7734,5,13,12,11,46,49,-3,51
Albion,7734,6,12,9,15,52,51,1,45
Peterhead,7734,7,11,7,18,47,66,-19,40
Queen's Park,7734,8,11,7,18,33,52,-19,40
Stranraer,7734,9,11,4,21,42,56,-14,37
Stenhousem'r,7734,10,9,8,19,46,74,-28,35
Livingston,7735,1,22,4,10,75,50,25,70
Alloa,7735,2,17,9,10,73,50,23,60
Brechin,7735,3,17,6,13,58,47,11,57
Airdrieon,7735,4,15,9,12,59,56,3,54
Stranraer,7735,5,14,10,12,57,57,0,52
East Fife,7735,6,13,11,12,60,52,8,50
Albion,7735,7,12,9,15,58,60,-2,45
Peterhead,7735,8,12,7,17,51,59,-8,43
Queen's Park,7735,9,11,10,15,37,53,-16,43
Stenhousem'r,7735,10,5,9,22,44,88,-44,24
Livingston,7736,1,24,4,8,71,38,33,76
Alloa,7736,2,19,7,10,67,37,30,64
Albion,7736,3,16,8,12,60,53,7,56
Airdrieon,7736,4,15,9,12,58,54,4,54
Brechin,7736,5,13,6,17,39,48,-9,45
Queen's Park,7736,6,12,8,16,33,48,-15,44
Stranraer,7736,7,12,7,17,44,53,-9,43
Peterhead,7736,8,12,7,17,39,53,-14,43
East Fife,7736,9,11,9,16,49,48,1,42
Stenhousem'r,7736,10,10,7,19,43,71,-28,37
Airdrieon,7737,1,19,7,10,65,53,12,64
Livingston,7737,2,18,7,11,66,48,18,61
Albion,7737,3,17,7,12,56,52,4,58
Alloa,7737,4,15,12,9,72,48,24,57
Queen's Park,7737,5,15,7,14,43,55,-12,52
Brechin,7737,6,15,6,15,50,56,-6,51
Stranraer,7737,7,13,5,18,52,57,-5,44
Peterhead,7737,8,11,10,15,48,49,-1,43
East Fife,7737,9,9,13,14,52,56,-4,40
Stenhousem'r,7737,10,6,10,20,44,74,-30,28
Alloa,7738,1,22,7,7,84,39,45,73
Brechin,7738,2,19,7,10,62,42,20,64
Livingston,7738,3,17,8,11,78,54,24,59
Airdrieon,7738,4,18,5,13,56,59,-3,59
Albion,7738,5,13,10,13,50,51,-1,49
East Fife,7738,6,12,9,15,47,49,-2,45
Peterhead,7738,7,13,5,18,46,62,-16,44
Queen's Park,7738,8,12,8,16,38,57,-19,44
Stranraer,7738,9,12,5,19,54,67,-13,41
Stenhousem'r,7738,10,4,12,20,41,76,-35,24
Alloa,7739,1,19,11,6,75,42,33,68
Livingston,7739,2,20,6,10,68,41,27,66
Brechin,7739,3,18,8,10,55,41,14,62
Airdrieon,7739,4,18,4,14,56,49,7,58
Peterhead,7739,5,14,9,13,51,49,2,51
Albion,7739,6,11,12,13,50,56,-6,45
East Fife,7739,7,12,8,16,50,56,-6,44
Queen's Park,7739,8,11,9,16,44,53,-9,42
Stranraer,7739,9,10,9,17,51,62,-11,39
Stenhousem'r,7739,10,4,10,22,44,95,-51,22
Alloa,7740,1,18,10,8,71,45,26,64
Airdrieon,7740,2,18,9,9,52,39,13,63
Livingston,7740,3,18,7,11,67,49,18,61
Brechin,7740,4,16,7,13,49,43,6,55
Queen's Park,7740,5,15,10,11,47,41,6,55
Albion,7740,6,12,10,14,49,45,4,46
Stranraer,7740,7,13,4,19,48,59,-11,43
Peterhead,7740,8,10,9,17,38,57,-19,39
Stenhousem'r,7740,9,11,6,19,50,86,-36,39
East Fife,7740,10,10,6,20,45,52,-7,36
Livingston,7741,1,22,5,9,72,47,25,71
Alloa,7741,2,18,11,7,72,46,26,65
Brechin,7741,3,19,7,10,49,38,11,64
Stranraer,7741,4,15,8,13,61,52,9,53
Albion,7741,5,15,4,17,56,61,-5,49
Peterhead,7741,6,11,12,13,50,55,-5,45
Queen's Park,7741,7,11,7,18,41,59,-18,40
East Fife,7741,8,9,10,17,47,51,-4,37
Airdrieon,7741,9,9,10,17,46,62,-16,37
Stenhousem'r,7741,10,8,12,16,52,75,-23,36
Alloa,7742,1,19,7,10,71,51,20,64
Livingston,7742,2,20,3,13,66,45,21,63
East Fife,7742,3,15,10,11,56,44,12,55
Albion,7742,4,14,11,11,55,47,8,53
Airdrieon,7742,5,15,5,16,52,56,-4,50
Peterhead,7742,6,14,5,17,50,51,-1,47
Stranraer,7742,7,14,5,17,58,64,-6,47
Queen's Park,7742,8,13,8,15,47,59,-12,47
Brechin,7742,9,11,11,14,45,58,-13,44
Stenhousem'r,7742,10,9,7,20,48,73,-25,34
Livingston,7743,1,21,6,9,72,44,28,69
Albion,7743,2,18,10,8,56,36,20,64
Alloa,7743,3,18,6,12,72,47,25,60
Brechin,7743,4,17,7,12,47,47,0,58
Airdrieon,7743,5,15,7,14,55,54,1,52
Peterhead,7743,6,15,5,16,48,54,-6,50
East Fife,7743,7,11,11,14,46,49,-3,44
Stranraer,7743,8,12,3,21,49,61,-12,39
Queen's Park,7743,9,10,9,17,29,52,-23,39
Stenhousem'r,7743,10,7,8,21,47,77,-30,29
Livingston,7744,1,19,6,11,77,51,26,63
Airdrieon,7744,2,18,9,9,60,47,13,63
Albion,7744,3,17,7,12,47,39,8,58
Alloa,7744,4,16,7,13,57,45,12,55
Brechin,7744,5,15,6,15,48,45,3,51
Peterhead,7744,6,14,8,14,55,52,3,50
Stranraer,7744,7,14,8,14,46,51,-5,50
Queen's Park,7744,8,15,4,17,41,51,-10,49
East Fife,7744,9,11,10,15,44,44,0,43
Stenhousem'r,7744,10,5,7,24,39,89,-50,22
Alloa,7745,1,21,6,9,75,45,30,69
Brechin,7745,2,19,5,12,51,39,12,62
Livingston,7745,3,17,9,10,77,54,23,60
Airdrieon,7745,4,15,7,14,49,48,1,52
Queen's Park,7745,5,14,6,16,34,44,-10,48
Peterhead,7745,6,13,7,16,53,67,-14,46
Albion,7745,7,12,9,15,51,53,-2,45
Stranraer,7745,8,11,10,15,50,53,-3,43
East Fife,7745,9,10,12,14,50,49,1,42
Stenhousem'r,7745,10,8,9,19,49,87,-38,33
Alloa,7746,1,18,8,10,73,44,29,62
Livingston,7746,2,19,4,13,83,53,30,61
Airdrieon,7746,3,17,9,10,61,52,9,60
Brechin,7746,4,14,11,11,46,44,2,53
Albion,7746,5,15,8,13,55,56,-1,53
Peterhead,7746,6,13,6,17,49,57,-8,45
East Fife,7746,7,12,8,16,51,51,0,44
Queen's Park,7746,8,10,12,14,38,51,-13,42
Stranraer,7746,9,11,8,17,41,60,-19,41
Stenhousem'r,7746,10,11,6,19,51,80,-29,39
Livingston,7747,1,20,5,11,79,51,28,65
Alloa,7747,2,19,8,9,76,48,28,65
East Fife,7747,3,19,4,13,67,45,22,61
Brechin,7747,4,18,5,13,51,45,6,59
Airdrieon,7747,5,17,7,12,65,57,8,58
Queen's Park,7747,6,13,9,14,38,45,-7,48
Peterhead,7747,7,11,9,16,49,68,-19,42
Albion,7747,8,11,7,18,48,64,-16,40
Stenhousem'r,7747,9,11,6,19,54,75,-21,39
Stranraer,7747,10,9,4,23,42,71,-29,31
Livingston,7748,1,22,3,11,79,46,33,69
Alloa,7748,2,21,5,10,75,39,36,68
East Fife,7748,3,19,7,10,59,43,16,64
Peterhead,7748,4,17,6,13,53,48,5,57
Stranraer,7748,5,17,3,16,60,58,2,54
Albion,7748,6,15,6,15,50,50,0,51
Airdrieon,7748,7,15,5,16,59,63,-4,50
Brechin,7748,8,14,6,16,47,50,-3,48
Queen's Park,7748,9,11,5,20,37,62,-25,38
Stenhousem'r,7748,10,3,6,27,38,98,-60,15
Livingston,7749,1,22,2,12,74,47,27,68
Alloa,7749,2,18,11,7,63,36,27,65
Airdrieon,7749,3,17,9,10,68,57,11,60
Brechin,7749,4,16,7,13,53,46,7,55
Peterhead,7749,5,13,7,16,52,62,-10,46
Stenhousem'r,7749,6,13,7,16,56,78,-22,46
Stranraer,7749,7,13,5,18,52,56,-4,44
East Fife,7749,8,10,10,16,45,52,-7,40
Queen's Park,7749,9,10,9,17,35,52,-17,39
Albion,7749,10,9,11,16,43,55,-12,38
Alloa,7750,1,22,5,9,77,43,34,71
Livingston,7750,2,22,3,11,84,46,38,69
Peterhead,7750,3,18,6,12,66,52,14,60
Brechin,7750,4,15,7,14,51,52,-1,52
Airdrieon,7750,5,15,6,15,56,58,-2,51
Queen's Park,7750,6,13,10,13,43,49,-6,49
East Fife,7750,7,12,10,14,49,49,0,46
Albion,7750,8,12,9,15,49,67,-18,45
Stranraer,7750,9,12,2,22,50,69,-19,38
Stenhousem'r,7750,10,5,10,21,42,82,-40,25
Livingston,7751,1,23,2,11,87,54,33,71
Alloa,7751,2,20,8,8,75,45,30,68
Airdrieon,7751,3,19,6,11,64,55,9,63
Brechin,7751,4,18,2,16,54,53,1,56
East Fife,7751,5,14,9,13,58,42,16,51
Peterhead,7751,6,14,7,15,54,67,-13,49
Queen's Park,7751,7,13,5,18,46,60,-14,44
Albion,7751,8,12,6,18,53,67,-14,42
Stranraer,7751,9,11,3,22,51,70,-19,36
Stenhousem'r,7751,10,9,6,21,47,76,-29,33
Livingston,7752,1,23,4,9,84,48,36,73
Brechin,7752,2,19,6,11,52,47,5,63
Alloa,7752,3,18,8,10,71,43,28,62
Airdrieon,7752,4,16,4,16,55,58,-3,52
Peterhead,7752,5,14,10,12,50,54,-4,52
Stranraer,7752,6,14,8,14,49,56,-7,50
Albion,7752,7,12,7,17,51,54,-3,43
Queen's Park,7752,8,12,4,20,40,62,-22,40
East Fife,7752,9,10,9,17,55,53,2,39
Stenhousem'r,7752,10,7,10,19,45,77,-32,31
East Fife,7753,1,17,10,9,58,43,15,61
Livingston,7753,2,18,6,12,76,56,20,60
Airdrieon,7753,3,17,8,11,66,53,13,59
Alloa,7753,4,16,10,10,81,48,33,58
Brechin,7753,5,17,2,17,59,68,-9,53
Stranraer,7753,6,15,6,15,59,55,4,51
Albion,7753,7,14,8,14,53,51,2,50
Queen's Park,7753,8,12,9,15,33,51,-18,45
Peterhead,7753,9,11,10,15,46,58,-12,43
Stenhousem'r,7753,10,4,9,23,38,86,-48,21
Livingston,7754,1,21,6,9,83,56,27,69
Alloa,7754,2,18,8,10,72,43,29,62
Airdrieon,7754,3,16,9,11,63,53,10,57
Brechin,7754,4,15,7,14,43,48,-5,52
Albion,7754,5,13,11,12,51,49,2,50
Peterhead,7754,6,13,10,13,53,52,1,49
Stranraer,7754,7,14,6,16,46,55,-9,48
East Fife,7754,8,12,9,15,49,45,4,45
Stenhousem'r,7754,9,9,7,20,42,75,-33,34
Queen's Park,7754,10,7,11,18,37,63,-26,32
Alloa,7755,1,19,7,10,70,44,26,64
Livingston,7755,2,18,9,9,79,55,24,63
Queen's Park,7755,3,16,8,12,51,52,-1,56
Brechin,7755,4,16,7,13,53,51,2,55
Peterhead,7755,5,15,9,12,53,51,2,54
Airdrieon,7755,6,14,7,15,53,62,-9,49
Stranraer,7755,7,11,11,14,51,54,-3,44
East Fife,7755,8,11,10,15,49,50,-1,43
Albion,7755,9,10,8,18,47,55,-8,38
Stenhousem'r,7755,10,7,10,19,41,73,-32,31
Livingston,7756,1,19,6,11,82,55,27,63
Alloa,7756,2,17,8,11,73,46,27,59
Brechin,7756,3,18,3,15,55,55,0,57
Airdrieon,7756,4,16,7,13,59,64,-5,55
Stranraer,7756,5,16,6,14,57,54,3,54
Peterhead,7756,6,14,10,12,46,49,-3,52
Albion,7756,7,14,7,15,62,57,5,49
East Fife,7756,8,12,8,16,40,44,-4,44
Queen's Park,7756,9,11,8,17,46,63,-17,41
Stenhousem'r,7756,10,7,9,20,50,83,-33,30
Livingston,7757,1,21,6,9,78,49,29,69
Airdrieon,7757,2,18,10,8,73,54,19,64
Alloa,7757,3,17,9,10,64,44,20,60
Brechin,7757,4,15,6,15,49,50,-1,51
Albion,7757,5,13,11,12,57,60,-3,50
Peterhead,7757,6,13,9,14,44,52,-8,48
Stenhousem'r,7757,7,12,8,16,63,80,-17,44
Stranraer,7757,8,10,9,17,51,56,-5,39
Queen's Park,7757,9,11,5,20,42,67,-25,38
East Fife,7757,10,10,7,19,50,59,-9,37
Livingston,7758,1,22,3,11,66,48,18,69
Alloa,7758,2,18,11,7,73,44,29,65
Albion,7758,3,19,5,12,52,42,10,62
Airdrieon,7758,4,18,7,11,63,54,9,61
Brechin,7758,5,16,5,15,46,42,4,53
Peterhead,7758,6,12,10,14,43,49,-6,46
East Fife,7758,7,12,9,15,51,50,1,45
Stenhousem'r,7758,8,10,8,18,51,73,-22,38
Queen's Park,7758,9,9,6,21,35,56,-21,33
Stranraer,7758,10,8,8,20,36,58,-22,32
Alloa,7759,1,20,8,8,71,45,26,68
Livingston,7759,2,19,6,11,74,53,21,63
Albion,7759,3,15,11,10,61,56,5,56
Airdrieon,7759,4,15,9,12,56,55,1,54
Brechin,7759,5,16,5,15,57,55,2,53
Queen's Park,7759,6,13,11,12,38,44,-6,50
East Fife,7759,7,12,10,14,51,46,5,46
Stranraer,7759,8,12,5,19,49,56,-7,41
Peterhead,7759,9,10,7,19,41,61,-20,37
Stenhousem'r,7759,10,7,10,19,46,73,-27,31
Livingston,7760,1,21,4,11,86,53,33,67
Alloa,7760,2,19,7,10,78,51,27,64
Airdrieon,7760,3,16,9,11,60,56,4,57
Brechin,7760,4,16,6,14,46,49,-3,54
Albion,7760,5,14,10,12,57,57,0,52
Peterhead,7760,6,14,8,14,60,65,-5,50
Queen's Park,7760,7,13,6,17,42,48,-6,45
East Fife,7760,8,12,8,16,49,47,2,44
Stranraer,7760,9,10,9,17,51,70,-19,39
Stenhousem'r,7760,10,4,15,17,40,73,-33,27
Livingston,7761,1,21,5,10,79,48,31,68
Airdrieon,7761,2,20,5,11,60,46,14,65
Brechin,7761,3,18,2,16,48,46,2,56
Alloa,7761,4,15,9,12,64,52,12,54
Queen's Park,7761,5,14,8,14,49,47,2,50
Peterhead,7761,6,15,5,16,47,59,-12,50
East Fife,7761,7,12,8,16,49,49,0,44
Albion,7761,8,13,5,18,44,56,-12,44
Stranraer,7761,9,13,3,20,57,65,-8,42
Stenhousem'r,7761,10,10,8,18,51,80,-29,38
Livingston,7762,1,20,9,7,85,57,28,69
Alloa,7762,2,20,6,10,72,49,23,66
Albion,7762,3,15,10,11,67,53,14,55
Peterhead,7762,4,14,12,10,54,50,4,54
Airdrieon,7762,5,16,5,15,62,61,1,53
Brechin,7762,6,14,6,16,48,52,-4,48
Stranraer,7762,7,14,6,16,47,53,-6,48
Queen's Park,7762,8,12,7,17,36,54,-18,43
East Fife,7762,9,10,7,19,53,53,0,37
Stenhousem'r,7762,10,8,6,22,44,86,-42,30
Livingston,7763,1,24,5,7,79,46,33,77
Albion,7763,2,17,7,12,57,53,4,58
Alloa,7763,3,16,9,11,75,51,24,57
Airdrieon,7763,4,15,8,13,64,59,5,53
Queen's Park,7763,5,16,3,17,43,52,-9,51
East Fife,7763,6,13,9,14,48,47,1,48
Stranraer,7763,7,15,3,18,51,54,-3,48
Brechin,7763,8,14,3,19,48,53,-5,45
Peterhead,7763,9,13,6,17,44,55,-11,45
Stenhousem'r,7763,10,6,9,21,43,82,-39,27
Livingston,7764,1,23,4,9,81,48,33,73
Alloa,7764,2,19,7,10,74,42,32,64
Airdrieon,7764,3,17,7,12,58,52,6,58
Brechin,7764,4,17,5,14,47,53,-6,56
Queen's Park,7764,5,15,8,13,44,45,-1,53
Albion,7764,6,14,10,12,58,55,3,52
Peterhead,7764,7,14,9,13,56,53,3,51
Stranraer,7764,8,10,7,19,45,59,-14,37
East Fife,7764,9,9,9,18,42,57,-15,36
Stenhousem'r,7764,10,6,6,24,42,83,-41,24
Brechin,7765,1,19,9,8,61,43,18,66
Livingston,7765,2,18,8,10,70,46,24,62
Alloa,7765,3,16,13,7,59,33,26,61
Peterhead,7765,4,15,8,13,52,46,6,53
Airdrieon,7765,5,13,7,16,61,63,-2,46
East Fife,7765,6,11,11,14,50,53,-3,44
Albion,7765,7,10,14,12,48,55,-7,44
Queen's Park,7765,8,11,11,14,36,46,-10,44
Stranraer,7765,9,11,6,19,45,62,-17,39
Stenhousem'r,7765,10,8,9,19,48,83,-35,33
Livingston,7766,1,23,4,9,79,45,34,73
Alloa,7766,2,20,5,11,79,44,35,65
Airdrieon,7766,3,18,8,10,58,44,14,62
Brechin,7766,4,18,6,12,53,46,7,60
Stranraer,7766,5,12,9,15,52,55,-3,45
Peterhead,7766,6,12,9,15,43,61,-18,45
Queen's Park,7766,7,13,5,18,35,52,-17,44
East Fife,7766,8,10,9,17,48,54,-6,39
Albion,7766,9,10,9,17,46,59,-13,39
Stenhousem'r,7766,10,8,8,20,45,78,-33,32
Alloa,7767,1,24,6,6,77,35,42,78
Airdrieon,7767,2,19,6,11,62,52,10,63
Livingston,7767,3,16,8,12,65,51,14,56
Albion,7767,4,16,6,14,60,49,11,54
Brechin,7767,5,15,8,13,56,55,1,53
East Fife,7767,6,12,7,17,46,50,-4,43
Queen's Park,7767,7,11,10,15,29,49,-20,43
Peterhead,7767,8,12,6,18,48,53,-5,42
Stranraer,7767,9,10,6,20,42,65,-23,36
Stenhousem'r,7767,10,9,9,18,49,75,-26,36
Brechin,7768,1,18,10,8,57,42,15,64
Alloa,7768,2,18,7,11,70,54,16,61
Livingston,7768,3,18,6,12,75,51,24,60
Airdrieon,7768,4,15,11,10,62,55,7,56
Peterhead,7768,5,14,7,15,52,56,-4,49
East Fife,7768,6,13,9,14,62,48,14,48
Queen's Park,7768,7,11,9,16,42,64,-22,42
Albion,7768,8,11,8,17,49,63,-14,41
Stranraer,7768,9,10,9,17,47,58,-11,39
Stenhousem'r,7768,10,10,8,18,51,76,-25,38
Alloa,7769,1,21,7,8,75,44,31,70
Livingston,7769,2,20,5,11,81,48,33,65
Airdrieon,7769,3,18,6,12,64,59,5,60
Brechin,7769,4,18,4,14,58,49,9,58
Peterhead,7769,5,17,5,14,53,52,1,56
East Fife,7769,6,13,9,14,53,54,-1,48
Stranraer,7769,7,12,7,17,53,54,-1,43
Albion,7769,8,11,9,16,53,64,-11,42
Queen's Park,7769,9,9,6,21,28,57,-29,33
Stenhousem'r,7769,10,6,12,18,41,78,-37,30
Livingston,7770,1,24,4,8,80,42,38,76
Alloa,7770,2,18,10,8,68,41,27,64
Albion,7770,3,16,9,11,64,56,8,57
Airdrieon,7770,4,16,8,12,60,58,2,56
Brechin,7770,5,14,8,14,53,51,2,50
East Fife,7770,6,11,11,14,42,42,0,44
Peterhead,7770,7,13,5,18,49,59,-10,44
Stranraer,7770,8,12,7,17,49,59,-10,43
Queen's Park,7770,9,11,7,18,33,56,-23,40
Stenhousem'r,7770,10,6,9,21,45,79,-34,27
Alloa,7771,1,20,9,7,61,35,26,69
Livingston,7771,2,19,7,10,71,47,24,64
Airdrieon,7771,3,17,7,12,64,54,10,58
Albion,7771,4,16,7,13,55,52,3,55
Peterhead,7771,5,13,8,15,55,54,1,47
Brechin,7771,6,13,8,15,47,55,-8,47
East Fife,7771,7,13,7,16,52,51,1,46
Stranraer,7771,8,13,5,18,57,61,-4,44
Queen's Park,7771,9,9,10,17,36,54,-18,37
Stenhousem'r,7771,10,10,6,20,41,76,-35,36
Livingston,7772,1,25,5,6,78,35,43,80
Brechin,7772,2,20,5,11,56,50,6,65
Alloa,7772,3,17,7,12,71,53,18,58
Peterhead,7772,4,15,8,13,50,48,2,53
Airdrieon,7772,5,15,7,14,56,61,-5,52
Queen's Park,7772,6,14,6,16,44,51,-7,48
East Fife,7772,7,11,10,15,47,49,-2,43
Albion,7772,8,12,6,18,48,58,-10,42
Stranraer,7772,9,9,7,20,49,69,-20,34
Stenhousem'r,7772,10,7,9,20,45,70,-25,30
Livingston,7773,1,23,3,10,91,51,40,72
Alloa,7773,2,20,5,11,69,49,20,65
Airdrieon,7773,3,19,4,13,62,52,10,61
Brechin,7773,4,18,6,12,59,47,12,60
Peterhead,7773,5,14,6,16,48,56,-8,48
Queen's Park,7773,6,14,6,16,38,50,-12,48
Stranraer,7773,7,13,5,18,46,53,-7,44
East Fife,7773,8,10,9,17,50,53,-3,39
Stenhousem'r,7773,9,10,7,19,44,82,-38,37
Albion,7773,10,9,9,18,49,63,-14,36
Airdrieon,7774,1,20,7,9,66,49,17,67
Alloa,7774,2,17,10,9,65,46,19,61
Livingston,7774,3,18,4,14,71,53,18,58
Brechin,7774,4,16,6,14,53,42,11,54
Queen's Park,7774,5,14,9,13,48,53,-5,51
Albion,7774,6,14,8,14,55,60,-5,50
East Fife,7774,7,13,10,13,53,44,9,49
Peterhead,7774,8,11,7,18,47,63,-16,40
Stranraer,7774,9,11,6,19,44,61,-17,39
Stenhousem'r,7774,10,8,9,19,49,80,-31,33
Airdrieon,7775,1,22,4,10,69,43,26,70
Livingston,7775,2,20,5,11,70,52,18,65
Alloa,7775,3,19,6,11,66,44,22,63
Albion,7775,4,15,10,11,50,47,3,55
Peterhead,7775,5,14,9,13,56,53,3,51
Brechin,7775,6,15,5,16,43,50,-7,50
Stranraer,7775,7,14,2,20,45,55,-10,44
Queen's Park,7775,8,13,5,18,36,48,-12,44
East Fife,7775,9,10,12,14,47,44,3,42
Stenhousem'r,7775,10,6,6,24,33,79,-46,24
Livingston,7776,1,20,6,10,70,42,28,66
Alloa,7776,2,19,5,12,67,47,20,62
Airdrieon,7776,3,18,7,11,57,50,7,61
Peterhead,7776,4,16,9,11,54,44,10,57
Brechin,7776,5,15,6,15,50,49,1,51
East Fife,7776,6,13,8,15,48,46,2,47
Stranraer,7776,7,13,6,17,54,60,-6,45
Queen's Park,7776,8,12,9,15,40,57,-17,45
Albion,7776,9,10,8,18,46,58,-12,38
Stenhousem'r,7776,10,7,10,19,49,82,-33,31
Livingston,7777,1,24,3,9,78,45,33,75
Airdrieon,7777,2,19,5,12,68,43,25,62
Alloa,7777,3,17,7,12,69,49,20,58
Brechin,7777,4,17,6,13,57,50,7,57
Peterhead,7777,5,16,9,11,53,52,1,57
Stranraer,7777,6,14,7,15,56,60,-4,49
Albion,7777,7,14,6,16,53,59,-6,48
Queen's Park,7777,8,9,9,18,34,57,-23,36
Stenhousem'r,7777,9,8,8,20,51,92,-41,32
East Fife,7777,10,6,12,18,46,58,-12,30
Livingston,7778,1,23,6,7,73,36,37,75
Alloa,7778,2,20,6,10,75,39,36,66
Airdrieon,7778,3,19,9,8,64,51,13,66
Albion,7778,4,15,7,14,52,49,3,52
Brechin,7778,5,15,5,16,49,53,-4,50
East Fife,7778,6,14,6,16,53,51,2,48
Queen's Park,7778,7,13,8,15,29,40,-11,47
Stranraer,7778,8,9,10,17,45,60,-15,37
Peterhead,7778,9,8,10,18,39,66,-27,34
Stenhousem'r,7778,10,5,11,20,46,80,-34,26
Livingston,7779,1,19,6,11,68,43,25,63
Alloa,7779,2,18,8,10,72,46,26,62
Albion,7779,3,18,8,10,58,46,12,62
Airdrieon,7779,4,18,5,13,61,56,5,59
Brechin,7779,5,16,7,13,55,53,2,55
East Fife,7779,6,13,10,13,57,50,7,49
Peterhead,7779,7,11,12,13,49,52,-3,45
Stranraer,7779,8,13,5,18,48,60,-12,44
Queen's Park,7779,9,9,10,17,35,60,-25,37
Stenhousem'r,7779,10,6,7,23,38,75,-37,25
Livingston,7780,1,23,6,7,76,41,35,75
Alloa,7780,2,21,5,10,76,47,29,68
East Fife,7780,3,16,10,10,54,33,21,58
Airdrieon,7780,4,16,8,12,51,47,4,56
Brechin,7780,5,16,6,14,49,49,0,54
Peterhead,7780,6,14,8,14,45,49,-4,50
Albion,7780,7,12,7,17,54,52,2,43
Queen's Park,7780,8,12,4,20,31,56,-25,40
Stranraer,7780,9,9,9,18,44,63,-19,36
Stenhousem'r,7780,10,5,9,22,36,79,-43,24
Livingston,7781,1,25,1,10,84,46,38,76
Alloa,7781,2,18,9,9,72,44,28,63
Airdrieon,7781,3,16,7,13,54,53,1,55
Stranraer,7781,4,15,9,12,52,44,8,54
Brechin,7781,5,14,10,12,48,42,6,52
Peterhead,7781,6,14,10,12,43,48,-5,52
East Fife,7781,7,11,7,18,48,48,0,40
Queen's Park,7781,8,11,7,18,36,56,-20,40
Albion,7781,9,9,10,17,45,68,-23,37
Stenhousem'r,7781,10,9,6,21,47,80,-33,33
Livingston,7782,1,19,5,12,71,55,16,62
Alloa,7782,2,17,9,10,68,47,21,60
Brechin,7782,3,17,8,11,51,41,10,59
Airdrieon,7782,4,16,5,15,57,54,3,53
Albion,7782,5,13,10,13,59,59,0,49
Queen's Park,7782,6,13,7,16,40,52,-12,46
Stenhousem'r,7782,7,12,10,14,52,70,-18,46
East Fife,7782,8,12,9,15,49,49,0,45
Peterhead,7782,9,12,7,17,39,49,-10,43
Stranraer,7782,10,12,4,20,53,63,-10,40
Livingston,7783,1,23,4,9,83,42,41,73
Alloa,7783,2,18,9,9,73,47,26,63
Brechin,7783,3,16,8,12,55,48,7,56
Airdrieon,7783,4,15,9,12,61,57,4,54
Albion,7783,5,14,8,14,56,55,1,50
Queen's Park,7783,6,14,6,16,49,59,-10,48
Peterhead,7783,7,14,6,16,44,54,-10,48
East Fife,7783,8,11,9,16,47,54,-7,42
Stranraer,7783,9,10,8,18,48,60,-12,38
Stenhousem'r,7783,10,6,11,19,48,88,-40,29
Alloa,7784,1,21,7,8,68,38,30,70
Livingston,7784,2,20,7,9,75,47,28,67
Airdrieon,7784,3,19,5,12,61,51,10,62
Brechin,7784,4,15,4,17,45,45,0,49
Stranraer,7784,5,14,6,16,53,55,-2,48
Peterhead,7784,6,12,9,15,44,53,-9,45
Queen's Park,7784,7,12,8,16,36,53,-17,44
Stenhousem'r,7784,8,11,9,16,46,67,-21,42
Albion,7784,9,11,8,17,49,61,-12,41
East Fife,7784,10,9,9,18,41,48,-7,36
Livingston,7785,1,24,3,9,83,44,39,75
Brechin,7785,2,17,7,12,57,48,9,58
Alloa,7785,3,17,6,13,72,54,18,57
Airdrieon,7785,4,17,5,14,60,56,4,56
Queen's Park,7785,5,14,10,12,43,44,-1,52
Peterhead,7785,6,13,9,14,53,61,-8,48
Albion,7785,7,12,11,13,53,53,0,47
Stranraer,7785,8,10,10,16,45,62,-17,40
East Fife,7785,9,10,8,18,45,57,-12,38
Stenhousem'r,7785,10,9,5,22,50,82,-32,32
Livingston,7786,1,21,8,7,68,35,33,71
Alloa,7786,2,20,7,9,66,40,26,67
Brechin,7786,3,18,6,12,58,43,15,60
Albion,7786,4,15,12,9,49,43,6,57
Airdrieon,7786,5,17,6,13,59,57,2,57
Queen's Park,7786,6,11,9,16,37,54,-17,42
East Fife,7786,7,9,13,14,45,48,-3,40
Stranraer,7786,8,11,6,19,42,60,-18,39
Peterhead,7786,9,8,11,17,44,54,-10,35
Stenhousem'r,7786,10,8,6,22,48,82,-34,30
Airdrieon,7787,1,23,4,9,74,52,22,73
Livingston,7787,2,20,6,10,73,47,26,66
Alloa,7787,3,18,11,7,80,51,29,65
Queen's Park,7787,4,15,7,14,43,55,-12,52
East Fife,7787,5,13,8,15,54,47,7,47
Albion,7787,6,12,9,15,47,59,-12,45
Brechin,7787,7,12,6,18,45,57,-12,42
Stranraer,7787,8,12,5,19,52,62,-10,41
Peterhead,7787,9,11,6,19,51,62,-11,39
Stenhousem'r,7787,10,9,8,19,55,82,-27,35
Alloa,7788,1,19,6,11,70,46,24,63
Livingston,7788,2,20,3,13,68,45,23,63
Airdrieon,7788,3,18,6,12,58,54,4,60
East Fife,7788,4,14,10,12,55,46,9,52
Queen's Park,7788,5,14,8,14,36,45,-9,50
Albion,7788,6,13,10,13,54,50,4,49
Stranraer,7788,7,15,4,17,60,62,-2,49
Brechin,7788,8,13,7,16,47,57,-10,46
Peterhead,7788,9,12,8,16,45,51,-6,44
Stenhousem'r,7788,10,8,6,22,40,77,-37,30
Livingston,7789,1,23,3,10,81,45,36,72
Alloa,7789,2,18,9,9,71,46,25,63
Airdrieon,7789,3,18,7,11,69,58,11,61
Brechin,7789,4,16,6,14,52,50,2,54
Albion,7789,5,15,7,14,56,56,0,52
Peterhead,7789,6,14,9,13,51,52,-1,51
East Fife,7789,7,12,9,15,42,42,0,45
Stranraer,7789,8,13,6,17,51,55,-4,45
Queen's Park,7789,9,10,8,18,41,64,-23,38
Stenhousem'r,7789,10,5,8,23,40,86,-46,23
Livingston,7790,1,23,5,8,85,52,33,74
Alloa,7790,2,18,9,9,62,46,16,63
Albion,7790,3,16,7,13,62,51,11,55
Airdrieon,7790,4,16,7,13,54,55,-1,55
Stranraer,7790,5,13,9,14,58,54,4,48
Brechin,7790,6,13,7,16,47,51,-4,46
Peterhead,7790,7,10,13,13,46,55,-9,43
Queen's Park,7790,8,11,7,18,34,52,-18,40
East Fife,7790,9,10,8,18,44,50,-6,38
Stenhousem'r,7790,10,10,8,18,53,79,-26,38
Alloa,7791,1,18,9,9,72,43,29,63
Airdrieon,7791,2,17,8,11,60,50,10,59
Brechin,7791,3,16,9,11,50,49,1,57
Livingston,7791,4,16,5,15,64,53,11,53
Queen's Park,7791,5,15,8,13,41,42,-1,53
Peterhead,7791,6,14,11,11,47,49,-2,53
Stranraer,7791,7,13,8,15,53,56,-3,47
Albion,7791,8,11,10,15,46,53,-7,43
East Fife,7791,9,9,10,17,46,50,-4,37
Stenhousem'r,7791,10,8,8,20,46,80,-34,32
Livingston,7792,1,23,7,6,73,43,30,76
Alloa,7792,2,22,6,8,71,41,30,72
Airdrieon,7792,3,17,4,15,62,54,8,55
Brechin,7792,4,16,7,13,54,49,5,55
Peterhead,7792,5,16,5,15,55,50,5,53
East Fife,7792,6,14,9,13,51,47,4,51
Albion,7792,7,13,6,17,51,54,-3,45
Stenhousem'r,7792,8,9,7,20,45,80,-35,34
Stranraer,7792,9,8,9,19,46,65,-19,33
Queen's Park,7792,10,9,6,21,34,59,-25,33
Alloa,7793,1,18,8,10,64,47,17,62
Brechin,7793,2,18,8,10,60,44,16,62
Livingston,7793,3,17,7,12,68,45,23,58
Airdrieon,7793,4,17,7,12,64,61,3,58
Stranraer,7793,5,15,7,14,56,50,6,52
Albion,7793,6,12,12,12,45,50,-5,48
Peterhead,7793,7,14,6,16,43,51,-8,48
East Fife,7793,8,12,8,16,53,54,-1,44
Queen's Park,7793,9,11,9,16,35,51,-16,42
Stenhousem'r,7793,10,5,10,21,37,72,-35,25
Alloa,7794,1,18,7,11,62,40,22,61
Airdrieon,7794,2,18,7,11,58,47,11,61
Livingston,7794,3,17,6,13,70,51,19,57
Albion,7794,4,16,6,14,52,54,-2,54
Peterhead,7794,4,16,6,14,52,54,-2,54
Brechin,7794,6,15,6,15,50,51,-1,51
East Fife,7794,7,13,10,13,47,43,4,49
Stranraer,7794,8,12,6,18,46,55,-9,42
Queen's Park,7794,9,11,7,18,40,56,-16,40
Stenhousem'r,7794,10,11,5,20,55,81,-26,38
Airdrieon,7795,1,20,6,10,68,50,18,66
Brechin,7795,2,19,7,10,52,39,13,64
Alloa,7795,3,18,8,10,69,38,31,62
Livingston,7795,4,18,3,15,81,58,23,57
Peterhead,7795,5,13,10,13,51,63,-12,49
East Fife,7795,6,12,11,13,50,45,5,47
Stranraer,7795,7,13,4,19,49,67,-18,43
Queen's Park,7795,8,11,9,16,29,46,-17,42
Albion,7795,9,9,11,16,44,56,-12,38
Stenhousem'r,7795,10,9,7,20,45,76,-31,34
Alloa,7796,1,20,8,8,84,45,39,68
Livingston,7796,2,20,5,11,72,50,22,65
Albion,7796,3,15,10,11,56,44,12,55
Brechin,7796,4,16,6,14,52,51,1,54
Airdrieon,7796,5,16,6,14,50,50,0,54
Queen's Park,7796,6,16,4,16,37,51,-14,52
East Fife,7796,7,13,6,17,51,47,4,45
Peterhead,7796,8,13,6,17,43,55,-12,45
Stranraer,7796,9,12,3,21,41,54,-13,39
Stenhousem'r,7796,10,9,6,21,40,79,-39,33
Airdrieon,7797,1,19,9,8,71,53,18,66
Livingston,7797,2,21,2,13,73,49,24,65
Alloa,7797,3,15,12,9,66,50,16,57
Peterhead,7797,4,14,8,14,49,50,-1,50
Queen's Park,7797,5,14,8,14,41,49,-8,50
East Fife,7797,6,13,9,14,53,50,3,48
Albion,7797,7,14,6,16,59,58,1,48
Brechin,7797,8,13,7,16,50,62,-12,46
Stranraer,7797,9,12,8,16,57,62,-5,44
Stenhousem'r,7797,10,7,7,22,44,80,-36,28
Livingston,7798,1,30,0,6,89,38,51,90
Alloa,7798,2,20,6,10,76,43,33,66
Peterhead,7798,3,16,6,14,55,52,3,54
Brechin,7798,4,15,7,14,48,58,-10,52
Airdrieon,7798,5,14,8,14,57,57,0,50
Stenhousem'r,7798,6,13,7,16,62,75,-13,46
East Fife,7798,7,13,6,17,60,62,-2,45
Albion,7798,8,10,9,17,39,56,-17,39
Stranraer,7798,9,9,8,19,45,61,-16,35
Queen's Park,7798,10,9,5,22,35,64,-29,32
Livingston,7799,1,22,4,10,81,47,34,70
Alloa,7799,2,18,9,9,73,42,31,63
Airdrieon,7799,3,17,7,12,59,49,10,58
Peterhead,7799,4,16,6,14,51,51,0,54
Brechin,7799,5,15,5,16,49,53,-4,50
Albion,7799,6,13,9,14,57,53,4,48
Stranraer,7799,7,13,5,18,45,59,-14,44
Queen's Park,7799,8,11,10,15,44,59,-15,43
East Fife,7799,9,10,12,14,44,51,-7,42
Stenhousem'r,7799,10,6,11,19,42,81,-39,29
Livingston,7800,1,22,4,10,73,43,30,70
Alloa,7800,2,18,8,10,69,44,25,62
Airdrieon,7800,3,19,5,12,55,50,5,62
Stranraer,7800,4,16,6,14,52,50,2,54
East Fife,7800,5,14,10,12,54,43,11,52
Peterhead,7800,6,15,6,15,48,46,2,51
Brechin,7800,7,13,10,13,44,44,0,49
Albion,7800,8,11,11,14,48,57,-9,44
Stenhousem'r,7800,9,9,7,20,42,77,-35,34
Queen's Park,7800,10,6,7,23,28,59,-31,25
Alloa,7801,1,23,8,5,82,37,45,77
Livingston,7801,2,19,6,11,79,54,25,63
Brechin,7801,3,16,6,14,58,55,3,54
East Fife,7801,4,15,7,14,55,45,10,52
Airdrieon,7801,5,15,5,16,49,61,-12,50
Peterhead,7801,6,14,7,15,47,54,-7,49
Stranraer,7801,7,15,3,18,49,53,-4,48
Queen's Park,7801,8,11,8,17,36,54,-18,41
Stenhousem'r,7801,9,11,5,20,58,84,-26,38
Albion,7801,10,10,7,19,42,58,-16,37
Livingston,7802,1,21,5,10,92,64,28,68
Brechin,7802,2,19,7,10,62,50,12,64
Airdrieon,7802,3,17,8,11,57,48,9,59
Peterhead,7802,4,15,8,13,50,47,3,53
Queen's Park,7802,5,14,8,14,38,44,-6,50
Alloa,7802,6,14,7,15,59,49,10,49
Stranraer,7802,7,14,4,18,48,56,-8,46
Albion,7802,8,12,9,15,38,48,-10,45
Stenhousem'r,7802,9,10,7,19,44,67,-23,37
East Fife,7802,10,6,13,17,43,58,-15,31
Livingston,7803,1,19,6,11,70,48,22,63
Airdrieon,7803,2,19,4,13,70,57,13,61
Albion,7803,3,17,9,10,62,51,11,60
Alloa,7803,4,17,8,11,64,45,19,59
Brechin,7803,5,17,4,15,41,47,-6,55
Peterhead,7803,6,14,9,13,50,54,-4,51
East Fife,7803,7,13,8,15,54,50,4,47
Queen's Park,7803,8,11,11,14,44,52,-8,44
Stranraer,7803,9,11,5,20,52,66,-14,38
Stenhousem'r,7803,10,7,6,23,42,79,-37,27
Alloa,7804,1,21,7,8,74,48,26,70
Livingston,7804,2,22,2,12,71,45,26,68
Brechin,7804,3,20,6,10,62,37,25,66
Airdrieon,7804,4,17,6,13,64,59,5,57
Albion,7804,5,15,9,12,55,54,1,54
Queen's Park,7804,6,14,6,16,41,46,-5,48
Peterhead,7804,7,13,5,18,48,56,-8,44
Stranraer,7804,8,12,2,22,45,66,-21,38
East Fife,7804,9,9,8,19,49,58,-9,35
Stenhousem'r,7804,10,7,9,20,44,84,-40,30
Livingston,7805,1,21,6,9,77,47,30,69
Alloa,7805,2,20,7,9,71,41,30,67
Airdrieon,7805,3,17,5,14,58,53,5,56
Albion,7805,4,14,12,10,53,43,10,54
Peterhead,7805,5,14,8,14,41,45,-4,50
Brechin,7805,6,15,5,16,45,51,-6,50
East Fife,7805,7,13,9,14,45,43,2,48
Stranraer,7805,8,13,5,18,55,60,-5,44
Queen's Park,7805,9,9,8,19,38,59,-21,35
Stenhousem'r,7805,10,7,9,20,45,86,-41,30
Livingston,7806,1,26,3,7,77,34,43,81
Alloa,7806,2,19,7,10,77,50,27,64
Brechin,7806,3,18,4,14,50,49,1,58
Airdrieon,7806,4,16,7,13,58,57,1,55
Peterhead,7806,5,14,9,13,44,45,-1,51
Stranraer,7806,6,15,4,17,52,59,-7,49
Albion,7806,7,11,11,14,50,52,-2,44
Queen's Park,7806,8,11,8,17,38,55,-17,41
East Fife,7806,9,8,12,16,45,48,-3,36
Stenhousem'r,7806,10,6,7,23,39,81,-42,25
Airdrieon,7807,1,18,10,8,55,42,13,64
Livingston,7807,2,18,5,13,77,62,15,59
Alloa,7807,3,16,9,11,66,49,17,57
Brechin,7807,4,16,7,13,49,52,-3,55
Albion,7807,5,16,5,15,53,47,6,53
Stranraer,7807,6,16,5,15,64,59,5,53
East Fife,7807,7,16,5,15,54,52,2,53
Queen's Park,7807,8,12,8,16,37,49,-12,44
Peterhead,7807,9,12,7,17,46,53,-7,43
Stenhousem'r,7807,10,6,7,23,41,77,-36,25
Livingston,7808,1,25,3,8,79,45,34,78
Alloa,7808,2,19,6,11,71,46,25,63
Brechin,7808,3,19,5,12,55,38,17,62
Airdrieon,7808,4,18,6,12,58,51,7,60
Albion,7808,5,15,8,13,55,46,9,53
Peterhead,7808,6,14,9,13,55,61,-6,51
Stranraer,7808,7,11,6,19,46,63,-17,39
Queen's Park,7808,8,10,7,19,37,59,-22,37
East Fife,7808,9,7,14,15,42,52,-10,35
Stenhousem'r,7808,10,7,6,23,43,80,-37,27
Livingston,7809,1,22,4,10,72,43,29,70
Alloa,7809,2,16,9,11,68,50,18,57
East Fife,7809,3,15,11,10,56,38,18,56
Airdrieon,7809,4,16,6,14,55,56,-1,54
Brechin,7809,5,16,4,16,51,64,-13,52
Stranraer,7809,6,14,5,17,61,57,4,47
Peterhead,7809,7,13,8,15,46,51,-5,47
Albion,7809,8,12,9,15,52,57,-5,45
Queen's Park,7809,9,13,5,18,41,56,-15,44
Stenhousem'r,7809,10,8,9,19,53,83,-30,33
Alloa,7810,1,20,9,7,68,41,27,69
Livingston,7810,2,21,5,10,88,56,32,68
Brechin,7810,3,18,6,12,61,45,16,60
Airdrieon,7810,4,16,5,15,57,60,-3,53
Queen's Park,7810,5,15,5,16,41,51,-10,50
Albion,7810,6,13,9,14,61,51,10,48
Peterhead,7810,7,13,9,14,58,59,-1,48
East Fife,7810,8,12,8,16,51,50,1,44
Stranraer,7810,9,9,7,20,41,64,-23,34
Stenhousem'r,7810,10,6,11,19,40,89,-49,29
Livingston,7811,1,22,5,9,88,52,36,71
Alloa,7811,2,19,9,8,65,38,27,66
Albion,7811,3,17,6,13,57,49,8,57
Brechin,7811,4,17,6,13,51,50,1,57
Airdrieon,7811,5,16,8,12,55,54,1,56
Peterhead,7811,6,14,8,14,57,54,3,50
Queen's Park,7811,7,12,9,15,35,49,-14,45
East Fife,7811,8,8,14,14,47,55,-8,38
Stranraer,7811,9,10,6,20,40,60,-20,36
Stenhousem'r,7811,10,5,9,22,48,82,-34,24
Livingston,7812,1,27,1,8,75,39,36,82
Brechin,7812,2,20,5,11,54,37,17,65
Airdrieon,7812,3,17,6,13,51,50,1,57
Alloa,7812,4,14,9,13,61,55,6,51
Peterhead,7812,5,15,5,16,43,49,-6,50
East Fife,7812,6,12,9,15,50,50,0,45
Albion,7812,7,12,9,15,48,51,-3,45
Stranraer,7812,8,12,6,18,48,54,-6,42
Queen's Park,7812,9,11,9,16,41,57,-16,42
Stenhousem'r,7812,10,8,5,23,43,72,-29,29
Alloa,7813,1,22,7,7,78,43,35,73
Livingston,7813,2,20,5,11,80,47,33,65
Airdrieon,7813,3,18,6,12,55,52,3,60
Brechin,7813,4,18,4,14,51,57,-6,58
Peterhead,7813,5,14,10,12,51,47,4,52
Albion,7813,6,14,7,15,58,57,1,49
Stranraer,7813,7,11,6,19,46,63,-17,39
East Fife,7813,8,10,8,18,53,57,-4,38
Stenhousem'r,7813,9,10,7,19,49,75,-26,37
Queen's Park,7813,10,10,6,20,32,55,-23,36
Alloa,7814,1,23,5,8,82,38,44,74
Livingston,7814,2,21,5,10,77,49,28,68
Airdrieon,7814,3,17,7,12,65,55,10,58
Brechin,7814,4,17,3,16,51,51,0,54
Stranraer,7814,5,16,6,14,57,58,-1,54
Albion,7814,6,13,11,12,43,46,-3,50
Peterhead,7814,7,14,8,14,48,52,-4,50
East Fife,7814,8,10,10,16,48,56,-8,40
Queen's Park,7814,9,11,3,22,32,59,-27,36
Stenhousem'r,7814,10,6,6,24,48,87,-39,24
Alloa,7815,1,22,7,7,72,35,37,73
Livingston,7815,2,23,4,9,78,42,36,73
Airdrieon,7815,3,16,9,11,62,60,2,57
Brechin,7815,4,16,3,17,63,55,8,51
Albion,7815,5,14,8,14,50,55,-5,50
Peterhead,7815,6,14,6,16,49,56,-7,48
Stranraer,7815,7,12,7,17,45,60,-15,43
Queen's Park,7815,8,11,8,17,33,53,-20,41
East Fife,7815,9,10,7,19,47,53,-6,37
Stenhousem'r,7815,10,7,11,18,46,76,-30,32
Livingston,7816,1,22,3,11,75,42,33,69
Airdrieon,7816,2,19,5,12,54,45,9,62
Alloa,7816,3,18,6,12,62,44,18,60
Albion,7816,4,18,6,12,52,47,5,60
Brechin,7816,5,17,8,11,52,42,10,59
East Fife,7816,6,13,10,13,55,37,18,49
Peterhead,7816,7,14,6,16,46,56,-10,48
Stranraer,7816,8,11,5,20,40,57,-17,38
Queen's Park,7816,9,9,6,21,35,63,-28,33
Stenhousem'r,7816,10,8,7,21,51,89,-38,31
Alloa,7817,1,21,7,8,67,33,34,70
Livingston,7817,2,20,6,10,77,43,34,66
Stranraer,7817,3,16,7,13,51,47,4,55
Airdrieon,7817,4,16,7,13,56,57,-1,55
Brechin,7817,5,14,6,16,38,43,-5,48
Albion,7817,6,13,6,17,53,59,-6,45
Stenhousem'r,7817,7,13,6,17,52,72,-20,45
Peterhead,7817,8,11,8,17,40,51,-11,41
Queen's Park,7817,9,10,10,16,39,57,-18,40
East Fife,7817,10,10,9,17,46,57,-11,39
Alloa,7818,1,23,6,7,84,43,41,75
Livingston,7818,2,18,8,10,75,52,23,62
Stranraer,7818,3,19,4,13,68,51,17,61
Airdrieon,7818,4,17,6,13,63,50,13,57
Albion,7818,5,16,7,13,59,59,0,55
Peterhead,7818,6,14,8,14,56,56,0,50
Queen's Park,7818,7,14,8,14,45,46,-1,50
Brechin,7818,8,14,5,17,52,65,-13,47
East Fife,7818,9,7,9,20,41,62,-21,30
Stenhousem'r,7818,10,6,3,27,37,96,-59,21
Alloa,7819,1,22,6,8,81,50,31,72
Livingston,7819,2,21,4,11,80,51,29,67
Airdrieon,7819,3,18,9,9,64,49,15,63
Brechin,7819,4,18,6,12,56,41,15,60
Stranraer,7819,5,13,6,17,50,61,-11,45
Queen's Park,7819,6,12,7,17,37,52,-15,43
Albion,7819,7,10,12,14,49,59,-10,42
East Fife,7819,8,10,9,17,51,53,-2,39
Stenhousem'r,7819,9,11,4,21,51,85,-34,37
Peterhead,7819,10,8,11,17,42,60,-18,35
Alloa,7820,1,20,6,10,79,43,36,66
Airdrieon,7820,2,18,8,10,67,55,12,62
Livingston,7820,3,18,7,11,80,62,18,61
Brechin,7820,4,18,5,13,51,43,8,59
Albion,7820,5,14,10,12,54,53,1,52
Queen's Park,7820,6,14,8,14,39,48,-9,50
Peterhead,7820,7,12,10,14,48,56,-8,46
Stranraer,7820,8,12,4,20,49,67,-18,40
East Fife,7820,9,9,10,17,51,58,-7,37
Stenhousem'r,7820,10,7,8,21,48,81,-33,29
Livingston,7821,1,22,7,7,82,50,32,73
Alloa,7821,2,22,5,9,74,42,32,71
Airdrieon,7821,3,16,7,13,50,50,0,55
Brechin,7821,4,17,4,15,50,52,-2,55
East Fife,7821,5,14,8,14,57,46,11,50
Queen's Park,7821,6,14,5,17,40,56,-16,47
Albion,7821,7,12,9,15,55,57,-2,45
Peterhead,7821,8,13,6,17,48,52,-4,45
Stranraer,7821,9,11,7,18,43,56,-13,40
Stenhousem'r,7821,10,7,6,23,41,79,-38,27
Livingston,7822,1,25,1,10,72,44,28,76
Alloa,7822,2,19,9,8,79,40,39,66
Airdrieon,7822,3,16,7,13,56,45,11,55
Albion,7822,4,15,10,11,53,52,1,55
Brechin,7822,5,16,6,14,52,52,0,54
Peterhead,7822,6,14,7,15,52,61,-9,49
Stranraer,7822,7,13,5,18,47,53,-6,44
Queen's Park,7822,8,13,5,18,38,55,-17,44
East Fife,7822,9,8,12,16,43,45,-2,36
Stenhousem'r,7822,10,7,6,23,45,90,-45,27
Alloa,7823,1,19,7,10,78,48,30,64
Airdrieon,7823,2,15,10,11,57,52,5,55
Albion,7823,3,15,10,11,58,54,4,55
Queen's Park,7823,4,16,7,13,52,48,4,55
Livingston,7823,5,15,9,12,66,51,15,54
Brechin,7823,6,16,6,14,51,58,-7,54
Peterhead,7823,7,14,7,15,58,60,-2,49
Stranraer,7823,8,12,9,15,54,62,-8,45
East Fife,7823,9,9,14,13,48,46,2,41
Stenhousem'r,7823,10,3,13,20,42,85,-43,22
Brechin,7824,1,19,9,8,60,44,16,66
Livingston,7824,2,20,5,11,75,46,29,65
Airdrieon,7824,3,18,8,10,57,55,2,62
Albion,7824,4,17,10,9,59,50,9,61
Alloa,7824,5,15,7,14,61,49,12,52
Peterhead,7824,6,14,6,16,57,60,-3,48
East Fife,7824,7,9,12,15,43,49,-6,39
Queen's Park,7824,8,9,10,17,32,54,-22,37
Stranraer,7824,9,10,6,20,52,57,-5,36
Stenhousem'r,7824,10,7,11,18,46,78,-32,32
Livingston,7825,1,21,5,10,79,52,27,68
Alloa,7825,2,18,9,9,64,41,23,63
Airdrieon,7825,3,18,9,9,54,45,9,63
Stranraer,7825,4,16,6,14,57,58,-1,54
Brechin,7825,5,15,8,13,54,47,7,53
East Fife,7825,6,12,11,13,46,43,3,47
Peterhead,7825,7,12,7,17,50,64,-14,43
Albion,7825,8,12,6,18,50,57,-7,42
Stenhousem'r,7825,9,8,11,17,49,66,-17,35
Queen's Park,7825,10,7,10,19,25,55,-30,31
Livingston,7826,1,21,7,8,77,50,27,70
Alloa,7826,2,19,9,8,72,41,31,66
Albion,7826,3,17,9,10,53,43,10,60
Brechin,7826,4,15,7,14,50,53,-3,52
Airdrieon,7826,5,14,6,16,60,63,-3,48
East Fife,7826,6,12,11,13,56,50,6,47
Peterhead,7826,7,11,12,13,47,52,-5,45
Stranraer,7826,8,11,7,18,53,61,-8,40
Queen's Park,7826,9,9,10,17,41,55,-14,37
Stenhousem'r,7826,10,6,12,18,49,90,-41,30
Livingston,7827,1,22,4,10,76,45,31,70
Alloa,7827,2,19,9,8,84,49,35,66
Brechin,7827,3,18,6,12,51,39,12,60
Peterhead,7827,4,16,5,15,52,49,3,53
Airdrieon,7827,5,15,8,13,54,66,-12,53
Albion,7827,6,14,8,14,57,53,4,50
Queen's Park,7827,7,12,8,16,37,48,-11,44
Stranraer,7827,8,11,6,19,46,64,-18,39
East Fife,7827,9,9,8,19,43,58,-15,35
Stenhousem'r,7827,10,8,10,18,49,78,-29,34
Livingston,7828,1,21,3,12,70,45,25,66
Brechin,7828,2,19,6,11,56,43,13,63
Airdrieon,7828,3,19,5,12,61,46,15,62
Alloa,7828,4,16,10,10,58,37,21,58
Albion,7828,5,14,12,10,53,41,12,54
Queen's Park,7828,6,15,6,15,37,43,-6,51
Peterhead,7828,7,11,9,16,43,53,-10,42
East Fife,7828,8,11,8,17,46,56,-10,41
Stranraer,7828,9,8,11,17,42,67,-25,35
Stenhousem'r,7828,10,7,8,21,47,82,-35,29
Livingston,7829,1,19,5,12,72,53,19,62
Alloa,7829,2,16,9,11,74,51,23,57
Airdrieon,7829,3,17,6,13,67,58,9,57
East Fife,7829,4,16,5,15,53,51,2,53
Brechin,7829,5,15,7,14,50,55,-5,52
Albion,7829,6,12,13,11,53,50,3,49
Stranraer,7829,7,14,6,16,53,59,-6,48
Queen's Park,7829,8,13,8,15,36,48,-12,47
Peterhead,7829,9,12,8,16,52,55,-3,44
Stenhousem'r,7829,10,7,11,18,47,77,-30,32
Livingston,7830,1,21,8,7,73,44,29,71
Alloa,7830,2,18,12,6,69,40,29,66
Brechin,7830,3,17,6,13,56,53,3,57
Airdrieon,7830,4,17,5,14,60,48,12,56
Albion,7830,5,14,9,13,53,55,-2,51
Peterhead,7830,6,13,7,16,50,56,-6,46
Stranraer,7830,7,12,7,17,50,58,-8,43
East Fife,7830,8,9,11,16,49,55,-6,38
Stenhousem'r,7830,9,11,5,20,54,83,-29,38
Queen's Park,7830,10,10,6,20,40,62,-22,36
Livingston,7831,1,21,2,13,77,56,21,65
Alloa,7831,2,19,6,11,65,46,19,63
Brechin,7831,3,19,6,11,54,38,16,63
Albion,7831,4,18,9,9,63,48,15,63
Peterhead,7831,5,15,8,13,45,43,2,53
Airdrieon,7831,6,16,4,16,54,56,-2,52
East Fife,7831,7,11,9,16,41,44,-3,42
Queen's Park,7831,8,11,7,18,37,59,-22,40
Stranraer,7831,9,12,3,21,51,62,-11,39
Stenhousem'r,7831,10,6,10,20,38,73,-35,28
Alloa,7832,1,21,6,9,66,38,28,69
Livingston,7832,2,21,5,10,78,53,25,68
Stranraer,7832,3,18,4,14,59,53,6,58
Brechin,7832,4,17,4,15,47,51,-4,55
Albion,7832,5,14,6,16,49,53,-4,48
Airdrieon,7832,6,13,7,16,52,56,-4,46
Queen's Park,7832,7,12,7,17,39,47,-8,43
Peterhead,7832,8,12,7,17,45,57,-12,43
East Fife,7832,9,10,11,15,47,52,-5,41
Stenhousem'r,7832,10,10,7,19,57,79,-22,37
Alloa,7833,1,21,6,9,65,40,25,69
Airdrieon,7833,2,17,8,11,59,55,4,59
Brechin,7833,3,15,7,14,53,52,1,52
Livingston,7833,4,15,5,16,63,50,13,50
East Fife,7833,5,14,8,14,52,47,5,50
Peterhead,7833,6,14,7,15,41,45,-4,49
Albion,7833,7,13,8,15,60,58,2,47
Queen's Park,7833,8,13,8,15,34,43,-9,47
Stranraer,7833,9,14,5,17,53,65,-12,47
Stenhousem'r,7833,10,10,6,20,43,68,-25,36
Alloa,7834,1,21,9,6,74,37,37,72
Livingston,7834,2,21,5,10,79,46,33,68
Airdrieon,7834,3,16,8,12,67,54,13,56
Queen's Park,7834,4,17,5,14,49,52,-3,56
Brechin,7834,5,15,9,12,50,53,-3,54
Albion,7834,6,12,9,15,50,54,-4,45
East Fife,7834,7,11,10,15,44,49,-5,43
Peterhead,7834,8,11,7,18,46,57,-11,40
Stranraer,7834,9,9,7,20,43,73,-30,34
Stenhousem'r,7834,10,7,11,18,52,79,-27,32
Livingston,7835,1,27,3,6,97,42,55,84
Alloa,7835,2,19,7,10,66,43,23,64
Airdrieon,7835,3,19,4,13,66,55,11,61
East Fife,7835,4,15,11,10,59,43,16,56
Brechin,7835,5,16,3,17,49,51,-2,51
Albion,7835,6,16,3,17,57,62,-5,51
Stranraer,7835,7,12,4,20,51,64,-13,40
Queen's Park,7835,8,10,8,18,43,58,-15,38
Peterhead,7835,9,9,11,16,44,69,-25,38
Stenhousem'r,7835,10,7,6,23,43,88,-45,27
Livingston,7836,1,23,1,12,82,46,36,70
Alloa,7836,2,20,5,11,72,50,22,65
Brechin,7836,3,17,8,11,50,43,7,59
Albion,7836,4,14,10,12,53,54,-1,52
Airdrieon,7836,5,13,9,14,54,57,-3,48
East Fife,7836,6,12,11,13,50,50,0,47
Peterhead,7836,7,12,8,16,44,51,-7,44
Stenhousem'r,7836,8,11,7,18,59,80,-21,40
Queen's Park,7836,9,12,4,20,38,64,-26,40
Stranraer,7836,10,10,9,17,53,60,-7,39
Livingston,7837,1,23,6,7,74,43,31,75
Brechin,7837,2,18,9,9,52,37,15,63
Alloa,7837,3,18,6,12,61,42,19,60
Airdrieon,7837,4,16,9,11,60,51,9,57
Peterhead,7837,5,16,8,12,49,51,-2,56
East Fife,7837,6,12,10,14,48,43,5,46
Stranraer,7837,7,11,5,20,49,66,-17,38
Albion,7837,8,10,7,19,51,64,-13,37
Queen's Park,7837,9,10,6,20,31,52,-21,36
Stenhousem'r,7837,10,7,12,17,47,73,-26,33
Livingston,7838,1,21,5,10,75,55,20,68
Alloa,7838,2,18,7,11,77,47,30,61
Peterhead,7838,3,16,9,11,53,46,7,57
Albion,7838,4,16,6,14,57,54,3,54
Queen's Park,7838,5,15,7,14,38,47,-9,52
Airdrieon,7838,6,15,5,16,58,61,-3,50
Brechin,7838,7,14,6,16,49,58,-9,48
Stranraer,7838,8,14,5,17,48,54,-6,47
East Fife,7838,9,11,9,16,47,51,-4,42
Stenhousem'r,7838,10,8,5,23,53,82,-29,29
Alloa,7839,1,18,12,6,78,37,41,66
Brechin,7839,2,17,9,10,55,39,16,60
Airdrieon,7839,3,16,8,12,62,47,15,56
Livingston,7839,4,16,7,13,65,45,20,55
East Fife,7839,5,12,12,12,47,45,2,48
Peterhead,7839,6,11,12,13,48,59,-11,45
Queen's Park,7839,7,10,14,12,33,48,-15,44
Albion,7839,8,11,9,16,50,59,-9,42
Stranraer,7839,9,12,5,19,50,71,-21,41
Stenhousem'r,7839,10,8,10,18,45,83,-38,34
Livingston,7840,1,21,5,10,80,47,33,68
Alloa,7840,2,19,8,9,68,48,20,65
Albion,7840,3,18,8,10,60,44,16,62
Airdrieon,7840,4,17,9,10,61,54,7,60
Brechin,7840,5,15,9,12,61,49,12,54
Stranraer,7840,6,14,5,17,52,54,-2,47
East Fife,7840,7,11,10,15,56,59,-3,43
Peterhead,7840,8,10,11,15,48,65,-17,41
Queen's Park,7840,9,11,7,18,43,61,-18,40
Stenhousem'r,7840,10,4,8,24,37,85,-48,20
Livingston,7841,1,22,2,12,73,43,30,68
Alloa,7841,2,19,9,8,72,41,31,66
Airdrieon,7841,3,16,8,12,53,54,-1,56
East Fife,7841,4,14,11,11,53,39,14,53
Brechin,7841,5,15,7,14,46,54,-8,52
Albion,7841,6,14,7,15,55,51,4,49
Peterhead,7841,7,13,9,14,50,56,-6,48
Stranraer,7841,8,12,7,17,46,62,-16,43
Queen's Park,7841,9,10,6,20,35,56,-21,36
Stenhousem'r,7841,10,9,6,21,50,77,-27,33
Alloa,7842,1,22,7,7,77,39,38,73
Brechin,7842,2,19,2,15,53,49,4,59
Albion,7842,3,15,9,12,63,47,16,54
Livingston,7842,4,17,3,16,68,55,13,54
Stranraer,7842,5,14,5,17,52,62,-10,47
Queen's Park,7842,6,12,11,13,41,56,-15,47
Airdrieon,7842,7,13,7,16,64,70,-6,46
Peterhead,7842,8,13,6,17,47,59,-12,45
Stenhousem'r,7842,9,12,6,18,50,78,-28,42
East Fife,7842,10,11,8,17,49,49,0,41
Alloa,7843,1,22,6,8,75,41,34,72
Livingston,7843,2,19,6,11,70,48,22,63
Airdrieon,7843,3,16,8,12,59,55,4,56
Brechin,7843,4,14,10,12,48,48,0,52
East Fife,7843,5,12,9,15,57,55,2,45
Albion,7843,6,12,8,16,54,55,-1,44
Peterhead,7843,7,11,11,14,42,57,-15,44
Stenhousem'r,7843,8,12,7,17,58,73,-15,43
Stranraer,7843,9,10,11,15,51,63,-12,41
Queen's Park,7843,10,10,8,18,35,54,-19,38
Alloa,7844,1,19,9,8,72,40,32,66
Brechin,7844,2,18,7,11,52,38,14,61
Airdrieon,7844,3,18,6,12,62,58,4,60
Livingston,7844,4,16,6,14,64,56,8,54
Albion,7844,5,15,9,12,52,48,4,54
East Fife,7844,6,12,11,13,54,52,2,47
Queen's Park,7844,7,12,9,15,36,47,-11,45
Peterhead,7844,8,11,11,14,48,55,-7,44
Stranraer,7844,9,12,4,20,47,60,-13,40
Stenhousem'r,7844,10,8,6,22,45,78,-33,30
Livingston,7845,1,23,6,7,80,44,36,75
Brechin,7845,2,20,7,9,50,42,8,67
Albion,7845,3,17,8,11,58,46,12,59
Alloa,7845,4,16,10,10,72,45,27,58
East Fife,7845,5,14,8,14,48,44,4,50
Stranraer,7845,6,13,5,18,49,60,-11,44
Peterhead,7845,7,12,7,17,39,50,-11,43
Airdrieon,7845,8,11,9,16,51,57,-6,42
Queen's Park,7845,9,10,9,17,32,50,-18,39
Stenhousem'r,7845,10,4,11,21,46,87,-41,23
Albion,7846,1,20,7,9,64,48,16,67
Alloa,7846,2,19,5,12,65,44,21,62
Livingston,7846,3,20,2,14,68,57,11,62
Airdrieon,7846,4,17,5,14,56,51,5,56
Brechin,7846,5,16,6,14,52,43,9,54
Stranraer,7846,6,14,7,15,58,57,1,49
East Fife,7846,7,12,7,17,51,56,-5,43
Queen's Park,7846,8,11,8,17,33,51,-18,41
Stenhousem'r,7846,9,11,6,19,48,70,-22,39
Peterhead,7846,10,11,5,20,42,60,-18,38
Livingston,7847,1,21,5,10,73,42,31,68
Alloa,7847,2,18,9,9,67,44,23,63
Brechin,7847,3,19,4,13,57,47,10,61
Airdrieon,7847,4,16,7,13,61,55,6,55
Peterhead,7847,5,13,11,12,48,53,-5,50
East Fife,7847,6,13,8,15,55,45,10,47
Queen's Park,7847,7,13,6,17,33,52,-19,45
Albion,7847,8,12,7,17,51,55,-4,43
Stranraer,7847,9,12,6,18,43,58,-15,42
Stenhousem'r,7847,10,7,9,20,41,78,-37,30
Livingston,7848,1,23,4,9,81,47,34,73
Brechin,7848,2,19,8,9,59,44,15,65
Alloa,7848,3,17,9,10,63,43,20,60
Peterhead,7848,4,16,7,13,52,57,-5,55
East Fife,7848,5,14,10,12,64,51,13,52
Airdrieon,7848,6,15,4,17,55,56,-1,49
Albion,7848,7,11,8,17,46,60,-14,41
Stranraer,7848,8,11,6,19,52,66,-14,39
Queen's Park,7848,9,11,5,20,36,58,-22,38
Stenhousem'r,7848,10,7,11,18,45,71,-26,32
Livingston,7849,1,21,5,10,72,45,27,68
Alloa,7849,2,18,8,10,69,47,22,62
Airdrieon,7849,3,17,10,9,60,48,12,61
Brechin,7849,4,17,5,14,45,41,4,56
Peterhead,7849,5,15,9,12,52,49,3,54
Albion,7849,6,14,8,14,48,47,1,50
East Fife,7849,7,13,9,14,51,51,0,48
Stranraer,7849,8,12,8,16,49,57,-8,44
Queen's Park,7849,9,9,7,20,29,51,-22,34
Stenhousem'r,7849,10,5,9,22,39,78,-39,24
Alloa,7850,1,21,4,11,73,49,24,67
Livingston,7850,2,18,5,13,68,57,11,59
Airdrieon,7850,3,18,5,13,63,57,6,59
Albion,7850,4,16,8,12,58,53,5,56
Queen's Park,7850,5,15,6,15,40,47,-7,51
Peterhead,7850,6,13,9,14,52,55,-3,48
East Fife,7850,7,13,8,15,48,44,4,47
Brechin,7850,8,12,10,14,47,50,-3,46
Stranraer,7850,9,13,6,17,58,62,-4,45
Stenhousem'r,7850,10,6,9,21,45,78,-33,27
Livingston,7851,1,22,6,8,90,46,44,72
Alloa,7851,2,19,8,9,71,46,25,65
Albion,7851,3,17,6,13,59,53,6,57
Airdrieon,7851,4,14,12,10,56,53,3,54
Brechin,7851,5,16,3,17,48,56,-8,51
Stranraer,7851,6,13,8,15,49,56,-7,47
East Fife,7851,7,12,10,14,53,45,8,46
Peterhead,7851,8,11,11,14,40,49,-9,44
Queen's Park,7851,9,10,10,16,40,62,-22,40
Stenhousem'r,7851,10,4,10,22,44,84,-40,22
Alloa,7852,1,22,6,8,80,40,40,72
Livingston,7852,2,19,8,9,72,46,26,65
Airdrieon,7852,3,18,8,10,68,57,11,62
Brechin,7852,4,16,3,17,57,68,-11,51
Peterhead,7852,5,14,8,14,44,44,0,50
Queen's Park,7852,6,13,6,17,42,59,-17,45
Stranraer,7852,7,12,8,16,46,50,-4,44
Albion,7852,8,10,12,14,51,56,-5,42
East Fife,7852,9,10,8,18,50,59,-9,38
Stenhousem'r,7852,10,9,7,20,55,86,-31,34
Airdrieon,7853,1,21,5,10,68,45,23,68
Brechin,7853,2,19,8,9,48,37,11,65
Livingston,7853,3,20,4,12,69,43,26,64
Alloa,7853,4,17,10,9,68,37,31,61
Queen's Park,7853,5,13,9,14,31,46,-15,48
East Fife,7853,6,12,9,15,54,47,7,45
Peterhead,7853,7,12,7,17,53,65,-12,43
Stenhousem'r,7853,8,9,11,16,46,80,-34,38
Albion,7853,9,8,11,17,43,61,-18,35
Stranraer,7853,10,8,8,20,38,57,-19,32
Livingston,7854,1,23,6,7,92,46,46,75
Alloa,7854,2,20,7,9,78,46,32,67
Brechin,7854,3,19,7,10,53,45,8,64
Airdrieon,7854,4,17,5,14,65,60,5,56
Albion,7854,5,14,10,12,66,55,11,52
East Fife,7854,6,10,11,15,54,52,2,41
Stranraer,7854,7,11,7,18,45,71,-26,40
Peterhead,7854,8,10,9,17,47,67,-20,39
Queen's Park,7854,9,9,10,17,41,64,-23,37
Stenhousem'r,7854,10,8,6,22,47,82,-35,30
Livingston,7855,1,23,2,11,79,44,35,71
Alloa,7855,2,18,7,11,63,49,14,61
Brechin,7855,3,16,7,13,53,50,3,55
Airdrieon,7855,4,17,3,16,62,72,-10,54
Peterhead,7855,5,15,6,15,57,59,-2,51
Albion,7855,6,14,8,14,57,52,5,50
Stranraer,7855,7,14,4,18,53,57,-4,46
Queen's Park,7855,8,13,7,16,38,45,-7,46
East Fife,7855,9,12,8,16,50,50,0,44
Stenhousem'r,7855,10,7,10,19,40,74,-34,31
Livingston,7856,1,23,6,7,86,37,49,75
Alloa,7856,2,20,4,12,68,47,21,64
Brechin,7856,3,19,5,12,53,48,5,62
Albion,7856,4,15,7,14,49,48,1,52
Peterhead,7856,5,14,6,16,51,57,-6,48
East Fife,7856,6,11,10,15,50,51,-1,43
Airdrieon,7856,7,12,7,17,44,59,-15,43
Queen's Park,7856,8,11,8,17,32,50,-18,41
Stenhousem'r,7856,9,9,12,15,52,71,-19,39
Stranraer,7856,10,11,5,20,44,61,-17,38
Alloa,7857,1,20,7,9,71,42,29,67
Airdrieon,7857,2,21,4,11,64,48,16,67
Livingston,7857,3,21,3,12,70,43,27,66
Brechin,7857,4,16,9,11,47,40,7,57
Queen's Park,7857,5,13,9,14,41,51,-10,48
East Fife,7857,6,12,10,14,48,45,3,46
Peterhead,7857,7,11,11,14,48,53,-5,44
Stranraer,7857,8,12,6,18,45,64,-19,42
Albion,7857,9,8,9,19,43,65,-22,33
Stenhousem'r,7857,10,6,12,18,47,73,-26,30
Livingston,7858,1,24,1,11,70,41,29,73
Airdrieon,7858,2,19,9,8,73,46,27,66
Alloa,7858,3,15,8,13,58,51,7,53
Brechin,7858,4,14,10,12,50,43,7,52
Albion,7858,5,11,14,11,54,53,1,47
East Fife,7858,6,11,11,14,49,49,0,44
Queen's Park,7858,7,12,8,16,37,51,-14,44
Peterhead,7858,8,12,6,18,41,53,-12,42
Stranraer,7858,9,12,5,19,51,64,-13,41
Stenhousem'r,7858,10,11,6,19,49,81,-32,39
Livingston,7859,1,23,4,9,87,53,34,73
Airdrieon,7859,2,20,6,10,63,47,16,66
Alloa,7859,3,18,8,10,67,42,25,62
Brechin,7859,4,19,4,13,65,49,16,61
Albion,7859,5,16,6,14,50,54,-4,54
East Fife,7859,6,14,9,13,58,53,5,51
Stranraer,7859,7,13,3,20,50,70,-20,42
Stenhousem'r,7859,8,9,8,19,51,79,-28,35
Queen's Park,7859,9,9,7,20,33,52,-19,34
Peterhead,7859,10,9,5,22,47,72,-25,32
Livingston,7860,1,22,3,11,75,49,26,69
Alloa,7860,2,20,8,8,76,42,34,68
Peterhead,7860,3,17,10,9,61,45,16,61
Airdrieon,7860,4,18,5,13,54,50,4,59
Brechin,7860,5,15,9,12,58,50,8,54
Stranraer,7860,6,15,2,19,47,57,-10,47
Albion,7860,7,12,6,18,50,60,-10,42
Queen's Park,7860,8,11,8,17,43,63,-20,41
East Fife,7860,9,11,6,19,53,61,-8,39
Stenhousem'r,7860,10,7,7,22,40,80,-40,28
Alloa,7861,1,19,7,10,71,45,26,64
Livingston,7861,2,20,2,14,75,56,19,62
Brechin,7861,3,18,7,11,57,43,14,61
Airdrieon,7861,4,18,7,11,65,56,9,61
Peterhead,7861,5,14,8,14,52,61,-9,50
Stranraer,7861,6,12,8,16,47,50,-3,44
East Fife,7861,7,11,10,15,51,50,1,43
Albion,7861,8,11,8,17,48,58,-10,41
Queen's Park,7861,9,11,6,19,31,54,-23,39
Stenhousem'r,7861,10,10,9,17,49,73,-24,39
Alloa,7862,1,22,9,5,75,40,35,75
Livingston,7862,2,21,6,9,75,44,31,69
Airdrieon,7862,3,18,7,11,61,48,13,61
Brechin,7862,4,16,7,13,46,44,2,55
East Fife,7862,5,13,12,11,53,47,6,51
Stranraer,7862,6,14,2,20,47,58,-11,44
Peterhead,7862,7,10,11,15,39,53,-14,41
Queen's Park,7862,8,10,8,18,38,57,-19,38
Albion,7862,9,9,10,17,45,56,-11,37
Stenhousem'r,7862,10,7,8,21,43,75,-32,29
Alloa,7863,1,22,8,6,72,40,32,74
Airdrieon,7863,2,20,6,10,62,49,13,66
Livingston,7863,3,18,6,12,75,54,21,60
Brechin,7863,4,17,5,14,47,37,10,56
Stranraer,7863,5,14,8,14,53,53,0,50
Albion,7863,6,14,5,17,53,59,-6,47
Queen's Park,7863,7,12,6,18,37,49,-12,42
East Fife,7863,8,10,10,16,46,52,-6,40
Peterhead,7863,9,10,8,18,45,56,-11,38
Stenhousem'r,7863,10,8,8,20,47,88,-41,32
Alloa,7864,1,20,7,9,74,48,26,67
Albion,7864,2,18,6,12,66,55,11,60
Livingston,7864,3,18,5,13,76,56,20,59
Airdrieon,7864,4,14,9,13,60,57,3,51
Stranraer,7864,5,15,5,16,51,53,-2,50
Peterhead,7864,6,14,7,15,57,55,2,49
Queen's Park,7864,7,14,7,15,41,53,-12,49
Brechin,7864,8,13,6,17,49,57,-8,45
East Fife,7864,9,12,7,17,57,56,1,43
Stenhousem'r,7864,10,10,5,21,49,90,-41,35
Alloa,7865,1,20,8,8,66,40,26,68
Livingston,7865,2,20,2,14,70,52,18,62
Airdrieon,7865,3,17,8,11,58,51,7,59
Queen's Park,7865,4,17,6,13,53,46,7,57
Albion,7865,5,16,9,11,53,52,1,57
Brechin,7865,6,14,7,15,51,56,-5,49
Peterhead,7865,7,12,10,14,52,54,-2,46
Stranraer,7865,8,10,11,15,53,57,-4,41
East Fife,7865,9,11,7,18,47,55,-8,40
Stenhousem'r,7865,10,5,8,23,47,87,-40,23
Alloa,7866,1,21,7,8,81,45,36,70
Livingston,7866,2,19,7,10,82,53,29,64
Airdrieon,7866,3,16,9,11,60,61,-1,57
Albion,7866,4,15,8,13,54,46,8,53
Brechin,7866,5,15,7,14,57,50,7,52
Queen's Park,7866,6,15,5,16,46,61,-15,50
Stranraer,7866,7,12,7,17,47,65,-18,43
Peterhead,7866,8,10,12,14,55,56,-1,42
East Fife,7866,9,9,12,15,47,56,-9,39
Stenhousem'r,7866,10,7,8,21,42,78,-36,29
Livingston,7867,1,21,3,12,85,60,25,66
Alloa,7867,2,17,8,11,64,47,17,59
Peterhead,7867,3,17,8,11,52,44,8,59
Airdrieon,7867,4,17,7,12,54,49,5,58
Brechin,7867,5,18,4,14,50,56,-6,58
East Fife,7867,6,12,11,13,51,49,2,47
Albion,7867,7,11,10,15,55,54,1,43
Queen's Park,7867,8,12,5,19,32,48,-16,41
Stranraer,7867,9,11,6,19,50,60,-10,39
Stenhousem'r,7867,10,9,8,19,48,74,-26,35
Livingston,7868,1,19,8,9,73,50,23,65
Brechin,7868,2,17,8,11,53,47,6,59
Airdrieon,7868,3,17,7,12,67,56,11,58
Queen's Park,7868,4,15,6,15,44,48,-4,51
Stranraer,7868,5,14,8,14,54,56,-2,50
Alloa,7868,6,12,12,12,60,53,7,48
Peterhead,7868,7,12,11,13,50,54,-4,47
East Fife,7868,8,11,10,15,47,43,4,43
Albion,7868,9,11,8,17,49,55,-6,41
Stenhousem'r,7868,10,9,8,19,48,83,-35,35
Livingston,7869,1,20,5,11,75,54,21,65
Alloa,7869,2,19,6,11,63,42,21,63
Brechin,7869,3,19,4,13,52,52,0,61
Airdrieon,7869,4,18,6,12,63,54,9,60
Albion,7869,5,15,7,14,56,55,1,52
Queen's Park,7869,6,14,7,15,47,50,-3,49
East Fife,7869,7,11,11,14,44,43,1,44
Stranraer,7869,8,12,8,16,51,60,-9,44
Peterhead,7869,9,11,7,18,46,56,-10,40
Stenhousem'r,7869,10,8,5,23,43,74,-31,29
Livingston,7870,1,22,6,8,79,49,30,72
Brechin,7870,2,19,5,12,53,43,10,62
Airdrieon,7870,3,15,12,9,62,52,10,57
Stranraer,7870,4,16,5,15,66,62,4,53
Alloa,7870,5,15,7,14,60,55,5,52
Albion,7870,6,12,13,11,60,57,3,49
Queen's Park,7870,7,13,6,17,39,48,-9,45
East Fife,7870,8,10,10,16,52,57,-5,40
Peterhead,7870,9,9,11,16,42,58,-16,38
Stenhousem'r,7870,10,6,11,19,41,73,-32,29
Livingston,7871,1,25,7,4,78,31,47,82
Albion,7871,2,19,8,9,56,43,13,65
Alloa,7871,3,17,9,10,60,43,17,60
Airdrieon,7871,4,18,4,14,53,56,-3,58
Brechin,7871,5,14,5,17,51,52,-1,47
Peterhead,7871,6,13,7,16,44,50,-6,46
Stranraer,7871,7,11,11,14,49,51,-2,44
East Fife,7871,8,11,9,16,43,45,-2,42
Queen's Park,7871,9,9,8,19,34,57,-23,35
Stenhousem'r,7871,10,6,6,24,44,84,-40,24
Livingston,7872,1,21,5,10,84,56,28,68
Alloa,7872,2,16,7,13,65,55,10,55
Albion,7872,3,15,10,11,54,48,6,55
Brechin,7872,4,17,4,15,44,42,2,55
Peterhead,7872,5,15,8,13,54,50,4,53
Airdrieon,7872,6,15,6,15,53,53,0,51
Queen's Park,7872,7,15,5,16,41,50,-9,50
Stenhousem'r,7872,8,13,6,17,49,71,-22,45
East Fife,7872,9,10,9,17,43,46,-3,39
Stranraer,7872,10,11,4,21,46,62,-16,37
Alloa,7873,1,19,11,6,71,34,37,68
Airdrieon,7873,2,20,8,8,67,48,19,68
Brechin,7873,3,16,9,11,54,47,7,57
Livingston,7873,4,17,4,15,64,42,22,55
Peterhead,7873,5,14,10,12,58,57,1,52
Albion,7873,6,13,8,15,52,53,-1,47
Queen's Park,7873,7,12,8,16,35,52,-17,44
East Fife,7873,8,10,12,14,44,54,-10,42
Stranraer,7873,9,9,7,20,45,64,-19,34
Stenhousem'r,7873,10,7,9,20,43,82,-39,30
Brechin,7874,1,22,4,10,63,44,19,70
Livingston,7874,2,22,2,12,75,50,25,68
Peterhead,7874,3,17,10,9,64,53,11,61
Airdrieon,7874,4,14,9,13,53,61,-8,51
Alloa,7874,5,12,12,12,61,52,9,48
Queen's Park,7874,6,11,10,15,34,49,-15,43
East Fife,7874,7,9,14,13,43,47,-4,41
Albion,7874,8,11,8,17,54,59,-5,41
Stranraer,7874,9,11,8,17,49,54,-5,41
Stenhousem'r,7874,10,10,5,21,52,79,-27,35
Livingston,7875,1,22,5,9,73,41,32,71
Alloa,7875,2,19,10,7,70,37,33,67
Airdrieon,7875,3,17,8,11,57,46,11,59
Peterhead,7875,4,15,8,13,55,54,1,53
Queen's Park,7875,5,15,7,14,39,49,-10,52
East Fife,7875,6,14,8,14,53,47,6,50
Brechin,7875,7,12,9,15,47,57,-10,45
Albion,7875,8,10,12,14,49,52,-3,42
Stenhousem'r,7875,9,10,3,23,52,87,-35,33
Stranraer,7875,10,8,6,22,37,62,-25,30
Alloa,7876,1,22,7,7,81,45,36,73
Livingston,7876,2,18,8,10,65,49,16,62
Airdrieon,7876,3,14,11,11,60,49,11,53
Brechin,7876,4,14,8,14,52,47,5,50
East Fife,7876,5,12,10,14,42,40,2,46
Stenhousem'r,7876,6,12,9,15,52,74,-22,45
Queen's Park,7876,7,12,8,16,36,59,-23,44
Albion,7876,8,10,13,13,45,52,-7,43
Peterhead,7876,9,10,10,16,39,46,-7,40
Stranraer,7876,10,10,8,18,48,59,-11,38
Livingston,7877,1,24,3,9,82,46,36,75
Alloa,7877,2,21,6,9,64,38,26,69
Airdrieon,7877,3,17,9,10,56,45,11,60
Brechin,7877,4,16,5,15,51,45,6,53
East Fife,7877,5,14,10,12,50,42,8,52
Peterhead,7877,6,14,7,15,51,53,-2,49
Albion,7877,7,11,8,17,43,56,-13,41
Queen's Park,7877,8,11,6,19,27,48,-21,39
Stenhousem'r,7877,9,10,8,18,52,80,-28,38
Stranraer,7877,10,9,4,23,39,62,-23,31
Livingston,7878,1,22,5,9,72,42,30,71
Alloa,7878,2,21,6,9,78,47,31,69
Airdrieon,7878,3,18,8,10,69,57,12,62
Brechin,7878,4,20,2,14,55,48,7,62
Peterhead,7878,5,14,9,13,48,49,-1,51
Albion,7878,6,14,8,14,58,57,1,50
Queen's Park,7878,7,14,4,18,41,59,-18,46
Stranraer,7878,8,12,6,18,52,61,-9,42
East Fife,7878,9,8,8,20,46,61,-15,32
Stenhousem'r,7878,10,7,4,25,42,80,-38,25
Livingston,7879,1,19,11,6,77,38,39,68
Alloa,7879,2,19,8,9,81,52,29,65
Albion,7879,3,18,8,10,65,56,9,62
Brechin,7879,4,18,4,14,62,53,9,58
Airdrieon,7879,5,16,9,11,57,56,1,57
Peterhead,7879,6,14,9,13,51,56,-5,51
East Fife,7879,7,9,11,16,49,57,-8,38
Stranraer,7879,8,9,8,19,49,73,-24,35
Queen's Park,7879,9,9,6,21,37,58,-21,33
Stenhousem'r,7879,10,8,8,20,54,83,-29,32
Livingston,7880,1,23,3,10,82,47,35,72
Peterhead,7880,2,17,7,12,50,45,5,58
Airdrieon,7880,3,16,7,13,56,59,-3,55
Alloa,7880,4,16,6,14,64,49,15,54
Brechin,7880,5,16,4,16,48,51,-3,52
Albion,7880,6,15,6,15,52,51,1,51
Queen's Park,7880,7,14,6,16,38,45,-7,48
East Fife,7880,8,12,10,14,47,45,2,46
Stenhousem'r,7880,9,9,11,16,46,64,-18,38
Stranraer,7880,10,10,4,22,46,73,-27,34
Alloa,7881,1,19,8,9,68,45,23,65
Livingston,7881,2,19,4,13,72,50,22,61
Airdrieon,7881,3,16,6,14,56,57,-1,54
Brechin,7881,4,14,11,11,45,44,1,53
Peterhead,7881,5,14,8,14,52,53,-1,50
Stenhousem'r,7881,6,12,11,13,52,66,-14,47
Queen's Park,7881,7,12,10,14,39,50,-11,46
Albion,7881,8,12,8,16,56,53,3,44
Stranraer,7881,9,12,7,17,49,61,-12,43
East Fife,7881,10,9,9,18,42,52,-10,36
Livingston,7882,1,17,8,11,75,51,24,59
Peterhead,7882,2,17,6,13,53,51,2,57
Alloa,7882,3,15,10,11,68,53,15,55
Queen's Park,7882,4,16,7,13,46,46,0,55
Albion,7882,5,15,9,12,53,45,8,54
Airdrieon,7882,6,15,8,13,59,59,0,53
Brechin,7882,7,14,9,13,49,51,-2,51
Stranraer,7882,8,10,11,15,53,64,-11,41
East Fife,7882,9,10,8,18,47,50,-3,38
Stenhousem'r,7882,10,7,12,17,38,71,-33,33
Alloa,7883,1,20,8,8,73,42,31,68
Brechin,7883,2,18,7,11,50,44,6,61
Airdrieon,7883,3,18,6,12,69,57,12,60
Livingston,7883,4,17,5,14,71,53,18,56
Albion,7883,5,15,11,10,59,42,17,56
Peterhead,7883,6,14,12,10,57,55,2,54
Queen's Park,7883,7,16,6,14,44,49,-5,54
Stranraer,7883,8,9,4,23,38,63,-25,31
Stenhousem'r,7883,9,7,10,19,52,87,-35,31
East Fife,7883,10,7,9,20,43,64,-21,30
Alloa,7884,1,21,9,6,72,43,29,72
Livingston,7884,2,21,4,11,78,45,33,67
Airdrieon,7884,3,19,8,9,63,50,13,65
Brechin,7884,4,13,9,14,52,48,4,48
East Fife,7884,5,13,9,14,50,47,3,48
Queen's Park,7884,6,13,7,16,39,50,-11,46
Stranraer,7884,7,12,8,16,60,65,-5,44
Peterhead,7884,8,11,9,16,38,54,-16,42
Albion,7884,9,9,9,18,48,61,-13,36
Stenhousem'r,7884,10,9,6,21,51,88,-37,33
Livingston,7885,1,21,4,11,79,50,29,67
Airdrieon,7885,2,17,8,11,59,48,11,59
Brechin,7885,3,17,6,13,53,52,1,57
Albion,7885,4,15,9,12,54,49,5,54
Alloa,7885,5,15,8,13,72,55,17,53
Peterhead,7885,6,13,9,14,49,59,-10,48
Queen's Park,7885,7,13,8,15,41,46,-5,47
Stranraer,7885,8,12,9,15,45,49,-4,45
East Fife,7885,9,12,8,16,55,56,-1,44
Stenhousem'r,7885,10,7,7,22,51,94,-43,28
Alloa,7886,1,22,5,9,82,43,39,71
Livingston,7886,2,21,4,11,77,48,29,67
Airdrieon,7886,3,20,5,11,71,52,19,65
Brechin,7886,4,15,5,16,60,54,6,50
Peterhead,7886,5,15,5,16,46,55,-9,50
Albion,7886,6,13,7,16,47,53,-6,46
Queen's Park,7886,7,12,9,15,44,63,-19,45
Stranraer,7886,8,12,6,18,44,63,-19,42
East Fife,7886,9,10,8,18,48,55,-7,38
Stenhousem'r,7886,10,8,10,18,47,80,-33,34
Livingston,7887,1,23,3,10,80,45,35,72
Alloa,7887,2,20,6,10,76,47,29,66
Brechin,7887,3,19,3,14,58,50,8,60
Albion,7887,4,15,8,13,55,51,4,53
Stranraer,7887,5,16,3,17,57,61,-4,51
East Fife,7887,6,14,8,14,61,56,5,50
Airdrieon,7887,7,14,8,14,60,69,-9,50
Peterhead,7887,8,12,6,18,44,57,-13,42
Queen's Park,7887,9,10,4,22,27,54,-27,34
Stenhousem'r,7887,10,9,7,20,47,75,-28,34
Livingston,7888,1,24,1,11,82,48,34,73
Alloa,7888,2,18,10,8,69,42,27,64
Queen's Park,7888,3,18,3,15,39,46,-7,57
Peterhead,7888,4,16,5,15,49,52,-3,53
Airdrieon,7888,5,15,7,14,56,58,-2,52
Brechin,7888,6,14,8,14,40,43,-3,50
Albion,7888,7,13,6,17,67,62,5,45
East Fife,7888,8,11,11,14,48,49,-1,44
Stranraer,7888,9,10,7,19,45,62,-17,37
Stenhousem'r,7888,10,9,6,21,48,81,-33,33
Alloa,7889,1,18,11,7,68,39,29,65
Livingston,7889,2,19,6,11,72,47,25,63
Brechin,7889,3,18,6,12,49,41,8,60
Airdrieon,7889,4,16,7,13,57,60,-3,55
Albion,7889,5,13,11,12,53,59,-6,50
Peterhead,7889,6,13,7,16,54,56,-2,46
Queen's Park,7889,7,12,9,15,34,47,-13,45
East Fife,7889,8,12,8,16,53,49,4,44
Stranraer,7889,9,12,8,16,53,58,-5,44
Stenhousem'r,7889,10,6,9,21,42,79,-37,27
Alloa,7890,1,23,5,8,75,37,38,74
Livingston,7890,2,20,6,10,73,44,29,66
Albion,7890,3,15,10,11,51,40,11,55
Stranraer,7890,4,15,6,15,48,58,-10,51
Airdrieon,7890,5,15,5,16,54,64,-10,50
Brechin,7890,6,15,4,17,52,55,-3,49
Peterhead,7890,7,13,10,13,48,52,-4,49
Queen's Park,7890,8,12,8,16,32,49,-17,44
East Fife,7890,9,11,8,17,46,51,-5,41
Stenhousem'r,7890,10,8,4,24,46,75,-29,28
Livingston,7891,1,23,5,8,87,48,39,74
Alloa,7891,2,16,10,10,65,48,17,58
Brechin,7891,3,17,6,13,52,45,7,57
Airdrieon,7891,4,17,6,13,60,56,4,57
Albion,7891,5,15,6,15,61,60,1,51
Peterhead,7891,6,14,7,15,55,54,1,49
Queen's Park,7891,7,13,6,17,36,50,-14,45
East Fife,7891,8,11,11,14,55,54,1,44
Stranraer,7891,9,11,5,20,51,67,-16,38
Stenhousem'r,7891,10,8,8,20,51,91,-40,32
Livingston,7892,1,25,6,5,90,49,41,81
Alloa,7892,2,20,9,7,66,36,30,69
Airdrieon,7892,3,18,8,10,68,50,18,62
Brechin,7892,4,14,7,15,46,54,-8,49
Stranraer,7892,5,13,7,16,52,54,-2,46
East Fife,7892,6,12,9,15,53,56,-3,45
Albion,7892,7,10,13,13,43,46,-3,43
Peterhead,7892,8,11,7,18,38,54,-16,40
Queen's Park,7892,9,10,7,19,39,64,-25,37
Stenhousem'r,7892,10,8,5,23,46,78,-32,29
Livingston,7893,1,23,6,7,87,44,43,75
Alloa,7893,2,19,7,10,67,42,25,64
Brechin,7893,3,18,7,11,63,44,19,61
Airdrieon,7893,4,18,5,13,63,66,-3,59
Queen's Park,7893,5,12,12,12,43,51,-8,48
East Fife,7893,6,11,11,14,52,53,-1,44
Peterhead,7893,7,11,9,16,51,64,-13,42
Albion,7893,8,11,8,17,57,59,-2,41
Stenhousem'r,7893,9,9,8,19,49,80,-31,35
Stranraer,7893,10,9,5,22,41,70,-29,32
Livingston,7894,1,23,2,11,85,54,31,71
Alloa,7894,2,18,10,8,68,42,26,64
Brechin,7894,3,19,5,12,60,51,9,62
Queen's Park,7894,4,16,6,14,39,41,-2,54
Peterhead,7894,5,15,8,13,55,60,-5,53
Airdrieon,7894,6,15,6,15,54,57,-3,51
Albion,7894,7,13,5,18,55,58,-3,44
Stranraer,7894,8,13,3,20,50,67,-17,42
East Fife,7894,9,9,13,14,57,55,2,40
Stenhousem'r,7894,10,6,8,22,49,87,-38,26
Livingston,7895,1,21,6,9,71,47,24,69
Alloa,7895,2,18,9,9,66,48,18,63
Peterhead,7895,3,17,8,11,55,44,11,59
Airdrieon,7895,4,17,8,11,59,50,9,59
Brechin,7895,5,16,6,14,43,38,5,54
East Fife,7895,6,13,12,11,53,37,16,51
Albion,7895,7,12,9,15,49,50,-1,45
Stranraer,7895,8,11,6,19,52,60,-8,39
Queen's Park,7895,9,9,8,19,34,62,-28,35
Stenhousem'r,7895,10,6,8,22,37,83,-46,26
Alloa,7896,1,21,7,8,76,47,29,70
Livingston,7896,2,18,7,11,77,49,28,61
Albion,7896,3,15,8,13,66,59,7,53
Queen's Park,7896,4,15,6,15,49,56,-7,51
Brechin,7896,5,13,11,12,51,48,3,50
East Fife,7896,6,14,6,16,47,46,1,48
Airdrieon,7896,7,13,9,14,52,61,-9,48
Peterhead,7896,8,13,9,14,50,59,-9,48
Stranraer,7896,9,12,6,18,47,60,-13,42
Stenhousem'r,7896,10,8,7,21,45,75,-30,31
Alloa,7897,1,20,8,8,74,51,23,68
Livingston,7897,2,20,5,11,66,38,28,65
Brechin,7897,3,17,8,11,60,48,12,59
Airdrieon,7897,4,18,4,14,58,44,14,58
Albion,7897,5,14,10,12,53,48,5,52
East Fife,7897,6,14,9,13,54,51,3,51
Peterhead,7897,7,13,8,15,49,53,-4,47
Stranraer,7897,8,13,4,19,45,62,-17,43
Queen's Park,7897,9,10,9,17,40,64,-24,39
Stenhousem'r,7897,10,4,9,23,41,81,-40,21
Livingston,7898,1,21,4,11,67,45,22,67
Alloa,7898,2,18,9,9,66,42,24,63
Airdrieon,7898,3,18,9,9,65,51,14,63
Stranraer,7898,4,16,6,14,61,50,11,54
Albion,7898,5,11,15,10,50,52,-2,48
Brechin,7898,6,13,6,17,48,52,-4,45
Peterhead,7898,7,12,8,16,47,58,-11,44
East Fife,7898,8,10,12,14,54,53,1,42
Queen's Park,7898,9,11,9,16,38,54,-16,42
Stenhousem'r,7898,10,6,10,20,43,82,-39,28
Livingston,7899,1,19,8,9,83,51,32,65
Alloa,7899,2,19,7,10,67,45,22,64
Brechin,7899,3,18,6,12,53,55,-2,60
Albion,7899,4,15,9,12,58,47,11,54
Queen's Park,7899,5,15,7,14,50,53,-3,52
Peterhead,7899,6,14,9,13,45,48,-3,51
Airdrieon,7899,7,13,9,14,55,54,1,48
Stenhousem'r,7899,8,10,9,17,52,77,-25,39
East Fife,7899,9,9,8,19,50,67,-17,35
Stranraer,7899,10,10,4,22,43,59,-16,34
Livingston,7900,1,20,6,10,74,48,26,66
Brechin,7900,2,19,4,13,48,41,7,61
Airdrieon,7900,3,17,9,10,60,50,10,60
Albion,7900,4,15,11,10,52,47,5,56
Alloa,7900,5,14,9,13,59,48,11,51
Stranraer,7900,6,13,8,15,55,58,-3,47
Queen's Park,7900,7,12,8,16,34,51,-17,44
Peterhead,7900,8,11,10,15,47,59,-12,43
East Fife,7900,9,9,12,15,48,51,-3,39
Stenhousem'r,7900,10,8,7,21,48,72,-24,31
Livingston,7901,1,20,7,9,71,44,27,67
Alloa,7901,2,19,7,10,68,41,27,64
Airdrieon,7901,3,16,9,11,67,60,7,57
Brechin,7901,4,15,8,13,50,52,-2,53
East Fife,7901,5,13,12,11,50,39,11,51
Queen's Park,7901,6,13,7,16,38,48,-10,46
Albion,7901,7,12,8,16,49,59,-10,44
Peterhead,7901,8,11,10,15,43,53,-10,43
Stranraer,7901,9,11,7,18,49,58,-9,40
Stenhousem'r,7901,10,8,9,19,46,77,-31,33
Alloa,7902,1,19,5,12,81,56,25,62
Livingston,7902,2,19,5,12,73,56,17,62
East Fife,7902,3,15,11,10,52,40,12,56
Airdrieon,7902,4,16,8,12,58,57,1,56
Albion,7902,5,15,10,11,66,56,10,55
Queen's Park,7902,6,14,7,15,43,52,-9,49
Peterhead,7902,7,13,9,14,42,45,-3,48
Brechin,7902,8,14,4,18,42,50,-8,46
Stranraer,7902,9,13,6,17,54,60,-6,45
Stenhousem'r,7902,10,6,7,23,39,78,-39,25
Livingston,7903,1,19,6,11,68,51,17,63
Brechin,7903,2,19,5,12,52,44,8,62
Airdrieon,7903,3,18,6,12,57,56,1,60
Alloa,7903,4,16,10,10,65,47,18,58
Queen's Park,7903,5,17,4,15,40,38,2,55
East Fife,7903,6,14,9,13,51,50,1,51
Peterhead,7903,7,13,9,14,57,55,2,48
Albion,7903,8,12,10,14,48,50,-2,46
Stranraer,7903,9,12,8,16,49,51,-2,44
Stenhousem'r,7903,10,4,5,27,40,85,-45,17
Livingston,7904,1,20,7,9,82,53,29,67
Brechin,7904,2,19,8,9,53,42,11,65
Alloa,7904,3,17,8,11,68,44,24,59
Airdrieon,7904,4,14,9,13,56,60,-4,51
Peterhead,7904,5,14,7,15,57,54,3,49
Queen's Park,7904,6,12,10,14,39,50,-11,46
Stranraer,7904,7,11,11,14,40,48,-8,44
East Fife,7904,8,11,10,15,42,43,-1,43
Albion,7904,9,11,8,17,46,58,-12,41
Stenhousem'r,7904,10,6,12,18,43,74,-31,30
Livingston,7905,1,20,6,10,86,55,31,66
Albion,7905,2,18,10,8,76,46,30,64
Airdrieon,7905,3,18,4,14,55,58,-3,58
Alloa,7905,4,15,9,12,69,52,17,54
Brechin,7905,5,16,6,14,51,64,-13,54
Queen's Park,7905,6,14,6,16,34,42,-8,48
Stranraer,7905,7,14,4,18,57,63,-6,46
East Fife,7905,8,11,12,13,52,50,2,45
Peterhead,7905,9,11,6,19,51,65,-14,39
Stenhousem'r,7905,10,9,5,22,51,87,-36,32
Livingston,7906,1,18,9,9,71,42,29,63
Airdrieon,7906,2,18,8,10,66,50,16,62
Alloa,7906,3,17,7,12,72,53,19,58
Peterhead,7906,4,15,8,13,60,54,6,53
Queen's Park,7906,5,15,6,15,37,49,-12,51
Brechin,7906,6,13,10,13,46,51,-5,49
Albion,7906,7,13,10,13,52,58,-6,49
Stranraer,7906,8,14,3,19,48,53,-5,45
East Fife,7906,9,10,13,13,47,48,-1,43
Stenhousem'r,7906,10,6,8,22,43,84,-41,26
Alloa,7907,1,21,8,7,69,35,34,71
Albion,7907,2,18,7,11,60,48,12,61
Livingston,7907,3,17,5,14,63,44,19,56
Brechin,7907,4,16,8,12,51,44,7,56
East Fife,7907,5,13,10,13,50,50,0,49
Peterhead,7907,6,12,9,15,46,55,-9,45
Queen's Park,7907,7,12,8,16,38,51,-13,44
Airdrieon,7907,8,11,9,16,53,65,-12,42
Stranraer,7907,9,11,7,18,46,60,-14,40
Stenhousem'r,7907,10,9,9,18,45,69,-24,36
Brechin,7908,1,24,5,7,67,44,23,77
Livingston,7908,2,21,3,12,68,47,21,66
Alloa,7908,3,17,13,6,62,32,30,64
Airdrieon,7908,4,15,10,11,55,50,5,55
East Fife,7908,5,13,9,14,45,43,2,48
Albion,7908,6,12,10,14,51,52,-1,46
Peterhead,7908,7,10,11,15,44,55,-11,41
Stenhousem'r,7908,8,10,7,19,52,77,-25,37
Stranraer,7908,9,9,8,19,43,57,-14,35
Queen's Park,7908,10,8,6,22,34,64,-30,30
Livingston,7909,1,23,4,9,90,46,44,73
Alloa,7909,2,21,6,9,84,44,40,69
Airdrieon,7909,3,19,5,12,56,50,6,62
Queen's Park,7909,4,14,8,14,38,45,-7,50
Peterhead,7909,5,14,6,16,52,57,-5,48
Brechin,7909,6,14,6,16,51,64,-13,48
Albion,7909,7,12,7,17,54,69,-15,43
East Fife,7909,8,10,11,15,52,58,-6,41
Stranraer,7909,9,12,3,21,46,62,-16,39
Stenhousem'r,7909,10,10,6,20,49,77,-28,36
Alloa,7910,1,20,4,12,73,50,23,64
Livingston,7910,2,20,2,14,72,45,27,62
Airdrieon,7910,3,15,9,12,57,60,-3,54
Peterhead,7910,4,15,7,14,60,53,7,52
Queen's Park,7910,5,14,10,12,37,47,-10,52
East Fife,7910,6,14,9,13,53,43,10,51
Albion,7910,7,14,7,15,50,50,0,49
Brechin,7910,8,15,3,18,48,63,-15,48
Stranraer,7910,9,10,11,15,41,48,-7,41
Stenhousem'r,7910,10,10,4,22,51,83,-32,34
Alloa,7911,1,22,4,10,73,43,30,70
Livingston,7911,2,21,4,11,73,44,29,67
Brechin,7911,3,19,9,8,54,35,19,66
Airdrieon,7911,4,15,7,14,56,56,0,52
Albion,7911,5,14,8,14,51,50,1,50
East Fife,7911,6,11,11,14,47,43,4,44
Queen's Park,7911,7,12,8,16,34,52,-18,44
Stranraer,7911,8,13,4,19,50,62,-12,43
Peterhead,7911,9,11,9,16,48,55,-7,42
Stenhousem'r,7911,10,7,6,23,39,85,-46,27
Livingston,7912,1,21,7,8,75,42,33,70
Alloa,7912,2,19,8,9,64,43,21,65
Stranraer,7912,3,18,4,14,50,43,7,58
Brechin,7912,4,15,7,14,48,48,0,52
Airdrieon,7912,5,13,12,11,58,58,0,51
Queen's Park,7912,6,13,10,13,45,49,-4,49
East Fife,7912,7,10,11,15,50,52,-2,41
Albion,7912,8,10,10,16,53,65,-12,40
Peterhead,7912,9,10,10,16,40,53,-13,40
Stenhousem'r,7912,10,9,5,22,50,80,-30,32
Livingston,7913,1,20,5,11,76,47,29,65
Brechin,7913,2,15,15,6,49,36,13,60
Alloa,7913,3,16,9,11,69,55,14,57
Albion,7913,4,15,8,13,58,58,0,53
Peterhead,7913,5,14,7,15,60,64,-4,49
Stranraer,7913,6,14,6,16,56,55,1,48
Airdrieon,7913,7,12,10,14,60,71,-11,46
Queen's Park,7913,8,10,13,13,39,51,-12,43
Stenhousem'r,7913,9,11,9,16,49,70,-21,42
East Fife,7913,10,7,10,19,47,56,-9,31
Livingston,7914,1,19,10,7,68,44,24,67
Airdrieon,7914,2,19,8,9,57,46,11,65
Brechin,7914,3,17,9,10,50,46,4,60
East Fife,7914,4,14,7,15,60,49,11,49
Peterhead,7914,5,13,8,15,54,50,4,47
Alloa,7914,6,13,7,16,54,47,7,46
Queen's Park,7914,7,12,10,14,43,51,-8,46
Stranraer,7914,8,14,4,18,50,63,-13,46
Albion,7914,9,9,14,13,51,51,0,41
Stenhousem'r,7914,10,7,9,20,40,80,-40,30
Alloa,7915,1,20,8,8,72,35,37,68
Livingston,7915,2,20,7,9,71,49,22,67
Airdrieon,7915,3,20,5,11,69,54,15,65
Brechin,7915,4,16,8,12,50,48,2,56
Albion,7915,5,12,12,12,46,44,2,48
Queen's Park,7915,6,14,6,16,37,50,-13,48
Stranraer,7915,7,12,10,14,48,53,-5,46
East Fife,7915,8,12,7,17,51,55,-4,43
Peterhead,7915,9,11,5,20,45,60,-15,38
Stenhousem'r,7915,10,5,8,23,42,83,-41,23
Livingston,7916,1,24,2,10,90,50,40,74
Alloa,7916,2,19,7,10,74,48,26,64
Airdrieon,7916,3,19,4,13,63,58,5,61
Peterhead,7916,4,15,8,13,56,60,-4,53
Queen's Park,7916,5,13,8,15,48,56,-8,47
Brechin,7916,6,14,5,17,46,55,-9,47
Albion,7916,7,13,7,16,54,54,0,46
East Fife,7916,8,11,11,14,51,51,0,44
Stranraer,7916,9,11,5,20,53,69,-16,38
Stenhousem'r,7916,10,8,9,19,47,81,-34,33
Livingston,7917,1,20,4,12,76,44,32,64
Alloa,7917,2,18,8,10,67,49,18,62
Brechin,7917,3,18,8,10,59,41,18,62
Queen's Park,7917,4,17,7,12,44,49,-5,58
Airdrieon,7917,5,17,5,14,52,54,-2,56
Stranraer,7917,6,14,6,16,56,59,-3,48
Peterhead,7917,7,13,8,15,51,51,0,47
Albion,7917,8,13,6,17,49,50,-1,45
East Fife,7917,9,9,13,14,40,45,-5,40
Stenhousem'r,7917,10,6,5,25,42,94,-52,23
Livingston,7918,1,22,4,10,88,54,34,70
Alloa,7918,2,17,9,10,80,45,35,60
Albion,7918,3,17,6,13,57,50,7,57
Brechin,7918,4,16,5,15,47,57,-10,53
Airdrieon,7918,5,15,7,14,59,59,0,52
Stranraer,7918,6,13,6,17,46,55,-9,45
Peterhead,7918,7,12,9,15,41,56,-15,45
East Fife,7918,8,11,10,15,46,48,-2,43
Queen's Park,7918,9,11,8,17,39,51,-12,41
Stenhousem'r,7918,10,11,6,19,50,78,-28,39
Livingston,7919,1,24,2,10,81,42,39,74
Alloa,7919,2,20,5,11,72,45,27,65
Airdrieon,7919,3,18,6,12,63,54,9,60
Brechin,7919,4,16,4,16,45,52,-7,52
Albion,7919,5,14,6,16,55,57,-2,48
Stranraer,7919,6,14,6,16,57,60,-3,48
Stenhousem'r,7919,7,12,9,15,52,74,-22,45
Peterhead,7919,8,10,10,16,42,56,-14,40
East Fife,7919,9,11,6,19,51,56,-5,39
Queen's Park,7919,10,11,6,19,45,67,-22,39
Livingston,7920,1,22,7,7,84,47,37,73
Alloa,7920,2,20,6,10,69,39,30,66
Albion,7920,3,18,7,11,65,49,16,61
Brechin,7920,4,15,6,15,42,44,-2,51
East Fife,7920,5,14,7,15,56,47,9,49
Queen's Park,7920,6,14,6,16,37,50,-13,48
Stranraer,7920,7,12,6,18,54,71,-17,42
Airdrieon,7920,8,11,8,17,49,68,-19,41
Peterhead,7920,9,11,7,18,42,59,-17,40
Stenhousem'r,7920,10,9,8,19,47,71,-24,35
Alloa,7921,1,18,11,7,76,40,36,65
Stranraer,7921,2,17,7,12,56,47,9,58
Livingston,7921,3,18,3,15,67,56,11,57
Airdrieon,7921,4,16,8,12,58,50,8,56
Peterhead,7921,5,16,7,13,49,46,3,55
Brechin,7921,6,15,8,13,44,46,-2,53
Queen's Park,7921,7,13,10,13,40,45,-5,49
Albion,7921,8,10,9,17,48,63,-15,39
East Fife,7921,9,9,9,18,40,54,-14,36
Stenhousem'r,7921,10,8,8,20,47,78,-31,32
Livingston,7922,1,18,10,8,77,45,32,64
Alloa,7922,2,17,12,7,71,46,25,63
Peterhead,7922,3,17,8,11,55,51,4,59
Brechin,7922,4,15,11,10,48,40,8,56
Stranraer,7922,5,14,5,17,66,71,-5,47
Airdrieon,7922,6,13,8,15,56,67,-11,47
Albion,7922,7,11,12,13,53,54,-1,45
Queen's Park,7922,8,11,11,14,36,52,-16,44
East Fife,7922,9,9,11,16,49,54,-5,38
Stenhousem'r,7922,10,8,6,22,48,79,-31,30
Livingston,7923,1,22,4,10,75,50,25,70
Alloa,7923,2,20,7,9,76,42,34,67
Albion,7923,3,19,6,11,61,45,16,63
Peterhead,7923,4,14,9,13,52,60,-8,51
Airdrieon,7923,5,14,5,17,50,53,-3,47
Brechin,7923,6,13,8,15,43,50,-7,47
East Fife,7923,7,12,10,14,44,45,-1,46
Queen's Park,7923,8,13,6,17,41,56,-15,45
Stranraer,7923,9,13,3,20,54,63,-9,42
Stenhousem'r,7923,10,8,6,22,54,86,-32,30
Livingston,7924,1,27,2,7,91,39,52,83
Airdrieon,7924,2,20,6,10,61,46,15,66
Alloa,7924,3,17,6,13,63,53,10,57
Brechin,7924,4,16,7,13,46,48,-2,55
Stranraer,7924,5,15,3,18,51,54,-3,48
Albion,7924,6,13,9,14,48,54,-6,48
Peterhead,7924,7,12,8,16,49,55,-6,44
East Fife,7924,8,11,9,16,52,47,5,42
Queen's Park,7924,9,10,9,17,31,49,-18,39
Stenhousem'r,7924,10,6,7,23,40,87,-47,25
Livingston,7925,1,23,5,8,82,44,38,74
Alloa,7925,2,19,11,6,70,34,36,68
Brechin,7925,3,19,6,11,53,39,14,63
Airdrieon,7925,4,14,8,14,51,52,-1,50
Albion,7925,5,13,9,14,53,58,-5,48
Peterhead,7925,6,13,7,16,50,59,-9,46
Queen's Park,7925,7,10,11,15,36,49,-13,41
Stranraer,7925,8,11,7,18,44,57,-13,40
East Fife,7925,9,10,9,17,46,53,-7,39
Stenhousem'r,7925,10,6,11,19,38,78,-40,29
Livingston,7926,1,24,3,9,81,48,33,75
Airdrieon,7926,2,18,8,10,61,49,12,62
Alloa,7926,3,18,5,13,68,47,21,59
Brechin,7926,4,17,4,15,56,54,2,55
East Fife,7926,5,15,7,14,57,48,9,52
Stranraer,7926,6,14,6,16,58,59,-1,48
Peterhead,7926,7,13,8,15,45,55,-10,47
Queen's Park,7926,8,13,7,16,38,52,-14,46
Albion,7926,9,12,8,16,53,53,0,44
Stenhousem'r,7926,10,5,6,25,40,92,-52,21
Livingston,7927,1,21,6,9,86,44,42,69
Alloa,7927,2,17,9,10,67,46,21,60
Brechin,7927,3,18,3,15,52,50,2,57
Queen's Park,7927,4,16,7,13,47,54,-7,55
Airdrieon,7927,5,14,10,12,53,51,2,52
East Fife,7927,6,14,7,15,52,46,6,49
Albion,7927,7,13,8,15,49,56,-7,47
Peterhead,7927,8,9,12,15,45,53,-8,39
Stranraer,7927,9,9,10,17,43,61,-18,37
Stenhousem'r,7927,10,8,10,18,48,81,-33,34
Livingston,7928,1,20,6,10,81,46,35,66
Alloa,7928,2,18,9,9,70,42,28,63
Brechin,7928,3,14,10,12,47,51,-4,52
Queen's Park,7928,4,15,7,14,40,58,-18,52
Albion,7928,5,15,6,15,57,60,-3,51
Peterhead,7928,6,15,6,15,45,49,-4,51
Airdrieon,7928,7,13,10,13,53,57,-4,49
East Fife,7928,8,12,12,12,54,39,15,48
Stranraer,7928,9,11,6,19,46,56,-10,39
Stenhousem'r,7928,10,7,8,21,48,83,-35,29
Peterhead,7929,1,20,6,10,69,48,21,66
Brechin,7929,2,17,9,10,51,41,10,60
Airdrieon,7929,3,16,9,11,57,58,-1,57
Livingston,7929,4,16,6,14,73,65,8,54
Alloa,7929,5,13,13,10,67,49,18,52
East Fife,7929,6,13,11,12,63,47,16,50
Albion,7929,7,13,8,15,57,65,-8,47
Queen's Park,7929,8,12,9,15,33,48,-15,45
Stranraer,7929,9,10,9,17,58,62,-4,39
Stenhousem'r,7929,10,6,8,22,42,87,-45,26
Airdrieon,7930,1,20,5,11,62,46,16,65
Livingston,7930,2,18,6,12,71,51,20,60
Alloa,7930,3,17,7,12,64,49,15,58
Brechin,7930,4,16,6,14,46,44,2,54
Peterhead,7930,5,13,8,15,45,49,-4,47
Albion,7930,6,12,9,15,48,52,-4,45
Stranraer,7930,7,13,6,17,54,59,-5,45
Queen's Park,7930,8,12,8,16,43,59,-16,44
East Fife,7930,9,10,12,14,48,48,0,42
Stenhousem'r,7930,10,11,9,16,50,74,-24,42
Livingston,7931,1,19,11,6,77,44,33,68
Alloa,7931,2,17,8,11,70,43,27,59
Peterhead,7931,3,16,7,13,47,47,0,55
Albion,7931,4,14,10,12,50,52,-2,52
East Fife,7931,5,13,11,12,53,46,7,50
Brechin,7931,6,14,6,16,51,55,-4,48
Airdrieon,7931,7,14,6,16,50,55,-5,48
Queen's Park,7931,8,11,10,15,30,40,-10,43
Stranraer,7931,9,12,7,17,52,70,-18,43
Stenhousem'r,7931,10,9,6,21,50,78,-28,33
Livingston,7932,1,22,4,10,79,43,36,70
Alloa,7932,2,20,7,9,82,47,35,67
Airdrieon,7932,3,16,7,13,58,59,-1,55
Peterhead,7932,4,15,5,16,47,53,-6,50
Brechin,7932,5,13,9,14,48,50,-2,48
Stranraer,7932,6,13,8,15,52,62,-10,47
East Fife,7932,7,11,12,13,45,47,-2,45
Queen's Park,7932,8,12,9,15,34,47,-13,45
Albion,7932,9,11,9,16,53,60,-7,42
Stenhousem'r,7932,10,9,6,21,52,82,-30,33
Alloa,7933,1,21,8,7,75,44,31,71
Livingston,7933,2,22,4,10,83,43,40,70
Airdrieon,7933,3,20,3,13,70,61,9,63
Peterhead,7933,4,16,7,13,49,52,-3,55
Queen's Park,7933,5,14,8,14,41,43,-2,50
Albion,7933,6,14,8,14,47,57,-10,50
Brechin,7933,7,14,6,16,47,47,0,48
East Fife,7933,8,12,8,16,51,49,2,44
Stranraer,7933,9,10,4,22,48,70,-22,34
Stenhousem'r,7933,10,5,8,23,50,95,-45,23
Livingston,7934,1,22,5,9,77,45,32,71
Alloa,7934,2,18,7,11,68,51,17,61
Airdrieon,7934,3,19,4,13,57,52,5,61
Albion,7934,4,16,8,12,71,63,8,56
Brechin,7934,5,15,7,14,48,48,0,52
East Fife,7934,6,13,10,13,60,57,3,49
Queen's Park,7934,7,12,7,17,40,52,-12,43
Stranraer,7934,8,11,6,19,52,60,-8,39
Stenhousem'r,7934,9,9,10,17,48,82,-34,37
Peterhead,7934,10,10,6,20,58,69,-11,36
Alloa,7935,1,21,7,8,72,42,30,70
Brechin,7935,2,21,3,12,55,45,10,66
Livingston,7935,3,18,7,11,69,44,25,61
Airdrieon,7935,4,17,6,13,61,51,10,57
Albion,7935,5,13,8,15,49,52,-3,47
Peterhead,7935,6,12,10,14,51,53,-2,46
Stranraer,7935,7,12,8,16,47,57,-10,44
East Fife,7935,8,9,13,14,51,54,-3,40
Stenhousem'r,7935,9,10,7,19,45,76,-31,37
Queen's Park,7935,10,8,9,19,35,61,-26,33
Brechin,7936,1,20,7,9,51,38,13,67
Airdrieon,7936,2,17,9,10,57,49,8,60
Alloa,7936,3,15,9,12,63,47,16,54
Livingston,7936,4,16,6,14,67,55,12,54
Peterhead,7936,5,15,8,13,56,53,3,53
Stenhousem'r,7936,6,14,5,17,59,75,-16,47
Albion,7936,7,13,7,16,47,48,-1,46
East Fife,7936,8,10,13,13,52,51,1,43
Queen's Park,7936,9,9,13,14,28,40,-12,40
Stranraer,7936,10,9,7,20,37,61,-24,34
Alloa,7937,1,21,6,9,85,42,43,69
Livingston,7937,2,21,3,12,81,49,32,66
Airdrieon,7937,3,18,5,13,56,54,2,59
East Fife,7937,4,17,6,13,52,44,8,57
Albion,7937,5,14,9,13,49,47,2,51
Brechin,7937,6,14,9,13,43,49,-6,51
Peterhead,7937,7,12,8,16,43,51,-8,44
Stranraer,7937,8,11,7,18,51,67,-16,40
Queen's Park,7937,9,10,9,17,39,57,-18,39
Stenhousem'r,7937,10,8,6,22,53,92,-39,30
Alloa,7938,1,22,6,8,70,41,29,72
Livingston,7938,2,19,5,12,81,54,27,62
Peterhead,7938,3,17,8,11,58,44,14,59
Airdrieon,7938,4,16,6,14,58,55,3,54
Brechin,7938,5,16,6,14,45,56,-11,54
Queen's Park,7938,6,15,7,14,49,51,-2,52
Albion,7938,7,12,9,15,54,51,3,45
Stranraer,7938,8,11,7,18,49,59,-10,40
Stenhousem'r,7938,9,9,10,17,49,80,-31,37
East Fife,7938,10,6,10,20,36,58,-22,28
Brechin,7939,1,19,9,8,62,45,17,66
Livingston,7939,2,17,10,9,80,57,23,61
Alloa,7939,3,17,6,13,66,53,13,57
East Fife,7939,4,15,8,13,59,52,7,53
Airdrieon,7939,5,15,8,13,65,60,5,53
Queen's Park,7939,6,14,7,15,38,55,-17,49
Peterhead,7939,7,13,7,16,58,56,2,46
Stranraer,7939,8,13,6,17,50,51,-1,45
Albion,7939,9,11,10,15,59,65,-6,43
Stenhousem'r,7939,10,4,13,19,46,89,-43,25
Livingston,7940,1,24,2,10,86,46,40,74
Alloa,7940,2,18,9,9,68,49,19,63
Queen's Park,7940,3,17,5,14,39,44,-5,56
Peterhead,7940,4,16,7,13,51,45,6,55
Airdrieon,7940,5,16,7,13,59,54,5,55
Albion,7940,6,14,9,13,48,42,6,51
Stranraer,7940,7,14,2,20,46,59,-13,44
East Fife,7940,8,11,10,15,50,48,2,43
Brechin,7940,9,12,7,17,42,57,-15,43
Stenhousem'r,7940,10,5,8,23,39,84,-45,23
Livingston,7941,1,25,3,8,79,43,36,78
Alloa,7941,2,19,7,10,67,43,24,64
Airdrieon,7941,3,19,7,10,57,43,14,64
Peterhead,7941,4,15,7,14,52,50,2,52
Brechin,7941,5,16,3,17,52,54,-2,51
Albion,7941,6,13,9,14,46,44,2,48
East Fife,7941,7,13,8,15,44,47,-3,47
Queen's Park,7941,8,11,7,18,39,57,-18,40
Stranraer,7941,9,9,8,19,47,66,-19,35
Stenhousem'r,7941,10,8,5,23,39,75,-36,29
Alloa,7942,1,24,4,8,78,44,34,76
Livingston,7942,2,19,8,9,73,45,28,65
Airdrieon,7942,3,18,6,12,59,58,1,60
Brechin,7942,4,17,6,13,52,47,5,57
Albion,7942,5,15,8,13,48,46,2,53
Stranraer,7942,6,16,4,16,53,58,-5,52
Peterhead,7942,7,13,8,15,50,48,2,47
Queen's Park,7942,8,11,7,18,36,52,-16,40
East Fife,7942,9,7,10,19,43,51,-8,31
Stenhousem'r,7942,10,5,9,22,36,79,-43,24
Livingston,7943,1,24,4,8,78,43,35,76
Alloa,7943,2,20,7,9,69,45,24,67
Airdrieon,7943,3,18,8,10,58,45,13,62
Brechin,7943,4,16,6,14,48,46,2,54
East Fife,7943,5,15,8,13,55,47,8,53
Peterhead,7943,6,12,9,15,50,59,-9,45
Queen's Park,7943,7,11,9,16,32,53,-21,42
Albion,7943,8,11,7,18,49,55,-6,40
Stranraer,7943,9,10,5,21,45,65,-20,35
Stenhousem'r,7943,10,8,7,21,48,74,-26,31
Alloa,7944,1,19,9,8,70,43,27,66
Livingston,7944,2,18,4,14,71,55,16,58
Peterhead,7944,3,17,7,12,51,44,7,58
Airdrieon,7944,4,16,8,12,60,55,5,56
Albion,7944,5,13,12,11,60,55,5,51
Brechin,7944,6,14,9,13,44,46,-2,51
East Fife,7944,7,12,9,15,53,49,4,45
Queen's Park,7944,8,11,9,16,35,48,-13,42
Stranraer,7944,9,10,8,18,42,55,-13,38
Stenhousem'r,7944,10,10,5,21,49,85,-36,35
Livingston,7945,1,21,7,8,73,45,28,70
Alloa,7945,2,19,7,10,66,41,25,64
Airdrieon,7945,3,16,9,11,58,52,6,57
Brechin,7945,4,15,7,14,48,50,-2,52
Albion,7945,5,14,9,13,60,56,4,51
East Fife,7945,6,14,8,14,51,48,3,50
Stranraer,7945,7,12,7,17,51,66,-15,43
Peterhead,7945,8,11,9,16,44,54,-10,42
Queen's Park,7945,9,11,8,17,46,57,-11,41
Stenhousem'r,7945,10,5,13,18,54,82,-28,28
Livingston,7946,1,26,4,6,93,44,49,82
Alloa,7946,2,18,8,10,73,50,23,62
Brechin,7946,3,19,4,13,62,52,10,61
Albion,7946,4,16,9,11,54,50,4,57
Stranraer,7946,5,15,8,13,60,55,5,53
Peterhead,7946,6,15,7,14,59,55,4,52
Airdrieon,7946,7,12,9,15,54,60,-6,45
Queen's Park,7946,8,10,8,18,32,57,-25,38
Stenhousem'r,7946,9,8,5,23,45,88,-43,29
East Fife,7946,10,5,10,21,36,57,-21,25
Alloa,7947,1,19,9,8,66,38,28,66
Airdrieon,7947,2,18,8,10,59,49,10,62
Livingston,7947,3,19,3,14,72,55,17,60
Peterhead,7947,4,17,5,14,53,45,8,56
Brechin,7947,5,15,7,14,51,52,-1,52
Stranraer,7947,6,14,6,16,49,58,-9,48
East Fife,7947,7,13,8,15,51,50,1,47
Queen's Park,7947,8,14,5,17,43,54,-11,47
Albion,7947,9,11,8,17,47,55,-8,41
Stenhousem'r,7947,10,7,7,22,46,81,-35,28
Alloa,7948,1,19,8,9,74,42,32,65
Livingston,7948,2,19,7,10,81,56,25,64
Brechin,7948,3,17,7,12,61,49,12,58
Airdrieon,7948,4,16,7,13,48,49,-1,55
Albion,7948,5,16,5,15,59,55,4,53
Stranraer,7948,6,11,12,13,49,54,-5,45
Queen's Park,7948,7,13,6,17,47,59,-12,45
Peterhead,7948,8,11,10,15,47,59,-12,43
East Fife,7948,9,11,7,18,51,64,-13,40
Stenhousem'r,7948,10,9,7,20,45,75,-30,34
Livingston,7949,1,25,3,8,83,41,42,78
Airdrieon,7949,2,18,6,12,65,55,10,60
Alloa,7949,3,17,7,12,72,54,18,58
Albion,7949,4,15,9,12,56,48,8,54
Brechin,7949,5,15,7,14,54,53,1,52
Stranraer,7949,6,14,6,16,50,61,-11,48
East Fife,7949,7,13,7,16,49,50,-1,46
Peterhead,7949,8,10,12,14,44,54,-10,42
Stenhousem'r,7949,9,8,9,19,49,79,-30,33
Queen's Park,7949,10,8,8,20,32,59,-27,32
Livingston,7950,1,22,5,9,84,49,35,71
Alloa,7950,2,19,8,9,79,47,32,65
Albion,7950,3,16,12,8,61,45,16,60
Brechin,7950,4,15,9,12,54,50,4,54
Airdrieon,7950,5,16,5,15,56,57,-1,53
East Fife,7950,6,13,10,13,46,48,-2,49
Peterhead,7950,7,11,13,12,42,51,-9,46
Stranraer,7950,8,11,4,21,46,63,-17,37
Queen's Park,7950,9,11,4,21,35,58,-23,37
Stenhousem'r,7950,10,8,6,22,42,77,-35,30
Livingston,7951,1,25,2,9,92,51,41,77
Alloa,7951,2,17,7,12,65,47,18,58
Brechin,7951,3,17,5,14,48,50,-2,56
Queen's Park,7951,4,16,7,13,40,41,-1,55
Airdrieon,7951,5,14,10,12,60,56,4,52
Albion,7951,6,14,7,15,49,50,-1,49
Stranraer,7951,7,11,9,16,46,58,-12,42
Peterhead,7951,8,10,10,16,37,51,-14,40
East Fife,7951,9,10,8,18,39,47,-8,38
Stenhousem'r,7951,10,8,11,17,43,68,-25,35
Livingston,7952,1,22,5,9,75,45,30,71
Albion,7952,2,16,11,9,52,46,6,59
Alloa,7952,3,15,9,12,71,50,21,54
Airdrieon,7952,4,15,7,14,52,45,7,52
Peterhead,7952,5,14,7,15,52,53,-1,49
Brechin,7952,6,15,3,18,43,46,-3,48
Stranraer,7952,7,14,6,16,45,55,-10,48
Queen's Park,7952,8,14,6,16,43,60,-17,48
Stenhousem'r,7952,9,10,9,17,51,72,-21,39
East Fife,7952,10,10,7,19,41,53,-12,37
Livingston,7953,1,25,3,8,74,38,36,78
Alloa,7953,2,20,8,8,73,42,31,68
Airdrieon,7953,3,17,6,13,58,55,3,57
Brechin,7953,4,16,7,13,56,54,2,55
Albion,7953,5,15,6,15,54,49,5,51
Queen's Park,7953,6,12,8,16,36,53,-17,44
Stranraer,7953,7,11,7,18,51,62,-11,40
East Fife,7953,8,10,9,17,46,56,-10,39
Peterhead,7953,9,10,8,18,48,61,-13,38
Stenhousem'r,7953,10,10,6,20,44,70,-26,36
Livingston,7954,1,22,4,10,70,42,28,70
Alloa,7954,2,20,6,10,63,38,25,66
Airdrieon,7954,3,15,8,13,47,52,-5,53
Albion,7954,4,14,9,13,51,51,0,51
Queen's Park,7954,5,14,9,13,43,51,-8,51
East Fife,7954,6,14,8,14,55,49,6,50
Brechin,7954,7,15,5,16,51,55,-4,50
Peterhead,7954,8,13,6,17,49,55,-6,45
Stranraer,7954,9,11,5,20,44,51,-7,38
Stenhousem'r,7954,10,6,12,18,48,77,-29,30
Alloa,7955,1,21,6,9,66,36,30,69
Livingston,7955,2,20,6,10,80,53,27,66
Albion,7955,3,15,8,13,62,58,4,53
Airdrieon,7955,4,14,10,12,53,53,0,52
Stranraer,7955,5,15,6,15,50,51,-1,51
Peterhead,7955,6,14,8,14,54,54,0,50
Queen's Park,7955,7,13,7,16,31,44,-13,46
Brechin,7955,8,12,8,16,49,58,-9,44
East Fife,7955,9,11,10,15,51,49,2,43
Stenhousem'r,7955,10,7,7,22,53,93,-40,28
Airdrieon,7956,1,21,7,8,70,42,28,70
Livingston,7956,2,21,5,10,81,44,37,68
Alloa,7956,3,17,11,8,68,40,28,62
Peterhead,7956,4,15,8,13,45,51,-6,53
Brechin,7956,5,15,7,14,55,50,5,52
Albion,7956,6,14,6,16,45,57,-12,48
Queen's Park,7956,7,12,6,18,38,56,-18,42
East Fife,7956,8,10,8,18,42,52,-10,38
Stranraer,7956,9,11,5,20,43,63,-20,38
Stenhousem'r,7956,10,9,7,20,50,82,-32,34
Alloa,7957,1,18,8,10,71,49,22,62
Livingston,7957,2,19,4,13,79,54,25,61
Airdrieon,7957,3,15,9,12,57,58,-1,54
Brechin,7957,4,16,6,14,40,41,-1,54
Queen's Park,7957,5,14,11,11,40,40,0,53
Peterhead,7957,6,14,10,12,47,45,2,52
Albion,7957,7,14,8,14,52,50,2,50
Stranraer,7957,8,10,9,17,40,57,-17,39
East Fife,7957,9,9,11,16,42,49,-7,38
Stenhousem'r,7957,10,10,6,20,51,76,-25,36
Airdrieon,7958,1,20,8,8,64,46,18,68
Livingston,7958,2,19,6,11,75,51,24,63
Alloa,7958,3,18,9,9,71,47,24,63
Brechin,7958,4,19,5,12,57,47,10,62
Peterhead,7958,5,17,6,13,52,47,5,57
Albion,7958,6,13,6,17,54,50,4,45
East Fife,7958,7,11,9,16,50,52,-2,42
Queen's Park,7958,8,12,6,18,38,53,-15,42
Stranraer,7958,9,11,5,20,46,75,-29,38
Stenhousem'r,7958,10,7,6,23,50,89,-39,27
Livingston,7959,1,23,1,12,83,42,41,70
Airdrieon,7959,2,19,6,11,57,47,10,63
Queen's Park,7959,3,16,8,12,47,50,-3,56
Alloa,7959,4,16,6,14,68,54,14,54
Albion,7959,5,14,8,14,51,53,-2,50
Peterhead,7959,6,15,4,17,48,54,-6,49
East Fife,7959,7,13,9,14,47,42,5,48
Brechin,7959,8,14,4,18,43,58,-15,46
Stranraer,7959,9,12,3,21,50,65,-15,39
Stenhousem'r,7959,10,10,7,19,43,72,-29,37
Livingston,7960,1,20,6,10,79,49,30,66
Alloa,7960,2,17,8,11,63,48,15,59
Albion,7960,3,18,5,13,53,51,2,59
Queen's Park,7960,4,15,9,12,45,48,-3,54
East Fife,7960,5,15,7,14,60,55,5,52
Airdrieon,7960,6,15,7,14,55,52,3,52
Peterhead,7960,7,14,6,16,50,58,-8,48
Brechin,7960,8,13,7,16,39,43,-4,46
Stranraer,7960,9,14,2,20,53,61,-8,44
Stenhousem'r,7960,10,7,7,22,46,78,-32,28
Livingston,7961,1,23,4,9,85,53,32,73
Alloa,7961,2,20,10,6,75,41,34,70
Brechin,7961,3,20,6,10,55,42,13,66
Airdrieon,7961,4,17,6,13,57,56,1,57
East Fife,7961,5,12,10,14,50,50,0,46
Queen's Park,7961,6,13,6,17,39,53,-14,45
Albion,7961,7,12,7,17,52,56,-4,43
Stranraer,7961,8,12,6,18,56,62,-6,42
Peterhead,7961,9,9,9,18,49,65,-16,36
Stenhousem'r,7961,10,7,6,23,53,93,-40,27
Livingston,7962,1,18,8,10,72,48,24,62
Alloa,7962,2,17,10,9,78,50,28,61
Airdrieon,7962,3,18,7,11,68,47,21,61
Brechin,7962,4,16,10,10,57,46,11,58
Stranraer,7962,5,16,4,16,48,58,-10,52
Albion,7962,6,14,6,16,56,59,-3,48
Peterhead,7962,7,12,10,14,47,56,-9,46
Queen's Park,7962,8,11,12,13,37,58,-21,45
East Fife,7962,9,10,10,16,46,51,-5,40
Stenhousem'r,7962,10,4,11,21,39,75,-36,23
Livingston,7963,1,20,7,9,76,43,33,67
Brechin,7963,2,20,7,9,49,36,13,67
Alloa,7963,3,19,7,10,62,35,27,64
Airdrieon,7963,4,15,6,15,52,56,-4,51
Peterhead,7963,5,13,8,15,54,53,1,47
Queen's Park,7963,6,12,9,15,41,47,-6,45
East Fife,7963,7,11,10,15,50,51,-1,43
Albion,7963,8,12,6,18,49,62,-13,42
Stranraer,7963,9,12,6,18,41,57,-16,42
Stenhousem'r,7963,10,10,6,20,47,81,-34,36
Livingston,7964,1,22,4,10,74,42,32,70
Alloa,7964,2,19,10,7,75,41,34,67
Peterhead,7964,3,14,10,12,55,49,6,52
Stranraer,7964,4,15,6,15,52,54,-2,51
Airdrieon,7964,5,14,8,14,50,56,-6,50
Albion,7964,6,13,10,13,47,54,-7,49
Queen's Park,7964,7,13,9,14,35,46,-11,48
Brechin,7964,8,12,8,16,38,47,-9,44
East Fife,7964,9,8,11,17,43,48,-5,35
Stenhousem'r,7964,10,9,6,21,45,77,-32,33
Livingston,7965,1,23,4,9,83,45,38,73
Alloa,7965,2,21,8,7,77,42,35,71
Peterhead,7965,3,15,8,13,58,57,1,53
Brechin,7965,4,15,6,15,47,49,-2,51
East Fife,7965,5,13,10,13,48,43,5,49
Airdrieon,7965,6,13,10,13,53,55,-2,49
Albion,7965,7,14,7,15,44,52,-8,49
Stranraer,7965,8,11,8,17,45,61,-16,41
Queen's Park,7965,9,11,8,17,42,60,-18,41
Stenhousem'r,7965,10,6,7,23,43,76,-33,25
Alloa,7966,1,23,6,7,83,38,45,75
Airdrieon,7966,2,21,8,7,65,43,22,71
Livingston,7966,3,18,5,13,73,56,17,59
Brechin,7966,4,15,5,16,45,50,-5,50
Peterhead,7966,5,13,10,13,45,51,-6,49
East Fife,7966,6,12,12,12,50,48,2,48
Stranraer,7966,7,11,8,17,47,55,-8,41
Queen's Park,7966,8,11,8,17,32,49,-17,41
Albion,7966,9,8,10,18,41,57,-16,34
Stenhousem'r,7966,10,7,10,19,48,82,-34,31
Alloa,7967,1,23,9,4,73,31,42,78
Livingston,7967,2,21,5,10,74,48,26,68
Brechin,7967,3,16,7,13,45,43,2,55
Airdrieon,7967,4,15,7,14,59,53,6,52
Stranraer,7967,5,13,9,14,50,47,3,48
East Fife,7967,6,12,11,13,47,42,5,47
Peterhead,7967,7,13,8,15,43,50,-7,47
Queen's Park,7967,8,12,8,16,30,45,-15,44
Albion,7967,9,7,10,19,37,63,-26,31
Stenhousem'r,7967,10,7,8,21,44,80,-36,29
Livingston,7968,1,23,5,8,84,47,37,74
Alloa,7968,2,18,7,11,61,43,18,61
Airdrieon,7968,3,17,9,10,56,52,4,60
Brechin,7968,4,15,9,12,49,47,2,54
Stranraer,7968,5,15,5,16,59,56,3,50
Peterhead,7968,6,14,6,16,56,63,-7,48
Albion,7968,7,14,5,17,57,55,2,47
Queen's Park,7968,8,11,7,18,27,48,-21,40
East Fife,7968,9,7,16,13,41,46,-5,37
Stenhousem'r,7968,10,8,7,21,53,86,-33,31
Livingston,7969,1,21,7,8,70,40,30,70
Alloa,7969,2,19,8,9,81,49,32,65
Albion,7969,3,17,9,10,66,56,10,60
Airdrieon,7969,4,15,7,14,50,58,-8,52
Peterhead,7969,5,14,9,13,54,59,-5,51
Brechin,7969,6,14,7,15,58,57,1,49
Stranraer,7969,7,12,9,15,50,50,0,45
Queen's Park,7969,8,11,11,14,33,53,-20,44
East Fife,7969,9,10,9,17,48,52,-4,39
Stenhousem'r,7969,10,4,10,22,43,79,-36,22
Alloa,7970,1,20,8,8,75,48,27,68
Livingston,7970,2,19,5,12,74,54,20,62
Airdrieon,7970,3,17,10,9,65,49,16,61
Albion,7970,4,15,9,12,49,41,8,54
Brechin,7970,5,15,7,14,48,48,0,52
Stranraer,7970,6,13,7,16,54,55,-1,46
Queen's Park,7970,7,12,8,16,35,48,-13,44
Peterhead,7970,8,11,9,16,52,60,-8,42
Stenhousem'r,7970,9,9,10,17,46,72,-26,37
East Fife,7970,10,9,7,20,48,71,-23,34
Livingston,7971,1,21,6,9,83,47,36,69
Alloa,7971,2,17,12,7,61,41,20,63
Peterhead,7971,3,17,8,11,55,48,7,59
Brechin,7971,4,16,7,13,56,45,11,55
Airdrieon,7971,5,16,7,13,58,53,5,55
Albion,7971,6,13,11,12,45,52,-7,50
Queen's Park,7971,7,12,9,15,33,46,-13,45
East Fife,7971,8,11,10,15,44,49,-5,43
Stranraer,7971,9,11,5,20,47,56,-9,38
Stenhousem'r,7971,10,5,7,24,36,81,-45,22
Livingston,7972,1,25,2,9,79,39,40,77
Airdrieon,7972,2,22,4,10,66,53,13,70
Alloa,7972,3,21,6,9,69,40,29,69
Brechin,7972,4,19,9,8,65,42,23,66
Albion,7972,5,13,7,16,55,59,-4,46
Peterhead,7972,6,13,7,16,43,53,-10,46
Stranraer,7972,7,11,3,22,43,61,-18,36
East Fife,7972,8,9,8,19,42,52,-10,35
Queen's Park,7972,9,9,7,20,24,52,-28,34
Stenhousem'r,7972,10,9,5,22,48,83,-35,32
Airdrieon,7973,1,22,2,12,68,48,20,68
Alloa,7973,2,19,6,11,68,42,26,63
Livingston,7973,3,17,8,11,80,49,31,59
Brechin,7973,4,17,4,15,50,54,-4,55
Peterhead,7973,5,14,11,11,51,49,2,53
Albion,7973,6,12,10,14,49,46,3,46
Queen's Park,7973,7,12,8,16,31,50,-19,44
Stranraer,7973,8,13,3,20,48,70,-22,42
East Fife,7973,9,11,8,17,43,57,-14,41
Stenhousem'r,7973,10,8,10,18,50,73,-23,34
Livingston,7974,1,24,3,9,91,57,34,75
Airdrieon,7974,2,20,10,6,71,46,25,70
Alloa,7974,3,18,10,8,74,44,30,64
East Fife,7974,4,16,5,15,58,47,11,53
Brechin,7974,5,15,3,18,51,57,-6,48
Peterhead,7974,6,14,6,16,46,58,-12,48
Albion,7974,7,13,8,15,52,50,2,47
Queen's Park,7974,8,12,7,17,35,52,-17,43
Stranraer,7974,9,8,8,20,47,70,-23,32
Stenhousem'r,7974,10,6,8,22,38,82,-44,26
Alloa,7975,1,23,6,7,79,40,39,75
Airdrieon,7975,2,17,6,13,59,55,4,57
Queen's Park,7975,3,17,5,14,49,51,-2,56
Livingston,7975,4,15,8,13,70,54,16,53
East Fife,7975,5,14,7,15,55,56,-1,49
Brechin,7975,6,14,6,16,49,52,-3,48
Peterhead,7975,7,13,9,14,44,50,-6,48
Stranraer,7975,8,13,7,16,53,58,-5,46
Albion,7975,9,11,10,15,44,56,-12,43
Stenhousem'r,7975,10,7,8,21,53,83,-30,29
Alloa,7976,1,22,7,7,73,44,29,73
Livingston,7976,2,19,4,13,78,50,28,61
Airdrieon,7976,3,15,8,13,55,55,0,53
Peterhead,7976,4,15,7,14,49,53,-4,52
Brechin,7976,5,14,6,16,41,51,-10,48
Queen's Park,7976,6,12,10,14,33,44,-11,46
Albion,7976,7,12,9,15,49,53,-4,45
East Fife,7976,8,11,11,14,55,54,1,44
Stranraer,7976,9,11,8,17,52,59,-7,41
Stenhousem'r,7976,10,8,12,16,47,69,-22,36
Alloa,7977,1,20,7,9,78,48,30,67
Brechin,7977,2,20,6,10,63,41,22,66
Livingston,7977,3,20,6,10,65,45,20,66
Airdrieon,7977,4,18,7,11,58,47,11,61
Peterhead,7977,5,14,9,13,43,47,-4,51
Albion,7977,6,13,11,12,56,55,1,50
Queen's Park,7977,7,11,7,18,42,57,-15,40
East Fife,7977,8,9,11,16,42,49,-7,38
Stenhousem'r,7977,9,8,9,19,39,64,-25,33
Stranraer,7977,10,6,9,21,34,67,-33,27
Livingston,7978,1,23,3,10,80,43,37,72
Alloa,7978,2,22,6,8,81,46,35,72
Brechin,7978,3,16,6,14,49,49,0,54
Queen's Park,7978,4,16,6,14,40,45,-5,54
Airdrieon,7978,5,14,9,13,48,53,-5,51
Albion,7978,6,13,11,12,58,49,9,50
Peterhead,7978,7,14,6,16,60,56,4,48
East Fife,7978,8,13,9,14,50,51,-1,48
Stranraer,7978,9,9,8,19,53,71,-18,35
Stenhousem'r,7978,10,5,6,25,40,96,-56,21
Alloa,7979,1,19,8,9,68,41,27,65
Livingston,7979,2,17,10,9,69,48,21,61
Airdrieon,7979,3,16,6,14,59,53,6,54
Peterhead,7979,4,15,9,12,48,44,4,54
Albion,7979,5,16,6,14,49,49,0,54
Brechin,7979,6,14,10,12,49,49,0,52
East Fife,7979,7,14,7,15,49,47,2,49
Queen's Park,7979,8,12,10,14,32,42,-10,46
Stranraer,7979,9,10,7,19,51,63,-12,37
Stenhousem'r,7979,10,7,7,22,49,87,-38,28
Alloa,7980,1,20,5,11,68,37,31,65
Livingston,7980,2,20,4,12,67,45,22,64
Peterhead,7980,3,18,6,12,49,42,7,60
Airdrieon,7980,4,17,6,13,54,46,8,57
Brechin,7980,5,17,4,15,49,49,0,55
Albion,7980,6,14,7,15,53,53,0,49
Stranraer,7980,7,14,5,17,54,55,-1,47
Queen's Park,7980,8,14,4,18,31,56,-25,46
East Fife,7980,9,10,9,17,44,50,-6,39
Stenhousem'r,7980,10,8,6,22,42,78,-36,30
Livingston,7981,1,21,6,9,78,49,29,69
Alloa,7981,2,17,12,7,69,37,32,63
Brechin,7981,3,17,5,14,51,43,8,56
Airdrieon,7981,4,15,9,12,57,57,0,54
East Fife,7981,5,14,8,14,48,39,9,50
Albion,7981,6,14,7,15,50,57,-7,49
Queen's Park,7981,7,12,9,15,33,46,-13,45
Stranraer,7981,8,11,7,18,45,56,-11,40
Peterhead,7981,9,10,10,16,33,48,-15,40
Stenhousem'r,7981,10,8,9,19,49,81,-32,33
Livingston,7982,1,22,4,10,72,42,30,70
Alloa,7982,2,20,8,8,75,46,29,68
Airdrieon,7982,3,21,5,10,59,42,17,68
Queen's Park,7982,4,17,4,15,51,54,-3,55
Albion,7982,5,16,4,16,59,52,7,52
Brechin,7982,6,15,5,16,50,59,-9,50
East Fife,7982,7,13,6,17,52,51,1,45
Stranraer,7982,8,11,8,17,51,59,-8,41
Peterhead,7982,9,11,7,18,49,63,-14,40
Stenhousem'r,7982,10,5,7,24,39,89,-50,22
Livingston,7983,1,23,5,8,79,46,33,74
Alloa,7983,2,17,12,7,67,45,22,63
Peterhead,7983,3,15,8,13,46,48,-2,53
Airdrieon,7983,4,15,6,15,54,52,2,51
Brechin,7983,5,14,7,15,47,52,-5,49
Queen's Park,7983,6,13,9,14,49,51,-2,48
Albion,7983,7,13,9,14,57,62,-5,48
East Fife,7983,8,12,9,15,49,53,-4,45
Stranraer,7983,9,11,5,20,45,55,-10,38
Stenhousem'r,7983,10,6,12,18,41,70,-29,30
Livingston,7984,1,22,4,10,72,46,26,70
Alloa,7984,2,19,6,11,70,47,23,63
Brechin,7984,3,18,8,10,57,46,11,62
Airdrieon,7984,4,16,7,13,62,61,1,55
Albion,7984,5,16,6,14,59,55,4,54
Stranraer,7984,6,14,7,15,58,61,-3,49
Peterhead,7984,7,13,7,16,43,53,-10,46
Queen's Park,7984,8,12,6,18,41,53,-12,42
East Fife,7984,9,11,7,18,50,54,-4,40
Stenhousem'r,7984,10,7,6,23,50,86,-36,27
Livingston,7985,1,22,1,13,77,51,26,67
Alloa,7985,2,17,12,7,67,39,28,63
Brechin,7985,3,19,6,11,59,49,10,63
Airdrieon,7985,4,16,7,13,58,57,1,55
Peterhead,7985,5,15,7,14,52,54,-2,52
Albion,7985,6,15,6,15,60,59,1,51
East Fife,7985,7,11,11,14,51,45,6,44
Stranraer,7985,8,11,9,16,49,57,-8,42
Queen's Park,7985,9,8,10,18,34,57,-23,34
Stenhousem'r,7985,10,7,9,20,43,82,-39,30
Albion,7986,1,21,6,9,70,47,23,69
Livingston,7986,2,21,4,11,75,41,34,67
Alloa,7986,3,18,7,11,75,51,24,61
Brechin,7986,4,17,8,11,53,48,5,59
Airdrieon,7986,5,17,5,14,59,52,7,56
Stranraer,7986,6,12,6,18,52,66,-14,42
Queen's Park,7986,7,11,8,17,34,48,-14,41
Peterhead,7986,8,11,8,17,45,68,-23,41
East Fife,7986,9,9,11,16,43,54,-11,38
Stenhousem'r,7986,10,9,5,22,52,83,-31,32
Livingston,7987,1,22,3,11,81,48,33,69
Alloa,7987,2,19,10,7,78,41,37,67
Airdrieon,7987,3,17,6,13,68,64,4,57
East Fife,7987,4,15,9,12,51,45,6,54
Brechin,7987,5,16,5,15,55,53,2,53
Stranraer,7987,6,14,4,18,55,66,-11,46
Albion,7987,7,11,10,15,51,55,-4,43
Peterhead,7987,8,11,8,17,46,64,-18,41
Stenhousem'r,7987,9,11,6,19,52,83,-31,39
Queen's Park,7987,10,10,7,19,42,60,-18,37
Livingston,7988,1,25,5,6,87,42,45,80
Brechin,7988,2,16,9,11,47,47,0,57
Airdrieon,7988,3,17,4,15,68,56,12,55
Alloa,7988,4,15,9,12,61,46,15,54
Albion,7988,5,15,7,14,58,49,9,52
Peterhead,7988,6,12,13,11,48,45,3,49
Stranraer,7988,7,12,7,17,56,68,-12,43
East Fife,7988,8,9,14,13,50,51,-1,41
Queen's Park,7988,9,10,8,18,35,63,-28,38
Stenhousem'r,7988,10,8,6,22,48,91,-43,30
Livingston,7989,1,18,8,10,72,43,29,62
Alloa,7989,2,18,6,12,74,57,17,60
East Fife,7989,3,16,8,12,54,42,12,56
Airdrieon,7989,4,17,5,14,59,61,-2,56
Brechin,7989,5,14,10,12,52,50,2,52
Albion,7989,6,15,6,15,49,54,-5,51
Peterhead,7989,7,13,9,14,49,56,-7,48
Stranraer,7989,8,13,7,16,40,44,-4,46
Queen's Park,7989,9,10,9,17,32,46,-14,39
Stenhousem'r,7989,10,8,8,20,47,75,-28,32
Alloa,7990,1,22,9,5,81,42,39,75
Livingston,7990,2,21,7,8,80,50,30,70
Queen's Park,7990,3,15,8,13,41,44,-3,53
Albion,7990,4,14,7,15,56,57,-1,49
Airdrieon,7990,5,14,6,16,56,60,-4,48
East Fife,7990,6,12,11,13,48,46,2,47
Brechin,7990,7,12,11,13,38,44,-6,47
Peterhead,7990,8,10,13,13,44,49,-5,43
Stranraer,7990,9,10,9,17,44,55,-11,39
Stenhousem'r,7990,10,6,7,23,43,84,-41,25
Livingston,7991,1,21,5,10,75,44,31,68
Brechin,7991,2,19,6,11,50,40,10,63
Albion,7991,3,15,10,11,54,46,8,55
Queen's Park,7991,4,16,6,14,42,47,-5,54
Alloa,7991,5,14,9,13,64,49,15,51
Stranraer,7991,6,15,4,17,57,60,-3,49
Airdrieon,7991,7,14,6,16,53,60,-7,48
East Fife,7991,8,12,11,13,48,45,3,47
Peterhead,7991,9,10,10,16,50,66,-16,40
Stenhousem'r,7991,10,7,7,22,43,79,-36,28
Livingston,7992,1,22,5,9,76,43,33,71
Airdrieon,7992,2,22,3,11,61,49,12,69
Alloa,7992,3,18,9,9,62,46,16,63
Brechin,7992,4,17,4,15,47,43,4,55
East Fife,7992,5,13,8,15,55,51,4,47
Stranraer,7992,6,14,5,17,41,41,0,47
Queen's Park,7992,7,11,9,16,40,52,-12,42
Peterhead,7992,8,11,9,16,37,51,-14,42
Albion,7992,9,10,10,16,50,58,-8,40
Stenhousem'r,7992,10,6,10,20,46,81,-35,28
Alloa,7993,1,22,9,5,74,34,40,75
Livingston,7993,2,22,6,8,79,36,43,72
Brechin,7993,3,17,5,14,55,50,5,56
Airdrieon,7993,4,14,9,13,55,60,-5,51
Stranraer,7993,5,14,8,14,61,55,6,50
Albion,7993,6,13,8,15,51,60,-9,47
Queen's Park,7993,7,14,5,17,39,50,-11,47
East Fife,7993,8,11,8,17,48,47,1,41
Peterhead,7993,9,11,6,19,38,62,-24,39
Stenhousem'r,7993,10,5,10,21,46,92,-46,25
Livingston,7994,1,20,7,9,72,44,28,67
Brechin,7994,2,20,7,9,62,41,21,67
Airdrieon,7994,3,20,5,11,65,57,8,65
Alloa,7994,4,19,7,10,72,47,25,64
Peterhead,7994,5,13,8,15,49,53,-4,47
Albion,7994,6,13,5,18,55,66,-11,44
Stranraer,7994,7,12,7,17,54,61,-7,43
East Fife,7994,8,10,11,15,46,50,-4,41
Queen's Park,7994,9,11,6,19,29,47,-18,39
Stenhousem'r,7994,10,6,9,21,42,80,-38,27
Livingston,7995,1,21,9,6,76,45,31,72
Alloa,7995,2,19,6,11,72,47,25,63
Airdrieon,7995,3,16,9,11,52,45,7,57
Peterhead,7995,4,15,8,13,42,48,-6,53
Queen's Park,7995,5,14,8,14,42,48,-6,50
Albion,7995,6,14,7,15,47,43,4,49
Brechin,7995,7,14,7,15,47,51,-4,49
East Fife,7995,8,11,10,15,49,50,-1,43
Stranraer,7995,9,11,6,19,42,58,-16,39
Stenhousem'r,7995,10,5,10,21,42,76,-34,25
Livingston,7996,1,22,5,9,74,47,27,71
Alloa,7996,2,21,7,8,73,43,30,70
Albion,7996,3,16,9,11,56,50,6,57
Brechin,7996,4,14,10,12,49,50,-1,52
Airdrieon,7996,5,14,7,15,49,51,-2,49
Stranraer,7996,6,14,6,16,52,55,-3,48
East Fife,7996,7,11,11,14,49,41,8,44
Queen's Park,7996,8,12,8,16,33,43,-10,44
Peterhead,7996,9,13,4,19,48,62,-14,43
Stenhousem'r,7996,10,5,9,22,34,75,-41,24
Livingston,7997,1,21,4,11,80,49,31,67
Alloa,7997,2,18,7,11,64,42,22,61
Airdrieon,7997,3,18,7,11,60,53,7,61
Brechin,7997,4,19,4,13,54,48,6,61
Peterhead,7997,5,16,8,12,56,47,9,56
East Fife,7997,6,12,11,13,47,41,6,47
Stranraer,7997,7,14,3,19,47,63,-16,45
Queen's Park,7997,8,12,8,16,41,53,-12,44
Albion,7997,9,11,9,16,51,62,-11,42
Stenhousem'r,7997,10,5,7,24,34,76,-42,22
Livingston,7998,1,24,5,7,78,47,31,77
Alloa,7998,2,19,6,11,69,44,25,63
Albion,7998,3,15,10,11,61,55,6,55
Queen's Park,7998,4,14,10,12,44,41,3,52
Airdrieon,7998,5,12,12,12,66,66,0,48
Brechin,7998,6,14,5,17,45,55,-10,47
Stranraer,7998,7,13,6,17,52,57,-5,45
East Fife,7998,8,9,11,16,41,43,-2,38
Stenhousem'r,7998,9,10,8,18,53,79,-26,38
Peterhead,7998,10,9,9,18,46,68,-22,36
Livingston,7999,1,24,5,7,82,41,41,77
Alloa,7999,2,20,7,9,77,48,29,67
Peterhead,7999,3,16,8,12,53,53,0,56
Brechin,7999,4,17,4,15,48,47,1,55
Airdrieon,7999,5,15,10,11,51,51,0,55
Albion,7999,6,14,6,16,41,44,-3,48
Stranraer,7999,7,12,8,16,49,53,-4,44
Queen's Park,7999,8,12,6,18,36,51,-15,42
East Fife,7999,9,9,8,19,44,50,-6,35
Stenhousem'r,7999,10,7,6,23,39,82,-43,27
Livingston,8000,1,21,4,11,76,47,29,67
Alloa,8000,2,21,4,11,68,44,24,67
Airdrieon,8000,3,20,6,10,60,52,8,66
Brechin,8000,4,15,9,12,49,44,5,54
Stranraer,8000,5,16,4,16,55,53,2,52
Albion,8000,6,12,14,10,41,40,1,50
Queen's Park,8000,7,12,6,18,38,53,-15,42
East Fife,8000,8,10,8,18,47,53,-6,38
Peterhead,8000,9,10,6,20,41,60,-19,36
Stenhousem'r,8000,10,6,13,17,40,69,-29,31
Livingston,8001,1,21,6,9,76,46,30,69
Airdrieon,8001,2,18,7,11,62,49,13,61
Alloa,8001,3,17,8,11,55,44,11,59
Peterhead,8001,4,17,7,12,58,47,11,58
Albion,8001,5,16,9,11,55,40,15,57
Brechin,8001,6,16,3,17,60,63,-3,51
Stranraer,8001,7,14,5,17,47,54,-7,47
Queen's Park,8001,8,13,6,17,40,54,-14,45
East Fife,8001,9,10,8,18,52,52,0,38
Stenhousem'r,8001,10,6,5,25,39,95,-56,23
Livingston,8002,1,23,5,8,75,41,34,74
Airdrieon,8002,2,18,7,11,55,49,6,61
Alloa,8002,3,16,11,9,69,47,22,59
Albion,8002,4,14,8,14,50,50,0,50
Stranraer,8002,5,14,6,16,42,52,-10,48
Queen's Park,8002,6,13,6,17,42,51,-9,45
Brechin,8002,7,12,8,16,46,49,-3,44
East Fife,8002,8,12,8,16,48,54,-6,44
Peterhead,8002,9,10,12,14,49,49,0,42
Stenhousem'r,8002,10,8,9,19,43,77,-34,33
Alloa,8003,1,23,5,8,74,40,34,74
Livingston,8003,2,21,3,12,75,49,26,66
Airdrieon,8003,3,19,7,10,57,50,7,64
Albion,8003,4,19,6,11,55,39,16,63
Brechin,8003,5,16,8,12,50,42,8,56
Peterhead,8003,6,12,6,18,54,62,-8,42
Queen's Park,8003,7,12,3,21,32,59,-27,39
Stranraer,8003,8,11,4,21,52,64,-12,37
East Fife,8003,9,8,11,17,44,54,-10,35
Stenhousem'r,8003,10,10,5,21,49,83,-34,35
Livingston,8004,1,20,7,9,81,47,34,67
Alloa,8004,2,19,7,10,69,46,23,64
Airdrieon,8004,3,17,6,13,64,55,9,57
Albion,8004,4,15,11,10,59,51,8,56
Peterhead,8004,5,16,7,13,49,54,-5,55
Brechin,8004,6,16,5,15,55,54,1,53
Queen's Park,8004,7,13,7,16,41,51,-10,46
Stranraer,8004,8,12,9,15,57,61,-4,45
East Fife,8004,9,9,11,16,42,53,-11,38
Stenhousem'r,8004,10,3,10,23,49,94,-45,19
Livingston,8005,1,22,8,6,79,43,36,74
Brechin,8005,2,18,11,7,60,47,13,65
Alloa,8005,3,16,8,12,75,53,22,56
Airdrieon,8005,4,15,8,13,55,54,1,53
Stranraer,8005,5,16,4,16,59,57,2,52
Albion,8005,6,13,10,13,60,57,3,49
Peterhead,8005,7,10,12,14,45,50,-5,42
Queen's Park,8005,8,11,6,19,35,62,-27,39
East Fife,8005,9,8,13,15,47,52,-5,37
Stenhousem'r,8005,10,5,12,19,43,83,-40,27
Alloa,8006,1,19,9,8,71,38,33,66
Livingston,8006,2,20,6,10,78,52,26,66
Airdrieon,8006,3,19,9,8,66,51,15,66
Brechin,8006,4,19,6,11,57,45,12,63
Albion,8006,5,12,12,12,55,53,2,48
Queen's Park,8006,6,13,6,17,41,52,-11,45
Stranraer,8006,7,13,3,20,47,61,-14,42
East Fife,8006,8,11,7,18,48,55,-7,40
Peterhead,8006,9,10,10,16,49,62,-13,40
Stenhousem'r,8006,10,8,4,24,44,87,-43,28
Alloa,8007,1,19,10,7,74,40,34,67
Livingston,8007,2,20,5,11,85,50,35,65
Brechin,8007,3,16,7,13,48,53,-5,55
Stranraer,8007,4,17,2,17,61,57,4,53
East Fife,8007,5,14,8,14,57,50,7,50
Peterhead,8007,6,13,9,14,56,63,-7,48
Airdrieon,8007,7,13,8,15,47,55,-8,47
Queen's Park,8007,8,12,9,15,38,46,-8,45
Albion,8007,9,11,10,15,45,51,-6,43
Stenhousem'r,8007,10,9,4,23,51,97,-46,31
Livingston,8008,1,24,4,8,84,44,40,76
Alloa,8008,2,17,9,10,66,41,25,60
Airdrieon,8008,3,17,7,12,70,59,11,58
Brechin,8008,4,17,6,13,52,45,7,57
Queen's Park,8008,5,17,6,13,46,44,2,57
Albion,8008,6,14,8,14,56,53,3,50
Peterhead,8008,7,12,9,15,51,61,-10,45
East Fife,8008,8,10,9,17,46,54,-8,39
Stranraer,8008,9,8,8,20,42,64,-22,32
Stenhousem'r,8008,10,7,8,21,48,96,-48,29
Livingston,8009,1,22,4,10,76,51,25,70
Alloa,8009,2,19,9,8,71,34,37,66
Brechin,8009,3,17,7,12,53,46,7,58
Airdrieon,8009,4,16,8,12,54,55,-1,56
Peterhead,8009,5,13,10,13,56,60,-4,49
Stranraer,8009,6,12,8,16,54,61,-7,44
Albion,8009,7,11,10,15,52,58,-6,43
East Fife,8009,8,10,12,14,54,55,-1,42
Queen's Park,8009,9,8,11,17,28,46,-18,35
Stenhousem'r,8009,10,9,7,20,53,85,-32,34
Brechin,8010,1,22,6,8,60,36,24,72
Airdrieon,8010,2,19,4,13,65,56,9,61
Livingston,8010,3,18,4,14,71,54,17,58
Alloa,8010,4,18,4,14,59,47,12,58
Albion,8010,5,16,7,13,57,50,7,55
Queen's Park,8010,6,15,7,14,41,45,-4,52
Peterhead,8010,7,11,10,15,48,57,-9,43
East Fife,8010,8,11,8,17,45,52,-7,41
Stranraer,8010,9,9,9,18,41,60,-19,36
Stenhousem'r,8010,10,8,7,21,45,75,-30,31
Livingston,8011,1,20,8,8,82,50,32,68
Brechin,8011,2,20,6,10,61,49,12,66
Alloa,8011,3,19,6,11,67,46,21,63
Albion,8011,4,16,6,14,61,54,7,54
Airdrieon,8011,5,14,10,12,63,59,4,52
East Fife,8011,6,14,6,16,60,56,4,48
Peterhead,8011,7,14,4,18,53,62,-9,46
Queen's Park,8011,8,13,7,16,32,49,-17,46
Stranraer,8011,9,10,7,19,45,61,-16,37
Stenhousem'r,8011,10,7,6,23,58,96,-38,27
Livingston,8012,1,23,7,6,89,45,44,76
Alloa,8012,2,18,10,8,69,46,23,64
Airdrieon,8012,3,18,8,10,61,46,15,62
Brechin,8012,4,14,9,13,53,58,-5,51
East Fife,8012,5,12,11,13,56,50,6,47
Peterhead,8012,6,13,8,15,45,57,-12,47
Queen's Park,8012,7,11,11,14,35,41,-6,44
Albion,8012,8,10,11,15,49,59,-10,41
Stranraer,8012,9,9,9,18,53,66,-13,36
Stenhousem'r,8012,10,6,8,22,41,83,-42,26
Livingston,8013,1,21,4,11,84,55,29,67
Alloa,8013,2,18,7,11,69,48,21,61
Airdrieon,8013,3,17,8,11,61,50,11,59
Brechin,8013,4,17,4,15,46,51,-5,55
Albion,8013,5,15,9,12,57,47,10,54
Queen's Park,8013,6,14,7,15,39,54,-15,49
Stranraer,8013,7,14,4,18,50,59,-9,46
Peterhead,8013,8,11,11,14,46,49,-3,44
East Fife,8013,9,10,11,15,48,49,-1,41
Stenhousem'r,8013,10,6,9,21,54,92,-38,27
Livingston,8014,1,25,3,8,84,39,45,78
Alloa,8014,2,20,6,10,71,41,30,66
Airdrieon,8014,3,18,6,12,63,50,13,60
Brechin,8014,4,16,8,12,53,48,5,56
Peterhead,8014,5,16,7,13,54,56,-2,55
Albion,8014,6,14,9,13,59,51,8,51
Stranraer,8014,7,14,5,17,53,63,-10,47
East Fife,8014,8,11,9,16,45,58,-13,42
Queen's Park,8014,9,11,6,19,33,57,-24,39
Stenhousem'r,8014,10,3,5,28,37,89,-52,14
Albion,8015,1,21,5,10,58,42,16,68
Alloa,8015,2,20,6,10,67,39,28,66
Livingston,8015,3,20,2,14,72,56,16,62
Brechin,8015,4,18,4,14,48,41,7,58
Airdrieon,8015,5,15,8,13,48,51,-3,53
Stranraer,8015,6,15,5,16,56,55,1,50
East Fife,8015,7,14,7,15,52,51,1,49
Peterhead,8015,8,10,11,15,42,51,-9,41
Queen's Park,8015,9,8,8,20,33,58,-25,32
Stenhousem'r,8015,10,6,10,20,45,77,-32,28
Livingston,8016,1,25,5,6,76,38,38,80
Alloa,8016,2,22,4,10,76,43,33,70
Peterhead,8016,3,20,5,11,54,44,10,65
Airdrieon,8016,4,15,9,12,54,51,3,54
Brechin,8016,5,15,8,13,50,54,-4,53
Albion,8016,6,11,12,13,47,48,-1,45
Queen's Park,8016,7,11,6,19,36,55,-19,39
Stranraer,8016,8,11,4,21,45,54,-9,37
East Fife,8016,9,9,9,18,43,55,-12,36
Stenhousem'r,8016,10,7,6,23,36,75,-39,27
Alloa,8017,1,23,5,8,81,42,39,74
Livingston,8017,2,21,7,8,82,43,39,70
Airdrieon,8017,3,18,7,11,64,61,3,61
Brechin,8017,4,16,7,13,55,57,-2,55
Peterhead,8017,5,13,11,12,45,44,1,50
Queen's Park,8017,6,13,5,18,42,51,-9,44
Albion,8017,7,12,7,17,48,60,-12,43
Stranraer,8017,8,11,8,17,50,65,-15,41
East Fife,8017,9,7,14,15,47,51,-4,35
Stenhousem'r,8017,10,4,13,19,41,81,-40,25
Alloa,8018,1,23,6,7,79,34,45,75
Livingston,8018,2,19,7,10,64,47,17,64
Albion,8018,3,15,12,9,55,47,8,57
Airdrieon,8018,4,17,6,13,54,53,1,57
Brechin,8018,5,14,7,15,48,46,2,49
Stranraer,8018,6,13,7,16,56,61,-5,46
Queen's Park,8018,7,11,11,14,39,55,-16,44
Peterhead,8018,8,10,11,15,48,55,-7,41
East Fife,8018,9,7,14,15,44,47,-3,35
Stenhousem'r,8018,10,6,9,21,38,80,-42,27
Livingston,8019,1,23,4,9,78,49,29,73
Alloa,8019,2,22,6,8,78,44,34,72
Airdrieon,8019,3,18,10,8,63,46,17,64
Brechin,8019,4,18,6,12,48,41,7,60
Albion,8019,5,15,8,13,64,61,3,53
Queen's Park,8019,6,15,5,16,38,44,-6,50
East Fife,8019,7,10,10,16,46,49,-3,40
Peterhead,8019,8,11,6,19,45,57,-12,39
Stranraer,8019,9,10,7,19,41,60,-19,37
Stenhousem'r,8019,10,4,6,26,34,84,-50,18
Livingston,8020,1,21,7,8,80,38,42,70
Airdrieon,8020,2,17,6,13,66,61,5,57
Brechin,8020,3,17,5,14,48,47,1,56
East Fife,8020,4,16,7,13,64,51,13,55
Alloa,8020,5,17,4,15,61,51,10,55
Albion,8020,6,16,5,15,59,59,0,53
Peterhead,8020,7,14,6,16,48,58,-10,48
Stranraer,8020,8,13,5,18,50,62,-12,44
Queen's Park,8020,9,11,7,18,36,52,-16,40
Stenhousem'r,8020,10,9,6,21,43,76,-33,33
Livingston,8021,1,24,3,9,79,47,32,75
Alloa,8021,2,22,5,9,85,47,38,71
Brechin,8021,3,17,5,14,54,54,0,56
Airdrieon,8021,4,15,9,12,59,55,4,54
Peterhead,8021,5,14,10,12,54,55,-1,52
Albion,8021,6,14,8,14,58,48,10,50
Queen's Park,8021,7,13,6,17,33,53,-20,45
Stranraer,8021,8,12,4,20,54,65,-11,40
East Fife,8021,9,10,8,18,48,64,-16,38
Stenhousem'r,8021,10,6,8,22,38,74,-36,26
Livingston,8022,1,24,2,10,80,45,35,74
Airdrieon,8022,2,19,8,9,58,45,13,65
Alloa,8022,3,18,8,10,75,52,23,62
Albion,8022,4,14,9,13,54,53,1,51
Brechin,8022,5,15,5,16,42,50,-8,50
East Fife,8022,6,13,9,14,54,50,4,48
Peterhead,8022,7,12,9,15,47,54,-7,45
Queen's Park,8022,8,12,8,16,43,50,-7,44
Stranraer,8022,9,11,7,18,52,66,-14,40
Stenhousem'r,8022,10,4,11,21,45,85,-40,23
Livingston,8023,1,26,2,8,91,48,43,80
Alloa,8023,2,18,8,10,69,49,20,62
Airdrieon,8023,3,17,8,11,59,54,5,59
Brechin,8023,4,15,8,13,45,49,-4,53
Albion,8023,5,13,7,16,60,62,-2,46
Peterhead,8023,6,12,8,16,55,53,2,44
Stranraer,8023,7,13,5,18,51,59,-8,44
Queen's Park,8023,8,12,8,16,43,61,-18,44
East Fife,8023,9,11,9,16,50,48,2,42
Stenhousem'r,8023,10,9,5,22,45,85,-40,32
Livingston,8024,1,22,5,9,83,51,32,71
Alloa,8024,2,20,7,9,68,42,26,67
Airdrieon,8024,3,15,8,13,50,53,-3,53
Peterhead,8024,4,12,12,12,52,49,3,48
Stranraer,8024,5,14,6,16,52,56,-4,48
Brechin,8024,6,14,6,16,39,52,-13,48
East Fife,8024,7,12,11,13,54,43,11,47
Albion,8024,8,13,8,15,55,51,4,47
Queen's Park,8024,9,13,7,16,48,55,-7,46
Stenhousem'r,8024,10,7,6,23,38,87,-49,27
Livingston,8025,1,21,7,8,87,55,32,70
Alloa,8025,2,20,9,7,82,44,38,69
Airdrieon,8025,3,18,8,10,61,43,18,62
East Fife,8025,4,15,8,13,50,49,1,53
Albion,8025,5,14,9,13,54,56,-2,51
Peterhead,8025,6,13,9,14,51,56,-5,48
Brechin,8025,7,14,4,18,52,64,-12,46
Queen's Park,8025,8,10,11,15,45,59,-14,41
Stranraer,8025,9,9,7,20,40,61,-21,34
Stenhousem'r,8025,10,7,6,23,43,78,-35,27
Alloa,8026,1,18,9,9,76,46,30,63
Airdrieon,8026,2,18,9,9,56,48,8,63
Livingston,8026,3,18,7,11,69,46,23,61
Brechin,8026,4,17,3,16,49,48,1,54
East Fife,8026,5,12,13,11,50,44,6,49
Stranraer,8026,6,15,4,17,58,55,3,49
Albion,8026,7,12,10,14,47,53,-6,46
Queen's Park,8026,8,12,10,14,31,42,-11,46
Peterhead,8026,9,11,9,16,43,59,-16,42
Stenhousem'r,8026,10,8,4,24,48,86,-38,28
Alloa,8027,1,19,8,9,68,41,27,65
Livingston,8027,2,20,5,11,68,50,18,65
Albion,8027,3,17,9,10,60,49,11,60
Brechin,8027,4,15,7,14,46,44,2,52
Airdrieon,8027,5,13,11,12,54,54,0,50
Peterhead,8027,6,13,10,13,53,53,0,49
East Fife,8027,7,14,6,16,47,50,-3,48
Stranraer,8027,8,13,4,19,54,57,-3,43
Queen's Park,8027,9,11,9,16,37,53,-16,42
Stenhousem'r,8027,10,6,9,21,46,82,-36,27
Livingston,8028,1,22,4,10,77,47,30,70
Airdrieon,8028,2,18,7,11,62,49,13,61
Alloa,8028,3,17,9,10,73,51,22,60
Brechin,8028,4,18,4,14,55,53,2,58
East Fife,8028,5,15,9,12,73,54,19,54
Peterhead,8028,6,14,8,14,50,53,-3,50
Stranraer,8028,7,13,9,14,48,53,-5,48
Albion,8028,8,9,11,16,50,62,-12,38
Queen's Park,8028,9,9,6,21,35,61,-26,33
Stenhousem'r,8028,10,9,5,22,40,80,-40,32
Livingston,8029,1,26,2,8,89,41,48,80
Stranraer,8029,2,19,3,14,65,51,14,60
Brechin,8029,3,17,6,13,48,48,0,57
Alloa,8029,4,15,10,11,69,51,18,55
Airdrieon,8029,5,16,5,15,58,62,-4,53
East Fife,8029,6,14,5,17,55,59,-4,47
Peterhead,8029,7,12,9,15,48,49,-1,45
Albion,8029,8,12,7,17,50,58,-8,43
Queen's Park,8029,9,11,8,17,39,57,-18,41
Stenhousem'r,8029,10,7,7,22,44,89,-45,28
Alloa,8030,1,18,11,7,76,45,31,65
Livingston,8030,2,17,9,10,72,54,18,60
Airdrieon,8030,3,17,8,11,54,55,-1,59
Queen's Park,8030,4,14,9,13,45,46,-1,51
Brechin,8030,5,14,8,14,43,49,-6,50
East Fife,8030,6,11,11,14,49,48,1,44
Stranraer,8030,7,12,7,17,45,60,-15,43
Albion,8030,8,10,12,14,61,64,-3,42
Peterhead,8030,9,9,13,14,41,54,-13,40
Stenhousem'r,8030,10,9,10,17,54,65,-11,37
Livingston,8031,1,21,8,7,74,42,32,71
Alloa,8031,2,21,7,8,70,43,27,70
Brechin,8031,3,14,9,13,50,44,6,51
Peterhead,8031,4,12,13,11,53,55,-2,49
Airdrieon,8031,5,13,10,13,57,61,-4,49
Queen's Park,8031,6,14,7,15,33,40,-7,49
Stranraer,8031,7,11,11,14,55,59,-4,44
East Fife,8031,8,10,11,15,51,53,-2,41
Albion,8031,9,9,12,15,40,50,-10,39
Stenhousem'r,8031,10,6,10,20,45,81,-36,28
Livingston,8032,1,19,6,11,74,50,24,63
Brechin,8032,2,19,5,12,51,47,4,62
Alloa,8032,3,18,7,11,70,39,31,61
Albion,8032,4,16,8,12,57,46,11,56
Peterhead,8032,5,14,7,15,51,48,3,49
Stranraer,8032,6,15,4,17,55,69,-14,49
Queen's Park,8032,7,14,6,16,36,49,-13,48
Airdrieon,8032,8,13,7,16,57,64,-7,46
East Fife,8032,9,12,8,16,53,48,5,44
Stenhousem'r,8032,10,8,6,22,51,95,-44,30
Livingston,8033,1,21,5,10,75,42,33,68
Alloa,8033,2,18,7,11,72,47,25,61
Airdrieon,8033,3,15,13,8,59,50,9,58
Queen's Park,8033,4,16,5,15,45,49,-4,53
Stranraer,8033,5,15,7,14,59,49,10,52
Brechin,8033,6,15,7,14,50,52,-2,52
East Fife,8033,7,12,9,15,49,48,1,45
Albion,8033,8,11,9,16,43,55,-12,42
Peterhead,8033,9,10,9,17,38,61,-23,39
Stenhousem'r,8033,10,7,9,20,49,86,-37,30
Alloa,8034,1,23,7,6,80,45,35,76
Livingston,8034,2,19,5,12,72,49,23,62
Albion,8034,3,17,7,12,64,57,7,58
Stranraer,8034,4,17,6,13,59,49,10,57
Airdrieon,8034,5,14,8,14,55,55,0,50
East Fife,8034,6,13,10,13,53,49,4,49
Brechin,8034,7,15,4,17,51,56,-5,49
Peterhead,8034,8,11,9,16,47,56,-9,42
Queen's Park,8034,9,11,4,21,39,65,-26,37
Stenhousem'r,8034,10,7,6,23,47,86,-39,27
Livingston,8035,1,21,4,11,84,60,24,67
Airdrieon,8035,2,18,8,10,63,47,16,62
Brechin,8035,3,17,9,10,61,51,10,60
Alloa,8035,4,16,11,9,68,50,18,59
Albion,8035,5,14,7,15,53,54,-1,49
Peterhead,8035,6,12,11,13,53,57,-4,47
East Fife,8035,7,12,10,14,55,57,-2,46
Queen's Park,8035,8,13,7,16,47,54,-7,46
Stranraer,8035,9,9,9,18,50,67,-17,36
Stenhousem'r,8035,10,7,6,23,51,88,-37,27
Alloa,8036,1,20,8,8,71,46,25,68
Airdrieon,8036,2,18,7,11,53,44,9,61
Brechin,8036,3,18,6,12,50,41,9,60
East Fife,8036,4,17,7,12,50,38,12,58
Livingston,8036,5,16,6,14,69,55,14,54
Stranraer,8036,6,15,8,13,57,56,1,53
Peterhead,8036,7,15,6,15,55,52,3,51
Albion,8036,8,13,6,17,47,54,-7,45
Queen's Park,8036,9,7,7,22,32,59,-27,28
Stenhousem'r,8036,10,7,7,22,41,80,-39,28
Airdrieon,8037,1,19,10,7,75,53,22,67
Queen's Park,8037,2,18,6,12,45,49,-4,60
Alloa,8037,3,16,9,11,67,47,20,57
Livingston,8037,4,17,6,13,75,58,17,57
Brechin,8037,5,16,4,16,48,51,-3,52
Peterhead,8037,6,14,8,14,48,53,-5,50
East Fife,8037,7,13,9,14,58,55,3,48
Stenhousem'r,8037,8,11,8,17,52,75,-23,41
Albion,8037,9,10,10,16,54,55,-1,40
Stranraer,8037,10,7,8,21,41,67,-26,29
Livingston,8038,1,20,4,12,72,48,24,64
Peterhead,8038,2,18,7,11,58,55,3,61
Brechin,8038,3,18,6,12,51,45,6,60
Alloa,8038,4,16,8,12,68,48,20,56
Airdrieon,8038,5,15,8,13,54,48,6,53
Albion,8038,6,12,12,12,53,47,6,48
East Fife,8038,7,14,6,16,51,49,2,48
Queen's Park,8038,8,11,11,14,33,46,-13,44
Stranraer,8038,9,11,6,19,44,58,-14,39
Stenhousem'r,8038,10,9,4,23,46,86,-40,31
Livingston,8039,1,21,6,9,70,44,26,69
Airdrieon,8039,2,18,9,9,63,45,18,63
Alloa,8039,3,17,11,8,60,40,20,62
Brechin,8039,4,16,8,12,57,48,9,56
East Fife,8039,5,12,10,14,47,45,2,46
Albion,8039,6,12,10,14,51,54,-3,46
Stenhousem'r,8039,7,11,9,16,52,67,-15,42
Stranraer,8039,8,11,7,18,48,64,-16,40
Queen's Park,8039,9,7,15,14,34,54,-20,36
Peterhead,8039,10,9,7,20,45,66,-21,34
Livingston,8040,1,25,1,10,86,38,48,76
Alloa,8040,2,21,7,8,76,43,33,70
Brechin,8040,3,17,4,15,50,60,-10,55
Albion,8040,4,14,7,15,45,48,-3,49
Queen's Park,8040,5,14,5,17,40,50,-10,47
Airdrieon,8040,6,13,6,17,55,68,-13,45
Peterhead,8040,7,12,8,16,47,56,-9,44
Stenhousem'r,8040,8,13,5,18,51,71,-20,44
Stranraer,8040,9,12,6,18,52,60,-8,42
East Fife,8040,10,10,9,17,52,60,-8,39
Livingston,8041,1,21,6,9,78,53,25,69
Alloa,8041,2,18,8,10,68,45,23,62
Brechin,8041,3,17,7,12,54,48,6,58
Airdrieon,8041,4,17,6,13,63,58,5,57
Peterhead,8041,5,14,8,14,51,51,0,50
Stranraer,8041,6,13,7,16,53,60,-7,46
East Fife,8041,7,11,11,14,55,51,4,44
Albion,8041,8,12,8,16,48,49,-1,44
Queen's Park,8041,9,12,6,18,31,56,-25,42
Stenhousem'r,8041,10,6,11,19,48,78,-30,29
Alloa,8042,1,22,6,8,76,41,35,72
Livingston,8042,2,22,5,9,87,49,38,71
Airdrieon,8042,3,16,6,14,54,55,-1,54
Brechin,8042,4,15,5,16,49,64,-15,50
Albion,8042,5,13,8,15,60,60,0,47
Queen's Park,8042,6,12,9,15,50,52,-2,45
Stranraer,8042,7,13,6,17,52,62,-10,45
Peterhead,8042,8,12,8,16,43,59,-16,44
East Fife,8042,9,10,11,15,47,54,-7,41
Stenhousem'r,8042,10,11,4,21,47,69,-22,37
Alloa,8043,1,24,6,6,72,30,42,78
Livingston,8043,2,25,2,9,76,43,33,77
Airdrieon,8043,3,19,5,12,57,54,3,62
Brechin,8043,4,17,5,14,51,51,0,56
Albion,8043,5,13,9,14,54,50,4,48
Peterhead,8043,6,13,5,18,56,55,1,44
East Fife,8043,7,12,6,18,53,53,0,42
Queen's Park,8043,8,11,8,17,35,51,-16,41
Stranraer,8043,9,12,2,22,42,62,-20,38
Stenhousem'r,8043,10,8,4,24,41,88,-47,28
Livingston,8044,1,22,4,10,84,42,42,70
Alloa,8044,2,21,5,10,77,47,30,68
Brechin,8044,3,16,11,9,50,44,6,59
Albion,8044,4,16,7,13,55,53,2,55
Stranraer,8044,5,15,4,17,48,50,-2,49
Queen's Park,8044,6,12,11,13,37,49,-12,47
East Fife,8044,7,12,10,14,63,55,8,46
Peterhead,8044,8,13,7,16,46,51,-5,46
Airdrieon,8044,9,11,8,17,50,63,-13,41
Stenhousem'r,8044,10,4,9,23,38,94,-56,21
Alloa,8045,1,20,6,10,67,39,28,66
Livingston,8045,2,20,5,11,69,45,24,65
Airdrieon,8045,3,17,6,13,64,60,4,57
Albion,8045,4,15,9,12,60,53,7,54
Stranraer,8045,5,14,6,16,53,70,-17,48
Peterhead,8045,6,13,8,15,47,48,-1,47
East Fife,8045,7,12,10,14,51,53,-2,46
Queen's Park,8045,8,12,8,16,48,59,-11,44
Brechin,8045,9,11,9,16,51,61,-10,42
Stenhousem'r,8045,10,10,5,21,50,72,-22,35
Livingston,8046,1,23,2,11,77,38,39,71
Airdrieon,8046,2,17,7,12,58,56,2,58
Stranraer,8046,3,16,6,14,58,51,7,54
Alloa,8046,4,15,8,13,67,47,20,53
Brechin,8046,5,15,7,14,49,61,-12,52
Peterhead,8046,6,13,8,15,46,52,-6,47
Albion,8046,7,13,7,16,62,58,4,46
East Fife,8046,8,11,12,13,48,47,1,45
Queen's Park,8046,9,11,9,16,39,62,-23,42
Stenhousem'r,8046,10,9,8,19,38,70,-32,35
Brechin,8047,1,20,7,9,67,51,16,67
Livingston,8047,2,20,4,12,66,42,24,64
Alloa,8047,3,16,9,11,65,40,25,57
Albion,8047,4,15,8,13,63,54,9,53
Airdrieon,8047,5,14,8,14,52,63,-11,50
East Fife,8047,6,13,8,15,51,48,3,47
Peterhead,8047,7,13,8,15,50,50,0,47
Stranraer,8047,8,13,8,15,44,55,-11,47
Queen's Park,8047,9,10,7,19,32,51,-19,37
Stenhousem'r,8047,10,8,9,19,42,78,-36,33
Livingston,8048,1,20,8,8,81,48,33,68
Alloa,8048,2,19,8,9,71,45,26,65
Brechin,8048,3,20,4,12,48,45,3,64
East Fife,8048,4,15,11,10,65,41,24,56
Peterhead,8048,5,13,8,15,51,60,-9,47
Queen's Park,8048,6,11,11,14,40,54,-14,44
Stranraer,8048,7,11,10,15,53,60,-7,43
Airdrieon,8048,8,12,5,19,53,69,-16,41
Stenhousem'r,8048,9,10,9,17,50,76,-26,39
Albion,8048,10,8,8,20,45,59,-14,32
Livingston,8049,1,23,3,10,79,48,31,72
Alloa,8049,2,21,7,8,73,44,29,70
Peterhead,8049,3,17,7,12,62,53,9,58
Airdrieon,8049,4,16,5,15,56,54,2,53
Albion,8049,5,15,8,13,54,52,2,53
Brechin,8049,6,15,7,14,52,51,1,52
Queen's Park,8049,7,13,9,14,39,48,-9,48
Stranraer,8049,8,11,4,21,50,65,-15,37
East Fife,8049,9,8,9,19,39,53,-14,33
Stenhousem'r,8049,10,8,7,21,45,81,-36,31
Alloa,8050,1,19,10,7,69,43,26,67
Livingston,8050,2,20,4,12,65,45,20,64
Airdrieon,8050,3,17,8,11,62,53,9,59
Queen's Park,8050,4,17,6,13,49,46,3,57
Peterhead,8050,5,12,10,14,48,55,-7,46
Albion,8050,6,11,11,14,43,48,-5,44
Stranraer,8050,7,11,10,15,46,54,-8,43
Brechin,8050,8,11,8,17,48,60,-12,41
East Fife,8050,9,10,9,17,49,55,-6,39
Stenhousem'r,8050,10,8,12,16,51,71,-20,36
Alloa,8051,1,22,6,8,71,40,31,72
Livingston,8051,2,20,2,14,67,52,15,62
Airdrieon,8051,3,18,7,11,61,57,4,61
Brechin,8051,4,18,5,13,49,49,0,59
Albion,8051,5,14,9,13,48,48,0,51
Queen's Park,8051,6,13,8,15,39,45,-6,47
Stranraer,8051,7,13,7,16,48,47,1,46
Peterhead,8051,8,13,7,16,36,44,-8,46
East Fife,8051,9,10,11,15,45,39,6,41
Stenhousem'r,8051,10,5,6,25,38,81,-43,21
Livingston,8052,1,21,4,11,67,45,22,67
Alloa,8052,2,20,5,11,75,47,28,65
Airdrieon,8052,3,18,7,11,58,50,8,61
Albion,8052,4,16,5,15,52,54,-2,53
Stranraer,8052,5,15,7,14,57,55,2,52
Brechin,8052,6,13,11,12,47,47,0,50
East Fife,8052,7,10,11,15,39,43,-4,41
Queen's Park,8052,8,11,8,17,36,55,-19,41
Peterhead,8052,9,8,13,15,40,54,-14,37
Stenhousem'r,8052,10,9,7,20,50,71,-21,34
Alloa,8053,1,21,7,8,82,41,41,70
Livingston,8053,2,20,5,11,75,44,31,65
Brechin,8053,3,17,8,11,54,48,6,59
Peterhead,8053,4,16,8,12,55,56,-1,56
Airdrieon,8053,5,15,7,14,53,57,-4,52
Albion,8053,6,11,11,14,50,53,-3,44
Queen's Park,8053,7,12,7,17,37,50,-13,43
East Fife,8053,8,10,12,14,42,45,-3,42
Stranraer,8053,9,13,3,20,44,61,-17,42
Stenhousem'r,8053,10,7,8,21,43,80,-37,29
Livingston,8054,1,23,5,8,82,38,44,74
Alloa,8054,2,20,7,9,72,41,31,67
Brechin,8054,3,13,14,9,50,47,3,53
Albion,8054,4,14,8,14,62,62,0,50
Airdrieon,8054,5,14,6,16,51,56,-5,48
Queen's Park,8054,6,13,7,16,42,55,-13,46
East Fife,8054,7,10,12,14,44,47,-3,42
Stranraer,8054,8,12,6,18,53,67,-14,42
Peterhead,8054,9,10,10,16,49,64,-15,40
Stenhousem'r,8054,10,11,5,20,57,85,-28,38
Alloa,8055,1,19,6,11,63,44,19,63
Airdrieon,8055,2,18,7,11,67,57,10,61
Peterhead,8055,3,17,7,12,57,54,3,58
Albion,8055,4,15,8,13,58,51,7,53
Brechin,8055,5,14,9,13,50,46,4,51
Livingston,8055,6,15,5,16,66,58,8,50
Stranraer,8055,7,13,6,17,55,63,-8,45
Queen's Park,8055,8,12,9,15,37,49,-12,45
Stenhousem'r,8055,9,11,8,17,52,72,-20,41
East Fife,8055,10,7,13,16,45,56,-11,34
Alloa,8056,1,21,10,5,78,38,40,73
Livingston,8056,2,17,7,12,67,56,11,58
Albion,8056,3,16,9,11,56,49,7,57
Queen's Park,8056,4,16,9,11,46,41,5,57
Airdrieon,8056,5,15,6,15,63,67,-4,51
Peterhead,8056,6,14,7,15,55,53,2,49
Brechin,8056,7,14,7,15,49,50,-1,49
Stranraer,8056,8,12,6,18,49,62,-13,42
East Fife,8056,9,10,8,18,42,51,-9,38
Stenhousem'r,8056,10,8,5,23,45,83,-38,29
Livingston,8057,1,23,5,8,79,48,31,74
Alloa,8057,2,22,6,8,73,39,34,72
Airdrieon,8057,3,18,7,11,59,49,10,61
Albion,8057,4,15,10,11,56,53,3,55
Brechin,8057,5,15,8,13,46,48,-2,53
Queen's Park,8057,6,14,5,17,47,50,-3,47
Stranraer,8057,7,13,6,17,50,60,-10,45
Peterhead,8057,8,10,7,19,46,60,-14,37
East Fife,8057,9,7,12,17,40,50,-10,33
Stenhousem'r,8057,10,5,10,21,46,85,-39,25
Livingston,8058,1,23,3,10,79,51,28,72
Airdrieon,8058,2,18,9,9,61,48,13,63
Peterhead,8058,3,17,7,12,52,41,11,58
Alloa,8058,4,16,9,11,74,52,22,57
Brechin,8058,5,17,4,15,48,47,1,55
Albion,8058,6,13,8,15,54,63,-9,47
East Fife,8058,7,11,13,12,54,47,7,46
Stranraer,8058,8,10,6,20,43,63,-20,36
Stenhousem'r,8058,9,11,3,22,53,84,-31,36
Queen's Park,8058,10,9,8,19,40,62,-22,35
Alloa,8059,1,23,6,7,78,40,38,75
Livingston,8059,2,19,4,13,69,55,14,61
Brechin,8059,3,18,6,12,47,46,1,60
Airdrieon,8059,4,18,5,13,63,48,15,59
Peterhead,8059,5,17,8,11,58,51,7,59
East Fife,8059,6,14,9,13,59,47,12,51
Albion,8059,7,14,6,16,51,52,-1,48
Queen's Park,8059,8,12,4,20,38,60,-22,40
Stranraer,8059,9,9,9,18,51,68,-17,36
Stenhousem'r,8059,10,5,5,26,45,92,-47,20
Livingston,8060,1,21,4,11,75,46,29,67
Alloa,8060,2,17,9,10,62,41,21,60
Brechin,8060,3,16,12,8,51,40,11,60
Airdrieon,8060,4,17,5,14,58,54,4,56
Stranraer,8060,5,14,7,15,63,63,0,49
Albion,8060,6,11,12,13,51,56,-5,45
Peterhead,8060,7,12,9,15,57,68,-11,45
Queen's Park,8060,8,12,8,16,37,51,-14,44
East Fife,8060,9,10,12,14,49,49,0,42
Stenhousem'r,8060,10,7,8,21,46,81,-35,29
Livingston,8061,1,23,7,6,76,41,35,76
Airdrieon,8061,2,19,7,10,59,46,13,64
Alloa,8061,3,16,12,8,69,40,29,60
Brechin,8061,4,14,10,12,46,45,1,52
Albion,8061,5,15,5,16,57,57,0,50
Peterhead,8061,6,13,9,14,56,53,3,48
Stranraer,8061,7,14,5,17,52,61,-9,47
East Fife,8061,8,10,11,15,54,58,-4,41
Queen's Park,8061,9,10,7,19,33,56,-23,37
Stenhousem'r,8061,10,6,7,23,40,85,-45,25
Livingston,8062,1,20,5,11,77,50,27,65
Alloa,8062,2,19,5,12,69,50,19,62
Airdrieon,8062,3,16,11,9,58,53,5,59
Brechin,8062,4,16,9,11,51,46,5,57
Peterhead,8062,5,13,8,15,62,59,3,47
Queen's Park,8062,6,14,5,17,37,51,-14,47
Stranraer,8062,7,13,7,16,60,60,0,46
Albion,8062,8,13,7,16,48,55,-7,46
East Fife,8062,9,9,12,15,52,55,-3,39
Stenhousem'r,8062,10,10,5,21,53,88,-35,35
Livingston,8063,1,22,1,13,78,55,23,67
Stranraer,8063,2,19,3,14,54,47,7,60
Alloa,8063,3,16,11,9,63,38,25,59
Airdrieon,8063,4,18,4,14,55,55,0,58
Queen's Park,8063,5,15,6,15,40,50,-10,51
East Fife,8063,6,13,10,13,49,46,3,49
Peterhead,8063,7,14,6,16,51,48,3,48
Albion,8063,8,11,7,18,51,57,-6,40
Brechin,8063,9,12,4,20,36,59,-23,40
Stenhousem'r,8063,10,9,10,17,42,64,-22,37
Brechin,8064,1,18,6,12,49,44,5,60
Livingston,8064,2,17,6,13,78,50,28,57
Alloa,8064,3,16,8,12,66,47,19,56
Peterhead,8064,4,15,9,12,49,47,2,54
Stranraer,8064,5,13,12,11,50,51,-1,51
Queen's Park,8064,6,14,8,14,43,54,-11,50
Albion,8064,7,11,12,13,48,48,0,45
Airdrieon,8064,8,11,12,13,46,54,-8,45
East Fife,8064,9,11,8,17,45,52,-7,41
Stenhousem'r,8064,10,9,9,18,47,74,-27,36
Brechin,8065,1,20,4,12,64,48,16,64
Livingston,8065,2,19,5,12,71,42,29,62
Alloa,8065,3,18,7,11,66,41,25,61
Airdrieon,8065,4,17,8,11,57,49,8,59
Albion,8065,5,17,6,13,56,56,0,57
Peterhead,8065,6,15,8,13,50,51,-1,53
Stranraer,8065,7,15,4,17,54,65,-11,49
East Fife,8065,8,9,11,16,51,58,-7,38
Queen's Park,8065,9,8,8,20,34,58,-24,32
Stenhousem'r,8065,10,8,7,21,47,82,-35,31
Alloa,8066,1,24,6,6,87,39,48,78
Livingston,8066,2,21,2,13,69,48,21,65
Brechin,8066,3,18,6,12,61,46,15,60
Airdrieon,8066,4,16,8,12,62,62,0,56
Albion,8066,5,14,9,13,61,58,3,51
Peterhead,8066,6,14,6,16,39,46,-7,48
Queen's Park,8066,7,14,6,16,44,58,-14,48
Stranraer,8066,8,13,5,18,52,67,-15,44
East Fife,8066,9,8,10,18,48,60,-12,34
Stenhousem'r,8066,10,4,10,22,37,76,-39,22
Alloa,8067,1,19,10,7,64,37,27,67
Airdrieon,8067,2,19,6,11,56,44,12,63
Brechin,8067,3,16,9,11,46,39,7,57
Livingston,8067,4,16,5,15,63,51,12,53
Peterhead,8067,5,15,7,14,50,55,-5,52
Queen's Park,8067,6,14,7,15,35,48,-13,49
Albion,8067,7,13,9,14,49,52,-3,48
Stranraer,8067,8,9,11,16,39,52,-13,38
Stenhousem'r,8067,9,10,7,19,55,70,-15,37
East Fife,8067,10,8,11,17,32,41,-9,35
Livingston,8068,1,22,5,9,75,42,33,71
Alloa,8068,2,20,8,8,75,45,30,68
Airdrieon,8068,3,17,8,11,59,52,7,59
Brechin,8068,4,17,6,13,58,52,6,57
Albion,8068,5,17,5,14,64,45,19,56
East Fife,8068,6,13,11,12,57,42,15,50
Peterhead,8068,7,12,9,15,43,60,-17,45
Queen's Park,8068,8,10,6,20,33,58,-25,36
Stranraer,8068,9,9,8,19,42,58,-16,35
Stenhousem'r,8068,10,5,10,21,45,97,-52,25
Livingston,8069,1,24,5,7,85,46,39,77
Alloa,8069,2,19,6,11,64,42,22,63
Airdrieon,8069,3,17,3,16,60,55,5,54
Brechin,8069,4,16,6,14,51,47,4,54
East Fife,8069,5,15,6,15,57,53,4,51
Albion,8069,6,13,9,14,52,55,-3,48
Queen's Park,8069,7,12,8,16,39,47,-8,44
Peterhead,8069,8,13,4,19,53,71,-18,43
Stranraer,8069,9,11,6,19,41,60,-19,39
Stenhousem'r,8069,10,10,7,19,42,68,-26,37
Livingston,8070,1,22,3,11,77,46,31,69
Alloa,8070,2,18,8,10,79,49,30,62
Stranraer,8070,3,18,4,14,55,51,4,58
Brechin,8070,4,17,6,13,53,49,4,57
Peterhead,8070,5,17,6,13,63,63,0,57
Airdrieon,8070,6,16,6,14,53,49,4,54
Queen's Park,8070,7,14,7,15,42,55,-13,49
Albion,8070,8,11,6,19,46,63,-17,39
East Fife,8070,9,8,10,18,42,52,-10,34
Stenhousem'r,8070,10,7,8,21,49,82,-33,29
Livingston,8071,1,23,3,10,85,44,41,72
Airdrieon,8071,2,17,9,10,59,50,9,60
Queen's Park,8071,3,16,7,13,47,57,-10,55
Alloa,8071,4,15,7,14,76,61,15,52
Albion,8071,5,16,4,16,50,54,-4,52
East Fife,8071,6,14,8,14,56,42,14,50
Brechin,8071,7,14,8,14,50,51,-1,50
Peterhead,8071,8,14,6,16,45,57,-12,48
Stenhousem'r,8071,9,13,6,17,45,69,-24,45
Stranraer,8071,10,6,6,24,41,69,-28,24
Livingston,8072,1,21,5,10,82,48,34,68
Alloa,8072,2,19,9,8,76,41,35,66
Airdrieon,8072,3,16,6,14,59,58,1,54
Brechin,8072,4,15,8,13,57,54,3,53
Peterhead,8072,5,15,6,15,46,52,-6,51
Stranraer,8072,6,14,7,15,56,54,2,49
Albion,8072,7,13,9,14,49,57,-8,48
East Fife,8072,8,13,7,16,50,48,2,46
Queen's Park,8072,9,11,6,19,40,61,-21,39
Stenhousem'r,8072,10,8,7,21,41,83,-42,31
Alloa,8073,1,21,10,5,75,33,42,73
Livingston,8073,2,20,6,10,74,53,21,66
Brechin,8073,3,17,6,13,53,46,7,57
Peterhead,8073,4,16,6,14,50,51,-1,54
Queen's Park,8073,5,13,8,15,36,52,-16,47
Albion,8073,6,11,13,12,45,49,-4,46
Airdrieon,8073,7,13,7,16,58,70,-12,46
Stranraer,8073,8,12,5,19,55,64,-9,41
East Fife,8073,9,9,9,18,47,52,-5,36
Stenhousem'r,8073,10,8,10,18,45,68,-23,34
Livingston,8074,1,22,3,11,83,43,40,69
Alloa,8074,2,20,8,8,75,43,32,68
Brechin,8074,3,18,3,15,60,63,-3,57
Airdrieon,8074,4,17,4,15,64,65,-1,55
Albion,8074,5,15,7,14,54,57,-3,52
Stranraer,8074,6,14,6,16,52,56,-4,48
Queen's Park,8074,7,14,5,17,48,53,-5,47
East Fife,8074,8,12,6,18,48,56,-8,42
Peterhead,8074,9,11,8,17,48,59,-11,41
Stenhousem'r,8074,10,9,6,21,38,75,-37,33
Livingston,8075,1,23,3,10,77,45,32,72
Alloa,8075,2,17,12,7,78,47,31,63
East Fife,8075,3,14,11,11,47,43,4,53
Brechin,8075,4,14,10,12,45,44,1,52
Airdrieon,8075,5,14,7,15,52,57,-5,49
Albion,8075,6,12,10,14,42,48,-6,46
Peterhead,8075,7,12,8,16,45,60,-15,44
Queen's Park,8075,8,11,9,16,36,50,-14,42
Stranraer,8075,9,11,7,18,56,60,-4,40
Stenhousem'r,8075,10,8,11,17,45,69,-24,35
Livingston,8076,1,24,6,6,80,43,37,78
Alloa,8076,2,16,11,9,64,45,19,59
Airdrieon,8076,3,16,8,12,63,53,10,56
Albion,8076,4,15,9,12,58,55,3,54
Brechin,8076,5,14,11,11,46,43,3,53
Queen's Park,8076,6,13,9,14,41,51,-10,48
Stranraer,8076,7,13,8,15,57,62,-5,47
Peterhead,8076,8,12,6,18,49,61,-12,42
East Fife,8076,9,7,12,17,47,56,-9,33
Stenhousem'r,8076,10,7,6,23,41,77,-36,27
Livingston,8077,1,20,4,12,76,46,30,64
Alloa,8077,2,19,6,11,67,38,29,63
Brechin,8077,3,18,7,11,49,41,8,61
Airdrieon,8077,4,18,6,12,56,56,0,60
Albion,8077,5,15,5,16,54,62,-8,50
Stranraer,8077,6,15,4,17,51,52,-1,49
Peterhead,8077,7,13,5,18,43,56,-13,44
Queen's Park,8077,8,12,6,18,43,57,-14,42
Stenhousem'r,8077,9,9,11,16,50,70,-20,38
East Fife,8077,10,9,10,17,42,53,-11,37
Livingston,8078,1,23,3,10,84,58,26,72
Alloa,8078,2,18,9,9,69,40,29,63
East Fife,8078,3,15,8,13,59,49,10,53
Airdrieon,8078,4,14,9,13,57,59,-2,51
Stranraer,8078,5,14,8,14,51,49,2,50
Albion,8078,6,14,8,14,57,56,1,50
Peterhead,8078,7,12,10,14,44,48,-4,46
Brechin,8078,8,13,6,17,41,49,-8,45
Queen's Park,8078,9,10,9,17,34,53,-19,39
Stenhousem'r,8078,10,8,8,20,38,73,-35,32
Alloa,8079,1,18,9,9,57,38,19,63
Livingston,8079,2,19,5,12,66,43,23,62
Albion,8079,3,18,5,13,61,48,13,59
Airdrieon,8079,4,17,5,14,53,47,6,56
Brechin,8079,5,16,6,14,50,50,0,54
East Fife,8079,6,14,10,12,51,43,8,52
Stranraer,8079,7,14,6,16,51,58,-7,48
Peterhead,8079,8,13,6,17,55,64,-9,45
Queen's Park,8079,9,10,6,20,32,51,-19,36
Stenhousem'r,8079,10,7,10,19,41,75,-34,31
Livingston,8080,1,22,3,11,75,54,21,69
Alloa,8080,2,18,10,8,78,45,33,64
East Fife,8080,3,16,10,10,63,41,22,58
Peterhead,8080,4,15,10,11,55,47,8,55
Airdrieon,8080,5,15,8,13,58,58,0,53
Albion,8080,6,14,8,14,53,55,-2,50
Brechin,8080,7,13,8,15,44,48,-4,47
Queen's Park,8080,8,12,6,18,39,54,-15,42
Stranraer,8080,9,11,4,21,50,70,-20,37
Stenhousem'r,8080,10,6,9,21,45,88,-43,27
Livingston,8081,1,24,5,7,83,40,43,77
Airdrieon,8081,2,21,5,10,65,49,16,68
Alloa,8081,3,17,8,11,69,48,21,59
Brechin,8081,4,18,4,14,45,40,5,58
East Fife,8081,5,13,9,14,46,50,-4,48
Albion,8081,6,13,8,15,51,52,-1,47
Stranraer,8081,7,14,4,18,56,66,-10,46
Peterhead,8081,8,13,5,18,43,52,-9,44
Queen's Park,8081,9,9,8,19,36,57,-21,35
Stenhousem'r,8081,10,6,8,22,40,80,-40,26
Livingston,8082,1,22,7,7,74,47,27,73
Alloa,8082,2,18,9,9,68,47,21,63
Albion,8082,3,17,6,13,50,45,5,57
Airdrieon,8082,4,16,7,13,55,57,-2,55
Brechin,8082,5,16,4,16,48,45,3,52
Peterhead,8082,6,14,10,12,45,44,1,52
Queen's Park,8082,7,13,8,15,40,48,-8,47
East Fife,8082,8,10,10,16,50,43,7,40
Stranraer,8082,9,11,5,20,44,63,-19,38
Stenhousem'r,8082,10,6,8,22,41,76,-35,26
Livingston,8083,1,22,4,10,70,42,28,70
Alloa,8083,2,19,7,10,74,44,30,64
Airdrieon,8083,3,17,8,11,58,50,8,59
Brechin,8083,4,17,6,13,48,48,0,57
Peterhead,8083,5,15,9,12,51,49,2,54
East Fife,8083,6,15,6,15,61,51,10,51
Albion,8083,7,14,6,16,49,54,-5,48
Queen's Park,8083,8,14,4,18,38,48,-10,46
Stranraer,8083,9,10,5,21,40,57,-17,35
Stenhousem'r,8083,10,5,9,22,48,94,-46,24
Alloa,8084,1,22,5,9,77,39,38,71
Airdrieon,8084,2,22,5,9,69,46,23,71
Livingston,8084,3,18,4,14,75,63,12,58
Brechin,8084,4,16,8,12,50,50,0,56
Peterhead,8084,5,15,10,11,56,54,2,55
Queen's Park,8084,6,14,9,13,45,51,-6,51
East Fife,8084,7,11,9,16,50,49,1,42
Stranraer,8084,8,11,5,20,51,71,-20,38
Stenhousem'r,8084,9,10,4,22,45,74,-29,34
Albion,8084,10,8,7,21,46,67,-21,31
Alloa,8085,1,24,5,7,80,39,41,77
Airdrieon,8085,2,18,9,9,70,48,22,63
Livingston,8085,3,20,3,13,69,47,22,63
Brechin,8085,4,17,5,14,53,51,2,56
Queen's Park,8085,5,16,4,16,45,46,-1,52
Albion,8085,6,14,6,16,56,61,-5,48
East Fife,8085,7,12,7,17,47,56,-9,43
Peterhead,8085,8,11,7,18,43,57,-14,40
Stranraer,8085,9,10,5,21,45,67,-22,35
Stenhousem'r,8085,10,9,7,20,44,80,-36,34
Alloa,8086,1,21,6,9,74,41,33,69
Livingston,8086,2,19,6,11,75,48,27,63
Airdrieon,8086,3,17,7,12,58,51,7,58
Brechin,8086,4,16,6,14,44,45,-1,54
Peterhead,8086,5,14,8,14,49,53,-4,50
East Fife,8086,6,14,7,15,55,46,9,49
Queen's Park,8086,7,14,4,18,39,51,-12,46
Stranraer,8086,8,13,4,19,44,62,-18,43
Albion,8086,9,11,9,16,45,53,-8,42
Stenhousem'r,8086,10,9,7,20,40,73,-33,34
Livingston,8087,1,23,3,10,78,46,32,72
Alloa,8087,2,18,9,9,66,43,23,63
Airdrieon,8087,3,17,4,15,56,59,-3,55
Peterhead,8087,4,14,11,11,54,45,9,53
Brechin,8087,5,15,8,13,55,51,4,53
Queen's Park,8087,6,15,8,13,50,52,-2,53
Stranraer,8087,7,12,9,15,52,65,-13,45
East Fife,8087,8,10,10,16,45,46,-1,40
Albion,8087,9,10,9,17,52,65,-13,39
Stenhousem'r,8087,10,7,7,22,47,83,-36,28
Livingston,8088,1,24,2,10,82,44,38,74
Alloa,8088,2,15,11,10,64,46,18,56
Brechin,8088,3,16,7,13,49,46,3,55
Albion,8088,4,15,8,13,62,50,12,53
Peterhead,8088,5,14,9,13,48,48,0,51
Airdrieon,8088,6,14,8,14,46,49,-3,50
Queen's Park,8088,7,13,5,18,38,58,-20,44
East Fife,8088,8,11,10,15,51,53,-2,43
Stranraer,8088,9,12,5,19,52,65,-13,41
Stenhousem'r,8088,10,10,7,19,46,79,-33,37
Brechin,8089,1,22,2,12,57,44,13,68
Livingston,8089,2,19,5,12,78,51,27,62
Alloa,8089,3,18,8,10,64,46,18,62
Airdrieon,8089,4,17,6,13,60,53,7,57
Peterhead,8089,5,17,5,14,55,58,-3,56
Albion,8089,6,16,4,16,52,54,-2,52
East Fife,8089,7,10,12,14,53,46,7,42
Stranraer,8089,8,11,8,17,47,58,-11,41
Queen's Park,8089,9,10,5,21,31,57,-26,35
Stenhousem'r,8089,10,8,9,19,48,78,-30,33
Livingston,8090,1,18,9,9,72,47,25,63
Alloa,8090,2,17,7,12,64,40,24,58
Airdrieon,8090,3,17,7,12,55,47,8,58
Stranraer,8090,4,16,7,13,55,44,11,55
Brechin,8090,5,17,2,17,53,55,-2,53
Queen's Park,8090,6,15,7,14,36,46,-10,52
Albion,8090,7,12,10,14,55,54,1,46
Peterhead,8090,8,10,11,15,41,53,-12,41
East Fife,8090,9,9,13,14,48,56,-8,40
Stenhousem'r,8090,10,9,7,20,45,82,-37,34
Livingston,8091,1,22,5,9,78,47,31,71
Alloa,8091,2,20,7,9,74,42,32,67
Airdrieon,8091,3,16,7,13,52,55,-3,55
Stranraer,8091,4,16,6,14,57,49,8,54
Brechin,8091,5,16,2,18,51,53,-2,50
Peterhead,8091,6,12,11,13,43,47,-4,47
Albion,8091,7,12,9,15,49,49,0,45
East Fife,8091,8,12,8,16,46,49,-3,44
Queen's Park,8091,9,12,8,16,35,51,-16,44
Stenhousem'r,8091,10,7,7,22,44,87,-43,28
Livingston,8092,1,24,4,8,83,41,42,76
Alloa,8092,2,21,8,7,80,49,31,71
Airdrieon,8092,3,15,11,10,56,48,8,56
Albion,8092,4,15,10,11,58,52,6,55
Brechin,8092,5,14,7,15,45,53,-8,49
Queen's Park,8092,6,11,8,17,32,48,-16,41
Peterhead,8092,7,11,7,18,40,55,-15,40
Stenhousem'r,8092,8,10,8,18,53,81,-28,38
East Fife,8092,9,9,10,17,52,61,-9,37
Stranraer,8092,10,9,9,18,46,57,-11,36
Peterhead,8093,1,18,6,12,59,51,8,60
Livingston,8093,2,17,6,13,62,49,13,57
Airdrieon,8093,3,16,9,11,59,47,12,57
Queen's Park,8093,4,17,4,15,49,45,4,55
Alloa,8093,5,15,8,13,66,46,20,53
Albion,8093,6,14,11,11,51,51,0,53
Brechin,8093,7,14,8,14,41,45,-4,50
East Fife,8093,8,13,9,14,52,48,4,48
Stranraer,8093,9,12,7,17,46,61,-15,43
Stenhousem'r,8093,10,6,8,22,41,83,-42,26
Livingston,8094,1,18,7,11,73,53,20,61
Alloa,8094,2,18,6,12,67,40,27,60
Airdrieon,8094,3,16,11,9,64,58,6,59
Brechin,8094,4,16,10,10,50,48,2,58
East Fife,8094,5,14,8,14,54,45,9,50
Albion,8094,6,13,10,13,54,49,5,49
Stranraer,8094,7,14,5,17,59,58,1,47
Queen's Park,8094,8,13,6,17,35,53,-18,45
Peterhead,8094,9,10,9,17,40,59,-19,39
Stenhousem'r,8094,10,8,8,20,43,76,-33,32
Alloa,8095,1,21,8,7,80,38,42,71
Livingston,8095,2,22,3,11,76,50,26,69
Brechin,8095,3,18,7,11,59,45,14,61
Peterhead,8095,4,15,9,12,57,49,8,54
Stranraer,8095,5,14,6,16,50,59,-9,48
East Fife,8095,6,11,12,13,44,45,-1,45
Queen's Park,8095,7,12,7,17,32,57,-25,43
Airdrieon,8095,8,11,8,17,46,58,-12,41
Albion,8095,9,10,7,19,55,71,-16,37
Stenhousem'r,8095,10,10,5,21,48,75,-27,35
Livingston,8096,1,21,5,10,86,56,30,68
Albion,8096,2,14,15,7,62,54,8,57
Alloa,8096,3,15,11,10,70,56,14,56
Airdrieon,8096,4,15,11,10,57,54,3,56
Stranraer,8096,5,14,7,15,56,55,1,49
Peterhead,8096,6,11,13,12,48,52,-4,46
Brechin,8096,7,12,8,16,53,53,0,44
Queen's Park,8096,8,10,12,14,36,49,-13,42
East Fife,8096,9,10,11,15,48,52,-4,41
Stenhousem'r,8096,10,6,11,19,37,72,-35,29
Alloa,8097,1,19,7,10,71,45,26,64
Airdrieon,8097,2,18,7,11,68,60,8,61
Livingston,8097,3,18,6,12,73,50,23,60
Stranraer,8097,4,17,1,18,52,59,-7,52
East Fife,8097,5,15,6,15,67,49,18,51
Brechin,8097,6,15,4,17,49,61,-12,49
Peterhead,8097,7,14,6,16,44,51,-7,48
Queen's Park,8097,8,14,6,16,44,54,-10,48
Albion,8097,9,11,10,15,50,57,-7,43
Stenhousem'r,8097,10,8,9,19,49,81,-32,33
Alloa,8098,1,20,8,8,69,37,32,68
Brechin,8098,2,21,5,10,59,44,15,68
Airdrieon,8098,3,20,6,10,57,42,15,66
Livingston,8098,4,18,4,14,70,60,10,58
Albion,8098,5,15,7,14,51,50,1,52
East Fife,8098,6,13,10,13,47,36,11,49
Peterhead,8098,7,10,11,15,43,46,-3,41
Queen's Park,8098,8,11,7,18,38,57,-19,40
Stranraer,8098,9,9,8,19,43,66,-23,35
Stenhousem'r,8098,10,7,6,23,35,74,-39,27
Livingston,8099,1,22,4,10,73,48,25,70
Alloa,8099,2,19,7,10,69,46,23,64
Peterhead,8099,3,15,8,13,61,52,9,53
Brechin,8099,4,16,5,15,53,57,-4,53
Airdrieon,8099,5,15,7,14,70,63,7,52
Queen's Park,8099,6,15,4,17,37,50,-13,49
East Fife,8099,7,12,11,13,53,47,6,47
Stranraer,8099,8,13,6,17,50,61,-11,45
Albion,8099,9,9,11,16,39,48,-9,38
Stenhousem'r,8099,10,6,13,17,50,83,-33,31
Livingston,8100,1,20,5,11,77,48,29,65
Alloa,8100,2,16,10,10,67,49,18,58
Airdrieon,8100,3,17,7,12,76,62,14,58
Brechin,8100,4,16,8,12,55,48,7,56
Peterhead,8100,5,14,11,11,53,58,-5,53
Albion,8100,6,15,7,14,47,49,-2,52
Queen's Park,8100,7,13,9,14,47,48,-1,48
Stranraer,8100,8,11,6,19,49,69,-20,39
East Fife,8100,9,8,13,15,43,48,-5,37
Stenhousem'r,8100,10,7,10,19,43,78,-35,31
Livingston,8101,1,24,4,8,84,50,34,76
Airdrieon,8101,2,20,3,13,56,61,-5,63
Alloa,8101,3,19,5,12,71,44,27,62
Albion,8101,4,17,8,11,76,59,17,59
Brechin,8101,5,17,4,15,50,49,1,55
Stranraer,8101,6,15,4,17,50,58,-8,49
Peterhead,8101,7,12,10,14,49,59,-10,46
East Fife,8101,8,10,8,18,51,56,-5,38
Queen's Park,8101,9,9,8,19,35,54,-19,35
Stenhousem'r,8101,10,7,6,23,42,74,-32,27
Alloa,8102,1,21,5,10,67,42,25,68
Brechin,8102,2,19,4,13,54,49,5,61
Airdrieon,8102,3,17,5,14,61,59,2,56
Peterhead,8102,4,16,8,12,48,51,-3,56
Albion,8102,5,14,10,12,52,45,7,52
Livingston,8102,6,13,9,14,69,58,11,48
Queen's Park,8102,7,11,12,13,38,43,-5,45
Stranraer,8102,8,11,9,16,45,49,-4,42
East Fife,8102,9,10,9,17,43,53,-10,39
Stenhousem'r,8102,10,6,13,17,42,70,-28,31
Livingston,8103,1,23,4,9,93,51,42,73
Brechin,8103,2,18,8,10,61,48,13,62
Alloa,8103,3,16,12,8,67,43,24,60
Stranraer,8103,4,17,2,17,61,59,2,53
Airdrieon,8103,5,13,11,12,54,61,-7,50
Albion,8103,6,13,8,15,48,56,-8,47
Peterhead,8103,7,12,9,15,46,52,-6,45
Stenhousem'r,8103,8,9,11,16,46,67,-21,38
East Fife,8103,9,9,10,17,43,50,-7,37
Queen's Park,8103,10,9,7,20,30,62,-32,34
Livingston,8104,1,22,5,9,87,50,37,71
Airdrieon,8104,2,19,8,9,64,49,15,65
Alloa,8104,3,19,6,11,70,46,24,63
Peterhead,8104,4,15,7,14,49,53,-4,52
Brechin,8104,5,14,8,14,55,57,-2,50
Queen's Park,8104,6,14,8,14,48,54,-6,50
Stranraer,8104,7,13,5,18,53,62,-9,44
Albion,8104,8,12,8,16,43,58,-15,44
East Fife,8104,9,11,9,16,37,40,-3,42
Stenhousem'r,8104,10,5,8,23,42,79,-37,23
Livingston,8105,1,20,5,11,78,50,28,65
Airdrieon,8105,2,19,6,11,54,49,5,63
Peterhead,8105,3,17,7,12,53,53,0,58
Alloa,8105,4,15,11,10,67,46,21,56
Brechin,8105,5,16,8,12,56,56,0,56
Albion,8105,6,14,8,14,56,45,11,50
East Fife,8105,7,10,14,12,47,44,3,44
Stranraer,8105,8,12,6,18,48,64,-16,42
Queen's Park,8105,9,9,9,18,37,64,-27,36
Stenhousem'r,8105,10,8,6,22,53,78,-25,30
Alloa,8106,1,20,7,9,69,46,23,67
Livingston,8106,2,19,6,11,74,46,28,63
Brechin,8106,3,17,8,11,58,52,6,59
Airdrieon,8106,4,16,7,13,60,58,2,55
Albion,8106,5,14,8,14,64,51,13,50
East Fife,8106,6,14,7,15,55,55,0,49
Peterhead,8106,7,13,7,16,45,58,-13,46
Queen's Park,8106,8,12,6,18,37,50,-13,42
Stranraer,8106,9,12,5,19,49,62,-13,41
Stenhousem'r,8106,10,10,5,21,46,79,-33,35
Alloa,8107,1,21,8,7,74,45,29,71
Livingston,8107,2,21,4,11,68,42,26,67
Peterhead,8107,3,16,9,11,63,50,13,57
Brechin,8107,4,16,7,13,53,53,0,55
Airdrieon,8107,5,14,7,15,61,63,-2,49
Albion,8107,6,13,9,14,49,54,-5,48
East Fife,8107,7,11,9,16,47,53,-6,42
Queen's Park,8107,8,10,12,14,35,46,-11,42
Stenhousem'r,8107,9,11,6,19,48,73,-25,39
Stranraer,8107,10,9,5,22,44,63,-19,32
Alloa,8108,1,22,7,7,80,44,36,73
Livingston,8108,2,19,4,13,70,46,24,61
Airdrieon,8108,3,17,9,10,64,49,15,60
Brechin,8108,4,17,7,12,52,58,-6,58
Stranraer,8108,5,17,5,14,54,48,6,56
Peterhead,8108,6,12,9,15,44,47,-3,45
Queen's Park,8108,7,12,9,15,29,45,-16,45
East Fife,8108,8,10,9,17,45,48,-3,39
Albion,8108,9,10,9,17,42,58,-16,39
Stenhousem'r,8108,10,7,6,23,37,74,-37,27
Alloa,8109,1,22,7,7,65,35,30,73
Livingston,8109,2,20,5,11,69,45,24,65
Airdrieon,8109,3,16,7,13,58,50,8,55
Brechin,8109,4,16,4,16,51,49,2,52
East Fife,8109,5,13,10,13,51,44,7,49
Stranraer,8109,6,13,8,15,56,53,3,47
Peterhead,8109,7,12,8,16,44,51,-7,44
Queen's Park,8109,8,13,5,18,36,48,-12,44
Albion,8109,9,11,8,17,39,58,-19,41
Stenhousem'r,8109,10,9,8,19,48,84,-36,35
Livingston,8110,1,21,6,9,75,47,28,69
Alloa,8110,2,18,9,9,66,41,25,63
Brechin,8110,3,18,4,14,47,46,1,58
Airdrieon,8110,4,16,9,11,58,54,4,57
Albion,8110,5,16,7,13,53,50,3,55
Peterhead,8110,6,14,11,11,50,47,3,53
Stranraer,8110,7,13,8,15,52,54,-2,47
East Fife,8110,8,11,10,15,47,46,1,43
Queen's Park,8110,9,10,7,19,33,57,-24,37
Stenhousem'r,8110,10,3,9,24,34,73,-39,18
Airdrieon,8111,1,19,7,10,65,55,10,64
Livingston,8111,2,19,5,12,76,50,26,62
Brechin,8111,3,18,8,10,54,47,7,62
Albion,8111,4,15,9,12,59,56,3,54
Queen's Park,8111,5,12,12,12,39,43,-4,48
East Fife,8111,6,13,8,15,52,47,5,47
Alloa,8111,7,13,7,16,62,60,2,46
Peterhead,8111,8,13,7,16,47,54,-7,46
Stranraer,8111,9,12,4,20,51,65,-14,40
Stenhousem'r,8111,10,10,5,21,51,79,-28,35
Livingston,8112,1,25,1,10,88,48,40,76
Alloa,8112,2,18,7,11,77,51,26,61
Albion,8112,3,16,8,12,59,58,1,56
Airdrieon,8112,4,16,7,13,67,57,10,55
East Fife,8112,5,14,10,12,63,51,12,52
Brechin,8112,6,14,6,16,47,55,-8,48
Peterhead,8112,7,11,10,15,47,59,-12,43
Stranraer,8112,8,10,12,14,49,62,-13,42
Queen's Park,8112,9,10,9,17,34,52,-18,39
Stenhousem'r,8112,10,6,10,20,39,77,-38,28
Livingston,8113,1,22,4,10,80,47,33,70
Alloa,8113,2,19,9,8,71,40,31,66
Brechin,8113,3,17,7,12,48,40,8,58
Albion,8113,4,17,6,13,56,52,4,57
Airdrieon,8113,5,15,10,11,56,57,-1,55
Queen's Park,8113,6,13,7,16,51,59,-8,46
Stranraer,8113,7,12,9,15,49,58,-9,45
East Fife,8113,8,10,9,17,47,56,-9,39
Peterhead,8113,9,10,8,18,41,52,-11,38
Stenhousem'r,8113,10,8,5,23,45,83,-38,29
Alloa,8114,1,25,3,8,77,40,37,78
Livingston,8114,2,19,3,14,68,50,18,60
Brechin,8114,3,18,6,12,58,56,2,60
Peterhead,8114,4,17,7,12,50,44,6,58
Queen's Park,8114,5,15,7,14,44,51,-7,52
Airdrieon,8114,6,14,8,14,60,57,3,50
East Fife,8114,7,13,9,14,52,45,7,48
Albion,8114,8,11,6,19,52,67,-15,39
Stranraer,8114,9,9,7,20,48,65,-17,34
Stenhousem'r,8114,10,7,8,21,40,74,-34,29
Alloa,8115,1,17,10,9,65,44,21,61
Livingston,8115,2,17,8,11,67,53,14,59
Airdrieon,8115,3,17,8,11,54,44,10,59
Peterhead,8115,4,16,9,11,60,55,5,57
Brechin,8115,5,14,10,12,47,48,-1,52
East Fife,8115,6,14,9,13,48,44,4,51
Albion,8115,7,12,14,10,56,48,8,50
Queen's Park,8115,8,12,9,15,43,54,-11,45
Stranraer,8115,9,9,5,22,44,62,-18,32
Stenhousem'r,8115,10,7,8,21,45,77,-32,29
Alloa,8116,1,18,11,7,73,47,26,65
Livingston,8116,2,20,3,13,69,49,20,63
Stranraer,8116,3,18,5,13,61,51,10,59
Brechin,8116,4,17,4,15,50,48,2,55
Peterhead,8116,5,15,9,12,52,50,2,54
Albion,8116,6,14,9,13,52,47,5,51
Airdrieon,8116,7,12,8,16,53,57,-4,44
Queen's Park,8116,8,12,7,17,35,58,-23,43
East Fife,8116,9,10,9,17,39,49,-10,39
Stenhousem'r,8116,10,8,7,21,37,65,-28,31
Alloa,8117,1,20,7,9,78,42,36,67
Brechin,8117,2,20,5,11,59,46,13,65
Airdrieon,8117,3,20,4,12,59,55,4,64
Livingston,8117,4,20,2,14,68,47,21,62
Albion,8117,5,16,8,12,60,47,13,56
Stranraer,8117,6,16,4,16,59,60,-1,52
East Fife,8117,7,11,9,16,54,63,-9,42
Queen's Park,8117,8,11,8,17,37,48,-11,41
Peterhead,8117,9,7,12,17,36,59,-23,33
Stenhousem'r,8117,10,5,9,22,37,80,-43,24
Alloa,8118,1,24,7,5,88,40,48,79
Livingston,8118,2,17,7,12,76,57,19,58
Peterhead,8118,3,16,8,12,49,43,6,56
Stranraer,8118,4,15,6,15,58,55,3,51
Brechin,8118,5,14,8,14,44,44,0,50
Airdrieon,8118,6,14,5,17,47,62,-15,47
Queen's Park,8118,7,13,6,17,40,57,-17,45
East Fife,8118,8,11,11,14,47,44,3,44
Albion,8118,9,12,7,17,51,54,-3,43
Stenhousem'r,8118,10,8,7,21,45,89,-44,31
Brechin,8119,1,20,6,10,58,47,11,66
Alloa,8119,2,19,7,10,77,49,28,64
Livingston,8119,3,20,4,12,78,51,27,64
Peterhead,8119,4,18,4,14,48,51,-3,58
Albion,8119,5,17,6,13,58,44,14,57
Airdrieon,8119,6,14,6,16,56,52,4,48
East Fife,8119,7,12,8,16,45,52,-7,44
Stranraer,8119,8,11,7,18,46,62,-16,40
Stenhousem'r,8119,9,9,7,20,54,80,-26,34
Queen's Park,8119,10,9,7,20,30,62,-32,34
Livingston,8120,1,21,7,8,72,42,30,70
Airdrieon,8120,2,19,5,12,61,52,9,62
Alloa,8120,3,16,10,10,67,56,11,58
Brechin,8120,4,15,8,13,45,48,-3,53
Peterhead,8120,5,13,10,13,49,50,-1,49
East Fife,8120,6,12,11,13,45,41,4,47
Queen's Park,8120,7,13,8,15,43,48,-5,47
Stranraer,8120,8,11,8,17,47,52,-5,41
Albion,8120,9,9,13,14,50,52,-2,40
Stenhousem'r,8120,10,8,6,22,46,84,-38,30
Alloa,8121,1,20,8,8,81,41,40,68
Livingston,8121,2,21,5,10,75,45,30,68
Airdrieon,8121,3,17,10,9,64,54,10,61
Brechin,8121,4,17,8,11,63,52,11,59
Peterhead,8121,5,12,11,13,48,53,-5,47
Albion,8121,6,12,10,14,50,56,-6,46
Stranraer,8121,7,11,9,16,52,63,-11,42
Queen's Park,8121,8,11,9,16,38,55,-17,42
Stenhousem'r,8121,9,8,12,16,53,84,-31,36
East Fife,8121,10,5,10,21,35,56,-21,25
Livingston,8122,1,21,6,9,81,46,35,69
Alloa,8122,2,19,8,9,65,44,21,65
Airdrieon,8122,3,16,10,10,56,48,8,58
Brechin,8122,4,15,8,13,49,41,8,53
Albion,8122,5,15,7,14,52,54,-2,52
Queen's Park,8122,6,15,7,14,43,45,-2,52
Peterhead,8122,7,14,8,14,51,48,3,50
Stranraer,8122,8,11,6,19,40,59,-19,39
East Fife,8122,9,9,10,17,50,53,-3,37
Stenhousem'r,8122,10,7,6,23,44,93,-49,27
Livingston,8123,1,24,4,8,86,50,36,76
Alloa,8123,2,16,8,12,68,54,14,56
Airdrieon,8123,3,16,8,12,61,53,8,56
Peterhead,8123,4,16,8,12,52,49,3,56
Queen's Park,8123,5,14,10,12,48,49,-1,52
Stranraer,8123,6,14,5,17,50,56,-6,47
Brechin,8123,7,13,8,15,47,55,-8,47
East Fife,8123,8,12,7,17,53,50,3,43
Albion,8123,9,11,10,15,49,56,-7,43
Stenhousem'r,8123,10,7,6,23,45,87,-42,27
Livingston,8124,1,18,6,12,72,49,23,60
Airdrieon,8124,2,18,5,13,65,50,15,59
Brechin,8124,3,16,8,12,47,48,-1,56
Alloa,8124,4,15,8,13,61,53,8,53
Peterhead,8124,5,14,9,13,50,50,0,51
East Fife,8124,6,13,11,12,56,47,9,50
Albion,8124,7,14,8,14,60,57,3,50
Queen's Park,8124,8,13,9,14,40,46,-6,48
Stranraer,8124,9,12,5,19,54,63,-9,41
Stenhousem'r,8124,10,8,9,19,43,85,-42,33
Alloa,8125,1,21,4,11,67,44,23,67
Brechin,8125,2,21,4,11,61,44,17,67
Livingston,8125,3,19,8,9,74,46,28,65
Peterhead,8125,4,17,7,12,49,48,1,58
Airdrieon,8125,5,14,7,15,56,53,3,49
East Fife,8125,6,11,12,13,57,45,12,45
Queen's Park,8125,7,12,8,16,39,50,-11,44
Albion,8125,8,11,8,17,45,59,-14,41
Stranraer,8125,9,12,4,20,45,64,-19,40
Stenhousem'r,8125,10,9,4,23,47,87,-40,31
Airdrieon,8126,1,19,7,10,67,51,16,64
Alloa,8126,2,18,8,10,65,47,18,62
Peterhead,8126,3,16,11,9,53,46,7,59
Livingston,8126,4,15,7,14,67,52,15,52
Brechin,8126,5,16,4,16,56,54,2,52
Stranraer,8126,6,15,6,15,57,57,0,51
Albion,8126,7,14,8,14,56,58,-2,50
East Fife,8126,8,11,9,16,44,48,-4,42
Queen's Park,8126,9,10,7,19,35,53,-18,37
Stenhousem'r,8126,10,9,7,20,47,81,-34,34
Livingston,8127,1,22,6,8,79,44,35,72
Alloa,8127,2,19,8,9,75,47,28,65
Airdrieon,8127,3,18,7,11,64,53,11,61
East Fife,8127,4,13,9,14,48,45,3,48
Albion,8127,5,13,9,14,53,55,-2,48
Brechin,8127,6,13,8,15,47,50,-3,47
Peterhead,8127,7,13,7,16,52,62,-10,46
Queen's Park,8127,8,13,5,18,38,51,-13,44
Stranraer,8127,9,12,6,18,50,59,-9,42
Stenhousem'r,8127,10,10,3,23,48,88,-40,33
Alloa,8128,1,20,9,7,74,37,37,69
Airdrieon,8128,2,18,8,10,67,50,17,62
Brechin,8128,3,18,4,14,44,39,5,58
Livingston,8128,4,15,9,12,71,57,14,54
Peterhead,8128,5,15,6,15,57,62,-5,51
Stranraer,8128,6,14,6,16,51,56,-5,48
Queen's Park,8128,7,13,6,17,42,55,-13,45
East Fife,8128,8,9,13,14,47,52,-5,40
Albion,8128,9,10,8,18,51,67,-16,38
Stenhousem'r,8128,10,9,9,18,43,72,-29,36
Brechin,8129,1,19,4,13,55,53,2,61
Airdrieon,8129,2,17,8,11,64,52,12,59
Alloa,8129,3,16,9,11,57,45,12,57
Livingston,8129,4,17,3,16,76,62,14,54
East Fife,8129,5,14,9,13,59,54,5,51
Stranraer,8129,6,14,7,15,50,55,-5,49
Peterhead,8129,7,14,5,17,52,54,-2,47
Albion,8129,8,12,9,15,48,53,-5,45
Queen's Park,8129,9,13,4,19,30,49,-19,43
Stenhousem'r,8129,10,11,8,17,50,64,-14,41
Alloa,8130,1,20,8,8,73,45,28,68
Livingston,8130,2,18,7,11,63,46,17,61
East Fife,8130,3,15,11,10,56,37,19,56
Airdrieon,8130,4,14,10,12,55,53,2,52
Brechin,8130,5,13,10,13,40,48,-8,49
Queen's Park,8130,6,12,9,15,37,47,-10,45
Peterhead,8130,7,13,6,17,46,57,-11,45
Stranraer,8130,8,11,8,17,44,54,-10,41
Albion,8130,9,11,8,17,47,58,-11,41
Stenhousem'r,8130,10,9,11,16,57,73,-16,38
Alloa,8131,1,21,8,7,84,52,32,71
Livingston,8131,2,19,5,12,73,52,21,62
Brechin,8131,3,16,5,15,49,47,2,53
Albion,8131,4,13,12,11,59,52,7,51
East Fife,8131,5,13,11,12,56,52,4,50
Peterhead,8131,6,14,8,14,57,59,-2,50
Airdrieon,8131,7,12,11,13,58,68,-10,47
Queen's Park,8131,8,12,10,14,44,51,-7,46
Stranraer,8131,9,12,8,16,64,73,-9,44
Stenhousem'r,8131,10,5,8,23,43,81,-38,23
Alloa,8132,1,20,8,8,75,44,31,68
Airdrieon,8132,2,18,9,9,58,44,14,63
Albion,8132,3,16,10,10,55,39,16,58
Livingston,8132,4,15,7,14,67,55,12,52
Queen's Park,8132,5,14,10,12,44,47,-3,52
Peterhead,8132,6,14,7,15,48,49,-1,49
Brechin,8132,7,14,7,15,48,51,-3,49
Stranraer,8132,8,10,9,17,44,54,-10,39
East Fife,8132,9,10,8,18,44,61,-17,38
Stenhousem'r,8132,10,7,9,20,45,84,-39,30
Alloa,8133,1,17,10,9,69,51,18,61
Airdrieon,8133,2,17,8,11,61,51,10,59
Livingston,8133,3,16,9,11,70,51,19,57
Albion,8133,4,16,8,12,62,53,9,56
Brechin,8133,5,16,4,16,46,46,0,52
Peterhead,8133,6,16,3,17,46,50,-4,51
Queen's Park,8133,7,14,7,15,42,46,-4,49
Stranraer,8133,8,13,6,17,47,51,-4,45
Stenhousem'r,8133,9,10,7,19,52,87,-35,37
East Fife,8133,10,8,12,16,43,52,-9,36
Alloa,8134,1,23,6,7,82,39,43,75
Airdrieon,8134,2,21,7,8,69,48,21,70
Livingston,8134,3,17,6,13,72,51,21,57
East Fife,8134,4,15,9,12,52,44,8,54
Brechin,8134,5,15,8,13,56,54,2,53
Queen's Park,8134,6,13,9,14,43,51,-8,48
Peterhead,8134,7,12,8,16,47,52,-5,44
Albion,8134,8,10,11,15,49,58,-9,41
Stranraer,8134,9,11,5,20,44,65,-21,38
Stenhousem'r,8134,10,4,9,23,39,91,-52,21
Alloa,8135,1,19,6,11,75,47,28,63
Livingston,8135,2,18,6,12,74,49,25,60
Airdrieon,8135,3,16,10,10,61,50,11,58
Brechin,8135,4,15,7,14,52,51,1,52
Albion,8135,5,13,11,12,64,58,6,50
Queen's Park,8135,6,13,10,13,42,48,-6,49
Peterhead,8135,7,12,10,14,52,63,-11,46
East Fife,8135,8,11,10,15,50,54,-4,43
Stranraer,8135,9,13,4,19,52,66,-14,43
Stenhousem'r,8135,10,8,10,18,43,79,-36,34
Livingston,8136,1,22,8,6,87,53,34,74
Alloa,8136,2,19,9,8,70,39,31,66
Brechin,8136,3,17,7,12,47,44,3,58
Albion,8136,4,16,8,12,58,45,13,56
Airdrieon,8136,5,16,8,12,71,65,6,56
Peterhead,8136,6,15,6,15,48,50,-2,51
Queen's Park,8136,7,10,10,16,34,55,-21,40
Stranraer,8136,8,11,5,20,41,57,-16,38
East Fife,8136,9,7,13,16,41,57,-16,34
Stenhousem'r,8136,10,7,6,23,44,76,-32,27
Livingston,8137,1,22,4,10,86,49,37,70
Alloa,8137,2,18,10,8,70,48,22,64
Brechin,8137,3,16,6,14,57,59,-2,54
Albion,8137,4,15,8,13,55,58,-3,53
Airdrieon,8137,5,16,4,16,61,58,3,52
East Fife,8137,6,13,9,14,57,48,9,48
Peterhead,8137,7,13,8,15,48,59,-11,47
Stranraer,8137,8,12,7,17,52,57,-5,43
Queen's Park,8137,9,9,10,17,39,58,-19,37
Stenhousem'r,8137,10,9,8,19,46,77,-31,35
Livingston,8138,1,25,3,8,86,39,47,78
Alloa,8138,2,18,9,9,58,38,20,63
Albion,8138,3,15,10,11,59,49,10,55
Stranraer,8138,4,17,3,16,56,56,0,54
Brechin,8138,5,16,4,16,48,54,-6,52
Airdrieon,8138,6,14,8,14,61,63,-2,50
East Fife,8138,7,13,8,15,53,52,1,47
Peterhead,8138,8,10,11,15,47,57,-10,41
Queen's Park,8138,9,8,10,18,32,56,-24,34
Stenhousem'r,8138,10,7,8,21,52,88,-36,29
Livingston,8139,1,20,7,9,71,46,25,67
Brechin,8139,2,21,4,11,54,41,13,67
Airdrieon,8139,3,18,7,11,60,50,10,61
Alloa,8139,4,18,6,12,73,50,23,60
Queen's Park,8139,5,13,10,13,42,48,-6,49
Peterhead,8139,6,13,8,15,56,61,-5,47
East Fife,8139,7,11,13,12,48,45,3,46
Albion,8139,8,12,7,17,55,56,-1,43
Stranraer,8139,9,11,5,20,44,58,-14,38
Stenhousem'r,8139,10,6,7,23,41,89,-48,25
Alloa,8140,1,21,7,8,69,41,28,70
Airdrieon,8140,2,19,7,10,57,43,14,64
Livingston,8140,3,17,7,12,72,53,19,58
Albion,8140,4,17,6,13,56,47,9,57
Brechin,8140,5,14,6,16,49,55,-6,48
Queen's Park,8140,6,13,9,14,34,47,-13,48
Peterhead,8140,7,10,12,14,50,55,-5,42
Stenhousem'r,8140,8,11,8,17,55,77,-22,41
Stranraer,8140,9,10,9,17,48,58,-10,39
East Fife,8140,10,7,11,18,38,52,-14,32
Livingston,8141,1,21,5,10,71,46,25,68
Airdrieon,8141,2,19,6,11,67,50,17,63
Alloa,8141,3,17,9,10,70,50,20,60
Albion,8141,4,18,5,13,55,52,3,59
Brechin,8141,5,16,8,12,49,47,2,56
East Fife,8141,6,15,9,12,61,44,17,54
Stranraer,8141,7,12,6,18,50,58,-8,42
Peterhead,8141,8,10,9,17,45,58,-13,39
Queen's Park,8141,9,10,6,20,29,59,-30,36
Stenhousem'r,8141,10,6,9,21,42,75,-33,27
Livingston,8142,1,21,7,8,76,46,30,70
Brechin,8142,2,22,4,10,60,47,13,70
Alloa,8142,3,20,7,9,73,44,29,67
Airdrieon,8142,4,15,6,15,56,57,-1,51
Peterhead,8142,5,13,9,14,51,56,-5,48
Albion,8142,6,14,4,18,58,62,-4,46
Stranraer,8142,7,12,8,16,52,55,-3,44
East Fife,8142,8,12,8,16,47,53,-6,44
Queen's Park,8142,9,11,7,18,38,54,-16,40
Stenhousem'r,8142,10,7,6,23,42,79,-37,27
Livingston,8143,1,21,5,10,81,47,34,68
Airdrieon,8143,2,19,5,12,59,54,5,62
Alloa,8143,3,18,7,11,69,48,21,61
Stranraer,8143,4,17,6,13,56,53,3,57
Brechin,8143,5,16,7,13,51,50,1,55
Peterhead,8143,6,15,5,16,52,53,-1,50
Albion,8143,7,13,8,15,62,63,-1,47
East Fife,8143,8,12,6,18,49,50,-1,42
Queen's Park,8143,9,8,12,16,42,59,-17,36
Stenhousem'r,8143,10,7,7,22,43,87,-44,28
Livingston,8144,1,22,9,5,79,38,41,75
Alloa,8144,2,18,8,10,70,49,21,62
Brechin,8144,3,16,10,10,53,47,6,58
Airdrieon,8144,4,15,10,11,68,54,14,55
Albion,8144,5,14,7,15,52,52,0,49
Stranraer,8144,6,14,7,15,55,60,-5,49
Peterhead,8144,7,14,7,15,50,56,-6,49
East Fife,8144,8,10,8,18,51,54,-3,38
Stenhousem'r,8144,9,9,7,20,47,82,-35,34
Queen's Park,8144,10,7,9,20,26,59,-33,30
Livingston,8145,1,20,4,12,62,46,16,64
Airdrieon,8145,2,19,6,11,74,60,14,63
Alloa,8145,3,17,11,8,74,47,27,62
Albion,8145,4,17,6,13,57,53,4,57
Queen's Park,8145,5,15,8,13,45,50,-5,53
Brechin,8145,6,14,10,12,51,52,-1,52
Peterhead,8145,7,12,9,15,50,51,-1,45
East Fife,8145,8,9,11,16,49,53,-4,38
Stranraer,8145,9,10,6,20,43,64,-21,36
Stenhousem'r,8145,10,7,9,20,46,75,-29,30
Livingston,8146,1,23,4,9,87,45,42,73
Alloa,8146,2,20,8,8,74,48,26,68
Airdrieon,8146,3,21,5,10,70,50,20,68
Peterhead,8146,4,14,5,17,50,54,-4,47
Stranraer,8146,5,14,5,17,48,56,-8,47
Brechin,8146,6,13,7,16,45,54,-9,46
East Fife,8146,7,12,8,16,56,52,4,44
Albion,8146,8,12,7,17,54,64,-10,43
Queen's Park,8146,9,10,8,18,32,62,-30,38
Stenhousem'r,8146,10,9,7,20,48,79,-31,34
Alloa,8147,1,24,6,6,78,37,41,78
Airdrieon,8147,2,20,4,12,64,49,15,64
Livingston,8147,3,19,6,11,74,52,22,63
Albion,8147,4,15,9,12,61,51,10,54
Peterhead,8147,5,15,9,12,53,49,4,54
East Fife,8147,6,12,9,15,52,52,0,45
Brechin,8147,7,12,8,16,47,59,-12,44
Stranraer,8147,8,11,6,19,44,58,-14,39
Queen's Park,8147,9,9,6,21,28,55,-27,33
Stenhousem'r,8147,10,8,7,21,49,88,-39,31
Alloa,8148,1,21,6,9,73,45,28,69
Livingston,8148,2,21,4,11,69,44,25,67
Airdrieon,8148,3,18,6,12,68,60,8,60
Brechin,8148,4,18,5,13,52,42,10,59
Albion,8148,5,12,14,10,49,45,4,50
Queen's Park,8148,6,13,9,14,36,45,-9,48
Peterhead,8148,7,12,7,17,44,57,-13,43
Stranraer,8148,8,11,3,22,47,67,-20,36
Stenhousem'r,8148,9,8,11,17,52,76,-24,35
East Fife,8148,10,7,13,16,43,52,-9,34
Livingston,8149,1,22,3,11,86,50,36,69
Alloa,8149,2,16,10,10,61,42,19,58
Peterhead,8149,3,17,6,13,45,43,2,57
Stranraer,8149,4,16,5,15,53,60,-7,53
Airdrieon,8149,5,15,7,14,55,56,-1,52
Brechin,8149,6,15,6,15,51,50,1,51
Albion,8149,7,13,9,14,48,55,-7,48
East Fife,8149,8,11,11,14,53,46,7,44
Queen's Park,8149,9,11,7,18,38,57,-19,40
Stenhousem'r,8149,10,9,6,21,41,72,-31,33
Airdrieon,8150,1,20,6,10,53,39,14,66
Livingston,8150,2,20,3,13,74,51,23,63
Alloa,8150,3,17,10,9,67,43,24,61
Peterhead,8150,4,14,8,14,47,55,-8,50
Brechin,8150,5,14,7,15,47,50,-3,49
Queen's Park,8150,6,12,9,15,39,54,-15,45
Albion,8150,7,12,7,17,57,58,-1,43
East Fife,8150,8,10,12,14,45,50,-5,42
Stranraer,8150,9,11,8,17,59,62,-3,41
Stenhousem'r,8150,10,10,10,16,44,70,-26,40
Livingston,8151,1,18,12,6,72,43,29,66
Alloa,8151,2,19,7,10,67,39,28,64
Albion,8151,3,16,10,10,57,50,7,58
Airdrieon,8151,4,16,7,13,56,55,1,55
Brechin,8151,5,13,10,13,47,47,0,49
Peterhead,8151,6,13,8,15,46,53,-7,47
Stranraer,8151,7,13,8,15,45,52,-7,47
East Fife,8151,8,10,9,17,42,46,-4,39
Queen's Park,8151,9,10,7,19,32,51,-19,37
Stenhousem'r,8151,10,8,10,18,39,67,-28,34
Alloa,8152,1,22,8,6,75,38,37,74
Livingston,8152,2,21,5,10,69,44,25,68
Airdrieon,8152,3,17,7,12,57,55,2,58
Brechin,8152,4,16,8,12,47,44,3,56
Albion,8152,5,14,8,14,61,58,3,50
Queen's Park,8152,6,13,6,17,41,49,-8,45
East Fife,8152,7,10,11,15,47,50,-3,41
Peterhead,8152,8,11,6,19,47,67,-20,39
Stranraer,8152,9,11,5,20,41,58,-17,38
Stenhousem'r,8152,10,10,6,20,48,70,-22,36
Livingston,8153,1,18,6,12,71,47,24,60
Airdrieon,8153,2,18,6,12,54,53,1,60
Alloa,8153,3,16,10,10,63,41,22,58
Brechin,8153,4,15,9,12,53,48,5,54
Stranraer,8153,5,16,5,15,53,56,-3,53
Albion,8153,6,13,11,12,54,53,1,50
Peterhead,8153,7,13,6,17,48,52,-4,45
Queen's Park,8153,8,12,9,15,42,55,-13,45
East Fife,8153,9,9,12,15,41,45,-4,39
Stenhousem'r,8153,10,10,6,20,49,78,-29,36
Alloa,8154,1,24,3,9,83,41,42,75
Livingston,8154,2,23,3,10,86,51,35,72
Airdrieon,8154,3,21,3,12,70,53,17,66
Brechin,8154,4,15,8,13,50,45,5,53
East Fife,8154,5,15,6,15,53,44,9,51
Albion,8154,6,14,6,16,50,54,-4,48
Queen's Park,8154,7,14,6,16,36,55,-19,48
Stranraer,8154,8,11,6,19,44,63,-19,39
Peterhead,8154,9,10,7,19,46,65,-19,37
Stenhousem'r,8154,10,7,4,25,42,89,-47,25
Alloa,8155,1,25,6,5,77,37,40,81
Livingston,8155,2,22,6,8,72,40,32,72
Albion,8155,3,15,9,12,60,50,10,54
Brechin,8155,4,16,6,14,52,49,3,54
Airdrieon,8155,5,16,6,14,52,56,-4,54
Peterhead,8155,6,12,9,15,40,45,-5,45
East Fife,8155,7,11,11,14,44,45,-1,44
Stranraer,8155,8,13,4,19,46,59,-13,43
Queen's Park,8155,9,8,6,22,29,55,-26,30
Stenhousem'r,8155,10,8,5,23,45,81,-36,29
Alloa,8156,1,25,5,6,78,39,39,80
Livingston,8156,2,18,9,9,78,52,26,63
Albion,8156,3,13,10,13,55,54,1,49
Stranraer,8156,4,14,7,15,52,56,-4,49
Brechin,8156,5,14,7,15,48,52,-4,49
Airdrieon,8156,6,12,12,12,50,52,-2,48
Peterhead,8156,7,13,7,16,49,54,-5,46
Queen's Park,8156,8,13,5,18,39,52,-13,44
East Fife,8156,9,11,8,17,47,52,-5,41
Stenhousem'r,8156,10,8,8,20,54,87,-33,32
Alloa,8157,1,20,8,8,72,46,26,68
Airdrieon,8157,2,18,8,10,58,48,10,62
Livingston,8157,3,17,7,12,71,49,22,58
Queen's Park,8157,4,16,6,14,39,44,-5,54
Albion,8157,5,15,8,13,57,53,4,53
Brechin,8157,6,16,5,15,42,44,-2,53
East Fife,8157,7,11,10,15,47,49,-2,43
Stenhousem'r,8157,8,12,5,19,57,76,-19,41
Peterhead,8157,9,10,8,18,38,52,-14,38
Stranraer,8157,10,10,5,21,40,60,-20,35
Livingston,8158,1,24,6,6,82,41,41,78
Airdrieon,8158,2,19,5,12,67,55,12,62
Alloa,8158,3,18,6,12,68,50,18,60
Brechin,8158,4,15,6,15,48,47,1,51
East Fife,8158,5,15,6,15,54,59,-5,51
Queen's Park,8158,6,14,7,15,44,56,-12,49
Stenhousem'r,8158,7,12,5,19,53,75,-22,41
Stranraer,8158,8,10,9,17,55,68,-13,39
Albion,8158,9,10,8,18,52,58,-6,38
Peterhead,8158,10,10,8,18,46,60,-14,38
Alloa,8159,1,18,11,7,61,37,24,65
Stranraer,8159,2,17,8,11,63,51,12,59
Livingston,8159,3,17,6,13,71,55,16,57
Airdrieon,8159,4,16,8,12,60,57,3,56
Brechin,8159,5,16,7,13,55,50,5,55
Queen's Park,8159,6,16,5,15,43,48,-5,53
Albion,8159,7,11,10,15,48,52,-4,43
Peterhead,8159,8,11,8,17,54,70,-16,41
East Fife,8159,9,9,10,17,45,49,-4,37
Stenhousem'r,8159,10,8,9,19,38,69,-31,33
Livingston,8160,1,21,3,12,75,54,21,66
Alloa,8160,2,18,11,7,71,45,26,65
Airdrieon,8160,3,18,9,9,62,49,13,63
Brechin,8160,4,17,7,12,53,48,5,58
Peterhead,8160,5,13,9,14,45,51,-6,48
Albion,8160,6,13,8,15,56,54,2,47
East Fife,8160,7,11,9,16,52,50,2,42
Queen's Park,8160,8,10,9,17,35,52,-17,39
Stranraer,8160,9,10,7,19,48,60,-12,37
Stenhousem'r,8160,10,10,6,20,46,80,-34,36
Alloa,8161,1,15,13,8,63,44,19,58
Brechin,8161,2,17,7,12,50,43,7,58
Livingston,8161,3,15,10,11,64,50,14,55
Airdrieon,8161,4,16,7,13,57,55,2,55
Albion,8161,5,15,9,12,56,51,5,54
Queen's Park,8161,6,13,12,11,41,44,-3,51
Peterhead,8161,7,13,9,14,46,47,-1,48
Stenhousem'r,8161,8,11,9,16,47,64,-17,42
East Fife,8161,9,9,11,16,39,45,-6,38
Stranraer,8161,10,10,5,21,48,68,-20,35
Livingston,8162,1,23,5,8,81,41,40,74
Alloa,8162,2,19,9,8,63,35,28,66
Airdrieon,8162,3,17,8,11,60,49,11,59
Brechin,8162,4,17,7,12,50,42,8,58
Peterhead,8162,5,14,9,13,42,40,2,51
Albion,8162,6,14,8,14,51,51,0,50
East Fife,8162,7,11,8,17,48,49,-1,41
Queen's Park,8162,8,11,8,17,41,58,-17,41
Stranraer,8162,9,12,4,20,45,68,-23,40
Stenhousem'r,8162,10,5,8,23,41,89,-48,23
Alloa,8163,1,24,4,8,84,44,40,76
Livingston,8163,2,24,1,11,82,48,34,73
Brechin,8163,3,17,7,12,45,46,-1,58
Peterhead,8163,4,17,3,16,55,45,10,54
Airdrieon,8163,5,15,8,13,57,56,1,53
Albion,8163,6,13,11,12,50,46,4,50
Queen's Park,8163,7,14,4,18,42,50,-8,46
East Fife,8163,8,8,11,17,40,53,-13,35
Stranraer,8163,9,10,4,22,43,65,-22,34
Stenhousem'r,8163,10,8,7,21,42,87,-45,31
Livingston,8164,1,24,7,5,82,41,41,79
Alloa,8164,2,19,9,8,89,59,30,66
Airdrieon,8164,3,18,7,11,66,50,16,61
Brechin,8164,4,16,6,14,55,49,6,54
Stranraer,8164,5,14,9,13,63,54,9,51
East Fife,8164,6,12,8,16,53,62,-9,44
Peterhead,8164,7,11,8,17,37,55,-18,41
Queen's Park,8164,8,10,10,16,36,49,-13,40
Albion,8164,9,8,10,18,42,65,-23,34
Stenhousem'r,8164,10,7,8,21,44,83,-39,29
Airdrieon,8165,1,22,6,8,68,48,20,72
Alloa,8165,2,19,6,11,70,43,27,63
Livingston,8165,3,18,7,11,73,53,20,61
Albion,8165,4,15,7,14,51,48,3,52
Queen's Park,8165,5,13,11,12,43,48,-5,50
East Fife,8165,6,14,7,15,48,43,5,49
Brechin,8165,7,14,6,16,46,56,-10,48
Peterhead,8165,8,11,8,17,39,48,-9,41
Stranraer,8165,9,10,9,17,57,69,-12,39
Stenhousem'r,8165,10,8,5,23,45,84,-39,29
Alloa,8166,1,20,7,9,63,35,28,67
Brechin,8166,2,18,5,13,53,43,10,59
Airdrieon,8166,3,17,8,11,52,48,4,59
Queen's Park,8166,4,17,5,14,40,46,-6,56
Livingston,8166,5,17,4,15,76,56,20,55
Albion,8166,6,15,10,11,52,47,5,55
East Fife,8166,7,13,8,15,52,48,4,47
Peterhead,8166,8,13,8,15,47,51,-4,47
Stranraer,8166,9,10,8,18,51,73,-22,38
Stenhousem'r,8166,10,5,7,24,39,78,-39,22
Alloa,8167,1,18,9,9,71,39,32,63
Livingston,8167,2,18,7,11,64,49,15,61
Airdrieon,8167,3,17,7,12,65,56,9,58
Queen's Park,8167,4,17,7,12,50,49,1,58
Albion,8167,5,14,8,14,57,56,1,50
Peterhead,8167,6,13,9,14,42,48,-6,48
East Fife,8167,7,12,8,16,56,56,0,44
Stranraer,8167,8,13,5,18,54,62,-8,44
Brechin,8167,9,11,11,14,44,58,-14,44
Stenhousem'r,8167,10,8,7,21,48,78,-30,31
Brechin,8168,1,23,5,8,66,34,32,74
Livingston,8168,2,21,4,11,73,56,17,67
Airdrieon,8168,3,21,4,11,65,48,17,67
Alloa,8168,4,15,10,11,61,44,17,55
Stranraer,8168,5,13,7,16,50,54,-4,46
Peterhead,8168,6,13,6,17,46,57,-11,45
Queen's Park,8168,7,13,6,17,35,53,-18,45
Albion,8168,8,12,7,17,46,55,-9,43
East Fife,8168,9,7,12,17,45,59,-14,33
Stenhousem'r,8168,10,7,9,20,37,64,-27,30
Alloa,8169,1,20,10,6,76,36,40,70
Brechin,8169,2,18,9,9,50,32,18,63
Livingston,8169,3,18,8,10,71,44,27,62
Airdrieon,8169,4,16,6,14,54,56,-2,54
East Fife,8169,5,15,6,15,51,52,-1,51
Peterhead,8169,6,14,8,14,48,49,-1,50
Queen's Park,8169,7,12,9,15,38,49,-11,45
Stranraer,8169,8,9,11,16,42,54,-12,38
Albion,8169,9,8,13,15,49,61,-12,37
Stenhousem'r,8169,10,6,8,22,41,87,-46,26
Livingston,8170,1,22,3,11,75,45,30,69
Peterhead,8170,2,17,12,7,58,44,14,63
Alloa,8170,3,18,8,10,65,43,22,62
Brechin,8170,4,16,5,15,56,51,5,53
East Fife,8170,5,15,7,14,57,50,7,52
Albion,8170,6,14,8,14,53,52,1,50
Queen's Park,8170,7,14,8,14,37,48,-11,50
Airdrieon,8170,8,13,7,16,57,67,-10,46
Stranraer,8170,9,12,3,21,40,55,-15,39
Stenhousem'r,8170,10,4,9,23,41,84,-43,21
Livingston,8171,1,20,6,10,69,44,25,66
Alloa,8171,2,18,9,9,70,40,30,63
Albion,8171,3,15,9,12,56,52,4,54
Peterhead,8171,4,14,11,11,57,46,11,53
Airdrieon,8171,5,14,8,14,57,62,-5,50
East Fife,8171,6,12,12,12,52,44,8,48
Brechin,8171,7,14,6,16,51,55,-4,48
Stranraer,8171,8,12,7,17,54,65,-11,43
Queen's Park,8171,9,12,4,20,31,61,-30,40
Stenhousem'r,8171,10,7,12,17,49,77,-28,33
Alloa,8172,1,19,8,9,68,38,30,65
Livingston,8172,2,18,7,11,70,54,16,61
Airdrieon,8172,3,15,13,8,60,45,15,58
Brechin,8172,4,17,6,13,51,45,6,57
Albion,8172,5,15,10,11,53,45,8,55
Peterhead,8172,6,14,10,12,51,49,2,52
Queen's Park,8172,7,13,6,17,43,50,-7,45
Stranraer,8172,8,12,4,20,48,65,-17,40
East Fife,8172,9,8,10,18,44,56,-12,34
Stenhousem'r,8172,10,8,8,20,49,90,-41,32
Livingston,8173,1,19,7,10,71,42,29,64
Peterhead,8173,2,18,6,12,53,41,12,60
Alloa,8173,3,16,9,11,66,50,16,57
Brechin,8173,4,16,5,15,54,50,4,53
Airdrieon,8173,5,16,4,16,53,62,-9,52
East Fife,8173,6,14,9,13,55,48,7,51
Stranraer,8173,7,15,5,16,55,56,-1,50
Albion,8173,8,12,12,12,51,51,0,48
Queen's Park,8173,9,13,6,17,45,55,-10,45
Stenhousem'r,8173,10,7,5,24,36,84,-48,26
Livingston,8174,1,23,5,8,82,42,40,74
Alloa,8174,2,19,8,9,76,45,31,65
Brechin,8174,3,17,7,12,61,58,3,58
Airdrieon,8174,4,16,7,13,60,57,3,55
Peterhead,8174,5,14,8,14,53,59,-6,50
Queen's Park,8174,6,14,6,16,43,52,-9,48
Albion,8174,7,12,7,17,51,62,-11,43
East Fife,8174,8,11,8,17,53,51,2,41
Stranraer,8174,9,10,7,19,53,71,-18,37
Stenhousem'r,8174,10,8,9,19,51,86,-35,33
Livingston,8175,1,22,3,11,86,49,37,69
Brechin,8175,2,21,5,10,54,47,7,68
Alloa,8175,3,19,8,9,75,45,30,65
Albion,8175,4,18,7,11,61,48,13,61
East Fife,8175,5,14,6,16,56,45,11,48
Airdrieon,8175,6,14,4,18,56,67,-11,46
Stranraer,8175,7,13,6,17,50,57,-7,45
Peterhead,8175,8,11,8,17,52,66,-14,41
Stenhousem'r,8175,9,9,10,17,55,86,-31,37
Queen's Park,8175,10,8,5,23,30,65,-35,29
Livingston,8176,1,21,5,10,77,46,31,68
Brechin,8176,2,19,8,9,58,46,12,65
Peterhead,8176,3,18,7,11,65,59,6,61
Alloa,8176,4,17,8,11,69,49,20,59
Airdrieon,8176,5,16,4,16,54,59,-5,52
Albion,8176,6,14,9,13,56,52,4,51
Queen's Park,8176,7,14,6,16,45,49,-4,48
East Fife,8176,8,11,10,15,50,47,3,43
Stranraer,8176,9,8,7,21,38,63,-25,31
Stenhousem'r,8176,10,6,8,22,49,91,-42,26
Livingston,8177,1,22,5,9,76,40,36,71
Airdrieon,8177,2,20,5,11,67,54,13,65
Alloa,8177,3,16,12,8,68,46,22,60
Brechin,8177,4,17,7,12,51,48,3,58
Albion,8177,5,14,8,14,54,53,1,50
Stranraer,8177,6,13,8,15,53,53,0,47
Peterhead,8177,7,13,7,16,48,51,-3,46
Queen's Park,8177,8,12,7,17,33,50,-17,43
Stenhousem'r,8177,9,9,6,21,43,83,-40,33
East Fife,8177,10,7,9,20,40,55,-15,30
Livingston,8178,1,22,6,8,81,45,36,72
Alloa,8178,2,19,7,10,63,34,29,64
Brechin,8178,3,18,5,13,59,55,4,59
Airdrieon,8178,4,17,5,14,67,65,2,56
Peterhead,8178,5,15,8,13,58,49,9,53
Albion,8178,6,15,6,15,54,66,-12,51
Stranraer,8178,7,15,3,18,54,61,-7,48
Queen's Park,8178,8,11,7,18,40,57,-17,40
East Fife,8178,9,9,10,17,42,46,-4,37
Stenhousem'r,8178,10,6,9,21,44,84,-40,27
Alloa,8179,1,20,9,7,72,39,33,69
Livingston,8179,2,19,6,11,66,48,18,63
Airdrieon,8179,3,16,10,10,69,59,10,58
Albion,8179,4,16,9,11,55,47,8,57
Queen's Park,8179,5,14,7,15,35,46,-11,49
Brechin,8179,6,14,6,16,50,54,-4,48
Stranraer,8179,7,13,6,17,48,53,-5,45
Peterhead,8179,8,12,8,16,49,64,-15,44
East Fife,8179,9,8,11,17,46,52,-6,35
Stenhousem'r,8179,10,8,8,20,51,79,-28,32
Livingston,8180,1,21,5,10,76,46,30,68
Peterhead,8180,2,19,7,10,69,51,18,64
Airdrieon,8180,3,18,8,10,67,52,15,62
Alloa,8180,4,16,10,10,64,43,21,58
Brechin,8180,5,16,9,11,47,41,6,57
Queen's Park,8180,6,16,5,15,45,52,-7,53
Stranraer,8180,7,13,8,15,54,58,-4,47
Albion,8180,8,12,6,18,43,56,-13,42
East Fife,8180,9,8,10,18,52,63,-11,34
Stenhousem'r,8180,10,3,8,25,34,89,-55,17
Livingston,8181,1,22,4,10,79,42,37,70
Alloa,8181,2,17,10,9,69,43,26,61
Brechin,8181,3,17,7,12,60,47,13,58
Airdrieon,8181,4,16,10,10,60,50,10,58
Albion,8181,5,14,13,9,52,47,5,55
Queen's Park,8181,6,12,11,13,45,57,-12,47
Peterhead,8181,7,12,9,15,46,54,-8,45
East Fife,8181,8,12,7,17,46,53,-7,43
Stranraer,8181,9,11,8,17,46,54,-8,41
Stenhousem'r,8181,10,5,5,26,34,90,-56,20
Alloa,8182,1,20,6,10,67,50,17,66
Airdrieon,8182,2,18,7,11,65,54,11,61
Albion,8182,3,17,9,10,58,43,15,60
Livingston,8182,4,18,4,14,68,54,14,58
Brechin,8182,5,17,6,13,57,47,10,57
Queen's Park,8182,6,14,6,16,35,46,-11,48
Stranraer,8182,7,13,4,19,47,61,-14,43
Peterhead,8182,8,11,9,16,55,61,-6,42
East Fife,8182,9,10,11,15,52,58,-6,41
Stenhousem'r,8182,10,7,8,21,49,79,-30,29
Livingston,8183,1,25,3,8,83,42,41,78
Airdrieon,8183,2,20,6,10,60,49,11,66
Alloa,8183,3,19,6,11,69,46,23,63
Brechin,8183,4,14,11,11,59,58,1,53
Queen's Park,8183,5,14,5,17,44,58,-14,47
Albion,8183,6,12,8,16,51,50,1,44
Stranraer,8183,7,12,7,17,53,55,-2,43
Peterhead,8183,8,12,7,17,46,62,-16,43
East Fife,8183,9,11,7,18,49,52,-3,40
Stenhousem'r,8183,10,6,10,20,45,87,-42,28
Livingston,8184,1,22,1,13,78,43,35,67
Alloa,8184,2,20,7,9,74,44,30,67
Brechin,8184,3,18,6,12,59,48,11,60
East Fife,8184,4,15,6,15,58,48,10,51
Albion,8184,5,15,6,15,54,55,-1,51
Airdrieon,8184,6,15,6,15,52,54,-2,51
Peterhead,8184,7,14,9,13,46,48,-2,51
Queen's Park,8184,8,13,5,18,40,59,-19,44
Stranraer,8184,9,11,4,21,43,65,-22,37
Stenhousem'r,8184,10,9,6,21,45,85,-40,33
Livingston,8185,1,24,3,9,80,41,39,75
Airdrieon,8185,2,17,7,12,58,51,7,58
Alloa,8185,3,16,8,12,66,53,13,56
Albion,8185,4,15,8,13,52,53,-1,53
East Fife,8185,5,14,8,14,54,42,12,50
Brechin,8185,6,13,9,14,48,48,0,48
Peterhead,8185,7,14,6,16,53,59,-6,48
Queen's Park,8185,8,14,5,17,33,45,-12,47
Stranraer,8185,9,10,11,15,46,58,-12,41
Stenhousem'r,8185,10,7,7,22,51,91,-40,28
Livingston,8186,1,22,5,9,83,45,38,71
Alloa,8186,2,19,9,8,69,37,32,66
Peterhead,8186,3,15,8,13,61,58,3,53
Airdrieon,8186,4,15,8,13,58,62,-4,53
East Fife,8186,5,13,10,13,51,53,-2,49
Albion,8186,6,13,9,14,56,56,0,48
Brechin,8186,7,13,9,14,50,55,-5,48
Queen's Park,8186,8,13,6,17,43,52,-9,45
Stranraer,8186,9,9,8,19,47,68,-21,35
Stenhousem'r,8186,10,7,10,19,47,79,-32,31
Alloa,8187,1,20,9,7,76,42,34,69
Livingston,8187,2,22,3,11,86,56,30,69
Peterhead,8187,3,15,9,12,47,46,1,54
Airdrieon,8187,4,16,6,14,62,64,-2,54
Brechin,8187,5,16,4,16,52,57,-5,52
East Fife,8187,6,13,9,14,55,48,7,48
Albion,8187,7,13,7,16,55,55,0,46
Queen's Park,8187,8,13,5,18,35,52,-17,44
Stranraer,8187,9,11,7,18,47,61,-14,40
Stenhousem'r,8187,10,7,9,20,45,79,-34,30
Alloa,8188,1,20,7,9,78,45,33,67
Livingston,8188,2,19,6,11,75,49,26,63
Stranraer,8188,3,15,7,14,52,55,-3,52
Albion,8188,4,14,9,13,49,51,-2,51
Brechin,8188,5,15,6,15,46,50,-4,51
Peterhead,8188,6,13,7,16,48,58,-10,46
Airdrieon,8188,7,12,9,15,54,56,-2,45
Queen's Park,8188,8,12,9,15,33,48,-15,45
Stenhousem'r,8188,9,13,5,18,57,83,-26,44
East Fife,8188,10,9,11,16,56,53,3,38
Livingston,8189,1,23,5,8,86,42,44,74
Airdrieon,8189,2,20,9,7,70,38,32,69
Alloa,8189,3,16,11,9,64,46,18,59
East Fife,8189,4,14,6,16,56,54,2,48
Albion,8189,5,13,9,14,51,58,-7,48
Stranraer,8189,6,15,2,19,47,53,-6,47
Peterhead,8189,7,12,8,16,43,52,-9,44
Brechin,8189,8,11,8,17,39,50,-11,41
Queen's Park,8189,9,11,6,19,36,68,-32,39
Stenhousem'r,8189,10,11,4,21,46,77,-31,37
Livingston,8190,1,21,8,7,69,41,28,71
Alloa,8190,2,19,7,10,83,39,44,64
Airdrieon,8190,3,17,8,11,59,53,6,59
Albion,8190,4,15,10,11,56,51,5,55
Stranraer,8190,5,15,7,14,58,61,-3,52
Brechin,8190,6,13,9,14,48,59,-11,48
Peterhead,8190,7,12,9,15,47,54,-7,45
East Fife,8190,8,11,9,16,56,53,3,42
Queen's Park,8190,9,9,10,17,30,50,-20,37
Stenhousem'r,8190,10,6,7,23,42,87,-45,25
Livingston,8191,1,23,3,10,81,46,35,72
Alloa,8191,2,20,9,7,70,44,26,69
Airdrieon,8191,3,17,8,11,52,45,7,59
Albion,8191,4,13,10,13,46,47,-1,49
Brechin,8191,5,13,8,15,48,45,3,47
East Fife,8191,6,12,9,15,43,50,-7,45
Queen's Park,8191,7,13,6,17,33,42,-9,45
Peterhead,8191,8,10,11,15,42,56,-14,41
Stenhousem'r,8191,9,11,7,18,45,63,-18,40
Stranraer,8191,10,10,5,21,42,64,-22,35
Livingston,8192,1,20,4,12,81,49,32,64
Brechin,8192,2,19,6,11,63,39,24,63
Airdrieon,8192,3,19,6,11,58,46,12,63
Alloa,8192,4,15,11,10,65,47,18,56
Albion,8192,5,15,9,12,54,54,0,54
East Fife,8192,6,14,8,14,47,49,-2,50
Stranraer,8192,7,13,4,19,56,70,-14,43
Queen's Park,8192,8,11,10,15,40,54,-14,43
Peterhead,8192,9,11,7,18,45,62,-17,40
Stenhousem'r,8192,10,6,9,21,44,83,-39,27
Livingston,8193,1,21,6,9,79,45,34,69
Alloa,8193,2,17,8,11,74,53,21,59
Airdrieon,8193,3,17,8,11,57,51,6,59
East Fife,8193,4,16,9,11,54,44,10,57
Albion,8193,5,13,10,13,53,53,0,49
Peterhead,8193,6,13,9,14,51,48,3,48
Stranraer,8193,7,14,5,17,48,58,-10,47
Brechin,8193,8,13,7,16,50,53,-3,46
Queen's Park,8193,9,9,8,19,29,67,-38,35
Stenhousem'r,8193,10,9,6,21,52,75,-23,33
Livingston,8194,1,20,4,12,71,52,19,64
Alloa,8194,2,19,6,11,71,49,22,63
Peterhead,8194,3,18,9,9,54,38,16,63
Brechin,8194,4,16,5,15,49,53,-4,53
Airdrieon,8194,5,14,9,13,63,63,0,51
Albion,8194,6,14,9,13,56,57,-1,51
Stranraer,8194,7,15,4,17,56,63,-7,49
Queen's Park,8194,8,12,8,16,46,54,-8,44
East Fife,8194,9,9,10,17,50,46,4,37
Stenhousem'r,8194,10,9,4,23,45,86,-41,31
Alloa,8195,1,20,11,5,77,40,37,71
Livingston,8195,2,21,5,10,78,46,32,68
Peterhead,8195,3,17,8,11,58,48,10,59
Brechin,8195,4,16,9,11,53,40,13,57
Albion,8195,5,13,12,11,56,52,4,51
Airdrieon,8195,6,12,8,16,57,63,-6,44
Stranraer,8195,7,12,8,16,43,58,-15,44
Queen's Park,8195,8,11,7,18,35,53,-18,40
East Fife,8195,9,10,9,17,46,59,-13,39
Stenhousem'r,8195,10,6,7,23,43,87,-44,25
Livingston,8196,1,23,4,9,86,47,39,73
Alloa,8196,2,17,12,7,70,48,22,63
Airdrieon,8196,3,18,6,12,59,48,11,60
Brechin,8196,4,17,4,15,50,47,3,55
Stranraer,8196,5,15,7,14,58,56,2,52
Albion,8196,6,13,8,15,52,59,-7,47
Peterhead,8196,7,10,11,15,49,59,-10,41
Queen's Park,8196,8,11,8,17,33,56,-23,41
East Fife,8196,9,11,7,18,46,48,-2,40
Stenhousem'r,8196,10,7,9,20,44,79,-35,30
Livingston,8197,1,19,6,11,71,46,25,63
Alloa,8197,2,18,9,9,68,51,17,63
Airdrieon,8197,3,18,8,10,57,47,10,62
Brechin,8197,4,17,8,11,59,47,12,59
East Fife,8197,5,13,9,14,46,47,-1,48
Peterhead,8197,6,12,10,14,55,57,-2,46
Queen's Park,8197,7,12,8,16,38,50,-12,44
Albion,8197,8,12,7,17,52,57,-5,43
Stranraer,8197,9,11,9,16,60,66,-6,42
Stenhousem'r,8197,10,8,6,22,46,84,-38,30
Livingston,8198,1,19,4,13,83,55,28,61
Airdrieon,8198,2,18,7,11,61,51,10,61
Alloa,8198,3,17,8,11,66,42,24,59
Peterhead,8198,4,16,6,14,58,53,5,54
Queen's Park,8198,5,15,9,12,39,47,-8,54
Brechin,8198,6,16,5,15,47,48,-1,53
Albion,8198,7,13,9,14,56,52,4,48
East Fife,8198,8,13,8,15,49,50,-1,47
Stranraer,8198,9,11,6,19,57,76,-19,39
Stenhousem'r,8198,10,7,8,21,41,83,-42,29
Livingston,8199,1,25,3,8,82,42,40,78
Alloa,8199,2,19,8,9,69,41,28,65
Airdrieon,8199,3,15,12,9,50,46,4,57
East Fife,8199,4,15,8,13,52,48,4,53
Peterhead,8199,5,15,6,15,50,58,-8,51
Stranraer,8199,6,14,6,16,52,59,-7,48
Queen's Park,8199,7,12,8,16,40,50,-10,44
Albion,8199,8,11,6,19,47,50,-3,39
Brechin,8199,9,11,6,19,42,57,-15,39
Stenhousem'r,8199,10,7,9,20,41,74,-33,30
Livingston,8200,1,25,3,8,85,44,41,78
Alloa,8200,2,20,8,8,72,43,29,68
Brechin,8200,3,18,7,11,60,44,16,61
Airdrieon,8200,4,18,5,13,67,53,14,59
Albion,8200,5,15,8,13,55,50,5,53
Stranraer,8200,6,13,4,19,49,61,-12,43
Queen's Park,8200,7,11,8,17,35,58,-23,41
Peterhead,8200,8,11,7,18,41,63,-22,40
Stenhousem'r,8200,9,9,7,20,45,74,-29,34
East Fife,8200,10,6,11,19,45,64,-19,29
Airdrieon,8201,1,20,6,10,63,50,13,66
Livingston,8201,2,19,6,11,74,54,20,63
Alloa,8201,3,16,12,8,67,45,22,60
Albion,8201,4,16,8,12,64,56,8,56
Brechin,8201,5,15,9,12,47,46,1,54
Peterhead,8201,6,13,9,14,53,56,-3,48
Stranraer,8201,7,12,9,15,49,52,-3,45
Queen's Park,8201,8,12,6,18,36,49,-13,42
East Fife,8201,9,10,7,19,48,55,-7,37
Stenhousem'r,8201,10,6,10,20,51,89,-38,28
Livingston,8202,1,21,5,10,79,54,25,68
Airdrieon,8202,2,17,10,9,64,54,10,61
Alloa,8202,3,16,9,11,73,52,21,57
Peterhead,8202,4,13,10,13,53,47,6,49
Albion,8202,5,13,10,13,51,51,0,49
Stranraer,8202,6,14,6,16,55,56,-1,48
Brechin,8202,7,13,9,14,48,50,-2,48
Stenhousem'r,8202,8,11,10,15,44,63,-19,43
Queen's Park,8202,9,9,11,16,37,62,-25,38
East Fife,8202,10,8,10,18,43,58,-15,34
Alloa,8203,1,20,9,7,80,39,41,69
Airdrieon,8203,2,18,6,12,66,58,8,60
Livingston,8203,3,17,8,11,72,54,18,59
Albion,8203,4,16,9,11,56,51,5,57
East Fife,8203,5,14,8,14,56,44,12,50
Stranraer,8203,6,14,5,17,56,60,-4,47
Brechin,8203,7,14,5,17,43,50,-7,47
Peterhead,8203,8,12,8,16,51,59,-8,44
Queen's Park,8203,9,7,13,16,31,58,-27,34
Stenhousem'r,8203,10,9,7,20,45,83,-38,34
Livingston,8204,1,19,7,10,72,49,23,64
Albion,8204,2,18,7,11,60,47,13,61
Alloa,8204,3,16,10,10,70,48,22,58
Stranraer,8204,4,15,9,12,61,56,5,54
Airdrieon,8204,5,14,10,12,47,42,5,52
Stenhousem'r,8204,6,12,9,15,44,65,-21,45
Peterhead,8204,7,11,10,15,38,45,-7,43
Brechin,8204,8,11,9,16,39,49,-10,42
East Fife,8204,9,9,11,16,49,56,-7,38
Queen's Park,8204,10,9,10,17,34,57,-23,37
Airdrieon,8205,1,21,3,12,68,54,14,66
Peterhead,8205,2,18,8,10,56,39,17,62
Livingston,8205,3,19,4,13,69,56,13,61
Albion,8205,4,18,7,11,61,50,11,61
Alloa,8205,5,17,7,12,70,50,20,58
East Fife,8205,6,16,6,14,51,41,10,54
Brechin,8205,7,17,3,16,54,49,5,54
Stranraer,8205,8,11,5,20,46,66,-20,38
Queen's Park,8205,9,9,11,16,32,52,-20,38
Stenhousem'r,8205,10,3,8,25,34,84,-50,17
Alloa,8206,1,22,8,6,81,30,51,74
Livingston,8206,2,19,6,11,68,53,15,63
Airdrieon,8206,3,17,5,14,53,52,1,56
Brechin,8206,4,16,6,14,49,45,4,54
Queen's Park,8206,5,14,6,16,43,53,-10,48
Peterhead,8206,6,12,9,15,50,59,-9,45
East Fife,8206,7,12,8,16,45,52,-7,44
Stranraer,8206,8,11,8,17,50,60,-10,41
Albion,8206,9,9,12,15,57,63,-6,39
Stenhousem'r,8206,10,11,6,19,47,76,-29,39
Airdrieon,8207,1,16,13,7,58,43,15,61
Livingston,8207,2,17,8,11,69,49,20,59
Alloa,8207,3,15,9,12,58,44,14,54
Brechin,8207,4,16,6,14,49,58,-9,54
Albion,8207,5,14,10,12,55,47,8,52
Queen's Park,8207,6,14,9,13,44,42,2,51
East Fife,8207,7,12,11,13,48,47,1,47
Peterhead,8207,8,14,5,17,47,54,-7,47
Stranraer,8207,9,12,10,14,50,48,2,46
Stenhousem'r,8207,10,5,9,22,40,86,-46,24
Livingston,8208,1,22,8,6,72,39,33,74
Alloa,8208,2,19,9,8,71,42,29,66
Airdrieon,8208,3,17,4,15,54,60,-6,55
Albion,8208,4,15,7,14,53,43,10,52
Peterhead,8208,5,14,10,12,49,48,1,52
Brechin,8208,6,16,4,16,44,49,-5,52
Stranraer,8208,7,15,5,16,49,51,-2,50
East Fife,8208,8,11,8,17,46,47,-1,41
Queen's Park,8208,9,10,7,19,33,50,-17,37
Stenhousem'r,8208,10,6,8,22,45,87,-42,26
Alloa,8209,1,21,10,5,76,32,44,73
Livingston,8209,2,21,2,13,74,43,31,65
Albion,8209,3,17,8,11,63,59,4,59
Brechin,8209,4,15,9,12,56,60,-4,54
Airdrieon,8209,5,14,7,15,55,59,-4,49
East Fife,8209,6,12,10,14,60,50,10,46
Peterhead,8209,7,12,9,15,48,57,-9,45
Stranraer,8209,8,11,8,17,47,57,-10,41
Queen's Park,8209,9,11,8,17,37,57,-20,41
Stenhousem'r,8209,10,7,7,22,37,79,-42,28
Alloa,8210,1,23,5,8,77,40,37,74
Livingston,8210,2,20,5,11,71,49,22,65
Airdrieon,8210,3,17,5,14,68,62,6,56
Peterhead,8210,4,14,10,12,48,52,-4,52
Albion,8210,5,13,10,13,43,42,1,49
Brechin,8210,6,14,7,15,43,46,-3,49
East Fife,8210,7,12,10,14,44,40,4,46
Stranraer,8210,8,12,6,18,50,58,-8,42
Queen's Park,8210,9,11,8,17,34,55,-21,41
Stenhousem'r,8210,10,8,6,22,41,75,-34,30
Airdrieon,8211,1,22,4,10,69,46,23,70
Livingston,8211,2,22,3,11,81,47,34,69
Brechin,8211,3,19,5,12,59,47,12,62
Albion,8211,4,17,7,12,60,54,6,58
Alloa,8211,5,15,9,12,63,46,17,54
Peterhead,8211,6,15,6,15,51,54,-3,51
East Fife,8211,7,10,8,18,51,59,-8,38
Stranraer,8211,8,12,2,22,49,67,-18,38
Stenhousem'r,8211,9,10,7,19,49,83,-34,37
Queen's Park,8211,10,9,7,20,30,59,-29,34
Livingston,8212,1,21,3,12,77,46,31,66
Airdrieon,8212,2,19,9,8,66,48,18,66
Alloa,8212,3,19,4,13,67,53,14,61
Albion,8212,4,17,8,11,57,51,6,59
Brechin,8212,5,13,9,14,48,53,-5,48
Stranraer,8212,6,13,5,18,52,64,-12,44
Queen's Park,8212,7,13,4,19,35,54,-19,43
Peterhead,8212,8,11,9,16,46,54,-8,42
East Fife,8212,9,10,10,16,49,51,-2,40
Stenhousem'r,8212,10,10,7,19,60,83,-23,37
Livingston,8213,1,22,4,10,74,42,32,70
Brechin,8213,2,20,4,12,58,43,15,64
Airdrieon,8213,3,18,7,11,65,50,15,61
Alloa,8213,4,17,8,11,70,47,23,59
East Fife,8213,5,14,11,11,60,43,17,53
Peterhead,8213,6,14,5,17,51,71,-20,47
Stranraer,8213,7,13,5,18,50,65,-15,44
Albion,8213,8,10,10,16,55,65,-10,40
Stenhousem'r,8213,9,9,7,20,43,71,-28,34
Queen's Park,8213,10,9,7,20,28,57,-29,34
Livingston,8214,1,20,7,9,79,48,31,67
Alloa,8214,2,19,7,10,72,41,31,64
Albion,8214,3,17,7,12,62,51,11,58
Airdrieon,8214,4,17,7,12,60,54,6,58
Peterhead,8214,5,16,7,13,53,54,-1,55
Brechin,8214,6,14,10,12,51,47,4,52
Stranraer,8214,7,13,7,16,53,58,-5,46
East Fife,8214,8,9,9,18,50,68,-18,36
Queen's Park,8214,9,10,5,21,27,55,-28,35
Stenhousem'r,8214,10,7,10,19,46,77,-31,31
Livingston,8215,1,21,5,10,79,49,30,68
Alloa,8215,2,20,6,10,82,45,37,66
Airdrieon,8215,3,18,6,12,61,54,7,60
Queen's Park,8215,4,16,7,13,42,43,-1,55
East Fife,8215,5,12,12,12,50,47,3,48
Albion,8215,6,13,7,16,54,60,-6,46
Peterhead,8215,7,11,13,12,44,51,-7,46
Stranraer,8215,8,12,7,17,55,66,-11,43
Brechin,8215,9,11,6,19,41,59,-18,39
Stenhousem'r,8215,10,8,7,21,42,76,-34,31
Livingston,8216,1,22,4,10,76,45,31,70
Airdrieon,8216,2,18,6,12,61,51,10,60
Alloa,8216,3,17,7,12,67,46,21,58
Peterhead,8216,4,16,10,10,55,44,11,58
Brechin,8216,5,15,9,12,43,48,-5,54
East Fife,8216,6,12,12,12,45,45,0,48
Albion,8216,7,12,11,13,47,47,0,47
Queen's Park,8216,8,9,11,16,36,50,-14,38
Stranraer,8216,9,9,9,18,50,59,-9,36
Stenhousem'r,8216,10,6,9,21,46,91,-45,27
Alloa,8217,1,16,10,10,75,48,27,58
Livingston,8217,2,18,4,14,76,63,13,58
Airdrieon,8217,3,16,9,11,58,54,4,57
Peterhead,8217,4,15,10,11,53,49,4,55
Albion,8217,5,15,8,13,60,49,11,53
Queen's Park,8217,6,13,9,14,45,53,-8,48
Brechin,8217,7,14,5,17,52,57,-5,47
Stranraer,8217,8,13,5,18,56,68,-12,44
East Fife,8217,9,11,9,16,46,56,-10,42
Stenhousem'r,8217,10,11,7,18,52,76,-24,40
Livingston,8218,1,21,5,10,88,53,35,68
Brechin,8218,2,18,9,9,61,45,16,63
Alloa,8218,3,17,9,10,73,53,20,60
Airdrieon,8218,4,17,7,12,70,51,19,58
Queen's Park,8218,5,17,6,13,42,50,-8,57
Albion,8218,6,13,8,15,48,51,-3,47
Peterhead,8218,7,12,10,14,54,68,-14,46
Stranraer,8218,8,10,7,19,47,60,-13,37
East Fife,8218,9,8,11,17,44,56,-12,35
Stenhousem'r,8218,10,9,4,23,51,91,-40,31
Livingston,8219,1,20,6,10,79,47,32,66
Brechin,8219,2,19,6,11,52,42,10,63
Airdrieon,8219,3,19,4,13,63,52,11,61
Alloa,8219,4,16,8,12,57,45,12,56
Stranraer,8219,5,15,8,13,53,52,1,53
East Fife,8219,6,14,9,13,54,45,9,51
Albion,8219,7,12,10,14,47,47,0,46
Peterhead,8219,8,13,6,17,46,61,-15,45
Queen's Park,8219,9,12,8,16,38,51,-13,44
Stenhousem'r,8219,10,5,5,26,39,86,-47,20
Livingston,8220,1,23,5,8,81,39,42,74
Alloa,8220,2,21,6,9,68,39,29,69
Albion,8220,3,17,9,10,64,50,14,60
Airdrieon,8220,4,16,9,11,68,56,12,57
Brechin,8220,5,15,4,17,42,55,-13,49
Queen's Park,8220,6,13,9,14,44,53,-9,48
Stranraer,8220,7,12,7,17,47,60,-13,43
Peterhead,8220,8,10,8,18,42,59,-17,38
East Fife,8220,9,8,9,19,35,47,-12,33
Stenhousem'r,8220,10,8,8,20,45,78,-33,32
Livingston,8221,1,17,8,11,61,48,13,59
Airdrieon,8221,2,15,11,10,58,50,8,56
Brechin,8221,3,16,8,12,44,41,3,56
Alloa,8221,4,15,10,11,68,48,20,55
Peterhead,8221,5,15,6,15,53,54,-1,51
Stranraer,8221,6,14,7,15,57,59,-2,49
Albion,8221,7,12,13,11,51,53,-2,49
Queen's Park,8221,8,11,12,13,33,45,-12,45
Stenhousem'r,8221,9,10,8,18,50,71,-21,38
East Fife,8221,10,9,9,18,44,50,-6,36
Livingston,8222,1,21,3,12,83,61,22,66
Alloa,8222,2,18,8,10,72,46,26,62
Brechin,8222,3,18,7,11,49,44,5,61
Airdrieon,8222,4,18,6,12,64,55,9,60
Albion,8222,5,13,9,14,54,55,-1,48
East Fife,8222,6,14,6,16,55,57,-2,48
Stranraer,8222,7,12,9,15,52,57,-5,45
Queen's Park,8222,8,11,11,14,36,49,-13,44
Peterhead,8222,9,11,9,16,45,53,-8,42
Stenhousem'r,8222,10,6,8,22,42,75,-33,26
Livingston,8223,1,23,5,8,75,41,34,74
Alloa,8223,2,18,6,12,66,51,15,60
Brechin,8223,3,16,8,12,51,44,7,56
Airdrieon,8223,4,14,12,10,54,50,4,54
Peterhead,8223,5,15,9,12,44,41,3,54
Stranraer,8223,6,15,3,18,54,58,-4,48
Queen's Park,8223,7,13,9,14,43,54,-11,48
Albion,8223,8,13,5,18,44,53,-9,44
East Fife,8223,9,11,7,18,49,51,-2,40
Stenhousem'r,8223,10,6,8,22,44,81,-37,26
Alloa,8224,1,22,7,7,72,33,39,73
Livingston,8224,2,19,8,9,73,50,23,65
Airdrieon,8224,3,18,10,8,64,47,17,64
Stranraer,8224,4,13,8,15,59,57,2,47
Albion,8224,5,11,13,12,46,42,4,46
Peterhead,8224,6,12,10,14,46,50,-4,46
Brechin,8224,7,13,7,16,42,53,-11,46
Queen's Park,8224,8,13,6,17,33,49,-16,45
East Fife,8224,9,10,9,17,46,53,-7,39
Stenhousem'r,8224,10,5,10,21,42,89,-47,25
Livingston,8225,1,21,4,11,74,43,31,67
Alloa,8225,2,18,5,13,69,51,18,59
Airdrieon,8225,3,17,6,13,63,54,9,57
Peterhead,8225,4,16,6,14,57,56,1,54
Brechin,8225,5,15,6,15,56,60,-4,51
Albion,8225,6,13,10,13,58,62,-4,49
Stranraer,8225,7,13,5,18,51,68,-17,44
Stenhousem'r,8225,8,13,5,18,51,71,-20,44
Queen's Park,8225,9,11,8,17,37,52,-15,41
East Fife,8225,10,9,13,14,54,53,1,40
Alloa,8226,1,21,7,8,74,42,32,70
Livingston,8226,2,21,4,11,78,56,22,67
Airdrieon,8226,3,16,6,14,60,58,2,54
Brechin,8226,4,16,4,16,51,49,2,52
Queen's Park,8226,5,14,6,16,39,49,-10,48
Stranraer,8226,6,13,8,15,55,59,-4,47
Peterhead,8226,7,12,11,13,44,48,-4,47
East Fife,8226,8,11,13,12,51,47,4,46
Albion,8226,9,11,10,15,53,55,-2,43
Stenhousem'r,8226,10,6,9,21,42,84,-42,27
Alloa,8227,1,20,9,7,71,41,30,69
Brechin,8227,2,20,4,12,48,38,10,64
Livingston,8227,3,19,6,11,70,47,23,63
Airdrieon,8227,4,17,7,12,59,54,5,58
Albion,8227,5,13,9,14,55,54,1,48
East Fife,8227,6,12,10,14,54,49,5,46
Peterhead,8227,7,12,7,17,40,53,-13,43
Queen's Park,8227,8,10,10,16,37,56,-19,40
Stenhousem'r,8227,9,9,10,17,57,78,-21,37
Stranraer,8227,10,8,8,20,42,63,-21,32
Livingston,8228,1,20,8,8,78,45,33,68
Alloa,8228,2,18,6,12,71,54,17,60
Peterhead,8228,3,17,9,10,55,41,14,60
Airdrieon,8228,4,17,7,12,59,45,14,58
Brechin,8228,5,16,8,12,49,53,-4,56
Albion,8228,6,12,12,12,51,53,-2,48
Queen's Park,8228,7,12,8,16,36,49,-13,44
Stranraer,8228,8,11,7,18,47,66,-19,40
East Fife,8228,9,7,11,18,38,49,-11,32
Stenhousem'r,8228,10,6,12,18,47,76,-29,30
Livingston,8229,1,22,4,10,71,44,27,70
Brechin,8229,2,18,5,13,58,49,9,59
Stranraer,8229,3,18,3,15,60,55,5,57
Alloa,8229,4,16,8,12,69,49,20,56
Peterhead,8229,5,16,7,13,56,51,5,55
Queen's Park,8229,6,15,6,15,43,53,-10,51
Airdrieon,8229,7,15,5,16,51,53,-2,50
East Fife,8229,8,13,8,15,46,43,3,47
Albion,8229,9,10,7,19,45,62,-17,37
Stenhousem'r,8229,10,8,5,23,46,86,-40,29
Alloa,8230,1,19,9,8,69,44,25,66
Livingston,8230,2,19,6,11,71,46,25,63
Albion,8230,3,15,11,10,61,53,8,56
Airdrieon,8230,4,15,10,11,64,55,9,55
Brechin,8230,5,15,7,14,51,51,0,52
Stranraer,8230,6,13,7,16,51,54,-3,46
Peterhead,8230,7,12,9,15,45,57,-12,45
Queen's Park,8230,8,12,8,16,41,53,-12,44
East Fife,8230,9,8,12,16,45,54,-9,36
Stenhousem'r,8230,10,7,11,18,40,71,-31,32
Livingston,8231,1,23,2,11,79,52,27,71
Brechin,8231,2,17,9,10,52,42,10,60
Alloa,8231,3,17,7,12,70,48,22,58
Queen's Park,8231,4,15,8,13,46,49,-3,53
Peterhead,8231,5,12,14,10,49,52,-3,50
Albion,8231,6,13,7,16,52,54,-2,46
Airdrieon,8231,7,13,6,17,58,61,-3,45
Stranraer,8231,8,11,7,18,47,61,-14,40
Stenhousem'r,8231,9,10,9,17,51,74,-23,39
East Fife,8231,10,9,11,16,45,56,-11,38
Livingston,8232,1,21,8,7,77,44,33,71
Alloa,8232,2,18,8,10,73,52,21,62
Airdrieon,8232,3,17,7,12,62,55,7,58
Peterhead,8232,4,16,9,11,64,51,13,57
Brechin,8232,5,16,9,11,51,50,1,57
Albion,8232,6,10,10,16,51,59,-8,40
Queen's Park,8232,7,10,10,16,46,62,-16,40
East Fife,8232,8,10,9,17,54,62,-8,39
Stranraer,8232,9,11,5,20,45,66,-21,38
Stenhousem'r,8232,10,10,7,19,56,78,-22,37
Livingston,8233,1,20,9,7,66,36,30,69
Alloa,8233,2,16,13,7,62,40,22,61
Stranraer,8233,3,16,7,13,58,50,8,55
Brechin,8233,4,14,9,13,44,51,-7,51
Albion,8233,5,12,11,13,47,50,-3,47
Airdrieon,8233,6,12,10,14,50,57,-7,46
Queen's Park,8233,7,13,6,17,29,44,-15,45
Peterhead,8233,8,11,11,14,50,55,-5,44
East Fife,8233,9,9,14,13,51,49,2,41
Stenhousem'r,8233,10,6,12,18,43,68,-25,30
Livingston,8234,1,25,4,7,90,35,55,79
Alloa,8234,2,20,6,10,72,50,22,66
Brechin,8234,3,17,4,15,53,47,6,55
Albion,8234,4,15,6,15,49,57,-8,51
Stranraer,8234,5,16,2,18,58,61,-3,50
Peterhead,8234,6,14,6,16,52,56,-4,48
Airdrieon,8234,7,13,7,16,46,64,-18,46
East Fife,8234,8,12,7,17,47,49,-2,43
Queen's Park,8234,9,13,4,19,35,52,-17,43
Stenhousem'r,8234,10,9,6,21,46,77,-31,33
Alloa,8235,1,19,7,10,76,48,28,64
Airdrieon,8235,2,19,6,11,64,47,17,63
Livingston,8235,3,17,8,11,70,46,24,59
Brechin,8235,4,17,6,13,48,52,-4,57
Peterhead,8235,5,15,9,12,52,47,5,54
Albion,8235,6,14,10,12,53,50,3,52
East Fife,8235,7,14,7,15,54,58,-4,49
Queen's Park,8235,8,11,9,16,39,52,-13,42
Stranraer,8235,9,7,10,19,42,61,-19,31
Stenhousem'r,8235,10,6,10,20,43,80,-37,28
Airdrieon,8236,1,20,6,10,63,42,21,66
Livingston,8236,2,20,5,11,74,45,29,65
Alloa,8236,3,18,5,13,70,52,18,59
Brechin,8236,4,18,3,15,54,47,7,57
Albion,8236,5,14,12,10,60,49,11,54
Peterhead,8236,6,15,8,13,45,43,2,53
East Fife,8236,7,12,9,15,56,64,-8,45
Queen's Park,8236,8,13,4,19,35,49,-14,43
Stranraer,8236,9,10,4,22,42,67,-25,34
Stenhousem'r,8236,10,7,10,19,46,87,-41,31
Livingston,8237,1,19,7,10,75,51,24,64
Alloa,8237,2,17,10,9,77,51,26,61
Airdrieon,8237,3,17,7,12,62,53,9,58
Brechin,8237,4,15,9,12,51,51,0,54
Albion,8237,5,15,8,13,55,53,2,53
Stranraer,8237,6,12,10,14,48,50,-2,46
Peterhead,8237,7,12,8,16,39,49,-10,44
East Fife,8237,8,12,7,17,49,49,0,43
Queen's Park,8237,9,10,12,14,41,56,-15,42
Stenhousem'r,8237,10,7,10,19,46,80,-34,31
Livingston,8238,1,19,4,13,74,53,21,61
Airdrieon,8238,2,18,4,14,60,54,6,58
Alloa,8238,3,17,6,13,70,55,15,57
Albion,8238,4,17,6,13,61,57,4,57
Brechin,8238,5,16,8,12,49,45,4,56
Peterhead,8238,6,14,8,14,66,65,1,50
Stranraer,8238,7,14,6,16,51,65,-14,48
East Fife,8238,8,12,10,14,53,49,4,46
Stenhousem'r,8238,9,11,7,18,56,73,-17,40
Queen's Park,8238,10,9,7,20,40,64,-24,34
Livingston,8239,1,23,5,8,80,50,30,74
Airdrieon,8239,2,19,9,8,66,45,21,66
Brechin,8239,3,18,7,11,63,41,22,61
Alloa,8239,4,16,9,11,63,47,16,57
East Fife,8239,5,13,11,12,52,47,5,50
Peterhead,8239,6,11,11,14,49,54,-5,44
Albion,8239,7,11,8,17,52,63,-11,41
Stranraer,8239,8,10,10,16,40,59,-19,40
Queen's Park,8239,9,11,6,19,37,58,-21,39
Stenhousem'r,8239,10,7,6,23,41,79,-38,27
Livingston,8240,1,25,2,9,85,46,39,77
Airdrieon,8240,2,22,7,7,67,42,25,73
Alloa,8240,3,18,5,13,71,53,18,59
Brechin,8240,4,18,3,15,54,48,6,57
Peterhead,8240,5,14,6,16,52,56,-4,48
East Fife,8240,6,12,10,14,49,48,1,46
Albion,8240,7,13,7,16,50,52,-2,46
Stranraer,8240,8,13,4,19,49,65,-16,43
Queen's Park,8240,9,9,10,17,36,56,-20,37
Stenhousem'r,8240,10,6,6,24,40,87,-47,24
Livingston,8241,1,24,3,9,88,50,38,75
Airdrieon,8241,2,21,5,10,71,48,23,68
Alloa,8241,3,17,7,12,76,50,26,58
Brechin,8241,4,17,7,12,45,44,1,58
East Fife,8241,5,13,8,15,56,51,5,47
Queen's Park,8241,6,14,5,17,36,55,-19,47
Albion,8241,7,12,7,17,53,63,-10,43
Stenhousem'r,8241,8,10,11,15,46,65,-19,41
Peterhead,8241,9,9,10,17,42,74,-32,37
Stranraer,8241,10,9,5,22,49,62,-13,32
Livingston,8242,1,22,5,9,82,50,32,71
Brechin,8242,2,20,6,10,60,39,21,66
Alloa,8242,3,19,7,10,71,47,24,64
Airdrieon,8242,4,19,2,15,68,65,3,59
Peterhead,8242,5,15,8,13,49,51,-2,53
Queen's Park,8242,6,14,6,16,56,57,-1,48
Albion,8242,7,13,7,16,58,60,-2,46
East Fife,8242,8,13,6,17,48,48,0,45
Stranraer,8242,9,11,4,21,56,77,-21,37
Stenhousem'r,8242,10,4,9,23,43,97,-54,21
Livingston,8243,1,19,8,9,82,48,34,65
Airdrieon,8243,2,17,9,10,60,46,14,60
Stranraer,8243,3,17,6,13,59,51,8,57
Brechin,8243,4,16,7,13,47,52,-5,55
East Fife,8243,5,15,7,14,49,44,5,52
Alloa,8243,6,14,8,14,57,49,8,50
Albion,8243,7,13,9,14,50,53,-3,48
Peterhead,8243,8,11,11,14,55,64,-9,44
Queen's Park,8243,9,9,10,17,33,55,-22,37
Stenhousem'r,8243,10,8,7,21,49,79,-30,31
Livingston,8244,1,25,5,6,73,32,41,80
Alloa,8244,2,19,6,11,74,50,24,63
Airdrieon,8244,3,18,5,13,50,51,-1,59
Stranraer,8244,4,16,5,15,53,51,2,53
East Fife,8244,5,15,7,14,49,46,3,52
Peterhead,8244,6,12,9,15,43,48,-5,45
Brechin,8244,7,12,8,16,54,55,-1,44
Albion,8244,8,10,9,17,46,54,-8,39
Stenhousem'r,8244,9,10,9,17,55,81,-26,39
Queen's Park,8244,10,8,7,21,30,59,-29,31
Livingston,8245,1,21,4,11,85,46,39,67
Alloa,8245,2,19,7,10,66,47,19,64
Brechin,8245,3,19,4,13,53,45,8,61
Peterhead,8245,4,18,6,12,49,40,9,60
Albion,8245,5,15,7,14,51,54,-3,52
Stranraer,8245,6,13,8,15,49,53,-4,47
Airdrieon,8245,7,13,8,15,55,63,-8,47
East Fife,8245,8,12,9,15,53,51,2,45
Queen's Park,8245,9,10,6,20,34,55,-21,36
Stenhousem'r,8245,10,6,9,21,38,79,-41,27
Airdrieon,8246,1,21,6,9,55,38,17,69
Livingston,8246,2,20,6,10,77,47,30,66
Brechin,8246,3,18,7,11,60,51,9,61
Alloa,8246,4,17,9,10,65,39,26,60
East Fife,8246,5,14,9,13,52,47,5,51
Albion,8246,6,12,10,14,46,50,-4,46
Queen's Park,8246,7,13,7,16,37,48,-11,46
Stranraer,8246,8,12,6,18,51,61,-10,42
Peterhead,8246,9,9,9,18,42,58,-16,36
Stenhousem'r,8246,10,6,7,23,44,90,-46,25
Alloa,8247,1,18,9,9,68,42,26,63
Livingston,8247,2,19,6,11,77,55,22,63
Airdrieon,8247,3,16,10,10,57,50,7,58
Queen's Park,8247,4,15,8,13,39,40,-1,53
Brechin,8247,5,15,7,14,58,50,8,52
Albion,8247,6,14,8,14,45,50,-5,50
Peterhead,8247,7,13,9,14,55,55,0,48
Stranraer,8247,8,13,7,16,56,64,-8,46
East Fife,8247,9,6,14,16,43,50,-7,32
Stenhousem'r,8247,10,7,10,19,43,85,-42,31
Livingston,8248,1,23,1,12,77,50,27,70
Alloa,8248,2,21,5,10,69,39,30,68
Airdrieon,8248,3,19,4,13,53,45,8,61
Albion,8248,4,16,9,11,54,45,9,57
Brechin,8248,5,14,7,15,46,48,-2,49
Stranraer,8248,6,14,3,19,52,59,-7,45
East Fife,8248,7,11,10,15,34,42,-8,43
Peterhead,8248,8,13,4,19,40,53,-13,43
Stenhousem'r,8248,9,12,4,20,50,70,-20,40
Queen's Park,8248,10,10,7,19,34,58,-24,37
Alloa,8249,1,24,5,7,82,44,38,77
Livingston,8249,2,18,5,13,70,56,14,59
Brechin,8249,3,16,8,12,53,49,4,56
East Fife,8249,4,15,8,13,48,39,9,53
Airdrieon,8249,5,15,8,13,63,59,4,53
Albion,8249,6,14,9,13,52,55,-3,51
Queen's Park,8249,7,12,9,15,40,49,-9,45
Stranraer,8249,8,12,7,17,44,54,-10,43
Peterhead,8249,9,11,8,17,45,55,-10,41
Stenhousem'r,8249,10,7,5,24,34,71,-37,26
Livingston,8250,1,21,4,11,79,50,29,67
Brechin,8250,2,19,7,10,45,31,14,64
Alloa,8250,3,18,9,9,64,37,27,63
Airdrieon,8250,4,17,4,15,56,59,-3,55
East Fife,8250,5,13,11,12,50,46,4,50
Albion,8250,6,14,8,14,47,45,2,50
Stranraer,8250,7,15,3,18,55,66,-11,48
Peterhead,8250,8,13,8,15,49,50,-1,47
Queen's Park,8250,9,12,4,20,40,58,-18,40
Stenhousem'r,8250,10,6,6,24,40,83,-43,24
Alloa,8251,1,20,8,8,74,42,32,68
Airdrieon,8251,2,19,5,12,60,48,12,62
Livingston,8251,3,17,6,13,70,53,17,57
Brechin,8251,4,15,7,14,52,45,7,52
Albion,8251,5,14,7,15,48,55,-7,49
East Fife,8251,6,13,9,14,45,46,-1,48
Stranraer,8251,7,14,4,18,49,52,-3,46
Peterhead,8251,8,12,9,15,41,53,-12,45
Queen's Park,8251,9,12,5,19,35,58,-23,41
Stenhousem'r,8251,10,11,6,19,57,79,-22,39
Airdrieon,8252,1,21,4,11,75,57,18,67
Alloa,8252,2,20,6,10,69,43,26,66
Livingston,8252,3,18,6,12,68,49,19,60
Peterhead,8252,4,17,6,13,54,47,7,57
Brechin,8252,5,14,8,14,45,46,-1,50
Stranraer,8252,6,13,9,14,50,54,-4,48
Albion,8252,7,11,9,16,48,59,-11,42
Stenhousem'r,8252,8,11,8,17,55,76,-21,41
East Fife,8252,9,10,10,16,44,52,-8,40
Queen's Park,8252,10,9,6,21,24,49,-25,33
Livingston,8253,1,23,5,8,88,49,39,74
Alloa,8253,2,21,7,8,75,42,33,70
Airdrieon,8253,3,15,9,12,52,53,-1,54
Brechin,8253,4,15,6,15,51,53,-2,51
Peterhead,8253,5,13,7,16,46,57,-11,46
Queen's Park,8253,6,12,9,15,37,44,-7,45
Albion,8253,7,12,9,15,47,59,-12,45
Stranraer,8253,8,11,9,16,53,54,-1,42
East Fife,8253,9,9,11,16,49,59,-10,38
Stenhousem'r,8253,10,9,8,19,48,76,-28,35
Livingston,8254,1,19,6,11,77,54,23,63
Alloa,8254,2,18,8,10,60,44,16,62
Airdrieon,8254,3,17,5,14,67,53,14,56
Peterhead,8254,4,16,7,13,58,57,1,55
Brechin,8254,5,15,8,13,51,50,1,53
Queen's Park,8254,6,15,6,15,41,47,-6,51
Albion,8254,7,15,5,16,54,59,-5,50
East Fife,8254,8,10,11,15,51,51,0,41
Stranraer,8254,9,12,4,20,44,59,-15,40
Stenhousem'r,8254,10,9,8,19,51,80,-29,35
Alloa,8255,1,22,7,7,76,36,40,73
Livingston,8255,2,19,6,11,72,53,19,63
Brechin,8255,3,18,6,12,52,41,11,60
Airdrieon,8255,4,16,5,15,51,55,-4,53
Stranraer,8255,5,15,6,15,48,54,-6,51
Peterhead,8255,6,12,12,12,45,43,2,48
Albion,8255,7,13,9,14,49,49,0,48
East Fife,8255,8,8,12,16,43,47,-4,36
Queen's Park,8255,9,8,10,18,30,58,-28,34
Stenhousem'r,8255,10,7,11,18,39,69,-30,32
Airdrieon,8256,1,21,6,9,59,45,14,69
Alloa,8256,2,20,5,11,67,39,28,65
Livingston,8256,3,18,4,14,62,46,16,58
Brechin,8256,4,15,12,9,53,49,4,57
Albion,8256,5,16,6,14,52,48,4,54
Queen's Park,8256,6,13,10,13,38,42,-4,49
Peterhead,8256,7,13,7,16,49,54,-5,46
Stranraer,8256,8,13,6,17,50,52,-2,45
East Fife,8256,9,8,12,16,38,51,-13,36
Stenhousem'r,8256,10,5,8,23,41,83,-42,23
Airdrieon,8257,1,22,4,10,72,47,25,70
Alloa,8257,2,21,6,9,69,41,28,69
Livingston,8257,3,21,6,9,70,45,25,69
Brechin,8257,4,18,9,9,56,42,14,63
East Fife,8257,5,13,8,15,51,52,-1,47
Queen's Park,8257,6,11,9,16,44,52,-8,42
Peterhead,8257,7,12,6,18,45,60,-15,42
Stranraer,8257,8,11,4,21,47,69,-22,37
Albion,8257,9,8,10,18,37,55,-18,34
Stenhousem'r,8257,10,6,12,18,50,78,-28,30
Alloa,8258,1,18,6,12,67,53,14,60
Livingston,8258,2,18,5,13,78,55,23,59
Airdrieon,8258,3,18,5,13,62,52,10,59
Brechin,8258,4,17,8,11,50,40,10,59
Peterhead,8258,5,17,7,12,54,54,0,58
Albion,8258,6,14,12,10,53,40,13,54
East Fife,8258,7,11,11,14,51,43,8,44
Stranraer,8258,8,11,6,19,49,65,-16,39
Queen's Park,8258,9,9,10,17,29,50,-21,37
Stenhousem'r,8258,10,9,6,21,44,85,-41,33
Livingston,8259,1,23,7,6,84,38,46,76
Alloa,8259,2,17,9,10,74,41,33,60
Airdrieon,8259,3,18,6,12,67,59,8,60
Brechin,8259,4,15,5,16,44,52,-8,50
Albion,8259,5,13,9,14,45,42,3,48
Peterhead,8259,6,13,8,15,41,51,-10,47
East Fife,8259,7,10,14,12,49,48,1,44
Queen's Park,8259,8,11,10,15,36,53,-17,43
Stranraer,8259,9,11,6,19,54,75,-21,39
Stenhousem'r,8259,10,8,8,20,45,80,-35,32
Alloa,8260,1,22,9,5,73,36,37,75
Livingston,8260,2,19,7,10,71,52,19,64
Airdrieon,8260,3,18,7,11,62,50,12,61
Brechin,8260,4,19,4,13,63,55,8,61
Albion,8260,5,15,9,12,62,54,8,54
Peterhead,8260,6,11,9,16,40,53,-13,42
East Fife,8260,7,10,10,16,44,51,-7,40
Stranraer,8260,8,11,7,18,47,57,-10,40
Queen's Park,8260,9,11,6,19,33,50,-17,39
Stenhousem'r,8260,10,6,8,22,47,84,-37,26
Livingston,8261,1,20,6,10,76,52,24,66
Alloa,8261,2,17,10,9,66,46,20,61
Airdrieon,8261,3,16,6,14,64,64,0,54
Queen's Park,8261,4,16,6,14,42,47,-5,54
Albion,8261,5,15,7,14,60,51,9,52
Stranraer,8261,6,15,5,16,54,56,-2,50
Brechin,8261,7,14,6,16,55,55,0,48
Peterhead,8261,8,12,11,13,51,58,-7,47
East Fife,8261,9,12,9,15,46,47,-1,45
Stenhousem'r,8261,10,5,10,21,38,76,-38,25
Livingston,8262,1,21,3,12,83,52,31,66
Airdrieon,8262,2,17,6,13,59,56,3,57
Brechin,8262,3,16,6,14,56,49,7,54
East Fife,8262,4,15,8,13,61,46,15,53
Albion,8262,5,15,7,14,59,57,2,52
Peterhead,8262,6,15,7,14,54,57,-3,52
Stranraer,8262,7,15,5,16,47,53,-6,50
Alloa,8262,8,13,9,14,58,56,2,48
Queen's Park,8262,9,12,6,18,44,62,-18,42
Stenhousem'r,8262,10,10,5,21,50,83,-33,35
Livingston,8263,1,20,7,9,78,42,36,67
Alloa,8263,2,16,10,10,67,48,19,58
Albion,8263,3,16,9,11,51,46,5,57
Airdrieon,8263,4,17,6,13,56,57,-1,57
Stranraer,8263,5,16,4,16,54,56,-2,52
Brechin,8263,6,14,7,15,51,50,1,49
East Fife,8263,7,11,13,12,55,46,9,46
Peterhead,8263,8,12,8,16,47,62,-15,44
Queen's Park,8263,9,11,6,19,30,52,-22,39
Stenhousem'r,8263,10,9,6,21,49,79,-30,33
Livingston,8264,1,24,1,11,88,49,39,73
Airdrieon,8264,2,18,6,12,57,54,3,60
Peterhead,8264,3,17,8,11,54,45,9,59
Brechin,8264,4,17,8,11,53,48,5,59
Alloa,8264,5,17,4,15,72,56,16,55
Albion,8264,6,14,8,14,56,53,3,50
East Fife,8264,7,14,6,16,68,59,9,48
Queen's Park,8264,8,12,5,19,35,59,-24,41
Stranraer,8264,9,10,4,22,46,66,-20,34
Stenhousem'r,8264,10,7,10,19,35,75,-40,31
Livingston,8265,1,21,5,10,78,46,32,68
Alloa,8265,2,20,7,9,69,40,29,67
Brechin,8265,3,17,8,11,56,47,9,59
Albion,8265,4,15,7,14,53,51,2,52
East Fife,8265,5,14,9,13,55,48,7,51
Peterhead,8265,6,13,9,14,51,59,-8,48
Airdrieon,8265,7,14,5,17,57,60,-3,47
Stenhousem'r,8265,8,11,8,17,52,80,-28,41
Queen's Park,8265,9,11,7,18,38,58,-20,40
Stranraer,8265,10,9,5,22,37,57,-20,32
Alloa,8266,1,23,5,8,67,38,29,74
Livingston,8266,2,22,6,8,88,46,42,72
Airdrieon,8266,3,16,9,11,61,51,10,57
Brechin,8266,4,16,8,12,58,53,5,56
Peterhead,8266,5,13,9,14,45,52,-7,48
Albion,8266,6,13,6,17,55,64,-9,45
Queen's Park,8266,7,14,3,19,46,55,-9,45
Stranraer,8266,8,11,6,19,56,65,-9,39
East Fife,8266,9,11,6,19,46,61,-15,39
Stenhousem'r,8266,10,8,8,20,46,83,-37,32
Alloa,8267,1,20,9,7,71,41,30,69
Brechin,8267,2,21,5,10,67,46,21,68
Livingston,8267,3,19,2,15,72,49,23,59
Airdrieon,8267,4,15,5,16,50,64,-14,50
Albion,8267,5,14,7,15,60,60,0,49
East Fife,8267,6,10,14,12,45,44,1,44
Peterhead,8267,7,11,10,15,46,54,-8,43
Queen's Park,8267,8,12,6,18,37,51,-14,42
Stranraer,8267,9,11,7,18,53,62,-9,40
Stenhousem'r,8267,10,11,7,18,50,80,-30,40
Alloa,8268,1,21,7,8,79,41,38,70
Livingston,8268,2,22,3,11,81,49,32,69
Airdrieon,8268,3,20,5,11,67,54,13,65
Brechin,8268,4,16,7,13,65,58,7,55
Queen's Park,8268,5,13,11,12,47,57,-10,50
Albion,8268,6,12,8,16,52,56,-4,44
Peterhead,8268,7,11,10,15,45,60,-15,43
East Fife,8268,8,10,11,15,45,53,-8,41
Stranraer,8268,9,11,6,19,49,68,-19,39
Stenhousem'r,8268,10,7,6,23,43,77,-34,27
Alloa,8269,1,22,7,7,69,38,31,73
Livingston,8269,2,21,4,11,74,49,25,67
Brechin,8269,3,15,9,12,50,42,8,54
Airdrieon,8269,4,14,7,15,45,56,-11,49
Albion,8269,5,14,6,16,51,52,-1,48
Peterhead,8269,6,13,8,15,47,52,-5,47
Queen's Park,8269,7,12,10,14,38,48,-10,46
East Fife,8269,8,12,8,16,48,53,-5,44
Stranraer,8269,9,11,6,19,46,58,-12,39
Stenhousem'r,8269,10,9,9,18,50,70,-20,36
Livingston,8270,1,18,8,10,73,51,22,62
Alloa,8270,2,18,7,11,80,55,25,61
Airdrieon,8270,3,18,6,12,59,49,10,60
Brechin,8270,4,16,7,13,49,46,3,55
Peterhead,8270,5,14,8,14,54,55,-1,50
Stranraer,8270,6,15,5,16,53,59,-6,50
Albion,8270,7,14,7,15,54,58,-4,49
Queen's Park,8270,8,14,6,16,52,63,-11,48
East Fife,8270,9,10,7,19,48,54,-6,37
Stenhousem'r,8270,10,8,9,19,46,78,-32,33
Livingston,8271,1,20,6,10,74,46,28,66
Queen's Park,8271,2,17,5,14,49,54,-5,56
Peterhead,8271,3,15,10,11,54,46,8,55
Airdrieon,8271,4,14,10,12,59,58,1,52
East Fife,8271,5,14,9,13,63,47,16,51
Alloa,8271,6,14,9,13,65,55,10,51
Brechin,8271,7,15,5,16,55,59,-4,50
Stranraer,8271,8,15,3,18,52,55,-3,48
Albion,8271,9,12,8,16,49,62,-13,44
Stenhousem'r,8271,10,7,9,20,45,83,-38,30
Airdrieon,8272,1,21,9,6,61,40,21,72
Alloa,8272,2,18,7,11,75,46,29,61
Queen's Park,8272,3,18,7,11,39,44,-5,61
Albion,8272,4,15,6,15,51,52,-1,51
Brechin,8272,5,16,2,18,51,45,6,50
Livingston,8272,6,15,4,17,71,65,6,49
Peterhead,8272,7,13,8,15,44,51,-7,47
Stranraer,8272,8,13,4,19,49,66,-17,43
Stenhousem'r,8272,9,9,10,17,54,76,-22,37
East Fife,8272,10,9,9,18,39,49,-10,36
Alloa,8273,1,20,9,7,72,41,31,69
Livingston,8273,2,20,5,11,81,50,31,65
Albion,8273,3,18,6,12,59,48,11,60
Peterhead,8273,4,17,7,12,61,50,11,58
Brechin,8273,5,16,6,14,51,57,-6,54
East Fife,8273,6,13,10,13,55,50,5,49
Stranraer,8273,7,13,5,18,58,63,-5,44
Airdrieon,8273,8,12,6,18,54,71,-17,42
Queen's Park,8273,9,8,9,19,30,53,-23,33
Stenhousem'r,8273,10,8,7,21,45,83,-38,31
Alloa,8274,1,22,6,8,80,44,36,72
Airdrieon,8274,2,20,6,10,63,47,16,66
Livingston,8274,3,18,2,16,72,54,18,56
Brechin,8274,4,17,4,15,54,51,3,55
Peterhead,8274,5,15,7,14,57,50,7,52
East Fife,8274,6,14,8,14,50,42,8,50
Queen's Park,8274,7,14,6,16,38,51,-13,48
Albion,8274,8,12,8,16,51,65,-14,44
Stranraer,8274,9,12,6,18,47,60,-13,42
Stenhousem'r,8274,10,6,7,23,44,92,-48,25
Alloa,8275,1,18,7,11,72,50,22,61
Livingston,8275,2,17,9,10,79,61,18,60
Airdrieon,8275,3,15,10,11,75,65,10,55
Albion,8275,4,15,10,11,60,52,8,55
Brechin,8275,5,16,7,13,54,50,4,55
Peterhead,8275,6,15,9,12,51,48,3,54
East Fife,8275,7,13,8,15,57,53,4,47
Queen's Park,8275,8,13,4,19,38,59,-21,43
Stranraer,8275,9,12,4,20,45,59,-14,40
Stenhousem'r,8275,10,8,8,20,50,84,-34,32
Airdrieon,8276,1,22,6,8,69,44,25,72
Alloa,8276,2,19,6,11,69,45,24,63
Brechin,8276,3,20,3,13,55,48,7,63
Livingston,8276,4,19,5,12,82,58,24,62
Peterhead,8276,5,18,8,10,66,46,20,62
East Fife,8276,6,11,10,15,47,49,-2,43
Queen's Park,8276,7,11,7,18,42,62,-20,40
Stenhousem'r,8276,8,10,7,19,49,81,-32,37
Albion,8276,9,10,6,20,51,73,-22,36
Stranraer,8276,10,8,6,22,44,68,-24,30
Livingston,8277,1,21,5,10,67,42,25,68
Alloa,8277,2,20,6,10,71,47,24,66
Airdrieon,8277,3,19,4,13,64,57,7,61
Albion,8277,4,16,10,10,56,45,11,58
Peterhead,8277,5,14,10,12,50,51,-1,52
Queen's Park,8277,6,15,6,15,51,52,-1,51
Brechin,8277,7,14,9,13,46,52,-6,51
East Fife,8277,8,9,9,18,40,44,-4,36
Stranraer,8277,9,9,7,20,46,60,-14,34
Stenhousem'r,8277,10,6,8,22,42,83,-41,26
Brechin,8278,1,19,8,9,68,48,20,65
Livingston,8278,2,19,6,11,71,46,25,63
Alloa,8278,3,18,6,12,75,51,24,60
Airdrieon,8278,4,18,6,12,56,51,5,60
Peterhead,8278,5,18,4,14,57,54,3,58
Albion,8278,6,14,6,16,46,56,-10,48
Stranraer,8278,7,14,2,20,50,64,-14,44
Queen's Park,8278,8,11,8,17,39,51,-12,41
Stenhousem'r,8278,9,10,7,19,56,85,-29,37
East Fife,8278,10,9,7,20,46,58,-12,34
Alloa,8279,1,21,5,10,77,52,25,68
Livingston,8279,2,18,6,12,68,48,20,60
Airdrieon,8279,3,18,5,13,72,63,9,59
Albion,8279,4,14,11,11,59,49,10,53
Peterhead,8279,5,15,8,13,49,52,-3,53
Brechin,8279,6,14,7,15,41,44,-3,49
Stranraer,8279,7,13,8,15,55,55,0,47
Queen's Park,8279,8,13,7,16,40,54,-14,46
East Fife,8279,9,12,9,15,53,55,-2,45
Stenhousem'r,8279,10,7,4,25,42,84,-42,25
Airdrieon,8280,1,20,7,9,69,52,17,67
Alloa,8280,2,16,8,12,71,49,22,56
Brechin,8280,3,16,8,12,60,59,1,56
Livingston,8280,4,17,4,15,63,57,6,55
Peterhead,8280,5,15,9,12,64,55,9,54
Queen's Park,8280,6,15,6,15,48,51,-3,51
Albion,8280,7,12,9,15,49,51,-2,45
Stranraer,8280,8,12,6,18,51,69,-18,42
East Fife,8280,9,9,12,15,44,54,-10,39
Stenhousem'r,8280,10,9,9,18,58,80,-22,36
Livingston,8281,1,21,5,10,77,50,27,68
Alloa,8281,2,17,13,6,68,42,26,64
Airdrieon,8281,3,17,7,12,57,51,6,58
Peterhead,8281,4,16,9,11,52,47,5,57
Brechin,8281,5,15,6,15,51,50,1,51
East Fife,8281,6,11,13,12,54,51,3,46
Queen's Park,8281,7,12,10,14,40,50,-10,46
Albion,8281,8,12,8,16,49,59,-10,44
Stranraer,8281,9,11,6,19,51,62,-11,39
Stenhousem'r,8281,10,7,5,24,35,72,-37,26
Alloa,8282,1,21,7,8,69,45,24,70
Livingston,8282,2,19,5,12,69,49,20,62
Airdrieon,8282,3,18,6,12,57,52,5,60
Brechin,8282,4,16,6,14,53,53,0,54
Albion,8282,5,13,9,14,47,47,0,48
East Fife,8282,6,11,10,15,47,49,-2,43
Peterhead,8282,7,11,10,15,54,57,-3,43
Stranraer,8282,8,13,4,19,50,58,-8,43
Stenhousem'r,8282,9,11,9,16,52,69,-17,42
Queen's Park,8282,10,11,6,19,42,61,-19,39
Livingston,8283,1,19,7,10,70,48,22,64
Albion,8283,2,17,9,10,56,44,12,60
Alloa,8283,3,15,10,11,61,44,17,55
Airdrieon,8283,4,15,10,11,54,44,10,55
Queen's Park,8283,5,15,7,14,36,40,-4,52
Brechin,8283,6,14,6,16,47,51,-4,48
Stranraer,8283,7,13,8,15,53,57,-4,47
East Fife,8283,8,10,15,11,38,40,-2,45
Peterhead,8283,9,9,12,15,44,55,-11,39
Stenhousem'r,8283,10,6,10,20,40,76,-36,28
Livingston,8284,1,22,2,12,75,50,25,68
Airdrieon,8284,2,20,5,11,68,58,10,65
Alloa,8284,3,18,9,9,71,39,32,63
Brechin,8284,4,17,9,10,54,44,10,60
Albion,8284,5,16,6,14,49,45,4,54
Peterhead,8284,6,13,7,16,40,55,-15,46
Stranraer,8284,7,13,4,19,50,64,-14,43
East Fife,8284,8,11,9,16,50,51,-1,42
Queen's Park,8284,9,11,3,22,29,50,-21,36
Stenhousem'r,8284,10,9,6,21,51,81,-30,33
Livingston,8285,1,20,6,10,81,51,30,66
Alloa,8285,2,19,6,11,73,46,27,63
Airdrieon,8285,3,18,7,11,63,52,11,61
Albion,8285,4,16,8,12,59,45,14,56
Brechin,8285,5,15,7,14,48,54,-6,52
Stranraer,8285,6,15,4,17,47,53,-6,49
Queen's Park,8285,7,14,7,15,41,49,-8,49
Peterhead,8285,8,12,10,14,45,56,-11,46
East Fife,8285,9,11,9,16,50,49,1,42
Stenhousem'r,8285,10,5,6,25,37,89,-52,21
Alloa,8286,1,20,11,5,70,32,38,71
Airdrieon,8286,2,18,4,14,63,59,4,58
Livingston,8286,3,16,8,12,67,50,17,56
East Fife,8286,4,14,10,12,58,44,14,52
Brechin,8286,5,14,10,12,50,48,2,52
Peterhead,8286,6,13,10,13,45,47,-2,49
Albion,8286,7,12,11,13,39,44,-5,47
Stranraer,8286,8,12,7,17,48,56,-8,43
Queen's Park,8286,9,11,5,20,32,55,-23,38
Stenhousem'r,8286,10,9,6,21,50,87,-37,33
Livingston,8287,1,27,3,6,89,36,53,84
Alloa,8287,2,20,6,10,82,43,39,66
Brechin,8287,3,17,7,12,51,51,0,58
Airdrieon,8287,4,15,6,15,59,57,2,51
Peterhead,8287,5,13,9,14,47,48,-1,48
Albion,8287,6,12,10,14,51,58,-7,46
Queen's Park,8287,7,13,7,16,40,52,-12,46
Stenhousem'r,8287,8,10,8,18,49,79,-30,38
Stranraer,8287,9,11,4,21,47,71,-24,37
East Fife,8287,10,6,12,18,39,59,-20,30
Alloa,8288,1,20,6,10,74,45,29,66
Livingston,8288,2,18,10,8,75,44,31,64
Airdrieon,8288,3,18,7,11,61,51,10,61
Brechin,8288,4,15,8,13,50,54,-4,53
Albion,8288,5,14,10,12,61,56,5,52
East Fife,8288,6,13,7,16,58,53,5,46
Peterhead,8288,7,12,10,14,45,54,-9,46
Stranraer,8288,8,14,4,18,50,62,-12,46
Queen's Park,8288,9,11,7,18,36,56,-20,40
Stenhousem'r,8288,10,5,11,20,45,80,-35,26
Alloa,8289,1,22,7,7,84,42,42,73
Livingston,8289,2,21,4,11,72,46,26,67
Brechin,8289,3,19,6,11,59,49,10,63
Airdrieon,8289,4,17,6,13,63,51,12,57
East Fife,8289,5,14,10,12,50,40,10,52
Peterhead,8289,6,14,8,14,42,54,-12,50
Albion,8289,7,13,10,13,55,59,-4,49
Stranraer,8289,8,10,4,22,42,60,-18,34
Queen's Park,8289,9,8,7,21,40,65,-25,31
Stenhousem'r,8289,10,8,6,22,37,78,-41,30
Livingston,8290,1,22,6,8,86,57,29,72
Alloa,8290,2,20,8,8,73,37,36,68
Brechin,8290,3,17,7,12,50,43,7,58
Albion,8290,4,15,9,12,56,51,5,54
Airdrieon,8290,5,16,4,16,59,68,-9,52
Stranraer,8290,6,14,6,16,49,49,0,48
Peterhead,8290,7,12,9,15,43,60,-17,45
East Fife,8290,8,11,8,17,55,46,9,41
Queen's Park,8290,9,11,5,20,37,60,-23,38
Stenhousem'r,8290,10,8,6,22,44,81,-37,30
Livingston,8291,1,25,3,8,90,39,51,78
Alloa,8291,2,17,7,12,68,52,16,58
Airdrieon,8291,3,17,6,13,60,55,5,57
East Fife,8291,4,14,9,13,55,50,5,51
Albion,8291,5,14,7,15,53,55,-2,49
Stranraer,8291,6,14,6,16,45,48,-3,48
Brechin,8291,7,14,6,16,50,60,-10,48
Peterhead,8291,8,11,12,13,36,49,-13,45
Queen's Park,8291,9,10,9,17,40,60,-20,39
Stenhousem'r,8291,10,7,9,20,45,74,-29,30
Livingston,8292,1,19,6,11,75,47,28,63
Alloa,8292,2,18,8,10,58,38,20,62
Peterhead,8292,3,17,8,11,54,49,5,59
Albion,8292,4,15,9,12,50,51,-1,54
Brechin,8292,5,16,5,15,53,49,4,53
Airdrieon,8292,6,14,9,13,53,53,0,51
Queen's Park,8292,7,13,6,17,42,54,-12,45
Stranraer,8292,8,12,7,17,52,58,-6,43
East Fife,8292,9,10,9,17,45,54,-9,39
Stenhousem'r,8292,10,9,7,20,44,73,-29,34
Livingston,8293,1,21,3,12,69,46,23,66
Alloa,8293,2,18,8,10,74,46,28,62
Peterhead,8293,3,18,7,11,52,42,10,61
Brechin,8293,4,17,7,12,50,50,0,58
Airdrieon,8293,5,16,6,14,58,53,5,54
Stranraer,8293,6,16,3,17,52,57,-5,51
Albion,8293,7,13,9,14,48,50,-2,48
East Fife,8293,8,12,8,16,52,54,-2,44
Queen's Park,8293,9,11,5,20,36,53,-17,38
Stenhousem'r,8293,10,5,10,21,43,83,-40,25
Livingston,8294,1,17,8,11,73,46,27,59
Alloa,8294,2,15,10,11,62,48,14,55
Peterhead,8294,3,16,7,13,51,46,5,55
East Fife,8294,4,13,12,11,49,45,4,51
Albion,8294,5,15,6,15,52,54,-2,51
Brechin,8294,6,15,6,15,48,50,-2,51
Airdrieon,8294,7,16,3,17,58,65,-7,51
Stranraer,8294,8,14,7,15,61,66,-5,49
Queen's Park,8294,9,13,7,16,33,47,-14,46
Stenhousem'r,8294,10,8,10,18,48,68,-20,34
Livingston,8295,1,22,5,9,70,45,25,71
Airdrieon,8295,2,20,4,12,58,48,10,64
Peterhead,8295,3,18,7,11,56,44,12,61
Alloa,8295,4,14,11,11,56,42,14,53
Brechin,8295,5,15,8,13,51,49,2,53
East Fife,8295,6,12,8,16,52,51,1,44
Albion,8295,7,10,12,14,50,55,-5,42
Stranraer,8295,8,12,5,19,48,67,-19,41
Queen's Park,8295,9,10,8,18,37,56,-19,38
Stenhousem'r,8295,10,8,10,18,50,71,-21,34
Livingston,8296,1,21,4,11,77,56,21,67
Airdrieon,8296,2,19,5,12,60,48,12,62
Peterhead,8296,3,17,8,11,48,37,11,59
Alloa,8296,4,17,5,14,62,49,13,56
Brechin,8296,5,17,5,14,52,45,7,56
Stranraer,8296,6,16,3,17,52,55,-3,51
Queen's Park,8296,7,14,7,15,42,54,-12,49
Stenhousem'r,8296,8,10,10,16,51,69,-18,40
East Fife,8296,9,9,9,18,37,44,-7,36
Albion,8296,10,8,8,20,46,70,-24,32
Livingston,8297,1,23,2,11,77,44,33,71
Albion,8297,2,18,7,11,62,50,12,61
Airdrieon,8297,3,17,8,11,52,49,3,59
Alloa,8297,4,15,10,11,66,50,16,55
Brechin,8297,5,16,5,15,47,47,0,53
Peterhead,8297,6,14,9,13,54,54,0,51
East Fife,8297,7,13,7,16,47,44,3,46
Stranraer,8297,8,13,5,18,55,62,-7,44
Queen's Park,8297,9,12,6,18,34,51,-17,42
Stenhousem'r,8297,10,6,7,23,42,85,-43,25
Alloa,8298,1,19,9,8,72,45,27,66
Brechin,8298,2,18,9,9,54,38,16,63
Livingston,8298,3,19,4,13,77,54,23,61
Airdrieon,8298,4,15,7,14,55,51,4,52
Stranraer,8298,5,15,6,15,60,58,2,51
Peterhead,8298,6,13,10,13,56,53,3,49
Albion,8298,7,11,13,12,51,54,-3,46
East Fife,8298,8,10,13,13,53,54,-1,43
Queen's Park,8298,9,12,6,18,35,62,-27,42
Stenhousem'r,8298,10,6,7,23,43,87,-44,25
Livingston,8299,1,19,7,10,76,56,20,64
Alloa,8299,2,17,9,10,68,45,23,60
Airdrieon,8299,3,18,5,13,66,61,5,59
Peterhead,8299,4,14,10,12,61,57,4,52
Stranraer,8299,5,14,9,13,64,54,10,51
Brechin,8299,6,15,5,16,54,58,-4,50
East Fife,8299,7,12,11,13,51,47,4,47
Albion,8299,8,13,8,15,44,53,-9,47
Queen's Park,8299,9,12,7,17,40,54,-14,43
Stenhousem'r,8299,10,5,11,20,49,88,-39,26
Livingston,8300,1,26,3,7,88,40,48,81
Alloa,8300,2,21,4,11,71,45,26,67
Brechin,8300,3,18,4,14,54,50,4,58
Airdrieon,8300,4,18,4,14,59,58,1,58
Albion,8300,5,15,7,14,53,51,2,52
Peterhead,8300,6,15,6,15,55,57,-2,51
Queen's Park,8300,7,12,7,17,40,52,-12,43
East Fife,8300,8,10,7,19,52,58,-6,37
Stranraer,8300,9,10,4,22,40,67,-27,34
Stenhousem'r,8300,10,9,6,21,45,79,-34,33
Alloa,8301,1,21,5,10,77,42,35,68
Airdrieon,8301,2,20,5,11,64,53,11,65
Livingston,8301,3,18,8,10,64,43,21,62
Brechin,8301,4,16,5,15,48,45,3,53
Albion,8301,5,15,7,14,49,60,-11,52
East Fife,8301,6,15,6,15,46,39,7,51
Peterhead,8301,7,13,7,16,50,55,-5,46
Queen's Park,8301,8,12,10,14,38,51,-13,46
Stranraer,8301,9,10,9,17,51,63,-12,39
Stenhousem'r,8301,10,6,6,24,44,80,-36,24
Alloa,8302,1,23,4,9,75,42,33,73
Livingston,8302,2,21,3,12,69,43,26,66
Brechin,8302,3,20,6,10,57,44,13,66
Airdrieon,8302,4,15,8,13,54,48,6,53
Albion,8302,5,11,12,13,51,53,-2,45
Peterhead,8302,6,11,12,13,45,48,-3,45
Stranraer,8302,7,13,5,18,57,62,-5,44
Queen's Park,8302,8,10,10,16,30,51,-21,40
East Fife,8302,9,9,9,18,55,65,-10,36
Stenhousem'r,8302,10,8,9,19,41,78,-37,33
Livingston,8303,1,24,3,9,94,46,48,75
Alloa,8303,2,19,11,6,70,38,32,68
Airdrieon,8303,3,18,7,11,68,59,9,61
Peterhead,8303,4,15,7,14,52,48,4,52
Brechin,8303,5,14,6,16,54,64,-10,48
East Fife,8303,6,12,10,14,49,48,1,46
Queen's Park,8303,7,12,9,15,42,51,-9,45
Albion,8303,8,12,8,16,48,66,-18,44
Stranraer,8303,9,11,4,21,48,59,-11,37
Stenhousem'r,8303,10,7,7,22,35,81,-46,28
Airdrieon,8304,1,20,7,9,66,48,18,67
Livingston,8304,2,21,2,13,72,48,24,65
Alloa,8304,3,17,12,7,70,43,27,63
Albion,8304,4,14,9,13,53,52,1,51
Queen's Park,8304,5,15,5,16,42,52,-10,50
East Fife,8304,6,13,10,13,51,50,1,49
Brechin,8304,7,11,11,14,42,50,-8,44
Peterhead,8304,8,11,8,17,48,52,-4,41
Stranraer,8304,9,10,9,17,49,64,-15,39
Stenhousem'r,8304,10,8,7,21,48,82,-34,31
Livingston,8305,1,20,6,10,72,49,23,66
Alloa,8305,2,18,9,9,76,51,25,63
Peterhead,8305,3,16,10,10,66,49,17,58
Brechin,8305,4,17,7,12,55,51,4,58
Airdrieon,8305,5,16,9,11,64,54,10,57
Queen's Park,8305,6,14,6,16,42,53,-11,48
East Fife,8305,7,11,10,15,48,52,-4,43
Albion,8305,8,10,11,15,49,59,-10,41
Stranraer,8305,9,10,6,20,58,77,-19,36
Stenhousem'r,8305,10,6,10,20,52,87,-35,28
Livingston,8306,1,20,4,12,72,46,26,64
Airdrieon,8306,2,18,8,10,69,45,24,62
Alloa,8306,3,16,9,11,61,49,12,57
Brechin,8306,4,16,9,11,44,40,4,57
Peterhead,8306,5,13,9,14,47,56,-9,48
Stenhousem'r,8306,6,12,10,14,53,69,-16,46
Queen's Park,8306,7,12,7,17,40,56,-16,43
East Fife,8306,8,9,14,13,56,51,5,41
Albion,8306,9,11,8,17,48,62,-14,41
Stranraer,8306,10,11,6,19,51,67,-16,39
Brechin,8307,1,18,6,12,52,44,8,60
Livingston,8307,2,17,7,12,74,54,20,58
Airdrieon,8307,3,17,6,13,64,59,5,57
Alloa,8307,4,14,11,11,55,46,9,53
East Fife,8307,5,14,10,12,55,47,8,52
Queen's Park,8307,6,12,13,11,43,45,-2,49
Albion,8307,7,13,9,14,53,50,3,48
Peterhead,8307,8,12,11,13,48,51,-3,47
Stranraer,8307,9,11,7,18,49,61,-12,40
Stenhousem'r,8307,10,9,6,21,47,83,-36,33
Livingston,8308,1,23,5,8,84,48,36,74
Peterhead,8308,2,17,8,11,52,50,2,59
Brechin,8308,3,19,1,16,57,55,2,58
Alloa,8308,4,16,9,11,69,52,17,57
Airdrieon,8308,5,16,7,13,60,55,5,55
Stranraer,8308,6,13,7,16,49,59,-10,46
East Fife,8308,7,12,9,15,55,51,4,45
Albion,8308,8,12,6,18,47,59,-12,42
Queen's Park,8308,9,11,6,19,33,53,-20,39
Stenhousem'r,8308,10,7,10,19,46,70,-24,31
Airdrieon,8309,1,18,11,7,66,47,19,65
Alloa,8309,2,16,11,9,70,47,23,59
Livingston,8309,3,16,5,15,70,61,9,53
Albion,8309,4,13,11,12,54,50,4,50
Queen's Park,8309,5,15,5,16,43,56,-13,50
Stranraer,8309,6,14,7,15,51,53,-2,49
Brechin,8309,7,14,6,16,46,52,-6,48
Peterhead,8309,8,13,7,16,51,52,-1,46
East Fife,8309,9,11,11,14,49,53,-4,44
Stenhousem'r,8309,10,7,12,17,52,81,-29,33
Livingston,8310,1,23,4,9,85,44,41,73
Alloa,8310,2,20,8,8,75,41,34,68
Brechin,8310,3,16,5,15,52,48,4,53
Albion,8310,4,14,10,12,53,55,-2,52
Queen's Park,8310,5,15,7,14,41,44,-3,52
Airdrieon,8310,6,14,9,13,52,56,-4,51
Stranraer,8310,7,14,4,18,56,60,-4,46
Peterhead,8310,8,13,6,17,49,61,-12,45
East Fife,8310,9,11,8,17,58,63,-5,41
Stenhousem'r,8310,10,6,7,23,44,93,-49,25
Alloa,8311,1,23,7,6,76,41,35,76
Airdrieon,8311,2,17,7,12,64,54,10,58
Livingston,8311,3,17,5,14,62,46,16,56
Brechin,8311,4,16,7,13,58,51,7,55
Peterhead,8311,5,14,11,11,53,49,4,53
East Fife,8311,6,14,8,14,57,51,6,50
Stranraer,8311,7,14,7,15,48,52,-4,49
Albion,8311,8,12,7,17,57,66,-9,43
Queen's Park,8311,9,10,6,20,37,59,-22,36
Stenhousem'r,8311,10,6,9,21,44,87,-43,27
Livingston,8312,1,22,6,8,88,48,40,72
Brechin,8312,2,18,9,9,55,46,9,63
Peterhead,8312,3,17,10,9,55,43,12,61
Alloa,8312,4,17,6,13,65,51,14,57
Airdrieon,8312,5,16,8,12,53,44,9,56
Albion,8312,6,13,9,14,49,52,-3,48
Stranraer,8312,7,13,4,19,44,59,-15,43
Queen's Park,8312,8,11,9,16,36,48,-12,42
Stenhousem'r,8312,9,9,7,20,46,77,-31,34
East Fife,8312,10,5,10,21,31,54,-23,25
Livingston,8313,1,21,3,12,80,52,28,66
Alloa,8313,2,19,9,8,70,44,26,66
Airdrieon,8313,3,16,7,13,56,55,1,55
Albion,8313,4,16,6,14,66,54,12,54
Brechin,8313,5,17,3,16,49,51,-2,54
Peterhead,8313,6,14,6,16,53,56,-3,48
East Fife,8313,7,12,10,14,49,52,-3,46
Stranraer,8313,8,12,8,16,45,54,-9,44
Queen's Park,8313,9,12,6,18,41,58,-17,42
Stenhousem'r,8313,10,8,8,20,48,81,-33,32
Livingston,8314,1,21,5,10,83,52,31,68
Airdrieon,8314,2,20,6,10,58,49,9,66
Brechin,8314,3,19,5,12,57,50,7,62
Stranraer,8314,4,18,5,13,63,58,5,59
Alloa,8314,5,17,7,12,66,45,21,58
Peterhead,8314,6,14,9,13,47,45,2,51
Albion,8314,7,12,7,17,58,60,-2,43
Queen's Park,8314,8,11,8,17,35,54,-19,41
East Fife,8314,9,11,7,18,44,54,-10,40
Stenhousem'r,8314,10,5,5,26,39,83,-44,20
Airdrieon,8315,1,19,9,8,70,49,21,66
Livingston,8315,2,20,6,10,65,44,21,66
Brechin,8315,3,18,5,13,51,49,2,59
Albion,8315,4,16,6,14,55,49,6,54
Alloa,8315,5,13,14,9,62,44,18,53
Peterhead,8315,6,13,10,13,54,55,-1,49
Stranraer,8315,7,14,4,18,52,60,-8,46
Queen's Park,8315,8,11,8,17,33,52,-19,41
Stenhousem'r,8315,9,9,8,19,61,85,-24,35
East Fife,8315,10,8,8,20,48,64,-16,32
Airdrieon,8316,1,21,7,8,68,44,24,70
Alloa,8316,2,19,10,7,75,38,37,67
Livingston,8316,3,20,4,12,76,49,27,64
Peterhead,8316,4,12,14,10,47,47,0,50
Brechin,8316,5,14,8,14,51,59,-8,50
Stranraer,8316,6,14,6,16,56,61,-5,48
Queen's Park,8316,7,11,8,17,38,58,-20,41
East Fife,8316,8,9,10,17,36,44,-8,37
Albion,8316,9,9,10,17,45,62,-17,37
Stenhousem'r,8316,10,7,11,18,39,69,-30,32
Livingston,8317,1,21,4,11,76,45,31,67
Alloa,8317,2,18,10,8,68,48,20,64
Brechin,8317,3,18,10,8,56,36,20,64
Airdrieon,8317,4,18,7,11,61,52,9,61
East Fife,8317,5,15,8,13,64,49,15,53
Queen's Park,8317,6,13,6,17,39,53,-14,45
Albion,8317,7,12,7,17,49,58,-9,43
Peterhead,8317,8,10,9,17,46,67,-21,39
Stranraer,8317,9,9,9,18,43,58,-15,36
Stenhousem'r,8317,10,7,8,21,45,81,-36,29
Livingston,8318,1,22,3,11,80,48,32,69
Alloa,8318,2,20,8,8,72,40,32,68
Albion,8318,3,18,7,11,52,44,8,61
Airdrieon,8318,4,15,8,13,56,55,1,53
East Fife,8318,5,13,12,11,51,41,10,51
Stranraer,8318,6,15,5,16,50,56,-6,50
Brechin,8318,7,14,6,16,52,50,2,48
Peterhead,8318,8,13,7,16,41,47,-6,46
Queen's Park,8318,9,10,7,19,32,56,-24,37
Stenhousem'r,8318,10,4,9,23,36,85,-49,21
Alloa,8319,1,21,8,7,71,42,29,71
Livingston,8319,2,20,7,9,76,48,28,67
Airdrieon,8319,3,17,8,11,66,55,11,59
Albion,8319,4,16,7,13,59,50,9,55
Brechin,8319,5,13,9,14,48,55,-7,48
Queen's Park,8319,6,11,11,14,39,56,-17,44
Peterhead,8319,7,9,12,15,41,55,-14,39
East Fife,8319,8,10,8,18,40,45,-5,38
Stranraer,8319,9,9,10,17,51,60,-9,37
Stenhousem'r,8319,10,9,10,17,55,80,-25,37
Livingston,8320,1,21,6,9,71,46,25,69
Airdrieon,8320,2,20,7,9,69,48,21,67
Alloa,8320,3,18,8,10,71,45,26,62
Brechin,8320,4,18,5,13,50,45,5,59
Stranraer,8320,5,13,6,17,49,63,-14,45
Peterhead,8320,6,11,11,14,52,58,-6,44
East Fife,8320,7,10,12,14,50,47,3,42
Albion,8320,8,11,9,16,47,54,-7,42
Queen's Park,8320,9,11,7,18,34,58,-24,40
Stenhousem'r,8320,10,9,5,22,43,72,-29,32
Livingston,8321,1,20,5,11,75,51,24,65
Alloa,8321,2,18,10,8,70,43,27,64
Airdrieon,8321,3,17,8,11,58,51,7,59
Albion,8321,4,15,11,10,59,47,12,56
Brechin,8321,5,16,7,13,45,40,5,55
Peterhead,8321,6,14,7,15,49,55,-6,49
Stranraer,8321,7,13,7,16,51,57,-6,46
East Fife,8321,8,11,11,14,45,49,-4,44
Stenhousem'r,8321,9,9,7,20,41,74,-33,34
Queen's Park,8321,10,8,5,23,30,56,-26,29
Alloa,8322,1,18,9,9,71,43,28,63
Airdrieon,8322,2,19,6,11,74,65,9,63
Livingston,8322,3,16,9,11,68,55,13,57
East Fife,8322,4,15,7,14,63,53,10,52
Brechin,8322,5,14,8,14,51,55,-4,50
Peterhead,8322,6,13,9,14,55,53,2,48
Albion,8322,7,14,6,16,50,58,-8,48
Queen's Park,8322,8,12,9,15,36,43,-7,45
Stenhousem'r,8322,9,10,8,18,49,75,-26,38
Stranraer,8322,10,8,11,17,44,61,-17,35
Brechin,8323,1,20,5,11,52,44,8,65
Alloa,8323,2,19,7,10,73,43,30,64
Livingston,8323,3,20,4,12,74,59,15,64
Airdrieon,8323,4,19,6,11,69,60,9,63
Stranraer,8323,5,17,4,15,66,56,10,55
Peterhead,8323,6,13,7,16,52,59,-7,46
Albion,8323,7,11,9,16,43,57,-14,42
Queen's Park,8323,8,12,5,19,38,59,-21,41
East Fife,8323,9,9,9,18,48,56,-8,36
Stenhousem'r,8323,10,8,8,20,56,78,-22,32
Alloa,8324,1,19,9,8,68,44,24,66
Livingston,8324,2,19,6,11,81,47,34,63
Airdrieon,8324,3,17,9,10,68,58,10,60
Brechin,8324,4,18,4,14,56,52,4,58
Albion,8324,5,15,7,14,54,52,2,52
Stranraer,8324,6,14,8,14,54,60,-6,50
Peterhead,8324,7,13,9,14,43,52,-9,48
Queen's Park,8324,8,12,9,15,36,42,-6,45
East Fife,8324,9,6,11,19,38,53,-15,29
Stenhousem'r,8324,10,7,8,21,44,82,-38,29
Livingston,8325,1,22,5,9,75,39,36,71
Airdrieon,8325,2,18,8,10,61,54,7,62
Alloa,8325,3,16,12,8,70,44,26,60
Brechin,8325,4,16,8,12,59,53,6,56
Stranraer,8325,5,15,6,15,46,54,-8,51
Albion,8325,6,14,7,15,62,51,11,49
Peterhead,8325,7,13,8,15,49,66,-17,47
Queen's Park,8325,8,12,9,15,39,55,-16,45
East Fife,8325,9,9,8,19,52,60,-8,35
Stenhousem'r,8325,10,5,9,22,42,79,-37,24
Livingston,8326,1,22,4,10,76,50,26,70
Alloa,8326,2,18,8,10,67,43,24,62
Brechin,8326,3,19,5,12,60,46,14,62
Airdrieon,8326,4,17,6,13,59,54,5,57
Peterhead,8326,5,16,5,15,53,53,0,53
Albion,8326,6,13,8,15,54,58,-4,47
Stranraer,8326,7,13,3,20,47,56,-9,42
Queen's Park,8326,8,12,5,19,30,52,-22,41
East Fife,8326,9,10,10,16,55,56,-1,40
Stenhousem'r,8326,10,10,6,20,43,76,-33,36
Alloa,8327,1,19,8,9,65,39,26,65
Livingston,8327,2,18,7,11,73,49,24,61
Airdrieon,8327,3,18,5,13,58,52,6,59
Brechin,8327,4,16,6,14,45,45,0,54
Albion,8327,5,16,5,15,55,52,3,53
Queen's Park,8327,6,14,9,13,40,46,-6,51
Peterhead,8327,7,13,11,12,46,52,-6,50
Stranraer,8327,8,10,8,18,44,55,-11,38
East Fife,8327,9,9,9,18,45,50,-5,36
Stenhousem'r,8327,10,10,6,20,47,78,-31,36
Livingston,8328,1,22,4,10,69,41,28,70
Alloa,8328,2,18,8,10,72,45,27,62
Airdrieon,8328,3,18,8,10,59,47,12,62
Brechin,8328,4,14,9,13,46,50,-4,51
Peterhead,8328,5,14,8,14,57,59,-2,50
East Fife,8328,6,12,13,11,50,46,4,49
Albion,8328,7,13,8,15,57,57,0,47
Stranraer,8328,8,10,7,19,45,59,-14,37
Queen's Park,8328,9,9,9,18,33,53,-20,36
Stenhousem'r,8328,10,9,8,19,40,71,-31,35
Livingston,8329,1,25,2,9,84,39,45,77
Alloa,8329,2,23,4,9,78,44,34,73
Airdrieon,8329,3,19,3,14,66,58,8,60
East Fife,8329,4,13,11,12,51,45,6,50
Brechin,8329,5,12,10,14,45,50,-5,46
Peterhead,8329,6,12,10,14,43,48,-5,46
Albion,8329,7,11,12,13,53,55,-2,45
Queen's Park,8329,8,12,9,15,38,59,-21,45
Stranraer,8329,9,11,5,20,48,63,-15,38
Stenhousem'r,8329,10,5,8,23,37,82,-45,23
Livingston,8330,1,22,3,11,74,50,24,69
Brechin,8330,2,21,4,11,54,50,4,67
Airdrieon,8330,3,19,5,12,67,50,17,62
Alloa,8330,4,15,7,14,70,57,13,52
East Fife,8330,5,14,8,14,57,46,11,50
Stranraer,8330,6,13,7,16,53,55,-2,46
Peterhead,8330,7,12,7,17,43,51,-8,43
Albion,8330,8,12,7,17,50,65,-15,43
Queen's Park,8330,9,11,6,19,36,61,-25,39
Stenhousem'r,8330,10,9,10,17,52,71,-19,37
Alloa,8331,1,20,8,8,80,44,36,68
Livingston,8331,2,19,6,11,79,49,30,63
Airdrieon,8331,3,17,4,15,68,74,-6,55
Albion,8331,4,14,10,12,55,55,0,52
Peterhead,8331,5,14,8,14,54,61,-7,50
Stranraer,8331,6,13,9,14,62,72,-10,48
Brechin,8331,7,13,8,15,52,55,-3,47
East Fife,8331,8,11,11,14,67,51,16,44
Queen's Park,8331,9,11,9,16,39,58,-19,42
Stenhousem'r,8331,10,8,7,21,47,84,-37,31
Brechin,8332,1,25,5,6,72,32,40,80
Alloa,8332,2,22,5,9,71,42,29,71
East Fife,8332,3,17,6,13,60,46,14,57
Airdrieon,8332,4,17,4,15,63,58,5,55
Livingston,8332,5,15,4,17,63,68,-5,49
Albion,8332,6,13,7,16,63,65,-2,46
Stranraer,8332,7,13,4,19,58,68,-10,43
Peterhead,8332,8,12,6,18,46,58,-12,42
Queen's Park,8332,9,12,5,19,40,60,-20,41
Stenhousem'r,8332,10,9,4,23,46,85,-39,31
Brechin,8333,1,19,6,11,53,43,10,63
Livingston,8333,2,18,6,12,68,46,22,60
Alloa,8333,3,17,7,12,58,43,15,58
Albion,8333,4,16,7,13,59,53,6,55
Peterhead,8333,5,15,7,14,59,53,6,52
Queen's Park,8333,6,15,7,14,49,55,-6,52
Stranraer,8333,7,14,4,18,53,61,-8,46
Airdrieon,8333,8,13,6,17,42,57,-15,45
East Fife,8333,9,9,12,15,50,52,-2,39
Stenhousem'r,8333,10,9,8,19,48,76,-28,35
Livingston,8334,1,21,4,11,73,49,24,67
Alloa,8334,2,19,8,9,66,40,26,65
Airdrieon,8334,3,16,12,8,56,47,9,60
Brechin,8334,4,16,9,11,45,42,3,57
Peterhead,8334,5,14,7,15,52,51,1,49
Albion,8334,6,13,8,15,49,58,-9,47
East Fife,8334,7,13,7,16,47,51,-4,46
Stranraer,8334,8,12,8,16,53,51,2,44
Queen's Park,8334,9,11,8,17,32,47,-15,41
Stenhousem'r,8334,10,5,9,22,40,77,-37,24
Alloa,8335,1,21,7,8,74,39,35,70
Livingston,8335,2,21,5,10,72,50,22,68
Albion,8335,3,16,8,12,60,50,10,56
Airdrieon,8335,4,16,7,13,49,51,-2,55
Brechin,8335,5,14,8,14,51,52,-1,50
Queen's Park,8335,6,13,9,14,40,46,-6,48
Stranraer,8335,7,11,8,17,46,62,-16,41
East Fife,8335,8,10,10,16,48,53,-5,40
Peterhead,8335,9,9,12,15,38,48,-10,39
Stenhousem'r,8335,10,5,14,17,42,69,-27,29
Livingston,8336,1,22,4,10,70,38,32,70
Airdrieon,8336,2,19,7,10,57,45,12,64
Alloa,8336,3,19,6,11,67,47,20,63
Brechin,8336,4,18,5,13,49,42,7,59
Albion,8336,5,13,8,15,53,57,-4,47
Peterhead,8336,6,12,11,13,45,49,-4,47
East Fife,8336,7,11,8,17,46,51,-5,41
Stenhousem'r,8336,8,11,8,17,51,63,-12,41
Queen's Park,8336,9,10,7,19,32,53,-21,37
Stranraer,8336,10,10,6,20,36,61,-25,36
Brechin,8337,1,22,4,10,55,45,10,70
Alloa,8337,2,19,10,7,70,37,33,67
Livingston,8337,3,18,10,8,74,49,25,64
Airdrieon,8337,4,17,4,15,47,49,-2,55
Albion,8337,5,13,8,15,58,53,5,47
Peterhead,8337,6,10,13,13,45,52,-7,43
Stranraer,8337,7,11,8,17,47,63,-16,41
Stenhousem'r,8337,8,10,10,16,45,67,-22,40
East Fife,8337,9,9,9,18,41,44,-3,36
Queen's Park,8337,10,9,8,19,30,53,-23,35
Airdrieon,8338,1,22,3,11,68,50,18,69
Livingston,8338,2,19,5,12,71,46,25,62
Alloa,8338,3,17,9,10,66,51,15,60
Queen's Park,8338,4,14,9,13,51,50,1,51
Albion,8338,5,13,11,12,58,63,-5,50
Peterhead,8338,6,14,7,15,51,50,1,49
Brechin,8338,7,13,8,15,46,49,-3,47
East Fife,8338,8,10,11,15,45,48,-3,41
Stranraer,8338,9,12,5,19,49,65,-16,41
Stenhousem'r,8338,10,8,8,20,40,73,-33,32
Alloa,8339,1,20,9,7,82,45,37,69
Livingston,8339,2,18,10,8,71,45,26,64
Airdrieon,8339,3,18,8,10,67,55,12,62
Brechin,8339,4,18,6,12,55,48,7,60
East Fife,8339,5,13,11,12,51,46,5,50
Albion,8339,6,10,11,15,48,56,-8,41
Stranraer,8339,7,11,7,18,56,68,-12,40
Stenhousem'r,8339,8,10,8,18,42,72,-30,38
Queen's Park,8339,9,9,10,17,41,57,-16,37
Peterhead,8339,10,8,10,18,38,59,-21,34
Alloa,8340,1,20,10,6,71,38,33,70
Livingston,8340,2,22,4,10,69,44,25,70
Airdrieon,8340,3,18,6,12,59,52,7,60
Brechin,8340,4,18,6,12,49,50,-1,60
Albion,8340,5,13,12,11,61,48,13,51
Peterhead,8340,6,13,10,13,53,54,-1,49
Stranraer,8340,7,12,9,15,51,56,-5,45
East Fife,8340,8,9,6,21,41,53,-12,33
Stenhousem'r,8340,9,9,6,21,52,85,-33,33
Queen's Park,8340,10,8,7,21,33,59,-26,31
Livingston,8341,1,24,3,9,94,49,45,75
Albion,8341,2,17,8,11,57,48,9,59
Alloa,8341,3,17,7,12,59,49,10,58
Airdrieon,8341,4,16,7,13,56,50,6,55
Brechin,8341,5,16,3,17,53,55,-2,51
Queen's Park,8341,6,13,8,15,42,47,-5,47
Peterhead,8341,7,12,10,14,49,58,-9,46
Stranraer,8341,8,14,3,19,51,61,-10,45
East Fife,8341,9,11,9,16,52,53,-1,42
Stenhousem'r,8341,10,7,8,21,44,87,-43,29
Alloa,8342,1,20,8,8,74,40,34,68
Brechin,8342,2,19,5,12,60,45,15,62
Livingston,8342,3,18,5,13,75,58,17,59
Airdrieon,8342,4,16,8,12,54,53,1,56
Albion,8342,5,15,9,12,56,51,5,54
East Fife,8342,6,13,9,14,50,47,3,48
Stranraer,8342,7,12,8,16,44,46,-2,44
Queen's Park,8342,8,11,11,14,39,49,-10,44
Peterhead,8342,9,11,6,19,48,71,-23,39
Stenhousem'r,8342,10,7,7,22,43,83,-40,28
Alloa,8343,1,19,9,8,67,40,27,66
Livingston,8343,2,18,6,12,69,51,18,60
Brechin,8343,3,17,7,12,52,47,5,58
Airdrieon,8343,4,16,8,12,62,60,2,56
Albion,8343,5,15,8,13,56,53,3,53
Peterhead,8343,6,13,11,12,50,51,-1,50
Queen's Park,8343,7,12,9,15,44,54,-10,45
Stranraer,8343,8,12,5,19,53,66,-13,41
East Fife,8343,9,9,9,18,44,48,-4,36
Stenhousem'r,8343,10,8,10,18,43,70,-27,34
Airdrieon,8344,1,20,7,9,59,45,14,67
Livingston,8344,2,20,4,12,77,49,28,64
Alloa,8344,3,19,6,11,67,46,21,63
Brechin,8344,4,16,4,16,45,48,-3,52
Queen's Park,8344,5,15,6,15,40,50,-10,51
Albion,8344,6,14,8,14,58,55,3,50
East Fife,8344,7,12,9,15,49,54,-5,45
Stranraer,8344,8,14,3,19,52,62,-10,45
Peterhead,8344,9,11,10,15,46,57,-11,43
Stenhousem'r,8344,10,8,5,23,45,72,-27,29
Alloa,8345,1,21,7,8,78,44,34,70
Livingston,8345,2,20,2,14,64,45,19,62
Brechin,8345,3,16,7,13,47,45,2,55
Stranraer,8345,4,16,6,14,52,49,3,54
Peterhead,8345,5,14,10,12,57,57,0,52
Queen's Park,8345,6,15,7,14,43,49,-6,52
Albion,8345,7,13,6,17,49,56,-7,45
Airdrieon,8345,8,12,9,15,55,66,-11,45
East Fife,8345,9,9,13,14,53,51,2,40
Stenhousem'r,8345,10,7,7,22,39,75,-36,28
Livingston,8346,1,25,4,7,88,43,45,79
Alloa,8346,2,22,5,9,76,41,35,71
Albion,8346,3,13,12,11,51,45,6,51
Airdrieon,8346,4,15,6,15,54,60,-6,51
Brechin,8346,5,14,8,14,46,45,1,50
Peterhead,8346,6,15,5,16,53,58,-5,50
Stranraer,8346,7,12,8,16,55,61,-6,44
Queen's Park,8346,8,11,6,19,31,58,-27,39
Stenhousem'r,8346,9,8,12,16,46,73,-27,36
East Fife,8346,10,7,10,19,38,54,-16,31
Alloa,8347,1,19,8,9,72,42,30,65
Airdrieon,8347,2,19,7,10,61,52,9,64
Livingston,8347,3,17,9,10,69,49,20,60
Brechin,8347,4,17,7,12,57,48,9,58
Albion,8347,5,14,10,12,47,42,5,52
Peterhead,8347,6,14,8,14,42,47,-5,50
Queen's Park,8347,7,12,10,14,41,51,-10,46
East Fife,8347,8,11,7,18,45,54,-9,40
Stranraer,8347,9,11,5,20,42,55,-13,38
Stenhousem'r,8347,10,5,11,20,34,70,-36,26
Livingston,8348,1,21,5,10,85,44,41,68
Albion,8348,2,18,7,11,65,44,21,61
Airdrieon,8348,3,15,8,13,63,63,0,53
Brechin,8348,4,16,5,15,53,58,-5,53
Alloa,8348,5,14,9,13,66,52,14,51
Queen's Park,8348,6,14,9,13,39,43,-4,51
Peterhead,8348,7,12,12,12,42,44,-2,48
Stranraer,8348,8,12,8,16,57,71,-14,44
East Fife,8348,9,8,12,16,40,55,-15,36
Stenhousem'r,8348,10,7,11,18,46,82,-36,32
Alloa,8349,1,23,6,7,74,45,29,75
Livingston,8349,2,21,3,12,70,44,26,66
Airdrieon,8349,3,18,6,12,65,54,11,60
Brechin,8349,4,17,5,14,51,42,9,56
Peterhead,8349,5,16,7,13,53,49,4,55
East Fife,8349,6,12,10,14,47,46,1,46
Stranraer,8349,7,14,4,18,50,69,-19,46
Albion,8349,8,12,7,17,47,52,-5,43
Stenhousem'r,8349,9,8,8,20,46,77,-31,32
Queen's Park,8349,10,8,6,22,31,56,-25,30
Alloa,8350,1,23,6,7,74,38,36,75
Livingston,8350,2,22,6,8,77,42,35,72
Brechin,8350,3,20,6,10,65,48,17,66
Airdrieon,8350,4,19,7,10,68,51,17,64
Albion,8350,5,13,8,15,57,54,3,47
Peterhead,8350,6,11,12,13,55,53,2,45
Queen's Park,8350,7,11,6,19,39,60,-21,39
Stranraer,8350,8,10,8,18,45,73,-28,38
East Fife,8350,9,9,7,20,48,60,-12,34
Stenhousem'r,8350,10,6,6,24,52,101,-49,24
Alloa,8351,1,19,10,7,80,49,31,67
Airdrieon,8351,2,20,7,9,80,57,23,67
Livingston,8351,3,19,6,11,76,54,22,63
Albion,8351,4,14,7,15,49,49,0,49
Peterhead,8351,5,14,7,15,56,58,-2,49
Brechin,8351,6,14,7,15,51,56,-5,49
Stranraer,8351,7,13,7,16,55,67,-12,46
Queen's Park,8351,8,10,11,15,44,55,-11,41
Stenhousem'r,8351,9,9,8,19,58,92,-34,35
East Fife,8351,10,8,10,18,48,60,-12,34
Livingston,8352,1,23,2,11,77,43,34,71
Brechin,8352,2,22,4,10,53,34,19,70
Alloa,8352,3,18,8,10,66,44,22,62
Airdrieon,8352,4,19,4,13,59,57,2,61
Albion,8352,5,17,6,13,66,53,13,57
Peterhead,8352,6,13,8,15,48,52,-4,47
Stranraer,8352,7,13,3,20,49,62,-13,42
East Fife,8352,8,10,9,17,45,51,-6,39
Queen's Park,8352,9,11,6,19,41,59,-18,39
Stenhousem'r,8352,10,6,6,24,31,80,-49,24
Livingston,8353,1,24,3,9,76,42,34,75
Alloa,8353,2,19,8,9,76,50,26,65
Brechin,8353,3,20,4,12,62,45,17,64
Peterhead,8353,4,15,6,15,59,65,-6,51
Airdrieon,8353,5,15,5,16,54,65,-11,50
Queen's Park,8353,6,14,6,16,39,53,-14,48
Albion,8353,7,13,8,15,49,56,-7,47
East Fife,8353,8,11,8,17,52,50,2,41
Stenhousem'r,8353,9,9,8,19,53,71,-18,35
Stranraer,8353,10,11,2,23,41,64,-23,35
Livingston,8354,1,21,6,9,81,54,27,69
Alloa,8354,2,19,7,10,71,43,28,64
Brechin,8354,3,15,7,14,53,55,-2,52
East Fife,8354,4,14,9,13,50,45,5,51
Airdrieon,8354,5,14,7,15,58,59,-1,49
Albion,8354,6,14,5,17,55,55,0,47
Stranraer,8354,7,14,5,17,45,55,-10,47
Queen's Park,8354,8,13,8,15,37,50,-13,47
Stenhousem'r,8354,9,12,6,18,56,69,-13,42
Peterhead,8354,10,10,8,18,44,65,-21,38
Livingston,8355,1,21,5,10,76,45,31,68
Brechin,8355,2,19,9,8,57,40,17,66
Alloa,8355,3,19,5,12,72,52,20,62
Airdrieon,8355,4,15,7,14,64,66,-2,52
Peterhead,8355,5,16,4,16,53,57,-4,52
Stranraer,8355,6,13,6,17,63,69,-6,45
Queen's Park,8355,7,12,9,15,39,48,-9,45
East Fife,8355,8,11,9,16,48,52,-4,42
Albion,8355,9,8,13,15,44,54,-10,37
Stenhousem'r,8355,10,9,7,20,53,86,-33,34
Livingston,8356,1,27,2,7,84,39,45,83
Airdrieon,8356,2,16,10,10,55,52,3,58
Alloa,8356,3,15,11,10,64,48,16,56
Brechin,8356,4,15,11,10,49,39,10,56
Peterhead,8356,5,15,7,14,49,49,0,52
Stranraer,8356,6,15,4,17,51,58,-7,49
East Fife,8356,7,12,10,14,41,43,-2,46
Albion,8356,8,9,12,15,45,49,-4,39
Queen's Park,8356,9,8,7,21,33,60,-27,31
Stenhousem'r,8356,10,7,8,21,43,77,-34,29
Livingston,8357,1,19,8,9,76,48,28,65
Airdrieon,8357,2,19,8,9,66,55,11,65
Peterhead,8357,3,16,7,13,55,54,1,55
Albion,8357,4,14,11,11,58,50,8,53
Alloa,8357,5,14,7,15,63,57,6,49
Brechin,8357,6,14,7,15,46,52,-6,49
Queen's Park,8357,7,12,12,12,38,44,-6,48
East Fife,8357,8,11,11,14,53,50,3,44
Stranraer,8357,9,10,7,19,47,59,-12,37
Stenhousem'r,8357,10,8,8,20,46,79,-33,32
Alloa,8358,1,20,7,9,75,46,29,67
Brechin,8358,2,20,6,10,56,41,15,66
Livingston,8358,3,19,7,10,78,52,26,64
Airdrieon,8358,4,17,8,11,67,60,7,59
Peterhead,8358,5,16,5,15,56,54,2,53
Stranraer,8358,6,14,4,18,52,57,-5,46
East Fife,8358,7,12,8,16,48,52,-4,44
Albion,8358,8,10,10,16,41,61,-20,40
Queen's Park,8358,9,10,8,18,38,55,-17,38
Stenhousem'r,8358,10,7,7,22,56,89,-33,28
Airdrieon,8359,1,19,7,10,64,50,14,64
Livingston,8359,2,19,3,14,69,50,19,60
Alloa,8359,3,16,8,12,58,42,16,56
Stranraer,8359,4,16,7,13,54,52,2,55
Queen's Park,8359,5,15,7,14,46,50,-4,52
Brechin,8359,6,14,9,13,50,44,6,51
Albion,8359,7,13,9,14,54,49,5,48
Peterhead,8359,8,13,8,15,51,57,-6,47
Stenhousem'r,8359,9,10,6,20,52,87,-35,36
East Fife,8359,10,8,10,18,41,58,-17,34
Brechin,8360,1,21,3,12,65,47,18,66
Livingston,8360,2,20,5,11,77,52,25,65
Alloa,8360,3,17,7,12,71,55,16,58
Airdrieon,8360,4,18,3,15,64,58,6,57
Albion,8360,5,15,7,14,54,53,1,52
Stranraer,8360,6,15,6,15,50,60,-10,51
Queen's Park,8360,7,14,7,15,39,47,-8,49
Peterhead,8360,8,14,6,16,50,53,-3,48
Stenhousem'r,8360,9,10,7,19,51,74,-23,37
East Fife,8360,10,7,7,22,37,59,-22,28
Livingston,8361,1,20,4,12,72,50,22,64
Airdrieon,8361,2,17,8,11,53,42,11,59
Alloa,8361,3,17,7,12,62,47,15,58
Brechin,8361,4,18,4,14,48,43,5,58
Peterhead,8361,5,15,9,12,52,48,4,54
Albion,8361,6,13,10,13,47,48,-1,49
East Fife,8361,7,13,8,15,52,54,-2,47
Stranraer,8361,8,10,10,16,49,61,-12,40
Queen's Park,8361,9,10,8,18,35,51,-16,38
Stenhousem'r,8361,10,8,10,18,43,69,-26,34
Livingston,8362,1,22,6,8,76,47,29,72
Brechin,8362,2,17,6,13,55,53,2,57
Queen's Park,8362,3,16,8,12,45,46,-1,56
Alloa,8362,4,16,6,14,61,52,9,54
Airdrieon,8362,5,16,6,14,56,53,3,54
Stranraer,8362,6,15,4,17,52,52,0,49
Peterhead,8362,7,13,8,15,55,63,-8,47
Albion,8362,8,12,10,14,55,53,2,46
East Fife,8362,9,11,10,15,55,52,3,43
Stenhousem'r,8362,10,5,10,21,41,80,-39,25
Livingston,8363,1,22,8,6,80,45,35,74
Brechin,8363,2,21,4,11,63,39,24,67
Alloa,8363,3,17,6,13,61,48,13,57
East Fife,8363,4,16,8,12,52,42,10,56
Peterhead,8363,5,16,5,15,47,46,1,53
Albion,8363,6,13,8,15,55,50,5,47
Queen's Park,8363,7,13,4,19,40,54,-14,43
Airdrieon,8363,8,12,7,17,46,64,-18,43
Stenhousem'r,8363,9,9,9,18,42,77,-35,36
Stranraer,8363,10,9,5,22,38,59,-21,32
Livingston,8364,1,20,6,10,74,38,36,66
Alloa,8364,2,18,7,11,66,38,28,61
Brechin,8364,3,18,6,12,50,44,6,60
Airdrieon,8364,4,17,5,14,65,62,3,56
Peterhead,8364,5,15,7,14,55,51,4,52
East Fife,8364,6,13,10,13,44,37,7,49
Albion,8364,7,13,9,14,43,56,-13,48
Queen's Park,8364,8,12,11,13,36,49,-13,47
Stranraer,8364,9,11,4,21,45,60,-15,37
Stenhousem'r,8364,10,6,9,21,36,79,-43,27
Airdrieon,8365,1,20,5,11,65,47,18,65
Livingston,8365,2,18,9,9,78,52,26,63
Alloa,8365,3,18,7,11,71,47,24,61
Stranraer,8365,4,15,6,15,52,55,-3,51
Queen's Park,8365,5,15,6,15,40,52,-12,51
Albion,8365,6,14,7,15,56,51,5,49
Brechin,8365,7,13,9,14,45,53,-8,48
Peterhead,8365,8,12,8,16,45,55,-10,44
East Fife,8365,9,9,9,18,47,59,-12,36
Stenhousem'r,8365,10,8,10,18,46,74,-28,34
Brechin,8366,1,22,3,11,62,47,15,69
Airdrieon,8366,2,20,5,11,64,47,17,65
Alloa,8366,3,18,10,8,71,44,27,64
Livingston,8366,4,16,7,13,68,43,25,55
Peterhead,8366,5,14,9,13,49,55,-6,51
Albion,8366,6,13,10,13,48,47,1,49
East Fife,8366,7,12,10,14,41,41,0,46
Queen's Park,8366,8,11,5,20,26,47,-21,38
Stranraer,8366,9,11,4,21,41,57,-16,37
Stenhousem'r,8366,10,7,9,20,39,81,-42,30
Airdrieon,8367,1,20,7,9,61,44,17,67
Albion,8367,2,18,7,11,56,41,15,61
Brechin,8367,3,18,5,13,52,47,5,59
Alloa,8367,4,17,7,12,67,51,16,58
Livingston,8367,5,17,4,15,70,57,13,55
Stranraer,8367,6,13,8,15,56,65,-9,47
Peterhead,8367,7,13,7,16,48,57,-9,46
East Fife,8367,8,11,6,19,46,53,-7,39
Queen's Park,8367,9,11,6,19,36,50,-14,39
Stenhousem'r,8367,10,11,5,20,51,78,-27,38
Livingston,8368,1,19,7,10,76,53,23,64
Airdrieon,8368,2,17,8,11,61,53,8,59
Alloa,8368,3,17,7,12,66,52,14,58
Peterhead,8368,4,16,7,13,48,49,-1,55
Brechin,8368,5,16,5,15,52,45,7,53
Stenhousem'r,8368,6,12,11,13,57,62,-5,47
Albion,8368,7,13,6,17,50,64,-14,45
Queen's Park,8368,8,12,7,17,37,55,-18,43
East Fife,8368,9,11,8,17,51,55,-4,41
Stranraer,8368,10,9,10,17,44,54,-10,37
Alloa,8369,1,23,7,6,78,30,48,76
Airdrieon,8369,2,20,6,10,69,58,11,66
Livingston,8369,3,19,6,11,67,46,21,63
Brechin,8369,4,16,6,14,50,53,-3,54
Albion,8369,5,11,13,12,47,47,0,46
Queen's Park,8369,6,13,7,16,34,45,-11,46
Peterhead,8369,7,11,10,15,46,55,-9,43
East Fife,8369,8,10,11,15,40,48,-8,41
Stranraer,8369,9,10,4,22,54,75,-21,34
Stenhousem'r,8369,10,8,8,20,46,74,-28,32
Alloa,8370,1,21,6,9,78,43,35,69
Livingston,8370,2,21,6,9,77,48,29,69
Airdrieon,8370,3,16,10,10,55,46,9,58
Queen's Park,8370,4,14,8,14,40,45,-5,50
East Fife,8370,5,14,7,15,55,51,4,49
Brechin,8370,6,14,5,17,46,56,-10,47
Peterhead,8370,7,12,8,16,51,59,-8,44
Albion,8370,8,13,4,19,54,64,-10,43
Stranraer,8370,9,10,11,15,54,67,-13,41
Stenhousem'r,8370,10,8,9,19,40,71,-31,33
Livingston,8371,1,24,3,9,82,47,35,75
Airdrieon,8371,2,23,5,8,69,45,24,74
Alloa,8371,3,20,5,11,71,48,23,65
Brechin,8371,4,18,5,13,55,49,6,59
Queen's Park,8371,5,14,5,17,37,46,-9,47
East Fife,8371,6,12,10,14,47,39,8,46
Peterhead,8371,7,10,12,14,45,61,-16,42
Stranraer,8371,8,10,8,18,49,62,-13,38
Albion,8371,9,10,7,19,54,69,-15,37
Stenhousem'r,8371,10,6,6,24,47,90,-43,24
Livingston,8372,1,23,6,7,86,44,42,75
Alloa,8372,2,21,7,8,79,40,39,70
Brechin,8372,3,16,9,11,49,42,7,57
Albion,8372,4,15,8,13,49,48,1,53
Airdrieon,8372,5,13,10,13,58,67,-9,49
Stranraer,8372,6,13,5,18,51,61,-10,44
Peterhead,8372,7,11,9,16,45,55,-10,42
Queen's Park,8372,8,10,10,16,44,59,-15,40
East Fife,8372,9,10,9,17,45,55,-10,39
Stenhousem'r,8372,10,7,9,20,44,79,-35,30
Livingston,8373,1,24,3,9,80,37,43,75
Alloa,8373,2,19,10,7,66,39,27,67
Peterhead,8373,3,17,5,14,58,50,8,56
Albion,8373,4,16,7,13,54,46,8,55
Brechin,8373,5,16,7,13,50,46,4,55
Airdrieon,8373,6,16,6,14,53,62,-9,54
Stranraer,8373,7,13,4,19,47,61,-14,43
East Fife,8373,8,9,7,20,48,65,-17,34
Stenhousem'r,8373,9,8,10,18,44,69,-25,34
Queen's Park,8373,10,9,7,20,40,65,-25,34
Brechin,8374,1,23,4,9,62,40,22,73
Livingston,8374,2,22,2,12,78,45,33,68
Airdrieon,8374,3,19,4,13,67,54,13,61
Alloa,8374,4,17,9,10,69,45,24,60
Albion,8374,5,13,13,10,55,48,7,52
Peterhead,8374,6,14,7,15,45,49,-4,49
Queen's Park,8374,7,13,5,18,32,51,-19,44
East Fife,8374,8,11,8,17,48,51,-3,41
Stenhousem'r,8374,9,9,5,22,41,80,-39,32
Stranraer,8374,10,8,5,23,44,78,-34,29
Livingston,8375,1,21,8,7,71,40,31,71
Alloa,8375,2,19,10,7,71,42,29,67
Peterhead,8375,3,16,8,12,50,48,2,56
Stranraer,8375,4,15,6,15,53,51,2,51
Airdrieon,8375,5,14,8,14,55,60,-5,50
Albion,8375,6,13,9,14,48,42,6,48
Brechin,8375,7,12,7,17,41,52,-11,43
East Fife,8375,8,10,11,15,41,44,-3,41
Stenhousem'r,8375,9,10,8,18,50,73,-23,38
Queen's Park,8375,10,10,5,21,29,57,-28,35
Alloa,8376,1,21,4,11,70,51,19,67
Livingston,8376,2,18,9,9,82,46,36,63
Airdrieon,8376,3,17,8,11,65,56,9,59
Peterhead,8376,4,16,8,12,58,53,5,56
Albion,8376,5,14,7,15,55,52,3,49
Queen's Park,8376,6,12,12,12,43,53,-10,48
East Fife,8376,7,12,11,13,47,48,-1,47
Brechin,8376,8,12,5,19,45,54,-9,41
Stranraer,8376,9,11,3,22,47,67,-20,36
Stenhousem'r,8376,10,8,11,17,47,79,-32,35
Alloa,8377,1,20,6,10,64,41,23,66
Peterhead,8377,2,18,5,13,59,45,14,59
Brechin,8377,3,18,2,16,48,54,-6,56
Livingston,8377,4,17,4,15,78,58,20,55
Airdrieon,8377,5,14,9,13,60,57,3,51
East Fife,8377,6,14,7,15,51,47,4,49
Albion,8377,7,12,13,11,58,61,-3,49
Stranraer,8377,8,14,5,17,49,55,-6,47
Queen's Park,8377,9,10,9,17,38,53,-15,39
Stenhousem'r,8377,10,10,6,20,44,78,-34,36
Livingston,8378,1,25,3,8,88,49,39,78
Alloa,8378,2,18,11,7,73,40,33,65
Airdrieon,8378,3,14,11,11,57,51,6,53
Stranraer,8378,4,14,7,15,60,61,-1,49
Albion,8378,5,13,8,15,54,57,-3,47
Brechin,8378,6,14,5,17,47,60,-13,47
Peterhead,8378,7,11,11,14,47,47,0,44
Stenhousem'r,8378,8,10,10,16,52,77,-25,40
East Fife,8378,9,9,11,16,45,57,-12,38
Queen's Park,8378,10,11,5,20,36,60,-24,38
Livingston,8379,1,21,8,7,77,40,37,71
Alloa,8379,2,17,11,8,62,36,26,62
Peterhead,8379,3,15,10,11,53,48,5,55
Brechin,8379,4,16,6,14,59,48,11,54
Albion,8379,5,13,9,14,47,59,-12,48
East Fife,8379,6,13,7,16,54,55,-1,46
Queen's Park,8379,7,14,4,18,35,46,-11,46
Stranraer,8379,8,13,6,17,46,57,-11,45
Airdrieon,8379,9,13,5,18,51,67,-16,44
Stenhousem'r,8379,10,8,8,20,55,83,-28,32
Alloa,8380,1,23,6,7,78,40,38,75
Livingston,8380,2,22,5,9,77,47,30,71
Albion,8380,3,18,9,9,62,46,16,63
Brechin,8380,4,14,7,15,46,43,3,49
Airdrieon,8380,5,13,7,16,51,54,-3,46
Queen's Park,8380,6,14,4,18,38,45,-7,46
Peterhead,8380,7,13,7,16,58,72,-14,46
East Fife,8380,8,12,9,15,49,50,-1,45
Stranraer,8380,9,12,6,18,48,65,-17,42
Stenhousem'r,8380,10,5,8,23,46,91,-45,23
Livingston,8381,1,23,7,6,86,40,46,76
Alloa,8381,2,21,6,9,77,40,37,69
Brechin,8381,3,20,3,13,55,46,9,63
Airdrieon,8381,4,18,6,12,54,48,6,60
Peterhead,8381,5,15,6,15,54,57,-3,51
Albion,8381,6,12,9,15,51,52,-1,45
Queen's Park,8381,7,13,5,18,38,55,-17,44
Stranraer,8381,8,11,8,17,41,53,-12,41
East Fife,8381,9,11,6,19,48,55,-7,39
Stenhousem'r,8381,10,4,8,24,42,100,-58,20
Livingston,8382,1,18,7,11,71,46,25,61
Airdrieon,8382,2,17,7,12,68,55,13,58
Brechin,8382,3,15,11,10,48,41,7,56
Alloa,8382,4,14,12,10,69,59,10,54
East Fife,8382,5,13,11,12,51,43,8,50
Albion,8382,6,13,11,12,61,57,4,50
Peterhead,8382,7,14,8,14,44,49,-5,50
Stranraer,8382,8,11,11,14,58,61,-3,44
Queen's Park,8382,9,10,9,17,33,54,-21,39
Stenhousem'r,8382,10,7,9,20,50,88,-38,30
Livingston,8383,1,20,5,11,79,53,26,65
Alloa,8383,2,18,8,10,66,48,18,62
Brechin,8383,3,16,8,12,55,49,6,56
Peterhead,8383,4,15,9,12,57,46,11,54
Queen's Park,8383,5,16,3,17,41,41,0,51
Airdrieon,8383,6,15,4,17,56,64,-8,49
Albion,8383,7,13,7,16,50,55,-5,46
East Fife,8383,8,12,8,16,51,50,1,44
Stenhousem'r,8383,9,13,4,19,50,75,-25,43
Stranraer,8383,10,9,10,17,48,72,-24,37
Alloa,8384,1,18,13,5,78,43,35,67
Livingston,8384,2,17,7,12,67,53,14,58
Stranraer,8384,3,17,7,12,52,51,1,58
Albion,8384,4,16,8,12,58,51,7,56
East Fife,8384,5,16,7,13,59,39,20,55
Airdrieon,8384,6,14,10,12,53,51,2,52
Brechin,8384,7,15,7,14,50,53,-3,52
Peterhead,8384,8,12,9,15,48,54,-6,45
Queen's Park,8384,9,10,6,20,33,52,-19,36
Stenhousem'r,8384,10,6,4,26,36,87,-51,22
Livingston,8385,1,21,4,11,68,49,19,67
Alloa,8385,2,20,5,11,81,50,31,65
Airdrieon,8385,3,18,6,12,81,67,14,60
Brechin,8385,4,15,10,11,49,45,4,55
Albion,8385,5,14,7,15,55,57,-2,49
Peterhead,8385,6,14,7,15,52,58,-6,49
Stranraer,8385,7,12,9,15,56,66,-10,45
East Fife,8385,8,10,12,14,46,45,1,42
Queen's Park,8385,9,10,9,17,35,49,-14,39
Stenhousem'r,8385,10,8,7,21,45,82,-37,31
Livingston,8386,1,21,5,10,80,51,29,68
Alloa,8386,2,18,6,12,68,43,25,60
Albion,8386,3,16,9,11,57,52,5,57
Brechin,8386,4,18,3,15,57,53,4,57
Queen's Park,8386,5,16,7,13,52,49,3,55
Airdrieon,8386,6,15,8,13,60,67,-7,53
Peterhead,8386,7,13,7,16,50,53,-3,46
East Fife,8386,8,10,8,18,52,55,-3,38
Stenhousem'r,8386,9,10,8,18,56,85,-29,38
Stranraer,8386,10,10,5,21,46,70,-24,35
Livingston,8387,1,22,3,11,69,46,23,69
Alloa,8387,2,20,6,10,67,42,25,66
Airdrieon,8387,3,17,9,10,63,52,11,60
Albion,8387,4,16,8,12,56,47,9,56
Brechin,8387,5,17,4,15,54,50,4,55
Queen's Park,8387,6,15,5,16,38,50,-12,50
East Fife,8387,7,11,11,14,42,45,-3,44
Peterhead,8387,8,10,11,15,38,48,-10,41
Stranraer,8387,9,10,6,20,46,61,-15,36
Stenhousem'r,8387,10,8,5,23,48,80,-32,29
Livingston,8388,1,22,4,10,78,50,28,70
Alloa,8388,2,17,10,9,70,47,23,61
Brechin,8388,3,16,10,10,51,44,7,58
Airdrieon,8388,4,17,6,13,75,61,14,57
Albion,8388,5,13,10,13,55,49,6,49
East Fife,8388,6,13,9,14,49,47,2,48
Peterhead,8388,7,12,8,16,51,57,-6,44
Queen's Park,8388,8,11,8,17,39,54,-15,41
Stranraer,8388,9,9,9,18,49,68,-19,36
Stenhousem'r,8388,10,8,10,18,43,83,-40,34
Livingston,8389,1,25,3,8,88,48,40,78
Alloa,8389,2,18,7,11,64,51,13,61
Brechin,8389,3,18,4,14,54,49,5,58
Airdrieon,8389,4,14,9,13,62,58,4,51
East Fife,8389,5,14,8,14,54,48,6,50
Peterhead,8389,6,14,7,15,53,60,-7,49
Albion,8389,7,12,8,16,58,56,2,44
Queen's Park,8389,8,12,7,17,31,47,-16,43
Stranraer,8389,9,10,8,18,46,60,-14,38
Stenhousem'r,8389,10,9,7,20,51,84,-33,34
Livingston,8390,1,22,7,7,71,43,28,73
Alloa,8390,2,17,9,10,72,47,25,60
Brechin,8390,3,17,8,11,55,50,5,59
Peterhead,8390,4,14,10,12,49,52,-3,52
Airdrieon,8390,5,15,4,17,61,65,-4,49
Queen's Park,8390,6,11,12,13,36,52,-16,45
Albion,8390,7,11,11,14,52,52,0,44
East Fife,8390,8,12,7,17,51,50,1,43
Stranraer,8390,9,11,8,17,45,56,-11,41
Stenhousem'r,8390,10,8,8,20,50,75,-25,32
Livingston,8391,1,19,6,11,84,52,32,63
Brechin,8391,2,17,5,14,54,51,3,56
Peterhead,8391,3,16,7,13,57,46,11,55
Alloa,8391,4,16,6,14,68,58,10,54
Airdrieon,8391,5,15,7,14,50,57,-7,52
Albion,8391,6,14,6,16,47,54,-7,48
Queen's Park,8391,7,12,10,14,43,57,-14,46
East Fife,8391,8,11,12,13,49,46,3,45
Stranraer,8391,9,13,4,19,49,57,-8,43
Stenhousem'r,8391,10,12,7,17,50,73,-23,43
Brechin,8392,1,21,4,11,57,44,13,67
Livingston,8392,2,20,4,12,77,51,26,64
Peterhead,8392,3,17,8,11,61,49,12,59
Airdrieon,8392,4,16,9,11,64,59,5,57
Alloa,8392,5,16,8,12,70,54,16,56
Albion,8392,6,15,8,13,56,52,4,53
Stranraer,8392,7,14,7,15,49,60,-11,49
East Fife,8392,8,10,7,19,47,54,-7,37
Stenhousem'r,8392,9,9,6,21,52,78,-26,33
Queen's Park,8392,10,8,7,21,31,63,-32,31
Brechin,8393,1,21,4,11,58,41,17,67
Livingston,8393,2,20,4,12,77,45,32,64
Alloa,8393,3,17,8,11,65,40,25,59
Airdrieon,8393,4,17,5,14,55,61,-6,56
Queen's Park,8393,5,16,5,15,43,50,-7,53
Peterhead,8393,6,12,10,14,46,51,-5,46
Stranraer,8393,7,13,7,16,44,51,-7,46
Albion,8393,8,13,6,17,51,69,-18,45
East Fife,8393,9,11,9,16,42,44,-2,42
Stenhousem'r,8393,10,8,6,22,48,77,-29,30
Alloa,8394,1,19,7,10,69,47,22,64
Livingston,8394,2,19,6,11,80,50,30,63
Brechin,8394,3,17,5,14,57,49,8,56
Airdrieon,8394,4,16,8,12,62,64,-2,56
Albion,8394,5,16,6,14,50,55,-5,54
Peterhead,8394,6,15,8,13,56,55,1,53
Queen's Park,8394,7,14,10,12,49,44,5,52
East Fife,8394,8,13,7,16,55,60,-5,46
Stranraer,8394,9,11,5,20,53,66,-13,38
Stenhousem'r,8394,10,6,6,24,47,88,-41,24
Alloa,8395,1,22,6,8,75,41,34,72
Livingston,8395,2,22,5,9,85,56,29,71
Airdrieon,8395,3,16,9,11,59,47,12,57
Brechin,8395,4,15,5,16,43,58,-15,50
Peterhead,8395,5,14,6,16,55,65,-10,48
Stranraer,8395,6,13,8,15,53,52,1,47
East Fife,8395,7,12,10,14,57,46,11,46
Albion,8395,8,11,9,16,49,56,-7,42
Stenhousem'r,8395,9,9,9,18,46,74,-28,36
Queen's Park,8395,10,7,11,18,32,59,-27,32
Alloa,8396,1,20,10,6,75,43,32,70
Livingston,8396,2,19,7,10,82,57,25,64
Airdrieon,8396,3,17,8,11,58,50,8,59
Albion,8396,4,16,9,11,56,53,3,57
Stranraer,8396,5,14,5,17,57,64,-7,47
East Fife,8396,6,10,13,13,48,45,3,43
Brechin,8396,7,11,8,17,43,47,-4,41
Peterhead,8396,8,10,10,16,38,51,-13,40
Queen's Park,8396,9,10,8,18,37,58,-21,38
Stenhousem'r,8396,10,10,8,18,57,83,-26,38
Livingston,8397,1,20,5,11,86,55,31,65
Alloa,8397,2,18,10,8,75,46,29,64
Airdrieon,8397,3,18,7,11,63,57,6,61
Queen's Park,8397,4,15,7,14,42,44,-2,52
Albion,8397,5,14,9,13,51,51,0,51
Brechin,8397,6,15,3,18,48,57,-9,48
Peterhead,8397,7,12,8,16,46,60,-14,44
Stranraer,8397,8,12,6,18,46,54,-8,42
East Fife,8397,9,10,11,15,52,54,-2,41
Stenhousem'r,8397,10,9,8,19,42,73,-31,35
Livingston,8398,1,25,5,6,81,30,51,80
Alloa,8398,2,20,8,8,71,41,30,68
Airdrieon,8398,3,15,8,13,65,64,1,53
Brechin,8398,4,14,9,13,47,47,0,51
Albion,8398,5,12,10,14,47,48,-1,46
Queen's Park,8398,6,13,7,16,45,56,-11,46
Peterhead,8398,7,11,11,14,50,54,-4,44
Stranraer,8398,8,11,8,17,51,62,-11,41
East Fife,8398,9,8,15,13,42,45,-3,39
Stenhousem'r,8398,10,6,9,21,46,98,-52,27
Livingston,8399,1,21,5,10,81,49,32,68
Brechin,8399,2,21,4,11,50,35,15,67
Alloa,8399,3,19,8,9,71,48,23,65
Peterhead,8399,4,13,14,9,57,46,11,53
Airdrieon,8399,5,14,11,11,54,50,4,53
Albion,8399,6,14,9,13,49,54,-5,51
East Fife,8399,7,8,12,16,38,50,-12,36
Queen's Park,8399,8,9,9,18,40,55,-15,36
Stranraer,8399,9,10,5,21,49,66,-17,35
Stenhousem'r,8399,10,7,11,18,41,77,-36,32
Livingston,8400,1,19,7,10,72,43,29,64
Airdrieon,8400,2,19,5,12,59,46,13,62
Albion,8400,3,16,7,13,50,45,5,55
Brechin,8400,4,17,4,15,42,38,4,55
Alloa,8400,5,14,9,13,59,47,12,51
Queen's Park,8400,6,13,8,15,37,50,-13,47
Peterhead,8400,7,13,8,15,47,63,-16,47
Stranraer,8400,8,12,9,15,53,57,-4,45
East Fife,8400,9,10,10,16,50,48,2,40
Stenhousem'r,8400,10,11,5,20,47,79,-32,38
Livingston,8401,1,21,4,11,70,47,23,67
Alloa,8401,2,17,10,9,72,47,25,61
Airdrieon,8401,3,17,6,13,64,60,4,57
Brechin,8401,4,15,7,14,49,48,1,52
Albion,8401,5,14,8,14,44,46,-2,50
Stenhousem'r,8401,6,14,7,15,56,66,-10,49
Peterhead,8401,7,12,10,14,46,53,-7,46
East Fife,8401,8,10,10,16,46,48,-2,40
Queen's Park,8401,9,8,14,14,29,43,-14,38
Stranraer,8401,10,10,8,18,51,69,-18,38
Alloa,8402,1,19,10,7,76,52,24,67
Livingston,8402,2,19,7,10,73,46,27,64
Airdrieon,8402,3,19,5,12,72,60,12,62
Brechin,8402,4,15,7,14,46,49,-3,52
Albion,8402,5,12,11,13,54,55,-1,47
Peterhead,8402,6,13,5,18,51,60,-9,44
Queen's Park,8402,7,12,8,16,37,50,-13,44
East Fife,8402,8,10,12,14,44,45,-1,42
Stranraer,8402,9,11,8,17,51,60,-9,41
Stenhousem'r,8402,10,9,9,18,47,74,-27,36
Livingston,8403,1,23,5,8,74,39,35,74
Brechin,8403,2,19,6,11,57,49,8,63
Alloa,8403,3,17,11,8,67,38,29,62
Airdrieon,8403,4,15,8,13,57,60,-3,53
Queen's Park,8403,5,14,9,13,44,46,-2,51
Albion,8403,6,14,8,14,57,46,11,50
Peterhead,8403,7,13,10,13,53,53,0,49
East Fife,8403,8,8,12,16,48,61,-13,36
Stranraer,8403,9,10,6,20,52,70,-18,36
Stenhousem'r,8403,10,6,7,23,33,80,-47,25
Alloa,8404,1,23,6,7,78,40,38,75
Livingston,8404,2,22,4,10,79,40,39,70
Airdrieon,8404,3,17,6,13,61,66,-5,57
Peterhead,8404,4,14,8,14,50,49,1,50
Brechin,8404,5,13,8,15,46,57,-11,47
Stranraer,8404,6,13,7,16,58,63,-5,46
Queen's Park,8404,7,13,7,16,46,61,-15,46
Albion,8404,8,12,8,16,52,54,-2,44
East Fife,8404,9,9,8,19,46,56,-10,35
Stenhousem'r,8404,10,8,10,18,48,78,-30,34
Airdrieon,8405,1,20,7,9,64,45,19,67
Alloa,8405,2,20,5,11,70,47,23,65
Livingston,8405,3,20,4,12,74,46,28,64
Albion,8405,4,17,4,15,53,46,7,55
Queen's Park,8405,5,15,7,14,38,47,-9,52
Brechin,8405,6,14,6,16,40,45,-5,48
Stranraer,8405,7,12,9,15,57,57,0,45
Peterhead,8405,8,11,8,17,44,57,-13,41
East Fife,8405,9,9,11,16,42,52,-10,38
Stenhousem'r,8405,10,6,11,19,45,85,-40,29
Livingston,8406,1,20,5,11,77,51,26,65
Alloa,8406,2,17,9,10,53,38,15,60
Airdrieon,8406,3,17,8,11,59,50,9,59
East Fife,8406,4,15,7,14,52,46,6,52
Brechin,8406,5,14,7,15,43,48,-5,49
Albion,8406,6,13,8,15,52,60,-8,47
Stenhousem'r,8406,7,12,9,15,57,64,-7,45
Queen's Park,8406,8,12,9,15,40,49,-9,45
Stranraer,8406,9,12,7,17,47,60,-13,43
Peterhead,8406,10,10,7,19,44,58,-14,37
Livingston,8407,1,22,5,9,72,46,26,71
Peterhead,8407,2,18,8,10,66,57,9,62
Alloa,8407,3,17,7,12,73,49,24,58
Airdrieon,8407,4,16,7,13,60,63,-3,55
Brechin,8407,5,16,6,14,54,48,6,54
Queen's Park,8407,6,13,7,16,46,58,-12,46
Albion,8407,7,11,10,15,49,54,-5,43
East Fife,8407,8,10,9,17,44,54,-10,39
Stranraer,8407,9,11,6,19,44,56,-12,39
Stenhousem'r,8407,10,9,9,18,51,74,-23,36
Livingston,8408,1,22,7,7,83,39,44,73
Brechin,8408,2,17,9,10,49,47,2,60
Alloa,8408,3,18,4,14,75,54,21,58
Airdrieon,8408,4,17,6,13,68,59,9,57
Stranraer,8408,5,13,8,15,51,51,0,47
Queen's Park,8408,6,12,9,15,46,55,-9,45
Peterhead,8408,7,13,6,17,49,63,-14,45
Albion,8408,8,10,13,13,52,60,-8,43
East Fife,8408,9,11,7,18,49,52,-3,40
Stenhousem'r,8408,10,7,11,18,43,85,-42,32
Livingston,8409,1,21,5,10,79,49,30,68
Alloa,8409,2,18,9,9,66,44,22,63
Brechin,8409,3,19,6,11,58,43,15,63
Queen's Park,8409,4,14,7,15,41,50,-9,49
Airdrieon,8409,5,15,4,17,50,60,-10,49
Albion,8409,6,13,8,15,53,54,-1,47
Peterhead,8409,7,12,11,13,49,54,-5,47
East Fife,8409,8,11,12,13,55,50,5,45
Stranraer,8409,9,11,6,19,49,65,-16,39
Stenhousem'r,8409,10,8,8,20,48,79,-31,32
Livingston,8410,1,21,4,11,80,48,32,67
Alloa,8410,2,19,8,9,65,43,22,65
Peterhead,8410,3,17,7,12,51,50,1,58
Brechin,8410,4,17,6,13,52,41,11,57
Stranraer,8410,5,15,8,13,56,51,5,53
Albion,8410,6,14,7,15,53,58,-5,49
Airdrieon,8410,7,12,9,15,47,49,-2,45
East Fife,8410,8,12,8,16,56,50,6,44
Queen's Park,8410,9,11,8,17,42,64,-22,41
Stenhousem'r,8410,10,5,9,22,42,90,-48,24
Alloa,8411,1,22,5,9,72,45,27,71
Brechin,8411,2,21,3,12,54,43,11,66
Livingston,8411,3,20,5,11,76,47,29,65
Stranraer,8411,4,17,6,13,64,53,11,57
Peterhead,8411,5,13,10,13,58,62,-4,49
Airdrieon,8411,6,13,6,17,51,59,-8,45
Albion,8411,7,13,6,17,56,67,-11,45
Queen's Park,8411,8,11,7,18,43,59,-16,40
East Fife,8411,9,10,9,17,54,59,-5,39
Stenhousem'r,8411,10,6,11,19,41,75,-34,29
Alloa,8412,1,17,11,8,64,44,20,62
Livingston,8412,2,18,7,11,77,54,23,61
Airdrieon,8412,3,18,5,13,61,54,7,59
Brechin,8412,4,17,3,16,57,52,5,54
Peterhead,8412,5,14,9,13,52,49,3,51
East Fife,8412,6,14,8,14,46,46,0,50
Albion,8412,7,12,9,15,55,56,-1,45
Stranraer,8412,8,12,8,16,49,57,-8,44
Queen's Park,8412,9,12,7,17,37,57,-20,43
Stenhousem'r,8412,10,9,7,20,48,77,-29,34
Livingston,8413,1,20,5,11,72,42,30,65
Alloa,8413,2,19,6,11,69,45,24,63
Albion,8413,3,18,6,12,72,59,13,60
Airdrieon,8413,4,16,7,13,52,52,0,55
Queen's Park,8413,5,15,7,14,37,50,-13,52
Brechin,8413,6,13,9,14,47,55,-8,48
Stranraer,8413,7,13,7,16,50,58,-8,46
Peterhead,8413,8,11,9,16,43,55,-12,42
Stenhousem'r,8413,9,11,7,18,49,66,-17,40
East Fife,8413,10,7,11,18,47,56,-9,32
Livingston,8414,1,21,4,11,82,46,36,67
Alloa,8414,2,19,8,9,66,41,25,65
Brechin,8414,3,17,8,11,59,44,15,59
Airdrieon,8414,4,16,8,12,56,53,3,56
Queen's Park,8414,5,13,9,14,38,48,-10,48
Stranraer,8414,6,13,8,15,46,50,-4,47
Albion,8414,7,11,12,13,47,49,-2,45
East Fife,8414,8,11,9,16,50,59,-9,42
Peterhead,8414,9,11,9,16,43,58,-15,42
Stenhousem'r,8414,10,5,11,20,49,88,-39,26
Livingston,8415,1,22,6,8,79,44,35,72
Alloa,8415,2,16,11,9,61,45,16,59
Brechin,8415,3,17,7,12,47,45,2,58
East Fife,8415,4,15,11,10,59,42,17,56
Airdrieon,8415,5,16,6,14,53,44,9,54
Albion,8415,6,14,9,13,47,46,1,51
Stranraer,8415,7,13,4,19,46,57,-11,43
Peterhead,8415,8,10,10,16,40,52,-12,40
Queen's Park,8415,9,11,4,21,36,57,-21,37
Stenhousem'r,8415,10,7,10,19,42,78,-36,31
Alloa,8416,1,20,8,8,82,47,35,68
Livingston,8416,2,20,6,10,68,44,24,66
Airdrieon,8416,3,19,8,9,63,43,20,65
Brechin,8416,4,18,6,12,59,56,3,60
East Fife,8416,5,14,8,14,51,42,9,50
Albion,8416,6,14,6,16,52,62,-10,48
Stranraer,8416,7,14,3,19,47,61,-14,45
Peterhead,8416,8,10,8,18,41,56,-15,38
Queen's Park,8416,9,9,9,18,35,59,-24,36
Stenhousem'r,8416,10,8,6,22,59,87,-28,30
Alloa,8417,1,22,7,7,65,41,24,73
Livingston,8417,2,18,5,13,70,46,24,59
Brechin,8417,3,16,10,10,56,46,10,58
Airdrieon,8417,4,16,8,12,55,50,5,56
Peterhead,8417,5,15,6,15,49,52,-3,51
Albion,8417,6,12,10,14,49,45,4,46
Stranraer,8417,7,11,8,17,48,59,-11,41
East Fife,8417,8,9,12,15,46,49,-3,39
Stenhousem'r,8417,9,10,8,18,47,79,-32,38
Queen's Park,8417,10,9,10,17,33,51,-18,37
Livingston,8418,1,21,5,10,76,47,29,68
Alloa,8418,2,18,8,10,70,50,20,62
Albion,8418,3,18,7,11,62,43,19,61
Airdrieon,8418,4,18,7,11,65,51,14,61
Brechin,8418,5,17,8,11,56,48,8,59
Peterhead,8418,6,14,8,14,49,50,-1,50
Queen's Park,8418,7,14,7,15,42,50,-8,49
Stranraer,8418,8,12,7,17,44,54,-10,43
East Fife,8418,9,10,6,20,47,62,-15,36
Stenhousem'r,8418,10,3,7,26,32,88,-56,16
Livingston,8419,1,20,5,11,82,54,28,65
Alloa,8419,2,18,8,10,67,40,27,62
Queen's Park,8419,3,17,7,12,46,50,-4,58
Brechin,8419,4,16,7,13,50,45,5,55
Airdrieon,8419,5,14,11,11,55,50,5,53
Albion,8419,6,14,10,12,49,50,-1,52
Stranraer,8419,7,12,9,15,52,51,1,45
East Fife,8419,8,10,12,14,43,48,-5,42
Peterhead,8419,9,10,10,16,44,56,-12,40
Stenhousem'r,8419,10,5,9,22,48,92,-44,24
Livingston,8420,1,23,4,9,77,43,34,73
Alloa,8420,2,16,8,12,67,52,15,56
Airdrieon,8420,3,16,8,12,60,57,3,56
Brechin,8420,4,16,7,13,63,58,5,55
Stranraer,8420,5,15,6,15,60,58,2,51
Peterhead,8420,6,12,11,13,52,56,-4,47
Albion,8420,7,13,7,16,51,61,-10,46
East Fife,8420,8,11,8,17,53,56,-3,41
Queen's Park,8420,9,10,10,16,38,60,-22,40
Stenhousem'r,8420,10,9,9,18,47,67,-20,36
Alloa,8421,1,20,8,8,83,48,35,68
Airdrieon,8421,2,20,7,9,62,49,13,67
Livingston,8421,3,20,5,11,77,48,29,65
Brechin,8421,4,16,6,14,48,43,5,54
Peterhead,8421,5,14,9,13,49,53,-4,51
Stranraer,8421,6,15,4,17,45,54,-9,49
Albion,8421,7,12,8,16,50,54,-4,44
Queen's Park,8421,8,12,7,17,43,55,-12,43
East Fife,8421,9,10,10,16,50,52,-2,40
Stenhousem'r,8421,10,6,6,24,42,93,-51,24
Livingston,8422,1,20,8,8,73,38,35,68
Alloa,8422,2,19,9,8,72,42,30,66
Brechin,8422,3,18,3,15,56,58,-2,57
Peterhead,8422,4,14,12,10,51,48,3,54
Airdrieon,8422,5,14,7,15,54,60,-6,49
Queen's Park,8422,6,12,8,16,40,56,-16,44
East Fife,8422,7,10,12,14,44,41,3,42
Stranraer,8422,8,13,3,20,58,69,-11,42
Stenhousem'r,8422,9,12,5,19,63,81,-18,41
Albion,8422,10,10,9,17,49,67,-18,39
Alloa,8423,1,21,6,9,82,46,36,69
Livingston,8423,2,21,4,11,72,47,25,67
Brechin,8423,3,18,8,10,57,46,11,62
Airdrieon,8423,4,16,4,16,46,48,-2,52
Albion,8423,5,13,10,13,56,53,3,49
Stranraer,8423,6,15,4,17,49,56,-7,49
East Fife,8423,7,12,7,17,49,58,-9,43
Queen's Park,8423,8,12,5,19,42,61,-19,41
Peterhead,8423,9,10,9,17,47,65,-18,39
Stenhousem'r,8423,10,9,9,18,46,66,-20,36
Alloa,8424,1,19,8,9,64,38,26,65
Livingston,8424,2,19,7,10,72,48,24,64
Brechin,8424,3,16,7,13,49,49,0,55
Airdrieon,8424,4,15,6,15,52,55,-3,51
Peterhead,8424,5,14,8,14,51,47,4,50
Albion,8424,6,12,12,12,54,53,1,48
Stranraer,8424,7,13,6,17,50,57,-7,45
Queen's Park,8424,8,11,11,14,32,49,-17,44
East Fife,8424,9,9,12,15,46,47,-1,39
Stenhousem'r,8424,10,9,9,18,51,78,-27,36
Livingston,8425,1,21,3,12,74,48,26,66
Alloa,8425,2,19,6,11,69,45,24,63
Peterhead,8425,3,19,5,12,56,48,8,62
Albion,8425,4,17,7,12,57,50,7,58
Brechin,8425,5,16,6,14,52,56,-4,54
Airdrieon,8425,6,15,7,14,60,57,3,52
East Fife,8425,7,13,7,16,47,47,0,46
Queen's Park,8425,8,12,7,17,37,50,-13,43
Stranraer,8425,9,11,6,19,45,58,-13,39
Stenhousem'r,8425,10,8,4,24,52,90,-38,28
Livingston,8426,1,20,4,12,81,61,20,64
Airdrieon,8426,2,17,7,12,63,58,5,58
Albion,8426,3,16,8,12,75,59,16,56
Alloa,8426,4,15,11,10,62,48,14,56
Brechin,8426,5,14,8,14,47,50,-3,50
Peterhead,8426,6,13,9,14,51,50,1,48
Stranraer,8426,7,13,7,16,65,62,3,46
Queen's Park,8426,8,12,9,15,39,65,-26,45
East Fife,8426,9,11,11,14,45,49,-4,44
Stenhousem'r,8426,10,9,6,21,58,84,-26,33
Livingston,8427,1,26,2,8,88,38,50,80
Alloa,8427,2,22,8,6,80,39,41,74
Airdrieon,8427,3,19,6,11,53,49,4,63
Albion,8427,4,14,7,15,53,51,2,49
Stranraer,8427,5,13,4,19,52,59,-7,43
Peterhead,8427,6,11,10,15,40,59,-19,43
Queen's Park,8427,7,11,9,16,36,54,-18,42
East Fife,8427,8,9,13,14,44,47,-3,40
Brechin,8427,9,11,5,20,40,55,-15,38
Stenhousem'r,8427,10,8,8,20,40,75,-35,32
Alloa,8428,1,21,5,10,66,38,28,68
Livingston,8428,2,18,8,10,75,52,23,62
Peterhead,8428,3,18,7,11,58,49,9,61
Airdrieon,8428,4,16,6,14,62,56,6,54
Stranraer,8428,5,16,5,15,57,57,0,53
Albion,8428,6,13,10,13,54,53,1,49
Brechin,8428,7,14,7,15,42,49,-7,49
Queen's Park,8428,8,11,10,15,36,49,-13,43
East Fife,8428,9,10,7,19,44,48,-4,37
Stenhousem'r,8428,10,8,5,23,45,88,-43,29
Livingston,8429,1,22,7,7,77,48,29,73
Brechin,8429,2,21,4,11,54,34,20,67
Alloa,8429,3,17,9,10,69,47,22,60
Airdrieon,8429,4,17,6,13,70,61,9,57
Albion,8429,5,14,6,16,51,52,-1,48
Stranraer,8429,6,13,9,14,56,58,-2,48
Queen's Park,8429,7,13,5,18,30,50,-20,44
East Fife,8429,8,11,7,18,45,46,-1,40
Peterhead,8429,9,10,10,16,47,60,-13,40
Stenhousem'r,8429,10,8,5,23,54,97,-43,29
Livingston,8430,1,20,7,9,76,53,23,67
Alloa,8430,2,16,11,9,62,38,24,59
Brechin,8430,3,16,9,11,50,52,-2,57
Airdrieon,8430,4,16,8,12,59,60,-1,56
Peterhead,8430,5,16,5,15,54,47,7,53
Stranraer,8430,6,14,7,15,57,60,-3,49
Albion,8430,7,12,10,14,54,55,-1,46
Queen's Park,8430,8,11,11,14,45,48,-3,44
East Fife,8430,9,10,7,19,45,57,-12,37
Stenhousem'r,8430,10,7,9,20,48,80,-32,30
Livingston,8431,1,22,5,9,85,50,35,71
Alloa,8431,2,18,10,8,67,46,21,64
Albion,8431,3,17,9,10,55,43,12,60
Peterhead,8431,4,14,7,15,52,62,-10,49
Brechin,8431,5,13,7,16,56,60,-4,46
Stranraer,8431,6,13,6,17,55,65,-10,45
East Fife,8431,7,12,8,16,55,51,4,44
Airdrieon,8431,8,12,8,16,54,64,-10,44
Queen's Park,8431,9,13,4,19,41,59,-18,43
Stenhousem'r,8431,10,10,8,18,55,75,-20,38
Alloa,8432,1,22,7,7,75,42,33,73
Livingston,8432,2,20,5,11,73,53,20,65
East Fife,8432,3,14,11,11,60,47,13,53
Stranraer,8432,4,16,5,15,58,54,4,53
Airdrieon,8432,5,14,10,12,55,55,0,52
Brechin,8432,6,14,6,16,49,47,2,48
Peterhead,8432,7,14,4,18,51,62,-11,46
Albion,8432,8,11,12,13,52,56,-4,45
Queen's Park,8432,9,13,6,17,36,47,-11,45
Stenhousem'r,8432,10,6,6,24,48,94,-46,24
Livingston,8433,1,22,3,11,74,42,32,69
Airdrieon,8433,2,18,11,7,68,51,17,65
Brechin,8433,3,18,10,8,48,40,8,64
Alloa,8433,4,17,10,9,61,41,20,61
Peterhead,8433,5,14,10,12,54,54,0,52
Albion,8433,6,12,8,16,54,59,-5,44
Queen's Park,8433,7,12,6,18,37,54,-17,42
East Fife,8433,8,9,12,15,46,46,0,39
Stranraer,8433,9,12,1,23,50,65,-15,37
Stenhousem'r,8433,10,6,9,21,42,82,-40,27
Livingston,8434,1,22,7,7,76,38,38,73
Alloa,8434,2,20,8,8,62,37,25,68
Albion,8434,3,16,7,13,59,45,14,55
Brechin,8434,4,17,2,17,46,50,-4,53
Airdrieon,8434,5,14,10,12,62,67,-5,52
East Fife,8434,6,12,10,14,45,40,5,46
Peterhead,8434,7,12,10,14,47,51,-4,46
Queen's Park,8434,8,12,6,18,41,54,-13,42
Stranraer,8434,9,9,11,16,44,53,-9,38
Stenhousem'r,8434,10,7,7,22,37,84,-47,28
Alloa,8435,1,20,10,6,69,34,35,70
Livingston,8435,2,20,5,11,72,55,17,65
Airdrieon,8435,3,19,6,11,61,57,4,63
Brechin,8435,4,14,10,12,55,50,5,52
Peterhead,8435,5,13,11,12,47,49,-2,50
Albion,8435,6,13,8,15,53,52,1,47
Stranraer,8435,7,12,7,17,47,55,-8,43
Queen's Park,8435,8,12,5,19,44,56,-12,41
East Fife,8435,9,9,11,16,49,53,-4,38
Stenhousem'r,8435,10,9,5,22,46,82,-36,32
Alloa,8436,1,18,9,9,69,45,24,63
Brechin,8436,2,19,5,12,50,40,10,62
Livingston,8436,3,18,3,15,61,50,11,57
Peterhead,8436,4,14,9,13,51,52,-1,51
Airdrieon,8436,5,14,9,13,55,59,-4,51
Albion,8436,6,14,8,14,63,53,10,50
Stranraer,8436,7,14,6,16,54,56,-2,48
Queen's Park,8436,8,11,12,13,34,43,-9,45
Stenhousem'r,8436,9,9,11,16,55,81,-26,38
East Fife,8436,10,8,10,18,48,61,-13,34
Livingston,8437,1,24,6,6,89,42,47,78
Alloa,8437,2,21,7,8,75,42,33,70
Brechin,8437,3,15,7,14,49,46,3,52
Airdrieon,8437,4,14,10,12,52,52,0,52
Peterhead,8437,5,14,7,15,47,52,-5,49
Queen's Park,8437,6,12,8,16,39,49,-10,44
Stranraer,8437,7,12,8,16,57,69,-12,44
Albion,8437,8,12,7,17,52,59,-7,43
East Fife,8437,9,9,11,16,38,51,-13,38
Stenhousem'r,8437,10,6,11,19,39,75,-36,29
Livingston,8438,1,22,6,8,83,53,30,72
Alloa,8438,2,18,8,10,71,45,26,62
Albion,8438,3,17,6,13,53,49,4,57
Airdrieon,8438,4,17,5,14,63,66,-3,56
Brechin,8438,5,15,8,13,48,47,1,53
East Fife,8438,6,14,10,12,52,41,11,52
Peterhead,8438,7,13,5,18,45,53,-8,44
Stranraer,8438,8,12,3,21,54,64,-10,39
Queen's Park,8438,9,9,10,17,32,51,-19,37
Stenhousem'r,8438,10,8,9,19,44,76,-32,33
Alloa,8439,1,20,6,10,69,46,23,66
Brechin,8439,2,18,7,11,64,51,13,61
Livingston,8439,3,18,6,12,62,45,17,60
Airdrieon,8439,4,13,11,12,51,54,-3,50
Albion,8439,5,14,6,16,53,56,-3,48
Queen's Park,8439,6,14,6,16,51,60,-9,48
East Fife,8439,7,13,7,16,50,54,-4,46
Stranraer,8439,8,12,8,16,53,56,-3,44
Peterhead,8439,9,11,8,17,51,61,-10,41
Stenhousem'r,8439,10,11,7,18,53,74,-21,40
Livingston,8440,1,24,6,6,84,38,46,78
Airdrieon,8440,2,19,7,10,66,48,18,64
Alloa,8440,3,17,7,12,71,52,19,58
Peterhead,8440,4,16,7,13,51,53,-2,55
Albion,8440,5,14,10,12,55,53,2,52
Brechin,8440,6,13,6,17,44,58,-14,45
Stranraer,8440,7,12,7,17,54,57,-3,43
Queen's Park,8440,8,12,7,17,45,65,-20,43
East Fife,8440,9,11,8,17,51,54,-3,41
Stenhousem'r,8440,10,7,5,24,41,84,-43,26
Airdrieon,8441,1,21,6,9,52,41,11,69
Livingston,8441,2,19,6,11,75,48,27,63
Albion,8441,3,19,6,11,65,41,24,63
Alloa,8441,4,18,8,10,57,41,16,62
Brechin,8441,5,14,9,13,47,50,-3,51
Peterhead,8441,6,14,7,15,59,56,3,49
Queen's Park,8441,7,14,6,16,39,51,-12,48
Stranraer,8441,8,13,2,21,49,60,-11,41
East Fife,8441,9,12,5,19,48,62,-14,41
Stenhousem'r,8441,10,6,5,25,44,85,-41,23
Livingston,8442,1,22,4,10,82,50,32,70
Alloa,8442,2,18,10,8,72,42,30,64
Airdrieon,8442,3,19,5,12,67,57,10,62
Albion,8442,4,15,8,13,50,49,1,53
Brechin,8442,5,15,6,15,56,50,6,51
Peterhead,8442,6,11,10,15,46,57,-11,43
Stranraer,8442,7,11,8,17,54,69,-15,41
Queen's Park,8442,8,10,11,15,34,50,-16,41
East Fife,8442,9,9,11,16,45,56,-11,38
Stenhousem'r,8442,10,10,7,19,46,72,-26,37
Alloa,8443,1,26,4,6,84,38,46,82
Livingston,8443,2,21,4,11,82,51,31,67
Albion,8443,3,17,7,12,56,52,4,58
Stranraer,8443,4,15,7,14,58,52,6,52
Queen's Park,8443,5,14,6,16,41,46,-5,48
Brechin,8443,6,13,9,14,44,50,-6,48
Peterhead,8443,7,13,6,17,42,60,-18,45
Airdrieon,8443,8,11,10,15,49,63,-14,43
East Fife,8443,9,8,7,21,42,57,-15,31
Stenhousem'r,8443,10,7,10,19,48,77,-29,31
Alloa,8444,1,20,6,10,71,46,25,66
Livingston,8444,2,21,2,13,74,45,29,65
Brechin,8444,3,17,6,13,51,49,2,57
Airdrieon,8444,4,16,6,14,53,54,-1,54
Albion,8444,5,15,8,13,52,49,3,53
Peterhead,8444,6,15,7,14,42,44,-2,52
Queen's Park,8444,7,14,4,18,45,49,-4,46
Stranraer,8444,8,12,10,14,52,57,-5,46
East Fife,8444,9,13,6,17,54,47,7,45
Stenhousem'r,8444,10,6,7,23,44,98,-54,25
Livingston,8445,1,21,4,11,76,41,35,67
Alloa,8445,2,20,7,9,77,44,33,67
Stranraer,8445,3,16,5,15,56,54,2,53
Brechin,8445,4,16,3,17,51,55,-4,51
Airdrieon,8445,5,13,11,12,52,50,2,50
East Fife,8445,6,13,10,13,55,47,8,49
Peterhead,8445,7,13,9,14,50,51,-1,48
Queen's Park,8445,8,12,8,16,35,56,-21,44
Albion,8445,9,10,11,15,38,55,-17,41
Stenhousem'r,8445,10,8,8,20,41,78,-37,32
Alloa,8446,1,22,9,5,88,40,48,75
Livingston,8446,2,21,3,12,72,46,26,66
Airdrieon,8446,3,16,8,12,63,58,5,56
Albion,8446,4,15,10,11,49,49,0,55
East Fife,8446,5,14,10,12,41,39,2,52
Queen's Park,8446,6,16,3,17,43,51,-8,51
Brechin,8446,7,13,8,15,44,53,-9,47
Stranraer,8446,8,12,6,18,45,54,-9,42
Peterhead,8446,9,11,5,20,39,53,-14,38
Stenhousem'r,8446,10,7,4,25,42,83,-41,25
Alloa,8447,1,19,10,7,74,44,30,67
Airdrieon,8447,2,20,5,11,59,47,12,65
Livingston,8447,3,20,4,12,71,46,25,64
Brechin,8447,4,17,7,12,59,46,13,58
Albion,8447,5,14,8,14,51,50,1,50
Peterhead,8447,6,14,8,14,53,57,-4,50
Queen's Park,8447,7,12,8,16,37,60,-23,44
East Fife,8447,8,10,11,15,48,52,-4,41
Stranraer,8447,9,10,9,17,52,59,-7,39
Stenhousem'r,8447,10,7,4,25,45,88,-43,25
Brechin,8448,1,20,6,10,55,35,20,66
Livingston,8448,2,19,6,11,72,56,16,63
Alloa,8448,3,18,7,11,65,42,23,61
Airdrieon,8448,4,18,6,12,65,52,13,60
Peterhead,8448,5,15,5,16,49,57,-8,50
Albion,8448,6,14,5,17,55,57,-2,47
Stranraer,8448,7,14,5,17,57,63,-6,47
Queen's Park,8448,8,13,6,17,39,56,-17,45
East Fife,8448,9,11,10,15,45,48,-3,43
Stenhousem'r,8448,10,6,8,22,39,75,-36,26
Livingston,8449,1,23,6,7,72,38,34,75
Alloa,8449,2,18,8,10,59,38,21,62
Airdrieon,8449,3,15,9,12,62,56,6,54
Brechin,8449,4,15,7,14,53,49,4,52
Albion,8449,5,14,10,12,57,54,3,52
Peterhead,8449,6,12,12,12,44,53,-9,48
Stranraer,8449,7,13,6,17,52,55,-3,45
East Fife,8449,8,13,5,18,51,52,-1,44
Queen's Park,8449,9,11,3,22,33,58,-25,36
Stenhousem'r,8449,10,10,6,20,50,80,-30,36
Livingston,8450,1,24,5,7,88,44,44,77
Airdrieon,8450,2,19,7,10,53,52,1,64
Alloa,8450,3,18,9,9,71,40,31,63
Brechin,8450,4,15,9,12,55,44,11,54
Albion,8450,5,12,11,13,59,61,-2,47
Peterhead,8450,6,12,8,16,42,57,-15,44
East Fife,8450,7,11,10,15,59,53,6,43
Queen's Park,8450,8,9,12,15,35,57,-22,39
Stranraer,8450,9,10,6,20,45,58,-13,36
Stenhousem'r,8450,10,8,7,21,45,86,-41,31
Livingston,8451,1,21,6,9,76,45,31,69
Alloa,8451,2,20,8,8,68,39,29,68
Albion,8451,3,17,8,11,57,43,14,59
Brechin,8451,4,15,9,12,55,57,-2,54
Airdrieon,8451,5,15,7,14,57,59,-2,52
Peterhead,8451,6,12,12,12,52,54,-2,48
East Fife,8451,7,13,8,15,55,54,1,47
Stranraer,8451,8,12,9,15,58,52,6,45
Stenhousem'r,8451,9,10,5,21,46,79,-33,35
Queen's Park,8451,10,7,4,25,32,74,-42,25
Livingston,8452,1,22,5,9,76,42,34,71
Albion,8452,2,19,7,10,60,45,15,64
Airdrieon,8452,3,17,7,12,53,54,-1,58
Alloa,8452,4,14,11,11,60,45,15,53
Brechin,8452,5,15,6,15,55,52,3,51
Peterhead,8452,6,14,8,14,57,51,6,50
Stranraer,8452,7,13,6,17,51,56,-5,45
East Fife,8452,8,11,9,16,45,52,-7,42
Queen's Park,8452,9,10,9,17,28,52,-24,39
Stenhousem'r,8452,10,7,8,21,45,81,-36,29
Livingston,8453,1,21,3,12,68,54,14,66
Alloa,8453,2,19,7,10,70,48,22,64
East Fife,8453,3,16,10,10,62,40,22,58
Albion,8453,4,17,6,13,60,55,5,57
Peterhead,8453,5,15,8,13,58,46,12,53
Brechin,8453,6,16,4,16,47,55,-8,52
Airdrieon,8453,7,12,10,14,51,55,-4,46
Stranraer,8453,8,10,10,16,43,54,-11,40
Queen's Park,8453,9,9,7,20,31,56,-25,34
Stenhousem'r,8453,10,9,7,20,53,80,-27,34
Livingston,8454,1,20,5,11,75,51,24,65
Airdrieon,8454,2,18,6,12,62,57,5,60
Alloa,8454,3,17,8,11,68,43,25,59
Brechin,8454,4,17,6,13,55,47,8,57
East Fife,8454,5,13,12,11,55,47,8,51
Albion,8454,6,14,7,15,56,62,-6,49
Queen's Park,8454,7,12,8,16,36,47,-11,44
Stranraer,8454,8,13,5,18,40,54,-14,44
Peterhead,8454,9,10,8,18,40,53,-13,38
Stenhousem'r,8454,10,7,13,16,47,73,-26,34
Livingston,8455,1,22,2,12,85,54,31,68
Alloa,8455,2,16,8,12,62,52,10,56
Peterhead,8455,3,16,8,12,49,47,2,56
Brechin,8455,4,15,8,13,48,46,2,53
Stranraer,8455,5,15,7,14,52,52,0,52
Airdrieon,8455,6,16,4,16,53,55,-2,52
Queen's Park,8455,7,15,5,16,48,49,-1,50
Albion,8455,8,13,8,15,56,53,3,47
East Fife,8455,9,11,12,13,46,43,3,45
Stenhousem'r,8455,10,6,8,22,51,99,-48,26
Brechin,8456,1,22,6,8,62,35,27,72
Airdrieon,8456,2,18,5,13,56,55,1,59
Livingston,8456,3,17,6,13,68,56,12,57
Alloa,8456,4,15,9,12,61,47,14,54
Stranraer,8456,5,14,7,15,62,55,7,49
Albion,8456,6,12,12,12,49,49,0,48
Queen's Park,8456,7,13,9,14,39,45,-6,48
Stenhousem'r,8456,8,11,9,16,50,72,-22,42
Peterhead,8456,9,9,10,17,45,64,-19,37
East Fife,8456,10,8,9,19,40,54,-14,33
Livingston,8457,1,23,5,8,71,35,36,74
Alloa,8457,2,22,7,7,74,38,36,73
Airdrieon,8457,3,18,11,7,56,38,18,65
Brechin,8457,4,14,9,13,49,50,-1,51
Peterhead,8457,5,14,5,17,50,56,-6,47
Queen's Park,8457,6,13,6,17,35,47,-12,45
Albion,8457,7,11,10,15,54,62,-8,43
East Fife,8457,8,9,14,13,54,51,3,41
Stranraer,8457,9,9,6,21,40,61,-21,33
Stenhousem'r,8457,10,7,7,22,41,86,-45,28
Brechin,8458,1,18,8,10,60,46,14,62
Livingston,8458,2,17,7,12,66,60,6,58
Queen's Park,8458,3,16,8,12,48,49,-1,56
Alloa,8458,4,15,10,11,69,47,22,55
Peterhead,8458,5,15,10,11,56,48,8,55
Airdrieon,8458,6,14,11,11,49,49,0,53
East Fife,8458,7,13,10,13,47,46,1,49
Albion,8458,8,13,6,17,53,55,-2,45
Stranraer,8458,9,10,6,20,49,61,-12,36
Stenhousem'r,8458,10,6,10,20,44,80,-36,28
Alloa,8459,1,16,13,7,66,43,23,61
Livingston,8459,2,16,12,8,73,57,16,60
Airdrieon,8459,3,16,10,10,62,49,13,58
Brechin,8459,4,17,6,13,52,47,5,57
Albion,8459,5,15,11,10,63,51,12,56
Stranraer,8459,6,14,4,18,57,63,-6,46
Queen's Park,8459,7,12,7,17,37,54,-17,43
Stenhousem'r,8459,8,10,10,16,49,69,-20,40
East Fife,8459,9,10,8,18,55,68,-13,38
Peterhead,8459,10,9,9,18,45,58,-13,36
Brechin,8460,1,20,5,11,57,47,10,65
Livingston,8460,2,20,4,12,71,57,14,64
Airdrieon,8460,3,17,3,16,66,58,8,54
Albion,8460,4,15,8,13,62,57,5,53
Alloa,8460,5,15,7,14,62,54,8,52
Peterhead,8460,6,14,9,13,63,58,5,51
East Fife,8460,7,14,7,15,55,54,1,49
Queen's Park,8460,8,13,10,13,46,50,-4,49
Stranraer,8460,9,11,6,19,46,57,-11,39
Stenhousem'r,8460,10,7,9,20,52,88,-36,30
Livingston,8461,1,22,4,10,80,49,31,70
Alloa,8461,2,18,6,12,73,45,28,60
Albion,8461,3,17,8,11,53,37,16,59
Airdrieon,8461,4,15,9,12,44,51,-7,54
East Fife,8461,5,13,11,12,55,43,12,50
Brechin,8461,6,14,6,16,37,47,-10,48
Peterhead,8461,7,12,9,15,46,56,-10,45
Queen's Park,8461,8,13,5,18,43,61,-18,44
Stranraer,8461,9,11,6,19,50,59,-9,39
Stenhousem'r,8461,10,9,8,19,41,74,-33,35
Alloa,8462,1,21,6,9,81,48,33,69
Livingston,8462,2,20,6,10,72,47,25,66
Brechin,8462,3,18,8,10,58,48,10,62
Airdrieon,8462,4,16,7,13,58,56,2,55
Albion,8462,5,14,8,14,53,53,0,50
Peterhead,8462,6,12,10,14,47,53,-6,46
East Fife,8462,7,11,12,13,54,49,5,45
Stranraer,8462,8,11,7,18,52,64,-12,40
Queen's Park,8462,9,10,9,17,34,54,-20,39
Stenhousem'r,8462,10,6,9,21,42,79,-37,27
Alloa,8463,1,23,6,7,68,32,36,75
Livingston,8463,2,22,5,9,70,45,25,71
Brechin,8463,3,17,7,12,49,44,5,58
Albion,8463,4,16,5,15,50,55,-5,53
Peterhead,8463,5,14,8,14,44,45,-1,50
East Fife,8463,6,13,7,16,52,47,5,46
Queen's Park,8463,7,13,7,16,37,54,-17,46
Airdrieon,8463,8,12,8,16,53,56,-3,44
Stranraer,8463,9,10,7,19,51,64,-13,37
Stenhousem'r,8463,10,6,8,22,45,77,-32,26
Livingston,8464,1,22,5,9,73,45,28,71
Brechin,8464,2,19,5,12,56,39,17,62
Alloa,8464,3,18,7,11,60,46,14,61
Airdrieon,8464,4,14,11,11,48,46,2,53
Stranraer,8464,5,15,5,16,61,70,-9,50
Albion,8464,6,14,6,16,49,46,3,48
Peterhead,8464,7,13,7,16,48,56,-8,46
East Fife,8464,8,10,12,14,55,53,2,42
Queen's Park,8464,9,11,6,19,36,53,-17,39
Stenhousem'r,8464,10,7,10,19,50,82,-32,31
Alloa,8465,1,20,7,9,70,40,30,67
Livingston,8465,2,21,1,14,83,57,26,64
Brechin,8465,3,18,6,12,55,48,7,60
Stranraer,8465,4,17,5,14,55,49,6,56
Albion,8465,5,15,10,11,54,46,8,55
Peterhead,8465,6,14,10,12,53,51,2,52
Airdrieon,8465,7,12,8,16,51,59,-8,44
Queen's Park,8465,8,12,6,18,35,58,-23,42
East Fife,8465,9,7,12,17,49,57,-8,33
Stenhousem'r,8465,10,7,9,20,45,85,-40,30
Livingston,8466,1,22,4,10,81,46,35,70
Alloa,8466,2,21,7,8,68,43,25,70
Airdrieon,8466,3,20,8,8,72,47,25,68
Brechin,8466,4,14,7,15,43,55,-12,49
Albion,8466,5,13,9,14,51,55,-4,48
East Fife,8466,6,12,11,13,52,50,2,47
Peterhead,8466,7,10,12,14,47,59,-12,42
Queen's Park,8466,8,11,8,17,39,57,-18,41
Stranraer,8466,9,9,11,16,45,51,-6,38
Stenhousem'r,8466,10,6,7,23,46,81,-35,25
Livingston,8467,1,21,4,11,73,49,24,67
Alloa,8467,2,18,7,11,71,44,27,61
Airdrieon,8467,3,17,9,10,54,46,8,60
Albion,8467,4,14,9,13,57,55,2,51
Brechin,8467,5,14,7,15,44,51,-7,49
East Fife,8467,6,12,12,12,49,41,8,48
Queen's Park,8467,7,13,9,14,43,47,-4,48
Peterhead,8467,8,13,8,15,47,52,-5,47
Stranraer,8467,9,10,6,20,54,71,-17,36
Stenhousem'r,8467,10,8,9,19,46,82,-36,33
Livingston,8468,1,21,7,8,84,51,33,70
Alloa,8468,2,17,9,10,70,41,29,60
Airdrieon,8468,3,17,8,11,68,54,14,59
Albion,8468,4,15,7,14,57,55,2,52
Brechin,8468,5,16,4,16,48,58,-10,52
East Fife,8468,6,15,6,15,51,44,7,51
Queen's Park,8468,7,15,5,16,42,55,-13,50
Peterhead,8468,8,11,10,15,47,57,-10,43
Stranraer,8468,9,10,6,20,46,67,-21,36
Stenhousem'r,8468,10,8,8,20,49,80,-31,32
Livingston,8469,1,19,7,10,81,55,26,64
Alloa,8469,2,18,8,10,67,44,23,62
Airdrieon,8469,3,17,7,12,58,60,-2,58
Queen's Park,8469,4,16,5,15,37,50,-13,53
Albion,8469,5,14,10,12,56,46,10,52
East Fife,8469,6,13,11,12,49,40,9,50
Brechin,8469,7,14,7,15,49,55,-6,49
Stranraer,8469,8,11,7,18,51,57,-6,40
Peterhead,8469,9,9,11,16,36,53,-17,38
Stenhousem'r,8469,10,8,9,19,46,70,-24,33
Livingston,8470,1,19,5,12,77,49,28,62
Alloa,8470,2,18,7,11,78,51,27,61
Brechin,8470,3,15,6,15,54,58,-4,51
Peterhead,8470,4,14,8,14,54,55,-1,50
Airdrieon,8470,5,13,11,12,48,51,-3,50
Stranraer,8470,6,14,7,15,60,61,-1,49
East Fife,8470,7,14,7,15,55,60,-5,49
Albion,8470,8,13,9,14,64,64,0,48
Queen's Park,8470,9,11,11,14,39,53,-14,44
Stenhousem'r,8470,10,10,7,19,59,86,-27,37
Livingston,8471,1,21,6,9,77,55,22,69
Brechin,8471,2,18,10,8,54,37,17,64
Alloa,8471,3,16,13,7,63,42,21,61
Queen's Park,8471,4,16,7,13,37,37,0,55
Airdrieon,8471,5,17,4,15,45,47,-2,55
Peterhead,8471,6,14,9,13,47,48,-1,51
Albion,8471,7,11,9,16,52,50,2,42
East Fife,8471,8,9,11,16,46,55,-9,38
Stranraer,8471,9,8,7,21,40,62,-22,31
Stenhousem'r,8471,10,7,10,19,46,74,-28,31
Livingston,8472,1,17,8,11,85,57,28,59
Brechin,8472,2,17,8,11,55,49,6,59
Alloa,8472,3,16,9,11,59,39,20,57
Albion,8472,4,14,10,12,50,52,-2,52
Airdrieon,8472,5,12,12,12,53,56,-3,48
Stranraer,8472,6,14,6,16,50,54,-4,48
Queen's Park,8472,7,14,5,17,35,59,-24,47
East Fife,8472,8,12,9,15,53,42,11,45
Stenhousem'r,8472,9,12,8,16,49,68,-19,44
Peterhead,8472,10,11,7,18,37,50,-13,40
Livingston,8473,1,20,4,12,76,54,22,64
Brechin,8473,2,18,6,12,57,53,4,60
Airdrieon,8473,3,17,6,13,72,62,10,57
Albion,8473,4,15,11,10,59,50,9,56
Alloa,8473,5,15,7,14,66,50,16,52
Queen's Park,8473,6,13,10,13,45,50,-5,49
East Fife,8473,7,14,5,17,51,52,-1,47
Peterhead,8473,8,12,7,17,46,67,-21,43
Stranraer,8473,9,12,6,18,51,64,-13,42
Stenhousem'r,8473,10,11,4,21,53,74,-21,37
Livingston,8474,1,21,4,11,69,44,25,67
Albion,8474,2,18,9,9,62,45,17,63
Alloa,8474,3,18,6,12,69,47,22,60
Airdrieon,8474,4,17,5,14,62,56,6,56
Brechin,8474,5,17,3,16,57,58,-1,54
Peterhead,8474,6,12,10,14,51,54,-3,46
East Fife,8474,7,11,12,13,49,47,2,45
Queen's Park,8474,8,12,8,16,31,52,-21,44
Stranraer,8474,9,9,11,16,43,54,-11,38
Stenhousem'r,8474,10,7,8,21,44,80,-36,29
Livingston,8475,1,19,5,12,72,62,10,62
Albion,8475,2,17,8,11,58,47,11,59
Airdrieon,8475,3,18,5,13,59,53,6,59
Alloa,8475,4,17,6,13,63,45,18,57
Brechin,8475,5,13,11,12,50,46,4,50
Peterhead,8475,6,14,8,14,45,46,-1,50
East Fife,8475,7,13,10,13,59,54,5,49
Stranraer,8475,8,11,8,17,52,59,-7,41
Stenhousem'r,8475,9,9,11,16,50,74,-24,38
Queen's Park,8475,10,9,8,19,34,56,-22,35
Brechin,8476,1,20,6,10,58,45,13,66
Livingston,8476,2,19,7,10,75,45,30,64
Airdrieon,8476,3,18,8,10,67,54,13,62
Alloa,8476,4,16,9,11,66,52,14,57
Stranraer,8476,5,14,6,16,59,58,1,48
Queen's Park,8476,6,13,8,15,36,51,-15,47
Peterhead,8476,7,13,6,17,44,60,-16,45
East Fife,8476,8,11,10,15,51,49,2,43
Albion,8476,9,11,10,15,46,55,-9,43
Stenhousem'r,8476,10,7,6,23,50,83,-33,27
Livingston,8477,1,19,2,15,76,58,18,59
Peterhead,8477,2,17,6,13,48,37,11,57
Queen's Park,8477,3,18,3,15,42,49,-7,57
Alloa,8477,4,16,7,13,64,47,17,55
East Fife,8477,5,15,8,13,52,40,12,53
Stranraer,8477,6,15,6,15,48,47,1,51
Brechin,8477,7,15,5,16,42,48,-6,50
Airdrieon,8477,8,14,7,15,53,61,-8,49
Albion,8477,9,13,9,14,49,49,0,48
Stenhousem'r,8477,10,7,9,20,41,79,-38,30
Alloa,8478,1,17,8,11,71,45,26,59
Livingston,8478,2,17,8,11,74,54,20,59
Albion,8478,3,16,9,11,56,50,6,57
Airdrieon,8478,4,16,9,11,67,62,5,57
Brechin,8478,5,16,9,11,56,52,4,57
Stranraer,8478,6,15,7,14,53,52,1,52
Queen's Park,8478,7,13,10,13,37,45,-8,49
East Fife,8478,8,9,11,16,49,54,-5,38
Peterhead,8478,9,10,8,18,45,59,-14,38
Stenhousem'r,8478,10,7,9,20,47,82,-35,30
Livingston,8479,1,24,3,9,82,44,38,75
Alloa,8479,2,19,8,9,76,46,30,65
Brechin,8479,3,20,4,12,52,45,7,64
Peterhead,8479,4,18,6,12,56,43,13,60
Albion,8479,5,15,10,11,56,46,10,55
Airdrieon,8479,6,13,8,15,54,62,-8,47
Stranraer,8479,7,12,5,19,47,65,-18,41
Queen's Park,8479,8,10,9,17,30,46,-16,39
East Fife,8479,9,9,11,16,45,47,-2,38
Stenhousem'r,8479,10,4,8,24,38,92,-54,20
Livingston,8480,1,24,4,8,80,39,41,76
Alloa,8480,2,20,5,11,75,50,25,65
Brechin,8480,3,19,5,12,52,40,12,62
Airdrieon,8480,4,16,7,13,63,57,6,55
Queen's Park,8480,5,15,7,14,39,47,-8,52
Albion,8480,6,13,7,16,55,57,-2,46
Peterhead,8480,7,13,7,16,47,60,-13,46
Stranraer,8480,8,12,7,17,52,67,-15,43
East Fife,8480,9,10,9,17,48,55,-7,39
Stenhousem'r,8480,10,5,8,23,42,81,-39,23
Livingston,8481,1,22,5,9,82,45,37,71
Alloa,8481,2,18,9,9,68,43,25,63
Brechin,8481,3,19,6,11,60,45,15,63
Albion,8481,4,16,11,9,57,47,10,59
Airdrieon,8481,5,16,7,13,52,53,-1,55
Peterhead,8481,6,13,7,16,54,64,-10,46
Queen's Park,8481,7,12,7,17,39,51,-12,43
East Fife,8481,8,11,9,16,46,51,-5,42
Stranraer,8481,9,9,7,20,49,68,-19,34
Stenhousem'r,8481,10,5,10,21,43,83,-40,25
Alloa,8482,1,23,6,7,75,31,44,75
Brechin,8482,2,18,7,11,47,42,5,61
Livingston,8482,3,18,6,12,74,50,24,60
Airdrieon,8482,4,17,8,11,70,61,9,59
Peterhead,8482,5,15,8,13,47,40,7,53
Albion,8482,6,13,10,13,49,46,3,49
Queen's Park,8482,7,12,8,16,39,59,-20,44
Stranraer,8482,8,11,4,21,44,64,-20,37
East Fife,8482,9,8,10,18,42,59,-17,34
Stenhousem'r,8482,10,8,7,21,39,74,-35,31
Livingston,8483,1,21,6,9,80,46,34,69
Brechin,8483,2,18,8,10,51,43,8,62
Alloa,8483,3,18,6,12,71,49,22,60
Stranraer,8483,4,17,6,13,62,54,8,57
Airdrieon,8483,5,17,5,14,57,58,-1,56
Queen's Park,8483,6,14,4,18,33,53,-20,46
Peterhead,8483,7,12,8,16,44,56,-12,44
Albion,8483,8,12,6,18,53,62,-9,42
East Fife,8483,9,10,9,17,47,46,1,39
Stenhousem'r,8483,10,8,8,20,47,78,-31,32
Livingston,8484,1,26,4,6,90,46,44,82
Alloa,8484,2,18,6,12,63,45,18,60
Brechin,8484,3,18,5,13,50,45,5,59
Airdrieon,8484,4,16,7,13,60,52,8,55
Albion,8484,5,15,6,15,56,59,-3,51
Queen's Park,8484,6,14,5,17,42,55,-13,47
Peterhead,8484,7,13,7,16,40,51,-11,46
Stranraer,8484,8,13,4,19,46,55,-9,43
East Fife,8484,9,9,11,16,49,56,-7,38
Stenhousem'r,8484,10,8,5,23,48,80,-32,29
Airdrieon,8485,1,20,8,8,62,47,15,68
Livingston,8485,2,19,6,11,75,51,24,63
Alloa,8485,3,19,6,11,68,45,23,63
Brechin,8485,4,15,9,12,54,54,0,54
Peterhead,8485,5,16,5,15,54,58,-4,53
Albion,8485,6,14,8,14,51,53,-2,50
Queen's Park,8485,7,14,4,18,41,53,-12,46
East Fife,8485,8,8,12,16,49,52,-3,36
Stranraer,8485,9,9,8,19,46,67,-21,35
Stenhousem'r,8485,10,8,10,18,53,73,-20,34
Alloa,8486,1,20,9,7,77,42,35,69
Livingston,8486,2,22,3,11,78,52,26,69
Airdrieon,8486,3,15,8,13,56,54,2,53
Stranraer,8486,4,15,7,14,55,51,4,52
Albion,8486,5,13,12,11,49,52,-3,51
Peterhead,8486,6,13,7,16,47,51,-4,46
Brechin,8486,7,12,7,17,46,57,-11,43
Queen's Park,8486,8,11,8,17,29,48,-19,41
East Fife,8486,9,10,9,17,42,48,-6,39
Stenhousem'r,8486,10,9,10,17,47,71,-24,37
Livingston,8487,1,19,7,10,71,52,19,64
Alloa,8487,2,18,9,9,69,38,31,63
Peterhead,8487,3,16,9,11,57,51,6,57
East Fife,8487,4,15,10,11,64,46,18,55
Airdrieon,8487,5,15,10,11,53,52,1,55
Albion,8487,6,14,9,13,55,51,4,51
Brechin,8487,7,15,6,15,52,55,-3,51
Queen's Park,8487,8,10,7,19,36,60,-24,37
Stranraer,8487,9,10,5,21,46,67,-21,35
Stenhousem'r,8487,10,6,12,18,42,73,-31,30
Livingston,8488,1,21,5,10,71,42,29,68
Alloa,8488,2,19,8,9,79,45,34,65
Brechin,8488,3,16,7,13,53,48,5,55
Albion,8488,4,14,11,11,57,47,10,53
Peterhead,8488,5,14,8,14,46,52,-6,50
Airdrieon,8488,6,14,7,15,56,65,-9,49
Queen's Park,8488,7,13,7,16,40,51,-11,46
Stranraer,8488,8,12,7,17,50,62,-12,43
East Fife,8488,9,8,15,13,46,51,-5,39
Stenhousem'r,8488,10,8,7,21,50,85,-35,31
Livingston,8489,1,22,4,10,79,40,39,70
Brechin,8489,2,19,4,13,51,47,4,61
Alloa,8489,3,15,12,9,65,40,25,57
Albion,8489,4,16,8,12,65,51,14,56
Peterhead,8489,5,15,10,11,52,47,5,55
Airdrieon,8489,6,14,10,12,47,46,1,52
East Fife,8489,7,12,9,15,49,45,4,45
Stranraer,8489,8,13,5,18,45,59,-14,44
Queen's Park,8489,9,9,7,20,26,53,-27,34
Stenhousem'r,8489,10,5,11,20,36,87,-51,26
Alloa,8490,1,24,6,6,77,43,34,78
Livingston,8490,2,21,1,14,83,59,24,64
Brechin,8490,3,19,5,12,57,47,10,62
Airdrieon,8490,4,17,4,15,59,57,2,55
Peterhead,8490,5,15,7,14,49,53,-4,52
Queen's Park,8490,6,14,8,14,40,52,-12,50
Albion,8490,7,9,14,13,43,55,-12,41
Stranraer,8490,8,12,3,21,48,55,-7,39
East Fife,8490,9,9,8,19,52,61,-9,35
Stenhousem'r,8490,10,9,6,21,52,78,-26,33
Livingston,8491,1,24,3,9,79,44,35,75
Alloa,8491,2,20,8,8,78,48,30,68
Peterhead,8491,3,17,6,13,54,55,-1,57
Brechin,8491,4,17,5,14,57,51,6,56
Albion,8491,5,14,11,11,59,51,8,53
Stranraer,8491,6,15,6,15,58,59,-1,51
Airdrieon,8491,7,13,4,19,55,73,-18,43
Queen's Park,8491,8,12,6,18,41,53,-12,42
East Fife,8491,9,6,15,15,47,59,-12,33
Stenhousem'r,8491,10,4,12,20,44,79,-35,24
Livingston,8492,1,20,7,9,69,43,26,67
Brechin,8492,2,21,3,12,65,45,20,66
Airdrieon,8492,3,19,4,13,53,53,0,61
Alloa,8492,4,16,10,10,69,47,22,58
Peterhead,8492,5,14,11,11,52,47,5,53
Albion,8492,6,13,6,17,53,61,-8,45
Queen's Park,8492,7,13,6,17,34,47,-13,45
Stranraer,8492,8,13,5,18,58,70,-12,44
East Fife,8492,9,11,8,17,51,56,-5,41
Stenhousem'r,8492,10,7,6,23,46,81,-35,27
Albion,8493,1,18,8,10,66,50,16,62
Airdrieon,8493,2,19,5,12,61,55,6,62
Brechin,8493,3,17,7,12,56,48,8,58
Peterhead,8493,4,16,8,12,56,47,9,56
Livingston,8493,5,16,4,16,68,54,14,52
East Fife,8493,6,13,9,14,52,56,-4,48
Stranraer,8493,7,14,5,17,53,50,3,47
Alloa,8493,8,13,7,16,58,56,2,46
Queen's Park,8493,9,12,6,18,37,57,-20,42
Stenhousem'r,8493,10,9,7,20,41,75,-34,34
Airdrieon,8494,1,22,5,9,71,46,25,71
Livingston,8494,2,19,6,11,78,52,26,63
Alloa,8494,3,16,12,8,69,52,17,60
Albion,8494,4,16,9,11,55,49,6,57
Brechin,8494,5,13,9,14,48,49,-1,48
Peterhead,8494,6,12,9,15,53,56,-3,45
Queen's Park,8494,7,12,9,15,41,49,-8,45
Stranraer,8494,8,12,7,17,55,59,-4,43
East Fife,8494,9,10,13,13,45,51,-6,43
Stenhousem'r,8494,10,6,5,25,43,95,-52,23
Livingston,8495,1,17,10,9,74,50,24,61
Airdrieon,8495,2,18,7,11,60,53,7,61
Alloa,8495,3,16,9,11,61,45,16,57
Brechin,8495,4,15,10,11,54,43,11,55
East Fife,8495,5,14,8,14,50,43,7,50
Albion,8495,6,13,8,15,48,50,-2,47
Stranraer,8495,7,13,7,16,49,53,-4,46
Peterhead,8495,8,12,9,15,44,56,-12,45
Queen's Park,8495,9,12,8,16,40,55,-15,44
Stenhousem'r,8495,10,9,6,21,45,77,-32,33
Livingston,8496,1,22,3,11,76,48,28,69
Alloa,8496,2,18,10,8,64,42,22,64
Airdrieon,8496,3,18,3,15,58,55,3,57
Brechin,8496,4,16,5,15,56,50,6,53
Queen's Park,8496,5,14,9,13,48,49,-1,51
Albion,8496,6,14,9,13,52,55,-3,51
Stenhousem'r,8496,7,12,7,17,49,69,-20,43
Stranraer,8496,8,12,6,18,45,61,-16,42
Peterhead,8496,9,10,10,16,38,54,-16,40
East Fife,8496,10,9,8,19,49,52,-3,35
Alloa,8497,1,19,7,10,69,48,21,64
Livingston,8497,2,18,7,11,71,43,28,61
Airdrieon,8497,3,16,11,9,57,49,8,59
Albion,8497,4,17,5,14,60,49,11,56
East Fife,8497,5,13,11,12,47,40,7,50
Peterhead,8497,6,12,11,13,45,50,-5,47
Queen's Park,8497,7,12,9,15,32,46,-14,45
Brechin,8497,8,12,8,16,54,62,-8,44
Stranraer,8497,9,12,6,18,50,64,-14,42
Stenhousem'r,8497,10,8,7,21,39,73,-34,31
Livingston,8498,1,25,1,10,84,42,42,76
Alloa,8498,2,21,8,7,80,43,37,71
Brechin,8498,3,17,6,13,49,51,-2,57
Airdrieon,8498,4,14,11,11,57,58,-1,53
Albion,8498,5,14,10,12,57,53,4,52
Peterhead,8498,6,13,8,15,54,58,-4,47
Queen's Park,8498,7,14,3,19,39,54,-15,45
Stranraer,8498,8,11,8,17,47,57,-10,41
East Fife,8498,9,8,8,20,42,60,-18,32
Stenhousem'r,8498,10,8,7,21,50,83,-33,31
Alloa,8499,1,20,7,9,67,40,27,67
Livingston,8499,2,20,5,11,80,59,21,65
Airdrieon,8499,3,17,7,12,69,56,13,58
Brechin,8499,4,15,9,12,46,46,0,54
Peterhead,8499,5,14,8,14,42,53,-11,50
Albion,8499,6,13,9,14,56,50,6,48
Stranraer,8499,7,14,4,18,49,59,-10,46
Queen's Park,8499,8,12,8,16,38,48,-10,44
East Fife,8499,9,11,9,16,43,50,-7,42
Stenhousem'r,8499,10,5,12,19,50,79,-29,27
Alloa,8500,1,23,6,7,79,33,46,75
Livingston,8500,2,21,8,7,77,37,40,71
Brechin,8500,3,19,5,12,55,45,10,62
Albion,8500,4,14,9,13,50,51,-1,51
Peterhead,8500,5,14,7,15,51,55,-4,49
Airdrieon,8500,6,14,7,15,59,67,-8,49
Stenhousem'r,8500,7,12,6,18,55,80,-25,42
Queen's Park,8500,8,11,5,20,33,54,-21,38
East Fife,8500,9,9,8,19,45,58,-13,35
Stranraer,8500,10,10,5,21,47,71,-24,35
Livingston,8501,1,25,4,7,83,41,42,79
Alloa,8501,2,20,8,8,71,41,30,68
Albion,8501,3,19,5,12,56,45,11,62
Airdrieon,8501,4,18,6,12,61,57,4,60
Queen's Park,8501,5,15,5,16,43,44,-1,50
Brechin,8501,6,14,6,16,51,55,-4,48
Peterhead,8501,7,11,10,15,47,54,-7,43
East Fife,8501,8,9,9,18,45,56,-11,36
Stranraer,8501,9,8,10,18,43,60,-17,34
Stenhousem'r,8501,10,5,9,22,40,87,-47,24
Livingston,8502,1,21,5,10,68,41,27,68
Alloa,8502,2,19,10,7,75,43,32,67
Airdrieon,8502,3,17,8,11,66,52,14,59
Brechin,8502,4,15,7,14,42,51,-9,52
Albion,8502,5,14,9,13,50,50,0,51
East Fife,8502,6,13,10,13,53,49,4,49
Stranraer,8502,7,13,6,17,62,65,-3,45
Peterhead,8502,8,11,12,13,43,48,-5,45
Queen's Park,8502,9,8,10,18,39,63,-24,34
Stenhousem'r,8502,10,6,9,21,54,90,-36,27
Livingston,8503,1,24,5,7,83,40,43,77
Alloa,8503,2,16,8,12,61,44,17,56
Airdrieon,8503,3,16,7,13,48,49,-1,55
Albion,8503,4,14,12,10,59,49,10,54
Peterhead,8503,5,11,15,10,48,50,-2,48
Brechin,8503,6,14,6,16,53,56,-3,48
East Fife,8503,7,12,10,14,45,48,-3,46
Stranraer,8503,8,10,8,18,43,59,-16,38
Stenhousem'r,8503,9,10,7,19,42,67,-25,37
Queen's Park,8503,10,8,12,16,34,54,-20,36
Livingston,8504,1,22,4,10,80,46,34,70
Alloa,8504,2,20,5,11,66,39,27,65
Brechin,8504,3,19,6,11,66,46,20,63
Airdrieon,8504,4,15,9,12,57,53,4,54
East Fife,8504,5,13,10,13,50,44,6,49
Albion,8504,6,13,7,16,53,58,-5,46
Peterhead,8504,7,13,6,17,42,54,-12,45
Stenhousem'r,8504,8,10,12,14,47,69,-22,42
Queen's Park,8504,9,10,6,20,28,56,-28,36
Stranraer,8504,10,10,5,21,42,66,-24,35
Brechin,8505,1,16,10,10,50,37,13,58
Airdrieon,8505,2,18,4,14,60,55,5,58
Livingston,8505,3,18,2,16,75,53,22,56
Alloa,8505,4,16,8,12,68,49,19,56
Albion,8505,5,16,8,12,55,56,-1,56
Peterhead,8505,6,15,6,15,47,51,-4,51
Stranraer,8505,7,14,6,16,47,54,-7,48
Queen's Park,8505,8,14,6,16,45,56,-11,48
East Fife,8505,9,10,10,16,43,50,-7,40
Stenhousem'r,8505,10,9,8,19,50,79,-29,35
Alloa,8506,1,21,7,8,81,41,40,70
Airdrieon,8506,2,22,4,10,65,39,26,70
Livingston,8506,3,19,9,8,74,52,22,66
Brechin,8506,4,16,3,17,41,47,-6,51
Albion,8506,5,12,9,15,46,54,-8,45
Queen's Park,8506,6,12,7,17,34,46,-12,43
Peterhead,8506,7,11,9,16,42,54,-12,42
Stranraer,8506,8,12,5,19,48,61,-13,41
Stenhousem'r,8506,9,11,7,18,44,69,-25,40
East Fife,8506,10,9,10,17,41,53,-12,37
Alloa,8507,1,19,8,9,78,51,27,65
Livingston,8507,2,18,6,12,79,54,25,60
Brechin,8507,3,18,6,12,61,49,12,60
Airdrieon,8507,4,18,6,12,62,53,9,60
Albion,8507,5,17,7,12,57,49,8,58
Peterhead,8507,6,15,7,14,50,51,-1,52
Stranraer,8507,7,14,4,18,50,61,-11,46
Queen's Park,8507,8,12,7,17,37,53,-16,43
East Fife,8507,9,6,13,17,40,57,-17,31
Stenhousem'r,8507,10,8,6,22,43,79,-36,30
Livingston,8508,1,21,4,11,72,48,24,67
Alloa,8508,2,18,7,11,74,51,23,61
Brechin,8508,3,19,3,14,56,49,7,60
Airdrieon,8508,4,17,7,12,51,45,6,58
Albion,8508,5,14,9,13,47,51,-4,51
Peterhead,8508,6,13,7,16,52,56,-4,46
East Fife,8508,7,13,7,16,46,51,-5,46
Stranraer,8508,8,13,5,18,57,59,-2,44
Queen's Park,8508,9,10,10,16,34,54,-20,40
Stenhousem'r,8508,10,10,5,21,43,68,-25,35
Alloa,8509,1,20,9,7,74,36,38,69
Livingston,8509,2,18,5,13,70,51,19,59
Brechin,8509,3,14,10,12,49,53,-4,52
Albion,8509,4,13,12,11,50,53,-3,51
Queen's Park,8509,5,13,11,12,34,44,-10,50
Airdrieon,8509,6,14,7,15,49,53,-4,49
East Fife,8509,7,11,15,10,54,44,10,48
Stranraer,8509,8,14,3,19,54,57,-3,45
Peterhead,8509,9,9,10,17,36,53,-17,37
Stenhousem'r,8509,10,7,12,17,42,68,-26,33
Alloa,8510,1,19,7,10,69,43,26,64
Brechin,8510,2,19,7,10,57,48,9,64
Livingston,8510,3,19,5,12,72,53,19,62
Airdrieon,8510,4,15,12,9,61,56,5,57
East Fife,8510,5,16,6,14,57,45,12,54
Peterhead,8510,6,14,7,15,48,48,0,49
Stranraer,8510,7,12,8,16,48,59,-11,44
Albion,8510,8,11,7,18,48,57,-9,40
Queen's Park,8510,9,11,7,18,31,51,-20,40
Stenhousem'r,8510,10,7,8,21,51,82,-31,29
Alloa,8511,1,19,11,6,68,41,27,68
Brechin,8511,2,21,5,10,60,40,20,68
Livingston,8511,3,18,7,11,67,54,13,61
Airdrieon,8511,4,18,4,14,62,62,0,58
Queen's Park,8511,5,14,7,15,43,55,-12,49
Albion,8511,6,12,12,12,49,54,-5,48
Peterhead,8511,7,14,5,17,53,55,-2,47
East Fife,8511,8,10,7,19,52,57,-5,37
Stranraer,8511,9,10,5,21,42,59,-17,35
Stenhousem'r,8511,10,8,9,19,48,67,-19,33
Alloa,8512,1,21,7,8,75,42,33,70
Livingston,8512,2,21,5,10,76,45,31,68
Airdrieon,8512,3,15,10,11,56,53,3,55
Brechin,8512,4,16,7,13,48,49,-1,55
Peterhead,8512,5,15,6,15,52,56,-4,51
East Fife,8512,6,13,9,14,47,45,2,48
Stranraer,8512,7,13,6,17,54,56,-2,45
Albion,8512,8,10,12,14,39,47,-8,42
Queen's Park,8512,9,9,8,19,32,55,-23,35
Stenhousem'r,8512,10,8,8,20,48,79,-31,32
Livingston,8513,1,21,6,9,89,54,35,69
Brechin,8513,2,19,5,12,60,43,17,62
Albion,8513,3,18,8,10,59,50,9,62
Alloa,8513,4,17,8,11,72,58,14,59
Airdrieon,8513,5,14,7,15,61,62,-1,49
East Fife,8513,6,14,5,17,58,53,5,47
Stranraer,8513,7,12,7,17,57,64,-7,43
Peterhead,8513,8,11,8,17,53,68,-15,41
Queen's Park,8513,9,10,9,17,42,65,-23,39
Stenhousem'r,8513,10,9,7,20,47,81,-34,34
Alloa,8514,1,22,8,6,79,43,36,74
Livingston,8514,2,23,1,12,79,47,32,70
Airdrieon,8514,3,17,8,11,69,55,14,59
East Fife,8514,4,16,6,14,55,50,5,54
Peterhead,8514,5,13,7,16,48,56,-8,46
Albion,8514,6,11,11,14,47,56,-9,44
Brechin,8514,7,12,7,17,41,51,-10,43
Stranraer,8514,8,12,6,18,47,66,-19,42
Queen's Park,8514,9,11,7,18,40,53,-13,40
Stenhousem'r,8514,10,7,11,18,46,74,-28,32
Alloa,8515,1,21,7,8,73,45,28,70
Livingston,8515,2,19,5,12,68,41,27,62
Airdrieon,8515,3,19,4,13,63,54,9,61
Brechin,8515,4,17,5,14,62,54,8,56
Albion,8515,5,16,6,14,51,51,0,54
Peterhead,8515,6,16,6,14,58,60,-2,54
East Fife,8515,7,12,7,17,53,54,-1,43
Stenhousem'r,8515,8,10,9,17,53,73,-20,39
Stranraer,8515,9,11,4,21,53,72,-19,37
Queen's Park,8515,10,9,7,20,40,70,-30,34
Livingston,8516,1,22,3,11,72,46,26,69
Alloa,8516,2,18,8,10,65,43,22,62
Brechin,8516,3,18,6,12,56,52,4,60
Albion,8516,4,16,5,15,52,48,4,53
Airdrieon,8516,5,14,8,14,52,54,-2,50
Peterhead,8516,6,13,9,14,44,51,-7,48
Queen's Park,8516,7,13,8,15,45,48,-3,47
Stenhousem'r,8516,8,12,8,16,54,72,-18,44
East Fife,8516,9,9,9,18,39,45,-6,36
Stranraer,8516,10,10,6,20,42,62,-20,36
Alloa,8517,1,18,11,7,73,45,28,65
Livingston,8517,2,19,7,10,75,47,28,64
Stranraer,8517,3,17,6,13,62,54,8,57
Brechin,8517,4,14,10,12,50,51,-1,52
Airdrieon,8517,5,14,7,15,58,63,-5,49
East Fife,8517,6,12,11,13,49,45,4,47
Albion,8517,7,13,8,15,47,48,-1,47
Peterhead,8517,8,12,9,15,41,47,-6,45
Queen's Park,8517,9,10,12,14,36,52,-16,42
Stenhousem'r,8517,10,7,7,22,49,88,-39,28
Alloa,8518,1,21,7,8,84,49,35,70
Livingston,8518,2,20,5,11,76,51,25,65
Airdrieon,8518,3,17,6,13,56,59,-3,57
Albion,8518,4,15,8,13,55,51,4,53
Brechin,8518,5,16,5,15,50,50,0,53
Peterhead,8518,6,16,5,15,43,43,0,53
East Fife,8518,7,14,9,13,52,43,9,51
Queen's Park,8518,8,11,10,15,41,52,-11,43
Stranraer,8518,9,10,4,22,53,75,-22,34
Stenhousem'r,8518,10,7,7,22,34,71,-37,28
Peterhead,8519,1,21,6,9,65,46,19,69
Livingston,8519,2,21,4,11,85,55,30,67
Alloa,8519,3,20,6,10,77,52,25,66
Brechin,8519,4,19,6,11,60,46,14,63
Airdrieon,8519,5,16,6,14,58,58,0,54
Albion,8519,6,11,10,15,52,65,-13,43
Queen's Park,8519,7,12,7,17,41,55,-14,43
East Fife,8519,8,11,9,16,54,56,-2,42
Stranraer,8519,9,11,3,22,51,64,-13,36
Stenhousem'r,8519,10,7,5,24,43,89,-46,26
Alloa,8520,1,18,10,8,62,39,23,64
Livingston,8520,2,18,6,12,68,50,18,60
Airdrieon,8520,3,17,6,13,63,58,5,57
Stranraer,8520,4,17,4,15,61,59,2,55
Albion,8520,5,13,10,13,55,55,0,49
Brechin,8520,6,14,7,15,46,46,0,49
East Fife,8520,7,10,15,11,47,45,2,45
Peterhead,8520,8,12,7,17,49,62,-13,43
Queen's Park,8520,9,11,8,17,35,46,-11,41
Stenhousem'r,8520,10,9,9,18,45,71,-26,36
Livingston,8521,1,23,3,10,80,50,30,72
Brechin,8521,2,19,5,12,54,45,9,62
Alloa,8521,3,16,10,10,68,47,21,58
Albion,8521,4,15,8,13,57,52,5,53
Airdrieon,8521,5,15,7,14,56,52,4,52
Peterhead,8521,6,13,9,14,51,48,3,48
East Fife,8521,7,12,7,17,48,50,-2,43
Stranraer,8521,8,11,8,17,49,68,-19,41
Queen's Park,8521,9,11,7,18,42,60,-18,40
Stenhousem'r,8521,10,9,8,19,49,82,-33,35
Airdrieon,8522,1,22,8,6,64,48,16,74
Livingston,8522,2,22,5,9,82,43,39,71
Alloa,8522,3,16,9,11,70,51,19,57
Albion,8522,4,16,8,12,60,57,3,56
Brechin,8522,5,14,7,15,53,56,-3,49
East Fife,8522,6,13,7,16,50,49,1,46
Stranraer,8522,7,13,6,17,55,60,-5,45
Queen's Park,8522,8,12,9,15,40,51,-11,45
Stenhousem'r,8522,9,9,6,21,42,75,-33,33
Peterhead,8522,10,7,7,22,42,68,-26,28
Livingston,8523,1,23,3,10,78,43,35,72
Alloa,8523,2,21,6,9,67,39,28,69
Airdrieon,8523,3,16,8,12,53,52,1,56
East Fife,8523,4,15,8,13,51,43,8,53
Peterhead,8523,5,15,7,14,49,51,-2,52
Stranraer,8523,6,16,4,16,49,53,-4,52
Brechin,8523,7,13,8,15,47,49,-2,47
Queen's Park,8523,8,12,6,18,32,50,-18,42
Albion,8523,9,11,7,18,51,58,-7,40
Stenhousem'r,8523,10,6,7,23,40,79,-39,25
Airdrieon,8524,1,21,7,8,62,42,20,70
Livingston,8524,2,21,4,11,73,46,27,67
Alloa,8524,3,19,6,11,71,49,22,63
Peterhead,8524,4,19,4,13,60,48,12,61
Brechin,8524,5,14,9,13,46,55,-9,51
Queen's Park,8524,6,15,5,16,42,48,-6,50
Albion,8524,7,12,5,19,40,49,-9,41
East Fife,8524,8,10,9,17,45,51,-6,39
Stranraer,8524,9,11,5,20,50,65,-15,38
Stenhousem'r,8524,10,7,8,21,42,78,-36,29
Alloa,8525,1,22,6,8,78,50,28,72
Livingston,8525,2,20,6,10,76,48,28,66
Airdrieon,8525,3,18,5,13,61,63,-2,59
Brechin,8525,4,15,7,14,48,49,-1,52
Stranraer,8525,5,14,7,15,46,53,-7,49
East Fife,8525,6,12,10,14,54,41,13,46
Peterhead,8525,7,13,7,16,53,59,-6,46
Queen's Park,8525,8,12,10,14,34,43,-9,46
Albion,8525,9,11,9,16,47,55,-8,42
Stenhousem'r,8525,10,5,9,22,43,79,-36,24
Alloa,8526,1,23,5,8,79,45,34,74
Livingston,8526,2,20,3,13,67,52,15,63
Albion,8526,3,17,8,11,63,53,10,59
Brechin,8526,4,16,6,14,49,43,6,54
Peterhead,8526,5,14,9,13,54,54,0,51
Airdrieon,8526,6,16,3,17,59,64,-5,51
Stranraer,8526,7,14,5,17,50,59,-9,47
Queen's Park,8526,8,11,8,17,38,49,-11,41
East Fife,8526,9,9,11,16,56,59,-3,38
Stenhousem'r,8526,10,7,8,21,43,80,-37,29
Livingston,8527,1,18,8,10,74,55,19,62
Brechin,8527,2,18,8,10,54,44,10,62
Peterhead,8527,3,17,6,13,56,50,6,57
Airdrieon,8527,4,17,6,13,60,58,2,57
Alloa,8527,5,15,6,15,69,56,13,51
East Fife,8527,6,13,11,12,52,37,15,50
Stranraer,8527,7,15,5,16,56,58,-2,50
Queen's Park,8527,8,12,7,17,33,48,-15,43
Albion,8527,9,8,11,17,55,63,-8,35
Stenhousem'r,8527,10,8,10,18,50,90,-40,34
Livingston,8528,1,21,6,9,80,53,27,69
Airdrieon,8528,2,19,4,13,68,55,13,61
Albion,8528,3,17,10,9,55,43,12,61
Alloa,8528,4,17,8,11,72,48,24,59
Brechin,8528,5,16,7,13,53,49,4,55
Peterhead,8528,6,12,8,16,47,51,-4,44
Stranraer,8528,7,12,7,17,45,62,-17,43
East Fife,8528,8,10,9,17,47,49,-2,39
Queen's Park,8528,9,9,8,19,34,60,-26,35
Stenhousem'r,8528,10,8,11,17,47,78,-31,35
Alloa,8529,1,21,6,9,75,42,33,69
Livingston,8529,2,19,7,10,69,46,23,64
Airdrieon,8529,3,17,4,15,53,52,1,55
Brechin,8529,4,16,6,14,46,45,1,54
East Fife,8529,5,13,11,12,53,41,12,50
Albion,8529,6,13,9,14,56,54,2,48
Queen's Park,8529,7,13,8,15,38,48,-10,47
Stenhousem'r,8529,8,13,3,20,54,78,-24,42
Peterhead,8529,9,11,8,17,44,58,-14,41
Stranraer,8529,10,11,4,21,36,60,-24,37
Livingston,8530,1,22,5,9,75,44,31,71
Brechin,8530,2,20,3,13,57,45,12,63
Airdrieon,8530,3,17,6,13,58,48,10,57
Alloa,8530,4,15,10,11,66,48,18,55
Albion,8530,5,15,9,12,55,52,3,54
Peterhead,8530,6,14,10,12,57,52,5,52
Queen's Park,8530,7,12,11,13,40,52,-12,47
Stranraer,8530,8,14,3,19,46,61,-15,45
East Fife,8530,9,8,10,18,46,64,-18,34
Stenhousem'r,8530,10,6,7,23,40,74,-34,25
Brechin,8531,1,20,5,11,58,49,9,65
Airdrieon,8531,2,19,6,11,61,49,12,63
Queen's Park,8531,3,16,7,13,45,42,3,55
Stranraer,8531,4,17,3,16,58,49,9,54
Albion,8531,5,14,10,12,48,46,2,52
Alloa,8531,6,14,8,14,62,55,7,50
Livingston,8531,7,15,4,17,71,63,8,49
Peterhead,8531,8,14,7,15,49,60,-11,49
East Fife,8531,9,9,12,15,53,55,-2,39
Stenhousem'r,8531,10,8,6,22,50,87,-37,30
Livingston,8532,1,23,6,7,86,39,47,75
Alloa,8532,2,19,9,8,69,40,29,66
Airdrieon,8532,3,16,10,10,61,54,7,58
Peterhead,8532,4,16,8,12,56,52,4,56
Brechin,8532,5,14,8,14,45,47,-2,50
Queen's Park,8532,6,13,9,14,45,54,-9,48
Albion,8532,7,12,8,16,53,61,-8,44
East Fife,8532,8,11,8,17,58,62,-4,41
Stranraer,8532,9,10,6,20,47,69,-22,36
Stenhousem'r,8532,10,8,4,24,50,92,-42,28
Livingston,8533,1,24,3,9,89,51,38,75
Alloa,8533,2,20,6,10,69,44,25,66
Peterhead,8533,3,14,12,10,49,45,4,54
Queen's Park,8533,4,14,10,12,41,47,-6,52
Brechin,8533,5,12,11,13,43,44,-1,47
Stranraer,8533,6,14,5,17,55,64,-9,47
Albion,8533,7,12,10,14,60,59,1,46
Airdrieon,8533,8,11,9,16,38,49,-11,42
East Fife,8533,9,9,9,18,48,62,-14,36
Stenhousem'r,8533,10,8,9,19,48,75,-27,33
Alloa,8534,1,17,11,8,63,42,21,62
Livingston,8534,2,18,6,12,75,56,19,60
Airdrieon,8534,3,17,8,11,58,50,8,59
Peterhead,8534,4,15,7,14,48,48,0,52
Albion,8534,5,14,7,15,47,44,3,49
Queen's Park,8534,6,12,12,12,43,46,-3,48
Stranraer,8534,7,12,8,16,56,64,-8,44
Brechin,8534,8,12,7,17,47,58,-11,43
East Fife,8534,9,9,13,14,48,52,-4,40
Stenhousem'r,8534,10,9,11,16,43,68,-25,38
Airdrieon,8535,1,20,10,6,66,44,22,70
Livingston,8535,2,17,12,7,71,42,29,63
Brechin,8535,3,18,7,11,53,51,2,61
Alloa,8535,4,13,14,9,68,52,16,53
Queen's Park,8535,5,15,6,15,49,49,0,51
Albion,8535,6,14,7,15,51,53,-2,49
East Fife,8535,7,11,9,16,52,58,-6,42
Stranraer,8535,8,11,8,17,56,58,-2,41
Peterhead,8535,9,7,13,16,31,51,-20,34
Stenhousem'r,8535,10,8,6,22,43,82,-39,30
Brechin,8536,1,21,5,10,60,44,16,68
Airdrieon,8536,2,18,6,12,56,52,4,60
Livingston,8536,3,17,8,11,71,54,17,59
Peterhead,8536,4,17,6,13,59,54,5,57
Stranraer,8536,5,15,6,15,61,58,3,51
Alloa,8536,6,14,8,14,61,47,14,50
Queen's Park,8536,7,14,6,16,40,53,-13,48
Albion,8536,8,13,6,17,46,56,-10,45
East Fife,8536,9,11,8,17,46,47,-1,41
Stenhousem'r,8536,10,7,7,22,48,83,-35,28
Livingston,8537,1,22,3,11,76,47,29,69
Airdrieon,8537,2,21,4,11,59,47,12,67
Brechin,8537,3,19,6,11,56,46,10,63
Alloa,8537,4,17,9,10,70,47,23,60
Albion,8537,5,13,10,13,55,45,10,49
Peterhead,8537,6,13,10,13,50,55,-5,49
Queen's Park,8537,7,14,4,18,40,55,-15,46
Stranraer,8537,8,12,6,18,54,66,-12,42
East Fife,8537,9,9,11,16,49,54,-5,38
Stenhousem'r,8537,10,6,5,25,40,87,-47,23
Albion,8538,1,19,7,10,62,40,22,64
Alloa,8538,2,16,11,9,71,53,18,59
Livingston,8538,3,17,7,12,63,46,17,58
Airdrieon,8538,4,17,5,14,59,55,4,56
Stranraer,8538,5,16,6,14,70,54,16,54
Queen's Park,8538,6,15,8,13,37,45,-8,53
Brechin,8538,7,15,7,14,46,56,-10,52
East Fife,8538,8,14,7,15,58,54,4,49
Peterhead,8538,9,11,6,19,47,65,-18,39
Stenhousem'r,8538,10,5,6,25,37,82,-45,21
Livingston,8539,1,22,1,13,73,47,26,67
Airdrieon,8539,2,19,3,14,57,47,10,60
Alloa,8539,3,16,11,9,67,43,24,59
Albion,8539,4,16,6,14,56,44,12,54
Brechin,8539,5,16,6,14,49,54,-5,54
East Fife,8539,6,13,10,13,55,52,3,49
Peterhead,8539,7,12,10,14,43,52,-9,46
Stranraer,8539,8,12,8,16,46,57,-11,44
Queen's Park,8539,9,10,10,16,38,54,-16,40
Stenhousem'r,8539,10,7,9,20,45,79,-34,30
Alloa,8540,1,21,7,8,75,43,32,70
Livingston,8540,2,22,4,10,78,48,30,70
Brechin,8540,3,17,7,12,51,49,2,58
Airdrieon,8540,4,17,5,14,58,55,3,56
Peterhead,8540,5,15,5,16,51,55,-4,50
Albion,8540,6,13,9,14,54,58,-4,48
East Fife,8540,7,11,11,14,54,54,0,44
Queen's Park,8540,8,12,7,17,46,55,-9,43
Stranraer,8540,9,11,5,20,50,62,-12,38
Stenhousem'r,8540,10,8,6,22,42,80,-38,30
Albion,8541,1,21,3,12,61,44,17,66
Livingston,8541,2,20,5,11,69,45,24,65
Airdrieon,8541,3,18,7,11,61,61,0,61
Alloa,8541,4,17,8,11,68,47,21,59
Stranraer,8541,5,16,4,16,53,55,-2,52
Brechin,8541,6,15,6,15,52,51,1,51
Peterhead,8541,7,14,8,14,49,46,3,50
Queen's Park,8541,8,15,4,17,38,49,-11,49
East Fife,8541,9,7,10,19,38,53,-15,31
Stenhousem'r,8541,10,7,5,24,37,75,-38,26
Livingston,8542,1,20,7,9,80,45,35,67
Alloa,8542,2,18,9,9,77,50,27,63
Airdrieon,8542,3,18,8,10,61,50,11,62
Peterhead,8542,4,16,11,9,55,40,15,59
Brechin,8542,5,17,7,12,52,45,7,58
Stranraer,8542,6,13,6,17,52,57,-5,45
Albion,8542,7,9,13,14,51,62,-11,40
East Fife,8542,8,8,12,16,43,57,-14,36
Stenhousem'r,8542,9,7,12,17,40,75,-35,33
Queen's Park,8542,10,8,7,21,31,61,-30,31
Livingston,8543,1,20,5,11,71,47,24,65
Brechin,8543,2,18,8,10,50,41,9,62
Alloa,8543,3,15,11,10,66,44,22,56
Airdrieon,8543,4,17,5,14,55,53,2,56
Albion,8543,5,15,8,13,49,41,8,53
Peterhead,8543,6,13,9,14,44,51,-7,48
East Fife,8543,7,12,11,13,50,48,2,47
Stranraer,8543,8,10,11,15,48,56,-8,41
Queen's Park,8543,9,10,11,15,28,42,-14,41
Stenhousem'r,8543,10,7,7,22,48,86,-38,28
Alloa,8544,1,21,8,7,71,36,35,71
Livingston,8544,2,21,5,10,83,55,28,68
Airdrieon,8544,3,17,8,11,61,50,11,59
Brechin,8544,4,14,9,13,50,50,0,51
East Fife,8544,5,12,13,11,50,39,11,49
Albion,8544,6,13,10,13,53,63,-10,49
Peterhead,8544,7,12,8,16,55,66,-11,44
Queen's Park,8544,8,13,5,18,47,63,-16,44
Stranraer,8544,9,11,7,18,51,63,-12,40
Stenhousem'r,8544,10,5,9,22,45,81,-36,24
Alloa,8545,1,22,8,6,88,45,43,74
Albion,8545,2,18,10,8,67,43,24,64
Livingston,8545,3,19,6,11,74,50,24,63
Airdrieon,8545,4,15,11,10,62,60,2,56
Brechin,8545,5,15,6,15,52,56,-4,51
East Fife,8545,6,12,9,15,52,53,-1,45
Queen's Park,8545,7,12,9,15,41,50,-9,45
Stranraer,8545,8,12,5,19,45,59,-14,41
Peterhead,8545,9,10,7,19,44,69,-25,37
Stenhousem'r,8545,10,7,5,24,40,80,-40,26
Livingston,8546,1,23,6,7,86,41,45,75
Alloa,8546,2,18,10,8,66,42,24,64
Airdrieon,8546,3,17,6,13,63,55,8,57
Albion,8546,4,17,5,14,55,52,3,56
Brechin,8546,5,15,5,16,47,46,1,50
Peterhead,8546,6,15,5,16,46,52,-6,50
Queen's Park,8546,7,12,10,14,35,44,-9,46
East Fife,8546,8,12,8,16,49,51,-2,44
Stranraer,8546,9,11,6,19,42,56,-14,39
Stenhousem'r,8546,10,5,9,22,39,89,-50,24
Livingston,8547,1,23,4,9,82,50,32,73
Alloa,8547,2,20,7,9,71,43,28,67
Airdrieon,8547,3,16,8,12,53,50,3,56
Brechin,8547,4,15,7,14,40,43,-3,52
Stranraer,8547,5,14,6,16,51,53,-2,48
Peterhead,8547,6,12,10,14,46,56,-10,46
Albion,8547,7,12,9,15,45,48,-3,45
Queen's Park,8547,8,12,4,20,35,53,-18,40
Stenhousem'r,8547,9,10,9,17,48,73,-25,39
East Fife,8547,10,9,10,17,42,44,-2,37
Livingston,8548,1,21,5,10,81,54,27,68
Alloa,8548,2,20,7,9,75,43,32,67
Airdrieon,8548,3,18,4,14,78,62,16,58
Albion,8548,4,16,9,11,57,51,6,57
Peterhead,8548,5,17,6,13,57,53,4,57
Brechin,8548,6,18,3,15,52,51,1,57
Queen's Park,8548,7,13,7,16,43,54,-11,46
Stenhousem'r,8548,8,12,5,19,55,86,-31,41
Stranraer,8548,9,9,5,22,47,66,-19,32
East Fife,8548,10,6,9,21,48,73,-25,27
Alloa,8549,1,21,7,8,65,34,31,70
Livingston,8549,2,18,7,11,73,52,21,61
East Fife,8549,3,15,10,11,51,43,8,55
Airdrieon,8549,4,15,9,12,48,48,0,54
Stranraer,8549,5,16,5,15,57,55,2,53
Brechin,8549,6,14,8,14,50,51,-1,50
Albion,8549,7,13,10,13,52,48,4,49
Queen's Park,8549,8,12,4,20,36,55,-19,40
Peterhead,8549,9,10,8,18,43,58,-15,38
Stenhousem'r,8549,10,8,8,20,44,75,-31,32
Livingston,8550,1,23,4,9,81,44,37,73
Alloa,8550,2,22,3,11,72,42,30,69
Airdrieon,8550,3,21,3,12,63,46,17,66
Brechin,8550,4,18,4,14,58,52,6,58
Albion,8550,5,14,10,12,51,50,1,52
East Fife,8550,6,12,9,15,51,54,-3,45
Stranraer,8550,7,13,4,19,50,55,-5,43
Queen's Park,8550,8,9,8,19,29,54,-25,35
Peterhead,8550,9,9,8,19,41,68,-27,35
Stenhousem'r,8550,10,8,9,19,50,81,-31,33
Livingston,8551,1,22,6,8,80,51,29,72
Airdrieon,8551,2,19,5,12,67,56,11,62
Alloa,8551,3,17,10,9,67,45,22,61
Brechin,8551,4,17,6,13,53,50,3,57
Peterhead,8551,5,13,10,13,53,50,3,49
Stranraer,8551,6,13,9,14,59,60,-1,48
Albion,8551,7,13,8,15,54,52,2,47
East Fife,8551,8,9,11,16,47,53,-6,38
Queen's Park,8551,9,11,5,20,31,56,-25,38
Stenhousem'r,8551,10,7,8,21,46,84,-38,29
Alloa,8552,1,22,8,6,83,42,41,74
Livingston,8552,2,19,7,10,71,52,19,64
Airdrieon,8552,3,17,9,10,60,52,8,60
Peterhead,8552,4,13,10,13,51,53,-2,49
Albion,8552,5,13,10,13,53,57,-4,49
Brechin,8552,6,12,10,14,41,44,-3,46
Stranraer,8552,7,11,9,16,52,63,-11,42
Queen's Park,8552,8,10,11,15,39,46,-7,41
East Fife,8552,9,9,11,16,44,50,-6,38
Stenhousem'r,8552,10,7,9,20,45,80,-35,30
Livingston,8553,1,22,4,10,77,51,26,70
Airdrieon,8553,2,17,5,14,56,61,-5,56
Peterhead,8553,3,15,10,11,52,40,12,55
Alloa,8553,4,15,10,11,63,53,10,55
Brechin,8553,5,15,10,11,45,42,3,55
Queen's Park,8553,6,12,8,16,33,48,-15,44
Stranraer,8553,7,13,4,19,53,61,-8,43
East Fife,8553,8,10,12,14,53,49,4,42
Stenhousem'r,8553,9,10,10,16,53,73,-20,40
Albion,8553,10,10,9,17,58,65,-7,39
Airdrieon,8554,1,23,7,6,74,50,24,76
Livingston,8554,2,21,3,12,82,52,30,66
Alloa,8554,3,18,4,14,73,54,19,58
East Fife,8554,4,15,7,14,58,44,14,52
Peterhead,8554,5,15,7,14,57,61,-4,52
Brechin,8554,6,15,7,14,44,49,-5,52
Queen's Park,8554,7,13,6,17,36,50,-14,45
Albion,8554,8,11,10,15,37,45,-8,43
Stranraer,8554,9,10,8,18,51,65,-14,38
Stenhousem'r,8554,10,7,5,24,37,79,-42,26
Alloa,8555,1,20,7,9,63,37,26,67
Brechin,8555,2,19,7,10,53,38,15,64
Airdrieon,8555,3,18,10,8,58,45,13,64
Livingston,8555,4,19,6,11,71,52,19,63
Peterhead,8555,5,12,9,15,51,52,-1,45
Queen's Park,8555,6,12,8,16,42,50,-8,44
Albion,8555,7,12,7,17,51,70,-19,43
Stranraer,8555,8,11,8,17,47,52,-5,41
East Fife,8555,9,9,10,17,39,46,-7,37
Stenhousem'r,8555,10,8,8,20,50,83,-33,32
Alloa,8556,1,20,8,8,74,38,36,68
Airdrieon,8556,2,19,10,7,61,49,12,67
Livingston,8556,3,18,9,9,74,46,28,63
Brechin,8556,4,16,7,13,57,51,6,55
Queen's Park,8556,5,12,10,14,38,48,-10,46
Albion,8556,6,11,10,15,53,59,-6,43
Peterhead,8556,7,10,12,14,46,52,-6,42
East Fife,8556,8,10,11,15,46,55,-9,41
Stenhousem'r,8556,9,9,8,19,54,84,-30,35
Stranraer,8556,10,9,7,20,55,76,-21,34
Livingston,8557,1,21,5,10,69,45,24,68
Brechin,8557,2,17,6,13,52,52,0,57
Airdrieon,8557,3,16,6,14,63,57,6,54
Albion,8557,4,15,8,13,50,49,1,53
Queen's Park,8557,5,15,5,16,39,46,-7,50
Alloa,8557,6,13,10,13,50,41,9,49
East Fife,8557,7,12,13,11,45,40,5,49
Stranraer,8557,8,15,4,17,58,63,-5,49
Peterhead,8557,9,10,9,17,45,60,-15,39
Stenhousem'r,8557,10,8,10,18,52,70,-18,34
Airdrieon,8558,1,22,3,11,62,50,12,69
Brechin,8558,2,19,7,10,56,42,14,64
Alloa,8558,3,17,7,12,67,45,22,58
Livingston,8558,4,17,7,12,75,58,17,58
Peterhead,8558,5,16,8,12,55,45,10,56
Albion,8558,6,13,10,13,55,56,-1,49
Stranraer,8558,7,13,3,20,43,56,-13,42
East Fife,8558,8,10,8,18,42,53,-11,38
Queen's Park,8558,9,10,8,18,36,56,-20,38
Stenhousem'r,8558,10,10,5,21,43,73,-30,35
Livingston,8559,1,23,3,10,84,44,40,72
Alloa,8559,2,17,10,9,66,39,27,61
Queen's Park,8559,3,15,8,13,40,46,-6,53
Airdrieon,8559,4,14,10,12,55,52,3,52
Brechin,8559,5,13,13,10,61,59,2,52
Peterhead,8559,6,12,10,14,58,55,3,46
Albion,8559,7,13,7,16,57,65,-8,46
East Fife,8559,8,10,10,16,49,57,-8,40
Stranraer,8559,9,11,7,18,43,68,-25,40
Stenhousem'r,8559,10,8,10,18,52,80,-28,34
Livingston,8560,1,21,3,12,70,43,27,66
Alloa,8560,2,18,8,10,67,47,20,62
Airdrieon,8560,3,17,3,16,54,50,4,54
Queen's Park,8560,4,16,4,16,41,47,-6,52
Brechin,8560,5,15,7,14,49,58,-9,52
Albion,8560,6,14,8,14,58,55,3,50
Stranraer,8560,7,14,8,14,50,52,-2,50
Peterhead,8560,8,13,9,14,51,54,-3,48
East Fife,8560,9,12,8,16,56,56,0,44
Stenhousem'r,8560,10,7,8,21,42,76,-34,29
Alloa,8561,1,19,9,8,66,41,25,66
Brechin,8561,2,18,6,12,55,38,17,60
Peterhead,8561,3,18,5,13,59,55,4,59
Livingston,8561,4,18,2,16,62,45,17,56
Albion,8561,5,14,10,12,58,57,1,52
Airdrieon,8561,6,15,7,14,53,54,-1,52
Stranraer,8561,7,13,7,16,50,58,-8,46
East Fife,8561,8,10,12,14,49,51,-2,42
Queen's Park,8561,9,10,10,16,35,46,-11,40
Stenhousem'r,8561,10,8,6,22,39,81,-42,30
Brechin,8562,1,21,5,10,67,39,28,68
Alloa,8562,2,19,5,12,71,52,19,62
Livingston,8562,3,19,3,14,72,55,17,60
Airdrieon,8562,4,17,5,14,58,54,4,56
Peterhead,8562,5,14,7,15,50,49,1,49
Stranraer,8562,6,14,6,16,56,58,-2,48
Queen's Park,8562,7,13,7,16,41,60,-19,46
East Fife,8562,8,12,9,15,48,42,6,45
Stenhousem'r,8562,9,9,10,17,50,76,-26,37
Albion,8562,10,10,7,19,41,69,-28,37
Brechin,8563,1,21,6,9,63,41,22,69
Livingston,8563,2,21,4,11,75,47,28,67
Airdrieon,8563,3,18,6,12,57,55,2,60
Albion,8563,4,15,11,10,58,51,7,56
Peterhead,8563,5,15,6,15,55,58,-3,51
Alloa,8563,6,14,8,14,70,62,8,50
Stranraer,8563,7,12,9,15,53,55,-2,45
Queen's Park,8563,8,10,8,18,34,55,-21,38
Stenhousem'r,8563,9,10,7,19,44,70,-26,37
East Fife,8563,10,9,5,22,42,57,-15,32
Livingston,8564,1,23,4,9,82,50,32,73
Alloa,8564,2,17,8,11,61,49,12,59
Brechin,8564,3,18,3,15,66,52,14,57
East Fife,8564,4,16,8,12,53,42,11,56
Peterhead,8564,5,16,6,14,51,45,6,54
Airdrieon,8564,6,13,12,11,55,60,-5,51
Albion,8564,7,11,9,16,48,52,-4,42
Stranraer,8564,8,9,11,16,43,54,-11,38
Queen's Park,8564,9,9,10,17,31,50,-19,37
Stenhousem'r,8564,10,9,7,20,44,80,-36,34
Livingston,8565,1,23,3,10,74,45,29,72
Alloa,8565,2,19,6,11,58,41,17,63
Brechin,8565,3,16,11,9,49,37,12,59
Peterhead,8565,4,16,8,12,53,49,4,56
Queen's Park,8565,5,15,9,12,37,38,-1,54
Airdrieon,8565,6,12,11,13,51,57,-6,47
Albion,8565,7,12,7,17,55,55,0,43
East Fife,8565,8,7,14,15,44,50,-6,35
Stranraer,8565,9,10,5,21,46,68,-22,35
Stenhousem'r,8565,10,9,8,19,44,71,-27,35
Livingston,8566,1,23,5,8,84,45,39,74
Alloa,8566,2,19,8,9,79,48,31,65
Brechin,8566,3,18,4,14,58,56,2,58
Airdrieon,8566,4,17,5,14,57,53,4,56
Albion,8566,5,15,8,13,58,49,9,53
Queen's Park,8566,6,15,6,15,41,49,-8,51
East Fife,8566,7,11,10,15,51,51,0,43
Peterhead,8566,8,10,11,15,46,60,-14,41
Stranraer,8566,9,10,8,18,52,69,-17,38
Stenhousem'r,8566,10,4,11,21,46,92,-46,23
Livingston,8567,1,23,2,11,76,43,33,71
Airdrieon,8567,2,21,6,9,71,47,24,69
Queen's Park,8567,3,15,8,13,40,45,-5,53
Alloa,8567,4,15,7,14,70,57,13,52
Albion,8567,5,15,7,14,56,55,1,52
Brechin,8567,6,14,7,15,50,56,-6,49
Peterhead,8567,7,14,6,16,45,54,-9,48
Stranraer,8567,8,14,4,18,49,60,-11,46
East Fife,8567,9,11,11,14,47,48,-1,44
Stenhousem'r,8567,10,6,6,24,48,87,-39,24
Alloa,8568,1,25,4,7,73,35,38,79
Peterhead,8568,2,20,7,9,59,42,17,67
Airdrieon,8568,3,19,5,12,56,46,10,62
Livingston,8568,4,17,2,17,65,58,7,53
Queen's Park,8568,5,14,8,14,40,45,-5,50
Albion,8568,6,15,3,18,49,53,-4,48
Brechin,8568,7,14,4,18,51,59,-8,46
East Fife,8568,8,11,9,16,46,49,-3,42
Stenhousem'r,8568,9,10,5,21,52,81,-29,35
Stranraer,8568,10,9,5,22,46,69,-23,32
Alloa,8569,1,21,7,8,81,43,38,70
Livingston,8569,2,18,5,13,67,49,18,59
Brechin,8569,3,16,10,10,49,42,7,58
East Fife,8569,4,16,8,12,53,44,9,56
Albion,8569,5,14,8,14,56,48,8,50
Peterhead,8569,6,13,10,13,53,57,-4,49
Airdrieon,8569,7,14,5,17,55,68,-13,47
Stranraer,8569,8,12,6,18,45,66,-21,42
Queen's Park,8569,9,11,6,19,42,60,-18,39
Stenhousem'r,8569,10,8,9,19,47,71,-24,33
Livingston,8570,1,24,4,8,74,44,30,76
Alloa,8570,2,18,8,10,77,43,34,62
Brechin,8570,3,19,4,13,54,44,10,61
Airdrieon,8570,4,17,9,10,59,46,13,60
Albion,8570,5,15,5,16,50,47,3,50
Peterhead,8570,6,13,8,15,48,60,-12,47
Stranraer,8570,7,11,9,16,48,60,-12,42
Queen's Park,8570,8,10,10,16,39,58,-19,40
East Fife,8570,9,10,9,17,43,55,-12,39
Stenhousem'r,8570,10,6,8,22,42,77,-35,26
Livingston,8571,1,22,3,11,76,42,34,69
Alloa,8571,2,21,6,9,72,44,28,69
Brechin,8571,3,18,7,11,48,40,8,61
Airdrieon,8571,4,18,4,14,53,48,5,58
Peterhead,8571,5,15,9,12,42,41,1,54
Albion,8571,6,14,9,13,49,45,4,51
East Fife,8571,7,11,12,13,42,44,-2,45
Queen's Park,8571,8,11,7,18,35,52,-17,40
Stranraer,8571,9,8,7,21,48,69,-21,31
Stenhousem'r,8571,10,6,8,22,42,82,-40,26
Livingston,8572,1,22,5,9,82,45,37,71
Brechin,8572,2,19,7,10,56,41,15,64
Alloa,8572,3,17,11,8,71,43,28,62
Airdrieon,8572,4,18,5,13,60,57,3,59
Albion,8572,5,12,10,14,52,53,-1,46
East Fife,8572,6,11,10,15,39,45,-6,43
Queen's Park,8572,7,10,13,13,38,51,-13,43
Stranraer,8572,8,11,9,16,50,56,-6,42
Peterhead,8572,9,9,8,19,41,67,-26,35
Stenhousem'r,8572,10,9,6,21,54,85,-31,33
Livingston,8573,1,26,5,5,77,35,42,83
Airdrieon,8573,2,19,8,9,55,41,14,65
Brechin,8573,3,18,6,12,52,46,6,60
Alloa,8573,4,17,8,11,66,49,17,59
Stranraer,8573,5,16,3,17,56,55,1,51
Queen's Park,8573,6,13,8,15,39,50,-11,47
Peterhead,8573,7,12,6,18,41,56,-15,42
East Fife,8573,8,10,9,17,44,43,1,39
Albion,8573,9,10,8,18,50,66,-16,38
Stenhousem'r,8573,10,5,7,24,41,80,-39,22
Airdrieon,8574,1,21,7,8,70,47,23,70
Alloa,8574,2,20,6,10,76,39,37,66
Livingston,8574,3,20,6,10,78,49,29,66
Peterhead,8574,4,16,10,10,60,50,10,58
Albion,8574,5,12,11,13,52,55,-3,47
Brechin,8574,6,14,5,17,50,60,-10,47
Queen's Park,8574,7,14,4,18,40,59,-19,46
Stranraer,8574,8,11,5,20,41,60,-19,38
Stenhousem'r,8574,9,9,7,20,45,76,-31,34
East Fife,8574,10,7,11,18,40,57,-17,32
Livingston,8575,1,22,6,8,77,42,35,72
Airdrieon,8575,2,20,5,11,66,48,18,65
Alloa,8575,3,18,8,10,67,47,20,62
Stranraer,8575,4,16,5,15,56,58,-2,53
Albion,8575,5,14,10,12,61,55,6,52
East Fife,8575,6,13,7,16,47,50,-3,46
Brechin,8575,7,10,10,16,46,56,-10,40
Peterhead,8575,8,11,7,18,51,63,-12,40
Queen's Park,8575,9,11,7,18,39,65,-26,40
Stenhousem'r,8575,10,8,9,19,51,77,-26,33
Livingston,8576,1,20,6,10,73,50,23,66
Alloa,8576,2,18,9,9,83,52,31,63
Airdrieon,8576,3,18,8,10,69,58,11,62
Brechin,8576,4,16,7,13,49,47,2,55
Queen's Park,8576,5,15,5,16,47,57,-10,50
Peterhead,8576,6,13,7,16,49,55,-6,46
East Fife,8576,7,11,11,14,45,50,-5,44
Albion,8576,8,9,14,13,51,54,-3,41
Stenhousem'r,8576,9,10,7,19,51,81,-30,37
Stranraer,8576,10,9,8,19,56,69,-13,35
Alloa,8577,1,18,12,6,75,40,35,66
Airdrieon,8577,2,19,5,12,67,57,10,62
Livingston,8577,3,18,6,12,63,50,13,60
Brechin,8577,4,15,10,11,60,54,6,55
Queen's Park,8577,5,15,8,13,47,49,-2,53
Peterhead,8577,6,13,7,16,49,52,-3,46
Albion,8577,7,11,12,13,54,58,-4,45
Stranraer,8577,8,12,7,17,52,66,-14,43
East Fife,8577,9,9,12,15,52,62,-10,39
Stenhousem'r,8577,10,5,11,20,45,76,-31,26
Livingston,8578,1,21,8,7,83,48,35,71
Alloa,8578,2,20,6,10,71,40,31,66
Brechin,8578,3,16,7,13,44,41,3,55
Peterhead,8578,4,14,9,13,51,50,1,51
Airdrieon,8578,5,14,8,14,55,51,4,50
Albion,8578,6,13,8,15,48,59,-11,47
East Fife,8578,7,12,9,15,47,42,5,45
Stenhousem'r,8578,8,12,5,19,56,87,-31,41
Queen's Park,8578,9,10,9,17,42,59,-17,39
Stranraer,8578,10,11,5,20,45,65,-20,38
Alloa,8579,1,19,6,11,76,48,28,63
Livingston,8579,2,18,7,11,74,50,24,61
Airdrieon,8579,3,16,7,13,55,59,-4,55
Stranraer,8579,4,15,8,13,60,58,2,53
Albion,8579,5,14,10,12,57,50,7,52
Brechin,8579,6,14,8,14,52,55,-3,50
Peterhead,8579,7,12,9,15,48,59,-11,45
Queen's Park,8579,8,12,7,17,35,57,-22,43
East Fife,8579,9,10,11,15,46,43,3,41
Stenhousem'r,8579,10,9,9,18,58,82,-24,36
Livingston,8580,1,21,4,11,77,61,16,67
Alloa,8580,2,19,7,10,73,46,27,64
Airdrieon,8580,3,17,9,10,55,50,5,60
Brechin,8580,4,17,6,13,61,52,9,57
Queen's Park,8580,5,14,6,16,45,57,-12,48
East Fife,8580,6,13,8,15,54,47,7,47
Albion,8580,7,13,6,17,56,56,0,45
Stranraer,8580,8,12,7,17,54,63,-9,43
Peterhead,8580,9,12,7,17,48,59,-11,43
Stenhousem'r,8580,10,8,8,20,47,79,-32,32
Livingston,8581,1,23,5,8,77,44,33,74
Airdrieon,8581,2,19,6,11,66,53,13,63
Alloa,8581,3,17,7,12,79,57,22,58
Brechin,8581,4,18,3,15,50,56,-6,57
Albion,8581,5,15,9,12,60,55,5,54
East Fife,8581,6,12,8,16,55,54,1,44
Stranraer,8581,7,13,5,18,45,54,-9,44
Peterhead,8581,8,12,7,17,50,62,-12,43
Queen's Park,8581,9,10,7,19,30,48,-18,37
Stenhousem'r,8581,10,9,7,20,51,80,-29,34
Livingston,8582,1,20,5,11,67,48,19,65
Airdrieon,8582,2,16,10,10,51,42,9,58
Alloa,8582,3,15,10,11,61,39,22,55
Albion,8582,4,15,9,12,47,45,2,54
Stranraer,8582,5,15,7,14,55,55,0,52
Brechin,8582,6,14,10,12,46,50,-4,52
Peterhead,8582,7,11,11,14,43,51,-8,44
East Fife,8582,8,10,10,16,49,43,6,40
Stenhousem'r,8582,9,10,8,18,44,72,-28,38
Queen's Park,8582,10,7,14,15,29,47,-18,35
Livingston,8583,1,26,1,9,83,42,41,79
Alloa,8583,2,20,8,8,67,39,28,68
Brechin,8583,3,18,7,11,48,41,7,61
Peterhead,8583,4,16,5,15,48,48,0,53
East Fife,8583,5,13,12,11,53,48,5,51
Airdrieon,8583,6,14,7,15,49,59,-10,49
Albion,8583,7,14,5,17,54,61,-7,47
Queen's Park,8583,8,12,5,19,33,47,-14,41
Stranraer,8583,9,10,7,19,43,57,-14,37
Stenhousem'r,8583,10,6,5,25,45,81,-36,23
Livingston,8584,1,24,2,10,74,42,32,74
Alloa,8584,2,19,8,9,68,42,26,65
Brechin,8584,3,17,6,13,54,51,3,57
Peterhead,8584,4,14,7,15,51,57,-6,49
Queen's Park,8584,5,13,10,13,41,51,-10,49
Stranraer,8584,6,14,5,17,55,61,-6,47
East Fife,8584,7,12,9,15,57,47,10,45
Albion,8584,8,11,11,14,49,44,5,44
Airdrieon,8584,9,12,6,18,52,71,-19,42
Stenhousem'r,8584,10,8,8,20,46,81,-35,32
Livingston,8585,1,22,2,12,80,48,32,68
Alloa,8585,2,19,6,11,69,48,21,63
Airdrieon,8585,3,18,5,13,64,51,13,59
Peterhead,8585,4,14,10,12,45,50,-5,52
Albion,8585,5,14,9,13,51,50,1,51
Brechin,8585,6,13,10,13,50,49,1,49
Stranraer,8585,7,12,8,16,52,56,-4,44
Queen's Park,8585,8,11,8,17,39,65,-26,41
East Fife,8585,9,11,7,18,46,53,-7,40
Stenhousem'r,8585,10,10,7,19,55,81,-26,37
Airdrieon,8586,1,18,8,10,57,47,10,62
Livingston,8586,2,18,7,11,78,54,24,61
Brechin,8586,3,17,9,10,53,49,4,60
Alloa,8586,4,16,9,11,62,48,14,57
East Fife,8586,5,14,10,12,53,44,9,52
Stranraer,8586,6,13,8,15,46,52,-6,47
Peterhead,8586,7,12,9,15,47,51,-4,45
Albion,8586,8,10,12,14,51,60,-9,42
Queen's Park,8586,9,9,10,17,44,58,-14,37
Stenhousem'r,8586,10,8,8,20,44,72,-28,32
Livingston,8587,1,24,2,10,76,43,33,74
Brechin,8587,2,18,8,10,53,45,8,62
Airdrieon,8587,3,18,5,13,58,55,3,59
Alloa,8587,4,16,9,11,64,47,17,57
Peterhead,8587,5,17,6,13,63,50,13,57
Albion,8587,6,15,7,14,56,52,4,52
Stranraer,8587,7,12,5,19,43,57,-14,41
East Fife,8587,8,10,9,17,52,58,-6,39
Queen's Park,8587,9,9,7,20,37,62,-25,34
Stenhousem'r,8587,10,7,10,19,42,75,-33,31
Livingston,8588,1,21,7,8,79,49,30,70
Alloa,8588,2,17,9,10,63,40,23,60
Airdrieon,8588,3,17,7,12,62,59,3,58
Peterhead,8588,4,16,7,13,57,43,14,55
Stranraer,8588,5,14,8,14,52,52,0,50
East Fife,8588,6,13,9,14,49,43,6,48
Brechin,8588,7,14,6,16,40,46,-6,48
Albion,8588,8,12,10,14,53,52,1,46
Queen's Park,8588,9,10,9,17,33,63,-30,39
Stenhousem'r,8588,10,5,10,21,37,78,-41,25
Livingston,8589,1,27,4,5,81,32,49,85
Airdrieon,8589,2,17,9,10,60,52,8,60
Alloa,8589,3,16,8,12,65,51,14,56
Queen's Park,8589,4,15,6,15,42,52,-10,51
Brechin,8589,5,15,5,16,52,53,-1,50
Peterhead,8589,6,13,10,13,50,43,7,49
Stranraer,8589,7,13,7,16,44,57,-13,46
Albion,8589,8,12,8,16,45,49,-4,44
East Fife,8589,9,8,8,20,37,48,-11,32
Stenhousem'r,8589,10,8,7,21,42,81,-39,31
Peterhead,8590,1,20,7,9,64,46,18,67
Airdrieon,8590,2,20,7,9,62,46,16,67
Brechin,8590,3,17,9,10,46,38,8,60
Alloa,8590,4,17,8,11,66,43,23,59
Albion,8590,5,15,8,13,45,45,0,53
Livingston,8590,6,14,4,18,61,57,4,46
Stranraer,8590,7,11,6,19,46,64,-18,39
East Fife,8590,8,8,12,16,48,56,-8,36
Queen's Park,8590,9,8,12,16,31,55,-24,36
Stenhousem'r,8590,10,8,11,17,47,66,-19,35
Livingston,8591,1,22,4,10,79,48,31,70
Airdrieon,8591,2,18,9,9,62,48,14,63
Alloa,8591,3,16,9,11,64,46,18,57
Albion,8591,4,12,14,10,51,41,10,50
Brechin,8591,5,12,14,10,45,45,0,50
Peterhead,8591,6,13,10,13,47,53,-6,49
Queen's Park,8591,7,14,7,15,46,55,-9,49
Stranraer,8591,8,11,10,15,43,54,-11,43
East Fife,8591,9,7,15,14,42,48,-6,36
Stenhousem'r,8591,10,4,10,22,44,85,-41,22
Livingston,8592,1,24,3,9,87,44,43,75
Alloa,8592,2,18,7,11,71,43,28,61
Brechin,8592,3,17,8,11,46,42,4,59
Peterhead,8592,4,17,7,12,55,49,6,58
Albion,8592,5,11,12,13,49,58,-9,45
Stranraer,8592,6,12,7,17,47,54,-7,43
Airdrieon,8592,7,11,9,16,47,59,-12,42
East Fife,8592,8,11,8,17,51,53,-2,41
Stenhousem'r,8592,9,11,6,19,50,77,-27,39
Queen's Park,8592,10,9,11,16,38,62,-24,38
Livingston,8593,1,18,6,12,80,53,27,60
Alloa,8593,2,17,9,10,65,40,25,60
Airdrieon,8593,3,18,6,12,62,55,7,60
Queen's Park,8593,4,17,7,12,44,45,-1,58
Brechin,8593,5,17,4,15,53,51,2,55
Peterhead,8593,6,14,12,10,54,52,2,54
Stranraer,8593,7,14,4,18,45,55,-10,46
East Fife,8593,8,12,5,19,50,59,-9,41
Albion,8593,9,9,9,18,43,57,-14,36
Stenhousem'r,8593,10,7,12,17,53,82,-29,33
Livingston,8594,1,25,3,8,79,39,40,78
Alloa,8594,2,21,8,7,70,36,34,71
Brechin,8594,3,16,5,15,49,51,-2,53
Queen's Park,8594,4,14,8,14,40,46,-6,50
Peterhead,8594,5,13,9,14,54,55,-1,48
Airdrieon,8594,6,13,6,17,56,60,-4,45
Albion,8594,7,12,7,17,44,53,-9,43
East Fife,8594,8,11,9,16,46,50,-4,42
Stenhousem'r,8594,9,12,5,19,49,74,-25,41
Stranraer,8594,10,10,6,20,36,59,-23,36
Alloa,8595,1,21,7,8,79,41,38,70
Brechin,8595,2,20,6,10,62,48,14,66
Airdrieon,8595,3,19,8,9,65,49,16,65
Livingston,8595,4,20,4,12,71,54,17,64
Albion,8595,5,15,9,12,56,53,3,54
Stranraer,8595,6,14,6,16,49,58,-9,48
Queen's Park,8595,7,13,5,18,42,51,-9,44
East Fife,8595,8,10,9,17,51,58,-7,39
Peterhead,8595,9,8,9,19,40,66,-26,33
Stenhousem'r,8595,10,5,7,24,45,82,-37,22
Livingston,8596,1,21,4,11,77,51,26,67
Alloa,8596,2,20,6,10,74,43,31,66
Albion,8596,3,17,8,11,55,40,15,59
Airdrieon,8596,4,16,8,12,54,55,-1,56
Brechin,8596,5,17,3,16,62,51,11,54
Peterhead,8596,6,14,6,16,48,63,-15,48
East Fife,8596,7,11,11,14,48,48,0,44
Stranraer,8596,8,11,10,15,57,67,-10,43
Queen's Park,8596,9,11,9,16,41,62,-21,42
Stenhousem'r,8596,10,7,5,24,51,87,-36,26
Airdrieon,8597,1,20,6,10,64,47,17,66
Livingston,8597,2,18,8,10,68,50,18,62
Alloa,8597,3,17,7,12,66,45,21,58
Brechin,8597,4,15,9,12,50,46,4,54
Stranraer,8597,5,14,9,13,56,56,0,51
Albion,8597,6,13,10,13,49,45,4,49
Peterhead,8597,7,14,7,15,48,53,-5,49
East Fife,8597,8,11,10,15,47,52,-5,43
Queen's Park,8597,9,10,10,16,44,52,-8,40
Stenhousem'r,8597,10,4,12,20,48,94,-46,24
Livingston,8598,1,21,5,10,84,49,35,68
Alloa,8598,2,19,6,11,67,46,21,63
Airdrieon,8598,3,17,7,12,52,53,-1,58
Brechin,8598,4,16,7,13,50,47,3,55
Peterhead,8598,5,14,10,12,54,50,4,52
Queen's Park,8598,6,15,4,17,38,51,-13,49
Albion,8598,7,13,6,17,59,63,-4,45
Stranraer,8598,8,13,6,17,45,54,-9,45
East Fife,8598,9,10,10,16,52,51,1,40
Stenhousem'r,8598,10,8,7,21,46,83,-37,31
Livingston,8599,1,20,9,7,78,46,32,69
Alloa,8599,2,19,8,9,68,41,27,65
Peterhead,8599,3,16,8,12,52,55,-3,56
Airdrieon,8599,4,16,6,14,68,62,6,54
Brechin,8599,5,14,6,16,50,51,-1,48
Albion,8599,6,14,5,17,62,64,-2,47
Stranraer,8599,7,13,7,16,50,57,-7,46
East Fife,8599,8,12,9,15,58,55,3,45
Queen's Park,8599,9,12,6,18,40,63,-23,42
Stenhousem'r,8599,10,8,8,20,52,84,-32,32
Livingston,8600,1,22,5,9,80,49,31,71
Alloa,8600,2,18,7,11,71,45,26,61
Brechin,8600,3,18,6,12,48,41,7,60
Airdrieon,8600,4,15,7,14,56,57,-1,52
East Fife,8600,5,14,9,13,56,51,5,51
Peterhead,8600,6,14,8,14,44,46,-2,50
Stranraer,8600,7,14,5,17,63,56,7,47
Albion,8600,8,13,7,16,50,62,-12,46
Queen's Park,8600,9,9,7,20,33,63,-30,34
Stenhousem'r,8600,10,8,9,19,41,72,-31,33
Livingston,8601,1,23,4,9,78,43,35,73
Albion,8601,2,20,8,8,60,38,22,68
Peterhead,8601,3,17,9,10,51,46,5,60
Alloa,8601,4,16,7,13,66,48,18,55
Brechin,8601,5,17,4,15,59,47,12,55
Airdrieon,8601,6,15,7,14,53,53,0,52
Stranraer,8601,7,10,8,18,42,61,-19,38
Queen's Park,8601,8,10,6,20,37,66,-29,36
East Fife,8601,9,7,12,17,41,52,-11,33
Stenhousem'r,8601,10,8,9,19,44,77,-33,33
Alloa,8602,1,19,10,7,70,39,31,67
Livingston,8602,2,20,6,10,72,48,24,66
Airdrieon,8602,3,16,5,15,54,64,-10,53
Stranraer,8602,4,15,7,14,55,53,2,52
Albion,8602,5,14,9,13,50,45,5,51
Peterhead,8602,6,15,6,15,58,59,-1,51
Brechin,8602,7,13,9,14,43,54,-11,48
Queen's Park,8602,8,11,10,15,28,41,-13,43
East Fife,8602,9,9,10,17,51,53,-2,37
Stenhousem'r,8602,10,7,10,19,46,71,-25,31
Alloa,8603,1,23,6,7,72,40,32,75
Livingston,8603,2,22,5,9,78,48,30,71
Brechin,8603,3,17,4,15,47,43,4,55
Airdrieon,8603,4,15,6,15,63,62,1,51
Stranraer,8603,5,14,7,15,54,54,0,49
Queen's Park,8603,6,14,4,18,31,52,-21,46
East Fife,8603,7,11,10,15,48,50,-2,43
Albion,8603,8,11,7,18,50,59,-9,40
Peterhead,8603,9,11,7,18,45,57,-12,40
Stenhousem'r,8603,10,8,12,16,60,83,-23,36
Alloa,8604,1,20,10,6,72,38,34,70
Livingston,8604,2,19,4,13,69,51,18,61
Airdrieon,8604,3,17,10,9,61,56,5,61
Albion,8604,4,15,7,14,54,51,3,52
Peterhead,8604,5,13,12,11,54,46,8,51
Brechin,8604,6,14,6,16,50,52,-2,48
Queen's Park,8604,7,13,6,17,41,55,-14,45
Stranraer,8604,8,11,10,15,48,54,-6,43
Stenhousem'r,8604,9,9,9,18,46,76,-30,36
East Fife,8604,10,7,10,19,40,56,-16,31
Alloa,8605,1,18,11,7,64,34,30,65
Livingston,8605,2,19,7,10,78,48,30,64
Peterhead,8605,3,17,10,9,61,50,11,61
Airdrieon,8605,4,16,7,13,50,44,6,55
Albion,8605,5,15,6,15,52,56,-4,51
Brechin,8605,6,14,8,14,48,48,0,50
Queen's Park,8605,7,13,8,15,40,45,-5,47
East Fife,8605,8,11,8,17,47,51,-4,41
Stranraer,8605,9,11,5,20,41,60,-19,38
Stenhousem'r,8605,10,7,8,21,50,95,-45,29
Livingston,8606,1,22,4,10,85,45,40,70
Alloa,8606,2,18,11,7,71,44,27,65
Albion,8606,3,17,7,12,66,51,15,58
Brechin,8606,4,15,9,12,53,46,7,54
Airdrieon,8606,5,16,5,15,56,57,-1,53
Stranraer,8606,6,13,8,15,56,60,-4,47
Peterhead,8606,7,11,8,17,48,66,-18,41
East Fife,8606,8,11,7,18,50,60,-10,40
Stenhousem'r,8606,9,11,7,18,46,76,-30,40
Queen's Park,8606,10,8,10,18,32,58,-26,34
Airdrieon,8607,1,18,8,10,65,50,15,62
Livingston,8607,2,18,4,14,66,48,18,58
Stranraer,8607,3,16,7,13,54,47,7,55
Brechin,8607,4,16,7,13,56,54,2,55
Peterhead,8607,5,15,7,14,49,51,-2,52
East Fife,8607,6,13,10,13,59,54,5,49
Alloa,8607,7,13,9,14,58,58,0,48
Albion,8607,8,12,10,14,49,52,-3,46
Queen's Park,8607,9,12,8,16,30,48,-18,44
Stenhousem'r,8607,10,8,8,20,48,72,-24,32
Livingston,8608,1,21,8,7,82,41,41,71
Alloa,8608,2,20,7,9,68,39,29,67
Airdrieon,8608,3,18,9,9,66,46,20,63
Brechin,8608,4,17,9,10,68,52,16,60
Albion,8608,5,16,5,15,68,69,-1,53
Queen's Park,8608,6,14,7,15,45,49,-4,49
Peterhead,8608,7,10,9,17,45,62,-17,39
East Fife,8608,8,10,8,18,48,59,-11,38
Stranraer,8608,9,10,6,20,45,70,-25,36
Stenhousem'r,8608,10,7,6,23,44,92,-48,27
Alloa,8609,1,20,6,10,76,48,28,66
Livingston,8609,2,19,5,12,73,54,19,62
Brechin,8609,3,18,4,14,55,47,8,58
Airdrieon,8609,4,17,7,12,55,49,6,58
East Fife,8609,5,15,10,11,53,43,10,55
Albion,8609,6,14,8,14,58,53,5,50
Peterhead,8609,7,15,5,16,58,59,-1,50
Stranraer,8609,8,14,5,17,48,60,-12,47
Queen's Park,8609,9,11,5,20,37,57,-20,38
Stenhousem'r,8609,10,6,7,23,42,85,-43,25
Livingston,8610,1,25,4,7,82,42,40,79
Airdrieon,8610,2,19,7,10,63,49,14,64
Alloa,8610,3,18,8,10,67,46,21,62
Brechin,8610,4,16,6,14,54,49,5,54
Peterhead,8610,5,14,7,15,53,57,-4,49
East Fife,8610,6,11,11,14,48,51,-3,44
Queen's Park,8610,7,12,6,18,39,53,-14,42
Albion,8610,8,11,8,17,43,53,-10,41
Stenhousem'r,8610,9,10,6,20,50,87,-37,36
Stranraer,8610,10,10,5,21,42,54,-12,35
Livingston,8611,1,19,9,8,84,45,39,66
Albion,8611,2,17,9,10,58,50,8,60
Airdrieon,8611,3,17,9,10,57,51,6,60
Peterhead,8611,4,14,9,13,46,44,2,51
Alloa,8611,5,13,11,12,57,52,5,50
Stranraer,8611,6,14,6,16,47,49,-2,48
Brechin,8611,7,14,5,17,43,50,-7,47
Queen's Park,8611,8,12,11,13,41,49,-8,47
East Fife,8611,9,11,11,14,48,44,4,44
Stenhousem'r,8611,10,5,8,23,39,86,-47,23
Livingston,8612,1,21,5,10,78,46,32,68
Alloa,8612,2,18,7,11,65,47,18,61
Brechin,8612,3,18,6,12,52,39,13,60
Airdrieon,8612,4,18,6,12,59,57,2,60
Peterhead,8612,5,16,7,13,50,44,6,55
Albion,8612,6,14,9,13,54,41,13,51
East Fife,8612,7,13,7,16,42,51,-9,46
Queen's Park,8612,8,14,4,18,43,54,-11,46
Stranraer,8612,9,12,4,20,50,70,-20,40
Stenhousem'r,8612,10,4,9,23,35,79,-44,21
Alloa,8613,1,20,8,8,81,43,38,68
Albion,8613,2,17,8,11,60,43,17,59
Livingston,8613,3,18,5,13,66,55,11,59
Brechin,8613,4,18,5,13,51,50,1,59
Peterhead,8613,5,15,8,13,58,48,10,53
Stranraer,8613,6,15,7,14,46,52,-6,52
Airdrieon,8613,7,15,6,15,54,52,2,51
Queen's Park,8613,8,13,5,18,42,60,-18,44
East Fife,8613,9,9,6,21,43,60,-17,33
Stenhousem'r,8613,10,7,8,21,47,85,-38,29
Alloa,8614,1,21,6,9,73,42,31,69
Livingston,8614,2,20,7,9,66,42,24,67
Peterhead,8614,3,16,8,12,53,54,-1,56
Airdrieon,8614,4,14,10,12,56,51,5,52
Queen's Park,8614,5,15,7,14,36,43,-7,52
Brechin,8614,6,14,4,18,39,48,-9,46
East Fife,8614,7,11,12,13,43,35,8,45
Stranraer,8614,8,11,11,14,46,57,-11,44
Albion,8614,9,9,10,17,47,56,-9,37
Stenhousem'r,8614,10,8,7,21,47,78,-31,31
Alloa,8615,1,20,9,7,62,39,23,69
Livingston,8615,2,21,5,10,83,51,32,68
Brechin,8615,3,16,11,9,51,37,14,59
Airdrieon,8615,4,15,5,16,60,68,-8,50
Queen's Park,8615,5,13,8,15,34,50,-16,47
Albion,8615,6,13,7,16,53,54,-1,46
Stranraer,8615,7,13,6,17,48,64,-16,45
Peterhead,8615,8,11,8,17,43,48,-5,41
East Fife,8615,9,10,10,16,44,48,-4,40
Stenhousem'r,8615,10,10,7,19,58,77,-19,37
Livingston,8616,1,22,3,11,71,39,32,69
Alloa,8616,2,18,10,8,62,43,19,64
Airdrieon,8616,3,17,6,13,58,61,-3,57
Brechin,8616,4,14,9,13,48,47,1,51
Stranraer,8616,5,13,10,13,52,55,-3,49
Peterhead,8616,6,14,7,15,40,44,-4,49
Albion,8616,7,11,12,13,57,53,4,45
Queen's Park,8616,8,11,9,16,34,47,-13,42
East Fife,8616,9,9,12,15,50,46,4,39
Stenhousem'r,8616,10,9,6,21,43,80,-37,33
Alloa,8617,1,20,9,7,80,40,40,69
Livingston,8617,2,18,8,10,74,45,29,62
Airdrieon,8617,3,18,7,11,70,68,2,61
Albion,8617,4,17,7,12,61,59,2,58
East Fife,8617,5,12,15,9,60,46,14,51
Brechin,8617,6,14,8,14,46,58,-12,50
Queen's Park,8617,7,11,8,17,42,63,-21,41
Peterhead,8617,8,11,7,18,49,57,-8,40
Stranraer,8617,9,9,11,16,49,53,-4,38
Stenhousem'r,8617,10,7,6,23,52,94,-42,27
Airdrieon,8618,1,23,7,6,73,46,27,76
Alloa,8618,2,19,8,9,79,43,36,65
Livingston,8618,3,17,5,14,64,50,14,56
Brechin,8618,4,14,11,11,45,41,4,53
Peterhead,8618,5,14,9,13,59,56,3,51
Queen's Park,8618,6,15,6,15,38,48,-10,51
Stranraer,8618,7,14,7,15,53,54,-1,49
Albion,8618,8,10,11,15,51,60,-9,41
East Fife,8618,9,10,9,17,51,59,-8,39
Stenhousem'r,8618,10,4,7,25,44,100,-56,19
Livingston,8619,1,24,5,7,93,44,49,77
Alloa,8619,2,20,6,10,80,48,32,66
Peterhead,8619,3,17,7,12,59,52,7,58
Brechin,8619,4,15,10,11,53,53,0,55
Airdrieon,8619,5,14,8,14,56,66,-10,50
Albion,8619,6,14,6,16,48,58,-10,48
East Fife,8619,7,12,8,16,64,59,5,44
Stranraer,8619,8,10,10,16,45,55,-10,40
Queen's Park,8619,9,10,8,18,33,51,-18,38
Stenhousem'r,8619,10,5,10,21,41,86,-45,25
Livingston,8620,1,24,2,10,81,42,39,74
Alloa,8620,2,20,6,10,76,47,29,66
Airdrieon,8620,3,16,9,11,61,58,3,57
Albion,8620,4,15,9,12,54,46,8,54
Brechin,8620,5,16,6,14,46,51,-5,54
Stranraer,8620,6,15,6,15,57,54,3,51
East Fife,8620,7,11,9,16,46,51,-5,42
Queen's Park,8620,8,11,9,16,33,53,-20,42
Peterhead,8620,9,9,12,15,46,48,-2,39
Stenhousem'r,8620,10,7,4,25,40,90,-50,25
Livingston,8621,1,23,5,8,76,43,33,74
Alloa,8621,2,19,9,8,72,40,32,66
Airdrieon,8621,3,19,5,12,62,54,8,62
Brechin,8621,4,16,7,13,54,46,8,55
Albion,8621,5,14,9,13,55,54,1,51
Stranraer,8621,6,14,6,16,56,58,-2,48
Peterhead,8621,7,13,8,15,48,54,-6,47
Queen's Park,8621,8,11,7,18,39,55,-16,40
East Fife,8621,9,9,7,20,46,61,-15,34
Stenhousem'r,8621,10,7,7,22,40,83,-43,28
Livingston,8622,1,22,3,11,80,51,29,69
Alloa,8622,2,19,8,9,68,43,25,65
Brechin,8622,3,19,5,12,52,46,6,62
Airdrieon,8622,4,15,8,13,61,50,11,53
Albion,8622,5,14,9,13,61,52,9,51
Queen's Park,8622,6,14,7,15,30,49,-19,49
East Fife,8622,7,12,8,16,47,48,-1,44
Stranraer,8622,8,11,6,19,41,51,-10,39
Peterhead,8622,9,10,7,19,34,53,-19,37
Stenhousem'r,8622,10,9,9,18,46,77,-31,36
Livingston,8623,1,20,4,12,61,42,19,64
Alloa,8623,2,19,5,12,65,44,21,62
Brechin,8623,3,17,9,10,56,46,10,60
Peterhead,8623,4,17,7,12,55,42,13,58
Airdrieon,8623,5,16,9,11,62,52,10,57
Stranraer,8623,6,16,5,15,48,45,3,53
Albion,8623,7,13,6,17,46,56,-10,45
East Fife,8623,8,10,12,14,41,47,-6,42
Queen's Park,8623,9,12,6,18,42,56,-14,42
Stenhousem'r,8623,10,6,5,25,41,87,-46,23
Livingston,8624,1,20,5,11,74,52,22,65
Brechin,8624,2,19,4,13,54,47,7,61
Airdrieon,8624,3,16,10,10,60,51,9,58
Alloa,8624,4,15,6,15,60,46,14,51
Peterhead,8624,5,14,9,13,52,61,-9,51
East Fife,8624,6,12,12,12,65,48,17,48
Queen's Park,8624,7,12,9,15,38,57,-19,45
Albion,8624,8,12,8,16,49,54,-5,44
Stranraer,8624,9,11,7,18,52,68,-16,40
Stenhousem'r,8624,10,10,8,18,60,80,-20,38
Airdrieon,8625,1,20,7,9,72,59,13,67
Brechin,8625,2,18,5,13,54,47,7,59
Queen's Park,8625,3,16,6,14,40,43,-3,54
Alloa,8625,4,14,11,11,64,50,14,53
Livingston,8625,5,15,8,13,68,55,13,53
Stranraer,8625,6,15,8,13,56,52,4,53
Peterhead,8625,7,14,10,12,47,53,-6,52
Albion,8625,8,13,8,15,50,48,2,47
East Fife,8625,9,10,10,16,57,59,-2,40
Stenhousem'r,8625,10,5,7,24,41,83,-42,22
Alloa,8626,1,21,4,11,74,48,26,67
Airdrieon,8626,2,20,3,13,60,55,5,63
Livingston,8626,3,18,4,14,81,61,20,58
East Fife,8626,4,15,9,12,54,38,16,54
Brechin,8626,5,15,8,13,39,50,-11,53
Queen's Park,8626,6,15,4,17,44,55,-11,49
Stranraer,8626,7,14,5,17,55,53,2,47
Peterhead,8626,8,12,7,17,43,59,-16,43
Stenhousem'r,8626,9,11,6,19,52,72,-20,39
Albion,8626,10,9,10,17,44,55,-11,37
Airdrieon,8627,1,18,9,9,64,52,12,63
Livingston,8627,2,17,4,15,68,52,16,55
Peterhead,8627,3,16,6,14,51,52,-1,54
Queen's Park,8627,4,15,8,13,42,49,-7,53
Stranraer,8627,5,16,4,16,58,56,2,52
Alloa,8627,6,14,9,13,58,44,14,51
Albion,8627,7,14,9,13,57,55,2,51
Brechin,8627,8,13,10,13,48,54,-6,49
East Fife,8627,9,11,9,16,51,55,-4,42
Stenhousem'r,8627,10,8,8,20,42,70,-28,32
Livingston,8628,1,25,2,9,87,48,39,77
Alloa,8628,2,18,6,12,68,45,23,60
Stranraer,8628,3,16,5,15,49,52,-3,53
Brechin,8628,4,15,6,15,47,47,0,51
Airdrieon,8628,5,15,6,15,57,61,-4,51
East Fife,8628,6,14,8,14,54,50,4,50
Albion,8628,7,13,8,15,54,57,-3,47
Queen's Park,8628,8,14,5,17,41,56,-15,47
Peterhead,8628,9,12,10,14,47,49,-2,46
Stenhousem'r,8628,10,7,6,23,46,85,-39,27
Alloa,8629,1,20,9,7,72,38,34,69
Livingston,8629,2,21,3,12,78,49,29,66
Albion,8629,3,18,6,12,54,51,3,60
Brechin,8629,4,18,4,14,55,49,6,58
Airdrieon,8629,5,15,12,9,59,52,7,57
East Fife,8629,6,14,8,14,53,48,5,50
Stranraer,8629,7,13,6,17,52,60,-8,45
Peterhead,8629,8,11,6,19,47,62,-15,39
Queen's Park,8629,9,11,5,20,36,57,-21,38
Stenhousem'r,8629,10,6,7,23,36,76,-40,25
Alloa,8630,1,22,8,6,80,39,41,74
Livingston,8630,2,23,4,9,71,42,29,73
Airdrieon,8630,3,18,7,11,63,54,9,61
Albion,8630,4,16,8,12,59,51,8,56
Brechin,8630,5,15,5,16,48,54,-6,50
East Fife,8630,6,13,9,14,53,46,7,48
Queen's Park,8630,7,13,3,20,35,63,-28,42
Peterhead,8630,8,11,8,17,48,55,-7,41
Stranraer,8630,9,12,4,20,44,54,-10,40
Stenhousem'r,8630,10,5,8,23,34,77,-43,23
Airdrieon,8631,1,20,6,10,72,56,16,66
Alloa,8631,2,18,9,9,69,46,23,63
Livingston,8631,3,19,4,13,78,52,26,61
East Fife,8631,4,17,7,12,58,43,15,58
Brechin,8631,5,18,4,14,54,56,-2,58
Albion,8631,6,14,7,15,58,57,1,49
Peterhead,8631,7,14,7,15,53,57,-4,49
Stranraer,8631,8,14,3,19,50,58,-8,45
Queen's Park,8631,9,9,8,19,30,52,-22,35
Stenhousem'r,8631,10,5,9,22,45,90,-45,24
Livingston,8632,1,24,3,9,83,52,31,75
Alloa,8632,2,22,7,7,75,39,36,73
Brechin,8632,3,21,6,9,60,43,17,69
Albion,8632,4,13,10,13,53,52,1,49
Peterhead,8632,5,13,10,13,43,49,-6,49
Airdrieon,8632,6,14,4,18,50,63,-13,46
East Fife,8632,7,10,12,14,51,46,5,42
Queen's Park,8632,8,12,5,19,34,52,-18,41
Stranraer,8632,9,10,8,18,47,64,-17,38
Stenhousem'r,8632,10,5,7,24,46,82,-36,22
Livingston,8633,1,25,2,9,81,46,35,77
Alloa,8633,2,17,8,11,75,50,25,59
Airdrieon,8633,3,16,10,10,57,53,4,58
Brechin,8633,4,14,9,13,49,53,-4,51
Queen's Park,8633,5,14,8,14,36,45,-9,50
East Fife,8633,6,12,12,12,56,47,9,48
Albion,8633,7,12,11,13,55,50,5,47
Stranraer,8633,8,10,11,15,53,67,-14,41
Peterhead,8633,9,10,10,16,49,58,-9,40
Stenhousem'r,8633,10,5,9,22,51,93,-42,24
Alloa,8634,1,21,5,10,78,51,27,68
Livingston,8634,2,19,7,10,78,47,31,64
Airdrieon,8634,3,17,7,12,58,52,6,58
Peterhead,8634,4,17,5,14,63,57,6,56
Brechin,8634,5,15,5,16,46,53,-7,50
Queen's Park,8634,6,15,5,16,40,55,-15,50
Albion,8634,7,12,10,14,47,42,5,46
East Fife,8634,8,10,12,14,41,44,-3,42
Stenhousem'r,8634,9,11,6,19,47,70,-23,39
Stranraer,8634,10,9,6,21,43,70,-27,33
Airdrieon,8635,1,20,8,8,73,49,24,68
Livingston,8635,2,19,5,12,75,52,23,62
Alloa,8635,3,17,10,9,67,49,18,61
East Fife,8635,4,15,11,10,59,46,13,56
Queen's Park,8635,5,12,12,12,43,48,-5,48
Peterhead,8635,6,13,8,15,48,48,0,47
Brechin,8635,7,14,4,18,40,57,-17,46
Stranraer,8635,8,12,6,18,51,63,-12,42
Albion,8635,9,9,12,15,48,60,-12,39
Stenhousem'r,8635,10,6,10,20,48,80,-32,28
Livingston,8636,1,19,6,11,71,47,24,63
Alloa,8636,2,17,9,10,70,51,19,60
Brechin,8636,3,17,7,12,52,45,7,58
Airdrieon,8636,4,16,7,13,62,62,0,55
East Fife,8636,5,15,9,12,52,40,12,54
Stranraer,8636,6,16,6,14,54,45,9,54
Queen's Park,8636,7,13,11,12,46,48,-2,50
Peterhead,8636,8,13,6,17,42,66,-24,45
Albion,8636,9,11,11,14,54,50,4,44
Stenhousem'r,8636,10,4,6,26,31,80,-49,18
Livingston,8637,1,21,6,9,66,42,24,69
Brechin,8637,2,19,6,11,55,39,16,63
Alloa,8637,3,15,12,9,61,39,22,57
Airdrieon,8637,4,16,7,13,58,52,6,55
Albion,8637,5,16,7,13,51,48,3,55
East Fife,8637,6,14,8,14,49,44,5,50
Queen's Park,8637,7,11,9,16,40,50,-10,42
Peterhead,8637,8,10,10,16,45,57,-12,40
Stranraer,8637,9,10,9,17,44,61,-17,39
Stenhousem'r,8637,10,7,8,21,44,81,-37,29
Alloa,8638,1,21,8,7,84,50,34,71
Livingston,8638,2,17,6,13,57,43,14,57
Stranraer,8638,3,17,6,13,55,50,5,57
Airdrieon,8638,4,15,7,14,57,56,1,52
Albion,8638,5,14,10,12,53,53,0,52
East Fife,8638,6,12,12,12,59,54,5,48
Brechin,8638,7,14,3,19,45,58,-13,45
Peterhead,8638,8,12,8,16,59,61,-2,44
Queen's Park,8638,9,11,9,16,42,56,-14,42
Stenhousem'r,8638,10,8,9,19,53,83,-30,33
Livingston,8639,1,22,4,10,76,46,30,70
Airdrieon,8639,2,17,12,7,61,51,10,63
Alloa,8639,3,17,7,12,63,45,18,58
Albion,8639,4,16,5,15,60,59,1,53
Stranraer,8639,5,14,9,13,57,57,0,51
Brechin,8639,6,14,6,16,53,62,-9,48
East Fife,8639,7,13,7,16,55,52,3,46
Peterhead,8639,8,13,7,16,45,51,-6,46
Stenhousem'r,8639,9,9,9,18,55,73,-18,36
Queen's Park,8639,10,8,8,20,23,52,-29,32
Livingston,8640,1,23,0,13,72,39,33,69
Alloa,8640,2,18,9,9,68,43,25,63
Brechin,8640,3,18,4,14,54,42,12,58
Peterhead,8640,4,17,6,13,57,56,1,57
Airdrieon,8640,5,13,9,14,56,55,1,48
Albion,8640,6,12,10,14,43,48,-5,46
East Fife,8640,7,12,9,15,50,56,-6,45
Stranraer,8640,8,11,9,16,46,52,-6,42
Queen's Park,8640,9,10,11,15,34,54,-20,41
Stenhousem'r,8640,10,9,7,20,44,79,-35,34
Livingston,8641,1,21,4,11,71,40,31,67
Alloa,8641,2,21,3,12,70,45,25,66
Airdrieon,8641,3,18,9,9,59,48,11,63
Brechin,8641,4,16,9,11,52,45,7,57
Albion,8641,5,16,7,13,50,48,2,55
Stranraer,8641,6,13,7,16,44,55,-11,46
Queen's Park,8641,7,13,6,17,41,50,-9,45
Peterhead,8641,8,13,4,19,41,58,-17,43
East Fife,8641,9,10,7,19,42,47,-5,37
Stenhousem'r,8641,10,6,10,20,40,74,-34,28
Alloa,8642,1,23,5,8,70,36,34,74
Brechin,8642,2,19,3,14,54,48,6,60
Livingston,8642,3,16,9,11,64,50,14,57
Stranraer,8642,4,17,3,16,55,56,-1,54
Albion,8642,5,16,5,15,50,46,4,53
Peterhead,8642,6,16,4,16,52,47,5,52
Airdrieon,8642,7,14,6,16,63,66,-3,48
Queen's Park,8642,8,13,7,16,39,52,-13,46
Stenhousem'r,8642,9,11,4,21,57,89,-32,37
East Fife,8642,10,8,8,20,41,55,-14,32
Livingston,8643,1,21,6,9,76,45,31,69
Alloa,8643,2,17,12,7,64,39,25,63
Brechin,8643,3,17,10,9,48,35,13,61
Albion,8643,4,16,9,11,47,41,6,57
Airdrieon,8643,5,13,10,13,54,48,6,49
Stranraer,8643,6,12,11,13,55,54,1,47
East Fife,8643,7,10,11,15,43,48,-5,41
Peterhead,8643,8,9,13,14,40,55,-15,40
Queen's Park,8643,9,10,7,19,29,46,-17,37
Stenhousem'r,8643,10,8,5,23,39,84,-45,29
Alloa,8644,1,22,5,9,74,42,32,71
Livingston,8644,2,21,2,13,75,50,25,65
Brechin,8644,3,17,8,11,56,52,4,59
Airdrieon,8644,4,17,4,15,61,57,4,55
Stranraer,8644,5,16,5,15,58,56,2,53
Albion,8644,6,15,6,15,56,58,-2,51
Peterhead,8644,7,15,4,17,41,56,-15,49
Queen's Park,8644,8,12,6,18,29,42,-13,42
East Fife,8644,9,9,11,16,49,52,-3,38
Stenhousem'r,8644,10,7,7,22,45,79,-34,28
Livingston,8645,1,24,2,10,81,44,37,74
Alloa,8645,2,20,9,7,74,39,35,69
Queen's Park,8645,3,16,10,10,54,48,6,58
Airdrieon,8645,4,16,7,13,58,54,4,55
Albion,8645,5,14,7,15,51,55,-4,49
Brechin,8645,6,14,6,16,47,59,-12,48
Peterhead,8645,7,12,9,15,43,58,-15,45
East Fife,8645,8,10,8,18,47,51,-4,38
Stranraer,8645,9,9,8,19,47,62,-15,35
Stenhousem'r,8645,10,8,8,20,49,81,-32,32
Alloa,8646,1,19,8,9,76,40,36,65
Livingston,8646,2,20,4,12,68,46,22,64
Brechin,8646,3,17,7,12,48,46,2,58
Queen's Park,8646,4,17,5,14,44,44,0,56
Airdrieon,8646,5,17,5,14,54,55,-1,56
Peterhead,8646,6,14,7,15,53,49,4,49
Albion,8646,7,12,6,18,46,58,-12,42
Stranraer,8646,8,12,6,18,43,56,-13,42
East Fife,8646,9,11,8,17,40,44,-4,41
Stenhousem'r,8646,10,9,8,19,51,85,-34,35
Airdrieon,8647,1,22,4,10,63,42,21,70
Alloa,8647,2,19,11,6,73,44,29,68
Livingston,8647,3,17,6,13,75,59,16,57
Brechin,8647,4,16,8,12,43,39,4,56
Peterhead,8647,5,13,10,13,53,51,2,49
Stranraer,8647,6,13,9,14,52,54,-2,48
Albion,8647,7,13,5,18,54,59,-5,44
East Fife,8647,8,11,9,16,46,49,-3,42
Queen's Park,8647,9,12,5,19,31,58,-27,41
Stenhousem'r,8647,10,9,3,24,52,87,-35,30
Brechin,8648,1,21,4,11,53,38,15,67
Livingston,8648,2,19,5,12,85,57,28,62
Alloa,8648,3,17,9,10,65,42,23,60
Airdrieon,8648,4,15,7,14,59,61,-2,52
Peterhead,8648,5,13,12,11,55,49,6,51
Albion,8648,6,11,13,12,52,55,-3,46
Stranraer,8648,7,11,9,16,51,62,-11,42
Stenhousem'r,8648,8,11,8,17,41,67,-26,41
Queen's Park,8648,9,10,9,17,38,62,-24,39
East Fife,8648,10,9,10,17,45,51,-6,37
Livingston,8649,1,24,5,7,95,45,50,77
Alloa,8649,2,18,8,10,71,45,26,62
Airdrieon,8649,3,15,9,12,59,58,1,54
Albion,8649,4,12,12,12,53,53,0,48
Peterhead,8649,5,13,9,14,53,55,-2,48
Brechin,8649,6,12,10,14,46,60,-14,46
Queen's Park,8649,7,12,8,16,39,47,-8,44
East Fife,8649,8,10,12,14,52,55,-3,42
Stranraer,8649,9,11,8,17,45,60,-15,41
Stenhousem'r,8649,10,10,5,21,51,86,-35,35
Alloa,8650,1,20,8,8,72,45,27,68
Livingston,8650,2,17,6,13,70,61,9,57
Brechin,8650,3,16,8,12,54,45,9,56
Airdrieon,8650,4,16,6,14,61,59,2,54
Peterhead,8650,5,15,7,14,54,49,5,52
East Fife,8650,6,13,12,11,58,48,10,51
Albion,8650,7,15,6,15,48,50,-2,51
Stranraer,8650,8,13,7,16,46,51,-5,46
Queen's Park,8650,9,12,6,18,38,53,-15,42
Stenhousem'r,8650,10,6,8,22,41,81,-40,26
Livingston,8651,1,18,9,9,74,49,25,63
Alloa,8651,2,18,8,10,61,44,17,62
Airdrieon,8651,3,17,9,10,65,53,12,60
Queen's Park,8651,4,16,7,13,47,45,2,55
Brechin,8651,5,16,6,14,54,53,1,54
Albion,8651,6,14,9,13,55,56,-1,51
Peterhead,8651,7,13,9,14,45,47,-2,48
Stranraer,8651,8,11,5,20,52,75,-23,38
Stenhousem'r,8651,9,10,6,20,50,79,-29,36
East Fife,8651,10,8,10,18,44,46,-2,34
Alloa,8652,1,16,11,9,65,38,27,59
Stranraer,8652,2,17,7,12,54,46,8,58
Albion,8652,3,17,6,13,54,47,7,57
Airdrieon,8652,4,15,9,12,56,52,4,54
East Fife,8652,5,14,11,11,48,42,6,53
Peterhead,8652,6,13,8,15,45,47,-2,47
Brechin,8652,7,12,10,14,44,48,-4,46
Queen's Park,8652,8,14,4,18,40,48,-8,46
Livingston,8652,9,12,8,16,62,65,-3,44
Stenhousem'r,8652,10,8,10,18,45,80,-35,34
Livingston,8653,1,19,8,9,70,40,30,65
Airdrieon,8653,2,17,8,11,60,52,8,59
Brechin,8653,3,16,10,10,49,45,4,58
East Fife,8653,4,14,10,12,54,45,9,52
Albion,8653,5,14,10,12,53,45,8,52
Stranraer,8653,6,15,6,15,50,53,-3,51
Alloa,8653,7,15,5,16,62,59,3,50
Peterhead,8653,8,13,8,15,53,52,1,47
Queen's Park,8653,9,12,6,18,36,50,-14,42
Stenhousem'r,8653,10,5,9,22,37,83,-46,24
Livingston,8654,1,20,6,10,77,48,29,66
Airdrieon,8654,2,18,6,12,50,46,4,60
Alloa,8654,3,15,11,10,67,46,21,56
Albion,8654,4,15,11,10,54,44,10,56
Peterhead,8654,5,16,8,12,54,55,-1,56
Brechin,8654,6,12,10,14,48,56,-8,46
East Fife,8654,7,11,11,14,59,59,0,44
Queen's Park,8654,8,12,6,18,39,49,-10,42
Stranraer,8654,9,12,6,18,46,60,-14,42
Stenhousem'r,8654,10,6,11,19,46,77,-31,29
Livingston,8655,1,20,7,9,74,51,23,67
Brechin,8655,2,17,7,12,54,48,6,58
Airdrieon,8655,3,16,8,12,68,62,6,56
East Fife,8655,4,15,9,12,48,38,10,54
Alloa,8655,5,13,9,14,66,58,8,48
Peterhead,8655,6,14,6,16,48,60,-12,48
Stranraer,8655,7,12,11,13,62,53,9,47
Albion,8655,8,13,7,16,54,52,2,46
Queen's Park,8655,9,11,8,17,35,59,-24,41
Stenhousem'r,8655,10,10,6,20,44,72,-28,36
Alloa,8656,1,18,10,8,72,45,27,64
Livingston,8656,2,19,6,11,78,55,23,63
Airdrieon,8656,3,17,6,13,57,55,2,57
Peterhead,8656,4,15,11,10,50,37,13,56
Brechin,8656,5,16,7,13,54,53,1,55
Stranraer,8656,6,16,3,17,63,68,-5,51
Albion,8656,7,12,11,13,58,57,1,47
East Fife,8656,8,11,12,13,48,45,3,45
Queen's Park,8656,9,9,7,20,29,58,-29,34
Stenhousem'r,8656,10,7,7,22,47,83,-36,28
Alloa,8657,1,19,10,7,77,45,32,67
Livingston,8657,2,19,5,12,77,57,20,62
Brechin,8657,3,16,7,13,53,52,1,55
Stranraer,8657,4,17,3,16,59,58,1,54
Airdrieon,8657,5,15,9,12,58,59,-1,54
Peterhead,8657,6,15,5,16,53,56,-3,50
Albion,8657,7,11,13,12,53,48,5,46
Queen's Park,8657,8,12,8,16,41,58,-17,44
East Fife,8657,9,11,9,16,48,56,-8,42
Stenhousem'r,8657,10,7,7,22,50,80,-30,28
Livingston,8658,1,21,6,9,74,39,35,69
Albion,8658,2,19,5,12,59,47,12,62
Alloa,8658,3,19,4,13,72,49,23,61
Brechin,8658,4,18,6,12,48,43,5,60
Airdrieon,8658,5,17,4,15,71,62,9,55
Peterhead,8658,6,11,12,13,52,60,-8,45
Queen's Park,8658,7,12,6,18,36,57,-21,42
Stenhousem'r,8658,8,10,9,17,45,66,-21,39
Stranraer,8658,9,12,3,21,46,68,-22,39
East Fife,8658,10,9,9,18,44,56,-12,36
Livingston,8659,1,23,3,10,78,42,36,72
Alloa,8659,2,19,7,10,75,44,31,64
Airdrieon,8659,3,18,8,10,62,49,13,62
Peterhead,8659,4,16,8,12,55,54,1,56
Brechin,8659,5,15,6,15,47,54,-7,51
Queen's Park,8659,6,15,5,16,52,57,-5,50
Albion,8659,7,11,10,15,52,62,-10,43
Stranraer,8659,8,10,9,17,49,60,-11,39
East Fife,8659,9,8,12,16,40,50,-10,36
Stenhousem'r,8659,10,7,8,21,44,82,-38,29
Livingston,8660,1,23,2,11,81,47,34,71
Alloa,8660,2,21,6,9,70,41,29,69
Airdrieon,8660,3,20,6,10,61,42,19,66
Albion,8660,4,17,6,13,50,45,5,57
Brechin,8660,5,18,2,16,52,52,0,56
Peterhead,8660,6,15,6,15,51,50,1,51
East Fife,8660,7,14,5,17,48,54,-6,47
Queen's Park,8660,8,13,6,17,37,52,-15,45
Stranraer,8660,9,11,3,22,43,65,-22,36
Stenhousem'r,8660,10,5,4,27,38,83,-45,19
Alloa,8661,1,19,6,11,79,50,29,63
Livingston,8661,2,18,9,9,67,46,21,63
Brechin,8661,3,17,6,13,60,51,9,57
Airdrieon,8661,4,15,6,15,52,57,-5,51
Albion,8661,5,13,11,12,56,55,1,50
East Fife,8661,6,14,8,14,58,59,-1,50
Stranraer,8661,7,15,5,16,58,61,-3,50
Peterhead,8661,8,13,10,13,60,59,1,49
Queen's Park,8661,9,11,8,17,40,54,-14,41
Stenhousem'r,8661,10,7,7,22,47,85,-38,28
Livingston,8662,1,21,3,12,72,53,19,66
Airdrieon,8662,2,17,9,10,62,47,15,60
Alloa,8662,3,16,9,11,63,49,14,57
Brechin,8662,4,16,8,12,48,42,6,56
Albion,8662,5,14,10,12,50,42,8,52
Queen's Park,8662,6,14,6,16,45,56,-11,48
Peterhead,8662,7,12,9,15,49,53,-4,45
East Fife,8662,8,11,8,17,51,53,-2,41
Stranraer,8662,9,11,7,18,48,71,-23,40
Stenhousem'r,8662,10,9,9,18,53,75,-22,36
Brechin,8663,1,23,3,10,64,46,18,72
Livingston,8663,2,21,4,11,73,46,27,67
Alloa,8663,3,20,7,9,66,42,24,67
Airdrieon,8663,4,16,6,14,59,58,1,54
Albion,8663,5,13,10,13,64,59,5,49
Peterhead,8663,6,13,9,14,48,55,-7,48
East Fife,8663,7,11,8,17,47,55,-8,41
Queen's Park,8663,8,10,9,17,44,60,-16,39
Stranraer,8663,9,10,8,18,47,60,-13,38
Stenhousem'r,8663,10,6,10,20,53,84,-31,28
Livingston,8664,1,23,2,11,75,41,34,71
Alloa,8664,2,21,6,9,63,40,23,69
Airdrieon,8664,3,19,6,11,57,48,9,63
Queen's Park,8664,4,15,8,13,44,45,-1,53
Brechin,8664,5,16,5,15,47,51,-4,53
Peterhead,8664,6,15,7,14,53,52,1,52
Albion,8664,7,13,4,19,47,60,-13,43
Stranraer,8664,8,12,6,18,50,55,-5,42
East Fife,8664,9,8,11,17,46,49,-3,35
Stenhousem'r,8664,10,8,5,23,49,90,-41,29
Alloa,8665,1,20,7,9,69,39,30,67
Airdrieon,8665,2,19,8,9,63,44,19,65
Brechin,8665,3,16,8,12,46,44,2,56
Peterhead,8665,4,16,6,14,59,58,1,54
Livingston,8665,5,16,5,15,64,55,9,53
Stranraer,8665,6,14,8,14,47,56,-9,50
Albion,8665,7,13,8,15,60,57,3,47
Queen's Park,8665,8,12,6,18,43,54,-11,42
East Fife,8665,9,10,9,17,41,49,-8,39
Stenhousem'r,8665,10,8,7,21,44,80,-36,31
Alloa,8666,1,21,8,7,74,38,36,71
Livingston,8666,2,21,4,11,70,49,21,67
Stranraer,8666,3,16,5,15,55,52,3,53
Brechin,8666,4,15,8,13,52,49,3,53
East Fife,8666,5,14,10,12,52,47,5,52
Airdrieon,8666,6,15,3,18,52,64,-12,48
Peterhead,8666,7,11,11,14,47,56,-9,44
Albion,8666,8,10,11,15,47,55,-8,41
Queen's Park,8666,9,11,7,18,35,50,-15,40
Stenhousem'r,8666,10,9,7,20,54,78,-24,34
Livingston,8667,1,22,4,10,74,45,29,70
Airdrieon,8667,2,18,9,9,64,46,18,63
Alloa,8667,3,16,5,15,58,47,11,53
Brechin,8667,4,15,8,13,52,50,2,53
Stranraer,8667,5,16,5,15,61,62,-1,53
East Fife,8667,6,14,9,13,53,44,9,51
Albion,8667,7,13,9,14,44,46,-2,48
Peterhead,8667,8,13,8,15,51,57,-6,47
Queen's Park,8667,9,12,6,18,41,55,-14,42
Stenhousem'r,8667,10,7,5,24,42,88,-46,26
Livingston,8668,1,21,6,9,76,40,36,69
Alloa,8668,2,19,5,12,73,47,26,62
Brechin,8668,3,17,5,14,47,48,-1,56
Airdrieon,8668,4,16,5,15,61,54,7,53
Albion,8668,5,15,7,14,56,53,3,52
Peterhead,8668,6,13,9,14,52,62,-10,48
East Fife,8668,7,12,10,14,51,49,2,46
Queen's Park,8668,8,12,9,15,41,52,-11,45
Stranraer,8668,9,13,5,18,57,65,-8,44
Stenhousem'r,8668,10,7,9,20,47,91,-44,30
Livingston,8669,1,20,6,10,85,50,35,66
Airdrieon,8669,2,18,10,8,61,47,14,64
Alloa,8669,3,19,6,11,72,52,20,63
Stranraer,8669,4,17,5,14,57,55,2,56
Brechin,8669,5,16,5,15,59,56,3,53
Peterhead,8669,6,14,8,14,49,53,-4,50
Albion,8669,7,12,10,14,48,57,-9,46
Queen's Park,8669,8,13,6,17,44,59,-15,45
East Fife,8669,9,8,15,13,47,47,0,39
Stenhousem'r,8669,10,3,9,24,41,87,-46,18
Livingston,8670,1,22,4,10,85,59,26,70
Alloa,8670,2,19,5,12,68,50,18,62
Airdrieon,8670,3,16,10,10,58,50,8,58
Brechin,8670,4,17,5,14,47,47,0,56
Albion,8670,5,15,8,13,55,45,10,53
Peterhead,8670,6,13,7,16,49,59,-10,46
East Fife,8670,7,11,11,14,54,53,1,44
Stranraer,8670,8,13,5,18,48,53,-5,44
Queen's Park,8670,9,12,6,18,41,56,-15,42
Stenhousem'r,8670,10,7,9,20,46,79,-33,30
Livingston,8671,1,18,7,11,73,48,25,61
Airdrieon,8671,2,18,6,12,61,51,10,60
Alloa,8671,3,18,4,14,74,47,27,58
Brechin,8671,4,15,7,14,49,52,-3,52
Stranraer,8671,5,15,6,15,51,46,5,51
Albion,8671,6,14,8,14,62,60,2,50
Peterhead,8671,7,12,12,12,51,51,0,48
East Fife,8671,8,10,14,12,45,52,-7,44
Queen's Park,8671,9,12,7,17,38,61,-23,43
Stenhousem'r,8671,10,9,7,20,46,82,-36,34
Livingston,8672,1,22,5,9,90,50,40,71
Alloa,8672,2,19,10,7,70,39,31,67
Brechin,8672,3,16,6,14,42,46,-4,54
East Fife,8672,4,14,11,11,54,46,8,53
Airdrieon,8672,5,15,7,14,53,54,-1,52
Stranraer,8672,6,15,6,15,50,51,-1,51
Peterhead,8672,7,13,11,12,59,54,5,50
Albion,8672,8,12,8,16,45,59,-14,44
Queen's Park,8672,9,8,9,19,35,58,-23,33
Stenhousem'r,8672,10,7,5,24,45,86,-41,26
Livingston,8673,1,23,4,9,81,43,38,73
Alloa,8673,2,18,7,11,66,46,20,61
Brechin,8673,3,17,8,11,55,46,9,59
East Fife,8673,4,15,8,13,54,46,8,53
Peterhead,8673,5,16,5,15,48,57,-9,53
Albion,8673,6,14,7,15,51,50,1,49
Airdrieon,8673,7,14,7,15,61,70,-9,49
Queen's Park,8673,8,13,7,16,45,58,-13,46
Stranraer,8673,9,11,4,21,55,70,-15,37
Stenhousem'r,8673,10,8,5,23,51,81,-30,29
Alloa,8674,1,21,8,7,84,48,36,71
Livingston,8674,2,21,6,9,80,56,24,69
Brechin,8674,3,19,4,13,59,50,9,61
Airdrieon,8674,4,17,9,10,70,58,12,60
East Fife,8674,5,14,9,13,59,52,7,51
Peterhead,8674,6,11,10,15,63,69,-6,43
Albion,8674,7,11,7,18,49,58,-9,40
Stenhousem'r,8674,8,10,7,19,54,84,-30,37
Stranraer,8674,9,9,8,19,47,64,-17,35
Queen's Park,8674,10,8,10,18,37,63,-26,34
Livingston,8675,1,22,5,9,79,47,32,71
Alloa,8675,2,17,9,10,69,51,18,60
Airdrieon,8675,3,15,8,13,60,49,11,53
East Fife,8675,4,13,12,11,57,40,17,51
Albion,8675,5,15,6,15,53,53,0,51
Peterhead,8675,6,15,5,16,56,57,-1,50
Brechin,8675,7,15,5,16,56,58,-2,50
Stranraer,8675,8,13,8,15,55,59,-4,47
Queen's Park,8675,9,13,7,16,44,60,-16,46
Stenhousem'r,8675,10,6,7,23,39,94,-55,25
Livingston,8676,1,26,3,7,85,43,42,81
Peterhead,8676,2,16,9,11,53,44,9,57
Alloa,8676,3,16,7,13,67,52,15,55
Airdrieon,8676,4,16,7,13,58,61,-3,55
Brechin,8676,5,15,7,14,53,53,0,52
Stranraer,8676,6,13,8,15,53,59,-6,47
Albion,8676,7,11,11,14,59,61,-2,44
East Fife,8676,8,11,10,15,52,51,1,43
Queen's Park,8676,9,12,7,17,36,53,-17,43
Stenhousem'r,8676,10,7,5,24,42,81,-39,26
Alloa,8677,1,21,8,7,79,45,34,71
Airdrieon,8677,2,18,9,9,66,52,14,63
Brechin,8677,3,17,8,11,55,45,10,59
Livingston,8677,4,15,10,11,67,56,11,55
Peterhead,8677,5,16,7,13,52,53,-1,55
Stranraer,8677,6,12,7,17,55,63,-8,43
East Fife,8677,7,11,9,16,45,47,-2,42
Albion,8677,8,11,9,16,49,57,-8,42
Stenhousem'r,8677,9,9,8,19,53,76,-23,35
Queen's Park,8677,10,8,9,19,28,55,-27,33
Brechin,8678,1,17,8,11,52,51,1,59
Airdrieon,8678,2,17,8,11,55,57,-2,59
Livingston,8678,3,18,4,14,77,59,18,58
Alloa,8678,4,14,12,10,66,53,13,54
Peterhead,8678,5,14,8,14,49,46,3,50
Albion,8678,6,14,7,15,56,54,2,49
East Fife,8678,7,13,7,16,53,50,3,46
Stranraer,8678,8,13,7,16,52,55,-3,46
Queen's Park,8678,9,11,11,14,43,58,-15,44
Stenhousem'r,8678,10,10,6,20,62,82,-20,36
Livingston,8679,1,22,4,10,73,48,25,70
Airdrieon,8679,2,19,6,11,59,51,8,63
Alloa,8679,3,16,12,8,65,44,21,60
Brechin,8679,4,15,9,12,47,39,8,54
Albion,8679,5,14,10,12,52,42,10,52
East Fife,8679,6,14,10,12,50,42,8,52
Peterhead,8679,7,14,8,14,51,55,-4,50
Stranraer,8679,8,10,9,17,45,56,-11,39
Queen's Park,8679,9,7,8,21,26,56,-30,29
Stenhousem'r,8679,10,6,10,20,38,73,-35,28
Livingston,8680,1,23,4,9,83,43,40,73
Airdrieon,8680,2,19,5,12,66,60,6,62
Alloa,8680,3,15,11,10,64,45,19,56
Brechin,8680,4,16,8,12,47,44,3,56
Peterhead,8680,5,14,8,14,50,51,-1,50
Stranraer,8680,6,14,6,16,48,53,-5,48
East Fife,8680,7,12,9,15,50,46,4,45
Queen's Park,8680,8,12,8,16,38,49,-11,44
Albion,8680,9,10,11,15,47,62,-15,41
Stenhousem'r,8680,10,5,10,21,38,78,-40,25
Airdrieon,8681,1,20,6,10,60,39,21,66
Alloa,8681,2,20,5,11,65,44,21,65
Livingston,8681,3,19,3,14,71,51,20,60
Peterhead,8681,4,17,6,13,55,49,6,57
Brechin,8681,5,17,4,15,50,43,7,55
Albion,8681,6,15,7,14,47,45,2,52
Stranraer,8681,7,13,5,18,46,57,-11,44
Stenhousem'r,8681,8,11,7,18,52,75,-23,40
Queen's Park,8681,9,10,7,19,33,61,-28,37
East Fife,8681,10,9,8,19,46,61,-15,35
Brechin,8682,1,18,8,10,54,43,11,62
Airdrieon,8682,2,17,10,9,56,44,12,61
Livingston,8682,3,17,8,11,67,56,11,59
Alloa,8682,4,16,8,12,61,44,17,56
Albion,8682,5,15,9,12,55,40,15,54
Stranraer,8682,6,14,7,15,50,51,-1,49
Peterhead,8682,7,12,8,16,42,46,-4,44
Queen's Park,8682,8,10,10,16,32,52,-20,40
East Fife,8682,9,9,11,16,36,48,-12,38
Stenhousem'r,8682,10,8,9,19,44,73,-29,33
Livingston,8683,1,22,7,7,75,42,33,73
Alloa,8683,2,16,13,7,67,39,28,61
Albion,8683,3,17,9,10,57,42,15,60
Brechin,8683,4,16,6,14,45,46,-1,54
Airdrieon,8683,5,13,8,15,51,55,-4,47
Peterhead,8683,6,13,8,15,52,60,-8,47
East Fife,8683,7,12,9,15,52,49,3,45
Stranraer,8683,8,11,8,17,45,55,-10,41
Queen's Park,8683,9,9,8,19,31,57,-26,35
Stenhousem'r,8683,10,9,8,19,42,72,-30,35
Livingston,8684,1,18,8,10,67,47,20,62
Airdrieon,8684,2,16,12,8,53,51,2,60
Alloa,8684,3,16,11,9,67,40,27,59
Brechin,8684,4,15,6,15,40,53,-13,51
Albion,8684,5,14,7,15,59,51,8,49
Peterhead,8684,6,13,10,13,54,52,2,49
Queen's Park,8684,7,13,8,15,44,51,-7,47
East Fife,8684,8,11,13,12,47,42,5,46
Stranraer,8684,9,11,7,18,56,70,-14,40
Stenhousem'r,8684,10,9,6,21,50,80,-30,33
Alloa,8685,1,21,8,7,78,49,29,71
Livingston,8685,2,18,6,12,81,51,30,60
Stranraer,8685,3,16,9,11,63,51,12,57
Albion,8685,4,15,8,13,58,51,7,53
Peterhead,8685,5,16,4,16,55,52,3,52
Brechin,8685,6,15,6,15,58,56,2,51
Queen's Park,8685,7,13,10,13,47,56,-9,49
Airdrieon,8685,8,14,3,19,57,79,-22,45
East Fife,8685,9,11,10,15,56,63,-7,43
Stenhousem'r,8685,10,6,6,24,47,92,-45,24
Brechin,8686,1,18,6,12,55,44,11,60
Airdrieon,8686,2,17,8,11,61,52,9,59
Livingston,8686,3,17,5,14,71,56,15,56
Albion,8686,4,16,8,12,57,48,9,56
Alloa,8686,5,14,12,10,62,53,9,54
East Fife,8686,6,14,9,13,53,47,6,51
Stranraer,8686,7,15,4,17,55,62,-7,49
Queen's Park,8686,8,12,6,18,39,57,-18,42
Peterhead,8686,9,11,7,18,41,56,-15,40
Stenhousem'r,8686,10,8,11,17,47,66,-19,35
Livingston,8687,1,21,4,11,72,46,26,67
Airdrieon,8687,2,19,6,11,62,54,8,63
Alloa,8687,3,15,11,10,64,47,17,56
Brechin,8687,4,17,5,14,48,46,2,56
Albion,8687,5,15,9,12,60,46,14,54
East Fife,8687,6,14,9,13,56,46,10,51
Peterhead,8687,7,15,5,16,46,49,-3,50
Stranraer,8687,8,13,6,17,49,56,-7,45
Queen's Park,8687,9,12,8,16,35,56,-21,44
Stenhousem'r,8687,10,4,7,25,37,83,-46,19
Livingston,8688,1,21,6,9,81,54,27,69
Brechin,8688,2,19,7,10,49,39,10,64
Airdrieon,8688,3,17,6,13,61,52,9,57
Alloa,8688,4,16,7,13,69,54,15,55
Albion,8688,5,14,10,12,59,53,6,52
Peterhead,8688,6,13,10,13,55,58,-3,49
Stranraer,8688,7,14,7,15,51,57,-6,49
Queen's Park,8688,8,12,7,17,44,56,-12,43
East Fife,8688,9,8,8,20,43,53,-10,32
Stenhousem'r,8688,10,8,8,20,45,81,-36,32
Livingston,8689,1,22,5,9,86,47,39,71
Alloa,8689,2,19,8,9,69,46,23,65
Brechin,8689,3,18,6,12,47,43,4,60
Airdrieon,8689,4,17,8,11,63,50,13,59
Albion,8689,5,13,9,14,53,53,0,48
Stranraer,8689,6,14,6,16,55,61,-6,48
Queen's Park,8689,7,14,5,17,30,45,-15,47
East Fife,8689,8,12,8,16,39,45,-6,44
Peterhead,8689,9,10,8,18,43,58,-15,38
Stenhousem'r,8689,10,6,7,23,43,80,-37,25
Alloa,8690,1,20,6,10,69,39,30,66
Airdrieon,8690,2,20,4,12,68,56,12,64
Livingston,8690,3,18,7,11,74,49,25,61
Albion,8690,4,16,5,15,56,60,-4,53
Brechin,8690,5,15,5,16,49,52,-3,50
East Fife,8690,6,13,9,14,52,49,3,48
Stranraer,8690,7,13,9,14,51,53,-2,48
Peterhead,8690,8,13,9,14,43,49,-6,48
Queen's Park,8690,9,11,9,16,31,48,-17,42
Stenhousem'r,8690,10,7,5,24,37,75,-38,26
Brechin,8691,1,18,8,10,51,41,10,62
Livingston,8691,2,17,5,14,66,54,12,56
Alloa,8691,3,15,8,13,60,45,15,53
Peterhead,8691,4,14,11,11,53,53,0,53
East Fife,8691,5,14,9,13,57,51,6,51
Airdrieon,8691,6,15,5,16,52,56,-4,50
Stranraer,8691,7,15,2,19,47,56,-9,47
Albion,8691,8,12,10,14,54,52,2,46
Queen's Park,8691,9,13,6,17,40,54,-14,45
Stenhousem'r,8691,10,9,12,15,53,71,-18,39
Livingston,8692,1,21,4,11,66,49,17,67
East Fife,8692,2,19,6,11,66,37,29,63
Alloa,8692,3,17,8,11,63,48,15,59
Airdrieon,8692,4,17,8,11,64,54,10,59
Brechin,8692,5,16,7,13,47,40,7,55
Peterhead,8692,6,12,11,13,39,47,-8,47
Queen's Park,8692,7,12,8,16,35,52,-17,44
Albion,8692,8,10,10,16,44,57,-13,40
Stranraer,8692,9,11,6,19,53,57,-4,39
Stenhousem'r,8692,10,7,8,21,41,77,-36,29
Livingston,8693,1,21,5,10,78,46,32,68
Alloa,8693,2,19,8,9,79,49,30,65
Brechin,8693,3,17,6,13,52,49,3,57
Albion,8693,4,16,8,12,56,50,6,56
Airdrieon,8693,5,15,8,13,59,62,-3,53
Stranraer,8693,6,13,6,17,51,60,-9,45
Queen's Park,8693,7,13,6,17,38,51,-13,45
East Fife,8693,8,9,13,14,41,44,-3,40
Peterhead,8693,9,9,11,16,45,60,-15,38
Stenhousem'r,8693,10,9,7,20,45,73,-28,34
Airdrieon,8694,1,19,5,12,57,55,2,62
Alloa,8694,2,16,11,9,72,47,25,59
Livingston,8694,3,18,5,13,75,51,24,59
Brechin,8694,4,16,7,13,47,49,-2,55
Stranraer,8694,5,16,4,16,58,55,3,52
East Fife,8694,6,13,9,14,64,61,3,48
Peterhead,8694,7,12,9,15,55,62,-7,45
Queen's Park,8694,8,12,9,15,39,53,-14,45
Albion,8694,9,9,12,15,46,59,-13,39
Stenhousem'r,8694,10,9,9,18,50,71,-21,36
Livingston,8695,1,20,7,9,80,50,30,67
Alloa,8695,2,18,10,8,69,40,29,64
Brechin,8695,3,18,8,10,49,37,12,62
Airdrieon,8695,4,18,6,12,61,50,11,60
Peterhead,8695,5,14,10,12,50,53,-3,52
Queen's Park,8695,6,14,6,16,38,52,-14,48
Albion,8695,7,11,11,14,45,52,-7,44
Stranraer,8695,8,9,10,17,41,53,-12,37
Stenhousem'r,8695,9,7,10,19,47,81,-34,31
East Fife,8695,10,6,12,18,37,49,-12,30
Alloa,8696,1,21,3,12,79,48,31,66
Airdrieon,8696,2,19,6,11,57,42,15,63
Brechin,8696,3,17,7,12,53,46,7,58
Livingston,8696,4,16,7,13,66,53,13,55
Stranraer,8696,5,14,7,15,56,62,-6,49
Peterhead,8696,6,12,12,12,45,44,1,48
East Fife,8696,7,12,10,14,51,54,-3,46
Albion,8696,8,12,10,14,53,59,-6,46
Queen's Park,8696,9,11,9,16,37,51,-14,42
Stenhousem'r,8696,10,7,7,22,43,81,-38,28
Livingston,8697,1,24,6,6,85,36,49,78
Airdrieon,8697,2,18,9,9,62,46,16,63
Alloa,8697,3,16,11,9,60,41,19,59
Peterhead,8697,4,16,9,11,49,49,0,57
Brechin,8697,5,13,9,14,47,54,-7,48
Albion,8697,6,11,14,11,53,49,4,47
East Fife,8697,7,12,6,18,53,53,0,42
Stranraer,8697,8,8,12,16,43,59,-16,36
Stenhousem'r,8697,9,8,8,20,44,72,-28,32
Queen's Park,8697,10,7,10,19,24,61,-37,31
Livingston,8698,1,26,0,10,76,40,36,78
Alloa,8698,2,22,5,9,71,35,36,71
Queen's Park,8698,3,17,5,14,47,45,2,56
Albion,8698,4,17,5,14,55,54,1,56
Airdrieon,8698,5,13,6,17,51,58,-7,45
Peterhead,8698,6,13,5,18,49,57,-8,44
Stranraer,8698,7,13,5,18,42,51,-9,44
Brechin,8698,8,13,5,18,43,56,-13,44
Stenhousem'r,8698,9,12,5,19,51,74,-23,41
East Fife,8698,10,9,9,18,44,59,-15,36
Livingston,8699,1,24,4,8,93,43,50,76
Alloa,8699,2,24,4,8,81,49,32,76
Airdrieon,8699,3,17,6,13,53,50,3,57
Brechin,8699,4,15,6,15,51,54,-3,51
Albion,8699,5,15,4,17,53,54,-1,49
Queen's Park,8699,6,14,6,16,42,54,-12,48
Stranraer,8699,7,14,3,19,57,60,-3,45
Peterhead,8699,8,11,10,15,44,52,-8,43
East Fife,8699,9,10,8,18,50,58,-8,38
Stenhousem'r,8699,10,8,5,23,43,93,-50,29
Livingston,8700,1,20,4,12,68,52,16,64
Peterhead,8700,2,19,5,12,58,43,15,62
Alloa,8700,3,18,7,11,72,48,24,61
Airdrieon,8700,4,18,5,13,63,54,9,59
Queen's Park,8700,5,16,8,12,55,46,9,56
Brechin,8700,6,17,5,14,46,46,0,56
Albion,8700,7,14,5,17,57,57,0,47
Stenhousem'r,8700,8,9,8,19,42,66,-24,35
Stranraer,8700,9,9,8,19,41,69,-28,35
East Fife,8700,10,9,7,20,36,57,-21,34
Livingston,8701,1,20,4,12,76,49,27,64
Alloa,8701,2,18,5,13,73,54,19,59
Brechin,8701,3,18,4,14,50,51,-1,58
Airdrieon,8701,4,16,6,14,53,57,-4,54
Albion,8701,5,14,10,12,56,56,0,52
Peterhead,8701,6,12,10,14,46,51,-5,46
East Fife,8701,7,10,13,13,43,41,2,43
Stenhousem'r,8701,8,12,7,17,48,60,-12,43
Queen's Park,8701,9,11,10,15,33,49,-16,43
Stranraer,8701,10,12,5,19,49,59,-10,41
Livingston,8702,1,22,4,10,81,47,34,70
Alloa,8702,2,19,8,9,72,48,24,65
Airdrieon,8702,3,17,9,10,61,56,5,60
Albion,8702,4,17,7,12,53,46,7,58
Brechin,8702,5,16,5,15,45,46,-1,53
Peterhead,8702,6,12,12,12,47,48,-1,48
Queen's Park,8702,7,12,8,16,39,50,-11,44
East Fife,8702,8,10,9,17,39,44,-5,39
Stranraer,8702,9,10,7,19,50,64,-14,37
Stenhousem'r,8702,10,7,7,22,47,85,-38,28
Alloa,8703,1,23,5,8,79,37,42,74
Livingston,8703,2,22,3,11,80,49,31,69
Albion,8703,3,15,9,12,56,47,9,54
Queen's Park,8703,4,14,10,12,38,40,-2,52
Airdrieon,8703,5,14,8,14,53,60,-7,50
Stranraer,8703,6,13,10,13,58,56,2,49
Brechin,8703,7,12,7,17,39,54,-15,43
East Fife,8703,8,10,10,16,52,52,0,40
Peterhead,8703,9,10,7,19,41,63,-22,37
Stenhousem'r,8703,10,8,9,19,43,81,-38,33
Alloa,8704,1,17,10,9,75,48,27,61
Livingston,8704,2,16,8,12,76,54,22,56
Stranraer,8704,3,17,5,14,61,51,10,56
Brechin,8704,4,16,7,13,57,51,6,55
Queen's Park,8704,5,16,7,13,43,51,-8,55
Airdrieon,8704,6,15,7,14,52,52,0,52
Albion,8704,7,14,9,13,49,50,-1,51
East Fife,8704,8,13,8,15,48,47,1,47
Peterhead,8704,9,13,8,15,61,66,-5,47
Stenhousem'r,8704,10,5,7,24,42,94,-52,22
Brechin,8705,1,18,9,9,47,40,7,63
Livingston,8705,2,19,5,12,64,43,21,62
Alloa,8705,3,15,11,10,61,45,16,56
Peterhead,8705,4,15,11,10,52,44,8,56
Airdrieon,8705,5,16,7,13,52,51,1,55
Albion,8705,6,14,6,16,56,53,3,48
Stranraer,8705,7,14,6,16,48,52,-4,48
Queen's Park,8705,8,10,10,16,40,50,-10,40
East Fife,8705,9,9,12,15,51,61,-10,39
Stenhousem'r,8705,10,8,7,21,46,78,-32,31
Livingston,8706,1,24,4,8,82,41,41,76
Alloa,8706,2,20,7,9,65,45,20,67
Brechin,8706,3,17,6,13,53,45,8,57
Albion,8706,4,15,8,13,64,50,14,53
Airdrieon,8706,5,14,9,13,55,58,-3,51
Stranraer,8706,6,15,5,16,54,55,-1,50
East Fife,8706,7,12,7,17,48,50,-2,43
Queen's Park,8706,8,12,6,18,38,53,-15,42
Peterhead,8706,9,11,7,18,40,62,-22,40
Stenhousem'r,8706,10,7,7,22,44,84,-40,28
Livingston,8707,1,26,2,8,83,41,42,80
Alloa,8707,2,21,8,7,66,38,28,71
Albion,8707,3,16,6,14,50,51,-1,54
Stranraer,8707,4,16,5,15,61,54,7,53
Brechin,8707,5,15,7,14,49,44,5,52
Peterhead,8707,6,14,8,14,56,61,-5,50
Airdrieon,8707,7,11,10,15,51,63,-12,43
East Fife,8707,8,10,8,18,44,53,-9,38
Queen's Park,8707,9,10,6,20,30,51,-21,36
Stenhousem'r,8707,10,5,12,19,38,72,-34,27
Alloa,8708,1,21,6,9,80,46,34,69
Brechin,8708,2,18,4,14,56,46,10,58
Airdrieon,8708,3,16,8,12,67,58,9,56
Livingston,8708,4,17,4,15,75,60,15,55
Queen's Park,8708,5,13,9,14,39,50,-11,48
Albion,8708,6,12,11,13,56,61,-5,47
Peterhead,8708,7,13,8,15,51,62,-11,47
Stranraer,8708,8,14,4,18,57,64,-7,46
East Fife,8708,9,11,10,15,52,53,-1,43
Stenhousem'r,8708,10,9,8,19,42,75,-33,35
Alloa,8709,1,20,7,9,75,42,33,67
Livingston,8709,2,19,8,9,65,36,29,65
Airdrieon,8709,3,16,9,11,53,49,4,57
Brechin,8709,4,17,6,13,56,58,-2,57
Peterhead,8709,5,15,10,11,55,56,-1,55
Queen's Park,8709,6,14,9,13,42,45,-3,51
Stranraer,8709,7,12,6,18,51,61,-10,42
East Fife,8709,8,10,10,16,40,40,0,40
Albion,8709,9,8,11,17,40,58,-18,35
Stenhousem'r,8709,10,6,10,20,52,84,-32,28
Livingston,8710,1,24,3,9,94,45,49,75
Alloa,8710,2,20,7,9,83,47,36,67
Airdrieon,8710,3,17,7,12,51,51,0,58
Queen's Park,8710,4,14,8,14,45,56,-11,50
Brechin,8710,5,14,6,16,53,52,1,48
Peterhead,8710,6,13,9,14,49,53,-4,48
East Fife,8710,7,13,8,15,56,51,5,47
Stranraer,8710,8,12,6,18,41,67,-26,42
Albion,8710,9,10,9,17,46,58,-12,39
Stenhousem'r,8710,10,7,9,20,44,82,-38,30
Livingston,8711,1,20,9,7,76,44,32,69
Alloa,8711,2,18,10,8,73,45,28,64
Airdrieon,8711,3,18,8,10,57,56,1,62
Peterhead,8711,4,16,7,13,54,57,-3,55
Brechin,8711,5,16,4,16,47,49,-2,52
Queen's Park,8711,6,14,8,14,41,40,1,50
Albion,8711,7,11,10,15,47,58,-11,43
Stranraer,8711,8,10,8,18,44,57,-13,38
East Fife,8711,9,9,8,19,46,56,-10,35
Stenhousem'r,8711,10,8,8,20,48,71,-23,32
Alloa,8712,1,20,6,10,71,47,24,66
Livingston,8712,2,20,5,11,83,56,27,65
Albion,8712,3,16,9,11,53,45,8,57
Peterhead,8712,4,16,8,12,58,52,6,56
Airdrieon,8712,5,17,5,14,59,55,4,56
Brechin,8712,6,16,6,14,55,55,0,54
East Fife,8712,7,11,9,16,49,41,8,42
Stranraer,8712,8,12,5,19,53,66,-13,41
Queen's Park,8712,9,10,10,16,37,56,-19,40
Stenhousem'r,8712,10,7,7,22,44,89,-45,28
Livingston,8713,1,20,7,9,74,44,30,67
Alloa,8713,2,18,7,11,69,43,26,61
Airdrieon,8713,3,17,8,11,58,51,7,59
Peterhead,8713,4,16,8,12,52,52,0,56
Brechin,8713,5,16,8,12,51,52,-1,56
Queen's Park,8713,6,14,8,14,35,41,-6,50
Albion,8713,7,11,12,13,50,50,0,45
Stranraer,8713,8,12,4,20,50,66,-16,40
East Fife,8713,9,9,10,17,51,58,-7,37
Stenhousem'r,8713,10,6,10,20,49,82,-33,28
Livingston,8714,1,22,3,11,80,45,35,69
Alloa,8714,2,17,12,7,79,46,33,63
Brechin,8714,3,16,11,9,47,42,5,59
Peterhead,8714,4,13,12,11,44,46,-2,51
Queen's Park,8714,5,15,6,15,45,54,-9,51
East Fife,8714,6,14,7,15,56,48,8,49
Airdrieon,8714,7,13,9,14,57,55,2,48
Stranraer,8714,8,11,6,19,45,60,-15,39
Albion,8714,9,9,11,16,44,59,-15,38
Stenhousem'r,8714,10,7,9,20,42,84,-42,30
Livingston,8715,1,24,5,7,86,39,47,77
Alloa,8715,2,19,5,12,74,46,28,62
East Fife,8715,3,15,8,13,50,41,9,53
Brechin,8715,4,16,5,15,53,56,-3,53
Airdrieon,8715,5,15,7,14,58,63,-5,52
Albion,8715,6,12,12,12,58,61,-3,48
Peterhead,8715,7,11,8,17,48,59,-11,41
Stranraer,8715,8,11,8,17,42,58,-16,41
Stenhousem'r,8715,9,10,10,16,48,70,-22,40
Queen's Park,8715,10,10,6,20,38,62,-24,36
Alloa,8716,1,21,6,9,76,42,34,69
Livingston,8716,2,20,7,9,78,45,33,67
Queen's Park,8716,3,18,6,12,46,39,7,60
Peterhead,8716,4,16,5,15,58,48,10,53
Albion,8716,5,15,5,16,54,59,-5,50
Stranraer,8716,6,14,6,16,55,60,-5,48
Brechin,8716,7,11,11,14,43,55,-12,44
Airdrieon,8716,8,12,7,17,46,58,-12,43
East Fife,8716,9,10,8,18,48,56,-8,38
Stenhousem'r,8716,10,9,7,20,54,96,-42,34
Livingston,8717,1,20,6,10,84,52,32,66
Brechin,8717,2,17,9,10,55,43,12,60
Airdrieon,8717,3,17,6,13,56,51,5,57
Albion,8717,4,16,8,12,60,54,6,56
Alloa,8717,5,15,10,11,68,44,24,55
Peterhead,8717,6,15,5,16,51,53,-2,50
Queen's Park,8717,7,13,7,16,36,49,-13,46
Stranraer,8717,8,13,6,17,46,64,-18,45
East Fife,8717,9,8,11,17,39,52,-13,35
Stenhousem'r,8717,10,9,6,21,46,79,-33,33
Brechin,8718,1,21,7,8,59,45,14,70
Livingston,8718,2,21,1,14,75,54,21,64
Alloa,8718,3,18,4,14,73,55,18,58
Albion,8718,4,16,10,10,65,54,11,58
Peterhead,8718,5,17,7,12,56,53,3,58
Airdrieon,8718,6,17,6,13,62,56,6,57
Queen's Park,8718,7,11,11,14,47,58,-11,44
East Fife,8718,8,9,10,17,48,55,-7,37
Stranraer,8718,9,9,4,23,47,71,-24,31
Stenhousem'r,8718,10,7,8,21,44,75,-31,29
Livingston,8719,1,19,5,12,67,44,23,62
Queen's Park,8719,2,17,8,11,45,44,1,59
Alloa,8719,3,15,7,14,66,52,14,52
Airdrieon,8719,4,14,9,13,55,50,5,51
East Fife,8719,5,12,13,11,53,48,5,49
Brechin,8719,6,13,10,13,53,55,-2,49
Albion,8719,7,12,12,12,53,49,4,48
Peterhead,8719,8,12,9,15,43,55,-12,45
Stranraer,8719,9,12,8,16,48,57,-9,44
Stenhousem'r,8719,10,9,9,18,46,75,-29,36
Alloa,8720,1,20,10,6,72,34,38,70
Livingston,8720,2,19,7,10,71,44,27,64
Airdrieon,8720,3,18,6,12,58,45,13,60
Brechin,8720,4,19,3,14,58,60,-2,60
Peterhead,8720,5,15,8,13,51,51,0,53
Albion,8720,6,14,9,13,50,52,-2,51
Queen's Park,8720,7,12,7,17,37,45,-8,43
East Fife,8720,8,11,8,17,46,47,-1,41
Stranraer,8720,9,11,5,20,44,69,-25,38
Stenhousem'r,8720,10,5,9,22,41,81,-40,24
Livingston,8721,1,21,5,10,76,54,22,68
Alloa,8721,2,18,9,9,76,46,30,63
Airdrieon,8721,3,18,8,10,73,55,18,62
Brechin,8721,4,16,6,14,45,47,-2,54
East Fife,8721,5,15,7,14,55,47,8,52
Albion,8721,6,14,7,15,55,57,-2,49
Stranraer,8721,7,13,9,14,51,55,-4,48
Peterhead,8721,8,12,9,15,50,66,-16,45
Queen's Park,8721,9,11,7,18,35,52,-17,40
Stenhousem'r,8721,10,4,9,23,47,84,-37,21
Livingston,8722,1,21,3,12,79,45,34,66
Airdrieon,8722,2,21,3,12,60,52,8,66
Alloa,8722,3,17,8,11,63,48,15,59
Albion,8722,4,18,5,13,51,49,2,59
Brechin,8722,5,17,7,12,55,49,6,58
East Fife,8722,6,15,5,16,64,49,15,50
Stranraer,8722,7,13,7,16,44,54,-10,46
Peterhead,8722,8,11,6,19,48,60,-12,39
Queen's Park,8722,9,9,9,18,29,59,-30,36
Stenhousem'r,8722,10,9,5,22,58,86,-28,32
Livingston,8723,1,19,9,8,67,41,26,66
Alloa,8723,2,16,10,10,63,47,16,58
Brechin,8723,3,16,7,13,52,43,9,55
Peterhead,8723,4,16,7,13,51,47,4,55
Albion,8723,5,15,8,13,52,47,5,53
Airdrieon,8723,6,15,8,13,51,52,-1,53
Stranraer,8723,7,12,8,16,54,55,-1,44
East Fife,8723,8,11,11,14,45,47,-2,44
Queen's Park,8723,9,10,6,20,27,49,-22,36
Stenhousem'r,8723,10,8,10,18,44,78,-34,34
Alloa,8724,1,19,10,7,68,38,30,67
Livingston,8724,2,20,6,10,82,55,27,66
Airdrieon,8724,3,18,6,12,61,54,7,60
Peterhead,8724,4,14,11,11,60,52,8,53
Brechin,8724,5,14,10,12,43,43,0,52
East Fife,8724,6,14,8,14,50,45,5,50
Albion,8724,7,13,9,14,49,54,-5,48
Stranraer,8724,8,14,5,17,57,62,-5,47
Queen's Park,8724,9,10,4,22,37,62,-25,34
Stenhousem'r,8724,10,7,5,24,46,88,-42,26
Livingston,8725,1,20,6,10,81,57,24,66
Alloa,8725,2,19,8,9,68,39,29,65
Airdrieon,8725,3,17,7,12,57,54,3,58
East Fife,8725,4,15,11,10,60,46,14,56
Brechin,8725,5,14,11,11,50,47,3,53
Albion,8725,6,14,6,16,57,59,-2,48
Peterhead,8725,7,12,11,13,45,54,-9,47
Queen's Park,8725,8,13,6,17,36,47,-11,45
Stranraer,8725,9,11,5,20,49,61,-12,38
Stenhousem'r,8725,10,5,9,22,44,83,-39,24
Livingston,8726,1,24,2,10,83,41,42,74
Alloa,8726,2,17,9,10,68,48,20,60
Peterhead,8726,3,16,8,12,47,45,2,56
Airdrieon,8726,4,16,4,16,64,71,-7,52
Brechin,8726,5,15,5,16,54,58,-4,50
Stranraer,8726,6,14,5,17,54,55,-1,47
Albion,8726,7,14,5,17,48,50,-2,47
Queen's Park,8726,8,13,7,16,43,54,-11,46
East Fife,8726,9,10,11,15,42,50,-8,41
Stenhousem'r,8726,10,10,6,20,50,81,-31,36
Alloa,8727,1,23,6,7,89,50,39,75
Livingston,8727,2,19,4,13,62,45,17,61
Airdrieon,8727,3,17,7,12,62,56,6,58
Brechin,8727,4,14,11,11,45,41,4,53
Stranraer,8727,5,16,5,15,52,51,1,53
Queen's Park,8727,6,12,8,16,33,44,-11,44
Peterhead,8727,7,11,9,16,42,60,-18,42
Albion,8727,8,10,10,16,51,61,-10,40
East Fife,8727,9,10,9,17,42,45,-3,39
Stenhousem'r,8727,10,9,9,18,52,77,-25,36
Brechin,8728,1,17,11,8,47,39,8,62
Livingston,8728,2,17,7,12,68,52,16,58
Stranraer,8728,3,18,4,14,65,49,16,58
Alloa,8728,4,16,9,11,66,39,27,57
Airdrieon,8728,5,15,7,14,54,58,-4,52
Albion,8728,6,14,9,13,50,51,-1,51
Peterhead,8728,7,14,8,14,56,59,-3,50
Queen's Park,8728,8,13,10,13,38,49,-11,49
East Fife,8728,9,7,11,18,47,61,-14,32
Stenhousem'r,8728,10,8,6,22,50,84,-34,30
Livingston,8729,1,23,1,12,78,50,28,70
Alloa,8729,2,20,8,8,82,42,40,68
Brechin,8729,3,19,8,9,47,39,8,65
East Fife,8729,4,13,9,14,48,42,6,48
Stranraer,8729,5,14,6,16,49,61,-12,48
Queen's Park,8729,6,13,7,16,38,51,-13,46
Airdrieon,8729,7,13,6,17,51,56,-5,45
Albion,8729,8,13,6,17,57,63,-6,45
Peterhead,8729,9,12,7,17,57,63,-6,43
Stenhousem'r,8729,10,9,4,23,40,80,-40,31
Livingston,8730,1,20,6,10,72,44,28,66
Alloa,8730,2,17,9,10,73,47,26,60
Brechin,8730,3,18,6,12,56,41,15,60
Airdrieon,8730,4,16,9,11,50,47,3,57
East Fife,8730,5,13,10,13,49,47,2,49
Albion,8730,6,13,9,14,52,51,1,48
Peterhead,8730,7,13,8,15,46,50,-4,47
Queen's Park,8730,8,10,12,14,38,54,-16,42
Stranraer,8730,9,11,6,19,50,62,-12,39
Stenhousem'r,8730,10,8,7,21,39,82,-43,31
Livingston,8731,1,23,2,11,83,45,38,71
Alloa,8731,2,21,8,7,70,43,27,71
Airdrieon,8731,3,18,8,10,64,50,14,62
Brechin,8731,4,15,7,14,43,47,-4,52
Albion,8731,5,13,8,15,59,64,-5,47
Queen's Park,8731,6,13,7,16,46,54,-8,46
East Fife,8731,7,11,11,14,48,48,0,44
Peterhead,8731,8,10,10,16,56,62,-6,40
Stenhousem'r,8731,9,7,13,16,49,75,-26,34
Stranraer,8731,10,9,6,21,43,73,-30,33
Livingston,8732,1,20,4,12,81,45,36,64
Alloa,8732,2,18,6,12,68,45,23,60
Brechin,8732,3,16,7,13,46,43,3,55
Airdrieon,8732,4,15,10,11,57,55,2,55
Peterhead,8732,5,16,6,14,51,60,-9,54
Albion,8732,6,13,13,10,55,54,1,52
Stranraer,8732,7,16,4,16,53,58,-5,52
Queen's Park,8732,8,13,8,15,40,48,-8,47
East Fife,8732,9,10,12,14,55,53,2,42
Stenhousem'r,8732,10,3,10,23,36,81,-45,19
Livingston,8733,1,24,2,10,77,50,27,74
Alloa,8733,2,16,10,10,59,47,12,58
Airdrieon,8733,3,16,8,12,63,50,13,56
Peterhead,8733,4,15,7,14,58,55,3,52
Albion,8733,5,15,7,14,54,51,3,52
Brechin,8733,6,14,9,13,48,49,-1,51
Stranraer,8733,7,13,10,13,59,57,2,49
Queen's Park,8733,8,11,6,19,32,53,-21,39
Stenhousem'r,8733,9,9,10,17,50,72,-22,37
East Fife,8733,10,7,11,18,35,51,-16,32
Alloa,8734,1,21,4,11,73,45,28,67
Airdrieon,8734,2,19,7,10,54,45,9,64
Livingston,8734,3,18,7,11,78,53,25,61
Albion,8734,4,15,8,13,53,48,5,53
Queen's Park,8734,5,13,9,14,42,46,-4,48
Brechin,8734,6,13,8,15,41,50,-9,47
East Fife,8734,7,11,11,14,46,51,-5,44
Stranraer,8734,8,13,5,18,44,53,-9,44
Stenhousem'r,8734,9,9,12,15,45,64,-19,39
Peterhead,8734,10,7,11,18,37,58,-21,32
Alloa,8735,1,23,7,6,83,37,46,76
Airdrieon,8735,2,20,6,10,69,50,19,66
Peterhead,8735,3,18,6,12,50,44,6,60
Livingston,8735,4,16,9,11,69,52,17,57
Brechin,8735,5,15,4,17,48,52,-4,49
Albion,8735,6,14,5,17,49,62,-13,47
Queen's Park,8735,7,12,9,15,43,54,-11,45
East Fife,8735,8,11,9,16,41,42,-1,42
Stranraer,8735,9,11,5,20,49,65,-16,38
Stenhousem'r,8735,10,7,6,23,46,89,-43,27
Alloa,8736,1,19,11,6,65,38,27,68
Livingston,8736,2,20,6,10,71,50,21,66
Airdrieon,8736,3,16,8,12,60,48,12,56
Albion,8736,4,15,8,13,50,48,2,53
Brechin,8736,5,14,8,14,45,53,-8,50
East Fife,8736,6,11,12,13,49,46,3,45
Stenhousem'r,8736,7,13,6,17,58,71,-13,45
Peterhead,8736,8,11,8,17,44,53,-9,41
Queen's Park,8736,9,9,11,16,31,47,-16,38
Stranraer,8736,10,11,4,21,41,60,-19,37
Livingston,8737,1,23,3,10,85,41,44,72
Alloa,8737,2,20,6,10,63,36,27,66
Airdrieon,8737,3,19,5,12,61,52,9,62
Brechin,8737,4,14,10,12,45,44,1,52
Albion,8737,5,14,8,14,52,58,-6,50
Queen's Park,8737,6,12,9,15,32,43,-11,45
Peterhead,8737,7,12,8,16,37,46,-9,44
Stranraer,8737,8,13,3,20,51,67,-16,42
East Fife,8737,9,11,8,17,45,49,-4,41
Stenhousem'r,8737,10,8,8,20,42,77,-35,32
Livingston,8738,1,21,2,13,83,53,30,65
Brechin,8738,2,19,6,11,54,52,2,63
Alloa,8738,3,17,7,12,69,52,17,58
Airdrieon,8738,4,17,7,12,58,56,2,58
Albion,8738,5,14,7,15,56,53,3,49
Peterhead,8738,6,14,5,17,56,58,-2,47
East Fife,8738,7,11,11,14,36,38,-2,44
Stranraer,8738,8,12,6,18,47,54,-7,42
Queen's Park,8738,9,12,6,18,34,50,-16,42
Stenhousem'r,8738,10,10,9,17,48,75,-27,39
Alloa,8739,1,20,10,6,78,37,41,70
Livingston,8739,2,19,7,10,64,41,23,64
Airdrieon,8739,3,19,5,12,57,53,4,62
Brechin,8739,4,19,4,13,58,52,6,61
Queen's Park,8739,5,13,10,13,38,43,-5,49
Albion,8739,6,12,8,16,51,54,-3,44
Peterhead,8739,7,11,9,16,48,55,-7,42
Stranraer,8739,8,12,6,18,53,67,-14,42
Stenhousem'r,8739,9,9,8,19,39,74,-35,35
East Fife,8739,10,8,9,19,52,62,-10,33
Airdrieon,8740,1,18,9,9,63,52,11,63
Livingston,8740,2,19,5,12,75,48,27,62
Alloa,8740,3,18,8,10,64,46,18,62
Albion,8740,4,14,10,12,54,47,7,52
Peterhead,8740,5,15,6,15,46,52,-6,51
Stranraer,8740,6,14,7,15,46,50,-4,49
Brechin,8740,7,14,6,16,46,52,-6,48
Queen's Park,8740,8,13,6,17,39,48,-9,45
East Fife,8740,9,9,12,15,48,58,-10,39
Stenhousem'r,8740,10,8,7,21,43,71,-28,31
Airdrieon,8741,1,19,6,11,73,57,16,63
Alloa,8741,2,17,9,10,72,50,22,60
Livingston,8741,3,17,6,13,74,59,15,57
Peterhead,8741,4,14,10,12,54,50,4,52
Stranraer,8741,5,16,4,16,54,59,-5,52
Brechin,8741,6,14,8,14,49,51,-2,50
East Fife,8741,7,14,5,17,58,52,6,47
Queen's Park,8741,8,11,12,13,44,54,-10,45
Albion,8741,9,11,8,17,48,64,-16,41
Stenhousem'r,8741,10,9,8,19,52,82,-30,35
Alloa,8742,1,21,8,7,66,39,27,71
Livingston,8742,2,21,6,9,79,45,34,69
Airdrieon,8742,3,19,7,10,59,51,8,64
East Fife,8742,4,16,7,13,59,47,12,55
Brechin,8742,5,15,6,15,46,39,7,51
Peterhead,8742,6,12,8,16,41,53,-12,44
Queen's Park,8742,7,12,6,18,38,59,-21,42
Albion,8742,8,11,8,17,43,47,-4,41
Stranraer,8742,9,12,5,19,47,62,-15,41
Stenhousem'r,8742,10,6,9,21,47,83,-36,27
Livingston,8743,1,21,6,9,80,42,38,69
Alloa,8743,2,17,9,10,67,45,22,60
Airdrieon,8743,3,15,13,8,57,47,10,58
Peterhead,8743,4,16,10,10,57,52,5,58
Albion,8743,5,13,10,13,49,48,1,49
Brechin,8743,6,14,7,15,50,53,-3,49
Queen's Park,8743,7,13,7,16,31,42,-11,46
Stranraer,8743,8,9,9,18,47,70,-23,36
Stenhousem'r,8743,9,9,9,18,47,73,-26,36
East Fife,8743,10,9,8,19,48,61,-13,35
Airdrieon,8744,1,19,5,12,65,48,17,62
Alloa,8744,2,16,10,10,64,47,17,58
Albion,8744,3,17,5,14,58,47,11,56
Brechin,8744,4,17,5,14,58,53,5,56
Livingston,8744,5,16,6,14,65,62,3,54
Stranraer,8744,6,16,5,15,52,55,-3,53
East Fife,8744,7,12,10,14,49,51,-2,46
Peterhead,8744,8,12,10,14,52,61,-9,46
Queen's Park,8744,9,10,9,17,37,53,-16,39
Stenhousem'r,8744,10,10,5,21,56,79,-23,35
Livingston,8745,1,22,4,10,71,47,24,70
Airdrieon,8745,2,17,6,13,64,53,11,57
Alloa,8745,3,16,7,13,63,46,17,55
Brechin,8745,4,15,9,12,49,46,3,54
Stranraer,8745,5,14,11,11,60,52,8,53
Peterhead,8745,6,13,9,14,52,53,-1,48
East Fife,8745,7,12,10,14,49,47,2,46
Queen's Park,8745,8,12,10,14,36,51,-15,46
Albion,8745,9,9,13,14,43,47,-4,40
Stenhousem'r,8745,10,5,11,20,38,83,-45,26
Livingston,8746,1,27,2,7,89,47,42,83
Alloa,8746,2,18,9,9,70,43,27,63
Airdrieon,8746,3,18,7,11,60,53,7,61
Brechin,8746,4,18,6,12,57,45,12,60
Stranraer,8746,5,15,4,17,49,55,-6,49
Peterhead,8746,6,13,7,16,50,53,-3,46
Albion,8746,7,12,5,19,49,60,-11,41
Queen's Park,8746,8,11,8,17,41,57,-16,41
East Fife,8746,9,11,6,19,49,56,-7,39
Stenhousem'r,8746,10,7,6,23,49,94,-45,27
Livingston,8747,1,22,5,9,83,52,31,71
Brechin,8747,2,19,3,14,64,51,13,60
Alloa,8747,3,17,8,11,73,56,17,59
Airdrieon,8747,4,16,10,10,62,55,7,58
Albion,8747,5,16,9,11,60,50,10,57
East Fife,8747,6,15,9,12,55,47,8,54
Peterhead,8747,7,14,7,15,56,56,0,49
Stranraer,8747,8,12,5,19,56,66,-10,41
Queen's Park,8747,9,9,7,20,34,62,-28,34
Stenhousem'r,8747,10,4,9,23,47,95,-48,21
Airdrieon,8748,1,24,2,10,62,45,17,74
Livingston,8748,2,23,3,10,86,51,35,72
Alloa,8748,3,20,6,10,69,46,23,66
Brechin,8748,4,17,3,16,52,57,-5,54
Albion,8748,5,13,8,15,59,61,-2,47
Peterhead,8748,6,13,7,16,51,55,-4,46
East Fife,8748,7,12,8,16,52,57,-5,44
Queen's Park,8748,8,12,7,17,46,59,-13,43
Stranraer,8748,9,12,3,21,57,61,-4,39
Stenhousem'r,8748,10,7,7,22,39,81,-42,28
Alloa,8749,1,18,10,8,71,43,28,64
Livingston,8749,2,19,6,11,80,62,18,63
Airdrieon,8749,3,19,5,12,73,62,11,62
Peterhead,8749,4,13,11,12,50,50,0,50
Brechin,8749,5,14,7,15,47,51,-4,49
Stranraer,8749,6,15,3,18,61,67,-6,48
Queen's Park,8749,7,14,6,16,45,51,-6,48
East Fife,8749,8,12,10,14,59,56,3,46
Albion,8749,9,12,8,16,44,52,-8,44
Stenhousem'r,8749,10,6,10,20,48,84,-36,28
Livingston,8750,1,22,5,9,76,45,31,71
Alloa,8750,2,18,10,8,62,39,23,64
Brechin,8750,3,18,8,10,58,43,15,62
Airdrieon,8750,4,15,10,11,57,51,6,55
Albion,8750,5,12,8,16,48,53,-5,44
Stranraer,8750,6,13,5,18,53,59,-6,44
Peterhead,8750,7,12,8,16,48,58,-10,44
East Fife,8750,8,12,6,18,46,48,-2,42
Queen's Park,8750,9,11,9,16,36,60,-24,42
Stenhousem'r,8750,10,8,9,19,53,81,-28,33
Alloa,8751,1,20,7,9,72,40,32,67
Livingston,8751,2,19,7,10,85,59,26,64
Brechin,8751,3,19,6,11,54,46,8,63
Albion,8751,4,16,9,11,60,51,9,57
Airdrieon,8751,5,17,5,14,62,63,-1,56
Stranraer,8751,6,14,4,18,53,61,-8,46
Peterhead,8751,7,13,6,17,52,56,-4,45
Queen's Park,8751,8,10,9,17,42,62,-20,39
East Fife,8751,9,8,11,17,39,51,-12,35
Stenhousem'r,8751,10,9,6,21,53,83,-30,33
Livingston,8752,1,19,5,12,66,53,13,62
Airdrieon,8752,2,18,7,11,63,60,3,61
Alloa,8752,3,18,5,13,69,44,25,59
Brechin,8752,4,17,6,13,55,51,4,57
Peterhead,8752,5,17,5,14,64,58,6,56
Stranraer,8752,6,14,6,16,55,55,0,48
East Fife,8752,7,12,10,14,52,49,3,46
Albion,8752,8,13,7,16,48,57,-9,46
Queen's Park,8752,9,9,10,17,37,56,-19,37
Stenhousem'r,8752,10,9,7,20,59,85,-26,34
Livingston,8753,1,23,2,11,77,43,34,71
Brechin,8753,2,19,7,10,60,40,20,64
Alloa,8753,3,17,8,11,63,43,20,59
Albion,8753,4,13,11,12,55,58,-3,50
Airdrieon,8753,5,14,7,15,66,73,-7,49
Peterhead,8753,6,13,9,14,47,49,-2,48
Stranraer,8753,7,13,4,19,49,56,-7,43
East Fife,8753,8,11,9,16,45,56,-11,42
Stenhousem'r,8753,9,11,7,18,51,79,-28,40
Queen's Park,8753,10,10,8,18,48,64,-16,38
Livingston,8754,1,20,4,12,67,47,20,64
Stranraer,8754,2,19,4,13,60,48,12,61
Alloa,8754,3,16,9,11,70,50,20,57
Airdrieon,8754,4,17,5,14,58,58,0,56
Peterhead,8754,5,14,10,12,43,48,-5,52
Queen's Park,8754,6,15,5,16,37,47,-10,50
Albion,8754,7,14,6,16,49,49,0,48
East Fife,8754,8,12,9,15,43,40,3,45
Brechin,8754,9,13,4,19,47,65,-18,43
Stenhousem'r,8754,10,8,8,20,48,70,-22,32
Livingston,8755,1,24,4,8,79,34,45,76
Airdrieon,8755,2,19,5,12,60,57,3,62
Brechin,8755,3,20,1,15,59,49,10,61
Alloa,8755,4,17,8,11,71,52,19,59
Peterhead,8755,5,16,6,14,51,56,-5,54
Albion,8755,6,15,8,13,55,53,2,53
East Fife,8755,7,13,8,15,50,48,2,47
Stranraer,8755,8,13,6,17,50,58,-8,45
Queen's Park,8755,9,10,3,23,37,62,-25,33
Stenhousem'r,8755,10,6,5,25,48,91,-43,23
Alloa,8756,1,19,7,10,79,51,28,64
Airdrieon,8756,2,20,2,14,67,52,15,62
Livingston,8756,3,18,7,11,69,49,20,61
Albion,8756,4,17,9,10,61,48,13,60
Brechin,8756,5,17,3,16,55,57,-2,54
Queen's Park,8756,6,14,6,16,43,54,-11,48
Stranraer,8756,7,13,6,17,49,64,-15,45
Peterhead,8756,8,11,7,18,51,66,-15,40
East Fife,8756,9,11,6,19,37,44,-7,39
Stenhousem'r,8756,10,10,7,19,50,76,-26,37
Alloa,8757,1,19,9,8,81,50,31,66
Livingston,8757,2,20,5,11,72,47,25,65
Airdrieon,8757,3,17,7,12,57,53,4,58
East Fife,8757,4,15,9,12,59,45,14,54
Brechin,8757,5,15,5,16,50,56,-6,50
Albion,8757,6,13,8,15,61,60,1,47
Queen's Park,8757,7,13,7,16,33,47,-14,46
Stenhousem'r,8757,8,13,4,19,55,68,-13,43
Stranraer,8757,9,12,4,20,48,64,-16,40
Peterhead,8757,10,12,4,20,44,70,-26,40
Alloa,8758,1,21,10,5,84,39,45,73
Livingston,8758,2,23,3,10,78,50,28,72
Brechin,8758,3,14,9,13,51,49,2,51
Airdrieon,8758,4,14,8,14,55,54,1,50
Queen's Park,8758,5,13,10,13,35,46,-11,49
Stranraer,8758,6,12,11,13,55,53,2,47
Albion,8758,7,11,10,15,39,47,-8,43
Peterhead,8758,8,10,13,13,44,58,-14,43
East Fife,8758,9,9,12,15,46,53,-7,39
Stenhousem'r,8758,10,6,8,22,35,73,-38,26
Livingston,8759,1,26,3,7,81,36,45,81
Airdrieon,8759,2,19,6,11,65,53,12,63
Brechin,8759,3,19,5,12,62,55,7,62
Alloa,8759,4,17,7,12,61,46,15,58
Albion,8759,5,16,8,12,61,48,13,56
East Fife,8759,6,11,12,13,56,54,2,45
Peterhead,8759,7,12,9,15,44,58,-14,45
Stranraer,8759,8,13,1,22,51,71,-20,40
Queen's Park,8759,9,8,9,19,37,58,-21,33
Stenhousem'r,8759,10,4,10,22,40,79,-39,22
Livingston,8760,1,19,7,10,73,45,28,64
Airdrieon,8760,2,18,8,10,60,43,17,62
Alloa,8760,3,14,12,10,65,49,16,54
Queen's Park,8760,4,14,11,11,37,45,-8,53
Stranraer,8760,5,14,9,13,45,45,0,51
Brechin,8760,6,15,6,15,48,51,-3,51
Peterhead,8760,7,11,12,13,49,58,-9,45
Albion,8760,8,11,9,16,44,56,-12,42
Stenhousem'r,8760,9,8,12,16,46,65,-19,36
East Fife,8760,10,7,12,17,40,50,-10,33
Alloa,8761,1,20,8,8,78,44,34,68
Livingston,8761,2,19,3,14,66,53,13,60
Airdrieon,8761,3,18,6,12,64,51,13,60
Brechin,8761,4,18,5,13,58,47,11,59
Peterhead,8761,5,16,4,16,46,55,-9,52
Albion,8761,6,12,9,15,43,50,-7,45
Queen's Park,8761,7,11,12,13,35,46,-11,45
East Fife,8761,8,11,11,14,50,44,6,44
Stranraer,8761,9,10,7,19,43,63,-20,37
Stenhousem'r,8761,10,8,9,19,44,74,-30,33
Alloa,8762,1,23,7,6,75,31,44,76
Livingston,8762,2,20,4,12,80,52,28,64
Airdrieon,8762,3,19,4,13,55,53,2,61
Brechin,8762,4,17,7,12,54,50,4,58
East Fife,8762,5,14,9,13,51,48,3,51
Albion,8762,6,13,9,14,48,50,-2,48
Peterhead,8762,7,13,6,17,45,52,-7,45
Stranraer,8762,8,12,6,18,54,61,-7,42
Queen's Park,8762,9,9,7,20,31,57,-26,34
Stenhousem'r,8762,10,6,9,21,50,89,-39,27
Airdrieon,8763,1,21,5,10,70,45,25,68
Alloa,8763,2,18,7,11,72,51,21,61
Queen's Park,8763,3,16,7,13,42,39,3,55
Brechin,8763,4,16,5,15,50,53,-3,53
Livingston,8763,5,14,9,13,67,58,9,51
Stranraer,8763,6,14,9,13,52,48,4,51
Albion,8763,7,13,11,12,60,55,5,50
Peterhead,8763,8,14,7,15,47,48,-1,49
East Fife,8763,9,11,9,16,49,58,-9,42
Stenhousem'r,8763,10,6,5,25,40,94,-54,23
Livingston,8764,1,24,6,6,87,41,46,78
Alloa,8764,2,19,8,9,72,45,27,65
Airdrieon,8764,3,19,6,11,72,53,19,63
Queen's Park,8764,4,14,8,14,45,44,1,50
Peterhead,8764,5,14,6,16,49,57,-8,48
Stranraer,8764,6,12,6,18,53,66,-13,42
East Fife,8764,7,11,8,17,49,58,-9,41
Brechin,8764,8,12,5,19,42,65,-23,41
Stenhousem'r,8764,9,11,6,19,53,81,-28,39
Albion,8764,10,9,11,16,49,61,-12,38
Alloa,8765,1,21,6,9,67,40,27,69
Livingston,8765,2,20,7,9,80,52,28,67
Airdrieon,8765,3,19,7,10,58,52,6,64
Brechin,8765,4,15,8,13,58,52,6,53
Peterhead,8765,5,14,7,15,58,59,-1,49
Albion,8765,6,12,11,13,43,39,4,47
Queen's Park,8765,7,13,7,16,34,52,-18,46
Stranraer,8765,8,14,3,19,51,60,-9,45
Stenhousem'r,8765,9,8,8,20,43,72,-29,32
East Fife,8765,10,7,10,19,36,50,-14,31
Alloa,8766,1,20,8,8,69,38,31,68
Livingston,8766,2,20,6,10,78,48,30,66
Airdrieon,8766,3,18,7,11,67,57,10,61
Brechin,8766,4,17,9,10,61,57,4,60
East Fife,8766,5,14,7,15,61,54,7,49
Albion,8766,6,14,6,16,51,58,-7,48
Peterhead,8766,7,10,10,16,44,56,-12,40
Queen's Park,8766,8,11,7,18,36,58,-22,40
Stenhousem'r,8766,9,10,7,19,53,74,-21,37
Stranraer,8766,10,10,5,21,41,61,-20,35
Alloa,8767,1,17,12,7,74,50,24,63
Airdrieon,8767,2,17,11,8,64,51,13,62
Albion,8767,3,18,7,11,61,49,12,61
Peterhead,8767,4,17,9,10,66,55,11,60
Livingston,8767,5,17,4,15,71,59,12,55
Brechin,8767,6,16,4,16,55,52,3,52
Stranraer,8767,7,12,2,22,45,63,-18,38
Stenhousem'r,8767,8,9,11,16,48,69,-21,38
Queen's Park,8767,9,10,8,18,34,59,-25,38
East Fife,8767,10,8,10,18,51,62,-11,34
Livingston,8768,1,21,2,13,83,53,30,65
Brechin,8768,2,19,7,10,58,46,12,64
Airdrieon,8768,3,19,6,11,60,60,0,63
Alloa,8768,4,18,7,11,66,46,20,61
Queen's Park,8768,5,14,7,15,38,45,-7,49
Stranraer,8768,6,14,5,17,53,61,-8,47
Peterhead,8768,7,13,7,16,60,56,4,46
East Fife,8768,8,11,11,14,52,51,1,44
Albion,8768,9,11,8,17,51,60,-9,41
Stenhousem'r,8768,10,7,6,23,47,90,-43,27
Livingston,8769,1,24,3,9,80,47,33,75
Brechin,8769,2,19,7,10,57,40,17,64
Albion,8769,3,16,10,10,60,53,7,58
Airdrieon,8769,4,17,7,12,56,49,7,58
Alloa,8769,5,17,5,14,72,55,17,56
East Fife,8769,6,12,8,16,50,43,7,44
Stranraer,8769,7,13,4,19,45,61,-16,43
Queen's Park,8769,8,11,8,17,36,54,-18,41
Peterhead,8769,9,11,7,18,45,59,-14,40
Stenhousem'r,8769,10,6,9,21,45,85,-40,27
Livingston,8770,1,21,2,13,68,50,18,65
Brechin,8770,2,18,6,12,63,46,17,60
Airdrieon,8770,3,18,5,13,57,56,1,59
Albion,8770,4,17,6,13,59,48,11,57
Alloa,8770,5,15,9,12,62,48,14,54
Queen's Park,8770,6,14,8,14,35,47,-12,50
East Fife,8770,7,13,7,16,52,48,4,46
Stranraer,8770,8,13,4,19,48,61,-13,43
Peterhead,8770,9,10,9,17,48,66,-18,39
Stenhousem'r,8770,10,10,6,20,55,77,-22,36
Alloa,8771,1,23,6,7,77,41,36,75
Brechin,8771,2,18,7,11,52,37,15,61
Livingston,8771,3,18,7,11,71,57,14,61
Airdrieon,8771,4,17,6,13,57,49,8,57
Albion,8771,5,15,8,13,52,47,5,53
East Fife,8771,6,11,11,14,50,49,1,44
Queen's Park,8771,7,11,11,14,35,43,-8,44
Stranraer,8771,8,12,7,17,46,61,-15,43
Peterhead,8771,9,8,10,18,36,52,-16,34
Stenhousem'r,8771,10,8,5,23,45,85,-40,29
Alloa,8772,1,19,10,7,81,46,35,67
Livingston,8772,2,21,4,11,84,57,27,67
Brechin,8772,3,18,5,13,54,47,7,59
Albion,8772,4,13,11,12,53,46,7,50
Airdrieon,8772,5,14,7,15,55,62,-7,49
East Fife,8772,6,13,9,14,47,46,1,48
Stenhousem'r,8772,7,12,7,17,50,74,-24,43
Queen's Park,8772,8,10,11,15,39,45,-6,41
Peterhead,8772,9,11,7,18,38,55,-17,40
Stranraer,8772,10,10,7,19,46,69,-23,37
Alloa,8773,1,22,5,9,68,37,31,71
Livingston,8773,2,20,5,11,76,43,33,65
Brechin,8773,3,17,6,13,53,48,5,57
Peterhead,8773,4,15,9,12,54,48,6,54
Airdrieon,8773,5,13,13,10,53,57,-4,52
Albion,8773,6,14,8,14,54,60,-6,50
Queen's Park,8773,7,12,7,17,34,52,-18,43
Stranraer,8773,8,11,8,17,52,58,-6,41
East Fife,8773,9,8,10,18,46,54,-8,34
Stenhousem'r,8773,10,9,7,20,44,77,-33,34
Livingston,8774,1,22,2,12,73,52,21,68
Alloa,8774,2,19,6,11,71,47,24,63
Brechin,8774,3,19,2,15,65,53,12,59
Airdrieon,8774,4,17,6,13,60,50,10,57
Stranraer,8774,5,17,2,17,57,54,3,53
Queen's Park,8774,6,16,4,16,51,61,-10,52
Peterhead,8774,7,14,7,15,49,54,-5,49
Albion,8774,8,14,4,18,53,57,-4,46
East Fife,8774,9,12,8,16,46,51,-5,44
Stenhousem'r,8774,10,7,5,24,38,84,-46,26
Brechin,8775,1,20,4,12,56,40,16,64
Alloa,8775,2,17,9,10,62,39,23,60
Airdrieon,8775,3,16,10,10,59,59,0,58
Livingston,8775,4,16,7,13,76,65,11,55
Peterhead,8775,5,15,9,12,45,45,0,54
Albion,8775,6,12,10,14,53,50,3,46
Queen's Park,8775,7,11,11,14,38,46,-8,44
Stranraer,8775,8,12,8,16,48,57,-9,44
East Fife,8775,9,10,8,18,48,55,-7,38
Stenhousem'r,8775,10,8,10,18,53,82,-29,34
Alloa,8776,1,19,8,9,65,39,26,65
Airdrieon,8776,2,16,12,8,59,49,10,60
Brechin,8776,3,18,5,13,50,50,0,59
Livingston,8776,4,16,6,14,61,44,17,54
Peterhead,8776,5,13,12,11,42,37,5,51
Queen's Park,8776,6,13,8,15,35,45,-10,47
East Fife,8776,7,12,10,14,50,44,6,46
Stranraer,8776,8,13,5,18,50,57,-7,44
Albion,8776,9,12,6,18,45,52,-7,42
Stenhousem'r,8776,10,9,6,21,45,85,-40,33
Livingston,8777,1,24,2,10,82,50,32,74
Brechin,8777,2,20,4,12,63,42,21,64
Alloa,8777,3,18,6,12,69,49,20,60
Albion,8777,4,16,8,12,53,48,5,56
East Fife,8777,5,14,10,12,54,45,9,52
Airdrieon,8777,6,14,10,12,57,56,1,52
Peterhead,8777,7,12,9,15,45,53,-8,45
Queen's Park,8777,8,11,6,19,40,63,-23,39
Stranraer,8777,9,10,7,19,41,60,-19,37
Stenhousem'r,8777,10,5,10,21,46,84,-38,25
Alloa,8778,1,20,7,9,71,44,27,67
Livingston,8778,2,20,5,11,72,51,21,65
Brechin,8778,3,15,10,11,54,41,13,55
East Fife,8778,4,15,8,13,55,45,10,53
Airdrieon,8778,5,15,5,16,53,59,-6,50
Queen's Park,8778,6,14,7,15,36,45,-9,49
Stranraer,8778,7,14,4,18,49,59,-10,46
Peterhead,8778,8,13,7,16,47,58,-11,46
Albion,8778,9,12,8,16,53,52,1,44
Stenhousem'r,8778,10,7,9,20,47,83,-36,30
Airdrieon,8779,1,21,6,9,68,44,24,69
Alloa,8779,2,20,7,9,70,47,23,67
Livingston,8779,3,19,6,11,72,52,20,63
Peterhead,8779,4,15,9,12,51,51,0,54
Brechin,8779,5,14,6,16,48,50,-2,48
Albion,8779,6,13,9,14,55,59,-4,48
East Fife,8779,7,14,5,17,53,50,3,47
Stranraer,8779,8,13,4,19,53,64,-11,43
Stenhousem'r,8779,9,10,6,20,42,73,-31,36
Queen's Park,8779,10,9,6,21,27,49,-22,33
Livingston,8780,1,23,6,7,75,38,37,75
Airdrieon,8780,2,19,7,10,64,53,11,64
Alloa,8780,3,19,6,11,69,42,27,63
Brechin,8780,4,16,6,14,53,45,8,54
Stranraer,8780,5,17,3,16,51,59,-8,54
Peterhead,8780,6,13,6,17,48,58,-10,45
Albion,8780,7,9,15,12,44,50,-6,42
East Fife,8780,8,10,8,18,38,47,-9,38
Queen's Park,8780,9,9,10,17,34,50,-16,37
Stenhousem'r,8780,10,8,7,21,44,78,-34,31
Livingston,8781,1,26,4,6,91,42,49,82
Airdrieon,8781,2,18,6,12,67,58,9,60
East Fife,8781,3,15,9,12,57,43,14,54
Alloa,8781,4,15,6,15,61,52,9,51
Brechin,8781,5,14,9,13,49,51,-2,51
Albion,8781,6,12,8,16,49,49,0,44
Queen's Park,8781,7,12,8,16,38,52,-14,44
Stranraer,8781,8,10,10,16,54,63,-9,40
Stenhousem'r,8781,9,9,11,16,50,83,-33,38
Peterhead,8781,10,9,9,18,44,67,-23,36
Livingston,8782,1,21,6,9,77,41,36,69
Alloa,8782,2,18,5,13,61,39,22,59
Peterhead,8782,3,15,13,8,50,41,9,58
Airdrieon,8782,4,16,7,13,61,62,-1,55
Brechin,8782,5,15,7,14,43,48,-5,52
Stranraer,8782,6,15,5,16,51,56,-5,50
Albion,8782,7,11,12,13,53,51,2,45
Queen's Park,8782,8,11,10,15,38,54,-16,43
Stenhousem'r,8782,9,10,8,18,50,76,-26,38
East Fife,8782,10,6,11,19,40,56,-16,29
Alloa,8783,1,21,7,8,88,44,44,70
Livingston,8783,2,21,5,10,77,55,22,68
Albion,8783,3,20,6,10,66,47,19,66
East Fife,8783,4,14,6,16,56,51,5,48
Stranraer,8783,5,13,7,16,43,56,-13,46
Airdrieon,8783,6,12,8,16,45,53,-8,44
Brechin,8783,7,14,2,20,44,57,-13,44
Peterhead,8783,8,11,10,15,52,65,-13,43
Queen's Park,8783,9,12,7,17,38,55,-17,43
Stenhousem'r,8783,10,9,8,19,48,74,-26,35
Livingston,8784,1,22,4,10,76,42,34,70
Alloa,8784,2,19,8,9,70,39,31,65
Airdrieon,8784,3,16,10,10,59,52,7,58
Queen's Park,8784,4,16,6,14,49,50,-1,54
Brechin,8784,5,14,8,14,43,45,-2,50
East Fife,8784,6,13,10,13,47,45,2,49
Albion,8784,7,12,9,15,51,58,-7,45
Peterhead,8784,8,12,9,15,47,54,-7,45
Stranraer,8784,9,12,4,20,44,69,-25,40
Stenhousem'r,8784,10,6,8,22,51,83,-32,26
Alloa,8785,1,19,6,11,67,46,21,63
Livingston,8785,2,17,8,11,70,50,20,59
Peterhead,8785,3,17,6,13,58,52,6,57
Airdrieon,8785,4,15,10,11,59,52,7,55
Queen's Park,8785,5,15,9,12,46,49,-3,54
Stranraer,8785,6,13,10,13,59,55,4,49
Brechin,8785,7,13,9,14,43,47,-4,48
Albion,8785,8,12,9,15,41,54,-13,45
East Fife,8785,9,11,7,18,57,58,-1,40
Stenhousem'r,8785,10,7,8,21,47,84,-37,29
Alloa,8786,1,19,9,8,82,55,27,66
Brechin,8786,2,20,6,10,57,44,13,66
Airdrieon,8786,3,19,6,11,65,52,13,63
Stranraer,8786,4,17,6,13,59,48,11,57
Livingston,8786,5,16,5,15,68,56,12,53
Albion,8786,6,13,12,11,63,58,5,51
East Fife,8786,7,12,8,16,45,42,3,44
Peterhead,8786,8,11,5,20,37,66,-29,38
Queen's Park,8786,9,10,6,20,29,52,-23,36
Stenhousem'r,8786,10,7,9,20,43,75,-32,30
Livingston,8787,1,22,7,7,87,42,45,73
Brechin,8787,2,17,8,11,49,38,11,59
Peterhead,8787,3,16,8,12,46,45,1,56
Airdrieon,8787,4,15,8,13,58,58,0,53
East Fife,8787,5,13,9,14,46,47,-1,48
Alloa,8787,6,14,5,17,58,57,1,47
Albion,8787,7,12,9,15,50,51,-1,45
Stranraer,8787,8,13,6,17,57,65,-8,45
Stenhousem'r,8787,9,10,8,18,48,74,-26,38
Queen's Park,8787,10,9,10,17,26,48,-22,37
Airdrieon,8788,1,20,6,10,61,51,10,66
Livingston,8788,2,20,5,11,78,54,24,65
Albion,8788,3,18,7,11,56,40,16,61
East Fife,8788,4,15,10,11,52,38,14,55
Brechin,8788,5,18,1,17,51,56,-5,55
Alloa,8788,6,15,9,12,61,44,17,54
Peterhead,8788,7,13,10,13,48,53,-5,49
Queen's Park,8788,8,12,7,17,37,54,-17,43
Stranraer,8788,9,13,3,20,47,59,-12,42
Stenhousem'r,8788,10,3,8,25,34,76,-42,17
Livingston,8789,1,24,3,9,87,39,48,75
Alloa,8789,2,23,5,8,89,43,46,74
Brechin,8789,3,21,4,11,54,37,17,67
Airdrieon,8789,4,20,6,10,67,52,15,66
Stranraer,8789,5,13,7,16,57,63,-6,46
Albion,8789,6,12,8,16,43,49,-6,44
East Fife,8789,7,11,8,17,41,53,-12,41
Queen's Park,8789,8,11,4,21,35,68,-33,37
Peterhead,8789,9,9,9,18,35,59,-24,36
Stenhousem'r,8789,10,5,8,23,43,88,-45,23
Livingston,8790,1,22,5,9,70,39,31,71
Airdrieon,8790,2,20,5,11,64,54,10,65
Alloa,8790,3,18,9,9,64,40,24,63
Albion,8790,4,16,10,10,58,48,10,58
Peterhead,8790,5,14,11,11,51,50,1,53
Brechin,8790,6,12,10,14,47,57,-10,46
East Fife,8790,7,9,14,13,54,51,3,41
Stranraer,8790,8,12,5,19,47,55,-8,41
Queen's Park,8790,9,10,6,20,32,50,-18,36
Stenhousem'r,8790,10,5,9,22,46,89,-43,24
Alloa,8791,1,17,11,8,70,46,24,62
Stranraer,8791,2,19,5,12,62,47,15,62
Livingston,8791,3,16,8,12,74,57,17,56
Brechin,8791,4,16,8,12,48,40,8,56
Airdrieon,8791,5,13,11,12,52,48,4,50
Peterhead,8791,6,12,13,11,50,50,0,49
Queen's Park,8791,7,12,9,15,42,53,-11,45
East Fife,8791,8,10,12,14,52,56,-4,42
Albion,8791,9,9,14,13,53,60,-7,41
Stenhousem'r,8791,10,6,9,21,46,92,-46,27
Livingston,8792,1,19,10,7,75,43,32,67
Alloa,8792,2,18,10,8,70,47,23,64
Peterhead,8792,3,15,9,12,59,57,2,54
Stranraer,8792,4,15,7,14,55,57,-2,52
Airdrieon,8792,5,14,9,13,50,54,-4,51
Queen's Park,8792,6,14,8,14,34,39,-5,50
Brechin,8792,7,13,10,13,43,47,-4,49
Albion,8792,8,12,8,16,47,49,-2,44
East Fife,8792,9,9,9,18,46,57,-11,36
Stenhousem'r,8792,10,8,6,22,49,78,-29,30
Livingston,8793,1,21,4,11,84,55,29,67
Airdrieon,8793,2,21,3,12,68,56,12,66
Alloa,8793,3,18,9,9,76,50,26,63
Queen's Park,8793,4,16,5,15,52,63,-11,53
Stranraer,8793,5,15,7,14,56,58,-2,52
Brechin,8793,6,14,5,17,53,56,-3,47
East Fife,8793,7,13,7,16,54,53,1,46
Albion,8793,8,11,8,17,50,58,-8,41
Peterhead,8793,9,10,9,17,49,62,-13,39
Stenhousem'r,8793,10,7,11,18,47,78,-31,32
Livingston,8794,1,22,6,8,74,43,31,72
Alloa,8794,2,18,11,7,72,38,34,65
Brechin,8794,3,19,4,13,58,48,10,61
Airdrieon,8794,4,16,8,12,66,58,8,56
East Fife,8794,5,14,7,15,51,46,5,49
Queen's Park,8794,6,13,6,17,38,50,-12,45
Peterhead,8794,7,10,12,14,44,54,-10,42
Albion,8794,8,10,12,14,48,63,-15,42
Stranraer,8794,9,11,8,17,49,63,-14,41
Stenhousem'r,8794,10,6,8,22,46,83,-37,26
Alloa,8795,1,20,8,8,70,41,29,68
Livingston,8795,2,21,1,14,75,51,24,64
Peterhead,8795,3,19,5,12,57,49,8,62
Airdrieon,8795,4,17,5,14,59,58,1,56
Brechin,8795,5,15,6,15,42,47,-5,51
East Fife,8795,6,13,10,13,53,46,7,49
Stranraer,8795,7,13,7,16,53,54,-1,46
Albion,8795,8,12,7,17,56,58,-2,43
Stenhousem'r,8795,9,12,5,19,52,80,-28,41
Queen's Park,8795,10,7,8,21,31,64,-33,29
Livingston,8796,1,26,3,7,92,41,51,81
Airdrieon,8796,2,17,9,10,53,47,6,60
Albion,8796,3,16,10,10,65,51,14,58
Alloa,8796,4,16,9,11,77,48,29,57
Brechin,8796,5,16,4,16,51,59,-8,52
Peterhead,8796,6,13,9,14,41,57,-16,48
Stranraer,8796,7,12,8,16,53,58,-5,44
Queen's Park,8796,8,12,6,18,41,64,-23,42
East Fife,8796,9,7,11,18,48,55,-7,32
Stenhousem'r,8796,10,7,7,22,48,89,-41,28
Alloa,8797,1,19,11,6,66,41,25,68
Livingston,8797,2,19,8,9,76,51,25,65
Airdrieon,8797,3,18,9,9,62,41,21,63
Peterhead,8797,4,14,9,13,52,48,4,51
Albion,8797,5,14,9,13,58,62,-4,51
Brechin,8797,6,13,10,13,44,46,-2,49
Stranraer,8797,7,12,8,16,51,60,-9,44
East Fife,8797,8,10,11,15,45,48,-3,41
Queen's Park,8797,9,10,8,18,41,60,-19,38
Stenhousem'r,8797,10,6,7,23,42,80,-38,25
Airdrieon,8798,1,20,7,9,72,51,21,67
Livingston,8798,2,20,6,10,70,48,22,66
Alloa,8798,3,19,7,10,72,42,30,64
Stranraer,8798,4,17,3,16,59,60,-1,54
Albion,8798,5,13,12,11,50,46,4,51
Brechin,8798,6,14,9,13,47,53,-6,51
Queen's Park,8798,7,12,5,19,44,60,-16,41
Peterhead,8798,8,10,8,18,40,59,-19,38
East Fife,8798,9,7,15,14,40,44,-4,36
Stenhousem'r,8798,10,7,10,19,48,79,-31,31
Livingston,8799,1,22,3,11,88,51,37,69
Airdrieon,8799,2,17,6,13,64,53,11,57
Alloa,8799,3,14,14,8,61,43,18,56
Brechin,8799,4,15,6,15,55,58,-3,51
Queen's Park,8799,5,14,8,14,36,47,-11,50
Albion,8799,6,12,13,11,47,41,6,49
Stranraer,8799,7,14,7,15,62,61,1,49
Peterhead,8799,8,10,14,12,45,50,-5,44
East Fife,8799,9,9,11,16,43,56,-13,38
Stenhousem'r,8799,10,8,8,20,43,84,-41,32
Livingston,8800,1,22,5,9,81,42,39,71
Alloa,8800,2,20,7,9,69,43,26,67
Albion,8800,3,16,10,10,55,38,17,58
Airdrieon,8800,4,16,9,11,55,50,5,57
Brechin,8800,5,15,9,12,48,49,-1,54
Queen's Park,8800,6,13,8,15,40,54,-14,47
East Fife,8800,7,11,11,14,54,49,5,44
Peterhead,8800,8,9,9,18,42,58,-16,36
Stenhousem'r,8800,9,8,9,19,45,77,-32,33
Stranraer,8800,10,8,7,21,37,66,-29,31
Airdrieon,8801,1,20,8,8,65,46,19,68
Alloa,8801,2,18,10,8,68,39,29,64
Livingston,8801,3,17,6,13,69,55,14,57
Brechin,8801,4,15,9,12,56,51,5,54
Albion,8801,5,14,10,12,50,56,-6,52
Queen's Park,8801,6,12,10,14,41,48,-7,46
Stranraer,8801,7,11,11,14,51,53,-2,44
Peterhead,8801,8,11,9,16,46,54,-8,42
East Fife,8801,9,10,9,17,42,48,-6,39
Stenhousem'r,8801,10,6,10,20,46,84,-38,28
Livingston,8802,1,22,4,10,88,60,28,70
Alloa,8802,2,19,9,8,71,39,32,66
Airdrieon,8802,3,19,6,11,68,54,14,63
Brechin,8802,4,16,9,11,43,43,0,57
Queen's Park,8802,5,14,6,16,48,56,-8,48
East Fife,8802,6,12,11,13,54,47,7,47
Peterhead,8802,7,12,11,13,54,59,-5,47
Albion,8802,8,10,10,16,54,67,-13,40
Stranraer,8802,9,12,4,20,53,66,-13,40
Stenhousem'r,8802,10,6,6,24,43,85,-42,24
Livingston,8803,1,22,4,10,83,48,35,70
Alloa,8803,2,19,6,11,71,48,23,63
Brechin,8803,3,15,9,12,50,43,7,54
Airdrieon,8803,4,16,6,14,71,69,2,54
Albion,8803,5,14,11,11,62,48,14,53
Stranraer,8803,6,14,11,11,52,48,4,53
East Fife,8803,7,9,12,15,45,47,-2,39
Queen's Park,8803,8,9,12,15,31,53,-22,39
Peterhead,8803,9,9,11,16,48,66,-18,38
Stenhousem'r,8803,10,8,8,20,48,91,-43,32
Airdrieon,8804,1,19,6,11,71,53,18,63
Livingston,8804,2,18,6,12,68,51,17,60
Albion,8804,3,16,9,11,60,51,9,57
Alloa,8804,4,17,6,13,67,60,7,57
Brechin,8804,5,13,10,13,51,50,1,49
Stranraer,8804,6,14,7,15,53,54,-1,49
Queen's Park,8804,7,12,9,15,42,53,-11,45
Peterhead,8804,8,12,8,16,44,57,-13,44
East Fife,8804,9,10,10,16,43,49,-6,40
Stenhousem'r,8804,10,9,9,18,52,73,-21,36
Airdrieon,8805,1,21,5,10,68,47,21,68
Alloa,8805,2,19,9,8,73,50,23,66
Livingston,8805,3,20,3,13,80,59,21,63
Brechin,8805,4,19,3,14,54,46,8,60
Peterhead,8805,5,14,7,15,45,49,-4,49
Queen's Park,8805,6,13,5,18,41,53,-12,44
East Fife,8805,7,11,10,15,52,58,-6,43
Albion,8805,8,11,8,17,48,56,-8,41
Stranraer,8805,9,11,8,17,48,62,-14,41
Stenhousem'r,8805,10,7,10,19,54,83,-29,31
Livingston,8806,1,22,8,6,80,38,42,74
Alloa,8806,2,20,6,10,76,51,25,66
Airdrieon,8806,3,18,7,11,56,57,-1,61
Brechin,8806,4,15,7,14,55,55,0,52
Queen's Park,8806,5,14,8,14,36,46,-10,50
Albion,8806,6,13,7,16,54,58,-4,46
Peterhead,8806,7,11,12,13,52,54,-2,45
East Fife,8806,8,10,11,15,40,43,-3,41
Stenhousem'r,8806,9,10,8,18,47,65,-18,38
Stranraer,8806,10,8,4,24,41,70,-29,28
Livingston,8807,1,19,6,11,72,53,19,63
Brechin,8807,2,18,5,13,51,42,9,59
Airdrieon,8807,3,16,8,12,61,55,6,56
Alloa,8807,4,14,12,10,56,43,13,54
Peterhead,8807,5,14,10,12,53,49,4,52
Stranraer,8807,6,15,5,16,54,59,-5,50
Queen's Park,8807,7,14,8,14,42,51,-9,50
East Fife,8807,8,12,9,15,56,48,8,45
Albion,8807,9,10,8,18,45,60,-15,38
Stenhousem'r,8807,10,5,15,16,35,65,-30,30
Airdrieon,8808,1,21,6,9,60,47,13,69
Livingston,8808,2,21,4,11,72,43,29,67
East Fife,8808,3,15,10,11,62,47,15,55
Brechin,8808,4,16,6,14,51,53,-2,54
Alloa,8808,5,15,8,13,64,53,11,53
Albion,8808,6,15,7,14,47,51,-4,52
Stranraer,8808,7,12,8,16,55,55,0,44
Queen's Park,8808,8,11,9,16,38,54,-16,42
Peterhead,8808,9,8,13,15,44,54,-10,37
Stenhousem'r,8808,10,7,7,22,43,79,-36,28
Livingston,8809,1,25,2,9,80,42,38,77
Alloa,8809,2,19,7,10,64,42,22,64
East Fife,8809,3,15,8,13,52,42,10,53
Airdrieon,8809,4,14,10,12,61,53,8,52
Brechin,8809,5,14,6,16,51,59,-8,48
Albion,8809,6,12,11,13,50,52,-2,47
Peterhead,8809,7,13,8,15,46,50,-4,47
Stranraer,8809,8,13,6,17,44,58,-14,45
Queen's Park,8809,9,11,9,16,40,49,-9,42
Stenhousem'r,8809,10,7,7,22,38,79,-41,28
Brechin,8810,1,22,6,8,73,49,24,72
Alloa,8810,2,20,9,7,81,49,32,69
Livingston,8810,3,20,8,8,80,48,32,68
Airdrieon,8810,4,15,8,13,58,59,-1,53
Peterhead,8810,5,13,10,13,54,51,3,49
Queen's Park,8810,6,13,6,17,43,53,-10,45
Stranraer,8810,7,13,4,19,44,57,-13,43
Albion,8810,8,11,7,18,41,58,-17,40
East Fife,8810,9,7,11,18,45,62,-17,32
Stenhousem'r,8810,10,7,9,20,43,76,-33,30
Livingston,8811,1,22,4,10,78,43,35,70
Alloa,8811,2,18,8,10,65,43,22,62
Airdrieon,8811,3,17,7,12,61,60,1,58
Peterhead,8811,4,14,13,9,51,42,9,55
Brechin,8811,5,14,9,13,50,47,3,51
Albion,8811,6,13,11,12,59,54,5,50
Queen's Park,8811,7,12,9,15,41,63,-22,45
Stranraer,8811,8,11,9,16,53,51,2,42
East Fife,8811,9,10,10,16,43,52,-9,40
Stenhousem'r,8811,10,5,8,23,33,79,-46,23
Livingston,8812,1,25,4,7,89,42,47,79
Alloa,8812,2,19,7,10,75,50,25,64
Airdrieon,8812,3,17,6,13,57,50,7,57
East Fife,8812,4,15,8,13,61,55,6,53
Brechin,8812,5,15,8,13,59,58,1,53
Albion,8812,6,14,7,15,55,52,3,49
Peterhead,8812,7,12,7,17,48,55,-7,43
Stranraer,8812,8,10,12,14,44,53,-9,42
Queen's Park,8812,9,12,5,19,35,53,-18,41
Stenhousem'r,8812,10,6,6,24,39,94,-55,24
Livingston,8813,1,22,5,9,72,40,32,71
Alloa,8813,2,21,8,7,66,35,31,71
Albion,8813,3,19,6,11,59,46,13,63
Airdrieon,8813,4,16,8,12,58,46,12,56
Brechin,8813,5,17,5,14,49,51,-2,56
East Fife,8813,6,12,7,17,57,56,1,43
Peterhead,8813,7,11,8,17,47,56,-9,41
Queen's Park,8813,8,10,9,17,30,48,-18,39
Stranraer,8813,9,8,10,18,47,61,-14,34
Stenhousem'r,8813,10,8,6,22,38,84,-46,30
Livingston,8814,1,23,4,9,74,50,24,73
Alloa,8814,2,17,8,11,68,47,21,59
Brechin,8814,3,17,6,13,45,36,9,57
Airdrieon,8814,4,16,7,13,54,50,4,55
Peterhead,8814,5,15,9,12,45,44,1,54
East Fife,8814,6,15,7,14,52,49,3,52
Queen's Park,8814,7,12,7,17,42,50,-8,43
Albion,8814,8,11,10,15,41,51,-10,43
Stranraer,8814,9,11,5,20,44,63,-19,38
Stenhousem'r,8814,10,8,7,21,43,68,-25,31
Alloa,8815,1,23,7,6,77,37,40,76
Livingston,8815,2,20,4,12,80,55,25,64
Airdrieon,8815,3,18,7,11,56,56,0,61
Brechin,8815,4,17,9,10,57,42,15,60
Albion,8815,5,14,9,13,53,52,1,51
Queen's Park,8815,6,12,10,14,34,48,-14,46
East Fife,8815,7,11,10,15,50,51,-1,43
Peterhead,8815,8,11,8,17,41,53,-12,41
Stenhousem'r,8815,9,10,7,19,53,79,-26,37
Stranraer,8815,10,5,7,24,38,66,-28,22
Livingston,8816,1,22,3,11,74,46,28,69
Airdrieon,8816,2,18,11,7,70,52,18,65
Brechin,8816,3,17,8,11,47,44,3,59
Alloa,8816,4,15,11,10,62,42,20,56
East Fife,8816,5,13,10,13,50,42,8,49
Stranraer,8816,6,12,6,18,39,54,-15,42
Stenhousem'r,8816,7,10,12,14,45,61,-16,42
Peterhead,8816,8,10,11,15,37,55,-18,41
Queen's Park,8816,9,9,11,16,33,46,-13,38
Albion,8816,10,7,11,18,38,53,-15,32
Livingston,8817,1,22,6,8,82,50,32,72
Alloa,8817,2,19,6,11,71,45,26,63
Albion,8817,3,15,11,10,54,48,6,56
Airdrieon,8817,4,15,9,12,66,65,1,54
Brechin,8817,5,16,6,14,47,46,1,54
East Fife,8817,6,11,11,14,52,47,5,44
Stranraer,8817,7,12,8,16,58,67,-9,44
Peterhead,8817,8,12,7,17,45,62,-17,43
Stenhousem'r,8817,9,10,8,18,52,72,-20,38
Queen's Park,8817,10,8,8,20,29,54,-25,32
Livingston,8818,1,23,5,8,80,44,36,74
Brechin,8818,2,21,5,10,58,43,15,68
Alloa,8818,3,15,11,10,63,44,19,56
Airdrieon,8818,4,15,10,11,55,50,5,55
Albion,8818,5,15,9,12,59,43,16,54
Peterhead,8818,6,16,6,14,61,59,2,54
Queen's Park,8818,7,13,6,17,33,53,-20,45
Stranraer,8818,8,12,5,19,55,64,-9,41
East Fife,8818,9,9,7,20,43,64,-21,34
Stenhousem'r,8818,10,6,6,24,42,85,-43,24
Livingston,8819,1,22,5,9,79,44,35,71
Brechin,8819,2,20,7,9,58,46,12,67
Airdrieon,8819,3,16,10,10,65,57,8,58
Alloa,8819,4,16,9,11,66,45,21,57
Queen's Park,8819,5,13,7,16,31,45,-14,46
Albion,8819,6,13,6,17,46,53,-7,45
Peterhead,8819,7,13,5,18,46,51,-5,44
Stranraer,8819,8,12,8,16,46,58,-12,44
East Fife,8819,9,11,7,18,43,53,-10,40
Stenhousem'r,8819,10,8,8,20,48,76,-28,32
Alloa,8820,1,21,8,7,70,40,30,71
Livingston,8820,2,20,6,10,76,50,26,66
Peterhead,8820,3,16,9,11,53,49,4,57
Brechin,8820,4,16,6,14,46,42,4,54
Airdrieon,8820,5,15,6,15,56,59,-3,51
Stranraer,8820,6,12,8,16,48,59,-11,44
East Fife,8820,7,10,13,13,42,40,2,43
Albion,8820,8,10,10,16,44,59,-15,40
Stenhousem'r,8820,9,10,7,19,49,67,-18,37
Queen's Park,8820,10,10,7,19,34,53,-19,37
Livingston,8821,1,21,5,10,86,46,40,68
Airdrieon,8821,2,19,4,13,65,59,6,61
Alloa,8821,3,17,7,12,64,57,7,58
Queen's Park,8821,4,17,4,15,42,42,0,55
East Fife,8821,5,14,8,14,50,46,4,50
Albion,8821,6,14,7,15,53,57,-4,49
Stranraer,8821,7,14,7,15,55,61,-6,49
Brechin,8821,8,14,6,16,41,50,-9,48
Peterhead,8821,9,13,7,16,45,49,-4,46
Stenhousem'r,8821,10,6,7,23,37,71,-34,25
Alloa,8822,1,19,9,8,79,48,31,66
Livingston,8822,2,19,5,12,67,52,15,62
Airdrieon,8822,3,19,4,13,59,52,7,61
Brechin,8822,4,17,7,12,52,45,7,58
Albion,8822,5,16,8,12,63,56,7,56
Queen's Park,8822,6,13,9,14,40,53,-13,48
East Fife,8822,7,10,13,13,59,51,8,43
Peterhead,8822,8,10,11,15,43,52,-9,41
Stranraer,8822,9,10,7,19,46,62,-16,37
Stenhousem'r,8822,10,6,9,21,51,88,-37,27
Airdrieon,8823,1,23,2,11,76,46,30,71
Alloa,8823,2,20,4,12,72,44,28,64
Livingston,8823,3,19,5,12,78,53,25,62
Brechin,8823,4,18,7,11,60,41,19,61
Peterhead,8823,5,14,9,13,48,55,-7,51
Stranraer,8823,6,16,3,17,49,62,-13,51
Albion,8823,7,13,7,16,43,49,-6,46
Queen's Park,8823,8,13,6,17,34,55,-21,45
East Fife,8823,9,11,10,15,49,48,1,43
Stenhousem'r,8823,10,5,3,28,38,94,-56,18
Livingston,8824,1,23,5,8,75,39,36,74
Alloa,8824,2,19,9,8,74,43,31,66
Brechin,8824,3,18,6,12,58,52,6,60
Queen's Park,8824,4,17,7,12,43,42,1,58
Airdrieon,8824,5,13,12,11,62,64,-2,51
Albion,8824,6,13,10,13,58,58,0,49
Peterhead,8824,7,14,6,16,53,61,-8,48
East Fife,8824,8,10,9,17,45,50,-5,39
Stranraer,8824,9,8,8,20,46,65,-19,32
Stenhousem'r,8824,10,5,8,23,46,86,-40,23
Stranraer,8825,1,20,4,12,55,47,8,64
Livingston,8825,2,19,3,14,80,57,23,60
Alloa,8825,3,17,9,10,63,42,21,60
Airdrieon,8825,4,17,6,13,62,55,7,57
Brechin,8825,5,17,6,13,53,49,4,57
Albion,8825,6,16,7,13,55,56,-1,55
Peterhead,8825,7,13,7,16,46,51,-5,46
Queen's Park,8825,8,12,4,20,35,53,-18,40
East Fife,8825,9,10,7,19,42,54,-12,37
Stenhousem'r,8825,10,8,9,19,52,79,-27,33
Livingston,8826,1,24,2,10,89,48,41,74
Alloa,8826,2,22,5,9,71,37,34,71
Airdrieon,8826,3,18,5,13,59,53,6,59
Peterhead,8826,4,16,8,12,54,55,-1,56
Albion,8826,5,12,11,13,48,51,-3,47
Brechin,8826,6,13,8,15,45,54,-9,47
Stranraer,8826,7,12,8,16,51,59,-8,44
East Fife,8826,8,10,8,18,49,56,-7,38
Queen's Park,8826,9,9,11,16,39,58,-19,38
Stenhousem'r,8826,10,9,4,23,43,77,-34,31
Livingston,8827,1,20,6,10,75,53,22,66
Alloa,8827,2,18,8,10,73,49,24,62
Airdrieon,8827,3,18,7,11,54,46,8,61
Brechin,8827,4,18,5,13,61,48,13,59
Albion,8827,5,14,7,15,52,53,-1,49
Peterhead,8827,6,12,11,13,40,46,-6,47
East Fife,8827,7,12,9,15,46,51,-5,45
Queen's Park,8827,8,12,8,16,35,46,-11,44
Stranraer,8827,9,12,4,20,48,58,-10,40
Stenhousem'r,8827,10,8,7,21,45,79,-34,31
Alloa,8828,1,20,6,10,70,49,21,66
Airdrieon,8828,2,20,6,10,56,47,9,66
Albion,8828,3,17,8,11,58,45,13,59
Livingston,8828,4,17,6,13,66,44,22,57
Brechin,8828,5,14,8,14,53,52,1,50
Stranraer,8828,6,13,9,14,57,57,0,48
Peterhead,8828,7,13,6,17,45,53,-8,45
Queen's Park,8828,8,11,9,16,34,52,-18,42
East Fife,8828,9,11,8,17,40,45,-5,41
Stenhousem'r,8828,10,7,8,21,44,79,-35,29
Alloa,8829,1,19,9,8,69,42,27,66
Albion,8829,2,17,9,10,58,53,5,60
Airdrieon,8829,3,19,3,14,56,55,1,60
Livingston,8829,4,18,2,16,73,53,20,56
Peterhead,8829,5,15,7,14,55,60,-5,52
Brechin,8829,6,16,3,17,49,49,0,51
Queen's Park,8829,7,13,11,12,39,41,-2,50
Stranraer,8829,8,14,3,19,50,51,-1,45
East Fife,8829,9,11,9,16,44,46,-2,42
Stenhousem'r,8829,10,8,4,24,43,86,-43,28
Alloa,8830,1,21,7,8,70,42,28,70
Livingston,8830,2,18,5,13,76,54,22,59
Brechin,8830,3,18,5,13,53,37,16,59
Airdrieon,8830,4,16,9,11,55,49,6,57
Albion,8830,5,16,7,13,49,50,-1,55
East Fife,8830,6,13,9,14,50,43,7,48
Peterhead,8830,7,12,9,15,38,45,-7,45
Stranraer,8830,8,11,5,20,46,63,-17,38
Queen's Park,8830,9,9,11,16,35,54,-19,38
Stenhousem'r,8830,10,9,7,20,46,81,-35,34
Alloa,8831,1,21,8,7,74,44,30,71
Livingston,8831,2,19,6,11,75,46,29,63
Brechin,8831,3,17,5,14,57,51,6,56
Airdrieon,8831,4,15,10,11,50,48,2,55
Albion,8831,5,13,9,14,48,54,-6,48
Queen's Park,8831,6,13,8,15,38,49,-11,47
Peterhead,8831,7,13,7,16,55,62,-7,46
East Fife,8831,8,10,11,15,53,50,3,41
Stranraer,8831,9,11,6,19,47,60,-13,39
Stenhousem'r,8831,10,9,8,19,55,88,-33,35
Alloa,8832,1,21,7,8,76,47,29,70
Airdrieon,8832,2,19,7,10,69,54,15,64
Brechin,8832,3,18,4,14,61,54,7,58
Peterhead,8832,4,16,6,14,59,62,-3,54
Livingston,8832,5,15,8,13,77,64,13,53
East Fife,8832,6,15,7,14,72,55,17,52
Albion,8832,7,14,6,16,50,50,0,48
Stranraer,8832,8,12,5,19,53,67,-14,41
Queen's Park,8832,9,11,7,18,35,56,-21,40
Stenhousem'r,8832,10,7,7,22,55,98,-43,28
Livingston,8833,1,24,4,8,82,41,41,76
Alloa,8833,2,19,8,9,67,41,26,65
Airdrieon,8833,3,18,5,13,65,52,13,59
Queen's Park,8833,4,16,5,15,38,49,-11,53
Brechin,8833,5,15,7,14,50,49,1,52
Peterhead,8833,6,13,8,15,50,58,-8,47
East Fife,8833,7,12,9,15,51,50,1,45
Stranraer,8833,8,14,2,20,46,62,-16,44
Albion,8833,9,11,7,18,47,58,-11,40
Stenhousem'r,8833,10,7,7,22,37,73,-36,28
Livingston,8834,1,23,6,7,88,45,43,75
Brechin,8834,2,18,9,9,59,44,15,63
Airdrieon,8834,3,18,7,11,61,54,7,61
Queen's Park,8834,4,16,3,17,41,50,-9,51
Peterhead,8834,5,14,8,14,51,53,-2,50
Albion,8834,6,13,9,14,49,56,-7,48
Stranraer,8834,7,12,9,15,60,61,-1,45
Alloa,8834,8,11,11,14,58,52,6,44
East Fife,8834,9,6,15,15,44,54,-10,33
Stenhousem'r,8834,10,7,7,22,44,86,-42,28
Brechin,8835,1,18,7,11,53,44,9,61
Alloa,8835,2,16,12,8,65,43,22,60
Albion,8835,3,17,8,11,60,48,12,59
Airdrieon,8835,4,17,5,14,66,60,6,56
Livingston,8835,5,16,7,13,74,57,17,55
Queen's Park,8835,6,14,7,15,42,49,-7,49
East Fife,8835,7,12,11,13,45,46,-1,47
Peterhead,8835,8,12,7,17,46,51,-5,43
Stranraer,8835,9,11,7,18,48,63,-15,40
Stenhousem'r,8835,10,8,7,21,46,84,-38,31
Alloa,8836,1,21,5,10,63,39,24,68
Brechin,8836,2,20,7,9,57,43,14,67
Livingston,8836,3,20,6,10,73,41,32,66
Airdrieon,8836,4,19,4,13,64,56,8,61
Peterhead,8836,5,15,10,11,55,55,0,55
Albion,8836,6,14,7,15,51,58,-7,49
Queen's Park,8836,7,12,4,20,41,57,-16,40
Stranraer,8836,8,11,6,19,58,61,-3,39
East Fife,8836,9,8,10,18,43,55,-12,34
Stenhousem'r,8836,10,8,5,23,40,80,-40,29
Livingston,8837,1,21,7,8,76,46,30,70
Airdrieon,8837,2,20,5,11,64,43,21,65
Alloa,8837,3,19,6,11,69,44,25,63
Albion,8837,4,17,7,12,67,58,9,58
Brechin,8837,5,16,3,17,47,54,-7,51
Peterhead,8837,6,13,8,15,40,56,-16,47
East Fife,8837,7,13,7,16,53,56,-3,46
Stranraer,8837,8,14,3,19,54,61,-7,45
Queen's Park,8837,9,9,9,18,32,50,-18,36
Stenhousem'r,8837,10,7,7,22,44,78,-34,28
Livingston,8838,1,20,4,12,81,54,27,64
Airdrieon,8838,2,20,4,12,69,64,5,64
Alloa,8838,3,19,6,11,70,48,22,63
Brechin,8838,4,19,3,14,50,45,5,60
Peterhead,8838,5,17,5,14,65,52,13,56
Stranraer,8838,6,17,2,17,52,54,-2,53
Albion,8838,7,15,6,15,53,55,-2,51
Queen's Park,8838,8,13,6,17,42,55,-13,45
East Fife,8838,9,10,8,18,43,56,-13,38
Stenhousem'r,8838,10,5,6,25,42,84,-42,21
Livingston,8839,1,22,5,9,82,44,38,71
Alloa,8839,2,18,9,9,73,42,31,63
Airdrieon,8839,3,19,4,13,60,49,11,61
Brechin,8839,4,16,11,9,53,43,10,59
Peterhead,8839,5,13,7,16,47,55,-8,46
Stranraer,8839,6,14,4,18,53,63,-10,46
Albion,8839,7,12,8,16,49,57,-8,44
Queen's Park,8839,8,11,9,16,33,46,-13,42
East Fife,8839,9,10,11,15,44,53,-9,41
Stenhousem'r,8839,10,8,6,22,40,82,-42,30
Livingston,8840,1,21,4,11,64,42,22,67
Brechin,8840,2,18,5,13,63,55,8,59
Airdrieon,8840,3,15,10,11,58,52,6,55
Alloa,8840,4,15,8,13,70,54,16,53
Stranraer,8840,5,17,2,17,54,54,0,53
Albion,8840,6,15,7,14,56,51,5,52
Queen's Park,8840,7,12,9,15,35,47,-12,45
Stenhousem'r,8840,8,13,6,17,53,66,-13,45
East Fife,8840,9,12,6,18,37,51,-14,42
Peterhead,8840,10,10,7,19,43,61,-18,37
Livingston,8841,1,23,5,8,74,38,36,74
Alloa,8841,2,19,8,9,67,41,26,65
Airdrieon,8841,3,16,9,11,60,51,9,57
Albion,8841,4,15,8,13,52,52,0,53
Stranraer,8841,5,16,4,16,55,57,-2,52
Brechin,8841,6,14,9,13,51,51,0,51
Peterhead,8841,7,12,10,14,44,49,-5,46
Queen's Park,8841,8,12,9,15,39,49,-10,45
East Fife,8841,9,7,12,17,43,54,-11,33
Stenhousem'r,8841,10,5,8,23,50,93,-43,23
Alloa,8842,1,19,9,8,69,40,29,66
Brechin,8842,2,16,8,12,49,45,4,56
Livingston,8842,3,14,13,9,64,45,19,55
Airdrieon,8842,4,16,7,13,61,58,3,55
Albion,8842,5,14,9,13,49,44,5,51
Queen's Park,8842,6,13,8,15,44,57,-13,47
Stenhousem'r,8842,7,14,3,19,46,72,-26,45
Stranraer,8842,8,13,5,18,49,63,-14,44
East Fife,8842,9,11,10,15,54,47,7,43
Peterhead,8842,10,9,10,17,43,57,-14,37
Alloa,8843,1,22,7,7,82,38,44,73
Livingston,8843,2,20,5,11,75,43,32,65
Airdrieon,8843,3,18,5,13,56,55,1,59
Brechin,8843,4,17,6,13,48,42,6,57
Albion,8843,5,16,9,11,53,50,3,57
Stranraer,8843,6,14,7,15,53,57,-4,49
Peterhead,8843,7,13,5,18,44,55,-11,44
East Fife,8843,8,10,9,17,49,65,-16,39
Queen's Park,8843,9,8,13,15,31,49,-18,37
Stenhousem'r,8843,10,6,6,24,47,84,-37,24
Livingston,8844,1,24,5,7,75,38,37,77
Brechin,8844,2,18,5,13,56,55,1,59
Albion,8844,3,14,10,12,55,50,5,52
Airdrieon,8844,4,15,7,14,63,60,3,52
Alloa,8844,5,13,9,14,60,57,3,48
Queen's Park,8844,6,14,6,16,39,54,-15,48
Stranraer,8844,7,12,11,13,45,52,-7,47
Peterhead,8844,8,12,7,17,51,57,-6,43
East Fife,8844,9,11,9,16,48,47,1,42
Stenhousem'r,8844,10,7,11,18,48,70,-22,32
Livingston,8845,1,23,4,9,87,45,42,73
Alloa,8845,2,19,10,7,76,46,30,67
Airdrieon,8845,3,18,8,10,60,52,8,62
Brechin,8845,4,17,10,9,53,42,11,61
Peterhead,8845,5,13,10,13,44,52,-8,49
Albion,8845,6,12,7,17,51,55,-4,43
Stranraer,8845,7,12,7,17,49,58,-9,43
East Fife,8845,8,11,9,16,52,53,-1,42
Queen's Park,8845,9,11,7,18,33,52,-19,40
Stenhousem'r,8845,10,5,6,25,37,87,-50,21
Alloa,8846,1,19,9,8,71,35,36,66
Albion,8846,2,20,6,10,56,40,16,66
Livingston,8846,3,19,8,9,74,39,35,65
Brechin,8846,4,15,7,14,52,50,2,52
Queen's Park,8846,5,12,11,13,36,43,-7,47
Airdrieon,8846,6,13,7,16,45,61,-16,46
Peterhead,8846,7,12,8,16,45,53,-8,44
Stranraer,8846,8,11,9,16,57,60,-3,42
East Fife,8846,9,10,10,16,47,55,-8,40
Stenhousem'r,8846,10,8,7,21,44,91,-47,31
Alloa,8847,1,18,12,6,64,40,24,66
Livingston,8847,2,19,5,12,70,46,24,62
Airdrieon,8847,3,17,8,11,60,51,9,59
Brechin,8847,4,16,9,11,51,35,16,57
Albion,8847,5,15,7,14,48,48,0,52
East Fife,8847,6,12,10,14,40,37,3,46
Stranraer,8847,7,12,10,14,52,52,0,46
Queen's Park,8847,8,13,7,16,31,48,-17,46
Peterhead,8847,9,11,7,18,39,54,-15,40
Stenhousem'r,8847,10,6,7,23,33,77,-44,25
Brechin,8848,1,19,7,10,62,43,19,64
Airdrieon,8848,2,17,9,10,65,51,14,60
Albion,8848,3,17,9,10,58,51,7,60
Alloa,8848,4,15,12,9,70,44,26,57
Livingston,8848,5,15,5,16,61,57,4,50
Queen's Park,8848,6,15,5,16,38,47,-9,50
Peterhead,8848,7,11,11,14,56,61,-5,44
East Fife,8848,8,11,9,16,61,59,2,42
Stranraer,8848,9,10,8,18,46,70,-24,38
Stenhousem'r,8848,10,7,11,18,51,85,-34,32
Livingston,8849,1,21,7,8,75,41,34,70
Alloa,8849,2,17,10,9,79,51,28,61
Airdrieon,8849,3,17,9,10,56,52,4,60
Queen's Park,8849,4,15,8,13,39,45,-6,53
Albion,8849,5,14,6,16,58,53,5,48
Brechin,8849,6,14,6,16,51,56,-5,48
East Fife,8849,7,12,10,14,59,53,6,46
Peterhead,8849,8,11,13,12,50,62,-12,46
Stranraer,8849,9,9,10,17,47,71,-24,37
Stenhousem'r,8849,10,7,7,22,53,83,-30,28
Alloa,8850,1,19,10,7,74,44,30,67
Livingston,8850,2,20,5,11,72,55,17,65
Peterhead,8850,3,15,9,12,48,46,2,54
Brechin,8850,4,15,7,14,55,47,8,52
Airdrieon,8850,5,15,6,15,58,55,3,51
Queen's Park,8850,6,14,7,15,45,57,-12,49
Albion,8850,7,13,8,15,55,58,-3,47
East Fife,8850,8,13,7,16,58,57,1,46
Stranraer,8850,9,13,6,17,53,64,-11,45
Stenhousem'r,8850,10,7,7,22,44,79,-35,28
Alloa,8851,1,22,5,9,70,41,29,71
Airdrieon,8851,2,21,5,10,69,49,20,68
Livingston,8851,3,21,3,12,79,49,30,66
Brechin,8851,4,16,9,11,60,47,13,57
Peterhead,8851,5,14,8,14,47,54,-7,50
Stranraer,8851,6,14,6,16,55,60,-5,48
Albion,8851,7,12,6,18,45,60,-15,42
East Fife,8851,8,10,8,18,53,62,-9,38
Stenhousem'r,8851,9,10,6,20,49,75,-26,36
Queen's Park,8851,10,9,6,21,30,60,-30,33
Alloa,8852,1,21,7,8,76,43,33,70
Brechin,8852,2,18,9,9,55,47,8,63
Livingston,8852,3,18,5,13,70,50,20,59
Queen's Park,8852,4,15,7,14,37,46,-9,52
Peterhead,8852,5,14,8,14,46,51,-5,50
Airdrieon,8852,6,13,8,15,55,59,-4,47
Albion,8852,7,10,12,14,53,59,-6,42
Stranraer,8852,8,11,7,18,48,58,-10,40
Stenhousem'r,8852,9,11,6,19,52,77,-25,39
East Fife,8852,10,9,11,16,55,57,-2,38
Livingston,8853,1,21,3,12,75,42,33,66
Airdrieon,8853,2,20,3,13,60,53,7,63
Alloa,8853,3,16,7,13,65,49,16,55
Queen's Park,8853,4,16,6,14,43,55,-12,54
Brechin,8853,5,16,5,15,59,49,10,53
Stranraer,8853,6,15,8,13,49,49,0,53
Albion,8853,7,14,6,16,48,51,-3,48
Peterhead,8853,8,12,9,15,54,51,3,45
East Fife,8853,9,11,10,15,48,54,-6,43
Stenhousem'r,8853,10,7,7,22,43,91,-48,28
Alloa,8854,1,18,10,8,69,46,23,64
Airdrieon,8854,2,17,7,12,58,51,7,58
Livingston,8854,3,16,6,14,69,57,12,54
Stranraer,8854,4,16,5,15,52,52,0,53
Brechin,8854,5,15,6,15,56,56,0,51
Queen's Park,8854,6,14,8,14,36,46,-10,50
Albion,8854,7,14,6,16,58,59,-1,48
Peterhead,8854,8,13,9,14,52,54,-2,48
East Fife,8854,9,13,7,16,51,53,-2,46
Stenhousem'r,8854,10,7,10,19,52,79,-27,31
Alloa,8855,1,22,5,9,79,36,43,71
Albion,8855,2,21,7,8,66,50,16,70
Livingston,8855,3,19,3,14,72,47,25,60
Brechin,8855,4,17,7,12,45,43,2,58
Airdrieon,8855,5,15,8,13,60,51,9,53
Queen's Park,8855,6,14,5,17,44,58,-14,47
Stranraer,8855,7,14,2,20,43,58,-15,44
East Fife,8855,8,11,9,16,44,53,-9,42
Peterhead,8855,9,11,5,20,37,58,-21,38
Stenhousem'r,8855,10,6,9,21,42,78,-36,27
Alloa,8856,1,19,7,10,70,44,26,64
Livingston,8856,2,17,9,10,68,47,21,60
Airdrieon,8856,3,17,7,12,60,48,12,58
Brechin,8856,4,17,7,12,56,52,4,58
Peterhead,8856,5,14,12,10,49,46,3,54
Albion,8856,6,12,11,13,51,54,-3,47
Stranraer,8856,7,12,7,17,48,63,-15,43
Queen's Park,8856,8,11,10,15,32,49,-17,43
East Fife,8856,9,9,11,16,48,50,-2,38
Stenhousem'r,8856,10,6,11,19,48,77,-29,29
Alloa,8857,1,19,7,10,66,40,26,64
Albion,8857,2,18,8,10,54,46,8,62
Airdrieon,8857,3,18,7,11,64,59,5,61
Brechin,8857,4,16,8,12,49,46,3,56
Livingston,8857,5,16,6,14,79,67,12,54
Queen's Park,8857,6,15,7,14,45,50,-5,52
East Fife,8857,7,10,11,15,57,52,5,41
Stranraer,8857,8,11,6,19,53,62,-9,39
Peterhead,8857,9,9,9,18,42,64,-22,36
Stenhousem'r,8857,10,9,9,18,53,76,-23,36
Airdrieon,8858,1,21,5,10,66,48,18,68
Livingston,8858,2,21,4,11,71,47,24,67
Alloa,8858,3,20,6,10,66,45,21,66
East Fife,8858,4,13,10,13,49,46,3,49
Albion,8858,5,14,7,15,53,52,1,49
Brechin,8858,6,15,4,17,52,51,1,49
Queen's Park,8858,7,13,7,16,42,57,-15,46
Stranraer,8858,8,12,5,19,45,58,-13,41
Peterhead,8858,9,9,10,17,44,57,-13,37
Stenhousem'r,8858,10,10,6,20,46,73,-27,36
Livingston,8859,1,25,2,9,85,39,46,77
Alloa,8859,2,22,4,10,68,44,24,70
Brechin,8859,3,18,5,13,55,62,-7,59
Albion,8859,4,14,10,12,64,54,10,52
Airdrieon,8859,5,15,6,15,47,47,0,51
East Fife,8859,6,12,8,16,51,50,1,44
Peterhead,8859,7,11,11,14,47,52,-5,44
Stranraer,8859,8,13,4,19,46,56,-10,43
Queen's Park,8859,9,11,7,18,31,54,-23,40
Stenhousem'r,8859,10,5,11,20,38,74,-36,26
Livingston,8860,1,22,6,8,75,37,38,72
Airdrieon,8860,2,20,8,8,63,47,16,68
Alloa,8860,3,19,8,9,71,51,20,65
Queen's Park,8860,4,14,11,11,45,45,0,53
East Fife,8860,5,14,8,14,55,52,3,50
Brechin,8860,6,15,4,17,46,52,-6,49
Albion,8860,7,11,8,17,50,58,-8,41
Stranraer,8860,8,12,3,21,51,63,-12,39
Stenhousem'r,8860,9,10,6,20,46,78,-32,36
Peterhead,8860,10,8,8,20,40,59,-19,32
Alloa,8861,1,22,9,5,74,35,39,75
Livingston,8861,2,21,6,9,87,47,40,69
Brechin,8861,3,18,6,12,56,48,8,60
Airdrieon,8861,4,14,9,13,56,63,-7,51
Albion,8861,5,13,8,15,52,56,-4,47
Peterhead,8861,6,12,9,15,46,57,-11,45
Queen's Park,8861,7,11,10,15,34,46,-12,43
East Fife,8861,8,9,13,14,43,42,1,40
Stenhousem'r,8861,9,9,9,18,49,77,-28,36
Stranraer,8861,10,8,7,21,37,63,-26,31
Brechin,8862,1,21,3,12,62,58,4,66
Livingston,8862,2,19,6,11,76,52,24,63
Alloa,8862,3,18,8,10,65,44,21,62
Airdrieon,8862,4,17,8,11,68,56,12,59
Stranraer,8862,5,19,2,15,54,51,3,59
Peterhead,8862,6,12,10,14,51,55,-4,46
Albion,8862,7,13,7,16,50,59,-9,46
East Fife,8862,8,12,6,18,54,53,1,42
Queen's Park,8862,9,12,5,19,41,53,-12,41
Stenhousem'r,8862,10,7,5,24,54,94,-40,26
Alloa,8863,1,21,9,6,77,40,37,72
Livingston,8863,2,22,4,10,81,44,37,70
Brechin,8863,3,21,5,10,65,44,21,68
Airdrieon,8863,4,17,5,14,64,56,8,56
Albion,8863,5,13,11,12,48,49,-1,50
East Fife,8863,6,13,10,13,54,51,3,49
Peterhead,8863,7,12,8,16,38,53,-15,44
Stranraer,8863,8,12,4,20,53,68,-15,40
Queen's Park,8863,9,7,8,21,31,65,-34,29
Stenhousem'r,8863,10,6,8,22,38,79,-41,26
Livingston,8864,1,26,5,5,95,42,53,83
Brechin,8864,2,17,9,10,56,42,14,60
Alloa,8864,3,16,8,12,61,41,20,56
Airdrieon,8864,4,14,11,11,54,55,-1,53
Albion,8864,5,14,9,13,57,56,1,51
Peterhead,8864,6,13,10,13,47,56,-9,49
East Fife,8864,7,9,11,16,42,53,-11,38
Stranraer,8864,8,10,7,19,52,69,-17,37
Queen's Park,8864,9,9,9,18,33,52,-19,36
Stenhousem'r,8864,10,9,7,20,47,78,-31,34
Alloa,8865,1,21,6,9,84,42,42,69
Livingston,8865,2,17,11,8,73,46,27,62
Brechin,8865,3,17,9,10,59,54,5,60
Airdrieon,8865,4,15,7,14,54,58,-4,52
East Fife,8865,5,12,11,13,54,51,3,47
Queen's Park,8865,6,11,11,14,37,49,-12,44
Peterhead,8865,7,11,9,16,48,59,-11,42
Albion,8865,8,11,9,16,47,58,-11,42
Stenhousem'r,8865,9,10,11,15,55,71,-16,41
Stranraer,8865,10,8,10,18,45,68,-23,34
Alloa,8866,1,18,11,7,67,41,26,65
Livingston,8866,2,19,7,10,74,54,20,64
Albion,8866,3,16,9,11,55,43,12,57
Brechin,8866,4,17,3,16,47,50,-3,54
Peterhead,8866,5,16,5,15,54,54,0,53
Airdrieon,8866,6,15,7,14,54,52,2,52
Queen's Park,8866,7,13,7,16,37,45,-8,46
Stranraer,8866,8,14,3,19,54,64,-10,45
East Fife,8866,9,10,7,19,40,54,-14,37
Stenhousem'r,8866,10,8,9,19,46,71,-25,33
Airdrieon,8867,1,21,7,8,68,43,25,70
Alloa,8867,2,21,5,10,62,40,22,68
Livingston,8867,3,19,5,12,64,51,13,62
Brechin,8867,4,14,8,14,49,50,-1,50
Albion,8867,5,14,6,16,52,50,2,48
East Fife,8867,6,11,11,14,48,46,2,44
Peterhead,8867,7,12,8,16,42,53,-11,44
Queen's Park,8867,8,13,5,18,27,47,-20,44
Stenhousem'r,8867,9,12,6,18,48,61,-13,42
Stranraer,8867,10,10,5,21,41,60,-19,35
Livingston,8868,1,24,3,9,78,44,34,75
Alloa,8868,2,20,6,10,63,35,28,66
Brechin,8868,3,17,5,14,52,47,5,56
Queen's Park,8868,4,16,7,13,45,42,3,55
Airdrieon,8868,5,14,7,15,49,50,-1,49
Albion,8868,6,13,9,14,59,56,3,48
Peterhead,8868,7,12,9,15,42,60,-18,45
Stranraer,8868,8,14,2,20,51,61,-10,44
Stenhousem'r,8868,9,10,7,19,45,73,-28,37
East Fife,8868,10,9,7,20,39,55,-16,34
Livingston,8869,1,21,5,10,80,52,28,68
Alloa,8869,2,20,7,9,78,44,34,67
Albion,8869,3,18,7,11,59,44,15,61
Airdrieon,8869,4,16,8,12,58,55,3,56
Brechin,8869,5,14,9,13,45,49,-4,51
Peterhead,8869,6,12,9,15,47,59,-12,45
Stranraer,8869,7,12,8,16,45,55,-10,44
East Fife,8869,8,11,9,16,59,66,-7,42
Queen's Park,8869,9,10,8,18,32,51,-19,38
Stenhousem'r,8869,10,6,10,20,47,75,-28,28
Alloa,8870,1,19,9,8,70,44,26,66
Airdrieon,8870,2,18,7,11,65,52,13,61
Albion,8870,3,17,6,13,54,45,9,57
East Fife,8870,4,15,10,11,55,41,14,55
Livingston,8870,5,15,8,13,63,48,15,53
Brechin,8870,6,14,5,17,37,48,-11,47
Stranraer,8870,7,13,6,17,46,55,-9,45
Peterhead,8870,8,11,11,14,40,48,-8,44
Queen's Park,8870,9,10,11,15,35,48,-13,41
Stenhousem'r,8870,10,8,7,21,44,80,-36,31
Livingston,8871,1,24,5,7,74,42,32,77
Alloa,8871,2,21,7,8,70,41,29,70
Brechin,8871,3,19,3,14,49,41,8,60
Airdrieon,8871,4,14,10,12,52,48,4,52
Albion,8871,5,14,8,14,43,46,-3,50
Stranraer,8871,6,14,6,16,54,56,-2,48
Peterhead,8871,7,11,10,15,50,57,-7,43
East Fife,8871,8,11,8,17,42,46,-4,41
Queen's Park,8871,9,10,6,20,32,58,-26,36
Stenhousem'r,8871,10,6,9,21,42,73,-31,27
Alloa,8872,1,19,10,7,68,37,31,67
Livingston,8872,2,21,4,11,70,52,18,67
Brechin,8872,3,17,5,14,54,52,2,56
East Fife,8872,4,15,10,11,58,41,17,55
Airdrieon,8872,5,15,7,14,53,48,5,52
Queen's Park,8872,6,13,8,15,43,54,-11,47
Stranraer,8872,7,13,7,16,55,59,-4,46
Albion,8872,8,12,10,14,56,61,-5,46
Peterhead,8872,9,10,6,20,42,59,-17,36
Stenhousem'r,8872,10,8,7,21,42,78,-36,31
Alloa,8873,1,21,7,8,79,49,30,70
Livingston,8873,2,22,3,11,80,50,30,69
Brechin,8873,3,18,9,9,61,45,16,63
Airdrieon,8873,4,17,5,14,60,60,0,56
Stranraer,8873,5,13,9,14,55,56,-1,48
Queen's Park,8873,6,12,8,16,35,50,-15,44
Albion,8873,7,11,8,17,52,62,-10,41
Peterhead,8873,8,11,7,18,47,60,-13,40
East Fife,8873,9,9,10,17,47,59,-12,37
Stenhousem'r,8873,10,8,10,18,48,73,-25,34
Livingston,8874,1,24,5,7,82,41,41,77
Alloa,8874,2,19,9,8,74,53,21,66
Brechin,8874,3,15,9,12,51,46,5,54
Peterhead,8874,4,15,7,14,50,47,3,52
Stranraer,8874,5,14,6,16,61,60,1,48
Queen's Park,8874,6,13,9,14,36,45,-9,48
Albion,8874,7,11,13,12,43,42,1,46
Airdrieon,8874,8,14,4,18,54,63,-9,46
East Fife,8874,9,8,8,20,46,59,-13,32
Stenhousem'r,8874,10,8,8,20,42,83,-41,32
Livingston,8875,1,23,6,7,92,42,50,75
Alloa,8875,2,20,9,7,79,49,30,69
Airdrieon,8875,3,17,10,9,64,51,13,61
Brechin,8875,4,17,6,13,55,51,4,57
Albion,8875,5,12,9,15,50,53,-3,45
East Fife,8875,6,12,8,16,51,52,-1,44
Peterhead,8875,7,11,11,14,51,61,-10,44
Queen's Park,8875,8,10,10,16,33,57,-24,40
Stranraer,8875,9,11,5,20,45,63,-18,38
Stenhousem'r,8875,10,6,8,22,45,86,-41,26
Alloa,8876,1,24,7,5,78,38,40,79
Brechin,8876,2,19,9,8,56,38,18,66
Airdrieon,8876,3,19,9,8,61,44,17,66
Livingston,8876,4,17,8,11,66,49,17,59
Albion,8876,5,14,9,13,56,46,10,51
Queen's Park,8876,6,14,7,15,36,47,-11,49
East Fife,8876,7,10,11,15,47,53,-6,41
Peterhead,8876,8,9,7,20,50,70,-20,34
Stranraer,8876,9,9,7,20,44,70,-26,34
Stenhousem'r,8876,10,5,6,25,39,78,-39,21
Livingston,8877,1,23,5,8,67,41,26,74
Alloa,8877,2,17,10,9,79,50,29,61
Airdrieon,8877,3,18,7,11,66,55,11,61
Albion,8877,4,14,11,11,58,52,6,53
Peterhead,8877,5,13,10,13,55,55,0,49
Stranraer,8877,6,13,6,17,48,54,-6,45
East Fife,8877,7,10,12,14,43,46,-3,42
Brechin,8877,8,12,6,18,39,57,-18,42
Queen's Park,8877,9,9,9,18,32,48,-16,36
Stenhousem'r,8877,10,9,8,19,46,75,-29,35
Livingston,8878,1,23,5,8,78,41,37,74
Alloa,8878,2,22,6,8,74,40,34,72
Airdrieon,8878,3,15,11,10,61,54,7,56
Brechin,8878,4,15,10,11,50,43,7,55
Queen's Park,8878,5,15,6,15,39,49,-10,51
Albion,8878,6,14,8,14,51,50,1,50
Peterhead,8878,7,11,10,15,43,47,-4,43
East Fife,8878,8,9,10,17,48,53,-5,37
Stranraer,8878,9,10,5,21,42,64,-22,35
Stenhousem'r,8878,10,7,7,22,44,89,-45,28
Livingston,8879,1,22,4,10,81,43,38,70
Alloa,8879,2,18,8,10,69,48,21,62
Brechin,8879,3,17,9,10,56,45,11,60
Airdrieon,8879,4,16,6,14,58,62,-4,54
East Fife,8879,5,14,9,13,49,43,6,51
Peterhead,8879,6,14,8,14,51,56,-5,50
Albion,8879,7,12,13,11,53,47,6,49
Queen's Park,8879,8,12,7,17,38,50,-12,43
Stranraer,8879,9,12,4,20,49,66,-17,40
Stenhousem'r,8879,10,5,8,23,36,80,-44,23
Airdrieon,8880,1,20,8,8,68,52,16,68
Livingston,8880,2,21,4,11,76,44,32,67
Alloa,8880,3,18,7,11,68,47,21,61
Brechin,8880,4,17,6,13,59,48,11,57
East Fife,8880,5,12,9,15,47,49,-2,45
Peterhead,8880,6,13,6,17,45,56,-11,45
Albion,8880,7,12,7,17,50,49,1,43
Queen's Park,8880,8,13,4,19,38,59,-21,43
Stranraer,8880,9,11,9,16,42,57,-15,42
Stenhousem'r,8880,10,10,6,20,45,77,-32,36
Livingston,8881,1,21,4,11,79,49,30,67
Alloa,8881,2,19,9,8,75,46,29,66
Airdrieon,8881,3,18,9,9,61,48,13,63
Brechin,8881,4,17,6,13,50,51,-1,57
Peterhead,8881,5,12,14,10,52,47,5,50
East Fife,8881,6,12,9,15,48,44,4,45
Albion,8881,7,12,9,15,51,54,-3,45
Stranraer,8881,8,11,5,20,42,59,-17,38
Queen's Park,8881,9,9,8,19,29,51,-22,35
Stenhousem'r,8881,10,7,11,18,41,79,-38,32
Livingston,8882,1,23,2,11,85,44,41,71
Alloa,8882,2,19,8,9,67,43,24,65
Airdrieon,8882,3,17,8,11,58,51,7,59
Peterhead,8882,4,16,8,12,54,54,0,56
Brechin,8882,5,15,7,14,49,52,-3,52
East Fife,8882,6,13,6,17,49,45,4,45
Stranraer,8882,7,13,6,17,50,60,-10,45
Queen's Park,8882,8,13,5,18,42,58,-16,44
Albion,8882,9,13,5,18,41,58,-17,44
Stenhousem'r,8882,10,7,7,22,51,81,-30,28
Livingston,8883,1,19,7,10,70,47,23,64
Alloa,8883,2,19,6,11,65,44,21,63
Airdrieon,8883,3,18,7,11,60,50,10,61
Brechin,8883,4,18,6,12,61,51,10,60
Peterhead,8883,5,14,9,13,52,49,3,51
Albion,8883,6,14,7,15,56,53,3,49
Queen's Park,8883,7,15,4,17,41,45,-4,49
East Fife,8883,8,14,6,16,45,45,0,48
Stranraer,8883,9,10,6,20,41,64,-23,36
Stenhousem'r,8883,10,8,4,24,35,78,-43,28
Livingston,8884,1,19,8,9,72,46,26,65
Alloa,8884,2,17,7,12,69,49,20,58
Airdrieon,8884,3,16,5,15,59,51,8,53
Albion,8884,4,15,8,13,58,56,2,53
Brechin,8884,5,15,8,13,45,47,-2,53
Queen's Park,8884,6,15,8,13,40,43,-3,53
East Fife,8884,7,12,9,15,50,49,1,45
Peterhead,8884,8,11,10,15,42,53,-11,43
Stenhousem'r,8884,9,10,9,17,53,73,-20,39
Stranraer,8884,10,11,6,19,40,61,-21,39
Airdrieon,8885,1,20,5,11,59,54,5,65
Livingston,8885,2,18,6,12,69,55,14,60
Brechin,8885,3,16,9,11,52,46,6,57
Alloa,8885,4,17,5,14,62,47,15,56
Stranraer,8885,5,17,2,17,73,62,11,53
Peterhead,8885,6,13,11,12,47,46,1,50
East Fife,8885,7,12,11,13,53,40,13,47
Queen's Park,8885,8,14,5,17,40,53,-13,47
Albion,8885,9,12,8,16,52,60,-8,44
Stenhousem'r,8885,10,6,8,22,42,86,-44,26
Alloa,8886,1,18,8,10,60,40,20,62
Livingston,8886,2,18,5,13,78,52,26,59
Airdrieon,8886,3,15,9,12,57,52,5,54
Peterhead,8886,4,15,6,15,46,54,-8,51
Stranraer,8886,5,14,8,14,54,56,-2,50
Albion,8886,6,14,7,15,55,56,-1,49
Brechin,8886,7,12,13,11,47,49,-2,49
Queen's Park,8886,8,12,6,18,34,56,-22,42
Stenhousem'r,8886,9,10,11,15,53,67,-14,41
East Fife,8886,10,9,13,14,47,49,-2,40
Livingston,8887,1,24,3,9,84,42,42,75
Alloa,8887,2,20,8,8,80,44,36,68
Airdrieon,8887,3,15,8,13,64,61,3,53
Peterhead,8887,4,14,10,12,57,51,6,52
Brechin,8887,5,14,9,13,48,42,6,51
Albion,8887,6,13,8,15,52,58,-6,47
Queen's Park,8887,7,13,8,15,34,46,-12,47
East Fife,8887,8,13,6,17,42,51,-9,45
Stranraer,8887,9,12,3,21,49,75,-26,39
Stenhousem'r,8887,10,7,7,22,42,82,-40,28
Livingston,8888,1,22,4,10,77,49,28,70
Alloa,8888,2,16,9,11,63,43,20,57
Airdrieon,8888,3,17,6,13,52,51,1,57
Stranraer,8888,4,16,6,14,56,52,4,54
Queen's Park,8888,5,16,5,15,41,48,-7,53
Brechin,8888,6,14,9,13,48,44,4,51
East Fife,8888,7,13,8,15,52,51,1,47
Albion,8888,8,12,11,13,45,44,1,47
Peterhead,8888,9,9,9,18,37,56,-19,36
Stenhousem'r,8888,10,6,11,19,42,75,-33,29
Alloa,8889,1,21,7,8,81,44,37,70
Livingston,8889,2,20,6,10,77,45,32,66
Brechin,8889,3,20,5,11,64,52,12,65
Airdrieon,8889,4,17,9,10,68,50,18,60
Peterhead,8889,5,15,9,12,51,47,4,54
Albion,8889,6,12,9,15,60,63,-3,45
Stranraer,8889,7,12,7,17,45,56,-11,43
East Fife,8889,8,11,9,16,48,45,3,42
Queen's Park,8889,9,8,7,21,25,62,-37,31
Stenhousem'r,8889,10,6,8,22,43,98,-55,26
Livingston,8890,1,23,3,10,85,47,38,72
Alloa,8890,2,21,6,9,70,42,28,69
Brechin,8890,3,16,8,12,55,52,3,56
Airdrieon,8890,4,16,7,13,54,51,3,55
Peterhead,8890,5,15,6,15,54,50,4,51
Stranraer,8890,6,13,11,12,47,50,-3,50
Queen's Park,8890,7,13,7,16,45,58,-13,46
East Fife,8890,8,10,9,17,41,51,-10,39
Albion,8890,9,8,11,17,46,63,-17,35
Stenhousem'r,8890,10,6,10,20,52,85,-33,28
Brechin,8891,1,18,5,13,53,50,3,59
Airdrieon,8891,2,17,7,12,51,49,2,58
Alloa,8891,3,17,6,13,73,50,23,57
Albion,8891,4,15,8,13,58,54,4,53
Livingston,8891,5,15,4,17,75,62,13,49
Stranraer,8891,6,14,7,15,53,61,-8,49
Peterhead,8891,7,13,9,14,48,52,-4,48
East Fife,8891,8,13,8,15,55,49,6,47
Queen's Park,8891,9,13,5,18,39,55,-16,44
Stenhousem'r,8891,10,12,7,17,45,68,-23,43
Livingston,8892,1,22,4,10,85,54,31,70
Airdrieon,8892,2,18,4,14,61,61,0,58
Alloa,8892,3,16,7,13,71,52,19,55
Stranraer,8892,4,16,7,13,60,57,3,55
Brechin,8892,5,17,4,15,54,54,0,55
Albion,8892,6,15,8,13,59,49,10,53
Queen's Park,8892,7,14,5,17,41,58,-17,47
East Fife,8892,8,12,7,17,51,55,-4,43
Peterhead,8892,9,9,10,17,52,65,-13,37
Stenhousem'r,8892,10,10,6,20,49,78,-29,36
Livingston,8893,1,19,9,8,78,49,29,66
Alloa,8893,2,16,12,8,66,44,22,60
Brechin,8893,3,17,6,13,57,46,11,57
Airdrieon,8893,4,15,10,11,56,58,-2,55
Queen's Park,8893,5,14,8,14,45,53,-8,50
East Fife,8893,6,13,9,14,53,50,3,48
Peterhead,8893,7,12,10,14,48,58,-10,46
Albion,8893,8,11,12,13,55,61,-6,45
Stranraer,8893,9,9,9,18,47,61,-14,36
Stenhousem'r,8893,10,8,7,21,52,77,-25,31
Livingston,8894,1,22,4,10,73,42,31,70
Brechin,8894,2,21,4,11,56,40,16,67
Alloa,8894,3,19,7,10,70,49,21,64
Airdrieon,8894,4,16,8,12,61,54,7,56
Stranraer,8894,5,14,7,15,50,52,-2,49
East Fife,8894,6,13,8,15,56,50,6,47
Queen's Park,8894,7,13,6,17,42,53,-11,45
Peterhead,8894,8,12,7,17,43,56,-13,43
Albion,8894,9,9,9,18,40,57,-17,36
Stenhousem'r,8894,10,7,8,21,40,78,-38,29
Livingston,8895,1,23,3,10,81,48,33,72
Alloa,8895,2,20,5,11,75,45,30,65
Brechin,8895,3,15,7,14,49,50,-1,52
Airdrieon,8895,4,15,6,15,55,63,-8,51
Peterhead,8895,5,14,8,14,48,48,0,50
Albion,8895,6,12,13,11,55,58,-3,49
Queen's Park,8895,7,14,7,15,40,49,-9,49
East Fife,8895,8,11,8,17,55,60,-5,41
Stranraer,8895,9,12,5,19,53,66,-13,41
Stenhousem'r,8895,10,10,6,20,52,76,-24,36
Livingston,8896,1,20,4,12,73,54,19,64
Alloa,8896,2,17,8,11,71,44,27,59
Brechin,8896,3,18,5,13,50,53,-3,59
Airdrieon,8896,4,16,8,12,53,52,1,56
Peterhead,8896,5,16,7,13,56,51,5,55
East Fife,8896,6,14,7,15,52,51,1,49
Queen's Park,8896,7,14,5,17,41,55,-14,47
Albion,8896,8,12,10,14,56,56,0,46
Stranraer,8896,9,12,7,17,47,52,-5,43
Stenhousem'r,8896,10,7,7,22,52,83,-31,28
Alloa,8897,1,20,9,7,77,41,36,69
Airdrieon,8897,2,19,8,9,63,49,14,65
Livingston,8897,3,19,3,14,75,52,23,60
Albion,8897,4,14,11,11,58,44,14,53
Brechin,8897,5,15,8,13,52,56,-4,53
East Fife,8897,6,13,7,16,49,49,0,46
Peterhead,8897,7,12,9,15,53,64,-11,45
Stranraer,8897,8,14,2,20,52,59,-7,44
Queen's Park,8897,9,11,7,18,31,56,-25,40
Stenhousem'r,8897,10,7,8,21,44,84,-40,29
Alloa,8898,1,22,7,7,73,41,32,73
Livingston,8898,2,20,6,10,76,42,34,66
Albion,8898,3,14,9,13,56,53,3,51
Airdrieon,8898,4,14,9,13,57,58,-1,51
Brechin,8898,5,14,7,15,46,52,-6,49
Peterhead,8898,6,13,7,16,51,56,-5,46
Stranraer,8898,7,13,6,17,53,61,-8,45
Queen's Park,8898,8,12,7,17,37,53,-16,43
East Fife,8898,9,9,12,15,44,56,-12,39
Stenhousem'r,8898,10,10,8,18,48,69,-21,38
Livingston,8899,1,25,2,9,88,50,38,77
Alloa,8899,2,20,7,9,75,52,23,67
Airdrieon,8899,3,16,8,12,65,55,10,56
Brechin,8899,4,14,8,14,47,49,-2,50
Queen's Park,8899,5,14,8,14,44,50,-6,50
Peterhead,8899,6,13,9,14,47,50,-3,48
Stranraer,8899,7,13,7,16,60,68,-8,46
Albion,8899,8,10,13,13,47,50,-3,43
East Fife,8899,9,8,11,17,50,61,-11,35
Stenhousem'r,8899,10,5,11,20,44,82,-38,26
Alloa,8900,1,21,5,10,72,40,32,68
Livingston,8900,2,21,2,13,66,48,18,65
Airdrieon,8900,3,18,7,11,70,58,12,61
Brechin,8900,4,18,6,12,52,44,8,60
Peterhead,8900,5,15,6,15,61,59,2,51
Queen's Park,8900,6,14,8,14,35,42,-7,50
Stranraer,8900,7,14,5,17,55,57,-2,47
Albion,8900,8,13,7,16,52,56,-4,46
East Fife,8900,9,10,9,17,49,54,-5,39
Stenhousem'r,8900,10,4,9,23,50,104,-54,21
Livingston,8901,1,25,2,9,76,42,34,77
Alloa,8901,2,21,6,9,69,48,21,69
Airdrieon,8901,3,18,4,14,51,43,8,58
Albion,8901,4,17,5,14,57,52,5,56
Brechin,8901,5,18,2,16,56,51,5,56
Queen's Park,8901,6,13,6,17,37,51,-14,45
East Fife,8901,7,10,13,13,48,47,1,43
Peterhead,8901,8,12,6,18,50,65,-15,42
Stranraer,8901,9,12,4,20,52,60,-8,40
Stenhousem'r,8901,10,8,4,24,48,85,-37,28
Alloa,8902,1,24,4,8,84,44,40,76
Livingston,8902,2,20,5,11,75,51,24,65
Brechin,8902,3,17,9,10,60,45,15,60
Albion,8902,4,14,9,13,57,52,5,51
Airdrieon,8902,5,13,12,11,56,58,-2,51
Queen's Park,8902,6,11,10,15,39,48,-9,43
Peterhead,8902,7,12,7,17,49,65,-16,43
East Fife,8902,8,10,12,14,46,47,-1,42
Stranraer,8902,9,9,9,18,45,66,-21,36
Stenhousem'r,8902,10,7,9,20,49,84,-35,30
Alloa,8903,1,23,6,7,73,36,37,75
Airdrieon,8903,2,19,7,10,69,57,12,64
Livingston,8903,3,19,5,12,76,57,19,62
Brechin,8903,4,17,8,11,55,49,6,59
Peterhead,8903,5,14,8,14,57,49,8,50
Albion,8903,6,14,8,14,57,53,4,50
Stranraer,8903,7,14,5,17,49,62,-13,47
Queen's Park,8903,8,10,10,16,36,52,-16,40
East Fife,8903,9,8,8,20,47,62,-15,32
Stenhousem'r,8903,10,6,7,23,50,92,-42,25
Livingston,8904,1,24,3,9,83,44,39,75
Alloa,8904,2,19,10,7,83,46,37,67
Airdrieon,8904,3,17,7,12,63,56,7,58
Brechin,8904,4,17,5,14,54,56,-2,56
Albion,8904,5,12,11,13,52,54,-2,47
Queen's Park,8904,6,11,11,14,35,47,-12,44
Stranraer,8904,7,12,7,17,50,59,-9,43
Peterhead,8904,8,9,13,14,46,61,-15,40
East Fife,8904,9,9,11,16,44,54,-10,38
Stenhousem'r,8904,10,6,10,20,46,79,-33,28
Livingston,8905,1,24,3,9,88,56,32,75
Alloa,8905,2,16,10,10,64,44,20,58
Airdrieon,8905,3,15,9,12,58,56,2,54
East Fife,8905,4,15,6,15,52,43,9,51
Brechin,8905,5,16,3,17,48,50,-2,51
Queen's Park,8905,6,13,10,13,39,41,-2,49
Stranraer,8905,7,13,6,17,50,59,-9,45
Peterhead,8905,8,13,5,18,43,53,-10,44
Albion,8905,9,11,9,16,44,55,-11,42
Stenhousem'r,8905,10,9,9,18,40,69,-29,36
Livingston,8906,1,22,4,10,83,48,35,70
Peterhead,8906,2,17,10,9,53,45,8,61
Alloa,8906,3,16,10,10,72,56,16,58
Airdrieon,8906,4,15,9,12,67,57,10,54
Albion,8906,5,13,12,11,50,50,0,51
Queen's Park,8906,6,14,8,14,48,52,-4,50
Brechin,8906,7,13,9,14,56,59,-3,48
Stranraer,8906,8,12,8,16,50,56,-6,44
East Fife,8906,9,11,8,17,43,49,-6,41
Stenhousem'r,8906,10,5,6,25,42,92,-50,21
Livingston,8907,1,22,2,12,78,51,27,68
Alloa,8907,2,18,8,10,77,50,27,62
Airdrieon,8907,3,18,5,13,62,56,6,59
Brechin,8907,4,16,8,12,64,63,1,56
Albion,8907,5,14,6,16,51,55,-4,48
East Fife,8907,6,12,11,13,47,47,0,47
Peterhead,8907,7,13,7,16,40,48,-8,46
Queen's Park,8907,8,11,9,16,40,52,-12,42
Stenhousem'r,8907,9,11,9,16,58,74,-16,42
Stranraer,8907,10,10,5,21,55,76,-21,35
Alloa,8908,1,22,7,7,65,32,33,73
Livingston,8908,2,21,4,11,71,46,25,67
Brechin,8908,3,16,9,11,56,43,13,57
Airdrieon,8908,4,15,8,13,51,53,-2,53
Queen's Park,8908,5,14,7,15,41,52,-11,49
East Fife,8908,6,11,14,11,56,49,7,47
Peterhead,8908,7,13,6,17,39,47,-8,45
Albion,8908,8,9,11,16,45,55,-10,38
Stranraer,8908,9,10,8,18,43,58,-15,38
Stenhousem'r,8908,10,9,6,21,47,79,-32,33
Airdrieon,8909,1,19,7,10,68,53,15,64
Alloa,8909,2,18,9,9,76,50,26,63
Livingston,8909,3,17,10,9,78,52,26,61
Brechin,8909,4,14,9,13,53,53,0,51
Peterhead,8909,5,14,7,15,58,57,1,49
Albion,8909,6,13,9,14,54,58,-4,48
Stranraer,8909,7,12,9,15,52,58,-6,45
East Fife,8909,8,10,12,14,55,59,-4,42
Stenhousem'r,8909,9,10,9,17,51,75,-24,39
Queen's Park,8909,10,9,7,20,36,66,-30,34
Livingston,8910,1,25,1,10,92,49,43,76
Alloa,8910,2,17,10,9,66,43,23,61
Peterhead,8910,3,17,6,13,58,50,8,57
Airdrieon,8910,4,16,8,12,55,65,-10,56
Brechin,8910,5,17,3,16,53,56,-3,54
Albion,8910,6,13,8,15,53,51,2,47
Queen's Park,8910,7,12,8,16,38,57,-19,44
Stranraer,8910,8,11,7,18,52,60,-8,40
East Fife,8910,9,9,10,17,48,50,-2,37
Stenhousem'r,8910,10,9,7,20,50,84,-34,34
Livingston,8911,1,22,3,11,77,48,29,69
Airdrieon,8911,2,20,6,10,56,43,13,66
Alloa,8911,3,18,8,10,64,44,20,62
Brechin,8911,4,18,8,10,54,40,14,62
Stranraer,8911,5,14,7,15,54,50,4,49
Albion,8911,6,12,11,13,49,50,-1,47
East Fife,8911,7,12,8,16,45,50,-5,44
Queen's Park,8911,8,12,7,17,30,46,-16,43
Peterhead,8911,9,11,7,18,52,67,-15,40
Stenhousem'r,8911,10,4,9,23,43,86,-43,21
Livingston,8912,1,24,4,8,84,43,41,76
Brechin,8912,2,17,11,8,52,40,12,62
Airdrieon,8912,3,18,5,13,63,58,5,59
Alloa,8912,4,16,8,12,67,46,21,56
Albion,8912,5,15,10,11,53,48,5,55
Peterhead,8912,6,14,10,12,51,53,-2,52
East Fife,8912,7,11,10,15,50,52,-2,43
Stranraer,8912,8,10,7,19,39,58,-19,37
Queen's Park,8912,9,9,10,17,32,52,-20,37
Stenhousem'r,8912,10,5,7,24,41,82,-41,22
Airdrieon,8913,1,19,9,8,66,48,18,66
Brechin,8913,2,19,5,12,59,50,9,62
Livingston,8913,3,15,11,10,72,59,13,56
Albion,8913,4,15,9,12,58,46,12,54
Alloa,8913,5,14,11,11,64,54,10,53
Stenhousem'r,8913,6,14,6,16,57,67,-10,48
Queen's Park,8913,7,12,9,15,39,50,-11,45
Peterhead,8913,8,11,7,18,38,56,-18,40
East Fife,8913,9,9,12,15,48,54,-6,39
Stranraer,8913,10,9,7,20,43,60,-17,34
Brechin,8914,1,21,5,10,60,46,14,68
Livingston,8914,2,20,5,11,78,54,24,65
Alloa,8914,3,17,7,12,63,42,21,58
Airdrieon,8914,4,15,8,13,64,61,3,53
Albion,8914,5,13,10,13,61,68,-7,49
Stranraer,8914,6,13,7,16,47,54,-7,46
Queen's Park,8914,7,13,6,17,40,52,-12,45
Peterhead,8914,8,11,11,14,47,55,-8,44
Stenhousem'r,8914,9,11,9,16,50,71,-21,42
East Fife,8914,10,7,10,19,49,56,-7,31
Livingston,8915,1,21,3,12,75,46,29,66
Alloa,8915,2,18,11,7,76,48,28,65
Queen's Park,8915,3,17,6,13,51,46,5,57
Airdrieon,8915,4,15,8,13,66,63,3,53
Albion,8915,5,14,10,12,61,52,9,52
Brechin,8915,6,13,10,13,45,50,-5,49
Peterhead,8915,7,12,9,15,50,60,-10,45
East Fife,8915,8,10,12,14,46,51,-5,42
Stenhousem'r,8915,9,9,9,18,49,75,-26,36
Stranraer,8915,10,11,2,23,40,68,-28,35
Livingston,8916,1,20,3,13,70,49,21,63
Alloa,8916,2,18,9,9,68,48,20,63
Brechin,8916,3,19,5,12,55,44,11,62
Albion,8916,4,15,9,12,58,52,6,54
Airdrieon,8916,5,15,7,14,64,68,-4,52
Peterhead,8916,6,13,10,13,56,53,3,49
Queen's Park,8916,7,14,6,16,45,51,-6,48
East Fife,8916,8,11,11,14,50,51,-1,44
Stranraer,8916,9,12,8,16,46,52,-6,44
Stenhousem'r,8916,10,6,6,24,41,85,-44,24
Alloa,8917,1,19,8,9,66,44,22,65
Brechin,8917,2,18,3,15,47,40,7,57
Livingston,8917,3,17,5,14,61,46,15,56
Airdrieon,8917,4,16,7,13,60,57,3,55
Queen's Park,8917,5,16,7,13,52,49,3,55
Peterhead,8917,6,15,8,13,55,52,3,53
Albion,8917,7,15,7,14,58,49,9,52
Stenhousem'r,8917,8,12,5,19,49,80,-31,41
Stranraer,8917,9,11,7,18,47,63,-16,40
East Fife,8917,10,7,11,18,43,58,-15,32
Brechin,8918,1,20,7,9,59,39,20,67
Livingston,8918,2,20,5,11,71,46,25,65
Alloa,8918,3,18,9,9,69,47,22,63
Airdrieon,8918,4,15,9,12,49,47,2,54
Peterhead,8918,5,14,5,17,41,47,-6,47
East Fife,8918,6,11,13,12,40,44,-4,46
Queen's Park,8918,7,13,5,18,41,60,-19,44
Stranraer,8918,8,10,10,16,52,59,-7,40
Stenhousem'r,8918,9,11,5,20,50,78,-28,38
Albion,8918,10,9,10,17,48,53,-5,37
Livingston,8919,1,19,7,10,68,46,22,64
Alloa,8919,2,19,6,11,73,49,24,63
Peterhead,8919,3,19,6,11,57,50,7,63
Brechin,8919,4,18,7,11,50,42,8,61
Queen's Park,8919,5,15,6,15,41,40,1,51
Airdrieon,8919,6,14,8,14,53,48,5,50
Albion,8919,7,11,10,15,45,50,-5,43
East Fife,8919,8,11,9,16,52,54,-2,42
Stranraer,8919,9,11,7,18,47,68,-21,40
Stenhousem'r,8919,10,8,4,24,42,81,-39,28
Alloa,8920,1,20,5,11,83,48,35,65
Livingston,8920,2,19,7,10,74,53,21,64
Airdrieon,8920,3,17,10,9,59,51,8,61
Brechin,8920,4,15,8,13,50,52,-2,53
Albion,8920,5,14,10,12,57,52,5,52
Peterhead,8920,6,14,6,16,51,63,-12,48
East Fife,8920,7,12,10,14,56,51,5,46
Queen's Park,8920,8,10,9,17,41,61,-20,39
Stenhousem'r,8920,9,10,7,19,44,72,-28,37
Stranraer,8920,10,10,6,20,57,69,-12,36
Livingston,8921,1,23,5,8,78,41,37,74
Alloa,8921,2,19,7,10,70,48,22,64
Airdrieon,8921,3,18,6,12,61,51,10,60
East Fife,8921,4,14,8,14,48,41,7,50
Albion,8921,5,13,10,13,57,56,1,49
Peterhead,8921,6,14,7,15,52,56,-4,49
Brechin,8921,7,13,6,17,43,53,-10,45
Queen's Park,8921,8,12,6,18,34,60,-26,42
Stranraer,8921,9,11,6,19,51,67,-16,39
Stenhousem'r,8921,10,10,5,21,56,77,-21,35
Livingston,8922,1,23,4,9,70,36,34,73
Brechin,8922,2,18,8,10,55,39,16,62
Airdrieon,8922,3,17,6,13,60,62,-2,57
Albion,8922,4,16,6,14,49,46,3,54
Alloa,8922,5,15,8,13,72,46,26,53
Queen's Park,8922,6,14,6,16,36,51,-15,48
Peterhead,8922,7,13,6,17,45,52,-7,45
East Fife,8922,8,10,11,15,58,57,1,41
Stranraer,8922,9,9,9,18,41,62,-21,36
Stenhousem'r,8922,10,8,10,18,46,81,-35,34
Livingston,8923,1,25,3,8,78,41,37,78
Airdrieon,8923,2,20,6,10,68,50,18,66
Alloa,8923,3,17,7,12,66,55,11,58
Albion,8923,4,16,5,15,55,54,1,53
Queen's Park,8923,5,15,7,14,44,51,-7,52
Brechin,8923,6,15,4,17,51,58,-7,49
Peterhead,8923,7,14,6,16,55,52,3,48
Stranraer,8923,8,13,4,19,48,53,-5,43
East Fife,8923,9,11,7,18,45,54,-9,40
Stenhousem'r,8923,10,7,5,24,47,89,-42,26
Livingston,8924,1,25,4,7,77,39,38,79
Alloa,8924,2,18,8,10,62,39,23,62
Brechin,8924,3,19,5,12,46,35,11,62
Peterhead,8924,4,14,9,13,50,48,2,51
Airdrieon,8924,5,12,9,15,48,57,-9,45
Stranraer,8924,6,14,3,19,50,62,-12,45
Queen's Park,8924,7,13,5,18,41,58,-17,44
Albion,8924,8,12,7,17,44,51,-7,43
East Fife,8924,9,10,9,17,48,51,-3,39
Stenhousem'r,8924,10,11,5,20,53,79,-26,38
Livingston,8925,1,23,1,12,69,45,24,70
Alloa,8925,2,17,11,8,62,41,21,62
Airdrieon,8925,3,17,5,14,54,47,7,56
Peterhead,8925,4,15,9,12,42,45,-3,54
Brechin,8925,5,14,8,14,50,49,1,50
Albion,8925,6,14,6,16,52,57,-5,48
Stranraer,8925,7,13,7,16,49,56,-7,46
East Fife,8925,8,11,11,14,49,51,-2,44
Stenhousem'r,8925,9,9,12,15,50,64,-14,39
Queen's Park,8925,10,8,8,20,30,52,-22,32
Airdrieon,8926,1,20,6,10,57,47,10,66
Livingston,8926,2,20,5,11,77,46,31,65
Alloa,8926,3,18,9,9,73,45,28,63
Albion,8926,4,16,7,13,57,43,14,55
Peterhead,8926,5,15,9,12,55,55,0,54
Brechin,8926,6,15,6,15,42,44,-2,51
Queen's Park,8926,7,13,8,15,39,51,-12,47
Stranraer,8926,8,13,6,17,48,58,-10,45
East Fife,8926,9,8,11,17,46,57,-11,35
Stenhousem'r,8926,10,5,7,24,36,84,-48,22
Alloa,8927,1,23,7,6,71,32,39,76
Livingston,8927,2,20,5,11,73,48,25,65
Airdrieon,8927,3,19,8,9,64,48,16,65
Brechin,8927,4,17,6,13,48,44,4,57
Peterhead,8927,5,15,5,16,44,51,-7,50
Queen's Park,8927,6,13,5,18,41,54,-13,44
East Fife,8927,7,11,10,15,50,50,0,43
Albion,8927,8,11,7,18,49,58,-9,40
Stranraer,8927,9,11,5,20,47,62,-15,38
Stenhousem'r,8927,10,7,8,21,47,87,-40,29
Livingston,8928,1,22,8,6,71,41,30,74
Alloa,8928,2,19,10,7,72,35,37,67
Airdrieon,8928,3,19,8,9,59,40,19,65
Brechin,8928,4,15,8,13,46,45,1,53
Albion,8928,5,12,10,14,49,49,0,46
Peterhead,8928,6,13,6,17,44,65,-21,45
East Fife,8928,7,12,8,16,46,49,-3,44
Queen's Park,8928,8,12,8,16,38,47,-9,44
Stenhousem'r,8928,9,8,9,19,43,74,-31,33
Stranraer,8928,10,8,5,23,41,64,-23,29
Livingston,8929,1,22,7,7,83,38,45,73
Alloa,8929,2,20,8,8,72,40,32,68
Brechin,8929,3,17,8,11,49,44,5,59
Albion,8929,4,13,8,15,52,54,-2,47
Airdrieon,8929,5,12,10,14,57,63,-6,46
Queen's Park,8929,6,12,9,15,41,61,-20,45
Peterhead,8929,7,10,11,15,51,63,-12,41
Stranraer,8929,8,12,5,19,53,67,-14,41
Stenhousem'r,8929,9,11,8,17,50,70,-20,41
East Fife,8929,10,8,12,16,48,56,-8,36
Livingston,8930,1,21,4,11,70,46,24,67
Alloa,8930,2,18,9,9,69,44,25,63
Albion,8930,3,15,9,12,64,52,12,54
Airdrieon,8930,4,14,8,14,53,49,4,50
Peterhead,8930,5,13,10,13,41,52,-11,49
Stranraer,8930,6,13,9,14,58,59,-1,48
Brechin,8930,7,12,10,14,45,58,-13,46
Stenhousem'r,8930,8,12,8,16,52,63,-11,44
East Fife,8930,9,10,9,17,46,53,-7,39
Queen's Park,8930,10,10,8,18,34,56,-22,38
Livingston,8931,1,22,8,6,77,38,39,74
Alloa,8931,2,15,11,10,64,48,16,56
East Fife,8931,3,15,10,11,50,41,9,55
Airdrieon,8931,4,15,7,14,56,56,0,52
Brechin,8931,5,14,7,15,49,49,0,49
Peterhead,8931,6,12,11,13,53,52,1,47
Queen's Park,8931,7,13,8,15,39,53,-14,47
Stranraer,8931,8,12,7,17,46,55,-9,43
Albion,8931,9,10,11,15,49,57,-8,41
Stenhousem'r,8931,10,8,8,20,47,81,-34,32
Livingston,8932,1,21,2,13,85,51,34,65
Alloa,8932,2,17,10,9,63,37,26,61
Albion,8932,3,17,7,12,52,45,7,58
Airdrieon,8932,4,16,8,12,55,58,-3,56
Brechin,8932,5,15,6,15,45,50,-5,51
Peterhead,8932,6,15,4,17,54,61,-7,49
Stranraer,8932,7,14,5,17,51,57,-6,47
Queen's Park,8932,8,11,10,15,38,50,-12,43
Stenhousem'r,8932,9,10,10,16,48,65,-17,40
East Fife,8932,10,9,8,19,41,58,-17,35
Airdrieon,8933,1,21,5,10,72,48,24,68
Alloa,8933,2,19,10,7,69,44,25,67
Livingston,8933,3,20,1,15,76,56,20,61
Albion,8933,4,14,9,13,54,56,-2,51
Brechin,8933,5,13,11,12,45,49,-4,50
Stranraer,8933,6,14,7,15,58,63,-5,49
Peterhead,8933,7,13,9,14,43,49,-6,48
East Fife,8933,8,12,8,16,50,46,4,44
Queen's Park,8933,9,9,7,20,34,55,-21,34
Stenhousem'r,8933,10,8,7,21,43,78,-35,31
Livingston,8934,1,20,6,10,72,54,18,66
Alloa,8934,2,19,7,10,70,41,29,64
Brechin,8934,3,18,6,12,53,44,9,60
East Fife,8934,4,15,7,14,49,46,3,52
Airdrieon,8934,5,13,11,12,50,50,0,50
Queen's Park,8934,6,14,5,17,38,54,-16,47
Albion,8934,7,13,5,18,53,51,2,44
Stranraer,8934,8,12,6,18,50,61,-11,42
Peterhead,8934,9,11,9,16,45,59,-14,42
Stenhousem'r,8934,10,9,10,17,47,67,-20,37
Brechin,8935,1,21,6,9,64,42,22,69
Alloa,8935,2,20,6,10,71,46,25,66
Livingston,8935,3,17,9,10,71,50,21,60
Airdrieon,8935,4,17,8,11,56,48,8,59
Stranraer,8935,5,15,8,13,45,44,1,53
East Fife,8935,6,12,9,15,52,57,-5,45
Albion,8935,7,10,13,13,51,55,-4,43
Peterhead,8935,8,10,9,17,45,57,-12,39
Queen's Park,8935,9,9,10,17,34,56,-22,37
Stenhousem'r,8935,10,7,6,23,45,79,-34,27
Livingston,8936,1,21,7,8,85,50,35,70
Alloa,8936,2,19,7,10,74,51,23,64
Brechin,8936,3,18,8,10,59,52,7,62
Airdrieon,8936,4,15,9,12,62,60,2,54
Peterhead,8936,5,13,8,15,52,62,-10,47
Queen's Park,8936,6,12,7,17,40,51,-11,43
Stranraer,8936,7,11,9,16,56,64,-8,42
East Fife,8936,8,11,8,17,43,44,-1,41
Stenhousem'r,8936,9,9,11,16,48,71,-23,38
Albion,8936,10,9,10,17,43,57,-14,37
Alloa,8937,1,20,7,9,65,45,20,67
Livingston,8937,2,18,10,8,64,35,29,64
Brechin,8937,3,19,5,12,54,43,11,62
Airdrieon,8937,4,16,7,13,63,68,-5,55
Peterhead,8937,5,15,5,16,57,54,3,50
Albion,8937,6,13,10,13,58,50,8,49
East Fife,8937,7,12,9,15,61,52,9,45
Queen's Park,8937,8,11,7,18,39,61,-22,40
Stranraer,8937,9,11,6,19,47,64,-17,39
Stenhousem'r,8937,10,8,8,20,46,82,-36,32
Alloa,8938,1,24,4,8,78,38,40,76
Livingston,8938,2,20,7,9,76,50,26,67
Brechin,8938,3,15,6,15,68,62,6,51
East Fife,8938,4,15,6,15,51,53,-2,51
Queen's Park,8938,5,16,3,17,45,47,-2,51
Airdrieon,8938,6,14,8,14,60,70,-10,50
Peterhead,8938,7,14,6,16,46,52,-6,48
Albion,8938,8,11,10,15,54,61,-7,43
Stranraer,8938,9,12,5,19,57,67,-10,41
Stenhousem'r,8938,10,8,7,21,48,83,-35,31
Livingston,8939,1,25,4,7,80,43,37,79
Alloa,8939,2,18,6,12,71,40,31,60
Airdrieon,8939,3,17,7,12,67,53,14,58
Brechin,8939,4,15,6,15,47,51,-4,51
Stranraer,8939,5,13,8,15,48,62,-14,47
East Fife,8939,6,12,10,14,56,51,5,46
Albion,8939,7,12,8,16,46,56,-10,44
Queen's Park,8939,8,12,6,18,33,45,-12,42
Peterhead,8939,9,11,8,17,41,53,-12,41
Stenhousem'r,8939,10,10,7,19,44,79,-35,37
Livingston,8940,1,21,7,8,80,49,31,70
Alloa,8940,2,16,13,7,67,45,22,61
Airdrieon,8940,3,16,10,10,57,53,4,58
Albion,8940,4,16,9,11,65,50,15,57
Brechin,8940,5,14,9,13,51,54,-3,51
Stenhousem'r,8940,6,12,8,16,59,73,-14,44
Stranraer,8940,7,10,12,14,50,58,-8,42
Peterhead,8940,8,10,10,16,41,51,-10,40
Queen's Park,8940,9,9,8,19,29,55,-26,35
East Fife,8940,10,6,14,16,43,54,-11,32
Alloa,8941,1,24,7,5,69,27,42,79
Livingston,8941,2,19,4,13,65,43,22,61
Albion,8941,3,16,11,9,48,37,11,59
Brechin,8941,4,13,11,12,48,44,4,50
Stranraer,8941,5,14,7,15,47,52,-5,49
Airdrieon,8941,6,14,7,15,44,49,-5,49
Peterhead,8941,7,14,7,15,43,49,-6,49
Queen's Park,8941,8,13,4,19,32,54,-22,43
Stenhousem'r,8941,9,8,8,20,45,71,-26,32
East Fife,8941,10,7,10,19,40,55,-15,31
Alloa,8942,1,21,7,8,75,40,35,70
Livingston,8942,2,20,6,10,70,48,22,66
Airdrieon,8942,3,18,6,12,53,50,3,60
Brechin,8942,4,16,6,14,57,59,-2,54
Stranraer,8942,5,15,7,14,50,53,-3,52
Peterhead,8942,6,13,8,15,43,42,1,47
Albion,8942,7,12,8,16,46,52,-6,44
Queen's Park,8942,8,11,9,16,35,52,-17,42
East Fife,8942,9,10,10,16,55,52,3,40
Stenhousem'r,8942,10,5,11,20,47,83,-36,26
Livingston,8943,1,21,6,9,80,53,27,69
Airdrieon,8943,2,19,7,10,60,44,16,64
Alloa,8943,3,17,8,11,77,61,16,59
Albion,8943,4,17,7,12,63,53,10,58
Brechin,8943,5,15,7,14,59,60,-1,52
East Fife,8943,6,12,12,12,50,51,-1,48
Peterhead,8943,7,13,7,16,46,58,-12,46
Stranraer,8943,8,12,5,19,53,58,-5,41
Queen's Park,8943,9,8,11,17,34,58,-24,35
Stenhousem'r,8943,10,8,6,22,53,79,-26,30
Alloa,8944,1,23,5,8,79,40,39,74
Livingston,8944,2,20,3,13,79,52,27,63
Airdrieon,8944,3,18,5,13,56,58,-2,59
Albion,8944,4,17,6,13,63,54,9,57
East Fife,8944,5,16,7,13,53,47,6,55
Brechin,8944,6,15,5,16,64,66,-2,50
Stranraer,8944,7,15,2,19,58,67,-9,47
Peterhead,8944,8,13,8,15,46,55,-9,47
Queen's Park,8944,9,9,6,21,29,55,-26,33
Stenhousem'r,8944,10,7,7,22,44,77,-33,28
Albion,8945,1,21,9,6,61,31,30,72
Livingston,8945,2,19,4,13,64,55,9,61
Alloa,8945,3,17,9,10,70,44,26,60
Airdrieon,8945,4,15,8,13,64,63,1,53
Peterhead,8945,5,15,5,16,49,51,-2,50
Brechin,8945,6,13,8,15,52,58,-6,47
East Fife,8945,7,10,12,14,51,47,4,42
Stranraer,8945,8,13,3,20,49,64,-15,42
Queen's Park,8945,9,11,8,17,33,55,-22,41
Stenhousem'r,8945,10,8,10,18,47,72,-25,34
Airdrieon,8946,1,20,7,9,74,56,18,67
Livingston,8946,2,20,6,10,70,44,26,66
Alloa,8946,3,16,10,10,60,45,15,58
East Fife,8946,4,15,11,10,61,45,16,56
Albion,8946,5,14,8,14,59,55,4,50
Brechin,8946,6,14,8,14,47,55,-8,50
Stranraer,8946,7,14,6,16,59,65,-6,48
Peterhead,8946,8,12,9,15,39,45,-6,45
Queen's Park,8946,9,9,6,21,30,59,-29,33
Stenhousem'r,8946,10,6,9,21,42,72,-30,27
Alloa,8947,1,20,7,9,76,40,36,67
Livingston,8947,2,21,3,12,79,47,32,66
Peterhead,8947,3,17,7,12,60,48,12,58
Airdrieon,8947,4,17,5,14,54,54,0,56
Brechin,8947,5,16,4,16,49,59,-10,52
Albion,8947,6,15,6,15,52,46,6,51
East Fife,8947,7,12,9,15,46,50,-4,45
Stranraer,8947,8,14,3,19,57,67,-10,45
Queen's Park,8947,9,12,6,18,38,57,-19,42
Stenhousem'r,8947,10,7,8,21,44,87,-43,29
Livingston,8948,1,24,2,10,77,48,29,74
Alloa,8948,2,20,6,10,78,43,35,66
Airdrieon,8948,3,17,4,15,55,59,-4,55
East Fife,8948,4,13,11,12,50,43,7,50
Albion,8948,5,14,8,14,50,47,3,50
Peterhead,8948,6,13,9,14,45,54,-9,48
Queen's Park,8948,7,12,7,17,41,52,-11,43
Stranraer,8948,8,12,7,17,49,62,-13,43
Brechin,8948,9,13,4,19,37,50,-13,43
Stenhousem'r,8948,10,9,8,19,48,72,-24,35
Alloa,8949,1,19,9,8,76,36,40,66
Livingston,8949,2,19,5,12,74,52,22,62
Airdrieon,8949,3,18,8,10,58,44,14,62
Brechin,8949,4,17,7,12,52,37,15,58
Peterhead,8949,5,13,9,14,42,55,-13,48
Stenhousem'r,8949,6,13,7,16,53,67,-14,46
Queen's Park,8949,7,11,8,17,36,59,-23,41
East Fife,8949,8,10,10,16,42,48,-6,40
Stranraer,8949,9,10,9,17,46,68,-22,39
Albion,8949,10,10,8,18,45,58,-13,38
Livingston,8950,1,22,4,10,71,44,27,70
Alloa,8950,2,16,9,11,69,49,20,57
Airdrieon,8950,3,17,6,13,68,56,12,57
Brechin,8950,4,16,7,13,57,45,12,55
Stranraer,8950,5,16,6,14,50,53,-3,54
Peterhead,8950,6,13,8,15,51,61,-10,47
Queen's Park,8950,7,13,6,17,38,47,-9,45
Albion,8950,8,11,10,15,47,54,-7,43
East Fife,8950,9,10,12,14,41,51,-10,42
Stenhousem'r,8950,10,7,10,19,48,80,-32,31
Livingston,8951,1,24,2,10,80,47,33,74
Brechin,8951,2,19,8,9,63,38,25,65
Airdrieon,8951,3,19,6,11,63,47,16,63
Peterhead,8951,4,13,8,15,51,59,-8,47
Stranraer,8951,5,14,4,18,48,60,-12,46
Alloa,8951,6,12,9,15,63,64,-1,45
Albion,8951,7,11,12,13,48,53,-5,45
East Fife,8951,8,9,12,15,37,42,-5,39
Queen's Park,8951,9,10,9,17,33,53,-20,39
Stenhousem'r,8951,10,11,6,19,49,72,-23,39
Livingston,8952,1,22,7,7,72,44,28,73
Alloa,8952,2,18,10,8,82,46,36,64
Albion,8952,3,15,8,13,55,43,12,53
Peterhead,8952,4,13,9,14,49,53,-4,48
Queen's Park,8952,5,14,6,16,40,49,-9,48
Brechin,8952,6,14,6,16,49,59,-10,48
Airdrieon,8952,7,14,6,16,48,58,-10,48
Stranraer,8952,8,13,4,19,53,62,-9,43
East Fife,8952,9,10,10,16,44,47,-3,40
Stenhousem'r,8952,10,9,10,17,48,79,-31,37
Alloa,8953,1,21,8,7,68,37,31,71
Brechin,8953,2,19,7,10,63,46,17,64
Livingston,8953,3,20,3,13,76,49,27,63
Airdrieon,8953,4,17,10,9,64,50,14,61
East Fife,8953,5,14,7,15,54,44,10,49
Peterhead,8953,6,13,8,15,53,52,1,47
Queen's Park,8953,7,12,8,16,33,48,-15,44
Stranraer,8953,8,12,7,17,59,69,-10,43
Albion,8953,9,9,7,20,49,74,-25,34
Stenhousem'r,8953,10,6,9,21,45,95,-50,27
Alloa,8954,1,21,4,11,68,40,28,67
Livingston,8954,2,21,4,11,78,52,26,67
Airdrieon,8954,3,18,7,11,60,49,11,61
Brechin,8954,4,17,2,17,45,50,-5,53
Stranraer,8954,5,15,4,17,53,54,-1,49
Peterhead,8954,6,13,7,16,47,56,-9,46
East Fife,8954,7,13,6,17,46,44,2,45
Queen's Park,8954,8,13,6,17,32,45,-13,45
Albion,8954,9,12,7,17,48,61,-13,43
Stenhousem'r,8954,10,11,5,20,53,79,-26,38
Alloa,8955,1,18,10,8,71,48,23,64
Livingston,8955,2,18,6,12,72,56,16,60
Brechin,8955,3,17,9,10,53,41,12,60
Airdrieon,8955,4,16,6,14,52,47,5,54
Peterhead,8955,5,16,5,15,49,51,-2,53
East Fife,8955,6,15,7,14,51,43,8,52
Albion,8955,7,13,10,13,54,50,4,49
Queen's Park,8955,8,14,4,18,41,51,-10,46
Stranraer,8955,9,11,6,19,57,74,-17,39
Stenhousem'r,8955,10,7,7,22,45,84,-39,28
Livingston,8956,1,22,2,12,79,51,28,68
Alloa,8956,2,20,7,9,72,45,27,67
Airdrieon,8956,3,18,9,9,63,54,9,63
Albion,8956,4,16,6,14,57,49,8,54
Peterhead,8956,5,15,6,15,48,47,1,51
Brechin,8956,6,15,6,15,52,55,-3,51
Queen's Park,8956,7,11,9,16,42,56,-14,42
East Fife,8956,8,11,7,18,46,51,-5,40
Stranraer,8956,9,11,5,20,41,59,-18,38
Stenhousem'r,8956,10,8,9,19,47,80,-33,33
Livingston,8957,1,20,6,10,80,52,28,66
Alloa,8957,2,18,6,12,71,55,16,60
Airdrieon,8957,3,18,5,13,58,58,0,59
Albion,8957,4,16,10,10,65,52,13,58
Stranraer,8957,5,16,5,15,59,57,2,53
Brechin,8957,6,14,7,15,43,51,-8,49
Peterhead,8957,7,12,10,14,53,55,-2,46
Stenhousem'r,8957,8,11,11,14,52,71,-19,44
East Fife,8957,9,9,10,17,45,48,-3,37
Queen's Park,8957,10,8,6,22,29,56,-27,30
Livingston,8958,1,24,5,7,85,44,41,77
Alloa,8958,2,19,6,11,67,46,21,63
Airdrieon,8958,3,19,5,12,60,52,8,62
East Fife,8958,4,16,8,12,55,42,13,56
Brechin,8958,5,14,6,16,51,52,-1,48
Peterhead,8958,6,14,4,18,48,61,-13,46
Stranraer,8958,7,12,8,16,50,55,-5,44
Albion,8958,8,12,5,19,49,63,-14,41
Queen's Park,8958,9,12,5,19,37,59,-22,41
Stenhousem'r,8958,10,10,4,22,51,79,-28,34
Livingston,8959,1,21,8,7,74,36,38,71
Alloa,8959,2,20,8,8,63,36,27,68
Albion,8959,3,16,9,11,59,48,11,57
Airdrieon,8959,4,17,5,14,56,53,3,56
Brechin,8959,5,15,7,14,50,50,0,52
Peterhead,8959,6,15,6,15,49,55,-6,51
East Fife,8959,7,9,11,16,47,55,-8,38
Queen's Park,8959,8,9,11,16,31,46,-15,38
Stranraer,8959,9,11,4,21,44,68,-24,37
Stenhousem'r,8959,10,9,7,20,46,72,-26,34
Livingston,8960,1,19,6,11,65,38,27,63
Brechin,8960,2,19,5,12,52,41,11,62
Airdrieon,8960,3,18,7,11,61,51,10,61
Alloa,8960,4,14,11,11,65,54,11,53
Queen's Park,8960,5,15,8,13,38,45,-7,53
Albion,8960,6,14,9,13,49,41,8,51
Stranraer,8960,7,11,10,15,50,54,-4,43
East Fife,8960,8,9,11,16,43,56,-13,38
Peterhead,8960,9,7,14,15,39,53,-14,35
Stenhousem'r,8960,10,8,11,17,47,76,-29,35
Livingston,8961,1,21,6,9,82,52,30,69
Alloa,8961,2,19,4,13,71,47,24,61
Brechin,8961,3,18,6,12,64,55,9,60
Airdrieon,8961,4,17,6,13,66,59,7,57
Queen's Park,8961,5,15,6,15,43,55,-12,51
Peterhead,8961,6,14,7,15,47,51,-4,49
Albion,8961,7,12,6,18,49,59,-10,42
Stenhousem'r,8961,8,11,7,18,47,74,-27,40
East Fife,8961,9,10,9,17,56,58,-2,39
Stranraer,8961,10,10,9,17,49,64,-15,39
Livingston,8962,1,25,2,9,84,43,41,77
Alloa,8962,2,18,7,11,68,48,20,61
Airdrieon,8962,3,18,4,14,63,56,7,58
Albion,8962,4,16,8,12,64,54,10,56
Stranraer,8962,5,16,4,16,53,56,-3,52
Brechin,8962,6,14,5,17,51,57,-6,47
East Fife,8962,7,11,10,15,54,59,-5,43
Queen's Park,8962,8,12,7,17,33,53,-20,43
Peterhead,8962,9,10,10,16,50,65,-15,40
Stenhousem'r,8962,10,6,11,19,45,74,-29,29
Livingston,8963,1,19,9,8,79,49,30,66
Airdrieon,8963,2,19,9,8,68,51,17,66
Alloa,8963,3,15,12,9,71,45,26,57
Brechin,8963,4,16,6,14,51,54,-3,54
Stranraer,8963,5,15,5,16,57,61,-4,50
Albion,8963,6,13,10,13,56,54,2,49
Peterhead,8963,7,13,8,15,47,53,-6,47
Queen's Park,8963,8,13,8,15,42,52,-10,47
East Fife,8963,9,9,9,18,48,63,-15,36
Stenhousem'r,8963,10,6,8,22,43,80,-37,26
Alloa,8964,1,20,9,7,75,48,27,69
Livingston,8964,2,20,4,12,68,48,20,64
Brechin,8964,3,18,7,11,61,51,10,61
Airdrieon,8964,4,17,7,12,51,51,0,58
Albion,8964,5,14,8,14,57,56,1,50
Queen's Park,8964,6,14,7,15,39,51,-12,49
East Fife,8964,7,12,9,15,62,53,9,45
Peterhead,8964,8,10,9,17,45,55,-10,39
Stenhousem'r,8964,9,9,9,18,46,73,-27,36
Stranraer,8964,10,10,3,23,43,61,-18,33
Livingston,8965,1,24,3,9,85,48,37,75
Alloa,8965,2,19,10,7,73,43,30,67
Peterhead,8965,3,17,4,15,59,59,0,55
Airdrieon,8965,4,15,8,13,62,59,3,53
Albion,8965,5,15,5,16,52,57,-5,50
East Fife,8965,6,14,6,16,52,54,-2,48
Queen's Park,8965,7,13,7,16,39,48,-9,46
Brechin,8965,8,13,5,18,35,54,-19,44
Stenhousem'r,8965,9,10,6,20,50,79,-29,36
Stranraer,8965,10,9,8,19,55,61,-6,35
Alloa,8966,1,21,5,10,71,45,26,68
Airdrieon,8966,2,19,5,12,63,52,11,62
Livingston,8966,3,16,8,12,70,55,15,56
Albion,8966,4,16,6,14,62,57,5,54
Queen's Park,8966,5,16,2,18,41,54,-13,50
East Fife,8966,6,14,7,15,53,47,6,49
Brechin,8966,7,14,5,17,46,56,-10,47
Peterhead,8966,8,13,5,18,42,54,-12,44
Stranraer,8966,9,13,4,19,51,53,-2,43
Stenhousem'r,8966,10,12,5,19,53,79,-26,41
Alloa,8967,1,21,8,7,76,46,30,71
Livingston,8967,2,20,5,11,66,43,23,65
Brechin,8967,3,17,5,14,48,41,7,56
Airdrieon,8967,4,15,8,13,56,55,1,53
Queen's Park,8967,5,15,6,15,38,45,-7,51
Peterhead,8967,6,13,8,15,51,54,-3,47
East Fife,8967,7,13,6,17,51,53,-2,45
Stranraer,8967,8,12,6,18,49,63,-14,42
Albion,8967,9,10,9,17,50,60,-10,39
Stenhousem'r,8967,10,11,5,20,48,73,-25,38
Livingston,8968,1,19,6,11,75,50,25,63
Alloa,8968,2,19,6,11,65,42,23,63
Airdrieon,8968,3,19,4,13,59,57,2,61
Brechin,8968,4,17,5,14,57,44,13,56
East Fife,8968,5,13,10,13,48,45,3,49
Peterhead,8968,6,14,5,17,50,53,-3,47
Queen's Park,8968,7,12,10,14,32,44,-12,46
Albion,8968,8,12,7,17,45,55,-10,43
Stenhousem'r,8968,9,12,7,17,52,76,-24,43
Stranraer,8968,10,11,4,21,51,68,-17,37
Livingston,8969,1,23,4,9,84,46,38,73
Alloa,8969,2,18,10,8,71,43,28,64
Airdrieon,8969,3,17,6,13,55,60,-5,57
Brechin,8969,4,15,10,11,57,47,10,55
East Fife,8969,5,12,11,13,49,43,6,47
Queen's Park,8969,6,13,8,15,39,48,-9,47
Peterhead,8969,7,14,5,17,45,57,-12,47
Albion,8969,8,12,7,17,44,56,-12,43
Stranraer,8969,9,12,6,18,56,63,-7,42
Stenhousem'r,8969,10,7,7,22,42,79,-37,28
Alloa,8970,1,20,6,10,74,45,29,66
Brechin,8970,2,18,7,11,59,52,7,61
Queen's Park,8970,3,19,4,13,38,37,1,61
Livingston,8970,4,18,6,12,65,47,18,60
Peterhead,8970,5,15,9,12,49,49,0,54
Stranraer,8970,6,14,5,17,53,57,-4,47
Albion,8970,7,13,7,16,42,43,-1,46
Stenhousem'r,8970,8,11,8,17,50,71,-21,41
Airdrieon,8970,9,10,9,17,45,61,-16,39
East Fife,8970,10,7,9,20,45,58,-13,30
Livingston,8971,1,23,2,11,86,51,35,71
Brechin,8971,2,20,4,12,55,41,14,64
Alloa,8971,3,19,5,12,64,44,20,62
Airdrieon,8971,4,18,6,12,65,56,9,60
Albion,8971,5,14,8,14,55,51,4,50
Queen's Park,8971,6,13,7,16,40,55,-15,46
East Fife,8971,7,13,5,18,41,45,-4,44
Stranraer,8971,8,13,5,18,50,65,-15,44
Peterhead,8971,9,10,10,16,48,59,-11,40
Stenhousem'r,8971,10,6,10,20,40,77,-37,28
Alloa,8972,1,20,10,6,78,44,34,70
Livingston,8972,2,18,6,12,75,58,17,60
Brechin,8972,3,17,7,12,57,45,12,58
Airdrieon,8972,4,16,6,14,54,51,3,54
Albion,8972,5,14,7,15,51,52,-1,49
Queen's Park,8972,6,13,7,16,35,49,-14,46
Peterhead,8972,7,13,7,16,45,62,-17,46
East Fife,8972,8,11,11,14,46,43,3,44
Stranraer,8972,9,11,8,17,46,59,-13,41
Stenhousem'r,8972,10,8,9,19,46,70,-24,33
Livingston,8973,1,23,6,7,84,41,43,75
Alloa,8973,2,19,11,6,62,37,25,68
Airdrieon,8973,3,16,6,14,55,56,-1,54
Albion,8973,4,15,8,13,47,44,3,53
Queen's Park,8973,5,14,7,15,39,46,-7,49
East Fife,8973,6,11,11,14,51,54,-3,44
Stranraer,8973,7,13,5,18,45,58,-13,44
Brechin,8973,8,12,6,18,44,53,-9,42
Peterhead,8973,9,11,7,18,45,58,-13,40
Stenhousem'r,8973,10,7,11,18,51,76,-25,32
Alloa,8974,1,21,8,7,69,40,29,71
Livingston,8974,2,20,9,7,79,49,30,69
Airdrieon,8974,3,14,10,12,56,50,6,52
Peterhead,8974,4,14,7,15,54,57,-3,49
Albion,8974,5,14,6,16,57,53,4,48
Stranraer,8974,6,14,6,16,51,66,-15,48
Brechin,8974,7,13,8,15,43,48,-5,47
East Fife,8974,8,11,11,14,53,50,3,44
Queen's Park,8974,9,11,10,15,39,50,-11,43
Stenhousem'r,8974,10,6,9,21,37,75,-38,27
Livingston,8975,1,22,5,9,76,45,31,71
Alloa,8975,2,18,9,9,72,43,29,63
Queen's Park,8975,3,17,6,13,49,43,6,57
Brechin,8975,4,16,8,12,45,48,-3,56
Airdrieon,8975,5,17,4,15,63,58,5,55
Albion,8975,6,14,10,12,45,46,-1,52
East Fife,8975,7,9,12,15,45,49,-4,39
Peterhead,8975,8,10,9,17,42,57,-15,39
Stranraer,8975,9,9,9,18,49,65,-16,36
Stenhousem'r,8975,10,8,8,20,58,90,-32,32
Livingston,8976,1,23,4,9,83,54,29,73
Airdrieon,8976,2,20,3,13,64,52,12,63
Alloa,8976,3,16,11,9,59,40,19,59
Brechin,8976,4,18,4,14,47,46,1,58
Peterhead,8976,5,15,7,14,51,48,3,52
East Fife,8976,6,12,10,14,51,43,8,46
Albion,8976,7,11,12,13,47,52,-5,45
Stranraer,8976,8,13,4,19,51,62,-11,43
Stenhousem'r,8976,9,9,9,18,52,76,-24,36
Queen's Park,8976,10,7,8,21,27,59,-32,29
Livingston,8977,1,24,3,9,76,45,31,75
Alloa,8977,2,16,11,9,65,50,15,59
Brechin,8977,3,17,7,12,50,41,9,58
Airdrieon,8977,4,16,8,12,62,60,2,56
Albion,8977,5,16,6,14,67,55,12,54
Queen's Park,8977,6,13,8,15,44,50,-6,47
Stranraer,8977,7,14,5,17,54,62,-8,47
Peterhead,8977,8,11,8,17,46,58,-12,41
Stenhousem'r,8977,9,10,7,19,49,72,-23,37
East Fife,8977,10,7,9,20,43,63,-20,30
Livingston,8978,1,22,3,11,72,46,26,69
Brechin,8978,2,20,4,12,55,47,8,64
Airdrieon,8978,3,18,7,11,59,47,12,61
Alloa,8978,4,17,8,11,64,40,24,59
Stranraer,8978,5,15,9,12,49,45,4,54
East Fife,8978,6,14,7,15,42,41,1,49
Albion,8978,7,12,8,16,48,57,-9,44
Peterhead,8978,8,10,8,18,41,56,-15,38
Queen's Park,8978,9,10,6,20,36,59,-23,36
Stenhousem'r,8978,10,9,6,21,39,67,-28,33
Airdrieon,8979,1,22,6,8,62,41,21,72
Alloa,8979,2,18,11,7,76,42,34,65
Albion,8979,3,19,4,13,65,38,27,61
Brechin,8979,4,19,3,14,51,56,-5,60
Livingston,8979,5,18,5,13,68,50,18,59
Stranraer,8979,6,15,5,16,57,58,-1,50
East Fife,8979,7,12,6,18,54,62,-8,42
Queen's Park,8979,8,12,4,20,37,55,-18,40
Peterhead,8979,9,9,8,19,37,68,-31,35
Stenhousem'r,8979,10,7,6,23,40,77,-37,27
Livingston,8980,1,22,3,11,75,51,24,69
Airdrieon,8980,2,20,4,12,67,62,5,64
Peterhead,8980,3,18,8,10,55,43,12,62
Alloa,8980,4,15,8,13,61,46,15,53
Brechin,8980,5,15,6,15,52,55,-3,51
Albion,8980,6,14,6,16,52,53,-1,48
Stranraer,8980,7,13,5,18,56,66,-10,44
Queen's Park,8980,8,10,11,15,35,47,-12,41
East Fife,8980,9,10,10,16,46,44,2,40
Stenhousem'r,8980,10,7,11,18,45,77,-32,32
Alloa,8981,1,19,7,10,67,41,26,64
Brechin,8981,2,18,7,11,53,40,13,61
Livingston,8981,3,18,4,14,72,55,17,58
Airdrieon,8981,4,17,7,12,52,49,3,58
Stranraer,8981,5,14,7,15,54,55,-1,49
East Fife,8981,6,13,9,14,55,44,11,48
Queen's Park,8981,7,14,6,16,45,61,-16,48
Peterhead,8981,8,12,10,14,49,57,-8,46
Albion,8981,9,11,9,16,45,53,-8,42
Stenhousem'r,8981,10,8,6,22,37,74,-37,30
Livingston,8982,1,22,5,9,78,40,38,71
Brechin,8982,2,21,5,10,56,44,12,68
Alloa,8982,3,17,9,10,72,48,24,60
Airdrieon,8982,4,17,5,14,45,43,2,56
Stranraer,8982,5,16,3,17,55,66,-11,51
East Fife,8982,6,12,9,15,51,48,3,45
Albion,8982,7,10,13,13,47,47,0,43
Stenhousem'r,8982,8,10,8,18,46,73,-27,38
Queen's Park,8982,9,9,9,18,37,63,-26,36
Peterhead,8982,10,9,8,19,43,58,-15,35
Livingston,8983,1,24,5,7,84,40,44,77
Alloa,8983,2,17,10,9,63,43,20,61
Albion,8983,3,18,7,11,66,56,10,61
Airdrieon,8983,4,18,5,13,62,50,12,59
Brechin,8983,5,15,10,11,44,42,2,55
Stranraer,8983,6,12,10,14,53,60,-7,46
Peterhead,8983,7,10,11,15,52,66,-14,41
East Fife,8983,8,10,5,21,41,54,-13,35
Queen's Park,8983,9,9,7,20,33,61,-28,34
Stenhousem'r,8983,10,9,6,21,54,80,-26,33
Livingston,8984,1,22,5,9,74,47,27,71
Albion,8984,2,18,6,12,61,48,13,60
Alloa,8984,3,18,4,14,72,47,25,58
East Fife,8984,4,14,10,12,49,41,8,52
Stranraer,8984,5,15,7,14,51,48,3,52
Airdrieon,8984,6,15,5,16,56,61,-5,50
Brechin,8984,7,13,7,16,38,54,-16,46
Peterhead,8984,8,13,4,19,52,62,-10,43
Queen's Park,8984,9,11,10,15,35,50,-15,43
Stenhousem'r,8984,10,8,8,20,43,73,-30,32
Livingston,8985,1,20,6,10,78,44,34,66
Alloa,8985,2,18,12,6,74,43,31,66
Albion,8985,3,17,10,9,54,42,12,61
Airdrieon,8985,4,17,8,11,58,47,11,59
Brechin,8985,5,16,7,13,49,45,4,55
Queen's Park,8985,6,13,9,14,41,50,-9,48
Peterhead,8985,7,10,15,11,40,43,-3,45
Stranraer,8985,8,12,8,16,45,56,-11,44
East Fife,8985,9,7,9,20,36,49,-13,30
Stenhousem'r,8985,10,5,6,25,39,95,-56,21
Alloa,8986,1,20,8,8,68,35,33,68
Livingston,8986,2,20,5,11,65,46,19,65
Airdrieon,8986,3,17,6,13,55,57,-2,57
Peterhead,8986,4,17,5,14,54,48,6,56
Queen's Park,8986,5,15,8,13,37,41,-4,53
Brechin,8986,6,13,8,15,44,42,2,47
East Fife,8986,7,12,9,15,54,48,6,45
Albion,8986,8,12,8,16,52,54,-2,44
Stranraer,8986,9,12,6,18,45,64,-19,42
Stenhousem'r,8986,10,8,5,23,48,87,-39,29
Alloa,8987,1,20,9,7,78,39,39,69
Livingston,8987,2,18,5,13,60,43,17,59
Airdrieon,8987,3,17,8,11,64,58,6,59
Brechin,8987,4,15,6,15,51,52,-1,51
Albion,8987,5,13,10,13,56,54,2,49
Stranraer,8987,6,14,7,15,55,57,-2,49
Peterhead,8987,7,13,9,14,51,58,-7,48
East Fife,8987,8,11,12,13,52,45,7,45
Stenhousem'r,8987,9,11,4,21,50,81,-31,37
Queen's Park,8987,10,8,10,18,32,62,-30,34
Alloa,8988,1,21,9,6,76,42,34,72
Livingston,8988,2,20,7,9,71,40,31,67
Airdrieon,8988,3,17,6,13,61,53,8,57
Peterhead,8988,4,14,10,12,53,52,1,52
Stranraer,8988,5,14,5,17,54,61,-7,47
Brechin,8988,6,12,9,15,45,53,-8,45
Queen's Park,8988,7,11,11,14,34,49,-15,44
East Fife,8988,8,11,10,15,55,54,1,43
Albion,8988,9,11,10,15,50,54,-4,43
Stenhousem'r,8988,10,4,13,19,41,82,-41,25
Brechin,8989,1,19,7,10,52,38,14,64
Alloa,8989,2,19,6,11,70,47,23,63
Livingston,8989,3,18,6,12,70,55,15,60
Peterhead,8989,4,16,7,13,55,53,2,55
Airdrieon,8989,5,16,5,15,63,54,9,53
Stranraer,8989,6,15,4,17,48,51,-3,49
Albion,8989,7,14,6,16,52,57,-5,48
East Fife,8989,8,12,7,17,45,46,-1,43
Queen's Park,8989,9,10,10,16,39,55,-16,40
Stenhousem'r,8989,10,8,8,20,48,86,-38,32
Airdrieon,8990,1,20,6,10,60,45,15,66
Livingston,8990,2,19,5,12,72,48,24,62
Brechin,8990,3,18,5,13,46,50,-4,59
Stranraer,8990,4,16,6,14,68,66,2,54
Albion,8990,5,15,8,13,59,49,10,53
Alloa,8990,6,14,9,13,59,52,7,51
Peterhead,8990,7,12,10,14,46,50,-4,46
East Fife,8990,8,10,10,16,54,53,1,40
Queen's Park,8990,9,11,7,18,37,52,-15,40
Stenhousem'r,8990,10,9,6,21,41,77,-36,33
Brechin,8991,1,21,5,10,70,47,23,68
Livingston,8991,2,19,5,12,80,56,24,62
Airdrieon,8991,3,18,5,13,61,59,2,59
Alloa,8991,4,16,10,10,61,48,13,58
Albion,8991,5,14,7,15,51,47,4,49
Peterhead,8991,6,13,9,14,53,59,-6,48
Stranraer,8991,7,14,6,16,50,61,-11,48
East Fife,8991,8,12,9,15,48,49,-1,45
Queen's Park,8991,9,11,9,16,39,53,-14,42
Stenhousem'r,8991,10,6,7,23,48,82,-34,25
Airdrieon,8992,1,18,9,9,58,49,9,63
Livingston,8992,2,18,7,11,63,39,24,61
Alloa,8992,3,17,9,10,69,47,22,60
East Fife,8992,4,14,10,12,59,51,8,52
Peterhead,8992,5,14,10,12,48,45,3,52
Brechin,8992,6,15,4,17,42,43,-1,49
Stranraer,8992,7,13,10,13,51,56,-5,49
Queen's Park,8992,8,12,10,14,39,48,-9,46
Albion,8992,9,10,11,15,48,56,-8,41
Stenhousem'r,8992,10,6,6,24,46,89,-43,24
Livingston,8993,1,22,5,9,82,53,29,71
Airdrieon,8993,2,22,5,9,67,49,18,71
Alloa,8993,3,18,4,14,64,48,16,58
Brechin,8993,4,17,4,15,53,50,3,55
Peterhead,8993,5,14,7,15,55,58,-3,49
Albion,8993,6,14,6,16,51,54,-3,48
East Fife,8993,7,13,7,16,49,49,0,46
Queen's Park,8993,8,13,5,18,42,54,-12,44
Stranraer,8993,9,11,6,19,44,62,-18,39
Stenhousem'r,8993,10,9,5,22,49,79,-30,32
Livingston,8994,1,23,3,10,88,42,46,72
Alloa,8994,2,21,9,6,72,36,36,72
Queen's Park,8994,3,15,9,12,39,39,0,54
Brechin,8994,4,14,9,13,40,37,3,51
Airdrieon,8994,5,13,12,11,52,51,1,51
Albion,8994,6,12,11,13,52,55,-3,47
Peterhead,8994,7,11,12,13,41,51,-10,45
Stranraer,8994,8,10,7,19,39,59,-20,37
East Fife,8994,9,8,11,17,44,59,-15,35
Stenhousem'r,8994,10,7,9,20,42,80,-38,30
Airdrieon,8995,1,19,4,13,65,51,14,61
East Fife,8995,2,18,5,13,70,51,19,59
Livingston,8995,3,17,8,11,74,57,17,59
Alloa,8995,4,16,7,13,59,54,5,55
Brechin,8995,5,16,6,14,59,56,3,54
Queen's Park,8995,6,16,3,17,39,49,-10,51
Albion,8995,7,14,6,16,62,65,-3,48
Peterhead,8995,8,13,5,18,50,65,-15,44
Stranraer,8995,9,12,6,18,55,58,-3,42
Stenhousem'r,8995,10,11,6,19,56,83,-27,39
Livingston,8996,1,19,5,12,80,52,28,62
Alloa,8996,2,17,8,11,75,51,24,59
Airdrieon,8996,3,17,7,12,57,61,-4,58
Brechin,8996,4,16,6,14,48,53,-5,54
Peterhead,8996,5,14,10,12,57,53,4,52
Queen's Park,8996,6,14,8,14,34,43,-9,50
East Fife,8996,7,13,9,14,56,49,7,48
Albion,8996,8,12,7,17,47,57,-10,43
Stenhousem'r,8996,9,10,10,16,54,73,-19,40
Stranraer,8996,10,11,4,21,42,58,-16,37
Alloa,8997,1,21,7,8,74,43,31,70
Airdrieon,8997,2,20,7,9,70,57,13,67
Peterhead,8997,3,16,5,15,57,53,4,53
Livingston,8997,4,15,7,14,75,62,13,52
Brechin,8997,5,13,8,15,57,61,-4,47
Stranraer,8997,6,14,5,17,49,55,-6,47
Albion,8997,7,13,8,15,53,62,-9,47
East Fife,8997,8,12,10,14,56,52,4,46
Queen's Park,8997,9,10,11,15,37,53,-16,41
Stenhousem'r,8997,10,7,10,19,52,82,-30,31
Livingston,8998,1,22,5,9,78,46,32,71
Airdrieon,8998,2,19,7,10,68,53,15,64
Brechin,8998,3,16,10,10,50,44,6,58
Alloa,8998,4,15,10,11,66,51,15,55
Stranraer,8998,5,14,8,14,56,60,-4,50
Peterhead,8998,6,12,7,17,49,55,-6,43
Queen's Park,8998,7,11,8,17,42,52,-10,41
Albion,8998,8,11,7,18,44,61,-17,40
Stenhousem'r,8998,9,11,7,18,52,77,-25,40
East Fife,8998,10,10,9,17,48,54,-6,39
Alloa,8999,1,21,5,10,73,43,30,68
Livingston,8999,2,17,5,14,69,48,21,56
Airdrieon,8999,3,16,7,13,58,50,8,55
Brechin,8999,4,14,9,13,48,48,0,51
East Fife,8999,5,12,12,12,49,50,-1,48
Albion,8999,6,11,13,12,46,47,-1,46
Stranraer,8999,7,13,6,17,47,57,-10,45
Queen's Park,8999,8,12,9,15,37,54,-17,45
Peterhead,8999,9,11,11,14,46,53,-7,44
Stenhousem'r,8999,10,10,9,17,47,70,-23,39
Livingston,9000,1,23,3,10,85,46,39,72
Airdrieon,9000,2,21,6,9,69,46,23,69
Alloa,9000,3,15,11,10,69,50,19,56
Peterhead,9000,4,16,7,13,50,52,-2,55
Queen's Park,9000,5,14,7,15,41,45,-4,49
Brechin,9000,6,14,6,16,51,53,-2,48
Albion,9000,7,13,9,14,51,54,-3,48
Stranraer,9000,8,14,6,16,52,65,-13,48
East Fife,9000,9,7,11,18,40,57,-17,32
Stenhousem'r,9000,10,7,6,23,44,84,-40,27
Alloa,9001,1,22,5,9,77,38,39,71
Livingston,9001,2,20,7,9,77,48,29,67
Airdrieon,9001,3,19,4,13,55,49,6,61
Queen's Park,9001,4,15,7,14,42,55,-13,52
Brechin,9001,5,12,13,11,53,50,3,49
Peterhead,9001,6,13,8,15,39,50,-11,47
Albion,9001,7,12,10,14,53,54,-1,46
Stranraer,9001,8,12,6,18,55,61,-6,42
East Fife,9001,9,11,8,17,50,56,-6,41
Stenhousem'r,9001,10,7,6,23,42,82,-40,27
Livingston,9002,1,20,7,9,79,48,31,67
Alloa,9002,2,18,7,11,75,47,28,61
Airdrieon,9002,3,18,5,13,65,64,1,59
Peterhead,9002,4,18,4,14,52,52,0,58
Brechin,9002,5,16,6,14,57,55,2,54
Albion,9002,6,14,8,14,53,51,2,50
Queen's Park,9002,7,14,6,16,39,50,-11,48
East Fife,9002,8,12,8,16,54,51,3,44
Stranraer,9002,9,13,4,19,52,60,-8,43
Stenhousem'r,9002,10,7,5,24,52,100,-48,26
Livingston,9003,1,21,3,12,80,52,28,66
Alloa,9003,2,20,4,12,72,44,28,64
Brechin,9003,3,19,7,10,57,47,10,64
Airdrieon,9003,4,16,8,12,54,61,-7,56
Albion,9003,5,13,10,13,50,45,5,49
Peterhead,9003,6,14,5,17,53,60,-7,47
Queen's Park,9003,7,12,11,13,41,48,-7,47
Stranraer,9003,8,12,5,19,50,64,-14,41
East Fife,9003,9,10,8,18,50,53,-3,38
Stenhousem'r,9003,10,9,7,20,47,80,-33,34
Airdrieon,9004,1,21,6,9,67,47,20,69
Livingston,9004,2,21,3,12,71,44,27,66
Brechin,9004,3,20,3,13,66,49,17,63
Alloa,9004,4,18,5,13,70,48,22,59
Albion,9004,5,16,6,14,57,61,-4,54
Peterhead,9004,6,14,8,14,51,61,-10,50
Queen's Park,9004,7,13,6,17,38,52,-14,45
Stranraer,9004,8,12,6,18,54,59,-5,42
East Fife,9004,9,9,10,17,53,62,-9,37
Stenhousem'r,9004,10,7,5,24,38,82,-44,26
Livingston,9005,1,21,10,5,78,43,35,73
Airdrieon,9005,2,20,4,12,69,55,14,64
East Fife,9005,3,15,10,11,65,43,22,55
Albion,9005,4,14,11,11,52,49,3,53
Brechin,9005,5,14,10,12,47,46,1,52
Alloa,9005,6,14,7,15,69,51,18,49
Peterhead,9005,7,11,11,14,46,61,-15,44
Queen's Park,9005,8,11,10,15,37,46,-9,43
Stranraer,9005,9,8,8,20,40,68,-28,32
Stenhousem'r,9005,10,6,11,19,44,85,-41,29
Livingston,9006,1,18,6,12,67,50,17,60
Alloa,9006,2,16,11,9,64,47,17,59
Albion,9006,3,16,8,12,57,43,14,56
Stranraer,9006,4,16,5,15,60,52,8,53
Airdrieon,9006,5,16,5,15,53,59,-6,53
Brechin,9006,6,15,7,14,41,47,-6,52
Queen's Park,9006,7,14,9,13,45,47,-2,51
Peterhead,9006,8,13,8,15,50,56,-6,47
East Fife,9006,9,10,11,15,43,45,-2,41
Stenhousem'r,9006,10,6,10,20,45,79,-34,28
Airdrieon,9007,1,23,5,8,70,47,23,74
Livingston,9007,2,22,3,11,76,49,27,69
Alloa,9007,3,18,7,11,73,50,23,61
Brechin,9007,4,17,6,13,46,44,2,57
Peterhead,9007,5,13,8,15,54,70,-16,47
Albion,9007,6,13,7,16,58,59,-1,46
Stranraer,9007,7,13,5,18,51,62,-11,44
East Fife,9007,8,12,7,17,56,51,5,43
Queen's Park,9007,9,11,7,18,38,58,-20,40
Stenhousem'r,9007,10,7,7,22,50,82,-32,28
Alloa,9008,1,19,8,9,67,40,27,65
Airdrieon,9008,2,17,10,9,64,53,11,61
Albion,9008,3,17,8,11,61,53,8,59
Peterhead,9008,4,17,6,13,59,51,8,57
Livingston,9008,5,15,10,11,74,56,18,55
Stranraer,9008,6,15,6,15,58,57,1,51
East Fife,9008,7,12,9,15,55,49,6,45
Brechin,9008,8,12,9,15,39,55,-16,45
Queen's Park,9008,9,11,6,19,35,54,-19,39
Stenhousem'r,9008,10,4,10,22,41,85,-44,22
Livingston,9009,1,23,3,10,83,48,35,72
Alloa,9009,2,19,7,10,62,42,20,64
Airdrieon,9009,3,16,9,11,54,52,2,57
Brechin,9009,4,16,7,13,52,45,7,55
Albion,9009,5,14,8,14,51,47,4,50
East Fife,9009,6,13,9,14,52,52,0,48
Peterhead,9009,7,13,8,15,46,50,-4,47
Queen's Park,9009,8,13,7,16,40,57,-17,46
Stranraer,9009,9,13,3,20,58,70,-12,42
Stenhousem'r,9009,10,7,5,24,43,78,-35,26
Alloa,9010,1,18,7,11,69,39,30,61
Livingston,9010,2,18,6,12,69,48,21,60
Albion,9010,3,17,8,11,64,48,16,59
Peterhead,9010,4,16,7,13,46,48,-2,55
Brechin,9010,5,16,6,14,54,56,-2,54
Queen's Park,9010,6,14,7,15,40,47,-7,49
Stranraer,9010,7,13,7,16,48,53,-5,46
Airdrieon,9010,8,13,6,17,44,57,-13,45
East Fife,9010,9,12,8,16,45,45,0,44
Stenhousem'r,9010,10,9,6,21,44,82,-38,33
Livingston,9011,1,23,4,9,80,53,27,73
Alloa,9011,2,18,8,10,66,40,26,62
Brechin,9011,3,18,4,14,46,47,-1,58
Airdrieon,9011,4,17,6,13,67,58,9,57
East Fife,9011,5,15,8,13,53,43,10,53
Albion,9011,6,15,7,14,55,49,6,52
Peterhead,9011,7,15,7,14,54,51,3,52
Stranraer,9011,8,11,5,20,47,65,-18,38
Queen's Park,9011,9,10,6,20,31,52,-21,36
Stenhousem'r,9011,10,7,7,22,38,79,-41,28
Livingston,9012,1,18,10,8,69,44,25,64
Alloa,9012,2,19,5,12,82,53,29,62
Brechin,9012,3,18,7,11,52,49,3,61
Airdrieon,9012,4,15,11,10,51,45,6,56
Queen's Park,9012,5,16,7,13,44,48,-4,55
Stranraer,9012,6,15,5,16,50,50,0,50
Peterhead,9012,7,13,9,14,57,56,1,48
East Fife,9012,8,12,7,17,46,51,-5,43
Albion,9012,9,9,8,19,45,56,-11,35
Stenhousem'r,9012,10,7,7,22,47,91,-44,28
Livingston,9013,1,20,6,10,76,50,26,66
Brechin,9013,2,18,9,9,56,43,13,63
Alloa,9013,3,15,11,10,60,38,22,56
Airdrieon,9013,4,17,4,15,51,57,-6,55
Peterhead,9013,5,14,9,13,50,52,-2,51
Stranraer,9013,6,14,8,14,51,53,-2,50
East Fife,9013,7,12,8,16,62,59,3,44
Albion,9013,8,11,10,15,43,50,-7,43
Queen's Park,9013,9,11,9,16,36,53,-17,42
Stenhousem'r,9013,10,6,10,20,49,79,-30,28
Livingston,9014,1,22,3,11,82,54,28,69
Airdrieon,9014,2,17,8,11,66,64,2,59
Alloa,9014,3,17,6,13,65,45,20,57
East Fife,9014,4,15,10,11,57,41,16,55
Peterhead,9014,5,15,7,14,60,59,1,52
Brechin,9014,6,15,6,15,61,54,7,51
Stranraer,9014,7,14,5,17,49,53,-4,47
Albion,9014,8,13,5,18,47,63,-16,44
Queen's Park,9014,9,12,6,18,36,52,-16,42
Stenhousem'r,9014,10,8,8,20,44,82,-38,32
Livingston,9015,1,23,4,9,83,46,37,73
Alloa,9015,2,20,7,9,75,46,29,67
Brechin,9015,3,18,6,12,49,42,7,60
Airdrieon,9015,4,15,8,13,62,67,-5,53
Queen's Park,9015,5,16,5,15,44,49,-5,53
Albion,9015,6,15,7,14,50,50,0,52
East Fife,9015,7,13,9,14,56,44,12,48
Stranraer,9015,8,12,7,17,50,60,-10,43
Peterhead,9015,9,9,6,21,41,64,-23,33
Stenhousem'r,9015,10,6,7,23,43,85,-42,25
Brechin,9016,1,22,3,11,64,44,20,69
Livingston,9016,2,22,2,12,81,45,36,68
Alloa,9016,3,18,6,12,66,47,19,60
Airdrieon,9016,4,18,6,12,58,56,2,60
Peterhead,9016,5,15,6,15,49,55,-6,51
Albion,9016,6,13,7,16,52,51,1,46
Queen's Park,9016,7,12,9,15,36,54,-18,45
Stranraer,9016,8,13,3,20,52,68,-16,42
East Fife,9016,9,11,8,17,50,56,-6,41
Stenhousem'r,9016,10,7,8,21,51,83,-32,29
Brechin,9017,1,22,7,7,57,34,23,73
Alloa,9017,2,21,8,7,75,38,37,71
Livingston,9017,3,20,5,11,63,51,12,65
Airdrieon,9017,4,19,4,13,66,56,10,61
Peterhead,9017,5,17,6,13,49,44,5,57
Stenhousem'r,9017,6,12,3,21,51,79,-28,39
East Fife,9017,7,10,8,18,49,54,-5,38
Albion,9017,8,11,5,20,48,65,-17,38
Stranraer,9017,9,10,5,21,39,56,-17,35
Queen's Park,9017,10,9,7,20,39,59,-20,34
Livingston,9018,1,23,3,10,88,48,40,72
Alloa,9018,2,21,8,7,81,41,40,71
Brechin,9018,3,20,3,13,55,43,12,63
Airdrieon,9018,4,15,6,15,63,65,-2,51
Albion,9018,5,13,10,13,57,55,2,49
East Fife,9018,6,12,10,14,51,49,2,46
Peterhead,9018,7,11,10,15,41,49,-8,43
Queen's Park,9018,8,11,8,17,36,65,-29,41
Stranraer,9018,9,11,7,18,44,64,-20,40
Stenhousem'r,9018,10,5,11,20,42,79,-37,26
Livingston,9019,1,19,6,11,81,51,30,63
Alloa,9019,2,17,8,11,71,50,21,59
Brechin,9019,3,18,5,13,59,56,3,59
Airdrieon,9019,4,17,6,13,64,62,2,57
Albion,9019,5,16,6,14,50,50,0,54
East Fife,9019,6,14,9,13,49,43,6,51
Queen's Park,9019,7,13,8,15,36,46,-10,47
Peterhead,9019,8,12,10,14,43,52,-9,46
Stranraer,9019,9,12,5,19,50,64,-14,41
Stenhousem'r,9019,10,8,5,23,52,81,-29,29
Brechin,9020,1,17,11,8,60,42,18,62
Airdrieon,9020,2,16,12,8,53,41,12,60
Alloa,9020,3,17,8,11,66,43,23,59
Livingston,9020,4,17,8,11,73,51,22,59
Queen's Park,9020,5,14,11,11,40,39,1,53
Peterhead,9020,6,14,8,14,55,55,0,50
Albion,9020,7,11,11,14,56,59,-3,44
Stranraer,9020,8,12,7,17,45,59,-14,43
East Fife,9020,9,8,11,17,50,55,-5,35
Stenhousem'r,9020,10,5,11,20,43,97,-54,26
Alloa,9021,1,22,6,8,81,45,36,72
Livingston,9021,2,21,4,11,75,51,24,67
Airdrieon,9021,3,17,5,14,61,67,-6,56
Albion,9021,4,15,7,14,56,51,5,52
Brechin,9021,5,13,8,15,48,54,-6,47
Stranraer,9021,6,12,7,17,52,58,-6,43
Queen's Park,9021,7,12,7,17,38,51,-13,43
East Fife,9021,8,10,12,14,53,55,-2,42
Peterhead,9021,9,10,11,15,53,66,-13,41
Stenhousem'r,9021,10,9,11,16,50,69,-19,38
Alloa,9022,1,23,8,5,84,39,45,77
Livingston,9022,2,24,4,8,86,43,43,76
Albion,9022,3,16,8,12,55,52,3,56
Airdrieon,9022,4,14,6,16,58,64,-6,48
Queen's Park,9022,5,13,8,15,47,50,-3,47
Peterhead,9022,6,13,6,17,45,63,-18,45
Brechin,9022,7,12,8,16,48,61,-13,44
Stranraer,9022,8,12,6,18,57,65,-8,42
East Fife,9022,9,9,11,16,48,52,-4,38
Stenhousem'r,9022,10,8,7,21,45,84,-39,31
Livingston,9023,1,19,9,8,74,46,28,66
Alloa,9023,2,17,11,8,67,42,25,62
Brechin,9023,3,17,8,11,62,52,10,59
Peterhead,9023,4,14,7,15,46,48,-2,49
Airdrieon,9023,5,13,9,14,49,51,-2,48
Albion,9023,6,12,11,13,49,53,-4,47
Queen's Park,9023,7,12,11,13,45,54,-9,47
Stranraer,9023,8,10,9,17,50,60,-10,39
Stenhousem'r,9023,9,9,11,16,44,74,-30,38
East Fife,9023,10,9,10,17,49,55,-6,37
Brechin,9024,1,21,6,9,56,46,10,69
Alloa,9024,2,18,7,11,68,48,20,61
Livingston,9024,3,18,6,12,66,46,20,60
Airdrieon,9024,4,17,4,15,56,55,1,55
Albion,9024,5,14,9,13,47,46,1,51
Peterhead,9024,6,14,9,13,53,56,-3,51
East Fife,9024,7,12,9,15,47,46,1,45
Queen's Park,9024,8,13,5,18,43,53,-10,44
Stranraer,9024,9,10,7,19,45,57,-12,37
Stenhousem'r,9024,10,8,8,20,47,75,-28,32
Alloa,9025,1,22,5,9,77,42,35,71
Livingston,9025,2,23,2,11,72,40,32,71
Brechin,9025,3,18,7,11,51,43,8,61
Albion,9025,4,15,6,15,58,52,6,51
Airdrieon,9025,5,15,5,16,58,68,-10,50
East Fife,9025,6,12,12,12,55,54,1,48
Peterhead,9025,7,13,7,16,47,54,-7,46
Queen's Park,9025,8,12,6,18,44,58,-14,42
Stranraer,9025,9,11,6,19,54,63,-9,39
Stenhousem'r,9025,10,7,8,21,54,96,-42,29
Livingston,9026,1,22,7,7,83,47,36,73
Airdrieon,9026,2,19,6,11,65,57,8,63
Alloa,9026,3,17,8,11,77,56,21,59
Queen's Park,9026,4,16,9,11,50,44,6,57
Peterhead,9026,5,14,8,14,53,49,4,50
Brechin,9026,6,13,11,12,44,50,-6,50
Albion,9026,7,14,5,17,50,50,0,47
Stranraer,9026,8,13,7,16,50,55,-5,46
East Fife,9026,9,11,8,17,51,61,-10,41
Stenhousem'r,9026,10,4,5,27,42,96,-54,17
Livingston,9027,1,26,1,9,88,39,49,79
Alloa,9027,2,18,11,7,72,42,30,65
Airdrieon,9027,3,18,5,13,58,53,5,59
Brechin,9027,4,16,10,10,49,44,5,58
Albion,9027,5,14,9,13,51,49,2,51
East Fife,9027,6,12,9,15,52,60,-8,45
Peterhead,9027,7,11,9,16,44,48,-4,42
Stranraer,9027,8,11,4,21,45,64,-19,37
Queen's Park,9027,9,10,6,20,27,56,-29,36
Stenhousem'r,9027,10,8,8,20,43,74,-31,32
Livingston,9028,1,18,5,13,75,49,26,59
Alloa,9028,2,16,8,12,70,53,17,56
Brechin,9028,3,17,4,15,53,57,-4,55
Albion,9028,4,15,9,12,50,48,2,54
Queen's Park,9028,5,16,6,14,44,49,-5,54
Peterhead,9028,6,15,7,14,50,50,0,52
Airdrieon,9028,7,13,9,14,56,56,0,48
Stranraer,9028,8,13,9,14,50,53,-3,48
East Fife,9028,9,11,11,14,48,41,7,44
Stenhousem'r,9028,10,8,8,20,50,90,-40,32
Alloa,9029,1,21,7,8,80,44,36,70
Livingston,9029,2,20,4,12,75,48,27,64
Albion,9029,3,17,5,14,50,41,9,56
Airdrieon,9029,4,17,5,14,55,58,-3,56
Peterhead,9029,5,13,9,14,49,53,-4,48
Brechin,9029,6,14,6,16,48,52,-4,48
East Fife,9029,7,13,8,15,44,48,-4,47
Stranraer,9029,8,14,4,18,53,57,-4,46
Queen's Park,9029,9,12,7,17,36,48,-12,43
Stenhousem'r,9029,10,5,13,18,41,82,-41,28
Livingston,9030,1,21,4,11,85,54,31,67
Alloa,9030,2,17,10,9,71,49,22,61
Peterhead,9030,3,17,7,12,65,53,12,58
Airdrieon,9030,4,17,3,16,62,66,-4,54
East Fife,9030,5,13,9,14,56,60,-4,48
Stranraer,9030,6,14,6,16,49,62,-13,48
Albion,9030,7,13,8,15,55,61,-6,47
Queen's Park,9030,8,13,6,17,46,61,-15,45
Brechin,9030,9,13,5,18,53,54,-1,44
Stenhousem'r,9030,10,8,10,18,53,75,-22,34
Alloa,9031,1,18,11,7,72,44,28,65
Livingston,9031,2,19,6,11,69,41,28,63
Queen's Park,9031,3,16,8,12,46,54,-8,56
Brechin,9031,4,16,7,13,48,42,6,55
Airdrieon,9031,5,14,9,13,54,54,0,51
Stranraer,9031,6,13,8,15,50,54,-4,47
East Fife,9031,7,11,11,14,50,51,-1,44
Albion,9031,8,11,9,16,48,55,-7,42
Peterhead,9031,9,11,8,17,46,62,-16,41
Stenhousem'r,9031,10,9,7,20,46,72,-26,34
Alloa,9032,1,20,10,6,77,41,36,70
Livingston,9032,2,19,7,10,63,42,21,64
Albion,9032,3,15,11,10,59,46,13,56
Airdrieon,9032,4,14,8,14,56,59,-3,50
Brechin,9032,5,14,6,16,52,53,-1,48
Queen's Park,9032,6,12,12,12,39,40,-1,48
Stranraer,9032,7,11,9,16,51,66,-15,42
Peterhead,9032,8,11,8,17,45,56,-11,41
East Fife,9032,9,7,16,13,44,53,-9,37
Stenhousem'r,9032,10,7,13,16,47,77,-30,34
Livingston,9033,1,21,4,11,73,45,28,67
Alloa,9033,2,21,3,12,69,44,25,66
Brechin,9033,3,18,6,12,52,48,4,60
Airdrieon,9033,4,17,5,14,55,53,2,56
Albion,9033,5,13,12,11,52,43,9,51
Peterhead,9033,6,14,9,13,53,51,2,51
East Fife,9033,7,13,9,14,48,42,6,48
Queen's Park,9033,8,11,6,19,36,62,-26,39
Stranraer,9033,9,11,5,20,47,65,-18,38
Stenhousem'r,9033,10,9,5,22,51,83,-32,32
Airdrieon,9034,1,21,5,10,58,45,13,68
Alloa,9034,2,20,6,10,77,47,30,66
Livingston,9034,3,20,3,13,76,53,23,63
Albion,9034,4,14,8,14,56,51,5,50
East Fife,9034,5,14,7,15,51,49,2,49
Brechin,9034,6,14,7,15,51,53,-2,49
Queen's Park,9034,7,14,7,15,38,48,-10,49
Peterhead,9034,8,12,9,15,41,54,-13,45
Stranraer,9034,9,12,5,19,51,65,-14,41
Stenhousem'r,9034,10,8,5,23,43,77,-34,29
Livingston,9035,1,23,3,10,80,52,28,72
Alloa,9035,2,18,8,10,66,46,20,62
Airdrieon,9035,3,17,9,10,61,45,16,60
Brechin,9035,4,17,9,10,52,44,8,60
Peterhead,9035,5,14,11,11,50,45,5,53
Albion,9035,6,13,9,14,55,49,6,48
Queen's Park,9035,7,9,12,15,29,47,-18,39
Stranraer,9035,8,10,7,19,50,66,-16,37
East Fife,9035,9,8,12,16,51,58,-7,36
Stenhousem'r,9035,10,7,8,21,42,84,-42,29
Livingston,9036,1,20,5,11,68,44,24,65
Brechin,9036,2,20,5,11,52,38,14,65
Alloa,9036,3,18,10,8,68,42,26,64
Albion,9036,4,17,9,10,48,39,9,60
Airdrieon,9036,5,18,6,12,56,56,0,60
Peterhead,9036,6,14,6,16,48,47,1,48
East Fife,9036,7,12,8,16,51,53,-2,44
Stranraer,9036,8,12,5,19,49,61,-12,41
Queen's Park,9036,9,11,7,18,37,52,-15,40
Stenhousem'r,9036,10,6,3,27,41,86,-45,21
Livingston,9037,1,20,9,7,75,39,36,69
Alloa,9037,2,19,8,9,69,42,27,65
Airdrieon,9037,3,18,6,12,60,53,7,60
Brechin,9037,4,15,9,12,52,48,4,54
Peterhead,9037,5,14,10,12,54,49,5,52
Stranraer,9037,6,14,9,13,50,50,0,51
Albion,9037,7,10,11,15,52,62,-10,41
Stenhousem'r,9037,8,11,5,20,49,73,-24,38
Queen's Park,9037,9,9,9,18,34,58,-24,36
East Fife,9037,10,7,10,19,38,59,-21,31
Alloa,9038,1,20,8,8,72,42,30,68
Livingston,9038,2,19,7,10,72,43,29,64
Peterhead,9038,3,15,9,12,54,48,6,54
Brechin,9038,4,15,8,13,45,43,2,53
Airdrieon,9038,5,15,6,15,57,59,-2,51
Queen's Park,9038,6,13,9,14,43,55,-12,48
East Fife,9038,7,12,7,17,45,49,-4,43
Stranraer,9038,8,12,7,17,48,59,-11,43
Albion,9038,9,10,11,15,46,53,-7,41
Stenhousem'r,9038,10,8,10,18,43,74,-31,34
Alloa,9039,1,17,10,9,75,45,30,61
Livingston,9039,2,18,7,11,73,49,24,61
Airdrieon,9039,3,17,9,10,56,47,9,60
Brechin,9039,4,18,6,12,48,39,9,60
Albion,9039,5,14,8,14,57,60,-3,50
East Fife,9039,6,13,6,17,56,65,-9,45
Peterhead,9039,7,11,9,16,46,59,-13,42
Stenhousem'r,9039,8,12,6,18,57,75,-18,42
Stranraer,9039,9,10,11,15,47,56,-9,41
Queen's Park,9039,10,10,8,18,37,57,-20,38
Livingston,9040,1,21,7,8,79,46,33,70
Albion,9040,2,15,10,11,63,57,6,55
Alloa,9040,3,15,8,13,65,53,12,53
Brechin,9040,4,14,11,11,50,45,5,53
Peterhead,9040,5,13,12,11,52,54,-2,51
Airdrieon,9040,6,15,5,16,63,63,0,50
Stranraer,9040,7,12,11,13,52,55,-3,47
Queen's Park,9040,8,13,7,16,42,50,-8,46
Stenhousem'r,9040,9,7,13,16,47,75,-28,34
East Fife,9040,10,6,14,16,45,60,-15,32
Livingston,9041,1,18,7,11,64,44,20,61
Airdrieon,9041,2,16,10,10,68,55,13,58
Alloa,9041,3,17,6,13,54,45,9,57
Queen's Park,9041,4,17,5,14,44,47,-3,56
Stranraer,9041,5,16,7,13,57,55,2,55
Albion,9041,6,16,5,15,58,57,1,53
East Fife,9041,7,14,9,13,51,46,5,51
Peterhead,9041,8,12,10,14,47,43,4,46
Brechin,9041,9,12,5,19,44,58,-14,41
Stenhousem'r,9041,10,5,10,21,43,80,-37,25
Livingston,9042,1,22,2,12,78,52,26,68
Brechin,9042,2,18,4,14,48,46,2,58
Peterhead,9042,3,17,6,13,55,47,8,57
Airdrieon,9042,4,17,6,13,55,61,-6,57
Alloa,9042,5,15,11,10,54,42,12,56
Queen's Park,9042,6,14,9,13,38,42,-4,51
Albion,9042,7,13,10,13,55,49,6,49
East Fife,9042,8,10,11,15,49,50,-1,41
Stranraer,9042,9,11,7,18,52,61,-9,40
Stenhousem'r,9042,10,6,8,22,41,75,-34,26
Alloa,9043,1,19,10,7,64,37,27,67
Livingston,9043,2,19,8,9,76,46,30,65
Airdrieon,9043,3,17,5,14,67,62,5,56
Albion,9043,4,14,12,10,56,54,2,54
Peterhead,9043,5,12,10,14,50,61,-11,46
Brechin,9043,6,13,6,17,42,49,-7,45
Stranraer,9043,7,11,11,14,47,50,-3,44
Stenhousem'r,9043,8,11,8,17,53,73,-20,41
Queen's Park,9043,9,10,10,16,41,55,-14,40
East Fife,9043,10,11,6,19,43,52,-9,39
Airdrieon,9044,1,22,5,9,68,49,19,71
Livingston,9044,2,21,3,12,63,41,22,66
Alloa,9044,3,19,8,9,64,42,22,65
Brechin,9044,4,15,7,14,55,49,6,52
Peterhead,9044,5,13,10,13,49,53,-4,49
Albion,9044,6,13,8,15,50,51,-1,47
Queen's Park,9044,7,13,6,17,39,50,-11,45
Stranraer,9044,8,13,5,18,51,60,-9,44
East Fife,9044,9,8,11,17,42,50,-8,35
Stenhousem'r,9044,10,7,9,20,47,83,-36,30
Alloa,9045,1,20,8,8,77,40,37,68
Brechin,9045,2,20,5,11,56,43,13,65
Livingston,9045,3,19,7,10,76,48,28,64
Airdrieon,9045,4,17,8,11,62,50,12,59
Peterhead,9045,5,13,8,15,39,51,-12,47
Albion,9045,6,10,13,13,45,51,-6,43
Queen's Park,9045,7,11,10,15,36,51,-15,43
East Fife,9045,8,10,11,15,42,38,4,41
Stranraer,9045,9,10,6,20,53,73,-20,36
Stenhousem'r,9045,10,7,10,19,40,81,-41,31
Alloa,9046,1,22,6,8,71,44,27,72
Livingston,9046,2,21,6,9,80,48,32,69
Brechin,9046,3,18,4,14,53,51,2,58
Airdrieon,9046,4,17,4,15,56,55,1,55
Albion,9046,5,14,8,14,53,57,-4,50
Stranraer,9046,6,14,7,15,51,52,-1,49
Peterhead,9046,7,13,6,17,45,54,-9,45
East Fife,9046,8,10,11,15,49,42,7,41
Queen's Park,9046,9,11,6,19,35,54,-19,39
Stenhousem'r,9046,10,7,8,21,41,77,-36,29
Alloa,9047,1,19,8,9,74,43,31,65
Livingston,9047,2,20,3,13,70,48,22,63
Queen's Park,9047,3,18,6,12,54,47,7,60
Airdrieon,9047,4,16,7,13,59,56,3,55
Albion,9047,5,16,7,13,58,57,1,55
Brechin,9047,6,15,4,17,54,57,-3,49
East Fife,9047,7,11,10,15,54,57,-3,43
Peterhead,9047,8,11,10,15,46,58,-12,43
Stranraer,9047,9,10,9,17,44,56,-12,39
Stenhousem'r,9047,10,8,8,20,45,79,-34,32
Alloa,9048,1,21,9,6,80,38,42,72
Livingston,9048,2,23,2,11,81,46,35,71
Airdrieon,9048,3,16,9,11,63,58,5,57
Brechin,9048,4,17,4,15,44,50,-6,55
Peterhead,9048,5,15,8,13,53,55,-2,53
Albion,9048,6,14,8,14,52,51,1,50
East Fife,9048,7,10,9,17,50,62,-12,39
Stenhousem'r,9048,8,9,10,17,51,74,-23,37
Stranraer,9048,9,10,6,20,58,70,-12,36
Queen's Park,9048,10,9,7,20,33,61,-28,34
Livingston,9049,1,23,5,8,75,46,29,74
Alloa,9049,2,17,8,11,68,50,18,59
Albion,9049,3,14,11,11,60,49,11,53
Queen's Park,9049,4,14,10,12,44,48,-4,52
Airdrieon,9049,5,13,8,15,50,64,-14,47
Brechin,9049,6,12,10,14,44,50,-6,46
Peterhead,9049,7,11,12,13,48,48,0,45
Stranraer,9049,8,13,6,17,49,54,-5,45
East Fife,9049,9,11,10,15,52,52,0,43
Stenhousem'r,9049,10,9,6,21,46,75,-29,33
Brechin,9050,1,18,9,9,58,50,8,63
Livingston,9050,2,18,5,13,65,45,20,59
Alloa,9050,3,13,13,10,59,43,16,52
East Fife,9050,4,12,14,10,53,48,5,50
Stranraer,9050,5,14,8,14,59,60,-1,50
Airdrieon,9050,6,14,8,14,54,55,-1,50
Albion,9050,7,14,7,15,62,53,9,49
Queen's Park,9050,8,12,9,15,38,44,-6,45
Peterhead,9050,9,10,10,16,47,70,-23,40
Stenhousem'r,9050,10,10,7,19,51,78,-27,37
Livingston,9051,1,21,7,8,70,41,29,70
Alloa,9051,2,19,11,6,81,43,38,68
Albion,9051,3,17,8,11,60,49,11,59
Airdrieon,9051,4,17,8,11,67,61,6,59
Brechin,9051,5,18,4,14,59,58,1,58
Peterhead,9051,6,10,14,12,48,55,-7,44
East Fife,9051,7,11,10,15,51,49,2,43
Queen's Park,9051,8,11,5,20,34,60,-26,38
Stranraer,9051,9,10,4,22,43,62,-19,34
Stenhousem'r,9051,10,7,7,22,50,85,-35,28
Livingston,9052,1,20,3,13,71,47,24,63
Alloa,9052,2,16,11,9,66,45,21,59
Airdrieon,9052,3,15,9,12,50,49,1,54
Brechin,9052,4,13,12,11,45,48,-3,51
Albion,9052,5,14,8,14,52,54,-2,50
Peterhead,9052,6,14,7,15,48,48,0,49
Queen's Park,9052,7,12,8,16,34,46,-12,44
Stenhousem'r,9052,8,12,7,17,46,66,-20,43
East Fife,9052,9,10,12,14,50,52,-2,42
Stranraer,9052,10,10,11,15,51,58,-7,41
Alloa,9053,1,17,9,10,67,44,23,60
Livingston,9053,2,18,6,12,74,57,17,60
Albion,9053,3,15,10,11,47,37,10,55
Airdrieon,9053,4,15,9,12,54,54,0,54
Stranraer,9053,5,17,3,16,55,58,-3,54
East Fife,9053,6,15,8,13,50,41,9,53
Brechin,9053,7,15,8,13,47,46,1,53
Peterhead,9053,8,12,8,16,47,57,-10,44
Queen's Park,9053,9,10,6,20,31,52,-21,36
Stenhousem'r,9053,10,9,7,20,49,75,-26,34
Livingston,9054,1,22,2,12,80,50,30,68
Albion,9054,2,17,8,11,57,44,13,59
Stranraer,9054,3,18,4,14,58,50,8,58
Alloa,9054,4,15,10,11,63,49,14,55
Brechin,9054,5,17,4,15,54,58,-4,55
Airdrieon,9054,6,16,6,14,58,51,7,54
Peterhead,9054,7,12,9,15,45,52,-7,45
Queen's Park,9054,8,12,9,15,42,51,-9,45
East Fife,9054,9,12,7,17,45,52,-7,43
Stenhousem'r,9054,10,5,9,22,44,89,-45,24
Alloa,9055,1,20,5,11,73,44,29,65
Livingston,9055,2,19,7,10,72,43,29,64
Peterhead,9055,3,18,5,13,62,56,6,59
Brechin,9055,4,17,6,13,57,48,9,57
East Fife,9055,5,15,7,14,50,40,10,52
Airdrieon,9055,6,13,8,15,42,56,-14,47
Stranraer,9055,7,13,6,17,46,57,-11,45
Albion,9055,8,11,8,17,46,53,-7,41
Stenhousem'r,9055,9,12,5,19,48,73,-25,41
Queen's Park,9055,10,9,9,18,31,57,-26,36
Alloa,9056,1,23,7,6,86,46,40,76
Livingston,9056,2,18,6,12,69,44,25,60
Brechin,9056,3,16,9,11,48,41,7,57
Airdrieon,9056,4,16,8,12,59,54,5,56
Queen's Park,9056,5,15,8,13,39,42,-3,53
Peterhead,9056,6,10,11,15,46,59,-13,41
Albion,9056,7,10,9,17,43,55,-12,39
Stenhousem'r,9056,8,8,14,14,50,69,-19,38
Stranraer,9056,9,9,10,17,40,57,-17,37
East Fife,9056,10,8,12,16,39,52,-13,36
Livingston,9057,1,24,4,8,79,34,45,76
Brechin,9057,2,18,7,11,51,41,10,61
Alloa,9057,3,16,9,11,60,43,17,57
Albion,9057,4,15,8,13,51,44,7,53
Airdrieon,9057,5,15,7,14,54,51,3,52
Queen's Park,9057,6,14,6,16,39,50,-11,48
Peterhead,9057,7,12,11,13,50,61,-11,47
East Fife,9057,8,10,14,12,45,44,1,44
Stranraer,9057,9,11,7,18,41,55,-14,40
Stenhousem'r,9057,10,5,7,24,36,83,-47,22
Livingston,9058,1,22,5,9,75,55,20,71
Brechin,9058,2,20,4,12,50,36,14,64
Alloa,9058,3,17,8,11,66,45,21,59
Peterhead,9058,4,18,4,14,53,41,12,58
Airdrieon,9058,5,17,7,12,54,45,9,58
Stranraer,9058,6,17,2,17,53,53,0,53
East Fife,9058,7,11,7,18,52,58,-6,40
Queen's Park,9058,8,10,7,19,38,62,-24,37
Stenhousem'r,9058,9,10,6,20,50,80,-30,36
Albion,9058,10,9,8,19,44,60,-16,35
Airdrieon,9059,1,19,9,8,61,44,17,66
Livingston,9059,2,19,5,12,70,57,13,62
Stranraer,9059,3,17,5,14,56,54,2,56
Alloa,9059,4,15,10,11,62,45,17,55
Brechin,9059,5,15,7,14,47,47,0,52
Queen's Park,9059,6,14,8,14,37,39,-2,50
Peterhead,9059,7,13,9,14,49,55,-6,48
East Fife,9059,8,12,6,18,39,48,-9,42
Albion,9059,9,9,13,14,49,51,-2,40
Stenhousem'r,9059,10,8,6,22,48,78,-30,30
Alloa,9060,1,19,10,7,62,37,25,67
Livingston,9060,2,18,7,11,71,48,23,61
Brechin,9060,3,18,6,12,59,50,9,60
Airdrieon,9060,4,16,8,12,56,50,6,56
Stranraer,9060,5,14,6,16,51,54,-3,48
Peterhead,9060,6,13,7,16,55,57,-2,46
East Fife,9060,7,11,12,13,48,46,2,45
Queen's Park,9060,8,12,7,17,39,59,-20,43
Albion,9060,9,10,9,17,44,55,-11,39
Stenhousem'r,9060,10,8,10,18,46,75,-29,34
Livingston,9061,1,22,4,10,71,48,23,70
Airdrieon,9061,2,21,6,9,77,54,23,69
Alloa,9061,3,21,5,10,72,42,30,68
Brechin,9061,4,18,3,15,59,49,10,57
Albion,9061,5,16,7,13,48,48,0,55
Queen's Park,9061,6,16,6,14,43,48,-5,54
Peterhead,9061,7,12,6,18,42,50,-8,42
Stranraer,9061,8,10,4,22,41,62,-21,34
East Fife,9061,9,7,10,19,38,52,-14,31
Stenhousem'r,9061,10,8,7,21,41,79,-38,31
Alloa,9062,1,19,6,11,72,46,26,63
Livingston,9062,2,19,4,13,74,50,24,61
Brechin,9062,3,15,9,12,46,39,7,54
Peterhead,9062,4,16,6,14,45,57,-12,54
Albion,9062,5,15,8,13,51,42,9,53
Stranraer,9062,6,16,3,17,47,54,-7,51
Queen's Park,9062,7,14,7,15,41,50,-9,49
Airdrieon,9062,8,12,9,15,52,57,-5,45
East Fife,9062,9,10,11,15,46,42,4,41
Stenhousem'r,9062,10,9,7,20,45,82,-37,34
Livingston,9063,1,23,4,9,89,43,46,73
Brechin,9063,2,21,3,12,58,43,15,66
Alloa,9063,3,17,8,11,62,46,16,59
Airdrieon,9063,4,15,10,11,55,51,4,55
Albion,9063,5,14,8,14,52,55,-3,50
East Fife,9063,6,14,7,15,60,51,9,49
Peterhead,9063,7,14,7,15,52,56,-4,49
Queen's Park,9063,8,13,6,17,35,53,-18,45
Stranraer,9063,9,10,4,22,43,64,-21,34
Stenhousem'r,9063,10,7,7,22,39,83,-44,28
Livingston,9064,1,25,3,8,86,49,37,78
Alloa,9064,2,19,10,7,80,43,37,67
Albion,9064,3,17,8,11,55,41,14,59
Brechin,9064,4,15,10,11,50,49,1,55
Queen's Park,9064,5,13,8,15,45,53,-8,47
Airdrieon,9064,6,14,5,17,55,66,-11,47
East Fife,9064,7,13,7,16,56,50,6,46
Peterhead,9064,8,12,7,17,44,59,-15,43
Stranraer,9064,9,12,3,21,50,69,-19,39
Stenhousem'r,9064,10,5,9,22,44,86,-42,24
Livingston,9065,1,22,7,7,81,49,32,73
Alloa,9065,2,18,10,8,69,43,26,64
Airdrieon,9065,3,15,10,11,56,48,8,55
Brechin,9065,4,16,7,13,47,39,8,55
Peterhead,9065,5,15,10,11,47,48,-1,55
Albion,9065,6,12,10,14,54,52,2,46
Stranraer,9065,7,12,9,15,52,59,-7,45
Queen's Park,9065,8,12,7,17,40,50,-10,43
East Fife,9065,9,8,13,15,45,49,-4,37
Stenhousem'r,9065,10,5,7,24,37,91,-54,22
Livingston,9066,1,23,5,8,85,47,38,74
Alloa,9066,2,21,5,10,72,48,24,68
Albion,9066,3,18,6,12,67,52,15,60
Airdrieon,9066,4,17,8,11,70,66,4,59
Brechin,9066,5,14,9,13,43,48,-5,51
East Fife,9066,6,12,7,17,49,52,-3,43
Queen's Park,9066,7,12,7,17,43,60,-17,43
Stranraer,9066,8,12,6,18,55,63,-8,42
Peterhead,9066,9,11,6,19,45,58,-13,39
Stenhousem'r,9066,10,6,9,21,39,74,-35,27
Alloa,9067,1,23,6,7,79,43,36,75
Livingston,9067,2,22,4,10,81,51,30,70
Airdrieon,9067,3,19,6,11,67,55,12,63
Albion,9067,4,15,7,14,69,54,15,52
Brechin,9067,5,16,4,16,58,61,-3,52
Peterhead,9067,6,14,6,16,51,59,-8,48
Stranraer,9067,7,13,5,18,47,60,-13,44
Queen's Park,9067,8,13,5,18,31,51,-20,44
East Fife,9067,9,10,7,19,48,59,-11,37
Stenhousem'r,9067,10,7,6,23,55,93,-38,27
Livingston,9068,1,19,5,12,76,53,23,62
Airdrieon,9068,2,18,7,11,72,54,18,61
Alloa,9068,3,17,7,12,64,51,13,58
Albion,9068,4,17,7,12,60,52,8,58
Brechin,9068,5,17,7,12,53,47,6,58
Queen's Park,9068,6,13,10,13,41,50,-9,49
East Fife,9068,7,13,9,14,47,46,1,48
Peterhead,9068,8,12,8,16,43,53,-10,44
Stranraer,9068,9,12,2,22,42,61,-19,38
Stenhousem'r,9068,10,6,10,20,48,79,-31,28
Livingston,9069,1,21,3,12,79,51,28,66
Alloa,9069,2,18,9,9,65,47,18,63
Albion,9069,3,17,7,12,54,47,7,58
Airdrieon,9069,4,16,8,12,59,41,18,56
Peterhead,9069,5,15,10,11,49,48,1,55
Brechin,9069,6,16,6,14,51,46,5,54
Stranraer,9069,7,12,6,18,44,57,-13,42
East Fife,9069,8,10,8,18,39,53,-14,38
Queen's Park,9069,9,10,8,18,38,56,-18,38
Stenhousem'r,9069,10,7,11,18,46,78,-32,32
Airdrieon,9070,1,21,4,11,69,48,21,67
Livingston,9070,2,21,3,12,70,50,20,66
Brechin,9070,3,17,6,13,57,49,8,57
Alloa,9070,4,17,5,14,72,48,24,56
Albion,9070,5,15,11,10,51,45,6,56
East Fife,9070,6,13,8,15,61,61,0,47
Peterhead,9070,7,12,6,18,46,60,-14,42
Queen's Park,9070,8,10,10,16,35,56,-21,40
Stenhousem'r,9070,9,9,10,17,51,73,-22,37
Stranraer,9070,10,10,7,19,44,66,-22,37
Livingston,9071,1,25,2,9,73,39,34,77
Alloa,9071,2,19,7,10,72,47,25,64
Brechin,9071,3,18,5,13,58,51,7,59
Airdrieon,9071,4,16,9,11,59,55,4,57
Queen's Park,9071,5,16,5,15,51,45,6,53
Albion,9071,6,14,8,14,56,50,6,50
Peterhead,9071,7,11,7,18,39,60,-21,40
Stenhousem'r,9071,8,11,7,18,56,79,-23,40
Stranraer,9071,9,11,4,21,49,75,-26,37
East Fife,9071,10,9,6,21,44,56,-12,33
Alloa,9072,1,19,7,10,72,45,27,64
Livingston,9072,2,19,6,11,68,45,23,63
Airdrieon,9072,3,19,6,11,64,53,11,63
Brechin,9072,4,18,6,12,52,49,3,60
Albion,9072,5,14,7,15,49,53,-4,49
Peterhead,9072,6,14,6,16,45,49,-4,48
East Fife,9072,7,12,11,13,49,45,4,47
Queen's Park,9072,8,11,8,17,40,47,-7,41
Stranraer,9072,9,11,6,19,47,64,-17,39
Stenhousem'r,9072,10,7,9,20,43,79,-36,30
Alloa,9073,1,21,6,9,73,51,22,69
Airdrieon,9073,2,21,5,10,66,47,19,68
Livingston,9073,3,21,3,12,86,55,31,66
Brechin,9073,4,17,6,13,48,48,0,57
Peterhead,9073,5,13,11,12,49,54,-5,50
Queen's Park,9073,6,14,7,15,38,52,-14,49
Albion,9073,7,11,8,17,47,50,-3,41
East Fife,9073,8,9,13,14,49,48,1,40
Stranraer,9073,9,12,4,20,56,67,-11,40
Stenhousem'r,9073,10,6,7,23,39,79,-40,25
Brechin,9074,1,21,1,14,62,46,16,64
Airdrieon,9074,2,17,8,11,59,51,8,59
Albion,9074,3,17,7,12,57,45,12,58
Alloa,9074,4,15,10,11,59,48,11,55
Livingston,9074,5,16,4,16,73,62,11,52
Queen's Park,9074,6,16,4,16,38,54,-16,52
Stranraer,9074,7,15,5,16,54,55,-1,50
East Fife,9074,8,11,9,16,46,50,-4,42
Peterhead,9074,9,10,11,15,49,60,-11,41
Stenhousem'r,9074,10,10,5,21,47,73,-26,35
Livingston,9075,1,21,7,8,80,53,27,70
Airdrieon,9075,2,19,9,8,72,50,22,66
Alloa,9075,3,17,7,12,70,52,18,58
Brechin,9075,4,17,4,15,49,50,-1,55
Albion,9075,5,15,8,13,50,50,0,53
Queen's Park,9075,6,13,7,16,35,47,-12,46
East Fife,9075,7,12,7,17,52,52,0,43
Peterhead,9075,8,11,9,16,44,58,-14,42
Stenhousem'r,9075,9,9,11,16,45,64,-19,38
Stranraer,9075,10,7,9,20,51,72,-21,30
Livingston,9076,1,24,3,9,89,37,52,75
Alloa,9076,2,18,8,10,74,45,29,62
Airdrieon,9076,3,18,8,10,56,53,3,62
Albion,9076,4,16,9,11,57,48,9,57
Brechin,9076,5,15,8,13,49,54,-5,53
Peterhead,9076,6,14,8,14,47,53,-6,50
Queen's Park,9076,7,13,7,16,43,56,-13,46
Stranraer,9076,8,10,8,18,42,62,-20,38
East Fife,9076,9,10,7,19,48,48,0,37
Stenhousem'r,9076,10,5,8,23,38,87,-49,23
Livingston,9077,1,22,5,9,82,48,34,71
Alloa,9077,2,18,10,8,66,42,24,64
Peterhead,9077,3,16,8,12,57,52,5,56
East Fife,9077,4,15,7,14,54,42,12,52
Brechin,9077,5,14,7,15,51,54,-3,49
Albion,9077,6,12,11,13,53,57,-4,47
Airdrieon,9077,7,12,10,14,61,63,-2,46
Stranraer,9077,8,12,7,17,51,67,-16,43
Queen's Park,9077,9,10,8,18,38,60,-22,38
Stenhousem'r,9077,10,6,13,17,51,79,-28,31
Livingston,9078,1,21,3,12,74,51,23,66
Alloa,9078,2,19,8,9,73,44,29,65
Airdrieon,9078,3,18,6,12,64,61,3,60
Stranraer,9078,4,17,7,12,55,47,8,58
Albion,9078,5,15,10,11,59,46,13,55
Peterhead,9078,6,13,10,13,51,52,-1,49
East Fife,9078,7,13,5,18,56,53,3,44
Brechin,9078,8,12,8,16,47,56,-9,44
Queen's Park,9078,9,9,10,17,35,56,-21,37
Stenhousem'r,9078,10,6,7,23,39,87,-48,25
Livingston,9079,1,25,2,9,82,38,44,77
Alloa,9079,2,19,9,8,64,41,23,66
Peterhead,9079,3,17,4,15,52,51,1,55
Brechin,9079,4,15,7,14,46,48,-2,52
Albion,9079,5,13,7,16,49,59,-10,46
East Fife,9079,6,12,9,15,50,53,-3,45
Airdrieon,9079,7,12,8,16,47,55,-8,44
Stenhousem'r,9079,8,11,8,17,50,73,-23,41
Stranraer,9079,9,11,7,18,46,52,-6,40
Queen's Park,9079,10,11,7,18,34,50,-16,40
Alloa,9080,1,22,6,8,79,43,36,72
Livingston,9080,2,21,5,10,69,38,31,68
Airdrieon,9080,3,17,8,11,58,51,7,59
Stranraer,9080,4,15,6,15,55,52,3,51
Peterhead,9080,5,15,5,16,48,55,-7,50
Queen's Park,9080,6,15,5,16,45,56,-11,50
Brechin,9080,7,14,5,17,44,50,-6,47
Albion,9080,8,12,7,17,47,57,-10,43
East Fife,9080,9,11,9,16,41,46,-5,42
Stenhousem'r,9080,10,7,6,23,38,76,-38,27
Alloa,9081,1,20,6,10,69,48,21,66
Airdrieon,9081,2,18,9,9,72,48,24,63
Brechin,9081,3,20,3,13,48,45,3,63
Livingston,9081,4,16,9,11,74,51,23,57
Stranraer,9081,5,16,7,13,55,47,8,55
Albion,9081,6,14,9,13,48,45,3,51
Peterhead,9081,7,12,9,15,49,58,-9,45
East Fife,9081,8,10,10,16,50,55,-5,40
Queen's Park,9081,9,9,9,18,28,47,-19,36
Stenhousem'r,9081,10,6,7,23,39,88,-49,25
Alloa,9082,1,21,7,8,74,47,27,70
Livingston,9082,2,20,4,12,69,44,25,64
Airdrieon,9082,3,17,8,11,65,55,10,59
Brechin,9082,4,17,6,13,42,42,0,57
East Fife,9082,5,14,7,15,63,53,10,49
Albion,9082,6,14,6,16,53,52,1,48
Queen's Park,9082,7,12,8,16,35,48,-13,44
Stranraer,9082,8,13,4,19,51,63,-12,43
Peterhead,9082,9,12,5,19,48,59,-11,41
Stenhousem'r,9082,10,10,5,21,45,82,-37,35
Livingston,9083,1,19,9,8,76,53,23,66
Alloa,9083,2,16,10,10,61,43,18,58
Brechin,9083,3,15,9,12,46,45,1,54
Airdrieon,9083,4,13,11,12,56,48,8,50
East Fife,9083,5,13,9,14,57,48,9,48
Albion,9083,6,13,9,14,51,52,-1,48
Queen's Park,9083,7,12,8,16,39,57,-18,44
Peterhead,9083,8,12,7,17,49,60,-11,43
Stranraer,9083,9,11,10,15,43,59,-16,43
Stenhousem'r,9083,10,11,8,17,52,65,-13,41
Alloa,9084,1,20,9,7,67,39,28,69
Livingston,9084,2,19,8,9,65,39,26,65
Brechin,9084,3,17,4,15,55,48,7,55
Airdrieon,9084,4,14,9,13,60,56,4,51
Peterhead,9084,5,14,9,13,40,45,-5,51
Stranraer,9084,6,14,4,18,50,53,-3,46
Queen's Park,9084,7,11,11,14,40,48,-8,44
Albion,9084,8,11,9,16,53,57,-4,42
Stenhousem'r,9084,9,11,7,18,46,78,-32,40
East Fife,9084,10,9,10,17,51,64,-13,37
Livingston,9085,1,21,8,7,82,47,35,71
Brechin,9085,2,20,5,11,54,42,12,65
Alloa,9085,3,17,10,9,69,44,25,61
Peterhead,9085,4,17,6,13,62,62,0,57
Albion,9085,5,14,5,17,59,55,4,47
East Fife,9085,6,13,8,15,50,46,4,47
Airdrieon,9085,7,13,8,15,57,58,-1,47
Stranraer,9085,8,13,5,18,53,67,-14,44
Queen's Park,9085,9,11,7,18,37,56,-19,40
Stenhousem'r,9085,10,5,10,21,38,84,-46,25
Livingston,9086,1,26,1,9,95,41,54,79
Airdrieon,9086,2,18,9,9,66,54,12,63
Brechin,9086,3,18,4,14,48,46,2,58
Queen's Park,9086,4,15,3,18,38,55,-17,48
Alloa,9086,5,13,8,15,58,52,6,47
Albion,9086,6,13,8,15,61,61,0,47
Peterhead,9086,7,13,8,15,50,54,-4,47
East Fife,9086,8,11,12,13,51,52,-1,45
Stranraer,9086,9,11,7,18,45,62,-17,40
Stenhousem'r,9086,10,10,4,22,52,87,-35,34
Alloa,9087,1,20,8,8,71,41,30,68
Livingston,9087,2,17,9,10,67,45,22,60
Airdrieon,9087,3,17,6,13,60,47,13,57
Stranraer,9087,4,18,1,17,58,60,-2,55
East Fife,9087,5,14,7,15,58,56,2,49
Albion,9087,6,14,7,15,51,55,-4,49
Queen's Park,9087,7,13,9,14,43,50,-7,48
Brechin,9087,8,15,3,18,44,54,-10,48
Stenhousem'r,9087,9,10,7,19,41,74,-33,37
Peterhead,9087,10,9,9,18,39,50,-11,36
Alloa,9088,1,20,4,12,69,43,26,64
Livingston,9088,2,20,3,13,81,55,26,63
Peterhead,9088,3,16,11,9,61,49,12,59
Brechin,9088,4,18,5,13,47,48,-1,59
Queen's Park,9088,5,16,7,13,41,50,-9,55
Airdrieon,9088,6,14,9,13,57,63,-6,51
Albion,9088,7,12,8,16,56,62,-6,44
East Fife,9088,8,10,10,16,47,44,3,40
Stenhousem'r,9088,9,9,9,18,49,68,-19,36
Stranraer,9088,10,10,4,22,46,72,-26,34
Livingston,9089,1,24,3,9,76,41,35,75
Alloa,9089,2,21,7,8,71,43,28,70
Brechin,9089,3,15,9,12,50,43,7,54
Airdrieon,9089,4,17,3,16,44,57,-13,54
Peterhead,9089,5,13,10,13,45,50,-5,49
Stranraer,9089,6,15,3,18,56,57,-1,48
Albion,9089,7,14,5,17,48,46,2,47
East Fife,9089,8,11,8,17,46,50,-4,41
Queen's Park,9089,9,10,7,19,31,49,-18,37
Stenhousem'r,9089,10,10,5,21,48,79,-31,35
Alloa,9090,1,23,5,8,68,40,28,74
Airdrieon,9090,2,19,7,10,59,48,11,64
Livingston,9090,3,18,4,14,71,53,18,58
Albion,9090,4,17,7,12,61,45,16,58
Brechin,9090,5,15,7,14,58,50,8,52
Peterhead,9090,6,11,11,14,50,60,-10,44
East Fife,9090,7,10,10,16,48,52,-4,40
Queen's Park,9090,8,10,8,18,28,47,-19,38
Stranraer,9090,9,11,5,20,44,70,-26,38
Stenhousem'r,9090,10,9,10,17,48,70,-22,37
Airdrieon,9091,1,19,6,11,65,52,13,63
Livingston,9091,2,19,4,13,73,53,20,61
Albion,9091,3,17,9,10,59,44,15,60
Alloa,9091,4,15,12,9,63,46,17,57
Brechin,9091,5,14,9,13,53,55,-2,51
Stranraer,9091,6,15,5,16,55,59,-4,50
Peterhead,9091,7,12,10,14,47,53,-6,46
East Fife,9091,8,10,11,15,51,57,-6,41
Queen's Park,9091,9,10,7,19,31,50,-19,37
Stenhousem'r,9091,10,8,9,19,44,72,-28,33
Albion,9092,1,18,9,9,58,37,21,63
Alloa,9092,2,17,9,10,64,42,22,60
Livingston,9092,3,19,2,15,65,53,12,59
Brechin,9092,4,16,5,15,49,49,0,53
East Fife,9092,5,15,7,14,52,46,6,52
Airdrieon,9092,6,15,7,14,55,52,3,52
Peterhead,9092,7,15,7,14,49,50,-1,52
Stranraer,9092,8,13,6,17,47,55,-8,45
Queen's Park,9092,9,11,6,19,38,52,-14,39
Stenhousem'r,9092,10,7,10,19,35,76,-41,31
Livingston,9093,1,21,3,12,68,47,21,66
Alloa,9093,2,18,7,11,70,52,18,61
Airdrieon,9093,3,17,6,13,59,51,8,57
Albion,9093,4,15,8,13,51,51,0,53
Brechin,9093,5,15,5,16,45,49,-4,50
East Fife,9093,6,13,10,13,58,47,11,49
Stranraer,9093,7,15,3,18,50,61,-11,48
Queen's Park,9093,8,13,5,18,35,48,-13,44
Peterhead,9093,9,10,11,15,48,51,-3,41
Stenhousem'r,9093,10,10,8,18,50,77,-27,38
Livingston,9094,1,22,5,9,72,42,30,71
Airdrieon,9094,2,18,7,11,63,53,10,61
Brechin,9094,3,15,9,12,50,43,7,54
Alloa,9094,4,14,9,13,70,53,17,51
Peterhead,9094,5,14,9,13,54,49,5,51
Queen's Park,9094,6,15,6,15,40,57,-17,51
Albion,9094,7,13,11,12,56,58,-2,50
Stranraer,9094,8,10,8,18,47,61,-14,38
East Fife,9094,9,8,12,16,49,56,-7,36
Stenhousem'r,9094,10,10,6,20,45,74,-29,36
Livingston,9095,1,23,3,10,82,45,37,72
Alloa,9095,2,22,6,8,76,39,37,72
Brechin,9095,3,19,4,13,53,50,3,61
Airdrieon,9095,4,16,5,15,48,58,-10,53
Peterhead,9095,5,13,9,14,48,58,-10,48
Albion,9095,6,13,8,15,47,50,-3,47
East Fife,9095,7,12,9,15,53,47,6,45
Stranraer,9095,8,14,2,20,54,63,-9,44
Queen's Park,9095,9,13,5,18,32,44,-12,44
Stenhousem'r,9095,10,6,7,23,40,79,-39,25
Livingston,9096,1,21,6,9,70,46,24,69
Alloa,9096,2,21,5,10,78,42,36,68
Peterhead,9096,3,17,7,12,62,49,13,58
Stranraer,9096,4,17,7,12,61,54,7,58
Airdrieon,9096,5,13,9,14,53,57,-4,48
East Fife,9096,6,12,9,15,40,46,-6,45
Albion,9096,7,12,8,16,61,64,-3,44
Queen's Park,9096,8,12,8,16,36,54,-18,44
Brechin,9096,9,13,4,19,46,54,-8,43
Stenhousem'r,9096,10,7,7,22,48,89,-41,28
Alloa,9097,1,18,9,9,73,45,28,63
Brechin,9097,2,16,7,13,56,57,-1,55
Livingston,9097,3,17,3,16,67,52,15,54
Airdrieon,9097,4,15,9,12,56,50,6,54
East Fife,9097,5,14,11,11,49,45,4,53
Stranraer,9097,6,15,7,14,51,55,-4,52
Albion,9097,7,12,13,11,50,46,4,49
Peterhead,9097,8,11,10,15,42,50,-8,43
Queen's Park,9097,9,12,6,18,35,55,-20,42
Stenhousem'r,9097,10,8,9,19,49,73,-24,33
Livingston,9098,1,20,3,13,77,50,27,63
Alloa,9098,2,15,14,7,56,38,18,59
Brechin,9098,3,15,9,12,56,49,7,54
Airdrieon,9098,4,15,9,12,57,51,6,54
Albion,9098,5,15,7,14,57,52,5,52
Peterhead,9098,6,14,7,15,44,49,-5,49
Queen's Park,9098,7,15,4,17,41,52,-11,49
East Fife,9098,8,12,10,14,46,39,7,46
Stranraer,9098,9,12,5,19,44,61,-17,41
Stenhousem'r,9098,10,9,8,19,45,82,-37,35
Livingston,9099,1,24,1,11,76,40,36,73
Alloa,9099,2,20,8,8,73,50,23,68
Albion,9099,3,16,10,10,58,46,12,58
Airdrieon,9099,4,16,7,13,60,57,3,55
Brechin,9099,5,15,7,14,50,47,3,52
East Fife,9099,6,13,11,12,57,46,11,50
Peterhead,9099,7,12,13,11,47,45,2,49
Queen's Park,9099,8,10,10,16,33,57,-24,40
Stranraer,9099,9,8,4,24,46,72,-26,28
Stenhousem'r,9099,10,6,9,21,47,87,-40,27
Livingston,9100,1,20,8,8,82,40,42,68
Airdrieon,9100,2,18,8,10,65,48,17,62
Brechin,9100,3,17,8,11,55,50,5,59
Alloa,9100,4,15,11,10,66,47,19,56
Peterhead,9100,5,13,11,12,55,51,4,50
Stranraer,9100,6,14,7,15,50,55,-5,49
East Fife,9100,7,11,11,14,47,50,-3,44
Albion,9100,8,11,8,17,56,64,-8,41
Queen's Park,9100,9,12,5,19,27,57,-30,41
Stenhousem'r,9100,10,8,5,23,48,89,-41,29
Alloa,9101,1,20,9,7,68,37,31,69
Livingston,9101,2,20,4,12,82,55,27,64
Brechin,9101,3,17,7,12,53,47,6,58
Albion,9101,4,15,8,13,59,61,-2,53
East Fife,9101,5,14,10,12,52,49,3,52
Peterhead,9101,6,14,8,14,53,57,-4,50
Queen's Park,9101,7,12,6,18,42,53,-11,42
Airdrieon,9101,8,12,5,19,59,71,-12,41
Stenhousem'r,9101,9,10,9,17,50,72,-22,39
Stranraer,9101,10,11,4,21,44,60,-16,37
Livingston,9102,1,20,7,9,75,46,29,67
Alloa,9102,2,18,8,10,75,45,30,62
Airdrieon,9102,3,17,9,10,64,54,10,60
Brechin,9102,4,15,10,11,60,46,14,55
Queen's Park,9102,5,16,6,14,44,50,-6,54
East Fife,9102,6,11,12,13,46,44,2,45
Albion,9102,7,10,11,15,46,55,-9,41
Peterhead,9102,8,10,11,15,40,55,-15,41
Stranraer,9102,9,11,7,18,43,64,-21,40
Stenhousem'r,9102,10,7,9,20,40,74,-34,30
Airdrieon,9103,1,22,3,11,75,49,26,69
Livingston,9103,2,20,6,10,75,49,26,66
Queen's Park,9103,3,14,10,12,42,40,2,52
Peterhead,9103,4,14,8,14,57,61,-4,50
Brechin,9103,5,13,10,13,46,46,0,49
East Fife,9103,6,12,10,14,51,45,6,46
Albion,9103,7,12,10,14,57,60,-3,46
Stranraer,9103,8,13,7,16,59,66,-7,46
Alloa,9103,9,11,12,13,60,58,2,45
Stenhousem'r,9103,10,7,8,21,40,88,-48,29
Airdrieon,9104,1,23,5,8,71,40,31,74
Livingston,9104,2,18,9,9,78,47,31,63
Alloa,9104,3,19,6,11,67,48,19,63
Stranraer,9104,4,16,6,14,51,57,-6,54
Brechin,9104,5,16,5,15,43,44,-1,53
Peterhead,9104,6,13,9,14,47,49,-2,48
Albion,9104,7,13,8,15,58,60,-2,47
Queen's Park,9104,8,10,7,19,29,54,-25,37
East Fife,9104,9,9,9,18,49,55,-6,36
Stenhousem'r,9104,10,7,8,21,50,89,-39,29
Alloa,9105,1,20,10,6,70,42,28,70
Airdrieon,9105,2,21,3,12,75,68,7,66
Brechin,9105,3,17,7,12,60,51,9,58
Livingston,9105,4,16,5,15,71,65,6,53
Albion,9105,5,14,10,12,60,57,3,52
Peterhead,9105,6,14,9,13,54,49,5,51
Queen's Park,9105,7,11,7,18,32,50,-18,40
East Fife,9105,8,9,12,15,45,51,-6,39
Stranraer,9105,9,10,9,17,49,58,-9,39
Stenhousem'r,9105,10,8,8,20,46,71,-25,32
Alloa,9106,1,22,4,10,72,41,31,70
Livingston,9106,2,20,3,13,68,43,25,63
Brechin,9106,3,19,5,12,58,45,13,62
Airdrieon,9106,4,18,4,14,58,58,0,58
Albion,9106,5,15,6,15,51,49,2,51
Stranraer,9106,6,14,6,16,49,52,-3,48
Peterhead,9106,7,13,9,14,43,50,-7,48
East Fife,9106,8,13,7,16,45,45,0,46
Queen's Park,9106,9,10,5,21,29,59,-30,35
Stenhousem'r,9106,10,9,5,22,47,78,-31,32
Livingston,9107,1,21,8,7,79,43,36,71
Alloa,9107,2,18,9,9,68,44,24,63
Airdrieon,9107,3,17,6,13,64,53,11,57
Brechin,9107,4,16,8,12,54,50,4,56
Albion,9107,5,15,7,14,53,52,1,52
Peterhead,9107,6,14,9,13,53,60,-7,51
Queen's Park,9107,7,14,5,17,42,57,-15,47
Stranraer,9107,8,12,5,19,46,58,-12,41
East Fife,9107,9,10,10,16,41,50,-9,40
Stenhousem'r,9107,10,5,9,22,40,73,-33,24
Alloa,9108,1,20,9,7,68,38,30,69
Livingston,9108,2,19,7,10,71,42,29,64
Airdrieon,9108,3,17,8,11,59,50,9,59
Albion,9108,4,14,10,12,51,50,1,52
Stranraer,9108,5,15,6,15,54,56,-2,51
Peterhead,9108,6,11,10,15,46,60,-14,43
Queen's Park,9108,7,11,10,15,33,49,-16,43
Brechin,9108,8,12,6,18,41,53,-12,42
Stenhousem'r,9108,9,9,10,17,46,67,-21,37
East Fife,9108,10,7,14,15,43,47,-4,35
Livingston,9109,1,21,6,9,69,49,20,69
Airdrieon,9109,2,20,3,13,62,51,11,63
Alloa,9109,3,17,9,10,72,49,23,60
Peterhead,9109,4,16,10,10,54,49,5,58
Albion,9109,5,13,10,13,56,54,2,49
Queen's Park,9109,6,13,8,15,52,56,-4,47
Stranraer,9109,7,14,5,17,54,65,-11,47
Brechin,9109,8,12,10,14,48,52,-4,46
East Fife,9109,9,10,9,17,48,53,-5,39
Stenhousem'r,9109,10,5,8,23,50,87,-37,23
Livingston,9110,1,24,4,8,80,37,43,76
Alloa,9110,2,17,7,12,66,56,10,58
Airdrieon,9110,3,16,9,11,64,59,5,57
Brechin,9110,4,16,6,14,54,51,3,54
East Fife,9110,5,13,8,15,49,45,4,47
Queen's Park,9110,6,14,4,18,42,51,-9,46
Peterhead,9110,7,13,7,16,50,61,-11,46
Albion,9110,8,11,10,15,45,49,-4,43
Stenhousem'r,9110,9,11,7,18,52,72,-20,40
Stranraer,9110,10,11,6,19,46,67,-21,39
Livingston,9111,1,22,7,7,78,43,35,73
Airdrieon,9111,2,18,6,12,61,54,7,60
Alloa,9111,3,16,9,11,64,50,14,57
Queen's Park,9111,4,16,7,13,38,42,-4,55
Brechin,9111,5,15,7,14,49,45,4,52
Peterhead,9111,6,13,11,12,54,55,-1,50
Stranraer,9111,7,13,8,15,60,59,1,47
Albion,9111,8,13,8,15,55,58,-3,47
East Fife,9111,9,11,7,18,46,59,-13,40
Stenhousem'r,9111,10,3,10,23,41,81,-40,19
Brechin,9112,1,21,4,11,57,43,14,67
Airdrieon,9112,2,20,5,11,60,45,15,65
Livingston,9112,3,20,4,12,77,52,25,64
Alloa,9112,4,18,8,10,72,45,27,62
East Fife,9112,5,16,6,14,55,45,10,54
Peterhead,9112,6,13,9,14,51,56,-5,48
Queen's Park,9112,7,13,6,17,35,46,-11,45
Albion,9112,8,11,7,18,41,53,-12,40
Stranraer,9112,9,9,5,22,41,70,-29,32
Stenhousem'r,9112,10,8,8,20,47,81,-34,32
Alloa,9113,1,21,7,8,65,32,33,70
Airdrieon,9113,2,20,4,12,57,51,6,64
Livingston,9113,3,18,5,13,71,49,22,59
Albion,9113,4,17,7,12,51,48,3,58
Peterhead,9113,5,16,8,12,57,46,11,56
East Fife,9113,6,15,5,16,53,46,7,50
Brechin,9113,7,14,6,16,44,57,-13,48
Queen's Park,9113,8,10,10,16,32,49,-17,40
Stranraer,9113,9,11,6,19,44,55,-11,39
Stenhousem'r,9113,10,6,6,24,42,83,-41,24
Livingston,9114,1,21,4,11,79,48,31,67
Alloa,9114,2,17,11,8,64,38,26,62
Airdrieon,9114,3,17,7,12,63,55,8,58
Albion,9114,4,15,11,10,47,39,8,56
Queen's Park,9114,5,14,8,14,35,42,-7,50
Brechin,9114,6,15,5,16,47,55,-8,50
Peterhead,9114,7,13,6,17,50,55,-5,45
Stranraer,9114,8,13,6,17,52,63,-11,45
East Fife,9114,9,11,9,16,46,54,-8,42
Stenhousem'r,9114,10,5,11,20,45,79,-34,26
Livingston,9115,1,24,2,10,82,54,28,74
Alloa,9115,2,16,10,10,72,51,21,58
Airdrieon,9115,3,15,9,12,58,49,9,54
Brechin,9115,4,14,11,11,46,46,0,53
Albion,9115,5,14,9,13,55,50,5,51
Peterhead,9115,6,11,13,12,44,48,-4,46
East Fife,9115,7,10,11,15,53,52,1,41
Stenhousem'r,9115,8,11,8,17,51,68,-17,41
Queen's Park,9115,9,10,9,17,32,57,-25,39
Stranraer,9115,10,10,8,18,47,65,-18,38
Livingston,9116,1,19,8,9,71,42,29,65
Alloa,9116,2,17,10,9,74,45,29,61
Airdrieon,9116,3,17,9,10,54,43,11,60
Albion,9116,4,15,7,14,57,51,6,52
Stranraer,9116,5,15,6,15,62,62,0,51
Brechin,9116,6,13,10,13,51,56,-5,49
Queen's Park,9116,7,12,9,15,36,49,-13,45
Peterhead,9116,8,12,7,17,45,52,-7,43
East Fife,9116,9,10,8,18,51,61,-10,38
Stenhousem'r,9116,10,10,6,20,39,79,-40,36
Livingston,9117,1,19,8,9,74,43,31,65
Brechin,9117,2,20,5,11,59,41,18,65
Albion,9117,3,18,7,11,64,47,17,61
Airdrieon,9117,4,17,8,11,61,54,7,59
Alloa,9117,5,16,9,11,63,41,22,57
Peterhead,9117,6,12,7,17,41,54,-13,43
Stranraer,9117,7,12,6,18,47,58,-11,42
East Fife,9117,8,10,9,17,40,55,-15,39
Stenhousem'r,9117,9,11,6,19,53,85,-32,39
Queen's Park,9117,10,8,9,19,31,55,-24,33
Brechin,9118,1,19,8,9,59,38,21,65
Alloa,9118,2,16,11,9,62,41,21,59
Livingston,9118,3,17,7,12,68,50,18,58
Airdrieon,9118,4,16,7,13,63,58,5,55
Albion,9118,5,14,10,12,51,44,7,52
Queen's Park,9118,6,14,8,14,42,46,-4,50
Peterhead,9118,7,11,11,14,48,53,-5,44
Stranraer,9118,8,11,11,14,50,57,-7,44
East Fife,9118,9,9,10,17,40,55,-15,37
Stenhousem'r,9118,10,7,9,20,42,83,-41,30
Alloa,9119,1,21,8,7,72,37,35,71
Livingston,9119,2,18,5,13,59,46,13,59
Airdrieon,9119,3,17,7,12,52,45,7,58
Brechin,9119,4,16,8,12,47,49,-2,56
Stranraer,9119,5,14,8,14,48,52,-4,50
Queen's Park,9119,6,14,8,14,42,49,-7,50
East Fife,9119,7,12,9,15,49,49,0,45
Peterhead,9119,8,12,8,16,53,55,-2,44
Albion,9119,9,9,10,17,44,60,-16,37
Stenhousem'r,9119,10,9,5,22,47,71,-24,32
Alloa,9120,1,21,6,9,78,45,33,69
Livingston,9120,2,21,4,11,88,52,36,67
Peterhead,9120,3,18,6,12,65,53,12,60
Airdrieon,9120,4,17,5,14,61,54,7,56
Brechin,9120,5,16,6,14,49,54,-5,54
Albion,9120,6,13,10,13,51,60,-9,49
East Fife,9120,7,12,7,17,44,48,-4,43
Stranraer,9120,8,12,7,17,56,65,-9,43
Queen's Park,9120,9,11,7,18,44,58,-14,40
Stenhousem'r,9120,10,6,8,22,44,91,-47,26
Alloa,9121,1,20,8,8,72,42,30,68
Livingston,9121,2,20,7,9,74,53,21,67
Brechin,9121,3,18,6,12,50,48,2,60
Airdrieon,9121,4,16,5,15,55,53,2,53
Stranraer,9121,5,14,5,17,48,54,-6,47
East Fife,9121,6,13,5,18,51,49,2,44
Stenhousem'r,9121,7,13,5,18,62,80,-18,44
Albion,9121,8,11,9,16,59,65,-6,42
Queen's Park,9121,9,12,6,18,42,55,-13,42
Peterhead,9121,10,11,8,17,51,65,-14,41
Livingston,9122,1,24,1,11,74,52,22,73
Alloa,9122,2,22,5,9,74,40,34,71
Airdrieon,9122,3,18,7,11,63,52,11,61
Brechin,9122,4,18,5,13,60,51,9,59
Albion,9122,5,17,8,11,55,46,9,59
East Fife,9122,6,15,9,12,59,48,11,54
Queen's Park,9122,7,10,8,18,37,55,-18,38
Stranraer,9122,8,10,7,19,43,63,-20,37
Peterhead,9122,9,7,9,20,39,65,-26,30
Stenhousem'r,9122,10,7,5,24,56,88,-32,26
Alloa,9123,1,21,7,8,70,44,26,70
Livingston,9123,2,21,3,12,81,54,27,66
Airdrieon,9123,3,19,7,10,71,51,20,64
Peterhead,9123,4,15,8,13,58,48,10,53
Albion,9123,5,15,7,14,57,56,1,52
East Fife,9123,6,14,8,14,55,56,-1,50
Brechin,9123,7,13,6,17,47,61,-14,45
Queen's Park,9123,8,11,9,16,37,52,-15,42
Stranraer,9123,9,10,5,21,49,66,-17,35
Stenhousem'r,9123,10,7,8,21,53,90,-37,29
Livingston,9124,1,25,3,8,88,44,44,78
Peterhead,9124,2,19,9,8,61,51,10,66
Brechin,9124,3,19,5,12,64,56,8,62
Alloa,9124,4,18,4,14,66,50,16,58
Airdrieon,9124,5,14,9,13,56,61,-5,51
East Fife,9124,6,12,11,13,64,49,15,47
Stranraer,9124,7,12,6,18,49,58,-9,42
Queen's Park,9124,8,12,4,20,43,65,-22,40
Albion,9124,9,9,10,17,46,66,-20,37
Stenhousem'r,9124,10,4,11,21,52,89,-37,23
Livingston,9125,1,21,4,11,86,52,34,67
Brechin,9125,2,18,7,11,51,43,8,61
Airdrieon,9125,3,16,7,13,53,50,3,55
Alloa,9125,4,14,12,10,61,50,11,54
Peterhead,9125,5,14,8,14,42,48,-6,50
Albion,9125,6,12,11,13,47,46,1,47
East Fife,9125,7,13,7,16,53,48,5,46
Stranraer,9125,8,12,7,17,42,53,-11,43
Queen's Park,9125,9,11,8,17,38,56,-18,41
Stenhousem'r,9125,10,9,9,18,50,77,-27,36
Livingston,9126,1,21,5,10,78,42,36,68
Peterhead,9126,2,18,8,10,57,43,14,62
Brechin,9126,3,17,10,9,58,49,9,61
Alloa,9126,4,17,9,10,64,43,21,60
Airdrieon,9126,5,14,11,11,54,56,-2,53
Albion,9126,6,11,13,12,51,56,-5,46
East Fife,9126,7,11,10,15,54,53,1,43
Queen's Park,9126,8,12,4,20,36,51,-15,40
Stranraer,9126,9,11,5,20,50,69,-19,38
Stenhousem'r,9126,10,6,9,21,38,78,-40,27
Alloa,9127,1,23,7,6,80,39,41,76
Brechin,9127,2,18,7,11,50,43,7,61
Livingston,9127,3,17,8,11,71,49,22,59
Peterhead,9127,4,17,7,12,54,47,7,58
Airdrieon,9127,5,13,10,13,58,60,-2,49
Albion,9127,6,13,8,15,48,54,-6,47
Queen's Park,9127,7,11,8,17,44,58,-14,41
East Fife,9127,8,11,7,18,48,54,-6,40
Stranraer,9127,9,11,5,20,40,58,-18,38
Stenhousem'r,9127,10,9,7,20,45,76,-31,34
Alloa,9128,1,21,5,10,66,40,26,68
Livingston,9128,2,22,0,14,78,50,28,66
Airdrieon,9128,3,19,8,9,65,52,13,65
Brechin,9128,4,16,9,11,55,52,3,57
Albion,9128,5,16,5,15,58,57,1,53
Stranraer,9128,6,15,7,14,52,50,2,52
Peterhead,9128,7,12,5,19,44,57,-13,41
Queen's Park,9128,8,10,10,16,39,54,-15,40
Stenhousem'r,9128,9,9,7,20,48,84,-36,34
East Fife,9128,10,8,8,20,44,53,-9,32
Livingston,9129,1,23,3,10,81,43,38,72
Brechin,9129,2,19,7,10,59,44,15,64
Alloa,9129,3,19,6,11,65,44,21,63
Peterhead,9129,4,18,9,9,57,43,14,63
Airdrieon,9129,5,13,8,15,47,55,-8,47
East Fife,9129,6,12,10,14,54,47,7,46
Albion,9129,7,12,10,14,54,60,-6,46
Stranraer,9129,8,14,3,19,48,61,-13,45
Queen's Park,9129,9,10,8,18,38,63,-25,38
Stenhousem'r,9129,10,4,8,24,47,90,-43,20
Livingston,9130,1,21,9,6,79,48,31,72
Brechin,9130,2,21,6,9,59,37,22,69
Airdrieon,9130,3,17,6,13,65,56,9,57
Alloa,9130,4,14,11,11,65,51,14,53
Peterhead,9130,5,14,9,13,54,56,-2,51
Queen's Park,9130,6,13,8,15,37,45,-8,47
Albion,9130,7,11,9,16,53,60,-7,42
East Fife,9130,8,11,8,17,43,52,-9,41
Stenhousem'r,9130,9,10,9,17,49,74,-25,39
Stranraer,9130,10,8,5,23,46,71,-25,29
Livingston,9131,1,19,9,8,75,44,31,66
Alloa,9131,2,18,10,8,84,45,39,64
Airdrieon,9131,3,18,8,10,54,47,7,62
Brechin,9131,4,17,10,9,49,39,10,61
Queen's Park,9131,5,14,11,11,41,43,-2,53
Albion,9131,6,13,8,15,52,49,3,47
East Fife,9131,7,12,7,17,44,51,-7,43
Peterhead,9131,8,11,10,15,41,62,-21,43
Stranraer,9131,9,8,7,21,41,62,-21,31
Stenhousem'r,9131,10,6,8,22,46,85,-39,26
Brechin,9132,1,21,5,10,54,45,9,68
Livingston,9132,2,20,5,11,73,44,29,65
Airdrieon,9132,3,16,8,12,56,53,3,56
Peterhead,9132,4,14,10,12,48,47,1,52
Albion,9132,5,15,6,15,49,55,-6,51
Alloa,9132,6,14,8,14,56,55,1,50
Queen's Park,9132,7,13,7,16,39,47,-8,46
Stranraer,9132,8,13,5,18,50,45,5,44
East Fife,9132,9,11,9,16,46,44,2,42
Stenhousem'r,9132,10,9,5,22,40,76,-36,32
Alloa,9133,1,22,5,9,70,41,29,71
Livingston,9133,2,21,6,9,81,52,29,69
Airdrieon,9133,3,18,6,12,66,52,14,60
Brechin,9133,4,16,8,12,50,41,9,56
East Fife,9133,5,13,13,10,50,38,12,52
Peterhead,9133,6,14,8,14,46,61,-15,50
Stranraer,9133,7,13,5,18,46,54,-8,44
Queen's Park,9133,8,11,6,19,36,51,-15,39
Albion,9133,9,7,11,18,42,60,-18,32
Stenhousem'r,9133,10,7,8,21,50,87,-37,29
Livingston,9134,1,21,5,10,83,42,41,68
Alloa,9134,2,19,9,8,65,42,23,66
Brechin,9134,3,17,11,8,53,43,10,62
Peterhead,9134,4,17,9,10,52,45,7,60
Airdrieon,9134,5,15,9,12,56,59,-3,54
East Fife,9134,6,12,10,14,42,40,2,46
Stranraer,9134,7,12,7,17,45,56,-11,43
Queen's Park,9134,8,10,8,18,34,56,-22,38
Stenhousem'r,9134,9,9,6,21,41,76,-35,33
Albion,9134,10,8,6,22,42,54,-12,30
Alloa,9135,1,17,10,9,73,47,26,61
Livingston,9135,2,18,7,11,72,54,18,61
Peterhead,9135,3,16,10,10,55,46,9,58
Brechin,9135,4,17,6,13,55,48,7,57
Albion,9135,5,15,11,10,60,49,11,56
Airdrieon,9135,6,15,7,14,55,50,5,52
Stranraer,9135,7,12,9,15,47,51,-4,45
East Fife,9135,8,11,8,17,51,60,-9,41
Queen's Park,9135,9,11,5,20,30,58,-28,38
Stenhousem'r,9135,10,8,7,21,54,89,-35,31
Livingston,9136,1,21,7,8,81,48,33,70
Airdrieon,9136,2,17,8,11,55,53,2,59
Alloa,9136,3,15,9,12,60,43,17,54
Brechin,9136,4,15,8,13,47,46,1,53
Stranraer,9136,5,15,6,15,56,58,-2,51
Albion,9136,6,13,10,13,49,44,5,49
East Fife,9136,7,11,12,13,43,42,1,45
Queen's Park,9136,8,12,9,15,40,49,-9,45
Peterhead,9136,9,10,9,17,43,58,-15,39
Stenhousem'r,9136,10,9,6,21,45,78,-33,33
Brechin,9137,1,21,5,10,61,40,21,68
Livingston,9137,2,19,10,7,78,51,27,67
Alloa,9137,3,16,7,13,58,46,12,55
Airdrieon,9137,4,16,7,13,52,53,-1,55
Queen's Park,9137,5,14,6,16,41,47,-6,48
East Fife,9137,6,12,10,14,57,53,4,46
Albion,9137,7,12,10,14,59,58,1,46
Peterhead,9137,8,12,10,14,60,62,-2,46
Stranraer,9137,9,12,7,17,50,67,-17,43
Stenhousem'r,9137,10,5,10,21,43,82,-39,25
Livingston,9138,1,20,4,12,69,51,18,64
Alloa,9138,2,19,6,11,79,60,19,63
Airdrieon,9138,3,16,7,13,58,52,6,55
East Fife,9138,4,15,9,12,54,41,13,54
Albion,9138,5,14,9,13,59,51,8,51
Brechin,9138,6,14,7,15,55,57,-2,49
Stranraer,9138,7,14,6,16,53,52,1,48
Peterhead,9138,8,13,8,15,45,55,-10,47
Queen's Park,9138,9,9,11,16,38,55,-17,38
Stenhousem'r,9138,10,8,9,19,35,71,-36,33
Alloa,9139,1,19,10,7,70,40,30,67
Livingston,9139,2,18,7,11,68,49,19,61
Airdrieon,9139,3,16,7,13,65,57,8,55
Albion,9139,4,14,12,10,56,43,13,54
Brechin,9139,5,14,10,12,46,46,0,52
Peterhead,9139,6,13,11,12,57,57,0,50
Queen's Park,9139,7,11,11,14,37,43,-6,44
Stranraer,9139,8,11,7,18,51,69,-18,40
East Fife,9139,9,9,11,16,43,57,-14,38
Stenhousem'r,9139,10,8,8,20,55,87,-32,32
Alloa,9140,1,18,7,11,70,47,23,61
Brechin,9140,2,18,7,11,49,40,9,61
Airdrieon,9140,3,18,7,11,60,59,1,61
Livingston,9140,4,18,6,12,71,58,13,60
East Fife,9140,5,15,8,13,47,40,7,53
Albion,9140,6,14,8,14,51,44,7,50
Stranraer,9140,7,12,7,17,59,62,-3,43
Queen's Park,9140,8,12,6,18,35,50,-15,42
Peterhead,9140,9,12,5,19,51,64,-13,41
Stenhousem'r,9140,10,9,7,20,46,75,-29,34
Alloa,9141,1,16,14,6,70,42,28,62
Livingston,9141,2,19,5,12,69,52,17,62
Airdrieon,9141,3,18,8,10,71,55,16,62
Brechin,9141,4,17,8,11,50,42,8,59
Albion,9141,5,15,9,12,59,56,3,54
East Fife,9141,6,13,7,16,49,46,3,46
Peterhead,9141,7,12,10,14,53,55,-2,46
Queen's Park,9141,8,10,9,17,36,55,-19,39
Stenhousem'r,9141,9,9,8,19,45,73,-28,35
Stranraer,9141,10,10,4,22,50,76,-26,34
Livingston,9142,1,20,5,11,73,51,22,65
Airdrieon,9142,2,18,8,10,63,47,16,62
Alloa,9142,3,15,12,9,64,45,19,57
Albion,9142,4,15,8,13,50,49,1,53
Brechin,9142,5,14,9,13,52,55,-3,51
East Fife,9142,6,13,11,12,49,37,12,50
Queen's Park,9142,7,14,7,15,38,49,-11,49
Peterhead,9142,8,13,9,14,51,53,-2,48
Stranraer,9142,9,9,10,17,52,67,-15,37
Stenhousem'r,9142,10,6,7,23,45,84,-39,25
Alloa,9143,1,19,8,9,77,46,31,65
Livingston,9143,2,21,2,13,80,54,26,65
Brechin,9143,3,16,9,11,51,46,5,57
Airdrieon,9143,4,17,6,13,53,60,-7,57
East Fife,9143,5,15,8,13,54,41,13,53
Peterhead,9143,6,12,9,15,44,53,-9,45
Queen's Park,9143,7,12,9,15,29,39,-10,45
Stranraer,9143,8,12,6,18,51,59,-8,42
Albion,9143,9,9,10,17,49,59,-10,37
Stenhousem'r,9143,10,8,11,17,50,81,-31,35
Livingston,9144,1,23,5,8,77,44,33,74
Alloa,9144,2,19,6,11,67,45,22,63
Stranraer,9144,3,17,6,13,54,47,7,57
Brechin,9144,4,15,8,13,48,45,3,53
Peterhead,9144,5,15,8,13,45,46,-1,53
Queen's Park,9144,6,14,7,15,36,46,-10,49
Albion,9144,7,13,6,17,44,49,-5,45
Airdrieon,9144,8,12,8,16,58,58,0,44
East Fife,9144,9,11,10,15,53,55,-2,43
Stenhousem'r,9144,10,7,4,25,42,89,-47,25
Livingston,9145,1,22,2,12,77,51,26,68
Brechin,9145,2,18,5,13,51,45,6,59
Alloa,9145,3,16,10,10,66,43,23,58
Airdrieon,9145,4,18,4,14,57,57,0,58
Albion,9145,5,16,7,13,56,45,11,55
East Fife,9145,6,15,8,13,52,48,4,53
Queen's Park,9145,7,14,5,17,41,54,-13,47
Stranraer,9145,8,13,5,18,54,63,-9,44
Peterhead,9145,9,11,9,16,46,50,-4,42
Stenhousem'r,9145,10,7,5,24,41,85,-44,26
Livingston,9146,1,22,5,9,86,50,36,71
Airdrieon,9146,2,17,10,9,57,42,15,61
Alloa,9146,3,17,9,10,60,45,15,60
East Fife,9146,4,15,8,13,52,44,8,53
Peterhead,9146,5,13,11,12,52,46,6,50
Albion,9146,6,12,12,12,52,48,4,48
Brechin,9146,7,13,7,16,45,56,-11,46
Queen's Park,9146,8,13,5,18,40,52,-12,44
Stranraer,9146,9,12,3,21,45,61,-16,39
Stenhousem'r,9146,10,6,10,20,37,82,-45,28
Livingston,9147,1,17,10,9,65,46,19,61
Alloa,9147,2,17,9,10,57,34,23,60
Brechin,9147,3,16,10,10,54,47,7,58
Airdrieon,9147,4,16,7,13,71,55,16,55
Peterhead,9147,5,14,9,13,51,49,2,51
East Fife,9147,6,12,10,14,44,44,0,46
Albion,9147,7,11,12,13,46,49,-3,45
Queen's Park,9147,8,12,9,15,39,56,-17,45
Stranraer,9147,9,11,7,18,46,61,-15,40
Stenhousem'r,9147,10,9,7,20,49,81,-32,34
Livingston,9148,1,20,5,11,71,42,29,65
Alloa,9148,2,19,5,12,75,53,22,62
Airdrieon,9148,3,16,9,11,56,51,5,57
Queen's Park,9148,4,16,6,14,36,44,-8,54
Albion,9148,5,14,9,13,55,47,8,51
East Fife,9148,6,13,10,13,56,50,6,49
Stranraer,9148,7,14,4,18,46,56,-10,46
Stenhousem'r,9148,8,13,5,18,47,71,-24,44
Brechin,9148,9,12,5,19,44,57,-13,41
Peterhead,9148,10,10,8,18,45,60,-15,38
Livingston,9149,1,20,3,13,64,52,12,63
Brechin,9149,2,19,6,11,54,43,11,63
Alloa,9149,3,18,7,11,65,46,19,61
Airdrieon,9149,4,16,8,12,54,53,1,56
Albion,9149,5,14,13,9,59,50,9,55
Queen's Park,9149,6,14,7,15,33,39,-6,49
Stranraer,9149,7,13,9,14,52,49,3,48
Stenhousem'r,9149,8,11,7,18,45,64,-19,40
East Fife,9149,9,8,9,19,41,52,-11,33
Peterhead,9149,10,7,11,18,40,59,-19,32
Airdrieon,9150,1,20,7,9,63,47,16,67
Livingston,9150,2,20,6,10,80,48,32,66
Brechin,9150,3,17,9,10,58,46,12,60
Alloa,9150,4,15,9,12,72,56,16,54
Albion,9150,5,15,9,12,62,51,11,54
Peterhead,9150,6,15,8,13,58,65,-7,53
Stranraer,9150,7,10,10,16,46,55,-9,40
East Fife,9150,8,11,7,18,42,51,-9,40
Queen's Park,9150,9,9,12,15,37,60,-23,39
Stenhousem'r,9150,10,6,7,23,41,80,-39,25
Brechin,9151,1,20,6,10,57,43,14,66
Livingston,9151,2,18,7,11,77,55,22,61
Alloa,9151,3,18,6,12,71,51,20,60
Airdrieon,9151,4,17,7,12,53,47,6,58
Albion,9151,5,15,9,12,61,48,13,54
Queen's Park,9151,6,15,8,13,38,49,-11,53
Peterhead,9151,7,10,10,16,39,55,-16,40
East Fife,9151,8,10,9,17,51,52,-1,39
Stenhousem'r,9151,9,10,7,19,54,82,-28,37
Stranraer,9151,10,10,5,21,53,72,-19,35
Alloa,9152,1,20,5,11,84,51,33,65
Livingston,9152,2,18,6,12,69,52,17,60
Brechin,9152,3,17,8,11,50,46,4,59
Peterhead,9152,4,18,5,13,57,55,2,59
Airdrieon,9152,5,16,7,13,61,56,5,55
Queen's Park,9152,6,15,6,15,39,49,-10,51
Albion,9152,7,13,9,14,59,58,1,48
Stranraer,9152,8,11,6,19,54,67,-13,39
East Fife,9152,9,9,9,18,43,48,-5,36
Stenhousem'r,9152,10,9,7,20,40,74,-34,34
Livingston,9153,1,23,5,8,78,51,27,74
Alloa,9153,2,17,8,11,67,42,25,59
Stranraer,9153,3,17,5,14,66,56,10,56
Brechin,9153,4,17,4,15,51,47,4,55
Peterhead,9153,5,15,9,12,44,43,1,54
Airdrieon,9153,6,15,7,14,62,63,-1,52
Albion,9153,7,14,7,15,54,63,-9,49
Queen's Park,9153,8,13,7,16,44,56,-12,46
East Fife,9153,9,6,12,18,39,54,-15,30
Stenhousem'r,9153,10,6,10,20,44,74,-30,28
Livingston,9154,1,20,6,10,68,50,18,66
Alloa,9154,2,19,8,9,68,47,21,65
Airdrieon,9154,3,18,6,12,65,48,17,60
Albion,9154,4,15,10,11,51,40,11,55
Stranraer,9154,5,16,4,16,56,53,3,52
Peterhead,9154,6,13,6,17,49,51,-2,45
Queen's Park,9154,7,11,12,13,40,47,-7,45
Brechin,9154,8,11,10,15,38,52,-14,43
East Fife,9154,9,8,15,13,44,52,-8,39
Stenhousem'r,9154,10,5,11,20,44,83,-39,26
Livingston,9155,1,21,4,11,83,51,32,67
Alloa,9155,2,16,10,10,64,47,17,58
Brechin,9155,3,17,7,12,45,41,4,58
Airdrieon,9155,4,16,5,15,60,55,5,53
East Fife,9155,5,14,8,14,54,52,2,50
Peterhead,9155,6,12,11,13,44,52,-8,47
Queen's Park,9155,7,13,7,16,40,55,-15,46
Albion,9155,8,12,9,15,40,42,-2,45
Stranraer,9155,9,13,3,20,50,61,-11,42
Stenhousem'r,9155,10,7,14,15,49,73,-24,35
Livingston,9156,1,23,2,11,79,49,30,71
Alloa,9156,2,20,5,11,70,46,24,65
Albion,9156,3,17,5,14,66,60,6,56
Queen's Park,9156,4,17,3,16,42,41,1,54
Peterhead,9156,5,16,5,15,54,53,1,53
East Fife,9156,6,14,8,14,52,48,4,50
Brechin,9156,7,15,4,17,51,61,-10,49
Airdrieon,9156,8,14,5,17,50,61,-11,47
Stranraer,9156,9,11,3,22,39,60,-21,36
Stenhousem'r,9156,10,10,6,20,54,78,-24,36
Livingston,9157,1,24,5,7,76,35,41,77
Alloa,9157,2,22,4,10,89,51,38,70
Brechin,9157,3,20,6,10,61,46,15,66
Airdrieon,9157,4,19,4,13,54,46,8,61
Peterhead,9157,5,17,7,12,53,49,4,58
Albion,9157,6,15,6,15,53,56,-3,51
East Fife,9157,7,11,7,18,45,59,-14,40
Queen's Park,9157,8,10,7,19,40,56,-16,37
Stranraer,9157,9,7,6,23,39,74,-35,27
Stenhousem'r,9157,10,6,6,24,42,80,-38,24
Livingston,9158,1,22,5,9,79,44,35,71
Alloa,9158,2,19,7,10,79,50,29,64
Airdrieon,9158,3,17,9,10,60,50,10,60
Brechin,9158,4,13,13,10,49,44,5,52
Peterhead,9158,5,15,6,15,55,54,1,51
Albion,9158,6,14,7,15,56,59,-3,49
Stranraer,9158,7,11,9,16,44,55,-11,42
East Fife,9158,8,11,6,19,48,61,-13,39
Stenhousem'r,9158,9,10,8,18,55,77,-22,38
Queen's Park,9158,10,9,8,19,36,67,-31,35
Livingston,9159,1,21,4,11,67,42,25,67
Airdrieon,9159,2,19,4,13,60,54,6,61
Alloa,9159,3,16,8,12,76,50,26,56
Brechin,9159,4,15,10,11,50,49,1,55
East Fife,9159,5,15,8,13,52,42,10,53
Peterhead,9159,6,13,12,11,57,57,0,51
Albion,9159,7,14,8,14,63,63,0,50
Queen's Park,9159,8,11,10,15,39,55,-16,43
Stranraer,9159,9,12,5,19,50,63,-13,41
Stenhousem'r,9159,10,5,9,22,49,88,-39,24
Queen's Park,9160,1,19,5,12,53,47,6,62
Airdrieon,9160,2,18,7,11,58,48,10,61
Alloa,9160,3,17,8,11,60,40,20,59
Livingston,9160,4,17,7,12,82,59,23,58
Albion,9160,5,15,7,14,62,60,2,52
Peterhead,9160,6,14,10,12,49,52,-3,52
Stranraer,9160,7,15,4,17,52,59,-7,49
Brechin,9160,8,11,10,15,36,44,-8,43
East Fife,9160,9,10,10,16,49,54,-5,40
Stenhousem'r,9160,10,5,10,21,46,84,-38,25
Brechin,9161,1,19,5,12,47,44,3,62
Alloa,9161,2,18,6,12,69,51,18,60
Airdrieon,9161,3,16,9,11,61,54,7,57
Livingston,9161,4,17,5,14,68,52,16,56
Albion,9161,5,16,7,13,59,48,11,55
Peterhead,9161,6,16,6,14,52,58,-6,54
Stranraer,9161,7,15,8,13,56,50,6,53
Queen's Park,9161,8,15,6,15,43,53,-10,51
East Fife,9161,9,7,13,16,41,48,-7,34
Stenhousem'r,9161,10,6,5,25,49,87,-38,23
Alloa,9162,1,21,6,9,70,40,30,69
Livingston,9162,2,20,8,8,78,42,36,68
Airdrieon,9162,3,20,5,11,70,52,18,65
Albion,9162,4,16,6,14,53,51,2,54
Brechin,9162,5,16,4,16,45,41,4,52
Stranraer,9162,6,14,7,15,57,61,-4,49
East Fife,9162,7,14,5,17,54,56,-2,47
Peterhead,9162,8,13,6,17,41,54,-13,45
Queen's Park,9162,9,11,4,21,36,62,-26,37
Stenhousem'r,9162,10,6,7,23,40,85,-45,25
Livingston,9163,1,23,6,7,76,38,38,75
Alloa,9163,2,17,8,11,59,42,17,59
Brechin,9163,3,18,5,13,59,52,7,59
Airdrieon,9163,4,13,10,13,48,50,-2,49
Peterhead,9163,5,14,7,15,41,49,-8,49
Stenhousem'r,9163,6,13,8,15,56,67,-11,47
Stranraer,9163,7,13,7,16,48,50,-2,46
Queen's Park,9163,8,11,10,15,31,51,-20,43
Albion,9163,9,9,12,15,49,50,-1,39
East Fife,9163,10,6,13,17,42,60,-18,31
Livingston,9164,1,22,6,8,80,42,38,72
Alloa,9164,2,18,12,6,68,42,26,66
Airdrieon,9164,3,17,9,10,57,49,8,60
Brechin,9164,4,13,8,15,40,55,-15,47
Peterhead,9164,5,11,13,12,57,60,-3,46
Stranraer,9164,6,12,10,14,56,59,-3,46
Albion,9164,7,12,9,15,53,57,-4,45
East Fife,9164,8,10,13,13,47,45,2,43
Queen's Park,9164,9,10,8,18,38,54,-16,38
Stenhousem'r,9164,10,5,12,19,45,78,-33,27
Airdrieon,9165,1,22,3,11,62,44,18,69
Alloa,9165,2,19,10,7,64,38,26,67
Livingston,9165,3,14,11,11,64,53,11,53
Stranraer,9165,4,16,5,15,44,46,-2,53
Brechin,9165,5,15,8,13,53,56,-3,53
Albion,9165,6,14,8,14,57,57,0,50
East Fife,9165,7,12,9,15,59,53,6,45
Peterhead,9165,8,13,6,17,48,63,-15,45
Stenhousem'r,9165,9,10,5,21,55,74,-19,35
Queen's Park,9165,10,9,7,20,34,56,-22,34
Alloa,9166,1,21,6,9,81,41,40,69
Livingston,9166,2,21,3,12,88,52,36,66
Peterhead,9166,3,18,5,13,68,67,1,59
Airdrieon,9166,4,18,3,15,70,65,5,57
East Fife,9166,5,14,11,11,56,49,7,53
Stranraer,9166,6,14,6,16,48,54,-6,48
Albion,9166,7,12,8,16,49,59,-10,44
Brechin,9166,8,12,6,18,47,60,-13,42
Stenhousem'r,9166,9,10,8,18,45,79,-34,38
Queen's Park,9166,10,9,6,21,35,61,-26,33
Livingston,9167,1,22,6,8,70,44,26,72
Airdrieon,9167,2,21,5,10,66,52,14,68
Alloa,9167,3,16,10,10,71,46,25,58
Brechin,9167,4,17,7,12,52,47,5,58
Peterhead,9167,5,14,8,14,45,51,-6,50
Albion,9167,6,13,9,14,54,52,2,48
East Fife,9167,7,12,9,15,47,50,-3,45
Stranraer,9167,8,11,6,19,46,57,-11,39
Queen's Park,9167,9,9,8,19,35,51,-16,35
Stenhousem'r,9167,10,8,6,22,44,80,-36,30
Albion,9168,1,20,6,10,77,54,23,66
Livingston,9168,2,20,5,11,69,41,28,65
Alloa,9168,3,18,6,12,63,48,15,60
Airdrieon,9168,4,19,3,14,63,55,8,60
Brechin,9168,5,17,7,12,63,48,15,58
East Fife,9168,6,12,11,13,46,44,2,47
Peterhead,9168,7,12,8,16,45,54,-9,44
Queen's Park,9168,8,10,7,19,36,61,-25,37
Stenhousem'r,9168,9,11,4,21,53,84,-31,37
Stranraer,9168,10,9,7,20,45,71,-26,34
Livingston,9169,1,22,4,10,76,45,31,70
Peterhead,9169,2,17,8,11,56,49,7,59
Brechin,9169,3,17,7,12,52,47,5,58
Alloa,9169,4,15,9,12,60,48,12,54
Albion,9169,5,14,8,14,47,48,-1,50
Airdrieon,9169,6,14,7,15,54,54,0,49
Queen's Park,9169,7,14,6,16,38,49,-11,48
East Fife,9169,8,10,10,16,50,52,-2,40
Stranraer,9169,9,12,4,20,49,66,-17,40
Stenhousem'r,9169,10,10,7,19,50,74,-24,37
Livingston,9170,1,20,7,9,73,48,25,67
Albion,9170,2,19,9,8,67,50,17,66
Alloa,9170,3,17,10,9,62,37,25,61
Brechin,9170,4,17,6,13,52,51,1,57
Peterhead,9170,5,15,11,10,47,42,5,56
Airdrieon,9170,6,15,7,14,61,59,2,52
East Fife,9170,7,11,10,15,49,45,4,43
Stranraer,9170,8,11,8,17,44,57,-13,41
Queen's Park,9170,9,8,8,20,33,55,-22,32
Stenhousem'r,9170,10,6,6,24,43,87,-44,24
Alloa,9171,1,18,8,10,75,53,22,62
Airdrieon,9171,2,18,6,12,66,60,6,60
East Fife,9171,3,16,11,9,62,42,20,59
Livingston,9171,4,18,3,15,69,59,10,57
Stranraer,9171,5,14,9,13,51,52,-1,51
Brechin,9171,6,15,6,15,48,53,-5,51
Peterhead,9171,7,14,7,15,57,54,3,49
Albion,9171,8,11,10,15,51,55,-4,43
Queen's Park,9171,9,9,11,16,34,51,-17,38
Stenhousem'r,9171,10,6,11,19,47,81,-34,29
Livingston,9172,1,23,4,9,93,55,38,73
Alloa,9172,2,16,11,9,65,42,23,59
Airdrieon,9172,3,16,10,10,57,47,10,58
East Fife,9172,4,15,8,13,56,44,12,53
Peterhead,9172,5,15,8,13,54,56,-2,53
Albion,9172,6,14,7,15,58,58,0,49
Brechin,9172,7,14,7,15,51,65,-14,49
Stranraer,9172,8,12,8,16,57,62,-5,44
Queen's Park,9172,9,10,5,21,37,60,-23,35
Stenhousem'r,9172,10,8,6,22,42,81,-39,30
Livingston,9173,1,26,3,7,98,40,58,81
Alloa,9173,2,18,7,11,62,44,18,61
Airdrieon,9173,3,18,6,12,62,54,8,60
Peterhead,9173,4,15,6,15,46,52,-6,51
Albion,9173,5,13,8,15,47,50,-3,47
Queen's Park,9173,6,12,8,16,41,48,-7,44
Brechin,9173,7,13,5,18,44,59,-15,44
Stranraer,9173,8,13,3,20,44,61,-17,42
East Fife,9173,9,11,8,17,53,64,-11,41
Stenhousem'r,9173,10,11,6,19,47,72,-25,39
Alloa,9174,1,22,6,8,81,40,41,72
Livingston,9174,2,22,5,9,90,44,46,71
Airdrieon,9174,3,18,9,9,61,54,7,63
Brechin,9174,4,15,6,15,50,57,-7,51
Albion,9174,5,12,11,13,50,46,4,47
Queen's Park,9174,6,12,8,16,33,53,-20,44
Peterhead,9174,7,11,10,15,45,54,-9,43
East Fife,9174,8,10,10,16,51,63,-12,40
Stranraer,9174,9,10,5,21,48,68,-20,35
Stenhousem'r,9174,10,8,10,18,49,79,-30,34
Livingston,9175,1,23,4,9,77,43,34,73
Brechin,9175,2,18,8,10,58,48,10,62
Alloa,9175,3,17,9,10,65,44,21,60
Airdrieon,9175,4,14,11,11,57,50,7,53
Peterhead,9175,5,15,8,13,45,43,2,53
Albion,9175,6,13,10,13,56,53,3,49
Stranraer,9175,7,12,8,16,53,61,-8,44
Queen's Park,9175,8,12,5,19,37,61,-24,41
East Fife,9175,9,9,11,16,55,63,-8,38
Stenhousem'r,9175,10,6,8,22,53,90,-37,26
Livingston,9176,1,19,5,12,74,51,23,62
Alloa,9176,2,18,8,10,71,48,23,62
Airdrieon,9176,3,17,7,12,62,61,1,58
Queen's Park,9176,4,16,5,15,47,56,-9,53
Peterhead,9176,5,14,9,13,50,53,-3,51
Stranraer,9176,6,13,10,13,52,51,1,49
Albion,9176,7,14,7,15,53,53,0,49
East Fife,9176,8,13,8,15,54,50,4,47
Brechin,9176,9,14,5,17,47,53,-6,47
Stenhousem'r,9176,10,6,8,22,44,78,-34,26
Alloa,9177,1,23,8,5,76,38,38,77
Livingston,9177,2,20,6,10,75,50,25,66
Brechin,9177,3,19,7,10,59,42,17,64
Airdrieon,9177,4,17,6,13,58,58,0,57
Albion,9177,5,15,7,14,57,55,2,52
Queen's Park,9177,6,13,8,15,37,49,-12,47
East Fife,9177,7,12,5,19,50,54,-4,41
Stranraer,9177,8,11,7,18,52,60,-8,40
Peterhead,9177,9,9,8,19,47,62,-15,35
Stenhousem'r,9177,10,8,4,24,47,90,-43,28
Livingston,9178,1,25,2,9,84,40,44,77
Alloa,9178,2,16,12,8,67,46,21,60
Brechin,9178,3,16,6,14,55,49,6,54
Stenhousem'r,9178,4,14,7,15,52,64,-12,49
Airdrieon,9178,5,14,6,16,53,62,-9,48
Stranraer,9178,6,14,5,17,53,62,-9,47
Queen's Park,9178,7,11,10,15,28,45,-17,43
Peterhead,9178,8,12,7,17,45,63,-18,43
East Fife,9178,9,11,9,16,51,50,1,42
Albion,9178,10,11,8,17,53,60,-7,41
Livingston,9179,1,25,3,8,77,39,38,78
Alloa,9179,2,18,9,9,65,41,24,63
Brechin,9179,3,16,8,12,55,42,13,56
East Fife,9179,4,15,8,13,46,41,5,53
Peterhead,9179,5,13,11,12,46,45,1,50
Airdrieon,9179,6,13,7,16,52,59,-7,46
Albion,9179,7,11,11,14,43,49,-6,44
Queen's Park,9179,8,8,14,14,31,47,-16,38
Stranraer,9179,9,11,5,20,43,64,-21,38
Stenhousem'r,9179,10,9,6,21,44,75,-31,33
Livingston,9180,1,17,11,8,78,44,34,62
Airdrieon,9180,2,17,9,10,56,44,12,60
Alloa,9180,3,17,8,11,62,43,19,59
Brechin,9180,4,16,7,13,51,53,-2,55
Stranraer,9180,5,14,8,14,45,50,-5,50
East Fife,9180,6,12,10,14,53,58,-5,46
Albion,9180,7,12,9,15,49,55,-6,45
Queen's Park,9180,8,12,7,17,34,49,-15,43
Peterhead,9180,9,11,9,16,51,59,-8,42
Stenhousem'r,9180,10,9,8,19,48,72,-24,35
Livingston,9181,1,21,7,8,70,45,25,70
Alloa,9181,2,18,7,11,68,45,23,61
Brechin,9181,3,18,5,13,52,42,10,59
Airdrieon,9181,4,17,5,14,58,51,7,56
Albion,9181,5,14,9,13,51,50,1,51
East Fife,9181,6,13,11,12,57,47,10,50
Queen's Park,9181,7,11,10,15,39,52,-13,43
Stranraer,9181,8,12,6,18,48,66,-18,42
Peterhead,9181,9,10,7,19,42,62,-20,37
Stenhousem'r,9181,10,9,7,20,46,71,-25,34
Alloa,9182,1,20,8,8,69,38,31,68
Peterhead,9182,2,17,8,11,59,49,10,59
Livingston,9182,3,17,5,14,56,52,4,56
Airdrieon,9182,4,15,9,12,57,53,4,54
Brechin,9182,5,14,8,14,50,52,-2,50
Stenhousem'r,9182,6,13,8,15,52,69,-17,47
Stranraer,9182,7,12,10,14,47,53,-6,46
East Fife,9182,8,11,10,15,47,44,3,43
Albion,9182,9,10,8,18,44,57,-13,38
Queen's Park,9182,10,9,10,17,34,48,-14,37
Airdrieon,9183,1,20,6,10,72,55,17,66
Livingston,9183,2,18,6,12,73,50,23,60
Alloa,9183,3,19,3,14,70,55,15,60
Brechin,9183,4,18,6,12,61,56,5,60
Albion,9183,5,16,9,11,54,45,9,57
Peterhead,9183,6,14,8,14,60,66,-6,50
East Fife,9183,7,11,8,17,52,55,-3,41
Queen's Park,9183,8,11,8,17,39,56,-17,41
Stenhousem'r,9183,9,11,5,20,57,78,-21,38
Stranraer,9183,10,9,7,20,46,68,-22,34
Alloa,9184,1,19,7,10,64,43,21,64
Airdrieon,9184,2,19,5,12,66,59,7,62
Livingston,9184,3,18,4,14,71,52,19,58
Brechin,9184,4,17,5,14,49,43,6,56
Peterhead,9184,5,15,10,11,64,58,6,55
Queen's Park,9184,6,16,6,14,50,53,-3,54
Albion,9184,7,15,8,13,56,52,4,53
Stranraer,9184,8,12,5,19,44,60,-16,41
East Fife,9184,9,10,6,20,43,57,-14,36
Stenhousem'r,9184,10,6,10,20,43,73,-30,28
Alloa,9185,1,21,9,6,81,44,37,72
Livingston,9185,2,23,2,11,74,51,23,71
Brechin,9185,3,19,7,10,66,45,21,64
Albion,9185,4,15,8,13,56,52,4,53
Airdrieon,9185,5,15,8,13,53,58,-5,53
Stranraer,9185,6,13,6,17,56,65,-9,45
Peterhead,9185,7,10,8,18,45,58,-13,38
Queen's Park,9185,8,10,7,19,39,59,-20,37
Stenhousem'r,9185,9,9,9,18,59,80,-21,36
East Fife,9185,10,9,8,19,51,68,-17,35
Livingston,9186,1,21,5,10,69,47,22,68
Airdrieon,9186,2,20,7,9,58,45,13,67
Alloa,9186,3,19,6,11,70,39,31,63
East Fife,9186,4,14,10,12,58,42,16,52
Brechin,9186,5,14,7,15,46,49,-3,49
Queen's Park,9186,6,14,7,15,39,50,-11,49
Peterhead,9186,7,14,6,16,48,52,-4,48
Albion,9186,8,10,9,17,50,63,-13,39
Stranraer,9186,9,8,10,18,45,60,-15,34
Stenhousem'r,9186,10,9,7,20,39,75,-36,34
Airdrieon,9187,1,20,8,8,62,38,24,68
Livingston,9187,2,19,10,7,79,49,30,67
Alloa,9187,3,19,8,9,70,49,21,65
Queen's Park,9187,4,15,7,14,41,48,-7,52
Peterhead,9187,5,14,9,13,54,49,5,51
Albion,9187,6,11,13,12,57,60,-3,46
Brechin,9187,7,12,6,18,56,66,-10,42
Stranraer,9187,8,11,8,17,52,60,-8,41
East Fife,9187,9,7,11,18,44,63,-19,32
Stenhousem'r,9187,10,7,10,19,46,79,-33,31
Alloa,9188,1,20,9,7,89,49,40,69
Airdrieon,9188,2,19,7,10,70,55,15,64
Livingston,9188,3,17,6,13,73,53,20,57
Albion,9188,4,12,14,10,55,55,0,50
Brechin,9188,5,12,11,13,49,49,0,47
Stranraer,9188,6,13,8,15,52,53,-1,47
Queen's Park,9188,7,9,14,13,39,56,-17,41
Peterhead,9188,8,11,8,17,49,70,-21,41
East Fife,9188,9,8,13,15,45,52,-7,37
Stenhousem'r,9188,10,9,10,17,49,78,-29,37
Airdrieon,9189,1,22,6,8,75,49,26,72
Brechin,9189,2,20,3,13,60,48,12,63
Livingston,9189,3,19,5,12,78,57,21,62
Queen's Park,9189,4,16,7,13,45,48,-3,55
Alloa,9189,5,15,9,12,69,56,13,54
Peterhead,9189,6,13,7,16,52,57,-5,46
East Fife,9189,7,11,10,15,45,49,-4,43
Albion,9189,8,11,10,15,53,62,-9,43
Stranraer,9189,9,11,8,17,50,62,-12,41
Stenhousem'r,9189,10,5,9,22,41,80,-39,24
Alloa,9190,1,21,7,8,68,38,30,70
Livingston,9190,2,21,4,11,82,47,35,67
Airdrieon,9190,3,18,4,14,61,59,2,58
Stranraer,9190,4,16,6,14,67,52,15,54
Peterhead,9190,5,14,9,13,54,52,2,51
Albion,9190,6,13,9,14,48,52,-4,48
Brechin,9190,7,13,7,16,53,62,-9,46
East Fife,9190,8,11,10,15,51,53,-2,43
Queen's Park,9190,9,11,7,18,38,60,-22,40
Stenhousem'r,9190,10,7,7,22,42,89,-47,28
Alloa,9191,1,20,11,5,75,38,37,71
Livingston,9191,2,19,8,9,76,50,26,65
Airdrieon,9191,3,16,12,8,60,51,9,60
Brechin,9191,4,15,8,13,51,44,7,53
East Fife,9191,5,12,10,14,48,43,5,46
Stranraer,9191,6,12,9,15,49,57,-8,45
Peterhead,9191,7,11,11,14,46,54,-8,44
Albion,9191,8,12,7,17,50,57,-7,43
Queen's Park,9191,9,11,6,19,37,58,-21,39
Stenhousem'r,9191,10,8,6,22,41,81,-40,30
Livingston,9192,1,23,3,10,80,53,27,72
Alloa,9192,2,16,11,9,66,42,24,59
Peterhead,9192,3,17,5,14,52,51,1,56
Airdrieon,9192,4,17,5,14,55,63,-8,56
Albion,9192,5,15,4,17,56,58,-2,49
Brechin,9192,6,14,5,17,53,55,-2,47
Queen's Park,9192,7,13,7,16,44,57,-13,46
Stranraer,9192,8,12,8,16,52,61,-9,44
East Fife,9192,9,10,9,17,36,41,-5,39
Stenhousem'r,9192,10,9,11,16,57,70,-13,38
Livingston,9193,1,21,4,11,71,46,25,67
Alloa,9193,2,19,8,9,68,44,24,65
Airdrieon,9193,3,18,9,9,63,48,15,63
Brechin,9193,4,18,7,11,58,53,5,61
Peterhead,9193,5,14,7,15,42,47,-5,49
Stranraer,9193,6,13,8,15,50,54,-4,47
East Fife,9193,7,11,10,15,60,55,5,43
Queen's Park,9193,8,10,12,14,32,48,-16,42
Albion,9193,9,9,8,19,55,68,-13,35
Stenhousem'r,9193,10,8,5,23,51,87,-36,29
Alloa,9194,1,19,8,9,62,41,21,65
Livingston,9194,2,19,5,12,71,46,25,62
Brechin,9194,3,16,8,12,45,51,-6,56
Airdrieon,9194,4,16,7,13,59,58,1,55
Stranraer,9194,5,15,5,16,55,51,4,50
East Fife,9194,6,12,13,11,55,43,12,49
Albion,9194,7,10,12,14,53,58,-5,42
Queen's Park,9194,8,12,6,18,36,48,-12,42
Peterhead,9194,9,9,12,15,45,62,-17,39
Stenhousem'r,9194,10,10,8,18,49,72,-23,38
Brechin,9195,1,23,2,11,61,46,15,71
Airdrieon,9195,2,18,8,10,66,47,19,62
Alloa,9195,3,17,9,10,65,41,24,60
Livingston,9195,4,18,6,12,73,54,19,60
Albion,9195,5,14,8,14,55,52,3,50
Stenhousem'r,9195,6,12,11,13,53,66,-13,47
Peterhead,9195,7,12,9,15,49,62,-13,45
Stranraer,9195,8,11,5,20,52,72,-20,38
East Fife,9195,9,9,10,17,46,54,-8,37
Queen's Park,9195,10,9,6,21,33,59,-26,33
Livingston,9196,1,21,4,11,88,52,36,67
Alloa,9196,2,17,11,8,72,46,26,62
Airdrieon,9196,3,19,5,12,62,47,15,62
Brechin,9196,4,17,6,13,51,52,-1,57
East Fife,9196,5,13,12,11,47,32,15,51
Peterhead,9196,6,13,11,12,52,53,-1,50
Stranraer,9196,7,14,4,18,47,62,-15,46
Albion,9196,8,10,10,16,47,60,-13,40
Queen's Park,9196,9,10,10,16,35,55,-20,40
Stenhousem'r,9196,10,6,7,23,42,84,-42,25
Airdrieon,9197,1,20,7,9,68,47,21,67
Alloa,9197,2,18,8,10,72,47,25,62
Brechin,9197,3,17,8,11,53,41,12,59
Livingston,9197,4,17,5,14,65,50,15,56
Albion,9197,5,16,7,13,65,57,8,55
Stranraer,9197,6,15,4,17,49,66,-17,49
Stenhousem'r,9197,7,13,3,20,57,82,-25,42
East Fife,9197,8,11,7,18,49,52,-3,40
Peterhead,9197,9,11,7,18,48,64,-16,40
Queen's Park,9197,10,11,6,19,32,52,-20,39
Alloa,9198,1,19,9,8,72,47,25,66
Livingston,9198,2,19,4,13,73,55,18,61
Peterhead,9198,3,17,8,11,73,51,22,59
Stranraer,9198,4,18,5,13,60,49,11,59
Airdrieon,9198,5,16,6,14,63,56,7,54
Queen's Park,9198,6,13,9,14,42,49,-7,48
Albion,9198,7,12,9,15,54,60,-6,45
Brechin,9198,8,13,6,17,49,64,-15,45
East Fife,9198,9,10,7,19,41,63,-22,37
Stenhousem'r,9198,10,10,3,23,49,82,-33,33
Livingston,9199,1,22,4,10,75,40,35,70
Alloa,9199,2,15,12,9,70,45,25,57
Stranraer,9199,3,18,3,15,57,51,6,57
Peterhead,9199,4,16,8,12,47,48,-1,56
Airdrieon,9199,5,15,7,14,59,58,1,52
Albion,9199,6,15,7,14,52,51,1,52
Brechin,9199,7,16,4,16,46,57,-11,52
Queen's Park,9199,8,10,10,16,31,46,-15,40
Stenhousem'r,9199,9,10,6,20,43,74,-31,36
East Fife,9199,10,9,7,20,39,49,-10,34
Alloa,9200,1,22,5,9,85,41,44,71
Brechin,9200,2,18,8,10,49,46,3,62
Airdrieon,9200,3,17,9,10,66,56,10,60
Livingston,9200,4,17,8,11,63,51,12,59
Stranraer,9200,5,13,8,15,47,52,-5,47
East Fife,9200,6,12,10,14,61,53,8,46
Queen's Park,9200,7,11,9,16,34,45,-11,42
Albion,9200,8,9,11,16,47,60,-13,38
Stenhousem'r,9200,9,10,8,18,46,72,-26,38
Peterhead,9200,10,9,8,19,38,60,-22,35
Alloa,9201,1,19,9,8,78,40,38,66
Livingston,9201,2,17,4,15,75,67,8,55
Queen's Park,9201,3,16,7,13,43,47,-4,55
Albion,9201,4,14,11,11,53,50,3,53
Airdrieon,9201,5,14,7,15,52,55,-3,49
East Fife,9201,6,12,12,12,54,46,8,48
Stenhousem'r,9201,7,11,11,14,56,70,-14,44
Brechin,9201,8,12,8,16,51,65,-14,44
Peterhead,9201,9,11,10,15,43,55,-12,43
Stranraer,9201,10,12,5,19,48,58,-10,41
Livingston,9202,1,22,6,8,80,42,38,72
Brechin,9202,2,22,6,8,64,40,24,72
Alloa,9202,3,16,6,14,72,55,17,54
Peterhead,9202,4,16,5,15,55,56,-1,53
Airdrieon,9202,5,15,6,15,49,57,-8,51
Queen's Park,9202,6,12,10,14,44,51,-7,46
Albion,9202,7,10,11,15,48,58,-10,41
East Fife,9202,8,11,7,18,44,49,-5,40
Stenhousem'r,9202,9,11,7,18,48,73,-25,40
Stranraer,9202,10,11,4,21,49,72,-23,37
Livingston,9203,1,25,5,6,82,43,39,80
Alloa,9203,2,19,10,7,70,41,29,67
Airdrieon,9203,3,19,5,12,65,50,15,62
Brechin,9203,4,17,5,14,50,43,7,56
Albion,9203,5,15,7,14,56,54,2,52
Peterhead,9203,6,14,5,17,50,50,0,47
Stranraer,9203,7,12,4,20,49,65,-16,40
East Fife,9203,8,10,8,18,38,48,-10,38
Queen's Park,9203,9,10,6,20,39,64,-25,36
Stenhousem'r,9203,10,7,9,20,45,86,-41,30
Livingston,9204,1,23,3,10,81,50,31,72
Alloa,9204,2,20,9,7,69,39,30,69
Airdrieon,9204,3,17,8,11,58,48,10,59
Albion,9204,4,16,10,10,62,54,8,58
Peterhead,9204,5,15,10,11,53,50,3,55
Brechin,9204,6,15,4,17,52,61,-9,49
Stranraer,9204,7,13,5,18,46,54,-8,44
East Fife,9204,8,8,12,16,44,48,-4,36
Queen's Park,9204,9,10,5,21,30,56,-26,35
Stenhousem'r,9204,10,5,10,21,43,78,-35,25
Livingston,9205,1,23,1,12,77,49,28,70
Alloa,9205,2,20,7,9,66,40,26,67
Airdrieon,9205,3,17,5,14,52,55,-3,56
Brechin,9205,4,16,5,15,50,44,6,53
Peterhead,9205,5,14,11,11,51,50,1,53
Albion,9205,6,13,10,13,49,44,5,49
Queen's Park,9205,7,14,7,15,46,52,-6,49
Stranraer,9205,8,14,5,17,46,60,-14,47
East Fife,9205,9,9,7,20,40,51,-11,34
Stenhousem'r,9205,10,6,10,20,36,68,-32,28
Livingston,9206,1,23,5,8,80,41,39,74
Alloa,9206,2,21,6,9,64,35,29,69
Airdrieon,9206,3,20,4,12,63,55,8,64
Brechin,9206,4,16,5,15,36,45,-9,53
Stranraer,9206,5,14,6,16,49,52,-3,48
Queen's Park,9206,6,13,8,15,33,44,-11,47
Albion,9206,7,13,6,17,62,59,3,45
Peterhead,9206,8,12,7,17,44,51,-7,43
East Fife,9206,9,11,7,18,46,47,-1,40
Stenhousem'r,9206,10,8,4,24,41,89,-48,28
Livingston,9207,1,19,7,10,73,51,22,64
Alloa,9207,2,17,7,12,62,46,16,58
Queen's Park,9207,3,18,4,14,43,47,-4,58
Peterhead,9207,4,16,8,12,67,51,16,56
Brechin,9207,5,16,7,13,53,43,10,55
Albion,9207,6,12,11,13,51,54,-3,47
East Fife,9207,7,12,9,15,52,54,-2,45
Airdrieon,9207,8,13,6,17,48,64,-16,45
Stenhousem'r,9207,9,9,10,17,49,74,-25,37
Stranraer,9207,10,9,9,18,43,57,-14,36
Airdrieon,9208,1,18,7,11,61,55,6,61
Alloa,9208,2,16,11,9,67,45,22,59
Livingston,9208,3,18,4,14,63,55,8,58
Brechin,9208,4,17,7,12,52,44,8,58
Peterhead,9208,5,15,7,14,47,46,1,52
Queen's Park,9208,6,14,7,15,37,45,-8,49
East Fife,9208,7,13,9,14,50,42,8,48
Albion,9208,8,12,9,15,41,44,-3,45
Stranraer,9208,9,12,6,18,44,52,-8,42
Stenhousem'r,9208,10,8,7,21,44,78,-34,31
Alloa,9209,1,19,10,7,69,43,26,67
Brechin,9209,2,19,8,9,51,39,12,65
Livingston,9209,3,19,7,10,75,44,31,64
Airdrieon,9209,4,16,7,13,56,55,1,55
Peterhead,9209,5,15,7,14,49,53,-4,52
Albion,9209,6,11,10,15,49,55,-6,43
Queen's Park,9209,7,11,10,15,42,49,-7,43
Stranraer,9209,8,11,7,18,42,56,-14,40
East Fife,9209,9,9,11,16,46,49,-3,38
Stenhousem'r,9209,10,7,9,20,42,78,-36,30
Livingston,9210,1,21,5,10,81,46,35,68
Alloa,9210,2,21,5,10,71,45,26,68
Brechin,9210,3,18,6,12,55,47,8,60
Airdrieon,9210,4,16,10,10,58,50,8,58
East Fife,9210,5,14,7,15,51,44,7,49
Peterhead,9210,6,13,9,14,43,48,-5,48
Queen's Park,9210,7,14,6,16,43,51,-8,48
Albion,9210,8,13,7,16,46,51,-5,46
Stranraer,9210,9,11,7,18,46,64,-18,40
Stenhousem'r,9210,10,5,6,25,35,83,-48,21
Airdrieon,9211,1,19,8,9,68,49,19,65
Alloa,9211,2,19,7,10,66,47,19,64
Livingston,9211,3,16,7,13,72,56,16,55
Peterhead,9211,4,15,10,11,52,42,10,55
Brechin,9211,5,14,8,14,53,49,4,50
Stranraer,9211,6,14,5,17,56,61,-5,47
East Fife,9211,7,12,10,14,59,56,3,46
Albion,9211,8,12,10,14,56,60,-4,46
Queen's Park,9211,9,11,9,16,35,52,-17,42
Stenhousem'r,9211,10,7,8,21,42,87,-45,29
Livingston,9212,1,20,4,12,76,54,22,64
Stranraer,9212,2,17,7,12,67,49,18,58
Alloa,9212,3,17,7,12,64,47,17,58
Brechin,9212,4,17,6,13,52,58,-6,57
East Fife,9212,5,15,11,10,57,44,13,56
Albion,9212,6,14,11,11,59,46,13,53
Airdrieon,9212,7,15,6,15,55,65,-10,51
Peterhead,9212,8,12,8,16,48,56,-8,44
Queen's Park,9212,9,11,7,18,35,51,-16,40
Stenhousem'r,9212,10,5,7,24,45,88,-43,22
Livingston,9213,1,23,4,9,74,38,36,73
Alloa,9213,2,18,7,11,76,48,28,61
Queen's Park,9213,3,15,9,12,35,40,-5,54
Airdrieon,9213,4,13,12,11,55,61,-6,51
Peterhead,9213,5,13,11,12,47,49,-2,50
Brechin,9213,6,14,8,14,52,55,-3,50
East Fife,9213,7,11,10,15,49,51,-2,43
Albion,9213,8,12,7,17,53,59,-6,43
Stenhousem'r,9213,9,9,11,16,40,59,-19,38
Stranraer,9213,10,8,9,19,40,61,-21,33
Brechin,9214,1,19,6,11,63,45,18,63
Alloa,9214,2,18,4,14,71,54,17,58
Livingston,9214,3,18,3,15,69,56,13,57
Peterhead,9214,4,16,7,13,53,49,4,55
East Fife,9214,5,14,11,11,55,45,10,53
Airdrieon,9214,6,13,13,10,60,60,0,52
Stranraer,9214,7,14,5,17,58,63,-5,47
Albion,9214,8,11,8,17,55,66,-11,41
Queen's Park,9214,9,11,7,18,38,58,-20,40
Stenhousem'r,9214,10,10,8,18,52,78,-26,38
Livingston,9215,1,21,3,12,67,47,20,66
Airdrieon,9215,2,19,5,12,60,46,14,62
Alloa,9215,3,17,10,9,69,47,22,61
Brechin,9215,4,15,9,12,54,49,5,54
Queen's Park,9215,5,16,5,15,46,47,-1,53
Peterhead,9215,6,15,8,13,47,49,-2,53
East Fife,9215,7,14,9,13,47,43,4,51
Stranraer,9215,8,15,2,19,47,59,-12,47
Albion,9215,9,10,6,20,52,62,-10,36
Stenhousem'r,9215,10,5,9,22,39,79,-40,24
Livingston,9216,1,21,6,9,76,45,31,69
Airdrieon,9216,2,16,9,11,55,49,6,57
Brechin,9216,3,17,5,14,57,57,0,56
East Fife,9216,4,16,7,13,60,45,15,55
Queen's Park,9216,5,16,7,13,40,40,0,55
Alloa,9216,6,15,9,12,60,49,11,54
Peterhead,9216,7,12,10,14,47,57,-10,46
Albion,9216,8,12,9,15,49,54,-5,45
Stranraer,9216,9,11,6,19,47,57,-10,39
Stenhousem'r,9216,10,7,6,23,41,79,-38,27
Livingston,9217,1,22,6,8,80,49,31,72
Alloa,9217,2,18,7,11,80,43,37,61
Airdrieon,9217,3,18,4,14,62,57,5,58
Albion,9217,4,16,6,14,54,54,0,54
Peterhead,9217,5,14,9,13,49,50,-1,51
Brechin,9217,6,14,9,13,47,51,-4,51
Stranraer,9217,7,13,7,16,51,54,-3,46
Queen's Park,9217,8,13,7,16,36,52,-16,46
East Fife,9217,9,12,7,17,48,53,-5,43
Stenhousem'r,9217,10,6,6,24,40,84,-44,24
Livingston,9218,1,20,6,10,81,48,33,66
Alloa,9218,2,19,8,9,68,48,20,65
Brechin,9218,3,19,7,10,61,35,26,64
Airdrieon,9218,4,18,5,13,61,53,8,59
Stranraer,9218,5,16,5,15,53,54,-1,53
Albion,9218,6,12,9,15,47,53,-6,45
East Fife,9218,7,11,10,15,48,57,-9,43
Peterhead,9218,8,9,10,17,48,58,-10,37
Stenhousem'r,9218,9,9,9,18,44,76,-32,36
Queen's Park,9218,10,7,11,18,30,59,-29,32
Livingston,9219,1,23,5,8,88,51,37,74
Airdrieon,9219,2,19,6,11,65,60,5,63
Alloa,9219,3,17,9,10,60,43,17,60
Brechin,9219,4,17,7,12,49,45,4,58
Peterhead,9219,5,15,9,12,52,45,7,54
Queen's Park,9219,6,13,8,15,43,51,-8,47
Albion,9219,7,11,10,15,53,54,-1,43
East Fife,9219,8,10,6,20,42,59,-17,36
Stranraer,9219,9,10,6,20,41,60,-19,36
Stenhousem'r,9219,10,9,6,21,54,79,-25,33
Livingston,9220,1,27,0,9,77,36,41,81
Albion,9220,2,18,7,11,62,48,14,61
Alloa,9220,3,17,9,10,75,41,34,60
Airdrieon,9220,4,16,5,15,50,48,2,53
Brechin,9220,5,15,8,13,51,63,-12,53
East Fife,9220,6,14,9,13,54,49,5,51
Peterhead,9220,7,13,8,15,43,50,-7,47
Stranraer,9220,8,9,10,17,42,55,-13,37
Stenhousem'r,9220,9,8,8,20,39,74,-35,32
Queen's Park,9220,10,8,6,22,33,62,-29,30
Brechin,9221,1,20,6,10,59,43,16,66
Livingston,9221,2,20,2,14,82,59,23,62
Alloa,9221,3,18,8,10,71,51,20,62
Airdrieon,9221,4,16,6,14,63,58,5,54
East Fife,9221,5,15,5,16,54,46,8,50
Peterhead,9221,6,13,11,12,51,54,-3,50
Albion,9221,7,12,8,16,48,56,-8,44
Queen's Park,9221,8,12,8,16,40,53,-13,44
Stranraer,9221,9,10,7,19,50,68,-18,37
Stenhousem'r,9221,10,10,7,19,45,75,-30,37
Livingston,9222,1,19,7,10,73,49,24,64
Alloa,9222,2,17,9,10,63,46,17,60
Brechin,9222,3,16,10,10,54,47,7,58
Peterhead,9222,4,16,9,11,67,54,13,57
Airdrieon,9222,5,14,9,13,57,54,3,51
Albion,9222,6,12,12,12,50,51,-1,48
Queen's Park,9222,7,10,14,12,42,49,-7,44
Stranraer,9222,8,11,8,17,43,58,-15,41
Stenhousem'r,9222,9,10,9,17,47,70,-23,39
East Fife,9222,10,6,11,19,41,59,-18,29
Livingston,9223,1,23,3,10,78,43,35,72
Alloa,9223,2,20,8,8,80,37,43,68
Peterhead,9223,3,20,5,11,64,45,19,65
Airdrieon,9223,4,19,7,10,67,49,18,64
Brechin,9223,5,12,12,12,49,57,-8,48
Queen's Park,9223,6,13,9,14,40,51,-11,48
Albion,9223,7,11,11,14,49,60,-11,44
Stranraer,9223,8,10,5,21,49,67,-18,35
East Fife,9223,9,7,10,19,43,57,-14,31
Stenhousem'r,9223,10,6,8,22,47,100,-53,26
Livingston,9224,1,23,3,10,82,45,37,72
Alloa,9224,2,19,10,7,75,41,34,67
Brechin,9224,3,19,4,13,56,58,-2,61
Airdrieon,9224,4,15,10,11,61,55,6,55
Queen's Park,9224,5,15,6,15,51,48,3,51
Peterhead,9224,6,11,8,17,47,66,-19,41
East Fife,9224,7,10,10,16,50,60,-10,40
Stranraer,9224,8,12,3,21,48,68,-20,39
Stenhousem'r,9224,9,10,9,17,58,81,-23,39
Albion,9224,10,9,11,16,43,49,-6,38
Alloa,9225,1,23,7,6,80,42,38,76
Brechin,9225,2,19,6,11,54,48,6,63
Livingston,9225,3,17,10,9,74,46,28,61
Airdrieon,9225,4,15,7,14,60,57,3,52
Stranraer,9225,5,12,8,16,50,51,-1,44
Albion,9225,6,10,13,13,55,63,-8,43
East Fife,9225,7,9,15,12,53,53,0,42
Queen's Park,9225,8,12,6,18,35,47,-12,42
Peterhead,9225,9,10,11,15,51,61,-10,41
Stenhousem'r,9225,10,6,11,19,42,86,-44,29
Livingston,9226,1,20,7,9,77,49,28,67
Alloa,9226,2,18,11,7,70,38,32,65
Airdrieon,9226,3,19,8,9,66,50,16,65
Brechin,9226,4,14,7,15,42,42,0,49
Albion,9226,5,11,14,11,60,56,4,47
Queen's Park,9226,6,12,10,14,37,48,-11,46
Peterhead,9226,7,11,12,13,45,60,-15,45
Stranraer,9226,8,11,7,18,49,59,-10,40
East Fife,9226,9,7,13,16,41,53,-12,34
Stenhousem'r,9226,10,7,11,18,51,83,-32,32
Livingston,9227,1,25,3,8,88,44,44,78
Airdrieon,9227,2,21,3,12,62,49,13,66
Alloa,9227,3,18,9,9,77,53,24,63
Queen's Park,9227,4,16,5,15,45,51,-6,53
Albion,9227,5,15,7,14,46,49,-3,52
Brechin,9227,6,16,4,16,46,53,-7,52
Peterhead,9227,7,14,8,14,56,52,4,50
East Fife,9227,8,10,10,16,50,58,-8,40
Stranraer,9227,9,10,6,20,38,54,-16,36
Stenhousem'r,9227,10,3,9,24,35,80,-45,18
Livingston,9228,1,20,4,12,77,46,31,64
Brechin,9228,2,19,6,11,50,42,8,63
Airdrieon,9228,3,18,7,11,64,54,10,61
Alloa,9228,4,16,7,13,54,45,9,55
Peterhead,9228,5,14,10,12,52,52,0,52
Albion,9228,6,14,7,15,57,59,-2,49
East Fife,9228,7,11,10,15,50,46,4,43
Queen's Park,9228,8,11,7,18,39,57,-18,40
Stenhousem'r,9228,9,11,7,18,56,75,-19,40
Stranraer,9228,10,9,9,18,38,61,-23,36
Livingston,9229,1,23,3,10,83,51,32,72
Alloa,9229,2,19,8,9,67,45,22,65
Airdrieon,9229,3,18,7,11,59,52,7,61
Brechin,9229,4,17,7,12,48,42,6,58
Peterhead,9229,5,14,7,15,44,49,-5,49
Queen's Park,9229,6,14,5,17,38,51,-13,47
Albion,9229,7,13,5,18,47,52,-5,44
East Fife,9229,8,11,10,15,48,43,5,43
Stranraer,9229,9,11,6,19,43,59,-16,39
Stenhousem'r,9229,10,7,8,21,48,81,-33,29
Livingston,9230,1,26,3,7,97,35,62,81
Alloa,9230,2,21,5,10,66,38,28,68
Albion,9230,3,18,6,12,60,50,10,60
Airdrieon,9230,4,18,5,13,61,60,1,59
Brechin,9230,5,17,3,16,48,54,-6,54
Peterhead,9230,6,15,6,15,51,55,-4,51
East Fife,9230,7,9,11,16,51,47,4,38
Queen's Park,9230,8,10,7,19,37,66,-29,37
Stranraer,9230,9,7,10,19,42,65,-23,31
Stenhousem'r,9230,10,8,6,22,42,85,-43,30
Airdrieon,9231,1,20,6,10,63,48,15,66
Alloa,9231,2,17,9,10,71,41,30,60
Livingston,9231,3,17,6,13,72,53,19,57
Peterhead,9231,4,16,8,12,55,53,2,56
Brechin,9231,5,15,6,15,49,52,-3,51
East Fife,9231,6,14,8,14,57,49,8,50
Stranraer,9231,7,11,10,15,49,54,-5,43
Albion,9231,8,10,13,13,46,57,-11,43
Queen's Park,9231,9,12,4,20,40,61,-21,40
Stenhousem'r,9231,10,8,10,18,39,73,-34,34
Alloa,9232,1,20,8,8,76,47,29,68
Livingston,9232,2,20,4,12,76,44,32,64
East Fife,9232,3,17,4,15,59,49,10,55
Airdrieon,9232,4,16,7,13,58,57,1,55
Albion,9232,5,15,9,12,62,52,10,54
Brechin,9232,6,16,6,14,50,45,5,54
Queen's Park,9232,7,14,4,18,41,49,-8,46
Peterhead,9232,8,12,7,17,45,67,-22,43
Stranraer,9232,9,11,6,19,44,66,-22,39
Stenhousem'r,9232,10,8,7,21,40,75,-35,31
Alloa,9233,1,18,12,6,72,42,30,66
Livingston,9233,2,20,3,13,72,48,24,63
Brechin,9233,3,19,5,12,54,43,11,62
Stranraer,9233,4,16,7,13,60,55,5,55
Airdrieon,9233,5,16,5,15,62,59,3,53
East Fife,9233,6,15,7,14,51,59,-8,52
Peterhead,9233,7,12,8,16,46,57,-11,44
Queen's Park,9233,8,11,9,16,32,52,-20,42
Albion,9233,9,9,10,17,50,55,-5,37
Stenhousem'r,9233,10,9,4,23,55,84,-29,31
Alloa,9234,1,18,10,8,67,47,20,64
Livingston,9234,2,20,3,13,78,48,30,63
Albion,9234,3,17,10,9,56,45,11,61
Airdrieon,9234,4,16,9,11,62,51,11,57
Brechin,9234,5,16,7,13,55,56,-1,55
Peterhead,9234,6,16,5,15,56,55,1,53
East Fife,9234,7,13,7,16,46,47,-1,46
Stranraer,9234,8,13,6,17,56,63,-7,45
Queen's Park,9234,9,11,6,19,42,61,-19,39
Stenhousem'r,9234,10,4,9,23,45,90,-45,21
Livingston,9235,1,22,6,8,90,51,39,72
Alloa,9235,2,17,8,11,73,49,24,59
Airdrieon,9235,3,15,11,10,63,56,7,56
Peterhead,9235,4,15,10,11,58,57,1,55
Brechin,9235,5,16,6,14,54,54,0,54
Queen's Park,9235,6,15,6,15,40,51,-11,51
Albion,9235,7,14,7,15,56,62,-6,49
Stranraer,9235,8,13,8,15,56,60,-4,47
East Fife,9235,9,6,11,19,42,58,-16,29
Stenhousem'r,9235,10,7,7,22,43,77,-34,28
Livingston,9236,1,21,6,9,68,42,26,69
Alloa,9236,2,17,9,10,71,46,25,60
Airdrieon,9236,3,18,6,12,61,57,4,60
Albion,9236,4,16,8,12,60,50,10,56
Brechin,9236,5,15,8,13,55,54,1,53
Stranraer,9236,6,14,7,15,57,57,0,49
Peterhead,9236,7,12,11,13,52,55,-3,47
Queen's Park,9236,8,11,9,16,38,56,-18,42
East Fife,9236,9,10,10,16,48,51,-3,40
Stenhousem'r,9236,10,4,10,22,36,78,-42,22
Livingston,9237,1,25,3,8,82,46,36,78
Airdrieon,9237,2,17,8,11,67,58,9,59
Alloa,9237,3,17,6,13,61,44,17,57
Queen's Park,9237,4,15,7,14,48,50,-2,52
Albion,9237,5,13,10,13,50,50,0,49
Brechin,9237,6,15,4,17,45,52,-7,49
East Fife,9237,7,12,8,16,40,44,-4,44
Peterhead,9237,8,11,11,14,48,53,-5,44
Stenhousem'r,9237,9,11,8,17,57,79,-22,41
Stranraer,9237,10,9,5,22,37,59,-22,32
Alloa,9238,1,24,4,8,78,46,32,76
Livingston,9238,2,20,5,11,71,49,22,65
Brechin,9238,3,19,6,11,57,39,18,63
Airdrieon,9238,4,18,7,11,52,39,13,61
Albion,9238,5,15,9,12,50,44,6,54
Stranraer,9238,6,14,6,16,48,54,-6,48
Queen's Park,9238,7,10,9,17,34,47,-13,39
East Fife,9238,8,8,11,17,49,57,-8,35
Peterhead,9238,9,9,8,19,36,60,-24,35
Stenhousem'r,9238,10,7,7,22,44,84,-40,28
Alloa,9239,1,19,7,10,65,44,21,64
Livingston,9239,2,17,10,9,72,49,23,61
East Fife,9239,3,16,6,14,63,51,12,54
Airdrieon,9239,4,15,9,12,57,57,0,54
Brechin,9239,5,15,7,14,47,46,1,52
Queen's Park,9239,6,14,9,13,41,48,-7,51
Peterhead,9239,7,12,12,12,54,67,-13,48
Albion,9239,8,12,10,14,52,51,1,46
Stranraer,9239,9,8,10,18,44,59,-15,34
Stenhousem'r,9239,10,7,10,19,43,66,-23,31
Alloa,9240,1,21,9,6,83,44,39,72
Livingston,9240,2,23,3,10,84,48,36,72
Airdrieon,9240,3,19,6,11,63,52,11,63
Albion,9240,4,17,8,11,55,39,16,59
Brechin,9240,5,17,4,15,50,50,0,55
Peterhead,9240,6,13,10,13,43,50,-7,49
Queen's Park,9240,7,11,7,18,35,58,-23,40
Stranraer,9240,8,12,3,21,61,75,-14,39
East Fife,9240,9,6,10,20,33,59,-26,28
Stenhousem'r,9240,10,6,10,20,42,74,-32,28
Alloa,9241,1,21,5,10,77,50,27,68
Brechin,9241,2,19,5,12,52,41,11,62
Livingston,9241,3,19,4,13,77,52,25,61
Airdrieon,9241,4,18,6,12,63,53,10,60
Albion,9241,5,15,6,15,48,56,-8,51
Queen's Park,9241,6,16,3,17,47,55,-8,51
Stranraer,9241,7,15,2,19,51,59,-8,47
East Fife,9241,8,11,9,16,47,48,-1,42
Peterhead,9241,9,11,6,19,44,61,-17,39
Stenhousem'r,9241,10,9,6,21,46,77,-31,33
Alloa,9242,1,18,7,11,66,48,18,61
Livingston,9242,2,17,7,12,64,51,13,58
Airdrieon,9242,3,16,7,13,57,54,3,55
East Fife,9242,4,15,8,13,48,43,5,53
Stranraer,9242,5,14,7,15,55,51,4,49
Albion,9242,6,14,7,15,47,49,-2,49
Brechin,9242,7,13,9,14,47,48,-1,48
Peterhead,9242,8,13,7,16,44,53,-9,46
Queen's Park,9242,9,10,11,15,32,47,-15,41
Stenhousem'r,9242,10,11,8,17,58,74,-16,41
Livingston,9243,1,24,4,8,77,45,32,76
Alloa,9243,2,21,8,7,85,39,46,71
Airdrieon,9243,3,16,8,12,55,53,2,56
Peterhead,9243,4,16,6,14,53,56,-3,54
East Fife,9243,5,14,8,14,57,50,7,50
Brechin,9243,6,14,8,14,51,48,3,50
Stranraer,9243,7,12,8,16,48,58,-10,44
Albion,9243,8,9,10,17,45,57,-12,37
Queen's Park,9243,9,10,5,21,30,60,-30,35
Stenhousem'r,9243,10,7,9,20,43,78,-35,30
Alloa,9244,1,20,7,9,73,41,32,67
Airdrieon,9244,2,20,5,11,59,51,8,65
Livingston,9244,3,20,3,13,83,65,18,63
East Fife,9244,4,18,7,11,56,41,15,61
Brechin,9244,5,16,6,14,45,45,0,54
Peterhead,9244,6,14,8,14,57,57,0,50
Stranraer,9244,7,13,3,20,43,60,-17,42
Queen's Park,9244,8,11,8,17,37,51,-14,41
Albion,9244,9,10,9,17,50,56,-6,39
Stenhousem'r,9244,10,7,6,23,48,84,-36,27
Livingston,9245,1,23,2,11,80,50,30,71
Airdrieon,9245,2,20,4,12,73,50,23,64
Peterhead,9245,3,17,8,11,61,45,16,59
Alloa,9245,4,17,5,14,66,54,12,56
Brechin,9245,5,16,8,12,57,59,-2,56
Albion,9245,6,16,7,13,56,51,5,55
East Fife,9245,7,14,9,13,54,44,10,51
Stranraer,9245,8,11,5,20,50,69,-19,38
Queen's Park,9245,9,7,9,20,31,64,-33,30
Stenhousem'r,9245,10,7,7,22,44,86,-42,28
Livingston,9246,1,21,4,11,81,52,29,67
Alloa,9246,2,19,8,9,70,40,30,65
Brechin,9246,3,15,8,13,42,44,-2,53
Airdrieon,9246,4,15,7,14,61,60,1,52
East Fife,9246,5,12,12,12,51,43,8,48
Queen's Park,9246,6,11,13,12,48,50,-2,46
Peterhead,9246,7,12,9,15,44,53,-9,45
Stranraer,9246,8,14,3,19,45,65,-20,45
Albion,9246,9,12,8,16,47,53,-6,44
Stenhousem'r,9246,10,7,12,17,46,75,-29,33
Alloa,9247,1,22,5,9,86,47,39,71
Livingston,9247,2,21,3,12,74,48,26,66
Peterhead,9247,3,15,9,12,59,56,3,54
Albion,9247,4,14,9,13,49,52,-3,51
Brechin,9247,5,15,6,15,56,63,-7,51
Airdrieon,9247,6,13,7,16,52,60,-8,46
East Fife,9247,7,11,12,13,53,54,-1,45
Queen's Park,9247,8,11,9,16,33,47,-14,42
Stenhousem'r,9247,9,10,10,16,46,62,-16,40
Stranraer,9247,10,9,8,19,38,57,-19,35
Alloa,9248,1,18,9,9,74,44,30,63
Livingston,9248,2,18,7,11,79,59,20,61
Brechin,9248,3,18,7,11,56,44,12,61
Airdrieon,9248,4,17,6,13,57,60,-3,57
Albion,9248,5,17,5,14,61,48,13,56
Queen's Park,9248,6,17,5,14,41,44,-3,56
Stranraer,9248,7,11,9,16,55,64,-9,42
Peterhead,9248,8,11,8,17,42,55,-13,41
Stenhousem'r,9248,9,10,5,21,44,80,-36,35
East Fife,9248,10,8,9,19,43,54,-11,33
Livingston,9249,1,23,6,7,78,41,37,75
Alloa,9249,2,20,5,11,71,47,24,65
Brechin,9249,3,18,9,9,61,48,13,63
Airdrieon,9249,4,17,5,14,62,56,6,56
Peterhead,9249,5,15,7,14,59,53,6,52
Albion,9249,6,13,10,13,54,56,-2,49
Queen's Park,9249,7,13,9,14,30,42,-12,48
Stranraer,9249,8,8,9,19,41,58,-17,33
East Fife,9249,9,6,13,17,39,53,-14,31
Stenhousem'r,9249,10,7,7,22,40,81,-41,28
Livingston,9250,1,22,3,11,78,50,28,69
Airdrieon,9250,2,21,5,10,68,48,20,68
Alloa,9250,3,19,6,11,74,50,24,63
Queen's Park,9250,4,14,9,13,49,51,-2,51
East Fife,9250,5,14,7,15,53,53,0,49
Peterhead,9250,6,14,6,16,53,56,-3,48
Brechin,9250,7,13,8,15,51,62,-11,47
Albion,9250,8,10,11,15,49,58,-9,41
Stranraer,9250,9,11,7,18,48,60,-12,40
Stenhousem'r,9250,10,7,8,21,47,82,-35,29
Alloa,9251,1,22,6,8,84,43,41,72
Livingston,9251,2,20,7,9,77,49,28,67
Airdrieon,9251,3,20,6,10,71,54,17,66
Albion,9251,4,13,9,14,62,56,6,48
Brechin,9251,5,15,3,18,57,65,-8,48
East Fife,9251,6,13,7,16,53,54,-1,46
Queen's Park,9251,7,11,12,13,35,53,-18,45
Peterhead,9251,8,11,8,17,44,55,-11,41
Stenhousem'r,9251,9,9,9,18,49,79,-30,36
Stranraer,9251,10,9,7,20,45,69,-24,34
Alloa,9252,1,19,8,9,69,40,29,65
Livingston,9252,2,19,5,12,68,46,22,62
Brechin,9252,3,18,8,10,56,45,11,62
East Fife,9252,4,17,6,13,60,44,16,57
Peterhead,9252,5,15,8,13,47,48,-1,53
Albion,9252,6,16,5,15,55,62,-7,53
Airdrieon,9252,7,16,4,16,60,58,2,52
Queen's Park,9252,8,10,9,17,33,51,-18,39
Stenhousem'r,9252,9,10,8,18,50,74,-24,38
Stranraer,9252,10,8,3,25,40,70,-30,27
Livingston,9253,1,24,3,9,84,42,42,75
Brechin,9253,2,20,5,11,62,47,15,65
Alloa,9253,3,15,12,9,62,46,16,57
Airdrieon,9253,4,16,7,13,65,59,6,55
East Fife,9253,5,15,8,13,56,56,0,53
Queen's Park,9253,6,13,7,16,36,50,-14,46
Stranraer,9253,7,14,3,19,60,64,-4,45
Peterhead,9253,8,11,8,17,43,54,-11,41
Albion,9253,9,10,8,18,46,62,-16,38
Stenhousem'r,9253,10,7,9,20,41,75,-34,30
Livingston,9254,1,23,5,8,81,45,36,74
Alloa,9254,2,20,8,8,68,45,23,68
Brechin,9254,3,17,7,12,49,45,4,58
Stranraer,9254,4,16,4,16,68,65,3,52
Albion,9254,5,14,10,12,55,53,2,52
Queen's Park,9254,6,13,7,16,47,58,-11,46
Airdrieon,9254,7,13,6,17,48,66,-18,45
Peterhead,9254,8,12,7,17,52,56,-4,43
East Fife,9254,9,10,10,16,52,56,-4,40
Stenhousem'r,9254,10,6,8,22,45,76,-31,26
Alloa,9255,1,18,9,9,66,41,25,63
Airdrieon,9255,2,19,6,11,71,56,15,63
Livingston,9255,3,16,5,15,61,57,4,53
Brechin,9255,4,15,7,14,46,48,-2,52
Peterhead,9255,4,14,10,12,46,48,-2,52
East Fife,9255,6,13,9,14,49,47,2,48
Albion,9255,7,14,5,17,56,56,0,47
Queen's Park,9255,8,13,6,17,34,47,-13,45
Stenhousem'r,9255,9,12,6,18,51,69,-18,42
Stranraer,9255,10,12,5,19,54,65,-11,41
Livingston,9256,1,25,3,8,88,45,43,78
Alloa,9256,2,17,8,11,61,45,16,59
Stranraer,9256,3,19,2,15,52,50,2,59
Albion,9256,4,17,6,13,57,53,4,57
Airdrieon,9256,5,17,3,16,57,57,0,54
Brechin,9256,6,16,5,15,51,47,4,53
Peterhead,9256,7,13,7,16,43,53,-10,46
East Fife,9256,8,11,9,16,50,49,1,42
Queen's Park,9256,9,10,10,16,34,49,-15,40
Stenhousem'r,9256,10,5,7,24,42,87,-45,22
Alloa,9257,1,21,9,6,69,36,33,72
Queen's Park,9257,2,18,7,11,45,40,5,61
Airdrieon,9257,3,17,5,14,63,63,0,56
Livingston,9257,4,17,2,17,68,61,7,53
East Fife,9257,5,15,5,16,54,48,6,50
Stranraer,9257,6,14,6,16,57,60,-3,48
Brechin,9257,7,14,5,17,46,56,-10,47
Peterhead,9257,8,13,6,17,55,55,0,45
Albion,9257,9,13,5,18,43,59,-16,44
Stenhousem'r,9257,10,9,8,19,53,75,-22,35
Alloa,9258,1,21,6,9,79,38,41,69
Livingston,9258,2,17,12,7,75,45,30,63
Brechin,9258,3,19,6,11,61,47,14,63
Airdrieon,9258,4,16,9,11,62,55,7,57
Albion,9258,5,13,10,13,44,52,-8,49
East Fife,9258,6,12,11,13,50,45,5,47
Peterhead,9258,7,12,8,16,48,64,-16,44
Queen's Park,9258,8,9,10,17,31,48,-17,37
Stenhousem'r,9258,9,9,9,18,54,84,-30,36
Stranraer,9258,10,9,5,22,34,60,-26,32
Livingston,9259,1,21,7,8,81,53,28,70
Alloa,9259,2,19,9,8,77,46,31,66
Brechin,9259,3,21,3,12,63,44,19,66
Airdrieon,9259,4,16,9,11,59,53,6,57
Peterhead,9259,5,14,7,15,46,53,-7,49
Stranraer,9259,6,13,6,17,47,53,-6,45
East Fife,9259,7,11,10,15,44,43,1,43
Queen's Park,9259,8,11,8,17,35,58,-23,41
Albion,9259,9,9,8,19,46,56,-10,35
Stenhousem'r,9259,10,5,13,18,35,74,-39,28
Alloa,9260,1,18,9,9,79,39,40,63
Livingston,9260,2,18,7,11,68,57,11,61
Albion,9260,3,15,10,11,59,44,15,55
Brechin,9260,4,16,7,13,52,47,5,55
Peterhead,9260,5,14,11,11,54,48,6,53
East Fife,9260,6,13,10,13,55,49,6,49
Airdrieon,9260,7,13,9,14,53,65,-12,48
Stranraer,9260,8,11,8,17,53,65,-12,41
Stenhousem'r,9260,9,9,9,18,51,85,-34,36
Queen's Park,9260,10,9,8,19,30,55,-25,35
Livingston,9261,1,23,2,11,76,40,36,71
Alloa,9261,2,17,8,11,66,40,26,59
Brechin,9261,3,18,3,15,55,49,6,57
Airdrieon,9261,4,16,8,12,58,51,7,56
Peterhead,9261,5,15,9,12,42,47,-5,54
Stranraer,9261,6,15,5,16,66,60,6,50
Albion,9261,7,14,8,14,51,53,-2,50
East Fife,9261,8,9,11,16,45,54,-9,38
Stenhousem'r,9261,9,10,7,19,49,90,-41,37
Queen's Park,9261,10,10,5,21,38,62,-24,35
Alloa,9262,1,20,8,8,74,38,36,68
Livingston,9262,2,21,4,11,83,54,29,67
Airdrieon,9262,3,19,7,10,54,46,8,64
Brechin,9262,4,15,6,15,47,48,-1,51
Albion,9262,5,13,11,12,51,50,1,50
Peterhead,9262,6,13,7,16,49,56,-7,46
Queen's Park,9262,7,13,7,16,31,48,-17,46
Stranraer,9262,8,12,8,16,49,55,-6,44
East Fife,9262,9,9,13,14,53,49,4,40
Stenhousem'r,9262,10,4,11,21,37,84,-47,23
Livingston,9263,1,22,5,9,86,47,39,71
Airdrieon,9263,2,19,8,9,60,46,14,65
Alloa,9263,3,17,11,8,70,43,27,62
Stranraer,9263,4,16,5,15,50,55,-5,53
Albion,9263,5,13,10,13,60,54,6,49
Brechin,9263,6,13,7,16,45,54,-9,46
Queen's Park,9263,7,12,8,16,38,61,-23,44
Peterhead,9263,8,10,13,13,39,46,-7,43
East Fife,9263,9,8,13,15,55,57,-2,37
Stenhousem'r,9263,10,6,8,22,50,90,-40,26
Alloa,9264,1,23,6,7,74,37,37,75
Livingston,9264,2,20,8,8,81,47,34,68
Airdrieon,9264,3,19,7,10,57,45,12,64
Brechin,9264,4,15,6,15,46,49,-3,51
Queen's Park,9264,5,14,7,15,41,50,-9,49
Peterhead,9264,6,12,7,17,42,51,-9,43
East Fife,9264,7,9,12,15,50,56,-6,39
Albion,9264,8,10,9,17,43,56,-13,39
Stenhousem'r,9264,9,9,10,17,41,69,-28,37
Stranraer,9264,10,10,6,20,46,61,-15,36
Livingston,9265,1,21,5,10,71,44,27,68
Airdrieon,9265,2,20,7,9,66,49,17,67
Brechin,9265,3,17,7,12,53,53,0,58
Alloa,9265,4,16,7,13,64,50,14,55
East Fife,9265,5,15,7,14,54,50,4,52
Albion,9265,6,14,8,14,59,52,7,50
Peterhead,9265,7,13,9,14,47,44,3,48
Stranraer,9265,8,12,6,18,46,55,-9,42
Queen's Park,9265,9,12,5,19,33,53,-20,41
Stenhousem'r,9265,10,6,7,23,38,81,-43,25
Alloa,9266,1,20,9,7,70,40,30,69
Livingston,9266,2,20,4,12,74,47,27,64
Airdrieon,9266,3,19,6,11,69,56,13,63
East Fife,9266,4,15,9,12,59,44,15,54
Peterhead,9266,5,16,6,14,52,52,0,54
Albion,9266,6,12,8,16,49,50,-1,44
Brechin,9266,7,13,4,19,49,65,-16,43
Queen's Park,9266,8,12,6,18,37,63,-26,42
Stranraer,9266,9,12,4,20,47,62,-15,40
Stenhousem'r,9266,10,10,6,20,51,78,-27,36
Livingston,9267,1,20,5,11,71,42,29,65
Airdrieon,9267,2,19,7,10,57,49,8,64
Alloa,9267,3,18,8,10,65,45,20,62
Brechin,9267,4,18,6,12,51,42,9,60
Albion,9267,5,16,9,11,61,47,14,57
Peterhead,9267,6,16,8,12,54,50,4,56
Stranraer,9267,7,11,7,18,52,63,-11,40
Queen's Park,9267,8,11,7,18,36,55,-19,40
East Fife,9267,9,9,11,16,49,55,-6,38
Stenhousem'r,9267,10,4,8,24,35,83,-48,20
Livingston,9268,1,19,7,10,69,52,17,64
Airdrieon,9268,2,19,5,12,68,57,11,62
Alloa,9268,3,17,9,10,66,48,18,60
Queen's Park,9268,4,16,8,12,40,46,-6,56
Brechin,9268,5,17,3,16,56,53,3,54
Stranraer,9268,6,15,6,15,59,57,2,51
Peterhead,9268,7,13,8,15,51,52,-1,47
Albion,9268,8,12,7,17,51,55,-4,43
East Fife,9268,9,11,9,16,55,55,0,42
Stenhousem'r,9268,10,5,10,21,46,86,-40,25
Livingston,9269,1,19,7,10,78,50,28,64
Alloa,9269,2,18,9,9,71,40,31,63
Airdrieon,9269,3,13,13,10,55,55,0,52
East Fife,9269,4,14,7,15,50,52,-2,49
Peterhead,9269,5,14,7,15,52,56,-4,49
Queen's Park,9269,6,13,10,13,43,49,-6,49
Brechin,9269,7,13,8,15,43,53,-10,47
Albion,9269,8,14,4,18,46,49,-3,46
Stranraer,9269,9,10,12,14,48,58,-10,42
Stenhousem'r,9269,10,11,5,20,47,71,-24,38
Alloa,9270,1,18,10,8,77,43,34,64
East Fife,9270,2,17,5,14,56,47,9,56
Livingston,9270,3,16,7,13,67,49,18,55
Peterhead,9270,4,15,9,12,49,44,5,54
Airdrieon,9270,5,16,6,14,57,55,2,54
Brechin,9270,6,16,6,14,54,60,-6,54
Stranraer,9270,7,15,5,16,62,64,-2,50
Queen's Park,9270,8,11,8,17,45,61,-16,41
Albion,9270,9,10,10,16,50,62,-12,40
Stenhousem'r,9270,10,9,8,19,49,81,-32,35
Livingston,9271,1,21,5,10,83,49,34,68
Brechin,9271,2,18,8,10,53,42,11,62
Alloa,9271,3,17,8,11,66,44,22,59
East Fife,9271,4,16,8,12,57,47,10,56
Peterhead,9271,5,15,9,12,45,44,1,54
Airdrieon,9271,6,13,9,14,60,57,3,48
Stranraer,9271,7,14,6,16,49,52,-3,48
Queen's Park,9271,8,10,12,14,38,46,-8,42
Albion,9271,9,9,9,18,38,63,-25,36
Stenhousem'r,9271,10,6,8,22,40,85,-45,26
Livingston,9272,1,21,4,11,77,48,29,67
Alloa,9272,2,15,11,10,71,58,13,56
East Fife,9272,3,15,9,12,51,44,7,54
Stranraer,9272,4,15,9,12,56,52,4,54
Airdrieon,9272,5,16,6,14,64,62,2,54
Peterhead,9272,6,14,8,14,58,51,7,50
Brechin,9272,7,12,12,12,51,49,2,48
Queen's Park,9272,8,14,4,18,37,55,-18,46
Albion,9272,9,12,8,16,47,50,-3,44
Stenhousem'r,9272,10,6,9,21,34,77,-43,27
Livingston,9273,1,21,3,12,83,55,28,66
Alloa,9273,2,17,9,10,63,46,17,60
Albion,9273,3,15,8,13,67,53,14,53
Peterhead,9273,4,14,10,12,55,51,4,52
Airdrieon,9273,5,14,8,14,57,56,1,50
Stranraer,9273,6,15,5,16,53,66,-13,50
East Fife,9273,7,13,9,14,48,53,-5,48
Brechin,9273,8,13,9,14,46,51,-5,48
Queen's Park,9273,9,13,6,17,44,48,-4,45
Stenhousem'r,9273,10,8,7,21,44,81,-37,31
Alloa,9274,1,22,6,8,83,39,44,72
Livingston,9274,2,19,3,14,81,60,21,60
Brechin,9274,3,16,9,11,47,42,5,57
Airdrieon,9274,4,17,4,15,59,63,-4,55
East Fife,9274,5,14,9,13,57,47,10,51
Albion,9274,6,13,9,14,57,56,1,48
Queen's Park,9274,7,12,7,17,42,60,-18,43
Stranraer,9274,8,12,6,18,49,60,-11,42
Stenhousem'r,9274,9,10,10,16,45,69,-24,40
Peterhead,9274,10,8,11,17,41,65,-24,35
Alloa,9275,1,18,9,9,73,49,24,63
Brechin,9275,2,19,5,12,64,48,16,62
Airdrieon,9275,3,19,5,12,63,54,9,62
Livingston,9275,4,19,2,15,73,57,16,59
Peterhead,9275,5,14,9,13,62,62,0,51
Albion,9275,6,14,5,17,53,57,-4,47
East Fife,9275,7,11,10,15,50,52,-2,43
Queen's Park,9275,8,11,9,16,39,56,-17,42
Stranraer,9275,9,11,6,19,49,64,-15,39
Stenhousem'r,9275,10,10,8,18,59,86,-27,38
Livingston,9276,1,20,3,13,77,56,21,63
Alloa,9276,2,17,10,9,79,50,29,61
Brechin,9276,3,16,8,12,60,53,7,56
Albion,9276,4,15,8,13,55,50,5,53
Airdrieon,9276,5,14,10,12,64,58,6,52
Peterhead,9276,6,13,10,13,41,48,-7,49
Queen's Park,9276,7,14,7,15,38,48,-10,49
Stranraer,9276,8,13,7,16,48,62,-14,46
East Fife,9276,9,11,9,16,53,52,1,42
Stenhousem'r,9276,10,8,6,22,47,85,-38,30
Alloa,9277,1,19,8,9,78,39,39,65
Livingston,9277,2,19,8,9,66,41,25,65
Airdrieon,9277,3,19,6,11,57,44,13,63
Brechin,9277,4,17,6,13,47,44,3,57
Stranraer,9277,5,16,4,16,51,49,2,52
Albion,9277,6,15,6,15,55,65,-10,51
Peterhead,9277,7,12,12,12,51,56,-5,48
East Fife,9277,8,10,6,20,43,57,-14,36
Queen's Park,9277,9,8,10,18,29,52,-23,34
Stenhousem'r,9277,10,8,8,20,49,79,-30,32
Alloa,9278,1,25,3,8,76,36,40,78
Livingston,9278,2,20,4,12,74,57,17,64
Brechin,9278,3,20,4,12,58,50,8,64
Airdrieon,9278,4,18,6,12,63,59,4,60
Albion,9278,5,16,5,15,58,50,8,53
Stranraer,9278,6,15,3,18,52,53,-1,48
Queen's Park,9278,7,13,5,18,38,58,-20,44
East Fife,9278,8,11,7,18,51,52,-1,40
Peterhead,9278,9,10,6,20,42,61,-19,36
Stenhousem'r,9278,10,7,7,22,51,87,-36,28
Alloa,9279,1,19,8,9,74,53,21,65
Livingston,9279,2,20,3,13,86,53,33,63
Airdrieon,9279,3,16,8,12,55,54,1,56
Albion,9279,4,15,10,11,64,52,12,55
Peterhead,9279,5,15,8,13,54,56,-2,53
Queen's Park,9279,6,14,6,16,41,54,-13,48
Brechin,9279,7,13,8,15,46,52,-6,47
East Fife,9279,8,12,10,14,49,45,4,46
Stranraer,9279,9,10,10,16,46,57,-11,40
Stenhousem'r,9279,10,7,7,22,39,78,-39,28
Airdrieon,9280,1,20,6,10,69,50,19,66
Alloa,9280,2,19,8,9,75,42,33,65
Peterhead,9280,3,18,8,10,51,41,10,62
Livingston,9280,4,17,8,11,64,46,18,59
Brechin,9280,5,17,6,13,49,44,5,57
Albion,9280,6,11,12,13,52,55,-3,45
East Fife,9280,7,10,11,15,48,45,3,41
Stranraer,9280,8,10,10,16,48,62,-14,40
Queen's Park,9280,9,10,9,17,29,47,-18,39
Stenhousem'r,9280,10,4,10,22,37,90,-53,22
Livingston,9281,1,23,3,10,76,46,30,72
Alloa,9281,2,18,12,6,67,37,30,66
Brechin,9281,3,17,7,12,47,47,0,58
Albion,9281,4,16,8,12,58,53,5,56
East Fife,9281,5,12,12,12,51,46,5,48
Airdrieon,9281,6,14,6,16,56,57,-1,48
Peterhead,9281,7,12,9,15,43,52,-9,45
Stranraer,9281,8,13,5,18,65,70,-5,44
Queen's Park,9281,9,11,6,19,35,57,-22,39
Stenhousem'r,9281,10,6,8,22,45,78,-33,26
Alloa,9282,1,20,9,7,72,47,25,69
Brechin,9282,2,18,9,9,61,40,21,63
Airdrieon,9282,3,17,10,9,64,55,9,61
Livingston,9282,4,15,8,13,66,56,10,53
Peterhead,9282,5,14,6,16,41,57,-16,48
Stranraer,9282,6,14,5,17,65,71,-6,47
Queen's Park,9282,7,13,7,16,44,55,-11,46
East Fife,9282,8,10,10,16,46,43,3,40
Stenhousem'r,9282,9,10,8,18,55,72,-17,38
Albion,9282,10,8,10,18,46,64,-18,34
Livingston,9283,1,25,3,8,87,45,42,78
Alloa,9283,2,22,4,10,84,46,38,70
Airdrieon,9283,3,19,9,8,62,45,17,66
Brechin,9283,4,20,2,14,56,49,7,62
Peterhead,9283,5,16,4,16,51,54,-3,52
Albion,9283,6,13,6,17,52,58,-6,45
East Fife,9283,7,10,10,16,44,51,-7,40
Queen's Park,9283,8,10,8,18,31,56,-25,38
Stranraer,9283,9,11,3,22,50,65,-15,36
Stenhousem'r,9283,10,5,9,22,47,95,-48,24
Livingston,9284,1,26,3,7,92,53,39,81
Albion,9284,2,19,9,8,73,43,30,66
Alloa,9284,3,16,8,12,70,49,21,56
Brechin,9284,4,15,8,13,52,51,1,53
East Fife,9284,5,15,6,15,64,64,0,51
Airdrieon,9284,6,14,7,15,60,65,-5,49
Queen's Park,9284,7,12,10,14,37,46,-9,46
Peterhead,9284,8,10,8,18,52,63,-11,38
Stranraer,9284,9,10,6,20,54,75,-21,36
Stenhousem'r,9284,10,7,7,22,44,89,-45,28
Airdrieon,9285,1,18,7,11,56,52,4,61
Albion,9285,2,17,7,12,54,43,11,58
Alloa,9285,3,15,12,9,65,44,21,57
Brechin,9285,4,16,9,11,55,52,3,57
Queen's Park,9285,5,15,10,11,39,41,-2,55
Livingston,9285,6,15,8,13,63,48,15,53
Peterhead,9285,7,12,12,12,47,49,-2,48
Stranraer,9285,8,10,12,14,50,58,-8,42
Stenhousem'r,9285,9,9,7,20,47,75,-28,34
East Fife,9285,10,6,10,20,37,51,-14,28
Livingston,9286,1,20,6,10,79,53,26,66
Alloa,9286,2,20,6,10,64,39,25,66
Airdrieon,9286,3,19,6,11,60,49,11,63
Brechin,9286,4,18,4,14,55,47,8,58
Albion,9286,5,14,9,13,57,51,6,51
Stranraer,9286,6,14,6,16,47,57,-10,48
Peterhead,9286,7,12,10,14,48,52,-4,46
East Fife,9286,8,12,9,15,50,49,1,45
Queen's Park,9286,9,13,5,18,38,50,-12,44
Stenhousem'r,9286,10,5,5,26,46,97,-51,20
Livingston,9287,1,21,6,9,77,36,41,69
Alloa,9287,2,19,10,7,75,43,32,67
Brechin,9287,3,18,8,10,54,44,10,62
Airdrieon,9287,4,16,8,12,53,44,9,56
Peterhead,9287,5,15,7,14,42,47,-5,52
Stranraer,9287,6,15,5,16,54,59,-5,50
Albion,9287,7,14,6,16,47,54,-7,48
Queen's Park,9287,8,11,7,18,30,49,-19,40
East Fife,9287,9,7,12,17,37,49,-12,33
Stenhousem'r,9287,10,5,9,22,35,79,-44,24
Livingston,9288,1,22,3,11,69,45,24,69
Brechin,9288,2,17,10,9,50,38,12,61
Airdrieon,9288,3,17,9,10,65,54,11,60
Alloa,9288,4,16,9,11,68,46,22,57
Stranraer,9288,5,15,6,15,55,62,-7,51
Albion,9288,6,14,8,14,52,55,-3,50
Peterhead,9288,7,14,4,18,48,55,-7,46
East Fife,9288,8,10,11,15,46,51,-5,41
Queen's Park,9288,9,11,7,18,39,51,-12,40
Stenhousem'r,9288,10,8,5,23,48,83,-35,29
Livingston,9289,1,24,4,8,74,39,35,76
Alloa,9289,2,19,7,10,73,51,22,64
Brechin,9289,3,18,6,12,51,43,8,60
Queen's Park,9289,4,18,3,15,42,43,-1,57
Airdrieon,9289,5,17,5,14,59,54,5,56
Peterhead,9289,6,17,4,15,52,54,-2,55
Albion,9289,7,12,7,17,47,54,-7,43
East Fife,9289,8,12,7,17,45,52,-7,43
Stranraer,9289,9,9,5,22,43,65,-22,32
Stenhousem'r,9289,10,6,8,22,44,75,-31,26
Alloa,9290,1,21,7,8,76,48,28,70
Livingston,9290,2,22,3,11,74,46,28,69
Airdrieon,9290,3,17,6,13,62,61,1,57
Brechin,9290,4,17,4,15,60,51,9,55
Albion,9290,5,15,9,12,56,53,3,54
Peterhead,9290,6,15,7,14,51,45,6,52
East Fife,9290,7,12,8,16,47,49,-2,44
Queen's Park,9290,8,10,9,17,32,50,-18,39
Stranraer,9290,9,10,5,21,37,58,-21,35
Stenhousem'r,9290,10,9,6,21,45,79,-34,33
Livingston,9291,1,21,4,11,78,51,27,67
Alloa,9291,2,18,9,9,69,38,31,63
Airdrieon,9291,3,16,7,13,59,59,0,55
Brechin,9291,4,15,7,14,54,52,2,52
East Fife,9291,5,14,9,13,58,45,13,51
Albion,9291,6,15,5,16,51,54,-3,50
Peterhead,9291,7,12,8,16,50,58,-8,44
Queen's Park,9291,8,11,9,16,27,48,-21,42
Stranraer,9291,9,12,5,19,44,60,-16,41
Stenhousem'r,9291,10,10,9,17,50,75,-25,39
Livingston,9292,1,22,5,9,78,38,40,71
Alloa,9292,2,19,9,8,71,40,31,66
Airdrieon,9292,3,16,8,12,56,53,3,56
Albion,9292,4,15,8,13,58,45,13,53
Queen's Park,9292,5,15,6,15,33,49,-16,51
Brechin,9292,6,13,5,18,44,59,-15,44
Stranraer,9292,7,12,7,17,49,61,-12,43
Stenhousem'r,9292,8,11,8,17,48,73,-25,41
Peterhead,9292,9,10,10,16,44,52,-8,40
East Fife,9292,10,9,10,17,44,55,-11,37
Alloa,9293,1,21,9,6,86,43,43,72
Livingston,9293,2,19,8,9,78,48,30,65
Brechin,9293,3,18,6,12,48,39,9,60
Airdrieon,9293,4,15,8,13,61,58,3,53
Queen's Park,9293,5,15,7,14,41,49,-8,52
Stranraer,9293,6,14,4,18,55,60,-5,46
Albion,9293,7,12,9,15,46,59,-13,45
East Fife,9293,8,9,13,14,44,48,-4,40
Peterhead,9293,9,11,6,19,38,59,-21,39
Stenhousem'r,9293,10,8,6,22,49,83,-34,30
Livingston,9294,1,24,5,7,77,41,36,77
Alloa,9294,2,20,6,10,70,47,23,66
Peterhead,9294,3,17,6,13,59,54,5,57
Airdrieon,9294,4,16,7,13,62,65,-3,55
Albion,9294,5,14,8,14,51,48,3,50
Brechin,9294,6,14,6,16,47,52,-5,48
East Fife,9294,7,12,9,15,52,48,4,45
Stranraer,9294,8,14,2,20,53,66,-13,44
Queen's Park,9294,9,12,5,19,38,49,-11,41
Stenhousem'r,9294,10,6,8,22,39,78,-39,26
Livingston,9295,1,23,4,9,90,48,42,73
Alloa,9295,2,20,6,10,77,48,29,66
Brechin,9295,3,18,8,10,51,38,13,62
Peterhead,9295,4,16,5,15,54,60,-6,53
Albion,9295,5,14,9,13,50,48,2,51
Airdrieon,9295,6,15,4,17,51,61,-10,49
East Fife,9295,7,12,10,14,45,46,-1,46
Queen's Park,9295,8,13,6,17,34,46,-12,45
Stranraer,9295,9,8,8,20,51,66,-15,32
Stenhousem'r,9295,10,7,8,21,47,89,-42,29
Alloa,9296,1,21,5,10,71,39,32,68
Livingston,9296,2,21,5,10,67,45,22,68
Airdrieon,9296,3,16,9,11,54,45,9,57
Stranraer,9296,4,15,10,11,54,47,7,55
Peterhead,9296,5,16,7,13,52,53,-1,55
Brechin,9296,6,16,2,18,41,47,-6,50
Albion,9296,7,11,13,12,51,49,2,46
East Fife,9296,8,11,10,15,49,50,-1,43
Queen's Park,9296,9,10,7,19,34,52,-18,37
Stenhousem'r,9296,10,4,10,22,37,83,-46,22
Alloa,9297,1,18,9,9,69,44,25,63
Brechin,9297,2,17,9,10,56,44,12,60
Airdrieon,9297,3,16,9,11,56,53,3,57
Livingston,9297,4,17,5,14,71,57,14,56
Peterhead,9297,5,16,8,12,51,51,0,56
Stranraer,9297,6,13,8,15,54,59,-5,47
Albion,9297,7,12,10,14,51,52,-1,46
East Fife,9297,8,11,10,15,59,56,3,43
Stenhousem'r,9297,9,10,6,20,54,76,-22,36
Queen's Park,9297,10,10,6,20,34,63,-29,36
Alloa,9298,1,23,7,6,79,36,43,76
Livingston,9298,2,19,6,11,73,47,26,63
Airdrieon,9298,3,16,7,13,60,59,1,55
Brechin,9298,4,16,5,15,51,51,0,53
Peterhead,9298,5,14,8,14,52,57,-5,50
Stranraer,9298,6,13,7,16,45,58,-13,46
Albion,9298,7,12,8,16,47,51,-4,44
Stenhousem'r,9298,8,12,7,17,48,65,-17,43
Queen's Park,9298,9,9,10,17,32,57,-25,37
East Fife,9298,10,7,13,16,40,46,-6,34
Livingston,9299,1,20,6,10,79,47,32,66
Alloa,9299,2,18,8,10,74,54,20,62
Airdrieon,9299,3,16,8,12,58,52,6,56
Brechin,9299,4,17,5,14,51,48,3,56
Peterhead,9299,5,14,10,12,46,49,-3,52
Queen's Park,9299,6,15,7,14,48,52,-4,52
Albion,9299,7,13,10,13,49,44,5,49
East Fife,9299,8,12,8,16,49,48,1,44
Stranraer,9299,9,9,8,19,45,64,-19,35
Stenhousem'r,9299,10,5,12,19,43,84,-41,27
Alloa,9300,1,18,9,9,70,44,26,63
Livingston,9300,2,19,5,12,72,50,22,62
Airdrieon,9300,3,18,6,12,49,44,5,60
Brechin,9300,4,16,4,16,45,46,-1,52
Stranraer,9300,5,15,5,16,57,54,3,50
Albion,9300,6,14,6,16,56,66,-10,48
East Fife,9300,7,12,9,15,50,52,-2,45
Peterhead,9300,8,12,8,16,53,58,-5,44
Queen's Park,9300,9,13,5,18,36,51,-15,44
Stenhousem'r,9300,10,10,9,17,52,75,-23,39
Livingston,9301,1,24,5,7,84,49,35,77
Airdrieon,9301,2,17,7,12,63,51,12,58
Brechin,9301,3,17,6,13,49,52,-3,57
East Fife,9301,4,16,8,12,52,35,17,56
Alloa,9301,5,16,4,16,64,58,6,52
Stranraer,9301,6,15,3,18,52,50,2,48
Albion,9301,7,13,9,14,53,57,-4,48
Peterhead,9301,8,12,6,18,45,56,-11,42
Queen's Park,9301,9,10,7,19,39,62,-23,37
Stenhousem'r,9301,10,9,7,20,44,75,-31,34
Alloa,9302,1,19,8,9,67,39,28,65
Livingston,9302,2,20,3,13,66,45,21,63
Brechin,9302,3,18,6,12,50,45,5,60
Peterhead,9302,4,15,9,12,51,50,1,54
Airdrieon,9302,5,16,5,15,53,53,0,53
Albion,9302,6,16,4,16,57,57,0,52
East Fife,9302,7,14,8,14,56,52,4,50
Queen's Park,9302,8,13,5,18,38,51,-13,44
Stenhousem'r,9302,9,9,8,19,49,78,-29,35
Stranraer,9302,10,10,4,22,46,63,-17,34
Alloa,9303,1,21,7,8,76,49,27,70
Livingston,9303,2,21,3,12,76,50,26,66
Airdrieon,9303,3,19,6,11,68,54,14,63
Stranraer,9303,4,15,7,14,58,55,3,52
Brechin,9303,5,14,7,15,40,48,-8,49
Peterhead,9303,6,14,6,16,58,62,-4,48
Albion,9303,7,13,8,15,50,50,0,47
East Fife,9303,8,13,7,16,50,51,-1,46
Queen's Park,9303,9,10,6,20,35,54,-19,36
Stenhousem'r,9303,10,9,5,22,50,88,-38,32
Alloa,9304,1,18,10,8,74,44,30,64
Brechin,9304,2,19,6,11,56,41,15,63
Airdrieon,9304,3,18,6,12,64,51,13,60
Livingston,9304,4,18,6,12,60,48,12,60
Albion,9304,5,15,9,12,60,48,12,54
East Fife,9304,6,13,9,14,53,44,9,48
Queen's Park,9304,7,11,7,18,37,58,-21,40
Peterhead,9304,8,10,9,17,43,64,-21,39
Stranraer,9304,9,9,10,17,45,62,-17,37
Stenhousem'r,9304,10,8,10,18,42,74,-32,34
Alloa,9305,1,22,6,8,70,41,29,72
Livingston,9305,2,18,5,13,78,53,25,59
Brechin,9305,3,16,7,13,52,52,0,55
Stranraer,9305,4,16,6,14,62,47,15,54
Albion,9305,5,14,11,11,62,54,8,53
Peterhead,9305,6,14,7,15,51,53,-2,49
East Fife,9305,7,13,9,14,48,47,1,48
Airdrieon,9305,8,13,8,15,58,66,-8,47
Queen's Park,9305,9,10,10,16,42,67,-25,40
Stenhousem'r,9305,10,6,7,23,48,91,-43,25
Livingston,9306,1,21,6,9,82,49,33,69
Brechin,9306,2,19,4,13,60,47,13,61
Alloa,9306,3,18,5,13,71,53,18,59
Peterhead,9306,4,15,7,14,53,49,4,52
Airdrieon,9306,5,14,6,16,52,54,-2,48
East Fife,9306,6,12,10,14,43,48,-5,46
Stranraer,9306,7,13,6,17,59,68,-9,45
Albion,9306,8,11,10,15,47,62,-15,43
Stenhousem'r,9306,9,11,8,17,48,66,-18,41
Queen's Park,9306,10,9,12,15,37,56,-19,39
Livingston,9307,1,21,7,8,82,46,36,70
Alloa,9307,2,18,10,8,69,41,28,64
Airdrieon,9307,3,17,7,12,61,58,3,58
Stranraer,9307,4,17,6,13,49,53,-4,57
Brechin,9307,5,13,8,15,40,47,-7,47
Peterhead,9307,6,11,10,15,42,58,-16,43
Queen's Park,9307,7,11,9,16,42,50,-8,42
East Fife,9307,8,10,11,15,57,54,3,41
Albion,9307,9,11,8,17,48,64,-16,41
Stenhousem'r,9307,10,10,6,20,60,79,-19,36
Brechin,9308,1,20,8,8,59,38,21,68
Livingston,9308,2,21,4,11,73,48,25,67
Alloa,9308,3,20,5,11,67,46,21,65
Airdrieon,9308,4,16,7,13,61,57,4,55
Peterhead,9308,5,14,11,11,51,45,6,53
Albion,9308,6,11,10,15,52,53,-1,43
Stenhousem'r,9308,7,11,8,17,56,79,-23,41
East Fife,9308,8,11,6,19,44,45,-1,39
Queen's Park,9308,9,10,8,18,34,59,-25,38
Stranraer,9308,10,8,9,19,34,61,-27,33
Livingston,9309,1,21,4,11,78,48,30,67
Alloa,9309,2,19,8,9,66,42,24,65
Airdrieon,9309,3,17,5,14,61,59,2,56
Queen's Park,9309,4,16,8,12,35,38,-3,56
Albion,9309,5,15,9,12,59,52,7,54
Brechin,9309,6,15,6,15,51,52,-1,51
Stranraer,9309,7,15,4,17,48,55,-7,49
East Fife,9309,8,10,9,17,52,57,-5,39
Peterhead,9309,9,11,6,19,47,61,-14,39
Stenhousem'r,9309,10,8,7,21,42,75,-33,31
Livingston,9310,1,23,4,9,74,40,34,73
Airdrieon,9310,2,20,8,8,68,45,23,68
Peterhead,9310,3,14,11,11,50,48,2,53
Alloa,9310,4,14,8,14,64,50,14,50
East Fife,9310,5,13,9,14,48,43,5,48
Queen's Park,9310,6,14,6,16,40,49,-9,48
Albion,9310,7,12,9,15,57,60,-3,45
Brechin,9310,8,13,6,17,41,56,-15,45
Stranraer,9310,9,11,7,18,51,58,-7,40
Stenhousem'r,9310,10,6,12,18,36,80,-44,30
Albion,9311,1,17,11,8,62,46,16,62
Alloa,9311,2,19,4,13,64,50,14,61
Peterhead,9311,3,17,8,11,53,40,13,59
Airdrieon,9311,4,17,8,11,56,50,6,59
Livingston,9311,5,18,4,14,79,57,22,58
Stranraer,9311,6,15,5,16,46,50,-4,50
Brechin,9311,7,13,8,15,44,47,-3,47
Queen's Park,9311,8,13,6,17,41,50,-9,45
East Fife,9311,9,10,10,16,45,50,-5,40
Stenhousem'r,9311,10,5,8,23,33,83,-50,23
Alloa,9312,1,21,8,7,77,46,31,71
Livingston,9312,2,20,4,12,70,47,23,64
Albion,9312,3,16,7,13,60,53,7,55
Brechin,9312,4,16,6,14,46,49,-3,54
Airdrieon,9312,5,15,7,14,58,50,8,52
Stranraer,9312,6,14,7,15,44,46,-2,49
Queen's Park,9312,7,13,8,15,36,52,-16,47
Peterhead,9312,8,12,10,14,46,51,-5,46
East Fife,9312,9,11,11,14,56,56,0,44
Stenhousem'r,9312,10,3,10,23,34,77,-43,19
Alloa,9313,1,20,8,8,74,46,28,68
Brechin,9313,2,19,7,10,52,39,13,64
Livingston,9313,3,18,6,12,71,50,21,60
Airdrieon,9313,4,17,5,14,66,62,4,56
Albion,9313,5,16,8,12,54,51,3,56
East Fife,9313,6,12,7,17,51,54,-3,43
Peterhead,9313,7,10,11,15,48,60,-12,41
Queen's Park,9313,8,11,7,18,33,51,-18,40
Stranraer,9313,9,10,9,17,45,57,-12,39
Stenhousem'r,9313,10,10,6,20,57,81,-24,36
Alloa,9314,1,21,7,8,76,40,36,70
Livingston,9314,2,22,4,10,76,44,32,70
Airdrieon,9314,3,19,4,13,61,55,6,61
Queen's Park,9314,4,16,6,14,49,51,-2,54
Stranraer,9314,5,15,6,15,48,51,-3,51
Albion,9314,6,14,7,15,52,52,0,49
Brechin,9314,7,15,4,17,46,57,-11,49
East Fife,9314,8,11,11,14,45,41,4,44
Peterhead,9314,9,11,6,19,46,62,-16,39
Stenhousem'r,9314,10,6,5,25,40,86,-46,23
Livingston,9315,1,22,7,7,73,38,35,73
Alloa,9315,2,20,8,8,71,33,38,68
Peterhead,9315,3,17,7,12,51,43,8,58
Brechin,9315,4,17,5,14,48,49,-1,56
Airdrieon,9315,5,15,7,14,59,57,2,52
Albion,9315,6,12,11,13,50,52,-2,47
East Fife,9315,7,12,9,15,47,55,-8,45
Queen's Park,9315,8,10,7,19,35,52,-17,37
Stenhousem'r,9315,9,9,9,18,50,79,-29,36
Stranraer,9315,10,7,8,21,44,70,-26,29
Livingston,9316,1,26,4,6,84,44,40,82
Alloa,9316,2,19,7,10,72,47,25,64
Airdrieon,9316,3,17,7,12,65,50,15,58
Peterhead,9316,4,15,9,12,57,50,7,54
Brechin,9316,5,16,6,14,51,55,-4,54
Albion,9316,6,14,6,16,53,53,0,48
Stranraer,9316,7,13,4,19,57,61,-4,43
Queen's Park,9316,8,12,6,18,34,56,-22,42
East Fife,9316,9,8,9,19,43,54,-11,33
Stenhousem'r,9316,10,7,8,21,41,87,-46,29
Livingston,9317,1,24,4,8,81,42,39,76
Alloa,9317,2,23,3,10,71,39,32,72
Albion,9317,3,17,7,12,61,52,9,58
Airdrieon,9317,4,17,5,14,59,62,-3,56
Stranraer,9317,5,17,3,16,58,59,-1,54
Brechin,9317,6,16,2,18,50,52,-2,50
Peterhead,9317,7,12,6,18,50,59,-9,42
Queen's Park,9317,8,12,5,19,36,54,-18,41
East Fife,9317,9,9,8,19,43,54,-11,35
Stenhousem'r,9317,10,9,5,22,50,86,-36,32
Alloa,9318,1,20,7,9,67,39,28,67
Airdrieon,9318,2,20,5,11,58,43,15,65
Livingston,9318,3,18,6,12,71,51,20,60
Queen's Park,9318,4,16,6,14,49,51,-2,54
Brechin,9318,5,15,7,14,54,55,-1,52
Stranraer,9318,6,14,6,16,49,56,-7,48
Albion,9318,7,13,8,15,53,52,1,47
East Fife,9318,8,11,10,15,49,54,-5,43
Peterhead,9318,9,11,8,17,53,62,-9,41
Stenhousem'r,9318,10,7,7,22,50,90,-40,28
Alloa,9319,1,26,4,6,83,39,44,82
Livingston,9319,2,20,4,12,69,45,24,64
Peterhead,9319,3,15,7,14,47,48,-1,52
Albion,9319,4,14,8,14,56,52,4,50
East Fife,9319,5,14,7,15,49,49,0,49
Brechin,9319,6,16,1,19,51,59,-8,49
Stranraer,9319,7,14,5,17,53,58,-5,47
Queen's Park,9319,8,14,5,17,39,48,-9,47
Airdrieon,9319,9,14,5,17,50,61,-11,47
Stenhousem'r,9319,10,6,8,22,43,81,-38,26
Livingston,9320,1,23,5,8,79,50,29,74
Alloa,9320,2,23,3,10,81,51,30,72
Peterhead,9320,3,18,4,14,57,54,3,58
Airdrieon,9320,4,17,6,13,59,52,7,57
Albion,9320,5,15,7,14,52,48,4,52
East Fife,9320,6,14,8,14,54,41,13,50
Brechin,9320,7,12,9,15,52,56,-4,45
Stenhousem'r,9320,8,9,9,18,54,83,-29,36
Stranraer,9320,9,10,4,22,48,76,-28,34
Queen's Park,9320,10,9,5,22,33,58,-25,32
Alloa,9321,1,22,8,6,81,40,41,74
Livingston,9321,2,22,5,9,75,46,29,71
Airdrieon,9321,3,19,5,12,61,46,15,62
Brechin,9321,4,15,8,13,58,61,-3,53
Peterhead,9321,5,12,10,14,54,55,-1,46
Albion,9321,6,12,8,16,51,63,-12,44
Queen's Park,9321,7,12,6,18,35,51,-16,42
East Fife,9321,8,10,11,15,50,56,-6,41
Stenhousem'r,9321,9,11,4,21,50,84,-34,37
Stranraer,9321,10,11,3,22,46,59,-13,36
Livingston,9322,1,20,2,14,75,52,23,62
Alloa,9322,2,15,11,10,70,52,18,56
Brechin,9322,3,16,5,15,51,42,9,53
Albion,9322,4,15,8,13,60,54,6,53
Airdrieon,9322,5,15,8,13,56,62,-6,53
Peterhead,9322,6,14,10,12,55,59,-4,52
Stranraer,9322,7,14,6,16,51,59,-8,48
Queen's Park,9322,8,12,7,17,47,68,-21,43
Stenhousem'r,9322,9,10,12,14,54,68,-14,42
East Fife,9322,10,10,9,17,53,56,-3,39
Livingston,9323,1,20,5,11,72,47,25,65
Alloa,9323,2,19,6,11,70,43,27,63
Airdrieon,9323,3,17,8,11,60,57,3,59
Albion,9323,4,15,8,13,63,59,4,53
Stranraer,9323,5,15,6,15,61,63,-2,51
Brechin,9323,6,14,7,15,49,52,-3,49
East Fife,9323,7,12,10,14,52,48,4,46
Peterhead,9323,8,11,9,16,52,61,-9,42
Queen's Park,9323,9,10,9,17,35,55,-20,39
Stenhousem'r,9323,10,9,8,19,56,85,-29,35
Alloa,9324,1,19,8,9,68,41,27,65
Airdrieon,9324,2,19,8,9,65,49,16,65
Livingston,9324,3,18,5,13,73,50,23,59
Brechin,9324,4,16,6,14,47,45,2,54
Peterhead,9324,5,14,7,15,50,58,-8,49
Queen's Park,9324,6,14,5,17,47,62,-15,47
East Fife,9324,7,11,10,15,47,47,0,43
Stranraer,9324,8,12,7,17,50,57,-7,43
Albion,9324,9,11,10,15,41,50,-9,43
Stenhousem'r,9324,10,9,8,19,57,86,-29,35
Livingston,9325,1,22,3,11,83,52,31,69
Alloa,9325,2,17,9,10,70,48,22,60
Brechin,9325,3,18,6,12,50,49,1,60
Airdrieon,9325,4,14,11,11,65,55,10,53
Stranraer,9325,5,15,7,14,58,56,2,52
East Fife,9325,6,14,9,13,52,47,5,51
Albion,9325,7,14,7,15,55,54,1,49
Peterhead,9325,8,13,9,14,48,54,-6,48
Queen's Park,9325,9,11,10,15,47,65,-18,43
Stenhousem'r,9325,10,2,9,25,33,81,-48,15
Livingston,9326,1,24,1,11,87,48,39,73
Alloa,9326,2,20,7,9,74,46,28,67
Albion,9326,3,17,6,13,48,45,3,57
Brechin,9326,4,16,5,15,46,47,-1,53
Airdrieon,9326,5,16,5,15,55,61,-6,53
Stranraer,9326,6,14,6,16,56,66,-10,48
East Fife,9326,7,11,10,15,51,49,2,43
Queen's Park,9326,8,11,10,15,38,47,-9,43
Peterhead,9326,9,10,6,20,46,62,-16,36
Stenhousem'r,9326,10,9,8,19,50,80,-30,35
Alloa,9327,1,20,5,11,73,40,33,65
Brechin,9327,2,19,6,11,51,43,8,63
Livingston,9327,3,17,5,14,68,51,17,56
Peterhead,9327,4,17,5,14,52,49,3,56
Airdrieon,9327,5,16,6,14,60,55,5,54
East Fife,9327,6,13,11,12,49,40,9,50
Stranraer,9327,7,14,3,19,46,58,-12,45
Queen's Park,9327,8,13,5,18,39,59,-20,44
Albion,9327,9,11,10,15,52,59,-7,43
Stenhousem'r,9327,10,9,6,21,46,82,-36,33
Livingston,9328,1,23,5,8,77,48,29,74
Alloa,9328,2,22,5,9,81,46,35,71
Brechin,9328,3,19,5,12,56,42,14,62
Peterhead,9328,4,17,8,11,53,45,8,59
Airdrieon,9328,5,16,6,14,61,63,-2,54
Albion,9328,6,14,10,12,48,50,-2,52
East Fife,9328,7,10,8,18,51,56,-5,38
Stranraer,9328,8,10,6,20,49,63,-14,36
Queen's Park,9328,9,9,6,21,33,56,-23,33
Stenhousem'r,9328,10,6,9,21,39,79,-40,27
Alloa,9329,1,22,7,7,81,37,44,73
Livingston,9329,2,18,7,11,75,54,21,61
Brechin,9329,3,16,8,12,54,50,4,56
Airdrieon,9329,4,16,5,15,58,68,-10,53
Stranraer,9329,5,16,2,18,51,52,-1,50
Peterhead,9329,6,13,10,13,52,57,-5,49
Albion,9329,7,11,14,11,53,55,-2,47
Queen's Park,9329,8,13,7,16,46,51,-5,46
East Fife,9329,9,9,13,14,49,52,-3,40
Stenhousem'r,9329,10,6,7,23,46,89,-43,25
Brechin,9330,1,22,6,8,52,30,22,72
Alloa,9330,2,20,8,8,68,48,20,68
Airdrieon,9330,3,19,8,9,64,44,20,65
Albion,9330,4,16,9,11,59,46,13,57
Livingston,9330,5,17,3,16,71,66,5,54
Peterhead,9330,6,11,13,12,42,47,-5,46
East Fife,9330,7,11,8,17,53,53,0,41
Stenhousem'r,9330,8,10,7,19,52,76,-24,37
Stranraer,9330,9,9,6,21,46,70,-24,33
Queen's Park,9330,10,8,6,22,30,57,-27,30
Alloa,9331,1,21,7,8,75,38,37,70
Airdrieon,9331,2,18,8,10,63,45,18,62
Brechin,9331,3,18,7,11,49,44,5,61
Livingston,9331,4,17,9,10,70,54,16,60
Peterhead,9331,5,18,6,12,57,48,9,60
Albion,9331,6,11,10,15,45,53,-8,43
Queen's Park,9331,7,11,7,18,42,58,-16,40
East Fife,9331,8,9,10,17,41,51,-10,37
Stranraer,9331,9,10,5,21,46,61,-15,35
Stenhousem'r,9331,10,9,7,20,41,77,-36,34
Brechin,9332,1,19,7,10,68,41,27,64
Livingston,9332,2,19,6,11,70,53,17,63
Alloa,9332,3,17,10,9,63,46,17,61
Airdrieon,9332,4,17,5,14,55,50,5,56
Albion,9332,5,14,9,13,52,53,-1,51
Queen's Park,9332,6,13,9,14,34,44,-10,48
Peterhead,9332,7,11,10,15,44,52,-8,43
Stenhousem'r,9332,8,9,11,16,53,70,-17,38
East Fife,9332,9,9,10,17,51,61,-10,37
Stranraer,9332,10,9,9,18,45,65,-20,36
Livingston,9333,1,18,9,9,78,48,30,63
Airdrieon,9333,2,17,8,11,61,54,7,59
Alloa,9333,3,16,9,11,69,49,20,57
Peterhead,9333,4,14,10,12,53,52,1,52
Queen's Park,9333,5,15,7,14,40,45,-5,52
Stranraer,9333,6,15,6,15,61,57,4,51
Brechin,9333,7,15,6,15,47,54,-7,51
East Fife,9333,8,11,11,14,53,54,-1,44
Albion,9333,9,11,7,18,58,67,-9,40
Stenhousem'r,9333,10,7,9,20,44,84,-40,30
Alloa,9334,1,21,7,8,83,45,38,70
Livingston,9334,2,22,1,13,74,50,24,67
Peterhead,9334,3,18,6,12,59,55,4,60
Airdrieon,9334,4,17,7,12,62,46,16,58
Brechin,9334,5,16,4,16,45,54,-9,52
Albion,9334,6,14,7,15,47,53,-6,49
East Fife,9334,7,12,8,16,49,44,5,44
Queen's Park,9334,8,11,7,18,38,56,-18,40
Stenhousem'r,9334,9,10,6,20,46,81,-35,36
Stranraer,9334,10,9,7,20,43,62,-19,34
Livingston,9335,1,22,2,12,78,54,24,68
Alloa,9335,2,20,5,11,76,44,32,65
Brechin,9335,3,20,5,11,54,43,11,65
Airdrieon,9335,4,18,5,13,54,50,4,59
Queen's Park,9335,5,16,5,15,47,49,-2,53
Peterhead,9335,6,14,6,16,55,61,-6,48
East Fife,9335,7,11,13,12,59,52,7,46
Albion,9335,8,13,7,16,55,59,-4,46
Stranraer,9335,9,12,3,21,41,63,-22,39
Stenhousem'r,9335,10,6,5,25,49,93,-44,23
Livingston,9336,1,23,3,10,78,48,30,72
Alloa,9336,2,20,5,11,79,47,32,65
Brechin,9336,3,18,8,10,48,42,6,62
East Fife,9336,4,15,7,14,53,50,3,52
Airdrieon,9336,5,14,7,15,62,60,2,49
Albion,9336,6,13,9,14,57,49,8,48
Queen's Park,9336,7,14,5,17,37,51,-14,47
Peterhead,9336,8,11,8,17,42,62,-20,41
Stenhousem'r,9336,9,10,7,19,48,79,-31,37
Stranraer,9336,10,11,3,22,52,68,-16,36
Livingston,9337,1,22,6,8,81,50,31,72
Alloa,9337,2,20,10,6,71,39,32,70
Airdrieon,9337,3,20,7,9,78,41,37,67
Peterhead,9337,4,16,12,8,48,39,9,60
Brechin,9337,5,13,6,17,47,62,-15,45
Stranraer,9337,6,13,4,19,50,65,-15,43
East Fife,9337,7,10,10,16,45,53,-8,40
Queen's Park,9337,8,11,6,19,39,53,-14,39
Albion,9337,9,10,9,17,52,68,-16,39
Stenhousem'r,9337,10,7,6,23,39,80,-41,27
Alloa,9338,1,19,10,7,74,46,28,67
Livingston,9338,2,20,5,11,79,51,28,65
Brechin,9338,3,16,9,11,48,41,7,57
Peterhead,9338,4,16,7,13,58,57,1,55
East Fife,9338,5,15,8,13,58,47,11,53
Airdrieon,9338,6,15,7,14,59,58,1,52
Albion,9338,7,13,9,14,61,58,3,48
Stranraer,9338,8,10,8,18,46,59,-13,38
Queen's Park,9338,9,10,7,19,40,69,-29,37
Stenhousem'r,9338,10,8,6,22,40,77,-37,30
Livingston,9339,1,22,7,7,78,45,33,73
Alloa,9339,2,18,8,10,73,47,26,62
Peterhead,9339,3,16,7,13,57,52,5,55
Airdrieon,9339,4,14,12,10,57,55,2,54
Queen's Park,9339,5,16,6,14,52,51,1,54
Stranraer,9339,6,13,8,15,55,60,-5,47
East Fife,9339,7,10,12,14,49,53,-4,42
Brechin,9339,8,11,9,16,45,56,-11,42
Albion,9339,9,10,10,16,51,62,-11,40
Stenhousem'r,9339,10,6,9,21,41,77,-36,27
Livingston,9340,1,22,4,10,92,52,40,70
Alloa,9340,2,19,9,8,80,45,35,66
Brechin,9340,3,18,7,11,57,55,2,61
Airdrieon,9340,4,17,5,14,67,62,5,56
Peterhead,9340,5,13,12,11,44,51,-7,51
Albion,9340,6,13,10,13,61,58,3,49
East Fife,9340,7,12,10,14,55,49,6,46
Stranraer,9340,8,11,4,21,50,72,-22,37
Queen's Park,9340,9,9,7,20,31,52,-21,34
Stenhousem'r,9340,10,8,8,20,43,84,-41,32
Airdrieon,9341,1,19,8,9,63,46,17,65
Brechin,9341,2,18,6,12,50,40,10,60
Alloa,9341,3,17,8,11,61,42,19,59
Livingston,9341,4,16,8,12,65,47,18,56
Peterhead,9341,5,15,9,12,51,51,0,54
East Fife,9341,6,14,7,15,51,49,2,49
Albion,9341,7,13,8,15,52,52,0,47
Stenhousem'r,9341,8,11,6,19,58,75,-17,39
Stranraer,9341,9,11,5,20,44,67,-23,38
Queen's Park,9341,10,9,9,18,31,57,-26,36
Livingston,9342,1,24,2,10,76,46,30,74
Alloa,9342,2,17,8,11,63,47,16,59
Brechin,9342,3,18,4,14,50,47,3,58
Airdrieon,9342,4,17,3,16,53,58,-5,54
Albion,9342,5,14,10,12,65,57,8,52
Peterhead,9342,6,13,8,15,49,50,-1,47
Queen's Park,9342,7,12,10,14,42,52,-10,46
East Fife,9342,8,12,8,16,50,49,1,44
Stranraer,9342,9,10,8,18,48,59,-11,38
Stenhousem'r,9342,10,8,9,19,47,78,-31,33
Livingston,9343,1,20,5,11,78,58,20,65
Airdrieon,9343,2,18,7,11,58,45,13,61
Alloa,9343,3,17,9,10,66,45,21,60
Albion,9343,4,16,9,11,55,44,11,57
Brechin,9343,5,15,10,11,45,47,-2,55
Peterhead,9343,6,14,10,12,48,46,2,52
East Fife,9343,7,12,8,16,48,48,0,44
Queen's Park,9343,8,11,9,16,37,50,-13,42
Stranraer,9343,9,11,7,18,46,54,-8,40
Stenhousem'r,9343,10,6,6,24,39,83,-44,24
Livingston,9344,1,24,5,7,89,44,45,77
Peterhead,9344,2,15,9,12,44,49,-5,54
East Fife,9344,3,15,8,13,56,45,11,53
Airdrieon,9344,4,16,5,15,58,56,2,53
Albion,9344,5,14,10,12,53,46,7,52
Brechin,9344,6,16,4,16,60,59,1,52
Alloa,9344,7,15,6,15,65,64,1,51
Stranraer,9344,8,13,2,21,42,56,-14,41
Queen's Park,9344,9,9,11,16,41,59,-18,38
Stenhousem'r,9344,10,8,10,18,41,71,-30,34
Livingston,9345,1,23,4,9,86,51,35,73
Brechin,9345,2,17,7,12,58,46,12,58
Airdrieon,9345,3,17,5,14,58,49,9,56
East Fife,9345,4,15,9,12,53,45,8,54
Alloa,9345,5,15,8,13,66,56,10,53
Stranraer,9345,6,15,7,14,53,57,-4,52
Peterhead,9345,7,12,8,16,46,56,-10,44
Albion,9345,8,12,7,17,52,60,-8,43
Queen's Park,9345,9,11,8,17,38,53,-15,41
Stenhousem'r,9345,10,8,7,21,51,88,-37,31
Alloa,9346,1,20,7,9,72,42,30,67
Livingston,9346,2,19,7,10,77,52,25,64
Peterhead,9346,3,16,11,9,47,40,7,59
Brechin,9346,4,15,8,13,52,48,4,53
Airdrieon,9346,5,15,7,14,50,62,-12,52
Stranraer,9346,6,14,7,15,54,57,-3,49
Albion,9346,7,11,11,14,50,53,-3,44
East Fife,9346,8,10,10,16,42,45,-3,40
Queen's Park,9346,9,11,6,19,42,57,-15,39
Stenhousem'r,9346,10,9,6,21,45,75,-30,33
Alloa,9347,1,22,8,6,75,36,39,74
Livingston,9347,2,21,7,8,77,46,31,70
Albion,9347,3,17,5,14,54,52,2,56
Brechin,9347,4,17,3,16,48,47,1,54
Peterhead,9347,5,15,6,15,53,52,1,51
Queen's Park,9347,6,13,9,14,33,43,-10,48
East Fife,9347,7,13,7,16,47,41,6,46
Airdrieon,9347,8,12,6,18,51,68,-17,42
Stranraer,9347,9,12,5,19,52,63,-11,41
Stenhousem'r,9347,10,6,8,22,37,79,-42,26
Livingston,9348,1,24,6,6,87,48,39,78
Alloa,9348,2,18,10,8,72,35,37,64
Brechin,9348,3,16,8,12,47,54,-7,56
Stranraer,9348,4,15,5,16,56,61,-5,50
Airdrieon,9348,5,13,10,13,58,58,0,49
Peterhead,9348,6,14,7,15,52,52,0,49
Albion,9348,7,13,10,13,54,56,-2,49
Queen's Park,9348,8,13,5,18,42,60,-18,44
East Fife,9348,9,8,11,17,51,59,-8,35
Stenhousem'r,9348,10,5,10,21,39,75,-36,25
Livingston,9349,1,24,3,9,91,48,43,75
Airdrieon,9349,2,18,5,13,60,56,4,59
Alloa,9349,3,14,12,10,63,45,18,54
Albion,9349,4,15,9,12,56,50,6,54
East Fife,9349,5,14,9,13,55,45,10,51
Queen's Park,9349,6,13,10,13,45,49,-4,49
Brechin,9349,7,14,5,17,44,53,-9,47
Stranraer,9349,8,13,6,17,48,58,-10,45
Peterhead,9349,9,12,8,16,48,57,-9,44
Stenhousem'r,9349,10,7,5,24,45,94,-49,26
Livingston,9350,1,20,5,11,84,58,26,65
Alloa,9350,2,18,10,8,68,41,27,64
Peterhead,9350,3,16,9,11,52,53,-1,57
Airdrieon,9350,4,16,8,12,54,45,9,56
Albion,9350,5,12,11,13,51,51,0,47
Brechin,9350,6,11,14,11,40,45,-5,47
Stranraer,9350,7,12,10,14,60,56,4,46
Queen's Park,9350,8,10,11,15,34,51,-17,41
East Fife,9350,9,10,9,17,46,55,-9,39
Stenhousem'r,9350,10,6,11,19,42,76,-34,29
Livingston,9351,1,24,2,10,78,45,33,74
Alloa,9351,2,18,8,10,86,53,33,62
Albion,9351,3,17,9,10,65,49,16,60
Airdrieon,9351,4,17,6,13,61,53,8,57
Brechin,9351,5,16,2,18,53,58,-5,50
East Fife,9351,6,13,9,14,47,50,-3,48
Peterhead,9351,7,12,8,16,56,65,-9,44
Queen's Park,9351,8,13,5,18,46,64,-18,44
Stranraer,9351,9,12,5,19,53,70,-17,41
Stenhousem'r,9351,10,8,6,22,48,86,-38,30
Alloa,9352,1,20,9,7,75,43,32,69
Livingston,9352,2,19,7,10,72,46,26,64
Brechin,9352,3,17,6,13,54,48,6,57
Stranraer,9352,4,17,5,14,57,57,0,56
Airdrieon,9352,5,16,7,13,56,59,-3,55
Albion,9352,6,10,12,14,48,53,-5,42
Queen's Park,9352,7,11,9,16,37,54,-17,42
East Fife,9352,8,11,8,17,48,49,-1,41
Peterhead,9352,9,11,8,17,45,55,-10,41
Stenhousem'r,9352,10,10,5,21,52,80,-28,35
Livingston,9353,1,27,0,9,80,40,40,81
Peterhead,9353,2,19,7,10,57,42,15,64
Airdrieon,9353,3,16,8,12,61,59,2,56
Stranraer,9353,4,16,7,13,48,47,1,55
Alloa,9353,5,14,9,13,67,51,16,51
Brechin,9353,6,15,5,16,45,52,-7,50
Queen's Park,9353,7,11,9,16,32,46,-14,42
East Fife,9353,8,10,9,17,52,53,-1,39
Albion,9353,9,9,10,17,42,53,-11,37
Stenhousem'r,9353,10,8,6,22,41,82,-41,30
Livingston,9354,1,21,4,11,68,42,26,67
Alloa,9354,2,20,6,10,72,41,31,66
Albion,9354,3,18,8,10,58,43,15,62
Airdrieon,9354,4,17,5,14,57,51,6,56
Peterhead,9354,5,16,6,14,51,57,-6,54
Brechin,9354,6,15,4,17,53,52,1,49
Stranraer,9354,7,14,5,17,54,62,-8,47
Queen's Park,9354,8,11,9,16,34,48,-14,42
East Fife,9354,9,8,13,15,40,50,-10,37
Stenhousem'r,9354,10,5,10,21,36,77,-41,25
Livingston,9355,1,20,6,10,75,50,25,66
Alloa,9355,2,19,6,11,76,53,23,63
Brechin,9355,3,18,8,10,60,48,12,62
Airdrieon,9355,4,17,10,9,60,53,7,61
Peterhead,9355,5,13,9,14,59,59,0,48
Albion,9355,6,12,10,14,60,53,7,46
Stranraer,9355,7,13,7,16,50,57,-7,46
Queen's Park,9355,8,11,8,17,43,62,-19,41
East Fife,9355,9,11,7,18,50,59,-9,40
Stenhousem'r,9355,10,7,7,22,49,88,-39,28
Alloa,9356,1,20,4,12,75,52,23,64
Airdrieon,9356,2,18,9,9,56,47,9,63
Livingston,9356,3,18,8,10,72,50,22,62
Stranraer,9356,4,18,6,12,65,59,6,60
Peterhead,9356,5,14,9,13,54,49,5,51
Brechin,9356,6,15,6,15,49,45,4,51
East Fife,9356,7,14,8,14,44,37,7,50
Albion,9356,8,10,11,15,48,58,-10,41
Queen's Park,9356,9,11,6,19,35,56,-21,39
Stenhousem'r,9356,10,5,7,24,32,77,-45,22
Alloa,9357,1,23,5,8,70,34,36,74
Livingston,9357,2,21,4,11,81,51,30,67
Airdrieon,9357,3,20,5,11,59,47,12,65
Brechin,9357,4,19,3,14,51,44,7,60
Albion,9357,5,14,8,14,53,58,-5,50
East Fife,9357,6,11,9,16,51,48,3,42
Queen's Park,9357,7,12,6,18,41,56,-15,42
Stranraer,9357,8,11,7,18,41,55,-14,40
Peterhead,9357,9,10,9,17,43,59,-16,39
Stenhousem'r,9357,10,7,8,21,47,85,-38,29
Livingston,9358,1,21,5,10,71,46,25,68
Brechin,9358,2,21,4,11,55,43,12,67
Airdrieon,9358,3,17,10,9,57,47,10,61
Alloa,9358,4,16,9,11,61,40,21,57
Albion,9358,5,17,5,14,53,45,8,56
Stranraer,9358,6,14,7,15,57,59,-2,49
East Fife,9358,7,13,8,15,52,44,8,47
Peterhead,9358,8,11,8,17,47,59,-12,41
Queen's Park,9358,9,10,7,19,30,55,-25,37
Stenhousem'r,9358,10,4,9,23,43,88,-45,21
Alloa,9359,1,21,6,9,69,44,25,69
Livingston,9359,2,18,6,12,63,40,23,60
Airdrieon,9359,3,17,8,11,54,49,5,59
Brechin,9359,4,18,4,14,50,50,0,58
Albion,9359,5,15,7,14,53,51,2,52
Peterhead,9359,6,13,8,15,48,50,-2,47
Stranraer,9359,7,12,8,16,43,55,-12,44
East Fife,9359,8,9,13,14,48,52,-4,40
Queen's Park,9359,9,11,6,19,48,62,-14,39
Stenhousem'r,9359,10,9,8,19,41,64,-23,35
Alloa,9360,1,23,8,5,81,37,44,77
Livingston,9360,2,22,3,11,78,53,25,69
Airdrieon,9360,3,16,7,13,58,52,6,55
Albion,9360,4,14,6,16,57,56,1,48
Peterhead,9360,5,13,9,14,45,51,-6,48
Brechin,9360,6,13,9,14,48,56,-8,48
Stranraer,9360,7,13,6,17,60,72,-12,45
East Fife,9360,8,10,10,16,46,48,-2,40
Queen's Park,9360,9,11,7,18,36,53,-17,40
Stenhousem'r,9360,10,9,7,20,50,81,-31,34
Livingston,9361,1,22,5,9,77,44,33,71
Airdrieon,9361,2,18,4,14,63,56,7,58
Peterhead,9361,3,15,9,12,54,49,5,54
Alloa,9361,4,14,10,12,67,55,12,52
Stranraer,9361,5,14,6,16,51,58,-7,48
Brechin,9361,6,13,7,16,45,57,-12,46
Albion,9361,7,12,9,15,51,51,0,45
East Fife,9361,8,11,12,13,46,47,-1,45
Stenhousem'r,9361,9,12,7,17,58,77,-19,43
Queen's Park,9361,10,10,9,17,35,53,-18,39
Alloa,9362,1,21,7,8,79,43,36,70
Airdrieon,9362,2,18,7,11,64,44,20,61
Brechin,9362,3,17,9,10,49,43,6,60
Livingston,9362,4,16,5,15,68,54,14,53
Peterhead,9362,5,15,8,13,48,53,-5,53
Stranraer,9362,6,13,6,17,54,59,-5,45
East Fife,9362,7,12,8,16,52,58,-6,44
Albion,9362,8,13,5,18,49,59,-10,44
Stenhousem'r,9362,9,12,6,18,57,81,-24,42
Queen's Park,9362,10,10,5,21,35,61,-26,35
Livingston,9363,1,20,7,9,78,48,30,67
Alloa,9363,2,19,8,9,67,45,22,65
Albion,9363,3,17,9,10,58,42,16,60
Peterhead,9363,4,17,8,11,56,50,6,59
Brechin,9363,5,18,5,13,51,48,3,59
Airdrieon,9363,6,16,5,15,60,62,-2,53
Stranraer,9363,7,13,8,15,57,50,7,47
Queen's Park,9363,8,9,7,20,29,53,-24,34
East Fife,9363,9,8,9,19,54,65,-11,33
Stenhousem'r,9363,10,5,10,21,41,88,-47,25
Livingston,9364,1,22,4,10,75,45,30,70
Airdrieon,9364,2,20,6,10,66,48,18,66
Alloa,9364,3,19,6,11,65,42,23,63
Brechin,9364,4,16,10,10,51,38,13,58
Queen's Park,9364,5,16,4,16,41,51,-10,52
Stranraer,9364,6,13,7,16,47,53,-6,46
East Fife,9364,7,12,8,16,43,55,-12,44
Albion,9364,8,10,8,18,48,57,-9,38
Peterhead,9364,9,9,11,16,48,60,-12,38
Stenhousem'r,9364,10,8,6,22,43,78,-35,30
Livingston,9365,1,21,3,12,71,42,29,66
Brechin,9365,2,19,6,11,56,48,8,63
Alloa,9365,3,17,7,12,66,46,20,58
Peterhead,9365,4,17,7,12,52,46,6,58
Airdrieon,9365,5,15,7,14,48,54,-6,52
Albion,9365,6,14,8,14,53,53,0,50
Stenhousem'r,9365,7,11,10,15,49,61,-12,43
Queen's Park,9365,8,12,6,18,39,57,-18,42
East Fife,9365,9,9,10,17,44,52,-8,37
Stranraer,9365,10,9,8,19,46,65,-19,35
Livingston,9366,1,24,3,9,84,48,36,75
Alloa,9366,2,21,7,8,73,39,34,70
Airdrieon,9366,3,20,5,11,73,50,23,65
Albion,9366,4,18,6,12,61,51,10,60
Brechin,9366,5,16,4,16,56,58,-2,52
Peterhead,9366,6,14,9,13,56,58,-2,51
Queen's Park,9366,7,13,6,17,37,49,-12,45
Stranraer,9366,8,10,6,20,49,66,-17,36
East Fife,9366,9,7,9,20,37,59,-22,30
Stenhousem'r,9366,10,7,5,24,42,90,-48,26
Alloa,9367,1,24,6,6,75,34,41,78
Livingston,9367,2,20,6,10,84,51,33,66
Albion,9367,3,17,9,10,64,52,12,60
Airdrieon,9367,4,17,7,12,54,53,1,58
Peterhead,9367,5,16,8,12,61,49,12,56
Brechin,9367,6,16,4,16,48,59,-11,52
East Fife,9367,7,12,8,16,52,49,3,44
Queen's Park,9367,8,9,9,18,40,58,-18,36
Stranraer,9367,9,9,3,24,47,80,-33,30
Stenhousem'r,9367,10,7,6,23,42,82,-40,27
Livingston,9368,1,21,5,10,74,47,27,68
Alloa,9368,2,19,8,9,70,45,25,65
Brechin,9368,3,20,5,11,57,48,9,65
Queen's Park,9368,4,15,8,13,49,45,4,53
Airdrieon,9368,5,15,6,15,49,59,-10,51
Stranraer,9368,6,13,8,15,61,63,-2,47
Peterhead,9368,7,12,11,13,54,57,-3,47
East Fife,9368,8,10,10,16,51,51,0,40
Albion,9368,9,10,10,16,60,62,-2,40
Stenhousem'r,9368,10,6,7,23,41,89,-48,25
Livingston,9369,1,17,11,8,64,39,25,62
Peterhead,9369,2,19,5,12,53,43,10,62
Alloa,9369,3,18,6,12,66,43,23,60
East Fife,9369,4,16,6,14,56,51,5,54
Stranraer,9369,5,15,9,12,53,50,3,54
Brechin,9369,6,16,4,16,48,47,1,52
Airdrieon,9369,7,13,10,13,55,56,-1,49
Albion,9369,8,13,9,14,56,61,-5,48
Queen's Park,9369,9,10,7,19,36,58,-22,37
Stenhousem'r,9369,10,6,7,23,44,83,-39,25
Alloa,9370,1,22,4,10,80,47,33,70
Airdrieon,9370,2,17,9,10,64,53,11,60
Livingston,9370,3,17,8,11,72,52,20,59
Albion,9370,4,16,8,12,57,55,2,56
Brechin,9370,5,15,8,13,55,52,3,53
Queen's Park,9370,6,15,6,15,43,51,-8,51
Peterhead,9370,7,13,10,13,49,51,-2,49
Stranraer,9370,8,11,9,16,59,67,-8,42
East Fife,9370,9,9,10,17,48,51,-3,37
Stenhousem'r,9370,10,4,10,22,42,90,-48,22
Livingston,9371,1,23,6,7,77,41,36,75
Alloa,9371,2,18,8,10,58,37,21,62
Airdrieon,9371,3,15,10,11,50,44,6,55
Peterhead,9371,4,15,10,11,42,40,2,55
Brechin,9371,5,13,10,13,44,43,1,49
Albion,9371,6,14,7,15,47,51,-4,49
East Fife,9371,7,11,10,15,47,45,2,43
Queen's Park,9371,8,11,8,17,35,53,-18,41
Stranraer,9371,9,10,7,19,43,63,-20,37
Stenhousem'r,9371,10,9,6,21,45,71,-26,33
Alloa,9372,1,19,7,10,82,50,32,64
Airdrieon,9372,2,19,7,10,68,52,16,64
Brechin,9372,3,19,6,11,65,54,11,63
Livingston,9372,4,18,2,16,63,55,8,56
Albion,9372,5,15,11,10,52,45,7,56
Stranraer,9372,6,14,4,18,50,61,-11,46
Peterhead,9372,7,11,10,15,46,56,-10,43
Queen's Park,9372,8,11,7,18,35,54,-19,40
East Fife,9372,9,9,12,15,53,50,3,39
Stenhousem'r,9372,10,8,8,20,42,79,-37,32
Livingston,9373,1,25,4,7,88,48,40,79
Alloa,9373,2,19,7,10,68,43,25,64
Airdrieon,9373,3,15,10,11,47,43,4,55
Queen's Park,9373,4,16,6,14,42,47,-5,54
Peterhead,9373,5,14,9,13,60,56,4,51
Brechin,9373,6,13,9,14,48,51,-3,48
Albion,9373,7,13,8,15,53,60,-7,47
Stranraer,9373,8,11,5,20,44,59,-15,38
East Fife,9373,9,8,10,18,39,58,-19,34
Stenhousem'r,9373,10,10,4,22,45,69,-24,34
Livingston,9374,1,21,3,12,79,50,29,66
Alloa,9374,2,18,10,8,73,42,31,64
Brechin,9374,3,19,6,11,58,49,9,63
Airdrieon,9374,4,17,8,11,55,48,7,59
East Fife,9374,5,12,11,13,51,50,1,47
Albion,9374,6,12,10,14,53,66,-13,46
Peterhead,9374,7,13,5,18,50,58,-8,44
Stranraer,9374,8,10,8,18,49,63,-14,38
Queen's Park,9374,9,10,8,18,40,60,-20,38
Stenhousem'r,9374,10,10,7,19,43,65,-22,37
Airdrieon,9375,1,20,7,9,64,46,18,67
Alloa,9375,2,19,8,9,72,42,30,65
Livingston,9375,3,20,4,12,74,47,27,64
Albion,9375,4,15,8,13,54,49,5,53
Brechin,9375,5,14,6,16,47,51,-4,48
Stranraer,9375,6,13,5,18,52,61,-9,44
Peterhead,9375,7,12,8,16,46,62,-16,44
Queen's Park,9375,8,12,7,17,36,48,-12,43
East Fife,9375,9,10,10,16,42,51,-9,40
Stenhousem'r,9375,10,10,7,19,50,80,-30,37
Alloa,9376,1,18,8,10,75,46,29,62
Livingston,9376,2,17,7,12,64,46,18,58
Brechin,9376,3,17,5,14,48,44,4,56
Queen's Park,9376,4,16,7,13,36,45,-9,55
Airdrieon,9376,5,15,8,13,56,63,-7,53
East Fife,9376,6,15,6,15,50,41,9,51
Peterhead,9376,7,14,8,14,50,54,-4,50
Albion,9376,8,13,8,15,52,49,3,47
Stranraer,9376,9,14,3,19,47,59,-12,45
Stenhousem'r,9376,10,7,8,21,40,71,-31,29
Alloa,9377,1,18,9,9,65,45,20,63
Airdrieon,9377,2,18,7,11,63,50,13,61
Queen's Park,9377,3,17,7,12,49,49,0,58
Livingston,9377,4,17,4,15,65,56,9,55
Brechin,9377,5,16,5,15,51,53,-2,53
Albion,9377,6,13,8,15,59,53,6,47
Peterhead,9377,7,12,10,14,45,53,-8,46
Stranraer,9377,8,12,7,17,44,49,-5,43
Stenhousem'r,9377,9,10,9,17,49,77,-28,39
East Fife,9377,10,10,8,18,47,52,-5,38
Livingston,9378,1,20,5,11,73,47,26,65
Airdrieon,9378,2,18,9,9,66,48,18,63
Albion,9378,3,16,8,12,52,48,4,56
Alloa,9378,4,15,10,11,62,43,19,55
Queen's Park,9378,5,15,8,13,46,45,1,53
Brechin,9378,6,15,8,13,51,55,-4,53
East Fife,9378,7,10,12,14,50,55,-5,42
Peterhead,9378,8,12,6,18,47,61,-14,42
Stranraer,9378,9,11,8,17,51,59,-8,41
Stenhousem'r,9378,10,7,8,21,46,83,-37,29
Alloa,9379,1,22,8,6,72,36,36,74
Livingston,9379,2,19,6,11,69,47,22,63
Brechin,9379,3,19,4,13,52,44,8,61
Airdrieon,9379,4,18,4,14,61,50,11,58
Albion,9379,5,14,11,11,50,45,5,53
Peterhead,9379,6,14,10,12,50,47,3,52
Stranraer,9379,7,14,3,19,52,63,-11,45
Queen's Park,9379,8,11,5,20,36,57,-21,38
East Fife,9379,9,9,8,19,41,55,-14,35
Stenhousem'r,9379,10,5,11,20,40,79,-39,26
Livingston,9380,1,25,2,9,82,39,43,77
Alloa,9380,2,18,9,9,73,42,31,63
Albion,9380,3,17,6,13,58,48,10,57
Stranraer,9380,4,15,6,15,52,54,-2,51
Airdrieon,9380,5,14,7,15,59,63,-4,49
Brechin,9380,6,13,9,14,44,52,-8,48
Peterhead,9380,7,12,7,17,51,59,-8,43
Queen's Park,9380,8,11,9,16,38,57,-19,42
East Fife,9380,9,9,10,17,41,55,-14,37
Stenhousem'r,9380,10,9,9,18,45,74,-29,36
Alloa,9381,1,19,7,10,74,42,32,64
Brechin,9381,2,19,5,12,58,48,10,62
Livingston,9381,3,18,3,15,76,57,19,57
Stranraer,9381,4,18,3,15,57,56,1,57
Peterhead,9381,5,14,7,15,49,56,-7,49
Albion,9381,6,14,6,16,53,52,1,48
Airdrieon,9381,7,14,5,17,54,63,-9,47
East Fife,9381,8,12,10,14,44,48,-4,46
Queen's Park,9381,9,11,8,17,34,58,-24,41
Stenhousem'r,9381,10,10,8,18,43,62,-19,38
Alloa,9382,1,21,6,9,76,42,34,69
Livingston,9382,2,20,4,12,70,44,26,64
Albion,9382,3,17,7,12,54,45,9,58
Airdrieon,9382,4,16,8,12,52,46,6,56
Brechin,9382,5,17,5,14,51,48,3,56
Peterhead,9382,6,14,5,17,44,52,-8,47
Stranraer,9382,7,12,7,17,52,60,-8,43
East Fife,9382,8,11,8,17,46,55,-9,41
Queen's Park,9382,9,12,3,21,35,65,-30,39
Stenhousem'r,9382,10,11,5,20,51,74,-23,38
Livingston,9383,1,22,3,11,78,46,32,69
Alloa,9383,2,20,7,9,67,40,27,67
Albion,9383,3,15,9,12,59,52,7,54
Brechin,9383,4,15,9,12,50,46,4,54
Peterhead,9383,5,14,8,14,55,53,2,50
Airdrieon,9383,6,14,8,14,51,50,1,50
East Fife,9383,7,12,10,14,50,53,-3,46
Stranraer,9383,8,12,7,17,54,66,-12,43
Queen's Park,9383,9,11,6,19,39,61,-22,39
Stenhousem'r,9383,10,8,7,21,47,83,-36,31
Alloa,9384,1,21,8,7,81,42,39,71
Airdrieon,9384,2,18,7,11,68,56,12,61
Brechin,9384,3,18,6,12,56,51,5,60
Albion,9384,4,17,7,12,59,55,4,58
Livingston,9384,5,15,10,11,71,49,22,55
Peterhead,9384,6,12,8,16,43,59,-16,44
Queen's Park,9384,7,11,8,17,35,54,-19,41
Stranraer,9384,8,11,7,18,47,57,-10,40
East Fife,9384,9,9,9,18,41,56,-15,36
Stenhousem'r,9384,10,9,8,19,46,68,-22,35
Livingston,9385,1,22,4,10,69,43,26,70
Alloa,9385,2,20,9,7,74,44,30,69
Peterhead,9385,3,15,10,11,56,49,7,55
Brechin,9385,4,17,4,15,47,46,1,55
Airdrieon,9385,5,15,9,12,62,55,7,54
East Fife,9385,6,13,12,11,50,42,8,51
Albion,9385,7,12,11,13,58,57,1,47
Stranraer,9385,8,10,6,20,43,62,-19,36
Queen's Park,9385,9,8,11,17,37,60,-23,35
Stenhousem'r,9385,10,7,6,23,45,83,-38,27
Livingston,9386,1,23,2,11,77,47,30,71
Brechin,9386,2,19,6,11,57,54,3,63
Airdrieon,9386,3,19,4,13,66,55,11,61
Alloa,9386,4,16,12,8,61,42,19,60
Albion,9386,5,11,11,14,44,46,-2,44
Stranraer,9386,6,13,5,18,48,58,-10,44
Peterhead,9386,7,12,6,18,43,58,-15,42
Stenhousem'r,9386,8,11,7,18,59,77,-18,40
East Fife,9386,9,9,12,15,48,50,-2,39
Queen's Park,9386,10,10,9,17,31,47,-16,39
Livingston,9387,1,18,5,13,69,54,15,59
Brechin,9387,2,16,11,9,53,41,12,59
Airdrieon,9387,3,16,10,10,68,62,6,58
Peterhead,9387,4,16,8,12,67,55,12,56
Alloa,9387,5,16,6,14,66,55,11,54
Albion,9387,6,13,10,13,63,62,1,49
East Fife,9387,7,12,12,12,54,51,3,48
Queen's Park,9387,8,13,5,18,41,55,-14,44
Stenhousem'r,9387,9,11,6,19,53,84,-31,39
Stranraer,9387,10,10,5,21,44,59,-15,35
Alloa,9388,1,21,7,8,76,42,34,70
Livingston,9388,2,22,3,11,75,46,29,69
Brechin,9388,3,18,9,9,56,43,13,63
Airdrieon,9388,4,18,7,11,66,51,15,61
Albion,9388,5,16,7,13,61,52,9,55
Peterhead,9388,6,12,7,17,54,71,-17,43
Queen's Park,9388,7,11,8,17,36,56,-20,41
East Fife,9388,8,9,10,17,43,59,-16,37
Stranraer,9388,9,10,4,22,46,71,-25,34
Stenhousem'r,9388,10,9,6,21,59,81,-22,33
Livingston,9389,1,24,3,9,85,43,42,75
Alloa,9389,2,21,8,7,73,42,31,71
Airdrieon,9389,3,17,10,9,62,48,14,61
Peterhead,9389,4,16,7,13,46,55,-9,55
Brechin,9389,5,15,7,14,52,53,-1,52
Albion,9389,6,13,7,16,43,45,-2,46
Stranraer,9389,7,12,8,16,55,56,-1,44
East Fife,9389,8,10,8,18,47,47,0,38
Queen's Park,9389,9,7,12,17,28,62,-34,33
Stenhousem'r,9389,10,6,8,22,48,88,-40,26
Livingston,9390,1,20,5,11,68,40,28,65
Alloa,9390,2,16,10,10,77,54,23,58
Airdrieon,9390,3,16,7,13,54,62,-8,55
Brechin,9390,4,15,8,13,42,43,-1,53
Queen's Park,9390,5,14,9,13,38,51,-13,51
Albion,9390,6,14,8,14,51,48,3,50
Peterhead,9390,7,13,8,15,58,60,-2,47
East Fife,9390,8,11,11,14,47,43,4,44
Stranraer,9390,9,12,8,16,51,55,-4,44
Stenhousem'r,9390,10,7,10,19,48,78,-30,31
Alloa,9391,1,19,8,9,72,45,27,65
Airdrieon,9391,2,19,7,10,63,52,11,64
Livingston,9391,3,16,7,13,66,55,11,55
Peterhead,9391,4,15,10,11,53,46,7,55
Albion,9391,5,15,9,12,56,52,4,54
Brechin,9391,6,16,5,15,47,48,-1,53
East Fife,9391,7,11,10,15,49,52,-3,43
Queen's Park,9391,8,11,8,17,35,51,-16,41
Stenhousem'r,9391,9,10,7,19,50,70,-20,37
Stranraer,9391,10,9,7,20,48,68,-20,34
Livingston,9392,1,24,5,7,84,46,38,77
Stranraer,9392,2,17,5,14,57,52,5,56
Brechin,9392,3,16,8,12,44,43,1,56
Airdrieon,9392,4,14,11,11,50,49,1,53
Alloa,9392,5,14,9,13,57,49,8,51
East Fife,9392,6,13,8,15,49,39,10,47
Albion,9392,7,12,10,14,48,51,-3,46
Peterhead,9392,8,12,8,16,45,57,-12,44
Queen's Park,9392,9,11,6,19,38,51,-13,39
Stenhousem'r,9392,10,6,12,18,39,74,-35,30
Alloa,9393,1,20,7,9,81,46,35,67
Livingston,9393,2,20,3,13,77,51,26,63
Peterhead,9393,3,15,11,10,45,41,4,56
East Fife,9393,4,15,7,14,59,54,5,52
Brechin,9393,5,15,7,14,50,54,-4,52
Airdrieon,9393,6,15,5,16,56,64,-8,50
Queen's Park,9393,7,14,7,15,39,49,-10,49
Albion,9393,8,13,7,16,59,57,2,46
Stranraer,9393,9,11,8,17,53,71,-18,41
Stenhousem'r,9393,10,7,8,21,54,86,-32,29
Livingston,9394,1,24,5,7,83,43,40,77
Airdrieon,9394,2,17,9,10,57,55,2,60
Brechin,9394,3,16,6,14,50,48,2,54
Alloa,9394,4,15,5,16,61,55,6,50
Stranraer,9394,5,12,11,13,57,58,-1,47
Peterhead,9394,6,13,8,15,51,57,-6,47
Albion,9394,7,12,10,14,52,56,-4,46
Queen's Park,9394,8,12,9,15,42,48,-6,45
Stenhousem'r,9394,9,10,8,18,52,75,-23,38
East Fife,9394,10,9,9,18,39,49,-10,36
Alloa,9395,1,24,4,8,80,44,36,76
Livingston,9395,2,24,3,9,86,40,46,75
Airdrieon,9395,3,18,4,14,62,58,4,58
Albion,9395,4,15,9,12,60,53,7,54
Brechin,9395,5,15,6,15,48,53,-5,51
Stranraer,9395,6,15,3,18,61,64,-3,48
Queen's Park,9395,7,12,8,16,35,55,-20,44
East Fife,9395,8,9,9,18,46,55,-9,36
Peterhead,9395,9,9,8,19,44,63,-19,35
Stenhousem'r,9395,10,8,8,20,40,77,-37,32
Alloa,9396,1,19,10,7,65,42,23,67
Livingston,9396,2,20,5,11,72,46,26,65
Brechin,9396,3,19,5,12,63,52,11,62
Airdrieon,9396,4,18,5,13,58,47,11,59
Albion,9396,5,14,8,14,50,56,-6,50
Peterhead,9396,6,12,8,16,56,54,2,44
East Fife,9396,7,11,9,16,48,53,-5,42
Queen's Park,9396,8,12,5,19,30,48,-18,41
Stranraer,9396,9,12,5,19,46,66,-20,41
Stenhousem'r,9396,10,10,6,20,51,75,-24,36
Livingston,9397,1,21,6,9,80,49,31,69
Alloa,9397,2,17,10,9,76,48,28,61
Brechin,9397,3,18,5,13,59,48,11,59
Peterhead,9397,4,16,9,11,54,45,9,57
Airdrieon,9397,5,16,8,12,61,57,4,56
Albion,9397,6,14,7,15,49,45,4,49
East Fife,9397,7,12,9,15,45,49,-4,45
Queen's Park,9397,8,12,7,17,39,62,-23,43
Stranraer,9397,9,9,7,20,50,61,-11,34
Stenhousem'r,9397,10,6,10,20,36,85,-49,28
Alloa,9398,1,22,6,8,80,50,30,72
Livingston,9398,2,21,6,9,80,48,32,69
Airdrieon,9398,3,16,7,13,63,58,5,55
Peterhead,9398,4,17,4,15,52,49,3,55
Queen's Park,9398,5,16,6,14,54,56,-2,54
Brechin,9398,6,14,4,18,42,58,-16,46
Albion,9398,7,12,7,17,49,56,-7,43
East Fife,9398,8,11,9,16,47,49,-2,42
Stenhousem'r,9398,9,11,5,20,44,70,-26,38
Stranraer,9398,10,11,4,21,58,75,-17,37
Alloa,9399,1,24,7,5,80,42,38,79
Brechin,9399,2,20,8,8,57,37,20,68
Airdrieon,9399,3,19,7,10,63,50,13,64
Livingston,9399,4,17,6,13,76,53,23,57
Peterhead,9399,5,14,7,15,48,47,1,49
Stranraer,9399,6,12,7,17,54,67,-13,43
East Fife,9399,7,11,8,17,46,48,-2,41
Albion,9399,8,12,5,19,51,57,-6,41
Queen's Park,9399,9,9,6,21,23,65,-42,33
Stenhousem'r,9399,10,9,5,22,52,84,-32,32
Alloa,9400,1,19,9,8,70,42,28,66
Livingston,9400,2,19,5,12,63,48,15,62
Peterhead,9400,3,18,8,10,60,48,12,62
Brechin,9400,4,15,7,14,51,51,0,52
Stranraer,9400,5,15,6,15,55,59,-4,51
Airdrieon,9400,6,15,5,16,62,62,0,50
East Fife,9400,7,13,10,13,54,49,5,49
Albion,9400,8,14,6,16,52,55,-3,48
Queen's Park,9400,9,11,7,18,33,51,-18,40
Stenhousem'r,9400,10,5,9,22,45,80,-35,24
Livingston,9401,1,23,4,9,75,43,32,73
Brechin,9401,2,16,6,14,49,50,-1,54
Alloa,9401,3,14,11,11,61,50,11,53
Airdrieon,9401,4,15,6,15,52,57,-5,51
Peterhead,9401,5,14,8,14,51,49,2,50
Stranraer,9401,6,15,5,16,47,52,-5,50
Queen's Park,9401,7,13,8,15,28,47,-19,47
Albion,9401,8,12,8,16,43,48,-5,44
Stenhousem'r,9401,9,11,9,16,52,62,-10,42
East Fife,9401,10,8,13,15,45,45,0,37
Alloa,9402,1,23,7,6,73,37,36,76
Livingston,9402,2,18,5,13,74,50,24,59
Airdrieon,9402,3,17,6,13,58,50,8,57
Albion,9402,4,15,8,13,55,49,6,53
Stranraer,9402,5,16,3,17,54,59,-5,51
Brechin,9402,6,16,3,17,44,51,-7,51
Peterhead,9402,7,14,7,15,42,49,-7,49
East Fife,9402,8,13,9,14,47,45,2,48
Queen's Park,9402,9,11,7,18,31,51,-20,40
Stenhousem'r,9402,10,7,5,24,45,82,-37,26
Livingston,9403,1,27,3,6,79,34,45,84
Alloa,9403,2,18,7,11,71,45,26,61
Brechin,9403,3,19,4,13,48,38,10,61
Peterhead,9403,4,15,8,13,52,45,7,53
Airdrieon,9403,5,15,6,15,62,66,-4,51
Albion,9403,6,13,9,14,51,57,-6,48
Queen's Park,9403,7,13,5,18,45,59,-14,44
Stranraer,9403,8,12,3,21,48,69,-21,39
East Fife,9403,9,9,8,19,43,52,-9,35
Stenhousem'r,9403,10,10,5,21,47,81,-34,35
Livingston,9404,1,23,4,9,75,40,35,73
Alloa,9404,2,21,8,7,76,42,34,71
Albion,9404,3,16,8,12,51,44,7,56
Brechin,9404,4,16,6,14,47,45,2,54
Airdrieon,9404,5,15,7,14,54,59,-5,52
Queen's Park,9404,6,12,9,15,32,47,-15,45
Stranraer,9404,7,13,4,19,50,61,-11,43
East Fife,9404,8,11,8,17,46,51,-5,41
Peterhead,9404,9,11,8,17,44,55,-11,41
Stenhousem'r,9404,10,7,8,21,40,71,-31,29
Airdrieon,9405,1,19,9,8,67,50,17,66
Alloa,9405,2,18,10,8,65,41,24,64
Livingston,9405,3,17,6,13,68,50,18,57
Albion,9405,4,16,7,13,63,53,10,55
Peterhead,9405,5,15,9,12,54,52,2,54
Stranraer,9405,6,16,4,16,59,61,-2,52
Brechin,9405,7,15,3,18,46,56,-10,48
Queen's Park,9405,8,13,8,15,46,50,-4,47
East Fife,9405,9,8,10,18,47,64,-17,34
Stenhousem'r,9405,10,7,6,23,44,82,-38,27
Brechin,9406,1,21,5,10,68,46,22,68
Airdrieon,9406,2,20,7,9,64,53,11,67
Alloa,9406,3,18,9,9,75,51,24,63
Livingston,9406,4,20,3,13,77,59,18,63
East Fife,9406,5,14,8,14,54,53,1,50
Peterhead,9406,6,14,8,14,54,54,0,50
Queen's Park,9406,7,12,7,17,41,62,-21,43
Albion,9406,8,12,6,18,49,57,-8,42
Stranraer,9406,9,12,2,22,62,68,-6,38
Stenhousem'r,9406,10,7,5,24,46,87,-41,26
Livingston,9407,1,19,7,10,79,56,23,64
Alloa,9407,2,16,11,9,60,42,18,59
Airdrieon,9407,3,15,10,11,59,53,6,55
Brechin,9407,4,15,9,12,49,50,-1,54
East Fife,9407,5,13,12,11,55,46,9,51
Albion,9407,6,13,10,13,59,51,8,49
Stranraer,9407,7,14,7,15,57,63,-6,49
Queen's Park,9407,8,12,8,16,32,48,-16,44
Peterhead,9407,9,9,10,17,45,55,-10,37
Stenhousem'r,9407,10,8,8,20,44,75,-31,32
Alloa,9408,1,21,7,8,79,45,34,70
Livingston,9408,2,20,7,9,74,45,29,67
Airdrieon,9408,3,16,7,13,65,55,10,55
Brechin,9408,4,16,5,15,50,61,-11,53
Albion,9408,5,12,15,9,57,49,8,51
Peterhead,9408,6,13,11,12,56,51,5,50
East Fife,9408,7,11,11,14,50,51,-1,44
Queen's Park,9408,8,11,7,18,35,52,-17,40
Stranraer,9408,9,10,9,17,43,60,-17,39
Stenhousem'r,9408,10,7,7,22,40,80,-40,28
Livingston,9409,1,22,5,9,75,44,31,71
Alloa,9409,2,19,6,11,69,48,21,63
Albion,9409,3,16,11,9,62,49,13,59
Peterhead,9409,4,16,10,10,52,41,11,58
Stranraer,9409,5,15,2,19,54,63,-9,47
Airdrieon,9409,6,14,5,17,46,62,-16,47
East Fife,9409,7,13,7,16,54,51,3,46
Queen's Park,9409,8,12,8,16,36,51,-15,44
Brechin,9409,9,12,7,17,41,54,-13,43
Stenhousem'r,9409,10,7,7,22,53,79,-26,28
Alloa,9410,1,20,7,9,68,45,23,67
Livingston,9410,2,19,7,10,67,45,22,64
Albion,9410,3,13,12,11,52,48,4,51
Stranraer,9410,4,13,11,12,53,50,3,50
East Fife,9410,5,13,11,12,48,45,3,50
Brechin,9410,6,13,11,12,41,43,-2,50
Queen's Park,9410,7,13,8,15,38,46,-8,47
Peterhead,9410,8,12,10,14,51,51,0,46
Airdrieon,9410,9,11,9,16,50,57,-7,42
Stenhousem'r,9410,10,6,8,22,39,77,-38,26
Livingston,9411,1,20,8,8,75,43,32,68
Brechin,9411,2,20,7,9,60,44,16,67
Alloa,9411,3,17,8,11,68,46,22,59
Airdrieon,9411,4,15,11,10,59,53,6,56
Albion,9411,5,14,9,13,55,52,3,51
Peterhead,9411,6,14,9,13,51,52,-1,51
East Fife,9411,7,13,8,15,50,49,1,47
Queen's Park,9411,8,13,7,16,39,56,-17,46
Stranraer,9411,9,8,6,22,44,63,-19,30
Stenhousem'r,9411,10,7,5,24,49,92,-43,26
Alloa,9412,1,22,5,9,77,47,30,71
Livingston,9412,2,20,6,10,73,41,32,66
Airdrieon,9412,3,19,7,10,56,43,13,64
Brechin,9412,4,16,7,13,50,45,5,55
Albion,9412,5,12,12,12,55,52,3,48
Peterhead,9412,6,13,8,15,47,53,-6,47
East Fife,9412,7,12,10,14,49,46,3,46
Stranraer,9412,8,12,3,21,45,69,-24,39
Queen's Park,9412,9,9,10,17,34,51,-17,37
Stenhousem'r,9412,10,5,12,19,43,82,-39,27
Livingston,9413,1,20,8,8,81,43,38,68
Brechin,9413,2,18,8,10,55,46,9,62
Alloa,9413,3,16,11,9,66,43,23,59
Peterhead,9413,4,14,9,13,55,54,1,51
Airdrieon,9413,5,16,3,17,51,51,0,51
Queen's Park,9413,6,13,9,14,38,51,-13,48
Albion,9413,7,13,7,16,62,61,1,46
East Fife,9413,8,11,11,14,42,47,-5,44
Stranraer,9413,9,10,7,19,44,59,-15,37
Stenhousem'r,9413,10,8,9,19,41,80,-39,33
Airdrieon,9414,1,17,9,10,51,43,8,60
Alloa,9414,2,17,8,11,78,52,26,59
Albion,9414,3,16,8,12,54,51,3,56
Queen's Park,9414,4,14,11,11,49,43,6,53
Stranraer,9414,5,15,5,16,45,50,-5,50
Livingston,9414,6,13,8,15,61,58,3,47
Brechin,9414,7,14,4,18,44,55,-11,46
Peterhead,9414,8,12,9,15,45,56,-11,45
East Fife,9414,9,9,14,13,44,42,2,41
Stenhousem'r,9414,10,11,8,17,55,76,-21,41
Alloa,9415,1,22,7,7,78,35,43,73
Airdrieon,9415,2,17,5,14,60,63,-3,56
Brechin,9415,3,15,8,13,48,45,3,53
Livingston,9415,4,16,4,16,71,57,14,52
East Fife,9415,5,14,10,12,43,41,2,52
Stranraer,9415,6,14,8,14,52,51,1,50
Peterhead,9415,7,14,7,15,51,57,-6,49
Queen's Park,9415,8,14,6,16,37,53,-16,48
Albion,9415,9,9,10,17,41,53,-12,37
Stenhousem'r,9415,10,8,9,19,45,71,-26,33
Livingston,9416,1,21,4,11,73,43,30,67
Alloa,9416,2,20,7,9,63,38,25,67
Brechin,9416,3,20,6,10,50,37,13,66
Airdrieon,9416,4,16,4,16,52,54,-2,52
Peterhead,9416,5,15,6,15,54,55,-1,51
Stranraer,9416,6,14,6,16,47,52,-5,48
Queen's Park,9416,7,14,5,17,33,48,-15,47
Albion,9416,8,13,6,17,42,48,-6,45
Stenhousem'r,9416,9,10,8,18,44,68,-24,38
East Fife,9416,10,6,10,20,35,50,-15,28
Alloa,9417,1,23,8,5,77,38,39,77
Livingston,9417,2,19,7,10,67,53,14,64
Airdrieon,9417,3,17,6,13,64,56,8,57
Brechin,9417,4,17,5,14,54,48,6,56
Peterhead,9417,5,16,6,14,50,51,-1,54
Albion,9417,6,13,6,17,52,51,1,45
East Fife,9417,7,13,6,17,48,47,1,45
Stranraer,9417,8,10,9,17,45,57,-12,39
Queen's Park,9417,9,10,8,18,36,58,-22,38
Stenhousem'r,9417,10,6,11,19,49,83,-34,29
Livingston,9418,1,22,6,8,80,44,36,72
Airdrieon,9418,2,17,8,11,67,52,15,59
Brechin,9418,3,19,2,15,47,51,-4,59
Alloa,9418,4,17,5,14,66,49,17,56
East Fife,9418,5,16,5,15,55,48,7,53
Albion,9418,6,13,11,12,51,47,4,50
Stranraer,9418,7,14,7,15,51,52,-1,49
Queen's Park,9418,8,13,5,18,39,52,-13,44
Peterhead,9418,9,12,6,18,50,61,-11,42
Stenhousem'r,9418,10,6,7,23,44,94,-50,25
Alloa,9419,1,18,8,10,85,44,41,62
Airdrieon,9419,2,17,11,8,53,43,10,62
Peterhead,9419,3,17,9,10,54,45,9,60
Livingston,9419,4,18,5,13,65,48,17,59
Brechin,9419,5,15,8,13,48,46,2,53
Stranraer,9419,6,14,5,17,49,57,-8,47
Queen's Park,9419,7,12,10,14,35,52,-17,46
Albion,9419,8,13,6,17,57,68,-11,45
East Fife,9419,9,11,9,16,48,51,-3,42
Stenhousem'r,9419,10,5,9,22,41,81,-40,24
Airdrieon,9420,1,24,6,6,72,41,31,78
Alloa,9420,2,22,7,7,82,41,41,73
Livingston,9420,3,20,5,11,74,50,24,65
Peterhead,9420,4,14,7,15,53,58,-5,49
Brechin,9420,5,13,9,14,49,56,-7,48
East Fife,9420,6,10,13,13,39,40,-1,43
Albion,9420,7,10,12,14,51,56,-5,42
Queen's Park,9420,8,10,8,18,32,49,-17,38
Stranraer,9420,9,10,5,21,44,61,-17,35
Stenhousem'r,9420,10,6,10,20,43,87,-44,28
Livingston,9421,1,20,6,10,88,56,32,66
Albion,9421,2,18,8,10,62,50,12,62
Airdrieon,9421,3,19,4,13,70,56,14,61
East Fife,9421,4,15,10,11,57,38,19,55
Alloa,9421,5,16,7,13,66,54,12,55
Brechin,9421,6,14,7,15,50,62,-12,49
Queen's Park,9421,7,14,5,17,37,52,-15,47
Peterhead,9421,8,12,8,16,38,52,-14,44
Stranraer,9421,9,10,7,19,45,61,-16,37
Stenhousem'r,9421,10,7,8,21,46,78,-32,29
Livingston,9422,1,22,5,9,83,55,28,71
Airdrieon,9422,2,18,7,11,69,52,17,61
Alloa,9422,3,16,9,11,59,46,13,57
Brechin,9422,4,16,5,15,53,49,4,53
Peterhead,9422,5,15,6,15,56,60,-4,51
Stranraer,9422,6,14,6,16,56,55,1,48
Albion,9422,7,12,10,14,54,57,-3,46
East Fife,9422,8,12,9,15,48,49,-1,45
Queen's Park,9422,9,12,7,17,31,50,-19,43
Stenhousem'r,9422,10,7,8,21,39,75,-36,29
Airdrieon,9423,1,21,4,11,63,56,7,67
Alloa,9423,2,19,6,11,68,49,19,63
Livingston,9423,3,19,4,13,68,51,17,61
East Fife,9423,4,16,9,11,57,38,19,57
Stranraer,9423,5,16,3,17,50,53,-3,51
Brechin,9423,6,14,6,16,50,53,-3,48
Queen's Park,9423,7,13,6,17,42,51,-9,45
Peterhead,9423,8,11,8,17,50,66,-16,41
Albion,9423,9,10,9,17,54,66,-12,39
Stenhousem'r,9423,10,10,7,19,44,63,-19,37
Alloa,9424,1,21,7,8,65,38,27,70
Brechin,9424,2,20,5,11,53,34,19,65
Livingston,9424,3,17,5,14,66,52,14,56
Airdrieon,9424,4,16,8,12,52,52,0,56
East Fife,9424,5,15,9,12,51,40,11,54
Peterhead,9424,6,15,8,13,51,50,1,53
Albion,9424,7,14,6,16,52,50,2,48
Stranraer,9424,8,12,5,19,40,55,-15,41
Queen's Park,9424,9,11,6,19,37,51,-14,39
Stenhousem'r,9424,10,5,9,22,37,82,-45,24
Livingston,9425,1,23,6,7,81,45,36,75
Alloa,9425,2,20,8,8,81,47,34,68
Brechin,9425,3,17,9,10,56,46,10,60
Albion,9425,4,15,9,12,55,47,8,54
Airdrieon,9425,5,13,11,12,55,53,2,50
Queen's Park,9425,6,15,2,19,41,58,-17,47
Stranraer,9425,7,13,6,17,46,59,-13,45
East Fife,9425,8,12,8,16,43,42,1,44
Peterhead,9425,9,10,9,17,41,57,-16,39
Stenhousem'r,9425,10,3,10,23,40,85,-45,19
Livingston,9426,1,20,7,9,72,47,25,67
Peterhead,9426,2,17,9,10,52,45,7,60
Albion,9426,3,16,10,10,65,46,19,58
Airdrieon,9426,4,16,7,13,68,57,11,55
Brechin,9426,5,15,8,13,43,46,-3,53
Alloa,9426,6,14,10,12,64,50,14,52
Queen's Park,9426,7,10,10,16,36,52,-16,40
East Fife,9426,8,9,12,15,41,52,-11,39
Stranraer,9426,9,10,8,18,52,69,-17,38
Stenhousem'r,9426,10,9,7,20,57,86,-29,34
Livingston,9427,1,23,4,9,77,52,25,73
Alloa,9427,2,19,7,10,70,45,25,64
Airdrieon,9427,3,18,9,9,63,55,8,63
Brechin,9427,4,15,6,15,55,48,7,51
East Fife,9427,5,12,11,13,52,47,5,47
Peterhead,9427,6,11,12,13,40,45,-5,45
Queen's Park,9427,7,12,7,17,40,47,-7,43
Albion,9427,8,10,12,14,53,61,-8,42
Stranraer,9427,9,11,8,17,55,69,-14,41
Stenhousem'r,9427,10,5,12,19,53,89,-36,27
Airdrieon,9428,1,22,7,7,62,39,23,73
Alloa,9428,2,21,6,9,73,44,29,69
Livingston,9428,3,19,5,12,73,53,20,62
Brechin,9428,4,18,7,11,54,45,9,61
Albion,9428,5,13,8,15,60,58,2,47
Peterhead,9428,6,11,9,16,45,51,-6,42
East Fife,9428,7,10,10,16,47,55,-8,40
Queen's Park,9428,8,11,5,20,42,69,-27,38
Stranraer,9428,9,10,7,19,42,62,-20,37
Stenhousem'r,9428,10,9,8,19,51,73,-22,35
Airdrieon,9429,1,20,5,11,62,48,14,65
Livingston,9429,2,20,4,12,85,55,30,64
Queen's Park,9429,3,15,9,12,43,47,-4,54
Alloa,9429,4,14,8,14,58,52,6,50
Peterhead,9429,5,14,7,15,55,56,-1,49
East Fife,9429,6,10,15,11,51,43,8,45
Stranraer,9429,7,12,9,15,51,56,-5,45
Albion,9429,8,11,11,14,48,54,-6,44
Brechin,9429,9,12,8,16,43,57,-14,44
Stenhousem'r,9429,10,9,10,17,43,71,-28,37
Alloa,9430,1,17,10,9,67,37,30,61
Airdrieon,9430,2,17,6,13,60,56,4,57
Brechin,9430,3,14,12,10,50,47,3,54
Peterhead,9430,4,14,9,13,50,52,-2,51
Stranraer,9430,5,15,6,15,54,59,-5,51
Livingston,9430,6,14,7,15,55,52,3,49
Albion,9430,7,9,17,10,43,46,-3,44
East Fife,9430,8,11,9,16,44,45,-1,42
Queen's Park,9430,9,10,12,14,33,43,-10,42
Stenhousem'r,9430,10,11,8,17,45,64,-19,41
Livingston,9431,1,21,7,8,81,44,37,70
Alloa,9431,2,16,9,11,72,45,27,57
Brechin,9431,3,15,8,13,58,48,10,53
Queen's Park,9431,4,15,7,14,39,51,-12,52
East Fife,9431,5,13,12,11,56,45,11,51
Airdrieon,9431,6,13,9,14,54,55,-1,48
Albion,9431,7,13,9,14,50,54,-4,48
Peterhead,9431,8,14,5,17,48,72,-24,47
Stranraer,9431,9,12,8,16,60,65,-5,44
Stenhousem'r,9431,10,7,8,21,40,79,-39,29
Livingston,9432,1,21,6,9,75,48,27,69
Alloa,9432,2,20,8,8,79,51,28,68
Airdrieon,9432,3,16,9,11,60,61,-1,57
Albion,9432,4,16,8,12,60,51,9,56
Brechin,9432,5,17,5,14,48,42,6,56
Peterhead,9432,6,14,9,13,56,49,7,51
Queen's Park,9432,7,14,4,18,40,58,-18,46
Stranraer,9432,8,11,10,15,46,54,-8,43
Stenhousem'r,9432,9,8,6,22,43,73,-30,30
East Fife,9432,10,5,11,20,36,56,-20,26
Alloa,9433,1,22,6,8,78,43,35,72
Livingston,9433,2,20,6,10,82,51,31,66
Airdrieon,9433,3,17,7,12,58,54,4,58
Brechin,9433,4,15,6,15,48,50,-2,51
Albion,9433,5,12,13,11,51,50,1,49
Peterhead,9433,6,14,6,16,48,55,-7,48
East Fife,9433,7,11,12,13,51,47,4,45
Queen's Park,9433,8,13,6,17,40,53,-13,45
Stranraer,9433,9,11,9,16,54,66,-12,42
Stenhousem'r,9433,10,5,9,22,43,84,-41,24
Livingston,9434,1,22,3,11,83,44,39,69
Alloa,9434,2,19,10,7,67,40,27,67
Airdrieon,9434,3,16,8,12,52,52,0,56
Stranraer,9434,4,16,7,13,54,48,6,55
Peterhead,9434,5,16,7,13,48,51,-3,55
Albion,9434,6,15,6,15,58,59,-1,51
Brechin,9434,7,13,6,17,41,51,-10,45
Queen's Park,9434,8,11,6,19,34,57,-23,39
East Fife,9434,9,8,10,18,41,52,-11,34
Stenhousem'r,9434,10,9,7,20,52,76,-24,34
Livingston,9435,1,19,9,8,77,43,34,66
Airdrieon,9435,2,18,6,12,54,44,10,60
Alloa,9435,3,17,7,12,65,53,12,58
East Fife,9435,4,16,9,11,61,44,17,57
Peterhead,9435,5,15,9,12,52,49,3,54
Albion,9435,6,14,10,12,52,55,-3,52
Brechin,9435,7,13,8,15,52,57,-5,47
Queen's Park,9435,8,12,9,15,44,53,-9,45
Stranraer,9435,9,10,6,20,44,61,-17,36
Stenhousem'r,9435,10,6,7,23,47,89,-42,25
Alloa,9436,1,21,8,7,72,32,40,71
Livingston,9436,2,20,5,11,65,39,26,65
Albion,9436,3,17,8,11,59,50,9,59
Airdrieon,9436,4,15,10,11,57,48,9,55
Peterhead,9436,5,15,8,13,51,50,1,53
Stranraer,9436,6,16,5,15,48,48,0,53
Brechin,9436,7,15,7,14,49,51,-2,52
East Fife,9436,8,10,8,18,47,55,-8,38
Queen's Park,9436,9,9,7,20,31,63,-32,34
Stenhousem'r,9436,10,6,6,24,39,82,-43,24
Alloa,9437,1,19,9,8,68,42,26,66
Livingston,9437,2,19,5,12,71,50,21,62
Airdrieon,9437,3,16,7,13,59,61,-2,55
Peterhead,9437,4,14,10,12,57,53,4,52
Albion,9437,5,14,6,16,49,53,-4,48
East Fife,9437,6,13,8,15,56,51,5,47
Queen's Park,9437,7,13,8,15,36,49,-13,47
Brechin,9437,8,12,9,15,42,48,-6,45
Stenhousem'r,9437,9,10,10,16,52,73,-21,40
Stranraer,9437,10,10,8,18,50,60,-10,38
Livingston,9438,1,22,4,10,81,48,33,70
Alloa,9438,2,19,8,9,64,40,24,65
Brechin,9438,3,19,7,10,50,42,8,64
Airdrieon,9438,4,19,5,12,60,47,13,62
Albion,9438,5,14,10,12,50,45,5,52
Peterhead,9438,6,15,7,14,49,54,-5,52
Stranraer,9438,7,14,7,15,53,58,-5,49
East Fife,9438,8,8,12,16,49,54,-5,36
Queen's Park,9438,9,10,5,21,30,56,-26,35
Stenhousem'r,9438,10,5,5,26,38,80,-42,20
Livingston,9439,1,23,5,8,90,45,45,74
Alloa,9439,2,20,11,5,72,37,35,71
Airdrieon,9439,3,16,11,9,54,53,1,59
Brechin,9439,4,14,5,17,44,50,-6,47
East Fife,9439,5,11,13,12,47,48,-1,46
Peterhead,9439,6,12,10,14,46,51,-5,46
Albion,9439,7,13,6,17,45,50,-5,45
Queen's Park,9439,8,12,7,17,40,52,-12,43
Stranraer,9439,9,10,8,18,48,60,-12,38
Stenhousem'r,9439,10,7,8,21,45,85,-40,29
Livingston,9440,1,24,1,11,80,50,30,73
Alloa,9440,2,19,8,9,73,44,29,65
Brechin,9440,3,19,5,12,57,50,7,62
Airdrieon,9440,4,17,7,12,60,52,8,58
Peterhead,9440,5,16,5,15,57,54,3,53
Stranraer,9440,6,15,4,17,44,60,-16,49
Albion,9440,7,14,6,16,55,55,0,48
Queen's Park,9440,8,11,6,19,41,58,-17,39
Stenhousem'r,9440,9,8,9,19,62,92,-30,33
East Fife,9440,10,7,9,20,41,55,-14,30
Livingston,9441,1,23,5,8,73,40,33,74
Airdrieon,9441,2,19,7,10,63,44,19,64
Alloa,9441,3,17,10,9,63,48,15,61
Brechin,9441,4,15,7,14,45,43,2,52
Peterhead,9441,5,14,6,16,40,51,-11,48
Albion,9441,6,13,8,15,44,47,-3,47
Queen's Park,9441,7,12,9,15,41,43,-2,45
East Fife,9441,8,10,10,16,45,50,-5,40
Stranraer,9441,9,10,9,17,49,60,-11,39
Stenhousem'r,9441,10,7,9,20,42,79,-37,30
Livingston,9442,1,24,3,9,75,42,33,75
Alloa,9442,2,16,10,10,68,44,24,58
Peterhead,9442,3,16,9,11,52,47,5,57
Airdrieon,9442,4,16,8,12,53,48,5,56
Brechin,9442,5,18,2,16,52,54,-2,56
Stranraer,9442,6,14,4,18,57,55,2,46
East Fife,9442,7,12,7,17,52,57,-5,43
Queen's Park,9442,8,12,6,18,39,57,-18,42
Stenhousem'r,9442,9,11,6,19,50,76,-26,39
Albion,9442,10,9,9,18,48,66,-18,36
Livingston,9443,1,22,2,12,80,51,29,68
Alloa,9443,2,17,11,8,68,40,28,62
Brechin,9443,3,18,5,13,49,51,-2,59
Albion,9443,4,14,11,11,60,51,9,53
Airdrieon,9443,5,15,8,13,62,56,6,53
East Fife,9443,6,14,8,14,53,46,7,50
Stranraer,9443,7,13,7,16,50,57,-7,46
Queen's Park,9443,8,10,9,17,39,54,-15,39
Peterhead,9443,9,10,9,17,40,59,-19,39
Stenhousem'r,9443,10,8,8,20,49,85,-36,32
Livingston,9444,1,20,6,10,70,52,18,66
Alloa,9444,2,20,5,11,74,46,28,65
Brechin,9444,3,17,9,10,46,36,10,60
East Fife,9444,4,15,9,12,54,46,8,54
Airdrieon,9444,5,14,8,14,56,60,-4,50
Stranraer,9444,6,15,5,16,57,63,-6,50
Albion,9444,7,13,8,15,56,52,4,47
Peterhead,9444,8,10,10,16,46,55,-9,40
Queen's Park,9444,9,9,9,18,38,57,-19,36
Stenhousem'r,9444,10,8,9,19,48,78,-30,33
Livingston,9445,1,21,3,12,76,42,34,66
Alloa,9445,2,17,11,8,65,48,17,62
Brechin,9445,3,18,7,11,51,38,13,61
Airdrieon,9445,4,16,8,12,58,57,1,56
Queen's Park,9445,5,16,4,16,39,51,-12,52
Albion,9445,6,13,8,15,44,52,-8,47
Stranraer,9445,7,12,9,15,56,65,-9,45
Peterhead,9445,8,9,12,15,46,53,-7,39
East Fife,9445,9,9,9,18,50,56,-6,36
Stenhousem'r,9445,10,8,11,17,49,72,-23,35
Airdrieon,9446,1,18,8,10,66,54,12,62
Brechin,9446,2,18,7,11,54,51,3,61
Livingston,9446,3,18,6,12,77,52,25,60
Albion,9446,4,17,8,11,68,50,18,59
Alloa,9446,5,15,10,11,70,46,24,55
Peterhead,9446,6,16,6,14,64,67,-3,54
East Fife,9446,7,9,14,13,40,49,-9,41
Queen's Park,9446,8,12,5,19,36,59,-23,41
Stranraer,9446,9,10,7,19,52,66,-14,37
Stenhousem'r,9446,10,8,7,21,49,82,-33,31
Alloa,9447,1,22,5,9,78,44,34,71
Livingston,9447,2,19,3,14,73,56,17,60
Brechin,9447,3,17,8,11,55,48,7,59
East Fife,9447,4,17,7,12,57,46,11,58
Peterhead,9447,5,15,6,15,60,58,2,51
Airdrieon,9447,6,15,4,17,53,63,-10,49
Albion,9447,7,13,8,15,51,52,-1,47
Queen's Park,9447,8,11,8,17,32,49,-17,41
Stenhousem'r,9447,9,11,6,19,54,73,-19,39
Stranraer,9447,10,10,5,21,43,67,-24,35
Alloa,9448,1,19,8,9,75,44,31,65
Livingston,9448,2,20,4,12,77,52,25,64
Peterhead,9448,3,17,8,11,56,45,11,59
Brechin,9448,4,17,5,14,57,46,11,56
Stranraer,9448,5,17,4,15,51,58,-7,55
Airdrieon,9448,6,16,6,14,62,66,-4,54
Albion,9448,7,13,9,14,54,61,-7,48
Queen's Park,9448,8,13,6,17,39,50,-11,45
East Fife,9448,9,8,10,18,43,55,-12,34
Stenhousem'r,9448,10,6,8,22,42,79,-37,26
Livingston,9449,1,24,1,11,80,43,37,73
Alloa,9449,2,17,9,10,67,49,18,60
Airdrieon,9449,3,16,9,11,54,51,3,57
Stranraer,9449,4,16,5,15,58,52,6,53
Albion,9449,5,13,9,14,45,51,-6,48
Queen's Park,9449,6,13,7,16,46,53,-7,46
Brechin,9449,7,13,7,16,44,53,-9,46
Peterhead,9449,8,12,7,17,45,53,-8,43
East Fife,9449,9,11,9,16,45,52,-7,42
Stenhousem'r,9449,10,11,5,20,44,71,-27,38
Livingston,9450,1,19,6,11,70,46,24,63
Alloa,9450,2,18,6,12,72,45,27,60
Airdrieon,9450,3,17,9,10,62,55,7,60
Brechin,9450,4,16,7,13,59,53,6,55
Peterhead,9450,5,15,9,12,46,44,2,54
Albion,9450,6,13,10,13,46,45,1,49
Queen's Park,9450,7,13,9,14,41,55,-14,48
Stranraer,9450,8,13,4,19,55,70,-15,43
East Fife,9450,9,9,9,18,45,56,-11,36
Stenhousem'r,9450,10,9,7,20,50,77,-27,34
Livingston,9451,1,22,6,8,79,45,34,72
Airdrieon,9451,2,21,5,10,61,45,16,68
Brechin,9451,3,18,7,11,49,44,5,61
Queen's Park,9451,4,15,8,13,49,48,1,53
Albion,9451,5,14,10,12,63,51,12,52
East Fife,9451,6,12,10,14,50,56,-6,46
Alloa,9451,7,12,6,18,55,54,1,42
Peterhead,9451,8,9,9,18,41,59,-18,36
Stenhousem'r,9451,9,9,9,18,46,73,-27,36
Stranraer,9451,10,9,8,19,45,63,-18,35
Livingston,9452,1,25,6,5,86,36,50,81
Alloa,9452,2,18,11,7,65,42,23,65
Peterhead,9452,3,17,4,15,59,57,2,55
Airdrieon,9452,4,15,6,15,56,57,-1,51
Stranraer,9452,5,15,6,15,52,58,-6,51
Brechin,9452,6,13,9,14,44,45,-1,48
East Fife,9452,7,9,12,15,39,43,-4,39
Stenhousem'r,9452,8,11,6,19,49,76,-27,39
Queen's Park,9452,9,10,7,19,33,50,-17,37
Albion,9452,10,9,9,18,42,61,-19,36
Livingston,9453,1,24,1,11,87,56,31,73
Airdrieon,9453,2,20,4,12,68,48,20,64
Alloa,9453,3,18,8,10,72,41,31,62
Brechin,9453,4,18,4,14,53,53,0,58
Peterhead,9453,5,14,10,12,47,46,1,52
Albion,9453,6,14,7,15,58,56,2,49
Queen's Park,9453,7,13,8,15,36,50,-14,47
East Fife,9453,8,11,11,14,54,58,-4,44
Stranraer,9453,9,12,5,19,56,73,-17,41
Stenhousem'r,9453,10,3,8,25,34,84,-50,17
Livingston,9454,1,22,6,8,79,42,37,72
Airdrieon,9454,2,19,5,12,74,53,21,62
Alloa,9454,3,17,10,9,68,46,22,61
Albion,9454,4,16,9,11,52,48,4,57
Brechin,9454,5,17,5,14,45,43,2,56
Queen's Park,9454,6,13,6,17,35,49,-14,45
East Fife,9454,7,11,11,14,48,52,-4,44
Peterhead,9454,8,12,7,17,52,61,-9,43
Stranraer,9454,9,14,1,21,57,70,-13,43
Stenhousem'r,9454,10,6,6,24,42,88,-46,24
Airdrieon,9455,1,18,8,10,69,53,16,62
Alloa,9455,2,18,7,11,60,44,16,61
Livingston,9455,3,18,6,12,76,55,21,60
Stranraer,9455,4,17,5,14,55,44,11,56
Queen's Park,9455,5,13,8,15,41,46,-5,47
Albion,9455,6,12,10,14,51,51,0,46
East Fife,9455,7,13,7,16,42,51,-9,46
Brechin,9455,8,12,9,15,37,50,-13,45
Peterhead,9455,9,10,13,13,47,53,-6,43
Stenhousem'r,9455,10,7,11,18,51,82,-31,32
Livingston,9456,1,22,7,7,68,37,31,73
Alloa,9456,2,19,8,9,77,52,25,65
Albion,9456,3,17,7,12,63,54,9,58
Brechin,9456,4,15,8,13,49,40,9,53
Airdrieon,9456,5,14,8,14,55,53,2,50
Peterhead,9456,6,13,8,15,44,54,-10,47
Stranraer,9456,7,12,10,14,56,61,-5,46
East Fife,9456,8,12,7,17,49,49,0,43
Queen's Park,9456,9,9,7,20,36,65,-29,34
Stenhousem'r,9456,10,7,10,19,46,78,-32,31
Livingston,9457,1,21,5,10,72,49,23,68
Alloa,9457,2,19,8,9,71,46,25,65
Airdrieon,9457,3,19,5,12,56,46,10,62
Brechin,9457,4,18,3,15,58,49,9,57
Albion,9457,5,17,6,13,62,54,8,57
Queen's Park,9457,6,14,7,15,36,44,-8,49
East Fife,9457,7,12,10,14,54,62,-8,46
Stranraer,9457,8,11,3,22,40,60,-20,36
Peterhead,9457,9,9,8,19,37,54,-17,35
Stenhousem'r,9457,10,9,7,20,45,67,-22,34
Livingston,9458,1,23,4,9,69,39,30,73
Alloa,9458,2,21,7,8,78,44,34,70
Airdrieon,9458,3,16,7,13,61,55,6,55
Brechin,9458,4,16,7,13,49,50,-1,55
Albion,9458,5,16,5,15,63,54,9,53
East Fife,9458,6,12,8,16,47,43,4,44
Stranraer,9458,7,12,6,18,45,61,-16,42
Queen's Park,9458,8,11,7,18,32,49,-17,40
Peterhead,9458,9,9,11,16,42,56,-14,38
Stenhousem'r,9458,10,9,8,19,53,88,-35,35
Livingston,9459,1,22,2,12,72,45,27,68
Alloa,9459,2,19,5,12,71,43,28,62
Peterhead,9459,3,16,7,13,53,53,0,55
Albion,9459,4,13,10,13,62,57,5,49
Airdrieon,9459,5,14,7,15,51,59,-8,49
East Fife,9459,6,13,9,14,56,52,4,48
Brechin,9459,7,13,7,16,48,58,-10,46
Stranraer,9459,8,13,5,18,53,65,-12,44
Queen's Park,9459,9,12,8,16,41,54,-13,44
Stenhousem'r,9459,10,12,6,18,56,77,-21,42
Livingston,9460,1,22,7,7,86,47,39,73
Albion,9460,2,18,7,11,52,41,11,61
Alloa,9460,3,18,6,12,60,45,15,60
Airdrieon,9460,4,18,6,12,59,55,4,60
Peterhead,9460,5,12,11,13,55,58,-3,47
Stranraer,9460,6,13,7,16,49,52,-3,46
Brechin,9460,7,13,6,17,52,58,-6,45
Queen's Park,9460,8,12,7,17,35,48,-13,43
East Fife,9460,9,11,9,16,43,44,-1,42
Stenhousem'r,9460,10,5,10,21,33,76,-43,25
Brechin,9461,1,22,5,9,59,39,20,71
Livingston,9461,2,22,3,11,81,53,28,69
Alloa,9461,3,15,11,10,65,45,20,56
Albion,9461,4,14,9,13,53,48,5,51
Airdrieon,9461,5,14,9,13,57,66,-9,51
Queen's Park,9461,6,14,7,15,35,45,-10,49
East Fife,9461,7,12,9,15,53,47,6,45
Peterhead,9461,8,12,9,15,49,57,-8,45
Stranraer,9461,9,10,7,19,39,57,-18,37
Stenhousem'r,9461,10,8,5,23,49,83,-34,29
Alloa,9462,1,19,10,7,76,42,34,67
Livingston,9462,2,20,6,10,74,45,29,66
Brechin,9462,3,16,8,12,52,46,6,56
Airdrieon,9462,4,14,13,9,53,50,3,55
Peterhead,9462,5,14,11,11,49,46,3,53
Albion,9462,6,13,10,13,55,58,-3,49
Stranraer,9462,7,12,11,13,52,54,-2,47
Stenhousem'r,9462,8,8,10,18,48,73,-25,34
East Fife,9462,9,7,12,17,43,57,-14,33
Queen's Park,9462,10,7,9,20,31,62,-31,30
Livingston,9463,1,23,4,9,69,34,35,73
Alloa,9463,2,20,8,8,75,42,33,68
Airdrieon,9463,3,19,4,13,65,55,10,61
Peterhead,9463,4,15,6,15,49,58,-9,51
Brechin,9463,5,13,8,15,45,46,-1,47
Albion,9463,6,12,10,14,52,54,-2,46
Queen's Park,9463,7,13,7,16,39,52,-13,46
East Fife,9463,8,12,8,16,53,49,4,44
Stranraer,9463,9,10,6,20,40,66,-26,36
Stenhousem'r,9463,10,8,9,19,50,81,-31,33
Peterhead,9464,1,18,8,10,57,42,15,62
Livingston,9464,2,19,4,13,79,47,32,61
Alloa,9464,3,16,13,7,59,38,21,61
Airdrieon,9464,4,17,9,10,64,67,-3,60
Stranraer,9464,5,17,7,12,58,50,8,58
Brechin,9464,6,16,6,14,45,44,1,54
Albion,9464,7,11,11,14,51,53,-2,44
East Fife,9464,8,9,9,18,43,52,-9,36
Stenhousem'r,9464,9,8,11,17,49,73,-24,35
Queen's Park,9464,10,8,4,24,30,69,-39,28
Livingston,9465,1,22,4,10,69,48,21,70
Alloa,9465,2,20,5,11,62,37,25,65
Airdrieon,9465,3,18,3,15,59,54,5,57
Queen's Park,9465,4,15,7,14,42,45,-3,52
Peterhead,9465,5,14,7,15,47,48,-1,49
Stranraer,9465,6,15,3,18,48,56,-8,48
East Fife,9465,7,14,5,17,55,54,1,47
Brechin,9465,8,14,5,17,53,59,-6,47
Albion,9465,9,11,11,14,53,55,-2,44
Stenhousem'r,9465,10,9,6,21,49,81,-32,33
Livingston,9466,1,20,8,8,83,49,34,68
Alloa,9466,2,19,9,8,68,35,33,66
Airdrieon,9466,3,16,9,11,67,65,2,57
Albion,9466,4,14,10,12,56,50,6,52
Brechin,9466,5,14,10,12,44,42,2,52
East Fife,9466,6,13,10,13,53,46,7,49
Peterhead,9466,7,11,11,14,50,61,-11,44
Stranraer,9466,8,10,7,19,49,69,-20,37
Queen's Park,9466,9,8,10,18,32,58,-26,34
Stenhousem'r,9466,10,8,10,18,45,72,-27,34
Alloa,9467,1,21,5,10,75,41,34,68
Airdrieon,9467,2,19,5,12,55,51,4,62
Livingston,9467,3,17,6,13,78,60,18,57
Stranraer,9467,4,17,6,13,59,53,6,57
Peterhead,9467,5,16,7,13,45,40,5,55
Brechin,9467,6,15,7,14,48,56,-8,52
Albion,9467,7,14,6,16,53,61,-8,48
East Fife,9467,8,13,7,16,59,49,10,46
Queen's Park,9467,9,10,6,20,31,59,-28,36
Stenhousem'r,9467,10,6,9,21,54,87,-33,27
Livingston,9468,1,25,2,9,78,39,39,77
Alloa,9468,2,18,8,10,71,43,28,62
Brechin,9468,3,18,5,13,57,51,6,59
Airdrieon,9468,4,16,10,10,64,51,13,58
Peterhead,9468,5,15,9,12,56,43,13,54
Albion,9468,6,14,8,14,51,57,-6,50
East Fife,9468,7,12,7,17,43,53,-10,43
Stranraer,9468,8,11,4,21,42,70,-28,37
Queen's Park,9468,9,10,6,20,31,56,-25,36
Stenhousem'r,9468,10,7,9,20,35,65,-30,30
Alloa,9469,1,17,9,10,66,42,24,60
Livingston,9469,2,17,5,14,68,56,12,56
Airdrieon,9469,3,15,11,10,61,51,10,56
Brechin,9469,4,16,7,13,53,49,4,55
Albion,9469,5,14,12,10,63,50,13,54
Stranraer,9469,6,15,5,16,53,59,-6,50
Stenhousem'r,9469,7,12,9,15,55,70,-15,45
Peterhead,9469,8,11,9,16,43,57,-14,42
East Fife,9469,9,10,9,17,47,56,-9,39
Queen's Park,9469,10,9,12,15,39,58,-19,39
Alloa,9470,1,18,9,9,72,47,25,63
Brechin,9470,2,20,3,13,66,50,16,63
Airdrieon,9470,3,19,3,14,66,60,6,60
Livingston,9470,4,17,7,12,74,49,25,58
Peterhead,9470,5,15,7,14,67,59,8,52
Albion,9470,6,14,9,13,51,48,3,51
Queen's Park,9470,7,15,6,15,42,51,-9,51
Stranraer,9470,8,10,11,15,44,59,-15,41
East Fife,9470,9,10,7,19,43,59,-16,37
Stenhousem'r,9470,10,6,10,20,47,90,-43,28
Alloa,9471,1,21,7,8,78,48,30,70
Airdrieon,9471,2,21,3,12,59,46,13,66
Livingston,9471,3,19,7,10,71,52,19,64
Albion,9471,4,15,10,11,54,46,8,55
Brechin,9471,5,16,7,13,50,44,6,55
East Fife,9471,6,12,10,14,54,44,10,46
Peterhead,9471,7,12,10,14,52,55,-3,46
Stranraer,9471,8,12,7,17,56,67,-11,43
Queen's Park,9471,9,8,10,18,29,54,-25,34
Stenhousem'r,9471,10,4,9,23,43,90,-47,21
Livingston,9472,1,20,8,8,78,47,31,68
Brechin,9472,2,17,9,10,47,41,6,60
Airdrieon,9472,3,18,5,13,61,54,7,59
Stranraer,9472,4,17,5,14,63,59,4,56
East Fife,9472,5,14,10,12,59,57,2,52
Alloa,9472,6,13,9,14,59,54,5,48
Albion,9472,7,13,8,15,53,53,0,47
Queen's Park,9472,8,12,7,17,40,61,-21,43
Peterhead,9472,9,10,8,18,43,53,-10,38
Stenhousem'r,9472,10,9,5,22,46,70,-24,32
Livingston,9473,1,25,3,8,72,39,33,78
Brechin,9473,2,18,6,12,58,49,9,60
Queen's Park,9473,3,16,7,13,41,42,-1,55
Alloa,9473,4,15,8,13,56,46,10,53
Airdrieon,9473,5,15,8,13,52,53,-1,53
Peterhead,9473,6,14,8,14,47,47,0,50
Albion,9473,7,11,12,13,58,55,3,45
Stranraer,9473,8,11,6,19,48,59,-11,39
East Fife,9473,9,9,8,19,52,60,-8,35
Stenhousem'r,9473,10,8,10,18,47,81,-34,34
Alloa,9474,1,17,12,7,73,48,25,63
Livingston,9474,2,18,7,11,78,48,30,61
Airdrieon,9474,3,17,9,10,56,50,6,60
East Fife,9474,4,16,8,12,61,48,13,56
Albion,9474,5,14,11,11,46,45,1,53
Brechin,9474,6,14,8,14,50,51,-1,50
Peterhead,9474,7,13,10,13,50,50,0,49
Queen's Park,9474,8,9,11,16,33,55,-22,38
Stranraer,9474,9,10,5,21,42,63,-21,35
Stenhousem'r,9474,10,6,11,19,45,76,-31,29
Alloa,9475,1,21,8,7,77,39,38,71
Livingston,9475,2,21,3,12,70,48,22,66
Albion,9475,3,13,13,10,54,48,6,52
Airdrieon,9475,4,15,5,16,55,58,-3,50
Queen's Park,9475,5,14,8,14,47,55,-8,50
Peterhead,9475,6,13,10,13,56,57,-1,49
East Fife,9475,7,10,13,13,43,43,0,43
Brechin,9475,8,10,13,13,41,51,-10,43
Stranraer,9475,9,11,6,19,44,59,-15,39
Stenhousem'r,9475,10,8,9,19,49,78,-29,33
Livingston,9476,1,21,5,10,78,46,32,68
Alloa,9476,2,18,8,10,62,38,24,62
Albion,9476,3,16,8,12,59,52,7,56
Airdrieon,9476,4,15,8,13,53,55,-2,53
Peterhead,9476,5,15,8,13,49,52,-3,53
Brechin,9476,6,16,4,16,48,43,5,52
East Fife,9476,7,11,10,15,51,58,-7,43
Queen's Park,9476,8,12,7,17,33,49,-16,43
Stenhousem'r,9476,9,10,9,17,60,78,-18,39
Stranraer,9476,10,11,3,22,44,66,-22,36
Alloa,9477,1,20,8,8,68,38,30,68
Livingston,9477,2,20,4,12,74,45,29,64
Albion,9477,3,19,6,11,62,52,10,63
Airdrieon,9477,4,15,6,15,53,56,-3,51
Brechin,9477,5,15,5,16,47,51,-4,50
Stranraer,9477,6,13,10,13,49,51,-2,49
Queen's Park,9477,7,14,7,15,45,50,-5,49
East Fife,9477,8,10,11,15,47,47,0,41
Peterhead,9477,9,9,11,16,43,60,-17,38
Stenhousem'r,9477,10,8,6,22,41,79,-38,30
Livingston,9478,1,18,8,10,71,49,22,62
Alloa,9478,2,17,10,9,75,46,29,61
Peterhead,9478,3,17,9,10,55,48,7,60
Airdrieon,9478,4,19,3,14,54,53,1,60
Albion,9478,5,15,7,14,60,55,5,52
East Fife,9478,6,14,7,15,57,51,6,49
Brechin,9478,7,14,7,15,53,51,2,49
Queen's Park,9478,8,13,8,15,36,49,-13,47
Stranraer,9478,9,11,7,18,54,65,-11,40
Stenhousem'r,9478,10,5,8,23,44,92,-48,23
Livingston,9479,1,21,4,11,90,55,35,67
Alloa,9479,2,16,11,9,64,47,17,59
Peterhead,9479,3,17,6,13,51,44,7,57
Brechin,9479,4,16,6,14,50,51,-1,54
Airdrieon,9479,5,15,5,16,51,62,-11,50
Queen's Park,9479,6,15,5,16,41,57,-16,50
East Fife,9479,7,12,9,15,57,53,4,45
Stranraer,9479,8,11,9,16,51,54,-3,42
Stenhousem'r,9479,9,11,7,18,52,75,-23,40
Albion,9479,10,9,12,15,51,60,-9,39
Alloa,9480,1,21,8,7,76,44,32,71
Brechin,9480,2,18,7,11,52,48,4,61
Airdrieon,9480,3,17,8,11,56,43,13,59
Livingston,9480,4,16,5,15,68,64,4,53
Peterhead,9480,5,14,10,12,52,51,1,52
East Fife,9480,6,13,10,13,54,44,10,49
Stranraer,9480,7,13,4,19,61,65,-4,43
Albion,9480,8,11,8,17,46,63,-17,41
Queen's Park,9480,9,10,7,19,37,55,-18,37
Stenhousem'r,9480,10,9,9,18,54,79,-25,36
Alloa,9481,1,21,6,9,87,42,45,69
Brechin,9481,2,22,2,12,56,48,8,68
Livingston,9481,3,20,5,11,72,49,23,65
Airdrieon,9481,4,16,8,12,57,51,6,56
Albion,9481,5,16,5,15,69,63,6,53
East Fife,9481,6,14,8,14,50,56,-6,50
Stranraer,9481,7,14,4,18,61,70,-9,46
Peterhead,9481,8,11,9,16,52,61,-9,42
Queen's Park,9481,9,8,7,21,30,56,-26,31
Stenhousem'r,9481,10,7,8,21,41,79,-38,29
Alloa,9482,1,20,6,10,67,45,22,66
Livingston,9482,2,19,5,12,72,52,20,62
Brechin,9482,3,18,6,12,53,40,13,60
Airdrieon,9482,4,16,7,13,62,59,3,55
Peterhead,9482,5,15,9,12,52,54,-2,54
Albion,9482,6,14,8,14,51,50,1,50
Queen's Park,9482,7,12,6,18,37,50,-13,42
Stranraer,9482,8,11,7,18,48,63,-15,40
East Fife,9482,9,10,9,17,46,48,-2,39
Stenhousem'r,9482,10,10,7,19,40,67,-27,37
Alloa,9483,1,21,8,7,79,36,43,71
Livingston,9483,2,19,6,11,67,49,18,63
Airdrieon,9483,3,17,6,13,60,49,11,57
Albion,9483,4,15,9,12,51,44,7,54
Brechin,9483,5,15,7,14,45,53,-8,52
Peterhead,9483,6,12,10,14,45,52,-7,46
Queen's Park,9483,7,12,7,17,31,45,-14,43
East Fife,9483,8,11,7,18,43,50,-7,40
Stranraer,9483,9,9,12,15,45,55,-10,39
Stenhousem'r,9483,10,8,10,18,41,74,-33,34
Livingston,9484,1,23,4,9,74,42,32,73
Brechin,9484,2,22,4,10,65,45,20,70
Alloa,9484,3,18,10,8,74,43,31,64
Airdrieon,9484,4,15,7,14,52,57,-5,52
Queen's Park,9484,5,13,12,11,44,52,-8,51
East Fife,9484,6,12,10,14,46,45,1,46
Peterhead,9484,7,12,8,16,54,56,-2,44
Albion,9484,8,10,11,15,52,57,-5,41
Stranraer,9484,9,12,3,21,52,78,-26,39
Stenhousem'r,9484,10,6,5,25,39,77,-38,23
Livingston,9485,1,21,8,7,73,43,30,71
Albion,9485,2,17,8,11,52,40,12,59
Alloa,9485,3,15,10,11,64,44,20,55
Airdrieon,9485,4,15,10,11,56,51,5,55
Peterhead,9485,5,14,12,10,49,48,1,54
Brechin,9485,6,15,7,14,49,46,3,52
Stranraer,9485,7,12,7,17,49,61,-12,43
East Fife,9485,8,11,8,17,47,52,-5,41
Stenhousem'r,9485,9,9,9,18,47,70,-23,36
Queen's Park,9485,10,7,9,20,33,64,-31,30
Alloa,9486,1,22,7,7,89,45,44,73
Airdrieon,9486,2,20,5,11,64,54,10,65
Livingston,9486,3,18,6,12,72,49,23,60
Brechin,9486,4,17,6,13,49,49,0,57
Albion,9486,5,14,7,15,49,48,1,49
Peterhead,9486,6,14,5,17,41,58,-17,47
Queen's Park,9486,7,13,7,16,46,53,-7,46
East Fife,9486,8,11,8,17,42,51,-9,41
Stranraer,9486,9,11,8,17,45,56,-11,41
Stenhousem'r,9486,10,7,7,22,43,77,-34,28
Alloa,9487,1,23,3,10,72,40,32,72
Airdrieon,9487,2,20,7,9,58,41,17,67
Brechin,9487,3,19,5,12,61,50,11,62
Livingston,9487,4,19,4,13,72,50,22,61
Albion,9487,5,13,10,13,56,55,1,49
Peterhead,9487,6,14,5,17,52,58,-6,47
Stranraer,9487,7,12,8,16,52,61,-9,44
Queen's Park,9487,8,12,7,17,47,59,-12,43
East Fife,9487,9,11,7,18,46,47,-1,40
Stenhousem'r,9487,10,6,6,24,42,97,-55,24
Livingston,9488,1,25,4,7,84,46,38,79
Alloa,9488,2,19,7,10,66,45,21,64
Brechin,9488,3,19,7,10,57,45,12,64
Airdrieon,9488,4,18,5,13,55,53,2,59
Albion,9488,5,14,9,13,45,47,-2,51
Peterhead,9488,6,13,9,14,50,54,-4,48
East Fife,9488,7,11,7,18,51,56,-5,40
Stranraer,9488,8,10,7,19,52,63,-11,37
Stenhousem'r,9488,9,9,7,20,51,74,-23,34
Queen's Park,9488,10,7,8,21,33,61,-28,29
Livingston,9489,1,23,4,9,80,46,34,73
Brechin,9489,2,22,4,10,54,37,17,70
Alloa,9489,3,16,11,9,65,44,21,59
Airdrieon,9489,4,14,10,12,55,54,1,52
Albion,9489,5,13,10,13,54,50,4,49
Stranraer,9489,6,14,7,15,49,52,-3,49
Peterhead,9489,7,13,9,14,53,54,-1,48
East Fife,9489,8,9,9,18,38,53,-15,36
Queen's Park,9489,9,9,8,19,32,58,-26,35
Stenhousem'r,9489,10,7,8,21,52,84,-32,29
Livingston,9490,1,22,6,8,88,54,34,72
Alloa,9490,2,20,9,7,72,40,32,69
Brechin,9490,3,18,6,12,54,48,6,60
Peterhead,9490,4,15,6,15,54,59,-5,51
Queen's Park,9490,5,16,3,17,45,55,-10,51
Albion,9490,6,14,5,17,57,58,-1,47
Airdrieon,9490,7,13,8,15,56,68,-12,47
Stranraer,9490,8,12,6,18,43,51,-8,42
East Fife,9490,9,10,11,15,43,45,-2,41
Stenhousem'r,9490,10,7,6,23,44,78,-34,27
Livingston,9491,1,25,1,10,77,44,33,76
Airdrieon,9491,2,19,5,12,58,51,7,62
Alloa,9491,3,18,4,14,64,46,18,58
Brechin,9491,4,17,6,13,49,39,10,57
Albion,9491,5,17,5,14,56,44,12,56
Peterhead,9491,6,13,7,16,46,53,-7,46
East Fife,9491,7,12,8,16,44,46,-2,44
Queen's Park,9491,8,11,7,18,45,54,-9,40
Stenhousem'r,9491,9,12,4,20,45,80,-35,40
Stranraer,9491,10,11,3,22,36,63,-27,36
Alloa,9492,1,20,6,10,74,47,27,66
Livingston,9492,2,18,7,11,64,41,23,61
Brechin,9492,3,16,9,11,62,61,1,57
Stranraer,9492,4,16,5,15,64,53,11,53
Airdrieon,9492,5,15,6,15,53,57,-4,51
Peterhead,9492,6,12,10,14,50,55,-5,46
Albion,9492,7,12,9,15,52,56,-4,45
East Fife,9492,8,10,12,14,49,56,-7,42
Queen's Park,9492,9,12,5,19,36,52,-16,41
Stenhousem'r,9492,10,11,7,18,49,75,-26,40
Livingston,9493,1,22,8,6,80,42,38,74
Alloa,9493,2,19,8,9,71,46,25,65
Airdrieon,9493,3,15,9,12,57,54,3,54
Brechin,9493,4,13,11,12,45,44,1,50
Stenhousem'r,9493,5,14,7,15,61,72,-11,49
East Fife,9493,6,12,11,13,55,45,10,47
Stranraer,9493,7,14,3,19,44,58,-14,45
Peterhead,9493,8,12,7,17,43,55,-12,43
Albion,9493,9,10,7,19,45,64,-19,37
Queen's Park,9493,10,10,7,19,32,53,-21,37
Livingston,9494,1,24,1,11,80,45,35,73
Alloa,9494,2,17,7,12,73,50,23,58
Brechin,9494,3,16,7,13,52,53,-1,55
Airdrieon,9494,4,16,4,16,57,56,1,52
East Fife,9494,5,14,9,13,51,46,5,51
Peterhead,9494,6,14,7,15,46,54,-8,49
Albion,9494,7,12,10,14,52,54,-2,46
Stranraer,9494,8,14,4,18,52,55,-3,46
Queen's Park,9494,9,12,7,17,33,56,-23,43
Stenhousem'r,9494,10,10,6,20,44,71,-27,36
Alloa,9495,1,21,5,10,77,45,32,68
Albion,9495,2,16,12,8,58,43,15,60
Airdrieon,9495,3,17,8,11,56,49,7,59
Brechin,9495,4,15,10,11,48,46,2,55
Livingston,9495,5,16,4,16,72,60,12,52
Peterhead,9495,6,13,10,13,48,55,-7,49
Stranraer,9495,7,13,7,16,51,60,-9,46
East Fife,9495,8,10,13,13,48,51,-3,43
Queen's Park,9495,9,11,7,18,38,55,-17,40
Stenhousem'r,9495,10,6,8,22,48,80,-32,26
Livingston,9496,1,19,6,11,77,48,29,63
Airdrieon,9496,2,17,7,12,52,46,6,58
Stranraer,9496,3,17,7,12,51,47,4,58
Peterhead,9496,4,15,7,14,54,52,2,52
Alloa,9496,5,14,9,13,62,47,15,51
East Fife,9496,6,14,8,14,48,47,1,50
Albion,9496,7,12,12,12,53,54,-1,48
Brechin,9496,8,13,7,16,41,48,-7,46
Queen's Park,9496,9,12,8,16,43,61,-18,44
Stenhousem'r,9496,10,8,7,21,47,78,-31,31
Livingston,9497,1,21,4,11,76,50,26,67
Alloa,9497,2,17,11,8,63,44,19,62
Brechin,9497,3,16,7,13,56,44,12,55
Queen's Park,9497,4,16,6,14,42,47,-5,54
Stranraer,9497,5,15,6,15,50,54,-4,51
Airdrieon,9497,6,14,8,14,53,58,-5,50
Peterhead,9497,7,11,13,12,50,52,-2,46
Albion,9497,8,11,8,17,55,67,-12,41
Stenhousem'r,9497,9,9,11,16,44,71,-27,38
East Fife,9497,10,9,8,19,52,54,-2,35
Livingston,9498,1,22,6,8,73,42,31,72
Alloa,9498,2,21,4,11,68,43,25,67
Airdrieon,9498,3,14,8,14,59,59,0,50
Brechin,9498,4,15,5,16,43,49,-6,50
Albion,9498,5,15,4,17,55,61,-6,49
East Fife,9498,6,12,11,13,46,37,9,47
Stranraer,9498,7,15,2,19,47,55,-8,47
Queen's Park,9498,8,13,7,16,37,46,-9,46
Peterhead,9498,9,11,9,16,38,51,-13,42
Stenhousem'r,9498,10,12,4,20,48,71,-23,40
Alloa,9499,1,19,10,7,66,40,26,67
Albion,9499,2,19,8,9,66,47,19,65
Livingston,9499,3,18,8,10,65,42,23,62
Peterhead,9499,4,16,9,11,50,44,6,57
Brechin,9499,5,17,6,13,48,43,5,57
Airdrieon,9499,6,16,5,15,54,56,-2,53
East Fife,9499,7,12,10,14,58,52,6,46
Queen's Park,9499,8,11,6,19,33,53,-20,39
Stranraer,9499,9,9,5,22,46,64,-18,32
Stenhousem'r,9499,10,6,7,23,41,86,-45,25
Alloa,9500,1,22,4,10,81,42,39,70
Livingston,9500,2,21,4,11,66,47,19,67
Airdrieon,9500,3,18,4,14,62,58,4,58
Brechin,9500,4,17,6,13,45,46,-1,57
Stranraer,9500,5,16,7,13,54,46,8,55
Albion,9500,6,13,12,11,50,49,1,51
Queen's Park,9500,7,14,5,17,35,46,-11,47
East Fife,9500,8,11,9,16,43,48,-5,42
Peterhead,9500,9,11,9,16,49,56,-7,42
Stenhousem'r,9500,10,4,6,26,40,87,-47,18
Livingston,9501,1,23,9,4,93,46,47,78
Alloa,9501,2,16,11,9,69,48,21,59
Brechin,9501,3,17,8,11,52,41,11,59
Airdrieon,9501,4,16,4,16,64,66,-2,52
Peterhead,9501,5,13,11,12,52,52,0,50
Albion,9501,6,14,8,14,49,52,-3,50
Stranraer,9501,7,12,8,16,44,55,-11,44
East Fife,9501,8,10,9,17,44,46,-2,39
Queen's Park,9501,9,9,9,18,30,55,-25,36
Stenhousem'r,9501,10,8,7,21,45,81,-36,31
Alloa,9502,1,22,5,9,71,38,33,71
Airdrieon,9502,2,20,6,10,62,45,17,66
Albion,9502,3,17,8,11,53,50,3,59
Peterhead,9502,4,17,6,13,51,46,5,57
East Fife,9502,5,15,8,13,54,43,11,53
Livingston,9502,6,16,4,16,67,57,10,52
Brechin,9502,7,15,7,14,47,47,0,52
Stranraer,9502,8,13,3,20,43,58,-15,42
Queen's Park,9502,9,12,4,20,33,61,-28,40
Stenhousem'r,9502,10,4,7,25,43,79,-36,19
Livingston,9503,1,23,6,7,80,49,31,75
Airdrieon,9503,2,17,11,8,61,51,10,62
Alloa,9503,3,17,10,9,64,38,26,61
Brechin,9503,4,16,8,12,44,46,-2,56
Peterhead,9503,5,12,9,15,55,57,-2,45
Stenhousem'r,9503,6,10,13,13,52,62,-10,43
Stranraer,9503,7,11,8,17,51,54,-3,41
Queen's Park,9503,8,9,11,16,28,49,-21,38
East Fife,9503,9,9,10,17,39,48,-9,37
Albion,9503,10,10,6,20,39,59,-20,36
Livingston,9504,1,25,2,9,89,47,42,77
Alloa,9504,2,18,8,10,79,52,27,62
Airdrieon,9504,3,15,10,11,49,51,-2,55
Brechin,9504,4,15,7,14,50,47,3,52
Stranraer,9504,5,14,7,15,55,63,-8,49
Queen's Park,9504,6,12,11,13,46,58,-12,47
East Fife,9504,7,13,7,16,49,38,11,46
Peterhead,9504,8,11,9,16,42,52,-10,42
Stenhousem'r,9504,9,9,9,18,59,87,-28,36
Albion,9504,10,8,10,18,45,68,-23,34
Alloa,9505,1,21,9,6,71,38,33,72
Livingston,9505,2,18,8,10,80,49,31,62
Airdrieon,9505,3,18,8,10,64,61,3,62
Brechin,9505,4,15,6,15,55,52,3,51
Stranraer,9505,5,15,4,17,54,63,-9,49
Peterhead,9505,6,14,6,16,46,56,-10,48
East Fife,9505,7,11,10,15,49,48,1,43
Queen's Park,9505,8,11,8,17,33,52,-19,41
Albion,9505,9,9,10,17,52,58,-6,37
Stenhousem'r,9505,10,9,9,18,47,74,-27,36
Livingston,9506,1,20,2,14,68,49,19,62
Alloa,9506,2,18,7,11,66,49,17,61
Brechin,9506,3,17,8,11,54,48,6,59
Peterhead,9506,4,15,12,9,53,42,11,57
Airdrieon,9506,5,17,5,14,63,57,6,56
Albion,9506,6,15,10,11,50,41,9,55
East Fife,9506,7,14,8,14,55,45,10,50
Stranraer,9506,8,13,5,18,53,61,-8,44
Queen's Park,9506,9,9,7,20,29,58,-29,34
Stenhousem'r,9506,10,6,8,22,44,85,-41,26
Livingston,9507,1,18,7,11,64,48,16,61
Airdrieon,9507,2,17,10,9,62,53,9,61
Alloa,9507,3,16,11,9,57,40,17,59
Albion,9507,4,16,7,13,58,52,6,55
Peterhead,9507,5,15,7,14,53,49,4,52
Queen's Park,9507,6,14,7,15,38,46,-8,49
East Fife,9507,7,12,7,17,54,57,-3,43
Stranraer,9507,8,11,9,16,46,50,-4,42
Brechin,9507,9,10,12,14,43,53,-10,42
Stenhousem'r,9507,10,8,9,19,47,74,-27,33
Airdrieon,9508,1,22,4,10,63,51,12,70
Brechin,9508,2,17,6,13,53,43,10,57
Alloa,9508,3,16,8,12,60,40,20,56
Livingston,9508,4,16,5,15,74,48,26,53
Stranraer,9508,5,15,8,13,49,46,3,53
Albion,9508,6,14,7,15,56,63,-7,49
Queen's Park,9508,7,12,10,14,35,51,-16,46
Peterhead,9508,8,12,7,17,53,60,-7,43
East Fife,9508,9,11,9,16,42,51,-9,42
Stenhousem'r,9508,10,11,4,21,49,81,-32,37
Livingston,9509,1,22,4,10,78,47,31,70
Peterhead,9509,2,17,8,11,50,47,3,59
Alloa,9509,3,15,9,12,64,49,15,54
Albion,9509,4,16,6,14,53,54,-1,54
Airdrieon,9509,5,14,11,11,64,62,2,53
Brechin,9509,6,14,6,16,45,52,-7,48
East Fife,9509,7,12,9,15,46,43,3,45
Queen's Park,9509,8,12,8,16,38,46,-8,44
Stranraer,9509,9,11,9,16,56,59,-3,42
Stenhousem'r,9509,10,9,6,21,47,82,-35,33
Alloa,9510,1,19,9,8,69,38,31,66
Livingston,9510,2,19,4,13,70,49,21,61
Airdrieon,9510,3,18,7,11,59,49,10,61
Brechin,9510,4,17,5,14,50,52,-2,56
Peterhead,9510,5,15,7,14,53,55,-2,52
Albion,9510,6,14,6,16,47,47,0,48
East Fife,9510,7,11,11,14,43,44,-1,44
Queen's Park,9510,8,10,11,15,31,48,-17,41
Stranraer,9510,9,10,9,17,47,60,-13,39
Stenhousem'r,9510,10,8,9,19,47,74,-27,33
Livingston,9511,1,20,5,11,76,49,27,65
Alloa,9511,2,19,7,10,71,49,22,64
Albion,9511,3,18,6,12,63,51,12,60
Airdrieon,9511,4,16,7,13,58,57,1,55
Brechin,9511,5,17,4,15,50,55,-5,55
Peterhead,9511,6,12,8,16,42,55,-13,44
Stranraer,9511,7,12,7,17,54,61,-7,43
East Fife,9511,8,10,10,16,44,49,-5,40
Queen's Park,9511,9,10,10,16,37,49,-12,40
Stenhousem'r,9511,10,11,6,19,47,67,-20,39
Alloa,9512,1,18,9,9,76,47,29,63
Brechin,9512,2,18,9,9,57,46,11,63
Livingston,9512,3,19,5,12,72,44,28,62
Airdrieon,9512,4,15,10,11,62,57,5,55
Queen's Park,9512,5,15,7,14,38,47,-9,52
Stranraer,9512,6,13,11,12,59,49,10,50
Peterhead,9512,7,11,11,14,45,60,-15,44
Albion,9512,8,11,9,16,52,60,-8,42
East Fife,9512,9,10,9,17,46,52,-6,39
Stenhousem'r,9512,10,6,8,22,50,95,-45,26
Airdrieon,9513,1,21,4,11,67,52,15,67
Alloa,9513,2,20,5,11,74,50,24,65
Livingston,9513,3,20,3,13,69,45,24,63
Peterhead,9513,4,18,7,11,60,49,11,61
Brechin,9513,5,15,6,15,54,53,1,51
Queen's Park,9513,6,14,8,14,37,49,-12,50
East Fife,9513,7,11,9,16,46,54,-8,42
Stranraer,9513,8,12,5,19,50,62,-12,41
Stenhousem'r,9513,9,10,8,18,56,79,-23,38
Albion,9513,10,8,7,21,44,64,-20,31
Airdrieon,9514,1,20,6,10,68,51,17,66
Brechin,9514,2,20,6,10,54,43,11,66
Livingston,9514,3,20,5,11,74,51,23,65
Alloa,9514,4,19,5,12,66,46,20,62
East Fife,9514,5,13,8,15,48,41,7,47
Peterhead,9514,6,13,6,17,44,54,-10,45
Albion,9514,7,11,9,16,52,58,-6,42
Stranraer,9514,8,13,3,20,43,53,-10,42
Stenhousem'r,9514,9,11,5,20,52,77,-25,38
Queen's Park,9514,10,11,5,20,36,63,-27,38
Livingston,9515,1,22,4,10,78,47,31,70
Airdrieon,9515,2,20,7,9,64,47,17,67
Alloa,9515,3,18,11,7,73,45,28,65
Albion,9515,4,13,11,12,53,52,1,50
Peterhead,9515,5,14,7,15,54,58,-4,49
East Fife,9515,6,13,7,16,48,45,3,46
Queen's Park,9515,7,13,6,17,47,55,-8,45
Brechin,9515,8,13,6,17,43,53,-10,45
Stranraer,9515,9,10,7,19,51,73,-22,37
Stenhousem'r,9515,10,7,8,21,46,82,-36,29
Livingston,9516,1,22,3,11,80,52,28,69
Alloa,9516,2,20,5,11,68,45,23,65
East Fife,9516,3,15,11,10,57,43,14,56
Peterhead,9516,4,17,5,14,53,50,3,56
Brechin,9516,5,14,8,14,48,54,-6,50
Airdrieon,9516,6,14,6,16,60,62,-2,48
Stranraer,9516,7,13,8,15,47,57,-10,47
Queen's Park,9516,8,11,10,15,48,55,-7,43
Albion,9516,9,12,7,17,42,50,-8,43
Stenhousem'r,9516,10,7,7,22,35,70,-35,28
Livingston,9517,1,20,8,8,82,44,38,68
Alloa,9517,2,19,8,9,68,39,29,65
Brechin,9517,3,18,4,14,50,50,0,58
Airdrieon,9517,4,16,5,15,49,52,-3,53
Stranraer,9517,5,15,5,16,42,50,-8,50
Peterhead,9517,6,13,10,13,54,57,-3,49
Queen's Park,9517,7,13,10,13,45,49,-4,49
Albion,9517,8,11,12,13,57,54,3,45
East Fife,9517,9,11,11,14,52,54,-2,44
Stenhousem'r,9517,10,4,7,25,40,90,-50,19
Airdrieon,9518,1,22,4,10,63,48,15,70
Livingston,9518,2,19,5,12,70,47,23,62
Alloa,9518,3,18,7,11,67,48,19,61
East Fife,9518,4,14,10,12,49,42,7,52
Albion,9518,5,14,9,13,45,43,2,51
Brechin,9518,6,14,9,13,44,49,-5,51
Peterhead,9518,7,11,13,12,46,47,-1,46
Stranraer,9518,8,12,8,16,50,55,-5,44
Queen's Park,9518,9,10,9,17,34,47,-13,39
Stenhousem'r,9518,10,6,6,24,48,90,-42,24
Livingston,9519,1,22,5,9,86,53,33,71
Brechin,9519,2,19,5,12,56,43,13,62
Airdrieon,9519,3,18,6,12,71,60,11,60
Peterhead,9519,4,15,10,11,54,52,2,55
Alloa,9519,5,14,11,11,64,55,9,53
Albion,9519,6,12,14,10,49,44,5,50
Queen's Park,9519,7,12,9,15,39,51,-12,45
Stranraer,9519,8,12,6,18,51,62,-11,42
East Fife,9519,9,8,11,17,48,56,-8,35
Stenhousem'r,9519,10,6,7,23,36,78,-42,25
Brechin,9520,1,22,4,10,58,44,14,70
Livingston,9520,2,20,5,11,85,50,35,65
Alloa,9520,3,19,8,9,71,44,27,65
Airdrieon,9520,4,14,8,14,55,60,-5,50
Stranraer,9520,5,15,4,17,55,54,1,49
East Fife,9520,6,12,9,15,46,48,-2,45
Peterhead,9520,7,11,10,15,51,58,-7,43
Albion,9520,8,10,9,17,50,65,-15,39
Stenhousem'r,9520,9,11,6,19,60,81,-21,39
Queen's Park,9520,10,10,9,17,29,56,-27,39
Livingston,9521,1,21,8,7,79,36,43,71
Alloa,9521,2,20,9,7,65,44,21,69
Brechin,9521,3,18,7,11,55,43,12,61
Peterhead,9521,4,15,9,12,51,48,3,54
East Fife,9521,5,13,6,17,47,53,-6,45
Queen's Park,9521,6,12,9,15,35,46,-11,45
Albion,9521,7,11,9,16,49,58,-9,42
Airdrieon,9521,8,10,11,15,57,65,-8,41
Stranraer,9521,9,11,7,18,50,54,-4,40
Stenhousem'r,9521,10,9,5,22,43,84,-41,32
Alloa,9522,1,19,9,8,73,39,34,66
Livingston,9522,2,20,5,11,69,46,23,65
Airdrieon,9522,3,19,7,10,69,46,23,64
Brechin,9522,4,14,11,11,45,46,-1,53
Stranraer,9522,5,15,6,15,60,54,6,51
Peterhead,9522,6,12,8,16,43,58,-15,44
East Fife,9522,7,11,10,15,53,48,5,43
Albion,9522,8,9,11,16,42,55,-13,38
Queen's Park,9522,9,10,8,18,32,61,-29,38
Stenhousem'r,9522,10,10,7,19,37,70,-33,37
Livingston,9523,1,18,9,9,82,49,33,63
Alloa,9523,2,18,9,9,77,45,32,63
Airdrieon,9523,3,17,6,13,64,57,7,57
Peterhead,9523,4,16,9,11,48,47,1,57
Brechin,9523,5,16,5,15,44,49,-5,53
East Fife,9523,6,13,9,14,51,56,-5,48
Albion,9523,7,13,7,16,54,55,-1,46
Queen's Park,9523,8,13,6,17,36,46,-10,45
Stranraer,9523,9,12,7,17,47,60,-13,43
Stenhousem'r,9523,10,7,7,22,43,82,-39,28
Alloa,9524,1,23,4,9,72,39,33,73
Airdrieon,9524,2,21,7,8,72,50,22,70
Brechin,9524,3,19,7,10,66,52,14,64
Livingston,9524,4,18,6,12,80,53,27,60
Albion,9524,5,12,8,16,49,58,-9,44
East Fife,9524,6,11,9,16,46,49,-3,42
Queen's Park,9524,7,10,9,17,37,48,-11,39
Stranraer,9524,8,12,3,21,52,67,-15,39
Peterhead,9524,9,10,9,17,45,68,-23,39
Stenhousem'r,9524,10,9,8,19,47,82,-35,35
Livingston,9525,1,22,4,10,85,45,40,70
Alloa,9525,2,17,9,10,70,45,25,60
Airdrieon,9525,3,18,5,13,66,56,10,59
Stranraer,9525,4,16,7,13,53,50,3,55
Peterhead,9525,5,14,11,11,46,47,-1,53
Albion,9525,6,15,7,14,59,52,7,52
Brechin,9525,7,13,7,16,45,58,-13,46
East Fife,9525,8,12,9,15,55,51,4,45
Queen's Park,9525,9,11,7,18,33,59,-26,40
Stenhousem'r,9525,10,5,8,23,44,93,-49,23
Livingston,9526,1,26,2,8,88,43,45,80
Brechin,9526,2,19,5,12,51,43,8,62
Alloa,9526,3,16,7,13,69,57,12,55
Airdrieon,9526,4,16,7,13,73,64,9,55
Peterhead,9526,5,16,5,15,56,59,-3,53
Stranraer,9526,6,14,5,17,53,56,-3,47
Albion,9526,7,12,10,14,47,51,-4,46
East Fife,9526,8,9,12,15,46,52,-6,39
Queen's Park,9526,9,10,7,19,38,61,-23,37
Stenhousem'r,9526,10,8,8,20,41,76,-35,32
Alloa,9527,1,20,10,6,80,42,38,70
Livingston,9527,2,21,5,10,74,43,31,68
Airdrieon,9527,3,17,7,12,59,50,9,58
Brechin,9527,4,17,7,12,52,45,7,58
Albion,9527,5,16,6,14,56,51,5,54
Queen's Park,9527,6,13,7,16,38,50,-12,46
Peterhead,9527,7,11,9,16,44,54,-10,42
East Fife,9527,8,10,8,18,46,56,-10,38
Stranraer,9527,9,10,8,18,52,65,-13,38
Stenhousem'r,9527,10,8,7,21,45,90,-45,31
Alloa,9528,1,22,6,8,75,45,30,72
Livingston,9528,2,20,4,12,72,53,19,64
Airdrieon,9528,3,17,9,10,70,55,15,60
Brechin,9528,4,18,5,13,53,47,6,59
East Fife,9528,5,12,10,14,54,48,6,46
Peterhead,9528,6,11,12,13,41,48,-7,45
Queen's Park,9528,7,11,8,17,34,53,-19,41
Albion,9528,8,9,12,15,48,51,-3,39
Stenhousem'r,9528,9,9,11,16,45,68,-23,38
Stranraer,9528,10,11,3,22,43,67,-24,36
Alloa,9529,1,24,5,7,73,32,41,77
Livingston,9529,2,18,7,11,75,51,24,61
Airdrieon,9529,3,18,4,14,56,55,1,58
Brechin,9529,4,16,6,14,47,48,-1,54
Queen's Park,9529,5,16,6,14,44,49,-5,54
Albion,9529,6,14,8,14,48,49,-1,50
Stranraer,9529,7,12,10,14,52,60,-8,46
Peterhead,9529,8,12,7,17,49,57,-8,43
East Fife,9529,9,8,11,17,53,58,-5,35
Stenhousem'r,9529,10,7,6,23,38,76,-38,27
Livingston,9530,1,20,6,10,82,49,33,66
Alloa,9530,2,17,11,8,74,48,26,62
Brechin,9530,3,19,5,12,57,49,8,62
Albion,9530,4,17,7,12,59,49,10,58
Airdrieon,9530,5,16,5,15,58,58,0,53
East Fife,9530,6,12,10,14,51,53,-2,46
Stranraer,9530,7,12,9,15,51,55,-4,45
Queen's Park,9530,8,12,7,17,36,57,-21,43
Peterhead,9530,9,10,11,15,45,53,-8,41
Stenhousem'r,9530,10,7,5,24,46,88,-42,26
Alloa,9531,1,18,8,10,67,48,19,62
Peterhead,9531,2,19,5,12,53,46,7,62
Brechin,9531,3,18,7,11,56,46,10,61
Livingston,9531,4,18,6,12,72,51,21,60
Airdrieon,9531,5,17,8,11,55,42,13,59
Albion,9531,6,13,11,12,49,50,-1,50
Queen's Park,9531,7,14,7,15,41,50,-9,49
East Fife,9531,8,11,10,15,53,46,7,43
Stranraer,9531,9,8,9,19,47,69,-22,33
Stenhousem'r,9531,10,5,7,24,47,92,-45,22
Alloa,9532,1,19,9,8,68,38,30,66
Livingston,9532,2,19,5,12,73,54,19,62
Brechin,9532,3,15,11,10,51,56,-5,56
Albion,9532,4,16,7,13,61,57,4,55
Airdrieon,9532,5,13,10,13,51,53,-2,49
Stranraer,9532,6,14,5,17,60,54,6,47
Queen's Park,9532,7,12,10,14,41,59,-18,46
Peterhead,9532,8,11,9,16,51,54,-3,42
East Fife,9532,9,10,10,16,47,51,-4,40
Stenhousem'r,9532,10,8,10,18,51,78,-27,34
Brechin,9533,1,24,3,9,61,37,24,75
Livingston,9533,2,18,9,9,71,48,23,63
Airdrieon,9533,3,18,8,10,52,43,9,62
Alloa,9533,4,19,4,13,70,52,18,61
Albion,9533,5,14,9,13,43,43,0,51
Peterhead,9533,6,13,10,13,50,52,-2,49
Stranraer,9533,7,13,6,17,46,58,-12,45
Queen's Park,9533,8,12,6,18,36,52,-16,42
Stenhousem'r,9533,9,8,5,23,49,76,-27,29
East Fife,9533,10,6,10,20,39,56,-17,28
Livingston,9534,1,21,6,9,78,49,29,69
Alloa,9534,2,21,5,10,75,43,32,68
Brechin,9534,3,19,7,10,57,40,17,64
Airdrieon,9534,4,18,8,10,60,46,14,62
Stranraer,9534,5,15,5,16,53,56,-3,50
Peterhead,9534,6,14,7,15,47,54,-7,49
Queen's Park,9534,7,10,13,13,36,54,-18,43
Albion,9534,8,11,7,18,44,54,-10,40
East Fife,9534,9,7,8,21,35,57,-22,29
Stenhousem'r,9534,10,5,12,19,46,78,-32,27
Livingston,9535,1,20,5,11,77,47,30,65
Alloa,9535,2,19,7,10,71,43,28,64
Airdrieon,9535,3,16,10,10,62,54,8,58
Brechin,9535,4,16,7,13,50,48,2,55
Albion,9535,5,15,6,15,52,53,-1,51
Peterhead,9535,6,14,8,14,48,54,-6,50
Queen's Park,9535,7,13,7,16,39,49,-10,46
Stranraer,9535,8,12,4,20,46,62,-16,40
East Fife,9535,9,9,11,16,46,56,-10,38
Stenhousem'r,9535,10,10,7,19,55,80,-25,37
Alloa,9536,1,20,9,7,71,40,31,69
Airdrieon,9536,2,18,5,13,58,47,11,59
Brechin,9536,3,17,7,12,53,45,8,58
Livingston,9536,4,16,6,14,63,51,12,54
Peterhead,9536,5,14,10,12,49,51,-2,52
Albion,9536,6,12,11,13,60,52,8,47
East Fife,9536,7,12,9,15,45,48,-3,45
Queen's Park,9536,8,13,5,18,39,63,-24,44
Stranraer,9536,9,11,5,20,41,58,-17,38
Stenhousem'r,9536,10,9,9,18,50,74,-24,36
Livingston,9537,1,19,7,10,84,59,25,64
Alloa,9537,2,18,9,9,72,48,24,63
Airdrieon,9537,3,19,6,11,74,54,20,63
Albion,9537,4,16,8,12,55,53,2,56
Peterhead,9537,5,14,11,11,53,49,4,53
Brechin,9537,6,14,10,12,45,43,2,52
East Fife,9537,7,13,7,16,50,61,-11,46
Queen's Park,9537,8,12,7,17,36,46,-10,43
Stranraer,9537,9,11,4,21,51,64,-13,37
Stenhousem'r,9537,10,6,7,23,44,87,-43,25
Alloa,9538,1,19,8,9,73,44,29,65
Airdrieon,9538,2,18,7,11,60,51,9,61
Livingston,9538,3,18,5,13,80,62,18,59
Brechin,9538,4,18,5,13,53,51,2,59
East Fife,9538,5,15,8,13,55,49,6,53
Stranraer,9538,6,15,5,16,54,55,-1,50
Queen's Park,9538,7,12,7,17,43,58,-15,43
Albion,9538,8,10,9,17,49,58,-9,39
Peterhead,9538,9,10,8,18,48,67,-19,38
Stenhousem'r,9538,10,10,8,18,47,67,-20,38
Brechin,9539,1,18,9,9,58,47,11,63
Livingston,9539,2,18,7,11,69,48,21,61
Airdrieon,9539,3,17,6,13,55,53,2,57
Alloa,9539,4,16,8,12,62,47,15,56
Stranraer,9539,5,16,8,12,52,44,8,56
East Fife,9539,6,14,8,14,57,49,8,50
Albion,9539,7,14,8,14,51,54,-3,50
Peterhead,9539,8,13,7,16,50,48,2,46
Stenhousem'r,9539,9,9,6,21,49,87,-38,33
Queen's Park,9539,10,8,7,21,37,63,-26,31
Livingston,9540,1,20,5,11,64,37,27,65
Alloa,9540,2,18,8,10,61,44,17,62
Brechin,9540,3,19,5,12,50,39,11,62
Albion,9540,4,16,7,13,61,52,9,55
Airdrieon,9540,5,16,6,14,56,55,1,54
Stranraer,9540,6,17,3,16,58,59,-1,54
Queen's Park,9540,7,11,8,17,34,47,-13,41
Stenhousem'r,9540,8,11,7,18,46,68,-22,40
Peterhead,9540,9,9,10,17,45,63,-18,37
East Fife,9540,10,8,11,17,44,55,-11,35
Airdrieon,9541,1,22,6,8,69,40,29,72
Brechin,9541,2,22,4,10,50,37,13,70
Livingston,9541,3,20,5,11,74,44,30,65
Alloa,9541,4,16,9,11,63,53,10,57
Peterhead,9541,5,14,7,15,53,60,-7,49
Stranraer,9541,6,14,6,16,60,58,2,48
Queen's Park,9541,7,10,13,13,38,44,-6,43
Albion,9541,8,9,11,16,46,61,-15,38
East Fife,9541,9,9,8,19,51,56,-5,35
Stenhousem'r,9541,10,6,7,23,40,91,-51,25
Livingston,9542,1,22,3,11,78,52,26,69
Airdrieon,9542,2,18,9,9,63,48,15,63
Alloa,9542,3,17,8,11,61,42,19,59
Albion,9542,4,17,7,12,60,44,16,58
Brechin,9542,5,15,6,15,44,51,-7,51
Peterhead,9542,6,13,10,13,45,53,-8,49
Stranraer,9542,7,12,7,17,50,58,-8,43
East Fife,9542,8,10,10,16,48,53,-5,40
Stenhousem'r,9542,9,10,7,19,51,75,-24,37
Queen's Park,9542,10,11,3,22,34,58,-24,36
Alloa,9543,1,19,7,10,69,43,26,64
Brechin,9543,2,18,8,10,58,46,12,62
Livingston,9543,3,18,7,11,72,60,12,61
Airdrieon,9543,4,17,9,10,59,53,6,60
East Fife,9543,5,13,8,15,48,51,-3,47
Peterhead,9543,6,13,8,15,49,54,-5,47
Albion,9543,7,12,8,16,53,51,2,44
Queen's Park,9543,8,12,6,18,41,55,-14,42
Stenhousem'r,9543,9,9,11,16,56,76,-20,38
Stranraer,9543,10,11,4,21,54,70,-16,37
Livingston,9544,1,22,4,10,72,41,31,70
Airdrieon,9544,2,16,11,9,60,57,3,59
Albion,9544,3,17,6,13,59,56,3,57
Alloa,9544,4,15,11,10,59,42,17,56
Brechin,9544,5,16,7,13,56,49,7,55
Peterhead,9544,6,15,10,11,47,40,7,55
East Fife,9544,7,13,9,14,47,45,2,48
Queen's Park,9544,8,13,7,16,42,49,-7,46
Stranraer,9544,9,9,7,20,47,66,-19,34
Stenhousem'r,9544,10,4,8,24,39,83,-44,20
Livingston,9545,1,23,3,10,72,43,29,72
Alloa,9545,2,21,5,10,76,46,30,68
East Fife,9545,3,15,8,13,54,39,15,53
Brechin,9545,4,16,5,15,48,44,4,53
Peterhead,9545,5,15,7,14,48,51,-3,52
Albion,9545,6,15,6,15,46,51,-5,51
Airdrieon,9545,7,13,8,15,53,62,-9,47
Queen's Park,9545,8,14,4,18,42,56,-14,46
Stranraer,9545,9,9,7,20,42,62,-20,34
Stenhousem'r,9545,10,9,7,20,43,70,-27,34
Livingston,9546,1,23,3,10,78,43,35,72
Alloa,9546,2,19,6,11,70,50,20,63
Brechin,9546,3,18,4,14,53,55,-2,58
Airdrieon,9546,4,16,9,11,54,45,9,57
Peterhead,9546,5,16,6,14,53,51,2,54
Albion,9546,6,12,9,15,47,55,-8,45
Stranraer,9546,7,13,5,18,54,61,-7,44
Queen's Park,9546,8,12,8,16,43,59,-16,44
East Fife,9546,9,6,16,14,46,50,-4,34
Stenhousem'r,9546,10,8,8,20,43,72,-29,32
Alloa,9547,1,21,7,8,83,40,43,70
Livingston,9547,2,21,7,8,78,48,30,70
Airdrieon,9547,3,18,4,14,59,64,-5,58
Brechin,9547,4,15,6,15,43,57,-14,51
Peterhead,9547,5,15,5,16,48,56,-8,50
Queen's Park,9547,6,13,7,16,42,49,-7,46
East Fife,9547,7,10,13,13,45,40,5,43
Stranraer,9547,8,12,6,18,52,59,-7,42
Albion,9547,9,10,9,17,46,55,-9,39
Stenhousem'r,9547,10,9,8,19,45,73,-28,35
Livingston,9548,1,20,5,11,82,47,35,65
Alloa,9548,2,16,10,10,69,49,20,58
Stranraer,9548,3,17,5,14,51,49,2,56
Brechin,9548,4,16,7,13,53,43,10,55
Peterhead,9548,5,16,6,14,47,47,0,54
Queen's Park,9548,6,16,5,15,35,45,-10,53
East Fife,9548,7,14,9,13,59,42,17,51
Airdrieon,9548,8,15,6,15,56,59,-3,51
Albion,9548,9,14,7,15,47,56,-9,49
Stenhousem'r,9548,10,3,6,27,33,95,-62,15
Livingston,9549,1,20,7,9,70,46,24,67
Brechin,9549,2,20,6,10,55,41,14,66
Alloa,9549,3,20,5,11,75,48,27,65
Peterhead,9549,4,14,10,12,56,52,4,52
East Fife,9549,5,14,8,14,60,45,15,50
Airdrieon,9549,6,13,11,12,50,56,-6,50
Albion,9549,7,12,8,16,53,52,1,44
Queen's Park,9549,8,11,8,17,37,54,-17,41
Stranraer,9549,9,11,7,18,46,63,-17,40
Stenhousem'r,9549,10,7,6,23,40,85,-45,27
Airdrieon,9550,1,21,6,9,59,43,16,69
Livingston,9550,2,20,8,8,72,41,31,68
Alloa,9550,3,16,10,10,62,44,18,58
Albion,9550,4,13,12,11,43,38,5,51
Peterhead,9550,5,12,10,14,47,53,-6,46
Queen's Park,9550,6,12,8,16,39,49,-10,44
Brechin,9550,7,13,5,18,50,65,-15,44
Stranraer,9550,8,11,7,18,47,56,-9,40
Stenhousem'r,9550,9,10,9,17,43,67,-24,39
East Fife,9550,10,7,15,14,37,43,-6,36
Alloa,9551,1,19,8,9,77,39,38,65
Livingston,9551,2,19,7,10,70,39,31,64
Airdrieon,9551,3,19,7,10,71,61,10,64
Brechin,9551,4,18,5,13,59,57,2,59
Peterhead,9551,5,13,11,12,56,57,-1,50
Albion,9551,6,15,5,16,55,58,-3,50
Queen's Park,9551,7,13,8,15,38,49,-11,47
Stranraer,9551,8,10,7,19,48,66,-18,37
East Fife,9551,9,9,9,18,44,55,-11,36
Stenhousem'r,9551,10,8,7,21,45,82,-37,31
Livingston,9552,1,24,3,9,88,51,37,75
Alloa,9552,2,22,6,8,68,36,32,72
Brechin,9552,3,20,6,10,54,37,17,66
Airdrieon,9552,4,17,5,14,57,56,1,56
Albion,9552,5,13,9,14,52,50,2,48
Peterhead,9552,6,13,9,14,43,45,-2,48
East Fife,9552,7,13,8,15,51,58,-7,47
Queen's Park,9552,8,12,3,21,32,52,-20,39
Stranraer,9552,9,10,5,21,54,72,-18,35
Stenhousem'r,9552,10,6,6,24,41,83,-42,24
Livingston,9553,1,22,5,9,85,45,40,71
Airdrieon,9553,2,21,3,12,59,49,10,66
Alloa,9553,3,17,9,10,69,46,23,60
Brechin,9553,4,17,7,12,51,43,8,58
Stranraer,9553,5,14,7,15,55,61,-6,49
East Fife,9553,6,13,9,14,50,43,7,48
Albion,9553,7,13,8,15,50,48,2,47
Queen's Park,9553,8,11,9,16,31,49,-18,42
Peterhead,9553,9,10,6,20,41,64,-23,36
Stenhousem'r,9553,10,8,5,23,36,79,-43,29
Livingston,9554,1,23,2,11,86,48,38,71
Alloa,9554,2,20,11,5,66,39,27,71
Airdrieon,9554,3,19,5,12,59,51,8,62
Albion,9554,4,16,7,13,60,58,2,55
Peterhead,9554,5,13,7,16,50,48,2,46
East Fife,9554,6,11,11,14,51,51,0,44
Brechin,9554,7,12,8,16,44,56,-12,44
Queen's Park,9554,8,11,6,19,32,49,-17,39
Stenhousem'r,9554,9,8,12,16,45,74,-29,36
Stranraer,9554,10,10,5,21,45,64,-19,35
Alloa,9555,1,20,6,10,77,45,32,66
Livingston,9555,2,19,8,9,79,42,37,65
Airdrieon,9555,3,16,9,11,50,43,7,57
Stranraer,9555,4,15,8,13,52,57,-5,53
Albion,9555,5,15,6,15,58,54,4,51
Peterhead,9555,6,14,8,14,52,56,-4,50
Brechin,9555,7,14,6,16,43,48,-5,48
Queen's Park,9555,8,12,7,17,42,64,-22,43
East Fife,9555,9,11,8,17,46,49,-3,41
Stenhousem'r,9555,10,6,10,20,39,80,-41,28
Livingston,9556,1,22,3,11,77,50,27,69
Airdrieon,9556,2,17,10,9,63,53,10,61
Brechin,9556,3,17,9,10,60,46,14,60
Alloa,9556,4,15,11,10,65,43,22,56
Albion,9556,5,12,13,11,55,53,2,49
East Fife,9556,6,11,11,14,54,53,1,44
Stranraer,9556,7,12,7,17,48,65,-17,43
Stenhousem'r,9556,8,10,10,16,43,64,-21,40
Peterhead,9556,9,10,8,18,45,63,-18,38
Queen's Park,9556,10,9,8,19,31,51,-20,35
Airdrieon,9557,1,18,8,10,57,42,15,62
Brechin,9557,2,19,4,13,46,36,10,61
Alloa,9557,3,17,8,11,65,41,24,59
Livingston,9557,4,17,7,12,74,56,18,58
Stranraer,9557,5,16,6,14,53,54,-1,54
Albion,9557,6,14,9,13,52,49,3,51
East Fife,9557,7,14,8,14,56,46,10,50
Peterhead,9557,8,13,7,16,43,55,-12,46
Queen's Park,9557,9,9,9,18,39,56,-17,36
Stenhousem'r,9557,10,8,4,24,41,91,-50,28
Livingston,9558,1,23,6,7,77,44,33,75
Alloa,9558,2,21,7,8,80,49,31,70
Brechin,9558,3,19,5,12,62,43,19,62
Airdrieon,9558,4,16,9,11,57,51,6,57
Albion,9558,5,13,9,14,54,60,-6,48
Queen's Park,9558,6,12,10,14,37,49,-12,46
Peterhead,9558,7,12,8,16,48,58,-10,44
East Fife,9558,8,9,10,17,46,53,-7,37
Stranraer,9558,9,8,9,19,38,58,-20,33
Stenhousem'r,9558,10,7,7,22,40,74,-34,28
Alloa,9559,1,18,8,10,64,43,21,62
Livingston,9559,2,18,7,11,60,45,15,61
Airdrieon,9559,3,16,11,9,56,48,8,59
East Fife,9559,4,15,9,12,49,37,12,54
Brechin,9559,5,13,9,14,44,45,-1,48
Queen's Park,9559,6,14,5,17,44,48,-4,47
Albion,9559,7,12,11,13,47,53,-6,47
Peterhead,9559,8,10,10,16,45,58,-13,40
Stranraer,9559,9,10,8,18,45,58,-13,38
Stenhousem'r,9559,10,8,14,14,48,67,-19,38
Livingston,9560,1,22,5,9,72,47,25,71
Alloa,9560,2,21,6,9,62,38,24,69
Airdrieon,9560,3,18,8,10,60,52,8,62
Albion,9560,4,15,11,10,62,48,14,56
Brechin,9560,5,16,6,14,53,48,5,54
Peterhead,9560,6,14,9,13,49,50,-1,51
Stranraer,9560,7,12,5,19,41,60,-19,41
East Fife,9560,8,9,10,17,42,46,-4,37
Queen's Park,9560,9,9,9,18,31,47,-16,36
Stenhousem'r,9560,10,5,9,22,44,80,-36,24
Livingston,9561,1,27,4,5,94,39,55,85
Alloa,9561,2,16,11,9,68,45,23,59
Brechin,9561,3,18,5,13,55,48,7,59
Peterhead,9561,4,16,8,12,52,51,1,56
Airdrieon,9561,5,14,7,15,61,63,-2,49
Queen's Park,9561,6,14,7,15,38,51,-13,49
Stranraer,9561,7,13,6,17,55,64,-9,45
Albion,9561,8,12,8,16,51,56,-5,44
East Fife,9561,9,9,6,21,44,56,-12,33
Stenhousem'r,9561,10,6,8,22,36,81,-45,26
Alloa,9562,1,18,9,9,69,50,19,63
Brechin,9562,2,17,9,10,58,50,8,60
Airdrieon,9562,3,17,8,11,55,54,1,59
Peterhead,9562,4,17,6,13,61,41,20,57
Livingston,9562,5,17,4,15,71,54,17,55
Stranraer,9562,6,16,5,15,53,56,-3,53
Queen's Park,9562,7,15,4,17,41,51,-10,49
Stenhousem'r,9562,8,11,7,18,55,81,-26,40
Albion,9562,9,10,8,18,45,56,-11,38
East Fife,9562,10,8,8,20,39,54,-15,32
Livingston,9563,1,26,1,9,92,44,48,79
Alloa,9563,2,19,10,7,76,39,37,67
Brechin,9563,3,17,5,14,51,49,2,56
Airdrieon,9563,4,15,7,14,58,58,0,52
Queen's Park,9563,5,14,8,14,42,52,-10,50
Albion,9563,6,15,4,17,49,60,-11,49
Peterhead,9563,7,12,10,14,47,50,-3,46
Stranraer,9563,8,13,6,17,48,55,-7,45
East Fife,9563,9,9,9,18,53,64,-11,36
Stenhousem'r,9563,10,5,10,21,41,86,-45,25
Livingston,9564,1,19,8,9,85,48,37,65
Alloa,9564,2,19,8,9,73,47,26,65
Brechin,9564,3,17,8,11,48,41,7,59
Albion,9564,4,16,10,10,47,38,9,58
Airdrieon,9564,5,15,8,13,50,58,-8,53
Stranraer,9564,6,14,7,15,54,56,-2,49
Peterhead,9564,7,12,8,16,47,55,-8,44
East Fife,9564,8,10,10,16,52,49,3,40
Queen's Park,9564,9,12,4,20,32,61,-29,40
Stenhousem'r,9564,10,6,9,21,43,78,-35,27
Livingston,9565,1,21,6,9,80,46,34,69
Alloa,9565,2,18,10,8,67,43,24,64
Airdrieon,9565,3,18,8,10,57,50,7,62
Brechin,9565,4,16,10,10,49,37,12,58
Queen's Park,9565,5,15,6,15,37,43,-6,51
Albion,9565,6,13,11,12,47,44,3,50
Stranraer,9565,7,11,8,17,44,59,-15,41
Peterhead,9565,8,10,10,16,37,47,-10,40
East Fife,9565,9,9,9,18,43,49,-6,36
Stenhousem'r,9565,10,5,10,21,39,82,-43,25
Alloa,9566,1,22,8,6,81,39,42,74
Livingston,9566,2,19,7,10,71,49,22,64
Brechin,9566,3,17,6,13,48,39,9,57
Queen's Park,9566,4,15,7,14,45,48,-3,52
Albion,9566,5,12,13,11,54,47,7,49
Airdrieon,9566,6,13,9,14,48,65,-17,48
Peterhead,9566,7,12,7,17,51,60,-9,43
Stranraer,9566,8,11,9,16,46,55,-9,42
East Fife,9566,9,9,11,16,40,46,-6,38
Stenhousem'r,9566,10,8,7,21,37,73,-36,31
Livingston,9567,1,21,2,13,77,50,27,65
Alloa,9567,2,16,13,7,68,44,24,61
Airdrieon,9567,3,17,8,11,56,46,10,59
Brechin,9567,4,18,5,13,54,47,7,59
Albion,9567,5,16,8,12,60,56,4,56
Peterhead,9567,6,15,9,12,51,48,3,54
East Fife,9567,7,13,7,16,54,50,4,46
Stranraer,9567,8,12,6,18,46,59,-13,42
Queen's Park,9567,9,9,9,18,37,58,-21,36
Stenhousem'r,9567,10,6,7,23,40,85,-45,25
Livingston,9568,1,21,5,10,72,44,28,68
Stranraer,9568,2,20,2,14,58,57,1,62
Brechin,9568,3,17,9,10,53,41,12,60
Alloa,9568,4,16,9,11,64,46,18,57
Albion,9568,5,16,6,14,51,57,-6,54
Peterhead,9568,6,13,9,14,44,52,-8,48
East Fife,9568,7,13,8,15,51,42,9,47
Airdrieon,9568,8,13,8,15,51,60,-9,47
Queen's Park,9568,9,8,7,21,37,57,-20,31
Stenhousem'r,9568,10,8,7,21,48,73,-25,31
Alloa,9569,1,21,6,9,75,41,34,69
Livingston,9569,2,21,5,10,74,48,26,68
Airdrieon,9569,3,19,8,9,60,44,16,65
Peterhead,9569,4,19,7,10,60,48,12,64
Albion,9569,5,13,9,14,59,60,-1,48
Queen's Park,9569,6,13,6,17,44,52,-8,45
Brechin,9569,7,13,6,17,41,57,-16,45
Stranraer,9569,8,14,2,20,48,58,-10,44
East Fife,9569,9,11,8,17,48,51,-3,41
Stenhousem'r,9569,10,3,9,24,42,92,-50,18
Livingston,9570,1,23,7,6,88,47,41,76
Alloa,9570,2,18,9,9,79,47,32,63
Albion,9570,3,15,8,13,53,52,1,53
Brechin,9570,4,15,7,14,47,47,0,52
Airdrieon,9570,5,15,6,15,59,61,-2,51
Peterhead,9570,6,13,8,15,44,48,-4,47
Stranraer,9570,7,14,5,17,43,59,-16,47
Queen's Park,9570,8,12,9,15,41,50,-9,45
East Fife,9570,9,10,13,13,54,52,2,43
Stenhousem'r,9570,10,4,10,22,43,88,-45,22
Livingston,9571,1,24,3,9,90,45,45,75
Alloa,9571,2,18,7,11,63,42,21,61
Brechin,9571,3,17,6,13,50,47,3,57
Albion,9571,4,14,9,13,55,56,-1,51
Stranraer,9571,5,14,5,17,55,59,-4,47
Airdrieon,9571,6,14,5,17,52,63,-11,47
East Fife,9571,7,12,8,16,49,57,-8,44
Peterhead,9571,8,10,12,14,43,52,-9,42
Queen's Park,9571,9,11,9,16,41,54,-13,42
Stenhousem'r,9571,10,9,10,17,52,75,-23,37
Livingston,9572,1,23,2,11,84,49,35,71
Alloa,9572,2,21,5,10,75,43,32,68
Brechin,9572,3,18,9,9,58,47,11,63
Airdrieon,9572,4,17,6,13,64,56,8,57
Peterhead,9572,5,14,10,12,51,48,3,52
Albion,9572,6,13,8,15,48,57,-9,47
East Fife,9572,7,11,8,17,53,55,-2,41
Stranraer,9572,8,11,4,21,47,68,-21,37
Queen's Park,9572,9,10,7,19,35,59,-24,37
Stenhousem'r,9572,10,8,9,19,38,71,-33,33
Livingston,9573,1,22,3,11,73,41,32,69
Brechin,9573,2,18,9,9,52,34,18,63
Alloa,9573,3,19,5,12,63,48,15,62
Airdrieon,9573,4,18,7,11,68,52,16,61
Peterhead,9573,5,15,11,10,55,48,7,56
Albion,9573,6,15,10,11,56,46,10,55
East Fife,9573,7,12,7,17,48,46,2,43
Queen's Park,9573,8,11,3,22,27,57,-30,36
Stranraer,9573,9,10,5,21,42,69,-27,35
Stenhousem'r,9573,10,7,6,23,37,80,-43,27
Livingston,9574,1,23,7,6,92,43,49,76
Alloa,9574,2,17,11,8,73,41,32,62
Brechin,9574,3,16,7,13,55,56,-1,55
Albion,9574,4,14,11,11,54,44,10,53
Peterhead,9574,5,14,11,11,51,54,-3,53
Airdrieon,9574,6,13,10,13,53,59,-6,49
East Fife,9574,7,10,12,14,47,51,-4,42
Queen's Park,9574,8,10,10,16,37,56,-19,40
Stranraer,9574,9,10,8,18,45,63,-18,38
Stenhousem'r,9574,10,4,11,21,44,84,-40,23
Alloa,9575,1,22,8,6,72,34,38,74
Airdrieon,9575,2,21,7,8,51,38,13,70
Livingston,9575,3,21,4,11,77,45,32,67
Brechin,9575,4,19,5,12,54,45,9,62
Peterhead,9575,5,15,8,13,51,45,6,53
Queen's Park,9575,6,15,4,17,41,50,-9,49
East Fife,9575,7,9,9,18,42,54,-12,36
Albion,9575,8,10,6,20,42,64,-22,36
Stranraer,9575,9,9,6,21,44,68,-24,33
Stenhousem'r,9575,10,6,9,21,45,76,-31,27
Livingston,9576,1,23,7,6,80,43,37,76
Alloa,9576,2,19,8,9,74,42,32,65
Airdrieon,9576,3,15,12,9,58,51,7,57
Albion,9576,4,15,9,12,54,59,-5,54
Peterhead,9576,5,11,13,12,50,56,-6,46
Brechin,9576,6,13,7,16,49,58,-9,46
East Fife,9576,7,11,11,14,51,48,3,44
Queen's Park,9576,8,12,5,19,40,56,-16,41
Stranraer,9576,9,10,9,17,59,68,-9,39
Stenhousem'r,9576,10,6,9,21,39,73,-34,27
Livingston,9577,1,20,7,9,76,49,27,67
Alloa,9577,2,17,8,11,67,54,13,59
Peterhead,9577,3,15,8,13,49,45,4,53
Albion,9577,4,14,9,13,58,58,0,51
Brechin,9577,5,15,6,15,46,50,-4,51
Airdrieon,9577,6,14,7,15,60,67,-7,49
Stranraer,9577,7,14,6,16,57,59,-2,48
Queen's Park,9577,8,14,6,16,48,61,-13,48
East Fife,9577,9,11,8,17,49,53,-4,41
Stenhousem'r,9577,10,10,7,19,60,74,-14,37
Alloa,9578,1,22,5,9,72,44,28,71
Livingston,9578,2,22,2,12,81,48,33,68
Airdrieon,9578,3,16,7,13,69,54,15,55
Peterhead,9578,4,17,3,16,48,56,-8,54
Brechin,9578,5,16,5,15,56,60,-4,53
Albion,9578,6,14,8,14,62,59,3,50
Stranraer,9578,7,14,5,17,52,65,-13,47
Queen's Park,9578,8,13,5,18,44,55,-11,44
East Fife,9578,9,11,10,15,48,51,-3,43
Stenhousem'r,9578,10,6,8,22,50,90,-40,26
Livingston,9579,1,21,3,12,74,48,26,66
Airdrieon,9579,2,18,6,12,64,62,2,60
Alloa,9579,3,17,7,12,68,51,17,58
Albion,9579,4,17,7,12,65,58,7,58
Brechin,9579,5,16,8,12,53,49,4,56
Peterhead,9579,6,13,9,14,44,49,-5,48
Stranraer,9579,7,13,6,17,57,63,-6,45
Queen's Park,9579,8,13,4,19,48,60,-12,43
East Fife,9579,9,8,13,15,44,53,-9,37
Stenhousem'r,9579,10,9,7,20,45,69,-24,34
Livingston,9580,1,22,5,9,84,50,34,71
Alloa,9580,2,18,7,11,70,43,27,61
Airdrieon,9580,3,18,6,12,64,60,4,60
Peterhead,9580,4,17,5,14,62,64,-2,56
Brechin,9580,5,17,2,17,49,51,-2,53
Albion,9580,6,14,6,16,52,59,-7,48
Stranraer,9580,7,13,8,15,51,55,-4,47
East Fife,9580,8,11,10,15,42,47,-5,43
Queen's Park,9580,9,12,7,17,37,49,-12,43
Stenhousem'r,9580,10,7,6,23,50,83,-33,27
Alloa,9581,1,22,7,7,86,44,42,73
Livingston,9581,2,21,6,9,74,42,32,69
Airdrieon,9581,3,19,5,12,68,57,11,62
Albion,9581,4,13,10,13,53,52,1,49
Brechin,9581,5,13,9,14,51,58,-7,48
Peterhead,9581,6,13,6,17,43,52,-9,45
East Fife,9581,7,11,11,14,51,50,1,44
Queen's Park,9581,8,11,10,15,32,50,-18,43
Stranraer,9581,9,9,8,19,42,64,-22,35
Stenhousem'r,9581,10,8,8,20,43,74,-31,32
Alloa,9582,1,25,5,6,77,33,44,80
Livingston,9582,2,18,4,14,72,55,17,58
Airdrieon,9582,3,16,8,12,57,57,0,56
Albion,9582,4,15,9,12,59,50,9,54
Peterhead,9582,5,14,9,13,51,50,1,51
Queen's Park,9582,6,12,11,13,37,47,-10,47
Stranraer,9582,7,14,4,18,52,59,-7,46
Brechin,9582,8,12,7,17,44,61,-17,43
East Fife,9582,9,10,12,14,49,47,2,42
Stenhousem'r,9582,10,6,7,23,39,78,-39,25
Livingston,9583,1,18,9,9,64,43,21,63
Airdrieon,9583,2,18,8,10,60,54,6,62
Brechin,9583,3,16,6,14,51,42,9,54
Stranraer,9583,4,16,6,14,63,57,6,54
Alloa,9583,5,14,10,12,56,51,5,52
Peterhead,9583,6,14,9,13,55,49,6,51
Albion,9583,7,13,8,15,54,50,4,47
Queen's Park,9583,8,12,8,16,34,46,-12,44
East Fife,9583,9,8,13,15,38,49,-11,37
Stenhousem'r,9583,10,8,9,19,44,78,-34,33
Livingston,9584,1,21,3,12,80,53,27,66
Alloa,9584,2,18,9,9,69,45,24,63
Brechin,9584,3,18,6,12,55,43,12,60
Airdrieon,9584,4,16,10,10,60,54,6,58
Albion,9584,5,16,7,13,69,53,16,55
Peterhead,9584,6,15,5,16,47,60,-13,50
Stranraer,9584,7,12,7,17,44,56,-12,43
Queen's Park,9584,8,13,4,19,44,61,-17,43
East Fife,9584,9,11,8,17,54,59,-5,41
Stenhousem'r,9584,10,8,5,23,48,86,-38,29
Livingston,9585,1,23,3,10,81,42,39,72
Brechin,9585,2,21,4,11,59,40,19,67
Alloa,9585,3,19,7,10,61,39,22,64
Airdrieon,9585,4,16,8,12,60,54,6,56
Albion,9585,5,14,6,16,45,59,-14,48
Queen's Park,9585,6,13,6,17,35,53,-18,45
Peterhead,9585,7,11,10,15,43,50,-7,43
Stranraer,9585,8,12,6,18,48,57,-9,42
East Fife,9585,9,9,10,17,46,56,-10,37
Stenhousem'r,9585,10,8,8,20,56,84,-28,32
Alloa,9586,1,20,10,6,71,35,36,70
Livingston,9586,2,20,4,12,70,55,15,64
Brechin,9586,3,16,9,11,59,54,5,57
Peterhead,9586,4,14,9,13,60,58,2,51
Albion,9586,5,14,9,13,58,56,2,51
Stranraer,9586,6,15,4,17,51,48,3,49
Airdrieon,9586,7,12,10,14,50,57,-7,46
East Fife,9586,8,11,9,16,46,54,-8,42
Queen's Park,9586,9,10,11,15,44,58,-14,41
Stenhousem'r,9586,10,5,11,20,46,80,-34,26
Airdrieon,9587,1,20,5,11,65,50,15,65
Livingston,9587,2,19,7,10,76,48,28,64
Alloa,9587,3,17,9,10,69,47,22,60
Albion,9587,4,15,9,12,53,49,4,54
Brechin,9587,5,16,5,15,50,49,1,53
Queen's Park,9587,6,13,11,12,43,44,-1,50
Stranraer,9587,7,15,4,17,49,54,-5,49
East Fife,9587,8,11,7,18,42,56,-14,40
Peterhead,9587,9,10,9,17,43,58,-15,39
Stenhousem'r,9587,10,7,8,21,43,78,-35,29
Alloa,9588,1,23,6,7,79,39,40,75
Livingston,9588,2,21,5,10,80,48,32,68
Airdrieon,9588,3,17,4,15,61,56,5,55
Albion,9588,4,16,6,14,57,57,0,54
Brechin,9588,5,15,7,14,54,58,-4,52
East Fife,9588,6,14,8,14,53,42,11,50
Queen's Park,9588,7,15,5,16,51,54,-3,50
Peterhead,9588,8,14,7,15,55,57,-2,49
Stranraer,9588,9,10,4,22,41,70,-29,34
Stenhousem'r,9588,10,6,6,24,40,90,-50,24
Livingston,9589,1,22,4,10,82,49,33,70
Alloa,9589,2,20,7,9,64,45,19,67
Brechin,9589,3,19,6,11,58,41,17,63
Airdrieon,9589,4,16,6,14,56,50,6,54
Queen's Park,9589,5,15,8,13,50,49,1,53
Peterhead,9589,6,16,5,15,56,57,-1,53
Albion,9589,7,12,11,13,47,51,-4,47
East Fife,9589,8,12,8,16,51,52,-1,44
Stranraer,9589,9,9,6,21,39,68,-29,33
Stenhousem'r,9589,10,5,7,24,42,83,-41,22
Alloa,9590,1,22,6,8,75,40,35,72
Livingston,9590,2,20,5,11,77,51,26,65
Albion,9590,3,17,5,14,52,46,6,56
Brechin,9590,4,18,2,16,51,49,2,56
Peterhead,9590,5,15,6,15,48,52,-4,51
Airdrieon,9590,6,15,5,16,45,54,-9,50
East Fife,9590,7,13,9,14,51,49,2,48
Queen's Park,9590,8,14,5,17,40,52,-12,47
Stranraer,9590,9,10,6,20,49,64,-15,36
Stenhousem'r,9590,10,8,7,21,46,77,-31,31
Alloa,9591,1,21,7,8,70,36,34,70
Airdrieon,9591,2,20,7,9,62,49,13,67
Livingston,9591,3,19,5,12,73,48,25,62
Queen's Park,9591,4,16,3,17,39,45,-6,51
Albion,9591,5,13,10,13,56,56,0,49
East Fife,9591,6,12,9,15,49,49,0,45
Brechin,9591,7,13,6,17,41,51,-10,45
Stranraer,9591,8,13,5,18,58,62,-4,44
Peterhead,9591,9,11,6,19,42,57,-15,39
Stenhousem'r,9591,10,9,8,19,42,79,-37,35
Livingston,9592,1,22,7,7,74,34,40,73
Alloa,9592,2,21,7,8,77,43,34,70
Airdrieon,9592,3,17,6,13,56,44,12,57
Brechin,9592,4,16,6,14,45,44,1,54
East Fife,9592,5,13,9,14,55,55,0,48
Peterhead,9592,6,13,8,15,44,54,-10,47
Albion,9592,7,10,10,16,43,55,-12,40
Queen's Park,9592,8,10,10,16,35,56,-21,40
Stranraer,9592,9,8,11,17,45,61,-16,35
Stenhousem'r,9592,10,9,8,19,52,80,-28,35
Livingston,9593,1,23,5,8,80,42,38,74
Brechin,9593,2,21,4,11,60,42,18,67
Albion,9593,3,18,8,10,58,38,20,62
Alloa,9593,4,17,8,11,72,53,19,59
East Fife,9593,5,13,10,13,50,50,0,49
Airdrieon,9593,6,14,7,15,56,58,-2,49
Peterhead,9593,7,10,10,16,41,52,-11,40
Stranraer,9593,8,12,3,21,44,58,-14,39
Queen's Park,9593,9,9,8,19,32,61,-29,35
Stenhousem'r,9593,10,9,5,22,43,82,-39,32
Livingston,9594,1,19,6,11,74,50,24,63
Alloa,9594,2,17,9,10,74,42,32,60
Albion,9594,3,17,9,10,57,44,13,60
Stranraer,9594,4,15,7,14,59,55,4,52
Airdrieon,9594,5,14,9,13,52,62,-10,51
Brechin,9594,6,15,6,15,50,62,-12,51
Stenhousem'r,9594,7,14,7,15,53,64,-11,49
Peterhead,9594,8,12,6,18,47,59,-12,42
East Fife,9594,9,10,9,17,53,58,-5,39
Queen's Park,9594,10,10,6,20,36,59,-23,36
Livingston,9595,1,23,5,8,83,44,39,74
Alloa,9595,2,21,6,9,65,35,30,69
Airdrieon,9595,3,18,4,14,55,48,7,58
Brechin,9595,4,15,7,14,42,42,0,52
Albion,9595,5,14,9,13,48,48,0,51
Stranraer,9595,6,13,7,16,45,55,-10,46
East Fife,9595,7,12,8,16,46,47,-1,44
Peterhead,9595,8,11,6,19,48,59,-11,39
Queen's Park,9595,9,10,7,19,37,61,-24,37
Stenhousem'r,9595,10,9,9,18,49,79,-30,36
Livingston,9596,1,20,3,13,82,56,26,63
Alloa,9596,2,18,8,10,78,50,28,62
Airdrieon,9596,3,18,8,10,58,46,12,62
Peterhead,9596,4,14,13,9,50,41,9,55
Brechin,9596,5,16,6,14,53,57,-4,54
Queen's Park,9596,6,14,8,14,35,48,-13,50
Stranraer,9596,7,14,7,15,55,59,-4,49
East Fife,9596,8,12,8,16,59,58,1,44
Albion,9596,9,8,13,15,50,59,-9,37
Stenhousem'r,9596,10,7,4,25,43,89,-46,25
Livingston,9597,1,20,4,12,67,45,22,64
Brechin,9597,2,19,3,14,56,50,6,60
Alloa,9597,3,16,10,10,68,48,20,58
Airdrieon,9597,4,17,6,13,59,54,5,57
Albion,9597,5,14,12,10,50,46,4,54
Peterhead,9597,6,13,11,12,47,43,4,50
Stranraer,9597,7,14,6,16,52,67,-15,48
East Fife,9597,8,12,10,14,57,46,11,46
Queen's Park,9597,9,10,8,18,32,49,-17,38
Stenhousem'r,9597,10,5,10,21,44,84,-40,25
Alloa,9598,1,19,9,8,76,45,31,66
Livingston,9598,2,18,7,11,72,57,15,61
Airdrieon,9598,3,17,6,13,71,60,11,57
Brechin,9598,4,16,8,12,51,52,-1,56
Albion,9598,5,15,9,12,53,49,4,54
Queen's Park,9598,6,14,7,15,44,52,-8,49
East Fife,9598,7,12,10,14,54,47,7,46
Peterhead,9598,8,13,7,16,60,62,-2,46
Stranraer,9598,9,11,7,18,55,64,-9,40
Stenhousem'r,9598,10,7,6,23,43,91,-48,27
Alloa,9599,1,22,5,9,83,42,41,71
Airdrieon,9599,2,19,3,14,61,59,2,60
Livingston,9599,3,18,5,13,70,51,19,59
Brechin,9599,4,16,5,15,53,55,-2,53
Peterhead,9599,5,16,5,15,51,56,-5,53
Stranraer,9599,6,16,1,19,59,67,-8,49
East Fife,9599,7,13,9,14,61,53,8,48
Queen's Park,9599,8,13,6,17,41,55,-14,45
Stenhousem'r,9599,9,11,6,19,42,68,-26,39
Albion,9599,10,8,11,17,43,58,-15,35
Livingston,9600,1,20,7,9,72,44,28,67
Peterhead,9600,2,17,9,10,56,47,9,60
Brechin,9600,3,18,4,14,52,47,5,58
Albion,9600,4,17,6,13,56,49,7,57
Queen's Park,9600,5,14,10,12,45,44,1,52
Airdrieon,9600,6,14,7,15,55,60,-5,49
Alloa,9600,7,12,11,13,54,51,3,47
East Fife,9600,8,9,11,16,45,50,-5,38
Stranraer,9600,9,10,7,19,41,62,-21,37
Stenhousem'r,9600,10,10,6,20,48,70,-22,36
Livingston,9601,1,23,5,8,82,46,36,74
Alloa,9601,2,20,7,9,77,48,29,67
Brechin,9601,3,16,10,10,55,45,10,58
Airdrieon,9601,4,17,7,12,54,52,2,58
Peterhead,9601,5,13,11,12,50,50,0,50
Albion,9601,6,14,7,15,51,50,1,49
Queen's Park,9601,7,12,9,15,40,51,-11,45
East Fife,9601,8,7,14,15,46,55,-9,35
Stenhousem'r,9601,9,7,10,19,50,85,-35,31
Stranraer,9601,10,8,6,22,47,70,-23,30
Livingston,9602,1,21,5,10,80,55,25,68
Alloa,9602,2,17,9,10,71,55,16,60
Brechin,9602,3,16,9,11,57,44,13,57
Albion,9602,4,15,10,11,65,56,9,55
Peterhead,9602,5,15,9,12,52,47,5,54
Airdrieon,9602,6,16,4,16,54,60,-6,52
Stranraer,9602,7,12,8,16,48,52,-4,44
East Fife,9602,8,12,6,18,51,60,-9,42
Queen's Park,9602,9,10,8,18,42,59,-17,38
Stenhousem'r,9602,10,10,4,22,43,75,-32,34
Livingston,9603,1,23,5,8,83,44,39,74
Alloa,9603,2,17,8,11,58,44,14,59
Airdrieon,9603,3,16,7,13,58,55,3,55
Queen's Park,9603,4,15,6,15,41,49,-8,51
Peterhead,9603,5,12,14,10,60,56,4,50
Albion,9603,6,14,7,15,54,58,-4,49
Stranraer,9603,7,14,7,15,52,60,-8,49
East Fife,9603,8,12,12,12,54,49,5,48
Brechin,9603,9,12,4,20,42,53,-11,40
Stenhousem'r,9603,10,6,8,22,45,79,-34,26
Airdrieon,9604,1,23,4,9,65,46,19,73
Livingston,9604,2,20,6,10,72,47,25,66
Brechin,9604,3,20,6,10,65,48,17,66
Albion,9604,4,17,8,11,61,53,8,59
Alloa,9604,5,16,9,11,65,50,15,57
East Fife,9604,6,14,11,11,49,37,12,53
Stranraer,9604,7,10,8,18,47,59,-12,38
Queen's Park,9604,8,10,5,21,34,51,-17,35
Peterhead,9604,9,8,7,21,37,61,-24,31
Stenhousem'r,9604,10,6,8,22,44,87,-43,26
Alloa,9605,1,19,8,9,73,44,29,65
Livingston,9605,2,18,6,12,72,56,16,60
Airdrieon,9605,3,18,6,12,59,52,7,60
Brechin,9605,4,16,7,13,46,43,3,55
Albion,9605,5,16,6,14,62,54,8,54
East Fife,9605,6,12,10,14,52,46,6,46
Peterhead,9605,7,13,7,16,44,52,-8,46
Stranraer,9605,8,13,4,19,45,57,-12,43
Queen's Park,9605,9,10,8,18,32,56,-24,38
Stenhousem'r,9605,10,9,10,17,50,75,-25,37
Airdrieon,9606,1,20,8,8,70,52,18,68
Livingston,9606,2,19,7,10,67,42,25,64
Brechin,9606,3,18,7,11,56,45,11,61
Peterhead,9606,4,17,6,13,54,53,1,57
Alloa,9606,5,12,13,11,58,48,10,49
Queen's Park,9606,6,13,10,13,43,49,-6,49
Albion,9606,7,13,9,14,43,49,-6,48
East Fife,9606,8,11,8,17,46,45,1,41
Stranraer,9606,9,9,11,16,49,58,-9,38
Stenhousem'r,9606,10,5,7,24,43,88,-45,22
Alloa,9607,1,22,6,8,84,37,47,72
Livingston,9607,2,20,6,10,74,44,30,66
Airdrieon,9607,3,17,9,10,54,48,6,60
Albion,9607,4,13,10,13,49,48,1,49
Brechin,9607,5,14,7,15,43,44,-1,49
East Fife,9607,6,12,10,14,45,46,-1,46
Queen's Park,9607,7,11,11,14,31,52,-21,44
Stranraer,9607,8,12,5,19,46,58,-12,41
Peterhead,9607,9,11,7,18,46,61,-15,40
Stenhousem'r,9607,10,9,7,20,46,80,-34,34
Livingston,9608,1,22,3,11,73,46,27,69
Airdrieon,9608,2,19,6,11,56,43,13,63
Brechin,9608,3,17,7,12,55,47,8,58
Alloa,9608,4,15,10,11,60,51,9,55
Peterhead,9608,5,14,9,13,42,42,0,51
Albion,9608,6,13,8,15,57,62,-5,47
East Fife,9608,7,11,12,13,44,44,0,45
Stranraer,9608,8,11,7,18,46,52,-6,40
Queen's Park,9608,9,10,10,16,37,55,-18,40
Stenhousem'r,9608,10,7,10,19,43,71,-28,31
Alloa,9609,1,19,8,9,79,46,33,65
Livingston,9609,2,18,7,11,67,48,19,61
East Fife,9609,3,17,7,12,60,43,17,58
Albion,9609,4,16,9,11,56,47,9,57
Airdrieon,9609,5,17,5,14,54,54,0,56
Brechin,9609,6,15,7,14,46,54,-8,52
Queen's Park,9609,7,14,7,15,42,50,-8,49
Stranraer,9609,8,12,5,19,61,67,-6,41
Peterhead,9609,9,9,7,20,42,62,-20,34
Stenhousem'r,9609,10,10,4,22,47,83,-36,34
Alloa,9610,1,19,8,9,70,41,29,65
Brechin,9610,2,19,5,12,58,45,13,62
Livingston,9610,3,18,6,12,68,53,15,60
Airdrieon,9610,4,16,11,9,58,48,10,59
Queen's Park,9610,5,15,9,12,39,42,-3,54
Peterhead,9610,6,14,8,14,51,51,0,50
East Fife,9610,7,12,8,16,44,45,-1,44
Albion,9610,8,12,6,18,49,49,0,42
Stranraer,9610,9,11,5,20,43,69,-26,38
Stenhousem'r,9610,10,8,6,22,37,74,-37,30
Alloa,9611,1,19,9,8,73,52,21,66
Airdrieon,9611,2,17,8,11,62,59,3,59
Albion,9611,3,18,4,14,57,51,6,58
Livingston,9611,4,17,6,13,66,51,15,57
Brechin,9611,5,16,7,13,49,45,4,55
Peterhead,9611,6,14,9,13,58,58,0,51
Queen's Park,9611,7,11,12,13,39,47,-8,45
Stranraer,9611,8,12,8,16,53,57,-4,44
East Fife,9611,9,11,7,18,50,56,-6,40
Stenhousem'r,9611,10,5,10,21,45,76,-31,25
Alloa,9612,1,18,8,10,71,42,29,62
Livingston,9612,2,18,6,12,70,55,15,60
Airdrieon,9612,3,17,8,11,59,53,6,59
Peterhead,9612,4,18,5,13,56,51,5,59
Brechin,9612,5,17,6,13,54,47,7,57
Albion,9612,6,16,7,13,45,46,-1,55
Stranraer,9612,7,14,6,16,47,52,-5,48
East Fife,9612,8,11,13,12,53,46,7,46
Queen's Park,9612,9,12,4,20,34,54,-20,40
Stenhousem'r,9612,10,4,7,25,44,87,-43,19
Livingston,9613,1,19,8,9,69,40,29,65
Peterhead,9613,2,16,11,9,65,49,16,59
Airdrieon,9613,3,18,4,14,59,65,-6,58
Queen's Park,9613,4,16,6,14,41,45,-4,54
Brechin,9613,5,15,8,13,50,47,3,53
Alloa,9613,6,12,12,12,58,53,5,48
Albion,9613,7,12,9,15,55,54,1,45
Stranraer,9613,8,13,5,18,53,63,-10,44
East Fife,9613,9,10,12,14,43,44,-1,42
Stenhousem'r,9613,10,7,9,20,43,76,-33,30
Livingston,9614,1,21,6,9,68,44,24,69
Airdrieon,9614,2,19,6,11,57,52,5,63
Peterhead,9614,3,14,11,11,50,47,3,53
Alloa,9614,4,15,7,14,64,56,8,52
Brechin,9614,5,15,7,14,49,47,2,52
Queen's Park,9614,6,14,9,13,38,41,-3,51
Stranraer,9614,7,14,7,15,47,48,-1,49
Albion,9614,8,13,8,15,51,43,8,47
Stenhousem'r,9614,9,8,11,17,40,67,-27,35
East Fife,9614,10,7,8,21,37,56,-19,29
Livingston,9615,1,25,3,8,78,42,36,78
Alloa,9615,2,21,6,9,80,37,43,69
Brechin,9615,3,18,5,13,51,47,4,59
Albion,9615,4,17,6,13,48,47,1,57
Airdrieon,9615,5,16,5,15,53,56,-3,53
Peterhead,9615,6,14,7,15,46,54,-8,49
East Fife,9615,7,12,9,15,57,54,3,45
Queen's Park,9615,8,11,7,18,29,47,-18,40
Stranraer,9615,9,12,3,21,49,64,-15,39
Stenhousem'r,9615,10,4,9,23,36,79,-43,21
Livingston,9616,1,20,5,11,83,48,35,65
Albion,9616,2,19,8,9,55,45,10,65
Alloa,9616,3,19,7,10,71,49,22,64
Airdrieon,9616,4,15,9,12,59,59,0,54
Brechin,9616,5,14,8,14,46,44,2,50
Queen's Park,9616,6,14,8,14,39,45,-6,50
Peterhead,9616,7,12,6,18,49,58,-9,42
Stranraer,9616,8,11,8,17,51,55,-4,41
East Fife,9616,9,11,8,17,46,50,-4,41
Stenhousem'r,9616,10,7,9,20,44,90,-46,30
Alloa,9617,1,20,8,8,75,42,33,68
Livingston,9617,2,20,4,12,68,49,19,64
Albion,9617,3,15,11,10,57,46,11,56
Peterhead,9617,4,16,7,13,55,55,0,55
Airdrieon,9617,5,15,7,14,55,57,-2,52
East Fife,9617,6,12,10,14,55,57,-2,46
Brechin,9617,7,12,9,15,49,54,-5,45
Stranraer,9617,8,12,8,16,49,53,-4,44
Queen's Park,9617,9,10,9,17,38,60,-22,39
Stenhousem'r,9617,10,8,7,21,54,82,-28,31
Livingston,9618,1,22,4,10,73,48,25,70
Alloa,9618,2,20,8,8,83,47,36,68
Airdrieon,9618,3,19,2,15,64,65,-1,59
Peterhead,9618,4,15,7,14,59,47,12,52
Albion,9618,5,15,7,14,57,55,2,52
Queen's Park,9618,6,15,5,16,39,46,-7,50
Stranraer,9618,7,14,4,18,53,53,0,46
East Fife,9618,8,12,10,14,52,59,-7,46
Brechin,9618,9,12,5,19,47,63,-16,41
Stenhousem'r,9618,10,6,8,22,41,85,-44,26
Livingston,9619,1,22,4,10,92,57,35,70
Alloa,9619,2,20,10,6,75,47,28,70
Albion,9619,3,17,7,12,61,52,9,58
Brechin,9619,4,15,8,13,51,48,3,53
Peterhead,9619,5,14,11,11,47,46,1,53
East Fife,9619,6,13,7,16,53,48,5,46
Queen's Park,9619,7,13,5,18,36,52,-16,44
Airdrieon,9619,8,12,7,17,52,55,-3,43
Stranraer,9619,9,10,10,16,49,63,-14,40
Stenhousem'r,9619,10,7,5,24,38,86,-48,26
Alloa,9620,1,19,8,9,63,42,21,65
Livingston,9620,2,18,8,10,75,45,30,62
Brechin,9620,3,16,10,10,48,44,4,58
Airdrieon,9620,4,14,12,10,49,46,3,54
Stranraer,9620,5,15,7,14,51,55,-4,52
Peterhead,9620,6,13,9,14,45,51,-6,48
Queen's Park,9620,7,12,7,17,37,53,-16,43
East Fife,9620,8,10,9,17,41,47,-6,39
Albion,9620,9,11,6,19,45,52,-7,39
Stenhousem'r,9620,10,9,10,17,44,63,-19,37
Airdrieon,9621,1,20,6,10,62,40,22,66
Livingston,9621,2,20,5,11,76,55,21,65
Brechin,9621,3,15,12,9,52,40,12,57
Alloa,9621,4,15,11,10,61,45,16,56
East Fife,9621,5,11,13,12,49,45,4,46
Stranraer,9621,6,13,6,17,48,60,-12,45
Albion,9621,7,10,13,13,54,57,-3,43
Peterhead,9621,8,10,11,15,43,53,-10,41
Queen's Park,9621,9,9,13,14,31,52,-21,40
Stenhousem'r,9621,10,7,10,19,50,79,-29,31
Airdrieon,9622,1,18,7,11,57,48,9,61
Queen's Park,9622,2,17,9,10,46,45,1,60
Livingston,9622,3,18,4,14,77,58,19,58
Alloa,9622,4,17,6,13,68,57,11,57
Brechin,9622,5,16,8,12,54,46,8,56
Stranraer,9622,6,15,3,18,50,55,-5,48
Albion,9622,7,12,9,15,49,50,-1,45
East Fife,9622,8,10,12,14,53,52,1,42
Stenhousem'r,9622,9,9,11,16,50,75,-25,38
Peterhead,9622,10,10,7,19,42,60,-18,37
Livingston,9623,1,19,7,10,70,37,33,64
Alloa,9623,2,18,9,9,66,45,21,63
Brechin,9623,3,19,6,11,54,45,9,63
Peterhead,9623,4,14,10,12,43,41,2,52
Queen's Park,9623,5,14,9,13,39,40,-1,51
Airdrieon,9623,6,15,6,15,50,55,-5,51
Albion,9623,7,13,11,12,47,48,-1,50
Stranraer,9623,8,11,9,16,57,64,-7,42
East Fife,9623,9,11,7,18,37,52,-15,40
Stenhousem'r,9623,10,6,6,24,41,77,-36,24
Livingston,9624,1,23,6,7,88,45,43,75
Alloa,9624,2,20,7,9,73,45,28,67
Albion,9624,3,18,8,10,50,42,8,62
Airdrieon,9624,4,16,9,11,63,57,6,57
Peterhead,9624,5,15,7,14,46,50,-4,52
Brechin,9624,6,15,4,17,48,52,-4,49
East Fife,9624,7,10,12,14,52,51,1,42
Stranraer,9624,8,11,5,20,51,64,-13,38
Queen's Park,9624,9,11,5,20,33,60,-27,38
Stenhousem'r,9624,10,6,7,23,49,87,-38,25
Alloa,9625,1,18,10,8,72,43,29,64
Airdrieon,9625,2,18,9,9,61,40,21,63
Brechin,9625,3,17,6,13,51,45,6,57
Livingston,9625,4,16,8,12,65,50,15,56
Albion,9625,5,14,10,12,57,47,10,52
Peterhead,9625,6,13,9,14,48,51,-3,48
East Fife,9625,7,11,14,11,42,37,5,47
Stranraer,9625,8,12,8,16,48,58,-10,44
Queen's Park,9625,9,12,6,18,37,63,-26,42
Stenhousem'r,9625,10,4,10,22,36,83,-47,22
Livingston,9626,1,26,0,10,90,49,41,78
Peterhead,9626,2,16,7,13,56,50,6,55
Alloa,9626,3,15,9,12,55,46,9,54
Stranraer,9626,4,15,7,14,54,53,1,52
Queen's Park,9626,5,15,6,15,40,42,-2,51
Brechin,9626,6,14,7,15,45,48,-3,49
Albion,9626,7,13,9,14,45,50,-5,48
Airdrieon,9626,8,13,7,16,48,58,-10,46
East Fife,9626,9,11,7,18,46,51,-5,40
Stenhousem'r,9626,10,9,7,20,53,85,-32,34
Livingston,9627,1,20,6,10,72,55,17,66
Alloa,9627,2,18,10,8,71,41,30,64
East Fife,9627,3,18,5,13,50,46,4,59
Brechin,9627,4,18,3,15,51,43,8,57
Airdrieon,9627,5,13,10,13,54,53,1,49
Queen's Park,9627,6,14,6,16,38,46,-8,48
Albion,9627,7,12,11,13,47,52,-5,47
Stranraer,9627,8,12,8,16,47,50,-3,44
Peterhead,9627,9,11,10,15,53,62,-9,43
Stenhousem'r,9627,10,6,7,23,44,79,-35,25
Alloa,9628,1,22,6,8,72,40,32,72
Livingston,9628,2,21,2,13,78,54,24,65
Airdrieon,9628,3,18,9,9,57,49,8,63
Brechin,9628,4,16,5,15,52,44,8,53
Peterhead,9628,5,16,5,15,49,49,0,53
Albion,9628,6,14,9,13,48,48,0,51
Stranraer,9628,7,13,5,18,51,62,-11,44
Queen's Park,9628,8,10,11,15,33,48,-15,41
East Fife,9628,9,10,10,16,47,50,-3,40
Stenhousem'r,9628,10,5,8,23,45,88,-43,23
Livingston,9629,1,22,6,8,84,51,33,72
Airdrieon,9629,2,20,7,9,59,48,11,67
Alloa,9629,3,20,6,10,77,45,32,66
Brechin,9629,4,16,8,12,59,48,11,56
Peterhead,9629,5,14,8,14,54,56,-2,50
Albion,9629,6,13,7,16,65,66,-1,46
Queen's Park,9629,7,12,8,16,35,51,-16,44
East Fife,9629,8,11,8,17,51,56,-5,41
Stranraer,9629,9,9,8,19,55,73,-18,35
Stenhousem'r,9629,10,6,8,22,37,82,-45,26
Livingston,9630,1,24,5,7,88,45,43,77
Alloa,9630,2,18,10,8,66,40,26,64
Peterhead,9630,3,16,8,12,54,56,-2,56
Brechin,9630,4,15,9,12,44,38,6,54
Albion,9630,5,14,10,12,55,51,4,52
Stranraer,9630,6,14,3,19,60,71,-11,45
East Fife,9630,7,11,8,17,45,50,-5,41
Queen's Park,9630,8,10,9,17,28,49,-21,39
Airdrieon,9630,9,10,8,18,51,62,-11,38
Stenhousem'r,9630,10,8,10,18,52,81,-29,34
Livingston,9631,1,22,5,9,82,50,32,71
Alloa,9631,2,19,6,11,67,39,28,63
Airdrieon,9631,3,15,11,10,56,47,9,56
Peterhead,9631,4,15,9,12,55,51,4,54
Albion,9631,5,15,8,13,57,50,7,53
Brechin,9631,6,14,8,14,53,62,-9,50
Queen's Park,9631,7,13,6,17,45,60,-15,45
East Fife,9631,8,12,7,17,54,54,0,43
Stranraer,9631,9,12,7,17,52,60,-8,43
Stenhousem'r,9631,10,6,7,23,43,91,-48,25
Livingston,9632,1,19,4,13,69,48,21,61
Airdrieon,9632,2,17,7,12,57,51,6,58
Alloa,9632,3,15,12,9,75,49,26,57
Peterhead,9632,4,16,8,12,51,49,2,56
Brechin,9632,5,16,6,14,47,45,2,54
East Fife,9632,6,14,10,12,56,44,12,52
Albion,9632,7,14,10,12,53,52,1,52
Stranraer,9632,8,14,6,16,63,64,-1,48
Queen's Park,9632,9,10,7,19,36,59,-23,37
Stenhousem'r,9632,10,6,8,22,36,82,-46,26
Livingston,9633,1,22,3,11,76,44,32,69
Alloa,9633,2,19,7,10,68,40,28,64
Stranraer,9633,3,16,6,14,57,57,0,54
Airdrieon,9633,4,16,4,16,60,66,-6,52
Albion,9633,5,15,6,15,49,56,-7,51
Queen's Park,9633,6,14,8,14,40,45,-5,50
East Fife,9633,7,14,7,15,51,48,3,49
Brechin,9633,8,14,5,17,51,58,-7,47
Peterhead,9633,9,11,7,18,49,59,-10,40
Stenhousem'r,9633,10,9,7,20,43,71,-28,34
Livingston,9634,1,22,3,11,80,55,25,69
Brechin,9634,2,18,5,13,54,47,7,59
Alloa,9634,3,17,6,13,72,56,16,57
Airdrieon,9634,4,18,2,16,59,58,1,56
Albion,9634,5,14,11,11,73,60,13,53
Queen's Park,9634,6,15,6,15,44,50,-6,51
East Fife,9634,7,13,8,15,58,51,7,47
Peterhead,9634,8,12,8,16,50,66,-16,44
Stranraer,9634,9,12,5,19,52,67,-15,41
Stenhousem'r,9634,10,8,8,20,55,87,-32,32
Alloa,9635,1,22,7,7,82,43,39,73
Livingston,9635,2,21,5,10,80,50,30,68
Airdrieon,9635,3,16,9,11,59,60,-1,57
Brechin,9635,4,17,4,15,49,51,-2,55
Peterhead,9635,5,14,11,11,54,51,3,53
Albion,9635,6,13,10,13,56,50,6,49
Stranraer,9635,7,11,10,15,53,62,-9,43
East Fife,9635,8,11,8,17,49,53,-4,41
Queen's Park,9635,9,10,10,16,43,57,-14,40
Stenhousem'r,9635,10,4,8,24,39,87,-48,20
Alloa,9636,1,19,9,8,75,42,33,66
Livingston,9636,2,20,5,11,75,49,26,65
Airdrieon,9636,3,18,9,9,56,43,13,63
Stranraer,9636,4,16,3,17,54,55,-1,51
Brechin,9636,5,13,10,13,55,58,-3,49
Peterhead,9636,6,13,9,14,53,52,1,48
Albion,9636,7,13,9,14,53,54,-1,48
Queen's Park,9636,8,12,8,16,41,59,-18,44
East Fife,9636,9,9,11,16,55,57,-2,38
Stenhousem'r,9636,10,6,9,21,43,91,-48,27
Airdrieon,9637,1,24,5,7,74,43,31,77
Livingston,9637,2,19,6,11,79,49,30,63
Queen's Park,9637,3,18,5,13,42,37,5,59
Alloa,9637,4,15,9,12,56,46,10,54
Albion,9637,5,15,8,13,56,49,7,53
Brechin,9637,6,14,6,16,47,56,-9,48
Stranraer,9637,7,14,3,19,55,67,-12,45
Peterhead,9637,8,13,5,18,50,66,-16,44
East Fife,9637,9,11,9,16,47,41,6,42
Stenhousem'r,9637,10,6,6,24,37,89,-52,24
Livingston,9638,1,21,7,8,74,50,24,70
Alloa,9638,2,16,12,8,65,41,24,60
Airdrieon,9638,3,17,7,12,61,50,11,58
Brechin,9638,4,15,7,14,45,49,-4,52
East Fife,9638,5,14,9,13,53,51,2,51
Peterhead,9638,6,14,7,15,61,53,8,49
Stranraer,9638,7,14,3,19,53,64,-11,45
Stenhousem'r,9638,8,11,7,18,54,74,-20,40
Queen's Park,9638,9,10,10,16,35,57,-22,40
Albion,9638,10,8,11,17,47,59,-12,35
Alloa,9639,1,18,9,9,66,44,22,63
Livingston,9639,2,17,6,13,71,53,18,57
Brechin,9639,3,16,9,11,52,45,7,57
Albion,9639,4,16,8,12,52,49,3,56
Airdrieon,9639,5,17,5,14,55,53,2,56
East Fife,9639,6,15,6,15,53,45,8,51
Stranraer,9639,7,16,3,17,55,59,-4,51
Queen's Park,9639,8,13,5,18,40,50,-10,44
Peterhead,9639,9,11,9,16,41,50,-9,42
Stenhousem'r,9639,10,8,6,22,46,83,-37,30
Alloa,9640,1,19,9,8,82,53,29,66
Livingston,9640,2,21,3,12,80,52,28,66
Airdrieon,9640,3,20,6,10,61,42,19,66
Brechin,9640,4,14,9,13,54,57,-3,51
Peterhead,9640,5,13,10,13,43,48,-5,49
East Fife,9640,6,12,12,12,50,43,7,48
Albion,9640,7,13,6,17,45,51,-6,45
Queen's Park,9640,8,12,7,17,31,56,-25,43
Stranraer,9640,9,11,4,21,46,60,-14,37
Stenhousem'r,9640,10,7,10,19,41,71,-30,31
Livingston,9641,1,23,2,11,71,51,20,71
Brechin,9641,2,19,8,9,65,47,18,65
Alloa,9641,3,17,13,6,75,47,28,64
Airdrieon,9641,4,18,6,12,66,65,1,60
Peterhead,9641,5,15,10,11,54,47,7,55
Albion,9641,6,12,10,14,53,52,1,46
Queen's Park,9641,7,12,6,18,43,59,-16,42
East Fife,9641,8,10,11,15,51,55,-4,41
Stranraer,9641,9,9,5,22,50,65,-15,32
Stenhousem'r,9641,10,4,11,21,40,80,-40,23
Livingston,9642,1,21,6,9,76,48,28,69
Alloa,9642,2,18,8,10,61,38,23,62
Airdrieon,9642,3,18,5,13,55,55,0,59
Brechin,9642,4,15,9,12,35,34,1,54
Peterhead,9642,5,16,5,15,54,57,-3,53
Queen's Park,9642,6,15,3,18,35,44,-9,48
Albion,9642,7,12,10,14,52,53,-1,46
East Fife,9642,8,11,10,15,51,52,-1,43
Stranraer,9642,9,11,7,18,46,58,-12,40
Stenhousem'r,9642,10,7,9,20,46,72,-26,30
Livingston,9643,1,21,5,10,78,49,29,68
Airdrieon,9643,2,19,7,10,67,48,19,64
Alloa,9643,3,18,8,10,70,53,17,62
Brechin,9643,4,17,6,13,53,46,7,57
Peterhead,9643,5,16,5,15,50,55,-5,53
Albion,9643,6,13,9,14,47,48,-1,48
Stranraer,9643,7,12,6,18,40,57,-17,42
Queen's Park,9643,8,10,8,18,37,55,-18,38
East Fife,9643,9,9,9,18,47,52,-5,36
Stenhousem'r,9643,10,9,9,18,49,75,-26,36
Livingston,9644,1,22,6,8,87,47,40,72
Alloa,9644,2,20,8,8,67,36,31,68
Airdrieon,9644,3,18,3,15,49,48,1,57
Brechin,9644,4,16,4,16,50,47,3,52
Peterhead,9644,5,14,8,14,57,57,0,50
Albion,9644,6,13,11,12,47,49,-2,50
East Fife,9644,7,11,12,13,56,55,1,45
Queen's Park,9644,8,13,6,17,40,59,-19,45
Stranraer,9644,9,11,4,21,44,60,-16,37
Stenhousem'r,9644,10,7,8,21,44,83,-39,29
Livingston,9645,1,25,2,9,79,46,33,77
Alloa,9645,2,19,8,9,80,51,29,65
Airdrieon,9645,3,17,6,13,59,61,-2,57
Peterhead,9645,4,16,8,12,66,55,11,56
Brechin,9645,5,16,6,14,55,45,10,54
East Fife,9645,6,11,11,14,53,55,-2,44
Albion,9645,7,12,7,17,46,60,-14,43
Stranraer,9645,8,11,9,16,60,67,-7,42
Queen's Park,9645,9,10,8,18,39,56,-17,38
Stenhousem'r,9645,10,5,11,20,42,83,-41,26
Livingston,9646,1,20,6,10,67,44,23,66
Alloa,9646,2,19,8,9,68,42,26,65
Airdrieon,9646,3,16,8,12,53,51,2,56
Brechin,9646,4,16,6,14,49,48,1,54
Albion,9646,5,16,6,14,53,53,0,54
Stenhousem'r,9646,6,14,7,15,48,64,-16,49
Peterhead,9646,7,13,9,14,55,56,-1,48
East Fife,9646,8,10,9,17,48,56,-8,39
Queen's Park,9646,9,9,11,16,34,45,-11,38
Stranraer,9646,10,9,6,21,46,62,-16,33
Livingston,9647,1,23,4,9,81,46,35,73
Alloa,9647,2,19,8,9,69,42,27,65
Brechin,9647,3,16,8,12,50,46,4,56
Peterhead,9647,4,16,8,12,57,54,3,56
Airdrieon,9647,5,16,5,15,60,59,1,53
Queen's Park,9647,6,15,7,14,45,52,-7,52
Stranraer,9647,7,14,7,15,51,55,-4,49
Albion,9647,8,12,8,16,48,57,-9,44
Stenhousem'r,9647,9,7,8,21,45,79,-34,29
East Fife,9647,10,7,7,22,45,61,-16,28
Livingston,9648,1,23,2,11,77,51,26,71
Airdrieon,9648,2,20,6,10,83,52,31,66
Alloa,9648,3,19,6,11,74,47,27,63
Queen's Park,9648,4,13,11,12,38,46,-8,50
Brechin,9648,5,13,9,14,51,53,-2,48
Albion,9648,6,12,11,13,45,53,-8,47
Peterhead,9648,7,12,7,17,46,53,-7,43
East Fife,9648,8,9,12,15,44,47,-3,39
Stranraer,9648,9,10,9,17,43,68,-25,39
Stenhousem'r,9648,10,9,7,20,51,82,-31,34
Livingston,9649,1,22,4,10,68,46,22,70
Alloa,9649,2,19,6,11,66,44,22,63
Brechin,9649,3,18,6,12,59,55,4,60
Airdrieon,9649,4,16,10,10,56,50,6,58
East Fife,9649,5,15,10,11,62,47,15,55
Queen's Park,9649,6,14,5,17,41,49,-8,47
Albion,9649,7,12,8,16,60,54,6,44
Peterhead,9649,8,12,7,17,42,54,-12,43
Stranraer,9649,9,12,6,18,48,57,-9,42
Stenhousem'r,9649,10,4,10,22,36,82,-46,22
Livingston,9650,1,22,3,11,75,40,35,69
Alloa,9650,2,18,7,11,67,46,21,61
Albion,9650,3,15,10,11,51,50,1,55
Brechin,9650,4,17,2,17,46,51,-5,53
Airdrieon,9650,5,15,6,15,59,58,1,51
Peterhead,9650,6,15,6,15,49,56,-7,51
Stenhousem'r,9650,7,13,7,16,47,66,-19,46
Stranraer,9650,8,12,7,17,48,56,-8,43
East Fife,9650,9,11,9,16,56,50,6,42
Queen's Park,9650,10,10,7,19,28,53,-25,37
Livingston,9651,1,22,3,11,79,51,28,69
Alloa,9651,2,19,9,8,70,41,29,66
Brechin,9651,3,18,9,9,58,40,18,63
Airdrieon,9651,4,17,7,12,58,55,3,58
Stranraer,9651,5,16,4,16,55,61,-6,52
Albion,9651,6,13,8,15,48,46,2,47
Queen's Park,9651,7,12,5,19,37,55,-18,41
Peterhead,9651,8,11,7,18,47,63,-16,40
East Fife,9651,9,9,9,18,51,64,-13,36
Stenhousem'r,9651,10,7,11,18,40,67,-27,32
Livingston,9652,1,22,6,8,81,48,33,72
Alloa,9652,2,20,7,9,83,46,37,67
Airdrieon,9652,3,16,7,13,58,51,7,55
Stranraer,9652,4,16,6,14,67,60,7,54
East Fife,9652,5,15,7,14,55,48,7,52
Brechin,9652,6,15,7,14,54,60,-6,52
Albion,9652,7,12,9,15,51,57,-6,45
Queen's Park,9652,8,12,6,18,29,51,-22,42
Peterhead,9652,9,10,10,16,41,54,-13,40
Stenhousem'r,9652,10,7,5,24,48,92,-44,26
Airdrieon,9653,1,20,7,9,68,47,21,67
Livingston,9653,2,20,6,10,68,44,24,66
Brechin,9653,3,15,8,13,48,50,-2,53
Peterhead,9653,4,14,9,13,47,47,0,51
Alloa,9653,5,14,7,15,52,49,3,49
Albion,9653,6,12,11,13,58,52,6,47
East Fife,9653,7,12,10,14,41,44,-3,46
Queen's Park,9653,8,12,7,17,33,48,-15,43
Stenhousem'r,9653,9,9,11,16,46,65,-19,38
Stranraer,9653,10,8,12,16,48,63,-15,36
Airdrieon,9654,1,20,8,8,76,53,23,68
Livingston,9654,2,19,10,7,80,44,36,67
Alloa,9654,3,17,9,10,66,43,23,60
East Fife,9654,4,15,7,14,54,47,7,52
Peterhead,9654,5,14,7,15,43,57,-14,49
Queen's Park,9654,6,13,8,15,42,53,-11,47
Albion,9654,7,12,9,15,44,45,-1,45
Brechin,9654,8,12,5,19,49,63,-14,41
Stranraer,9654,9,11,7,18,45,67,-22,40
Stenhousem'r,9654,10,5,14,17,41,68,-27,29
Livingston,9655,1,25,3,8,79,41,38,78
Airdrieon,9655,2,20,6,10,60,42,18,66
Alloa,9655,3,17,9,10,73,45,28,60
Brechin,9655,4,16,3,17,48,53,-5,51
Queen's Park,9655,5,16,3,17,49,62,-13,51
East Fife,9655,6,11,12,13,50,49,1,45
Stranraer,9655,7,11,10,15,44,56,-12,43
Peterhead,9655,8,11,9,16,47,54,-7,42
Albion,9655,9,11,7,18,47,58,-11,40
Stenhousem'r,9655,10,6,10,20,46,83,-37,28
Livingston,9656,1,23,3,10,74,40,34,72
Alloa,9656,2,19,8,9,74,45,29,65
Airdrieon,9656,3,18,6,12,57,47,10,60
Brechin,9656,4,15,8,13,43,46,-3,53
Albion,9656,5,14,9,13,52,49,3,51
Stranraer,9656,6,13,8,15,53,57,-4,47
Queen's Park,9656,7,13,6,17,37,52,-15,45
Peterhead,9656,8,11,9,16,43,49,-6,42
East Fife,9656,9,9,10,17,48,53,-5,37
Stenhousem'r,9656,10,7,9,20,41,84,-43,30
Alloa,9657,1,24,6,6,84,41,43,78
Livingston,9657,2,21,4,11,82,52,30,67
Albion,9657,3,16,9,11,61,49,12,57
Airdrieon,9657,4,18,2,16,55,57,-2,56
Brechin,9657,5,15,8,13,45,50,-5,53
East Fife,9657,6,13,10,13,52,47,5,49
Peterhead,9657,7,12,10,14,50,54,-4,46
Queen's Park,9657,8,10,8,18,37,52,-15,38
Stenhousem'r,9657,9,9,7,20,46,79,-33,34
Stranraer,9657,10,6,8,22,37,68,-31,26
Livingston,9658,1,22,5,9,78,41,37,71
Alloa,9658,2,20,9,7,68,41,27,69
Airdrieon,9658,3,16,7,13,55,52,3,55
Albion,9658,4,13,8,15,55,53,2,47
East Fife,9658,5,13,8,15,46,47,-1,47
Queen's Park,9658,6,12,10,14,37,46,-9,46
Stranraer,9658,7,12,7,17,50,56,-6,43
Brechin,9658,8,12,7,17,39,49,-10,43
Peterhead,9658,9,11,10,15,49,63,-14,43
Stenhousem'r,9658,10,9,9,18,47,76,-29,36
Alloa,9659,1,19,9,8,80,50,30,66
Livingston,9659,2,19,4,13,71,42,29,61
Brechin,9659,3,18,2,16,54,47,7,56
Airdrieon,9659,4,17,5,14,64,60,4,56
Peterhead,9659,5,15,7,14,54,57,-3,52
East Fife,9659,6,14,9,13,52,44,8,51
Stranraer,9659,7,16,1,19,46,58,-12,49
Queen's Park,9659,8,13,7,16,35,51,-16,46
Albion,9659,9,11,8,17,46,56,-10,41
Stenhousem'r,9659,10,9,6,21,50,87,-37,33
Alloa,9660,1,20,6,10,72,36,36,66
Livingston,9660,2,18,7,11,77,50,27,61
Peterhead,9660,3,17,6,13,47,45,2,57
Brechin,9660,4,16,7,13,47,49,-2,55
Airdrieon,9660,5,16,6,14,46,50,-4,54
Albion,9660,6,13,8,15,50,55,-5,47
Queen's Park,9660,7,12,9,15,42,54,-12,45
East Fife,9660,8,12,8,16,58,55,3,44
Stranraer,9660,9,13,5,18,47,60,-13,44
Stenhousem'r,9660,10,9,6,21,44,76,-32,33
Livingston,9661,1,21,2,13,73,53,20,65
Alloa,9661,2,19,6,11,76,54,22,63
Brechin,9661,3,18,6,12,52,46,6,60
East Fife,9661,4,13,13,10,55,41,14,52
Peterhead,9661,5,13,11,12,55,50,5,50
Albion,9661,6,14,7,15,56,57,-1,49
Stranraer,9661,7,15,4,17,54,59,-5,49
Stenhousem'r,9661,8,13,6,17,56,74,-18,45
Airdrieon,9661,9,11,7,18,51,70,-19,40
Queen's Park,9661,10,8,8,20,32,56,-24,32
Livingston,9662,1,23,4,9,77,47,30,73
Airdrieon,9662,2,22,6,8,71,43,28,72
Peterhead,9662,3,19,6,11,55,49,6,63
Alloa,9662,4,18,6,12,68,51,17,60
Albion,9662,5,14,10,12,59,48,11,52
Brechin,9662,6,15,7,14,54,67,-13,52
East Fife,9662,7,11,8,17,57,55,2,41
Stranraer,9662,8,10,4,22,46,64,-18,34
Queen's Park,9662,9,8,8,20,31,61,-30,32
Stenhousem'r,9662,10,8,5,23,44,77,-33,29
Livingston,9663,1,20,7,9,73,46,27,67
Alloa,9663,2,17,10,9,70,43,27,61
Airdrieon,9663,3,18,5,13,53,56,-3,59
Peterhead,9663,4,16,8,12,55,54,1,56
Brechin,9663,5,14,11,11,51,53,-2,53
Queen's Park,9663,6,15,4,17,50,52,-2,49
Albion,9663,7,12,10,14,59,57,2,46
East Fife,9663,8,11,11,14,49,47,2,44
Stranraer,9663,9,11,5,20,48,61,-13,38
Stenhousem'r,9663,10,6,9,21,43,82,-39,27
Livingston,9664,1,27,4,5,96,42,54,85
Alloa,9664,2,19,7,10,82,49,33,64
Airdrieon,9664,3,18,6,12,58,49,9,60
East Fife,9664,4,15,6,15,51,51,0,51
Brechin,9664,5,14,6,16,50,55,-5,48
Albion,9664,6,13,9,14,48,56,-8,48
Peterhead,9664,7,13,6,17,45,59,-14,45
Queen's Park,9664,8,10,9,17,35,53,-18,39
Stranraer,9664,9,10,5,21,54,69,-15,35
Stenhousem'r,9664,10,9,6,21,54,90,-36,33
Alloa,9665,1,21,7,8,75,40,35,70
Livingston,9665,2,18,9,9,66,42,24,63
Albion,9665,3,18,7,11,65,52,13,61
Brechin,9665,4,16,6,14,48,48,0,54
Peterhead,9665,5,15,7,14,53,52,1,52
Airdrieon,9665,6,14,8,14,54,60,-6,50
Stranraer,9665,7,13,5,18,56,60,-4,44
Queen's Park,9665,8,12,8,16,46,60,-14,44
East Fife,9665,9,11,7,18,52,60,-8,40
Stenhousem'r,9665,10,6,8,22,44,85,-41,26
Livingston,9666,1,21,7,8,89,49,40,70
Alloa,9666,2,20,5,11,64,49,15,65
Airdrieon,9666,3,17,6,13,65,60,5,57
Albion,9666,4,13,12,11,60,52,8,51
Peterhead,9666,5,14,8,14,45,52,-7,50
Stranraer,9666,6,14,5,17,50,56,-6,47
East Fife,9666,7,11,11,14,45,44,1,44
Brechin,9666,8,12,7,17,47,54,-7,43
Stenhousem'r,9666,9,11,6,19,53,82,-29,39
Queen's Park,9666,10,11,5,20,38,58,-20,38
Livingston,9667,1,22,5,9,77,43,34,71
Alloa,9667,2,21,5,10,71,34,37,68
Brechin,9667,3,19,5,12,58,50,8,62
Airdrieon,9667,4,18,6,12,58,50,8,60
Peterhead,9667,5,17,6,13,46,49,-3,57
Albion,9667,6,15,7,14,64,59,5,52
East Fife,9667,7,11,10,15,51,51,0,43
Queen's Park,9667,8,11,7,18,37,57,-20,40
Stranraer,9667,9,11,3,22,49,67,-18,36
Stenhousem'r,9667,10,5,6,25,42,93,-51,21
Livingston,9668,1,21,7,8,77,43,34,70
Brechin,9668,2,20,6,10,58,47,11,66
Alloa,9668,3,17,7,12,65,47,18,58
Airdrieon,9668,4,14,9,13,50,49,1,51
Albion,9668,5,14,8,14,57,51,6,50
Peterhead,9668,6,12,11,13,53,55,-2,47
East Fife,9668,7,13,7,16,53,51,2,46
Stranraer,9668,8,12,8,16,61,67,-6,44
Stenhousem'r,9668,9,9,8,19,48,84,-36,35
Queen's Park,9668,10,9,7,20,37,65,-28,34
Livingston,9669,1,25,3,8,89,41,48,78
Alloa,9669,2,25,3,8,93,46,47,78
Airdrieon,9669,3,17,6,13,64,61,3,57
Peterhead,9669,4,13,10,13,55,53,2,49
Brechin,9669,5,14,7,15,48,56,-8,49
Albion,9669,6,13,7,16,43,57,-14,46
Stranraer,9669,7,11,8,17,50,57,-7,41
Queen's Park,9669,8,10,9,17,34,51,-17,39
East Fife,9669,9,10,6,20,47,67,-20,36
Stenhousem'r,9669,10,10,5,21,48,82,-34,35
Livingston,9670,1,24,1,11,86,51,35,73
Brechin,9670,2,19,7,10,61,48,13,64
Alloa,9670,3,18,9,9,67,43,24,63
Airdrieon,9670,4,16,6,14,65,63,2,54
Queen's Park,9670,5,14,7,15,43,45,-2,49
Albion,9670,6,14,7,15,52,56,-4,49
Peterhead,9670,7,13,7,16,49,58,-9,46
East Fife,9670,8,11,10,15,51,62,-11,43
Stranraer,9670,9,10,6,20,54,68,-14,36
Stenhousem'r,9670,10,8,6,22,43,77,-34,30
Livingston,9671,1,21,7,8,81,43,38,70
Airdrieon,9671,2,19,9,8,69,56,13,66
Alloa,9671,3,17,9,10,76,52,24,60
Brechin,9671,4,17,6,13,53,51,2,57
Peterhead,9671,5,14,9,13,46,39,7,51
Albion,9671,6,10,12,14,43,56,-13,42
Queen's Park,9671,7,12,5,19,35,63,-28,41
Stranraer,9671,8,9,12,15,54,59,-5,39
East Fife,9671,9,9,9,18,37,51,-14,36
Stenhousem'r,9671,10,8,10,18,41,65,-24,34
Livingston,9672,1,25,3,8,94,51,43,78
Alloa,9672,2,21,7,8,73,39,34,70
Airdrieon,9672,3,18,5,13,61,52,9,59
Albion,9672,4,17,7,12,62,50,12,58
Brechin,9672,5,16,7,13,52,44,8,55
Peterhead,9672,6,13,8,15,50,60,-10,47
East Fife,9672,7,12,5,19,49,50,-1,41
Stranraer,9672,8,11,8,17,49,67,-18,41
Queen's Park,9672,9,11,7,18,40,63,-23,40
Stenhousem'r,9672,10,4,7,25,39,93,-54,19
Livingston,9673,1,24,4,8,88,45,43,76
Alloa,9673,2,16,9,11,67,46,21,57
Peterhead,9673,3,16,9,11,58,50,8,57
Airdrieon,9673,4,16,7,13,54,54,0,55
Brechin,9673,5,16,6,14,46,53,-7,54
East Fife,9673,6,14,11,11,59,44,15,53
Albion,9673,7,13,5,18,49,63,-14,44
Stranraer,9673,8,10,10,16,47,58,-11,40
Queen's Park,9673,9,10,6,20,35,56,-21,36
Stenhousem'r,9673,10,8,7,21,52,86,-34,31
Livingston,9674,1,23,4,9,77,42,35,73
Alloa,9674,2,17,13,6,71,42,29,64
Brechin,9674,3,16,10,10,54,44,10,58
Albion,9674,4,13,8,15,48,57,-9,47
Stranraer,9674,5,13,6,17,48,60,-12,45
Stenhousem'r,9674,6,11,12,13,59,73,-14,45
East Fife,9674,7,11,11,14,55,50,5,44
Airdrieon,9674,8,12,8,16,49,55,-6,44
Peterhead,9674,9,11,8,17,50,60,-10,41
Queen's Park,9674,10,8,10,18,29,57,-28,34
Alloa,9675,1,20,6,10,75,53,22,66
Livingston,9675,2,18,9,9,70,44,26,63
Airdrieon,9675,3,17,9,10,67,48,19,60
Queen's Park,9675,4,15,7,14,47,47,0,52
Albion,9675,5,14,8,14,47,55,-8,50
Stranraer,9675,6,13,7,16,53,62,-9,46
East Fife,9675,7,11,12,13,52,40,12,45
Peterhead,9675,8,11,12,13,41,44,-3,45
Brechin,9675,9,12,9,15,45,55,-10,45
Stenhousem'r,9675,10,5,9,22,43,92,-49,24
Livingston,9676,1,20,9,7,77,54,23,69
Alloa,9676,2,18,9,9,75,42,33,63
East Fife,9676,3,15,8,13,55,44,11,53
Peterhead,9676,4,15,6,15,47,53,-6,51
Airdrieon,9676,5,13,10,13,60,61,-1,49
Brechin,9676,6,14,5,17,46,49,-3,47
Stranraer,9676,7,13,6,17,53,57,-4,45
Queen's Park,9676,8,13,5,18,43,60,-17,44
Stenhousem'r,9676,9,11,8,17,49,73,-24,41
Albion,9676,10,10,10,16,49,61,-12,40
Alloa,9677,1,22,7,7,72,37,35,73
Livingston,9677,2,20,3,13,71,47,24,63
Airdrieon,9677,3,18,4,14,59,59,0,58
Brechin,9677,4,16,3,17,47,52,-5,51
Peterhead,9677,5,14,7,15,50,53,-3,49
Stranraer,9677,6,14,6,16,60,59,1,48
Queen's Park,9677,7,13,8,15,40,53,-13,47
East Fife,9677,8,13,6,17,50,48,2,45
Albion,9677,9,11,6,19,48,59,-11,39
Stenhousem'r,9677,10,11,6,19,45,75,-30,39
Livingston,9678,1,22,6,8,80,48,32,72
Alloa,9678,2,18,10,8,64,44,20,64
Airdrieon,9678,3,17,10,9,69,45,24,61
Brechin,9678,4,16,12,8,46,33,13,60
Albion,9678,5,16,8,12,51,51,0,56
Peterhead,9678,6,13,8,15,49,56,-7,47
Queen's Park,9678,7,10,8,18,31,49,-18,38
Stranraer,9678,8,11,4,21,47,69,-22,37
East Fife,9678,9,9,8,19,41,52,-11,35
Stenhousem'r,9678,10,8,6,22,51,82,-31,30
Livingston,9679,1,20,6,10,81,52,29,66
Alloa,9679,2,16,9,11,67,57,10,57
Airdrieon,9679,3,15,8,13,58,57,1,53
Peterhead,9679,4,15,7,14,42,45,-3,52
Brechin,9679,5,15,5,16,42,44,-2,50
Queen's Park,9679,6,13,10,13,42,48,-6,49
Albion,9679,7,11,14,11,49,45,4,47
East Fife,9679,8,12,10,14,54,45,9,46
Stranraer,9679,9,12,6,18,48,61,-13,42
Stenhousem'r,9679,10,8,11,17,44,73,-29,35
Livingston,9680,1,24,5,7,88,49,39,77
Alloa,9680,2,22,7,7,78,41,37,73
Stranraer,9680,3,15,7,14,51,53,-2,52
Airdrieon,9680,4,15,5,16,54,61,-7,50
Brechin,9680,5,13,8,15,50,53,-3,47
East Fife,9680,6,12,9,15,59,57,2,45
Albion,9680,7,12,8,16,57,58,-1,44
Queen's Park,9680,8,13,5,18,39,51,-12,44
Peterhead,9680,9,11,10,15,50,67,-17,43
Stenhousem'r,9680,10,6,10,20,42,78,-36,28
Alloa,9681,1,20,8,8,72,45,27,68
Livingston,9681,2,20,7,9,79,50,29,67
Albion,9681,3,18,7,11,59,50,9,61
Brechin,9681,4,16,4,16,46,46,0,52
Airdrieon,9681,5,15,6,15,62,63,-1,51
Peterhead,9681,6,14,5,17,54,59,-5,47
Queen's Park,9681,7,13,6,17,41,53,-12,45
Stranraer,9681,8,11,9,16,49,60,-11,42
Stenhousem'r,9681,9,10,8,18,49,75,-26,38
East Fife,9681,10,8,10,18,51,61,-10,34
Alloa,9682,1,19,8,9,73,41,32,65
Airdrieon,9682,2,17,8,11,60,55,5,59
Albion,9682,3,16,9,11,64,49,15,57
Queen's Park,9682,4,16,6,14,41,48,-7,54
Livingston,9682,5,16,3,17,66,64,2,51
Brechin,9682,6,15,6,15,55,56,-1,51
Peterhead,9682,7,14,8,14,45,46,-1,50
Stranraer,9682,8,14,5,17,49,53,-4,47
East Fife,9682,9,10,13,13,44,43,1,43
Stenhousem'r,9682,10,7,6,23,42,84,-42,27
Alloa,9683,1,20,10,6,77,39,38,70
Livingston,9683,2,19,5,12,82,57,25,62
Brechin,9683,3,19,3,14,53,45,8,60
Airdrieon,9683,4,17,8,11,62,53,9,59
Queen's Park,9683,5,15,9,12,39,42,-3,54
Peterhead,9683,6,13,5,18,50,57,-7,44
East Fife,9683,7,9,16,11,44,41,3,43
Albion,9683,8,9,10,17,38,55,-17,37
Stranraer,9683,9,9,9,18,47,68,-21,36
Stenhousem'r,9683,10,8,9,19,51,86,-35,33
Alloa,9684,1,22,6,8,79,44,35,72
Livingston,9684,2,21,7,8,81,46,35,70
Albion,9684,3,16,10,10,62,53,9,58
Queen's Park,9684,4,15,9,12,41,52,-11,54
Airdrieon,9684,5,15,8,13,62,61,1,53
East Fife,9684,6,15,7,14,52,50,2,52
Brechin,9684,7,12,7,17,47,52,-5,43
Peterhead,9684,8,12,6,18,56,62,-6,42
Stranraer,9684,9,12,6,18,52,63,-11,42
Stenhousem'r,9684,10,4,6,26,37,86,-49,18
Livingston,9685,1,23,1,12,79,48,31,70
Alloa,9685,2,17,8,11,66,49,17,59
Airdrieon,9685,3,16,8,12,56,54,2,56
Albion,9685,4,15,8,13,53,52,1,53
Peterhead,9685,5,14,9,13,51,55,-4,51
East Fife,9685,6,12,11,13,55,49,6,47
Stenhousem'r,9685,7,13,6,17,51,68,-17,45
Brechin,9685,8,12,7,17,45,53,-8,43
Stranraer,9685,9,12,6,18,53,63,-10,42
Queen's Park,9685,10,10,8,18,37,55,-18,38
Alloa,9686,1,22,5,9,77,46,31,71
Livingston,9686,2,19,7,10,75,51,24,64
Albion,9686,3,18,6,12,58,49,9,60
Brechin,9686,4,16,6,14,50,49,1,54
Airdrieon,9686,5,15,8,13,50,47,3,53
Peterhead,9686,6,14,8,14,52,57,-5,50
Queen's Park,9686,7,14,5,17,41,51,-10,47
East Fife,9686,8,12,9,15,52,42,10,45
Stranraer,9686,9,12,7,17,49,64,-15,43
Stenhousem'r,9686,10,4,7,25,41,89,-48,19
Livingston,9687,1,21,6,9,80,50,30,69
Peterhead,9687,2,17,8,11,53,47,6,59
Alloa,9687,3,15,11,10,71,45,26,56
Brechin,9687,4,16,5,15,44,44,0,53
Stranraer,9687,5,14,8,14,52,57,-5,50
Queen's Park,9687,6,14,7,15,35,45,-10,49
Airdrieon,9687,7,13,9,14,55,57,-2,48
East Fife,9687,8,12,11,13,46,41,5,47
Albion,9687,9,8,10,18,37,56,-19,34
Stenhousem'r,9687,10,9,7,20,45,76,-31,34
Alloa,9688,1,21,7,8,67,36,31,70
Livingston,9688,2,19,7,10,69,49,20,64
Brechin,9688,3,19,6,11,56,44,12,63
Peterhead,9688,4,17,7,12,52,40,12,58
Albion,9688,5,16,7,13,61,57,4,55
Airdrieon,9688,6,16,5,15,61,54,7,53
Stranraer,9688,7,13,6,17,50,60,-10,45
East Fife,9688,8,11,9,16,51,56,-5,42
Queen's Park,9688,9,10,3,23,33,66,-33,33
Stenhousem'r,9688,10,6,7,23,53,91,-38,25
Livingston,9689,1,22,4,10,80,46,34,70
Alloa,9689,2,18,11,7,87,47,40,65
Airdrieon,9689,3,15,11,10,60,51,9,56
Brechin,9689,4,15,5,16,50,56,-6,50
East Fife,9689,5,13,10,13,49,46,3,49
Albion,9689,6,13,9,14,55,59,-4,48
Peterhead,9689,7,13,8,15,51,59,-8,47
Stranraer,9689,8,10,9,17,50,60,-10,39
Queen's Park,9689,9,10,9,17,29,50,-21,39
Stenhousem'r,9689,10,8,10,18,42,79,-37,34
Alloa,9690,1,20,7,9,72,40,32,67
Livingston,9690,2,20,6,10,69,41,28,66
Brechin,9690,3,19,5,12,55,46,9,62
Albion,9690,4,17,6,13,53,45,8,57
Stranraer,9690,5,16,4,16,51,49,2,52
Peterhead,9690,6,13,8,15,52,58,-6,47
East Fife,9690,7,12,10,14,46,45,1,46
Airdrieon,9690,8,13,7,16,52,62,-10,46
Queen's Park,9690,9,9,9,18,34,54,-20,36
Stenhousem'r,9690,10,6,8,22,37,81,-44,26
Alloa,9691,1,20,5,11,65,45,20,65
Brechin,9691,2,19,7,10,46,40,6,64
Livingston,9691,3,19,5,12,68,44,24,62
Peterhead,9691,4,17,6,13,59,52,7,57
Airdrieon,9691,5,16,8,12,59,57,2,56
East Fife,9691,6,12,8,16,54,52,2,44
Stranraer,9691,7,13,5,18,51,55,-4,44
Albion,9691,8,10,11,15,56,63,-7,41
Queen's Park,9691,9,11,8,17,36,52,-16,41
Stenhousem'r,9691,10,8,7,21,44,78,-34,31
Alloa,9692,1,19,7,10,74,48,26,64
Livingston,9692,2,19,7,10,66,48,18,64
Airdrieon,9692,3,19,7,10,66,50,16,64
Brechin,9692,4,16,8,12,55,49,6,56
Albion,9692,5,14,6,16,46,57,-11,48
East Fife,9692,6,12,10,14,50,49,1,46
Queen's Park,9692,7,13,7,16,41,50,-9,46
Peterhead,9692,8,11,8,17,40,50,-10,41
Stranraer,9692,9,11,7,18,49,61,-12,40
Stenhousem'r,9692,10,8,9,19,40,65,-25,33
Livingston,9693,1,21,4,11,75,50,25,67
Brechin,9693,2,17,9,10,61,49,12,60
Alloa,9693,3,16,11,9,59,45,14,59
Airdrieon,9693,4,16,8,12,68,61,7,56
Albion,9693,5,14,9,13,49,41,8,51
East Fife,9693,6,11,10,15,53,59,-6,43
Peterhead,9693,7,11,10,15,49,55,-6,43
Stranraer,9693,8,11,9,16,56,65,-9,42
Queen's Park,9693,9,11,9,16,40,55,-15,42
Stenhousem'r,9693,10,8,9,19,49,79,-30,33
Alloa,9694,1,22,6,8,76,42,34,72
Livingston,9694,2,19,6,11,78,51,27,63
Airdrieon,9694,3,16,8,12,63,61,2,56
Brechin,9694,4,16,7,13,54,51,3,55
Peterhead,9694,5,14,8,14,54,60,-6,50
Queen's Park,9694,6,14,7,15,42,42,0,49
Albion,9694,7,13,8,15,50,58,-8,47
Stranraer,9694,8,13,6,17,50,61,-11,45
East Fife,9694,9,10,8,18,49,54,-5,38
Stenhousem'r,9694,10,7,8,21,42,78,-36,29
Alloa,9695,1,22,4,10,80,46,34,70
Brechin,9695,2,20,4,12,57,49,8,64
Livingston,9695,3,19,5,12,69,50,19,62
Airdrieon,9695,4,18,7,11,60,51,9,61
Peterhead,9695,5,15,7,14,47,43,4,52
East Fife,9695,6,13,10,13,51,43,8,49
Queen's Park,9695,7,13,7,16,43,57,-14,46
Albion,9695,8,12,8,16,54,60,-6,44
Stranraer,9695,9,10,5,21,49,70,-21,35
Stenhousem'r,9695,10,6,7,23,46,87,-41,25
Alloa,9696,1,22,4,10,72,49,23,70
Livingston,9696,2,20,5,11,77,49,28,65
Peterhead,9696,3,18,6,12,54,47,7,60
Brechin,9696,4,18,4,14,60,51,9,58
Albion,9696,5,16,6,14,54,48,6,54
Airdrieon,9696,6,17,3,16,54,63,-9,54
Stranraer,9696,7,15,4,17,53,58,-5,49
Queen's Park,9696,8,11,8,17,29,48,-19,41
East Fife,9696,9,10,6,20,46,59,-13,36
Stenhousem'r,9696,10,6,8,22,43,70,-27,26
Airdrieon,9697,1,22,3,11,60,50,10,69
Livingston,9697,2,19,5,12,77,49,28,62
Brechin,9697,3,18,7,11,59,46,13,61
Alloa,9697,4,16,9,11,62,45,17,57
Stranraer,9697,5,15,6,15,57,56,1,51
East Fife,9697,6,13,10,13,52,43,9,49
Peterhead,9697,7,12,11,13,41,45,-4,47
Queen's Park,9697,8,12,8,16,35,58,-23,44
Albion,9697,9,10,13,13,58,50,8,43
Stenhousem'r,9697,10,4,6,26,36,95,-59,18
Alloa,9698,1,18,10,8,66,41,25,64
Livingston,9698,2,19,6,11,71,44,27,63
Brechin,9698,3,18,7,11,51,40,11,61
Airdrieon,9698,4,18,6,12,64,61,3,60
Stranraer,9698,5,17,3,16,55,50,5,54
Peterhead,9698,6,13,10,13,49,52,-3,49
Queen's Park,9698,7,13,6,17,33,43,-10,45
East Fife,9698,8,10,10,16,45,51,-6,40
Albion,9698,9,10,8,18,47,60,-13,38
Stenhousem'r,9698,10,8,6,22,46,85,-39,30
Livingston,9699,1,26,3,7,90,44,46,81
Brechin,9699,2,18,6,12,57,52,5,60
Alloa,9699,3,17,8,11,65,46,19,59
Airdrieon,9699,4,16,9,11,71,57,14,57
Albion,9699,5,15,9,12,58,52,6,54
Queen's Park,9699,6,12,9,15,42,55,-13,45
Peterhead,9699,7,9,12,15,53,67,-14,39
East Fife,9699,8,9,10,17,45,66,-21,37
Stranraer,9699,9,9,6,21,44,62,-18,33
Stenhousem'r,9699,10,7,12,17,55,79,-24,33
Alloa,9700,1,21,10,5,79,38,41,73
Livingston,9700,2,21,6,9,80,48,32,69
Brechin,9700,3,17,11,8,52,38,14,62
Airdrieon,9700,4,15,9,12,63,56,7,54
Albion,9700,5,13,10,13,51,53,-2,49
East Fife,9700,6,12,10,14,48,48,0,46
Peterhead,9700,7,12,9,15,45,57,-12,45
Queen's Park,9700,8,8,11,17,34,52,-18,35
Stranraer,9700,9,7,12,17,46,68,-22,33
Stenhousem'r,9700,10,6,8,22,34,74,-40,26
Livingston,9701,1,21,5,10,81,50,31,68
Brechin,9701,2,20,5,11,67,48,19,65
Alloa,9701,3,18,9,9,80,50,30,63
Airdrieon,9701,4,16,8,12,61,54,7,56
Queen's Park,9701,5,15,7,14,42,54,-12,52
Albion,9701,6,12,10,14,45,49,-4,46
Peterhead,9701,7,12,10,14,42,52,-10,46
East Fife,9701,8,11,11,14,51,50,1,44
Stranraer,9701,9,12,4,20,50,65,-15,40
Stenhousem'r,9701,10,5,7,24,37,84,-47,22
Livingston,9702,1,22,2,12,76,54,22,68
Airdrieon,9702,2,17,6,13,63,57,6,57
Alloa,9702,3,15,11,10,62,49,13,56
Brechin,9702,4,16,6,14,51,44,7,54
Albion,9702,5,14,9,13,55,55,0,51
Peterhead,9702,6,13,11,12,54,53,1,50
Stranraer,9702,7,13,7,16,57,61,-4,46
East Fife,9702,8,12,9,15,53,54,-1,45
Stenhousem'r,9702,9,11,8,17,58,71,-13,41
Queen's Park,9702,10,9,7,20,30,61,-31,34
Alloa,9703,1,20,6,10,72,42,30,66
Albion,9703,2,19,9,8,56,43,13,66
Airdrieon,9703,3,18,7,11,50,47,3,61
Livingston,9703,4,17,8,11,66,48,18,59
Brechin,9703,5,14,8,14,51,52,-1,50
Stranraer,9703,6,13,7,16,47,49,-2,46
East Fife,9703,7,11,11,14,51,51,0,44
Peterhead,9703,8,12,7,17,46,57,-11,43
Queen's Park,9703,9,10,9,17,35,50,-15,39
Stenhousem'r,9703,10,7,6,23,34,69,-35,27
Livingston,9704,1,20,8,8,68,42,26,68
Alloa,9704,2,20,7,9,76,46,30,67
Brechin,9704,3,20,5,11,60,41,19,65
Peterhead,9704,4,14,9,13,57,60,-3,51
Stranraer,9704,5,14,3,19,52,61,-9,45
Airdrieon,9704,6,13,6,17,52,67,-15,45
Albion,9704,7,11,10,15,46,51,-5,43
Queen's Park,9704,8,11,9,16,41,48,-7,42
East Fife,9704,9,9,12,15,41,46,-5,39
Stenhousem'r,9704,10,8,11,17,51,82,-31,35
Livingston,9705,1,19,10,7,74,47,27,67
Alloa,9705,2,18,10,8,64,39,25,64
Airdrieon,9705,3,18,6,12,65,59,6,60
Brechin,9705,4,17,6,13,55,49,6,57
Peterhead,9705,5,15,7,14,58,50,8,52
Albion,9705,6,15,7,14,52,51,1,52
East Fife,9705,7,12,10,14,56,53,3,46
Stranraer,9705,8,12,5,19,46,59,-13,41
Queen's Park,9705,9,11,7,18,36,57,-21,40
Stenhousem'r,9705,10,4,10,22,42,84,-42,22
Livingston,9706,1,21,6,9,80,40,40,69
Airdrieon,9706,2,18,10,8,59,45,14,64
Alloa,9706,3,19,6,11,69,52,17,63
Brechin,9706,4,18,4,14,51,48,3,58
Albion,9706,5,14,6,16,48,51,-3,48
East Fife,9706,6,12,9,15,55,55,0,45
Peterhead,9706,7,11,11,14,43,58,-15,44
Queen's Park,9706,8,11,9,16,40,51,-11,42
Stenhousem'r,9706,9,11,6,19,48,69,-21,39
Stranraer,9706,10,9,5,22,44,68,-24,32
Livingston,9707,1,23,1,12,71,45,26,70
Airdrieon,9707,2,20,7,9,69,50,19,67
Alloa,9707,3,18,7,11,65,39,26,61
Brechin,9707,4,18,6,12,61,56,5,60
Peterhead,9707,5,14,9,13,48,45,3,51
Albion,9707,6,11,9,16,56,64,-8,42
Queen's Park,9707,7,11,9,16,41,57,-16,42
Stranraer,9707,8,11,8,17,52,63,-11,41
Stenhousem'r,9707,9,10,6,20,51,83,-32,36
East Fife,9707,10,8,10,18,41,53,-12,34
Alloa,9708,1,18,11,7,73,41,32,65
Livingston,9708,2,20,4,12,74,57,17,64
Airdrieon,9708,3,19,5,12,61,50,11,62
Peterhead,9708,4,16,10,10,53,49,4,58
Brechin,9708,5,13,11,12,48,50,-2,50
Queen's Park,9708,6,13,9,14,44,52,-8,48
Stranraer,9708,7,14,5,17,56,58,-2,47
East Fife,9708,8,9,11,16,54,62,-8,38
Albion,9708,9,9,10,17,52,64,-12,37
Stenhousem'r,9708,10,8,6,22,48,80,-32,30
Livingston,9709,1,19,7,10,79,45,34,64
Alloa,9709,2,18,9,9,63,43,20,63
Brechin,9709,3,18,8,10,53,51,2,62
Albion,9709,4,15,9,12,56,46,10,54
Peterhead,9709,5,14,9,13,51,58,-7,51
Airdrieon,9709,6,13,7,16,51,59,-8,46
East Fife,9709,7,11,8,17,48,53,-5,41
Stenhousem'r,9709,8,12,5,19,54,75,-21,41
Queen's Park,9709,9,11,7,18,37,49,-12,40
Stranraer,9709,10,11,7,18,47,60,-13,40
Livingston,9710,1,22,5,9,87,56,31,71
Alloa,9710,2,20,6,10,80,48,32,66
East Fife,9710,3,16,9,11,64,46,18,57
Airdrieon,9710,4,17,6,13,61,65,-4,57
Peterhead,9710,5,16,4,16,67,56,11,52
Stranraer,9710,6,15,5,16,55,63,-8,50
Queen's Park,9710,7,13,9,14,43,55,-12,48
Albion,9710,8,13,8,15,57,60,-3,47
Brechin,9710,9,11,6,19,46,68,-22,39
Stenhousem'r,9710,10,5,6,25,47,90,-43,21
Livingston,9711,1,20,7,9,82,50,32,67
Alloa,9711,2,17,11,8,77,45,32,62
Albion,9711,3,15,7,14,51,46,5,52
Airdrieon,9711,4,15,6,15,56,58,-2,51
Stranraer,9711,5,15,5,16,63,67,-4,50
Queen's Park,9711,6,14,8,14,40,54,-14,50
Brechin,9711,7,14,7,15,49,49,0,49
Peterhead,9711,8,14,7,15,44,46,-2,49
East Fife,9711,9,9,11,16,46,58,-12,38
Stenhousem'r,9711,10,8,9,19,39,74,-35,33
Alloa,9712,1,19,6,11,67,43,24,63
Livingston,9712,2,20,3,13,62,48,14,63
Airdrieon,9712,3,17,8,11,65,49,16,59
Albion,9712,4,15,9,12,56,52,4,54
Peterhead,9712,5,16,5,15,49,59,-10,53
Brechin,9712,6,13,10,13,48,44,4,49
East Fife,9712,7,12,10,14,51,51,0,46
Stranraer,9712,8,13,6,17,52,57,-5,45
Queen's Park,9712,9,12,8,16,36,47,-11,44
Stenhousem'r,9712,10,7,7,22,45,81,-36,28
Livingston,9713,1,19,6,11,78,54,24,63
Alloa,9713,2,18,7,11,71,55,16,61
Airdrieon,9713,3,17,9,10,59,51,8,60
Brechin,9713,4,16,9,11,51,49,2,57
Queen's Park,9713,5,17,6,13,50,51,-1,57
Albion,9713,6,15,8,13,59,49,10,53
East Fife,9713,7,12,9,15,56,49,7,45
Peterhead,9713,8,10,8,18,46,64,-18,38
Stenhousem'r,9713,9,9,9,18,48,79,-31,36
Stranraer,9713,10,7,9,20,44,61,-17,30
Alloa,9714,1,21,8,7,73,46,27,71
Brechin,9714,2,19,6,11,55,43,12,63
Livingston,9714,3,18,7,11,76,57,19,61
Albion,9714,4,14,12,10,50,41,9,54
Airdrieon,9714,5,14,9,13,52,54,-2,51
Queen's Park,9714,6,14,5,17,41,47,-6,47
Peterhead,9714,7,11,10,15,48,54,-6,43
Stranraer,9714,8,11,10,15,46,55,-9,43
East Fife,9714,9,11,5,20,46,57,-11,38
Stenhousem'r,9714,10,7,8,21,53,86,-33,29
Livingston,9715,1,22,3,11,82,51,31,69
Airdrieon,9715,2,19,7,10,61,48,13,64
Brechin,9715,3,18,7,11,46,41,5,61
Alloa,9715,4,17,8,11,67,49,18,59
Peterhead,9715,5,14,10,12,48,49,-1,52
Albion,9715,6,12,9,15,47,52,-5,45
Queen's Park,9715,7,12,7,17,39,54,-15,43
Stranraer,9715,8,11,7,18,51,63,-12,40
East Fife,9715,9,8,12,16,43,54,-11,36
Stenhousem'r,9715,10,6,12,18,52,75,-23,30
Alloa,9716,1,22,5,9,77,47,30,71
Livingston,9716,2,17,10,9,60,41,19,61
Airdrieon,9716,3,17,5,14,52,57,-5,56
Peterhead,9716,4,15,7,14,52,48,4,52
Albion,9716,5,12,12,12,51,46,5,48
Stranraer,9716,6,14,6,16,57,59,-2,48
Queen's Park,9716,7,12,9,15,39,54,-15,45
East Fife,9716,8,10,13,13,45,44,1,43
Brechin,9716,9,12,6,18,35,46,-11,42
Stenhousem'r,9716,10,7,11,18,44,70,-26,32
Livingston,9717,1,20,7,9,73,44,29,67
Alloa,9717,2,16,13,7,63,36,27,61
Brechin,9717,3,17,6,13,43,41,2,57
Peterhead,9717,4,14,10,12,42,41,1,52
Airdrieon,9717,5,14,8,14,48,47,1,50
Stranraer,9717,6,13,10,13,49,52,-3,49
East Fife,9717,7,11,12,13,50,46,4,45
Albion,9717,8,11,11,14,44,43,1,44
Queen's Park,9717,9,10,9,17,28,51,-23,39
Stenhousem'r,9717,10,8,6,22,37,76,-39,30
Livingston,9718,1,22,4,10,77,52,25,70
Alloa,9718,2,17,11,8,66,42,24,62
Airdrieon,9718,3,14,11,11,53,52,1,53
Brechin,9718,4,15,6,15,49,51,-2,51
Albion,9718,5,14,8,14,51,48,3,50
Stranraer,9718,6,13,9,14,51,51,0,48
East Fife,9718,7,13,8,15,51,50,1,47
Queen's Park,9718,8,13,6,17,41,51,-10,45
Peterhead,9718,9,13,5,18,45,53,-8,44
Stenhousem'r,9718,10,9,6,21,40,74,-34,33
Alloa,9719,1,21,5,10,76,43,33,68
Livingston,9719,2,20,5,11,72,54,18,65
Airdrieon,9719,3,18,4,14,60,53,7,58
Albion,9719,4,16,8,12,54,43,11,56
Brechin,9719,5,16,7,13,47,52,-5,55
Peterhead,9719,6,16,6,14,45,46,-1,54
East Fife,9719,7,14,7,15,50,45,5,49
Stranraer,9719,8,10,6,20,48,65,-17,36
Queen's Park,9719,9,9,9,18,42,61,-19,36
Stenhousem'r,9719,10,7,9,20,47,79,-32,30
Alloa,9720,1,21,8,7,74,40,34,71
Livingston,9720,2,21,6,9,79,47,32,69
Airdrieon,9720,3,17,7,12,63,57,6,58
Brechin,9720,4,17,6,13,52,49,3,57
East Fife,9720,5,15,9,12,57,41,16,54
Albion,9720,6,15,8,13,55,51,4,53
Peterhead,9720,7,12,4,20,40,56,-16,40
Stranraer,9720,8,12,3,21,53,73,-20,39
Queen's Park,9720,9,10,9,17,35,56,-21,39
Stenhousem'r,9720,10,6,8,22,43,81,-38,26
Alloa,9721,1,19,8,9,67,41,26,65
Livingston,9721,2,20,5,11,73,55,18,65
Airdrieon,9721,3,18,7,11,55,44,11,61
Peterhead,9721,4,17,8,11,69,53,16,59
Queen's Park,9721,5,14,9,13,41,48,-7,51
Albion,9721,6,13,7,16,50,57,-7,46
Brechin,9721,7,12,10,14,37,47,-10,46
Stranraer,9721,8,13,5,18,48,52,-4,44
East Fife,9721,9,11,7,18,42,46,-4,40
Stenhousem'r,9721,10,6,8,22,38,77,-39,26
Livingston,9722,1,21,5,10,71,45,26,68
Alloa,9722,2,19,8,9,67,46,21,65
Airdrieon,9722,3,17,10,9,66,48,18,61
Brechin,9722,4,16,7,13,57,47,10,55
Peterhead,9722,5,16,6,14,51,50,1,54
Albion,9722,6,14,9,13,50,39,11,51
East Fife,9722,7,13,8,15,48,43,5,47
Stranraer,9722,8,10,5,21,39,68,-29,35
Queen's Park,9722,9,10,5,21,31,62,-31,35
Stenhousem'r,9722,10,9,7,20,45,77,-32,34
Livingston,9723,1,22,5,9,84,46,38,71
Alloa,9723,2,19,8,9,74,50,24,65
Brechin,9723,3,18,7,11,56,48,8,61
Airdrieon,9723,4,16,7,13,54,52,2,55
East Fife,9723,5,14,9,13,63,58,5,51
Peterhead,9723,6,14,7,15,39,51,-12,49
Stranraer,9723,7,12,7,17,45,46,-1,43
Queen's Park,9723,8,12,5,19,36,53,-17,41
Albion,9723,9,9,11,16,42,53,-11,38
Stenhousem'r,9723,10,7,8,21,36,72,-36,29
Livingston,9724,1,22,3,11,81,52,29,69
Alloa,9724,2,17,9,10,72,58,14,60
Airdrieon,9724,3,17,4,15,68,53,15,55
Brechin,9724,4,16,5,15,48,54,-6,53
Albion,9724,5,13,10,13,58,46,12,49
Stranraer,9724,6,15,4,17,55,56,-1,49
Peterhead,9724,7,12,8,16,51,59,-8,44
Stenhousem'r,9724,8,12,8,16,47,68,-21,44
Queen's Park,9724,9,11,9,16,29,52,-23,42
East Fife,9724,10,11,8,17,44,55,-11,41
Livingston,9725,1,21,8,7,73,44,29,71
Alloa,9725,2,17,13,6,80,44,36,64
Albion,9725,3,16,10,10,63,48,15,58
Airdrieon,9725,4,15,10,11,59,56,3,55
East Fife,9725,5,13,8,15,48,46,2,47
Brechin,9725,6,12,11,13,42,50,-8,47
Queen's Park,9725,7,13,7,16,34,44,-10,46
Peterhead,9725,8,12,8,16,46,56,-10,44
Stranraer,9725,9,10,5,21,50,73,-23,35
Stenhousem'r,9725,10,7,8,21,44,78,-34,29
Alloa,9726,1,22,5,9,79,43,36,71
Livingston,9726,2,19,5,12,71,59,12,62
Airdrieon,9726,3,16,11,9,68,58,10,59
Brechin,9726,4,18,4,14,58,51,7,58
Peterhead,9726,5,17,5,14,57,49,8,56
Albion,9726,6,15,5,16,54,52,2,50
Stranraer,9726,7,13,6,17,59,68,-9,45
Queen's Park,9726,8,11,8,17,32,51,-19,41
East Fife,9726,9,9,10,17,49,58,-9,37
Stenhousem'r,9726,10,7,7,22,48,86,-38,28
Livingston,9727,1,22,4,10,75,42,33,70
Alloa,9727,2,19,6,11,69,41,28,63
Brechin,9727,3,20,3,13,58,40,18,63
Airdrieon,9727,4,18,7,11,59,50,9,61
Peterhead,9727,5,17,7,12,57,52,5,58
Stranraer,9727,6,13,6,17,52,61,-9,45
Albion,9727,7,13,5,18,53,52,1,44
East Fife,9727,8,9,13,14,47,57,-10,40
Queen's Park,9727,9,10,6,20,36,62,-26,36
Stenhousem'r,9727,10,8,5,23,36,85,-49,29
Livingston,9728,1,23,5,8,79,46,33,74
Alloa,9728,2,19,8,9,68,39,29,65
Airdrieon,9728,3,19,6,11,58,47,11,63
Brechin,9728,4,15,9,12,46,48,-2,54
Albion,9728,5,13,8,15,51,53,-2,47
Peterhead,9728,6,12,10,14,40,46,-6,46
Queen's Park,9728,7,12,8,16,37,54,-17,44
East Fife,9728,8,11,10,15,45,48,-3,43
Stranraer,9728,9,10,5,21,53,67,-14,35
Stenhousem'r,9728,10,7,9,20,49,78,-29,30
Airdrieon,9729,1,20,6,10,81,54,27,66
Livingston,9729,2,19,5,12,81,51,30,62
Alloa,9729,3,18,6,12,59,48,11,60
Albion,9729,4,16,10,10,59,50,9,58
East Fife,9729,5,13,9,14,50,42,8,48
Peterhead,9729,6,14,6,16,51,48,3,48
Brechin,9729,7,13,8,15,44,57,-13,47
Stranraer,9729,8,11,8,17,51,68,-17,41
Queen's Park,9729,9,11,7,18,36,58,-22,40
Stenhousem'r,9729,10,9,7,20,49,85,-36,34
Livingston,9730,1,21,4,11,79,53,26,67
Albion,9730,2,19,8,9,72,53,19,65
Airdrieon,9730,3,18,9,9,66,52,14,63
Alloa,9730,4,18,8,10,73,43,30,62
Brechin,9730,5,18,8,10,56,37,19,62
East Fife,9730,6,12,9,15,55,51,4,45
Queen's Park,9730,7,11,9,16,34,49,-15,42
Peterhead,9730,8,11,8,17,49,70,-21,41
Stranraer,9730,9,9,8,19,40,63,-23,35
Stenhousem'r,9730,10,3,9,24,41,94,-53,18
Livingston,9731,1,25,3,8,88,50,38,78
Alloa,9731,2,20,6,10,60,46,14,66
Airdrieon,9731,3,18,7,11,66,54,12,61
Albion,9731,4,16,8,12,58,45,13,56
Brechin,9731,5,15,5,16,47,55,-8,50
Peterhead,9731,6,14,7,15,56,53,3,49
East Fife,9731,7,11,10,15,49,51,-2,43
Stranraer,9731,8,12,5,19,50,60,-10,41
Queen's Park,9731,9,8,9,19,29,58,-29,33
Stenhousem'r,9731,10,8,6,22,43,74,-31,30
Livingston,9732,1,22,5,9,76,46,30,71
Airdrieon,9732,2,20,6,10,75,53,22,66
Alloa,9732,3,19,8,9,68,44,24,65
Peterhead,9732,4,16,6,14,50,51,-1,54
Stranraer,9732,5,15,6,15,49,51,-2,51
Brechin,9732,6,15,5,16,56,57,-1,50
East Fife,9732,7,10,12,14,46,48,-2,42
Albion,9732,8,11,9,16,53,59,-6,42
Queen's Park,9732,9,10,8,18,29,49,-20,38
Stenhousem'r,9732,10,5,9,22,48,92,-44,24
Livingston,9733,1,21,3,12,80,55,25,66
Albion,9733,2,18,8,10,61,43,18,62
Alloa,9733,3,17,8,11,70,40,30,59
Peterhead,9733,4,14,10,12,50,52,-2,52
East Fife,9733,5,15,6,15,52,40,12,51
Brechin,9733,6,15,5,16,53,47,6,50
Stranraer,9733,7,14,6,16,47,54,-7,48
Queen's Park,9733,8,14,6,16,38,57,-19,48
Airdrieon,9733,9,13,8,15,43,55,-12,47
Stenhousem'r,9733,10,3,12,21,37,88,-51,21
Brechin,9734,1,21,6,9,58,43,15,69
Alloa,9734,2,20,7,9,67,41,26,67
Airdrieon,9734,3,18,8,10,67,56,11,62
Livingston,9734,4,18,5,13,68,48,20,59
Stranraer,9734,5,13,8,15,46,48,-2,47
Albion,9734,6,12,9,15,46,49,-3,45
Queen's Park,9734,7,13,6,17,48,60,-12,45
East Fife,9734,8,9,13,14,51,51,0,40
Peterhead,9734,9,10,8,18,35,51,-16,38
Stenhousem'r,9734,10,6,10,20,46,85,-39,28
Airdrieon,9735,1,18,9,9,62,46,16,63
Alloa,9735,2,18,8,10,73,42,31,62
Brechin,9735,3,17,5,14,57,55,2,56
Queen's Park,9735,4,16,7,13,48,47,1,55
Livingston,9735,5,16,4,16,59,58,1,52
Albion,9735,6,14,9,13,52,52,0,51
Peterhead,9735,7,15,6,15,51,59,-8,51
East Fife,9735,8,12,8,16,55,49,6,44
Stranraer,9735,9,9,8,19,38,60,-22,35
Stenhousem'r,9735,10,9,8,19,50,77,-27,35
Livingston,9736,1,21,5,10,77,47,30,68
Alloa,9736,2,19,8,9,67,46,21,65
Airdrieon,9736,3,19,7,10,62,49,13,64
Peterhead,9736,4,16,8,12,55,50,5,56
Stranraer,9736,5,15,4,17,54,53,1,49
Brechin,9736,6,14,5,17,47,51,-4,47
Queen's Park,9736,7,11,8,17,37,59,-22,41
Albion,9736,8,10,10,16,47,60,-13,40
East Fife,9736,9,9,10,17,45,55,-10,37
Stenhousem'r,9736,10,9,9,18,54,75,-21,36
Livingston,9737,1,20,6,10,82,55,27,66
Alloa,9737,2,20,6,10,67,44,23,66
Airdrieon,9737,3,16,5,15,59,62,-3,53
Albion,9737,4,13,11,12,61,49,12,50
East Fife,9737,5,14,7,15,46,42,4,49
Stranraer,9737,6,14,5,17,48,57,-9,47
Peterhead,9737,7,12,10,14,50,52,-2,46
Stenhousem'r,9737,8,13,7,16,49,70,-21,46
Brechin,9737,9,13,4,19,44,56,-12,43
Queen's Park,9737,10,11,7,18,30,49,-19,40
Alloa,9738,1,17,11,8,60,38,22,62
Airdrieon,9738,2,18,7,11,63,55,8,61
Albion,9738,3,16,10,10,56,45,11,58
Livingston,9738,4,16,7,13,70,60,10,55
Brechin,9738,5,14,9,13,58,55,3,51
East Fife,9738,6,12,10,14,49,41,8,46
Peterhead,9738,7,12,7,17,47,60,-13,43
Stenhousem'r,9738,8,12,7,17,45,63,-18,43
Stranraer,9738,9,11,9,16,52,59,-7,42
Queen's Park,9738,10,9,9,18,32,56,-24,36
Alloa,9739,1,24,6,6,75,39,36,78
Livingston,9739,2,20,6,10,84,51,33,66
Airdrieon,9739,3,17,9,10,63,53,10,60
Brechin,9739,4,14,10,12,49,43,6,52
East Fife,9739,5,13,8,15,49,52,-3,47
Albion,9739,6,14,5,17,52,57,-5,47
Queen's Park,9739,7,11,12,13,39,43,-4,45
Peterhead,9739,8,13,6,17,47,61,-14,45
Stranraer,9739,9,9,7,20,45,70,-25,34
Stenhousem'r,9739,10,7,7,22,50,84,-34,28
Brechin,9740,1,21,2,13,53,43,10,65
Alloa,9740,2,18,9,9,75,47,28,63
Stranraer,9740,3,18,4,14,48,49,-1,58
Livingston,9740,4,16,6,14,69,51,18,54
Airdrieon,9740,5,14,7,15,51,48,3,49
East Fife,9740,6,13,7,16,45,47,-2,46
Albion,9740,7,12,9,15,42,46,-4,45
Queen's Park,9740,8,13,6,17,30,46,-16,45
Stenhousem'r,9740,9,11,9,16,45,65,-20,42
Peterhead,9740,10,12,5,19,42,58,-16,41
Livingston,9741,1,23,3,10,77,44,33,72
Alloa,9741,2,18,8,10,74,50,24,62
Brechin,9741,3,17,5,14,51,47,4,56
Airdrieon,9741,4,16,7,13,61,53,8,55
Albion,9741,5,15,8,13,52,50,2,53
Peterhead,9741,6,14,10,12,45,46,-1,52
Stranraer,9741,7,13,8,15,53,57,-4,47
Queen's Park,9741,8,11,8,17,37,52,-15,41
East Fife,9741,9,10,7,19,46,60,-14,37
Stenhousem'r,9741,10,9,4,23,50,87,-37,31
Livingston,9742,1,21,5,10,70,39,31,68
Alloa,9742,2,20,8,8,71,46,25,68
Brechin,9742,3,17,7,12,60,50,10,58
Albion,9742,4,14,10,12,51,44,7,52
Airdrieon,9742,5,15,5,16,51,54,-3,50
Peterhead,9742,6,14,7,15,44,42,2,49
East Fife,9742,7,12,9,15,54,50,4,45
Stranraer,9742,8,13,6,17,49,56,-7,45
Queen's Park,9742,9,9,9,18,33,63,-30,36
Stenhousem'r,9742,10,8,8,20,38,77,-39,32
Livingston,9743,1,20,6,10,67,49,18,66
Alloa,9743,2,17,8,11,80,55,25,59
Albion,9743,3,17,8,11,56,45,11,59
Peterhead,9743,4,15,9,12,50,50,0,54
Brechin,9743,5,15,6,15,59,51,8,51
Airdrieon,9743,6,14,5,17,53,59,-6,47
Stranraer,9743,7,14,4,18,51,59,-8,46
East Fife,9743,8,11,12,13,53,51,2,45
Queen's Park,9743,9,11,10,15,38,49,-11,43
Stenhousem'r,9743,10,9,6,21,40,79,-39,33
Alloa,9744,1,24,6,6,72,38,34,78
Airdrieon,9744,2,18,6,12,58,52,6,60
Brechin,9744,3,17,8,11,53,43,10,59
Livingston,9744,4,17,7,12,72,51,21,58
Stranraer,9744,5,14,9,13,59,50,9,51
Queen's Park,9744,6,14,9,13,40,52,-12,51
Albion,9744,7,10,12,14,43,49,-6,42
East Fife,9744,8,9,11,16,43,47,-4,38
Peterhead,9744,9,9,7,20,42,67,-25,34
Stenhousem'r,9744,10,6,9,21,38,71,-33,27
Livingston,9745,1,22,4,10,81,48,33,70
Airdrieon,9745,2,21,4,11,66,48,18,67
Alloa,9745,3,18,8,10,66,47,19,62
Albion,9745,4,14,10,12,57,51,6,52
Queen's Park,9745,5,14,9,13,37,40,-3,51
Brechin,9745,6,12,12,12,38,38,0,48
Peterhead,9745,7,11,8,17,47,62,-15,41
East Fife,9745,8,11,7,18,49,54,-5,40
Stranraer,9745,9,11,7,18,46,62,-16,40
Stenhousem'r,9745,10,7,9,20,42,79,-37,30
Livingston,9746,1,22,4,10,82,48,34,70
Airdrieon,9746,2,19,6,11,62,47,15,63
Brechin,9746,3,18,6,12,60,51,9,60
Stranraer,9746,4,18,3,15,63,59,4,57
Alloa,9746,5,14,13,9,69,53,16,55
Peterhead,9746,6,12,11,13,47,54,-7,47
Albion,9746,7,11,10,15,56,59,-3,43
Queen's Park,9746,8,11,8,17,32,56,-24,41
East Fife,9746,9,9,8,19,43,54,-11,35
Stenhousem'r,9746,10,8,7,21,50,83,-33,31
Livingston,9747,1,24,2,10,87,49,38,74
Alloa,9747,2,17,12,7,65,40,25,63
Brechin,9747,3,15,10,11,41,43,-2,55
Queen's Park,9747,4,16,5,15,45,47,-2,53
Albion,9747,5,14,9,13,58,53,5,51
Airdrieon,9747,6,14,4,18,50,64,-14,46
Stranraer,9747,7,13,6,17,55,53,2,45
East Fife,9747,8,12,9,15,47,47,0,45
Peterhead,9747,9,10,13,13,39,50,-11,43
Stenhousem'r,9747,10,7,6,23,42,83,-41,27
Livingston,9748,1,24,5,7,73,34,39,77
Brechin,9748,2,16,10,10,58,52,6,58
Airdrieon,9748,3,16,7,13,63,58,5,55
Alloa,9748,4,14,10,12,64,50,14,52
Albion,9748,5,12,12,12,52,53,-1,48
Peterhead,9748,6,13,6,17,52,54,-2,45
East Fife,9748,7,10,14,12,47,47,0,44
Stenhousem'r,9748,8,12,6,18,45,62,-17,42
Queen's Park,9748,9,11,7,18,44,62,-18,40
Stranraer,9748,10,11,5,20,37,63,-26,38
Alloa,9749,1,22,8,6,88,40,48,74
Livingston,9749,2,18,2,16,58,55,3,56
Brechin,9749,3,16,7,13,49,51,-2,55
Peterhead,9749,4,14,11,11,54,50,4,53
Airdrieon,9749,5,15,7,14,60,62,-2,52
Queen's Park,9749,6,13,8,15,45,51,-6,47
Albion,9749,7,12,10,14,54,60,-6,46
Stranraer,9749,8,13,7,16,48,57,-9,46
East Fife,9749,9,11,11,14,48,46,2,44
Stenhousem'r,9749,10,6,9,21,37,69,-32,27
Livingston,9750,1,20,5,11,72,49,23,65
Alloa,9750,2,18,8,10,76,51,25,62
Stranraer,9750,3,18,3,15,50,48,2,57
Brechin,9750,4,16,8,12,55,50,5,56
Airdrieon,9750,5,17,5,14,62,60,2,56
Peterhead,9750,6,16,6,14,45,49,-4,54
Albion,9750,7,14,9,13,52,47,5,51
East Fife,9750,8,11,9,16,55,53,2,42
Queen's Park,9750,9,8,9,19,28,58,-30,33
Stenhousem'r,9750,10,8,6,22,50,80,-30,30
Livingston,9751,1,21,5,10,70,41,29,68
Airdrieon,9751,2,19,7,10,66,54,12,64
Alloa,9751,3,16,10,10,69,45,24,58
Albion,9751,4,14,11,11,55,52,3,53
Brechin,9751,5,15,7,14,46,54,-8,52
Queen's Park,9751,6,13,5,18,50,59,-9,44
Peterhead,9751,7,11,10,15,53,59,-6,43
Stranraer,9751,8,12,7,17,43,51,-8,43
East Fife,9751,9,10,10,16,52,50,2,40
Stenhousem'r,9751,10,10,6,20,49,88,-39,36
Livingston,9752,1,26,1,9,87,47,40,79
Alloa,9752,2,23,7,6,74,38,36,76
Airdrieon,9752,3,20,6,10,62,44,18,66
Brechin,9752,4,16,8,12,44,36,8,56
Peterhead,9752,5,10,10,16,38,53,-15,40
Queen's Park,9752,6,11,7,18,34,54,-20,40
Stranraer,9752,7,10,9,17,49,61,-12,39
Albion,9752,8,10,9,17,44,57,-13,39
East Fife,9752,9,8,11,17,41,51,-10,35
Stenhousem'r,9752,10,9,6,21,48,80,-32,33
Livingston,9753,1,21,5,10,80,47,33,68
Airdrieon,9753,2,18,7,11,57,56,1,61
Alloa,9753,3,17,7,12,72,50,22,58
Brechin,9753,4,17,7,12,46,42,4,58
Queen's Park,9753,5,14,8,14,45,45,0,50
East Fife,9753,6,12,10,14,42,40,2,46
Albion,9753,7,12,10,14,54,60,-6,46
Peterhead,9753,8,13,7,16,45,51,-6,46
Stranraer,9753,9,11,7,18,44,61,-17,40
Stenhousem'r,9753,10,6,10,20,46,79,-33,28
Alloa,9754,1,16,13,7,62,42,20,61
Albion,9754,2,19,4,13,59,44,15,61
Livingston,9754,3,18,5,13,67,51,16,59
Brechin,9754,4,17,7,12,55,42,13,58
Airdrieon,9754,5,15,12,9,53,54,-1,57
Stranraer,9754,6,16,6,14,54,50,4,54
Peterhead,9754,7,13,9,14,55,57,-2,48
East Fife,9754,8,8,13,15,38,43,-5,37
Stenhousem'r,9754,9,8,9,19,48,78,-30,33
Queen's Park,9754,10,7,8,21,30,60,-30,29
Alloa,9755,1,20,8,8,68,41,27,68
Livingston,9755,2,20,6,10,81,50,31,66
Airdrieon,9755,3,19,5,12,60,49,11,62
Albion,9755,4,16,5,15,51,48,3,53
Peterhead,9755,5,14,8,14,57,56,1,50
Queen's Park,9755,6,14,6,16,41,55,-14,48
East Fife,9755,7,11,10,15,40,44,-4,43
Brechin,9755,8,12,7,17,44,50,-6,43
Stranraer,9755,9,12,6,18,50,65,-15,42
Stenhousem'r,9755,10,8,7,21,45,79,-34,31
Alloa,9756,1,20,6,10,77,36,41,66
Livingston,9756,2,19,7,10,71,46,25,64
Brechin,9756,3,17,4,15,43,47,-4,55
Albion,9756,4,15,9,12,53,46,7,54
Peterhead,9756,5,11,15,10,56,49,7,48
Airdrieon,9756,6,12,11,13,49,61,-12,47
Stranraer,9756,7,13,5,18,48,68,-20,44
East Fife,9756,8,11,10,15,51,52,-1,43
Stenhousem'r,9756,9,9,11,16,51,72,-21,38
Queen's Park,9756,10,10,8,18,36,58,-22,38
Airdrieon,9757,1,19,7,10,63,51,12,64
Livingston,9757,2,20,3,13,76,51,25,63
Albion,9757,3,15,11,10,56,49,7,56
Alloa,9757,4,14,12,10,62,44,18,54
Brechin,9757,5,15,6,15,42,44,-2,51
East Fife,9757,6,13,9,14,47,46,1,48
Stranraer,9757,7,12,9,15,50,61,-11,45
Peterhead,9757,8,11,11,14,55,57,-2,44
Queen's Park,9757,9,10,9,17,35,49,-14,39
Stenhousem'r,9757,10,8,9,19,42,76,-34,33
Livingston,9758,1,22,5,9,78,43,35,71
Alloa,9758,2,20,7,9,84,50,34,67
Airdrieon,9758,3,18,6,12,65,59,6,60
East Fife,9758,4,16,7,13,66,46,20,55
Peterhead,9758,5,12,12,12,52,64,-12,48
Stranraer,9758,6,14,5,17,53,62,-9,47
Brechin,9758,7,15,2,19,48,57,-9,47
Albion,9758,8,11,10,15,59,69,-10,43
Queen's Park,9758,9,11,6,19,38,57,-19,39
Stenhousem'r,9758,10,7,8,21,49,85,-36,29
Livingston,9759,1,22,2,12,92,58,34,68
Alloa,9759,2,21,5,10,62,41,21,68
Airdrieon,9759,3,18,4,14,65,55,10,58
Albion,9759,4,16,8,12,69,51,18,56
Brechin,9759,5,15,7,14,47,53,-6,52
Peterhead,9759,6,13,7,16,48,62,-14,46
East Fife,9759,7,11,11,14,50,48,2,44
Queen's Park,9759,8,11,10,15,35,53,-18,43
Stranraer,9759,9,12,5,19,53,60,-7,41
Stenhousem'r,9759,10,7,9,20,46,86,-40,30
Livingston,9760,1,25,5,6,94,39,55,80
Alloa,9760,2,20,8,8,72,40,32,68
Airdrieon,9760,3,20,5,11,74,53,21,65
Peterhead,9760,4,15,6,15,52,64,-12,51
East Fife,9760,5,14,8,14,58,46,12,50
Brechin,9760,6,15,5,16,53,63,-10,50
Queen's Park,9760,7,14,6,16,44,60,-16,48
Stranraer,9760,8,13,3,20,52,64,-12,42
Albion,9760,9,9,9,18,45,62,-17,36
Stenhousem'r,9760,10,4,7,25,34,87,-53,19
Alloa,9761,1,20,6,10,76,46,30,66
Airdrieon,9761,2,19,6,11,63,50,13,63
Livingston,9761,3,19,4,13,67,47,20,61
Brechin,9761,4,15,8,13,42,48,-6,53
East Fife,9761,5,11,14,11,57,50,7,47
Stranraer,9761,6,14,5,17,49,54,-5,47
Queen's Park,9761,7,12,9,15,35,45,-10,45
Albion,9761,8,11,8,17,54,63,-9,41
Peterhead,9761,9,10,9,17,35,49,-14,39
Stenhousem'r,9761,10,10,9,17,55,81,-26,39
Alloa,9762,1,20,7,9,69,45,24,67
Livingston,9762,2,19,5,12,90,59,31,62
Airdrieon,9762,3,17,6,13,58,62,-4,57
Brechin,9762,4,17,5,14,55,48,7,56
Queen's Park,9762,5,13,12,11,36,44,-8,51
East Fife,9762,6,10,14,12,50,47,3,44
Stranraer,9762,7,12,6,18,47,54,-7,42
Peterhead,9762,8,10,11,15,46,57,-11,41
Albion,9762,9,10,11,15,41,52,-11,41
Stenhousem'r,9762,10,9,9,18,39,63,-24,36
Livingston,9763,1,20,8,8,73,44,29,68
Airdrieon,9763,2,15,12,9,54,54,0,57
Brechin,9763,3,16,7,13,54,52,2,55
Alloa,9763,4,15,8,13,63,53,10,53
Albion,9763,5,14,9,13,59,52,7,51
East Fife,9763,6,13,9,14,61,50,11,48
Peterhead,9763,7,11,11,14,43,50,-7,44
Queen's Park,9763,8,11,8,17,39,54,-15,41
Stranraer,9763,9,9,13,14,58,68,-10,40
Stenhousem'r,9763,10,6,15,15,42,69,-27,33
Livingston,9764,1,22,6,8,81,45,36,72
Airdrieon,9764,2,16,7,13,51,53,-2,55
Alloa,9764,3,13,13,10,65,48,17,52
Queen's Park,9764,4,14,10,12,42,44,-2,52
Peterhead,9764,5,13,11,12,54,56,-2,50
Brechin,9764,6,14,7,15,47,48,-1,49
Albion,9764,7,13,9,14,55,53,2,48
East Fife,9764,8,13,6,17,50,56,-6,45
Stranraer,9764,9,9,12,15,49,57,-8,39
Stenhousem'r,9764,10,8,9,19,43,77,-34,33
Livingston,9765,1,22,5,9,83,41,42,71
Alloa,9765,2,18,13,5,65,36,29,67
Airdrieon,9765,3,20,7,9,70,50,20,67
Brechin,9765,4,16,6,14,52,49,3,54
Queen's Park,9765,5,13,7,16,41,51,-10,46
Albion,9765,6,12,9,15,48,57,-9,45
Peterhead,9765,7,10,13,13,46,58,-12,43
Stranraer,9765,8,10,9,17,43,60,-17,39
Stenhousem'r,9765,9,8,9,19,48,82,-34,33
East Fife,9765,10,7,10,19,48,60,-12,31
Brechin,9766,1,19,5,12,66,45,21,62
Alloa,9766,2,16,12,8,70,40,30,60
Livingston,9766,3,18,6,12,80,55,25,60
Airdrieon,9766,4,17,8,11,57,58,-1,59
Albion,9766,5,16,8,12,50,54,-4,56
East Fife,9766,6,15,4,17,55,57,-2,49
Peterhead,9766,7,12,8,16,47,56,-9,44
Stranraer,9766,8,9,14,13,48,56,-8,41
Queen's Park,9766,9,11,3,22,35,64,-29,36
Stenhousem'r,9766,10,8,10,18,55,78,-23,34
Livingston,9767,1,20,6,10,71,40,31,66
Airdrieon,9767,2,18,9,9,63,49,14,63
Alloa,9767,3,16,10,10,60,51,9,58
Brechin,9767,4,16,7,13,51,51,0,55
Queen's Park,9767,5,15,7,14,43,47,-4,52
East Fife,9767,6,14,7,15,55,51,4,49
Albion,9767,7,13,10,13,52,50,2,49
Peterhead,9767,8,11,7,18,51,59,-8,40
Stranraer,9767,9,10,5,21,49,67,-18,35
Stenhousem'r,9767,10,8,10,18,48,78,-30,34
Alloa,9768,1,20,7,9,66,35,31,67
Livingston,9768,2,20,7,9,78,50,28,67
Airdrieon,9768,3,18,4,14,53,54,-1,58
Brechin,9768,4,16,5,15,54,49,5,53
Peterhead,9768,5,14,7,15,55,50,5,49
Stranraer,9768,6,13,8,15,56,61,-5,47
Albion,9768,7,13,7,16,52,60,-8,46
East Fife,9768,8,11,11,14,45,47,-2,44
Queen's Park,9768,9,10,8,18,38,59,-21,38
Stenhousem'r,9768,10,8,10,18,42,74,-32,34
Livingston,9769,1,20,7,9,85,55,30,67
Peterhead,9769,2,19,6,11,68,49,19,63
Alloa,9769,3,16,10,10,59,44,15,58
Brechin,9769,4,16,7,13,55,54,1,55
Queen's Park,9769,5,16,6,14,46,46,0,54
Airdrieon,9769,6,11,11,14,52,55,-3,44
East Fife,9769,7,10,12,14,47,44,3,42
Stranraer,9769,8,10,10,16,44,61,-17,40
Albion,9769,9,9,12,15,43,51,-8,39
Stenhousem'r,9769,10,10,5,21,45,85,-40,35
Alloa,9770,1,20,10,6,79,39,40,70
Livingston,9770,2,19,7,10,72,46,26,64
Airdrieon,9770,3,15,10,11,59,61,-2,55
Brechin,9770,4,14,9,13,42,49,-7,51
Albion,9770,5,13,9,14,54,52,2,48
Peterhead,9770,6,12,11,13,45,53,-8,47
East Fife,9770,7,12,9,15,49,46,3,45
Queen's Park,9770,8,12,7,17,37,51,-14,43
Stranraer,9770,9,10,7,19,46,57,-11,37
Stenhousem'r,9770,10,9,9,18,51,80,-29,36
Alloa,9771,1,21,6,9,67,41,26,69
Livingston,9771,2,21,5,10,75,46,29,68
Brechin,9771,3,20,5,11,59,46,13,65
Airdrieon,9771,4,14,8,14,55,58,-3,50
Albion,9771,5,14,6,16,50,57,-7,48
East Fife,9771,6,12,10,14,50,46,4,46
Queen's Park,9771,7,13,6,17,40,56,-16,45
Peterhead,9771,8,12,8,16,55,55,0,44
Stranraer,9771,9,11,5,20,50,71,-21,38
Stenhousem'r,9771,10,9,7,20,60,85,-25,34
Alloa,9772,1,23,4,9,77,40,37,73
Livingston,9772,2,20,6,10,76,48,28,66
East Fife,9772,3,17,6,13,55,44,11,57
Albion,9772,4,16,9,11,58,51,7,57
Brechin,9772,5,16,4,16,43,47,-4,52
Airdrieon,9772,6,14,9,13,51,56,-5,51
Peterhead,9772,7,12,7,17,44,55,-11,43
Stranraer,9772,8,12,6,18,46,58,-12,42
Queen's Park,9772,9,10,7,19,38,58,-20,37
Stenhousem'r,9772,10,6,10,20,56,87,-31,28
Livingston,9773,1,18,6,12,67,49,18,60
Brechin,9773,2,17,9,10,53,47,6,60
Airdrieon,9773,3,18,5,13,59,55,4,59
Peterhead,9773,4,16,10,10,56,44,12,58
Alloa,9773,5,15,9,12,68,55,13,54
Queen's Park,9773,6,15,7,14,47,50,-3,52
Albion,9773,7,13,6,17,53,58,-5,45
Stranraer,9773,8,12,4,20,50,65,-15,40
East Fife,9773,9,10,9,17,51,53,-2,39
Stenhousem'r,9773,10,10,7,19,48,76,-28,37
Livingston,9774,1,20,4,12,67,43,24,64
Alloa,9774,2,17,8,11,70,42,28,59
Airdrieon,9774,3,18,5,13,60,52,8,59
Stranraer,9774,4,16,5,15,48,50,-2,53
Brechin,9774,5,13,10,13,46,53,-7,49
Albion,9774,6,13,9,14,59,59,0,48
Peterhead,9774,7,13,9,14,45,54,-9,48
Queen's Park,9774,8,13,6,17,34,48,-14,45
East Fife,9774,9,11,11,14,47,47,0,44
Stenhousem'r,9774,10,8,9,19,44,72,-28,33
Alloa,9775,1,20,9,7,85,51,34,69
Livingston,9775,2,18,5,13,71,49,22,59
Airdrieon,9775,3,16,9,11,69,59,10,57
Brechin,9775,4,16,8,12,51,44,7,56
Peterhead,9775,5,15,8,13,53,55,-2,53
Queen's Park,9775,6,16,4,16,44,45,-1,52
Stranraer,9775,7,13,8,15,60,65,-5,47
East Fife,9775,8,11,9,16,42,49,-7,42
Albion,9775,9,10,8,18,53,62,-9,38
Stenhousem'r,9775,10,7,8,21,39,88,-49,29
Livingston,9776,1,20,4,12,69,50,19,64
Brechin,9776,2,18,8,10,51,47,4,62
Alloa,9776,3,16,11,9,78,51,27,59
Airdrieon,9776,4,16,7,13,65,52,13,55
Queen's Park,9776,5,15,10,11,43,40,3,55
East Fife,9776,6,15,6,15,64,48,16,51
Stranraer,9776,7,16,2,18,46,59,-13,50
Albion,9776,8,9,15,12,49,54,-5,42
Peterhead,9776,9,11,6,19,47,64,-17,39
Stenhousem'r,9776,10,5,9,22,43,90,-47,24
Alloa,9777,1,17,10,9,70,43,27,61
Livingston,9777,2,19,3,14,65,45,20,60
Airdrieon,9777,3,17,9,10,62,48,14,60
Peterhead,9777,4,17,7,12,59,52,7,58
Brechin,9777,5,13,10,13,48,49,-1,49
Stranraer,9777,6,14,6,16,53,63,-10,48
Albion,9777,7,12,7,17,48,58,-10,43
Queen's Park,9777,8,12,7,17,33,51,-18,43
East Fife,9777,9,9,14,13,44,44,0,41
Stenhousem'r,9777,10,9,9,18,50,79,-29,36
Livingston,9778,1,23,3,10,78,43,35,72
Brechin,9778,2,21,3,12,51,40,11,66
Alloa,9778,3,17,6,13,62,47,15,57
Airdrieon,9778,4,16,6,14,66,62,4,54
Stranraer,9778,5,17,3,16,55,54,1,54
Albion,9778,6,15,8,13,54,50,4,53
Stenhousem'r,9778,7,13,6,17,59,75,-16,45
Peterhead,9778,8,10,11,15,45,62,-17,41
Queen's Park,9778,9,10,6,20,28,53,-25,36
East Fife,9778,10,7,10,19,40,52,-12,31
Livingston,9779,1,22,3,11,74,42,32,69
Brechin,9779,2,17,7,12,60,57,3,58
Alloa,9779,3,16,7,13,66,52,14,55
Airdrieon,9779,4,15,6,15,55,54,1,51
Peterhead,9779,5,14,6,16,50,51,-1,48
East Fife,9779,6,14,6,16,45,47,-2,48
Albion,9779,7,11,13,12,46,52,-6,46
Queen's Park,9779,8,12,10,14,41,49,-8,46
Stranraer,9779,9,14,4,18,49,59,-10,46
Stenhousem'r,9779,10,10,8,18,47,70,-23,38
Livingston,9780,1,22,3,11,84,49,35,69
Airdrieon,9780,2,21,2,13,68,58,10,65
Alloa,9780,3,16,9,11,68,57,11,57
Albion,9780,4,16,8,12,59,51,8,56
Queen's Park,9780,5,15,7,14,44,56,-12,52
Brechin,9780,6,14,8,14,62,60,2,50
Stranraer,9780,7,14,6,16,60,59,1,48
Peterhead,9780,8,14,5,17,50,54,-4,47
East Fife,9780,9,10,9,17,49,60,-11,39
Stenhousem'r,9780,10,6,7,23,51,91,-40,25
Airdrieon,9781,1,19,7,10,62,44,18,64
Brechin,9781,2,19,7,10,51,41,10,64
Livingston,9781,3,18,5,13,64,52,12,59
Peterhead,9781,4,16,10,10,56,48,8,58
Alloa,9781,5,15,10,11,58,43,15,55
Albion,9781,6,14,8,14,48,47,1,50
East Fife,9781,7,10,13,13,44,45,-1,43
Stranraer,9781,8,11,8,17,54,68,-14,41
Stenhousem'r,9781,9,10,7,19,44,60,-16,37
Queen's Park,9781,10,8,5,23,28,61,-33,29
Livingston,9782,1,22,6,8,71,44,27,72
Alloa,9782,2,17,11,8,69,43,26,62
Airdrieon,9782,3,17,7,12,62,52,10,58
Brechin,9782,4,16,10,10,49,44,5,58
East Fife,9782,5,14,8,14,58,52,6,50
Albion,9782,6,12,9,15,52,54,-2,45
Queen's Park,9782,7,12,7,17,37,49,-12,43
Peterhead,9782,8,11,9,16,49,62,-13,42
Stranraer,9782,9,11,7,18,45,61,-16,40
Stenhousem'r,9782,10,8,6,22,45,76,-31,30
Alloa,9783,1,22,5,9,78,43,35,71
Livingston,9783,2,19,3,14,67,54,13,60
Airdrieon,9783,3,17,7,12,57,46,11,58
Brechin,9783,4,17,5,14,51,47,4,56
Queen's Park,9783,5,16,7,13,41,49,-8,55
Peterhead,9783,6,15,4,17,53,55,-2,49
East Fife,9783,7,12,8,16,63,54,9,44
Stranraer,9783,8,12,6,18,46,65,-19,42
Albion,9783,9,10,7,19,47,55,-8,37
Stenhousem'r,9783,10,9,10,17,48,83,-35,37
Alloa,9784,1,20,9,7,70,40,30,69
Livingston,9784,2,18,6,12,70,48,22,60
Brechin,9784,3,14,11,11,48,48,0,53
Albion,9784,4,13,12,11,52,53,-1,51
Airdrieon,9784,5,13,8,15,50,55,-5,47
Stranraer,9784,6,13,7,16,58,60,-2,46
East Fife,9784,7,11,12,13,42,46,-4,45
Queen's Park,9784,8,12,9,15,38,52,-14,45
Peterhead,9784,9,11,11,14,50,53,-3,44
Stenhousem'r,9784,10,8,9,19,43,66,-23,33
Alloa,9785,1,23,4,9,83,47,36,73
Livingston,9785,2,20,7,9,76,51,25,67
Brechin,9785,3,18,3,15,55,49,6,57
Airdrieon,9785,4,17,6,13,64,62,2,57
East Fife,9785,5,15,8,13,58,46,12,53
Queen's Park,9785,6,13,7,16,39,53,-14,46
Stranraer,9785,7,12,6,18,53,57,-4,42
Peterhead,9785,8,11,8,17,40,58,-18,41
Albion,9785,9,11,6,19,52,68,-16,39
Stenhousem'r,9785,10,9,7,20,49,78,-29,34
Livingston,9786,1,25,0,11,94,45,49,75
Alloa,9786,2,18,9,9,67,44,23,63
Brechin,9786,3,19,4,13,52,50,2,61
Peterhead,9786,4,15,6,15,54,56,-2,51
Airdrieon,9786,5,15,6,15,53,57,-4,51
East Fife,9786,6,13,8,15,49,45,4,47
Queen's Park,9786,7,12,10,14,39,51,-12,46
Stranraer,9786,8,13,6,17,54,67,-13,45
Albion,9786,9,12,7,17,46,60,-14,43
Stenhousem'r,9786,10,7,6,23,41,74,-33,27
Livingston,9787,1,23,7,6,79,39,40,76
Airdrieon,9787,2,17,12,7,64,43,21,63
Alloa,9787,3,15,11,10,71,45,26,56
Brechin,9787,4,15,4,17,40,49,-9,49
Albion,9787,5,12,12,12,48,42,6,48
Peterhead,9787,6,12,10,14,48,59,-11,46
Stranraer,9787,7,13,6,17,51,67,-16,45
East Fife,9787,8,11,10,15,44,46,-2,43
Queen's Park,9787,9,11,8,17,35,52,-17,41
Stenhousem'r,9787,10,6,10,20,44,82,-38,28
Alloa,9788,1,22,7,7,76,41,35,73
Livingston,9788,2,18,10,8,73,51,22,64
Brechin,9788,3,17,5,14,60,50,10,56
Airdrieon,9788,4,16,8,12,56,54,2,56
Peterhead,9788,5,14,7,15,53,52,1,49
Albion,9788,6,13,8,15,49,52,-3,47
Queen's Park,9788,7,14,5,17,39,57,-18,47
East Fife,9788,8,10,9,17,45,48,-3,39
Stranraer,9788,9,10,7,19,46,69,-23,37
Stenhousem'r,9788,10,10,6,20,55,78,-23,36
Livingston,9789,1,20,7,9,76,42,34,67
Airdrieon,9789,2,18,6,12,68,51,17,60
Alloa,9789,3,16,8,12,63,50,13,56
East Fife,9789,4,14,10,12,51,44,7,52
Peterhead,9789,5,14,8,14,43,50,-7,50
Brechin,9789,6,13,10,13,50,55,-5,49
Stranraer,9789,7,13,7,16,49,56,-7,46
Albion,9789,8,12,9,15,58,61,-3,45
Stenhousem'r,9789,9,11,6,19,48,79,-31,39
Queen's Park,9789,10,9,9,18,42,60,-18,36
Livingston,9790,1,22,5,9,76,43,33,71
Alloa,9790,2,18,8,10,72,46,26,62
Airdrieon,9790,3,18,8,10,74,63,11,62
Peterhead,9790,4,13,9,14,58,50,8,48
Albion,9790,5,12,10,14,48,56,-8,46
Stenhousem'r,9790,6,12,9,15,54,70,-16,45
Queen's Park,9790,7,13,5,18,34,57,-23,44
Stranraer,9790,8,12,6,18,50,57,-7,42
Brechin,9790,9,11,9,16,43,58,-15,42
East Fife,9790,10,7,15,14,37,46,-9,36
Airdrieon,9791,1,21,5,10,61,49,12,68
Alloa,9791,2,19,8,9,69,44,25,65
Livingston,9791,3,18,4,14,66,48,18,58
Brechin,9791,4,17,5,14,63,55,8,56
Albion,9791,5,16,7,13,46,42,4,55
Peterhead,9791,6,14,7,15,45,48,-3,49
East Fife,9791,7,11,9,16,55,52,3,42
Queen's Park,9791,8,11,6,19,33,58,-25,39
Stenhousem'r,9791,9,11,6,19,48,75,-27,39
Stranraer,9791,10,11,5,20,55,70,-15,38
Livingston,9792,1,24,3,9,86,45,41,75
Alloa,9792,2,16,11,9,70,43,27,59
Albion,9792,3,17,6,13,62,62,0,57
Brechin,9792,4,15,8,13,41,46,-5,53
Airdrieon,9792,5,14,9,13,57,60,-3,51
Peterhead,9792,6,13,10,13,46,47,-1,49
Stranraer,9792,7,14,6,16,52,50,2,48
East Fife,9792,8,12,8,16,48,50,-2,44
Queen's Park,9792,9,11,7,18,34,52,-18,40
Stenhousem'r,9792,10,5,10,21,45,86,-41,25
Livingston,9793,1,20,6,10,65,43,22,66
Alloa,9793,2,16,13,7,68,45,23,61
Airdrieon,9793,3,17,8,11,63,52,11,59
Brechin,9793,4,16,8,12,50,45,5,56
Albion,9793,5,14,10,12,57,51,6,52
Queen's Park,9793,6,14,10,12,46,44,2,52
Stranraer,9793,7,11,9,16,49,57,-8,42
Peterhead,9793,8,11,8,17,37,52,-15,41
East Fife,9793,9,9,12,15,53,55,-2,39
Stenhousem'r,9793,10,6,8,22,42,86,-44,26
Livingston,9794,1,22,4,10,81,48,33,70
Stranraer,9794,2,19,4,13,59,49,10,61
Alloa,9794,3,17,8,11,69,45,24,59
Brechin,9794,4,17,4,15,56,50,6,55
Airdrieon,9794,5,14,9,13,50,49,1,51
Peterhead,9794,6,14,8,14,52,53,-1,50
Queen's Park,9794,7,13,7,16,39,52,-13,46
Albion,9794,8,12,8,16,46,55,-9,44
East Fife,9794,9,10,10,16,47,49,-2,40
Stenhousem'r,9794,10,8,6,22,38,87,-49,30
Alloa,9795,1,18,10,8,77,51,26,64
Brechin,9795,2,19,7,10,59,41,18,64
Livingston,9795,3,19,6,11,84,53,31,63
Peterhead,9795,4,16,8,12,59,53,6,56
Airdrieon,9795,5,16,8,12,63,58,5,56
Albion,9795,6,12,10,14,50,57,-7,46
Stranraer,9795,7,13,5,18,55,61,-6,44
Queen's Park,9795,8,12,8,16,41,57,-16,44
East Fife,9795,9,9,10,17,46,61,-15,37
Stenhousem'r,9795,10,5,10,21,45,87,-42,25
Livingston,9796,1,25,3,8,81,43,38,78
Alloa,9796,2,21,5,10,72,41,31,68
Airdrieon,9796,3,17,8,11,60,47,13,59
Albion,9796,4,15,6,15,57,52,5,51
Stranraer,9796,5,14,7,15,55,58,-3,49
Brechin,9796,6,13,7,16,43,51,-8,46
Queen's Park,9796,7,12,6,18,31,56,-25,42
East Fife,9796,8,11,8,17,45,53,-8,41
Peterhead,9796,9,11,6,19,45,60,-15,39
Stenhousem'r,9796,10,11,4,21,47,75,-28,37
Alloa,9797,1,20,8,8,75,48,27,68
Albion,9797,2,18,8,10,59,48,11,62
Livingston,9797,3,17,7,12,74,55,19,58
Airdrieon,9797,4,16,9,11,60,53,7,57
Brechin,9797,5,14,9,13,57,59,-2,51
East Fife,9797,6,13,8,15,53,48,5,47
Stranraer,9797,7,13,5,18,55,64,-9,44
Peterhead,9797,8,10,12,14,43,52,-9,42
Queen's Park,9797,9,12,5,19,43,55,-12,41
Stenhousem'r,9797,10,7,9,20,45,82,-37,30
Livingston,9798,1,21,3,12,80,53,27,66
Airdrieon,9798,2,20,4,12,62,52,10,64
Brechin,9798,3,19,5,12,50,43,7,62
Alloa,9798,4,16,7,13,61,49,12,55
East Fife,9798,5,15,6,15,53,52,1,51
Peterhead,9798,6,15,6,15,52,51,1,51
Queen's Park,9798,7,15,6,15,41,50,-9,51
Albion,9798,8,12,5,19,51,50,1,41
Stranraer,9798,9,11,5,20,45,64,-19,38
Stenhousem'r,9798,10,9,7,20,44,75,-31,34
Livingston,9799,1,24,5,7,87,37,50,77
Alloa,9799,2,21,6,9,69,41,28,69
Peterhead,9799,3,14,9,13,40,49,-9,51
Albion,9799,4,13,11,12,57,55,2,50
Brechin,9799,5,14,8,14,47,52,-5,50
Queen's Park,9799,6,14,4,18,45,53,-8,46
Stranraer,9799,7,12,9,15,56,59,-3,45
East Fife,9799,8,10,13,13,47,53,-6,43
Airdrieon,9799,9,13,4,19,56,65,-9,43
Stenhousem'r,9799,10,7,7,22,45,85,-40,28
Livingston,9800,1,20,7,9,79,55,24,67
Airdrieon,9800,2,18,8,10,62,47,15,62
Alloa,9800,3,16,8,12,67,46,21,56
Brechin,9800,4,16,6,14,50,57,-7,54
Stranraer,9800,5,15,6,15,56,54,2,51
Albion,9800,6,13,11,12,56,52,4,50
Queen's Park,9800,7,12,10,14,38,50,-12,46
East Fife,9800,8,12,8,16,46,43,3,44
Peterhead,9800,9,12,8,16,46,59,-13,44
Stenhousem'r,9800,10,5,10,21,39,76,-37,25
Livingston,9801,1,19,7,10,74,44,30,64
Airdrieon,9801,2,18,8,10,60,46,14,62
Alloa,9801,3,18,7,11,60,43,17,61
Brechin,9801,4,17,8,11,49,49,0,59
Albion,9801,5,16,6,14,53,44,9,54
Peterhead,9801,6,11,13,12,48,49,-1,46
Stranraer,9801,7,12,8,16,48,59,-11,44
East Fife,9801,8,11,9,16,51,55,-4,42
Queen's Park,9801,9,11,8,17,34,48,-14,41
Stenhousem'r,9801,10,4,12,20,38,78,-40,24
Livingston,9802,1,21,6,9,78,50,28,69
Airdrieon,9802,2,19,9,8,63,49,14,66
Alloa,9802,3,16,11,9,63,47,16,59
Brechin,9802,4,14,9,13,44,44,0,51
Albion,9802,5,12,12,12,50,48,2,48
East Fife,9802,6,12,11,13,53,47,6,47
Peterhead,9802,7,11,10,15,38,46,-8,43
Queen's Park,9802,8,10,11,15,32,48,-16,41
Stranraer,9802,9,11,7,18,54,65,-11,40
Stenhousem'r,9802,10,7,8,21,48,79,-31,29
Livingston,9803,1,18,9,9,72,46,26,63
Brechin,9803,2,19,5,12,56,48,8,62
Airdrieon,9803,3,17,8,11,64,52,12,59
Alloa,9803,4,17,5,14,62,47,15,56
East Fife,9803,5,14,9,13,53,42,11,51
Albion,9803,6,13,9,14,52,54,-2,48
Peterhead,9803,7,13,7,16,52,63,-11,46
Queen's Park,9803,8,12,7,17,35,51,-16,43
Stranraer,9803,9,11,7,18,49,65,-16,40
Stenhousem'r,9803,10,7,12,17,49,76,-27,33
Airdrieon,9804,1,23,4,9,68,42,26,73
Brechin,9804,2,22,1,13,53,49,4,67
Alloa,9804,3,18,8,10,65,43,22,62
Livingston,9804,4,19,4,13,69,50,19,61
Stenhousem'r,9804,5,13,8,15,60,71,-11,47
Stranraer,9804,6,13,4,19,47,61,-14,43
Albion,9804,7,11,9,16,49,63,-14,42
Peterhead,9804,8,11,7,18,52,58,-6,40
East Fife,9804,9,10,8,18,51,53,-2,38
Queen's Park,9804,10,10,7,19,38,62,-24,37
Alloa,9805,1,20,8,8,77,44,33,68
Livingston,9805,2,19,8,9,63,37,26,65
Airdrieon,9805,3,18,7,11,62,51,11,61
Albion,9805,4,17,5,14,55,49,6,56
Brechin,9805,5,17,4,15,48,49,-1,55
East Fife,9805,6,13,9,14,60,45,15,48
Stranraer,9805,7,14,4,18,52,59,-7,46
Queen's Park,9805,8,12,7,17,35,51,-16,43
Peterhead,9805,9,10,8,18,49,70,-21,38
Stenhousem'r,9805,10,6,8,22,40,86,-46,26
Livingston,9806,1,24,4,8,90,40,50,76
Alloa,9806,2,19,11,6,71,41,30,68
Brechin,9806,3,17,6,13,52,51,1,57
Airdrieon,9806,4,17,5,14,57,57,0,56
Peterhead,9806,5,12,13,11,49,46,3,49
Albion,9806,6,11,8,17,48,55,-7,41
Stenhousem'r,9806,7,11,8,17,60,81,-21,41
East Fife,9806,8,10,8,18,43,55,-12,38
Stranraer,9806,9,11,5,20,52,73,-21,38
Queen's Park,9806,10,9,10,17,31,54,-23,37
Alloa,9807,1,19,11,6,72,40,32,68
Livingston,9807,2,20,4,12,77,48,29,64
Airdrieon,9807,3,19,5,12,57,51,6,62
Peterhead,9807,4,16,9,11,61,48,13,57
Brechin,9807,5,16,4,16,44,49,-5,52
East Fife,9807,6,13,8,15,43,41,2,47
Stranraer,9807,7,14,5,17,48,51,-3,47
Queen's Park,9807,8,13,5,18,42,60,-18,44
Albion,9807,9,9,8,19,43,62,-19,35
Stenhousem'r,9807,10,8,7,21,45,82,-37,31
Alloa,9808,1,21,7,8,65,38,27,70
Airdrieon,9808,2,20,8,8,65,46,19,68
Livingston,9808,3,19,5,12,74,51,23,62
Brechin,9808,4,17,5,14,52,48,4,56
Stranraer,9808,5,14,9,13,59,54,5,51
East Fife,9808,6,13,10,13,54,44,10,49
Peterhead,9808,7,11,10,15,45,54,-9,43
Albion,9808,8,11,10,15,44,55,-11,43
Stenhousem'r,9808,9,7,9,20,49,82,-33,30
Queen's Park,9808,10,6,9,21,28,63,-35,27
Brechin,9809,1,20,4,12,52,41,11,64
Alloa,9809,2,19,5,12,69,43,26,62
Livingston,9809,3,20,2,14,76,56,20,62
East Fife,9809,4,17,8,11,61,42,19,59
Airdrieon,9809,5,15,6,15,56,61,-5,51
Peterhead,9809,6,14,8,14,57,53,4,50
Albion,9809,7,14,7,15,56,55,1,49
Stranraer,9809,8,14,6,16,54,59,-5,48
Queen's Park,9809,9,13,5,18,38,60,-22,44
Stenhousem'r,9809,10,7,3,26,41,90,-49,24
Livingston,9810,1,19,5,12,69,49,20,62
Alloa,9810,2,18,7,11,76,42,34,61
Airdrieon,9810,3,17,10,9,66,51,15,61
Albion,9810,4,15,7,14,53,51,2,52
Brechin,9810,5,14,8,14,50,51,-1,50
Peterhead,9810,6,12,13,11,48,55,-7,49
East Fife,9810,7,11,13,12,55,49,6,46
Stranraer,9810,8,13,6,17,47,66,-19,45
Queen's Park,9810,9,12,4,20,36,59,-23,40
Stenhousem'r,9810,10,5,15,16,53,80,-27,30
Livingston,9811,1,22,4,10,73,44,29,70
Alloa,9811,2,17,11,8,70,52,18,62
Brechin,9811,3,18,7,11,55,44,11,61
Peterhead,9811,4,17,7,12,58,51,7,58
Albion,9811,5,15,10,11,53,45,8,55
Airdrieon,9811,6,15,6,15,58,59,-1,51
East Fife,9811,7,12,11,13,50,50,0,47
Stranraer,9811,8,11,3,22,38,57,-19,36
Queen's Park,9811,9,8,10,18,38,58,-20,34
Stenhousem'r,9811,10,6,9,21,45,78,-33,27
Alloa,9812,1,23,5,8,80,47,33,74
Livingston,9812,2,22,5,9,75,45,30,71
Airdrieon,9812,3,17,8,11,64,56,8,59
Brechin,9812,4,15,5,16,48,52,-4,50
East Fife,9812,5,14,7,15,56,47,9,49
Albion,9812,6,12,9,15,48,51,-3,45
Queen's Park,9812,7,12,9,15,43,52,-9,45
Peterhead,9812,8,11,8,17,43,55,-12,41
Stenhousem'r,9812,9,12,4,20,45,73,-28,40
Stranraer,9812,10,11,2,23,43,67,-24,35
Livingston,9813,1,22,6,8,80,43,37,72
Airdrieon,9813,2,18,4,14,72,58,14,58
Brechin,9813,3,17,4,15,48,57,-9,55
Peterhead,9813,4,15,9,12,54,50,4,54
Queen's Park,9813,5,14,9,13,40,42,-2,51
Albion,9813,6,14,8,14,57,56,1,50
Alloa,9813,7,13,10,13,68,54,14,49
Stranraer,9813,8,13,4,19,47,62,-15,43
Stenhousem'r,9813,9,11,5,20,55,86,-31,38
East Fife,9813,10,10,7,19,47,60,-13,37
Livingston,9814,1,22,3,11,87,49,38,69
Brechin,9814,2,18,5,13,53,52,1,59
Airdrieon,9814,3,18,3,15,63,67,-4,57
Stranraer,9814,4,15,9,12,52,48,4,54
Alloa,9814,5,13,9,14,61,58,3,48
Albion,9814,6,13,8,15,55,47,8,47
Peterhead,9814,7,11,11,14,47,53,-6,44
Queen's Park,9814,8,13,5,18,42,55,-13,44
East Fife,9814,9,12,7,17,52,58,-6,43
Stenhousem'r,9814,10,13,4,19,56,81,-25,43
Alloa,9815,1,20,6,10,70,42,28,66
Airdrieon,9815,2,20,5,11,67,54,13,65
Livingston,9815,3,20,3,13,73,54,19,63
Albion,9815,4,18,5,13,60,50,10,59
Stranraer,9815,5,16,5,15,61,61,0,53
Brechin,9815,6,16,5,15,49,58,-9,53
Peterhead,9815,7,15,4,17,52,54,-2,49
Queen's Park,9815,8,12,7,17,42,54,-12,43
East Fife,9815,9,11,7,18,47,49,-2,40
Stenhousem'r,9815,10,5,7,24,41,86,-45,22
Alloa,9816,1,20,8,8,68,40,28,68
Livingston,9816,2,18,7,11,63,47,16,61
Brechin,9816,3,16,5,15,48,50,-2,53
Airdrieon,9816,4,15,7,14,54,57,-3,52
East Fife,9816,5,14,8,14,54,45,9,50
Albion,9816,6,12,12,12,54,52,2,48
Peterhead,9816,7,12,12,12,46,48,-2,48
Queen's Park,9816,8,14,6,16,41,50,-9,48
Stenhousem'r,9816,9,9,10,17,48,68,-20,37
Stranraer,9816,10,10,5,21,51,70,-19,35
Alloa,9817,1,20,8,8,69,41,28,68
Brechin,9817,2,20,6,10,67,53,14,66
Livingston,9817,3,17,4,15,67,53,14,55
Airdrieon,9817,4,15,10,11,65,59,6,55
Albion,9817,5,14,10,12,49,49,0,52
Peterhead,9817,6,15,6,15,57,53,4,51
Stranraer,9817,7,14,4,18,48,51,-3,46
Queen's Park,9817,8,11,8,17,39,58,-19,41
Stenhousem'r,9817,9,8,11,17,45,72,-27,35
East Fife,9817,10,8,9,19,42,59,-17,33
Livingston,9818,1,25,4,7,80,42,38,79
Alloa,9818,2,21,7,8,75,43,32,70
Airdrieon,9818,3,17,7,12,60,53,7,58
Stranraer,9818,4,17,2,17,53,58,-5,53
Peterhead,9818,5,14,9,13,41,43,-2,51
Queen's Park,9818,6,15,6,15,41,48,-7,51
Brechin,9818,7,12,6,18,51,55,-4,42
Albion,9818,8,10,9,17,43,51,-8,39
East Fife,9818,9,6,13,17,37,52,-15,31
Stenhousem'r,9818,10,7,9,20,44,80,-36,30
Livingston,9819,1,21,7,8,75,43,32,70
Airdrieon,9819,2,17,10,9,65,50,15,61
Alloa,9819,3,17,7,12,60,47,13,58
Albion,9819,4,14,10,12,58,58,0,52
Brechin,9819,5,15,6,15,41,43,-2,51
Queen's Park,9819,6,13,9,14,47,48,-1,48
Peterhead,9819,7,12,7,17,44,52,-8,43
Stranraer,9819,8,11,9,16,43,55,-12,42
East Fife,9819,9,10,10,16,48,54,-6,40
Stenhousem'r,9819,10,8,9,19,44,75,-31,33
Livingston,9820,1,21,7,8,76,45,31,70
Alloa,9820,2,19,9,8,72,48,24,66
Brechin,9820,3,17,8,11,61,48,13,59
Airdrieon,9820,4,17,8,11,63,51,12,59
Stranraer,9820,5,14,9,13,52,50,2,51
Peterhead,9820,6,12,10,14,51,54,-3,46
Albion,9820,7,12,10,14,57,67,-10,46
Queen's Park,9820,8,9,13,14,33,42,-9,40
Stenhousem'r,9820,9,8,6,22,42,84,-42,30
East Fife,9820,10,5,12,19,43,61,-18,27
Livingston,9821,1,19,6,11,80,56,24,63
Airdrieon,9821,2,18,7,11,65,53,12,61
Brechin,9821,3,19,4,13,51,47,4,61
Alloa,9821,4,17,9,10,65,41,24,60
Peterhead,9821,5,13,11,12,50,45,5,50
Queen's Park,9821,6,13,9,14,36,48,-12,48
Albion,9821,7,11,13,12,55,52,3,46
East Fife,9821,8,10,12,14,51,50,1,42
Stranraer,9821,9,10,7,19,56,75,-19,37
Stenhousem'r,9821,10,7,8,21,41,83,-42,29
Livingston,9822,1,22,3,11,84,58,26,69
Alloa,9822,2,18,10,8,64,43,21,64
Airdrieon,9822,3,15,10,11,57,51,6,55
Stranraer,9822,4,15,8,13,64,53,11,53
Brechin,9822,5,15,8,13,53,48,5,53
Peterhead,9822,6,13,7,16,52,62,-10,46
Albion,9822,7,13,6,17,49,57,-8,45
Queen's Park,9822,8,11,9,16,34,52,-18,42
East Fife,9822,9,9,10,17,45,46,-1,37
Stenhousem'r,9822,10,9,9,18,49,81,-32,36
Queen's Park,9823,1,17,7,12,52,45,7,58
Alloa,9823,2,16,9,11,68,50,18,57
Stranraer,9823,3,17,6,13,61,56,5,57
Airdrieon,9823,4,17,5,14,48,49,-1,56
Peterhead,9823,5,15,8,13,53,53,0,53
Albion,9823,6,15,7,14,58,56,2,52
Brechin,9823,7,13,10,13,58,60,-2,49
East Fife,9823,8,13,8,15,48,45,3,47
Livingston,9823,9,13,4,19,62,63,-1,43
Stenhousem'r,9823,10,8,8,20,43,74,-31,32
Alloa,9824,1,21,7,8,72,36,36,70
Livingston,9824,2,17,9,10,65,46,19,60
Brechin,9824,3,17,8,11,53,40,13,59
Airdrieon,9824,4,14,10,12,42,50,-8,52
Stranraer,9824,5,15,5,16,57,61,-4,50
Peterhead,9824,6,14,6,16,45,53,-8,48
East Fife,9824,7,11,12,13,43,42,1,45
Albion,9824,8,11,9,16,47,51,-4,42
Queen's Park,9824,9,10,8,18,33,50,-17,38
Stenhousem'r,9824,10,8,10,18,49,77,-28,34
Alloa,9825,1,21,8,7,70,37,33,71
Livingston,9825,2,21,6,9,75,46,29,69
Albion,9825,3,16,12,8,61,44,17,60
Brechin,9825,4,16,6,14,46,49,-3,54
Airdrieon,9825,5,13,9,14,57,64,-7,48
East Fife,9825,6,12,9,15,47,48,-1,45
Peterhead,9825,7,12,8,16,47,57,-10,44
Queen's Park,9825,8,12,7,17,42,50,-8,43
Stranraer,9825,9,10,4,22,51,73,-22,34
Stenhousem'r,9825,10,8,9,19,51,79,-28,33
Airdrieon,9826,1,20,6,10,67,48,19,66
Livingston,9826,2,20,5,11,74,52,22,65
Alloa,9826,3,19,7,10,68,42,26,64
Brechin,9826,4,18,7,11,51,47,4,61
Stranraer,9826,5,15,6,15,45,49,-4,51
Peterhead,9826,6,14,8,14,49,56,-7,50
Albion,9826,7,12,10,14,48,48,0,46
Stenhousem'r,9826,8,9,9,18,48,72,-24,36
Queen's Park,9826,9,9,6,21,40,61,-21,33
East Fife,9826,10,7,10,19,41,56,-15,31
Livingston,9827,1,22,4,10,79,55,24,70
Alloa,9827,2,19,10,7,74,40,34,67
Airdrieon,9827,3,19,4,13,66,55,11,61
Brechin,9827,4,18,4,14,60,51,9,58
Albion,9827,5,15,7,14,53,46,7,52
East Fife,9827,6,13,8,15,55,48,7,47
Stranraer,9827,7,12,7,17,46,61,-15,43
Queen's Park,9827,8,13,4,19,41,59,-18,43
Stenhousem'r,9827,9,10,5,21,43,78,-35,35
Peterhead,9827,10,9,7,20,38,62,-24,34
Livingston,9828,1,25,7,4,81,37,44,82
Brechin,9828,2,19,7,10,60,49,11,64
Airdrieon,9828,3,17,9,10,54,43,11,60
Peterhead,9828,4,16,10,10,61,51,10,58
Alloa,9828,5,15,11,10,60,38,22,56
East Fife,9828,6,14,8,14,48,45,3,50
Albion,9828,7,12,7,17,52,60,-8,43
Stranraer,9828,8,10,6,20,49,67,-18,36
Queen's Park,9828,9,8,9,19,29,54,-25,33
Stenhousem'r,9828,10,5,4,27,40,90,-50,19
Livingston,9829,1,20,7,9,82,53,29,67
Airdrieon,9829,2,17,7,12,71,60,11,58
Alloa,9829,3,16,8,12,82,63,19,56
East Fife,9829,4,15,7,14,57,48,9,52
Queen's Park,9829,5,15,7,14,40,51,-11,52
Brechin,9829,6,14,8,14,47,51,-4,50
Peterhead,9829,7,13,10,13,60,60,0,49
Albion,9829,8,12,10,14,59,62,-3,46
Stranraer,9829,9,13,6,17,52,59,-7,45
Stenhousem'r,9829,10,6,8,22,53,96,-43,26
Livingston,9830,1,23,4,9,85,50,35,73
Airdrieon,9830,2,18,8,10,62,47,15,62
Alloa,9830,3,17,6,13,61,46,15,57
Brechin,9830,4,16,9,11,52,47,5,57
Peterhead,9830,5,16,8,12,57,43,14,56
Albion,9830,6,14,6,16,55,47,8,48
East Fife,9830,7,12,9,15,43,48,-5,45
Stranraer,9830,8,12,5,19,41,61,-20,41
Queen's Park,9830,9,9,7,20,28,58,-30,34
Stenhousem'r,9830,10,9,6,21,50,87,-37,33
Livingston,9831,1,22,6,8,81,43,38,72
Alloa,9831,2,18,9,9,70,45,25,63
Airdrieon,9831,3,18,6,12,65,63,2,60
Albion,9831,4,13,12,11,61,51,10,51
Queen's Park,9831,5,14,7,15,36,51,-15,49
East Fife,9831,6,12,10,14,55,54,1,46
Brechin,9831,7,12,8,16,34,41,-7,44
Stranraer,9831,8,11,7,18,54,66,-12,40
Peterhead,9831,9,10,8,18,40,56,-16,38
Stenhousem'r,9831,10,10,7,19,54,80,-26,37
Livingston,9832,1,22,5,9,78,51,27,71
Alloa,9832,2,19,7,10,77,50,27,64
Albion,9832,3,16,10,10,57,48,9,58
Brechin,9832,4,17,3,16,55,63,-8,54
Stranraer,9832,5,16,5,15,65,56,9,53
Queen's Park,9832,6,13,10,13,37,44,-7,49
Airdrieon,9832,7,13,8,15,50,51,-1,47
East Fife,9832,8,10,10,16,39,48,-9,40
Peterhead,9832,9,8,12,16,41,53,-12,36
Stenhousem'r,9832,10,5,12,19,45,80,-35,27
Livingston,9833,1,20,4,12,74,48,26,64
Brechin,9833,2,19,3,14,58,50,8,60
Alloa,9833,3,17,8,11,68,51,17,59
Albion,9833,4,17,6,13,61,54,7,57
Airdrieon,9833,5,16,9,11,56,55,1,57
Peterhead,9833,6,14,7,15,48,49,-1,49
Stranraer,9833,7,12,8,16,49,59,-10,44
East Fife,9833,8,11,10,15,57,59,-2,43
Stenhousem'r,9833,9,10,7,19,52,75,-23,37
Queen's Park,9833,10,9,8,19,34,57,-23,35
Alloa,9834,1,20,8,8,63,35,28,68
Livingston,9834,2,19,5,12,71,54,17,62
Brechin,9834,3,19,5,12,62,51,11,62
Queen's Park,9834,4,17,9,10,49,41,8,60
Airdrieon,9834,5,15,8,13,58,54,4,53
Peterhead,9834,6,12,7,17,46,55,-9,43
Albion,9834,7,12,6,18,49,61,-12,42
Stranraer,9834,8,12,6,18,49,62,-13,42
East Fife,9834,9,10,9,17,43,44,-1,39
Stenhousem'r,9834,10,9,7,20,45,78,-33,34
Alloa,9835,1,20,8,8,70,43,27,68
Livingston,9835,2,20,5,11,72,46,26,65
Airdrieon,9835,3,17,6,13,58,58,0,57
Albion,9835,4,16,8,12,56,43,13,56
Peterhead,9835,5,15,9,12,48,44,4,54
Brechin,9835,6,14,7,15,43,44,-1,49
Queen's Park,9835,7,13,7,16,42,50,-8,46
East Fife,9835,8,12,8,16,47,52,-5,44
Stranraer,9835,9,12,5,19,48,66,-18,41
Stenhousem'r,9835,10,5,9,22,36,74,-38,24
Livingston,9836,1,22,5,9,84,53,31,71
Brechin,9836,2,18,8,10,53,48,5,62
Alloa,9836,3,17,9,10,70,46,24,60
Albion,9836,4,15,9,12,60,46,14,54
Airdrieon,9836,5,13,8,15,51,57,-6,47
Stranraer,9836,6,12,7,17,50,55,-5,43
Queen's Park,9836,7,11,10,15,44,55,-11,43
Peterhead,9836,8,11,10,15,54,66,-12,43
East Fife,9836,9,9,15,12,51,48,3,42
Stenhousem'r,9836,10,9,5,22,48,91,-43,32
Livingston,9837,1,19,8,9,78,53,25,65
Alloa,9837,2,18,10,8,70,48,22,64
Airdrieon,9837,3,18,9,9,59,47,12,63
Queen's Park,9837,4,17,9,10,48,37,11,60
Peterhead,9837,5,15,5,16,45,47,-2,50
Stranraer,9837,6,15,3,18,45,58,-13,48
Albion,9837,7,14,4,18,56,62,-6,46
Brechin,9837,8,14,4,18,49,55,-6,46
East Fife,9837,9,9,8,19,49,59,-10,35
Stenhousem'r,9837,10,7,8,21,41,74,-33,29
Alloa,9838,1,21,7,8,74,45,29,70
Airdrieon,9838,2,20,6,10,71,56,15,66
Livingston,9838,3,18,6,12,74,58,16,60
Brechin,9838,4,18,6,12,62,53,9,60
Queen's Park,9838,5,16,5,15,51,55,-4,53
Peterhead,9838,6,12,8,16,51,55,-4,44
East Fife,9838,7,12,7,17,49,50,-1,43
Albion,9838,8,12,6,18,49,59,-10,42
Stenhousem'r,9838,9,10,8,18,49,72,-23,38
Stranraer,9838,10,9,5,22,45,72,-27,32
Airdrieon,9839,1,20,6,10,65,46,19,66
Livingston,9839,2,19,5,12,76,52,24,62
Albion,9839,3,16,8,12,54,43,11,56
Alloa,9839,4,16,7,13,68,51,17,55
Queen's Park,9839,5,15,7,14,38,49,-11,52
Peterhead,9839,6,13,12,11,57,56,1,51
Brechin,9839,7,16,1,19,52,64,-12,49
Stranraer,9839,8,11,7,18,56,61,-5,40
Stenhousem'r,9839,9,9,11,16,52,79,-27,38
East Fife,9839,10,8,10,18,45,62,-17,34
Airdrieon,9840,1,21,7,8,73,48,25,70
Livingston,9840,2,20,6,10,78,54,24,66
Alloa,9840,3,15,11,10,71,54,17,56
Stranraer,9840,4,16,6,14,54,55,-1,54
Peterhead,9840,5,15,5,16,55,58,-3,50
Queen's Park,9840,6,14,6,16,41,53,-12,48
Albion,9840,7,12,9,15,61,56,5,45
Brechin,9840,8,12,7,17,45,58,-13,43
East Fife,9840,9,9,11,16,47,53,-6,38
Stenhousem'r,9840,10,8,8,20,44,80,-36,32
Alloa,9841,1,20,7,9,65,32,33,67
Brechin,9841,2,19,4,13,54,45,9,61
Stranraer,9841,3,18,6,12,57,45,12,60
Livingston,9841,4,18,4,14,65,50,15,58
Airdrieon,9841,5,16,5,15,54,54,0,53
Queen's Park,9841,6,13,9,14,39,43,-4,48
East Fife,9841,7,13,7,16,47,48,-1,46
Albion,9841,8,13,7,16,50,54,-4,46
Peterhead,9841,9,11,6,19,45,66,-21,39
Stenhousem'r,9841,10,9,5,22,41,80,-39,32
Livingston,9842,1,21,6,9,84,55,29,69
Alloa,9842,2,18,9,9,69,44,25,63
East Fife,9842,3,17,6,13,65,48,17,57
Brechin,9842,4,17,6,13,46,38,8,57
Airdrieon,9842,5,15,9,12,54,60,-6,54
Peterhead,9842,6,16,4,16,49,53,-4,52
Albion,9842,7,13,7,16,53,52,1,46
Queen's Park,9842,8,12,7,17,41,51,-10,43
Stranraer,9842,9,12,5,19,50,70,-20,41
Stenhousem'r,9842,10,6,7,23,47,87,-40,25
Alloa,9843,1,20,10,6,82,40,42,70
Airdrieon,9843,2,20,6,10,61,52,9,66
Livingston,9843,3,18,8,10,78,52,26,62
Brechin,9843,4,16,5,15,52,53,-1,53
Queen's Park,9843,5,14,8,14,45,53,-8,50
East Fife,9843,6,12,10,14,47,45,2,46
Albion,9843,7,13,7,16,51,57,-6,46
Peterhead,9843,8,10,9,17,49,59,-10,39
Stranraer,9843,9,9,10,17,50,63,-13,37
Stenhousem'r,9843,10,8,7,21,43,84,-41,31
Livingston,9844,1,21,8,7,75,42,33,71
Alloa,9844,2,16,11,9,64,46,18,59
Airdrieon,9844,3,16,9,11,62,55,7,57
Albion,9844,4,15,8,13,54,46,8,53
Queen's Park,9844,5,15,8,13,44,45,-1,53
Brechin,9844,6,14,8,14,46,46,0,50
Peterhead,9844,7,12,12,12,51,49,2,48
East Fife,9844,8,8,14,14,40,53,-13,38
Stranraer,9844,9,10,7,19,47,58,-11,37
Stenhousem'r,9844,10,7,7,22,43,86,-43,28
Alloa,9845,1,19,6,11,71,46,25,63
Livingston,9845,2,19,3,14,72,57,15,60
Airdrieon,9845,3,17,5,14,56,51,5,56
East Fife,9845,4,14,10,12,56,46,10,52
Albion,9845,5,15,7,14,53,54,-1,52
Brechin,9845,6,14,8,14,58,64,-6,50
Peterhead,9845,7,14,7,15,57,58,-1,49
Queen's Park,9845,8,15,4,17,44,56,-12,49
Stenhousem'r,9845,9,13,5,18,56,75,-19,44
Stranraer,9845,10,8,9,19,46,62,-16,33
Livingston,9846,1,22,3,11,77,54,23,69
Alloa,9846,2,18,12,6,71,36,35,66
Airdrieon,9846,3,18,9,9,63,57,6,63
Albion,9846,4,16,8,12,56,45,11,56
Peterhead,9846,5,13,8,15,55,59,-4,47
East Fife,9846,6,13,7,16,52,54,-2,46
Queen's Park,9846,7,13,7,16,43,48,-5,46
Brechin,9846,8,12,7,17,47,58,-11,43
Stranraer,9846,9,12,5,19,44,60,-16,41
Stenhousem'r,9846,10,6,8,22,45,82,-37,26
Livingston,9847,1,22,4,10,75,49,26,70
Alloa,9847,2,19,9,8,62,38,24,66
Brechin,9847,3,18,7,11,53,44,9,61
Albion,9847,4,14,11,11,57,51,6,53
Airdrieon,9847,5,14,10,12,60,59,1,52
Peterhead,9847,6,11,13,12,54,56,-2,46
Stranraer,9847,7,12,5,19,51,62,-11,41
Queen's Park,9847,8,10,9,17,43,59,-16,39
East Fife,9847,9,9,11,16,45,47,-2,38
Stenhousem'r,9847,10,6,11,19,49,84,-35,29
Livingston,9848,1,20,5,11,67,44,23,65
Airdrieon,9848,2,17,8,11,63,57,6,59
Brechin,9848,3,17,8,11,50,44,6,59
Alloa,9848,4,15,13,8,62,42,20,58
Albion,9848,5,14,8,14,60,52,8,50
East Fife,9848,6,13,8,15,48,44,4,47
Peterhead,9848,7,12,11,13,44,53,-9,47
Queen's Park,9848,8,12,6,18,39,51,-12,42
Stenhousem'r,9848,9,11,8,17,53,70,-17,41
Stranraer,9848,10,8,7,21,42,71,-29,31
Livingston,9849,1,21,7,8,77,52,25,70
Alloa,9849,2,20,7,9,65,39,26,67
Airdrieon,9849,3,19,8,9,63,50,13,65
Stranraer,9849,4,19,3,14,64,52,12,60
Peterhead,9849,5,15,7,14,49,51,-2,52
Albion,9849,6,14,7,15,55,56,-1,49
Queen's Park,9849,7,13,8,15,42,49,-7,47
Brechin,9849,8,12,6,18,42,49,-7,42
Stenhousem'r,9849,9,7,8,21,47,84,-37,29
East Fife,9849,10,5,9,22,36,58,-22,24
Livingston,9850,1,23,4,9,86,40,46,73
Alloa,9850,2,18,7,11,73,50,23,61
Brechin,9850,3,19,4,13,59,52,7,61
Stranraer,9850,4,14,8,14,61,57,4,50
Albion,9850,5,15,5,16,57,60,-3,50
Airdrieon,9850,6,14,7,15,51,61,-10,49
Queen's Park,9850,7,13,9,14,38,54,-16,48
East Fife,9850,8,13,7,16,51,46,5,46
Peterhead,9850,9,13,5,18,47,69,-22,44
Stenhousem'r,9850,10,5,10,21,45,79,-34,25
Livingston,9851,1,24,5,7,78,43,35,77
Alloa,9851,2,19,7,10,72,44,28,64
Airdrieon,9851,3,18,7,11,61,46,15,61
Brechin,9851,4,18,7,11,45,36,9,61
Peterhead,9851,5,13,9,14,46,53,-7,48
Albion,9851,6,12,10,14,41,46,-5,46
Stranraer,9851,7,12,6,18,53,58,-5,42
East Fife,9851,8,11,7,18,40,53,-13,40
Queen's Park,9851,9,12,3,21,42,58,-16,39
Stenhousem'r,9851,10,7,7,22,50,91,-41,28
Livingston,9852,1,23,6,7,83,46,37,75
Alloa,9852,2,18,11,7,66,42,24,65
Brechin,9852,3,14,12,10,44,43,1,54
Airdrieon,9852,4,15,8,13,54,51,3,53
Albion,9852,5,14,9,13,52,50,2,51
Peterhead,9852,6,14,7,15,55,51,4,49
East Fife,9852,7,11,13,12,49,46,3,46
Queen's Park,9852,8,12,6,18,36,54,-18,42
Stranraer,9852,9,9,6,21,45,66,-21,33
Stenhousem'r,9852,10,7,8,21,40,75,-35,29
Livingston,9853,1,21,7,8,77,43,34,70
Peterhead,9853,2,16,12,8,59,47,12,60
Brechin,9853,3,17,9,10,53,42,11,60
Alloa,9853,4,17,8,11,60,44,16,59
Airdrieon,9853,5,17,5,14,49,55,-6,56
Stranraer,9853,6,11,10,15,40,47,-7,43
Queen's Park,9853,7,11,10,15,40,54,-14,43
Albion,9853,8,9,12,15,41,49,-8,39
East Fife,9853,9,8,12,16,49,49,0,36
Stenhousem'r,9853,10,5,11,20,40,78,-38,26
Alloa,9854,1,21,9,6,70,32,38,72
Livingston,9854,2,22,3,11,73,44,29,69
Brechin,9854,3,18,6,12,50,53,-3,60
Albion,9854,4,15,8,13,60,53,7,53
Stranraer,9854,5,14,7,15,53,52,1,49
Airdrieon,9854,6,13,9,14,52,57,-5,48
Peterhead,9854,7,11,12,13,44,51,-7,45
East Fife,9854,8,10,9,17,44,50,-6,39
Queen's Park,9854,9,11,6,19,33,51,-18,39
Stenhousem'r,9854,10,8,5,23,52,88,-36,29
Livingston,9855,1,23,2,11,74,46,28,71
Peterhead,9855,2,18,11,7,59,45,14,65
Alloa,9855,3,15,10,11,60,43,17,55
Airdrieon,9855,4,16,7,13,60,52,8,55
Brechin,9855,5,15,7,14,46,53,-7,52
Albion,9855,6,14,7,15,61,57,4,49
Stranraer,9855,7,13,5,18,50,63,-13,44
East Fife,9855,8,11,10,15,60,53,7,43
Queen's Park,9855,9,10,7,19,33,59,-26,37
Stenhousem'r,9855,10,8,8,20,42,74,-32,32
Livingston,9856,1,21,2,13,78,51,27,65
Airdrieon,9856,2,20,4,12,61,48,13,64
Alloa,9856,3,18,6,12,67,49,18,60
East Fife,9856,4,16,7,13,65,50,15,55
Brechin,9856,5,17,4,15,50,46,4,55
Peterhead,9856,6,15,10,11,49,50,-1,55
Stranraer,9856,7,16,4,16,54,57,-3,52
Stenhousem'r,9856,8,9,9,18,44,74,-30,36
Albion,9856,9,9,8,19,51,63,-12,35
Queen's Park,9856,10,11,2,23,33,64,-31,35
Livingston,9857,1,23,5,8,85,50,35,74
Alloa,9857,2,16,9,11,58,47,11,57
Airdrieon,9857,3,16,8,12,60,56,4,56
Albion,9857,4,15,9,12,55,51,4,54
Brechin,9857,5,16,5,15,48,49,-1,53
Peterhead,9857,6,14,7,15,50,50,0,49
Queen's Park,9857,7,13,9,14,44,49,-5,48
Stranraer,9857,8,13,6,17,53,59,-6,45
Stenhousem'r,9857,9,11,4,21,52,81,-29,37
East Fife,9857,10,7,10,19,47,60,-13,31
Alloa,9858,1,20,6,10,72,46,26,66
Livingston,9858,2,20,5,11,72,52,20,65
Brechin,9858,3,16,10,10,53,40,13,58
Queen's Park,9858,4,14,9,13,39,47,-8,51
Peterhead,9858,5,14,8,14,50,49,1,50
Stranraer,9858,6,13,8,15,49,54,-5,47
Airdrieon,9858,7,13,8,15,47,54,-7,47
Albion,9858,8,12,8,16,46,51,-5,44
Stenhousem'r,9858,9,10,9,17,48,68,-20,39
East Fife,9858,10,8,9,19,38,53,-15,33
Alloa,9859,1,21,7,8,81,43,38,70
East Fife,9859,2,17,7,12,59,41,18,58
Livingston,9859,3,16,10,10,64,51,13,58
Queen's Park,9859,4,16,7,13,45,51,-6,55
Brechin,9859,5,15,9,12,57,53,4,54
Albion,9859,6,14,8,14,53,52,1,50
Airdrieon,9859,7,13,7,16,50,60,-10,46
Stranraer,9859,8,12,8,16,53,64,-11,44
Peterhead,9859,9,9,12,15,44,54,-10,39
Stenhousem'r,9859,10,7,5,24,42,79,-37,26
Livingston,9860,1,21,5,10,82,51,31,68
East Fife,9860,2,17,7,12,55,38,17,58
Alloa,9860,3,16,9,11,62,46,16,57
Queen's Park,9860,4,16,9,11,47,52,-5,57
Albion,9860,5,15,8,13,53,48,5,53
Airdrieon,9860,6,15,8,13,59,55,4,53
Brechin,9860,7,13,8,15,43,47,-4,47
Peterhead,9860,8,11,9,16,48,58,-10,42
Stranraer,9860,9,11,5,20,47,65,-18,38
Stenhousem'r,9860,10,6,10,20,42,78,-36,28
Livingston,9861,1,20,9,7,80,45,35,69
Airdrieon,9861,2,19,11,6,70,38,32,68
Alloa,9861,3,19,10,7,71,43,28,67
Brechin,9861,4,18,5,13,59,57,2,59
Peterhead,9861,5,15,10,11,44,40,4,55
Albion,9861,6,12,11,13,46,51,-5,47
Queen's Park,9861,7,12,9,15,31,45,-14,45
Stranraer,9861,8,8,8,20,46,69,-23,32
East Fife,9861,9,5,11,20,51,64,-13,26
Stenhousem'r,9861,10,6,8,22,39,85,-46,26
Livingston,9862,1,25,4,7,86,43,43,79
Airdrieon,9862,2,18,8,10,64,52,12,62
Alloa,9862,3,16,9,11,67,48,19,57
Brechin,9862,4,16,3,17,48,51,-3,51
East Fife,9862,5,14,8,14,61,46,15,50
Albion,9862,6,13,7,16,54,50,4,46
Peterhead,9862,7,13,6,17,41,56,-15,45
Stranraer,9862,8,12,8,16,47,54,-7,44
Queen's Park,9862,9,10,7,19,34,67,-33,37
Stenhousem'r,9862,10,8,10,18,40,75,-35,34
Livingston,9863,1,21,5,10,79,46,33,68
Alloa,9863,2,20,7,9,78,44,34,67
Airdrieon,9863,3,20,7,9,68,56,12,67
Brechin,9863,4,15,8,13,44,43,1,53
Peterhead,9863,5,12,12,12,53,54,-1,48
Queen's Park,9863,6,14,4,18,33,54,-21,46
East Fife,9863,7,11,10,15,55,48,7,43
Albion,9863,8,11,9,16,50,59,-9,42
Stranraer,9863,9,10,6,20,48,68,-20,36
Stenhousem'r,9863,10,7,10,19,42,78,-36,31
Livingston,9864,1,20,6,10,77,47,30,66
Brechin,9864,2,19,4,13,53,47,6,61
Airdrieon,9864,3,17,9,10,64,55,9,60
Alloa,9864,4,15,9,12,62,43,19,54
Peterhead,9864,5,14,9,13,54,51,3,51
Stranraer,9864,6,15,6,15,66,65,1,51
Queen's Park,9864,7,13,5,18,38,62,-24,44
East Fife,9864,8,10,11,15,46,52,-6,41
Albion,9864,9,11,8,17,51,61,-10,41
Stenhousem'r,9864,10,10,5,21,51,79,-28,35
Airdrieon,9865,1,21,7,8,60,40,20,70
Alloa,9865,2,16,11,9,65,45,20,59
Livingston,9865,3,18,3,15,75,58,17,57
Brechin,9865,4,16,5,15,46,49,-3,53
Albion,9865,5,15,5,16,55,57,-2,50
East Fife,9865,6,14,6,16,50,43,7,48
Stenhousem'r,9865,7,13,7,16,49,63,-14,46
Queen's Park,9865,8,13,6,17,38,49,-11,45
Peterhead,9865,9,11,7,18,45,61,-16,40
Stranraer,9865,10,10,9,17,42,60,-18,39
Livingston,9866,1,23,6,7,78,42,36,75
Alloa,9866,2,19,5,12,76,51,25,62
Brechin,9866,3,18,7,11,51,45,6,61
East Fife,9866,4,16,7,13,54,43,11,55
Airdrieon,9866,5,14,7,15,59,58,1,49
Peterhead,9866,6,13,8,15,49,54,-5,47
Stranraer,9866,7,12,6,18,50,55,-5,42
Albion,9866,8,10,12,14,52,58,-6,42
Queen's Park,9866,9,11,6,19,37,57,-20,39
Stenhousem'r,9866,10,8,8,20,43,86,-43,32
Livingston,9867,1,21,6,9,79,51,28,69
Alloa,9867,2,20,5,11,70,51,19,65
Albion,9867,3,18,8,10,65,44,21,62
Peterhead,9867,4,17,5,14,66,57,9,56
Airdrieon,9867,5,15,9,12,51,52,-1,54
Brechin,9867,6,15,3,18,47,55,-8,48
Stenhousem'r,9867,7,11,8,17,52,72,-20,41
East Fife,9867,8,11,6,19,55,64,-9,39
Stranraer,9867,9,11,5,20,44,67,-23,38
Queen's Park,9867,10,10,7,19,34,50,-16,37
Alloa,9868,1,23,7,6,76,43,33,76
Albion,9868,2,19,8,9,63,39,24,65
Livingston,9868,3,20,2,14,62,50,12,62
Airdrieon,9868,4,15,7,14,57,54,3,52
East Fife,9868,5,13,9,14,45,45,0,48
Peterhead,9868,6,14,6,16,50,57,-7,48
Queen's Park,9868,7,13,7,16,38,47,-9,46
Brechin,9868,8,12,5,19,38,53,-15,41
Stranraer,9868,9,11,4,21,47,59,-12,37
Stenhousem'r,9868,10,7,11,18,47,76,-29,32
Livingston,9869,1,22,2,12,70,47,23,68
Alloa,9869,2,20,7,9,69,37,32,67
Airdrieon,9869,3,18,7,11,69,53,16,61
Brechin,9869,4,16,9,11,49,35,14,57
Albion,9869,5,14,8,14,58,59,-1,50
East Fife,9869,6,11,11,14,52,56,-4,44
Peterhead,9869,7,12,7,17,49,59,-10,43
Stenhousem'r,9869,8,11,7,18,50,79,-29,40
Stranraer,9869,9,11,6,19,45,65,-20,39
Queen's Park,9869,10,8,10,18,32,53,-21,34
Livingston,9870,1,23,4,9,80,44,36,73
Alloa,9870,2,18,7,11,65,44,21,61
Airdrieon,9870,3,19,4,13,65,58,7,61
Brechin,9870,4,17,8,11,57,46,11,59
Albion,9870,5,13,11,12,49,47,2,50
Peterhead,9870,6,14,5,17,40,48,-8,47
Stranraer,9870,7,13,6,17,55,59,-4,45
East Fife,9870,8,11,8,17,50,54,-4,41
Queen's Park,9870,9,9,9,18,34,60,-26,36
Stenhousem'r,9870,10,10,4,22,55,90,-35,34
Livingston,9871,1,22,6,8,79,40,39,72
Albion,9871,2,16,10,10,65,58,7,58
Brechin,9871,3,15,8,13,51,54,-3,53
Alloa,9871,4,14,10,12,71,57,14,52
Airdrieon,9871,5,15,7,14,60,56,4,52
East Fife,9871,6,13,8,15,56,48,8,47
Queen's Park,9871,7,11,13,12,39,49,-10,46
Peterhead,9871,8,11,10,15,45,56,-11,43
Stranraer,9871,9,11,8,17,47,60,-13,41
Stenhousem'r,9871,10,9,6,21,49,84,-35,33
Livingston,9872,1,20,9,7,74,45,29,69
Airdrieon,9872,2,20,5,11,68,53,15,65
Alloa,9872,3,18,8,10,58,44,14,62
Brechin,9872,4,16,7,13,52,45,7,55
Stranraer,9872,5,14,9,13,55,54,1,51
East Fife,9872,6,10,11,15,56,58,-2,41
Queen's Park,9872,7,11,8,17,33,48,-15,41
Peterhead,9872,8,10,10,16,51,59,-8,40
Albion,9872,9,10,8,18,47,67,-20,38
Stenhousem'r,9872,10,8,11,17,50,71,-21,35
Alloa,9873,1,19,10,7,63,39,24,67
Livingston,9873,2,21,3,12,76,53,23,66
Airdrieon,9873,3,18,8,10,60,51,9,62
Brechin,9873,4,16,8,12,49,41,8,56
Albion,9873,5,13,13,10,50,47,3,52
Peterhead,9873,6,13,11,12,46,49,-3,50
East Fife,9873,7,10,13,13,41,41,0,43
Stranraer,9873,8,11,6,19,52,59,-7,39
Queen's Park,9873,9,10,9,17,45,54,-9,39
Stenhousem'r,9873,10,4,9,23,37,85,-48,21
Livingston,9874,1,19,6,11,77,53,24,63
Alloa,9874,2,18,7,11,74,48,26,61
Airdrieon,9874,3,16,9,11,58,51,7,57
East Fife,9874,4,14,9,13,53,47,6,51
Stranraer,9874,5,15,6,15,63,68,-5,51
Albion,9874,6,12,11,13,45,43,2,47
Brechin,9874,7,13,8,15,47,48,-1,47
Peterhead,9874,8,13,7,16,46,56,-10,46
Queen's Park,9874,9,11,6,19,33,58,-25,39
Stenhousem'r,9874,10,9,11,16,50,74,-24,38
Brechin,9875,1,20,4,12,56,45,11,64
Alloa,9875,2,17,12,7,71,46,25,63
Livingston,9875,3,19,4,13,69,48,21,61
Airdrieon,9875,4,18,5,13,60,56,4,59
Stranraer,9875,5,15,6,15,60,57,3,51
Queen's Park,9875,6,14,9,13,48,51,-3,51
Albion,9875,7,12,8,16,46,58,-12,44
Peterhead,9875,8,12,7,17,51,59,-8,43
East Fife,9875,9,9,13,14,43,45,-2,40
Stenhousem'r,9875,10,6,8,22,42,81,-39,26
Livingston,9876,1,23,4,9,80,41,39,73
Alloa,9876,2,18,9,9,63,41,22,63
Brechin,9876,3,16,11,9,43,33,10,59
Airdrieon,9876,4,17,7,12,61,54,7,58
Peterhead,9876,5,15,8,13,53,57,-4,53
East Fife,9876,6,11,11,14,48,47,1,44
Stranraer,9876,7,11,10,15,51,63,-12,43
Albion,9876,8,10,9,17,47,59,-12,39
Queen's Park,9876,9,11,4,21,40,60,-20,37
Stenhousem'r,9876,10,6,11,19,45,76,-31,29
Livingston,9877,1,21,7,8,77,43,34,70
Airdrieon,9877,2,22,3,11,64,54,10,69
Brechin,9877,3,21,3,12,57,42,15,66
Alloa,9877,4,18,9,9,63,35,28,63
Queen's Park,9877,5,14,6,16,33,41,-8,48
Albion,9877,6,13,8,15,53,53,0,47
Stranraer,9877,7,12,3,21,38,56,-18,39
East Fife,9877,8,9,10,17,56,57,-1,37
Peterhead,9877,9,10,7,19,34,57,-23,37
Stenhousem'r,9877,10,7,10,19,44,81,-37,31
Livingston,9878,1,22,5,9,77,49,28,71
Alloa,9878,2,21,5,10,84,52,32,68
Brechin,9878,3,17,6,13,46,43,3,57
East Fife,9878,4,14,7,15,47,43,4,49
Peterhead,9878,5,13,9,14,49,50,-1,48
Airdrieon,9878,6,13,7,16,50,58,-8,46
Queen's Park,9878,7,13,6,17,51,56,-5,45
Stranraer,9878,8,13,6,17,48,56,-8,45
Albion,9878,9,11,9,16,54,60,-6,42
Stenhousem'r,9878,10,7,12,17,39,78,-39,33
Livingston,9879,1,21,7,8,72,45,27,70
Alloa,9879,2,16,9,11,58,45,13,57
Albion,9879,3,16,9,11,62,53,9,57
Queen's Park,9879,4,16,8,12,47,43,4,56
Brechin,9879,5,15,8,13,51,46,5,53
Airdrieon,9879,6,14,10,12,61,56,5,52
Stranraer,9879,7,11,8,17,51,62,-11,41
Peterhead,9879,8,11,7,18,46,61,-15,40
Stenhousem'r,9879,9,10,7,19,51,72,-21,37
East Fife,9879,10,9,9,18,48,64,-16,36
Brechin,9880,1,21,5,10,55,36,19,68
Livingston,9880,2,21,3,12,77,52,25,66
Airdrieon,9880,3,18,9,9,68,59,9,63
Alloa,9880,4,17,9,10,65,43,22,60
Peterhead,9880,5,16,6,14,52,50,2,54
Albion,9880,6,12,11,13,54,55,-1,47
East Fife,9880,7,13,6,17,51,49,2,45
Stranraer,9880,8,12,6,18,47,56,-9,42
Queen's Park,9880,9,10,9,17,37,55,-18,39
Stenhousem'r,9880,10,4,8,24,43,94,-51,20
Brechin,9881,1,20,7,9,67,49,18,67
Alloa,9881,2,18,12,6,75,38,37,66
Livingston,9881,3,19,5,12,76,48,28,62
Airdrieon,9881,4,15,8,13,56,56,0,53
Peterhead,9881,5,14,10,12,60,59,1,52
Albion,9881,6,11,9,16,49,60,-11,42
Queen's Park,9881,7,10,12,14,41,55,-14,42
Stranraer,9881,8,11,7,18,53,66,-13,40
East Fife,9881,9,9,10,17,40,50,-10,37
Stenhousem'r,9881,10,7,12,17,43,79,-36,33
Livingston,9882,1,22,5,9,80,53,27,71
Alloa,9882,2,21,5,10,78,46,32,68
Brechin,9882,3,20,5,11,62,49,13,65
Airdrieon,9882,4,16,7,13,59,48,11,55
Peterhead,9882,5,15,7,14,62,61,1,52
Queen's Park,9882,6,14,8,14,43,50,-7,50
Stranraer,9882,7,14,3,19,54,58,-4,45
East Fife,9882,8,9,9,18,40,53,-13,36
Albion,9882,9,10,6,20,47,62,-15,36
Stenhousem'r,9882,10,6,11,19,41,86,-45,29
Livingston,9883,1,23,5,8,80,47,33,74
Brechin,9883,2,21,3,12,55,42,13,66
Peterhead,9883,3,16,7,13,49,46,3,55
Alloa,9883,4,16,6,14,63,55,8,54
Albion,9883,5,14,10,12,51,46,5,52
East Fife,9883,6,13,11,12,57,48,9,50
Airdrieon,9883,7,13,6,17,53,57,-4,45
Queen's Park,9883,8,10,11,15,41,56,-15,41
Stranraer,9883,9,8,9,19,37,57,-20,33
Stenhousem'r,9883,10,9,6,21,41,73,-32,33
Airdrieon,9884,1,22,5,9,74,53,21,71
Livingston,9884,2,22,3,11,81,46,35,69
Brechin,9884,3,16,9,11,55,45,10,57
Alloa,9884,4,15,11,10,63,51,12,56
East Fife,9884,5,14,11,11,58,45,13,53
Queen's Park,9884,6,13,8,15,42,49,-7,47
Peterhead,9884,7,11,10,15,42,52,-10,43
Stranraer,9884,8,10,10,16,50,61,-11,40
Albion,9884,9,9,11,16,51,66,-15,38
Stenhousem'r,9884,10,5,8,23,38,86,-48,23
Alloa,9885,1,20,8,8,70,42,28,68
Livingston,9885,2,20,2,14,76,47,29,62
Brechin,9885,3,15,8,13,52,57,-5,53
East Fife,9885,4,14,10,12,50,43,7,52
Airdrieon,9885,5,16,4,16,55,56,-1,52
Queen's Park,9885,6,14,9,13,54,51,3,51
Peterhead,9885,7,13,8,15,48,56,-8,47
Albion,9885,8,12,9,15,46,52,-6,45
Stenhousem'r,9885,9,11,6,19,39,67,-28,39
Stranraer,9885,10,9,8,19,41,60,-19,35
Alloa,9886,1,24,6,6,89,42,47,78
Livingston,9886,2,21,2,13,76,52,24,65
Brechin,9886,3,18,5,13,56,51,5,59
Airdrieon,9886,4,15,9,12,57,59,-2,54
Peterhead,9886,5,15,6,15,49,52,-3,51
Queen's Park,9886,6,14,3,19,41,56,-15,45
Albion,9886,7,11,9,16,49,57,-8,42
East Fife,9886,8,11,8,17,48,59,-11,41
Stranraer,9886,9,11,7,18,51,55,-4,40
Stenhousem'r,9886,10,9,7,20,45,78,-33,34
Livingston,9887,1,24,6,6,76,40,36,78
Brechin,9887,2,18,7,11,54,44,10,61
Airdrieon,9887,3,17,8,11,57,51,6,59
Alloa,9887,4,14,12,10,67,53,14,54
Albion,9887,5,12,12,12,54,52,2,48
East Fife,9887,6,11,12,13,52,43,9,45
Peterhead,9887,7,9,13,14,50,56,-6,40
Stranraer,9887,8,10,10,16,53,63,-10,40
Stenhousem'r,9887,9,11,5,20,45,75,-30,38
Queen's Park,9887,10,8,7,21,32,63,-31,31
Livingston,9888,1,19,6,11,87,62,25,63
Alloa,9888,2,16,11,9,72,48,24,59
Peterhead,9888,3,16,11,9,58,47,11,59
Airdrieon,9888,4,16,7,13,58,56,2,55
Brechin,9888,5,17,2,17,44,48,-4,53
Stranraer,9888,6,15,7,14,50,48,2,52
Queen's Park,9888,7,13,10,13,39,46,-7,49
Albion,9888,8,12,9,15,52,59,-7,45
East Fife,9888,9,7,11,18,49,60,-11,32
Stenhousem'r,9888,10,8,8,20,45,80,-35,32
Alloa,9889,1,19,10,7,74,42,32,67
Livingston,9889,2,20,6,10,65,43,22,66
Airdrieon,9889,3,19,6,11,54,45,9,63
Peterhead,9889,4,16,7,13,55,56,-1,55
Queen's Park,9889,5,13,8,15,43,47,-4,47
Brechin,9889,6,13,7,16,45,52,-7,46
East Fife,9889,7,11,11,14,45,47,-2,44
Albion,9889,8,10,10,16,46,51,-5,40
Stenhousem'r,9889,9,9,10,17,52,73,-21,37
Stranraer,9889,10,8,9,19,37,60,-23,33
Alloa,9890,1,20,6,10,76,41,35,66
Livingston,9890,2,20,4,12,82,63,19,64
Airdrieon,9890,3,19,5,12,69,59,10,62
Brechin,9890,4,18,5,13,56,49,7,59
Albion,9890,5,17,7,12,54,49,5,58
Peterhead,9890,6,15,6,15,47,50,-3,51
Stranraer,9890,7,14,4,18,55,64,-9,46
East Fife,9890,8,10,10,16,49,50,-1,40
Queen's Park,9890,9,12,4,20,41,65,-24,40
Stenhousem'r,9890,10,6,7,23,49,88,-39,25
Livingston,9891,1,23,6,7,75,41,34,75
Albion,9891,2,17,9,10,71,49,22,60
Airdrieon,9891,3,17,9,10,56,48,8,60
Alloa,9891,4,16,8,12,64,44,20,56
Stranraer,9891,5,15,5,16,52,61,-9,50
Queen's Park,9891,6,14,5,17,43,53,-10,47
Brechin,9891,7,13,5,18,53,64,-11,44
Peterhead,9891,8,11,9,16,46,58,-12,42
East Fife,9891,9,10,10,16,45,57,-12,40
Stenhousem'r,9891,10,6,10,20,46,76,-30,28
Livingston,9892,1,19,7,10,70,47,23,64
Alloa,9892,2,18,9,9,79,56,23,63
Brechin,9892,3,18,6,12,67,50,17,60
Albion,9892,4,15,9,12,55,48,7,54
Airdrieon,9892,5,15,7,14,54,57,-3,52
Queen's Park,9892,6,14,7,15,38,54,-16,49
East Fife,9892,7,12,10,14,55,55,0,46
Stranraer,9892,8,13,6,17,60,66,-6,45
Peterhead,9892,9,10,10,16,37,54,-17,40
Stenhousem'r,9892,10,6,9,21,50,78,-28,27
Alloa,9893,1,21,7,8,75,45,30,70
Livingston,9893,2,21,5,10,81,50,31,68
Brechin,9893,3,18,5,13,47,41,6,59
Peterhead,9893,4,16,7,13,56,54,2,55
Airdrieon,9893,5,15,7,14,64,65,-1,52
Stranraer,9893,6,15,4,17,56,61,-5,49
Albion,9893,7,12,8,16,52,60,-8,44
East Fife,9893,8,11,6,19,47,54,-7,39
Queen's Park,9893,9,10,8,18,35,57,-22,38
Stenhousem'r,9893,10,9,7,20,45,71,-26,34
Alloa,9894,1,21,6,9,71,42,29,69
Livingston,9894,2,19,3,14,75,52,23,60
Brechin,9894,3,15,12,9,50,40,10,57
Peterhead,9894,4,16,8,12,53,51,2,56
Airdrieon,9894,5,14,10,12,54,53,1,52
Queen's Park,9894,6,12,11,13,41,49,-8,47
Albion,9894,7,12,9,15,51,54,-3,45
Stranraer,9894,8,13,5,18,52,60,-8,44
East Fife,9894,9,10,10,16,50,58,-8,40
Stenhousem'r,9894,10,7,8,21,45,83,-38,29
Alloa,9895,1,22,8,6,77,36,41,74
Livingston,9895,2,23,4,9,81,42,39,73
Airdrieon,9895,3,18,8,10,61,54,7,62
Albion,9895,4,14,10,12,58,47,11,52
Brechin,9895,5,15,4,17,41,49,-8,49
Peterhead,9895,6,13,9,14,54,55,-1,48
Stranraer,9895,7,12,7,17,48,61,-13,43
East Fife,9895,8,10,10,16,40,50,-10,40
Queen's Park,9895,9,11,6,19,33,49,-16,39
Stenhousem'r,9895,10,6,6,24,42,92,-50,24
Livingston,9896,1,22,4,10,77,45,32,70
Airdrieon,9896,2,18,9,9,58,45,13,63
Brechin,9896,3,18,6,12,59,44,15,60
Albion,9896,4,15,10,11,52,50,2,55
Alloa,9896,5,15,8,13,71,60,11,53
East Fife,9896,6,13,8,15,48,49,-1,47
Peterhead,9896,7,12,7,17,49,59,-10,43
Stranraer,9896,8,11,6,19,45,59,-14,39
Queen's Park,9896,9,10,9,17,40,59,-19,39
Stenhousem'r,9896,10,8,9,19,45,74,-29,33
Livingston,9897,1,20,5,11,69,49,20,65
Alloa,9897,2,19,6,11,82,49,33,63
Airdrieon,9897,3,19,6,11,66,48,18,63
Stranraer,9897,4,15,8,13,53,55,-2,53
Albion,9897,5,14,8,14,56,53,3,50
Brechin,9897,6,15,5,16,47,53,-6,50
East Fife,9897,7,12,10,14,57,49,8,46
Peterhead,9897,8,13,7,16,51,62,-11,46
Queen's Park,9897,9,11,8,17,34,51,-17,41
Stenhousem'r,9897,10,7,7,22,46,92,-46,28
Livingston,9898,1,19,8,9,76,50,26,65
Airdrieon,9898,2,20,5,11,60,49,11,65
Albion,9898,3,18,9,9,63,38,25,63
Alloa,9898,4,18,8,10,77,48,29,62
Stranraer,9898,5,17,6,13,53,49,4,57
Brechin,9898,6,15,6,15,45,47,-2,51
Peterhead,9898,7,11,7,18,46,63,-17,40
Queen's Park,9898,8,9,9,18,32,56,-24,36
East Fife,9898,9,9,7,20,45,63,-18,34
Stenhousem'r,9898,10,7,9,20,46,80,-34,30
Livingston,9899,1,21,3,12,77,49,28,66
Alloa,9899,2,18,8,10,64,41,23,62
Airdrieon,9899,3,17,6,13,51,52,-1,57
East Fife,9899,4,15,9,12,59,49,10,54
Queen's Park,9899,5,15,6,15,44,53,-9,51
Albion,9899,6,12,11,13,56,55,1,47
Brechin,9899,7,14,5,17,49,48,1,47
Peterhead,9899,8,11,11,14,59,63,-4,44
Stranraer,9899,9,12,5,19,52,70,-18,41
Stenhousem'r,9899,10,8,10,18,40,71,-31,34
Brechin,9900,1,18,10,8,57,39,18,64
Livingston,9900,2,18,9,9,75,45,30,63
Alloa,9900,3,17,8,11,57,38,19,59
Airdrieon,9900,4,16,9,11,50,47,3,57
Albion,9900,5,15,8,13,52,47,5,53
Queen's Park,9900,6,16,4,16,36,45,-9,52
Stranraer,9900,7,13,7,16,47,51,-4,46
Peterhead,9900,8,12,6,18,49,54,-5,42
East Fife,9900,9,9,10,17,49,64,-15,37
Stenhousem'r,9900,10,9,3,24,44,86,-42,30
Livingston,9901,1,22,3,11,72,44,28,69
Alloa,9901,2,19,10,7,75,40,35,67
Albion,9901,3,15,10,11,59,51,8,55
Airdrieon,9901,4,17,4,15,56,52,4,55
Brechin,9901,5,15,10,11,49,53,-4,55
Stranraer,9901,6,12,7,17,50,59,-9,43
East Fife,9901,7,12,7,17,50,60,-10,43
Peterhead,9901,8,12,7,17,41,53,-12,43
Queen's Park,9901,9,11,8,17,37,51,-14,41
Stenhousem'r,9901,10,7,10,19,42,68,-26,31
Alloa,9902,1,21,7,8,78,45,33,70
Livingston,9902,2,20,2,14,81,60,21,62
Airdrieon,9902,3,15,9,12,64,56,8,54
Peterhead,9902,4,15,8,13,57,58,-1,53
Brechin,9902,5,15,7,14,49,48,1,52
Albion,9902,6,14,9,13,51,49,2,51
Stranraer,9902,7,14,8,14,57,54,3,50
East Fife,9902,8,11,11,14,51,50,1,44
Queen's Park,9902,9,10,7,19,27,56,-29,37
Stenhousem'r,9902,10,8,6,22,48,87,-39,30
Livingston,9903,1,23,4,9,87,46,41,73
Airdrieon,9903,2,17,8,11,52,53,-1,59
Brechin,9903,3,16,8,12,60,52,8,56
Albion,9903,4,15,6,15,62,58,4,51
Stranraer,9903,5,15,6,15,57,65,-8,51
East Fife,9903,6,12,11,13,54,45,9,47
Peterhead,9903,7,12,11,13,42,47,-5,47
Alloa,9903,8,12,9,15,65,62,3,45
Queen's Park,9903,9,12,8,16,36,47,-11,44
Stenhousem'r,9903,10,7,7,22,40,80,-40,28
Alloa,9904,1,21,9,6,73,36,37,72
Livingston,9904,2,17,5,14,78,65,13,56
Airdrieon,9904,3,15,11,10,52,50,2,56
Brechin,9904,4,16,6,14,46,45,1,54
Peterhead,9904,5,14,11,11,55,58,-3,53
Queen's Park,9904,6,15,7,14,36,44,-8,52
East Fife,9904,7,12,9,15,54,45,9,45
Stranraer,9904,8,13,5,18,46,56,-10,44
Albion,9904,9,10,7,19,51,65,-14,37
Stenhousem'r,9904,10,8,8,20,47,74,-27,32
Livingston,9905,1,23,6,7,94,43,51,75
Brechin,9905,2,19,7,10,61,44,17,64
Alloa,9905,3,18,8,10,72,56,16,62
Albion,9905,4,14,10,12,65,62,3,52
Airdrieon,9905,5,14,8,14,58,59,-1,50
Queen's Park,9905,6,14,7,15,35,55,-20,49
Peterhead,9905,7,13,8,15,55,61,-6,47
East Fife,9905,8,8,10,18,43,55,-12,34
Stenhousem'r,9905,9,7,13,16,54,78,-24,34
Stranraer,9905,10,7,9,20,45,69,-24,30
Airdrieon,9906,1,19,8,9,68,55,13,65
Alloa,9906,2,18,9,9,67,46,21,63
Livingston,9906,3,18,6,12,70,48,22,60
Brechin,9906,4,18,5,13,55,55,0,59
Queen's Park,9906,5,15,6,15,48,53,-5,51
Peterhead,9906,6,13,10,13,51,53,-2,49
Stranraer,9906,7,13,9,14,48,60,-12,48
Albion,9906,8,10,10,16,53,52,1,40
East Fife,9906,9,9,8,19,52,55,-3,35
Stenhousem'r,9906,10,6,11,19,44,79,-35,29
Livingston,9907,1,23,5,8,79,42,37,74
Alloa,9907,2,17,9,10,71,48,23,60
Airdrieon,9907,3,17,6,13,60,52,8,57
Albion,9907,4,15,10,11,63,54,9,55
Brechin,9907,5,15,8,13,43,45,-2,53
Queen's Park,9907,6,15,8,13,44,51,-7,53
Stranraer,9907,7,12,7,17,45,49,-4,43
East Fife,9907,8,10,11,15,45,52,-7,41
Peterhead,9907,9,10,10,16,45,56,-11,40
Stenhousem'r,9907,10,5,8,23,45,91,-46,23
Alloa,9908,1,23,6,7,75,40,35,75
Livingston,9908,2,22,5,9,80,44,36,71
East Fife,9908,3,16,9,11,64,43,21,57
Airdrieon,9908,4,16,8,12,60,51,9,56
Brechin,9908,5,17,3,16,52,57,-5,54
Albion,9908,6,14,8,14,51,51,0,50
Peterhead,9908,7,13,8,15,52,56,-4,47
Queen's Park,9908,8,10,8,18,30,53,-23,38
Stranraer,9908,9,10,3,23,37,61,-24,33
Stenhousem'r,9908,10,6,8,22,34,79,-45,26
Airdrieon,9909,1,19,8,9,63,45,18,65
Alloa,9909,2,16,11,9,72,49,23,59
Livingston,9909,3,18,2,16,74,59,15,56
Brechin,9909,4,16,8,12,54,53,1,56
Peterhead,9909,5,15,8,13,56,52,4,53
East Fife,9909,6,13,9,14,48,46,2,48
Queen's Park,9909,7,14,6,16,41,48,-7,48
Albion,9909,8,11,11,14,50,53,-3,44
Stranraer,9909,9,12,5,19,47,62,-15,41
Stenhousem'r,9909,10,9,6,21,47,85,-38,33
Alloa,9910,1,24,4,8,73,39,34,76
Livingston,9910,2,22,3,11,79,55,24,69
Airdrieon,9910,3,19,7,10,63,47,16,64
Brechin,9910,4,18,4,14,53,47,6,58
Albion,9910,5,13,11,12,53,53,0,50
Peterhead,9910,6,14,7,15,43,48,-5,49
Queen's Park,9910,7,13,7,16,41,51,-10,46
Stranraer,9910,8,12,3,21,42,57,-15,39
East Fife,9910,9,9,9,18,44,45,-1,36
Stenhousem'r,9910,10,5,7,24,41,90,-49,22
Livingston,9911,1,21,6,9,75,46,29,69
Peterhead,9911,2,18,9,9,57,48,9,63
Airdrieon,9911,3,17,8,11,57,49,8,59
Brechin,9911,4,16,8,12,52,44,8,56
Alloa,9911,5,14,9,13,59,43,16,51
Queen's Park,9911,6,11,10,15,34,48,-14,43
Albion,9911,7,11,10,15,46,62,-16,43
East Fife,9911,8,9,13,14,47,53,-6,40
Stenhousem'r,9911,9,10,8,18,62,84,-22,38
Stranraer,9911,10,10,5,21,42,54,-12,35
Livingston,9912,1,21,6,9,77,41,36,69
Airdrieon,9912,2,18,7,11,71,55,16,61
Queen's Park,9912,3,19,4,13,40,43,-3,61
Brechin,9912,4,17,6,13,47,52,-5,57
Peterhead,9912,5,15,8,13,44,46,-2,53
Alloa,9912,6,15,6,15,56,45,11,51
East Fife,9912,7,12,9,15,53,50,3,45
Stranraer,9912,8,13,4,19,52,65,-13,43
Albion,9912,9,10,11,15,47,52,-5,41
Stenhousem'r,9912,10,6,7,23,46,84,-38,25
Alloa,9913,1,22,5,9,75,40,35,71
Livingston,9913,2,21,7,8,79,44,35,70
Airdrieon,9913,3,17,8,11,53,50,3,59
Albion,9913,4,16,6,14,69,61,8,54
Brechin,9913,5,11,12,13,51,57,-6,45
Stranraer,9913,6,12,8,16,54,60,-6,44
East Fife,9913,7,12,7,17,39,50,-11,43
Peterhead,9913,8,11,8,17,45,51,-6,41
Queen's Park,9913,9,10,11,15,41,59,-18,41
Stenhousem'r,9913,10,8,8,20,52,86,-34,32
Alloa,9914,1,20,7,9,79,42,37,67
Livingston,9914,2,20,4,12,76,49,27,64
Brechin,9914,3,17,6,13,55,50,5,57
Peterhead,9914,4,16,8,12,45,45,0,56
Stranraer,9914,5,16,5,15,57,63,-6,53
Airdrieon,9914,6,14,10,12,51,51,0,52
Queen's Park,9914,7,12,8,16,39,57,-18,44
Albion,9914,8,10,10,16,52,61,-9,40
East Fife,9914,9,10,9,17,47,55,-8,39
Stenhousem'r,9914,10,7,9,20,48,76,-28,30
Livingston,9915,1,22,6,8,82,50,32,72
Alloa,9915,2,20,7,9,72,42,30,67
Brechin,9915,3,18,8,10,60,55,5,62
Peterhead,9915,4,17,7,12,58,50,8,58
Airdrieon,9915,5,16,5,15,56,58,-2,53
Albion,9915,6,11,11,14,48,56,-8,44
East Fife,9915,7,10,10,16,51,52,-1,40
Queen's Park,9915,8,11,6,19,44,59,-15,39
Stranraer,9915,9,10,8,18,52,69,-17,38
Stenhousem'r,9915,10,8,6,22,45,77,-32,30
Alloa,9916,1,20,6,10,73,44,29,66
Airdrieon,9916,2,20,6,10,62,48,14,66
Livingston,9916,3,17,7,12,69,48,21,58
Albion,9916,4,16,6,14,62,57,5,54
Peterhead,9916,5,15,7,14,52,58,-6,52
Queen's Park,9916,6,14,6,16,42,50,-8,48
Brechin,9916,7,13,7,16,47,59,-12,46
East Fife,9916,8,10,14,12,52,46,6,44
Stranraer,9916,9,12,5,19,43,53,-10,41
Stenhousem'r,9916,10,6,10,20,47,86,-39,28
Alloa,9917,1,23,7,6,72,33,39,76
Livingston,9917,2,20,4,12,75,49,26,64
Brechin,9917,3,19,2,15,53,50,3,59
Airdrieon,9917,4,17,7,12,53,48,5,58
Peterhead,9917,5,14,9,13,54,49,5,51
Albion,9917,6,13,9,14,51,54,-3,48
East Fife,9917,7,11,9,16,43,51,-8,42
Stranraer,9917,8,12,6,18,50,59,-9,42
Queen's Park,9917,9,11,9,16,39,49,-10,42
Stenhousem'r,9917,10,6,6,24,39,87,-48,24
Livingston,9918,1,20,5,11,67,43,24,65
Alloa,9918,2,18,8,10,71,41,30,62
Brechin,9918,3,19,5,12,52,41,11,62
Airdrieon,9918,4,17,6,13,59,58,1,57
Albion,9918,5,16,8,12,56,51,5,56
Stranraer,9918,6,13,5,18,51,64,-13,44
Peterhead,9918,7,10,13,13,47,51,-4,43
East Fife,9918,8,10,9,17,47,54,-7,39
Queen's Park,9918,9,8,12,16,31,51,-20,36
Stenhousem'r,9918,10,9,9,18,46,73,-27,36
Livingston,9919,1,23,3,10,73,43,30,72
Alloa,9919,2,18,7,11,61,45,16,61
Stranraer,9919,3,18,4,14,50,45,5,58
Albion,9919,4,15,11,10,60,46,14,56
Brechin,9919,5,16,7,13,52,47,5,55
Airdrieon,9919,6,16,4,16,55,54,1,52
Peterhead,9919,7,13,5,18,48,56,-8,44
Queen's Park,9919,8,12,7,17,29,48,-19,43
East Fife,9919,9,9,10,17,42,54,-12,37
Stenhousem'r,9919,10,9,4,23,44,76,-32,31
Albion,9920,1,20,6,10,68,51,17,66
Airdrieon,9920,2,19,7,10,65,49,16,64
Livingston,9920,3,19,6,11,71,49,22,63
Alloa,9920,4,17,9,10,67,46,21,60
Brechin,9920,5,15,8,13,51,46,5,53
Peterhead,9920,6,11,10,15,43,52,-9,43
Queen's Park,9920,7,12,7,17,36,49,-13,43
Stranraer,9920,8,12,5,19,46,69,-23,41
East Fife,9920,9,9,9,18,43,50,-7,36
Stenhousem'r,9920,10,10,5,21,50,79,-29,35
Alloa,9921,1,19,7,10,70,43,27,64
Livingston,9921,2,19,5,12,76,49,27,62
Airdrieon,9921,3,17,9,10,50,47,3,60
Brechin,9921,4,18,4,14,55,53,2,58
Albion,9921,5,15,10,11,53,46,7,55
Stranraer,9921,6,16,6,14,52,49,3,54
East Fife,9921,7,9,11,16,42,49,-7,38
Peterhead,9921,8,10,8,18,43,57,-14,38
Queen's Park,9921,9,10,7,19,35,58,-23,37
Stenhousem'r,9921,10,10,7,19,50,75,-25,37
Livingston,9922,1,22,6,8,82,48,34,72
Alloa,9922,2,19,8,9,72,46,26,65
Airdrieon,9922,3,17,7,12,67,57,10,58
Brechin,9922,4,17,7,12,50,48,2,58
East Fife,9922,5,12,11,13,57,48,9,47
Stenhousem'r,9922,6,11,9,16,49,69,-20,42
Albion,9922,7,10,11,15,47,56,-9,41
Peterhead,9922,8,11,8,17,48,59,-11,41
Stranraer,9922,9,10,7,19,52,68,-16,37
Queen's Park,9922,10,9,10,17,38,63,-25,37
Livingston,9923,1,23,5,8,76,37,39,74
Alloa,9923,2,21,5,10,71,47,24,68
East Fife,9923,3,15,9,12,48,38,10,54
Stranraer,9923,4,15,6,15,56,62,-6,51
Brechin,9923,5,15,6,15,51,58,-7,51
Airdrieon,9923,6,15,5,16,49,58,-9,50
Albion,9923,7,12,8,16,47,53,-6,44
Peterhead,9923,8,11,9,16,42,49,-7,42
Queen's Park,9923,9,10,7,19,41,57,-16,37
Stenhousem'r,9923,10,8,10,18,47,69,-22,34
Alloa,9924,1,22,8,6,79,37,42,74
Livingston,9924,2,21,5,10,78,49,29,68
Airdrieon,9924,3,17,7,12,52,54,-2,58
Brechin,9924,4,16,8,12,47,45,2,56
East Fife,9924,5,12,10,14,47,50,-3,46
Peterhead,9924,6,12,8,16,45,49,-4,44
Queen's Park,9924,7,12,8,16,33,46,-13,44
Albion,9924,8,10,10,16,44,51,-7,40
Stenhousem'r,9924,9,10,7,19,47,76,-29,37
Stranraer,9924,10,11,3,22,43,58,-15,36
Alloa,9925,1,22,7,7,81,45,36,73
Livingston,9925,2,21,2,13,70,51,19,65
Airdrieon,9925,3,19,5,12,73,58,15,62
Brechin,9925,4,16,9,11,55,49,6,57
Stranraer,9925,5,15,6,15,58,53,5,51
Queen's Park,9925,6,12,9,15,42,48,-6,45
Peterhead,9925,7,13,6,17,52,59,-7,45
Albion,9925,8,12,7,17,47,59,-12,43
East Fife,9925,9,10,12,14,51,56,-5,42
Stenhousem'r,9925,10,5,7,24,31,82,-51,22
Livingston,9926,1,28,2,6,78,39,39,86
Alloa,9926,2,20,6,10,72,45,27,66
Airdrieon,9926,3,16,9,11,64,50,14,57
Brechin,9926,4,17,6,13,48,48,0,57
East Fife,9926,5,12,10,14,46,41,5,46
Peterhead,9926,6,12,9,15,49,52,-3,45
Queen's Park,9926,7,13,4,19,35,52,-17,43
Albion,9926,8,12,5,19,50,61,-11,41
Stenhousem'r,9926,9,10,5,21,46,83,-37,35
Stranraer,9926,10,9,6,21,44,61,-17,33
Livingston,9927,1,24,1,11,85,53,32,73
Alloa,9927,2,21,6,9,76,48,28,69
Brechin,9927,3,17,7,12,57,50,7,58
Airdrieon,9927,4,13,10,13,53,58,-5,49
Peterhead,9927,5,13,9,14,58,54,4,48
Albion,9927,6,12,11,13,57,54,3,47
Stranraer,9927,7,13,7,16,59,58,1,46
Queen's Park,9927,8,12,8,16,39,61,-22,44
East Fife,9927,9,9,9,18,43,58,-15,36
Stenhousem'r,9927,10,8,8,20,47,80,-33,32
Livingston,9928,1,21,4,11,74,50,24,67
Alloa,9928,2,18,8,10,67,42,25,62
Albion,9928,3,18,8,10,58,47,11,62
Brechin,9928,4,19,5,12,49,41,8,62
Queen's Park,9928,5,16,6,14,42,40,2,54
East Fife,9928,6,12,12,12,57,47,10,48
Peterhead,9928,7,13,6,17,50,59,-9,45
Stranraer,9928,8,12,6,18,50,65,-15,42
Airdrieon,9928,9,12,5,19,58,65,-7,41
Stenhousem'r,9928,10,5,8,23,39,88,-49,23
Livingston,9929,1,23,3,10,75,43,32,72
Alloa,9929,2,21,4,11,76,44,32,67
Queen's Park,9929,3,18,4,14,48,57,-9,58
Airdrieon,9929,4,17,5,14,66,54,12,56
Brechin,9929,5,17,4,15,54,49,5,55
Albion,9929,6,15,4,17,53,52,1,49
East Fife,9929,7,13,7,16,49,54,-5,46
Peterhead,9929,8,13,7,16,47,63,-16,46
Stranraer,9929,9,11,4,21,45,65,-20,37
Stenhousem'r,9929,10,9,4,23,46,78,-32,31
Livingston,9930,1,21,5,10,78,44,34,68
Brechin,9930,2,18,5,13,51,45,6,59
Alloa,9930,3,17,7,12,72,52,20,58
Airdrieon,9930,4,16,9,11,58,55,3,57
Peterhead,9930,5,14,10,12,46,46,0,52
Stranraer,9930,6,14,6,16,50,54,-4,48
Queen's Park,9930,7,12,10,14,40,51,-11,46
Albion,9930,8,11,10,15,48,57,-9,43
East Fife,9930,9,10,7,19,47,53,-6,37
Stenhousem'r,9930,10,9,7,20,46,79,-33,34
Livingston,9931,1,22,8,6,80,47,33,74
Alloa,9931,2,18,8,10,66,46,20,62
Brechin,9931,3,18,7,11,57,44,13,61
Airdrieon,9931,4,17,5,14,65,65,0,56
Albion,9931,5,14,5,17,62,65,-3,47
Peterhead,9931,6,13,8,15,51,60,-9,47
Queen's Park,9931,7,12,9,15,39,50,-11,45
East Fife,9931,8,11,9,16,46,49,-3,42
Stranraer,9931,9,10,9,17,46,53,-7,39
Stenhousem'r,9931,10,8,6,22,46,79,-33,30
Livingston,9932,1,20,4,12,71,45,26,64
Alloa,9932,2,17,11,8,68,46,22,62
Airdrieon,9932,3,17,6,13,63,44,19,57
Albion,9932,4,15,11,10,51,43,8,56
Peterhead,9932,5,13,12,11,55,51,4,51
Brechin,9932,6,14,9,13,52,50,2,51
East Fife,9932,7,13,8,15,48,53,-5,47
Queen's Park,9932,8,9,10,17,40,62,-22,37
Stranraer,9932,9,9,9,18,40,64,-24,36
Stenhousem'r,9932,10,7,12,17,39,69,-30,33
Alloa,9933,1,21,9,6,87,43,44,72
Livingston,9933,2,22,4,10,78,48,30,70
Brechin,9933,3,17,7,12,58,42,16,58
Airdrieon,9933,4,16,8,12,62,61,1,56
East Fife,9933,5,15,7,14,53,45,8,52
Stranraer,9933,6,13,6,17,51,67,-16,45
Queen's Park,9933,7,12,6,18,36,57,-21,42
Albion,9933,8,11,7,18,44,55,-11,40
Peterhead,9933,9,10,7,19,42,68,-26,37
Stenhousem'r,9933,10,8,9,19,50,75,-25,33
Alloa,9934,1,22,8,6,77,36,41,74
Livingston,9934,2,21,3,12,78,54,24,66
Brechin,9934,3,18,8,10,57,44,13,62
Airdrieon,9934,4,15,10,11,54,58,-4,55
Peterhead,9934,5,15,8,13,46,43,3,53
Queen's Park,9934,6,14,6,16,43,52,-9,48
Albion,9934,7,12,8,16,46,52,-6,44
Stranraer,9934,8,12,8,16,58,66,-8,44
East Fife,9934,9,8,10,18,38,50,-12,34
Stenhousem'r,9934,10,5,7,24,36,78,-42,22
Livingston,9935,1,24,2,10,84,47,37,74
Alloa,9935,2,20,7,9,75,47,28,67
Albion,9935,3,19,6,11,72,46,26,63
Brechin,9935,4,16,6,14,53,49,4,54
Peterhead,9935,4,17,3,16,53,49,4,54
Airdrieon,9935,6,14,7,15,56,65,-9,49
East Fife,9935,7,12,7,17,46,48,-2,43
Queen's Park,9935,8,12,7,17,38,56,-18,43
Stranraer,9935,9,13,3,20,45,63,-18,42
Stenhousem'r,9935,10,6,6,24,43,95,-52,24
Livingston,9936,1,23,6,7,87,40,47,75
Alloa,9936,2,17,9,10,69,52,17,60
Airdrieon,9936,3,18,6,12,59,57,2,60
Brechin,9936,4,14,11,11,53,50,3,53
Peterhead,9936,5,15,6,15,57,61,-4,51
Queen's Park,9936,6,13,8,15,37,49,-12,47
Stranraer,9936,7,11,8,17,51,62,-11,41
Albion,9936,8,8,13,15,48,57,-9,37
East Fife,9936,9,8,12,16,46,54,-8,36
Stenhousem'r,9936,10,9,9,18,53,78,-25,36
Livingston,9937,1,24,4,8,76,43,33,76
Alloa,9937,2,21,7,8,77,41,36,70
Airdrieon,9937,3,18,7,11,58,43,15,61
Brechin,9937,4,17,5,14,59,51,8,56
East Fife,9937,5,16,7,13,56,50,6,55
Albion,9937,6,16,7,13,52,50,2,55
Peterhead,9937,7,10,9,17,38,52,-14,39
Queen's Park,9937,8,10,5,21,44,71,-27,35
Stranraer,9937,9,7,9,20,41,66,-25,30
Stenhousem'r,9937,10,7,8,21,47,81,-34,29
Alloa,9938,1,19,8,9,64,41,23,65
Livingston,9938,2,17,7,12,71,49,22,58
Brechin,9938,3,17,6,13,50,43,7,57
Airdrieon,9938,4,16,8,12,54,47,7,56
Albion,9938,5,17,5,14,52,54,-2,56
Stranraer,9938,6,14,7,15,53,56,-3,49
Queen's Park,9938,7,14,6,16,37,44,-7,48
East Fife,9938,8,12,9,15,43,43,0,45
Peterhead,9938,9,13,6,17,46,54,-8,45
Stenhousem'r,9938,10,7,6,23,44,83,-39,27
Livingston,9939,1,23,3,10,81,48,33,72
Alloa,9939,2,22,3,11,79,46,33,69
Stranraer,9939,3,19,3,14,57,57,0,60
Airdrieon,9939,4,16,5,15,51,48,3,53
Brechin,9939,5,17,2,17,48,50,-2,53
Albion,9939,6,15,6,15,57,52,5,51
Peterhead,9939,7,14,7,15,45,56,-11,49
Queen's Park,9939,8,12,5,19,38,55,-17,41
East Fife,9939,9,9,9,18,45,59,-14,36
Stenhousem'r,9939,10,8,7,21,43,73,-30,31
Brechin,9940,1,23,4,9,64,39,25,73
Livingston,9940,2,19,6,11,68,40,28,63
Alloa,9940,3,18,8,10,67,43,24,62
Albion,9940,4,16,8,12,49,49,0,56
Peterhead,9940,5,13,8,15,46,55,-9,47
Airdrieon,9940,6,13,7,16,62,69,-7,46
Stranraer,9940,7,11,8,17,51,64,-13,41
East Fife,9940,8,10,10,16,46,51,-5,40
Stenhousem'r,9940,9,10,8,18,49,69,-20,38
Queen's Park,9940,10,10,7,19,33,56,-23,37
Livingston,9941,1,22,7,7,86,42,44,73
Alloa,9941,2,18,10,8,62,40,22,64
Airdrieon,9941,3,16,9,11,58,56,2,57
Brechin,9941,4,15,6,15,48,53,-5,51
Peterhead,9941,5,14,5,17,44,51,-7,47
Queen's Park,9941,6,13,7,16,38,46,-8,46
East Fife,9941,7,12,7,17,48,43,5,43
Albion,9941,8,11,10,15,48,54,-6,43
Stranraer,9941,9,11,7,18,51,65,-14,40
Stenhousem'r,9941,10,10,8,18,44,77,-33,38
Alloa,9942,1,20,8,8,72,42,30,68
Brechin,9942,2,18,6,12,57,47,10,60
Airdrieon,9942,3,18,6,12,59,57,2,60
Albion,9942,4,16,8,12,52,49,3,56
Peterhead,9942,5,16,7,13,55,52,3,55
Livingston,9942,6,15,9,12,63,49,14,54
Stranraer,9942,7,13,4,19,54,59,-5,43
East Fife,9942,8,11,9,16,49,51,-2,42
Queen's Park,9942,9,10,9,17,37,55,-18,39
Stenhousem'r,9942,10,6,8,22,46,83,-37,26
Livingston,9943,1,23,7,6,71,34,37,76
Alloa,9943,2,16,9,11,54,44,10,57
Brechin,9943,3,16,9,11,48,45,3,57
Airdrieon,9943,4,14,8,14,60,62,-2,50
Peterhead,9943,5,14,6,16,55,62,-7,48
Stranraer,9943,6,13,8,15,45,45,0,47
East Fife,9943,7,11,10,15,50,45,5,43
Queen's Park,9943,8,12,7,17,36,45,-9,43
Albion,9943,9,10,10,16,42,56,-14,40
Stenhousem'r,9943,10,9,10,17,40,63,-23,37
Livingston,9944,1,21,6,9,82,47,35,69
Brechin,9944,2,20,6,10,62,47,15,66
Alloa,9944,3,18,8,10,70,48,22,62
Airdrieon,9944,4,18,5,13,69,52,17,59
Peterhead,9944,5,14,10,12,54,46,8,52
Albion,9944,6,13,8,15,47,53,-6,47
East Fife,9944,7,12,9,15,51,47,4,45
Stranraer,9944,8,13,2,21,46,70,-24,41
Queen's Park,9944,9,9,8,19,37,60,-23,35
Stenhousem'r,9944,10,9,4,23,39,87,-48,31
Alloa,9945,1,19,5,12,73,46,27,62
Brechin,9945,2,17,9,10,56,49,7,60
Peterhead,9945,3,16,9,11,56,49,7,57
Airdrieon,9945,4,15,8,13,66,63,3,53
Queen's Park,9945,5,15,5,16,48,52,-4,50
Livingston,9945,6,15,4,17,65,58,7,49
Stranraer,9945,7,12,11,13,59,65,-6,47
East Fife,9945,8,11,10,15,43,49,-6,43
Albion,9945,9,12,6,18,52,56,-4,42
Stenhousem'r,9945,10,11,7,18,50,81,-31,40
Livingston,9946,1,21,7,8,82,53,29,70
Alloa,9946,2,21,5,10,73,45,28,68
Brechin,9946,3,16,7,13,52,49,3,55
Airdrieon,9946,4,14,9,13,58,58,0,51
Stranraer,9946,5,14,6,16,60,60,0,48
Peterhead,9946,6,12,7,17,56,62,-6,43
Queen's Park,9946,7,12,7,17,48,59,-11,43
East Fife,9946,8,11,9,16,45,50,-5,42
Albion,9946,9,11,9,16,47,59,-12,42
Stenhousem'r,9946,10,9,12,15,49,75,-26,39
Alloa,9947,1,23,6,7,72,42,30,75
Livingston,9947,2,20,5,11,68,42,26,65
Albion,9947,3,18,7,11,62,48,14,61
Brechin,9947,4,18,2,16,53,58,-5,56
East Fife,9947,5,15,7,14,55,48,7,52
Airdrieon,9947,6,15,5,16,50,54,-4,50
Peterhead,9947,7,14,6,16,50,52,-2,48
Stenhousem'r,9947,8,11,4,21,59,82,-23,37
Stranraer,9947,9,10,5,21,51,67,-16,35
Queen's Park,9947,10,9,7,20,28,55,-27,34
Alloa,9948,1,21,10,5,86,41,45,73
Livingston,9948,2,17,6,13,64,54,10,57
Brechin,9948,3,16,9,11,51,48,3,57
Peterhead,9948,4,16,8,12,56,48,8,56
Airdrieon,9948,5,16,8,12,54,50,4,56
East Fife,9948,6,12,6,18,46,50,-4,42
Queen's Park,9948,7,11,9,16,36,54,-18,42
Stranraer,9948,8,13,3,20,45,66,-21,42
Albion,9948,9,10,10,16,59,61,-2,40
Stenhousem'r,9948,10,9,9,18,51,76,-25,36
Livingston,9949,1,27,3,6,83,36,47,84
Alloa,9949,2,19,8,9,70,38,32,65
Airdrieon,9949,3,19,6,11,58,53,5,63
Brechin,9949,4,16,6,14,41,42,-1,54
Albion,9949,5,14,9,13,53,51,2,51
Queen's Park,9949,6,12,9,15,31,43,-12,45
Stranraer,9949,7,11,5,20,47,57,-10,38
Peterhead,9949,8,10,8,18,38,50,-12,38
East Fife,9949,9,8,13,15,46,55,-9,37
Stenhousem'r,9949,10,7,7,22,46,88,-42,28
Livingston,9950,1,21,5,10,85,48,37,68
Alloa,9950,2,19,8,9,65,40,25,65
Airdrieon,9950,3,19,5,12,61,53,8,62
Brechin,9950,4,19,3,14,52,46,6,60
East Fife,9950,5,14,9,13,57,47,10,51
Peterhead,9950,6,14,9,13,44,48,-4,51
Queen's Park,9950,7,16,3,17,39,59,-20,51
Stranraer,9950,8,12,4,20,51,63,-12,40
Albion,9950,9,8,8,20,43,56,-13,32
Stenhousem'r,9950,10,8,6,22,45,82,-37,30
Livingston,9951,1,24,5,7,77,43,34,77
Airdrieon,9951,2,19,7,10,62,49,13,64
Alloa,9951,3,17,8,11,59,43,16,59
Brechin,9951,4,17,8,11,46,41,5,59
Queen's Park,9951,5,15,5,16,40,45,-5,50
Stranraer,9951,6,15,4,17,49,52,-3,49
Albion,9951,7,12,9,15,49,50,-1,45
Peterhead,9951,8,12,5,19,39,56,-17,41
East Fife,9951,9,11,7,18,49,53,-4,40
Stenhousem'r,9951,10,6,6,24,39,77,-38,24
Livingston,9952,1,23,4,9,78,44,34,73
Alloa,9952,2,18,6,12,66,48,18,60
Airdrieon,9952,3,16,6,14,56,50,6,54
East Fife,9952,4,15,7,14,56,47,9,52
Brechin,9952,5,14,10,12,48,49,-1,52
Albion,9952,6,12,12,12,49,50,-1,48
Peterhead,9952,7,12,9,15,44,57,-13,45
Stranraer,9952,8,11,10,15,50,55,-5,43
Queen's Park,9952,9,11,7,18,37,57,-20,40
Stenhousem'r,9952,10,8,9,19,48,75,-27,33
Livingston,9953,1,24,2,10,90,56,34,74
Albion,9953,2,17,6,13,57,51,6,57
Brechin,9953,3,16,8,12,44,44,0,56
Peterhead,9953,4,15,8,13,56,55,1,53
Airdrieon,9953,5,17,2,17,54,55,-1,53
Alloa,9953,6,14,10,12,65,47,18,52
East Fife,9953,7,13,7,16,56,50,6,46
Stranraer,9953,8,14,2,20,51,64,-13,44
Queen's Park,9953,9,13,4,19,44,62,-18,43
Stenhousem'r,9953,10,10,5,21,46,79,-33,35
Livingston,9954,1,23,5,8,80,45,35,74
Alloa,9954,2,18,9,9,79,44,35,63
Airdrieon,9954,3,18,5,13,61,59,2,59
East Fife,9954,4,14,7,15,50,45,5,49
Brechin,9954,5,15,4,17,46,51,-5,49
Albion,9954,6,13,7,16,54,57,-3,46
Queen's Park,9954,7,13,7,16,44,58,-14,46
Stranraer,9954,8,13,6,17,55,62,-7,45
Peterhead,9954,9,12,8,16,55,72,-17,44
Stenhousem'r,9954,10,8,8,20,51,82,-31,32
Airdrieon,9955,1,21,6,9,63,49,14,69
Brechin,9955,2,17,7,12,52,46,6,58
Livingston,9955,3,17,6,13,80,60,20,57
Alloa,9955,4,16,8,12,72,48,24,56
Albion,9955,5,13,10,13,59,59,0,49
Queen's Park,9955,6,13,9,14,40,48,-8,48
Stenhousem'r,9955,7,13,6,17,60,78,-18,45
Peterhead,9955,8,12,8,16,48,57,-9,44
Stranraer,9955,9,12,6,18,49,67,-18,42
East Fife,9955,10,10,6,20,48,59,-11,36
Livingston,9956,1,21,5,10,66,41,25,68
Alloa,9956,2,19,10,7,73,44,29,67
Brechin,9956,3,17,7,12,53,47,6,58
Airdrieon,9956,4,15,9,12,56,51,5,54
Albion,9956,5,14,8,14,49,47,2,50
East Fife,9956,6,12,13,11,52,43,9,49
Queen's Park,9956,7,12,7,17,36,53,-17,43
Peterhead,9956,8,12,5,19,51,66,-15,41
Stranraer,9956,9,10,10,16,53,61,-8,40
Stenhousem'r,9956,10,7,8,21,38,74,-36,29
Alloa,9957,1,23,7,6,78,37,41,76
Livingston,9957,2,20,5,11,76,49,27,65
Airdrieon,9957,3,19,8,9,60,46,14,65
Brechin,9957,4,18,4,14,53,57,-4,58
Albion,9957,5,16,7,13,56,50,6,55
Stranraer,9957,6,15,4,17,47,56,-9,49
Peterhead,9957,7,13,3,20,53,63,-10,42
Queen's Park,9957,8,10,10,16,31,46,-15,40
East Fife,9957,9,8,7,21,42,57,-15,31
Stenhousem'r,9957,10,7,7,22,47,82,-35,28
Livingston,9958,1,22,7,7,79,41,38,73
Airdrieon,9958,2,19,4,13,64,57,7,61
Peterhead,9958,3,17,6,13,52,55,-3,57
Albion,9958,4,16,8,12,61,53,8,56
Alloa,9958,5,15,8,13,56,50,6,53
Brechin,9958,6,16,5,15,41,49,-8,53
East Fife,9958,7,13,8,15,51,45,6,47
Queen's Park,9958,8,13,7,16,44,48,-4,46
Stranraer,9958,9,9,9,18,41,56,-15,36
Stenhousem'r,9958,10,6,6,24,44,79,-35,24
Livingston,9959,1,24,3,9,81,40,41,75
Alloa,9959,2,17,9,10,69,46,23,60
Brechin,9959,3,16,10,10,58,48,10,58
Peterhead,9959,3,17,7,12,58,48,10,58
Airdrieon,9959,5,15,9,12,68,61,7,54
Albion,9959,6,13,10,13,50,49,1,49
Queen's Park,9959,7,12,8,16,35,57,-22,44
East Fife,9959,8,10,7,19,52,59,-7,37
Stranraer,9959,9,10,6,20,49,69,-20,36
Stenhousem'r,9959,10,7,9,20,41,84,-43,30
Livingston,9960,1,22,5,9,79,39,40,71
Airdrieon,9960,2,19,9,8,58,40,18,66
Alloa,9960,3,19,7,10,69,44,25,64
Brechin,9960,4,19,3,14,51,43,8,60
Albion,9960,5,15,7,14,54,55,-1,52
Peterhead,9960,6,14,8,14,50,52,-2,50
Stranraer,9960,7,14,6,16,49,56,-7,48
Queen's Park,9960,8,10,5,21,29,52,-23,35
East Fife,9960,9,8,9,19,34,55,-21,33
Stenhousem'r,9960,10,7,7,22,45,82,-37,28
Airdrieon,9961,1,23,5,8,73,47,26,74
Livingston,9961,2,18,7,11,77,56,21,61
Alloa,9961,3,17,9,10,70,53,17,60
Stranraer,9961,4,14,6,16,59,62,-3,48
Brechin,9961,5,15,3,18,45,52,-7,48
East Fife,9961,6,12,9,15,54,53,1,45
Peterhead,9961,7,12,9,15,51,61,-10,45
Queen's Park,9961,8,12,9,15,36,52,-16,45
Albion,9961,9,12,7,17,49,59,-10,43
Stenhousem'r,9961,10,9,8,19,51,70,-19,35
Alloa,9962,1,20,9,7,80,46,34,69
Brechin,9962,2,17,9,10,55,54,1,60
Livingston,9962,3,17,6,13,75,55,20,57
Airdrieon,9962,4,16,9,11,62,54,8,57
Albion,9962,5,12,11,13,55,52,3,47
East Fife,9962,6,13,8,15,50,47,3,47
Peterhead,9962,7,12,8,16,50,59,-9,44
Stranraer,9962,8,12,7,17,45,56,-11,43
Queen's Park,9962,9,11,7,18,35,59,-24,40
Stenhousem'r,9962,10,10,6,20,45,70,-25,36
Alloa,9963,1,22,5,9,64,38,26,71
Livingston,9963,2,22,0,14,68,51,17,66
Albion,9963,3,19,6,11,68,52,16,63
Airdrieon,9963,4,17,6,13,54,48,6,57
Brechin,9963,5,16,5,15,53,51,2,53
Peterhead,9963,6,15,8,13,53,56,-3,53
Queen's Park,9963,7,13,5,18,39,54,-15,44
East Fife,9963,8,9,11,16,42,46,-4,38
Stranraer,9963,9,11,5,20,54,69,-15,38
Stenhousem'r,9963,10,8,5,23,48,78,-30,29
Livingston,9964,1,24,3,9,84,43,41,75
Alloa,9964,2,18,9,9,71,45,26,63
Brechin,9964,3,15,11,10,54,50,4,56
Albion,9964,4,14,9,13,59,53,6,51
Peterhead,9964,5,13,10,13,44,49,-5,49
Airdrieon,9964,6,12,8,16,50,69,-19,44
East Fife,9964,7,11,8,17,51,54,-3,41
Stranraer,9964,8,10,11,15,49,56,-7,41
Queen's Park,9964,9,11,8,17,40,59,-19,41
Stenhousem'r,9964,10,10,7,19,55,79,-24,37
Livingston,9965,1,23,4,9,81,42,39,73
Airdrieon,9965,2,18,8,10,65,54,11,62
Alloa,9965,3,17,7,12,61,48,13,58
East Fife,9965,4,15,8,13,55,45,10,53
Queen's Park,9965,5,14,7,15,42,47,-5,49
Albion,9965,6,13,8,15,62,69,-7,47
Brechin,9965,7,15,2,19,47,59,-12,47
Stranraer,9965,8,13,7,16,51,60,-9,46
Peterhead,9965,9,13,5,18,57,60,-3,44
Stenhousem'r,9965,10,7,8,21,44,81,-37,29
Alloa,9966,1,20,8,8,66,43,23,68
Airdrieon,9966,2,19,6,11,61,45,16,63
Livingston,9966,3,19,4,13,76,52,24,61
Albion,9966,4,16,7,13,54,49,5,55
East Fife,9966,5,14,9,13,57,48,9,51
Brechin,9966,6,15,6,15,47,44,3,51
Queen's Park,9966,7,15,5,16,44,58,-14,50
Peterhead,9966,8,11,9,16,51,58,-7,42
Stranraer,9966,9,11,6,19,52,71,-19,39
Stenhousem'r,9966,10,7,6,23,48,88,-40,27
Livingston,9967,1,21,5,10,73,48,25,68
Airdrieon,9967,2,19,6,11,74,55,19,63
Alloa,9967,3,17,10,9,66,44,22,61
East Fife,9967,4,17,5,14,55,44,11,56
Queen's Park,9967,5,15,7,14,41,50,-9,52
Stranraer,9967,6,16,2,18,49,54,-5,50
Brechin,9967,7,13,8,15,46,54,-8,47
Peterhead,9967,8,13,6,17,53,54,-1,45
Albion,9967,9,12,5,19,56,69,-13,41
Stenhousem'r,9967,10,6,8,22,45,86,-41,26
Livingston,9968,1,23,6,7,75,40,35,75
Alloa,9968,2,18,8,10,70,37,33,62
Airdrieon,9968,3,17,6,13,55,51,4,57
Brechin,9968,4,16,7,13,60,51,9,55
Albion,9968,5,16,6,14,52,55,-3,54
Peterhead,9968,6,12,10,14,46,54,-8,46
East Fife,9968,7,11,10,15,53,56,-3,43
Queen's Park,9968,8,12,4,20,41,68,-27,40
Stenhousem'r,9968,9,10,8,18,47,68,-21,38
Stranraer,9968,10,10,5,21,39,58,-19,35
Livingston,9969,1,24,4,8,82,48,34,76
Alloa,9969,2,19,10,7,79,44,35,67
Airdrieon,9969,3,18,6,12,57,51,6,60
Albion,9969,4,13,11,12,53,46,7,50
Peterhead,9969,5,14,8,14,53,60,-7,50
East Fife,9969,6,10,11,15,42,47,-5,41
Stranraer,9969,7,11,8,17,48,58,-10,41
Brechin,9969,8,11,8,17,36,52,-16,41
Queen's Park,9969,9,10,9,17,38,52,-14,39
Stenhousem'r,9969,10,8,9,19,44,74,-30,33
Alloa,9970,1,19,9,8,71,45,26,66
Livingston,9970,2,20,4,12,70,44,26,64
Albion,9970,3,18,5,13,56,46,10,59
Brechin,9970,4,17,8,11,46,44,2,59
Airdrieon,9970,5,16,9,11,73,62,11,57
Stranraer,9970,6,15,6,15,51,56,-5,51
East Fife,9970,7,11,11,14,43,41,2,44
Peterhead,9970,8,10,6,20,37,55,-18,36
Queen's Park,9970,9,9,7,20,32,56,-24,34
Stenhousem'r,9970,10,9,7,20,40,70,-30,34
Alloa,9971,1,19,8,9,72,44,28,65
Livingston,9971,2,17,10,9,72,51,21,61
Airdrieon,9971,3,17,6,13,63,57,6,57
East Fife,9971,4,14,11,11,55,42,13,53
Brechin,9971,5,14,9,13,46,44,2,51
Peterhead,9971,6,14,8,14,47,54,-7,50
Albion,9971,7,13,9,14,52,60,-8,48
Queen's Park,9971,8,11,6,19,35,58,-23,39
Stranraer,9971,9,9,10,17,44,60,-16,37
Stenhousem'r,9971,10,9,9,18,56,72,-16,36
Livingston,9972,1,21,4,11,74,48,26,67
Alloa,9972,2,19,8,9,74,46,28,65
Airdrieon,9972,3,18,5,13,58,54,4,59
Albion,9972,4,15,8,13,56,41,15,53
Brechin,9972,5,15,8,13,49,49,0,53
Peterhead,9972,6,14,7,15,51,54,-3,49
Stranraer,9972,7,13,4,19,55,68,-13,43
East Fife,9972,8,10,11,15,45,47,-2,41
Queen's Park,9972,9,10,9,17,28,46,-18,39
Stenhousem'r,9972,10,7,12,17,40,77,-37,33
Livingston,9973,1,24,3,9,85,47,38,75
Brechin,9973,2,19,8,9,52,45,7,65
Alloa,9973,3,19,7,10,70,47,23,64
Stranraer,9973,4,16,4,16,63,63,0,52
Queen's Park,9973,5,14,8,14,42,49,-7,50
Airdrieon,9973,6,14,6,16,50,61,-11,48
East Fife,9973,7,12,7,17,50,48,2,43
Albion,9973,8,12,6,18,53,61,-8,42
Peterhead,9973,9,10,7,19,36,58,-22,37
Stenhousem'r,9973,10,8,8,20,51,73,-22,32
Livingston,9974,1,22,3,11,75,53,22,69
Alloa,9974,2,19,9,8,71,46,25,66
Airdrieon,9974,3,16,6,14,57,49,8,54
Stranraer,9974,4,15,8,13,58,55,3,53
Peterhead,9974,5,15,7,14,53,55,-2,52
Albion,9974,6,14,9,13,54,49,5,51
Queen's Park,9974,7,14,6,16,43,53,-10,48
East Fife,9974,8,12,9,15,58,59,-1,45
Brechin,9974,9,11,6,19,42,62,-20,39
Stenhousem'r,9974,10,5,11,20,50,80,-30,26
Livingston,9975,1,22,3,11,77,49,28,69
Alloa,9975,2,19,7,10,67,45,22,64
Airdrieon,9975,3,17,7,12,60,53,7,58
Albion,9975,4,15,9,12,50,51,-1,54
Peterhead,9975,5,13,9,14,47,52,-5,48
Brechin,9975,6,13,9,14,45,51,-6,48
East Fife,9975,7,12,11,13,49,42,7,47
Stranraer,9975,8,12,10,14,53,50,3,46
Queen's Park,9975,9,10,6,20,31,51,-20,36
Stenhousem'r,9975,10,8,7,21,42,77,-35,31
Alloa,9976,1,20,8,8,63,41,22,68
Livingston,9976,2,17,8,11,66,44,22,59
Albion,9976,3,15,11,10,55,48,7,56
Stranraer,9976,4,16,5,15,56,57,-1,53
Airdrieon,9976,5,14,10,12,58,55,3,52
Brechin,9976,6,14,7,15,53,49,4,49
East Fife,9976,7,13,9,14,51,44,7,48
Peterhead,9976,8,12,7,17,47,61,-14,43
Queen's Park,9976,9,12,7,17,37,55,-18,43
Stenhousem'r,9976,10,6,10,20,37,69,-32,28
Livingston,9977,1,22,4,10,77,41,36,70
Alloa,9977,2,19,7,10,73,46,27,64
Airdrieon,9977,3,17,9,10,65,56,9,60
Stranraer,9977,4,18,4,14,63,59,4,58
Brechin,9977,5,14,6,16,47,57,-10,48
Queen's Park,9977,6,13,8,15,41,52,-11,47
East Fife,9977,7,12,9,15,48,50,-2,45
Albion,9977,8,11,10,15,49,52,-3,43
Peterhead,9977,9,12,6,18,43,56,-13,42
Stenhousem'r,9977,10,7,7,22,51,88,-37,28
Livingston,9978,1,20,5,11,73,43,30,65
Alloa,9978,2,18,9,9,75,56,19,63
Peterhead,9978,3,17,6,13,50,57,-7,57
Brechin,9978,4,16,8,12,52,46,6,56
Albion,9978,5,14,9,13,51,47,4,51
Stranraer,9978,6,14,8,14,60,59,1,50
East Fife,9978,7,13,7,16,57,51,6,46
Queen's Park,9978,8,12,8,16,32,45,-13,44
Airdrieon,9978,9,11,6,19,45,58,-13,39
Stenhousem'r,9978,10,8,8,20,41,74,-33,32
Alloa,9979,1,20,9,7,71,41,30,69
Livingston,9979,2,19,5,12,78,59,19,62
Airdrieon,9979,3,18,6,12,69,55,14,60
Albion,9979,4,15,11,10,57,48,9,56
Queen's Park,9979,5,14,8,14,43,49,-6,50
Brechin,9979,6,13,6,17,56,64,-8,45
Peterhead,9979,7,12,8,16,52,56,-4,44
Stranraer,9979,8,12,8,16,46,54,-8,44
East Fife,9979,9,9,10,17,50,63,-13,37
Stenhousem'r,9979,10,7,11,18,46,79,-33,32
Alloa,9980,1,21,6,9,71,36,35,69
Brechin,9980,2,20,4,12,53,39,14,64
Airdrieon,9980,3,20,4,12,56,51,5,64
Livingston,9980,4,18,8,10,65,47,18,62
Peterhead,9980,5,15,6,15,52,50,2,51
Stenhousem'r,9980,6,12,7,17,58,75,-17,43
Albion,9980,7,11,9,16,53,64,-11,42
East Fife,9980,8,10,11,15,47,45,2,41
Stranraer,9980,9,11,3,22,48,71,-23,36
Queen's Park,9980,10,10,6,20,32,57,-25,36
Alloa,9981,1,22,6,8,77,41,36,72
Livingston,9981,2,20,1,15,73,54,19,61
Brechin,9981,3,17,7,12,48,38,10,58
Airdrieon,9981,4,16,6,14,57,54,3,54
East Fife,9981,5,15,7,14,57,49,8,52
Albion,9981,6,15,7,14,56,55,1,52
Stranraer,9981,7,14,5,17,53,63,-10,47
Queen's Park,9981,8,11,7,18,35,50,-15,40
Stenhousem'r,9981,9,10,8,18,48,75,-27,38
Peterhead,9981,10,11,4,21,43,68,-25,37
Livingston,9982,1,25,2,9,81,45,36,77
Alloa,9982,2,20,6,10,76,52,24,66
Peterhead,9982,3,21,3,12,64,46,18,66
Airdrieon,9982,4,16,4,16,56,72,-16,52
Albion,9982,5,14,6,16,61,59,2,48
Brechin,9982,6,13,9,14,54,56,-2,48
Queen's Park,9982,7,13,7,16,38,55,-17,46
East Fife,9982,8,13,6,17,49,47,2,45
Stranraer,9982,9,11,7,18,59,62,-3,40
Stenhousem'r,9982,10,6,6,24,40,84,-44,24
Livingston,9983,1,22,5,9,77,52,25,71
Alloa,9983,2,22,4,10,75,46,29,70
Airdrieon,9983,3,22,4,10,78,56,22,70
Brechin,9983,4,19,5,12,54,44,10,62
Albion,9983,5,14,11,11,52,43,9,53
Peterhead,9983,6,15,6,15,51,59,-8,51
East Fife,9983,7,11,8,17,46,51,-5,41
Queen's Park,9983,8,10,4,22,31,60,-29,34
Stenhousem'r,9983,9,8,8,20,47,74,-27,32
Stranraer,9983,10,8,3,25,42,68,-26,27
Livingston,9984,1,25,2,9,89,44,45,77
Alloa,9984,2,20,6,10,82,54,28,66
Airdrieon,9984,3,19,5,12,68,60,8,62
Peterhead,9984,4,16,8,12,50,49,1,56
East Fife,9984,5,14,8,14,54,44,10,50
Queen's Park,9984,6,14,7,15,43,57,-14,49
Albion,9984,7,13,7,16,56,68,-12,46
Brechin,9984,8,12,5,19,45,58,-13,41
Stranraer,9984,9,11,5,20,52,62,-10,38
Stenhousem'r,9984,10,7,5,24,44,87,-43,26
Alloa,9985,1,19,9,8,72,43,29,66
Livingston,9985,2,20,4,12,87,53,34,64
Airdrieon,9985,3,19,6,11,62,48,14,63
Brechin,9985,4,16,6,14,46,45,1,54
Queen's Park,9985,5,16,5,15,38,54,-16,53
Stranraer,9985,6,13,9,14,53,54,-1,48
Peterhead,9985,7,12,8,16,40,50,-10,44
Albion,9985,8,11,8,17,51,60,-9,41
Stenhousem'r,9985,9,10,7,19,51,78,-27,37
East Fife,9985,10,9,8,19,41,56,-15,35
Alloa,9986,1,21,7,8,68,42,26,70
Livingston,9986,2,18,5,13,70,53,17,59
Airdrieon,9986,3,16,7,13,51,54,-3,55
Peterhead,9986,4,16,6,14,60,56,4,54
Albion,9986,5,15,8,13,60,49,11,53
Brechin,9986,6,14,7,15,51,57,-6,49
Queen's Park,9986,7,13,6,17,35,52,-17,45
East Fife,9986,8,12,8,16,49,52,-3,44
Stranraer,9986,9,12,7,17,50,56,-6,43
Stenhousem'r,9986,10,9,7,20,49,72,-23,34
Alloa,9987,1,21,6,9,73,42,31,69
Livingston,9987,2,22,2,12,79,53,26,68
Airdrieon,9987,3,20,4,12,64,50,14,64
Brechin,9987,4,17,4,15,50,55,-5,55
Albion,9987,5,15,8,13,63,62,1,53
Peterhead,9987,6,13,6,17,52,54,-2,45
Queen's Park,9987,7,13,6,17,42,53,-11,45
Stranraer,9987,8,13,3,20,54,65,-11,42
East Fife,9987,9,11,8,17,42,46,-4,41
Stenhousem'r,9987,10,8,7,21,50,89,-39,31
Airdrieon,9988,1,21,6,9,70,47,23,69
Livingston,9988,2,21,5,10,80,51,29,68
Brechin,9988,3,20,6,10,61,54,7,66
Alloa,9988,4,19,8,9,76,45,31,65
East Fife,9988,5,13,9,14,57,53,4,48
Albion,9988,6,12,9,15,54,58,-4,45
Peterhead,9988,7,13,6,17,44,60,-16,45
Stranraer,9988,8,10,7,19,63,74,-11,37
Queen's Park,9988,9,9,9,18,32,51,-19,36
Stenhousem'r,9988,10,5,9,22,44,88,-44,24
Alloa,9989,1,22,6,8,75,41,34,72
Livingston,9989,2,22,5,9,76,42,34,71
Brechin,9989,3,16,7,13,45,41,4,55
Peterhead,9989,4,14,9,13,49,45,4,51
East Fife,9989,5,12,12,12,49,44,5,48
Albion,9989,6,13,9,14,52,58,-6,48
Airdrieon,9989,7,14,6,16,55,66,-11,48
Queen's Park,9989,8,12,9,15,35,50,-15,45
Stranraer,9989,9,9,6,21,49,71,-22,33
Stenhousem'r,9989,10,8,7,21,48,75,-27,31
Alloa,9990,1,21,6,9,73,44,29,69
Livingston,9990,2,17,8,11,69,46,23,59
Airdrieon,9990,3,16,8,12,46,52,-6,56
Queen's Park,9990,4,16,6,14,48,46,2,54
Peterhead,9990,5,15,8,13,59,49,10,53
Brechin,9990,6,15,8,13,51,52,-1,53
East Fife,9990,7,13,9,14,49,52,-3,48
Stranraer,9990,8,11,8,17,45,62,-17,41
Stenhousem'r,9990,9,9,8,19,45,73,-28,35
Albion,9990,10,8,9,19,48,57,-9,33
Livingston,9991,1,23,4,9,84,45,39,73
Airdrieon,9991,2,19,6,11,63,49,14,63
Alloa,9991,3,15,9,12,67,61,6,54
Peterhead,9991,4,14,7,15,54,64,-10,49
Albion,9991,5,11,14,11,52,51,1,47
East Fife,9991,6,12,10,14,49,48,1,46
Brechin,9991,7,12,9,15,50,56,-6,45
Queen's Park,9991,8,12,9,15,41,55,-14,45
Stranraer,9991,9,11,7,18,51,56,-5,40
Stenhousem'r,9991,10,9,9,18,47,73,-26,36
Alloa,9992,1,20,4,12,63,43,20,64
Airdrieon,9992,2,19,7,10,58,42,16,64
Livingston,9992,3,18,6,12,69,47,22,60
Brechin,9992,4,17,6,13,53,51,2,57
Peterhead,9992,5,15,10,11,51,54,-3,55
Stranraer,9992,6,14,8,14,54,52,2,50
Albion,9992,7,12,10,14,49,50,-1,46
Queen's Park,9992,8,11,11,14,35,50,-15,44
East Fife,9992,9,10,8,18,48,55,-7,38
Stenhousem'r,9992,10,4,10,22,36,72,-36,22
Livingston,9993,1,22,7,7,83,48,35,73
Alloa,9993,2,20,8,8,78,45,33,68
Airdrieon,9993,3,19,7,10,71,53,18,64
Albion,9993,4,14,10,12,57,49,8,52
Brechin,9993,5,14,9,13,54,50,4,51
Peterhead,9993,6,12,7,17,52,66,-14,43
Queen's Park,9993,7,11,7,18,35,57,-22,40
East Fife,9993,8,9,11,16,47,59,-12,38
Stranraer,9993,9,10,8,18,49,65,-16,38
Stenhousem'r,9993,10,7,10,19,54,88,-34,31
Livingston,9994,1,24,3,9,79,41,38,75
Alloa,9994,2,22,6,8,76,38,38,72
Brechin,9994,3,20,5,11,51,42,9,65
Albion,9994,4,15,6,15,58,53,5,51
Airdrieon,9994,5,15,5,16,53,63,-10,50
Peterhead,9994,6,13,7,16,52,58,-6,46
East Fife,9994,7,11,9,16,52,49,3,42
Queen's Park,9994,8,12,6,18,44,61,-17,42
Stranraer,9994,9,12,4,20,44,64,-20,40
Stenhousem'r,9994,10,7,7,22,41,81,-40,28
Alloa,9995,1,20,9,7,73,37,36,69
Livingston,9995,2,21,2,13,73,55,18,65
Albion,9995,3,16,8,12,63,55,8,56
Airdrieon,9995,4,16,5,15,53,53,0,53
Brechin,9995,5,16,5,15,51,53,-2,53
Peterhead,9995,6,14,8,14,51,53,-2,50
Stranraer,9995,7,12,7,17,56,66,-10,43
Queen's Park,9995,8,12,7,17,43,57,-14,43
East Fife,9995,9,11,8,17,46,54,-8,41
Stenhousem'r,9995,10,9,7,20,46,72,-26,34
Livingston,9996,1,22,5,9,78,46,32,71
Brechin,9996,2,19,6,11,61,48,13,63
Alloa,9996,3,17,9,10,71,44,27,60
Airdrieon,9996,4,16,7,13,63,61,2,55
Albion,9996,5,14,9,13,55,57,-2,51
East Fife,9996,6,13,9,14,55,47,8,48
Queen's Park,9996,7,13,7,16,43,59,-16,46
Peterhead,9996,8,11,9,16,54,57,-3,42
Stranraer,9996,9,10,5,21,54,71,-17,35
Stenhousem'r,9996,10,8,8,20,43,87,-44,32
Alloa,9997,1,20,7,9,61,41,20,67
Livingston,9997,2,20,4,12,72,47,25,64
Airdrieon,9997,3,17,7,12,63,55,8,58
Peterhead,9997,4,15,9,12,59,54,5,54
Queen's Park,9997,5,15,6,15,34,45,-11,51
East Fife,9997,6,15,5,16,56,48,8,50
Brechin,9997,7,15,3,18,52,53,-1,48
Stranraer,9997,8,14,5,17,52,57,-5,47
Albion,9997,9,10,10,16,49,61,-12,40
Stenhousem'r,9997,10,6,10,20,46,83,-37,28
Alloa,9998,1,20,10,6,76,46,30,70
Livingston,9998,2,20,6,10,70,47,23,66
Queen's Park,9998,3,15,9,12,51,51,0,54
Airdrieon,9998,4,15,7,14,61,69,-8,52
Peterhead,9998,5,14,8,14,53,50,3,50
Brechin,9998,6,14,6,16,50,56,-6,48
Stranraer,9998,7,13,6,17,56,59,-3,45
Albion,9998,8,12,7,17,47,53,-6,43
Stenhousem'r,9998,9,11,6,19,49,74,-25,39
East Fife,9998,10,10,7,19,48,56,-8,37
Alloa,9999,1,21,7,8,77,42,35,70
Livingston,9999,2,21,4,11,68,49,19,67
Airdrieon,9999,3,18,5,13,59,52,7,59
Brechin,9999,4,17,7,12,58,53,5,58
Albion,9999,5,15,5,16,54,51,3,50
Queen's Park,9999,6,15,5,16,39,51,-12,50
East Fife,9999,7,12,8,16,56,60,-4,44
Stranraer,9999,8,11,8,17,53,63,-10,41
Peterhead,9999,9,11,6,19,43,58,-15,39
Stenhousem'r,9999,10,8,7,21,47,75,-28,31
